"","INSEE_COM","Annee","Nb_mutations","NbMaisons","NbApparts","PrixMoyen","Prixm2Moyen","SurfaceMoy"
"1","01001","2014",10,10,0,180207,1708.9,107.4
"2","01002","2014",3,3,0,107930,1338,80.3333333333333
"3","01004","2014",125,77,48,164579.392,1946.432,85.872
"4","01005","2014",15,12,3,252109.733333333,2412.2,110.533333333333
"5","01006","2014",1,1,0,60000,857,70
"6","01007","2014",25,24,1,176524.88,1694.16,110.96
"7","01008","2014",8,8,0,170813.75,1800.875,97.875
"8","01009","2014",2,1,1,145000,1237,107.5
"9","01010","2014",15,14,1,176520,1984.33333333333,94.5333333333333
"10","01011","2014",4,4,0,101125,1371.5,98.75
"11","01012","2014",1,1,0,65000,878,74
"12","01014","2014",14,11,3,186254.428571429,1669.42857142857,108.642857142857
"13","01015","2014",9,9,0,159983.888888889,1405.77777777778,105.444444444444
"14","01016","2014",3,3,0,116800,960.666666666667,115
"15","01017","2014",5,5,0,65600,1429.4,52
"16","01021","2014",4,4,0,184000,2214,87
"17","01022","2014",17,11,6,121185.294117647,1388.58823529412,88.1176470588235
"18","01023","2014",1,1,0,125200,1170,107
"19","01024","2014",27,25,2,186506.481481481,1756.66666666667,106.148148148148
"20","01025","2014",26,26,0,176078.076923077,1622.69230769231,111.884615384615
"21","01026","2014",5,5,0,118960,1559.6,74.4
"22","01027","2014",9,8,1,211935.888888889,2508.77777777778,90
"23","01028","2014",4,4,0,135500,2265.75,74.25
"24","01029","2014",1,1,0,63000,438,144
"25","01030","2014",9,5,4,126126.666666667,1743.88888888889,72.1111111111111
"26","01031","2014",12,6,6,157783.5,1773.41666666667,89.75
"27","01032","2014",22,19,3,231575.227272727,2282.40909090909,105.227272727273
"28","01033","2014",142,58,84,175815.316901408,2259.96478873239,79.5211267605634
"29","01034","2014",69,36,33,136006.304347826,1554.66666666667,89.3768115942029
"30","01035","2014",6,5,1,160166.666666667,1581.16666666667,105
"31","01036","2014",15,15,0,142467.333333333,1529.86666666667,101.6
"32","01037","2014",2,2,0,147500,1652,92
"33","01038","2014",2,2,0,126000,1100,115.5
"34","01039","2014",4,3,1,116500,1212,98
"35","01040","2014",3,3,0,147333.333333333,1015.33333333333,141.666666666667
"36","01041","2014",8,8,0,170740.75,1641,101.25
"37","01042","2014",2,2,0,384285.5,2150.5,190
"38","01043","2014",41,33,8,313599.56097561,2951.07317073171,105.341463414634
"39","01044","2014",3,3,0,237240,2346,102.333333333333
"40","01046","2014",9,9,0,172573.333333333,1600.77777777778,111.888888888889
"41","01047","2014",17,17,0,221327.647058824,2307.41176470588,98.8823529411765
"42","01049","2014",31,23,8,227074.612903226,2138.1935483871,107.290322580645
"43","01050","2014",6,6,0,176558.333333333,1775.66666666667,100.166666666667
"44","01051","2014",1,1,0,155000,3100,50
"45","01052","2014",5,5,0,268408,1817.4,175
"46","01053","2014",438,105,333,127921.97260274,1637.42922374429,79.662100456621
"47","01054","2014",10,10,0,212745,2006.2,108.2
"48","01056","2014",7,7,0,109785.714285714,1165.57142857143,94.4285714285714
"49","01058","2014",8,6,2,128187.5,1335.625,92.375
"50","01060","2014",7,7,0,146008.571428571,1549.85714285714,108.571428571429
"51","01061","2014",13,11,2,198686.153846154,1819.30769230769,108.615384615385
"52","01062","2014",10,10,0,256367,2064,128.3
"53","01063","2014",2,2,0,77500,831.5,92
"54","01064","2014",9,9,0,148718.333333333,1698.88888888889,88.7777777777778
"55","01065","2014",5,5,0,179716.2,1619.2,114.4
"56","01066","2014",1,1,0,15000,556,27
"57","01067","2014",3,1,2,182333.333333333,2035,92.3333333333333
"58","01068","2014",7,6,1,91142.8571428571,978.857142857143,97.8571428571429
"59","01069","2014",13,10,3,165602.307692308,1707.76923076923,96.8461538461538
"60","01071","2014",40,18,22,410870.525,4350.15,94.5
"61","01072","2014",23,22,1,200573.739130435,1839.26086956522,110.086956521739
"62","01073","2014",9,8,1,188377.222222222,2194.77777777778,124.777777777778
"63","01074","2014",24,22,2,228154.416666667,2157.75,103.375
"64","01075","2014",5,5,0,169650,1955.6,85
"65","01076","2014",5,4,1,75206.4,1207.2,64.4
"66","01077","2014",1,1,0,105000,772,136
"67","01078","2014",12,8,4,350317.916666667,3884.66666666667,97.6666666666667
"68","01079","2014",6,5,1,188466.666666667,1843.33333333333,117.333333333333
"69","01080","2014",3,3,0,138900,1280.33333333333,106.666666666667
"70","01081","2014",5,5,0,212110,2085.6,102.6
"71","01082","2014",7,5,2,176714.285714286,2457.71428571429,71.1428571428571
"72","01083","2014",7,7,0,233491.428571429,1874.71428571429,131.285714285714
"73","01084","2014",8,8,0,183045.625,1757.125,105.125
"74","01085","2014",2,2,0,174660,1867,93.5
"75","01087","2014",3,3,0,159100,1281.66666666667,117.666666666667
"76","01088","2014",5,4,1,315040,2276.6,132.8
"77","01089","2014",24,24,0,157925.625,1721.54166666667,89.7916666666667
"78","01090","2014",2,2,0,305750,2174,140
"79","01092","2014",19,19,0,166667.210526316,1712,96
"80","01093","2014",45,27,18,181736.377777778,2102.35555555556,87
"81","01094","2014",6,6,0,135533.333333333,1450.66666666667,93.5
"82","01095","2014",5,5,0,113630,1052,106.2
"83","01096","2014",4,4,0,105957.5,1071,89
"84","01098","2014",7,4,3,128771.142857143,1375.42857142857,94.8571428571429
"85","01099","2014",10,10,0,224737.9,2096.5,107.1
"86","01100","2014",4,4,0,174700,2099,94
"87","01101","2014",1,1,0,212000,2186,97
"88","01102","2014",10,10,0,177786.6,1552.4,115
"89","01103","2014",10,7,3,394668.6,3831,107.6
"90","01104","2014",6,3,3,200333.333333333,1501.83333333333,116.5
"91","01105","2014",12,12,0,207810.833333333,1707.16666666667,119.166666666667
"92","01108","2014",7,7,0,143285.714285714,1395.57142857143,106.428571428571
"93","01109","2014",21,13,8,265592.857142857,3433.71428571429,79.7619047619048
"94","01110","2014",3,3,0,105369.333333333,946,110.666666666667
"95","01111","2014",3,3,0,146666.666666667,1819.33333333333,85.3333333333333
"96","01112","2014",4,4,0,172375,1702.75,101.25
"97","01113","2014",4,4,0,200625,2170,103
"98","01114","2014",7,5,2,218514.285714286,2248.57142857143,96.8571428571429
"99","01115","2014",10,8,2,142045,1517.3,99.9
"100","01116","2014",2,2,0,97500,747,116.5
"101","01117","2014",2,2,0,107500,1205,90
"102","01118","2014",11,11,0,157772.727272727,1644.27272727273,104.363636363636
"103","01121","2014",1,1,0,101300,844,120
"104","01123","2014",5,5,0,186450,1816.6,104.6
"105","01124","2014",7,7,0,113107.142857143,1238.42857142857,92.2857142857143
"106","01125","2014",9,9,0,121777.777777778,1141.66666666667,105.666666666667
"107","01127","2014",3,3,0,124000,1201,99
"108","01128","2014",4,4,0,186750,1653.75,102
"109","01129","2014",1,1,0,157000,1427,110
"110","01130","2014",12,11,1,174661.333333333,1315,139.833333333333
"111","01133","2014",2,2,0,160500,1112.5,144
"112","01134","2014",14,14,0,179789.785714286,1944,97.6428571428571
"113","01135","2014",16,11,5,460362.5625,3754.9375,122.75
"114","01136","2014",9,9,0,205742.777777778,1695.11111111111,126
"115","01138","2014",26,18,8,116297.307692308,1273.30769230769,93.3846153846154
"116","01139","2014",4,4,0,106750,1188,114.25
"117","01140","2014",4,4,0,169972.5,1623.5,105.25
"118","01141","2014",1,1,0,230000,2447,94
"119","01142","2014",64,36,28,195689.34375,2305.609375,88.84375
"120","01143","2014",96,21,75,521046.333333333,5102.375,95.4895833333333
"121","01145","2014",5,5,0,151900,1806.8,86.2
"122","01146","2014",4,4,0,198625,1785.25,111
"123","01147","2014",9,9,0,139070,1593.66666666667,94.5555555555556
"124","01148","2014",8,7,1,141750,1632.875,88.25
"125","01149","2014",9,9,0,178456.666666667,1677.11111111111,104.333333333333
"126","01151","2014",3,3,0,166819,1404,115
"127","01152","2014",6,6,0,205833.333333333,1962.83333333333,105.833333333333
"128","01153","2014",17,15,2,469626.117647059,3557.29411764706,145.470588235294
"129","01155","2014",1,1,0,45000,450,100
"130","01156","2014",4,4,0,211525,1830.5,122.25
"131","01157","2014",12,10,2,216410.833333333,2072.5,115
"132","01158","2014",6,5,1,304575,3122.5,90.5
"133","01159","2014",10,10,0,166862.5,1533,110
"134","01160","2014",94,7,87,298730.468085106,4035.5,71.468085106383
"135","01162","2014",2,2,0,89750,1060,85
"136","01163","2014",22,22,0,148558.181818182,1501.68181818182,103
"137","01165","2014",15,15,0,236276.666666667,2272.86666666667,109.266666666667
"138","01166","2014",19,19,0,220699.473684211,2009.57894736842,114.684210526316
"139","01169","2014",1,1,0,95000,1173,81
"140","01170","2014",3,3,0,255016.333333333,2794.33333333333,100
"141","01171","2014",4,4,0,259330,1604.75,148.75
"142","01173","2014",120,28,92,284755.858333333,3555.05833333333,80.2833333333333
"143","01174","2014",2,2,0,147000,1421,101
"144","01175","2014",4,4,0,143212.5,1610.75,89
"145","01177","2014",2,2,0,62600,571.5,101
"146","01179","2014",23,22,1,199976.086956522,2052.5652173913,105.478260869565
"147","01180","2014",5,3,2,516260,4880.6,101.6
"148","01181","2014",8,8,0,176466.625,1665,109.625
"149","01183","2014",10,10,0,183567.5,1859.9,99.3
"150","01184","2014",8,8,0,130281.5,1216.25,107.25
"151","01185","2014",28,17,11,110032.5,1341.89285714286,83.5714285714286
"152","01187","2014",7,4,3,126840.571428571,1556.71428571429,92.5714285714286
"153","01188","2014",8,8,0,211881.25,1517.625,138
"154","01189","2014",3,2,1,169833.333333333,2103.33333333333,81.6666666666667
"155","01192","2014",9,9,0,205803.333333333,1472.44444444444,138
"156","01193","2014",3,3,0,237833.333333333,2308,102.666666666667
"157","01194","2014",62,47,15,195466.516129032,2200.27419354839,95.9838709677419
"158","01195","2014",7,5,2,194251.714285714,1753.14285714286,116.571428571429
"159","01196","2014",5,5,0,155780,1601.6,94
"160","01197","2014",4,4,0,152300,1916.25,88
"161","01198","2014",3,3,0,230443.333333333,3386,69.3333333333333
"162","01199","2014",20,18,2,144157.05,1769.4,94.85
"163","01200","2014",4,4,0,88705.5,904,101.5
"164","01202","2014",67,45,22,161283.701492537,1845.80597014925,86.7014925373134
"165","01203","2014",8,8,0,185980,1868.125,95.625
"166","01204","2014",7,7,0,149571.428571429,1197.85714285714,129.857142857143
"167","01206","2014",1,1,0,160000,1143,140
"168","01207","2014",4,4,0,234887.5,1674.5,128.25
"169","01209","2014",6,6,0,154034.166666667,1852.5,79.1666666666667
"170","01210","2014",11,0,11,56295,1820.18181818182,31.1818181818182
"171","01211","2014",9,9,0,246944.444444444,1790.88888888889,126.444444444444
"172","01212","2014",6,6,0,112070,1748.83333333333,65.5
"173","01213","2014",10,10,0,172797,1937.7,87.8
"174","01214","2014",4,4,0,134125,1271.25,104.25
"175","01215","2014",4,4,0,287917.5,2702.25,102.75
"176","01216","2014",15,15,0,134875.333333333,1568.4,88.4666666666667
"177","01224","2014",23,20,3,184704.782608696,2047.5652173913,103.695652173913
"178","01225","2014",1,1,0,201400,1900,106
"179","01227","2014",5,5,0,126660,1403.6,101.8
"180","01228","2014",1,1,0,183000,1408,130
"181","01229","2014",4,3,1,174510,1763.25,99.5
"182","01231","2014",13,13,0,159282.307692308,1585.76923076923,102.538461538462
"183","01232","2014",17,17,0,157736.176470588,1643.58823529412,97.9411764705882
"184","01233","2014",1,1,0,179380,1993,90
"185","01234","2014",1,1,0,75000,938,80
"186","01235","2014",9,9,0,165875.111111111,2045.77777777778,88.5555555555556
"187","01236","2014",6,6,0,120700,1386.5,90.1666666666667
"188","01237","2014",13,13,0,213605.538461538,1762.15384615385,121.769230769231
"189","01239","2014",5,5,0,250424,1945.2,128.6
"190","01240","2014",5,5,0,87800,1336,80.4
"191","01241","2014",5,5,0,115800,1098.8,113.4
"192","01242","2014",1,1,0,95000,1188,80
"193","01243","2014",11,10,1,260563.181818182,2086.90909090909,125
"194","01244","2014",71,55,16,188336.267605634,1983.70422535211,97.3943661971831
"195","01245","2014",7,7,0,172671.428571429,1298,133.714285714286
"196","01246","2014",20,19,1,174097.5,1465.85,121.85
"197","01247","2014",20,4,16,78008.1,2057.95,39.15
"198","01248","2014",16,11,5,246070.625,3236.8125,84.5
"199","01249","2014",81,45,36,238730.555555556,2575.87654320988,93.320987654321
"200","01250","2014",9,9,0,208054,1886.66666666667,111.555555555556
"201","01252","2014",12,12,0,297447.083333333,2362.66666666667,137.416666666667
"202","01254","2014",6,6,0,229801.666666667,1905,122
"203","01255","2014",6,6,0,162670,1303.83333333333,128.166666666667
"204","01257","2014",2,2,0,250500,3302.5,76
"205","01258","2014",5,5,0,230200,2151,106.4
"206","01259","2014",8,8,0,156150,1791.125,93.5
"207","01260","2014",1,1,0,155000,2818,55
"208","01261","2014",6,6,0,313233.333333333,2429.33333333333,133.333333333333
"209","01262","2014",54,27,27,192606.759259259,2186.7962962963,90.3703703703704
"210","01263","2014",45,42,3,216382.111111111,2053.86666666667,105.733333333333
"211","01264","2014",10,10,0,151781.9,1242.6,122.7
"212","01265","2014",17,7,10,112717.647058824,1487.11764705882,74.3529411764706
"213","01266","2014",14,7,7,128909.214285714,1579.07142857143,94.7857142857143
"214","01267","2014",3,3,0,150000,1621.33333333333,92.3333333333333
"215","01268","2014",3,3,0,121550,1651.33333333333,76.3333333333333
"216","01269","2014",27,9,18,110879.62962963,1188.85185185185,96.6296296296296
"217","01272","2014",18,16,2,178189.833333333,1856.5,91.4444444444444
"218","01273","2014",10,9,1,157254,1735.7,92.6
"219","01274","2014",7,7,0,162599.428571429,1484.14285714286,111.714285714286
"220","01275","2014",19,14,5,285412.842105263,2491,116.842105263158
"221","01276","2014",14,14,0,240559.642857143,2350.92857142857,101.5
"222","01280","2014",2,2,0,66250,962,68
"223","01281","2014",37,19,18,470330.837837838,4334.05405405405,107.756756756757
"224","01282","2014",1,1,0,180000,1895,95
"225","01283","2014",161,66,95,119473.136645963,1452.67701863354,82.3354037267081
"226","01284","2014",2,2,0,178000,1792.5,98
"227","01285","2014",1,1,0,761100,2861,266
"228","01286","2014",4,3,1,128562.5,2086.5,64
"229","01288","2014",25,16,9,357518.88,3444.48,108.2
"230","01289","2014",58,39,19,167420.465517241,1769.74137931034,95.1551724137931
"231","01290","2014",9,7,2,223100,2058.22222222222,112.888888888889
"232","01291","2014",7,7,0,166288.571428571,1989.14285714286,98.8571428571429
"233","01293","2014",2,2,0,194250,1437,135
"234","01294","2014",6,6,0,149358.333333333,1521.33333333333,96.8333333333333
"235","01295","2014",5,5,0,194450,1549.2,117
"236","01296","2014",5,5,0,158188,2004.2,89
"237","01297","2014",7,7,0,304797.142857143,2300.14285714286,134.714285714286
"238","01299","2014",5,5,0,164460,2015.8,79.2
"239","01301","2014",8,7,1,206800,1690.625,121.375
"240","01302","2014",1,1,0,245000,2784,88
"241","01303","2014",19,18,1,135401.263157895,1511.26315789474,87.5263157894737
"242","01304","2014",28,26,2,143278.75,1559.67857142857,98
"243","01305","2014",16,6,10,95875.5,1091.75,88.25
"244","01306","2014",5,1,4,121800,1510.4,80.6
"245","01307","2014",9,4,5,131488.888888889,1571.22222222222,80.3333333333333
"246","01308","2014",5,2,3,213440,3354.2,66.8
"247","01309","2014",1,1,0,174500,1255,139
"248","01310","2014",1,1,0,80000,1067,75
"249","01313","2014",56,27,29,453948.821428571,4628.64285714286,95.6071428571429
"250","01314","2014",22,20,2,168385.454545455,1653.13636363636,104.045454545455
"251","01317","2014",3,3,0,161633.333333333,1694.66666666667,98
"252","01318","2014",6,6,0,238033.333333333,2490,103.5
"253","01320","2014",26,25,1,170234,1839.03846153846,92.7307692307692
"254","01321","2014",8,8,0,142912.5,1547.125,104.25
"255","01322","2014",32,28,4,244253.90625,2271.3125,111.21875
"256","01323","2014",8,8,0,119625,1248.75,98.875
"257","01325","2014",6,6,0,189885,1747.5,109.833333333333
"258","01328","2014",5,5,0,250750,2520,116.4
"259","01329","2014",4,4,0,68187.5,754,102.25
"260","01331","2014",2,2,0,137200,1365.5,97
"261","01332","2014",2,2,0,138450,1734,79.5
"262","01333","2014",18,13,5,238741.111111111,2482,100.888888888889
"263","01334","2014",6,6,0,200333.333333333,2701.83333333333,130.333333333333
"264","01335","2014",3,3,0,238133.333333333,2021,117.333333333333
"265","01336","2014",9,7,2,214745.555555556,2107.33333333333,98.6666666666667
"266","01337","2014",14,14,0,137747.142857143,1481.5,96.4285714285714
"267","01338","2014",8,8,0,115167.5,1256.25,96.5
"268","01339","2014",11,11,0,308400,2624.09090909091,125.272727272727
"269","01343","2014",12,12,0,153229.166666667,1588.75,96.0833333333333
"270","01344","2014",49,44,5,172297.224489796,1827.14285714286,94.2244897959184
"271","01345","2014",16,11,5,148942.5,1696.875,89.5625
"272","01346","2014",6,6,0,137125,1396.33333333333,100.666666666667
"273","01347","2014",13,13,0,265009.230769231,2532.76923076923,105.846153846154
"274","01348","2014",14,14,0,172538.714285714,1797.28571428571,96.2857142857143
"275","01349","2014",5,5,0,245950,2184,112
"276","01350","2014",16,11,5,172837.5,1538,113.5625
"277","01351","2014",12,12,0,173191.666666667,1647.58333333333,112.666666666667
"278","01352","2014",8,8,0,157358.75,1339.5,125.125
"279","01353","2014",23,20,3,240981.304347826,2200.21739130435,111.95652173913
"280","01354","2014",134,29,105,289053.276119403,3380.98507462687,85.589552238806
"281","01355","2014",5,5,0,125666,1014,145.2
"282","01356","2014",2,2,0,217500,2250,105
"283","01357","2014",4,3,1,162500,2162.25,77.75
"284","01359","2014",1,1,0,245000,2130,115
"285","01360","2014",15,8,7,298216.266666667,3272.13333333333,85.7333333333333
"286","01361","2014",6,6,0,179808.333333333,2328,82.5
"287","01362","2014",4,4,0,229437.5,2157.25,112.75
"288","01363","2014",17,17,0,210323.529411765,2073.11764705882,109.529411764706
"289","01364","2014",3,3,0,200750,1946.66666666667,103.333333333333
"290","01365","2014",5,5,0,160626.8,1676.2,98.8
"291","01366","2014",9,9,0,197300,1826.33333333333,111.777777777778
"292","01367","2014",7,7,0,104507.142857143,1222.57142857143,87
"293","01368","2014",4,4,0,144387.5,1944.5,70.75
"294","01369","2014",9,8,1,191305.555555556,1868,102.666666666667
"295","01370","2014",18,0,18,92049.3333333333,1541.72222222222,58.8888888888889
"296","01371","2014",6,5,1,230101.666666667,2345.16666666667,98.8333333333333
"297","01372","2014",3,3,0,138500,1099,116.666666666667
"298","01373","2014",2,2,0,110000,1422.5,70
"299","01374","2014",12,12,0,205354.583333333,1768.41666666667,123.166666666667
"300","01375","2014",3,3,0,151850,1315.66666666667,142
"301","01376","2014",39,17,22,219345.051282051,2661.25641025641,82
"302","01378","2014",23,22,1,239096.086956522,2078.34782608696,119.086956521739
"303","01379","2014",7,7,0,151457.142857143,1809.14285714286,99
"304","01380","2014",7,7,0,131004.285714286,1945.28571428571,75.1428571428571
"305","01381","2014",8,8,0,233749.875,1727.75,135.25
"306","01382","2014",2,2,0,315310,2986.5,108.5
"307","01383","2014",11,11,0,144609.090909091,1630.09090909091,87.4545454545455
"308","01384","2014",18,17,1,80287.3333333333,1190.16666666667,73.0555555555556
"309","01385","2014",3,3,0,96666.6666666667,800.333333333333,123.666666666667
"310","01386","2014",8,5,3,132165,1390.875,108.625
"311","01387","2014",1,1,0,185000,3491,53
"312","01388","2014",7,7,0,124597.428571429,1120.42857142857,110
"313","01389","2014",10,5,5,137185.5,1450.7,104
"314","01390","2014",8,8,0,205601.875,2168.625,101
"315","01391","2014",1,1,0,60000,1000,60
"316","01392","2014",2,2,0,131000,1350,97
"317","01393","2014",4,4,0,189635,1507,122
"318","01396","2014",10,8,2,107236.6,1200.9,89
"319","01397","2014",6,4,2,622975.666666667,4796,117.166666666667
"320","01398","2014",11,9,2,255808.181818182,2199.45454545455,115
"321","01399","2014",15,14,1,507818.866666667,4201.06666666667,123.666666666667
"322","01401","2014",21,13,8,415242.857142857,4080.04761904762,103.666666666667
"323","01402","2014",3,3,0,103033.333333333,1482,70.6666666666667
"324","01403","2014",7,7,0,139135.714285714,1510.14285714286,89.5714285714286
"325","01404","2014",1,1,0,150000,1136,132
"326","01405","2014",13,12,1,188883.692307692,1767.53846153846,101.384615384615
"327","01406","2014",1,1,0,123000,3075,40
"328","01407","2014",7,3,4,104257.142857143,1558.28571428571,68.8571428571429
"329","01408","2014",6,5,1,143700,1223.66666666667,116.666666666667
"330","01410","2014",2,2,0,128250,1495,86.5
"331","01411","2014",5,5,0,162416,1554.2,105.4
"332","01412","2014",2,2,0,190775,1228,155.5
"333","01415","2014",1,1,0,292000,1622,180
"334","01416","2014",13,7,6,66966.9230769231,815.923076923077,81.7692307692308
"335","01418","2014",9,7,2,247668.555555556,2530.55555555556,98.8888888888889
"336","01419","2014",38,23,15,378195.263157895,3851.73684210526,98.3157894736842
"337","01420","2014",13,5,8,124691.230769231,1529.53846153846,83.2307692307692
"338","01421","2014",11,11,0,144189.090909091,1440.27272727273,101.818181818182
"339","01422","2014",19,18,1,186182.105263158,1723.31578947368,108.315789473684
"340","01423","2014",10,10,0,223872,2317.2,105.9
"341","01424","2014",10,10,0,321252.5,2798,117.3
"342","01425","2014",4,4,0,224150,1900,121.5
"343","01426","2014",19,19,0,148526.315789474,1447.36842105263,105.789473684211
"344","01427","2014",66,37,29,188816.636363636,2236.40909090909,87.3181818181818
"345","01428","2014",1,1,0,167000,2288,73
"346","01429","2014",3,3,0,187000,1735,108
"347","01430","2014",3,3,0,126383.333333333,1682,72
"348","01431","2014",7,6,1,129481.428571429,1497,94
"349","01432","2014",2,2,0,97000,1231,79
"350","01433","2014",2,2,0,97500,845,110.5
"351","01434","2014",6,3,3,215000,3280.33333333333,79.6666666666667
"352","01435","2014",14,11,3,408935.357142857,4197.5,96.2857142857143
"353","01436","2014",5,1,4,331590,3420.8,93.2
"354","01437","2014",1,1,0,170890,1526,112
"355","01441","2014",6,6,0,132250,1007,127.833333333333
"356","01443","2014",49,29,20,182630.224489796,2117.91836734694,87.3877551020408
"357","01444","2014",11,11,0,111604.545454545,1268.18181818182,85.2727272727273
"358","01445","2014",4,3,1,170525,1965.25,88.5
"359","01446","2014",14,12,2,236726.785714286,2070.21428571429,120.857142857143
"360","01447","2014",13,13,0,125147.692307692,1220.38461538462,103.153846153846
"361","01448","2014",2,2,0,227100,1505.5,139
"362","01449","2014",7,7,0,183435,1684.57142857143,107.428571428571
"363","01450","2014",36,33,3,191742.277777778,2049.19444444444,94.8333333333333
"364","01451","2014",23,18,5,149273.913043478,1761.04347826087,87.304347826087
"365","01452","2014",10,10,0,152095,1661.3,91.1
"366","01453","2014",3,3,0,127333.333333333,1041.33333333333,132.666666666667
"367","01454","2014",8,6,2,158935.25,1532.25,109.25
"368","01456","2014",2,2,0,220500,1577.5,137
"369","01457","2014",21,16,5,179970.476190476,2125.42857142857,87.0952380952381
"370","02001","2014",7,7,0,69785.7142857143,880.714285714286,75.1428571428571
"371","02002","2014",8,8,0,82031.25,910.375,96.125
"372","02003","2014",8,8,0,146287.5,1917.625,86.375
"373","02004","2014",1,1,0,1e+05,943,106
"374","02005","2014",2,2,0,114650,941,108.5
"375","02006","2014",5,5,0,116400,932.2,119.2
"376","02009","2014",5,5,0,121900,1189.8,103.2
"377","02010","2014",1,1,0,227000,2948,77
"378","02011","2014",11,11,0,142454.545454545,1626.36363636364,95.7272727272727
"379","02013","2014",2,2,0,136600,1382,103.5
"380","02014","2014",4,4,0,138175,1417.75,97.25
"381","02016","2014",3,3,0,147466.666666667,1601.66666666667,95
"382","02017","2014",2,2,0,78500,647,118.5
"383","02018","2014",27,27,0,112407.407407407,1164.33333333333,96.2592592592593
"384","02019","2014",6,6,0,110833.333333333,1193.66666666667,94.5
"385","02020","2014",4,4,0,146625,1152.25,138.5
"386","02022","2014",4,4,0,107250,1129.25,96.25
"387","02023","2014",1,1,0,108000,893,121
"388","02025","2014",2,2,0,102500,1188.5,87.5
"389","02027","2014",3,3,0,80666.6666666667,691.666666666667,117.333333333333
"390","02028","2014",20,20,0,126009.5,1391.65,90.15
"391","02029","2014",3,3,0,222666.666666667,1257,173.333333333333
"392","02030","2014",2,2,0,75000,805,92.5
"393","02031","2014",2,1,1,31550,394.5,80.5
"394","02032","2014",2,2,0,96850,1142,93
"395","02034","2014",2,2,0,112052.5,1563.5,72
"396","02035","2014",1,1,0,60000,732,82
"397","02036","2014",1,1,0,195000,3362,58
"398","02037","2014",10,10,0,119800,1120.7,108.9
"399","02041","2014",15,15,0,125613.333333333,1428,91.3333333333333
"400","02042","2014",4,4,0,80000,1423.5,57.5
"401","02046","2014",14,14,0,119000,1224.57142857143,99.6428571428571
"402","02049","2014",8,8,0,91537.5,1403.625,70.75
"403","02050","2014",2,2,0,54250,738.5,69
"404","02051","2014",5,5,0,213600,1553.4,145.2
"405","02052","2014",1,1,0,40000,1538,26
"406","02053","2014",2,2,0,97500,969.5,114
"407","02054","2014",3,3,0,94986.6666666667,1406.66666666667,80
"408","02055","2014",3,3,0,133100,1547.33333333333,88
"409","02057","2014",6,6,0,132288.333333333,1188.66666666667,109.166666666667
"410","02058","2014",9,9,0,120965.555555556,1334.55555555556,92.3333333333333
"411","02059","2014",18,17,1,80883.3333333333,992.222222222222,82.5
"412","02060","2014",3,3,0,86300,905.333333333333,100.333333333333
"413","02061","2014",1,1,0,54600,642,85
"414","02062","2014",2,2,0,147500,687.5,209
"415","02063","2014",5,5,0,101500,1336.2,75.8
"416","02064","2014",18,17,1,135458.333333333,1530.55555555556,90.3333333333333
"417","02065","2014",5,5,0,99100,1100.2,90.2
"418","02066","2014",1,1,0,112000,1087,103
"419","02067","2014",2,2,0,63750,759,87
"420","02069","2014",1,1,0,60000,759,79
"421","02070","2014",6,6,0,117333.333333333,1213.5,99.3333333333333
"422","02071","2014",1,1,0,80000,1053,76
"423","02072","2014",3,3,0,156433.333333333,1515.66666666667,106
"424","02073","2014",8,8,0,152975,1677.625,93.25
"425","02074","2014",7,7,0,90271.4285714286,1025,88.8571428571429
"426","02075","2014",3,3,0,109666.666666667,1216.66666666667,89.6666666666667
"427","02076","2014",1,1,0,60000,1154,52
"428","02077","2014",5,4,1,152540,1971.6,95.8
"429","02078","2014",1,1,0,87000,1160,75
"430","02080","2014",1,1,0,243000,688,353
"431","02081","2014",10,10,0,114530,1202.9,95.7
"432","02083","2014",7,7,0,136428.571428571,1466,103
"433","02084","2014",6,6,0,103666.666666667,1760.16666666667,78.8333333333333
"434","02085","2014",7,7,0,143255.714285714,1471.57142857143,101
"435","02086","2014",5,5,0,108060,1122.4,99.2
"436","02087","2014",1,1,0,125253,684,183
"437","02088","2014",1,1,0,228000,1594,143
"438","02089","2014",14,14,0,148643.5,1518.64285714286,94.8571428571429
"439","02090","2014",1,1,0,163000,1254,130
"440","02093","2014",12,10,2,96298.3333333333,1405.16666666667,72.75
"441","02094","2014",4,4,0,149096.25,1926,79.25
"442","02095","2014",37,37,0,55094.5945945946,699.702702702703,74.6756756756757
"443","02096","2014",1,1,0,140000,389,360
"444","02097","2014",3,3,0,88000,970.666666666667,92.6666666666667
"445","02098","2014",1,1,0,65000,2031,32
"446","02099","2014",1,1,0,178020,1484,120
"447","02101","2014",5,5,0,73105.4,739.4,123.6
"448","02102","2014",1,1,0,175000,1174,149
"449","02103","2014",16,16,0,92468.75,998.25,95.5
"450","02104","2014",2,2,0,180850,1479.5,124
"451","02105","2014",4,4,0,141875,1012.25,153.5
"452","02106","2014",3,3,0,130606.666666667,1467.33333333333,92.6666666666667
"453","02107","2014",1,1,0,140000,1573,89
"454","02108","2014",4,4,0,122375,1849,72.75
"455","02109","2014",1,1,0,60000,536,112
"456","02110","2014",16,14,2,95300.625,983.375,98.9375
"457","02111","2014",5,5,0,151400,1280.4,120.2
"458","02112","2014",10,10,0,64100,677,95.1
"459","02114","2014",9,9,0,132111.111111111,1661.88888888889,82.8888888888889
"460","02118","2014",1,1,0,161000,1809,89
"461","02119","2014",1,1,0,70000,875,80
"462","02120","2014",4,4,0,115000,1268.5,94
"463","02121","2014",3,3,0,110600,1261.33333333333,89
"464","02122","2014",1,1,0,80000,661,121
"465","02123","2014",2,2,0,41250,694.5,58.5
"466","02124","2014",4,4,0,125640,1406.5,91.75
"467","02125","2014",1,1,0,137000,2283,60
"468","02126","2014",3,3,0,70666.6666666667,745.666666666667,93.3333333333333
"469","02128","2014",13,13,0,118291.769230769,1299.69230769231,93
"470","02131","2014",12,12,0,206416.666666667,1735.33333333333,132.916666666667
"471","02132","2014",2,2,0,93250,1090.5,82
"472","02133","2014",3,3,0,77666.6666666667,966,103.333333333333
"473","02134","2014",13,13,0,88984.6153846154,931.307692307692,89.3846153846154
"474","02135","2014",7,7,0,64285.7142857143,850.285714285714,74.2857142857143
"475","02136","2014",2,2,0,101000,731.5,141
"476","02137","2014",2,2,0,182500,2451.5,74.5
"477","02138","2014",1,1,0,128000,1293,99
"478","02139","2014",1,1,0,95000,1610,59
"479","02140","2014",1,1,0,1e+05,746,134
"480","02141","2014",16,16,0,90906.25,887,91.125
"481","02142","2014",2,2,0,199750,1883.5,104
"482","02143","2014",3,3,0,128333.333333333,1074,116
"483","02144","2014",1,1,0,70000,769,91
"484","02145","2014",3,3,0,130166.666666667,1423.33333333333,92.3333333333333
"485","02146","2014",1,1,0,140000,1867,75
"486","02151","2014",2,2,0,192500,1644,143
"487","02153","2014",8,8,0,111412.5,1137,93.125
"488","02154","2014",1,1,0,155000,1782,87
"489","02155","2014",5,5,0,89674,956,91
"490","02157","2014",3,3,0,153725,1517.66666666667,108.333333333333
"491","02158","2014",1,1,0,170000,1717,99
"492","02159","2014",2,2,0,59200,664,88
"493","02160","2014",1,1,0,66900,683,98
"494","02162","2014",2,2,0,124700,1173,104.5
"495","02163","2014",17,16,1,196443.705882353,1669.35294117647,117.294117647059
"496","02164","2014",2,2,0,127538.5,1156.5,117.5
"497","02165","2014",12,12,0,88295.8333333333,953.916666666667,106.333333333333
"498","02166","2014",5,5,0,117724,1288.4,89.8
"499","02167","2014",9,9,0,123014,1350.88888888889,88.5555555555556
"500","02168","2014",105,61,44,147526.371428571,1680.20952380952,91.7904761904762
"501","02169","2014",2,2,0,65000,757,85
"502","02172","2014",4,4,0,177000,1286.75,142
"503","02173","2014",113,101,12,93745.1681415929,1099.42477876106,87.6637168141593
"504","02174","2014",4,4,0,91500,818.75,119.25
"505","02176","2014",1,1,0,123500,1372,90
"506","02178","2014",2,2,0,92000,1021,93
"507","02179","2014",4,4,0,122400,1021,117.5
"508","02180","2014",9,9,0,94455.4444444444,999,98.3333333333333
"509","02181","2014",3,3,0,66666.6666666667,598.666666666667,104
"510","02183","2014",1,1,0,43000,754,57
"511","02184","2014",3,3,0,181966.666666667,1193,165.333333333333
"512","02185","2014",3,3,0,175000,1882.33333333333,94.3333333333333
"513","02186","2014",15,14,1,171800,1921.86666666667,97.6666666666667
"514","02187","2014",6,5,1,155583.333333333,1477.33333333333,96.5
"515","02189","2014",5,5,0,52000,712.2,72.4
"516","02190","2014",4,4,0,129772.5,1221.75,108
"517","02191","2014",3,3,0,129333.333333333,1444.33333333333,98.3333333333333
"518","02192","2014",4,4,0,112750,1263.5,86.75
"519","02193","2014",1,1,0,187500,915,205
"520","02195","2014",7,7,0,162857.142857143,1642.14285714286,106.857142857143
"521","02196","2014",2,2,0,65000,759.5,86
"522","02197","2014",4,4,0,83125,764.25,102
"523","02198","2014",1,1,0,137000,979,140
"524","02199","2014",2,2,0,121000,1015,125.5
"525","02201","2014",5,5,0,105534.6,1214.6,85
"526","02203","2014",7,7,0,149428.571428571,1437.14285714286,115.571428571429
"527","02204","2014",1,1,0,70000,972,72
"528","02205","2014",3,3,0,130333.333333333,1305,103.333333333333
"529","02207","2014",2,2,0,112500,1026.5,108.5
"530","02208","2014",7,7,0,182814.285714286,1409.42857142857,136
"531","02209","2014",12,12,0,122541.666666667,1319.08333333333,100.083333333333
"532","02210","2014",3,3,0,97366.6666666667,998,108
"533","02211","2014",4,4,0,137000,1747,79.75
"534","02212","2014",5,5,0,72200,1034.8,67.2
"535","02213","2014",4,4,0,141250,1735,90.75
"536","02214","2014",1,1,0,92000,773,119
"537","02215","2014",1,1,0,120500,1086,111
"538","02216","2014",3,3,0,146333.333333333,1428.66666666667,102.666666666667
"539","02217","2014",5,4,1,122419.4,1253,114
"540","02218","2014",8,8,0,113625,1160,99.875
"541","02219","2014",1,1,0,50000,794,63
"542","02220","2014",4,4,0,158750,1382,123
"543","02221","2014",3,3,0,198427.666666667,1672.33333333333,121
"544","02223","2014",3,3,0,141000,1238.33333333333,117.666666666667
"545","02224","2014",2,2,0,154500,1883,83.5
"546","02225","2014",1,1,0,2e+05,1333,150
"547","02226","2014",15,13,2,128874,1435.93333333333,90.6666666666667
"548","02228","2014",2,2,0,135000,1075.5,134.5
"549","02229","2014",1,1,0,66000,1179,56
"550","02230","2014",3,3,0,104666.666666667,1312.33333333333,79.3333333333333
"551","02231","2014",6,6,0,131833.333333333,1114,127
"552","02233","2014",1,1,0,1e+05,1010,99
"553","02234","2014",2,2,0,121500,934.5,128.5
"554","02236","2014",2,2,0,119000,1700.5,67
"555","02237","2014",15,14,1,90073.3333333333,908.066666666667,111.6
"556","02238","2014",10,10,0,105430,1134.1,93.5
"557","02239","2014",6,6,0,145916.666666667,1565.16666666667,96.6666666666667
"558","02240","2014",1,1,0,40000,556,72
"559","02242","2014",8,8,0,157937.5,1745,95.75
"560","02243","2014",23,18,5,117178.260869565,1510.4347826087,79.6521739130435
"561","02245","2014",5,5,0,111400,1518,73.8
"562","02246","2014",5,5,0,132600,1448.8,97.6
"563","02248","2014",2,2,0,112500,1470,87.5
"564","02249","2014",2,2,0,140000,1520.5,95
"565","02250","2014",1,1,0,195000,2349,83
"566","02252","2014",1,1,0,105000,1235,85
"567","02253","2014",2,2,0,82500,1755,47
"568","02254","2014",2,2,0,157000,1786.5,95
"569","02255","2014",2,2,0,124500,1323.5,94
"570","02256","2014",1,1,0,95000,651,146
"571","02257","2014",2,2,0,116300,974,113.5
"572","02258","2014",3,3,0,109000,1162.66666666667,93
"573","02259","2014",6,6,0,157166.666666667,1706.5,101
"574","02260","2014",4,4,0,155750,1210,135.5
"575","02261","2014",1,1,0,52000,839,62
"576","02262","2014",1,1,0,145000,1229,118
"577","02264","2014",4,4,0,98250,874.25,109.5
"578","02267","2014",1,1,0,62500,658,95
"579","02268","2014",7,7,0,151500,1732.42857142857,92.4285714285714
"580","02269","2014",1,1,0,63000,741,85
"581","02270","2014",1,1,0,70000,1061,66
"582","02272","2014",1,1,0,156700,1205,130
"583","02273","2014",2,2,0,187150,1412.5,134
"584","02274","2014",2,2,0,85600,1041.5,78.5
"585","02275","2014",1,1,0,45000,517,87
"586","02276","2014",2,2,0,114000,984,127.5
"587","02277","2014",2,2,0,88000,1312.5,66.5
"588","02279","2014",8,8,0,139750,1781.75,81.125
"589","02280","2014",4,4,0,173725,1313,137.25
"590","02281","2014",3,3,0,182500,1572.66666666667,136.666666666667
"591","02282","2014",4,4,0,108800,1252.25,99.25
"592","02283","2014",2,2,0,182500,1404.5,136
"593","02284","2014",1,1,0,53000,631,84
"594","02286","2014",4,4,0,75575,711,97.75
"595","02287","2014",6,6,0,160000,1429.83333333333,109
"596","02288","2014",5,5,0,104400,990,102.2
"597","02289","2014",4,4,0,153125,1897.25,85.5
"598","02290","2014",15,15,0,144961.6,1704.53333333333,84.6666666666667
"599","02291","2014",1,1,0,75000,833,90
"600","02292","2014",8,6,2,167115.25,1981.625,87.5
"601","02293","2014",3,3,0,72500,791.333333333333,90.6666666666667
"602","02294","2014",1,1,0,157000,1725,91
"603","02295","2014",5,5,0,136580,1111.6,126
"604","02296","2014",3,3,0,68000,760.666666666667,86
"605","02297","2014",1,1,0,120000,930,129
"606","02298","2014",10,10,0,74610,944,79.1
"607","02299","2014",4,4,0,113743.75,1511.75,75
"608","02302","2014",8,8,0,165875,1349.5,130.375
"609","02303","2014",10,10,0,185666,1495.1,121.6
"610","02304","2014",9,9,0,88055.5555555556,757.888888888889,119.444444444444
"611","02305","2014",25,23,2,101386.4,1182.84,87
"612","02306","2014",8,8,0,65212.5,990.25,69.5
"613","02307","2014",16,15,1,177568.75,1958.6875,94.375
"614","02308","2014",6,6,0,92583.3333333333,967,97
"615","02309","2014",4,4,0,113145,926.75,116.5
"616","02310","2014",1,1,0,41656,347,120
"617","02311","2014",1,1,0,116000,1365,85
"618","02312","2014",9,9,0,82330.5555555556,857.444444444444,90.6666666666667
"619","02313","2014",5,5,0,64400,715.2,93
"620","02315","2014",10,9,1,93950,1092.2,84
"621","02317","2014",5,5,0,113800,1170.8,93.2
"622","02318","2014",13,13,0,82000,928.538461538462,91.0769230769231
"623","02319","2014",2,2,0,98500,1020.5,97.5
"624","02320","2014",1,1,0,165000,1618,102
"625","02321","2014",8,8,0,98656.25,1087.125,94.75
"626","02322","2014",3,3,0,172233.333333333,1038.33333333333,164
"627","02323","2014",1,1,0,55000,655,84
"628","02324","2014",2,2,0,69000,658,105
"629","02326","2014",6,6,0,113000,1198.66666666667,94.5
"630","02327","2014",1,1,0,162000,1820,89
"631","02328","2014",2,2,0,145467.5,1460,91.5
"632","02329","2014",4,4,0,142500,1415.75,108
"633","02332","2014",4,4,0,147500,1428.25,112.75
"634","02334","2014",17,17,0,78282.3529411765,856.352941176471,90.2352941176471
"635","02335","2014",4,4,0,108500,1301,86.75
"636","02336","2014",6,6,0,87333.3333333333,1141.83333333333,85.6666666666667
"637","02337","2014",1,1,0,162000,1276,127
"638","02338","2014",2,2,0,92250,1537.5,60
"639","02339","2014",4,3,1,166750,1483.75,127
"640","02340","2014",23,23,0,115336.956521739,1432.08695652174,82.1304347826087
"641","02341","2014",1,1,0,134600,928,145
"642","02343","2014",2,2,0,111500,1260,97.5
"643","02346","2014",9,9,0,86777.7777777778,884.222222222222,96.5555555555556
"644","02347","2014",2,2,0,116000,1658.5,75.5
"645","02351","2014",1,1,0,130000,1016,128
"646","02352","2014",4,4,0,124250,844.75,132.75
"647","02353","2014",1,1,0,75000,500,150
"648","02355","2014",8,8,0,138925,1245.375,109
"649","02356","2014",2,2,0,91000,1120,85
"650","02358","2014",1,1,0,78000,661,118
"651","02359","2014",10,10,0,132370,1383.9,100.8
"652","02360","2014",23,23,0,167854.347826087,1716.04347826087,97.8695652173913
"653","02361","2014",22,21,1,78359.0909090909,999.454545454545,80.5454545454545
"654","02362","2014",2,2,0,71500,834,86
"655","02363","2014",2,2,0,101250,1024,99.5
"656","02364","2014",2,2,0,166250,1221.5,137
"657","02366","2014",3,3,0,154833.333333333,1329.66666666667,115
"658","02367","2014",1,1,0,82000,965,85
"659","02368","2014",6,6,0,195111.666666667,2011,101
"660","02369","2014",1,1,0,65000,812,80
"661","02370","2014",3,3,0,106333.333333333,993,118.666666666667
"662","02371","2014",12,12,0,98000,1045.25,89.0833333333333
"663","02372","2014",3,3,0,91000,1142,108
"664","02373","2014",3,3,0,62666.6666666667,861.666666666667,75.3333333333333
"665","02374","2014",10,10,0,85495.4,1115.6,76.5
"666","02376","2014",1,1,0,80000,714,112
"667","02378","2014",1,1,0,35000,500,70
"668","02379","2014",2,2,0,37500,357,105
"669","02381","2014",65,64,1,69166,872.476923076923,80.8307692307692
"670","02382","2014",8,8,0,124562.5,1231.125,100.5
"671","02383","2014",14,14,0,171805.214285714,1524.71428571429,113.785714285714
"672","02384","2014",1,1,0,150000,1111,135
"673","02385","2014",1,1,0,170000,1259,135
"674","02386","2014",1,1,0,40000,426,94
"675","02387","2014",8,8,0,125416.625,2113.125,81.875
"676","02388","2014",1,1,0,70000,547,128
"677","02389","2014",6,6,0,142450,1442,109.833333333333
"678","02390","2014",2,2,0,116250,1147,99.5
"679","02391","2014",6,6,0,95000,1073.83333333333,84.8333333333333
"680","02393","2014",2,2,0,92750,687.5,132
"681","02396","2014",1,1,0,185000,1480,125
"682","02397","2014",9,9,0,102622.222222222,1159.44444444444,87.8888888888889
"683","02398","2014",1,1,0,145795,1638,89
"684","02399","2014",3,3,0,142500,1501.66666666667,96.3333333333333
"685","02401","2014",2,2,0,62000,841,74
"686","02403","2014",5,5,0,56200,605.6,95.6
"687","02405","2014",4,4,0,82420,997.5,88
"688","02406","2014",2,2,0,175000,1042,186
"689","02407","2014",5,5,0,124000,1201.6,111.8
"690","02408","2014",157,112,45,88502.9044585987,1110.45859872611,82.7133757961783
"691","02409","2014",4,4,0,89921.25,853.75,100.5
"692","02410","2014",3,3,0,80666.6666666667,1144.33333333333,75.3333333333333
"693","02411","2014",4,4,0,72000,944.5,93.75
"694","02412","2014",2,2,0,94200,1265.5,71
"695","02413","2014",1,1,0,95000,833,114
"696","02414","2014",4,4,0,107500,797.75,139
"697","02415","2014",1,1,0,101000,1443,70
"698","02416","2014",2,2,0,22500,513.5,48
"699","02417","2014",2,2,0,67500,653.5,106.5
"700","02418","2014",2,2,0,118500,1510.5,75
"701","02419","2014",2,2,0,87500,810,107
"702","02420","2014",5,5,0,106200,1034.8,101.2
"703","02422","2014",3,3,0,77333.3333333333,864,90.6666666666667
"704","02423","2014",6,6,0,104873.333333333,2044.16666666667,70.3333333333333
"705","02424","2014",2,2,0,73000,1893,38.5
"706","02426","2014",2,2,0,85000,937,95
"707","02427","2014",2,2,0,94300,1340.5,65.5
"708","02428","2014",1,1,0,201000,1733,116
"709","02429","2014",1,1,0,112500,1308,86
"710","02430","2014",11,11,0,93281.8181818182,1194,85.3636363636364
"711","02431","2014",2,2,0,82500,1002.5,83.5
"712","02432","2014",1,1,0,150000,1034,145
"713","02433","2014",2,2,0,97134,890,120.5
"714","02435","2014",1,1,0,76000,950,80
"715","02438","2014",3,3,0,185666.666666667,1717.66666666667,106.666666666667
"716","02439","2014",13,13,0,125847.692307692,1249.76923076923,115.615384615385
"717","02440","2014",1,1,0,91700,752,122
"718","02441","2014",4,4,0,145750,2110.5,69.75
"719","02443","2014",1,1,0,170000,1141,149
"720","02446","2014",1,1,0,20000,357,56
"721","02447","2014",3,3,0,101333.333333333,993.666666666667,111.333333333333
"722","02449","2014",2,2,0,113500,1032,104
"723","02450","2014",1,1,0,25075,473,53
"724","02452","2014",3,3,0,172250,1268.66666666667,145.333333333333
"725","02453","2014",4,4,0,92500,1565.75,62.75
"726","02454","2014",3,3,0,97800,1222.33333333333,79.6666666666667
"727","02455","2014",5,5,0,131600,959.6,136
"728","02456","2014",1,1,0,45000,750,60
"729","02457","2014",3,3,0,129833.333333333,1186.33333333333,113.333333333333
"730","02458","2014",10,10,0,139650,1402.6,105.4
"731","02459","2014",1,1,0,171600,1467,117
"732","02460","2014",2,2,0,138750,1545,89.5
"733","02461","2014",3,3,0,74333.3333333333,864,87.3333333333333
"734","02462","2014",3,3,0,120666.666666667,1123,105
"735","02463","2014",1,1,0,29500,492,60
"736","02464","2014",3,3,0,151333.333333333,1339,116.333333333333
"737","02465","2014",5,5,0,140200,1635.4,88.6
"738","02466","2014",4,4,0,164125,1179,147
"739","02467","2014",1,1,0,110000,1528,72
"740","02468","2014",20,20,0,80555,907.35,88.3
"741","02469","2014",5,5,0,86900,933.6,102.4
"742","02470","2014",3,3,0,72500,1017,76.3333333333333
"743","02471","2014",2,2,0,87500,752,112.5
"744","02472","2014",5,5,0,84176,1117.4,85.8
"745","02473","2014",3,3,0,104533.666666667,1200.33333333333,85.6666666666667
"746","02474","2014",3,3,0,87333.3333333333,977,83.6666666666667
"747","02476","2014",6,6,0,69666.6666666667,912.166666666667,83.8333333333333
"748","02477","2014",10,8,2,139300,1780.3,77.3
"749","02478","2014",4,4,0,94875,918.5,112.5
"750","02480","2014",2,2,0,137000,931,146.5
"751","02481","2014",6,6,0,177033.333333333,1493.83333333333,116.166666666667
"752","02482","2014",1,1,0,135000,2250,60
"753","02483","2014",2,2,0,85000,925,99
"754","02484","2014",2,2,0,172500,1998.5,95.5
"755","02485","2014",1,1,0,70000,1014,69
"756","02486","2014",2,1,1,118250,1273,92
"757","02487","2014",4,4,0,153750,1581,99
"758","02488","2014",1,1,0,179100,1544,116
"759","02489","2014",2,2,0,192500,1606,118
"760","02490","2014",1,1,0,79180,932,85
"761","02491","2014",4,4,0,80750,686.5,116.75
"762","02492","2014",4,4,0,83500,823.75,101.25
"763","02493","2014",3,3,0,67833.3333333333,832.333333333333,76.6666666666667
"764","02494","2014",2,2,0,101500,1134,93
"765","02495","2014",9,9,0,116388.888888889,1067.11111111111,112.777777777778
"766","02496","2014",2,2,0,192250,1430,129
"767","02497","2014",7,7,0,117542.857142857,1233,95.7142857142857
"768","02498","2014",5,5,0,94300,1115.2,84.6
"769","02500","2014",5,5,0,96340,1402.4,71.2
"770","02501","2014",2,2,0,105000,1500,70
"771","02502","2014",6,6,0,74125,716.333333333333,102.166666666667
"772","02503","2014",7,7,0,66300,911.428571428571,74
"773","02504","2014",11,11,0,107968.181818182,1129.90909090909,98.6363636363636
"774","02505","2014",6,6,0,256384.666666667,1777.33333333333,131.166666666667
"775","02506","2014",1,1,0,140000,2154,65
"776","02509","2014",2,2,0,155000,1499.5,111.5
"777","02510","2014",5,5,0,115500,1440.4,95.8
"778","02511","2014",2,2,0,67500,590,107.5
"779","02512","2014",7,7,0,164785.714285714,1464.71428571429,115.857142857143
"780","02513","2014",2,2,0,59000,660.5,96
"781","02514","2014",4,4,0,121875,1776.75,68.25
"782","02518","2014",10,10,0,108900,1767.2,77.6
"783","02519","2014",1,1,0,88000,854,103
"784","02520","2014",7,7,0,149814.285714286,1463,107.857142857143
"785","02521","2014",20,20,0,137625,1603.5,90.25
"786","02522","2014",1,1,0,68000,680,100
"787","02524","2014",8,7,1,178125,2120.125,91.25
"788","02525","2014",5,5,0,112700,1136.6,100.2
"789","02527","2014",4,4,0,144250,1453.25,99.25
"790","02528","2014",1,1,0,170000,1604,106
"791","02529","2014",1,1,0,175000,1232,142
"792","02531","2014",1,1,0,142000,1464,97
"793","02532","2014",10,10,0,94600,1008.7,94.9
"794","02533","2014",1,1,0,83000,1509,55
"795","02537","2014",2,2,0,42500,664,64
"796","02539","2014",2,2,0,141150,1079,131.5
"797","02540","2014",8,8,0,189125,1498,126.625
"798","02541","2014",10,10,0,112915,1157.8,96.2
"799","02543","2014",12,11,1,109166.666666667,1293.91666666667,84.8333333333333
"800","02544","2014",2,2,0,126500,1071,118
"801","02545","2014",3,3,0,54500,845.333333333333,71
"802","02549","2014",5,5,0,143060,1571.6,92
"803","02551","2014",1,1,0,85000,1000,85
"804","02552","2014",1,1,0,140000,1053,133
"805","02553","2014",8,8,0,131250,1161.25,123.5
"806","02554","2014",11,11,0,159201.454545455,1876.27272727273,87.5454545454545
"807","02555","2014",23,23,0,151475.565217391,1742,94.0434782608696
"808","02557","2014",2,2,0,82500,926.5,87.5
"809","02558","2014",14,14,0,96046.4285714286,839.857142857143,117.714285714286
"810","02559","2014",6,6,0,101633.333333333,1081.16666666667,114.333333333333
"811","02560","2014",1,1,0,120000,930,129
"812","02562","2014",3,3,0,129536.666666667,1412.66666666667,92
"813","02563","2014",1,1,0,25000,641,39
"814","02564","2014",5,5,0,129817,1736.6,75
"815","02565","2014",2,2,0,80000,1549,57
"816","02566","2014",7,7,0,111228.571428571,1321,83.4285714285714
"817","02567","2014",4,4,0,82250,787.5,100.75
"818","02568","2014",3,3,0,264500,1789.33333333333,139.666666666667
"819","02569","2014",4,4,0,88250,935,94
"820","02570","2014",1,1,0,168000,933,180
"821","02571","2014",4,4,0,136875,1350.5,104.5
"822","02572","2014",6,6,0,159621.333333333,1756.66666666667,96.5
"823","02574","2014",10,10,0,86670,805.6,106
"824","02575","2014",16,16,0,72475,786.5,87.625
"825","02576","2014",6,6,0,133516.666666667,1575,87.1666666666667
"826","02577","2014",1,1,0,60000,1224,49
"827","02579","2014",2,2,0,117575,1336.5,106.5
"828","02580","2014",5,5,0,79400,1450.4,56
"829","02581","2014",2,2,0,82750,902.5,93.5
"830","02582","2014",2,2,0,95000,1206,79
"831","02584","2014",1,1,0,73000,811,90
"832","02585","2014",2,2,0,114207.5,1281,89
"833","02586","2014",2,2,0,80000,821.5,100
"834","02587","2014",3,3,0,183333.333333333,1429,129.333333333333
"835","02588","2014",1,1,0,105000,1312,80
"836","02589","2014",1,1,0,170000,802,212
"837","02590","2014",3,3,0,121333.333333333,1371.66666666667,97.6666666666667
"838","02591","2014",1,1,0,110000,1019,108
"839","02592","2014",2,2,0,132200,1617.5,81.5
"840","02593","2014",11,11,0,152318.181818182,1706.18181818182,95.4545454545455
"841","02594","2014",4,4,0,170000,1781.25,96.5
"842","02595","2014",1,1,0,162000,1276,127
"843","02596","2014",12,12,0,116833.333333333,1427,85.75
"844","02598","2014",6,6,0,155916.666666667,2383.83333333333,83.1666666666667
"845","02599","2014",1,1,0,159000,1500,106
"846","02600","2014",4,4,0,127917.5,1387.75,91.75
"847","02601","2014",2,2,0,177500,2012.5,88
"848","02602","2014",13,13,0,95476.9230769231,1206.69230769231,81.1538461538462
"849","02605","2014",2,2,0,151000,1089.5,139
"850","02606","2014",1,1,0,186000,1453,128
"851","02608","2014",6,6,0,60050,754.166666666667,79.8333333333333
"852","02610","2014",7,7,0,184704.285714286,1663.28571428571,110
"853","02612","2014",2,2,0,110300,1063.5,100
"854","02613","2014",9,9,0,148733.333333333,1502.66666666667,99.1111111111111
"855","02614","2014",3,3,0,65233.3333333333,907,72
"856","02615","2014",4,4,0,140364.75,1268.25,106.25
"857","02617","2014",3,3,0,84000,775.666666666667,109.333333333333
"858","02618","2014",3,3,0,75000,1050.66666666667,72
"859","02619","2014",6,6,0,73430.8333333333,1016,73.3333333333333
"860","02621","2014",6,6,0,154583.333333333,1482.5,105.833333333333
"861","02622","2014",1,1,0,1e+05,926,108
"862","02625","2014",4,4,0,104125,1103.5,93.25
"863","02626","2014",4,4,0,114050,1493,78.5
"864","02627","2014",3,3,0,159000,1878,89.6666666666667
"865","02628","2014",1,1,0,94000,862,109
"866","02629","2014",1,1,0,85000,1049,81
"867","02631","2014",3,3,0,116608.333333333,1214.33333333333,93.3333333333333
"868","02632","2014",1,1,0,135000,1500,90
"869","02635","2014",1,1,0,123000,1079,114
"870","02636","2014",1,1,0,110000,1089,101
"871","02637","2014",2,2,0,188500,1722,108.5
"872","02638","2014",2,2,0,110450,861,134
"873","02639","2014",2,2,0,90500,1372.5,65.5
"874","02640","2014",2,2,0,127000,953.5,133.5
"875","02641","2014",1,1,0,125000,1042,120
"876","02643","2014",5,5,0,157200,1855,86.2
"877","02644","2014",4,4,0,132875,1472,88.5
"878","02645","2014",7,7,0,94357.1428571429,1366.71428571429,71.5714285714286
"879","02648","2014",19,19,0,108031.578947368,1019.94736842105,117
"880","02649","2014",4,4,0,83250,998.75,83
"881","02650","2014",1,1,0,60000,714,84
"882","02653","2014",4,4,0,155500,1731,95.25
"883","02656","2014",4,4,0,111912.5,1806.75,68
"884","02657","2014",3,3,0,72666.6666666667,833.666666666667,86.6666666666667
"885","02659","2014",4,4,0,199050,1716.75,116.25
"886","02661","2014",2,2,0,101500,1080.5,95.5
"887","02662","2014",4,4,0,123125,1685,76.5
"888","02663","2014",2,2,0,145000,1512,100
"889","02664","2014",1,1,0,104000,1106,94
"890","02665","2014",1,1,0,90000,573,157
"891","02666","2014",6,6,0,68833.3333333333,1127.66666666667,64.5
"892","02668","2014",8,8,0,81250,809.25,94.375
"893","02670","2014",1,1,0,128500,1028,125
"894","02671","2014",1,1,0,143000,1362,105
"895","02672","2014",2,2,0,153250,1487,134
"896","02673","2014",4,4,0,172875,1458.25,113.75
"897","02675","2014",2,2,0,115000,1283.5,87.5
"898","02676","2014",13,13,0,124100,1087.15384615385,124.307692307692
"899","02677","2014",3,3,0,429333.333333333,3203.33333333333,120.666666666667
"900","02679","2014",1,1,0,110000,1375,80
"901","02680","2014",22,22,0,84256.8181818182,946.136363636364,94.0454545454545
"902","02681","2014",6,6,0,53666.6666666667,700.833333333333,81.8333333333333
"903","02682","2014",1,1,0,153000,1308,117
"904","02684","2014",17,17,0,79294.1176470588,942.352941176471,82.8235294117647
"905","02686","2014",4,4,0,109000,1333.5,79.5
"906","02687","2014",6,6,0,248550,2545,98.3333333333333
"907","02691","2014",441,364,77,91679.5102040816,1112.14739229025,86.4852607709751
"908","02693","2014",2,2,0,127500,1180.5,106
"909","02694","2014",8,8,0,136692.25,1398.75,102.375
"910","02696","2014",1,1,0,227000,1566,145
"911","02697","2014",2,2,0,146500,1633,93.5
"912","02699","2014",4,4,0,117475,1396.5,84.5
"913","02701","2014",8,7,1,106500,1302.625,81
"914","02702","2014",3,3,0,134166.666666667,1668,85.3333333333333
"915","02703","2014",12,12,0,76485.5833333333,822.166666666667,97.75
"916","02704","2014",1,1,0,52000,495,105
"917","02705","2014",2,2,0,71000,614.5,124.5
"918","02706","2014",4,3,1,105500,1211.25,86.5
"919","02708","2014",1,1,0,90000,1343,67
"920","02709","2014",6,6,0,84300,821.333333333333,106
"921","02710","2014",5,5,0,143260,1544,100.4
"922","02711","2014",2,2,0,126500,1446.5,87.5
"923","02712","2014",1,1,0,132000,2000,66
"924","02714","2014",4,3,1,110750,1302.75,85.5
"925","02716","2014",6,6,0,158833.333333333,1309.66666666667,124.833333333333
"926","02717","2014",9,9,0,102194.444444444,1065.88888888889,95.1111111111111
"927","02719","2014",19,19,0,107831.578947368,1071.78947368421,100.157894736842
"928","02720","2014",12,12,0,95966.6666666667,1062.41666666667,112
"929","02721","2014",8,8,0,117150,959.625,124.625
"930","02722","2014",187,106,81,131717.534759358,1569.01604278075,86.0802139037433
"931","02723","2014",1,1,0,48000,686,70
"932","02724","2014",2,2,0,84441,831.5,102
"933","02725","2014",2,2,0,101750,856,115.5
"934","02726","2014",1,1,0,105000,1117,94
"935","02727","2014",1,1,0,73500,700,105
"936","02728","2014",1,1,0,135000,718,188
"937","02729","2014",1,1,0,172000,1911,90
"938","02730","2014",3,3,0,116000,1045,114.333333333333
"939","02734","2014",2,2,0,222500,2206,100.5
"940","02737","2014",5,5,0,89400,886.4,95.8
"941","02738","2014",100,99,1,87913.68,1000.83,90.54
"942","02740","2014",2,2,0,81500,785,99.5
"943","02741","2014",6,6,0,55333.3333333333,660.5,82.3333333333333
"944","02744","2014",1,1,0,70000,511,137
"945","02745","2014",1,1,0,70000,500,140
"946","02746","2014",7,7,0,106171.428571429,1071.57142857143,98.5714285714286
"947","02748","2014",6,6,0,122000,1297.66666666667,97.1666666666667
"948","02749","2014",2,2,0,134000,1592,84
"949","02750","2014",3,3,0,138000,963.333333333333,123.666666666667
"950","02751","2014",2,2,0,85500,1135.5,74
"951","02752","2014",1,1,0,70000,875,80
"952","02753","2014",1,1,0,35000,467,75
"953","02755","2014",4,4,0,160400,1333,126.5
"954","02756","2014",2,2,0,1e+05,1197.5,85
"955","02757","2014",4,4,0,72125,847.75,90.25
"956","02758","2014",19,16,3,106552.631578947,1327.10526315789,82.0526315789474
"957","02760","2014",1,1,0,88000,822,107
"958","02762","2014",7,7,0,128257.857142857,1174.28571428571,107.857142857143
"959","02764","2014",1,1,0,80000,437,183
"960","02765","2014",4,4,0,122750,1195.5,104.5
"961","02766","2014",2,2,0,164000,1845,88.5
"962","02767","2014",4,4,0,135000,1772.25,78.25
"963","02768","2014",3,3,0,107433.333333333,1194,94.6666666666667
"964","02769","2014",3,3,0,93333.3333333333,859,110
"965","02770","2014",8,8,0,131303.25,1697.125,74.5
"966","02772","2014",2,2,0,73000,1124.5,64.5
"967","02773","2014",1,1,0,105000,772,136
"968","02775","2014",12,12,0,104208.333333333,1088.75,97.5833333333333
"969","02776","2014",10,10,0,100400,912,114.3
"970","02777","2014",4,4,0,117750,876,139.75
"971","02778","2014",1,1,0,95000,1044,91
"972","02779","2014",1,1,0,110000,1100,100
"973","02780","2014",12,12,0,110812.5,1356,82.9166666666667
"974","02781","2014",4,4,0,159641.25,1913.5,99
"975","02782","2014",2,2,0,87000,1040.5,80.5
"976","02784","2014",2,2,0,98250,1017,95
"977","02785","2014",10,10,0,102570,1032.3,104.4
"978","02787","2014",1,1,0,70000,1045,67
"979","02788","2014",8,8,0,90875,957.375,89.375
"980","02789","2014",13,13,0,81293.1538461538,1173.46153846154,68.6153846153846
"981","02790","2014",2,2,0,104250,1504,80
"982","02791","2014",4,4,0,96900,1390,71.75
"983","02792","2014",3,3,0,115000,1434.66666666667,110.666666666667
"984","02793","2014",1,1,0,119000,1123,106
"985","02794","2014",1,1,0,50000,532,94
"986","02795","2014",10,7,3,127525,1199.9,113.4
"987","02796","2014",1,1,0,249000,1270,196
"988","02798","2014",10,10,0,127450,1172.6,107.7
"989","02799","2014",4,4,0,127500,1456.25,101
"990","02800","2014",3,3,0,151800,1313.66666666667,116.333333333333
"991","02801","2014",1,1,0,41000,512,80
"992","02802","2014",2,2,0,58500,613,86
"993","02803","2014",2,2,0,132690,1165.5,112
"994","02804","2014",3,3,0,153825,1334.66666666667,121
"995","02805","2014",17,13,4,158355.882352941,2046.47058823529,86.7647058823529
"996","02806","2014",3,3,0,87333.3333333333,1333.33333333333,62.6666666666667
"997","02807","2014",4,4,0,209500,1739.5,127
"998","02808","2014",1,1,0,15000,395,38
"999","02810","2014",65,53,12,156410.153846154,1768.89230769231,94.4615384615385
"1000","02812","2014",2,2,0,167000,1736.5,96
"1001","02814","2014",3,3,0,97840,1369,69.6666666666667
"1002","02815","2014",1,1,0,140000,1667,84
"1003","02816","2014",6,6,0,138166.666666667,1591.83333333333,86.8333333333333
"1004","02818","2014",10,10,0,146257.1,1878.2,83.7
"1005","02819","2014",2,2,0,79000,621,113.5
"1006","02820","2014",10,9,1,140080,1286.6,122
"1007","02821","2014",5,5,0,130340,1139.2,121.2
"1008","02822","2014",6,6,0,132241.666666667,1103.83333333333,125.166666666667
"1009","02823","2014",1,1,0,70000,972,72
"1010","02824","2014",5,5,0,148100,1596.6,93.2
"1011","02826","2014",1,1,0,130000,1226,106
"1012","02827","2014",3,3,0,75833.3333333333,849,85.6666666666667
"1013","02829","2014",1,1,0,45000,900,50
"1014","02830","2014",5,5,0,80500,685,135.8
"1015","02831","2014",6,6,0,119833.333333333,1167,104
"1016","02832","2014",2,2,0,20500,641.5,37.5
"1017","02833","2014",5,5,0,119840,875.4,142.4
"1018","02834","2014",2,2,0,85000,1403,60.5
"1019","03001","2014",26,26,0,135438.846153846,1312,105.461538461538
"1020","03002","2014",5,5,0,132500,980,133.6
"1021","03003","2014",11,11,0,84195.3636363636,906.454545454545,89.0909090909091
"1022","03004","2014",2,2,0,79840,1258.5,63.5
"1023","03005","2014",1,1,0,67500,951,71
"1024","03006","2014",15,15,0,57974.6666666667,640.8,91.3333333333333
"1025","03007","2014",4,4,0,133875,999.75,122.75
"1026","03008","2014",5,5,0,71040,687.2,116
"1027","03010","2014",2,2,0,181000,1006.5,190.5
"1028","03012","2014",1,1,0,1e+05,833,120
"1029","03013","2014",28,28,0,161301.785714286,1398.85714285714,116.142857142857
"1030","03014","2014",1,1,0,30000,411,73
"1031","03015","2014",2,2,0,65250,739,99
"1032","03016","2014",1,1,0,52000,650,80
"1033","03017","2014",1,1,0,120000,1395,86
"1034","03018","2014",10,10,0,86678.5,1236.8,79.3
"1035","03019","2014",11,11,0,78136.3636363636,797.272727272727,97.7272727272727
"1036","03020","2014",2,2,0,66575,615.5,112.5
"1037","03021","2014",4,4,0,90095,996.5,95.75
"1038","03022","2014",13,13,0,88200.7692307692,897.307692307692,91.8461538461538
"1039","03023","2014",89,70,19,135503.719101124,1470.83146067416,90.4943820224719
"1040","03024","2014",4,4,0,197723.75,2068,87.25
"1041","03025","2014",9,9,0,87611.1111111111,1012.66666666667,88
"1042","03026","2014",4,4,0,116862.5,1154,104.75
"1043","03027","2014",14,14,0,49684.7142857143,757,65.9285714285714
"1044","03028","2014",5,5,0,110200,1132.8,93.4
"1045","03029","2014",3,3,0,186876.666666667,2011.66666666667,106.666666666667
"1046","03030","2014",3,3,0,116466.666666667,1095,109
"1047","03031","2014",1,1,0,88000,1000,88
"1048","03032","2014",1,1,0,130000,1130,115
"1049","03033","2014",4,4,0,129000,1489,92
"1050","03034","2014",4,4,0,106137.5,1275,82.75
"1051","03035","2014",2,2,0,85000,1180,86.5
"1052","03036","2014",27,27,0,114307.962962963,1205.88888888889,101.592592592593
"1053","03038","2014",3,3,0,89400,1161.33333333333,73
"1054","03039","2014",4,4,0,72150,728.5,94.75
"1055","03040","2014",12,11,1,125470.916666667,1313.25,96.25
"1056","03041","2014",4,4,0,56250,588,101.75
"1057","03042","2014",3,3,0,59666.6666666667,807.666666666667,77.3333333333333
"1058","03043","2014",14,13,1,140246.428571429,1260.14285714286,108.5
"1059","03044","2014",14,14,0,188514.285714286,1959.42857142857,93
"1060","03045","2014",7,7,0,125090,1150.57142857143,101.571428571429
"1061","03046","2014",6,6,0,80000,1271,73.3333333333333
"1062","03047","2014",3,3,0,79333.3333333333,672.666666666667,113
"1063","03048","2014",12,11,1,75080.8333333333,928,79.5
"1064","03049","2014",5,5,0,86200,1205.6,70
"1065","03050","2014",2,2,0,97500,989.5,99
"1066","03051","2014",1,1,0,30000,750,40
"1067","03052","2014",9,9,0,125511.111111111,1152.55555555556,103.555555555556
"1068","03053","2014",16,16,0,92468.1875,967.6875,102.25
"1069","03054","2014",5,5,0,88314.4,880.6,94.8
"1070","03055","2014",8,7,1,83937.5,821.25,97.75
"1071","03056","2014",2,2,0,49625,591,86
"1072","03058","2014",4,4,0,30355.25,603,51
"1073","03059","2014",4,4,0,129500,1146,107.75
"1074","03060","2014",5,5,0,119857.6,1561.2,72.2
"1075","03061","2014",3,3,0,153466.666666667,1174.66666666667,120.333333333333
"1076","03062","2014",8,7,1,152326.25,1343.75,121.375
"1077","03063","2014",5,5,0,82800,1060.8,76.2
"1078","03064","2014",3,3,0,38666.6666666667,530.333333333333,72.6666666666667
"1079","03065","2014",3,3,0,212366.666666667,1497,142
"1080","03066","2014",6,6,0,77433.3333333333,976.833333333333,76.8333333333333
"1081","03067","2014",2,2,0,105000,791.5,134
"1082","03068","2014",1,1,0,40000,444,90
"1083","03069","2014",4,4,0,175000,1319.75,137.75
"1084","03071","2014",3,3,0,76833.3333333333,660,120.333333333333
"1085","03072","2014",9,9,0,87241.8888888889,1095.88888888889,82.2222222222222
"1086","03073","2014",2,2,0,130750,1329,99.5
"1087","03074","2014",4,4,0,92500,982.75,94.25
"1088","03075","2014",1,1,0,72500,625,116
"1089","03077","2014",5,5,0,58520,781.4,77.4
"1090","03078","2014",2,2,0,85000,895.5,96
"1091","03079","2014",1,1,0,73430,456,161
"1092","03081","2014",3,3,0,72810,757.666666666667,80
"1093","03082","2014",46,43,3,77189.1304347826,912.021739130435,85.2391304347826
"1094","03083","2014",6,6,0,71533.3333333333,694.666666666667,100
"1095","03084","2014",17,15,2,94588.2352941177,937.411764705882,101.176470588235
"1096","03085","2014",8,8,0,135060,1150.75,119.625
"1097","03086","2014",1,1,0,73000,777,94
"1098","03087","2014",3,3,0,33866.6666666667,524.666666666667,64
"1099","03088","2014",3,3,0,56000,1006.33333333333,55
"1100","03089","2014",1,1,0,54500,556,98
"1101","03091","2014",1,1,0,96500,965,100
"1102","03092","2014",2,2,0,120050,1052.5,116.5
"1103","03093","2014",6,6,0,125700,1378.5,95.3333333333333
"1104","03094","2014",29,29,0,135690.586206897,1287.72413793103,106.724137931034
"1105","03095","2014",124,84,40,94842.0806451613,1152.79032258065,83.3145161290323
"1106","03096","2014",3,3,0,95666.6666666667,1515.33333333333,65.3333333333333
"1107","03097","2014",4,4,0,45375,825,68.5
"1108","03098","2014",35,34,1,101527.142857143,1237.94285714286,85.4857142857143
"1109","03099","2014",3,3,0,73333.3333333333,718.333333333333,97.6666666666667
"1110","03100","2014",13,13,0,74051.5384615385,1090.15384615385,72.3846153846154
"1111","03101","2014",62,59,3,105630.838709677,1197.70967741935,89.3870967741936
"1112","03102","2014",18,18,0,115558.333333333,1047.27777777778,109.055555555556
"1113","03103","2014",6,6,0,92565,911,99
"1114","03104","2014",10,10,0,75050,871.5,91.3
"1115","03105","2014",1,1,0,47000,461,102
"1116","03106","2014",12,12,0,81858.3333333333,1039.91666666667,82
"1117","03107","2014",15,15,0,100709.8,1060.06666666667,95.5333333333333
"1118","03108","2014",2,2,0,72500,1125,65
"1119","03109","2014",3,3,0,152333.333333333,902,169.666666666667
"1120","03110","2014",6,6,0,132033.333333333,1104.16666666667,118.833333333333
"1121","03111","2014",12,12,0,120487.5,1341.58333333333,86.9166666666667
"1122","03112","2014",4,4,0,96000,909.75,104.75
"1123","03113","2014",3,3,0,78000,805,96.6666666666667
"1124","03114","2014",3,3,0,74056.6666666667,1078.66666666667,67.3333333333333
"1125","03115","2014",6,6,0,96600,973.5,107.166666666667
"1126","03116","2014",1,1,0,80000,650,123
"1127","03117","2014",2,2,0,88000,836,93
"1128","03118","2014",55,55,0,107900.563636364,1195.25454545455,91.6727272727273
"1129","03119","2014",4,4,0,78875,830,96.25
"1130","03120","2014",7,7,0,94642.8571428571,1011.14285714286,101.428571428571
"1131","03121","2014",2,2,0,124500,1110.5,112
"1132","03122","2014",3,3,0,90000,895.666666666667,100.666666666667
"1133","03125","2014",3,3,0,49000,707.666666666667,66.6666666666667
"1134","03126","2014",5,4,1,94930,1181,80.8
"1135","03127","2014",7,7,0,139779.285714286,1075.71428571429,96.1428571428571
"1136","03128","2014",33,33,0,96666.7575757576,1023.57575757576,97.1818181818182
"1137","03129","2014",3,3,0,1e+05,993,118
"1138","03130","2014",4,4,0,103859.5,825.5,133.5
"1139","03131","2014",6,6,0,78050,1257.83333333333,67.1666666666667
"1140","03132","2014",4,4,0,100375,773.75,117.75
"1141","03133","2014",3,3,0,99173.3333333333,1110.33333333333,84
"1142","03135","2014",4,4,0,52340,677,77.5
"1143","03136","2014",2,2,0,75500,989.5,76.5
"1144","03137","2014",1,1,0,69000,639,108
"1145","03138","2014",23,23,0,86056.0869565217,1059.82608695652,82.7391304347826
"1146","03139","2014",4,4,0,91875,959,89.5
"1147","03140","2014",8,8,0,113952.625,1417.125,77.875
"1148","03141","2014",1,1,0,30000,366,82
"1149","03142","2014",2,2,0,62500,712,86.5
"1150","03145","2014",4,4,0,164963.75,1411,126.25
"1151","03146","2014",1,1,0,72650,1191,61
"1152","03147","2014",2,2,0,53000,760.5,69.5
"1153","03148","2014",3,3,0,127500.333333333,1175.33333333333,115
"1154","03149","2014",3,3,0,100766.666666667,1383,75.3333333333333
"1155","03150","2014",2,2,0,50000,934,50.5
"1156","03151","2014",2,2,0,113000,846.5,140
"1157","03152","2014",3,3,0,32000,578.666666666667,60.6666666666667
"1158","03154","2014",3,3,0,71000,868.666666666667,81.6666666666667
"1159","03155","2014",19,19,0,87689.4736842105,957.526315789474,85.2105263157895
"1160","03156","2014",6,6,0,110900,1078.16666666667,111.333333333333
"1161","03157","2014",8,8,0,92931.25,1025.625,80.75
"1162","03158","2014",8,8,0,99375,1098.375,92.375
"1163","03159","2014",2,2,0,83242.5,986.5,92
"1164","03160","2014",3,3,0,126000,957.666666666667,131.666666666667
"1165","03161","2014",5,5,0,54800,808,68.2
"1166","03163","2014",9,9,0,154992.222222222,1425.11111111111,100.666666666667
"1167","03164","2014",5,5,0,94100,1152.8,82.2
"1168","03165","2014",7,7,0,67571.4285714286,838,80.2857142857143
"1169","03167","2014",3,3,0,71333.3333333333,821,96.6666666666667
"1170","03168","2014",8,8,0,117812.5,1139.5,113.375
"1171","03169","2014",6,6,0,101333.333333333,1265.33333333333,81.3333333333333
"1172","03170","2014",1,1,0,196000,916,214
"1173","03171","2014",2,2,0,99750,1280,77
"1174","03172","2014",1,1,0,83500,982,85
"1175","03173","2014",7,7,0,94300,922.571428571429,106.142857142857
"1176","03174","2014",13,13,0,90353.0769230769,969.692307692308,92.7692307692308
"1177","03175","2014",6,6,0,99183.3333333333,1328.33333333333,82.5
"1178","03176","2014",7,7,0,109221.428571429,1130.57142857143,98.2857142857143
"1179","03177","2014",3,3,0,80000,769.333333333333,96.3333333333333
"1180","03179","2014",3,3,0,98833.3333333333,1035,94.6666666666667
"1181","03180","2014",4,4,0,137656.25,1386.75,99.5
"1182","03181","2014",5,5,0,60900,912,79
"1183","03182","2014",4,4,0,171137.5,1420,126.75
"1184","03183","2014",3,3,0,93123.3333333333,568.666666666667,150.333333333333
"1185","03184","2014",1,1,0,119000,952,125
"1186","03185","2014",347,199,148,83157.8299711816,1037.70893371758,79.1613832853026
"1187","03186","2014",8,7,1,94125,1179.5,78.375
"1188","03187","2014",6,6,0,115083.333333333,1077,105.166666666667
"1189","03188","2014",1,1,0,125000,833,150
"1190","03189","2014",11,11,0,69786.3636363636,721.545454545455,96.7272727272727
"1191","03190","2014",180,70,110,94076.7333333333,1229.20555555556,77.9333333333333
"1192","03191","2014",2,2,0,141000,1804,75.5
"1193","03192","2014",1,1,0,60000,896,67
"1194","03194","2014",2,2,0,86500,1022,77
"1195","03195","2014",30,21,9,81820,1038.03333333333,79.2333333333333
"1196","03196","2014",1,1,0,30000,400,75
"1197","03197","2014",11,11,0,108494.363636364,1099.54545454545,101.909090909091
"1198","03198","2014",5,5,0,30711,544.4,56.2
"1199","03200","2014",7,7,0,176000,1701,102.142857142857
"1200","03202","2014",10,10,0,69400,923.3,73.9
"1201","03203","2014",4,4,0,58750,749.25,78
"1202","03204","2014",6,6,0,98818.3333333333,1057.5,95.1666666666667
"1203","03205","2014",1,1,0,116500,955,122
"1204","03206","2014",3,3,0,53333.3333333333,647.666666666667,87
"1205","03207","2014",2,2,0,82500,840,98.5
"1206","03208","2014",2,2,0,137000,972.5,144
"1207","03209","2014",3,3,0,125000,1283.66666666667,103.666666666667
"1208","03210","2014",4,4,0,46250,583.25,78.25
"1209","03211","2014",13,13,0,112976.923076923,1412.76923076923,83.3846153846154
"1210","03212","2014",11,11,0,135597.272727273,1283.09090909091,102.909090909091
"1211","03213","2014",2,2,0,53500,1366.5,55
"1212","03214","2014",3,3,0,73000,1025,67.6666666666667
"1213","03215","2014",2,2,0,81500,776.5,114
"1214","03216","2014",2,2,0,81000,1142.5,76
"1215","03217","2014",6,6,0,127966.666666667,1288,102
"1216","03218","2014",2,2,0,83750,785.5,102.5
"1217","03219","2014",4,4,0,75162.5,835,90.5
"1218","03220","2014",5,5,0,82174,967.2,84.2
"1219","03221","2014",6,6,0,68516.6666666667,820.333333333333,78.3333333333333
"1220","03223","2014",2,2,0,87282.5,1097,80
"1221","03224","2014",1,1,0,30189,671,45
"1222","03225","2014",5,5,0,58700,844,68.6
"1223","03226","2014",7,7,0,117685.714285714,1257.42857142857,103
"1224","03227","2014",6,6,0,108458.333333333,1161,92.8333333333333
"1225","03228","2014",1,1,0,68000,1000,68
"1226","03229","2014",4,4,0,95500,1267.75,78.5
"1227","03230","2014",1,1,0,75000,600,125
"1228","03231","2014",1,1,0,85000,607,140
"1229","03232","2014",3,3,0,94316.6666666667,736,127
"1230","03233","2014",8,8,0,106750,1207.875,93.25
"1231","03234","2014",4,4,0,67375,756.5,91.75
"1232","03235","2014",5,5,0,95160,1193,86.6
"1233","03236","2014",35,33,2,95903.4285714286,1189.6,79.7428571428571
"1234","03237","2014",6,6,0,124633.333333333,970,130.166666666667
"1235","03238","2014",4,4,0,86500,998.25,96.75
"1236","03239","2014",1,1,0,174000,2486,70
"1237","03240","2014",9,9,0,112418.888888889,1109,84.5555555555556
"1238","03241","2014",6,6,0,61666.6666666667,835.833333333333,76.3333333333333
"1239","03242","2014",3,3,0,129666.666666667,996,121.333333333333
"1240","03244","2014",2,2,0,77000,837.5,91.5
"1241","03245","2014",2,2,0,101500,934.5,106
"1242","03246","2014",2,2,0,86000,1177.5,63.5
"1243","03247","2014",8,8,0,95512.5,1069.75,82.375
"1244","03248","2014",4,4,0,95125,852.75,108.25
"1245","03249","2014",5,5,0,78904,853,86.2
"1246","03250","2014",5,5,0,101440,965.8,99.6
"1247","03251","2014",8,8,0,105830,1258.875,81.875
"1248","03252","2014",10,10,0,167240,1329.9,133.9
"1249","03253","2014",3,3,0,123500,2009,75.6666666666667
"1250","03254","2014",51,43,8,99568.9803921569,1102.01960784314,91.4705882352941
"1251","03255","2014",1,1,0,60000,1034,58
"1252","03256","2014",2,2,0,86650,768.5,112.5
"1253","03257","2014",11,11,0,56027.2727272727,823.090909090909,68.5454545454545
"1254","03258","2014",18,18,0,126741.111111111,1422.05555555556,92.5
"1255","03259","2014",2,2,0,141000,916,164
"1256","03260","2014",2,2,0,209000,1015,188
"1257","03261","2014",2,2,0,69500,805,86
"1258","03262","2014",11,11,0,116505.454545455,1222.54545454545,90.3636363636364
"1259","03264","2014",18,18,0,94651.6666666667,1299.83333333333,73.1111111111111
"1260","03265","2014",6,6,0,59333.3333333333,847.166666666667,76.3333333333333
"1261","03266","2014",2,2,0,97782.5,1199,77.5
"1262","03267","2014",8,8,0,132500,1425.125,95.5
"1263","03268","2014",3,3,0,179700,1407.66666666667,150
"1264","03270","2014",1,1,0,30000,769,39
"1265","03271","2014",3,3,0,254400,1559.33333333333,163.666666666667
"1266","03272","2014",2,2,0,70500,760,94
"1267","03273","2014",3,3,0,195233.333333333,1567.33333333333,123
"1268","03274","2014",3,3,0,131250,951.333333333333,133.666666666667
"1269","03275","2014",13,10,3,85661.5384615385,1073.76923076923,87
"1270","03276","2014",2,2,0,110000,1688,71.5
"1271","03277","2014",3,3,0,50500,667.666666666667,75
"1272","03279","2014",10,10,0,57803.7,922.2,61.9
"1273","03280","2014",2,2,0,101175,1397.5,78
"1274","03281","2014",2,2,0,115312.5,1037.5,100.5
"1275","03282","2014",5,5,0,73140,816.8,96.6
"1276","03283","2014",5,5,0,87050,1123.2,78.4
"1277","03284","2014",3,3,0,103333.333333333,1341.66666666667,73
"1278","03285","2014",2,2,0,125000,1923,65
"1279","03286","2014",10,10,0,116508,1228.3,94.9
"1280","03287","2014",5,5,0,165540,1570.8,103.4
"1281","03288","2014",1,1,0,51122,568,90
"1282","03289","2014",4,4,0,173750,2057.5,87.5
"1283","03290","2014",12,12,0,124025,1241.41666666667,96.1666666666667
"1284","03291","2014",2,2,0,54650,429,119.5
"1285","03292","2014",3,3,0,69500,958.333333333333,94
"1286","03293","2014",4,4,0,72000,778.5,74
"1287","03294","2014",2,2,0,54100,740,74
"1288","03296","2014",8,8,0,74625,1012.25,76.375
"1289","03297","2014",19,19,0,74184.2105263158,858.894736842105,86.1578947368421
"1290","03298","2014",20,18,2,86415.75,982.75,92.1
"1291","03299","2014",1,1,0,86000,1323,65
"1292","03300","2014",11,11,0,86472.7272727273,888.909090909091,99.7272727272727
"1293","03301","2014",10,9,1,103100,1106,97.3
"1294","03304","2014",16,16,0,150954.375,1443,100.25
"1295","03305","2014",5,5,0,61400,845.4,71.2
"1296","03306","2014",18,18,0,175877.388888889,1856.88888888889,106.666666666667
"1297","03307","2014",2,2,0,121250,849,153
"1298","03308","2014",2,2,0,48625,985,51
"1299","03309","2014",9,9,0,67166.6666666667,679.555555555556,102
"1300","03310","2014",496,123,373,92989.8447580645,1388.25,67.6229838709677
"1301","03311","2014",1,1,0,147000,2940,50
"1302","03312","2014",3,3,0,64166.6666666667,1039.66666666667,61.6666666666667
"1303","03313","2014",2,2,0,45000,757,65
"1304","03314","2014",9,9,0,135188.888888889,1292.55555555556,109.777777777778
"1305","03315","2014",8,8,0,102615,1065.125,97
"1306","03316","2014",7,6,1,79629.2857142857,978.857142857143,82.8571428571429
"1307","03317","2014",1,1,0,40000,667,60
"1308","03319","2014",4,4,0,62250,782.5,73
"1309","03320","2014",7,7,0,192110.857142857,1541.71428571429,128.142857142857
"1310","03321","2014",148,123,25,118670.824324324,1373.16891891892,86.8986486486486
"1311","04001","2014",11,10,1,171120.909090909,2012,88.1818181818182
"1312","04004","2014",4,3,1,130750,2442.5,50.75
"1313","04005","2014",3,3,0,188750,2711.33333333333,53.6666666666667
"1314","04006","2014",104,10,94,88959.5192307692,2573.27884615385,30.6442307692308
"1315","04008","2014",14,7,7,105107.142857143,1785.64285714286,66.0714285714286
"1316","04013","2014",4,4,0,149250,1882.75,79.25
"1317","04016","2014",1,1,0,105000,905,116
"1318","04017","2014",5,1,4,53142,1542.4,33.2
"1319","04018","2014",8,8,0,196375,2154.875,96.625
"1320","04019","2014",58,6,52,97325.1206896552,1824.68965517241,60.3103448275862
"1321","04022","2014",1,1,0,29500,590,50
"1322","04023","2014",4,4,0,83632,1428.5,68.5
"1323","04024","2014",2,1,1,105000,1399,72.5
"1324","04025","2014",11,6,5,94630.9090909091,1848.81818181818,60
"1325","04026","2014",2,2,0,232500,1798.5,129.5
"1326","04028","2014",1,1,0,75000,1000,75
"1327","04031","2014",8,8,0,170175,1470.25,107
"1328","04032","2014",4,4,0,231075,3210,77.5
"1329","04033","2014",7,7,0,152864.285714286,2373,69.5714285714286
"1330","04034","2014",12,11,1,197990.25,2265.5,90.8333333333333
"1331","04035","2014",4,3,1,165500,2031,86.5
"1332","04036","2014",4,3,1,103625,1637,82
"1333","04037","2014",1,1,0,50000,833,60
"1334","04039","2014",17,9,8,98082.6470588235,1677.94117647059,63.1176470588235
"1335","04040","2014",1,1,0,40000,571,70
"1336","04041","2014",1,1,0,1e+05,1667,60
"1337","04042","2014",1,0,1,25000,417,60
"1338","04043","2014",2,1,1,120500,1270.5,101.5
"1339","04045","2014",15,15,0,171120.866666667,2539.86666666667,68.6
"1340","04046","2014",2,0,2,70000,2000,35
"1341","04047","2014",1,1,0,212000,2208,96
"1342","04049","2014",33,20,13,140316.666666667,1684.9696969697,92.4848484848485
"1343","04053","2014",1,1,0,205000,2092,98
"1344","04055","2014",2,2,0,86550,1523,54
"1345","04057","2014",1,1,0,65000,867,75
"1346","04058","2014",3,1,2,66333.3333333333,1559,39.3333333333333
"1347","04059","2014",1,1,0,46000,958,48
"1348","04061","2014",7,3,4,101404.285714286,1453.71428571429,70.4285714285714
"1349","04063","2014",12,11,1,181985,2031.16666666667,86.3333333333333
"1350","04065","2014",9,8,1,287837.222222222,2386.22222222222,117.333333333333
"1351","04066","2014",3,3,0,61666.6666666667,1071.33333333333,56.3333333333333
"1352","04068","2014",4,3,1,138988,1894.5,71.5
"1353","04069","2014",1,1,0,120000,2000,60
"1354","04070","2014",114,34,80,120418.456140351,1640.9649122807,72.5526315789474
"1355","04073","2014",35,9,26,107484.942857143,2234.14285714286,43.6
"1356","04075","2014",3,3,0,245333.333333333,2374.66666666667,114.333333333333
"1357","04076","2014",12,7,5,158496.666666667,2066.58333333333,77.6666666666667
"1358","04077","2014",4,3,1,94500,1649,64
"1359","04079","2014",9,8,1,183700,2004.77777777778,90.3333333333333
"1360","04081","2014",9,7,2,192015.555555556,2033.44444444444,98.5555555555556
"1361","04084","2014",2,2,0,47500,1577,26.5
"1362","04086","2014",1,1,0,303000,2463,123
"1363","04088","2014",59,32,27,163513.711864407,2163.96610169492,80.1694915254237
"1364","04094","2014",74,28,46,134370.891891892,2503.10810810811,54.9459459459459
"1365","04095","2014",1,1,0,164000,2216,74
"1366","04096","2014",19,11,8,117501.052631579,1667.84210526316,69.1578947368421
"1367","04097","2014",1,1,0,2e+05,1709,117
"1368","04099","2014",2,2,0,76500,2243.5,33.5
"1369","04101","2014",2,2,0,312500,2405.5,113.5
"1370","04102","2014",2,2,0,158750,1744,125
"1371","04104","2014",2,2,0,130000,2000,64
"1372","04106","2014",3,3,0,393333.333333333,2401.66666666667,154.333333333333
"1373","04107","2014",1,1,0,20000,444,45
"1374","04108","2014",14,11,3,146476.071428571,1672.5,87.2857142857143
"1375","04109","2014",6,6,0,235866.666666667,2431.83333333333,102.166666666667
"1376","04110","2014",6,5,1,144091.666666667,1912,72.5
"1377","04111","2014",8,7,1,227543.75,2425.375,99.5
"1378","04112","2014",205,80,125,172571.985365854,2152.65365853659,78.7121951219512
"1379","04113","2014",1,1,0,108000,1714,63
"1380","04115","2014",5,5,0,97930,2139.6,46.8
"1381","04116","2014",22,18,4,136276.363636364,1568.95454545455,82.2727272727273
"1382","04121","2014",7,5,2,119406.571428571,1369.14285714286,89.4285714285714
"1383","04122","2014",3,3,0,141666.666666667,1753.66666666667,77
"1384","04123","2014",8,8,0,166825,1914.625,83.125
"1385","04124","2014",6,6,0,177166.666666667,2079.33333333333,80
"1386","04126","2014",16,4,12,93828.125,2144.75,46.6875
"1387","04127","2014",1,1,0,315000,2625,120
"1388","04128","2014",3,3,0,278333.333333333,4472.33333333333,71.3333333333333
"1389","04130","2014",2,2,0,205000,3858.5,94.5
"1390","04132","2014",3,3,0,63333.3333333333,1079,63.3333333333333
"1391","04134","2014",3,2,1,126613.333333333,2036.66666666667,57.6666666666667
"1392","04135","2014",4,2,2,448060,4051.25,121.5
"1393","04136","2014",4,4,0,72625,1060.5,69
"1394","04139","2014",3,2,1,208733.333333333,2363.66666666667,89
"1395","04140","2014",2,2,0,126500,2506,50.5
"1396","04141","2014",3,3,0,229833.333333333,2505.33333333333,102.666666666667
"1397","04143","2014",46,35,11,173636.804347826,2237.0652173913,78.2173913043478
"1398","04144","2014",5,4,1,90672,1180.6,70.4
"1399","04145","2014",9,9,0,166261.111111111,1873.77777777778,85.3333333333333
"1400","04148","2014",5,5,0,223750,3412,76.2
"1401","04149","2014",22,18,4,135417.590909091,1754.45454545455,79.5
"1402","04150","2014",1,1,0,175000,2160,81
"1403","04151","2014",5,5,0,165510,1961.6,88.4
"1404","04152","2014",32,32,0,257368.5,2358.28125,109.40625
"1405","04154","2014",1,1,0,140000,2456,57
"1406","04155","2014",3,3,0,44833.3333333333,1456,36
"1407","04156","2014",1,1,0,125500,1394,90
"1408","04157","2014",8,8,0,126750,1727.125,87
"1409","04158","2014",7,7,0,150702.857142857,2073.14285714286,78.1428571428571
"1410","04160","2014",18,18,0,225123.888888889,2740.94444444444,90.2777777777778
"1411","04161","2014",5,5,0,156200,2015,83.4
"1412","04162","2014",3,3,0,145300,2407.66666666667,65.3333333333333
"1413","04163","2014",4,4,0,122500,1520.5,76.25
"1414","04166","2014",15,12,3,134625,2000.6,73.6
"1415","04167","2014",1,1,0,115000,1494,77
"1416","04171","2014",1,1,0,270000,3176,85
"1417","04172","2014",6,5,1,123326.666666667,1746.33333333333,69.1666666666667
"1418","04173","2014",16,11,5,137643.75,1455.4375,99
"1419","04174","2014",1,0,1,18000,947,19
"1420","04176","2014",4,0,4,109155,3123.5,41.75
"1421","04178","2014",18,16,2,142043.944444444,1770.22222222222,78.1666666666667
"1422","04179","2014",2,2,0,69000,1698,40.5
"1423","04180","2014",2,2,0,98400,1154.5,87
"1424","04183","2014",1,1,0,160500,2360,68
"1425","04184","2014",1,1,0,160000,1569,102
"1426","04186","2014",2,1,1,104500,1530.5,65
"1427","04187","2014",1,1,0,67600,1408,48
"1428","04188","2014",11,10,1,177609.090909091,2216.36363636364,79.0909090909091
"1429","04189","2014",7,7,0,158757.142857143,1992.28571428571,78.1428571428571
"1430","04190","2014",1,1,0,1165000,2912,400
"1431","04192","2014",3,3,0,233666.666666667,2415.66666666667,93
"1432","04193","2014",4,4,0,204580,1759.75,88.75
"1433","04194","2014",1,1,0,45000,978,46
"1434","04195","2014",7,6,1,155064.285714286,1772.57142857143,84.2857142857143
"1435","04197","2014",28,23,5,171700.678571429,2090.07142857143,85.6785714285714
"1436","04199","2014",4,4,0,145375,1429.75,90.25
"1437","04200","2014",4,4,0,189000,2191,88.75
"1438","04201","2014",5,4,1,74808,1075.6,66
"1439","04202","2014",3,2,1,152333.333333333,1246.66666666667,116
"1440","04203","2014",1,1,0,186000,4650,40
"1441","04204","2014",3,3,0,163333.333333333,2617.66666666667,71.6666666666667
"1442","04205","2014",16,10,6,142302.5,1898.3125,78.125
"1443","04206","2014",6,4,2,109166.666666667,1546,69.5
"1444","04208","2014",4,4,0,188625,1986,97
"1445","04209","2014",52,24,28,124283.653846154,1621.05769230769,74.8846153846154
"1446","04210","2014",3,2,1,65333.3333333333,1167,56
"1447","04211","2014",2,2,0,104400,1058,98
"1448","04214","2014",2,2,0,136575,1947.5,75.5
"1449","04216","2014",2,2,0,69750,985.5,70
"1450","04217","2014",4,3,1,86250,1676.25,53.25
"1451","04219","2014",1,0,1,55000,1058,52
"1452","04220","2014",4,4,0,138421.25,2157.5,74.75
"1453","04222","2014",1,1,0,130000,1625,80
"1454","04226","2014",73,7,66,103118.534246575,2463.16438356164,39.2602739726027
"1455","04227","2014",6,6,0,136500,2114.33333333333,64.3333333333333
"1456","04229","2014",2,2,0,92500,1363.5,60.5
"1457","04230","2014",28,24,4,136922.857142857,2232.92857142857,65.4642857142857
"1458","04231","2014",3,3,0,236666.666666667,2272.33333333333,103.333333333333
"1459","04233","2014",1,1,0,90000,1500,60
"1460","04236","2014",1,1,0,50000,1351,37
"1461","04237","2014",3,2,1,108500,2141.66666666667,43.3333333333333
"1462","04240","2014",10,6,4,133854,1511,87.5
"1463","04241","2014",2,2,0,210100,1917,109
"1464","04242","2014",20,20,0,214610.5,2154.6,99
"1465","04244","2014",7,6,1,138857.142857143,2341.85714285714,69.8571428571429
"1466","04245","2014",24,23,1,178447.625,2143.25,88.9583333333333
"1467","05001","2014",17,3,14,110261.470588235,2345.88235294118,51.5882352941176
"1468","05003","2014",4,0,4,45492.5,1375,32.5
"1469","05004","2014",43,5,38,99224.0697674419,2406.6976744186,41.6279069767442
"1470","05006","2014",16,7,9,132113.8125,1765.875,74.75
"1471","05007","2014",2,1,1,64000,4057,17
"1472","05008","2014",4,4,0,74625,1138.75,68.25
"1473","05010","2014",2,2,0,115000,1281,83
"1474","05011","2014",2,2,0,235750,2411,97.5
"1475","05012","2014",6,2,4,192908.333333333,3016.66666666667,64.1666666666667
"1476","05014","2014",2,2,0,47500,1142.5,45.5
"1477","05016","2014",3,3,0,166722.666666667,1663,102.333333333333
"1478","05017","2014",15,12,3,204765.266666667,2014.86666666667,106.333333333333
"1479","05022","2014",2,2,0,192495,2060.5,92.5
"1480","05023","2014",192,26,166,154227.744791667,2285.5625,67.8385416666667
"1481","05024","2014",3,3,0,105216.666666667,1693,62.6666666666667
"1482","05026","2014",10,0,10,104370.5,2215.5,50.6
"1483","05027","2014",3,1,2,99256.6666666667,1821,51.3333333333333
"1484","05028","2014",1,1,0,353070,2675,132
"1485","05029","2014",6,5,1,117466.666666667,1959.5,62.5
"1486","05031","2014",3,3,0,201360,2095.33333333333,92.3333333333333
"1487","05033","2014",3,3,0,203100,1953,108
"1488","05036","2014",12,6,6,118000,1589.33333333333,78.0833333333333
"1489","05038","2014",8,4,4,158937.5,2134.125,67.875
"1490","05039","2014",4,4,0,90300,1651.75,63.5
"1491","05040","2014",27,14,13,162526.481481481,2274.81481481481,78.0740740740741
"1492","05044","2014",2,1,1,111500,1583.5,74
"1493","05045","2014",8,6,2,210193.75,2569.625,81.5
"1494","05046","2014",108,21,87,148943.898148148,2451.51851851852,63.5277777777778
"1495","05047","2014",3,1,2,45000,999,49
"1496","05048","2014",1,1,0,133000,1081,123
"1497","05050","2014",3,2,1,188446.666666667,1872.33333333333,94.6666666666667
"1498","05052","2014",7,5,2,202087.142857143,1992.14285714286,101.428571428571
"1499","05053","2014",1,1,0,49500,762,65
"1500","05054","2014",1,1,0,132000,1650,80
"1501","05055","2014",2,2,0,145750,2451.5,62
"1502","05056","2014",2,2,0,185000,2682.5,69
"1503","05057","2014",1,1,0,198000,1980,100
"1504","05058","2014",1,1,0,157500,3351,47
"1505","05059","2014",1,1,0,155800,2258,69
"1506","05060","2014",2,2,0,112250,818,128
"1507","05061","2014",379,87,292,159665.163588391,2024.84696569921,80.131926121372
"1508","05062","2014",6,5,1,134689.166666667,1768.16666666667,76.5
"1509","05063","2014",8,5,3,88187.5,2043.75,48.875
"1510","05065","2014",39,14,25,156431.461538462,2257.23076923077,70
"1511","05066","2014",1,1,0,83500,1246,67
"1512","05070","2014",16,10,6,162211.25,1813.9375,83.375
"1513","05071","2014",1,1,0,144000,1440,100
"1514","05072","2014",6,2,4,110508.333333333,2164.66666666667,47.6666666666667
"1515","05073","2014",1,1,0,235000,2350,100
"1516","05074","2014",1,1,0,327850,2687,122
"1517","05075","2014",2,2,0,184675,2429.5,76
"1518","05076","2014",1,1,0,252000,2571,98
"1519","05077","2014",9,6,3,173351.111111111,2583.11111111111,65.1111111111111
"1520","05079","2014",36,6,30,183209.583333333,3200.33333333333,58.4444444444444
"1521","05080","2014",2,2,0,99000,1250.5,77.5
"1522","05081","2014",1,1,0,140000,1400,100
"1523","05082","2014",1,0,1,67950,1446,47
"1524","05084","2014",1,1,0,263490,3213,82
"1525","05085","2014",32,5,27,209410,3714.84375,54.96875
"1526","05086","2014",1,1,0,79000,658,120
"1527","05087","2014",4,4,0,105112.5,1337.5,78.5
"1528","05089","2014",1,1,0,90000,1111,81
"1529","05091","2014",1,1,0,50000,794,63
"1530","05092","2014",2,2,0,224500,3176,69.5
"1531","05093","2014",4,0,4,241057.5,2151,117.25
"1532","05095","2014",1,1,0,322500,2500,129
"1533","05096","2014",85,8,77,79355.0705882353,1940.62352941176,43.8588235294118
"1534","05097","2014",7,5,2,96035.7142857143,1465.85714285714,68.4285714285714
"1535","05098","2014",62,3,59,87018.6290322581,2606.09677419355,32.6451612903226
"1536","05100","2014",2,2,0,190000,2264,80
"1537","05101","2014",16,9,7,155373.125,3113.3125,63.5625
"1538","05102","2014",1,1,0,112000,1455,77
"1539","05103","2014",5,5,0,118800,1699.8,74.6
"1540","05104","2014",2,2,0,122500,2755,46
"1541","05106","2014",3,2,1,277096.666666667,2436.33333333333,124.666666666667
"1542","05107","2014",7,6,1,239542.857142857,3253.42857142857,83.7142857142857
"1543","05108","2014",1,1,0,180000,3600,50
"1544","05109","2014",4,3,1,236000,1855.5,123
"1545","05110","2014",60,2,58,63793.45,2025.16666666667,31.35
"1546","05111","2014",8,8,0,267555,2708.125,111.125
"1547","05113","2014",2,2,0,346950,2230.5,155
"1548","05114","2014",9,2,7,81687.2222222222,2154.55555555556,36.5555555555556
"1549","05115","2014",8,6,2,113268.75,1500.625,80.75
"1550","05116","2014",2,2,0,2e+05,2072.5,100.5
"1551","05117","2014",1,1,0,95000,1000,95
"1552","05118","2014",7,6,1,137042.857142857,1719.14285714286,88.2857142857143
"1553","05119","2014",115,2,113,83735,2897.51304347826,28.8521739130435
"1554","05121","2014",2,1,1,139280,1169.5,123
"1555","05122","2014",7,6,1,159285.714285714,1632.57142857143,102.571428571429
"1556","05123","2014",9,9,0,179253.111111111,2201.33333333333,95.6666666666667
"1557","05124","2014",3,1,2,179000,1888,97.6666666666667
"1558","05126","2014",1,1,0,75000,938,80
"1559","05128","2014",6,6,0,181375,2330.5,85.8333333333333
"1560","05129","2014",2,2,0,116000,1150.5,96
"1561","05130","2014",3,1,2,164300,2417.33333333333,69.6666666666667
"1562","05132","2014",18,8,10,117928.388888889,1628.38888888889,72.0555555555556
"1563","05133","2014",59,4,55,155785.542372881,2961.62711864407,50.4406779661017
"1564","05134","2014",1,0,1,90000,687,131
"1565","05136","2014",5,4,1,182160,2388.8,76.4
"1566","05139","2014",95,9,86,91702.8526315789,2332.42105263158,38.1473684210526
"1567","05142","2014",3,2,1,50012,832.666666666667,80.3333333333333
"1568","05144","2014",2,2,0,107500,1443,79.5
"1569","05145","2014",8,3,5,125388.125,1690.125,81.25
"1570","05148","2014",2,2,0,173500,3369,56
"1571","05149","2014",10,0,10,75377,1994,39.3
"1572","05151","2014",11,7,4,177145.454545455,1950.09090909091,84.4545454545455
"1573","05152","2014",2,2,0,115000,1816.5,62
"1574","05153","2014",16,4,12,86495.625,2024.125,41.625
"1575","05154","2014",2,2,0,50750,1441.5,35
"1576","05156","2014",6,5,1,233866.666666667,2671.16666666667,93.1666666666667
"1577","05157","2014",11,2,9,176306.363636364,3735.45454545455,59.9090909090909
"1578","05158","2014",1,1,0,133000,2217,60
"1579","05160","2014",1,1,0,205000,1340,153
"1580","05161","2014",78,17,61,180455.730769231,3334.65384615385,52.2692307692308
"1581","05162","2014",24,11,13,119645.833333333,1717.16666666667,71
"1582","05163","2014",2,2,0,191250,2613,75.5
"1583","05164","2014",24,8,16,153304.958333333,2312.41666666667,68.75
"1584","05165","2014",1,1,0,90000,647,139
"1585","05166","2014",23,13,10,83029.347826087,1301.26086956522,66.1304347826087
"1586","05167","2014",2,2,0,73000,1028.5,76
"1587","05168","2014",4,4,0,230750,1868.5,121.25
"1588","05170","2014",25,20,5,190159.72,2092.96,94.36
"1589","05172","2014",2,2,0,142500,1654.5,87
"1590","05173","2014",1,1,0,140000,4828,29
"1591","05174","2014",4,0,4,56093.75,1972.75,31.75
"1592","05176","2014",2,2,0,88857.5,1237,70
"1593","05177","2014",90,6,84,132055.777777778,3447.94444444444,36.2888888888889
"1594","05178","2014",3,3,0,133583.333333333,1586,106
"1595","05179","2014",34,15,19,104226.617647059,1294.70588235294,83.7941176470588
"1596","05180","2014",6,6,0,264604.333333333,2521,107.5
"1597","05181","2014",3,2,1,176666.666666667,1988.33333333333,84.6666666666667
"1598","05183","2014",9,8,1,250644.444444444,2667.44444444444,94.1111111111111
"1599","06001","2014",2,2,0,125000,1798.5,70.5
"1600","06002","2014",2,2,0,290000,4577.5,77.5
"1601","06003","2014",10,3,7,67500,1456.1,47.8
"1602","06004","2014",1345,108,1237,266157.924163569,4386.58141263941,59.2788104089219
"1603","06005","2014",2,0,2,50000,752.5,66.5
"1604","06006","2014",20,13,7,376224.5,3602.1,105.5
"1605","06007","2014",30,21,9,307318.866666667,4214.9,76.1
"1606","06009","2014",1,1,0,86000,2867,30
"1607","06010","2014",26,14,12,318882.615384615,3325.88461538462,90.7692307692308
"1608","06011","2014",94,4,90,388446.64893617,6059.6170212766,61.6702127659574
"1609","06012","2014",225,7,218,236746.431111111,4919.99555555556,49.7333333333333
"1610","06013","2014",15,7,8,66600,1824.13333333333,38.4
"1611","06014","2014",6,3,3,180000,3769.66666666667,54.3333333333333
"1612","06015","2014",10,7,3,263900,2992.5,82.2
"1613","06016","2014",20,7,13,122500,3393.55,44.7
"1614","06017","2014",7,7,0,139428.571428571,1993.14285714286,78.5714285714286
"1615","06018","2014",95,64,31,477451.210526316,4855.13684210526,99.2842105263158
"1616","06019","2014",13,6,7,269692.307692308,2733.07692307692,107.076923076923
"1617","06020","2014",10,3,7,92750,1808.9,48.8
"1618","06021","2014",4,4,0,161750,3557.5,57
"1619","06022","2014",8,7,1,169937.5,3069.25,48.375
"1620","06023","2014",20,8,12,136479,2063.7,65.3
"1621","06024","2014",4,3,1,52500,1314,39.75
"1622","06025","2014",15,9,6,220886.666666667,2865.53333333333,76.5333333333333
"1623","06026","2014",20,18,2,486717.1,4017.55,125.75
"1624","06027","2014",763,83,680,229739.526867628,3989.03407601573,57.9226736566186
"1625","06028","2014",4,3,1,180130,2611.75,71.75
"1626","06029","2014",1580,69,1511,299105.348101266,4727.12658227848,60.7664556962025
"1627","06030","2014",691,58,633,220597.23154848,3442.87843704776,62.0086830680174
"1628","06031","2014",2,1,1,124500,2792.5,56.5
"1629","06032","2014",48,3,45,340851.666666667,6533.54166666667,49.4375
"1630","06033","2014",71,31,40,262939.436619718,3330.56338028169,78.8591549295775
"1631","06034","2014",6,6,0,344241.666666667,3771,104
"1632","06035","2014",11,6,5,322272.727272727,3926.36363636364,76.2727272727273
"1633","06036","2014",7,3,4,290285.714285714,3828.57142857143,74.2857142857143
"1634","06037","2014",4,4,0,203000,2370,82.25
"1635","06038","2014",31,26,5,557269.935483871,4311.41935483871,122.935483870968
"1636","06039","2014",8,5,3,252437.5,3222.875,86.75
"1637","06040","2014",1,1,0,50000,1429,35
"1638","06041","2014",2,0,2,134375,2359,53.5
"1639","06042","2014",3,2,1,59666.6666666667,1497.33333333333,38.3333333333333
"1640","06043","2014",6,4,2,195833.333333333,2721.83333333333,71.1666666666667
"1641","06044","2014",69,49,20,521694.202898551,4615.46376811594,107.507246376812
"1642","06045","2014",1,1,0,90000,1500,60
"1643","06046","2014",13,13,0,488246.153846154,3974.15384615385,127.615384615385
"1644","06047","2014",5,2,3,70000,1284,52.4
"1645","06048","2014",48,32,16,214221.25,2994.02083333333,75.5416666666667
"1646","06049","2014",1,1,0,174320,2235,78
"1647","06050","2014",7,7,0,280178.571428571,3471.28571428571,84.5714285714286
"1648","06051","2014",2,0,2,22250,572,42
"1649","06052","2014",1,1,0,150000,1562,96
"1650","06053","2014",1,1,0,150000,2459,61
"1651","06054","2014",28,13,15,249485.714285714,3027.46428571429,84.8928571428571
"1652","06056","2014",2,1,1,37500,613,61
"1653","06057","2014",29,7,22,162839.655172414,2691.65517241379,63.1034482758621
"1654","06058","2014",4,3,1,165000,2289.5,73.25
"1655","06059","2014",43,16,27,676816.744186047,7370.76744186046,82.8372093023256
"1656","06060","2014",12,8,4,621391.666666667,4723,132.25
"1657","06061","2014",1,1,0,134500,1921,70
"1658","06062","2014",5,1,4,60300,1016.2,61.6
"1659","06063","2014",1,1,0,185000,3304,56
"1660","06064","2014",30,25,5,325852.666666667,3769.56666666667,93.7333333333333
"1661","06065","2014",50,44,6,452520.8,4089.68,109.8
"1662","06066","2014",12,7,5,197916.666666667,2620.08333333333,71.5
"1663","06067","2014",10,1,9,232962.5,4383,59.1
"1664","06068","2014",3,3,0,90000,1899.66666666667,49.6666666666667
"1665","06069","2014",590,155,435,222321.798305085,2898.31525423729,72.5152542372881
"1666","06070","2014",29,8,21,74956.8965517241,1862.96551724138,42.0689655172414
"1667","06071","2014",23,3,20,115391.304347826,2588.26086956522,47.304347826087
"1668","06072","2014",2,2,0,74000,1755.5,43
"1669","06073","2014",75,5,70,129239.24,3375.65333333333,36.8933333333333
"1670","06074","2014",19,14,5,136925,2253.68421052632,66.5789473684211
"1671","06075","2014",45,33,12,289718.666666667,3438.84444444444,89.2
"1672","06077","2014",12,4,8,142515,1935.83333333333,70.6666666666667
"1673","06078","2014",5,3,2,171000,2069.2,94.8
"1674","06079","2014",508,71,437,235275.322834646,4118.15354330709,57.259842519685
"1675","06080","2014",2,2,0,90000,1382.5,64
"1676","06081","2014",2,2,0,68500,2212.5,27.5
"1677","06082","2014",2,2,0,202000,2672,77.5
"1678","06083","2014",618,36,582,234490.860841424,4318.66828478964,54.8883495145631
"1679","06084","2014",115,61,54,459747.565217391,4098.15652173913,103.669565217391
"1680","06085","2014",242,111,131,584953.553719008,4985.55785123967,101.289256198347
"1681","06086","2014",2,0,2,65000,1324.5,55
"1682","06088","2014",5584,239,5345,224729.96472063,3761.85297277937,59.7888610315186
"1683","06089","2014",25,24,1,922205.68,6264,145
"1684","06090","2014",87,54,33,286763.793103448,3635.44827586207,80.1954022988506
"1685","06091","2014",28,18,10,376039.642857143,4045.35714285714,89.5714285714286
"1686","06092","2014",12,5,7,140291.666666667,2525.66666666667,54.8333333333333
"1687","06093","2014",1,1,0,189140,1801,105
"1688","06094","2014",48,7,41,143027.520833333,3015.97916666667,47.5833333333333
"1689","06095","2014",93,57,36,304997.903225806,3540.77419354839,87.8602150537634
"1690","06097","2014",5,5,0,200700,2332.2,89.6
"1691","06098","2014",2,1,1,135000,2075,90.5
"1692","06099","2014",19,10,9,159157.894736842,2064.68421052632,75.6315789473684
"1693","06100","2014",3,2,1,138000,1153.66666666667,106.333333333333
"1694","06101","2014",5,4,1,171800,3200.6,59
"1695","06102","2014",2,2,0,184500,1730,110
"1696","06103","2014",24,4,20,110975,1857.25,62.0416666666667
"1697","06104","2014",256,26,230,371642.50390625,5663.3046875,61.33203125
"1698","06105","2014",72,69,3,648967.805555556,5099.91666666667,132.763888888889
"1699","06106","2014",11,11,0,109395.454545455,1510.90909090909,72.4545454545455
"1700","06107","2014",1,0,1,21000,955,22
"1701","06108","2014",37,33,4,371825.675675676,3637.62162162162,103.675675675676
"1702","06109","2014",3,1,2,258666.666666667,2792,88
"1703","06110","2014",6,4,2,116025,2024.66666666667,58.5
"1704","06113","2014",12,7,5,232691.25,3306.16666666667,76.75
"1705","06114","2014",33,4,29,199430.606060606,3745.60606060606,55.969696969697
"1706","06115","2014",1,1,0,180000,2118,85
"1707","06116","2014",3,3,0,255000,1549,163
"1708","06117","2014",8,8,0,306862.5,3023.25,108.5
"1709","06118","2014",43,31,12,270099.511627907,2981.60465116279,89.8372093023256
"1710","06119","2014",1,1,0,273000,1138,240
"1711","06120","2014",58,2,56,198820.327586207,4354.86206896552,42.1551724137931
"1712","06121","2014",19,2,17,497257.894736842,8064.78947368421,62.5789473684211
"1713","06122","2014",22,19,3,434336.363636364,4275.72727272727,99.3181818181818
"1714","06123","2014",397,58,339,272819.14861461,4083.08816120907,64.1309823677582
"1715","06124","2014",1,1,0,18000,600,30
"1716","06125","2014",3,3,0,137036.333333333,2051.66666666667,65.3333333333333
"1717","06126","2014",3,1,2,241000,2850,84.6666666666667
"1718","06127","2014",35,13,22,110596,2364.48571428571,50.7428571428571
"1719","06128","2014",38,30,8,612548.947368421,4892.57894736842,131.947368421053
"1720","06129","2014",2,1,1,112500,1660.5,58.5
"1721","06130","2014",56,43,13,216603.857142857,3234.58928571429,73.125
"1722","06132","2014",9,2,7,65934.2222222222,1412.11111111111,46.3333333333333
"1723","06134","2014",9,8,1,152111.111111111,2288.33333333333,73.8888888888889
"1724","06135","2014",5,4,1,79400,1542.6,52.6
"1725","06136","2014",33,9,24,175121.212121212,2824.45454545455,65.3030303030303
"1726","06137","2014",25,21,4,358429.32,3975.56,95.2
"1727","06138","2014",73,19,54,534437.342465753,6069.12328767123,71.7534246575343
"1728","06140","2014",28,23,5,370092.857142857,3576.28571428571,109.035714285714
"1729","06141","2014",4,3,1,174750,2324.25,69.25
"1730","06142","2014",4,0,4,111750,2010.75,54.5
"1731","06143","2014",7,6,1,140871.428571429,2582.71428571429,53.4285714285714
"1732","06144","2014",8,7,1,129262.5,1878.25,76.625
"1733","06145","2014",2,1,1,120000,1488,70.5
"1734","06146","2014",1,1,0,138000,2300,60
"1735","06147","2014",18,14,4,281210,3412.05555555556,78.2777777777778
"1736","06148","2014",58,44,14,549703.775862069,4598.96551724138,114.396551724138
"1737","06149","2014",70,23,47,209516,3014.51428571429,69.7571428571429
"1738","06150","2014",30,16,14,401068.533333333,4828.2,80.6
"1739","06151","2014",8,2,6,99750,1724.625,54
"1740","06152","2014",174,78,96,330329.75862069,4067.48850574713,79.5287356321839
"1741","06153","2014",34,16,18,145937.352941176,1743.88235294118,79.7647058823529
"1742","06154","2014",7,7,0,267142.857142857,2256.42857142857,115.571428571429
"1743","06155","2014",435,57,378,223040.151724138,3810.81379310345,57.0551724137931
"1744","06156","2014",2,0,2,77310.5,1849,41.5
"1745","06157","2014",268,81,187,302483.473880597,3681.67537313433,78.9776119402985
"1746","06158","2014",7,4,3,103271.428571429,1871.57142857143,54.1428571428571
"1747","06159","2014",104,14,90,472740.038461538,5905.26923076923,78.4519230769231
"1748","06160","2014",2,1,1,105000,1529,59
"1749","06161","2014",308,66,242,328712.438311688,4941,63.9772727272727
"1750","06162","2014",15,6,9,62533.3333333333,1066.06666666667,61.5333333333333
"1751","06163","2014",19,4,15,85447.3684210526,1695.57894736842,49.3684210526316
"1752","07001","2014",4,3,1,146466.25,2266.75,91
"1753","07002","2014",5,5,0,236484,2571.8,96.8
"1754","07003","2014",3,3,0,94000,1245.66666666667,77
"1755","07004","2014",1,1,0,55100,848,65
"1756","07005","2014",11,10,1,209215.454545455,2479.09090909091,91.3636363636364
"1757","07006","2014",2,2,0,276721.5,2303,129.5
"1758","07007","2014",7,7,0,111528.571428571,1412.85714285714,81.1428571428571
"1759","07008","2014",6,6,0,153740,2074.83333333333,82.3333333333333
"1760","07009","2014",7,3,4,110521.428571429,1160.85714285714,87.1428571428571
"1761","07010","2014",145,50,95,100826.55862069,1229.20689655172,83.8206896551724
"1762","07011","2014",4,2,2,61581.25,1207.5,52.5
"1763","07012","2014",2,2,0,65300,1227,54.5
"1764","07013","2014",9,9,0,102955.555555556,1458.22222222222,73.5555555555556
"1765","07014","2014",2,2,0,121500,2434.5,50
"1766","07015","2014",1,1,0,123000,1685,73
"1767","07017","2014",5,5,0,210440,2123.2,108.4
"1768","07018","2014",1,1,0,50000,1250,40
"1769","07019","2014",85,26,59,115208.905882353,1554.82352941176,75.0117647058824
"1770","07020","2014",1,1,0,221000,1373,161
"1771","07022","2014",5,4,1,148000,1595.8,89.4
"1772","07023","2014",1,1,0,165288,2710,61
"1773","07024","2014",5,5,0,167200,1840.8,89.8
"1774","07025","2014",2,2,0,89000,1242.5,66
"1775","07026","2014",6,6,0,127966.666666667,2088.16666666667,71.1666666666667
"1776","07027","2014",20,18,2,161205.25,1651.35,95.4
"1777","07028","2014",6,6,0,192881.666666667,1953.16666666667,105
"1778","07029","2014",3,3,0,133666.666666667,2158.33333333333,66.6666666666667
"1779","07030","2014",2,2,0,82500,1083.5,72.5
"1780","07031","2014",2,2,0,115000,884.5,129
"1781","07032","2014",2,2,0,185850,1377,136
"1782","07033","2014",4,4,0,156250,1820.5,93.75
"1783","07035","2014",8,8,0,151143.75,1367,104.75
"1784","07036","2014",1,1,0,160000,1468,109
"1785","07037","2014",2,2,0,70750,1274.5,57.5
"1786","07039","2014",1,1,0,130000,1226,106
"1787","07040","2014",1,1,0,80000,1026,78
"1788","07041","2014",15,14,1,153866.666666667,1691.46666666667,93.8
"1789","07042","2014",52,39,13,131852.711538462,1478.15384615385,88.0192307692308
"1790","07044","2014",2,2,0,163500,1556.5,104.5
"1791","07045","2014",7,7,0,127928.571428571,1523.85714285714,79.4285714285714
"1792","07047","2014",3,2,1,47333.3333333333,542.333333333333,82
"1793","07048","2014",3,3,0,156176.666666667,2088.66666666667,86.6666666666667
"1794","07050","2014",13,12,1,228681.076923077,2353.07692307692,93.4615384615385
"1795","07051","2014",4,4,0,150250,1735.5,88.25
"1796","07052","2014",4,4,0,109500,1383.5,83.75
"1797","07053","2014",1,1,0,237000,2279,104
"1798","07054","2014",1,1,0,189700,4216,45
"1799","07055","2014",14,13,1,181492.857142857,1896.42857142857,96.2857142857143
"1800","07056","2014",7,7,0,181114.285714286,1639.42857142857,109.142857142857
"1801","07058","2014",9,9,0,178966.666666667,2260.66666666667,86.2222222222222
"1802","07059","2014",4,4,0,222437.5,1838,116.5
"1803","07060","2014",2,2,0,82500,1341,61.5
"1804","07061","2014",4,4,0,233750,3405.75,74.5
"1805","07062","2014",3,3,0,139666.666666667,1798.33333333333,76.6666666666667
"1806","07064","2014",9,6,3,66000,1028.55555555556,67.2222222222222
"1807","07065","2014",5,5,0,110000,1602,66.4
"1808","07066","2014",29,23,6,166668.75862069,1616.68965517241,104.689655172414
"1809","07067","2014",2,2,0,221500,2034.5,108.5
"1810","07068","2014",5,5,0,162000,1610.8,102.8
"1811","07069","2014",4,4,0,177977.5,1790.25,104.75
"1812","07070","2014",12,12,0,164358.333333333,1705.5,92.75
"1813","07071","2014",9,9,0,109774.111111111,1196.11111111111,92.2222222222222
"1814","07072","2014",13,11,2,155341.846153846,1741.38461538462,87.5384615384615
"1815","07074","2014",1,1,0,60000,800,75
"1816","07075","2014",3,3,0,126500,1413,77.3333333333333
"1817","07076","2014",19,18,1,163811.631578947,1742.73684210526,97.5789473684211
"1818","07077","2014",2,2,0,170050,2865,59
"1819","07078","2014",27,20,7,166097.222222222,1778.62962962963,94.8888888888889
"1820","07079","2014",15,15,0,137728,1491.33333333333,97.4
"1821","07080","2014",2,2,0,99750,1492,67.5
"1822","07082","2014",4,4,0,68866.25,1048.25,71
"1823","07083","2014",3,3,0,93333.3333333333,1294,62
"1824","07084","2014",10,10,0,119999.2,1193.9,108.3
"1825","07085","2014",10,10,0,124032,1533.6,78.7
"1826","07086","2014",5,5,0,124720,1729.2,75
"1827","07087","2014",2,2,0,89500,1109,102.5
"1828","07088","2014",1,1,0,85000,1889,45
"1829","07089","2014",10,8,2,147585,1406,99.6
"1830","07090","2014",4,3,1,140125,1389.5,109.25
"1831","07091","2014",2,2,0,102500,1228.5,85.5
"1832","07093","2014",2,2,0,111500,1738.5,69.5
"1833","07095","2014",3,3,0,152333.333333333,2552.33333333333,86
"1834","07096","2014",4,4,0,155312.5,1674.5,88
"1835","07097","2014",2,2,0,99825,1456.5,68.5
"1836","07098","2014",3,3,0,78233.3333333333,1297,66.6666666666667
"1837","07099","2014",3,3,0,218456.666666667,1960,100.666666666667
"1838","07100","2014",2,2,0,110000,1701,69.5
"1839","07101","2014",3,3,0,161830,1720.33333333333,83.3333333333333
"1840","07102","2014",141,44,97,141408.269503546,1882.71631205674,75.6737588652482
"1841","07103","2014",2,0,2,30000,461,66
"1842","07105","2014",1,1,0,35000,412,85
"1843","07106","2014",1,1,0,140000,1400,100
"1844","07107","2014",11,11,0,132709.090909091,1632.36363636364,80.9090909090909
"1845","07108","2014",1,1,0,25000,833,30
"1846","07109","2014",1,1,0,220000,1746,126
"1847","07110","2014",21,14,7,120006.666666667,1443.7619047619,84.1428571428571
"1848","07111","2014",1,1,0,149000,1490,100
"1849","07112","2014",5,5,0,119911.8,1731.8,73.2
"1850","07113","2014",2,2,0,261175,2232,117
"1851","07114","2014",3,3,0,57500,952,57.6666666666667
"1852","07115","2014",3,3,0,188666.666666667,3417.66666666667,63.3333333333333
"1853","07116","2014",13,9,4,92730.7692307692,1159.61538461538,78
"1854","07117","2014",15,15,0,213410,2130.06666666667,105.8
"1855","07118","2014",2,2,0,109000,1339,86
"1856","07119","2014",4,2,2,92500,1811.25,49.25
"1857","07120","2014",2,2,0,112000,1327.5,90
"1858","07121","2014",3,3,0,82675.6666666667,1426,58
"1859","07122","2014",11,11,0,177545.454545455,1768.27272727273,100.727272727273
"1860","07123","2014",2,2,0,130000,1229,110
"1861","07124","2014",1,1,0,109000,1211,90
"1862","07126","2014",14,14,0,197807.142857143,2247.28571428571,91.2142857142857
"1863","07127","2014",5,5,0,178900,1818.8,96
"1864","07128","2014",5,4,1,119400,1321.8,89.2
"1865","07129","2014",17,15,2,97797.6470588235,1331.76470588235,78.8235294117647
"1866","07130","2014",2,2,0,66000,1391.5,48
"1867","07131","2014",3,2,1,84566.6666666667,1189,86.3333333333333
"1868","07132","2014",10,7,3,124629,1603,82.7
"1869","07133","2014",2,2,0,450380.5,1985,213.5
"1870","07134","2014",5,5,0,145946,1772.4,83.8
"1871","07136","2014",2,2,0,1e+05,1821.5,55.5
"1872","07137","2014",1,1,0,275000,1618,170
"1873","07138","2014",13,13,0,205770,1880.15384615385,108.846153846154
"1874","07139","2014",1,1,0,132000,1714,77
"1875","07140","2014",5,5,0,166100,1804.4,96.2
"1876","07141","2014",1,1,0,205000,5125,40
"1877","07142","2014",4,4,0,106300,999.25,104.25
"1878","07143","2014",6,6,0,129358.333333333,1607.5,105
"1879","07144","2014",1,1,0,155000,2214,70
"1880","07145","2014",6,6,0,128988.166666667,1342.83333333333,96.1666666666667
"1881","07146","2014",6,6,0,165693.333333333,1692.83333333333,95
"1882","07147","2014",3,3,0,92133.3333333333,2065.33333333333,44
"1883","07149","2014",1,1,0,90000,900,100
"1884","07150","2014",5,5,0,100570,1374.6,73.6
"1885","07151","2014",1,1,0,110000,1429,77
"1886","07152","2014",8,8,0,136818.75,1424,91.75
"1887","07153","2014",2,1,1,34000,630.5,54.5
"1888","07154","2014",1,1,0,60000,1111,54
"1889","07155","2014",2,2,0,177500,1767,102
"1890","07156","2014",15,13,2,140383.333333333,1816.73333333333,80.6666666666667
"1891","07157","2014",7,7,0,182341.428571429,1834.71428571429,98.8571428571429
"1892","07158","2014",1,1,0,2e+05,1923,104
"1893","07159","2014",5,5,0,230807,2100.2,111.4
"1894","07160","2014",1,1,0,72000,1385,52
"1895","07161","2014",12,12,0,118786,1518.16666666667,84.1666666666667
"1896","07162","2014",4,4,0,150525,1900.25,84.75
"1897","07163","2014",2,2,0,165000,2404,70
"1898","07165","2014",3,3,0,108233.333333333,1723,64
"1899","07166","2014",3,3,0,95833.3333333333,1213.66666666667,67.6666666666667
"1900","07167","2014",8,8,0,147358.75,1480.875,91.875
"1901","07168","2014",4,3,1,228175,5396.5,78
"1902","07169","2014",2,2,0,120500,1082,98.5
"1903","07170","2014",1,1,0,50000,515,97
"1904","07171","2014",3,3,0,225333.333333333,2054.33333333333,109.333333333333
"1905","07172","2014",13,13,0,179553.846153846,1745.15384615385,101.769230769231
"1906","07174","2014",1,1,0,54000,1459,37
"1907","07175","2014",3,3,0,81666.6666666667,793,101.666666666667
"1908","07176","2014",1,1,0,165000,2200,75
"1909","07177","2014",7,7,0,173401.142857143,1772.57142857143,97
"1910","07178","2014",6,5,1,106000,1141.33333333333,92
"1911","07179","2014",2,2,0,187500,1442,125.5
"1912","07181","2014",24,17,7,129835.416666667,1544,87.4166666666667
"1913","07182","2014",4,4,0,122962.5,2349.75,53.5
"1914","07183","2014",1,1,0,236698,2466,96
"1915","07184","2014",2,2,0,157500,1768,85
"1916","07185","2014",10,10,0,159657.4,1267.7,133.6
"1917","07186","2014",90,43,47,121569.211111111,1364.05555555556,85.1111111111111
"1918","07188","2014",11,11,0,114162.818181818,1882.72727272727,67.8181818181818
"1919","07189","2014",1,1,0,47000,1958,24
"1920","07190","2014",3,3,0,246666.666666667,2821.33333333333,102
"1921","07191","2014",14,14,0,170895.714285714,1878.78571428571,95
"1922","07192","2014",4,4,0,91125,1514,70
"1923","07193","2014",3,3,0,106666.666666667,1442.33333333333,73.6666666666667
"1924","07194","2014",3,2,1,111208.333333333,1417.33333333333,67.6666666666667
"1925","07196","2014",5,5,0,96400,1103,93.4
"1926","07197","2014",16,15,1,160067.8125,1610.6875,99.5625
"1927","07198","2014",4,4,0,125750,1353.25,94.5
"1928","07199","2014",9,9,0,211700,2269,93.1111111111111
"1929","07200","2014",1,1,0,125000,718,174
"1930","07201","2014",24,13,11,157450,2235.66666666667,78.5
"1931","07202","2014",4,4,0,138750,1480,93
"1932","07203","2014",1,1,0,210000,1391,151
"1933","07204","2014",17,14,3,125531.058823529,1333.94117647059,90.8235294117647
"1934","07205","2014",6,6,0,162625,1546.5,105.5
"1935","07207","2014",8,7,1,250766.875,2932.75,93.25
"1936","07208","2014",4,4,0,206551.25,1263,164
"1937","07209","2014",1,1,0,94500,1050,90
"1938","07210","2014",3,3,0,60000,895,65.3333333333333
"1939","07211","2014",3,3,0,131666.666666667,1407.33333333333,118.333333333333
"1940","07212","2014",5,3,2,65600,1904.8,71.2
"1941","07213","2014",5,5,0,173930,1923.6,92.6
"1942","07214","2014",1,1,0,185700,1857,100
"1943","07215","2014",5,5,0,77800,1240.2,67.8
"1944","07216","2014",6,6,0,133908.333333333,1322.16666666667,99.8333333333333
"1945","07217","2014",4,4,0,121979.75,2613,54.5
"1946","07218","2014",2,2,0,111750,739.5,151
"1947","07219","2014",4,4,0,195334.25,1981.75,97.75
"1948","07220","2014",3,3,0,57333.3333333333,525,100
"1949","07221","2014",1,1,0,81000,1306,62
"1950","07222","2014",1,1,0,95000,950,100
"1951","07223","2014",1,1,0,55000,1222,45
"1952","07224","2014",2,2,0,90500,1267,63
"1953","07225","2014",8,8,0,220543.75,1934.5,113.625
"1954","07226","2014",2,2,0,106800,1095,111.5
"1955","07227","2014",7,7,0,147885.714285714,1592.14285714286,96.2857142857143
"1956","07228","2014",6,6,0,115533.333333333,1507.16666666667,81.1666666666667
"1957","07229","2014",6,5,1,143098.333333333,1726.33333333333,94.1666666666667
"1958","07230","2014",3,3,0,125285,1382.33333333333,93.3333333333333
"1959","07231","2014",19,18,1,189797.368421053,1832.68421052632,104.526315789474
"1960","07232","2014",1,1,0,77500,1192,65
"1961","07234","2014",3,3,0,165083.333333333,1695.66666666667,87.3333333333333
"1962","07235","2014",2,2,0,81500,1456.5,57
"1963","07236","2014",13,11,2,115526.923076923,1216.07692307692,96.8461538461538
"1964","07237","2014",6,6,0,127642.833333333,1440.16666666667,86
"1965","07238","2014",2,2,0,156000,1452.5,107
"1966","07239","2014",2,2,0,90500,1620.5,55.5
"1967","07240","2014",21,21,0,185879.666666667,1908.47619047619,98.8095238095238
"1968","07241","2014",2,1,1,147000,1627.5,79.5
"1969","07242","2014",1,1,0,87500,795,110
"1970","07243","2014",1,1,0,228000,1854,123
"1971","07245","2014",15,14,1,184606.666666667,1688.33333333333,109.666666666667
"1972","07247","2014",1,1,0,161000,2064,78
"1973","07248","2014",3,3,0,129630,1351,102.333333333333
"1974","07249","2014",1,1,0,1e+05,2000,50
"1975","07250","2014",2,2,0,167000,1689.5,96.5
"1976","07251","2014",2,2,0,201805,1639,119.5
"1977","07253","2014",1,1,0,45000,1125,40
"1978","07254","2014",5,5,0,167054,1848.4,91.2
"1979","07255","2014",9,9,0,129294.444444444,1478.66666666667,84.8888888888889
"1980","07257","2014",2,2,0,125500,741.5,147.5
"1981","07258","2014",1,1,0,30000,769,39
"1982","07259","2014",8,7,1,159843.75,1640.25,97.25
"1983","07260","2014",3,3,0,184016.666666667,1485,125.333333333333
"1984","07261","2014",9,8,1,152955.555555556,2119.77777777778,76.2222222222222
"1985","07262","2014",3,3,0,108046,1822.33333333333,62
"1986","07264","2014",11,11,0,121276.090909091,1386.18181818182,91.4545454545455
"1987","07265","2014",8,7,1,94243.75,1038.5,74.75
"1988","07267","2014",1,1,0,121650,647,188
"1989","07268","2014",15,15,0,156335.666666667,2253.2,76.4
"1990","07269","2014",6,6,0,78308.3333333333,1489.5,57.1666666666667
"1991","07270","2014",2,2,0,614500,6343,110.5
"1992","07272","2014",2,2,0,96500,1582,55
"1993","07273","2014",2,2,0,255000,3188.5,86
"1994","07276","2014",3,3,0,91666.6666666667,1822.66666666667,48.3333333333333
"1995","07277","2014",1,1,0,150000,2174,69
"1996","07278","2014",3,3,0,55750,1591,37
"1997","07279","2014",15,15,0,165875.333333333,1589.8,105.466666666667
"1998","07280","2014",14,14,0,177035.714285714,1990.28571428571,91.8571428571429
"1999","07281","2014",50,40,10,216876.88,2102.68,102.3
"2000","07282","2014",5,5,0,90582,1239.4,80.8
"2001","07284","2014",1,1,0,150000,1500,100
"2002","07285","2014",1,1,0,111000,1914,58
"2003","07286","2014",4,4,0,71050,1208,64.5
"2004","07287","2014",6,6,0,134587.5,1781.16666666667,75.6666666666667
"2005","07288","2014",2,2,0,101500,1402.5,68.5
"2006","07289","2014",11,10,1,129500,1680.90909090909,81.9090909090909
"2007","07290","2014",3,3,0,87333.3333333333,659.333333333333,120.333333333333
"2008","07291","2014",5,5,0,135720,1819.8,76.2
"2009","07292","2014",9,9,0,172842.222222222,1670.33333333333,100.333333333333
"2010","07293","2014",1,1,0,80000,1143,70
"2011","07294","2014",2,1,1,60000,1244.5,57.5
"2012","07295","2014",7,4,3,100571.428571429,1417.14285714286,72.7142857142857
"2013","07296","2014",5,5,0,184104.2,2044.8,91.2
"2014","07298","2014",3,3,0,115000,1669.66666666667,85.6666666666667
"2015","07299","2014",1,1,0,15000,625,24
"2016","07300","2014",4,4,0,209881.25,1831.25,117.75
"2017","07301","2014",6,6,0,116738.333333333,1677.66666666667,73
"2018","07302","2014",4,4,0,309937.5,2504,125.75
"2019","07303","2014",1,1,0,103500,1190,87
"2020","07304","2014",15,10,5,139339.666666667,2210.6,66.8
"2021","07305","2014",2,2,0,228500,1724,136
"2022","07306","2014",2,2,0,128479.5,1529,84
"2023","07307","2014",6,5,1,179633.333333333,1708.83333333333,103.666666666667
"2024","07308","2014",20,15,5,116120.85,1326.9,94.15
"2025","07309","2014",6,5,1,148453.333333333,1267.83333333333,121.166666666667
"2026","07310","2014",3,3,0,139666.666666667,1458,95.6666666666667
"2027","07311","2014",2,2,0,95000,1191.5,71
"2028","07312","2014",8,8,0,147981.25,1907.25,83.625
"2029","07313","2014",10,10,0,135970,1524.5,93.9
"2030","07314","2014",1,1,0,85000,1771,48
"2031","07315","2014",6,6,0,126000,1993.5,74.8333333333333
"2032","07316","2014",22,17,5,165706.909090909,1861.31818181818,93.9090909090909
"2033","07317","2014",9,9,0,175027.777777778,1897.44444444444,92.5555555555556
"2034","07318","2014",4,4,0,134750,1604,83
"2035","07319","2014",85,57,28,125060.517647059,1564.61176470588,80.2117647058824
"2036","07321","2014",1,1,0,2e+05,2083,96
"2037","07322","2014",8,7,1,107456.25,1479,78.625
"2038","07323","2014",7,7,0,171440,1989.85714285714,88
"2039","07324","2014",80,40,40,149313.0625,1729.8125,86.2
"2040","07325","2014",15,13,2,164223.333333333,1753.46666666667,93.4
"2041","07326","2014",1,1,0,42000,618,68
"2042","07327","2014",6,5,1,93416.6666666667,1251.83333333333,77.3333333333333
"2043","07328","2014",10,8,2,229725,1757.2,126.5
"2044","07329","2014",5,5,0,135200,2109.4,68.8
"2045","07330","2014",46,39,7,160524.608695652,2270.82608695652,73.804347826087
"2046","07331","2014",36,18,18,120271.944444444,1739.02777777778,72.9166666666667
"2047","07333","2014",5,5,0,155080,1650.2,94
"2048","07334","2014",35,22,13,175097.714285714,1922.17142857143,85.7714285714286
"2049","07335","2014",2,1,1,61250,943.5,68.5
"2050","07336","2014",4,4,0,177500,2281.5,81.5
"2051","07337","2014",13,13,0,184133.076923077,1750.07692307692,108
"2052","07338","2014",6,6,0,146383.333333333,1565.16666666667,97.1666666666667
"2053","07339","2014",26,26,0,174565.769230769,1895.34615384615,92.9615384615385
"2054","07340","2014",13,13,0,167869.230769231,1632.84615384615,98.7692307692308
"2055","07341","2014",17,15,2,155653.529411765,1702.23529411765,93.4705882352941
"2056","07342","2014",5,5,0,138300,1225.4,120.2
"2057","07343","2014",7,7,0,193063.857142857,2616.14285714286,76
"2058","07344","2014",1,1,0,186100,1919,97
"2059","07345","2014",8,8,0,93250,1124.375,89.5
"2060","07346","2014",28,25,3,118091.357142857,1528.14285714286,78.3928571428571
"2061","07347","2014",1,1,0,128000,1600,80
"2062","07348","2014",7,7,0,121508.571428571,1743.42857142857,70
"2063","07349","2014",36,21,15,120633.333333333,1433.5,83.75
"2064","08001","2014",2,2,0,140000,1865.5,74.5
"2065","08003","2014",18,18,0,136727.777777778,1333.88888888889,104.555555555556
"2066","08004","2014",4,4,0,137225,1155.75,113.25
"2067","08005","2014",6,6,0,111593.666666667,1188.66666666667,97
"2068","08008","2014",7,7,0,86408.7142857143,1051.85714285714,86
"2069","08010","2014",2,2,0,87500,685,127.5
"2070","08011","2014",2,2,0,42500,789.5,58
"2071","08022","2014",2,2,0,119250,1083,113
"2072","08024","2014",8,8,0,122521.25,1430.875,93.625
"2073","08028","2014",5,5,0,91000,1291.2,69.8
"2074","08029","2014",1,1,0,208000,1101,189
"2075","08032","2014",4,4,0,106071.5,844.5,115.5
"2076","08038","2014",3,3,0,143617.666666667,1103,154.333333333333
"2077","08039","2014",2,2,0,87600,995,86
"2078","08040","2014",8,8,0,166068.75,1690.5,111.375
"2079","08043","2014",12,8,4,145818.916666667,1396.83333333333,104.916666666667
"2080","08044","2014",4,4,0,83450,962,85
"2081","08046","2014",2,2,0,105341,886.5,130.5
"2082","08048","2014",3,3,0,106000,1006.33333333333,101.333333333333
"2083","08053","2014",19,19,0,127319.105263158,1302.31578947368,95.4736842105263
"2084","08060","2014",3,3,0,177100,1536,116.333333333333
"2085","08062","2014",1,1,0,18000,750,24
"2086","08064","2014",3,3,0,205928,1415.66666666667,150
"2087","08070","2014",5,5,0,100948,1315.2,74
"2088","08078","2014",5,5,0,78500,1153.2,70.4
"2089","08081","2014",33,33,0,75822.8484848485,872.242424242424,86.3939393939394
"2090","08084","2014",2,2,0,172750,1558.5,115
"2091","08094","2014",1,1,0,55000,1038,53
"2092","08096","2014",5,5,0,136200,1304.2,99.8
"2093","08101","2014",2,2,0,188525,2317,81
"2094","08105","2014",342,186,156,103519.973684211,1250.86257309942,83.4298245614035
"2095","08107","2014",9,9,0,95111.1111111111,1221.11111111111,87.8888888888889
"2096","08119","2014",4,4,0,113462.5,837.75,131.5
"2097","08122","2014",7,7,0,101164.285714286,1083.85714285714,91.1428571428571
"2098","08125","2014",2,2,0,143100,1585.5,90.5
"2099","08126","2014",1,1,0,128000,1455,88
"2100","08133","2014",7,7,0,121900,1451.57142857143,85.4285714285714
"2101","08136","2014",2,2,0,105000,1077,97.5
"2102","08137","2014",4,4,0,151625,1548.75,115.25
"2103","08140","2014",10,9,1,115600,1269.1,92.9
"2104","08142","2014",9,7,2,128766.666666667,1240.44444444444,103.666666666667
"2105","08144","2014",1,1,0,75000,735,102
"2106","08148","2014",3,3,0,147000,1481.66666666667,99.6666666666667
"2107","08150","2014",1,1,0,69000,1438,48
"2108","08162","2014",6,6,0,145833.333333333,1068.66666666667,137
"2109","08166","2014",2,2,0,42500,878.5,60
"2110","08170","2014",2,2,0,68000,1152.5,59
"2111","08173","2014",19,19,0,121478.947368421,1193.36842105263,104.263157894737
"2112","08174","2014",17,16,1,139250,1388.58823529412,100.470588235294
"2113","08179","2014",3,3,0,97000,849.333333333333,108.333333333333
"2114","08180","2014",10,10,0,164760,1497.8,113.1
"2115","08183","2014",12,12,0,112206.583333333,1290.5,87.5833333333333
"2116","08185","2014",19,15,4,57752.6315789474,756.894736842105,77.3157894736842
"2117","08188","2014",13,13,0,73461.5384615385,850.923076923077,87.2307692307692
"2118","08190","2014",39,36,3,98170,982.538461538462,102.794871794872
"2119","08191","2014",10,10,0,141466.6,1326.6,106.4
"2120","08194","2014",6,6,0,121316.666666667,1313.66666666667,92.8333333333333
"2121","08195","2014",2,2,0,138500,1296,110
"2122","08199","2014",7,7,0,152255.714285714,1163.85714285714,126.285714285714
"2123","08203","2014",1,1,0,130000,1226,106
"2124","08207","2014",1,1,0,40000,1250,32
"2125","08209","2014",3,3,0,95000,815.666666666667,116.666666666667
"2126","08210","2014",1,1,0,65000,1083,60
"2127","08214","2014",3,3,0,68333.3333333333,977.666666666667,78
"2128","08216","2014",1,1,0,163000,1482,110
"2129","08218","2014",7,7,0,81142.8571428571,929.714285714286,87.2857142857143
"2130","08222","2014",12,12,0,82062.5,1005.16666666667,82
"2131","08226","2014",2,2,0,115000,1446,76
"2132","08229","2014",2,2,0,164000,1806.5,120
"2133","08230","2014",1,1,0,133500,1608,83
"2134","08232","2014",3,3,0,92000,977,89
"2135","08234","2014",1,1,0,140000,1321,106
"2136","08235","2014",3,3,0,133666.666666667,1297.33333333333,106
"2137","08239","2014",8,8,0,183900,1458,129.375
"2138","08246","2014",3,3,0,36833.3333333333,1214.66666666667,55
"2139","08247","2014",1,1,0,1e+05,870,115
"2140","08248","2014",5,5,0,80213.4,844.2,93.8
"2141","08262","2014",5,5,0,106600,1126,101.8
"2142","08263","2014",9,9,0,129257.777777778,1458.11111111111,90.7777777777778
"2143","08284","2014",9,9,0,103833.333333333,1141.11111111111,94.1111111111111
"2144","08287","2014",2,2,0,160025,1654.5,110
"2145","08289","2014",3,3,0,91000,1339.66666666667,70.3333333333333
"2146","08294","2014",1,1,0,173500,1388,125
"2147","08298","2014",15,13,2,105902.666666667,1420.8,76.2666666666667
"2148","08304","2014",2,2,0,42500,451.5,93
"2149","08306","2014",1,1,0,135000,1350,100
"2150","08311","2014",14,13,1,97775,1092.71428571429,98.5714285714286
"2151","08314","2014",12,12,0,164508.333333333,1692.25,98
"2152","08316","2014",10,10,0,63510,846.9,77.7
"2153","08320","2014",4,4,0,169625,1794,97.75
"2154","08327","2014",11,11,0,118340.909090909,1443,82.5454545454545
"2155","08328","2014",45,41,4,83460,975.111111111111,87.3777777777778
"2156","08330","2014",7,6,1,141428.571428571,1400.28571428571,109.714285714286
"2157","08331","2014",3,3,0,156233.333333333,1084,145.666666666667
"2158","08339","2014",1,1,0,182000,1583,115
"2159","08342","2014",2,2,0,96000,826,101.5
"2160","08343","2014",13,13,0,110712.538461538,1116.30769230769,103.461538461538
"2161","08346","2014",10,9,1,167530,1656,104.5
"2162","08349","2014",6,6,0,82333.3333333333,704.333333333333,113
"2163","08350","2014",1,1,0,50000,641,78
"2164","08353","2014",5,5,0,139378.8,1351.6,104.4
"2165","08361","2014",13,13,0,112153.846153846,1237.38461538462,90.6153846153846
"2166","08362","2014",59,47,12,116877.06779661,1339.84745762712,88.271186440678
"2167","08363","2014",36,33,3,74375,862.194444444444,85.6111111111111
"2168","08367","2014",13,12,1,84961.5384615385,937.230769230769,93.3076923076923
"2169","08368","2014",2,2,0,122500,1109.5,113.5
"2170","08377","2014",1,1,0,85000,1214,70
"2171","08381","2014",10,10,0,131905,1227.6,111.1
"2172","08385","2014",8,8,0,144287.5,1159.125,121
"2173","08386","2014",5,5,0,129300,1240.2,111.2
"2174","08391","2014",4,4,0,135000,723.75,174.75
"2175","08400","2014",5,5,0,98000,810.2,124.8
"2176","08402","2014",2,2,0,127658.5,1257.5,116
"2177","08403","2014",9,9,0,125399.666666667,1602.22222222222,80.1111111111111
"2178","08408","2014",5,5,0,122200,1321.4,88.6
"2179","08409","2014",85,44,41,100706.2,1073.2,91.5294117647059
"2180","08413","2014",2,2,0,172500,1003.5,179
"2181","08415","2014",2,2,0,97486,1044,93.5
"2182","08418","2014",2,2,0,397564.5,4003,167
"2183","08420","2014",7,7,0,137785.714285714,1347.14285714286,112.571428571429
"2184","08426","2014",1,1,0,75000,893,84
"2185","08427","2014",1,1,0,134000,1340,100
"2186","08435","2014",6,6,0,152250,1497.83333333333,113.5
"2187","08438","2014",1,1,0,135000,1239,109
"2188","08445","2014",3,3,0,39166.6666666667,532.666666666667,72
"2189","08448","2014",5,5,0,59700,623.8,96.8
"2190","08451","2014",3,3,0,126333.333333333,1611.66666666667,84.3333333333333
"2191","08452","2014",1,1,0,92500,1595,58
"2192","08457","2014",12,12,0,147358.333333333,1435.83333333333,105.833333333333
"2193","08473","2014",3,3,0,132666.666666667,1346.33333333333,103.666666666667
"2194","08476","2014",4,4,0,72612.5,895.5,79.75
"2195","08480","2014",18,18,0,133761.111111111,1612,85.2222222222222
"2196","08481","2014",1,1,0,120000,1000,120
"2197","08483","2014",4,4,0,178750,1770,100.25
"2198","08484","2014",1,1,0,150000,1562,96
"2199","08486","2014",12,12,0,81603.3333333333,843.333333333333,99.3333333333333
"2200","08487","2014",12,12,0,123229.166666667,1259.33333333333,99.0833333333333
"2201","08488","2014",14,14,0,117050,1191.35714285714,100.785714285714
"2202","08490","2014",24,19,5,95264.4166666667,969.75,101.833333333333
"2203","08491","2014",27,27,0,117396.296296296,1275.44444444444,90.1851851851852
"2204","08492","2014",4,4,0,170750,1165.25,154.5
"2205","08494","2014",3,3,0,127933.333333333,1248.33333333333,101.666666666667
"2206","08497","2014",12,12,0,147208.333333333,1596.5,90.6666666666667
"2207","08498","2014",2,2,0,266000,1796.5,147
"2208","09002","2014",5,4,1,119400,1116.2,112.6
"2209","09003","2014",4,4,0,59150,866.75,66.75
"2210","09004","2014",3,3,0,59636.6666666667,836.333333333333,67
"2211","09005","2014",3,3,0,43400,1200.66666666667,37.6666666666667
"2212","09008","2014",4,4,0,72875,1017.75,69.25
"2213","09011","2014",1,1,0,15000,500,30
"2214","09014","2014",2,2,0,132500,1608.5,80
"2215","09015","2014",3,3,0,146666.666666667,1613.33333333333,91
"2216","09016","2014",1,1,0,165000,1854,89
"2217","09017","2014",2,2,0,178200,2156,107
"2218","09018","2014",2,2,0,39000,696,56
"2219","09019","2014",7,7,0,87642.8571428571,821.714285714286,107.714285714286
"2220","09020","2014",1,1,0,36000,1161,31
"2221","09022","2014",2,2,0,210800,1671.5,125.5
"2222","09023","2014",5,5,0,96460,1290.4,77.2
"2223","09024","2014",4,4,0,102932.5,996.25,111.75
"2224","09026","2014",2,2,0,84250,1165.5,65
"2225","09029","2014",3,2,1,57500,1004,64.3333333333333
"2226","09030","2014",12,12,0,87507.0833333333,1450.66666666667,65.25
"2227","09032","2014",88,19,69,88893.6136363636,2010.35227272727,47.5568181818182
"2228","09033","2014",1,1,0,40000,563,71
"2229","09035","2014",2,2,0,34000,364,95
"2230","09038","2014",6,6,0,59250,836.833333333333,71.5
"2231","09039","2014",5,5,0,159840,1538,106
"2232","09040","2014",4,4,0,214142.5,1447.75,153.25
"2233","09041","2014",1,1,0,90000,891,101
"2234","09042","2014",13,13,0,127457.769230769,1238.92307692308,109
"2235","09043","2014",3,3,0,106200,1154.33333333333,92.6666666666667
"2236","09044","2014",1,1,0,34200,684,50
"2237","09045","2014",2,2,0,107500,1887,61
"2238","09047","2014",6,6,0,62833.3333333333,746.5,85.6666666666667
"2239","09048","2014",1,1,0,40000,2667,15
"2240","09049","2014",1,1,0,3e+05,2143,140
"2241","09050","2014",4,3,1,158267.5,1017.25,137.75
"2242","09051","2014",3,3,0,116833.333333333,1012.66666666667,106.666666666667
"2243","09054","2014",2,2,0,171000,1110,142.5
"2244","09055","2014",2,2,0,58000,1702,32.5
"2245","09056","2014",1,1,0,165600,1656,100
"2246","09057","2014",12,12,0,89662.0833333333,1315.16666666667,75.4166666666667
"2247","09058","2014",2,2,0,119750,1241.5,110
"2248","09059","2014",4,4,0,81050,1815.25,43
"2249","09060","2014",4,4,0,95000,1296.5,77.25
"2250","09061","2014",6,6,0,87666.6666666667,1243,76.8333333333333
"2251","09062","2014",1,1,0,119833,2923,41
"2252","09063","2014",3,3,0,54000,918.333333333333,57.3333333333333
"2253","09065","2014",3,3,0,139333.333333333,1833,65.3333333333333
"2254","09066","2014",4,4,0,241930,1892.75,110.25
"2255","09067","2014",2,2,0,65484,941,58
"2256","09070","2014",2,2,0,178000,1566.5,147
"2257","09073","2014",2,2,0,252500,4400,63
"2258","09074","2014",2,2,0,73000,1114.5,63.5
"2259","09075","2014",2,2,0,85750,1114,80
"2260","09076","2014",1,1,0,118000,908,130
"2261","09077","2014",1,1,0,2e+05,1600,125
"2262","09078","2014",2,2,0,127900,1471,85
"2263","09079","2014",5,5,0,84542,1129.8,84.6
"2264","09080","2014",1,1,0,55000,1100,50
"2265","09081","2014",2,2,0,176433,1470.5,121
"2266","09082","2014",4,4,0,87750,1122,101
"2267","09085","2014",2,1,1,115000,1059.5,122
"2268","09087","2014",2,2,0,102000,904,110
"2269","09089","2014",1,1,0,180000,1200,150
"2270","09091","2014",4,4,0,119000,1515.75,85
"2271","09092","2014",3,3,0,115000,2283,60
"2272","09093","2014",1,1,0,1e+05,1087,92
"2273","09097","2014",1,1,0,85000,759,112
"2274","09099","2014",3,3,0,236250,1474.33333333333,171.666666666667
"2275","09100","2014",4,0,4,37000,587.25,64.5
"2276","09101","2014",2,2,0,275000,1709.5,158
"2277","09102","2014",2,2,0,130000,1353,86
"2278","09103","2014",5,5,0,195800,1790.8,110.4
"2279","09104","2014",7,7,0,128195.714285714,1212,106.571428571429
"2280","09105","2014",11,11,0,122536.363636364,1418.09090909091,92.5454545454545
"2281","09106","2014",1,1,0,90000,874,103
"2282","09107","2014",6,6,0,74000,931.5,79
"2283","09108","2014",4,4,0,145250,1188,119.75
"2284","09110","2014",1,1,0,50000,439,114
"2285","09111","2014",1,1,0,35000,636,55
"2286","09113","2014",5,5,0,69060,1194.4,62.2
"2287","09114","2014",1,1,0,94600,1785,53
"2288","09115","2014",1,1,0,32500,650,50
"2289","09116","2014",2,2,0,103590,989,121
"2290","09118","2014",1,1,0,170000,2267,75
"2291","09119","2014",7,7,0,71714.2857142857,1252.71428571429,54.2857142857143
"2292","09120","2014",1,1,0,20000,351,57
"2293","09121","2014",4,4,0,121875,1222.5,102.5
"2294","09122","2014",117,75,42,122043.35042735,1374.1452991453,89.2820512820513
"2295","09123","2014",1,1,0,82000,1708,48
"2296","09124","2014",10,8,2,79950,971.5,86.1
"2297","09125","2014",8,8,0,177405,1625.625,105
"2298","09126","2014",1,1,0,120000,2000,60
"2299","09127","2014",1,1,0,63000,840,75
"2300","09128","2014",1,1,0,120000,779,154
"2301","09129","2014",1,1,0,29000,659,44
"2302","09130","2014",8,8,0,122937.5,1248.5,104.375
"2303","09131","2014",2,2,0,145650,1656,88.5
"2304","09132","2014",2,2,0,280970.5,1572.5,176.5
"2305","09134","2014",1,1,0,80000,800,100
"2306","09136","2014",1,1,0,75000,1562,48
"2307","09137","2014",1,1,0,170000,783,217
"2308","09138","2014",1,1,0,48000,457,105
"2309","09140","2014",2,2,0,171834.5,1931.5,97
"2310","09142","2014",1,1,0,199000,1605,124
"2311","09145","2014",3,3,0,168286.666666667,1482.66666666667,111.666666666667
"2312","09147","2014",1,1,0,332800,1707,195
"2313","09149","2014",6,6,0,77045,733.333333333333,101.333333333333
"2314","09150","2014",4,4,0,65000,746.25,109
"2315","09151","2014",2,2,0,115000,1009.5,115
"2316","09152","2014",1,1,0,35000,875,40
"2317","09153","2014",2,2,0,282500,3420.5,130.5
"2318","09154","2014",1,1,0,1e+05,1389,72
"2319","09155","2014",3,3,0,106000,1724.66666666667,83
"2320","09157","2014",19,19,0,98670,999.421052631579,102
"2321","09158","2014",2,2,0,67500,1022.5,66
"2322","09160","2014",42,40,2,95415,911.785714285714,109.166666666667
"2323","09161","2014",8,8,0,80000,977.75,85.625
"2324","09162","2014",2,2,0,62500,1239.5,58
"2325","09163","2014",1,1,0,150000,806,186
"2326","09164","2014",4,4,0,152450,1510.25,105.25
"2327","09165","2014",1,1,0,82000,1640,50
"2328","09166","2014",3,3,0,91666.6666666667,1086.66666666667,85.6666666666667
"2329","09167","2014",14,12,2,120642.857142857,1266.5,94.8571428571429
"2330","09168","2014",2,2,0,167375,2355.5,67
"2331","09170","2014",1,1,0,198000,1245,159
"2332","09173","2014",1,1,0,375000,1250,300
"2333","09174","2014",3,3,0,202333.333333333,1681.66666666667,125
"2334","09176","2014",5,5,0,95638,981.4,100.4
"2335","09177","2014",2,2,0,113500,1219,90
"2336","09178","2014",1,1,0,115000,1186,97
"2337","09179","2014",2,2,0,52500,374,143.5
"2338","09180","2014",2,2,0,85931,606,175
"2339","09181","2014",10,10,0,138250,1262.4,109.9
"2340","09182","2014",13,13,0,83654.6153846154,1219,66.0769230769231
"2341","09185","2014",41,38,3,139715.365853659,1390.46341463415,106.268292682927
"2342","09188","2014",9,8,1,98094.4444444444,1146.22222222222,91.4444444444444
"2343","09189","2014",4,4,0,70752.5,1547.25,48
"2344","09190","2014",1,1,0,120000,984,122
"2345","09192","2014",2,2,0,97125,1067.5,101
"2346","09193","2014",1,1,0,66000,641,103
"2347","09194","2014",41,35,6,144989.951219512,1341.9756097561,102.951219512195
"2348","09195","2014",1,1,0,85000,1181,72
"2349","09198","2014",1,1,0,64000,914,70
"2350","09199","2014",2,2,0,140000,1193,95
"2351","09200","2014",1,1,0,60000,857,70
"2352","09201","2014",1,1,0,90000,1098,82
"2353","09203","2014",3,3,0,88116.6666666667,1123.33333333333,87.6666666666667
"2354","09206","2014",23,6,17,51910,1396.86956521739,40.7826086956522
"2355","09207","2014",12,12,0,101312.5,1187.66666666667,85.8333333333333
"2356","09208","2014",1,1,0,170000,1441,118
"2357","09209","2014",2,2,0,2e+05,1939.5,116.5
"2358","09210","2014",4,4,0,99750,1381.5,80.75
"2359","09211","2014",1,1,0,60000,652,92
"2360","09212","2014",3,3,0,96033.3333333333,1472,75
"2361","09214","2014",8,8,0,95152.5,1567,69.5
"2362","09215","2014",1,1,0,88000,1189,74
"2363","09216","2014",2,2,0,213750,1545.5,159.5
"2364","09217","2014",2,2,0,97700,1324.5,76
"2365","09219","2014",3,3,0,77000,962,77.6666666666667
"2366","09220","2014",2,2,0,52690,1063.5,50
"2367","09221","2014",2,2,0,86250,946.5,86.5
"2368","09223","2014",8,7,1,79843.75,948.75,110.25
"2369","09224","2014",3,3,0,67333.3333333333,1745.33333333333,56.3333333333333
"2370","09225","2014",133,98,35,111889.165413534,1336.07518796992,88.5037593984962
"2371","09227","2014",2,1,1,65000,742,87
"2372","09228","2014",4,4,0,72662.5,1126.5,69.5
"2373","09229","2014",3,3,0,125000,847,120.333333333333
"2374","09230","2014",1,1,0,105000,1000,105
"2375","09231","2014",4,3,1,97850,2364.5,48.75
"2376","09232","2014",1,1,0,73000,1460,50
"2377","09234","2014",4,4,0,148550,1352,104.5
"2378","09235","2014",3,3,0,120709.333333333,1134.33333333333,99
"2379","09236","2014",5,5,0,122580,1388.8,96.8
"2380","09237","2014",1,1,0,125000,1645,76
"2381","09238","2014",7,7,0,141878.571428571,1297.85714285714,107
"2382","09239","2014",4,4,0,43450,648.75,67.25
"2383","09240","2014",2,2,0,123781.5,1054.5,106
"2384","09241","2014",6,6,0,63333.3333333333,1060.5,72.1666666666667
"2385","09244","2014",2,2,0,119625,1350.5,88.5
"2386","09245","2014",10,10,0,169290,1458.3,117
"2387","09246","2014",10,10,0,134415.7,1860.9,84.2
"2388","09247","2014",5,5,0,62262,1368.6,43.2
"2389","09250","2014",2,2,0,154825,1460.5,106
"2390","09251","2014",1,1,0,250000,1645,152
"2391","09253","2014",3,3,0,62000,860.333333333333,103.333333333333
"2392","09254","2014",2,1,1,95350,1134,84.5
"2393","09257","2014",12,12,0,89500,914.833333333333,93.9166666666667
"2394","09258","2014",3,3,0,177600,1378.66666666667,145.333333333333
"2395","09261","2014",56,43,13,106508.928571429,1179.53571428571,93.8214285714286
"2396","09262","2014",2,2,0,1e+05,1365,73.5
"2397","09264","2014",7,7,0,152928.571428571,1719.85714285714,91.8571428571429
"2398","09265","2014",23,20,3,131076.086956522,1534.5652173913,91.5217391304348
"2399","09267","2014",1,1,0,65000,878,74
"2400","09268","2014",15,15,0,133620,1356.13333333333,97.6666666666667
"2401","09269","2014",3,3,0,133016.666666667,1141.33333333333,124.666666666667
"2402","09271","2014",2,2,0,199750,1325.5,150.5
"2403","09272","2014",13,13,0,112562.307692308,1330.84615384615,86.3076923076923
"2404","09273","2014",5,5,0,119880,1204.8,111
"2405","09274","2014",1,1,0,170000,1700,100
"2406","09275","2014",3,3,0,168666.666666667,1571.66666666667,118.333333333333
"2407","09277","2014",7,7,0,158660.714285714,1493.28571428571,106
"2408","09280","2014",7,7,0,147342.857142857,1726.85714285714,90.2857142857143
"2409","09281","2014",1,1,0,139000,1418,98
"2410","09282","2014",40,39,1,144889.375,1519.625,105.5
"2411","09283","2014",2,1,1,40050,1289.5,41.5
"2412","09284","2014",2,2,0,197500,1630.5,124
"2413","09285","2014",6,6,0,99583.3333333333,1761.33333333333,65.8333333333333
"2414","09289","2014",12,11,1,132025,1493.25,94.5
"2415","09290","2014",4,4,0,43000,1031,56.75
"2416","09291","2014",1,1,0,25000,625,40
"2417","09293","2014",7,7,0,103971.428571429,1156.57142857143,92.2857142857143
"2418","09294","2014",1,1,0,80000,1067,75
"2419","09295","2014",2,2,0,67250,1622.5,42.5
"2420","09296","2014",3,3,0,92566.6666666667,1259.33333333333,76
"2421","09298","2014",3,3,0,185126.666666667,2381.33333333333,75.6666666666667
"2422","09299","2014",9,9,0,98311.8888888889,1100,79.2222222222222
"2423","09300","2014",1,1,0,351250,2019,174
"2424","09301","2014",6,6,0,67083.3333333333,1287,62.6666666666667
"2425","09303","2014",3,3,0,135000,1261.33333333333,107
"2426","09305","2014",5,5,0,118300,1065.4,101
"2427","09306","2014",21,14,7,103995.238095238,1164.57142857143,99.6666666666667
"2428","09308","2014",1,1,0,130000,1161,112
"2429","09309","2014",3,3,0,120666.666666667,1112.33333333333,108.666666666667
"2430","09312","2014",31,31,0,151452.064516129,1599.29032258065,93.0322580645161
"2431","09314","2014",1,1,0,130000,1757,74
"2432","09316","2014",1,1,0,84000,875,96
"2433","09318","2014",1,1,0,85000,1700,50
"2434","09319","2014",1,1,0,240000,2069,116
"2435","09320","2014",1,1,0,95000,605,157
"2436","09321","2014",3,3,0,104750,1625,64
"2437","09322","2014",29,21,8,74165.3103448276,1703.86206896552,48.448275862069
"2438","09324","2014",33,32,1,134875.181818182,1449.60606060606,99.8181818181818
"2439","09326","2014",1,0,1,80000,593,135
"2440","09327","2014",3,2,1,67666.6666666667,789.333333333333,87.3333333333333
"2441","09328","2014",1,1,0,265000,1568,169
"2442","09329","2014",2,2,0,145250,2421.5,68
"2443","09331","2014",4,4,0,115500,1321.25,89
"2444","09332","2014",17,17,0,159511.294117647,1481.41176470588,107.411764705882
"2445","09334","2014",11,7,4,79958.1818181818,997.181818181818,80.5454545454545
"2446","09336","2014",11,11,0,106133.181818182,1116.81818181818,77.5454545454545
"2447","09339","2014",4,4,0,147720,1336,120
"2448","09340","2014",2,2,0,76004,729,120
"2449","09341","2014",2,2,0,145000,1575,92
"2450","09342","2014",1,1,0,174000,1955,89
"2451","10002","2014",2,1,1,115000,1723.5,67
"2452","10003","2014",20,20,0,83030.5,962.6,92.55
"2453","10004","2014",3,3,0,83736.6666666667,834,94.3333333333333
"2454","10005","2014",4,4,0,115125,1124.25,103.25
"2455","10006","2014",20,18,2,101128.85,1146.55,91.8
"2456","10008","2014",2,2,0,64705,920,72.5
"2457","10009","2014",1,1,0,60000,811,74
"2458","10011","2014",1,1,0,90000,549,164
"2459","10012","2014",2,2,0,138952.5,1000.5,138.5
"2460","10013","2014",1,1,0,147000,1652,89
"2461","10014","2014",2,2,0,140500,1596.5,88
"2462","10015","2014",2,2,0,120500,1200.5,99
"2463","10017","2014",1,1,0,54000,519,104
"2464","10018","2014",6,6,0,98357.8333333333,867.833333333333,109.666666666667
"2465","10021","2014",1,1,0,165000,1154,143
"2466","10023","2014",2,2,0,121000,1465,92.5
"2467","10024","2014",2,2,0,62500,991,63
"2468","10030","2014",5,4,1,162720,1746.8,94.6
"2469","10031","2014",5,5,0,112100,1204.2,90
"2470","10033","2014",14,10,4,90446.4285714286,1069.78571428571,87.9285714285714
"2471","10034","2014",25,14,11,83176,1078.64,83.88
"2472","10035","2014",2,2,0,91925,992,94.5
"2473","10037","2014",2,2,0,142250,1498,96.5
"2474","10038","2014",2,2,0,60000,739.5,97
"2475","10040","2014",1,1,0,42150,398,106
"2476","10042","2014",3,3,0,112000,850,137
"2477","10043","2014",1,1,0,120000,1500,80
"2478","10049","2014",3,3,0,204033.333333333,1550,130.666666666667
"2479","10051","2014",13,13,0,149500,1391.38461538462,117.615384615385
"2480","10052","2014",3,3,0,147523.333333333,1436.66666666667,105.333333333333
"2481","10053","2014",8,8,0,131081.25,1436.375,88.875
"2482","10054","2014",4,4,0,98875,1247.75,79
"2483","10055","2014",3,3,0,142333.333333333,954.666666666667,146.333333333333
"2484","10060","2014",26,21,5,204521.153846154,1866.88461538462,118
"2485","10061","2014",5,5,0,110260,1401,80
"2486","10062","2014",1,1,0,162000,1500,108
"2487","10066","2014",3,3,0,169333.333333333,1090,166.666666666667
"2488","10067","2014",18,12,6,136255.555555556,1287.11111111111,112.888888888889
"2489","10074","2014",4,4,0,85125,854.5,93.5
"2490","10075","2014",1,1,0,78000,1114,70
"2491","10079","2014",1,1,0,66000,733,90
"2492","10080","2014",4,2,2,106250,938.75,117.5
"2493","10081","2014",65,34,31,112078.153846154,1389.72307692308,78.6615384615385
"2494","10083","2014",1,1,0,110000,902,122
"2495","10084","2014",9,9,0,136915.555555556,1272.66666666667,102
"2496","10086","2014",2,2,0,84000,888,98.5
"2497","10089","2014",6,6,0,130333.333333333,882.5,161.666666666667
"2498","10090","2014",1,1,0,154000,1833,84
"2499","10091","2014",2,2,0,95500,1038.5,102
"2500","10092","2014",1,1,0,150000,1500,100
"2501","10095","2014",4,4,0,147530,1064.75,126
"2502","10096","2014",4,4,0,122125,1226.75,105.5
"2503","10098","2014",3,3,0,94666.6666666667,812.666666666667,121.666666666667
"2504","10099","2014",5,5,0,102406,888.4,120
"2505","10100","2014",8,8,0,157735,1726.75,92.5
"2506","10102","2014",1,1,0,50000,379,132
"2507","10104","2014",5,5,0,181680,1369.2,156.8
"2508","10106","2014",1,1,0,50000,1000,50
"2509","10107","2014",1,1,0,60000,750,80
"2510","10110","2014",8,8,0,153375,1633.125,97.125
"2511","10112","2014",1,1,0,120500,1066,113
"2512","10113","2014",2,2,0,73750,849,87
"2513","10114","2014",5,5,0,127200,1472.6,88
"2514","10115","2014",11,9,2,196300,1778,112.727272727273
"2515","10116","2014",3,3,0,94000,877,100
"2516","10118","2014",1,1,0,199200,655,304
"2517","10120","2014",3,3,0,145666.666666667,936.666666666667,154
"2518","10121","2014",3,3,0,91333.3333333333,937.333333333333,106.666666666667
"2519","10122","2014",2,2,0,117600,765,147
"2520","10124","2014",1,1,0,145000,843,172
"2521","10125","2014",2,2,0,243750,1426.5,172
"2522","10129","2014",5,5,0,174900,1769.6,113.2
"2523","10131","2014",2,2,0,119500,1164,102.5
"2524","10132","2014",2,2,0,152000,917,178.5
"2525","10133","2014",4,4,0,164250,1068.25,140
"2526","10135","2014",1,1,0,130000,464,280
"2527","10139","2014",2,2,0,86500,863,103.5
"2528","10140","2014",11,10,1,80264.3636363636,930.545454545455,98.6363636363636
"2529","10141","2014",4,4,0,130837.5,1500,87.5
"2530","10142","2014",19,17,2,124842.105263158,1362.52631578947,92.1052631578947
"2531","10143","2014",1,1,0,57000,877,65
"2532","10144","2014",1,1,0,70000,787,89
"2533","10147","2014",1,1,0,150000,1667,90
"2534","10148","2014",4,4,0,139850,1608.5,90.75
"2535","10149","2014",1,1,0,92500,889,104
"2536","10151","2014",5,5,0,86400,1073.6,81.8
"2537","10156","2014",4,4,0,146151,1460.25,100.75
"2538","10157","2014",1,1,0,50000,413,121
"2539","10158","2014",3,3,0,177666.666666667,1360,143.666666666667
"2540","10164","2014",7,7,0,84142.8571428571,1146.28571428571,73.1428571428571
"2541","10165","2014",4,4,0,110850,1818.5,65.5
"2542","10166","2014",5,5,0,94941.8,1131.4,90.4
"2543","10170","2014",2,2,0,82750,911.5,78
"2544","10171","2014",1,1,0,110000,1467,75
"2545","10172","2014",2,2,0,88000,917,93
"2546","10176","2014",2,2,0,87000,1492,75.5
"2547","10177","2014",3,3,0,179000,1550.33333333333,107.333333333333
"2548","10178","2014",3,3,0,116466.666666667,1094.33333333333,97.3333333333333
"2549","10179","2014",2,2,0,165780,1729.5,86
"2550","10181","2014",4,4,0,102250,1113.75,92
"2551","10183","2014",1,1,0,69000,1062,65
"2552","10184","2014",1,1,0,30000,333,90
"2553","10186","2014",6,5,1,197816.666666667,1436.83333333333,134
"2554","10187","2014",5,5,0,70100,756.4,91.4
"2555","10190","2014",3,3,0,175166.666666667,1426.66666666667,121.333333333333
"2556","10191","2014",6,6,0,161344.166666667,1676.16666666667,95.3333333333333
"2557","10194","2014",1,1,0,55000,797,69
"2558","10196","2014",1,1,0,149950,757,198
"2559","10197","2014",2,2,0,127500,1315,97
"2560","10198","2014",3,3,0,91853.3333333333,2069,50
"2561","10199","2014",3,3,0,176000,982,132.666666666667
"2562","10200","2014",1,1,0,120000,1091,110
"2563","10202","2014",1,1,0,40000,870,46
"2564","10204","2014",3,3,0,118333.333333333,1094.66666666667,111.666666666667
"2565","10208","2014",1,1,0,136000,1360,100
"2566","10209","2014",18,15,3,164247.222222222,1560.5,111
"2567","10210","2014",2,2,0,235000,1887,130
"2568","10211","2014",10,10,0,173355.4,1850.2,100.6
"2569","10213","2014",1,1,0,80000,879,91
"2570","10214","2014",1,1,0,65700,738,89
"2571","10216","2014",7,7,0,105257.142857143,1138.71428571429,93.5714285714286
"2572","10218","2014",1,1,0,160000,1702,94
"2573","10220","2014",12,11,1,142116.666666667,1453.58333333333,105.166666666667
"2574","10222","2014",5,5,0,91837,890.6,97.4
"2575","10223","2014",9,9,0,118544.444444444,1255.66666666667,109.222222222222
"2576","10224","2014",8,8,0,118547.5,1214.5,96.625
"2577","10225","2014",2,2,0,62500,811,67
"2578","10227","2014",3,3,0,64000,879.666666666667,72
"2579","10229","2014",1,1,0,156000,1431,109
"2580","10230","2014",2,2,0,145650,1405,99
"2581","10233","2014",8,8,0,120175,1369.5,88.625
"2582","10234","2014",2,2,0,91500,785.5,106.5
"2583","10237","2014",5,5,0,132460,1049.6,129.2
"2584","10238","2014",2,2,0,216500,3615,60.5
"2585","10239","2014",3,3,0,147733.333333333,1673,88.3333333333333
"2586","10240","2014",5,5,0,146000,1343.6,112.6
"2587","10241","2014",2,2,0,275000,1504,166
"2588","10243","2014",2,2,0,46500,486.5,92.5
"2589","10245","2014",7,7,0,164729.285714286,1522,109
"2590","10246","2014",1,1,0,115000,1095,105
"2591","10247","2014",2,2,0,116000,959.5,127
"2592","10248","2014",2,2,0,196975,1533.5,136
"2593","10249","2014",4,4,0,93000,1298.25,72.5
"2594","10250","2014",1,1,0,236650,1376,172
"2595","10251","2014",2,2,0,100205,791.5,102
"2596","10254","2014",1,1,0,80000,1143,70
"2597","10255","2014",1,1,0,184000,1840,100
"2598","10256","2014",2,2,0,245950,1628.5,221.5
"2599","10257","2014",1,1,0,145000,1368,106
"2600","10258","2014",3,3,0,115000,777.333333333333,149.333333333333
"2601","10259","2014",2,2,0,165600,1282,132.5
"2602","10260","2014",3,3,0,201833.333333333,2225.66666666667,89.3333333333333
"2603","10261","2014",7,7,0,59857.1428571429,750.857142857143,79.1428571428571
"2604","10263","2014",2,2,0,73925,908,85.5
"2605","10265","2014",27,25,2,139011.962962963,1679.96296296296,84.9259259259259
"2606","10267","2014",2,2,0,87000,935.5,94
"2607","10268","2014",41,31,10,131532.317073171,1703.31707317073,83.2926829268293
"2608","10271","2014",3,3,0,143516.666666667,1329.66666666667,109
"2609","10274","2014",3,3,0,156666.666666667,1213,137.666666666667
"2610","10275","2014",4,4,0,100227.5,900.5,105.5
"2611","10276","2014",4,4,0,106362.5,1110.5,91.25
"2612","10278","2014",2,2,0,1e+05,1371.5,77.5
"2613","10280","2014",10,9,1,116155.6,1144.9,103.1
"2614","10282","2014",6,5,1,197333.333333333,1700.83333333333,110.166666666667
"2615","10284","2014",1,1,0,131500,1096,120
"2616","10287","2014",7,7,0,121478.571428571,1155.57142857143,108.428571428571
"2617","10288","2014",4,4,0,71000,780,90.5
"2618","10290","2014",2,2,0,96000,675.5,132.5
"2619","10296","2014",3,3,0,195666.666666667,1426,124.666666666667
"2620","10297","2014",29,21,8,117397.24137931,1467,83.1379310344828
"2621","10299","2014",1,1,0,175000,1389,126
"2622","10301","2014",5,5,0,71500,770.8,93.6
"2623","10305","2014",1,1,0,117000,1093,107
"2624","10307","2014",2,2,0,118000,1163.5,112.5
"2625","10310","2014",2,2,0,103500,1006.5,108
"2626","10312","2014",1,1,0,120000,1622,74
"2627","10314","2014",5,5,0,106200,959.8,95.8
"2628","10316","2014",2,2,0,160500,730.5,227
"2629","10317","2014",6,6,0,134408.666666667,1285.83333333333,102.666666666667
"2630","10318","2014",3,3,0,141333.333333333,1387.33333333333,102.333333333333
"2631","10319","2014",6,6,0,67326.5,525.5,125.833333333333
"2632","10320","2014",1,1,0,65000,812,80
"2633","10321","2014",21,19,2,210498.571428571,1866.7619047619,118.238095238095
"2634","10323","2014",142,119,23,95556.4647887324,1163.33802816901,82.5
"2635","10324","2014",1,1,0,133500,1483,90
"2636","10325","2014",22,21,1,201440.909090909,1804.86363636364,113.136363636364
"2637","10329","2014",2,2,0,247500,2217.5,111.5
"2638","10331","2014",1,1,0,140000,560,250
"2639","10332","2014",2,2,0,177750,1402,128
"2640","10333","2014",136,65,71,124251.433823529,1593.15441176471,80.7205882352941
"2641","10335","2014",4,4,0,69000,719.5,104
"2642","10336","2014",4,4,0,179250,1690.75,97.75
"2643","10339","2014",2,2,0,81300,1091,71.5
"2644","10340","2014",13,11,2,139008.230769231,1668.46153846154,85.1538461538462
"2645","10341","2014",2,2,0,120000,1048,113.5
"2646","10342","2014",1,1,0,186300,1882,99
"2647","10343","2014",93,55,38,118997.086021505,1476.7311827957,82.5268817204301
"2648","10344","2014",6,6,0,256791.666666667,1811.5,138.833333333333
"2649","10346","2014",1,1,0,30000,545,55
"2650","10347","2014",3,3,0,140000,1889.33333333333,80.3333333333333
"2651","10348","2014",1,1,0,120000,1600,75
"2652","10349","2014",21,21,0,179700,1631.80952380952,113.238095238095
"2653","10350","2014",8,8,0,91950,966.5,98.125
"2654","10351","2014",6,5,1,121833.333333333,1293.66666666667,111.333333333333
"2655","10352","2014",12,12,0,195433.333333333,1737.16666666667,113.333333333333
"2656","10353","2014",15,14,1,117510,1224.86666666667,96.8666666666667
"2657","10354","2014",2,2,0,2e+05,1482,132
"2658","10355","2014",1,1,0,185000,1445,128
"2659","10356","2014",4,4,0,75750,799.25,107
"2660","10357","2014",29,25,4,139355.172413793,1667.51724137931,82.4137931034483
"2661","10359","2014",2,2,0,160000,1492.5,131.5
"2662","10360","2014",5,5,0,170220,2004.2,84.8
"2663","10362","2014",158,79,79,120121.772151899,1765.46202531646,67.7721518987342
"2664","10363","2014",2,2,0,98800,1006,105
"2665","10368","2014",11,11,0,146490.909090909,1395.81818181818,104.454545454545
"2666","10369","2014",5,5,0,104400,1045.8,100.2
"2667","10371","2014",3,3,0,141666.666666667,1433.33333333333,101.666666666667
"2668","10373","2014",2,2,0,164249,1131.5,133.5
"2669","10375","2014",3,3,0,246666.666666667,2623,102.666666666667
"2670","10376","2014",1,1,0,132000,1320,100
"2671","10377","2014",1,1,0,125000,731,171
"2672","10381","2014",5,3,2,160670,1219.2,136
"2673","10387","2014",777,162,615,99721.1325611326,1446.19176319176,68.4620334620335
"2674","10391","2014",1,1,0,97000,1311,74
"2675","10392","2014",6,6,0,103766.666666667,1118.16666666667,98.8333333333333
"2676","10394","2014",4,4,0,98250,999,106.25
"2677","10395","2014",4,4,0,113500,1531,80.25
"2678","10396","2014",3,3,0,120666.666666667,1197.66666666667,109.666666666667
"2679","10398","2014",1,1,0,80100,673,119
"2680","10400","2014",1,1,0,195000,1175,166
"2681","10401","2014",12,10,2,94983.3333333333,911.75,103.416666666667
"2682","10402","2014",1,1,0,147000,1470,100
"2683","10406","2014",15,15,0,189322.066666667,1687.06666666667,115.4
"2684","10408","2014",1,1,0,115000,983,117
"2685","10409","2014",2,2,0,131500,1400.5,93
"2686","10412","2014",6,6,0,197000,1722.33333333333,116.833333333333
"2687","10422","2014",1,1,0,61000,462,132
"2688","10423","2014",4,4,0,83325,1238.5,61.5
"2689","10425","2014",1,1,0,116500,826,141
"2690","10430","2014",1,1,0,150000,1485,101
"2691","10435","2014",1,1,0,130000,1032,126
"2692","10436","2014",1,1,0,140000,1197,117
"2693","10437","2014",1,1,0,1e+05,1176,85
"2694","10439","2014",3,3,0,107933.333333333,1123.66666666667,98.3333333333333
"2695","10440","2014",1,1,0,120000,1348,89
"2696","10441","2014",4,4,0,146375,1300.25,104.75
"2697","10442","2014",9,9,0,136315.555555556,1451.22222222222,96.6666666666667
"2698","10444","2014",2,2,0,129500,1521,108.5
"2699","11001","2014",5,5,0,106900,898.8,110
"2700","11003","2014",1,1,0,25000,417,60
"2701","11004","2014",7,7,0,142214.285714286,1122.57142857143,121.285714285714
"2702","11005","2014",6,6,0,215091.666666667,1636,130.166666666667
"2703","11007","2014",2,2,0,236750,2584,92
"2704","11008","2014",6,6,0,96252.8333333333,1068,89.1666666666667
"2705","11009","2014",4,4,0,141275,1674.25,86.25
"2706","11010","2014",3,3,0,164500,1196,137.333333333333
"2707","11011","2014",6,6,0,162966.666666667,1698.83333333333,95.3333333333333
"2708","11012","2014",27,27,0,166419.222222222,1696.25925925926,100.962962962963
"2709","11013","2014",4,4,0,197354,1696.25,118.5
"2710","11014","2014",9,8,1,186055.555555556,2242.55555555556,87.5555555555556
"2711","11015","2014",4,4,0,50625,787.75,65
"2712","11016","2014",3,3,0,165666.666666667,1196.66666666667,127
"2713","11017","2014",2,2,0,89780,1063,77
"2714","11018","2014",6,6,0,107500,1057.5,99.6666666666667
"2715","11019","2014",1,1,0,96600,773,125
"2716","11021","2014",4,4,0,97875,1111.75,89.75
"2717","11022","2014",19,18,1,127626.842105263,1461.73684210526,98.2631578947368
"2718","11023","2014",7,7,0,120585.714285714,1268.14285714286,94.5714285714286
"2719","11024","2014",10,9,1,184380,2340.5,86.9
"2720","11025","2014",2,2,0,146000,1505.5,101
"2721","11026","2014",2,2,0,88090,1033.5,88.5
"2722","11027","2014",11,10,1,100173.636363636,982.272727272727,95.9090909090909
"2723","11028","2014",4,4,0,100750,1164.5,80.25
"2724","11032","2014",8,7,1,153425,1460.5,102.375
"2725","11033","2014",10,10,0,145250,1125.2,129
"2726","11034","2014",3,3,0,119166.666666667,1283,90.3333333333333
"2727","11035","2014",5,5,0,105500,1117,93.6
"2728","11037","2014",8,7,1,140375,1391.5,103
"2729","11039","2014",1,1,0,50000,435,115
"2730","11040","2014",20,19,1,144201.6,1627,91.55
"2731","11041","2014",17,17,0,163160.294117647,1566.58823529412,112.117647058824
"2732","11042","2014",3,3,0,133000,1318.33333333333,116.333333333333
"2733","11043","2014",1,1,0,222100,1501,148
"2734","11044","2014",1,1,0,80000,1000,80
"2735","11045","2014",1,1,0,2e+05,1316,152
"2736","11046","2014",1,1,0,220000,1028,214
"2737","11047","2014",3,3,0,48666.6666666667,1321,35.6666666666667
"2738","11048","2014",6,6,0,127270,1629.16666666667,75.6666666666667
"2739","11049","2014",27,27,0,132725.555555556,1256,107.962962962963
"2740","11051","2014",1,1,0,190000,1638,116
"2741","11052","2014",5,5,0,110184,2024,63
"2742","11053","2014",3,3,0,124500,1405.66666666667,90.3333333333333
"2743","11054","2014",2,2,0,179000,1897.5,94
"2744","11055","2014",3,2,1,79000,945.333333333333,81.3333333333333
"2745","11058","2014",8,8,0,128463.375,1544.5,80.125
"2746","11061","2014",4,4,0,98847.5,1187.75,78.5
"2747","11062","2014",1,1,0,36000,360,100
"2748","11063","2014",2,2,0,91051,993,90.5
"2749","11064","2014",1,1,0,177500,1793,99
"2750","11065","2014",1,1,0,40000,1538,26
"2751","11066","2014",7,7,0,105331.428571429,1236,90.1428571428571
"2752","11067","2014",21,20,1,149866.80952381,1473.71428571429,102.190476190476
"2753","11068","2014",13,13,0,114942.307692308,1061.53846153846,103.076923076923
"2754","11069","2014",445,270,175,117024.159550562,1336.69438202247,86.6224719101124
"2755","11070","2014",3,3,0,107833.333333333,956.333333333333,115
"2756","11071","2014",4,4,0,132125,1387.5,95.5
"2757","11074","2014",1,1,0,142500,1295,110
"2758","11075","2014",3,3,0,69133.3333333333,1056,84.3333333333333
"2759","11076","2014",89,78,11,138722.033707865,1573.55056179775,96.2359550561798
"2760","11077","2014",5,5,0,102800,805.4,99
"2761","11079","2014",3,3,0,155500,2930.66666666667,57.6666666666667
"2762","11080","2014",2,2,0,81500,1311.5,72
"2763","11081","2014",18,17,1,162303.333333333,1633.88888888889,103
"2764","11084","2014",4,4,0,143750,1797.25,82
"2765","11085","2014",9,9,0,164341.888888889,1597.77777777778,100.555555555556
"2766","11086","2014",7,7,0,158203.571428571,1889,82.7142857142857
"2767","11088","2014",15,15,0,144302.666666667,1534.46666666667,94.8666666666667
"2768","11089","2014",3,3,0,91833.3333333333,1067.33333333333,79
"2769","11090","2014",4,4,0,120250,1155.25,99.75
"2770","11091","2014",7,6,1,70000,784.428571428571,89
"2771","11092","2014",1,1,0,46500,664,70
"2772","11094","2014",1,1,0,380000,2077,183
"2773","11095","2014",4,4,0,157750,1934.25,86
"2774","11096","2014",2,2,0,73475,883.5,82.5
"2775","11098","2014",9,9,0,127368.888888889,1270.88888888889,103.666666666667
"2776","11099","2014",16,16,0,122403.125,1213.1875,101.8125
"2777","11101","2014",1,1,0,95000,848,112
"2778","11102","2014",3,3,0,109966.666666667,1474.33333333333,71.3333333333333
"2779","11103","2014",5,5,0,103788,1037.2,92.2
"2780","11105","2014",4,4,0,131000,1251,110.5
"2781","11106","2014",56,50,6,129142.071428571,1592.08928571429,82.7142857142857
"2782","11108","2014",1,1,0,301000,1654,182
"2783","11109","2014",1,1,0,24800,620,40
"2784","11110","2014",2,2,0,115250,1455,62.5
"2785","11111","2014",8,8,0,183075,1845,101.875
"2786","11112","2014",2,2,0,70000,1137.5,61.5
"2787","11113","2014",2,1,1,49500,527.5,93
"2788","11115","2014",11,11,0,139345.454545455,1475.81818181818,104.272727272727
"2789","11116","2014",37,36,1,143959.891891892,1445.40540540541,97.5945945945946
"2790","11118","2014",1,1,0,22000,344,64
"2791","11119","2014",5,5,0,158400,1551.2,108.8
"2792","11120","2014",3,3,0,124666.666666667,1035.33333333333,107.666666666667
"2793","11121","2014",1,1,0,115000,1438,80
"2794","11122","2014",5,5,0,71400,802.8,92
"2795","11124","2014",4,3,1,193300,1609.75,99.75
"2796","11125","2014",1,1,0,69350,937,74
"2797","11126","2014",3,3,0,79666.6666666667,953.333333333333,76.6666666666667
"2798","11127","2014",2,2,0,53250,628.5,84.5
"2799","11128","2014",4,4,0,162500,1631.5,102.75
"2800","11129","2014",30,30,0,86520,1044.13333333333,85.4666666666667
"2801","11130","2014",3,3,0,153833.333333333,1193,122.333333333333
"2802","11131","2014",5,5,0,126400,1527.8,88.6
"2803","11132","2014",20,19,1,161115,1608.75,99.85
"2804","11135","2014",2,2,0,30270,439.5,67
"2805","11136","2014",5,5,0,160200,1434.6,105.8
"2806","11137","2014",3,3,0,72666.6666666667,702.666666666667,92
"2807","11138","2014",1,1,0,136000,1046,130
"2808","11140","2014",20,20,0,127871,1276.15,100.5
"2809","11141","2014",1,1,0,425000,2179,195
"2810","11142","2014",1,1,0,90000,455,198
"2811","11144","2014",14,12,2,119990.357142857,1751.28571428571,78.5
"2812","11145","2014",215,122,93,110098.651162791,2783.2,44.153488372093
"2813","11146","2014",4,4,0,139375,1397,101.5
"2814","11147","2014",1,1,0,72000,1029,70
"2815","11148","2014",6,5,1,112439.166666667,984.166666666667,108.666666666667
"2816","11150","2014",6,6,0,96833.3333333333,1073.83333333333,90.6666666666667
"2817","11151","2014",5,5,0,109420,1214.4,99.6
"2818","11152","2014",2,2,0,183750,1504,118
"2819","11153","2014",1,1,0,149000,1693,88
"2820","11154","2014",1,1,0,35000,500,70
"2821","11156","2014",1,1,0,1e+05,962,104
"2822","11157","2014",1,1,0,16500,375,44
"2823","11158","2014",3,3,0,72000,1318.66666666667,71.6666666666667
"2824","11159","2014",2,2,0,77325,1363,67
"2825","11160","2014",2,2,0,90050,676.5,135
"2826","11161","2014",2,2,0,100500,1066.5,104
"2827","11162","2014",1,1,0,60000,645,93
"2828","11164","2014",13,13,0,135001.384615385,1494.76923076923,92.6153846153846
"2829","11165","2014",4,4,0,154000,1574.5,103.25
"2830","11166","2014",1,1,0,210000,1909,110
"2831","11167","2014",1,1,0,60000,759,79
"2832","11168","2014",1,1,0,55000,550,100
"2833","11169","2014",2,2,0,71250,834.5,78.5
"2834","11170","2014",306,147,159,120025.931372549,2888.80392156863,42.9248366013072
"2835","11172","2014",11,11,0,197738.545454545,1683.63636363636,117.090909090909
"2836","11174","2014",1,1,0,56990,1140,50
"2837","11175","2014",2,2,0,178500,2247,79.5
"2838","11178","2014",11,11,0,152149.090909091,1647.45454545455,94.5454545454545
"2839","11180","2014",1,1,0,170000,1667,102
"2840","11181","2014",4,4,0,87556,1111.25,79
"2841","11182","2014",5,5,0,66900,850.6,77
"2842","11183","2014",5,5,0,57580,926.8,64.8
"2843","11184","2014",1,1,0,98000,438,224
"2844","11185","2014",6,5,1,85375,1338.16666666667,70.6666666666667
"2845","11186","2014",4,4,0,125000,1301.5,93.75
"2846","11188","2014",9,8,1,276802.777777778,2118,127.888888888889
"2847","11189","2014",4,4,0,89500,1051.5,85.75
"2848","11190","2014",14,12,2,88910.7142857143,1053.42857142857,86
"2849","11192","2014",9,9,0,126833.333333333,1285.88888888889,99.3333333333333
"2850","11193","2014",3,3,0,101166.666666667,1287,71
"2851","11195","2014",4,4,0,172250,1446.5,113.75
"2852","11196","2014",4,4,0,72908.75,901.25,84.25
"2853","11197","2014",6,6,0,125830,1154.83333333333,105.333333333333
"2854","11198","2014",10,10,0,67010,833.3,77.4
"2855","11199","2014",14,14,0,144305.357142857,1361.85714285714,108.642857142857
"2856","11200","2014",6,6,0,36033.3333333333,719.166666666667,55.1666666666667
"2857","11201","2014",5,5,0,132200,1207.6,102.8
"2858","11202","2014",349,144,205,94764.0687679083,2663.00286532951,36.4785100286533
"2859","11203","2014",94,83,11,148058.031914894,1632.73404255319,93.063829787234
"2860","11206","2014",115,104,11,118781.391304348,1289.31304347826,91.1826086956522
"2861","11209","2014",2,2,0,139942.5,1314.5,122
"2862","11210","2014",12,12,0,174313.333333333,1743,100.083333333333
"2863","11211","2014",7,7,0,122185.714285714,1152.57142857143,106
"2864","11212","2014",7,7,0,163368.714285714,1646,94.1428571428571
"2865","11213","2014",2,2,0,65000,776.5,90.5
"2866","11214","2014",2,2,0,179200,1167.5,155
"2867","11215","2014",7,7,0,120571.428571429,1249.57142857143,91.8571428571429
"2868","11216","2014",2,2,0,167900,1718.5,97.5
"2869","11217","2014",8,8,0,187656.25,1643.75,120.75
"2870","11218","2014",1,1,0,138000,587,235
"2871","11219","2014",1,1,0,135000,1406,96
"2872","11220","2014",10,8,2,102046,1330.3,83.3
"2873","11221","2014",1,1,0,120000,1188,101
"2874","11222","2014",2,2,0,49500,825,60
"2875","11224","2014",2,2,0,64650,600.5,99
"2876","11225","2014",7,7,0,181178.571428571,1380.57142857143,104.428571428571
"2877","11231","2014",2,2,0,159660,1354.5,172.5
"2878","11232","2014",2,2,0,53000,727,68
"2879","11233","2014",10,10,0,145312.6,1599.5,84.8
"2880","11234","2014",1,1,0,168000,949,177
"2881","11236","2014",1,1,0,80000,1039,77
"2882","11238","2014",2,2,0,196000,1553.5,121.5
"2883","11240","2014",7,7,0,137547.428571429,1373.14285714286,113.571428571429
"2884","11241","2014",7,7,0,137492.857142857,1923,84.2857142857143
"2885","11242","2014",1,1,0,218000,1817,120
"2886","11243","2014",12,12,0,202674.916666667,1384.58333333333,153.083333333333
"2887","11244","2014",3,3,0,29500,511.666666666667,60.3333333333333
"2888","11249","2014",1,1,0,130000,1857,70
"2889","11251","2014",4,4,0,89375,889.25,98.25
"2890","11252","2014",2,2,0,330900,1640.5,198.5
"2891","11253","2014",17,17,0,112701.470588235,1340.52941176471,88.1176470588235
"2892","11254","2014",21,21,0,92300,1247.09523809524,78.5238095238095
"2893","11255","2014",15,14,1,156286.666666667,1587.93333333333,100.266666666667
"2894","11256","2014",6,6,0,164258.333333333,1375.66666666667,110.5
"2895","11257","2014",4,3,1,113750,1209.5,84.25
"2896","11258","2014",11,11,0,203609.090909091,2034.36363636364,97.6363636363636
"2897","11259","2014",8,8,0,147437.5,1345.25,107.125
"2898","11260","2014",1,1,0,28500,712,40
"2899","11261","2014",7,7,0,136415.714285714,1500.42857142857,92.4285714285714
"2900","11262","2014",737,306,431,141056.170963365,2063.43012211669,69.8113975576662
"2901","11263","2014",6,6,0,113500,1150.66666666667,105.666666666667
"2902","11264","2014",14,13,1,183202.142857143,1774.35714285714,103.785714285714
"2903","11266","2014",129,61,68,106627.209302326,2197.22480620155,51.3178294573643
"2904","11267","2014",10,10,0,140972,1479.2,99.2
"2905","11268","2014",1,1,0,1e+05,990,101
"2906","11269","2014",18,16,2,129983.5,1297.11111111111,98.4444444444444
"2907","11270","2014",3,3,0,64500,899.666666666667,79
"2908","11271","2014",1,1,0,99300,782,127
"2909","11272","2014",16,16,0,188377.3125,1641.1875,114.6875
"2910","11273","2014",13,12,1,166219.692307692,1471.46153846154,122.384615384615
"2911","11274","2014",2,2,0,241000,2004.5,103.5
"2912","11275","2014",2,2,0,105000,760,148.5
"2913","11276","2014",9,8,1,109111.111111111,1429,71.4444444444444
"2914","11278","2014",1,1,0,240000,1326,181
"2915","11279","2014",21,20,1,121915.714285714,1235.42857142857,99.9047619047619
"2916","11280","2014",16,15,1,127734.0625,989.75,130
"2917","11281","2014",19,19,0,96224.2105263158,1034.47368421053,98.4210526315789
"2918","11282","2014",1,1,0,40000,667,60
"2919","11283","2014",1,1,0,150000,1667,90
"2920","11284","2014",4,4,0,157125,1614.25,98.75
"2921","11285","2014",15,13,2,210543.333333333,2133.86666666667,95.8
"2922","11286","2014",14,14,0,128385.714285714,1308.57142857143,90.0714285714286
"2923","11288","2014",14,14,0,146879.357142857,1583.21428571429,95.5714285714286
"2924","11289","2014",7,7,0,151755.714285714,1721.28571428571,107.428571428571
"2925","11290","2014",1,1,0,159000,1019,156
"2926","11292","2014",3,3,0,195666.666666667,1412,146
"2927","11293","2014",5,5,0,132100,1596.8,83.6
"2928","11295","2014",18,15,3,135881.666666667,1417.11111111111,98.3888888888889
"2929","11296","2014",8,8,0,154913.25,2149.375,70.5
"2930","11297","2014",4,4,0,115937.5,1127.75,107.75
"2931","11299","2014",5,5,0,133800,1232.6,101
"2932","11300","2014",2,2,0,95000,755.5,125
"2933","11301","2014",12,12,0,126732.5,1406.66666666667,98.4166666666667
"2934","11302","2014",6,6,0,112833.333333333,1329.16666666667,94.6666666666667
"2935","11303","2014",14,14,0,119882.928571429,1144.35714285714,108.357142857143
"2936","11304","2014",37,32,5,110451.351351351,1257.32432432432,90.945945945946
"2937","11305","2014",2,2,0,51050,1021,50
"2938","11306","2014",2,2,0,95000,969,94
"2939","11307","2014",1,1,0,121000,2420,50
"2940","11308","2014",3,3,0,116333.333333333,1429,80.3333333333333
"2941","11310","2014",6,4,2,98878.3333333333,1291.83333333333,116.833333333333
"2942","11311","2014",2,2,0,125450,1500,91
"2943","11312","2014",1,1,0,104600,1291,81
"2944","11313","2014",4,4,0,139750,1314.25,106
"2945","11314","2014",3,3,0,86000,905,107.333333333333
"2946","11315","2014",20,20,0,103997.25,1169.9,87.65
"2947","11316","2014",2,2,0,122500,913,133
"2948","11318","2014",1,1,0,34000,596,57
"2949","11319","2014",1,1,0,119000,2975,40
"2950","11320","2014",1,1,0,62000,827,75
"2951","11321","2014",5,5,0,70800,760.4,95.8
"2952","11322","2014",14,14,0,96255,1160.07142857143,98
"2953","11323","2014",1,1,0,160000,1404,114
"2954","11324","2014",3,3,0,151328.666666667,1724.33333333333,78.3333333333333
"2955","11325","2014",1,1,0,113000,831,136
"2956","11326","2014",2,2,0,56000,813,65
"2957","11327","2014",4,4,0,319790,2034.25,138.5
"2958","11328","2014",2,2,0,59500,554,109.5
"2959","11330","2014",2,1,1,32985,816,40
"2960","11332","2014",11,11,0,175752.090909091,1836.54545454545,106.909090909091
"2961","11333","2014",1,1,0,82000,2343,35
"2962","11334","2014",1,1,0,143800,1453,99
"2963","11335","2014",2,2,0,30000,874,36.5
"2964","11336","2014",13,13,0,112196.153846154,877.230769230769,122.769230769231
"2965","11337","2014",7,7,0,79341.7142857143,1135.57142857143,72
"2966","11339","2014",6,6,0,107750,1683,68.5
"2967","11340","2014",2,2,0,180500,2050,105
"2968","11341","2014",1,1,0,525000,2100,250
"2969","11342","2014",5,5,0,97500,1069.6,89.6
"2970","11343","2014",3,3,0,209000,1818.66666666667,110.333333333333
"2971","11344","2014",13,13,0,132823.076923077,1419.15384615385,89.2307692307692
"2972","11345","2014",4,4,0,75150,921,82
"2973","11347","2014",1,1,0,110000,846,130
"2974","11350","2014",1,1,0,160000,1013,158
"2975","11351","2014",9,9,0,67438.8888888889,915.888888888889,75.4444444444444
"2976","11353","2014",25,24,1,163832.44,1654.56,101.92
"2977","11354","2014",2,2,0,39250,1175,33.5
"2978","11355","2014",3,3,0,141666.666666667,1203.66666666667,97
"2979","11356","2014",7,7,0,145831.428571429,1456.42857142857,95.4285714285714
"2980","11357","2014",3,3,0,106000,1191.66666666667,100.666666666667
"2981","11358","2014",1,1,0,57600,640,90
"2982","11359","2014",10,9,1,177539.5,1935.9,97.4
"2983","11360","2014",29,29,0,191264.931034483,1849.62068965517,103.689655172414
"2984","11361","2014",12,12,0,137504.166666667,1218.33333333333,109.083333333333
"2985","11362","2014",2,2,0,149000,1417,107
"2986","11363","2014",4,4,0,228529.25,2281,100.75
"2987","11364","2014",2,2,0,1e+05,622,165.5
"2988","11366","2014",8,8,0,195837.5,1752.625,126.875
"2989","11367","2014",4,4,0,80260,830.25,105.5
"2990","11368","2014",1,1,0,81500,799,102
"2991","11369","2014",26,23,3,154458.461538462,2044.73076923077,84.5769230769231
"2992","11370","2014",38,33,5,153251.894736842,1733.21052631579,91.7894736842105
"2993","11371","2014",9,9,0,123652.222222222,1330.33333333333,96.4444444444444
"2994","11372","2014",6,6,0,75839.3333333333,986,87
"2995","11373","2014",2,2,0,52325,872,59
"2996","11376","2014",2,2,0,132500,1055.5,125.5
"2997","11378","2014",1,1,0,159000,1272,125
"2998","11379","2014",55,49,6,142974.727272727,1588.03636363636,91.8181818181818
"2999","11382","2014",5,5,0,143200,1545,95.4
"3000","11383","2014",1,1,0,182900,1604,114
"3001","11385","2014",7,7,0,115800,1296.14285714286,82.4285714285714
"3002","11386","2014",4,4,0,98625,946.25,98.75
"3003","11387","2014",2,2,0,106250,872,154.5
"3004","11388","2014",1,1,0,60000,923,65
"3005","11389","2014",1,1,0,30000,417,72
"3006","11390","2014",11,10,1,104640.909090909,1147.90909090909,101.818181818182
"3007","11392","2014",5,5,0,134224,1293.4,97.4
"3008","11393","2014",7,7,0,128000,1270.57142857143,106.142857142857
"3009","11394","2014",1,1,0,85000,1181,72
"3010","11395","2014",1,1,0,95000,1284,74
"3011","11396","2014",8,8,0,126750,1256,94
"3012","11397","2014",68,61,7,105531.661764706,1235.92647058824,85.1911764705882
"3013","11398","2014",3,3,0,137986.666666667,1253.33333333333,112.333333333333
"3014","11400","2014",2,2,0,60000,743,79
"3015","11401","2014",14,14,0,105067.285714286,1108.64285714286,89.9285714285714
"3016","11404","2014",10,10,0,214470,2002.7,110.5
"3017","11405","2014",8,8,0,181709.375,1750.375,101.75
"3018","11406","2014",2,2,0,177500,1378.5,126.5
"3019","11407","2014",3,3,0,128166.666666667,1476.33333333333,88
"3020","11408","2014",1,1,0,90000,709,127
"3021","11409","2014",1,1,0,29000,341,85
"3022","11410","2014",18,18,0,101150,1104.38888888889,90.1111111111111
"3023","11411","2014",2,2,0,53000,714,81
"3024","11413","2014",7,7,0,69642.8571428571,964.285714285714,72.2857142857143
"3025","11415","2014",2,2,0,163000,1023.5,170
"3026","11416","2014",1,1,0,30000,417,72
"3027","11417","2014",2,2,0,94000,1089.5,76
"3028","11418","2014",5,5,0,102000,1006.8,120.4
"3029","11420","2014",1,1,0,67000,558,120
"3030","11421","2014",4,4,0,119375,1540.75,86.75
"3031","11422","2014",6,6,0,177041.666666667,1554.83333333333,108
"3032","11423","2014",1,1,0,25000,431,58
"3033","11425","2014",15,15,0,129614,1483.46666666667,89.6666666666667
"3034","11426","2014",1,1,0,75000,735,102
"3035","11427","2014",7,7,0,156488.571428571,1410.14285714286,101.428571428571
"3036","11428","2014",4,4,0,124508.75,1568.75,98.5
"3037","11429","2014",45,36,9,134588.888888889,1384,94.1777777777778
"3038","11430","2014",9,9,0,140311.111111111,1434.22222222222,96.2222222222222
"3039","11431","2014",2,2,0,185500,1647,104
"3040","11432","2014",2,2,0,81500,1045,80
"3041","11433","2014",6,6,0,153916.666666667,1175,111
"3042","11434","2014",7,6,1,103000,1265.14285714286,82.8571428571429
"3043","11436","2014",5,4,1,75600,742.2,115.2
"3044","11437","2014",6,6,0,154980,1452,100.5
"3045","11438","2014",5,5,0,160880,1688.2,101.6
"3046","11439","2014",9,9,0,82850,860.555555555556,107.555555555556
"3047","11441","2014",19,18,1,189858.947368421,2077.36842105263,92.0526315789474
"3048","12001","2014",6,6,0,190516.666666667,1663.33333333333,116.333333333333
"3049","12002","2014",9,7,2,120888.888888889,1407.22222222222,90.1111111111111
"3050","12004","2014",2,2,0,125000,1466.5,82
"3051","12006","2014",1,0,1,80000,816,98
"3052","12007","2014",1,1,0,94000,2043,46
"3053","12008","2014",7,7,0,88184.2857142857,971.714285714286,88.4285714285714
"3054","12011","2014",3,3,0,139550,2126.66666666667,59.3333333333333
"3055","12012","2014",7,7,0,130370,1510.71428571429,100
"3056","12013","2014",25,23,2,77488.8,972.32,77.68
"3057","12016","2014",8,8,0,104368.75,1092.75,108.125
"3058","12017","2014",4,4,0,67375,889.25,79
"3059","12018","2014",1,1,0,125000,1250,100
"3060","12019","2014",1,1,0,285000,3608,79
"3061","12021","2014",11,11,0,118235.454545455,1252.72727272727,107.272727272727
"3062","12023","2014",1,1,0,42000,1077,39
"3063","12024","2014",1,1,0,186000,2447,76
"3064","12025","2014",1,1,0,152800,1252,122
"3065","12026","2014",8,8,0,167312.5,1787.25,98.375
"3066","12027","2014",1,1,0,55000,917,60
"3067","12028","2014",4,4,0,79300,848.75,86.75
"3068","12030","2014",5,5,0,51609.2,854.8,62.4
"3069","12031","2014",2,2,0,181000,1828.5,92
"3070","12032","2014",3,3,0,150299.333333333,1521,99
"3071","12033","2014",14,10,4,133365,1434.28571428571,95.7142857142857
"3072","12034","2014",1,1,0,166100,989,168
"3073","12036","2014",3,3,0,77666.6666666667,807.333333333333,109
"3074","12037","2014",7,7,0,104800,1202.85714285714,82.5714285714286
"3075","12038","2014",2,2,0,55000,884.5,62.5
"3076","12039","2014",2,2,0,105000,1250,82.5
"3077","12042","2014",4,3,1,80125,796.75,101
"3078","12043","2014",9,8,1,198941.111111111,1867.22222222222,107.111111111111
"3079","12044","2014",4,4,0,140860.25,1163,121
"3080","12045","2014",2,2,0,83000,1683,47.5
"3081","12046","2014",1,1,0,80550,474,170
"3082","12047","2014",5,4,1,65800,950.8,70.6
"3083","12048","2014",2,2,0,75000,659,103
"3084","12049","2014",1,1,0,142000,1578,90
"3085","12050","2014",5,5,0,87666,976.6,98
"3086","12051","2014",2,2,0,69000,1004,75
"3087","12052","2014",35,28,7,90644.2857142857,1084.97142857143,85.3428571428571
"3088","12053","2014",1,1,0,91000,1596,57
"3089","12055","2014",1,1,0,2e+05,1333,150
"3090","12056","2014",24,18,6,135436.041666667,1541.625,90.0833333333333
"3091","12057","2014",5,5,0,79026.8,1189,66.4
"3092","12059","2014",1,1,0,107500,1075,100
"3093","12061","2014",6,6,0,71300,992.5,78.3333333333333
"3094","12062","2014",1,0,1,45000,938,48
"3095","12063","2014",11,10,1,118650.909090909,1254.54545454545,94
"3096","12064","2014",6,6,0,116609.333333333,1338.83333333333,86.1666666666667
"3097","12065","2014",2,2,0,56500,652.5,87
"3098","12066","2014",2,2,0,196500,1931.5,103.5
"3099","12067","2014",3,3,0,72768.3333333333,909,74
"3100","12068","2014",6,6,0,97470,1310.83333333333,79.8333333333333
"3101","12069","2014",1,1,0,1e+05,855,117
"3102","12070","2014",3,3,0,195000,1854.66666666667,100
"3103","12071","2014",5,5,0,173295,1045.4,132.2
"3104","12072","2014",4,4,0,177790,1754.25,95.25
"3105","12073","2014",1,1,0,52600,751,70
"3106","12074","2014",1,1,0,130000,1857,70
"3107","12076","2014",11,11,0,113884.545454545,1570.72727272727,81.6363636363636
"3108","12077","2014",7,7,0,72479.7142857143,831.714285714286,92.8571428571429
"3109","12078","2014",3,3,0,87000,1145.66666666667,66
"3110","12079","2014",1,1,0,150000,1210,124
"3111","12080","2014",3,3,0,133333.333333333,1145.33333333333,113
"3112","12082","2014",7,7,0,114571.428571429,1400.42857142857,89.2857142857143
"3113","12083","2014",10,9,1,70414,883.1,83.4
"3114","12084","2014",8,6,2,169455,1741.25,96
"3115","12085","2014",2,2,0,77500,663,119.5
"3116","12086","2014",4,4,0,190616.25,1500.75,137.5
"3117","12088","2014",2,2,0,33179.5,1194.5,42
"3118","12089","2014",31,26,5,81391.935483871,1031.51612903226,87.258064516129
"3119","12090","2014",40,40,0,164090.65,1712.4,96.95
"3120","12091","2014",5,5,0,115440,1254.4,96.2
"3121","12092","2014",2,2,0,51500,645.5,75.5
"3122","12094","2014",8,7,1,115112.5,1975.625,81
"3123","12095","2014",1,1,0,102857,1029,100
"3124","12096","2014",42,23,19,102887.261904762,1252.14285714286,83.5238095238095
"3125","12097","2014",1,1,0,135000,1350,100
"3126","12098","2014",6,6,0,109916.666666667,1299.66666666667,76.3333333333333
"3127","12099","2014",3,2,1,49833.3333333333,749.333333333333,73.3333333333333
"3128","12100","2014",21,18,3,99919.0476190476,1152.42857142857,82.0476190476191
"3129","12101","2014",6,6,0,136168.333333333,1127.16666666667,120.166666666667
"3130","12102","2014",10,8,2,120192,1664.4,69.3
"3131","12103","2014",2,2,0,134500,744,163
"3132","12104","2014",2,2,0,58000,771,76
"3133","12105","2014",8,8,0,110500,1465.25,79.5
"3134","12106","2014",1,1,0,177500,924,192
"3135","12107","2014",1,1,0,110000,1571,70
"3136","12108","2014",2,2,0,175392.5,1146.5,145
"3137","12109","2014",4,4,0,175150,1330.25,96
"3138","12110","2014",1,1,0,85000,1700,50
"3139","12111","2014",3,3,0,141250,1567.66666666667,101.666666666667
"3140","12113","2014",3,1,2,90600,922.666666666667,98.6666666666667
"3141","12115","2014",4,4,0,97375,1185.25,85.5
"3142","12116","2014",1,1,0,72000,1412,51
"3143","12118","2014",4,4,0,113000,1674.25,68
"3144","12119","2014",14,6,8,72565.5,1195.35714285714,54.9285714285714
"3145","12120","2014",10,7,3,128840,1411.2,93
"3146","12121","2014",4,3,1,74955,809.5,114
"3147","12122","2014",1,1,0,4e+05,5000,80
"3148","12124","2014",3,3,0,167616.666666667,1467.33333333333,123.333333333333
"3149","12125","2014",4,4,0,33000,581.5,61
"3150","12127","2014",3,3,0,67666.6666666667,1650,51.6666666666667
"3151","12128","2014",2,2,0,142500,1812,79
"3152","12129","2014",2,2,0,58900,1342.5,42
"3153","12130","2014",9,9,0,55767,810.444444444444,67.7777777777778
"3154","12131","2014",6,6,0,203975,1835.5,109.833333333333
"3155","12133","2014",46,33,13,148226.043478261,1735,86.4130434782609
"3156","12134","2014",2,2,0,45000,478,91.5
"3157","12135","2014",5,5,0,155140,1458,112.2
"3158","12136","2014",6,6,0,117250,1180.33333333333,108
"3159","12137","2014",4,4,0,150790.25,1408,107
"3160","12138","2014",15,13,2,132560,2069.4,82.2666666666667
"3161","12139","2014",4,4,0,78730,1350.75,63.75
"3162","12140","2014",7,7,0,115057.142857143,1301.14285714286,87
"3163","12141","2014",2,2,0,63000,1192,53
"3164","12142","2014",3,3,0,131166.666666667,1222.66666666667,110.333333333333
"3165","12144","2014",1,1,0,1e+05,1667,60
"3166","12145","2014",198,80,118,115670.565656566,1422.20202020202,80.7222222222222
"3167","12146","2014",25,11,14,141862.48,1612.56,89.12
"3168","12147","2014",1,1,0,18000,360,50
"3169","12148","2014",10,9,1,99910,1600.9,65.1
"3170","12149","2014",1,1,0,150000,1500,100
"3171","12150","2014",6,6,0,88980,924.833333333333,93.5
"3172","12153","2014",4,4,0,128250,1490.25,85.75
"3173","12154","2014",1,1,0,90000,2000,45
"3174","12155","2014",3,3,0,88166.6666666667,1006.33333333333,87.6666666666667
"3175","12156","2014",1,1,0,23000,348,66
"3176","12157","2014",5,5,0,105920,1097.6,106.2
"3177","12158","2014",1,1,0,220000,1467,150
"3178","12159","2014",2,2,0,83500,983.5,85.5
"3179","12160","2014",2,2,0,105500,1029.5,102
"3180","12161","2014",4,4,0,84750,1462.5,58
"3181","12162","2014",3,3,0,105300,1241.33333333333,79
"3182","12163","2014",4,4,0,153000,3924.75,77.75
"3183","12164","2014",5,4,1,107566,860.6,118.4
"3184","12165","2014",3,3,0,46666.6666666667,802.666666666667,70.3333333333333
"3185","12167","2014",15,15,0,135144.2,1672.26666666667,81.0666666666667
"3186","12168","2014",10,10,0,110850,1305,85.2
"3187","12169","2014",13,13,0,124735.538461538,1337.69230769231,97.3076923076923
"3188","12170","2014",1,1,0,160000,1203,133
"3189","12171","2014",3,3,0,137233.333333333,1217,107.666666666667
"3190","12172","2014",4,4,0,115500,1199.75,98.25
"3191","12174","2014",41,30,11,155139.707317073,1783.70731707317,92.0487804878049
"3192","12176","2014",132,44,88,135186.333333333,1729.82575757576,78.6742424242424
"3193","12177","2014",7,7,0,79914.2857142857,1018.71428571429,75.8571428571429
"3194","12178","2014",2,2,0,190000,1586,126.5
"3195","12179","2014",3,3,0,34000,731,52.3333333333333
"3196","12180","2014",2,2,0,310000,6396,79.5
"3197","12181","2014",1,1,0,85000,559,152
"3198","12183","2014",2,2,0,56500,845.5,68.5
"3199","12184","2014",1,1,0,76000,1101,69
"3200","12185","2014",7,7,0,151592.857142857,1379.14285714286,107.142857142857
"3201","12186","2014",1,1,0,81000,900,90
"3202","12187","2014",3,2,1,41666.6666666667,801.333333333333,54.6666666666667
"3203","12188","2014",3,3,0,86833.3333333333,974.333333333333,106.666666666667
"3204","12189","2014",2,2,0,187500,1400.5,133.5
"3205","12190","2014",5,5,0,85400,1225.8,78
"3206","12191","2014",8,8,0,118295.375,1052.75,107.375
"3207","12192","2014",2,2,0,70000,641,110
"3208","12193","2014",2,2,0,111390,1026,116.5
"3209","12194","2014",4,4,0,223625,1317.75,178
"3210","12195","2014",1,1,0,60000,923,65
"3211","12197","2014",12,12,0,74766.6666666667,1114.5,68
"3212","12198","2014",10,8,2,107449.6,1298.8,92.5
"3213","12199","2014",18,12,6,121676.666666667,1393.94444444444,88
"3214","12200","2014",7,7,0,108446.428571429,1495.42857142857,78.8571428571429
"3215","12201","2014",9,9,0,167744.444444444,1530.22222222222,107.333333333333
"3216","12202","2014",393,51,342,97597.6259541985,1437.92875318066,67.2595419847328
"3217","12204","2014",3,3,0,94146.6666666667,954.666666666667,99.6666666666667
"3218","12205","2014",5,5,0,135150,1287,100
"3219","12206","2014",5,5,0,112180,975.6,112.2
"3220","12208","2014",88,56,32,115771.363636364,1455.65909090909,84.1022727272727
"3221","12209","2014",10,10,0,91362,1096.5,86.6
"3222","12210","2014",6,6,0,157583.333333333,1767.83333333333,99.6666666666667
"3223","12212","2014",2,2,0,176430,1449,129
"3224","12213","2014",7,7,0,133714.285714286,1316.14285714286,103.571428571429
"3225","12214","2014",2,2,0,87500,1115,75
"3226","12215","2014",8,8,0,137812.5,1507.875,92.5
"3227","12216","2014",13,11,2,115103.846153846,1385.38461538462,77.7692307692308
"3228","12217","2014",1,1,0,170000,1589,107
"3229","12219","2014",2,2,0,36000,814.5,42.5
"3230","12220","2014",3,3,0,91176.3333333333,1252,71.3333333333333
"3231","12222","2014",1,1,0,32600,408,80
"3232","12223","2014",8,8,0,81453.125,772.625,107.5
"3233","12224","2014",28,22,6,82265.3571428571,1127.28571428571,78.9285714285714
"3234","12225","2014",9,9,0,123911.111111111,1296.33333333333,102
"3235","12226","2014",8,8,0,108504.375,1333.375,84.25
"3236","12227","2014",1,1,0,197500,1299,152
"3237","12228","2014",4,4,0,121026,1032.5,113.5
"3238","12229","2014",2,2,0,95555,1298.5,73.5
"3239","12230","2014",3,3,0,130333.333333333,1079.66666666667,118.666666666667
"3240","12231","2014",11,9,2,57169.1818181818,974.181818181818,59.2727272727273
"3241","12232","2014",1,1,0,97000,1516,64
"3242","12233","2014",2,2,0,103620,883.5,126
"3243","12234","2014",5,5,0,94196.4,1194.6,75.4
"3244","12235","2014",1,1,0,97000,647,150
"3245","12236","2014",1,1,0,150000,2000,75
"3246","12237","2014",7,7,0,116928.571428571,1294.71428571429,92.1428571428571
"3247","12238","2014",2,2,0,254000,2543.5,103.5
"3248","12239","2014",2,2,0,61900,778.5,84.5
"3249","12240","2014",2,2,0,59050,561.5,107
"3250","12241","2014",12,9,3,220629.166666667,1955.16666666667,117.166666666667
"3251","12242","2014",1,1,0,90000,1286,70
"3252","12243","2014",9,8,1,119255.555555556,1269.77777777778,90.8888888888889
"3253","12244","2014",4,4,0,171600,1519.75,106.25
"3254","12246","2014",3,3,0,109866.666666667,1124.33333333333,98.3333333333333
"3255","12247","2014",1,1,0,59000,1405,42
"3256","12248","2014",3,3,0,159500,1403.33333333333,131.666666666667
"3257","12249","2014",4,4,0,63500,857.75,71
"3258","12250","2014",1,1,0,70000,1000,70
"3259","12251","2014",4,4,0,80912.5,939.25,84
"3260","12252","2014",2,2,0,127500,1322.5,100
"3261","12253","2014",10,7,3,66500,1032.7,65.9
"3262","12254","2014",15,15,0,168656.066666667,1535.86666666667,109.733333333333
"3263","12255","2014",10,9,1,135445,1310,117.6
"3264","12256","2014",7,7,0,123142.857142857,1442.71428571429,87.8571428571429
"3265","12257","2014",2,2,0,215425,2299.5,96
"3266","12258","2014",7,7,0,83575.7142857143,1461.57142857143,77
"3267","12259","2014",4,4,0,121762.5,1482,78.75
"3268","12260","2014",2,2,0,55500,822,74.5
"3269","12262","2014",5,4,1,143454,2507.8,67.6
"3270","12263","2014",4,4,0,135500,1310.25,104.25
"3271","12264","2014",24,21,3,153353.75,1714.54166666667,88.5416666666667
"3272","12265","2014",2,2,0,108839.5,867.5,97.5
"3273","12266","2014",3,3,0,88733.3333333333,2320.33333333333,60
"3274","12267","2014",6,4,2,104336.5,1173.5,96.5
"3275","12270","2014",36,34,2,126145.416666667,1369.52777777778,92.7222222222222
"3276","12272","2014",1,1,0,59000,656,90
"3277","12274","2014",1,1,0,48500,851,57
"3278","12276","2014",2,2,0,124500,1083,110.5
"3279","12277","2014",4,4,0,132500,1349.75,94.75
"3280","12278","2014",3,3,0,90000,924.333333333333,102.333333333333
"3281","12280","2014",3,3,0,99666.6666666667,989.666666666667,100.666666666667
"3282","12281","2014",1,1,0,159000,1293,123
"3283","12282","2014",2,2,0,102000,1234.5,95.5
"3284","12283","2014",4,4,0,108800,1090,98
"3285","12284","2014",3,3,0,100833.333333333,1410.66666666667,94
"3286","12286","2014",9,9,0,101533.333333333,1167.77777777778,87.3333333333333
"3287","12287","2014",5,5,0,103626,1333.2,87.4
"3288","12288","2014",14,14,0,142317.5,1641.85714285714,86
"3289","12290","2014",1,1,0,183800,1935,95
"3290","12292","2014",1,1,0,218500,1181,185
"3291","12294","2014",5,5,0,105452,1064.6,102
"3292","12295","2014",1,1,0,295000,983,300
"3293","12296","2014",10,10,0,88470,1388.8,66.8
"3294","12297","2014",6,6,0,81200,1032.5,82.3333333333333
"3295","12298","2014",2,2,0,88500,910,119
"3296","12299","2014",8,7,1,79500,1068.125,75.5
"3297","12300","2014",93,62,31,106035.11827957,1328.12903225806,84.1720430107527
"3298","12301","2014",12,12,0,149500,1652.5,96.4166666666667
"3299","12303","2014",3,3,0,123353.333333333,1030.66666666667,123
"3300","12305","2014",8,7,1,46131.25,676.5,69.375
"3301","12307","2014",2,2,0,93500,1306.5,70.5
"3302","13001","2014",1610,231,1379,248992.450931677,4008.42049689441,62.4167701863354
"3303","13002","2014",41,30,11,296770.585365854,3516.09756097561,86.4146341463415
"3304","13003","2014",21,20,1,221645.238095238,2711.71428571429,88.1428571428571
"3305","13004","2014",398,262,136,172911.283919598,2274.37688442211,77.8140703517588
"3306","13005","2014",334,112,222,223332.751497006,2953.35329341317,75.1137724550898
"3307","13006","2014",12,11,1,261076.5,2652.66666666667,96.25
"3308","13007","2014",85,63,22,271025.564705882,3052.8,88.4941176470588
"3309","13008","2014",6,6,0,362233.333333333,3514.33333333333,104.666666666667
"3310","13009","2014",5,5,0,505600,3561,145.8
"3311","13010","2014",26,24,2,168208.461538462,2027.30769230769,83
"3312","13011","2014",3,3,0,834766.666666667,4490.33333333333,175
"3313","13013","2014",11,10,1,381842.636363636,3439.27272727273,115.545454545455
"3314","13014","2014",57,33,24,186477.192982456,2293.28070175439,80.2105263157895
"3315","13015","2014",84,64,20,388179.571428571,3950.72619047619,100.261904761905
"3316","13016","2014",48,40,8,282852.583333333,3300.5625,91
"3317","13017","2014",7,7,0,185614.285714286,1988.71428571429,92
"3318","13018","2014",3,3,0,377933.333333333,3632.66666666667,122.666666666667
"3319","13019","2014",84,67,17,374642.630952381,3766.44047619048,100.607142857143
"3320","13020","2014",19,16,3,249143.157894737,3011.89473684211,84.1052631578947
"3321","13021","2014",59,30,29,386198.13559322,4883.59322033898,83.0677966101695
"3322","13022","2014",103,21,82,383317,5051.88349514563,72.6019417475728
"3323","13023","2014",41,28,13,346836.926829268,3635.41463414634,92.7560975609756
"3324","13024","2014",26,20,6,229978.076923077,2211.53846153846,104.846153846154
"3325","13025","2014",15,13,2,392409.333333333,3441.93333333333,116.2
"3326","13026","2014",107,61,46,218281.158878505,3176.27102803738,73.8878504672897
"3327","13027","2014",121,75,46,179031.603305785,2171.28925619835,82.0082644628099
"3328","13028","2014",464,112,352,236949.467672414,3838.51939655172,62.1206896551724
"3329","13029","2014",7,7,0,352600,3188.71428571429,106.285714285714
"3330","13030","2014",41,25,16,253934.146341463,3016.90243902439,83.0731707317073
"3331","13031","2014",27,18,9,287677.777777778,3628.44444444444,80.1851851851852
"3332","13032","2014",63,45,18,467227.920634921,4047.03174603175,115.126984126984
"3333","13033","2014",42,33,9,343238.119047619,3752.33333333333,93.9047619047619
"3334","13034","2014",13,13,0,1011480,5674.92307692308,171.769230769231
"3335","13035","2014",52,39,13,227333.865384615,3323.88461538462,71.4807692307692
"3336","13036","2014",38,33,5,266293.842105263,2591.84210526316,107.210526315789
"3337","13037","2014",57,48,9,258856.228070175,3117.91228070175,84.2280701754386
"3338","13038","2014",28,24,4,256713.75,3035.89285714286,91.2142857142857
"3339","13039","2014",132,91,41,221648.545454545,2818.91666666667,81.3030303030303
"3340","13040","2014",79,63,16,307093.898734177,3422.53164556962,91.1139240506329
"3341","13041","2014",137,63,74,206642.102189781,2933.62773722628,71.4890510948905
"3342","13042","2014",42,28,14,414493.047619048,3992.80952380952,106.97619047619
"3343","13043","2014",61,41,20,247366.114754098,3143.80327868852,82.1147540983606
"3344","13044","2014",45,38,7,313920.6,3123.93333333333,102.088888888889
"3345","13045","2014",31,28,3,203963.774193548,2542,82
"3346","13046","2014",27,23,4,312415.925925926,3522.07407407407,92.4444444444444
"3347","13047","2014",324,208,116,208687.861111111,2602.11111111111,81.4938271604938
"3348","13048","2014",31,30,1,292756.129032258,3208.03225806452,94.2903225806452
"3349","13049","2014",12,10,2,268621,3282.25,82.4166666666667
"3350","13050","2014",83,57,26,266099.096385542,3208.15662650602,85.0361445783133
"3351","13051","2014",76,65,11,281667.039473684,3013.53947368421,96.7894736842105
"3352","13052","2014",14,14,0,343196.428571429,3004.64285714286,118.642857142857
"3353","13053","2014",60,48,12,258858.95,3132.3,88.0333333333333
"3354","13054","2014",276,93,183,188550.362318841,2510.90942028986,76.6159420289855
"3355","13055","2014",8219,1147,7072,178254.662611023,2667.45419150748,65.1990509794379
"3356","13056","2014",371,149,222,215411.28032345,2891.45283018868,76.7493261455526
"3357","13057","2014",3,3,0,282536.666666667,2764.33333333333,103
"3358","13058","2014",28,25,3,450153.857142857,4120.85714285714,107.464285714286
"3359","13059","2014",37,26,11,234266.648648649,2593.48648648649,89.1621621621622
"3360","13060","2014",44,35,9,352936.136363636,3591.68181818182,102.409090909091
"3361","13062","2014",28,27,1,390561.714285714,3432.5,113.142857142857
"3362","13063","2014",157,89,68,173887.700636943,2206.15286624204,81.0445859872611
"3363","13064","2014",11,11,0,288096.363636364,2936.36363636364,95.7272727272727
"3364","13065","2014",27,26,1,322366.333333333,3062.85185185185,101.518518518519
"3365","13066","2014",3,3,0,202166.666666667,1992,102
"3366","13067","2014",17,15,2,174147.176470588,2097.23529411765,87.1176470588235
"3367","13068","2014",33,32,1,547477.272727273,3803.9696969697,134.333333333333
"3368","13069","2014",92,77,15,255111.163043478,2815.36956521739,91.8369565217391
"3369","13070","2014",45,23,22,237124.444444444,3128.93333333333,76.4888888888889
"3370","13071","2014",131,98,33,251810.152671756,3190.12213740458,81.6793893129771
"3371","13072","2014",19,17,2,290589.473684211,2732.78947368421,105.789473684211
"3372","13073","2014",51,44,7,266982.058823529,3382.88235294118,81.7450980392157
"3373","13074","2014",42,24,18,240190.761904762,2736.5,86.9761904761905
"3374","13075","2014",83,42,41,259671.939759036,3262.49397590361,80.7831325301205
"3375","13076","2014",18,16,2,259555.555555556,2642.11111111111,101.277777777778
"3376","13077","2014",94,40,54,167655.627659574,2226.58510638298,76.1170212765958
"3377","13078","2014",40,23,17,163834.25,2422.95,70.075
"3378","13079","2014",13,12,1,324624.769230769,3192.23076923077,97.6923076923077
"3379","13080","2014",43,27,16,295653.674418605,3104.11627906977,91.8139534883721
"3380","13081","2014",114,81,33,257209.657894737,2915.36842105263,90.2368421052632
"3381","13082","2014",22,17,5,341257.727272727,3156.09090909091,106.636363636364
"3382","13083","2014",26,25,1,231656.461538462,2337.03846153846,98.2692307692308
"3383","13084","2014",27,25,2,234395.555555556,2660.03703703704,90.2962962962963
"3384","13085","2014",42,27,15,308158.80952381,3313.47619047619,93.5
"3385","13086","2014",51,27,24,281162.62745098,3355.80392156863,87.0196078431373
"3386","13087","2014",35,25,10,276333.714285714,3344.54285714286,82.9142857142857
"3387","13088","2014",28,24,4,284857.142857143,3142.32142857143,90.8928571428571
"3388","13089","2014",18,15,3,199361.388888889,2235.94444444444,88.1666666666667
"3389","13091","2014",44,37,7,335581.227272727,3359.52272727273,100.954545454545
"3390","13092","2014",73,44,29,202321.068493151,2542.72602739726,80.3698630136986
"3391","13093","2014",3,3,0,106550,1784,59
"3392","13094","2014",27,18,9,250224.444444444,2494.2962962963,104.666666666667
"3393","13095","2014",10,7,3,735183.5,5236,134.7
"3394","13096","2014",57,22,35,191638,3524.49122807018,58.0701754385965
"3395","13097","2014",84,66,18,226502.202380952,2482.78571428571,93.2142857142857
"3396","13098","2014",52,46,6,234507.615384615,3056.09615384615,80.7115384615385
"3397","13099","2014",12,10,2,158593,2354.25,68.75
"3398","13100","2014",82,59,23,431925.097560976,3837.30487804878,101.792682926829
"3399","13101","2014",18,10,8,277098.333333333,3394,84.3888888888889
"3400","13102","2014",29,20,9,212278.275862069,2855.41379310345,77.3103448275862
"3401","13103","2014",412,135,277,186780.953883495,2454.88349514563,76.3349514563107
"3402","13104","2014",119,57,62,269769.974789916,5016.10084033613,60.4789915966387
"3403","13105","2014",32,26,6,214334.65625,2403,91.625
"3404","13106","2014",77,29,48,197781.038961039,2769.83116883117,74.5844155844156
"3405","13107","2014",28,23,5,336194.642857143,4009.53571428571,87.8571428571429
"3406","13108","2014",99,61,38,159049.484848485,1787.55555555556,89
"3407","13109","2014",26,13,13,348824.730769231,3876.76923076923,91.2692307692308
"3408","13110","2014",84,59,25,240564.714285714,2923.71428571429,83.2142857142857
"3409","13111","2014",6,6,0,386741.666666667,3415,100.833333333333
"3410","13112","2014",52,38,14,325684.519230769,3538.07692307692,92.7692307692308
"3411","13113","2014",88,61,27,325726.647727273,3519.72727272727,92.6818181818182
"3412","13114","2014",40,35,5,426252.125,3809.2,116.725
"3413","13115","2014",19,17,2,284049.473684211,2809.42105263158,103.736842105263
"3414","13117","2014",312,138,174,208363.775641026,2708.83012820513,78.3044871794872
"3415","13118","2014",25,21,4,295595.6,3275.84,89.84
"3416","13119","2014",52,25,27,281085.192307692,3103.03846153846,88.5961538461538
"3417","14001","2014",11,11,0,158010.545454545,1914.90909090909,92.4545454545455
"3418","14003","2014",3,3,0,160666.666666667,1798,97
"3419","14005","2014",11,11,0,196692.727272727,1712.45454545455,120.181818181818
"3420","14006","2014",7,7,0,209314.285714286,2108.14285714286,102.714285714286
"3421","14007","2014",2,2,0,83000,829.5,99
"3422","14009","2014",11,11,0,188101.909090909,1953.63636363636,96.8181818181818
"3423","14011","2014",16,16,0,126812.5,1277.625,102.4375
"3424","14012","2014",1,1,0,190000,1418,134
"3425","14014","2014",13,13,0,286726.923076923,2223.23076923077,137.230769230769
"3426","14015","2014",7,7,0,363428.571428571,2034.57142857143,181.428571428571
"3427","14016","2014",4,4,0,178250,1750,115
"3428","14020","2014",3,3,0,179366.666666667,1805.33333333333,103
"3429","14021","2014",15,9,6,137008.666666667,1870,80.2666666666667
"3430","14022","2014",12,11,1,163256.666666667,2115.66666666667,87.5
"3431","14023","2014",2,2,0,209500,1582,131.5
"3432","14024","2014",4,3,1,177950,2730,78.5
"3433","14025","2014",4,4,0,110600,1222.25,89
"3434","14026","2014",6,6,0,169966.666666667,1432.83333333333,117
"3435","14027","2014",45,40,5,128912.444444444,1280.24444444444,103.266666666667
"3436","14030","2014",9,9,0,259277.777777778,2302.33333333333,115.111111111111
"3437","14032","2014",6,6,0,88666.6666666667,903.5,101.333333333333
"3438","14033","2014",5,5,0,163000,1585.8,109.6
"3439","14034","2014",4,4,0,184565,1478.5,126.25
"3440","14035","2014",17,17,0,143768.235294118,1338.76470588235,114.294117647059
"3441","14037","2014",12,12,0,141033.333333333,1341,107.583333333333
"3442","14038","2014",6,6,0,194157.5,1695,116.666666666667
"3443","14039","2014",6,6,0,166666.666666667,1596.5,106.666666666667
"3444","14040","2014",1,1,0,230000,3898,59
"3445","14041","2014",1,1,0,242000,1458,166
"3446","14042","2014",5,5,0,271400,2151.8,134
"3447","14043","2014",2,2,0,89000,1481.5,65
"3448","14044","2014",5,5,0,270980,2232.4,124
"3449","14045","2014",1,1,0,230000,2396,96
"3450","14046","2014",20,20,0,181745,2087.55,91.15
"3451","14047","2014",122,64,58,144016.852459016,1816.56557377049,81.6803278688525
"3452","14050","2014",3,3,0,90616.6666666667,826.333333333333,96.3333333333333
"3453","14053","2014",1,1,0,32300,646,50
"3454","14054","2014",1,1,0,150000,1250,120
"3455","14055","2014",8,8,0,284062.5,2560.625,103.5
"3456","14057","2014",7,7,0,159657.142857143,1643.71428571429,99.7142857142857
"3457","14059","2014",24,11,13,294372.083333333,3588.20833333333,84.2916666666667
"3458","14061","2014",54,54,0,102635.962962963,1174.42592592593,91.6851851851852
"3459","14062","2014",3,3,0,149900,2873.66666666667,55
"3460","14063","2014",2,2,0,115000,1137.5,101.5
"3461","14064","2014",2,2,0,110750,1133,100
"3462","14066","2014",58,44,14,155173.103448276,2216,72.7068965517241
"3463","14068","2014",32,32,0,222853.6875,2257.6875,101.71875
"3464","14069","2014",6,6,0,140166.666666667,1539.83333333333,95.3333333333333
"3465","14070","2014",2,2,0,135000,1800,75
"3466","14076","2014",22,19,3,184190.909090909,2105.13636363636,90.5
"3467","14077","2014",6,6,0,233750,2533.33333333333,82.3333333333333
"3468","14078","2014",3,3,0,139666.666666667,1252,107.666666666667
"3469","14079","2014",75,25,50,188068.133333333,3310.89333333333,57.6133333333333
"3470","14080","2014",4,4,0,103750,1089,118.75
"3471","14083","2014",6,6,0,175033.333333333,2002.83333333333,88
"3472","14084","2014",5,5,0,141600,1571.4,93.6
"3473","14085","2014",8,8,0,215031.875,1878.125,118.75
"3474","14086","2014",2,2,0,260000,3394.5,71
"3475","14088","2014",4,4,0,134500,1050.5,125.5
"3476","14089","2014",4,4,0,198000,1924.75,106
"3477","14090","2014",5,5,0,165960,1583.4,116.8
"3478","14091","2014",3,3,0,290333.333333333,2163.66666666667,128.666666666667
"3479","14092","2014",8,8,0,194662.5,1680.75,114.75
"3480","14096","2014",2,2,0,113750,1334.5,90
"3481","14097","2014",3,3,0,219100,1599.33333333333,136.333333333333
"3482","14098","2014",63,62,1,180418.650793651,1888.98412698413,98.5873015873016
"3483","14100","2014",2,2,0,132000,1673,78
"3484","14101","2014",37,34,3,213979.72972973,2192.2972972973,96.054054054054
"3485","14102","2014",10,10,0,172401,1623.8,103.6
"3486","14103","2014",4,4,0,111875,1296.25,90.25
"3487","14104","2014",1,1,0,60000,561,107
"3488","14106","2014",10,10,0,176153.2,1932.6,92.6
"3489","14107","2014",2,2,0,430000,2800,149
"3490","14111","2014",4,4,0,157300,1441.75,111.75
"3491","14116","2014",3,3,0,143666.666666667,1527.66666666667,102.333333333333
"3492","14117","2014",310,73,237,152495.238709677,3072.25483870968,50.3387096774194
"3493","14118","2014",1392,291,1101,140925.976293103,2139.48132183908,67.1300287356322
"3494","14119","2014",11,11,0,169603.636363636,1742.09090909091,98
"3495","14120","2014",8,8,0,155937.5,1554,111.125
"3496","14121","2014",2,2,0,91500,1175,77
"3497","14122","2014",1,1,0,160000,2000,80
"3498","14123","2014",15,14,1,239734.466666667,2061.06666666667,131.2
"3499","14124","2014",6,6,0,101138,1305.16666666667,84
"3500","14125","2014",43,22,21,211355.162790698,2431.11627906977,86.6976744186046
"3501","14126","2014",6,6,0,207050,1576.16666666667,132.166666666667
"3502","14127","2014",3,3,0,100666.666666667,999,102.666666666667
"3503","14130","2014",1,1,0,50000,847,59
"3504","14131","2014",1,1,0,220000,2821,78
"3505","14135","2014",2,2,0,107500,1292,88.5
"3506","14136","2014",1,1,0,75000,1119,67
"3507","14137","2014",9,9,0,196429.888888889,2190.44444444444,89.7777777777778
"3508","14138","2014",4,4,0,160875,1353.5,120.25
"3509","14140","2014",4,4,0,146937.5,1522.75,106.5
"3510","14141","2014",1,1,0,2e+05,1439,139
"3511","14143","2014",21,21,0,98174.0952380952,1005.19047619048,102.285714285714
"3512","14145","2014",2,2,0,125750,1280,99
"3513","14146","2014",5,5,0,67231,856.4,74.8
"3514","14147","2014",1,1,0,123500,1235,100
"3515","14149","2014",6,6,0,165833.333333333,2001.5,83
"3516","14150","2014",4,4,0,183850,1515.25,123.75
"3517","14159","2014",3,3,0,221333.333333333,2134.33333333333,103.333333333333
"3518","14160","2014",1,1,0,175000,1699,103
"3519","14161","2014",2,2,0,259000,1842.5,135.5
"3520","14162","2014",18,18,0,100433.333333333,1059.33333333333,92.7777777777778
"3521","14163","2014",3,3,0,191666.666666667,1856.33333333333,108.666666666667
"3522","14165","2014",1,1,0,120000,1333,90
"3523","14166","2014",25,23,2,220896,2161.96,105.44
"3524","14167","2014",23,16,7,192276.565217391,2284.39130434783,83.4347826086957
"3525","14168","2014",4,4,0,92550,1150.25,84.25
"3526","14169","2014",6,6,0,151475,1403.16666666667,105.833333333333
"3527","14171","2014",2,2,0,89000,1483.5,61.5
"3528","14172","2014",6,6,0,154875,1627.83333333333,104
"3529","14173","2014",2,2,0,215350,1158.5,184.5
"3530","14174","2014",53,44,9,85921.1509433962,965.849056603774,88.8490566037736
"3531","14175","2014",3,3,0,171833.333333333,1366,134
"3532","14177","2014",10,10,0,136200,1770.1,95.2
"3533","14179","2014",2,2,0,169100,1722.5,102
"3534","14180","2014",2,2,0,151500,1887,84
"3535","14181","2014",27,19,8,173124.814814815,1883.62962962963,91.2592592592593
"3536","14182","2014",6,6,0,76666.6666666667,910.833333333333,84.1666666666667
"3537","14191","2014",149,46,103,116549.597315436,2341.45637583893,50.3288590604027
"3538","14193","2014",3,3,0,127833.333333333,1525.66666666667,86.3333333333333
"3539","14194","2014",8,8,0,114500,1382.875,89.75
"3540","14195","2014",1,1,0,136000,1432,95
"3541","14196","2014",3,3,0,215666.666666667,1623,131.666666666667
"3542","14197","2014",9,9,0,256947.222222222,2198.66666666667,118.666666666667
"3543","14198","2014",3,3,0,178333.333333333,2301,77.6666666666667
"3544","14200","2014",17,17,0,166082.352941176,1613.23529411765,106.235294117647
"3545","14202","2014",1,1,0,185000,1832,101
"3546","14203","2014",1,1,0,150000,1875,80
"3547","14204","2014",4,4,0,97000,1284.5,77.25
"3548","14206","2014",6,6,0,128333.333333333,996,129.333333333333
"3549","14207","2014",4,4,0,136250,1073,124.5
"3550","14209","2014",5,5,0,158860,1124.2,146.4
"3551","14211","2014",4,4,0,107137.5,1324.75,84.25
"3552","14214","2014",1,1,0,128000,1524,84
"3553","14215","2014",6,6,0,178433.333333333,1839.33333333333,96.3333333333333
"3554","14216","2014",2,2,0,152500,1326.5,118.5
"3555","14218","2014",4,4,0,279375,2744.25,106.25
"3556","14220","2014",172,31,141,292881.918604651,4661.41279069767,61.406976744186
"3557","14221","2014",32,29,3,171520.3125,2077.40625,88.6875
"3558","14223","2014",2,2,0,90500,1122,80
"3559","14225","2014",76,50,26,145982.486842105,2649.47368421053,59.2763157894737
"3560","14226","2014",1,1,0,38000,422,90
"3561","14227","2014",2,2,0,147500,1301,111.5
"3562","14228","2014",48,40,8,198974.833333333,1997.64583333333,99.4166666666667
"3563","14229","2014",21,21,0,111657.142857143,1365.38095238095,78.8571428571429
"3564","14231","2014",4,4,0,95000,1481.25,64
"3565","14232","2014",1,1,0,193000,1874,103
"3566","14236","2014",3,3,0,149833.333333333,1536.33333333333,96.3333333333333
"3567","14237","2014",5,5,0,181220,1698.6,98
"3568","14238","2014",2,2,0,419725,3170.5,133
"3569","14239","2014",1,1,0,150000,1304,115
"3570","14240","2014",2,2,0,112500,1008.5,110
"3571","14241","2014",3,3,0,148333.333333333,1665.66666666667,100
"3572","14242","2014",11,7,4,159090.909090909,1862.81818181818,91.0909090909091
"3573","14243","2014",18,12,6,193874.444444444,2709.22222222222,78.1666666666667
"3574","14244","2014",3,3,0,231200,1560.66666666667,147.666666666667
"3575","14245","2014",6,6,0,153916.666666667,1440.83333333333,111.166666666667
"3576","14246","2014",15,15,0,210293.6,2027.13333333333,110.666666666667
"3577","14248","2014",2,2,0,140000,1424,98.5
"3578","14249","2014",8,8,0,190843.75,2019.375,103.625
"3579","14250","2014",4,4,0,144700,1326.25,112
"3580","14251","2014",4,4,0,66500,697.25,101
"3581","14252","2014",3,3,0,162333.333333333,1296,126
"3582","14254","2014",7,7,0,211300,2418.71428571429,99
"3583","14256","2014",6,6,0,175891.666666667,1474,132.666666666667
"3584","14257","2014",13,13,0,194062.461538462,2060.92307692308,95.6923076923077
"3585","14260","2014",2,2,0,670400,8191.5,117.5
"3586","14261","2014",5,5,0,208720,1802.6,126.8
"3587","14266","2014",19,19,0,197776.315789474,1971.26315789474,101.631578947368
"3588","14270","2014",2,2,0,125500,1756.5,71.5
"3589","14271","2014",13,9,4,185040,2414.38461538462,94.0769230769231
"3590","14272","2014",1,1,0,105000,1567,67
"3591","14273","2014",1,1,0,279000,1559,179
"3592","14274","2014",14,14,0,240503.142857143,2071.92857142857,115.571428571429
"3593","14275","2014",4,4,0,212075,1754.25,121.75
"3594","14276","2014",3,3,0,243333.333333333,1686.33333333333,139.666666666667
"3595","14277","2014",17,16,1,166823.529411765,1671.58823529412,99.9411764705882
"3596","14278","2014",5,5,0,202310,1494.6,136.6
"3597","14280","2014",2,2,0,152500,1338,110
"3598","14281","2014",8,8,0,156650,1284.625,121
"3599","14282","2014",5,5,0,153800,1441.6,115
"3600","14283","2014",2,2,0,138750,1728,73
"3601","14284","2014",1,1,0,130000,1121,116
"3602","14285","2014",1,1,0,1e+05,1515,66
"3603","14286","2014",3,3,0,385116.666666667,2602.66666666667,165.333333333333
"3604","14287","2014",12,12,0,167683.333333333,1925.25,89.6666666666667
"3605","14288","2014",8,8,0,141468.75,1205.25,128.25
"3606","14289","2014",4,4,0,155950,1487,111.75
"3607","14290","2014",5,5,0,158560,1812.4,86.4
"3608","14291","2014",1,1,0,166000,1766,94
"3609","14293","2014",4,4,0,367417.5,2841.5,123.5
"3610","14297","2014",8,8,0,175825,1634.5,110.5
"3611","14298","2014",1,1,0,45920,1435,32
"3612","14299","2014",8,8,0,175300.125,1757.125,99.625
"3613","14301","2014",6,6,0,197000,2173.33333333333,93.1666666666667
"3614","14302","2014",4,4,0,109250,1276.5,84.5
"3615","14303","2014",5,5,0,106980.8,1359.6,80.2
"3616","14304","2014",7,6,1,277071.428571429,2223.42857142857,109.428571428571
"3617","14305","2014",5,5,0,226600,1998.6,109.4
"3618","14306","2014",1,1,0,310000,2696,115
"3619","14308","2014",3,3,0,232333.333333333,1638.66666666667,153.333333333333
"3620","14309","2014",10,9,1,170960,1639.2,107.1
"3621","14310","2014",6,6,0,143666.666666667,1564.33333333333,94.1666666666667
"3622","14311","2014",4,4,0,170325,1686.25,104
"3623","14312","2014",62,55,7,96624.8870967742,1416.53225806452,65.1129032258064
"3624","14316","2014",2,2,0,180000,2239,81.5
"3625","14318","2014",3,3,0,143800,1473.33333333333,93.3333333333333
"3626","14319","2014",3,3,0,129833.333333333,2249.33333333333,77
"3627","14320","2014",2,2,0,87500,978,93.5
"3628","14325","2014",53,46,7,228463.433962264,2379.52830188679,95.4716981132076
"3629","14326","2014",7,7,0,242157.142857143,2204.28571428571,110.857142857143
"3630","14327","2014",148,46,102,125230.952702703,1863.58783783784,70.4594594594595
"3631","14328","2014",6,6,0,141491.666666667,1553.66666666667,92.8333333333333
"3632","14332","2014",6,6,0,136250,1542.83333333333,90
"3633","14333","2014",121,49,72,164760.297520661,2611.3305785124,66.5785123966942
"3634","14336","2014",2,2,0,153600,1522.5,108.5
"3635","14337","2014",4,4,0,147750,1455.5,98.25
"3636","14338","2014",116,35,81,146935.784482759,2657.37068965517,55.8620689655172
"3637","14341","2014",82,59,23,172091.073170732,1985.84146341463,87.9512195121951
"3638","14342","2014",34,31,3,100845.588235294,1198.5,90.2352941176471
"3639","14343","2014",3,3,0,144000,1109,111.666666666667
"3640","14344","2014",5,5,0,207020,1959,104.2
"3641","14346","2014",5,5,0,141900,1372.4,105.8
"3642","14347","2014",7,7,0,122500,1400.85714285714,97
"3643","14348","2014",1,1,0,160000,667,240
"3644","14349","2014",15,15,0,170462.666666667,1725.93333333333,99.9333333333333
"3645","14352","2014",10,10,0,83930,880.4,93.7
"3646","14353","2014",4,4,0,152675,1400,109
"3647","14354","2014",31,23,8,171188.387096774,2472.35483870968,75.6451612903226
"3648","14355","2014",7,7,0,176528.571428571,1924.14285714286,96
"3649","14357","2014",13,13,0,77961.5384615385,990.538461538462,80.6923076923077
"3650","14358","2014",1,1,0,110000,1864,59
"3651","14360","2014",1,1,0,80000,727,110
"3652","14362","2014",4,4,0,145375,1794,81
"3653","14364","2014",3,3,0,153966.666666667,1778.33333333333,105.333333333333
"3654","14365","2014",48,34,14,178501.854166667,2504.35416666667,75.8958333333333
"3655","14366","2014",176,75,101,106747.306818182,1453.36931818182,76.1079545454545
"3656","14367","2014",5,5,0,135140,1012.6,120.4
"3657","14368","2014",3,3,0,108333.333333333,1540.66666666667,72
"3658","14369","2014",2,2,0,129500,1305.5,111.5
"3659","14370","2014",20,19,1,130236.9,1342.95,97.25
"3660","14371","2014",76,74,2,123416.381578947,1241.51315789474,99.8815789473684
"3661","14374","2014",2,2,0,134000,1407,108
"3662","14377","2014",5,5,0,136528,1452,88.8
"3663","14378","2014",3,3,0,138333.333333333,892.666666666667,168
"3664","14379","2014",2,2,0,102500,1339.5,77
"3665","14383","2014",19,17,2,184686.842105263,2065.36842105263,91.5263157894737
"3666","14384","2014",57,40,17,178905.263157895,2348.9649122807,83.4912280701754
"3667","14389","2014",2,2,0,109500,1484,82
"3668","14391","2014",1,1,0,168000,1806,93
"3669","14393","2014",2,2,0,128250,1834,70.5
"3670","14394","2014",8,8,0,173250,1589.375,103.5
"3671","14396","2014",9,9,0,228910.555555556,2240.55555555556,105.555555555556
"3672","14397","2014",2,2,0,201555,1724.5,117
"3673","14398","2014",5,5,0,188620,1829.4,99
"3674","14399","2014",3,3,0,318333.333333333,2630.33333333333,117.333333333333
"3675","14400","2014",1,1,0,230000,1533,150
"3676","14402","2014",1,1,0,105000,875,120
"3677","14403","2014",10,10,0,162850,1860.8,87.1
"3678","14404","2014",1,1,0,178000,1483,120
"3679","14405","2014",3,3,0,134666.666666667,1156.33333333333,119
"3680","14406","2014",8,8,0,264898.5,2065.25,129.25
"3681","14407","2014",22,20,2,334914.272727273,2354.18181818182,140.818181818182
"3682","14408","2014",7,5,2,138428.571428571,1868.42857142857,79.1428571428571
"3683","14409","2014",71,42,29,165528.647887324,2863.40845070423,62.7746478873239
"3684","14410","2014",8,8,0,160212.5,1375.25,115.875
"3685","14411","2014",6,6,0,137566.666666667,1390.16666666667,107.333333333333
"3686","14412","2014",2,2,0,129000,1394,92.5
"3687","14419","2014",2,2,0,220000,1707,129.5
"3688","14421","2014",3,3,0,111666.666666667,1327.33333333333,88
"3689","14425","2014",2,2,0,145000,1402.5,111.5
"3690","14426","2014",1,1,0,140000,1538,91
"3691","14427","2014",1,1,0,65500,1365,48
"3692","14431","2014",45,44,1,142753.688888889,1503.48888888889,101.755555555556
"3693","14435","2014",2,2,0,131500,1564.5,83
"3694","14436","2014",2,2,0,157028,1691.5,87
"3695","14437","2014",5,5,0,193500,1954.6,98.8
"3696","14438","2014",4,4,0,168102.5,1301.5,127.75
"3697","14445","2014",2,2,0,134400,1481,92
"3698","14449","2014",3,3,0,115666.666666667,1858,61.3333333333333
"3699","14452","2014",4,3,1,130187.5,1374.5,95.5
"3700","14453","2014",6,6,0,150500,1462.66666666667,102.666666666667
"3701","14454","2014",16,16,0,164868.75,1821.6875,93.9375
"3702","14455","2014",2,2,0,161250,2108,87
"3703","14456","2014",21,21,0,170693.333333333,1668.47619047619,104.285714285714
"3704","14457","2014",1,1,0,220000,1375,160
"3705","14458","2014",4,4,0,146250,1681.25,89.5
"3706","14460","2014",11,11,0,135272.727272727,1393.27272727273,97.1818181818182
"3707","14461","2014",2,2,0,180000,1893,103
"3708","14465","2014",2,2,0,159500,2197,73.5
"3709","14466","2014",2,2,0,152500,1748,87.5
"3710","14467","2014",3,3,0,274173.333333333,1787.33333333333,175.333333333333
"3711","14468","2014",3,3,0,170276.666666667,1431,119.333333333333
"3712","14474","2014",2,2,0,99860,736.5,137.5
"3713","14475","2014",25,25,0,176662,1557.6,114.68
"3714","14478","2014",24,23,1,106374.583333333,1108.91666666667,98.75
"3715","14480","2014",5,5,0,95560,1040.8,89.4
"3716","14482","2014",1,1,0,112000,1120,100
"3717","14483","2014",4,4,0,179475,2189.25,82.25
"3718","14486","2014",3,3,0,106166.666666667,1333,81.3333333333333
"3719","14487","2014",8,8,0,178312.5,1721.25,105.75
"3720","14488","2014",137,75,62,174548.868613139,2583.52554744526,72.1313868613139
"3721","14491","2014",1,1,0,197000,1247,158
"3722","14492","2014",3,3,0,245333.333333333,2836,76.6666666666667
"3723","14494","2014",1,1,0,159000,1097,145
"3724","14495","2014",6,6,0,264533.333333333,2179.66666666667,123
"3725","14496","2014",1,1,0,67000,957,70
"3726","14497","2014",2,2,0,117500,1244,100
"3727","14498","2014",1,1,0,98000,1307,75
"3728","14499","2014",7,7,0,238657.142857143,2024,113.714285714286
"3729","14500","2014",1,1,0,283000,2888,98
"3730","14501","2014",1,1,0,125000,1667,75
"3731","14502","2014",1,1,0,146000,1921,76
"3732","14504","2014",9,9,0,133944.444444444,1364.33333333333,97.6666666666667
"3733","14506","2014",4,4,0,118478,1038.75,118.25
"3734","14509","2014",2,2,0,237500,1767.5,134
"3735","14510","2014",2,2,0,41750,541.5,93.5
"3736","14512","2014",1,1,0,94000,1880,50
"3737","14514","2014",39,31,8,182679.051282051,2153.51282051282,94.8974358974359
"3738","14515","2014",5,5,0,165890,1872.8,89.4
"3739","14516","2014",20,20,0,103287.5,1540.25,67.05
"3740","14519","2014",1,1,0,168000,1159,145
"3741","14520","2014",3,3,0,109333.333333333,1419.66666666667,77
"3742","14524","2014",6,6,0,202333.333333333,2044.83333333333,101
"3743","14527","2014",3,3,0,203000,1881.33333333333,119.666666666667
"3744","14528","2014",3,3,0,145600,1724,85.3333333333333
"3745","14529","2014",1,1,0,90000,2432,37
"3746","14530","2014",17,17,0,190026,2033.41176470588,90.4705882352941
"3747","14534","2014",2,2,0,165750,1465.5,112.5
"3748","14535","2014",9,9,0,183822.222222222,1709.55555555556,100.222222222222
"3749","14538","2014",13,12,1,199860,1944,103.538461538462
"3750","14540","2014",2,2,0,303975,1854.5,164
"3751","14541","2014",1,1,0,90000,1343,67
"3752","14542","2014",9,9,0,269444.444444444,1981.55555555556,139.333333333333
"3753","14543","2014",24,22,2,197632.5,2061.79166666667,97
"3754","14546","2014",2,2,0,174000,1437.5,119
"3755","14547","2014",2,2,0,172500,2041,101.5
"3756","14552","2014",5,5,0,171990,1499.2,113
"3757","14554","2014",3,3,0,161333.333333333,1716.33333333333,96.3333333333333
"3758","14555","2014",5,5,0,228290,1974,109.6
"3759","14556","2014",9,9,0,201081.666666667,1906.22222222222,108.444444444444
"3760","14557","2014",27,14,13,181203.555555556,2796.11111111111,66.2962962962963
"3761","14558","2014",11,11,0,225730.090909091,2053.72727272727,114.363636363636
"3762","14559","2014",3,3,0,117500,1103.66666666667,112.666666666667
"3763","14562","2014",42,27,15,158753.833333333,2336.47619047619,72.2380952380952
"3764","14563","2014",3,3,0,159333.333333333,1597.33333333333,130
"3765","14565","2014",3,3,0,129420,2036,60
"3766","14566","2014",17,17,0,262416.235294118,2130.23529411765,121.647058823529
"3767","14569","2014",4,4,0,230950,1962.5,117.25
"3768","14570","2014",26,25,1,113480.769230769,1295.73076923077,97.8461538461538
"3769","14571","2014",1,1,0,3e+05,1775,169
"3770","14572","2014",3,3,0,112733.333333333,1541.33333333333,73.3333333333333
"3771","14574","2014",16,16,0,204022.6875,1463.625,144
"3772","14575","2014",3,3,0,327313.333333333,2424.33333333333,140
"3773","14576","2014",4,4,0,155875,1422.5,110.75
"3774","14578","2014",5,5,0,315410,2221.8,136.8
"3775","14579","2014",12,12,0,136558.333333333,1268.58333333333,114.5
"3776","14582","2014",1,1,0,81000,900,90
"3777","14587","2014",6,5,1,155833.333333333,1931.16666666667,82
"3778","14588","2014",4,4,0,122512.5,1272.25,95.25
"3779","14589","2014",10,10,0,141150,1542.6,96.4
"3780","14590","2014",1,1,0,144000,1398,103
"3781","14591","2014",6,6,0,131266.666666667,1436.16666666667,90
"3782","14592","2014",7,7,0,152457.142857143,1334.71428571429,114
"3783","14593","2014",8,8,0,248637.5,1903.5,130.875
"3784","14595","2014",4,4,0,144400,1659.75,90.75
"3785","14598","2014",3,3,0,472666.666666667,4006.66666666667,90.3333333333333
"3786","14602","2014",2,2,0,155500,1012.5,157
"3787","14603","2014",2,2,0,191805,1750.5,110.5
"3788","14605","2014",4,4,0,176000,1652.75,111.5
"3789","14607","2014",1,1,0,140000,2333,60
"3790","14609","2014",3,3,0,110733.333333333,1510.66666666667,68.3333333333333
"3791","14610","2014",11,11,0,199485.454545455,1693.45454545455,122.636363636364
"3792","14613","2014",1,1,0,95000,655,145
"3793","14614","2014",4,4,0,99625,838.25,121.5
"3794","14620","2014",4,4,0,372750,3471.25,110.25
"3795","14621","2014",3,3,0,94006.6666666667,1635.33333333333,58
"3796","14623","2014",23,23,0,183187.391304348,1866.08695652174,103.130434782609
"3797","14625","2014",13,13,0,146423.846153846,1618.30769230769,94.0769230769231
"3798","14626","2014",6,6,0,113500,958.5,121.5
"3799","14627","2014",4,4,0,160750,1366,115
"3800","14630","2014",5,5,0,186140,1721,113
"3801","14635","2014",2,2,0,151000,1319,115
"3802","14637","2014",3,3,0,165460,1834.33333333333,91
"3803","14639","2014",1,1,0,268200,2530,106
"3804","14640","2014",2,2,0,226500,2024.5,112
"3805","14643","2014",6,6,0,107116.666666667,1626.66666666667,67.8333333333333
"3806","14644","2014",4,4,0,217842.5,1841.25,119.5
"3807","14645","2014",4,4,0,406030.75,2143.5,167.5
"3808","14646","2014",5,5,0,134560,1365,99
"3809","14648","2014",4,4,0,214968.75,2126.75,104.25
"3810","14649","2014",3,3,0,147083.333333333,1186.66666666667,127.666666666667
"3811","14650","2014",1,1,0,70000,1522,46
"3812","14651","2014",2,2,0,328000,2396.5,162.5
"3813","14654","2014",51,49,2,131454.901960784,1411.58823529412,95.4901960784314
"3814","14656","2014",9,9,0,114243.888888889,1072.66666666667,119.777777777778
"3815","14657","2014",1,1,0,396000,1559,254
"3816","14658","2014",35,34,1,83546.8571428571,1029.88571428571,86.5142857142857
"3817","14659","2014",13,13,0,146369.230769231,1536.46153846154,95.7692307692308
"3818","14660","2014",1,1,0,530000,2789,190
"3819","14661","2014",3,3,0,143333.333333333,1540.33333333333,92
"3820","14663","2014",13,11,2,165103.846153846,1707.61538461538,95.2307692307692
"3821","14664","2014",3,3,0,102000,927.666666666667,112
"3822","14665","2014",4,3,1,165625,2177.75,102.75
"3823","14666","2014",18,16,2,152643.333333333,1691.61111111111,94.9444444444444
"3824","14667","2014",2,2,0,125000,1288.5,96.5
"3825","14668","2014",1,1,0,181600,1157,157
"3826","14669","2014",1,1,0,165000,1231,134
"3827","14672","2014",7,7,0,102814.285714286,1260.71428571429,79.8571428571429
"3828","14674","2014",1,1,0,155000,1449,107
"3829","14675","2014",14,14,0,188892.142857143,2113.78571428571,91.6428571428571
"3830","14676","2014",8,8,0,153600,1688.375,94.375
"3831","14677","2014",1,1,0,310000,1782,174
"3832","14678","2014",4,4,0,124075,1001.5,121.75
"3833","14679","2014",3,3,0,148500,1797.33333333333,82.6666666666667
"3834","14680","2014",1,1,0,138000,2226,62
"3835","14681","2014",1,1,0,1e+05,667,150
"3836","14682","2014",2,2,0,275000,2211.5,125
"3837","14684","2014",1,1,0,90000,918,98
"3838","14685","2014",12,11,1,223088.333333333,1840.16666666667,120.166666666667
"3839","14687","2014",4,4,0,175627.5,1846.25,93.25
"3840","14689","2014",40,35,5,143510.2,1612.9,96.975
"3841","14692","2014",18,18,0,171366.666666667,1738.33333333333,106.833333333333
"3842","14694","2014",7,7,0,159000,1664,93
"3843","14698","2014",4,4,0,142450,1311.5,109.25
"3844","14699","2014",54,32,22,188628.333333333,2887.5,66.4074074074074
"3845","14700","2014",6,6,0,155416.666666667,1629,97.8333333333333
"3846","14701","2014",37,7,30,261867.297297297,3980.91891891892,65.1891891891892
"3847","14706","2014",4,4,0,279475,2292.5,120
"3848","14707","2014",8,8,0,161553.75,1637.875,104.125
"3849","14708","2014",1,1,0,197600,1813,109
"3850","14709","2014",2,2,0,60058.5,3094,21.5
"3851","14710","2014",2,2,0,86500,950.5,89.5
"3852","14711","2014",6,6,0,128283.333333333,1202.66666666667,105.166666666667
"3853","14712","2014",30,29,1,184380,1931.4,98.5
"3854","14713","2014",1,1,0,95000,1583,60
"3855","14714","2014",11,11,0,130695.454545455,1604,92.2727272727273
"3856","14715","2014",209,71,138,209354.488038278,3646.28708133971,58.1244019138756
"3857","14716","2014",3,3,0,181333.333333333,1859.33333333333,96.3333333333333
"3858","14719","2014",5,4,1,167086,1604.4,97.6
"3859","14720","2014",7,7,0,145571.428571429,1259.14285714286,118.571428571429
"3860","14721","2014",6,6,0,154333.333333333,1266.33333333333,120.666666666667
"3861","14723","2014",3,3,0,219946.666666667,1965.66666666667,115
"3862","14724","2014",33,18,15,158554.545454545,2832.60606060606,64.2424242424242
"3863","14726","2014",44,44,0,101002.181818182,1006.36363636364,102.636363636364
"3864","14728","2014",3,3,0,113323.333333333,1363,83.3333333333333
"3865","14731","2014",1,1,0,258000,3534,73
"3866","14732","2014",1,1,0,467000,1698,275
"3867","14733","2014",1,1,0,208500,869,240
"3868","14734","2014",2,2,0,187500,1389,135
"3869","14735","2014",5,5,0,110000,1167.6,98.2
"3870","14737","2014",1,1,0,155000,1824,85
"3871","14738","2014",32,28,4,180273.4375,1920.53125,96.8125
"3872","14739","2014",26,26,0,192771.153846154,1955.23076923077,100.923076923077
"3873","14740","2014",17,17,0,118717.647058824,1137.82352941176,98.4117647058823
"3874","14741","2014",1,1,0,45000,3000,15
"3875","14743","2014",3,3,0,155000,2289,66.6666666666667
"3876","14744","2014",2,2,0,117150,1160.5,92.5
"3877","14745","2014",8,7,1,111262.5,1685.125,72.375
"3878","14747","2014",6,6,0,191050,1769.33333333333,109.5
"3879","14748","2014",2,2,0,76250,870.5,94
"3880","14753","2014",3,3,0,105000,1146.66666666667,91
"3881","14754","2014",260,39,221,121865.157692308,2880.91923076923,43.2576923076923
"3882","14755","2014",16,12,4,273020,2554.125,99.625
"3883","14756","2014",3,3,0,131166.666666667,1247,122.666666666667
"3884","14758","2014",4,4,0,320000,2020.75,177.75
"3885","14759","2014",2,2,0,212000,1544.5,134
"3886","14760","2014",4,4,0,176125,1624.25,110.75
"3887","14761","2014",6,6,0,150066.666666667,1632.83333333333,95
"3888","14762","2014",137,92,45,97062.0437956204,1131.3795620438,86.2262773722628
"3889","14764","2014",12,11,1,77416.6666666667,1173.5,69.3333333333333
"3890","15001","2014",4,4,0,60500,872.75,68.5
"3891","15003","2014",8,8,0,78841.25,938.625,86.75
"3892","15004","2014",5,5,0,158142,1406.8,107.6
"3893","15006","2014",8,8,0,101802.5,922.375,112.25
"3894","15007","2014",1,1,0,169000,1878,90
"3895","15008","2014",4,4,0,57400,922.75,72.5
"3896","15009","2014",1,1,0,25000,962,26
"3897","15010","2014",2,2,0,84010,803.5,108.5
"3898","15011","2014",1,1,0,65000,915,71
"3899","15012","2014",33,27,6,128119.545454545,1421.0303030303,88.5454545454545
"3900","15014","2014",349,80,269,88354.7020057307,1254.82521489971,71.0974212034384
"3901","15015","2014",2,2,0,123000,1073.5,117.5
"3902","15017","2014",1,1,0,48500,808,60
"3903","15019","2014",1,1,0,110000,2444,45
"3904","15020","2014",3,3,0,66100,928.333333333333,71.6666666666667
"3905","15021","2014",7,6,1,83571.4285714286,1095.85714285714,83.2857142857143
"3906","15025","2014",3,3,0,104666.666666667,929,111
"3907","15026","2014",1,1,0,150000,2344,64
"3908","15027","2014",2,2,0,78000,975,80
"3909","15028","2014",1,1,0,170800,1525,112
"3910","15029","2014",4,4,0,98750,1656.75,69
"3911","15030","2014",4,4,0,144612.5,1243.5,109.75
"3912","15032","2014",1,1,0,28000,444,63
"3913","15033","2014",1,1,0,80000,1633,49
"3914","15036","2014",1,1,0,90020,874,103
"3915","15037","2014",5,5,0,73600,1338,72.4
"3916","15038","2014",11,11,0,62083.6363636364,935,62.2727272727273
"3917","15040","2014",3,3,0,42500,712.666666666667,63.3333333333333
"3918","15041","2014",1,1,0,110000,769,143
"3919","15045","2014",6,5,1,95000,1195,86.8333333333333
"3920","15046","2014",2,2,0,55000,871.5,60
"3921","15049","2014",2,2,0,93500,2010,61.5
"3922","15050","2014",3,3,0,112166.666666667,1619.33333333333,64.6666666666667
"3923","15051","2014",1,1,0,78000,1200,65
"3924","15052","2014",2,2,0,66500,1252,51.5
"3925","15053","2014",3,3,0,85666.6666666667,906.666666666667,97
"3926","15054","2014",7,7,0,65657.1428571429,1063.14285714286,63
"3927","15055","2014",2,2,0,102500,1207,95
"3928","15056","2014",3,3,0,154333.333333333,1087,154
"3929","15057","2014",3,3,0,41500,547.666666666667,81
"3930","15059","2014",2,2,0,141510,827.5,167
"3931","15061","2014",1,1,0,72000,2323,31
"3932","15063","2014",3,3,0,80128.3333333333,670,131.333333333333
"3933","15066","2014",2,2,0,175500,1149,152.5
"3934","15067","2014",1,1,0,65000,812,80
"3935","15069","2014",1,1,0,97970,1633,60
"3936","15070","2014",1,1,0,120000,1333,90
"3937","15072","2014",1,1,0,20000,400,50
"3938","15073","2014",1,1,0,80000,1111,72
"3939","15074","2014",7,7,0,122444.285714286,1267.57142857143,95.7142857142857
"3940","15075","2014",2,2,0,81100,1004.5,77.5
"3941","15076","2014",1,1,0,72000,878,82
"3942","15078","2014",2,2,0,65000,1273,51
"3943","15079","2014",5,5,0,80046.6,731,111.6
"3944","15080","2014",1,1,0,160000,941,170
"3945","15081","2014",1,1,0,1e+05,901,111
"3946","15082","2014",1,1,0,210000,1909,110
"3947","15083","2014",6,6,0,131700,1338.66666666667,98.3333333333333
"3948","15084","2014",1,1,0,30000,769,39
"3949","15085","2014",5,5,0,133210,1538.6,86.2
"3950","15087","2014",1,1,0,114000,1373,83
"3951","15088","2014",7,7,0,112957.142857143,1270.71428571429,88.5714285714286
"3952","15089","2014",4,4,0,101085,1106.25,93.75
"3953","15090","2014",5,5,0,105530,1382.4,75.8
"3954","15092","2014",7,7,0,82428.5714285714,1229.57142857143,75.4285714285714
"3955","15093","2014",1,1,0,188000,1709,110
"3956","15094","2014",12,9,3,87541.6666666667,985.666666666667,98
"3957","15095","2014",7,7,0,147792.857142857,1748.28571428571,94.8571428571429
"3958","15096","2014",3,3,0,80833.3333333333,1056.66666666667,73.3333333333333
"3959","15097","2014",1,1,0,75000,1531,49
"3960","15101","2014",45,8,37,82432.7777777778,2009.68888888889,44.5333333333333
"3961","15103","2014",2,2,0,124000,1081.5,112
"3962","15104","2014",3,3,0,118273.333333333,1063.33333333333,112
"3963","15107","2014",1,1,0,92000,575,160
"3964","15108","2014",5,5,0,75296,1052.6,76.8
"3965","15110","2014",2,2,0,65600,546.5,120
"3966","15113","2014",2,2,0,81500,1329.5,67
"3967","15114","2014",5,5,0,148100,1753,105.2
"3968","15116","2014",4,2,2,76000,809,93.75
"3969","15117","2014",5,5,0,45860,568.8,76
"3970","15118","2014",4,4,0,132120,1388.5,98.5
"3971","15119","2014",11,11,0,101909.090909091,1049.09090909091,92
"3972","15120","2014",21,15,6,119352.857142857,1316.2380952381,95.1904761904762
"3973","15121","2014",1,1,0,520850,3297,158
"3974","15122","2014",19,16,3,102268.421052632,1331.68421052632,75.6315789473684
"3975","15123","2014",2,2,0,61500,555,110
"3976","15124","2014",3,3,0,100500,966,102.333333333333
"3977","15126","2014",1,1,0,60000,811,74
"3978","15127","2014",4,4,0,95475,956.25,107.25
"3979","15128","2014",2,2,0,141000,1251.5,110
"3980","15129","2014",3,3,0,77666.6666666667,761.666666666667,91.3333333333333
"3981","15131","2014",2,2,0,84500,1088.5,82
"3982","15134","2014",2,2,0,120325,1080.5,110
"3983","15137","2014",6,5,1,51307.3333333333,817,70.1666666666667
"3984","15138","2014",15,12,3,128276.666666667,1693.73333333333,87.6666666666667
"3985","15140","2014",15,15,0,138665.333333333,1511.93333333333,91.7333333333333
"3986","15141","2014",17,16,1,110580.235294118,1345.76470588235,92.5294117647059
"3987","15142","2014",7,7,0,101151.428571429,959,101.857142857143
"3988","15143","2014",1,1,0,50000,714,70
"3989","15144","2014",2,2,0,82500,967.5,95.5
"3990","15146","2014",2,2,0,107750,888.5,108.5
"3991","15147","2014",1,1,0,69500,496,140
"3992","15148","2014",3,3,0,109000,1045.66666666667,103.333333333333
"3993","15149","2014",3,3,0,65666.6666666667,980.333333333333,68
"3994","15152","2014",3,2,1,110000,1208.66666666667,91.3333333333333
"3995","15153","2014",12,11,1,115659.166666667,1068,115.666666666667
"3996","15154","2014",8,8,0,100400,1404.25,73
"3997","15156","2014",5,5,0,110200,1180.8,92
"3998","15157","2014",2,2,0,106750,1144.5,76.5
"3999","15159","2014",1,1,0,55000,1100,50
"4000","15160","2014",3,3,0,129666.666666667,2176.33333333333,64.6666666666667
"4001","15162","2014",22,18,4,117105.454545455,1237.22727272727,83.5
"4002","15163","2014",6,6,0,114858.333333333,1098.5,99.6666666666667
"4003","15164","2014",2,2,0,74250,835,79.5
"4004","15166","2014",2,2,0,75400,1156,67.5
"4005","15167","2014",1,1,0,97728,2172,45
"4006","15168","2014",5,3,2,96828,1223,83.2
"4007","15169","2014",4,4,0,54025,616.25,88.75
"4008","15170","2014",2,2,0,72500,1010,108.5
"4009","15172","2014",2,2,0,81015,1073.5,88.5
"4010","15174","2014",2,2,0,176410,1363.5,136
"4011","15175","2014",9,9,0,154016.666666667,1075.22222222222,136.555555555556
"4012","15176","2014",2,2,0,48250,843,58.5
"4013","15178","2014",3,3,0,108966.666666667,1339,84
"4014","15179","2014",3,3,0,43718.6666666667,737.333333333333,56.6666666666667
"4015","15181","2014",3,3,0,82833.3333333333,1250,69.3333333333333
"4016","15182","2014",1,1,0,139990,538,260
"4017","15183","2014",1,1,0,107850,1348,80
"4018","15185","2014",1,1,0,52000,765,68
"4019","15186","2014",6,6,0,65883.3333333333,749.666666666667,91.3333333333333
"4020","15187","2014",43,23,20,134423.046511628,1514.55813953488,88.4883720930233
"4021","15188","2014",3,3,0,114993.333333333,1253.33333333333,93
"4022","15189","2014",7,7,0,100990.428571429,1606.71428571429,65.5714285714286
"4023","15190","2014",2,2,0,102000,1164,85.5
"4024","15191","2014",4,3,1,88750,1268.5,71.75
"4025","15192","2014",4,4,0,75125,1332.25,81
"4026","15194","2014",1,1,0,89000,1369,65
"4027","15196","2014",8,8,0,180298.125,1402,126.625
"4028","15198","2014",2,2,0,73500,921.5,85
"4029","15200","2014",1,1,0,25000,521,48
"4030","15201","2014",5,5,0,68300,1145.6,63.8
"4031","15202","2014",2,2,0,60000,930.5,66
"4032","15203","2014",1,1,0,64000,1306,49
"4033","15204","2014",11,11,0,125822.727272727,1185,109.363636363636
"4034","15205","2014",5,4,1,117500,1725.2,66.2
"4035","15206","2014",1,1,0,62000,1033,60
"4036","15207","2014",4,4,0,65750,1084.5,60.5
"4037","15208","2014",1,1,0,80000,523,153
"4038","15209","2014",2,2,0,110000,1957,51
"4039","15211","2014",1,1,0,45000,643,70
"4040","15212","2014",3,3,0,73333.3333333333,685.666666666667,95
"4041","15213","2014",3,3,0,55416.6666666667,779.333333333333,66
"4042","15214","2014",1,1,0,25000,357,70
"4043","15215","2014",11,11,0,137717.272727273,1962.09090909091,89.3636363636364
"4044","15216","2014",3,3,0,170000,2409.66666666667,95.6666666666667
"4045","15219","2014",2,2,0,105000,1445.5,76
"4046","15220","2014",1,1,0,70000,473,148
"4047","15221","2014",9,9,0,138383.333333333,1494.44444444444,91.3333333333333
"4048","15222","2014",1,1,0,39000,830,47
"4049","15223","2014",3,3,0,161545.333333333,1311.33333333333,138
"4050","15224","2014",1,1,0,42500,545,78
"4051","15225","2014",1,1,0,15000,357,42
"4052","15226","2014",1,1,0,67500,1607,42
"4053","15228","2014",2,2,0,98736,1391.5,70.5
"4054","15230","2014",2,2,0,67500,1193,60
"4055","15231","2014",4,4,0,86600,1145.25,107.25
"4056","15232","2014",1,1,0,147800,1344,110
"4057","15233","2014",3,3,0,204983.333333333,1119.66666666667,189.666666666667
"4058","15234","2014",1,1,0,118000,983,120
"4059","15235","2014",4,4,0,78750,1042,83
"4060","15236","2014",7,7,0,114642.857142857,1260.42857142857,88
"4061","15237","2014",3,3,0,163933.333333333,1729.33333333333,99
"4062","15238","2014",1,1,0,92000,767,120
"4063","15240","2014",6,6,0,71583.3333333333,1594,48.6666666666667
"4064","15241","2014",1,1,0,30000,667,45
"4065","15243","2014",4,4,0,108000,1287.75,92.5
"4066","15244","2014",1,1,0,199280,1647,121
"4067","15245","2014",2,2,0,74000,824.5,90
"4068","15246","2014",3,3,0,75333.3333333333,666.666666666667,110
"4069","15247","2014",1,1,0,125000,1562,80
"4070","15248","2014",9,9,0,106354,1063,100.333333333333
"4071","15250","2014",6,6,0,126516.666666667,1222.66666666667,105.666666666667
"4072","15251","2014",1,1,0,15000,385,39
"4073","15252","2014",4,4,0,118250,1061,113.75
"4074","15253","2014",1,1,0,50000,417,120
"4075","15255","2014",6,5,1,100291.666666667,1325.33333333333,80.5
"4076","15257","2014",1,1,0,90000,783,115
"4077","15258","2014",13,11,2,137746.153846154,1262.07692307692,113.230769230769
"4078","15260","2014",2,2,0,173750,1264,134.5
"4079","15261","2014",4,4,0,73000,777.75,97.75
"4080","15262","2014",4,4,0,93125,1114.5,83
"4081","15263","2014",2,2,0,91600,900.5,93
"4082","15264","2014",1,1,0,52000,1040,50
"4083","15265","2014",9,9,0,101077.777777778,1013.11111111111,104.333333333333
"4084","15266","2014",4,4,0,138787.5,1168.25,120.75
"4085","15267","2014",31,30,1,163257.741935484,1609.93548387097,101.483870967742
"4086","15268","2014",7,7,0,85071.4285714286,1039.28571428571,91.2857142857143
"4087","15269","2014",1,1,0,61000,1130,54
"4088","16001","2014",11,11,0,102763.272727273,1038.27272727273,82.1818181818182
"4089","16002","2014",5,5,0,61200,677.2,93.6
"4090","16003","2014",4,4,0,114062.5,947.5,122.25
"4091","16005","2014",7,7,0,76371.4285714286,1014.42857142857,76.5714285714286
"4092","16007","2014",3,3,0,58922,688,86
"4093","16008","2014",3,3,0,90183.3333333333,870.333333333333,119
"4094","16009","2014",4,4,0,103291.25,956.25,100.75
"4095","16011","2014",3,3,0,101333.333333333,1243,72.3333333333333
"4096","16012","2014",3,3,0,130666.666666667,1308.33333333333,102.666666666667
"4097","16013","2014",3,3,0,91500,602,156
"4098","16015","2014",460,298,162,108085.810869565,1316.23913043478,83.4173913043478
"4099","16016","2014",10,10,0,114723.6,1208,103.2
"4100","16018","2014",7,7,0,163540,1113.14285714286,145.142857142857
"4101","16019","2014",13,13,0,118044.615384615,1230.61538461538,98.3076923076923
"4102","16020","2014",16,15,1,154984.375,1495.8125,107.625
"4103","16023","2014",10,10,0,74780,657,118.7
"4104","16024","2014",4,4,0,108412.5,1278.5,84
"4105","16025","2014",3,3,0,147886.666666667,1015.66666666667,122
"4106","16026","2014",11,11,0,115720,1393.09090909091,84.4545454545455
"4107","16027","2014",2,2,0,153208,648.5,225
"4108","16028","2014",45,45,0,105422.666666667,1075.35555555556,105.755555555556
"4109","16030","2014",4,4,0,110150,1007,110
"4110","16031","2014",5,5,0,151440,1148.2,133
"4111","16032","2014",5,5,0,232860,1405.8,161.4
"4112","16034","2014",4,4,0,83567.5,767,109.5
"4113","16035","2014",4,4,0,31250,559.25,62
"4114","16038","2014",2,2,0,157250,873.5,180
"4115","16039","2014",1,1,0,102500,1079,95
"4116","16040","2014",5,5,0,148523.2,1087.2,136.8
"4117","16044","2014",3,3,0,100943.333333333,1110.33333333333,89.3333333333333
"4118","16045","2014",2,2,0,180100,1276.5,140
"4119","16046","2014",3,3,0,123192.333333333,1061.33333333333,122.666666666667
"4120","16047","2014",1,1,0,110000,940,117
"4121","16049","2014",9,9,0,112743.777777778,1174.77777777778,88.4444444444444
"4122","16050","2014",3,3,0,75000,936,85.6666666666667
"4123","16052","2014",1,1,0,150000,1145,131
"4124","16054","2014",1,1,0,60000,583,103
"4125","16055","2014",9,9,0,119938.888888889,1000,120.333333333333
"4126","16056","2014",9,9,0,145330.444444444,1252.22222222222,122.444444444444
"4127","16057","2014",2,2,0,240000,1984.5,135
"4128","16058","2014",15,15,0,157211.466666667,1322.66666666667,114.466666666667
"4129","16059","2014",2,2,0,61500,557.5,104
"4130","16060","2014",3,3,0,145666.666666667,1003.33333333333,132
"4131","16061","2014",22,22,0,143741.363636364,1321.13636363636,107.909090909091
"4132","16062","2014",2,2,0,99250,1143,86.5
"4133","16063","2014",4,4,0,155333.75,1261.5,119
"4134","16064","2014",10,10,0,87200,859.9,98.5
"4135","16065","2014",6,6,0,62140,696.5,89
"4136","16066","2014",8,8,0,113812.5,1200.75,92
"4137","16067","2014",3,3,0,127333.333333333,1409.66666666667,90
"4138","16068","2014",6,5,1,108225,876.833333333333,120
"4139","16069","2014",4,4,0,89525,989.25,86.75
"4140","16070","2014",17,16,1,85585.9411764706,787.588235294118,109.823529411765
"4141","16071","2014",5,5,0,75400,694.6,103
"4142","16072","2014",3,3,0,66250,1119.66666666667,70.3333333333333
"4143","16073","2014",21,21,0,80430.8095238095,780.904761904762,102.333333333333
"4144","16074","2014",4,4,0,94375,917.25,107.75
"4145","16076","2014",9,9,0,129122.222222222,1104.66666666667,136.111111111111
"4146","16077","2014",3,3,0,222716.666666667,1488.66666666667,161.666666666667
"4147","16078","2014",50,50,0,151007.28,1387.7,108.18
"4148","16079","2014",5,5,0,73000,719.4,116.4
"4149","16081","2014",1,1,0,115000,1278,90
"4150","16082","2014",4,4,0,167586.75,1575,111.75
"4151","16083","2014",4,4,0,106140.25,886.75,116.75
"4152","16084","2014",2,2,0,161300,1441,119.5
"4153","16085","2014",32,32,0,97580.3125,1027,96.34375
"4154","16086","2014",5,5,0,72520,759.4,86.2
"4155","16087","2014",3,3,0,134666.666666667,1372.33333333333,102.666666666667
"4156","16088","2014",10,10,0,112630,1024.4,105.3
"4157","16089","2014",30,26,4,113702.6,1571.26666666667,79.4333333333333
"4158","16090","2014",36,36,0,135946.888888889,1185.36111111111,122.083333333333
"4159","16091","2014",4,4,0,173852,1785,98
"4160","16093","2014",11,11,0,112272.727272727,1184.54545454545,95.2727272727273
"4161","16096","2014",5,5,0,76400,1433.2,71.2
"4162","16097","2014",19,19,0,122702.315789474,1125.05263157895,110
"4163","16098","2014",1,1,0,39750,365,109
"4164","16100","2014",6,6,0,85916.6666666667,901.166666666667,101.5
"4165","16101","2014",11,11,0,134481.818181818,1255.63636363636,108.545454545455
"4166","16102","2014",242,197,45,111519.871900826,1245.90082644628,87.6776859504132
"4167","16103","2014",3,3,0,132319.666666667,866,155.333333333333
"4168","16104","2014",1,1,0,50000,641,78
"4169","16105","2014",2,2,0,158250,2458.5,63
"4170","16106","2014",28,27,1,90000,926.321428571429,108.107142857143
"4171","16107","2014",4,4,0,79250,737,96
"4172","16109","2014",4,4,0,71525,843.5,83.5
"4173","16110","2014",7,7,0,98137.1428571429,1198.85714285714,84.4285714285714
"4174","16113","2014",48,47,1,131627.083333333,1515.08333333333,93.8333333333333
"4175","16114","2014",2,2,0,62500,756,89.5
"4176","16116","2014",2,2,0,146695,1160.5,126.5
"4177","16117","2014",1,1,0,148000,1741,85
"4178","16119","2014",10,10,0,129778.3,1289.8,101.4
"4179","16120","2014",11,11,0,144179.818181818,1190.09090909091,122.090909090909
"4180","16121","2014",5,5,0,145989.6,1213.6,118
"4181","16122","2014",1,1,0,48000,432,111
"4182","16123","2014",4,4,0,177500,2394,93.25
"4183","16124","2014",5,5,0,61160,772.4,73
"4184","16125","2014",3,3,0,191666.666666667,1223,165.333333333333
"4185","16127","2014",6,6,0,129000,1056,118
"4186","16128","2014",3,3,0,150000,1951.33333333333,70
"4187","16130","2014",5,5,0,130735.4,999.2,133.2
"4188","16131","2014",4,4,0,157587,2603.25,59.75
"4189","16132","2014",3,3,0,32286.6666666667,449,74
"4190","16134","2014",10,10,0,104520,1307,96.6
"4191","16135","2014",3,3,0,85166.6666666667,908,95
"4192","16136","2014",4,4,0,92000,971.75,85
"4193","16137","2014",2,2,0,80000,542.5,139.5
"4194","16138","2014",30,29,1,138885.5,1499.33333333333,91.7666666666667
"4195","16139","2014",2,2,0,123737.5,1074,111.5
"4196","16140","2014",3,3,0,61333.3333333333,682.333333333333,103.666666666667
"4197","16141","2014",3,3,0,97333.3333333333,789.333333333333,123.333333333333
"4198","16142","2014",2,2,0,104500,787,185.5
"4199","16143","2014",9,9,0,131569.222222222,1357.55555555556,100.222222222222
"4200","16144","2014",4,4,0,77250,737.25,106.25
"4201","16145","2014",7,7,0,204291.285714286,2363.57142857143,78
"4202","16146","2014",13,13,0,169191.307692308,1318.69230769231,126.538461538462
"4203","16148","2014",7,7,0,116642.857142857,888.428571428571,128.571428571429
"4204","16150","2014",14,14,0,162911.142857143,1428.92857142857,118.5
"4205","16151","2014",2,2,0,105550,1326.5,79.5
"4206","16152","2014",4,4,0,179825,1666.25,107.5
"4207","16153","2014",8,8,0,148041.875,1227.25,122.75
"4208","16154","2014",58,56,2,100284.137931034,1234.93103448276,81.9655172413793
"4209","16155","2014",1,1,0,21000,525,40
"4210","16158","2014",2,2,0,130525,719.5,189
"4211","16160","2014",2,2,0,113425,1314,87
"4212","16161","2014",2,2,0,84900,501.5,176.5
"4213","16163","2014",9,9,0,144300,1135.55555555556,133.555555555556
"4214","16164","2014",2,2,0,48750,596,82
"4215","16165","2014",3,3,0,148333.333333333,1079,138.333333333333
"4216","16166","2014",53,49,4,124763.471698113,1332.64150943396,93.6792452830189
"4217","16167","2014",57,55,2,109909.596491228,1083.29824561404,101.666666666667
"4218","16168","2014",3,3,0,117000,1340,99
"4219","16169","2014",4,4,0,129500,1154.25,115.5
"4220","16170","2014",5,5,0,115200,974.6,124.4
"4221","16171","2014",8,8,0,159376.625,1265.375,120.375
"4222","16173","2014",2,2,0,62500,599,101
"4223","16174","2014",2,2,0,220000,2293.5,100.5
"4224","16175","2014",9,9,0,135066.666666667,1146.22222222222,121.333333333333
"4225","16176","2014",1,1,0,120000,1154,104
"4226","16177","2014",2,2,0,212097.5,2234,93.5
"4227","16178","2014",3,3,0,137216.666666667,1370,110
"4228","16180","2014",8,8,0,139698.125,1241.25,111.125
"4229","16181","2014",5,5,0,161400,1098.6,127.2
"4230","16182","2014",6,6,0,54000,786.333333333333,71
"4231","16183","2014",6,6,0,135015.833333333,999,130
"4232","16185","2014",2,2,0,77945.5,618.5,124.5
"4233","16186","2014",5,5,0,137220,1086.8,126.8
"4234","16187","2014",17,17,0,98564.5294117647,1141.23529411765,82.6470588235294
"4235","16188","2014",4,4,0,119229.25,987.75,126.75
"4236","16189","2014",4,4,0,108637.5,846.25,138
"4237","16190","2014",6,6,0,94783.3333333333,1070.83333333333,95.6666666666667
"4238","16192","2014",17,17,0,85423.5294117647,867.117647058824,102.352941176471
"4239","16193","2014",5,5,0,128400,1216.6,104
"4240","16194","2014",3,3,0,61000,872,66.6666666666667
"4241","16195","2014",2,2,0,114500,875,104
"4242","16196","2014",6,6,0,74500,993.333333333333,70.3333333333333
"4243","16197","2014",1,1,0,172000,2234,77
"4244","16198","2014",4,4,0,146875,1429.5,113.75
"4245","16199","2014",36,35,1,121714.75,1281.75,97.9722222222222
"4246","16200","2014",5,5,0,81200,900.6,85.6
"4247","16203","2014",3,3,0,84333.3333333333,934,88
"4248","16204","2014",7,7,0,141448.571428571,1410.14285714286,98.5714285714286
"4249","16205","2014",4,4,0,103100,970,102.25
"4250","16206","2014",9,9,0,84083.3333333333,696.777777777778,119.777777777778
"4251","16207","2014",7,7,0,68285.7142857143,662.714285714286,104.428571428571
"4252","16208","2014",6,6,0,125333.333333333,1218.83333333333,104.166666666667
"4253","16209","2014",5,5,0,125870,1152,108.4
"4254","16210","2014",7,7,0,124357.142857143,1156.28571428571,111.857142857143
"4255","16211","2014",4,4,0,55250,764.75,91
"4256","16212","2014",7,7,0,77571.4285714286,1277,70
"4257","16213","2014",1,1,0,52500,750,70
"4258","16215","2014",3,3,0,186443.333333333,1339,135.333333333333
"4259","16216","2014",5,5,0,204428,1596.8,128
"4260","16217","2014",13,13,0,143688.461538462,1197.61538461538,123.461538461538
"4261","16218","2014",4,4,0,167628.25,1147.5,146.25
"4262","16220","2014",6,6,0,122854.333333333,1207.83333333333,97.1666666666667
"4263","16221","2014",3,3,0,170257.666666667,1263.66666666667,124.333333333333
"4264","16222","2014",5,5,0,188300,1003.2,191
"4265","16223","2014",23,21,2,124421.739130435,1479.78260869565,93.9130434782609
"4266","16224","2014",5,5,0,143142.8,1333.6,114.4
"4267","16225","2014",7,7,0,123400,1288.57142857143,87.8571428571429
"4268","16226","2014",8,8,0,98000,1114.375,86.375
"4269","16227","2014",1,0,1,138000,1314,105
"4270","16229","2014",3,3,0,94333.3333333333,1020.33333333333,101.666666666667
"4271","16230","2014",14,13,1,130806.071428571,1125.85714285714,101.857142857143
"4272","16231","2014",7,7,0,80530.1428571429,869.285714285714,93.8571428571429
"4273","16232","2014",15,15,0,147994,1289.66666666667,113.866666666667
"4274","16233","2014",7,7,0,108583.714285714,986.142857142857,116.857142857143
"4275","16234","2014",7,7,0,122642.857142857,1112.42857142857,117.428571428571
"4276","16236","2014",11,11,0,174550,1626.72727272727,108.272727272727
"4277","16237","2014",2,2,0,50135,597,81.5
"4278","16238","2014",1,1,0,137000,830,165
"4279","16240","2014",2,2,0,55000,1014,52.5
"4280","16241","2014",2,2,0,49750,679.5,77.5
"4281","16242","2014",17,17,0,77092.3529411765,941.823529411765,81.5882352941177
"4282","16243","2014",8,8,0,119062.5,1105.875,109.25
"4283","16244","2014",12,12,0,121968.333333333,1333.33333333333,87.0833333333333
"4284","16245","2014",6,6,0,94166.6666666667,1060,94.3333333333333
"4285","16246","2014",1,1,0,75000,852,88
"4286","16248","2014",1,1,0,52000,510,102
"4287","16249","2014",6,6,0,60975,716.5,81.8333333333333
"4288","16250","2014",1,1,0,76000,1267,60
"4289","16251","2014",1,1,0,134000,798,168
"4290","16252","2014",1,1,0,107900,1401,77
"4291","16253","2014",3,3,0,85000,884.666666666667,103.333333333333
"4292","16254","2014",2,2,0,45000,1201.5,55.5
"4293","16255","2014",3,3,0,65389.6666666667,960.666666666667,71.3333333333333
"4294","16256","2014",2,2,0,181500,1613,113
"4295","16258","2014",4,4,0,98669.5,868.5,111.75
"4296","16260","2014",3,3,0,66705.3333333333,846,82.6666666666667
"4297","16261","2014",3,3,0,106333.333333333,834.333333333333,124.666666666667
"4298","16263","2014",2,2,0,174000,1567,110.5
"4299","16264","2014",4,4,0,62500,740.25,92.25
"4300","16268","2014",1,1,0,298000,1840,162
"4301","16269","2014",6,6,0,163180,1327.83333333333,136.333333333333
"4302","16270","2014",3,3,0,50333.3333333333,673.666666666667,79.6666666666667
"4303","16271","2014",14,14,0,197705,2624.57142857143,101.142857142857
"4304","16272","2014",4,4,0,133250,1421,93.75
"4305","16273","2014",1,1,0,57000,731,78
"4306","16276","2014",6,6,0,118833.333333333,1243.66666666667,95.1666666666667
"4307","16277","2014",5,5,0,96760,1201.6,80
"4308","16279","2014",6,6,0,105250.666666667,1195.33333333333,90.8333333333333
"4309","16280","2014",14,14,0,132492.571428571,1547.64285714286,94.4285714285714
"4310","16281","2014",29,27,2,100526.586206897,1118.48275862069,91.0344827586207
"4311","16283","2014",5,5,0,85280,951.2,90.8
"4312","16284","2014",1,1,0,135000,1436,94
"4313","16285","2014",5,5,0,103291.8,980.4,100
"4314","16286","2014",38,38,0,97489.4736842105,1050.31578947368,95.6315789473684
"4315","16287","2014",37,37,0,123356.432432432,1163.97297297297,105.324324324324
"4316","16289","2014",8,8,0,83917.875,768.375,98.375
"4317","16290","2014",4,4,0,91250,898.5,107
"4318","16291","2014",74,72,2,110524.283783784,1366.12162162162,82.3648648648649
"4319","16292","2014",30,28,2,89613.6666666667,1100.46666666667,86.2
"4320","16293","2014",6,6,0,96500,936.166666666667,99.6666666666667
"4321","16295","2014",14,14,0,119242.857142857,1220.28571428571,96.5
"4322","16297","2014",3,3,0,90166.6666666667,833.666666666667,123.666666666667
"4323","16298","2014",3,3,0,119000,1209,99.6666666666667
"4324","16300","2014",16,16,0,104068.75,899,121
"4325","16301","2014",1,1,0,79800,1010,79
"4326","16302","2014",1,1,0,160000,1270,126
"4327","16303","2014",2,2,0,125000,1507,85.5
"4328","16304","2014",9,9,0,232333.333333333,1825.66666666667,129.333333333333
"4329","16306","2014",3,3,0,53600,974.333333333333,59
"4330","16308","2014",11,11,0,107195.454545455,947.636363636364,124.090909090909
"4331","16310","2014",2,2,0,92500,663.5,132.5
"4332","16312","2014",5,5,0,159860,1373.8,120.6
"4333","16315","2014",2,2,0,145597,873.5,161.5
"4334","16316","2014",5,5,0,89000,920.4,97
"4335","16317","2014",2,2,0,80500,724,89
"4336","16318","2014",6,6,0,108355.666666667,1224,96.1666666666667
"4337","16320","2014",5,5,0,111283.6,950.2,115.4
"4338","16323","2014",4,4,0,77000,812.75,96.25
"4339","16326","2014",1,1,0,255000,1197,213
"4340","16329","2014",3,3,0,95060,1206,76.6666666666667
"4341","16330","2014",10,10,0,152986,1217,129
"4342","16331","2014",1,1,0,110000,701,157
"4343","16334","2014",1,1,0,53000,589,90
"4344","16336","2014",2,2,0,160047.5,833,197.5
"4345","16337","2014",4,4,0,125486.25,1711,86.75
"4346","16339","2014",7,7,0,163292.857142857,1098.28571428571,150.142857142857
"4347","16340","2014",11,11,0,115818.181818182,1108.09090909091,108.272727272727
"4348","16341","2014",43,32,11,86262.7906976744,1143.02325581395,77.4651162790698
"4349","16342","2014",2,2,0,184025,1309.5,143
"4350","16345","2014",1,1,0,123000,1367,90
"4351","16346","2014",4,4,0,158750,1268.25,130.75
"4352","16347","2014",6,6,0,111630,1194.66666666667,122.333333333333
"4353","16348","2014",9,9,0,162433.333333333,1374,104.666666666667
"4354","16349","2014",3,3,0,116700,984.333333333333,125
"4355","16350","2014",8,8,0,143911.25,1161.75,126.875
"4356","16352","2014",2,2,0,182750,1036,158.5
"4357","16353","2014",4,4,0,108712.5,1235,88.5
"4358","16355","2014",7,7,0,123000,1175.42857142857,102.285714285714
"4359","16356","2014",1,1,0,154000,1770,87
"4360","16357","2014",4,4,0,115750,775.25,149.5
"4361","16358","2014",59,57,2,146848.389830508,1575.08474576271,97.5423728813559
"4362","16359","2014",7,7,0,135121.428571429,1366.14285714286,99.2857142857143
"4363","16360","2014",4,4,0,90750,898.25,95.25
"4364","16361","2014",6,6,0,96500,1020.16666666667,95.3333333333333
"4365","16362","2014",7,7,0,171400,1209.85714285714,142.428571428571
"4366","16363","2014",5,5,0,78100,758.6,107
"4367","16365","2014",1,1,0,1e+05,820,122
"4368","16366","2014",19,19,0,128171.052631579,1165.36842105263,108.894736842105
"4369","16368","2014",4,4,0,100750,940.5,110
"4370","16369","2014",5,5,0,141760,1174.6,119.2
"4371","16370","2014",4,4,0,117400,1065.25,101.25
"4372","16372","2014",2,2,0,98500,889,142
"4373","16373","2014",2,2,0,82030,778,105.5
"4374","16374","2014",63,57,6,116481.285714286,1310.09523809524,89.6507936507936
"4375","16375","2014",3,3,0,65716.6666666667,660.333333333333,101
"4376","16377","2014",1,1,0,162400,1353,120
"4377","16378","2014",3,3,0,103266.666666667,739.666666666667,138.333333333333
"4378","16379","2014",8,8,0,100930.625,870.75,113.5
"4379","16380","2014",1,1,0,207500,930,223
"4380","16381","2014",2,2,0,95000,810.5,110.5
"4381","16382","2014",2,2,0,116000,1033.5,110
"4382","16383","2014",6,6,0,114158.333333333,1475.66666666667,89.3333333333333
"4383","16384","2014",4,4,0,188412.5,1112,165
"4384","16385","2014",7,7,0,137910.428571429,1458.57142857143,92.1428571428571
"4385","16387","2014",3,3,0,67733.3333333333,1220,82.3333333333333
"4386","16388","2014",4,4,0,88325,1049,86
"4387","16389","2014",1,1,0,83000,865,96
"4388","16390","2014",2,2,0,72500,762,96
"4389","16392","2014",3,3,0,89833.3333333333,902.666666666667,97.3333333333333
"4390","16393","2014",17,17,0,104324.941176471,1290.82352941176,84.8823529411765
"4391","16395","2014",2,2,0,80000,763,112.5
"4392","16396","2014",3,3,0,100150,828,120.333333333333
"4393","16397","2014",4,4,0,144187.5,1139.75,113
"4394","16399","2014",3,3,0,125666.666666667,1470,85.3333333333333
"4395","16400","2014",12,12,0,142320.833333333,1289.91666666667,112.333333333333
"4396","16401","2014",3,3,0,114066.333333333,1520.66666666667,95.6666666666667
"4397","16402","2014",3,3,0,105633.333333333,1647,73
"4398","16404","2014",2,2,0,107500,1080.5,97.5
"4399","16408","2014",7,7,0,101285.714285714,1144.57142857143,93.7142857142857
"4400","16409","2014",3,3,0,48833.3333333333,819,59.6666666666667
"4401","16412","2014",5,5,0,119970,1092.8,122
"4402","16413","2014",2,2,0,109000,858.5,123
"4403","16414","2014",2,2,0,44000,442.5,103.5
"4404","16415","2014",13,13,0,128992.307692308,1262.76923076923,109.538461538462
"4405","16416","2014",7,7,0,89464.2857142857,935.428571428571,92.7142857142857
"4406","16418","2014",10,10,0,142085,1340.3,102.9
"4407","16419","2014",2,2,0,51500,600,83
"4408","16420","2014",4,4,0,147392.5,1097,135
"4409","16422","2014",8,8,0,182383.75,1411.375,124.625
"4410","16424","2014",8,8,0,86625,797.875,110.25
"4411","16425","2014",5,5,0,137400,901.2,143
"4412","17003","2014",40,38,2,187304.15,1957.55,106.025
"4413","17004","2014",4,4,0,513244.25,6133,84.5
"4414","17005","2014",1,1,0,54000,1800,30
"4415","17006","2014",1,1,0,122000,1184,103
"4416","17007","2014",2,2,0,297520,1633,177
"4417","17008","2014",18,18,0,176277.777777778,1818.33333333333,99.6111111111111
"4418","17009","2014",4,4,0,177000,2475.25,81.75
"4419","17010","2014",42,41,1,232688.095238095,2561.45238095238,93.7142857142857
"4420","17011","2014",1,1,0,176000,1467,120
"4421","17012","2014",2,2,0,84750,1199.5,66
"4422","17013","2014",1,1,0,81500,906,90
"4423","17015","2014",7,7,0,144428.571428571,1615.28571428571,108
"4424","17016","2014",8,8,0,209292.5,2103.75,96.75
"4425","17017","2014",10,10,0,124022,1199.6,105.2
"4426","17018","2014",9,9,0,171161.111111111,1501.77777777778,113.888888888889
"4427","17019","2014",24,24,0,362698.5,4287.125,96.4583333333333
"4428","17020","2014",3,3,0,196814.333333333,925.666666666667,207.333333333333
"4429","17021","2014",35,34,1,174441.514285714,1798.85714285714,94.9714285714286
"4430","17022","2014",11,11,0,118592,1428.90909090909,83.8181818181818
"4431","17023","2014",4,4,0,43500,968.75,61.5
"4432","17024","2014",18,18,0,92608.3333333333,909.277777777778,103
"4433","17025","2014",8,8,0,123183.75,1376,95.125
"4434","17026","2014",1,1,0,162000,1500,108
"4435","17027","2014",3,3,0,137180,1313,97.6666666666667
"4436","17028","2014",120,79,41,179775.85,2441.65,76.6
"4437","17029","2014",3,3,0,92000,677.333333333333,136.333333333333
"4438","17030","2014",3,3,0,155000,1067.33333333333,159
"4439","17031","2014",1,1,0,85000,1441,59
"4440","17032","2014",9,9,0,157547.777777778,1446.11111111111,110.888888888889
"4441","17033","2014",7,7,0,102428.571428571,1019.85714285714,97.4285714285714
"4442","17034","2014",4,4,0,120500,1671.25,72.25
"4443","17035","2014",1,1,0,57000,570,100
"4444","17036","2014",7,7,0,163700,1523,105.428571428571
"4445","17037","2014",7,7,0,228135.571428571,1712.28571428571,125.714285714286
"4446","17038","2014",3,3,0,155360,1338.33333333333,117
"4447","17041","2014",14,14,0,158956,1503.78571428571,109
"4448","17042","2014",7,7,0,124781.428571429,1161.28571428571,104.428571428571
"4449","17043","2014",10,10,0,144110,976.8,118.5
"4450","17044","2014",12,12,0,146632.5,1493.91666666667,109.75
"4451","17045","2014",7,7,0,167524.285714286,1460,122.142857142857
"4452","17046","2014",6,6,0,164666.666666667,1274.33333333333,124.666666666667
"4453","17048","2014",2,2,0,117500,1181,99.5
"4454","17049","2014",1,1,0,70000,467,150
"4455","17050","2014",3,3,0,115966.666666667,1083.66666666667,111.666666666667
"4456","17051","2014",39,39,0,505889.923076923,5018.05128205128,102.717948717949
"4457","17052","2014",12,12,0,86050,851.583333333333,104.833333333333
"4458","17053","2014",10,10,0,115100,1189.4,94.8
"4459","17054","2014",3,3,0,92333.3333333333,872.666666666667,99.3333333333333
"4460","17055","2014",4,4,0,144050,1145.5,124.5
"4461","17056","2014",6,6,0,128570.5,1404.5,118
"4462","17057","2014",6,6,0,137833.333333333,1332.66666666667,108.833333333333
"4463","17058","2014",49,45,4,153174.040816327,1975.02040816327,83.4897959183673
"4464","17059","2014",5,5,0,233800,1985.4,124
"4465","17060","2014",4,4,0,145050,1060,135.25
"4466","17061","2014",3,3,0,84166.6666666667,834.333333333333,99.3333333333333
"4467","17062","2014",1,1,0,79950,381,210
"4468","17063","2014",6,6,0,104583.333333333,1019.66666666667,101.833333333333
"4469","17064","2014",29,27,2,211725.862068966,2073.55172413793,99.4827586206897
"4470","17065","2014",16,16,0,197902.3125,1931.4375,104.75
"4471","17066","2014",1,1,0,35000,686,51
"4472","17067","2014",1,1,0,45000,331,136
"4473","17068","2014",2,2,0,92500,1465.5,70.5
"4474","17069","2014",3,3,0,222333.333333333,886.333333333333,202
"4475","17070","2014",6,6,0,130350,1236.33333333333,101.5
"4476","17071","2014",3,3,0,68333.3333333333,929.666666666667,81
"4477","17072","2014",18,17,1,86888.8888888889,912.944444444444,98
"4478","17073","2014",9,9,0,125777.777777778,1409.22222222222,95.2222222222222
"4479","17074","2014",6,6,0,110666.666666667,1217.83333333333,92.8333333333333
"4480","17075","2014",7,7,0,121007.142857143,1121.14285714286,103.142857142857
"4481","17077","2014",9,9,0,113094.444444444,1126,106.333333333333
"4482","17078","2014",2,2,0,190000,1439.5,120.5
"4483","17079","2014",11,11,0,139500,1460.09090909091,93.6363636363636
"4484","17080","2014",7,7,0,183531.714285714,1276.14285714286,141.857142857143
"4485","17081","2014",3,3,0,94666.6666666667,1422,74
"4486","17083","2014",11,11,0,157936.363636364,1342.18181818182,120
"4487","17084","2014",4,4,0,87000,961.25,88
"4488","17085","2014",3,3,0,126000,1395.33333333333,108.333333333333
"4489","17086","2014",29,29,0,143180.517241379,1463.55172413793,96.6896551724138
"4490","17087","2014",2,2,0,89500,891.5,99
"4491","17089","2014",13,13,0,163576.923076923,1432.07692307692,112.076923076923
"4492","17091","2014",21,21,0,181151.619047619,1675.66666666667,110.52380952381
"4493","17092","2014",3,3,0,93658.6666666667,722,131
"4494","17093","2014",44,43,1,184635.454545455,2351.65909090909,83.5681818181818
"4495","17094","2014",118,83,35,243751.152542373,3682.52542372881,72.5677966101695
"4496","17095","2014",1,1,0,210000,1243,169
"4497","17097","2014",3,3,0,133333.333333333,1134.66666666667,115.666666666667
"4498","17098","2014",10,10,0,138350,1131.4,125.5
"4499","17099","2014",1,1,0,50000,556,90
"4500","17100","2014",8,8,0,148062.5,1111.125,141.25
"4501","17101","2014",5,5,0,121000,1141.2,107.4
"4502","17102","2014",9,9,0,162833.333333333,1375.88888888889,118.555555555556
"4503","17104","2014",6,6,0,101666.666666667,1261.5,104.333333333333
"4504","17105","2014",2,2,0,83750,711,121.5
"4505","17107","2014",12,12,0,159872.916666667,1622.16666666667,101
"4506","17108","2014",3,3,0,202666.666666667,1702.66666666667,119
"4507","17109","2014",12,11,1,200359.166666667,1840.16666666667,107.5
"4508","17110","2014",7,7,0,256238.857142857,1896.85714285714,96.2857142857143
"4509","17111","2014",5,5,0,88000,1055.4,86.4
"4510","17112","2014",6,6,0,131516.666666667,1303.16666666667,110.5
"4511","17113","2014",4,4,0,104575,1104,92.75
"4512","17114","2014",1,1,0,206000,958,215
"4513","17115","2014",2,2,0,94000,830.5,110.5
"4514","17116","2014",1,1,0,237905,1775,134
"4515","17117","2014",1,1,0,127000,1155,110
"4516","17118","2014",2,2,0,139660,1434,98
"4517","17119","2014",7,7,0,138928.571428571,1511.57142857143,91.2857142857143
"4518","17120","2014",12,12,0,145473.333333333,1627.25,90
"4519","17121","2014",25,21,4,372150.08,4732.16,79.36
"4520","17122","2014",1,1,0,270000,2547,106
"4521","17124","2014",2,2,0,78500,1096,62
"4522","17125","2014",3,3,0,235830,1580.33333333333,188.333333333333
"4523","17126","2014",2,2,0,79818.5,1113.5,67.5
"4524","17127","2014",15,15,0,134520,1415.33333333333,94
"4525","17128","2014",6,6,0,108416.666666667,1060,98.3333333333333
"4526","17129","2014",4,4,0,150500,1152,135.75
"4527","17130","2014",2,2,0,82450,910,90
"4528","17131","2014",18,17,1,177845,1783.05555555556,103.666666666667
"4529","17132","2014",5,5,0,97150,1181.6,89.2
"4530","17133","2014",11,11,0,117686.363636364,1227.18181818182,93.0909090909091
"4531","17134","2014",9,9,0,126084.444444444,1378.55555555556,97.6666666666667
"4532","17135","2014",1,1,0,70500,881,80
"4533","17136","2014",6,6,0,176675,1767.33333333333,100.333333333333
"4534","17137","2014",2,2,0,140675,1444,97.5
"4535","17138","2014",6,6,0,111597.5,958.166666666667,116.333333333333
"4536","17139","2014",3,3,0,153666.666666667,1040.66666666667,140.333333333333
"4537","17140","2014",55,48,7,204518.563636364,2985.30909090909,77.9636363636364
"4538","17141","2014",6,6,0,121523.833333333,1334.66666666667,97
"4539","17142","2014",50,47,3,218996,2267.22,94.78
"4540","17143","2014",5,4,1,155976,1618.4,98.2
"4541","17145","2014",2,2,0,83011.5,773,105.5
"4542","17146","2014",30,30,0,165883.333333333,1667.83333333333,104.333333333333
"4543","17147","2014",12,12,0,108641.666666667,1131.16666666667,97.3333333333333
"4544","17148","2014",3,3,0,236716.666666667,2028.33333333333,119.666666666667
"4545","17150","2014",6,6,0,116216.666666667,832.666666666667,141.5
"4546","17151","2014",13,13,0,163923.076923077,1862.46153846154,85.6923076923077
"4547","17152","2014",8,8,0,124450,1325.375,98
"4548","17153","2014",17,17,0,219432.352941176,2114.47058823529,101
"4549","17154","2014",6,6,0,191811.666666667,1500.83333333333,127.333333333333
"4550","17155","2014",22,22,0,169684.090909091,1797.68181818182,97.8181818181818
"4551","17158","2014",11,11,0,179953.181818182,1730.45454545455,107.454545454545
"4552","17159","2014",1,1,0,155000,1632,95
"4553","17160","2014",4,4,0,237687.5,1617.75,140.25
"4554","17161","2014",47,40,7,388199.638297872,4433.17021276596,91.0851063829787
"4555","17162","2014",1,1,0,40000,702,57
"4556","17163","2014",7,7,0,117500,916.428571428571,121.714285714286
"4557","17164","2014",23,23,0,166665.217391304,1540.39130434783,106.565217391304
"4558","17165","2014",4,4,0,92500,789,113
"4559","17166","2014",10,10,0,182190.8,1554.8,122.7
"4560","17167","2014",2,2,0,52000,1007,54.5
"4561","17168","2014",97,86,11,247023.226804124,2933.09278350515,89.1855670103093
"4562","17171","2014",9,9,0,168143.111111111,1399.33333333333,123
"4563","17172","2014",27,26,1,136851.851851852,1192.81481481481,118.777777777778
"4564","17173","2014",2,2,0,161250,1645.5,90
"4565","17174","2014",19,19,0,131289.473684211,1275.36842105263,104.421052631579
"4566","17175","2014",5,5,0,137300,1433.8,96.6
"4567","17176","2014",2,2,0,72250,763,80
"4568","17177","2014",1,1,0,40000,417,96
"4569","17178","2014",2,2,0,416850,1733.5,240
"4570","17179","2014",15,12,3,149896.666666667,1635.26666666667,99.4
"4571","17180","2014",2,2,0,184375,1361,134
"4572","17181","2014",3,3,0,128333.333333333,979.333333333333,127.333333333333
"4573","17182","2014",7,7,0,152785.714285714,1493.42857142857,109
"4574","17183","2014",10,10,0,138020,1425,107.9
"4575","17184","2014",1,1,0,270000,1280,211
"4576","17185","2014",14,14,0,128339.285714286,1665.5,77.7857142857143
"4577","17186","2014",7,7,0,140285.714285714,1259.28571428571,118.571428571429
"4578","17187","2014",2,2,0,179000,1186,149
"4579","17188","2014",5,5,0,109036,958,100.6
"4580","17190","2014",25,25,0,283583.6,2601.96,107.48
"4581","17191","2014",5,5,0,100400,1099.4,105.6
"4582","17192","2014",9,9,0,153138.333333333,1350.44444444444,152.555555555556
"4583","17193","2014",30,30,0,195261.666666667,2176.66666666667,95.9333333333333
"4584","17194","2014",22,21,1,210986,2014.18181818182,105
"4585","17196","2014",6,6,0,174250,1334.5,137.333333333333
"4586","17197","2014",33,30,3,125836.727272727,1393.12121212121,97.1515151515152
"4587","17198","2014",2,2,0,95000,1044.5,101
"4588","17200","2014",83,77,6,246873.34939759,2526.38554216867,98.2409638554217
"4589","17201","2014",10,10,0,158591.4,1306.7,119
"4590","17202","2014",6,6,0,139500,1024.33333333333,122.666666666667
"4591","17203","2014",9,9,0,130482.222222222,1369.88888888889,93.8888888888889
"4592","17204","2014",1,1,0,70000,1014,69
"4593","17206","2014",3,3,0,68333.3333333333,764,86.6666666666667
"4594","17207","2014",16,16,0,356633.4375,3693.5625,99.625
"4595","17208","2014",10,10,0,218142,1881.4,116.9
"4596","17209","2014",2,2,0,117750,905,143.5
"4597","17210","2014",2,2,0,95000,720,124.5
"4598","17211","2014",8,8,0,110250,1064,98.625
"4599","17212","2014",4,4,0,88000,783.25,100.75
"4600","17213","2014",4,4,0,116375,1481.25,90
"4601","17214","2014",5,5,0,184000,1594.4,123.4
"4602","17216","2014",13,13,0,111707.692307692,1176.69230769231,95.5384615384615
"4603","17217","2014",1,1,0,131500,1370,96
"4604","17218","2014",45,40,5,144855.933333333,1526.17777777778,100.377777777778
"4605","17219","2014",66,61,5,145135.606060606,1754.37878787879,86.1363636363636
"4606","17220","2014",3,3,0,117333.333333333,1146,109.666666666667
"4607","17221","2014",9,9,0,108111.111111111,1133.44444444444,101
"4608","17222","2014",34,33,1,260581.941176471,2690.52941176471,99.2941176470588
"4609","17224","2014",22,22,0,97906.8181818182,1084.90909090909,91
"4610","17225","2014",98,90,8,186684.081632653,3462.07142857143,60.9489795918367
"4611","17226","2014",7,7,0,94928.5714285714,978.571428571429,89.8571428571429
"4612","17227","2014",2,2,0,217500,1596.5,136.5
"4613","17228","2014",34,34,0,213342.205882353,2212.64705882353,100.205882352941
"4614","17229","2014",2,2,0,133235,666,179
"4615","17230","2014",73,65,8,196234.452054795,2560.72602739726,82.3424657534247
"4616","17231","2014",3,3,0,75666.6666666667,546.333333333333,138.666666666667
"4617","17232","2014",16,16,0,206664.1875,1893.625,116.625
"4618","17233","2014",1,1,0,40000,404,99
"4619","17235","2014",7,7,0,116467.571428571,1057.14285714286,105.285714285714
"4620","17236","2014",17,17,0,135168.764705882,1218.29411764706,127.294117647059
"4621","17237","2014",6,6,0,122883.333333333,1443.16666666667,85.6666666666667
"4622","17239","2014",4,4,0,126250,1220.75,106.75
"4623","17240","2014",29,28,1,97862.0689655172,1105.13793103448,90.5172413793103
"4624","17241","2014",13,13,0,90137.0769230769,912.384615384615,97.4615384615385
"4625","17242","2014",10,10,0,116300,1173.1,119.2
"4626","17243","2014",11,11,0,111220.818181818,1081.81818181818,101.909090909091
"4627","17244","2014",5,5,0,153460,1705.2,92.4
"4628","17245","2014",10,10,0,165392.7,1669.2,103.6
"4629","17246","2014",1,1,0,125000,1420,88
"4630","17247","2014",12,12,0,187178.583333333,2039,98.6666666666667
"4631","17248","2014",20,19,1,121915,1269.75,101.65
"4632","17249","2014",2,2,0,75000,885,84
"4633","17250","2014",3,3,0,96666.6666666667,1079.33333333333,100
"4634","17252","2014",2,2,0,135000,1392,83
"4635","17253","2014",9,9,0,104777.777777778,1141,89.7777777777778
"4636","17254","2014",5,5,0,119810,999.4,109.6
"4637","17255","2014",5,5,0,194540,1443.6,135.4
"4638","17256","2014",3,3,0,75716.6666666667,748.666666666667,95
"4639","17257","2014",7,7,0,61785.7142857143,615,103.142857142857
"4640","17258","2014",2,2,0,118250,1067.5,111
"4641","17259","2014",1,1,0,87000,500,174
"4642","17260","2014",1,1,0,90000,849,106
"4643","17261","2014",5,5,0,122900,937.2,130.4
"4644","17262","2014",9,9,0,150251.888888889,1573.88888888889,97.4444444444444
"4645","17263","2014",5,5,0,133068.6,1064.2,113.2
"4646","17264","2014",65,65,0,253744.769230769,2455.24615384615,106.430769230769
"4647","17265","2014",9,9,0,161277.777777778,1741.33333333333,93.1111111111111
"4648","17266","2014",11,11,0,154772.727272727,1381.90909090909,125.636363636364
"4649","17267","2014",16,16,0,167798.125,1576.25,109.5625
"4650","17268","2014",1,1,0,110000,957,115
"4651","17269","2014",1,1,0,120000,1714,70
"4652","17270","2014",21,21,0,72613.0952380952,1645,48.3333333333333
"4653","17271","2014",3,3,0,116666.666666667,1030.66666666667,128.666666666667
"4654","17273","2014",5,5,0,140800,799.6,160
"4655","17274","2014",86,61,25,234196.162790698,2757.62790697674,88.2209302325581
"4656","17275","2014",6,6,0,165903.333333333,1514.66666666667,108.5
"4657","17277","2014",14,14,0,135285.714285714,1439.5,103.357142857143
"4658","17278","2014",8,8,0,125687.5,1405,87.75
"4659","17279","2014",7,7,0,123947.142857143,1120,112.857142857143
"4660","17280","2014",4,4,0,147125,1342.5,109
"4661","17282","2014",1,1,0,110000,764,144
"4662","17283","2014",38,38,0,107874.157894737,1169.68421052632,96.5526315789474
"4663","17284","2014",2,2,0,137500,1344,99.5
"4664","17285","2014",12,12,0,151708.333333333,1114.66666666667,135.083333333333
"4665","17286","2014",17,17,0,647652.941176471,5998.94117647059,112.058823529412
"4666","17287","2014",4,4,0,159930.25,1291.25,129.25
"4667","17288","2014",2,2,0,142500,1367,104.5
"4668","17289","2014",5,5,0,214400,1533.8,148
"4669","17290","2014",1,1,0,50000,556,90
"4670","17291","2014",43,35,8,218146.279069767,2340.53488372093,93.8837209302326
"4671","17292","2014",1,1,0,210000,4118,51
"4672","17293","2014",4,4,0,116048.25,1121.25,104.5
"4673","17294","2014",2,2,0,83750,821.5,93.5
"4674","17295","2014",5,5,0,108000,948,100.8
"4675","17296","2014",15,15,0,166233.333333333,1568.4,110.333333333333
"4676","17297","2014",23,23,0,419609.043478261,4966.95652173913,89.3913043478261
"4677","17298","2014",9,9,0,128922.222222222,1090.88888888889,121
"4678","17299","2014",374,177,197,114766.409090909,1658.08556149733,72.596256684492
"4679","17300","2014",1206,444,762,205795.077943615,3232.228026534,66.3665008291874
"4680","17301","2014",1,1,0,69900,624,112
"4681","17302","2014",3,3,0,147826.666666667,1685,88.6666666666667
"4682","17303","2014",16,16,0,130850.625,1251.75,106.625
"4683","17304","2014",8,8,0,99125,891.25,109.375
"4684","17306","2014",488,206,282,199736.795081967,2806.87295081967,72.0840163934426
"4685","17308","2014",24,24,0,159502.083333333,1650.375,99.7916666666667
"4686","17309","2014",18,18,0,97722.2222222222,1240.05555555556,81
"4687","17310","2014",6,6,0,159604.166666667,2196.66666666667,88.3333333333333
"4688","17311","2014",32,28,4,171407.46875,2283.59375,78.53125
"4689","17312","2014",7,7,0,115166,1253.42857142857,94.7142857142857
"4690","17313","2014",3,3,0,142433.333333333,1481,79
"4691","17314","2014",8,8,0,115812.5,1296.75,85.625
"4692","17316","2014",2,2,0,104982.5,1209.5,94.5
"4693","17317","2014",4,2,2,108637.5,1002.5,116.5
"4694","17318","2014",16,14,2,318980.375,4159,77.8125
"4695","17319","2014",1,1,0,145470,1500,97
"4696","17320","2014",4,4,0,181110,1068.5,155.5
"4697","17322","2014",7,7,0,106000,1305.14285714286,87.4285714285714
"4698","17323","2014",37,36,1,196336.567567568,2893.89189189189,72.2162162162162
"4699","17324","2014",1,1,0,32000,444,72
"4700","17325","2014",5,5,0,93320,1146.4,83.8
"4701","17326","2014",5,5,0,92300,1064.8,86.8
"4702","17327","2014",2,2,0,160000,1337.5,117.5
"4703","17328","2014",16,16,0,124241.5625,1101.6875,104.9375
"4704","17329","2014",3,3,0,138333.333333333,1448.66666666667,99
"4705","17330","2014",10,10,0,156388,1371.8,127.3
"4706","17331","2014",6,6,0,156666.666666667,1137.83333333333,154.666666666667
"4707","17332","2014",5,5,0,141700,1130.8,123.2
"4708","17333","2014",237,164,73,171287.696202532,3076.08016877637,59.5400843881857
"4709","17334","2014",7,7,0,125900,1060.57142857143,128.285714285714
"4710","17335","2014",4,4,0,98750,1211,88.25
"4711","17336","2014",23,23,0,165740.782608696,1956.26086956522,97.7826086956522
"4712","17337","2014",105,99,6,190565.39047619,2890.44761904762,72.5714285714286
"4713","17338","2014",15,15,0,130839,1220.13333333333,107.333333333333
"4714","17339","2014",13,13,0,107200,1111.69230769231,93.4615384615385
"4715","17340","2014",11,11,0,126195.454545455,1276.81818181818,102.818181818182
"4716","17341","2014",1,1,0,208300,1184,176
"4717","17342","2014",7,7,0,95214.2857142857,1166.42857142857,89
"4718","17343","2014",1,1,0,155000,2500,62
"4719","17344","2014",13,13,0,128422.615384615,1372.84615384615,98.7692307692308
"4720","17345","2014",4,4,0,142500,1453.25,97.25
"4721","17346","2014",15,15,0,165992.4,1604.13333333333,111.466666666667
"4722","17347","2014",76,73,3,110730.947368421,1168.31578947368,99.9078947368421
"4723","17348","2014",4,4,0,111750,1254.75,94.5
"4724","17349","2014",31,31,0,152134.516129032,1344.29032258065,121.516129032258
"4725","17350","2014",9,9,0,132394.444444444,1156.33333333333,116.333333333333
"4726","17351","2014",25,25,0,124931.6,1611.76,81.08
"4727","17353","2014",24,24,0,175409.125,2030.75,89.6666666666667
"4728","17354","2014",5,5,0,134800,1159.2,117.4
"4729","17355","2014",1,1,0,160000,1379,116
"4730","17356","2014",2,2,0,117500,1219.5,95
"4731","17357","2014",7,7,0,150156.428571429,1200.57142857143,128.857142857143
"4732","17358","2014",4,4,0,53125,610,83.5
"4733","17359","2014",14,14,0,125214.285714286,1147,110.642857142857
"4734","17360","2014",52,50,2,474614.903846154,4733.80769230769,104.076923076923
"4735","17361","2014",1,1,0,120000,750,160
"4736","17362","2014",1,1,0,259500,1622,160
"4737","17363","2014",1,1,0,163000,1791,91
"4738","17365","2014",5,5,0,89824,928.4,104.6
"4739","17366","2014",4,4,0,87875,917.5,96
"4740","17367","2014",2,2,0,97500,1428,81.5
"4741","17369","2014",41,17,24,413843.926829268,5462.51219512195,74.9756097560976
"4742","17372","2014",1,1,0,104000,1156,90
"4743","17374","2014",4,4,0,114532.5,1160.25,102
"4744","17375","2014",9,9,0,92944.4444444444,1466.44444444444,64.5555555555556
"4745","17376","2014",13,13,0,231638.461538462,1958.92307692308,127.538461538462
"4746","17377","2014",2,2,0,99000,939,117
"4747","17378","2014",1,1,0,95000,979,97
"4748","17379","2014",1,1,0,115000,1198,96
"4749","17380","2014",120,98,22,247642.733333333,3400.06666666667,79.2833333333333
"4750","17381","2014",2,2,0,125000,1197.5,96.5
"4751","17382","2014",4,4,0,120435.75,1281.75,88.75
"4752","17384","2014",3,3,0,104333.333333333,1136.66666666667,95.3333333333333
"4753","17385","2014",106,100,6,194318.669811321,2596.8679245283,76.2264150943396
"4754","17386","2014",2,2,0,91750,1005,88.5
"4755","17387","2014",18,18,0,158298.333333333,1416,116.166666666667
"4756","17388","2014",3,3,0,130666.666666667,833.333333333333,158.333333333333
"4757","17389","2014",2,2,0,146250,1264.5,110
"4758","17391","2014",15,15,0,256090.466666667,2279.2,114
"4759","17393","2014",18,17,1,168027.777777778,1610,110.888888888889
"4760","17394","2014",9,9,0,119466.666666667,1427.11111111111,85.8888888888889
"4761","17395","2014",5,5,0,90076,985,86.8
"4762","17396","2014",18,17,1,188623.333333333,1682.33333333333,116.388888888889
"4763","17397","2014",19,19,0,100052.631578947,1103.15789473684,100.105263157895
"4764","17400","2014",3,3,0,95000,711.666666666667,134.666666666667
"4765","17401","2014",2,2,0,185750,1289.5,130
"4766","17403","2014",7,7,0,132714.285714286,1144,110.285714285714
"4767","17404","2014",6,6,0,162500,1156.16666666667,145.166666666667
"4768","17405","2014",4,4,0,72643.25,1165.25,64.5
"4769","17406","2014",6,6,0,127916.666666667,1440.16666666667,90.1666666666667
"4770","17407","2014",36,36,0,209775.694444444,1823.16666666667,117.111111111111
"4771","17408","2014",5,5,0,141200,1435.2,99.2
"4772","17409","2014",26,26,0,196086.538461538,1886.92307692308,111.730769230769
"4773","17410","2014",10,10,0,95750,900.1,103.4
"4774","17411","2014",33,31,2,249614.575757576,3037.06060606061,86.1818181818182
"4775","17412","2014",5,5,0,166440,1296,123
"4776","17413","2014",13,11,2,197980.153846154,2298.15384615385,91.0769230769231
"4777","17414","2014",42,42,0,223053.095238095,2355.83333333333,94.7857142857143
"4778","17415","2014",329,247,82,134014.835866261,1542.74468085106,87.7841945288754
"4779","17418","2014",1,1,0,115000,927,124
"4780","17420","2014",15,14,1,223783.866666667,2235.33333333333,99.3333333333333
"4781","17421","2014",87,79,8,159980.689655172,1835.71264367816,89.183908045977
"4782","17422","2014",1,1,0,159000,1282,124
"4783","17423","2014",1,1,0,137000,1123,122
"4784","17424","2014",2,2,0,73000,898.5,82
"4785","17425","2014",18,18,0,148979.888888889,1731.33333333333,87.3888888888889
"4786","17426","2014",3,3,0,100333.333333333,1090.66666666667,91
"4787","17427","2014",1,1,0,180000,861,209
"4788","17428","2014",3,3,0,115833.333333333,1037.66666666667,111
"4789","17429","2014",21,21,0,157714.285714286,1861.33333333333,98.6190476190476
"4790","17430","2014",2,2,0,63000,1175,58.5
"4791","17431","2014",8,8,0,153562.5,1367.25,112.625
"4792","17433","2014",2,2,0,157200,765.5,221
"4793","17434","2014",75,72,3,114149.52,1397.37333333333,86.52
"4794","17435","2014",4,4,0,132250,1377.75,94.75
"4795","17436","2014",3,3,0,110000,1550,71.6666666666667
"4796","17437","2014",3,3,0,114333.333333333,3465.66666666667,66
"4797","17438","2014",2,2,0,188750,1462,130
"4798","17439","2014",13,13,0,108151.153846154,1196.23076923077,91.3076923076923
"4799","17440","2014",2,2,0,130000,1535.5,85
"4800","17441","2014",12,12,0,125300,1419.75,124.25
"4801","17442","2014",2,2,0,172050,1715,99.5
"4802","17443","2014",14,14,0,187532.142857143,1775.42857142857,114.642857142857
"4803","17444","2014",16,15,1,91327.1875,1174.8125,83.25
"4804","17445","2014",1,1,0,99600,1245,80
"4805","17446","2014",3,3,0,41333.3333333333,736,53
"4806","17447","2014",17,17,0,154126.470588235,1507.47058823529,103.941176470588
"4807","17448","2014",10,10,0,97630,1159.2,90
"4808","17449","2014",71,60,11,155831.901408451,1753.91549295775,93.4507042253521
"4809","17450","2014",3,3,0,83333.3333333333,940,86
"4810","17451","2014",8,8,0,86375,845.375,114.625
"4811","17452","2014",96,87,9,211404.65625,2539.89583333333,87.8229166666667
"4812","17453","2014",12,12,0,143991.666666667,1666.16666666667,100.583333333333
"4813","17454","2014",6,6,0,77500,874.5,106
"4814","17455","2014",10,10,0,139084,1196.4,119.1
"4815","17457","2014",13,13,0,93010.3076923077,1362.15384615385,94.7692307692308
"4816","17458","2014",4,4,0,157754.25,1731.75,103.5
"4817","17459","2014",6,6,0,93666.6666666667,942.333333333333,101.166666666667
"4818","17460","2014",10,10,0,153827,1503.5,105.8
"4819","17461","2014",130,74,56,225151.438461538,3535.93076923077,66.6230769230769
"4820","17462","2014",4,4,0,152787.5,1337.75,120.75
"4821","17463","2014",18,18,0,190710,2090.77777777778,94.6111111111111
"4822","17465","2014",6,6,0,168333.333333333,1389.5,118
"4823","17466","2014",16,15,1,177690.3125,1556.1875,116
"4824","17467","2014",1,1,0,217500,1908,114
"4825","17469","2014",6,6,0,131833.333333333,1070,131.333333333333
"4826","17471","2014",3,3,0,125833.333333333,1383,101.333333333333
"4827","17472","2014",28,28,0,250099.107142857,2422.85714285714,104.642857142857
"4828","17473","2014",4,4,0,116662.5,934.75,129.75
"4829","17474","2014",8,8,0,108875,921.125,130
"4830","17476","2014",2,2,0,165320,1133.5,138
"4831","17477","2014",3,3,0,52333.3333333333,556.333333333333,91.6666666666667
"4832","17478","2014",1,1,0,60000,896,67
"4833","17479","2014",4,4,0,88845,860.5,96.5
"4834","17480","2014",6,6,0,173916.666666667,1584.33333333333,112.333333333333
"4835","17482","2014",6,6,0,154666.666666667,1360.5,108.833333333333
"4836","17483","2014",20,20,0,170750,1980.95,88.25
"4837","17484","2014",33,33,0,165918.090909091,1937.93939393939,88.3030303030303
"4838","17485","2014",17,15,2,226090,3109.88235294118,75.8235294117647
"4839","17486","2014",28,28,0,197551.071428571,2511,84.1785714285714
"4840","18001","2014",4,4,0,87750,930.25,95.5
"4841","18002","2014",1,1,0,77500,1092,71
"4842","18003","2014",14,14,0,110071.428571429,1223.42857142857,88.9285714285714
"4843","18004","2014",13,13,0,122703.846153846,1305.38461538462,91.8461538461538
"4844","18005","2014",12,12,0,109125,1295.16666666667,86.8333333333333
"4845","18007","2014",1,1,0,377600,1987,190
"4846","18008","2014",8,8,0,119600,1045.5,120.5
"4847","18009","2014",1,1,0,40000,354,113
"4848","18010","2014",1,1,0,95000,1080,88
"4849","18011","2014",16,16,0,95420.625,1211.6875,79.875
"4850","18012","2014",4,4,0,91250,1005,99.25
"4851","18013","2014",2,2,0,81000,980,82.5
"4852","18014","2014",3,3,0,159666.666666667,1171.66666666667,136.333333333333
"4853","18015","2014",44,42,2,102533.227272727,1637.63636363636,72.3181818181818
"4854","18016","2014",3,3,0,100222.333333333,978,94.3333333333333
"4855","18017","2014",5,5,0,62946,937.8,70
"4856","18018","2014",5,5,0,110000,1393.8,85.6
"4857","18019","2014",6,6,0,87500,1064.66666666667,85.1666666666667
"4858","18020","2014",8,8,0,85587.5,1057.375,79.375
"4859","18021","2014",4,4,0,100250,857.75,109.75
"4860","18022","2014",4,4,0,75750,802.5,102.5
"4861","18023","2014",18,18,0,119988.055555556,1158.61111111111,103.222222222222
"4862","18024","2014",1,1,0,150000,1786,84
"4863","18025","2014",4,4,0,69750,841.75,87.75
"4864","18026","2014",3,3,0,131000,924,140.666666666667
"4865","18027","2014",9,9,0,90511.1111111111,953.888888888889,96.8888888888889
"4866","18028","2014",5,5,0,150700,1415,110.6
"4867","18029","2014",3,3,0,54333.3333333333,894,60.3333333333333
"4868","18030","2014",3,3,0,54666.6666666667,679.333333333333,80
"4869","18031","2014",3,3,0,81666.6666666667,1379,62.3333333333333
"4870","18032","2014",14,14,0,113271.428571429,1106.57142857143,99.5714285714286
"4871","18033","2014",655,345,310,118396.383206107,1517.88702290076,79.2320610687023
"4872","18034","2014",4,4,0,50750,613.5,81.5
"4873","18035","2014",5,5,0,113566.4,1162.2,98.2
"4874","18036","2014",4,4,0,123625,1202.75,108.75
"4875","18037","2014",11,11,0,121727.272727273,1357.18181818182,92.0909090909091
"4876","18040","2014",3,3,0,83000,838,101.333333333333
"4877","18041","2014",3,3,0,191553.333333333,1758.66666666667,108.666666666667
"4878","18042","2014",7,7,0,53714.2857142857,793.571428571429,73.7142857142857
"4879","18044","2014",2,2,0,138000,1169.5,118
"4880","18045","2014",4,4,0,98750,861.25,125.5
"4881","18046","2014",4,4,0,58125,691.25,83.5
"4882","18047","2014",4,4,0,150000,1219,127.5
"4883","18048","2014",4,4,0,121000,1433.75,86
"4884","18049","2014",5,5,0,53800,806,73.4
"4885","18050","2014",21,20,1,152253.333333333,1508.95238095238,103.666666666667
"4886","18051","2014",3,3,0,57666.6666666667,661,80.3333333333333
"4887","18052","2014",8,8,0,105725,1227.375,107.125
"4888","18053","2014",1,1,0,45000,804,56
"4889","18054","2014",4,4,0,152637.5,1171.25,119.5
"4890","18055","2014",11,11,0,79045.4545454545,1036,76
"4891","18056","2014",2,2,0,26750,515,52
"4892","18057","2014",27,27,0,74566.6666666667,841.925925925926,89.1851851851852
"4893","18058","2014",24,24,0,76875,975.208333333333,87.4166666666667
"4894","18059","2014",6,6,0,75700,800.166666666667,120
"4895","18060","2014",1,1,0,42300,863,49
"4896","18061","2014",1,1,0,26000,433,60
"4897","18062","2014",1,0,1,53000,1178,45
"4898","18063","2014",3,3,0,78900,1319,65
"4899","18064","2014",1,1,0,60000,429,140
"4900","18065","2014",2,2,0,20900,380.5,56
"4901","18066","2014",7,7,0,137492.857142857,1435.14285714286,103.857142857143
"4902","18067","2014",10,10,0,125250,1140.6,112.5
"4903","18069","2014",2,2,0,95900,827,116.5
"4904","18070","2014",2,2,0,86500,1152,76
"4905","18072","2014",2,2,0,59500,710.5,85
"4906","18073","2014",3,3,0,103333.333333333,1140.66666666667,91
"4907","18074","2014",2,2,0,80625,595.5,121
"4908","18075","2014",4,4,0,139664.25,1290.75,107.5
"4909","18076","2014",1,1,0,120000,1290,93
"4910","18077","2014",4,4,0,101500,862.5,107.75
"4911","18079","2014",1,1,0,90000,1364,66
"4912","18081","2014",3,3,0,105366.666666667,1222,83.6666666666667
"4913","18082","2014",16,16,0,100875,1337.3125,82.5
"4914","18083","2014",8,8,0,78500,986.75,80.625
"4915","18084","2014",2,2,0,46000,1173.5,38
"4916","18085","2014",1,1,0,84000,1050,80
"4917","18086","2014",6,6,0,79250,940.666666666667,83.5
"4918","18087","2014",38,36,2,82304.5526315789,983.315789473684,85.0263157894737
"4919","18088","2014",1,1,0,68000,1700,40
"4920","18089","2014",2,2,0,80000,1019,77.5
"4921","18090","2014",4,4,0,58500,889.25,62.75
"4922","18091","2014",5,5,0,95420,1134,85.8
"4923","18092","2014",6,6,0,142883.333333333,1420,105.333333333333
"4924","18093","2014",1,1,0,95000,613,155
"4925","18094","2014",4,4,0,54250,795.75,77.75
"4926","18096","2014",26,26,0,102704.5,1069.34615384615,99.3076923076923
"4927","18097","2014",11,11,0,173641.818181818,1548.09090909091,114.363636363636
"4928","18098","2014",3,3,0,141666.666666667,887.666666666667,162.333333333333
"4929","18100","2014",4,4,0,80000,893,90.25
"4930","18101","2014",8,8,0,121500,947.375,117
"4931","18102","2014",8,8,0,51011.125,746.125,66.125
"4932","18103","2014",18,17,1,69486.1111111111,863.888888888889,80.8333333333333
"4933","18104","2014",1,1,0,55000,902,61
"4934","18105","2014",4,4,0,129750,1364,101.5
"4935","18106","2014",3,3,0,54066.6666666667,663,79.6666666666667
"4936","18108","2014",41,41,0,92519.5121951219,1005.07317073171,94.0487804878049
"4937","18109","2014",18,18,0,104225,1313.22222222222,109.055555555556
"4938","18110","2014",10,10,0,95106,894.6,107.1
"4939","18111","2014",1,1,0,89000,1112,80
"4940","18112","2014",2,2,0,80000,838.5,104.5
"4941","18113","2014",3,3,0,51333.3333333333,687.666666666667,70
"4942","18115","2014",7,7,0,111257.142857143,1054,115.571428571429
"4943","18117","2014",9,9,0,73944.4444444444,922.222222222222,86.4444444444444
"4944","18118","2014",15,15,0,74173.3333333333,893.466666666667,84.2666666666667
"4945","18119","2014",2,2,0,111750,997,106
"4946","18120","2014",10,10,0,73780,883.4,79.3
"4947","18121","2014",1,1,0,33000,458,72
"4948","18122","2014",3,3,0,88000,1100.66666666667,79.6666666666667
"4949","18124","2014",2,2,0,60500,892.5,62
"4950","18125","2014",19,19,0,92447.3684210526,969.631578947368,103.578947368421
"4951","18126","2014",9,9,0,114516.111111111,1209.66666666667,92.7777777777778
"4952","18127","2014",12,12,0,60916.6666666667,897.333333333333,69.1666666666667
"4953","18128","2014",3,3,0,131733.333333333,1560,86.6666666666667
"4954","18129","2014",1,1,0,150000,1042,144
"4955","18130","2014",2,2,0,61500,737,69.5
"4956","18132","2014",2,2,0,122500,653,175
"4957","18133","2014",8,8,0,89451.625,1126.125,83.75
"4958","18134","2014",2,2,0,97500,1079.5,90.5
"4959","18135","2014",2,2,0,57260,716,81
"4960","18136","2014",2,2,0,125000,1273,106.5
"4961","18137","2014",8,8,0,77312.5,955.875,77.75
"4962","18138","2014",13,13,0,139451.538461538,1386.61538461538,102.076923076923
"4963","18139","2014",5,5,0,87200,852.2,104.2
"4964","18140","2014",16,16,0,102212.5,1089.5625,106.3125
"4965","18141","2014",43,43,0,94326.7441860465,1156.76744186047,82.6279069767442
"4966","18142","2014",7,7,0,105000,1489.85714285714,78.1428571428571
"4967","18143","2014",2,2,0,70500,940,75
"4968","18144","2014",3,3,0,69000,850,84
"4969","18145","2014",8,8,0,107500,1289.875,82.625
"4970","18146","2014",1,1,0,31000,525,59
"4971","18147","2014",2,2,0,40000,731,54
"4972","18148","2014",18,18,0,126792.833333333,1158.44444444444,111.944444444444
"4973","18149","2014",14,14,0,95059.2857142857,1023,82.7857142857143
"4974","18150","2014",2,2,0,128500,1020,117
"4975","18151","2014",5,5,0,86200,1516,70.2
"4976","18153","2014",3,3,0,70566.6666666667,710.333333333333,94
"4977","18154","2014",2,2,0,56250,462.5,117
"4978","18155","2014",5,5,0,190600,1164,129.6
"4979","18156","2014",2,2,0,113500,1002.5,112
"4980","18157","2014",1,1,0,113000,1284,88
"4981","18158","2014",1,1,0,160000,1720,93
"4982","18159","2014",9,9,0,96628.8888888889,1088.77777777778,91.5555555555556
"4983","18160","2014",12,12,0,77670.8333333333,965.666666666667,85.5
"4984","18161","2014",2,2,0,49500,629,78
"4985","18162","2014",2,2,0,63500,944.5,69.5
"4986","18163","2014",3,3,0,176600,1730.66666666667,121
"4987","18164","2014",1,1,0,55700,679,82
"4988","18165","2014",10,9,1,95765.7,1203.5,77.7
"4989","18166","2014",2,2,0,148250,1475.5,100.5
"4990","18167","2014",7,7,0,88357.1428571429,808.285714285714,102.428571428571
"4991","18168","2014",3,3,0,138333.333333333,1227.33333333333,120
"4992","18169","2014",1,1,0,53500,500,107
"4993","18170","2014",3,3,0,239000,1946,170.666666666667
"4994","18171","2014",2,2,0,117500,1116,106
"4995","18172","2014",7,7,0,89571.4285714286,1026.71428571429,85.1428571428571
"4996","18174","2014",2,2,0,70000,930.5,76
"4997","18175","2014",6,6,0,84166.6666666667,875.166666666667,97.6666666666667
"4998","18176","2014",4,4,0,100875,1390.75,74.25
"4999","18177","2014",1,1,0,20000,333,60
"5000","18178","2014",3,3,0,72666.6666666667,693,101
"5001","18179","2014",4,4,0,159500,1579,97
"5002","18180","2014",14,14,0,177538.785714286,1610.85714285714,112.5
"5003","18181","2014",10,10,0,102450,1206.6,85.8
"5004","18182","2014",2,2,0,90500,775,117
"5005","18183","2014",3,3,0,140333.333333333,1406,86.6666666666667
"5006","18184","2014",5,5,0,49600,735.6,72.8
"5007","18185","2014",2,2,0,73000,1381.5,50
"5008","18186","2014",4,4,0,72875,807.75,97.75
"5009","18187","2014",7,7,0,96214.2857142857,993.714285714286,95.2857142857143
"5010","18189","2014",5,5,0,111290,1134,100.8
"5011","18190","2014",7,7,0,101100,1007.14285714286,94.2857142857143
"5012","18192","2014",2,2,0,202500,1578,120
"5013","18193","2014",2,2,0,91000,843,99.5
"5014","18194","2014",9,9,0,108946.666666667,1297.55555555556,84.2222222222222
"5015","18195","2014",5,5,0,79400,1012.2,77.2
"5016","18196","2014",2,2,0,53750,774,69.5
"5017","18197","2014",93,85,8,86591.2903225807,1088.96774193548,83.4623655913979
"5018","18198","2014",1,1,0,25000,641,39
"5019","18199","2014",3,3,0,44833.3333333333,539,78
"5020","18200","2014",3,3,0,102000,1121.33333333333,86.3333333333333
"5021","18201","2014",10,10,0,122134.2,1194.7,112.9
"5022","18203","2014",1,1,0,60000,1000,60
"5023","18204","2014",1,1,0,90000,1184,76
"5024","18205","2014",62,62,0,146271.774193548,1595.56451612903,92.8548387096774
"5025","18206","2014",17,17,0,155720.588235294,1287.29411764706,118.882352941176
"5026","18207","2014",58,53,5,101610.172413793,1178.8275862069,87.7068965517241
"5027","18208","2014",7,7,0,100314.285714286,1568.28571428571,78.2857142857143
"5028","18209","2014",5,5,0,125600,1176.8,105.6
"5029","18210","2014",8,8,0,84425,915.75,90.25
"5030","18211","2014",5,5,0,124103,1191.4,105
"5031","18212","2014",4,4,0,145500,1351.25,116.5
"5032","18213","2014",42,41,1,124886.19047619,1350.09523809524,94.5952380952381
"5033","18214","2014",5,5,0,66024.4,830.8,88.4
"5034","18216","2014",3,3,0,128500,948,124.333333333333
"5035","18217","2014",2,2,0,177500,975,175
"5036","18218","2014",2,2,0,103750,1047,100
"5037","18219","2014",4,4,0,135500,1144.75,116
"5038","18220","2014",5,5,0,65320,922.4,68
"5039","18221","2014",4,4,0,153044,3066.5,61.75
"5040","18223","2014",12,12,0,98288.6666666667,1102.83333333333,95.5
"5041","18224","2014",2,2,0,60000,710,79
"5042","18225","2014",3,3,0,72833.6666666667,827.666666666667,90
"5043","18226","2014",2,2,0,126500,770,161
"5044","18227","2014",3,3,0,89000,852.333333333333,108
"5045","18228","2014",1,1,0,58000,1160,50
"5046","18229","2014",4,4,0,98563.75,1120.25,98
"5047","18230","2014",3,3,0,64666.6666666667,916,77.3333333333333
"5048","18231","2014",4,4,0,94375,1193.25,86
"5049","18232","2014",3,3,0,61666.6666666667,564,113
"5050","18233","2014",15,15,0,109340,1109.53333333333,99.3333333333333
"5051","18234","2014",2,2,0,80000,1278,69
"5052","18235","2014",11,11,0,104954.545454545,1297.54545454545,82
"5053","18236","2014",1,1,0,135000,1047,129
"5054","18238","2014",1,1,0,60000,741,81
"5055","18240","2014",7,7,0,78642.8571428571,819.714285714286,101.571428571429
"5056","18241","2014",23,22,1,106163.043478261,1143.21739130435,85.3913043478261
"5057","18242","2014",28,28,0,98141.9642857143,829.178571428571,106.571428571429
"5058","18243","2014",11,11,0,79390.9090909091,951.818181818182,98.9090909090909
"5059","18245","2014",5,5,0,63400,845.6,75.6
"5060","18246","2014",17,17,0,85613.2352941177,1383.17647058824,76.9411764705882
"5061","18247","2014",3,3,0,158250,1465.66666666667,108.333333333333
"5062","18248","2014",4,4,0,119357,1188.75,100.75
"5063","18249","2014",5,5,0,102970,900.2,111.8
"5064","18250","2014",1,1,0,69469,1389,50
"5065","18252","2014",1,1,0,40000,1000,40
"5066","18253","2014",4,4,0,101005,1172.75,80.5
"5067","18254","2014",5,5,0,186283.8,1281.2,145.6
"5068","18255","2014",12,12,0,184891.666666667,1724.66666666667,110.25
"5069","18256","2014",2,2,0,94000,2039.5,55
"5070","18257","2014",3,3,0,78333.3333333333,1078,72
"5071","18258","2014",9,9,0,96926.6666666667,1043.33333333333,89.4444444444444
"5072","18259","2014",4,4,0,93125,923.75,84.25
"5073","18260","2014",1,1,0,62500,1042,60
"5074","18261","2014",7,7,0,70082.8571428571,724.428571428571,93.8571428571429
"5075","18262","2014",4,4,0,61250,940.5,73.25
"5076","18263","2014",5,5,0,59100,822.6,82.8
"5077","18265","2014",5,5,0,66700,675,95.2
"5078","18266","2014",1,1,0,40000,455,88
"5079","18267","2014",27,27,0,141144.62962963,1435.25925925926,99.1111111111111
"5080","18268","2014",4,4,0,78125,882.75,91.5
"5081","18269","2014",6,6,0,95000,971.833333333333,108.666666666667
"5082","18270","2014",5,5,0,83180,810.6,100.6
"5083","18271","2014",10,10,0,159770,1416.9,122.9
"5084","18272","2014",6,6,0,68000,824,89
"5085","18273","2014",6,6,0,71523.3333333333,1002.66666666667,67.3333333333333
"5086","18274","2014",2,2,0,78100,969,126.5
"5087","18275","2014",4,4,0,84500,968.75,115
"5088","18276","2014",1,1,0,71100,790,90
"5089","18278","2014",7,7,0,53928.5714285714,617,86.5714285714286
"5090","18279","2014",225,186,39,82857.9688888889,1101.61333333333,80.3511111111111
"5091","18280","2014",8,8,0,147785,1293.5,114.25
"5092","18281","2014",17,17,0,107750,1075.17647058824,105.058823529412
"5093","18282","2014",3,3,0,112000,1374.33333333333,84.6666666666667
"5094","18283","2014",3,3,0,69950,918.666666666667,76
"5095","18284","2014",1,1,0,170000,1405,121
"5096","18285","2014",3,3,0,101666.666666667,1236,83.3333333333333
"5097","18286","2014",6,6,0,76843.6666666667,894.333333333333,82
"5098","18287","2014",5,5,0,119500,1297.4,81.4
"5099","18288","2014",1,1,0,113500,1091,104
"5100","18289","2014",9,9,0,106044.444444444,1024.11111111111,100.222222222222
"5101","18290","2014",5,5,0,201500,2003.2,99.8
"5102","19002","2014",4,4,0,80000,874,85.75
"5103","19003","2014",1,1,0,50000,926,54
"5104","19004","2014",6,6,0,111080.666666667,1075,104.333333333333
"5105","19005","2014",31,29,2,145163.870967742,1587.32258064516,90.1935483870968
"5106","19007","2014",10,10,0,120300,1235.6,98.7
"5107","19008","2014",4,4,0,106828,1155.75,88.5
"5108","19010","2014",30,24,6,118899.666666667,1232.83333333333,99.6
"5109","19011","2014",11,11,0,67954.5454545455,1001.09090909091,70.1818181818182
"5110","19012","2014",3,3,0,102000,1441.66666666667,72
"5111","19013","2014",16,16,0,129236.8125,1346.0625,99.0625
"5112","19014","2014",1,1,0,50000,676,74
"5113","19015","2014",6,6,0,72333.3333333333,981.5,86.6666666666667
"5114","19016","2014",2,2,0,85100,878.5,94.5
"5115","19018","2014",2,2,0,82500,1117.5,73
"5116","19019","2014",13,11,2,101984.615384615,1364.69230769231,81
"5117","19022","2014",2,2,0,132500,1852.5,71.5
"5118","19023","2014",9,9,0,96325.4444444444,1278.77777777778,84.7777777777778
"5119","19024","2014",7,7,0,90242.8571428571,1508.28571428571,67.7142857142857
"5120","19025","2014",4,4,0,141250,1400.75,99.75
"5121","19026","2014",1,1,0,1e+05,1429,70
"5122","19027","2014",3,3,0,56333.3333333333,620.666666666667,91.3333333333333
"5123","19029","2014",1,1,0,243262,1569,155
"5124","19030","2014",6,6,0,132748.833333333,1492.5,92.8333333333333
"5125","19031","2014",540,287,253,114363.003703704,1467.9,78.0833333333333
"5126","19033","2014",7,7,0,55157.1428571429,784.285714285714,77.5714285714286
"5127","19035","2014",4,4,0,95750,1307,71.25
"5128","19036","2014",17,17,0,95973.5294117647,1066.41176470588,102.529411764706
"5129","19037","2014",11,11,0,100456.363636364,1062.45454545455,99.0909090909091
"5130","19038","2014",10,10,0,143843,1598.6,93.2
"5131","19039","2014",7,5,2,78952.8571428571,901.142857142857,114.428571428571
"5132","19041","2014",3,3,0,120000,1239.33333333333,97.6666666666667
"5133","19042","2014",6,6,0,89640,1255.66666666667,70.8333333333333
"5134","19043","2014",3,3,0,97000,896,94.6666666666667
"5135","19045","2014",1,1,0,82900,964,86
"5136","19046","2014",1,1,0,73400,895,82
"5137","19047","2014",6,6,0,169908.333333333,1356.33333333333,123.5
"5138","19048","2014",6,6,0,122866.666666667,1022.33333333333,125.166666666667
"5139","19049","2014",5,5,0,188356.4,1588.4,125
"5140","19051","2014",3,2,1,109058.333333333,1821,75
"5141","19052","2014",1,1,0,85000,630,135
"5142","19054","2014",2,2,0,130000,1760.5,74.5
"5143","19055","2014",1,1,0,108650,1207,90
"5144","19056","2014",5,5,0,83000,1099.6,77.2
"5145","19058","2014",2,2,0,71000,1454,47
"5146","19059","2014",5,5,0,102562.8,899,108.6
"5147","19060","2014",4,4,0,91875,1143,88.25
"5148","19061","2014",3,3,0,141666.666666667,1271,112
"5149","19062","2014",7,7,0,88885.7142857143,944.571428571429,106.714285714286
"5150","19063","2014",27,24,3,173332.222222222,1710.92592592593,108.925925925926
"5151","19064","2014",1,1,0,65000,722,90
"5152","19066","2014",12,12,0,125701.666666667,1338.75,95.4166666666667
"5153","19067","2014",5,5,0,80200,1665.8,55
"5154","19068","2014",5,5,0,150990,1397.6,102
"5155","19070","2014",2,2,0,83250,1210.5,69
"5156","19072","2014",19,19,0,129946.263157895,1274.10526315789,102.789473684211
"5157","19073","2014",18,17,1,101488.888888889,1127.27777777778,91.0555555555556
"5158","19075","2014",4,4,0,140450,1979.5,80
"5159","19076","2014",3,3,0,93223.3333333333,1052,87.3333333333333
"5160","19078","2014",2,2,0,123000,1277.5,97
"5161","19079","2014",2,2,0,61875,821.5,78.5
"5162","19080","2014",1,1,0,162780,1403,116
"5163","19081","2014",5,5,0,95600,926.8,101.6
"5164","19082","2014",9,9,0,166469.444444444,1490.11111111111,110.555555555556
"5165","19083","2014",1,1,0,85000,1417,60
"5166","19084","2014",6,6,0,100758.333333333,803.333333333333,124.5
"5167","19085","2014",3,3,0,74287.6666666667,1465.33333333333,60.6666666666667
"5168","19088","2014",1,1,0,52000,1576,33
"5169","19089","2014",2,2,0,88000,1940.5,46
"5170","19093","2014",4,4,0,171500,1808.25,106.25
"5171","19094","2014",14,14,0,91200,1241.92857142857,78.3571428571429
"5172","19096","2014",2,2,0,152750,1377.5,109.5
"5173","19097","2014",2,2,0,86500,1496,72
"5174","19098","2014",3,3,0,83540,960.333333333333,80.3333333333333
"5175","19100","2014",6,6,0,75925,1071.66666666667,76
"5176","19101","2014",10,10,0,91000,1016.8,93.2
"5177","19103","2014",1,1,0,28300,382,74
"5178","19106","2014",5,5,0,74160,945.2,77.6
"5179","19107","2014",14,11,3,133824.071428571,1504.35714285714,97.3571428571429
"5180","19110","2014",1,1,0,75500,1007,75
"5181","19111","2014",1,1,0,41000,820,50
"5182","19113","2014",8,8,0,101462.5,1558.125,70.875
"5183","19115","2014",5,5,0,143540,1782,80.2
"5184","19116","2014",4,4,0,91362.5,909.5,111.5
"5185","19117","2014",5,5,0,94094,1414.8,78
"5186","19119","2014",1,1,0,195000,1681,116
"5187","19120","2014",3,3,0,178891.666666667,2462,83
"5188","19121","2014",13,13,0,109115.384615385,1220,101.307692307692
"5189","19123","2014",66,62,4,134120.696969697,1689.22727272727,88.6515151515152
"5190","19124","2014",2,2,0,116000,1276.5,93.5
"5191","19125","2014",10,10,0,92420,1241.7,79.1
"5192","19126","2014",2,2,0,61000,1039.5,59
"5193","19128","2014",5,5,0,70380,894.2,79.2
"5194","19129","2014",10,10,0,118170.5,1101.7,113
"5195","19130","2014",2,2,0,67432.5,1027.5,69
"5196","19131","2014",4,4,0,47862.5,593.75,88
"5197","19132","2014",1,1,0,39000,684,57
"5198","19134","2014",5,5,0,62450,768.4,85.6
"5199","19136","2014",15,14,1,72333.3333333333,882.4,81.3333333333333
"5200","19138","2014",17,17,0,169090,1692,102.117647058824
"5201","19139","2014",1,1,0,45000,900,50
"5202","19140","2014",3,3,0,117666.666666667,1205,96.3333333333333
"5203","19141","2014",2,2,0,88150,1120,79.5
"5204","19142","2014",1,1,0,97000,2205,44
"5205","19143","2014",5,5,0,133300,1235.6,105.8
"5206","19144","2014",3,3,0,53333.3333333333,820,66.6666666666667
"5207","19145","2014",2,2,0,146050,1505,97
"5208","19146","2014",17,16,1,137829.411764706,1381.52941176471,101.235294117647
"5209","19147","2014",5,5,0,157600,1522.6,110
"5210","19148","2014",12,12,0,74166.6666666667,865,97.0833333333333
"5211","19149","2014",2,2,0,111000,1484.5,72
"5212","19150","2014",2,2,0,131025,1416,93
"5213","19151","2014",9,9,0,121633.333333333,1260.55555555556,96.5555555555556
"5214","19152","2014",4,4,0,142500,1217.25,115.25
"5215","19153","2014",38,32,6,112699.210526316,1511.07894736842,83.7368421052632
"5216","19154","2014",2,2,0,130000,1508,83.5
"5217","19155","2014",1,1,0,43000,717,60
"5218","19157","2014",2,2,0,30500,416.5,73.5
"5219","19159","2014",2,2,0,121500,1156.5,105.5
"5220","19160","2014",1,1,0,102600,933,110
"5221","19161","2014",6,6,0,125158.333333333,1307.5,92
"5222","19162","2014",9,9,0,98222.2222222222,1204.55555555556,80
"5223","19163","2014",4,4,0,167250,1474.25,115.25
"5224","19164","2014",5,5,0,101821.6,1013,114.2
"5225","19166","2014",1,1,0,110000,1170,94
"5226","19167","2014",2,2,0,94000,1297.5,74
"5227","19168","2014",1,1,0,30000,435,69
"5228","19170","2014",1,1,0,50000,495,101
"5229","19175","2014",1,1,0,88000,2095,42
"5230","19176","2014",6,5,1,111750,1177.33333333333,93.3333333333333
"5231","19178","2014",5,5,0,195280,1708,123.4
"5232","19179","2014",1,1,0,40000,1143,35
"5233","19180","2014",5,5,0,126320,1374.4,88.2
"5234","19181","2014",7,7,0,103857.142857143,1418,80.1428571428571
"5235","19182","2014",9,9,0,113405.555555556,1545.33333333333,77.8888888888889
"5236","19186","2014",1,1,0,70900,921,77
"5237","19187","2014",4,4,0,117192.5,1004,119.75
"5238","19188","2014",1,1,0,45000,1125,40
"5239","19190","2014",1,1,0,140000,1918,73
"5240","19191","2014",3,3,0,183666.666666667,1478.66666666667,129
"5241","19192","2014",4,4,0,67500,900.25,75
"5242","19194","2014",8,8,0,148217.75,1373.75,115
"5243","19195","2014",1,1,0,90300,951,95
"5244","19196","2014",2,2,0,113225,917,131.5
"5245","19198","2014",1,1,0,123000,946,130
"5246","19200","2014",1,1,0,146000,973,150
"5247","19201","2014",1,1,0,228000,1146,199
"5248","19202","2014",5,5,0,176600,1628.2,104
"5249","19203","2014",6,6,0,111166.666666667,1004.83333333333,108.333333333333
"5250","19204","2014",2,2,0,169875,1467,114.5
"5251","19207","2014",5,5,0,141030,1409,97.6
"5252","19208","2014",1,1,0,57000,1425,40
"5253","19211","2014",5,5,0,123860,1233.8,110.6
"5254","19212","2014",1,1,0,136625,1301,105
"5255","19213","2014",6,6,0,70083.3333333333,879.333333333333,77.6666666666667
"5256","19214","2014",1,1,0,92000,582,158
"5257","19216","2014",4,4,0,106500,875.25,125
"5258","19217","2014",1,1,0,176000,2444,72
"5259","19219","2014",1,1,0,101000,918,110
"5260","19220","2014",4,4,0,130937.5,1589.25,80.25
"5261","19221","2014",1,1,0,150000,1250,120
"5262","19222","2014",9,9,0,101637.777777778,1000.44444444444,108.777777777778
"5263","19223","2014",1,1,0,178800,2292,78
"5264","19225","2014",1,1,0,78000,1219,64
"5265","19226","2014",1,1,0,80300,681,118
"5266","19227","2014",9,9,0,139688.444444444,1425.33333333333,99
"5267","19229","2014",38,32,6,131355,1511.26315789474,87.6578947368421
"5268","19230","2014",1,1,0,130000,2031,64
"5269","19231","2014",1,1,0,99000,1571,63
"5270","19232","2014",1,1,0,114500,1080,106
"5271","19233","2014",2,2,0,127025,1576.5,80
"5272","19234","2014",3,3,0,125896.666666667,1160.33333333333,113
"5273","19235","2014",3,3,0,124333.333333333,1436.33333333333,82.3333333333333
"5274","19236","2014",6,6,0,108733.333333333,1179.66666666667,100.833333333333
"5275","19237","2014",2,2,0,121250,1276.5,99.5
"5276","19238","2014",3,3,0,89000,1105.33333333333,80.6666666666667
"5277","19239","2014",3,3,0,96983.3333333333,897.333333333333,108
"5278","19240","2014",3,3,0,29333.3333333333,567.666666666667,54.6666666666667
"5279","19241","2014",2,2,0,50000,581.5,84.5
"5280","19242","2014",3,3,0,71666.6666666667,1066.33333333333,65.6666666666667
"5281","19243","2014",8,8,0,88375,1195.75,72.5
"5282","19245","2014",2,2,0,60000,446.5,135
"5283","19246","2014",7,7,0,161485.714285714,1558,109.857142857143
"5284","19247","2014",5,5,0,121001.8,976.4,115
"5285","19248","2014",5,5,0,102434,979.6,106.2
"5286","19249","2014",3,2,1,83753.3333333333,1127,73
"5287","19250","2014",4,4,0,79000,872,86.5
"5288","19251","2014",1,1,0,66000,1119,59
"5289","19252","2014",2,2,0,137250,1397.5,111
"5290","19254","2014",2,2,0,104420,1176.5,87.5
"5291","19255","2014",15,15,0,119434,1266.4,102.933333333333
"5292","19256","2014",3,3,0,70166.6666666667,773.333333333333,95.6666666666667
"5293","19257","2014",2,2,0,120500,1431.5,82.5
"5294","19260","2014",3,3,0,107333.333333333,1041.33333333333,90.6666666666667
"5295","19261","2014",4,4,0,70250,723.5,108.75
"5296","19263","2014",4,4,0,85250,1116.5,81.25
"5297","19264","2014",4,4,0,103700,990,105
"5298","19265","2014",7,7,0,66000,752.428571428571,88.5714285714286
"5299","19269","2014",20,20,0,70472,940.85,82.35
"5300","19270","2014",5,5,0,91120,1082.2,78.2
"5301","19271","2014",1,1,0,55000,764,72
"5302","19272","2014",115,48,67,77778.2086956522,1011.86956521739,76.5739130434783
"5303","19273","2014",6,6,0,128583.333333333,1361.83333333333,90.6666666666667
"5304","19274","2014",24,23,1,176018.041666667,1663.04166666667,105.375
"5305","19275","2014",63,51,12,95263.9841269841,1140.66666666667,86.9523809523809
"5306","19276","2014",26,22,4,89704.2307692308,983.423076923077,88.5
"5307","19278","2014",12,12,0,142077.5,1345.66666666667,127.833333333333
"5308","19279","2014",6,6,0,103259.666666667,1123.66666666667,95.6666666666667
"5309","19280","2014",1,1,0,30000,1111,27
"5310","19285","2014",10,10,0,108298,1092,93
"5311","19286","2014",9,8,1,148811.111111111,1238.66666666667,123.333333333333
"5312","19287","2014",3,3,0,113666.666666667,1081.33333333333,107.666666666667
"5313","19288","2014",11,11,0,97973.1818181818,1175.90909090909,73.1818181818182
"5314","19289","2014",4,4,0,141500,1601.5,89
"5315","21001","2014",2,2,0,134500,1902.5,70.5
"5316","21002","2014",4,4,0,130200,1278.75,97.25
"5317","21003","2014",11,9,2,241586.363636364,2645.27272727273,97.2727272727273
"5318","21004","2014",1,1,0,50000,500,100
"5319","21005","2014",16,14,2,167741.75,1824.75,95.0625
"5320","21006","2014",4,4,0,85412.5,939,81.75
"5321","21007","2014",1,1,0,92000,1022,90
"5322","21008","2014",1,1,0,105000,1329,79
"5323","21010","2014",1,1,0,85000,1371,62
"5324","21011","2014",1,1,0,1e+05,1099,91
"5325","21012","2014",2,2,0,230000,1393.5,179
"5326","21013","2014",10,10,0,201435,1724.6,119.4
"5327","21014","2014",1,1,0,80000,727,110
"5328","21016","2014",6,6,0,195883.333333333,1900.5,105
"5329","21017","2014",6,6,0,134516.666666667,1566,83
"5330","21018","2014",2,2,0,171325,1516.5,112.5
"5331","21020","2014",2,2,0,90000,1027.5,86.5
"5332","21021","2014",16,15,1,222004.6875,1947.3125,121
"5333","21022","2014",3,3,0,158533.333333333,1613.66666666667,101
"5334","21023","2014",8,7,1,100812.5,1103.375,96.875
"5335","21024","2014",1,1,0,20000,556,36
"5336","21025","2014",1,1,0,180000,1417,127
"5337","21027","2014",5,5,0,325293.8,2488.6,130.8
"5338","21028","2014",5,5,0,106980,1245.4,81.6
"5339","21029","2014",1,1,0,186000,1114,167
"5340","21030","2014",1,1,0,230000,1544,149
"5341","21031","2014",4,4,0,123500,1108.25,113
"5342","21032","2014",3,3,0,127183.333333333,1096,125.333333333333
"5343","21033","2014",1,1,0,37000,1850,20
"5344","21035","2014",1,1,0,47000,2238,21
"5345","21037","2014",5,5,0,120600,1793,73.2
"5346","21038","2014",56,34,22,115732.142857143,1372.23214285714,84.2321428571429
"5347","21040","2014",1,1,0,60000,606,99
"5348","21042","2014",1,1,0,255000,2576,99
"5349","21044","2014",2,2,0,63310,924.5,66
"5350","21047","2014",1,1,0,50000,625,80
"5351","21048","2014",5,5,0,219800,1972.2,112.4
"5352","21049","2014",1,1,0,124729,974,128
"5353","21050","2014",2,2,0,110000,879.5,140.5
"5354","21051","2014",2,2,0,152795,1349.5,114
"5355","21053","2014",2,2,0,95000,1024.5,93
"5356","21054","2014",236,108,128,174692.06779661,2090.71186440678,84.521186440678
"5357","21056","2014",10,9,1,173130,1778.9,103.9
"5358","21058","2014",1,1,0,96000,1116,86
"5359","21059","2014",10,10,0,290664.4,2314.8,128
"5360","21061","2014",1,1,0,75000,750,100
"5361","21062","2014",1,1,0,144050,1412,102
"5362","21063","2014",1,1,0,167000,913,183
"5363","21064","2014",1,1,0,120000,1034,116
"5364","21066","2014",1,1,0,129050,1075,120
"5365","21067","2014",6,6,0,162738.333333333,1668.5,97.6666666666667
"5366","21071","2014",6,6,0,168958.333333333,1346.66666666667,134.166666666667
"5367","21074","2014",2,2,0,135000,959,140
"5368","21075","2014",1,1,0,89000,517,172
"5369","21076","2014",8,8,0,196687.5,1781.375,110.875
"5370","21078","2014",1,1,0,163000,1468,111
"5371","21079","2014",1,1,0,110000,815,135
"5372","21080","2014",10,10,0,164357,1417.8,121.1
"5373","21081","2014",3,3,0,171821,1507,104.333333333333
"5374","21083","2014",2,2,0,103500,2408,58
"5375","21086","2014",7,7,0,176000,1635.57142857143,108
"5376","21087","2014",9,9,0,112088.888888889,1111.44444444444,105.888888888889
"5377","21088","2014",2,2,0,154450,1452,122
"5378","21089","2014",2,2,0,185500,1868.5,100
"5379","21091","2014",1,1,0,40000,784,51
"5380","21092","2014",2,2,0,92500,1172.5,74
"5381","21093","2014",1,1,0,30000,400,75
"5382","21094","2014",4,4,0,129018.5,1362,93.75
"5383","21096","2014",2,2,0,79450,674,132
"5384","21097","2014",1,1,0,182000,1300,140
"5385","21098","2014",2,2,0,134000,1103.5,126.5
"5386","21099","2014",4,4,0,118000,1420.75,82.25
"5387","21101","2014",2,2,0,152500,1139.5,133
"5388","21102","2014",2,2,0,125500,1775.5,72.5
"5389","21103","2014",27,27,0,126141.296296296,1460.51851851852,86.7777777777778
"5390","21105","2014",6,6,0,216591.666666667,2124.33333333333,103.166666666667
"5391","21106","2014",6,6,0,229530,2080.83333333333,113
"5392","21107","2014",8,8,0,312481.25,2362.625,133.875
"5393","21108","2014",1,1,0,54000,2160,25
"5394","21109","2014",1,1,0,130000,1625,80
"5395","21110","2014",3,3,0,199943.666666667,1626,118.666666666667
"5396","21111","2014",3,3,0,274333.333333333,1930.66666666667,138.333333333333
"5397","21112","2014",6,6,0,123108.333333333,1439.83333333333,88.1666666666667
"5398","21113","2014",1,1,0,263000,2229,118
"5399","21114","2014",1,1,0,1e+05,1408,71
"5400","21115","2014",9,9,0,90194.4444444444,1174.66666666667,77.2222222222222
"5401","21116","2014",3,3,0,87500,740,113.333333333333
"5402","21117","2014",1,1,0,80000,1026,78
"5403","21118","2014",1,1,0,143000,1362,105
"5404","21120","2014",4,4,0,120250,1069,111.75
"5405","21122","2014",3,3,0,99333.3333333333,1095.66666666667,92.6666666666667
"5406","21123","2014",1,1,0,65000,650,100
"5407","21124","2014",3,3,0,42333.3333333333,678.666666666667,69.6666666666667
"5408","21125","2014",1,1,0,106500,995,107
"5409","21126","2014",5,5,0,122300,1462.2,83.2
"5410","21127","2014",2,2,0,176155,1660.5,102.5
"5411","21128","2014",2,2,0,130975,1830.5,69.5
"5412","21130","2014",4,4,0,201662.5,1744.25,116.5
"5413","21131","2014",9,9,0,125811.111111111,1441.22222222222,90.8888888888889
"5414","21132","2014",4,4,0,257942.5,1610.75,163.25
"5415","21133","2014",3,3,0,158666.666666667,1596.33333333333,94.3333333333333
"5416","21135","2014",4,4,0,178325,1604.75,114.25
"5417","21138","2014",7,7,0,96928.5714285714,991.571428571429,105
"5418","21139","2014",4,4,0,138725,1419,100
"5419","21140","2014",1,1,0,106500,1076,99
"5420","21141","2014",2,2,0,72500,1037,76
"5421","21142","2014",1,1,0,55000,444,124
"5422","21145","2014",1,1,0,150000,1282,117
"5423","21146","2014",1,1,0,116000,1706,68
"5424","21148","2014",3,3,0,108166.666666667,719,128.666666666667
"5425","21150","2014",4,4,0,248750,1738.75,141.75
"5426","21151","2014",1,1,0,75000,852,88
"5427","21152","2014",1,1,0,160000,1739,92
"5428","21153","2014",1,1,0,58000,1055,55
"5429","21154","2014",51,28,23,86182.1176470588,930.156862745098,91.9411764705882
"5430","21156","2014",1,1,0,380000,5938,64
"5431","21161","2014",4,4,0,90125,907.25,100
"5432","21162","2014",4,4,0,165250,1539.25,107
"5433","21163","2014",2,2,0,65000,1011,87
"5434","21164","2014",1,1,0,90000,1429,63
"5435","21166","2014",114,42,72,136531.885964912,1830.19298245614,74.8771929824561
"5436","21167","2014",3,3,0,130233.333333333,1400.33333333333,97.6666666666667
"5437","21168","2014",2,2,0,33750,869,40
"5438","21169","2014",2,2,0,184000,2506,69.5
"5439","21170","2014",3,3,0,174000,1535,116.666666666667
"5440","21171","2014",108,36,72,169317.435185185,2071.74074074074,83.1388888888889
"5441","21172","2014",2,2,0,66000,617,113
"5442","21173","2014",8,8,0,187450,1583.5,115.25
"5443","21175","2014",2,2,0,132500,1061,124
"5444","21177","2014",1,1,0,55000,500,110
"5445","21178","2014",2,2,0,236750,1709.5,140
"5446","21179","2014",5,5,0,300600,2282.6,132.2
"5447","21180","2014",1,1,0,150840,1207,125
"5448","21181","2014",2,2,0,162500,1186,138.5
"5449","21182","2014",2,2,0,75500,950.5,92
"5450","21183","2014",17,17,0,169096.470588235,1679.94117647059,102.647058823529
"5451","21185","2014",2,2,0,267500,1808,149.5
"5452","21186","2014",6,5,1,130083.333333333,1569.16666666667,83
"5453","21189","2014",5,5,0,182612,1660.6,113.8
"5454","21190","2014",2,2,0,332500,2382.5,128.5
"5455","21191","2014",7,7,0,146795.714285714,1614.42857142857,98
"5456","21192","2014",2,2,0,277500,2191.5,125
"5457","21193","2014",5,5,0,197200,1513.6,124.6
"5458","21194","2014",10,10,0,162971.7,1714.9,98.3
"5459","21195","2014",4,4,0,118575,1290.75,91.5
"5460","21196","2014",9,9,0,158883.333333333,1637.55555555556,113.333333333333
"5461","21198","2014",4,4,0,120000,1123.5,104
"5462","21199","2014",2,2,0,117100,1080,110
"5463","21200","2014",11,11,0,301409.090909091,2638,110.818181818182
"5464","21202","2014",1,1,0,130000,812,160
"5465","21203","2014",1,1,0,80000,620,129
"5466","21205","2014",1,1,0,1e+05,1333,75
"5467","21207","2014",1,1,0,88200,938,94
"5468","21208","2014",3,3,0,126333.333333333,1516.66666666667,83.3333333333333
"5469","21209","2014",15,15,0,251786.666666667,2347.8,111.933333333333
"5470","21210","2014",7,7,0,116857.142857143,1408.14285714286,80
"5471","21211","2014",1,1,0,168400,936,180
"5472","21212","2014",2,1,1,129950,1196.5,110.5
"5473","21214","2014",1,1,0,134300,1385,97
"5474","21215","2014",1,1,0,165700,2180,76
"5475","21217","2014",1,1,0,180000,1622,111
"5476","21220","2014",3,3,0,111166.666666667,986.666666666667,123.333333333333
"5477","21223","2014",16,13,3,303651.875,2647.75,115.625
"5478","21225","2014",1,1,0,106000,1536,69
"5479","21226","2014",6,6,0,63383,848.5,76.6666666666667
"5480","21227","2014",2,2,0,145000,1365,105.5
"5481","21228","2014",2,2,0,136650,1576.5,107.5
"5482","21230","2014",5,5,0,144500,1307.8,111.8
"5483","21231","2014",2284,360,1924,136296.352889667,2176.93739054291,63.6090192644483
"5484","21233","2014",1,1,0,166200,1539,108
"5485","21236","2014",3,3,0,149450,1684,89.3333333333333
"5486","21238","2014",2,2,0,189234,1718,127.5
"5487","21239","2014",7,7,0,127592.857142857,1211,111.571428571429
"5488","21240","2014",5,5,0,162040,1468.8,115.8
"5489","21241","2014",4,4,0,172750,1657,106
"5490","21242","2014",3,3,0,154000,1675.33333333333,92.3333333333333
"5491","21245","2014",2,2,0,226200,1574.5,149
"5492","21246","2014",1,1,0,90000,826,109
"5493","21247","2014",8,8,0,124518.75,1247.625,107.25
"5494","21249","2014",6,6,0,136466.666666667,1587,106.833333333333
"5495","21250","2014",2,2,0,135000,1085,123
"5496","21251","2014",2,2,0,109250,1070.5,107
"5497","21252","2014",1,1,0,83000,769,108
"5498","21253","2014",2,2,0,62500,775.5,85
"5499","21254","2014",3,3,0,96666.6666666667,1376.33333333333,71.3333333333333
"5500","21255","2014",2,2,0,90750,927,95.5
"5501","21256","2014",1,1,0,181500,1911,95
"5502","21258","2014",2,2,0,89000,1028.5,80
"5503","21259","2014",4,4,0,123302.5,1250,100
"5504","21260","2014",3,3,0,124666.666666667,1583,79.6666666666667
"5505","21261","2014",5,5,0,144700,1342.4,100.4
"5506","21262","2014",1,1,0,36900,351,105
"5507","21263","2014",16,16,0,310787.5,2465.375,128.0625
"5508","21264","2014",1,1,0,25000,625,40
"5509","21265","2014",6,6,0,236500,2386.83333333333,100.166666666667
"5510","21266","2014",1,1,0,247500,2250,110
"5511","21267","2014",1,1,0,150000,2174,69
"5512","21268","2014",3,3,0,150166.666666667,1567,89.3333333333333
"5513","21269","2014",2,2,0,155630,1523,104
"5514","21270","2014",1,1,0,175000,2011,87
"5515","21271","2014",4,4,0,142250,1407.25,97.25
"5516","21272","2014",1,1,0,188150,1394,135
"5517","21273","2014",11,11,0,233336.818181818,2146.18181818182,110
"5518","21274","2014",3,3,0,77763.3333333333,1111.66666666667,70
"5519","21275","2014",1,1,0,110000,335,328
"5520","21276","2014",1,1,0,111500,558,200
"5521","21277","2014",9,9,0,125158.888888889,1273.88888888889,100.333333333333
"5522","21278","2014",94,44,50,210996.904255319,2334.28723404255,90.6808510638298
"5523","21280","2014",2,2,0,105000,951,95
"5524","21281","2014",3,3,0,130333.333333333,1601.33333333333,89.6666666666667
"5525","21282","2014",1,1,0,60000,659,91
"5526","21284","2014",1,1,0,168220,1558,108
"5527","21285","2014",2,2,0,151050,1354,111.5
"5528","21287","2014",2,2,0,87000,1268.5,62.5
"5529","21288","2014",4,4,0,116687.5,1226.75,93.25
"5530","21289","2014",1,1,0,69000,986,70
"5531","21290","2014",14,14,0,202821.428571429,1394.57142857143,150.214285714286
"5532","21291","2014",2,2,0,90000,1329.5,63.5
"5533","21292","2014",53,43,10,161166.037735849,1779.96226415094,92.0377358490566
"5534","21293","2014",1,1,0,188000,1709,110
"5535","21294","2014",2,2,0,191825,1638,119
"5536","21295","2014",12,6,6,139370.75,2108.33333333333,66.5833333333333
"5537","21296","2014",3,3,0,68333.3333333333,615,111.666666666667
"5538","21297","2014",2,2,0,207550,2043.5,108
"5539","21300","2014",1,1,0,103000,896,115
"5540","21301","2014",1,1,0,151000,1248,121
"5541","21304","2014",6,6,0,82039.6666666667,1059.66666666667,75.6666666666667
"5542","21305","2014",1,1,0,73000,912,80
"5543","21306","2014",2,2,0,90000,1786,51
"5544","21307","2014",1,1,0,221500,1507,147
"5545","21315","2014",7,7,0,249357.142857143,2220.14285714286,113.571428571429
"5546","21316","2014",4,4,0,72850,950,95.5
"5547","21317","2014",37,36,1,173318.351351351,1836.72972972973,104.72972972973
"5548","21319","2014",5,5,0,150637,1264.8,120.6
"5549","21320","2014",3,3,0,122000,1510.33333333333,80.3333333333333
"5550","21322","2014",1,1,0,1e+05,1282,78
"5551","21324","2014",1,1,0,150000,1948,77
"5552","21325","2014",1,1,0,90000,1286,70
"5553","21327","2014",2,2,0,61500,645,96.5
"5554","21330","2014",2,2,0,207645,1878.5,108
"5555","21332","2014",7,6,1,123828.571428571,1268,108
"5556","21334","2014",3,3,0,81533.3333333333,833,100
"5557","21335","2014",3,3,0,197333.333333333,1397,140
"5558","21336","2014",10,8,2,90500,788.5,122.4
"5559","21337","2014",14,14,0,118675,1435.57142857143,85.9285714285714
"5560","21338","2014",4,4,0,75500,929.25,73
"5561","21339","2014",4,4,0,148540,1586,90.75
"5562","21340","2014",2,2,0,161640,956.5,177
"5563","21342","2014",2,2,0,64400,796.5,80.5
"5564","21343","2014",1,1,0,20000,741,27
"5565","21344","2014",6,6,0,127800,1603.83333333333,87.5
"5566","21345","2014",5,5,0,80938,980.2,79.6
"5567","21346","2014",3,3,0,158850,1348,141
"5568","21347","2014",3,3,0,277333.333333333,2008,142.666666666667
"5569","21349","2014",3,3,0,51000,798.666666666667,61
"5570","21351","2014",10,10,0,163792.5,1652,103.9
"5571","21352","2014",1,1,0,175600,1084,162
"5572","21353","2014",6,5,1,168057.5,1564.83333333333,112.833333333333
"5573","21355","2014",59,35,24,157242.372881356,2060.62711864407,75.4576271186441
"5574","21356","2014",18,18,0,125363.055555556,1387.27777777778,91.1111111111111
"5575","21357","2014",1,1,0,85000,773,110
"5576","21358","2014",1,1,0,103500,1150,90
"5577","21359","2014",1,1,0,70000,368,190
"5578","21360","2014",1,1,0,270000,2700,100
"5579","21361","2014",4,4,0,159500,1731.75,93.5
"5580","21362","2014",2,2,0,131750,1029,128.5
"5581","21363","2014",1,1,0,150000,1200,125
"5582","21364","2014",2,2,0,167500,1426.5,127.5
"5583","21366","2014",2,2,0,164900,1165.5,142.5
"5584","21367","2014",5,5,0,127840,1489,86.4
"5585","21368","2014",5,5,0,166000,2291.4,61.8
"5586","21369","2014",1,1,0,135500,1715,79
"5587","21370","2014",2,2,0,187656,1836,103
"5588","21371","2014",9,9,0,114733.333333333,1096.88888888889,102.444444444444
"5589","21373","2014",8,6,2,125180,1494.125,98.125
"5590","21374","2014",3,3,0,70333.3333333333,791.666666666667,89.6666666666667
"5591","21375","2014",3,3,0,51502,720.333333333333,78.3333333333333
"5592","21376","2014",2,2,0,177900,1453.5,123.5
"5593","21377","2014",1,1,0,233000,1324,176
"5594","21378","2014",3,3,0,75333.3333333333,584,140.333333333333
"5595","21379","2014",1,1,0,55680,456,122
"5596","21381","2014",1,1,0,166000,1137,146
"5597","21382","2014",1,1,0,68000,907,75
"5598","21383","2014",9,9,0,108722.222222222,1366.22222222222,84.2222222222222
"5599","21385","2014",5,5,0,141400,1453.6,101
"5600","21386","2014",6,6,0,75833.3333333333,949.5,93.8333333333333
"5601","21387","2014",2,2,0,277250,1395,221
"5602","21388","2014",3,3,0,197266.666666667,1765.66666666667,113.333333333333
"5603","21390","2014",51,48,3,187744.31372549,2077.96078431373,89.2941176470588
"5604","21391","2014",7,7,0,227224.285714286,2341,97.2857142857143
"5605","21393","2014",3,3,0,65000,692.333333333333,94
"5606","21394","2014",2,2,0,124500,1652.5,75.5
"5607","21395","2014",1,1,0,260000,1413,184
"5608","21397","2014",2,2,0,107500,1299,80.5
"5609","21398","2014",2,2,0,160500,1480.5,110.5
"5610","21399","2014",2,2,0,110567.5,780,137
"5611","21401","2014",5,5,0,128252,1665.6,76.2
"5612","21403","2014",2,2,0,52750,984,55
"5613","21404","2014",4,4,0,161250,1367.75,115.25
"5614","21405","2014",7,7,0,255235.714285714,1913.85714285714,133.142857142857
"5615","21406","2014",2,2,0,198860,1202.5,173
"5616","21407","2014",2,2,0,204500,2073.5,98.5
"5617","21408","2014",18,14,4,236147.222222222,1997.38888888889,112.055555555556
"5618","21409","2014",2,2,0,267590,2112,126.5
"5619","21410","2014",1,1,0,93900,894,105
"5620","21411","2014",5,4,1,146990,1578.4,87.8
"5621","21412","2014",12,11,1,254333.333333333,2180,113.083333333333
"5622","21413","2014",4,4,0,108537.5,1437.5,82.25
"5623","21416","2014",16,8,8,135218.75,1650.125,89.625
"5624","21417","2014",2,2,0,152500,1188.5,124.5
"5625","21419","2014",3,3,0,94000,1763.66666666667,83.6666666666667
"5626","21420","2014",1,1,0,20000,513,39
"5627","21421","2014",3,3,0,221833.333333333,1546.66666666667,149
"5628","21423","2014",3,3,0,143166.666666667,2329.33333333333,64.6666666666667
"5629","21424","2014",2,2,0,71000,996,66.5
"5630","21425","2014",25,21,4,97860,1213.92,80.4
"5631","21426","2014",2,2,0,127491.5,1127.5,131.5
"5632","21427","2014",2,2,0,150100,1558.5,86
"5633","21429","2014",2,2,0,84000,1072,78.5
"5634","21430","2014",2,2,0,57000,1383.5,48
"5635","21431","2014",3,3,0,168595.333333333,1331,126.666666666667
"5636","21433","2014",5,5,0,94160,934,111
"5637","21435","2014",3,3,0,118833.333333333,959,127.666666666667
"5638","21437","2014",1,1,0,198000,1329,149
"5639","21440","2014",2,2,0,136000,1116.5,124
"5640","21441","2014",2,2,0,221000,865,239
"5641","21442","2014",4,3,1,178537.5,1389,118.75
"5642","21444","2014",1,1,0,115000,1337,86
"5643","21445","2014",2,2,0,161500,1745,111.5
"5644","21446","2014",1,1,0,110000,1375,80
"5645","21447","2014",2,2,0,139500,1128,128
"5646","21448","2014",1,1,0,90000,1139,79
"5647","21449","2014",4,4,0,91250,987,84.5
"5648","21450","2014",1,1,0,75000,1875,40
"5649","21452","2014",12,11,1,199691.666666667,2166,95.75
"5650","21454","2014",1,1,0,1e+05,1493,67
"5651","21455","2014",2,2,0,83990,726.5,146.5
"5652","21456","2014",1,1,0,185000,1850,100
"5653","21458","2014",6,6,0,184653.333333333,1573.83333333333,111.166666666667
"5654","21459","2014",3,3,0,146516.666666667,1337.33333333333,104
"5655","21461","2014",15,15,0,130779,1144.33333333333,107.4
"5656","21462","2014",8,5,3,200187.5,2333.125,85.75
"5657","21463","2014",1,1,0,64000,1016,63
"5658","21464","2014",42,25,17,143178.571428571,1808.02380952381,80.5952380952381
"5659","21465","2014",1,1,0,55000,1000,55
"5660","21467","2014",1,1,0,234000,1054,222
"5661","21469","2014",7,7,0,173128.571428571,1890.28571428571,93.1428571428571
"5662","21471","2014",1,1,0,1e+05,714,140
"5663","21472","2014",2,2,0,93100,1147.5,83.5
"5664","21473","2014",6,5,1,205370.666666667,2212.5,94.6666666666667
"5665","21474","2014",9,9,0,103444.444444444,1309.55555555556,77.4444444444444
"5666","21475","2014",2,2,0,101500,1074.5,105.5
"5667","21476","2014",1,1,0,115000,1085,106
"5668","21477","2014",1,1,0,105000,1346,78
"5669","21478","2014",3,3,0,177750,1192.33333333333,149.333333333333
"5670","21480","2014",1,1,0,179000,1584,113
"5671","21481","2014",9,7,2,209488.444444444,2268.88888888889,91.7777777777778
"5672","21482","2014",7,7,0,134310,1559.42857142857,92.7142857142857
"5673","21483","2014",4,4,0,192335,1661,118
"5674","21485","2014",22,17,5,144577.272727273,2060.63636363636,70.9545454545455
"5675","21487","2014",1,1,0,169000,1579,107
"5676","21488","2014",2,2,0,55000,641,75
"5677","21490","2014",1,1,0,17000,500,34
"5678","21492","2014",12,11,1,125660.416666667,1553.58333333333,80.5833333333333
"5679","21493","2014",8,8,0,114614.375,1379.375,86.5
"5680","21494","2014",1,1,0,120000,800,150
"5681","21495","2014",1,1,0,208000,1576,132
"5682","21496","2014",14,13,1,102833.571428571,1278.78571428571,84
"5683","21499","2014",3,3,0,74500,773.666666666667,93
"5684","21500","2014",7,6,1,125285.714285714,1613.71428571429,82.7142857142857
"5685","21501","2014",8,1,7,75577.5,1033.875,76.375
"5686","21502","2014",6,6,0,126701.666666667,1119.16666666667,118.166666666667
"5687","21503","2014",4,4,0,121885,880,136
"5688","21504","2014",2,2,0,89000,967.5,92.5
"5689","21505","2014",6,6,0,115833.333333333,1279.66666666667,94.3333333333333
"5690","21506","2014",4,4,0,134430,1360.75,101.75
"5691","21508","2014",5,5,0,195780,1503.8,126.6
"5692","21510","2014",1,1,0,104500,1174,89
"5693","21511","2014",2,2,0,60000,549,108.5
"5694","21512","2014",6,6,0,425258.333333333,3410.5,111.166666666667
"5695","21515","2014",80,33,47,164256.3,1991.6625,81.45
"5696","21517","2014",7,5,2,186942.857142857,1620,117.714285714286
"5697","21518","2014",5,5,0,91060,745.8,115.4
"5698","21519","2014",5,5,0,81552,896,91.8
"5699","21520","2014",1,1,0,190000,1939,98
"5700","21521","2014",3,3,0,194000,2054.66666666667,91.3333333333333
"5701","21522","2014",5,5,0,116800,1080.6,120.8
"5702","21523","2014",1,1,0,152000,1900,80
"5703","21525","2014",7,7,0,84571.4285714286,907.571428571429,91
"5704","21527","2014",3,3,0,102450,1344,75
"5705","21529","2014",1,1,0,120500,1339,90
"5706","21530","2014",4,4,0,86250,902,99.5
"5707","21531","2014",5,5,0,95100,791.2,106.2
"5708","21532","2014",9,8,1,160853.111111111,1613.33333333333,95.1111111111111
"5709","21533","2014",3,3,0,90433.3333333333,1230.66666666667,69
"5710","21534","2014",9,9,0,199538.888888889,1856.55555555556,115
"5711","21535","2014",9,9,0,181138.111111111,1744.66666666667,111.111111111111
"5712","21536","2014",2,2,0,105000,1064.5,121
"5713","21537","2014",3,3,0,47933.3333333333,1018.66666666667,46
"5714","21538","2014",1,1,0,145000,1160,125
"5715","21539","2014",1,1,0,70000,583,120
"5716","21540","2014",62,35,27,220354,2603.5,83.8870967741936
"5717","21541","2014",2,2,0,58750,824.5,71.5
"5718","21542","2014",2,2,0,171945,2284,75.5
"5719","21543","2014",3,3,0,89956.6666666667,950.666666666667,93.3333333333333
"5720","21545","2014",8,7,1,93640,1122,83.75
"5721","21546","2014",3,3,0,171166.666666667,2511.33333333333,81.6666666666667
"5722","21548","2014",1,1,0,55000,1100,50
"5723","21549","2014",1,1,0,259800,1299,200
"5724","21552","2014",1,1,0,141300,1009,140
"5725","21553","2014",2,2,0,72000,1153,88
"5726","21554","2014",13,3,10,77761.5384615385,1026.53846153846,73.3076923076923
"5727","21555","2014",10,9,1,214540,2079,102.9
"5728","21556","2014",1,1,0,146000,1217,120
"5729","21557","2014",1,1,0,45000,600,75
"5730","21558","2014",5,5,0,215082,1789,122.2
"5731","21559","2014",8,8,0,178571.875,1492.875,120.125
"5732","21560","2014",3,3,0,58500,876,66.6666666666667
"5733","21561","2014",1,1,0,60000,600,100
"5734","21562","2014",1,1,0,90000,608,148
"5735","21563","2014",2,2,0,143500,1043,138
"5736","21564","2014",2,2,0,159000,1656,96
"5737","21565","2014",4,4,0,164250,1728,97.25
"5738","21566","2014",1,1,0,55000,509,108
"5739","21567","2014",2,2,0,49000,725,67
"5740","21568","2014",6,6,0,129566.666666667,1390.66666666667,90.5
"5741","21569","2014",5,5,0,118250,1583.8,104.8
"5742","21570","2014",1,1,0,55000,688,80
"5743","21571","2014",2,2,0,106000,1488,70
"5744","21572","2014",3,3,0,87666.6666666667,1234.66666666667,70.6666666666667
"5745","21573","2014",3,3,0,138940,1492.33333333333,96
"5746","21574","2014",4,4,0,136187.5,1829.75,88
"5747","21575","2014",3,3,0,137000,926.666666666667,150
"5748","21576","2014",2,2,0,230600,1150.5,180
"5749","21577","2014",14,13,1,143593.714285714,1401.21428571429,108.428571428571
"5750","21578","2014",2,2,0,177425,1299,145
"5751","21579","2014",2,2,0,121200,1078.5,110
"5752","21580","2014",1,1,0,40000,678,59
"5753","21582","2014",5,5,0,178794,2700.6,74.4
"5754","21584","2014",21,20,1,115522.380952381,1258.95238095238,94.8095238095238
"5755","21585","2014",6,6,0,201062.5,1996.83333333333,100.333333333333
"5756","21586","2014",5,5,0,189540,1881,101.4
"5757","21587","2014",3,3,0,145666.666666667,1900,87
"5758","21589","2014",2,2,0,167250,1475,124.5
"5759","21590","2014",5,4,1,194170,1807.6,96.8
"5760","21591","2014",4,4,0,319101.25,2206.5,149.25
"5761","21592","2014",4,4,0,135875,1565.25,88
"5762","21594","2014",1,1,0,147355,1228,120
"5763","21595","2014",3,3,0,208666.666666667,1753,124.333333333333
"5764","21596","2014",7,7,0,206397.857142857,1671.57142857143,126.142857142857
"5765","21598","2014",2,2,0,96500,1104.5,86
"5766","21599","2014",19,18,1,126987.894736842,1263.21052631579,104.210526315789
"5767","21600","2014",2,2,0,152000,1161,122
"5768","21603","2014",19,14,5,151794.736842105,1799.84210526316,92.2105263157895
"5769","21604","2014",1,1,0,40000,465,86
"5770","21605","2014",13,13,0,217707.692307692,2209.84615384615,99.6923076923077
"5771","21606","2014",14,13,1,198365.428571429,1843.71428571429,121.857142857143
"5772","21607","2014",28,21,7,97770,1147,86.8928571428571
"5773","21608","2014",1,1,0,90000,1059,85
"5774","21609","2014",5,5,0,154120,1560.6,98
"5775","21610","2014",6,6,0,100083.333333333,1060.66666666667,95.1666666666667
"5776","21611","2014",5,5,0,176226.6,1432.6,134.6
"5777","21612","2014",3,3,0,117942,1291.66666666667,97.3333333333333
"5778","21613","2014",5,5,0,83000,1097.8,73.6
"5779","21614","2014",3,3,0,113333.333333333,1498.33333333333,77
"5780","21615","2014",2,2,0,27250,929,46
"5781","21616","2014",2,2,0,283000,2641,122.5
"5782","21617","2014",98,42,56,198837.897959184,2224.88775510204,88.530612244898
"5783","21618","2014",4,3,1,107183.75,1030.75,112.25
"5784","21619","2014",1,1,0,131500,2229,59
"5785","21620","2014",3,3,0,168266.666666667,1457,117.666666666667
"5786","21622","2014",4,4,0,172762.5,1433.75,121.25
"5787","21623","2014",14,14,0,173506.357142857,1670.64285714286,106.785714285714
"5788","21624","2014",1,1,0,148000,1721,86
"5789","21626","2014",1,1,0,2e+05,1124,178
"5790","21628","2014",2,2,0,97000,1054.5,103.5
"5791","21629","2014",5,5,0,84000,654.8,124.6
"5792","21630","2014",3,3,0,83333.3333333333,917,91.6666666666667
"5793","21632","2014",3,3,0,202300,2245.66666666667,90.6666666666667
"5794","21633","2014",2,2,0,132672.5,1255,114
"5795","21634","2014",1,1,0,110000,1196,92
"5796","21636","2014",4,4,0,77387.5,984,76.5
"5797","21637","2014",1,1,0,30000,556,54
"5798","21638","2014",11,9,2,152299.090909091,1530.36363636364,102
"5799","21639","2014",6,6,0,163765.833333333,1551.33333333333,99.3333333333333
"5800","21640","2014",2,2,0,74000,828,80.5
"5801","21641","2014",1,1,0,208120,2040,102
"5802","21642","2014",5,5,0,95695,1128,82.6
"5803","21643","2014",5,5,0,153254,1552.6,99.2
"5804","21645","2014",5,5,0,138716,1505.2,95.4
"5805","21646","2014",1,1,0,150000,1200,125
"5806","21648","2014",1,1,0,121500,1105,110
"5807","21649","2014",1,1,0,80000,1000,80
"5808","21650","2014",2,2,0,151500,887.5,181
"5809","21651","2014",2,2,0,114250,1580.5,75
"5810","21655","2014",2,2,0,258000,1545,149.5
"5811","21656","2014",5,3,2,116400,1319,87.4
"5812","21657","2014",16,15,1,216165.625,1971.5,112.5625
"5813","21659","2014",1,1,0,125000,2083,60
"5814","21661","2014",16,13,3,211168.75,2111.4375,103.5
"5815","21663","2014",17,17,0,127676.470588235,1439.88235294118,90.5882352941177
"5816","21664","2014",1,1,0,147000,1246,118
"5817","21665","2014",3,3,0,149950,1031.66666666667,145.333333333333
"5818","21667","2014",4,4,0,140475,1563,90
"5819","21670","2014",7,6,1,60396.8571428571,938.714285714286,65.8571428571429
"5820","21671","2014",1,1,0,92500,804,115
"5821","21672","2014",1,1,0,65571,737,89
"5822","21673","2014",3,3,0,171333.333333333,1149.66666666667,126.333333333333
"5823","21674","2014",1,1,0,55000,1375,40
"5824","21675","2014",1,1,0,175000,972,180
"5825","21676","2014",1,1,0,142700,649,220
"5826","21678","2014",1,1,0,128000,1255,102
"5827","21679","2014",2,2,0,166000,1807.5,99.5
"5828","21680","2014",4,4,0,89750,984.25,101.25
"5829","21681","2014",1,1,0,55000,688,80
"5830","21682","2014",1,1,0,155000,969,160
"5831","21683","2014",2,2,0,54000,697.5,75.5
"5832","21684","2014",5,5,0,209390,1843.4,116.2
"5833","21685","2014",1,1,0,19000,422,45
"5834","21686","2014",1,1,0,169000,2112,80
"5835","21690","2014",1,1,0,46296,634,73
"5836","21691","2014",2,2,0,135000,1166,112
"5837","21692","2014",4,4,0,205046.25,1610.25,131.25
"5838","21693","2014",5,5,0,48900,987.6,46.2
"5839","21695","2014",1,1,0,139000,874,159
"5840","21696","2014",3,3,0,144000,1427.33333333333,107
"5841","21698","2014",1,1,0,50000,649,77
"5842","21699","2014",6,6,0,123500,1218.33333333333,100
"5843","21701","2014",1,1,0,163700,1705,96
"5844","21702","2014",2,2,0,110500,1040,103.5
"5845","21703","2014",1,1,0,86000,601,143
"5846","21705","2014",1,1,0,20000,1000,20
"5847","21706","2014",1,1,0,185000,2643,70
"5848","21707","2014",3,3,0,90400,1082.33333333333,77.3333333333333
"5849","21708","2014",7,7,0,170581.428571429,1741,93
"5850","21709","2014",1,1,0,55520,1322,42
"5851","21710","2014",3,3,0,89158.3333333333,1023.66666666667,82.6666666666667
"5852","21711","2014",1,1,0,140000,693,202
"5853","21712","2014",2,2,0,106500,1426,75.5
"5854","21713","2014",10,10,0,125260,1383.9,92.1
"5855","21714","2014",2,2,0,288500,1902.5,150.5
"5856","21716","2014",2,2,0,106500,1605,65
"5857","21717","2014",1,1,0,130000,778,167
"5858","22001","2014",4,4,0,80000,1044.5,70.25
"5859","22002","2014",4,4,0,145575,1640.5,93.75
"5860","22003","2014",8,8,0,142937.625,1365,104.5
"5861","22004","2014",39,38,1,108574.333333333,1083.05128205128,101.538461538462
"5862","22005","2014",13,13,0,88400,912.307692307692,101.230769230769
"5863","22006","2014",1,1,0,15000,500,30
"5864","22008","2014",7,7,0,129892.857142857,1361.85714285714,94.4285714285714
"5865","22011","2014",10,10,0,114700,1014.8,119.6
"5866","22012","2014",4,4,0,160500,1412.75,118.75
"5867","22013","2014",22,21,1,65295.4545454545,923.818181818182,71.9545454545455
"5868","22014","2014",8,8,0,109937.5,1001.25,109.375
"5869","22015","2014",19,19,0,125325.315789474,1403.15789473684,93.8421052631579
"5870","22016","2014",10,10,0,408164.4,4831.7,100.7
"5871","22018","2014",4,4,0,73750,834.75,94
"5872","22019","2014",6,6,0,120916.666666667,1299,104.166666666667
"5873","22020","2014",24,24,0,119628.333333333,1273.16666666667,98.7083333333333
"5874","22021","2014",6,6,0,80206.6666666667,1027.5,79.6666666666667
"5875","22023","2014",6,6,0,88615.8333333333,1106.16666666667,79.3333333333333
"5876","22024","2014",4,4,0,38250,560,63.5
"5877","22025","2014",31,31,0,80739.6774193548,857.451612903226,95.0322580645161
"5878","22026","2014",5,5,0,165800,1496,112
"5879","22027","2014",11,11,0,56691.8181818182,785.454545454545,73.0909090909091
"5880","22028","2014",5,5,0,104800,1050.2,99
"5881","22029","2014",3,3,0,91033.3333333333,803.666666666667,104.666666666667
"5882","22030","2014",5,5,0,174400,1460.6,120.4
"5883","22031","2014",12,12,0,70237.5,848.166666666667,83.25
"5884","22032","2014",30,30,0,119292.033333333,1203.73333333333,98.7333333333333
"5885","22033","2014",12,12,0,55182.5,953.666666666667,58.8333333333333
"5886","22034","2014",10,10,0,112325,1043.2,112.3
"5887","22035","2014",9,9,0,154415,1450.55555555556,114.555555555556
"5888","22037","2014",3,3,0,54500,612,90.6666666666667
"5889","22039","2014",3,3,0,66000,789.333333333333,88
"5890","22040","2014",1,1,0,228000,1349,169
"5891","22041","2014",1,1,0,180000,1125,160
"5892","22042","2014",6,6,0,143950.5,1607.66666666667,87.5
"5893","22043","2014",2,2,0,88250,1158.5,75
"5894","22044","2014",10,10,0,144759,1438,103.8
"5895","22045","2014",5,5,0,170800,1427,121.6
"5896","22046","2014",63,62,1,89414.9206349206,982.52380952381,91.8412698412698
"5897","22047","2014",6,6,0,86115,1021.83333333333,84.6666666666667
"5898","22048","2014",16,16,0,127812.5,1288.6875,107
"5899","22049","2014",4,4,0,145875,1311,112
"5900","22050","2014",209,110,99,152515.387559809,1713.33971291866,87.6985645933014
"5901","22052","2014",5,5,0,76200,945.6,79.4
"5902","22053","2014",6,6,0,95916.6666666667,1376.5,72.3333333333333
"5903","22054","2014",60,41,19,190578.083333333,2549.36666666667,78.9
"5904","22055","2014",101,81,20,174738.97029703,1962.40594059406,91.1782178217822
"5905","22056","2014",18,18,0,116200.833333333,1206.61111111111,96.4444444444444
"5906","22057","2014",6,6,0,120150,1239,96
"5907","22059","2014",9,9,0,125933.333333333,1129.33333333333,111.333333333333
"5908","22060","2014",7,7,0,81314.2857142857,1084.57142857143,74.4285714285714
"5909","22061","2014",26,26,0,94411.5384615385,1109.34615384615,90.1923076923077
"5910","22062","2014",4,4,0,70125,773.5,90
"5911","22063","2014",11,11,0,91363.6363636364,1009.09090909091,85.0909090909091
"5912","22064","2014",9,9,0,80282.4444444444,950,83.2222222222222
"5913","22065","2014",20,19,1,124875,1276.45,97.65
"5914","22067","2014",17,17,0,99944.1176470588,1212.58823529412,86.7647058823529
"5915","22068","2014",5,5,0,94265.8,844.8,105.8
"5916","22069","2014",3,3,0,148559.333333333,1124.66666666667,133
"5917","22070","2014",69,41,28,89435.8405797101,1248.78260869565,75.8550724637681
"5918","22071","2014",4,4,0,125750,1314.75,98.25
"5919","22072","2014",4,4,0,104200,1154,90.5
"5920","22073","2014",3,3,0,80666.6666666667,1146.33333333333,79.6666666666667
"5921","22074","2014",3,3,0,58166.6666666667,702,84
"5922","22075","2014",1,1,0,108000,812,133
"5923","22076","2014",10,9,1,143800,1545.1,118.1
"5924","22077","2014",13,13,0,146569.230769231,1635,95.4615384615385
"5925","22079","2014",18,18,0,114761.111111111,1186.88888888889,98.7777777777778
"5926","22081","2014",28,27,1,157443.464285714,1478.28571428571,117.107142857143
"5927","22082","2014",8,8,0,194252.5,1326.625,128.875
"5928","22083","2014",4,4,0,55750,730.5,79.25
"5929","22084","2014",18,16,2,100136.277777778,1207,85.4444444444444
"5930","22085","2014",3,3,0,107000,1241.66666666667,93.3333333333333
"5931","22086","2014",8,8,0,144975,1435.75,98.75
"5932","22087","2014",7,7,0,61142.8571428571,929.285714285714,81.4285714285714
"5933","22088","2014",5,5,0,50400,676.4,75
"5934","22090","2014",8,8,0,144350,1459.5,98.25
"5935","22091","2014",5,5,0,99735.6,1041.4,95.2
"5936","22092","2014",2,2,0,151276,1143,136.5
"5937","22093","2014",132,108,24,154823.181818182,1633.39393939394,94.8712121212121
"5938","22094","2014",29,25,4,290931.034482759,2888,107.551724137931
"5939","22096","2014",4,4,0,103000,1311.5,75.75
"5940","22097","2014",4,4,0,125625,1441.75,82.5
"5941","22098","2014",3,3,0,149719.333333333,1398.66666666667,106.666666666667
"5942","22099","2014",11,11,0,109245.454545455,1243.27272727273,92.4545454545455
"5943","22101","2014",8,8,0,171248.75,1114,144.625
"5944","22103","2014",13,13,0,166969.230769231,1617.38461538462,106.923076923077
"5945","22104","2014",7,7,0,100620.714285714,1193.14285714286,82.2857142857143
"5946","22105","2014",8,8,0,128218.75,1286.75,91.875
"5947","22106","2014",65,53,12,150163.323076923,1710.18461538462,92.1076923076923
"5948","22107","2014",15,15,0,82429.8666666667,1002.73333333333,87.2
"5949","22108","2014",2,2,0,62500,929.5,69.5
"5950","22109","2014",7,7,0,100785.714285714,1560.42857142857,64.4285714285714
"5951","22110","2014",3,3,0,68333.3333333333,721,98.6666666666667
"5952","22111","2014",3,3,0,226331.666666667,2064.33333333333,116
"5953","22113","2014",174,122,52,125680.637931034,1481.87356321839,86.6379310344828
"5954","22114","2014",11,11,0,75841.5454545455,878,85.2727272727273
"5955","22115","2014",3,3,0,75300,753.333333333333,95
"5956","22116","2014",3,3,0,148666.666666667,1279.33333333333,117.666666666667
"5957","22117","2014",6,6,0,110833.333333333,1394.33333333333,78.6666666666667
"5958","22118","2014",33,31,2,171395.636363636,1608.90909090909,110.393939393939
"5959","22119","2014",7,7,0,79142.8571428571,920,88.7142857142857
"5960","22121","2014",13,13,0,124815.384615385,1316.92307692308,96.1538461538462
"5961","22122","2014",7,7,0,100714.428571429,942.142857142857,103.714285714286
"5962","22124","2014",2,2,0,86000,1320.5,74.5
"5963","22127","2014",15,15,0,166833.333333333,1643.73333333333,99.8
"5964","22128","2014",10,10,0,70626.5,806.2,85.4
"5965","22129","2014",1,1,0,43000,453,95
"5966","22131","2014",11,11,0,64456.8181818182,838.090909090909,74
"5967","22132","2014",2,2,0,50000,699.5,73.5
"5968","22133","2014",4,4,0,79250,1259.5,65.5
"5969","22134","2014",33,33,0,188366.515151515,1804.36363636364,108.121212121212
"5970","22135","2014",26,26,0,70591.2307692308,949.269230769231,78.8461538461538
"5971","22136","2014",81,73,8,110303.086419753,1132.64197530864,101.679012345679
"5972","22137","2014",17,17,0,82607.1764705882,865.823529411765,97.8235294117647
"5973","22138","2014",4,4,0,47000,564,84
"5974","22139","2014",4,4,0,79475,758.75,102
"5975","22141","2014",2,2,0,188345,1347,140.5
"5976","22143","2014",13,11,2,159838.461538462,1906.46153846154,87
"5977","22144","2014",6,6,0,131600,1630,93.3333333333333
"5978","22145","2014",4,4,0,122375,894.75,145.75
"5979","22146","2014",9,9,0,116195.111111111,1163.22222222222,97.7777777777778
"5980","22147","2014",17,16,1,95524.2941176471,1058.05882352941,89.3529411764706
"5981","22148","2014",2,2,0,51600,715,67.5
"5982","22149","2014",7,7,0,71864.1428571429,866,89.7142857142857
"5983","22150","2014",6,6,0,110916.666666667,985.666666666667,115.333333333333
"5984","22152","2014",10,10,0,145700.2,1256.5,112.7
"5985","22153","2014",8,8,0,125500,1131.75,106.875
"5986","22155","2014",10,10,0,97400,1081.1,88.8
"5987","22156","2014",3,3,0,122000,1839,66.6666666666667
"5988","22157","2014",10,10,0,100358.6,1062.7,93.1
"5989","22158","2014",17,17,0,80441.1764705882,999.058823529412,89.5294117647059
"5990","22160","2014",2,2,0,146500,1203.5,122
"5991","22161","2014",25,25,0,124820,1365.52,89
"5992","22162","2014",83,68,15,151112.855421687,1744.74698795181,86.9036144578313
"5993","22163","2014",2,2,0,57500,762.5,86.5
"5994","22164","2014",19,19,0,79131.5789473684,922.157894736842,82.9473684210526
"5995","22165","2014",3,3,0,145533.333333333,1359,110
"5996","22166","2014",31,30,1,218980.64516129,2301.16129032258,100.58064516129
"5997","22168","2014",118,72,46,164201.940677966,2223.47457627119,77.0084745762712
"5998","22169","2014",3,3,0,80333.3333333333,751.666666666667,102.333333333333
"5999","22170","2014",9,9,0,112378.111111111,1370.22222222222,85.2222222222222
"6000","22171","2014",24,24,0,139910.125,1388.20833333333,104.583333333333
"6001","22172","2014",21,14,7,100252.380952381,1191.52380952381,90.9047619047619
"6002","22174","2014",8,8,0,114025,1117.75,100
"6003","22175","2014",11,11,0,105686.272727273,1220.18181818182,92.2727272727273
"6004","22176","2014",32,31,1,147707.8125,1502.28125,98.15625
"6005","22177","2014",13,13,0,132400,1281.23076923077,106.076923076923
"6006","22178","2014",10,10,0,151739.8,1501.4,99.7
"6007","22179","2014",25,25,0,166110,1765.36,97.56
"6008","22180","2014",15,15,0,134913.333333333,1459.06666666667,92.1333333333333
"6009","22181","2014",8,8,0,95087.5,925.5,94.75
"6010","22182","2014",13,13,0,143346.153846154,1246.84615384615,111.692307692308
"6011","22183","2014",24,24,0,78854.1666666667,937.625,87.125
"6012","22184","2014",13,13,0,71869.2307692308,822.692307692308,86.7692307692308
"6013","22185","2014",23,22,1,110829.043478261,1495.08695652174,82.0434782608696
"6014","22186","2014",83,58,25,202410.240963855,2575.33734939759,84.9397590361446
"6015","22187","2014",113,95,18,162152.752212389,1827.91150442478,91.0884955752212
"6016","22188","2014",6,6,0,134666.666666667,1505.66666666667,89.3333333333333
"6017","22189","2014",6,6,0,80750,818.666666666667,87.8333333333333
"6018","22190","2014",40,39,1,152037.5,1548.575,99.35
"6019","22193","2014",13,13,0,121510.769230769,1396.15384615385,87.1538461538462
"6020","22194","2014",45,44,1,144768.444444444,1745.08888888889,92
"6021","22195","2014",34,33,1,120339.882352941,1368.85294117647,92.1176470588235
"6022","22196","2014",8,8,0,113287.5,1399.25,87.25
"6023","22197","2014",30,30,0,192850,1638.93333333333,116.1
"6024","22198","2014",32,32,0,189684.6875,1986.25,98.5
"6025","22199","2014",15,15,0,95800,1154,90.4
"6026","22200","2014",6,6,0,130591.666666667,1145,113.833333333333
"6027","22201","2014",14,14,0,176111.428571429,1816.92857142857,100.428571428571
"6028","22202","2014",8,8,0,63062.5,854.5,75
"6029","22203","2014",41,40,1,93980.4878048781,1060.41463414634,87.7073170731707
"6030","22204","2014",14,14,0,131250,949.714285714286,138.571428571429
"6031","22205","2014",2,2,0,69650,851,78
"6032","22206","2014",29,29,0,144747.172413793,1478.55172413793,98.551724137931
"6033","22207","2014",26,26,0,102238.461538462,1135.15384615385,91.2692307692308
"6034","22208","2014",18,18,0,130011.111111111,1202.5,114.277777777778
"6035","22209","2014",44,35,9,151012.818181818,1846.81818181818,85.0454545454545
"6036","22210","2014",39,39,0,182948.717948718,1995.20512820513,90.8974358974359
"6037","22211","2014",25,25,0,131034.4,1418.72,92.52
"6038","22212","2014",10,10,0,89660,975.2,89.3
"6039","22213","2014",37,37,0,194387.540540541,1765.7027027027,111.594594594595
"6040","22214","2014",48,48,0,143100,1570.02083333333,94.0625
"6041","22215","2014",85,83,2,144670.188235294,1513.28235294118,96.0588235294118
"6042","22216","2014",11,11,0,99081.8181818182,1109.18181818182,88.6363636363636
"6043","22217","2014",4,4,0,149991.25,1625.75,109
"6044","22218","2014",13,13,0,211653.846153846,2259.46153846154,97
"6045","22219","2014",14,14,0,86000,810.5,108.5
"6046","22220","2014",21,21,0,68521.4285714286,910.857142857143,73.5714285714286
"6047","22221","2014",25,25,0,128360.4,1399.96,91.4
"6048","22222","2014",63,59,4,128532.492063492,1564.39682539683,88.4126984126984
"6049","22223","2014",20,20,0,98690,1156.4,84.6
"6050","22224","2014",10,10,0,151277.5,1485.7,106.9
"6051","22225","2014",51,51,0,127561.68627451,1321.78431372549,97.1176470588235
"6052","22226","2014",14,14,0,138642.5,1344.42857142857,103.071428571429
"6053","22227","2014",7,7,0,98428.5714285714,1432,81
"6054","22228","2014",10,10,0,93100,981.4,95.3
"6055","22229","2014",12,12,0,78308.3333333333,856.583333333333,88.75
"6056","22231","2014",2,2,0,51750,627,82
"6057","22232","2014",10,10,0,167200,1740.1,100.5
"6058","22233","2014",17,17,0,120594.117647059,1266.35294117647,93.8235294117647
"6059","22234","2014",8,8,0,115937.5,1203.625,97.75
"6060","22235","2014",2,2,0,94000,1082.5,81.5
"6061","22236","2014",5,5,0,169628,1561.4,111.6
"6062","22237","2014",18,18,0,150588.333333333,1523.66666666667,106.611111111111
"6063","22238","2014",1,1,0,148000,961,154
"6064","22239","2014",7,7,0,108428.571428571,1285.57142857143,83.5714285714286
"6065","22240","2014",6,6,0,119498.333333333,1171.16666666667,104
"6066","22241","2014",4,4,0,53787.5,702.75,77
"6067","22242","2014",21,21,0,152844.761904762,1700.71428571429,95.2380952380952
"6068","22243","2014",7,7,0,101114.285714286,1143.71428571429,111.857142857143
"6069","22244","2014",5,5,0,107000,1072,98.8
"6070","22245","2014",9,9,0,75652.7777777778,870.888888888889,87.3333333333333
"6071","22246","2014",10,10,0,125535,1190,103.9
"6072","22248","2014",17,17,0,128770.588235294,1205.70588235294,114.882352941176
"6073","22249","2014",6,6,0,96033.3333333333,911.166666666667,103.166666666667
"6074","22250","2014",9,9,0,94370.3333333333,1189.66666666667,85.8888888888889
"6075","22251","2014",60,59,1,178801.133333333,1741.83333333333,100.1
"6076","22254","2014",9,9,0,131133.333333333,1192.66666666667,108.888888888889
"6077","22255","2014",8,8,0,80348.5,930.5,88.625
"6078","22256","2014",16,16,0,97000,1021.625,97.5
"6079","22257","2014",6,6,0,102000,1105.5,103.5
"6080","22258","2014",20,20,0,141911.9,1556.7,92
"6081","22259","2014",42,42,0,164372.142857143,1690.35714285714,97.8333333333333
"6082","22260","2014",2,2,0,112500,1252.5,90
"6083","22261","2014",1,1,0,240000,1455,165
"6084","22262","2014",21,20,1,127895.238095238,1246.2380952381,111.380952380952
"6085","22263","2014",6,6,0,115500,977,108.5
"6086","22264","2014",28,28,0,104732.357142857,1139.46428571429,95.4285714285714
"6087","22265","2014",14,14,0,116828.571428571,1227,95.5
"6088","22266","2014",29,29,0,77884.4827586207,877.620689655172,87.4137931034483
"6089","22267","2014",6,6,0,102193.333333333,1141.5,97.1666666666667
"6090","22268","2014",8,8,0,152687.5,1376.125,115.625
"6091","22269","2014",4,4,0,87250,837,105.5
"6092","22272","2014",17,14,3,142957.647058824,1412.64705882353,96.0588235294118
"6093","22273","2014",23,23,0,156795.652173913,1495.04347826087,111.565217391304
"6094","22274","2014",4,4,0,86750,1018.25,83.5
"6095","22275","2014",6,6,0,76750,953.833333333333,77.6666666666667
"6096","22276","2014",3,3,0,219666.666666667,2133.33333333333,90.3333333333333
"6097","22277","2014",12,12,0,113490,1270.58333333333,88
"6098","22278","2014",514,220,294,102733.241245136,1341.03891050584,75.9494163424124
"6099","22279","2014",7,7,0,103142.857142857,1097.28571428571,100.857142857143
"6100","22280","2014",8,8,0,130586.25,1265.125,103.5
"6101","22281","2014",10,10,0,109880,1089.8,105.5
"6102","22282","2014",87,46,41,228483.206896552,2789.32183908046,85.7701149425287
"6103","22283","2014",9,9,0,88833.3333333333,945.333333333333,92.4444444444444
"6104","22284","2014",6,6,0,72783.3333333333,1039.83333333333,72.6666666666667
"6105","22286","2014",2,2,0,225000,1702.5,133.5
"6106","22287","2014",10,10,0,130521.5,1293.9,97.1
"6107","22288","2014",1,1,0,140000,1022,137
"6108","22289","2014",4,4,0,87625,1124.5,80.75
"6109","22293","2014",1,1,0,65000,1182,55
"6110","22294","2014",6,6,0,75083.3333333333,969.333333333333,79.8333333333333
"6111","22295","2014",4,4,0,78250,801,84.5
"6112","22296","2014",5,5,0,65300,828.6,74.6
"6113","22299","2014",12,12,0,98885.4166666667,1500.08333333333,73.4166666666667
"6114","22300","2014",3,3,0,124633.333333333,1605.33333333333,95.3333333333333
"6115","22302","2014",13,11,2,268804.846153846,3102.53846153846,83.6923076923077
"6116","22304","2014",5,5,0,79500,1085,73.8
"6117","22305","2014",3,3,0,131666.666666667,1347.33333333333,120.666666666667
"6118","22306","2014",4,4,0,102375,1063.5,97.5
"6119","22307","2014",12,11,1,145979.583333333,1558.41666666667,96.9166666666667
"6120","22308","2014",11,11,0,118366.363636364,1210.54545454545,99.1818181818182
"6121","22309","2014",2,2,0,108800,785,130.5
"6122","22310","2014",5,5,0,101400,910.2,107
"6123","22311","2014",7,7,0,117428.571428571,1516.42857142857,81.2857142857143
"6124","22312","2014",4,4,0,105875,1194.25,95.25
"6125","22313","2014",4,4,0,71500.25,567.75,114.5
"6126","22314","2014",5,5,0,100660,986,96.2
"6127","22315","2014",3,3,0,116933.333333333,1419,81.6666666666667
"6128","22316","2014",7,7,0,67571.4285714286,690.428571428571,95.1428571428571
"6129","22317","2014",1,1,0,132500,1440,92
"6130","22318","2014",1,1,0,210000,1235,170
"6131","22319","2014",10,8,2,196434.7,2010.1,93
"6132","22320","2014",2,2,0,18000,408,44
"6133","22321","2014",14,14,0,55128.5714285714,799.5,73
"6134","22322","2014",4,4,0,91937.5,1034,97.75
"6135","22323","2014",9,9,0,155136.666666667,1722,95.7777777777778
"6136","22324","2014",11,10,1,154463.636363636,1704.72727272727,97.7272727272727
"6137","22325","2014",85,47,38,188048,2278.95294117647,84.0588235294118
"6138","22326","2014",5,5,0,129400,1454.2,92.2
"6139","22327","2014",20,20,0,170635,1629.65,109.2
"6140","22328","2014",5,5,0,69146,809.8,85.6
"6141","22330","2014",7,7,0,127245.714285714,1167.42857142857,106.142857142857
"6142","22331","2014",3,3,0,47333.3333333333,669.666666666667,70
"6143","22332","2014",3,3,0,84548.3333333333,1000,75
"6144","22333","2014",3,3,0,74333.3333333333,747.333333333333,100.333333333333
"6145","22334","2014",2,2,0,58250,672.5,80
"6146","22337","2014",6,6,0,72666.6666666667,971.666666666667,73.3333333333333
"6147","22338","2014",9,9,0,107000,1053.77777777778,105.555555555556
"6148","22339","2014",23,22,1,158490.869565217,1568.60869565217,100.565217391304
"6149","22340","2014",14,14,0,118464.285714286,1377.07142857143,92.2857142857143
"6150","22341","2014",9,9,0,109500,1219.33333333333,86.2222222222222
"6151","22342","2014",3,3,0,211666.666666667,1423.33333333333,148.666666666667
"6152","22343","2014",49,35,14,178276.530612245,2166.87755102041,88.2857142857143
"6153","22344","2014",7,7,0,66457.1428571429,809.571428571429,75.8571428571429
"6154","22345","2014",4,4,0,84175,1042.75,82
"6155","22346","2014",7,6,1,113928.571428571,1172.85714285714,101
"6156","22347","2014",13,13,0,119378.230769231,1154.76923076923,103.769230769231
"6157","22348","2014",7,7,0,85342.8571428571,915.857142857143,99
"6158","22349","2014",14,13,1,138310.357142857,1648.07142857143,84.2142857142857
"6159","22351","2014",8,8,0,117361,1014.375,114.75
"6160","22353","2014",30,23,7,227030.233333333,2570.56666666667,87.9
"6161","22354","2014",5,5,0,150980,1675,95.6
"6162","22356","2014",6,6,0,152895,1570.5,97.6666666666667
"6163","22358","2014",2,2,0,98250,966,99
"6164","22359","2014",5,5,0,75029,859.4,95
"6165","22360","2014",53,46,7,140363.58490566,1527.83018867925,93.5094339622642
"6166","22361","2014",5,5,0,84800,1042.2,76.8
"6167","22362","2014",18,11,7,105127.777777778,1274.27777777778,82.7777777777778
"6168","22363","2014",15,15,0,180416.333333333,1623.8,110.466666666667
"6169","22364","2014",17,17,0,160238.176470588,1441.23529411765,109.705882352941
"6170","22365","2014",2,2,0,88500,1084,79
"6171","22366","2014",3,3,0,100116.666666667,897.666666666667,120
"6172","22368","2014",12,12,0,174952.75,1799.58333333333,98.5
"6173","22369","2014",4,4,0,65444,952.75,63.5
"6174","22370","2014",2,2,0,140000,1678,92.5
"6175","22371","2014",8,8,0,115843.75,1393,87.75
"6176","22372","2014",14,14,0,132594.5,1284.85714285714,100.642857142857
"6177","22373","2014",1,1,0,41000,373,110
"6178","22375","2014",6,6,0,104903.333333333,862.166666666667,119.666666666667
"6179","22376","2014",8,8,0,115562.5,1012,112.5
"6180","22377","2014",8,8,0,131875,2006,69
"6181","22378","2014",6,6,0,131581.666666667,1337.66666666667,96.3333333333333
"6182","22379","2014",23,21,2,195157.173913043,1966.30434782609,103.869565217391
"6183","22380","2014",12,12,0,115290.833333333,1202.91666666667,103.75
"6184","22381","2014",5,5,0,137200,1100.8,135
"6185","22383","2014",3,3,0,92000,755.333333333333,116.333333333333
"6186","22384","2014",7,7,0,132190,1166.71428571429,105.857142857143
"6187","22385","2014",10,10,0,211730,1858.6,115.4
"6188","22386","2014",9,9,0,109188.888888889,1112.88888888889,101.555555555556
"6189","22387","2014",10,10,0,89450,1190.8,72
"6190","22388","2014",8,8,0,160469.375,1480,113.75
"6191","22389","2014",26,22,4,139031.538461538,1680.11538461538,91.3846153846154
"6192","22390","2014",3,3,0,92733.3333333333,1004,91.6666666666667
"6193","22391","2014",10,10,0,77450,914.1,86.5
"6194","23001","2014",14,14,0,65500,712.642857142857,95.7857142857143
"6195","23002","2014",6,6,0,83583.3333333333,827.5,103.166666666667
"6196","23003","2014",1,1,0,62000,738,84
"6197","23004","2014",9,9,0,83338.8888888889,1013.88888888889,81.2222222222222
"6198","23005","2014",3,3,0,98166.6666666667,1196.66666666667,87.3333333333333
"6199","23006","2014",6,6,0,79785,869.833333333333,87.3333333333333
"6200","23007","2014",2,2,0,112500,1329.5,77.5
"6201","23008","2014",30,20,10,72383.3333333333,966.133333333333,79.8333333333333
"6202","23009","2014",1,1,0,65000,663,98
"6203","23011","2014",2,2,0,33500,408,80
"6204","23012","2014",2,2,0,93000,711.5,139
"6205","23013","2014",4,4,0,98000,1097,89.75
"6206","23014","2014",2,2,0,90000,1041.5,91.5
"6207","23015","2014",12,12,0,74291.6666666667,796.166666666667,93.9166666666667
"6208","23016","2014",1,1,0,43000,1075,40
"6209","23017","2014",1,1,0,80000,667,120
"6210","23019","2014",1,1,0,80000,457,175
"6211","23020","2014",2,2,0,66000,600,105
"6212","23021","2014",2,2,0,34900,361.5,96
"6213","23022","2014",12,12,0,75554.1666666667,935.583333333333,82.5
"6214","23024","2014",4,4,0,69762.5,775.25,86.75
"6215","23025","2014",8,8,0,80387.625,914.375,91.875
"6216","23026","2014",2,2,0,106650,1893,51.5
"6217","23027","2014",2,2,0,79000,593.5,132.5
"6218","23029","2014",3,3,0,117666.666666667,1123.33333333333,104.666666666667
"6219","23030","2014",11,11,0,62430.5454545455,756.636363636364,82.5454545454545
"6220","23031","2014",15,15,0,84566.6666666667,1108.26666666667,79.8
"6221","23032","2014",5,5,0,97400,1282,78.2
"6222","23033","2014",2,2,0,96000,931,108
"6223","23034","2014",1,1,0,47500,1011,47
"6224","23035","2014",6,6,0,83750,1123.83333333333,72
"6225","23036","2014",6,6,0,80750,925.5,83.5
"6226","23038","2014",6,6,0,81083.3333333333,715.166666666667,114
"6227","23039","2014",10,10,0,66244.5,829.9,76.8
"6228","23040","2014",2,2,0,102500,959,106.5
"6229","23041","2014",4,4,0,77250,1007.75,74.75
"6230","23042","2014",1,1,0,35000,417,84
"6231","23043","2014",1,1,0,35000,833,42
"6232","23044","2014",1,1,0,72900,900,81
"6233","23045","2014",5,5,0,81600,953.8,105.6
"6234","23046","2014",1,1,0,110000,640,172
"6235","23047","2014",4,4,0,64625,827,96.25
"6236","23048","2014",3,3,0,108620,838.666666666667,131.666666666667
"6237","23049","2014",3,3,0,80333.3333333333,906.666666666667,71
"6238","23050","2014",1,1,0,48000,1231,39
"6239","23052","2014",1,1,0,116000,1221,95
"6240","23053","2014",2,2,0,86803,583,140
"6241","23054","2014",4,4,0,80937.5,806.25,102.75
"6242","23056","2014",3,3,0,63166.6666666667,779.333333333333,78.6666666666667
"6243","23057","2014",10,10,0,64040,1002.9,77.2
"6244","23058","2014",1,1,0,60000,496,121
"6245","23060","2014",3,3,0,80333.3333333333,1037.66666666667,92.3333333333333
"6246","23061","2014",9,8,1,95388.8888888889,1320.66666666667,83.5555555555556
"6247","23062","2014",4,4,0,106235,1117.5,100.75
"6248","23063","2014",2,2,0,94500,737,138
"6249","23064","2014",4,4,0,89750,1223.25,83.75
"6250","23065","2014",6,6,0,65000,745.333333333333,78.5
"6251","23066","2014",3,3,0,171933.333333333,1048.66666666667,125
"6252","23067","2014",5,3,2,89300,1196.8,78.6
"6253","23068","2014",5,5,0,56100,816,68.8
"6254","23069","2014",3,3,0,53500,622.333333333333,96.6666666666667
"6255","23070","2014",3,3,0,111666.666666667,1687,61.3333333333333
"6256","23071","2014",3,3,0,79166.6666666667,1025.33333333333,84
"6257","23072","2014",3,3,0,66666.6666666667,854.666666666667,85.6666666666667
"6258","23073","2014",4,4,0,111100,1266.25,74
"6259","23074","2014",3,3,0,145000,1682.33333333333,84
"6260","23075","2014",9,9,0,78075,1092.55555555556,71.8888888888889
"6261","23076","2014",11,10,1,64182.7272727273,839.090909090909,88.5454545454545
"6262","23077","2014",9,9,0,111444.444444444,843.888888888889,131.777777777778
"6263","23078","2014",3,3,0,90000,1118.33333333333,80
"6264","23079","2014",9,7,2,57988.8888888889,738.222222222222,81.5555555555556
"6265","23080","2014",1,1,0,87000,1740,50
"6266","23081","2014",5,5,0,75650,956,78
"6267","23083","2014",4,4,0,66250,794,91.75
"6268","23084","2014",1,1,0,30000,476,63
"6269","23086","2014",3,3,0,98833.3333333333,837.666666666667,118.333333333333
"6270","23087","2014",10,9,1,77710,959.5,77.6
"6271","23089","2014",7,7,0,79185.7142857143,922.428571428571,84
"6272","23090","2014",5,5,0,71668,872.8,87.6
"6273","23091","2014",3,3,0,39666.6666666667,635,74.3333333333333
"6274","23092","2014",1,1,0,120000,816,147
"6275","23093","2014",14,14,0,84003.6428571429,1002.85714285714,84.2857142857143
"6276","23095","2014",10,10,0,85050,1041.2,96.3
"6277","23096","2014",115,80,35,93454.3826086957,1069.49565217391,88.2086956521739
"6278","23097","2014",4,4,0,137600,1466.5,104.5
"6279","23098","2014",1,1,0,148000,2552,58
"6280","23099","2014",1,1,0,124000,861,144
"6281","23100","2014",3,3,0,87833.3333333333,633.333333333333,119
"6282","23101","2014",2,2,0,120000,1147.5,108.5
"6283","23102","2014",8,8,0,74187.5,932,75.625
"6284","23103","2014",3,3,0,73923.3333333333,979.333333333333,73.3333333333333
"6285","23104","2014",1,1,0,43000,1024,42
"6286","23105","2014",7,7,0,56428.5714285714,720.285714285714,73.2857142857143
"6287","23106","2014",2,2,0,48100,616,97.5
"6288","23107","2014",1,1,0,40000,625,64
"6289","23111","2014",1,1,0,98600,880,112
"6290","23112","2014",13,13,0,73627.3846153846,820,89
"6291","23113","2014",3,3,0,175900,1090.33333333333,162.666666666667
"6292","23114","2014",4,4,0,77500,599.75,118
"6293","23115","2014",3,3,0,89500,757.666666666667,108.666666666667
"6294","23116","2014",4,4,0,76767.5,604.75,121
"6295","23117","2014",3,3,0,76333.3333333333,1211.33333333333,63
"6296","23118","2014",1,1,0,88440,804,110
"6297","23120","2014",6,6,0,83666.6666666667,1207.33333333333,73.8333333333333
"6298","23124","2014",6,6,0,81766.6666666667,840.666666666667,100.833333333333
"6299","23127","2014",3,3,0,82166.6666666667,755,108
"6300","23130","2014",2,2,0,44000,932,46
"6301","23131","2014",3,3,0,61666.6666666667,749.333333333333,78.3333333333333
"6302","23132","2014",4,4,0,41013.5,584,63
"6303","23133","2014",5,5,0,91400,1014.4,88.8
"6304","23134","2014",5,5,0,74780,791,100.6
"6305","23136","2014",2,2,0,69500,888,83.5
"6306","23137","2014",5,5,0,67600,888,78.4
"6307","23138","2014",3,3,0,84000,763.333333333333,94
"6308","23139","2014",3,3,0,38333.3333333333,638,59
"6309","23140","2014",5,5,0,47600,737.4,68
"6310","23141","2014",5,5,0,52900,771,82.2
"6311","23142","2014",5,5,0,66400,633,102.8
"6312","23143","2014",6,6,0,81166.6666666667,909,100.833333333333
"6313","23144","2014",1,1,0,28000,483,58
"6314","23145","2014",1,1,0,125000,984,127
"6315","23146","2014",4,4,0,88480,1137.75,75.25
"6316","23147","2014",1,1,0,1e+05,735,136
"6317","23148","2014",2,2,0,77250,953.5,90.5
"6318","23149","2014",5,5,0,51400,800.8,66.4
"6319","23151","2014",2,2,0,70500,748.5,99
"6320","23152","2014",1,1,0,19000,432,44
"6321","23154","2014",5,5,0,111380,991.6,95.6
"6322","23155","2014",2,2,0,81500,814,97.5
"6323","23156","2014",1,1,0,40000,952,42
"6324","23157","2014",1,1,0,105000,1479,71
"6325","23158","2014",1,1,0,37000,673,55
"6326","23159","2014",1,1,0,46000,708,65
"6327","23162","2014",3,3,0,89738.6666666667,811.333333333333,104.666666666667
"6328","23164","2014",8,8,0,85012.5,934.25,93.5
"6329","23165","2014",13,13,0,65546.1538461538,1339.07692307692,58.9230769230769
"6330","23167","2014",2,2,0,23250,420,55.5
"6331","23168","2014",8,8,0,75375,865.25,89.5
"6332","23169","2014",7,7,0,89907.1428571429,1062.28571428571,87.8571428571429
"6333","23171","2014",1,1,0,65000,677,96
"6334","23172","2014",2,2,0,99500,976,98.5
"6335","23174","2014",1,1,0,55000,426,129
"6336","23175","2014",1,1,0,124000,459,270
"6337","23176","2014",26,26,0,112949.307692308,1124.46153846154,98.5
"6338","23177","2014",6,6,0,98000,1128,85
"6339","23178","2014",3,3,0,61666.6666666667,735.666666666667,80
"6340","23179","2014",2,2,0,163500,978.5,167
"6341","23180","2014",2,2,0,116050,905.5,113.5
"6342","23181","2014",1,1,0,54000,540,100
"6343","23182","2014",2,2,0,59400,721,83.5
"6344","23183","2014",1,1,0,30000,517,58
"6345","23184","2014",1,1,0,172500,2029,85
"6346","23185","2014",2,2,0,45250,754,60
"6347","23186","2014",2,2,0,130000,896.5,132.5
"6348","23187","2014",2,2,0,102500,1047.5,82.5
"6349","23188","2014",4,4,0,92250,1783.75,52.5
"6350","23189","2014",20,20,0,70595,818.3,86.95
"6351","23190","2014",2,2,0,59000,913,85.5
"6352","23191","2014",1,1,0,45000,900,50
"6353","23192","2014",16,16,0,81265.1875,873,99.8125
"6354","23193","2014",15,15,0,123355.466666667,1191.6,101.333333333333
"6355","23194","2014",2,2,0,66350,898,78
"6356","23195","2014",11,11,0,98201.2727272727,1068.45454545455,88.2727272727273
"6357","23196","2014",2,2,0,56000,832,66.5
"6358","23197","2014",6,6,0,89833.3333333333,979.833333333333,88.5
"6359","23198","2014",3,3,0,40666.6666666667,793,51.6666666666667
"6360","23199","2014",3,3,0,53666.6666666667,610.666666666667,91
"6361","23200","2014",3,3,0,74666.6666666667,911,76.3333333333333
"6362","23202","2014",3,3,0,77666.6666666667,953,89.3333333333333
"6363","23203","2014",2,2,0,99000,883,99.5
"6364","23205","2014",1,1,0,60000,1250,48
"6365","23206","2014",7,7,0,142642.857142857,1218.57142857143,118.428571428571
"6366","23208","2014",5,5,0,117006.8,1156.8,101.6
"6367","23210","2014",4,4,0,62125,740.75,86
"6368","23214","2014",3,3,0,83833.3333333333,829.333333333333,106
"6369","23216","2014",1,1,0,25000,568,44
"6370","23217","2014",7,7,0,46142.8571428571,658.428571428571,69.7142857142857
"6371","23219","2014",7,7,0,103428.571428571,922.142857142857,106.857142857143
"6372","23220","2014",3,3,0,46666.6666666667,520,90.3333333333333
"6373","23221","2014",3,3,0,111666.666666667,1080.66666666667,103.666666666667
"6374","23222","2014",1,1,0,90000,1125,80
"6375","23223","2014",4,4,0,94250,661.75,145.5
"6376","23224","2014",2,2,0,41500,736.5,53.5
"6377","23226","2014",1,1,0,32000,582,55
"6378","23227","2014",5,5,0,63800,575,109.6
"6379","23228","2014",2,2,0,132500,1138.5,119
"6380","23229","2014",2,2,0,28500,757,40
"6381","23232","2014",2,2,0,81000,1167,72.5
"6382","23233","2014",2,2,0,29000,638,48.5
"6383","23234","2014",1,1,0,66500,875,76
"6384","23235","2014",8,8,0,74689.75,715.875,98.75
"6385","23236","2014",1,1,0,47000,870,54
"6386","23238","2014",4,4,0,66745,805.75,83.25
"6387","23239","2014",5,5,0,82400,857.4,111.8
"6388","23240","2014",5,5,0,84140,1156.2,82.8
"6389","23241","2014",3,3,0,53500,498.333333333333,106.666666666667
"6390","23242","2014",1,1,0,80000,1026,78
"6391","23243","2014",4,4,0,91982.5,974.75,103.75
"6392","23244","2014",5,5,0,166100,1364.6,100
"6393","23245","2014",15,15,0,110461.933333333,1108.93333333333,101.066666666667
"6394","23247","2014",13,13,0,113176.923076923,969.384615384615,117.153846153846
"6395","23248","2014",4,4,0,117750,1217,99.25
"6396","23249","2014",3,3,0,66333.3333333333,800,84.3333333333333
"6397","23250","2014",2,2,0,45500,564,75
"6398","23251","2014",1,1,0,143000,1117,128
"6399","23252","2014",5,5,0,93244,1001.4,91.4
"6400","23253","2014",2,2,0,105500,1494,61
"6401","23254","2014",3,3,0,111333.333333333,1577.33333333333,72.3333333333333
"6402","23257","2014",9,9,0,132550,1205,109.555555555556
"6403","23259","2014",1,1,0,20000,333,60
"6404","23260","2014",2,2,0,38500,537.5,70
"6405","23261","2014",2,1,1,41500,875,49
"6406","23263","2014",1,1,0,110000,1000,110
"6407","23266","2014",2,2,0,107293.5,829,130
"6408","24001","2014",5,5,0,108660,1194.8,98.2
"6409","24002","2014",18,17,1,124390.277777778,1095.27777777778,118.444444444444
"6410","24004","2014",4,4,0,124175,1625.75,82.5
"6411","24005","2014",1,1,0,30000,361,83
"6412","24007","2014",2,2,0,113755,1232,92.5
"6413","24008","2014",2,2,0,61250,647,92
"6414","24009","2014",5,5,0,109436,1199.6,104.2
"6415","24010","2014",15,15,0,155466.666666667,1571.66666666667,105
"6416","24011","2014",8,8,0,117698.75,1357,87.625
"6417","24012","2014",2,2,0,199000,1657.5,117
"6418","24014","2014",4,4,0,219500,1828.25,126.5
"6419","24015","2014",3,3,0,230333.333333333,2045.66666666667,112
"6420","24016","2014",8,8,0,105216.875,987,103.125
"6421","24018","2014",6,6,0,145748.666666667,1220,111
"6422","24019","2014",4,4,0,115677.5,1205,117.5
"6423","24020","2014",13,12,1,162353.846153846,1400.76923076923,116.769230769231
"6424","24021","2014",3,3,0,102701.666666667,1136.66666666667,92
"6425","24022","2014",5,5,0,144600,1117.6,125.6
"6426","24023","2014",1,1,0,135000,1436,94
"6427","24024","2014",1,1,0,343750,982,350
"6428","24025","2014",2,2,0,222112.5,2338,92
"6429","24026","2014",36,36,0,143469.805555556,1380.63888888889,108.25
"6430","24028","2014",21,21,0,142526.333333333,1533,97.0476190476191
"6431","24029","2014",4,4,0,81000,1061,76.75
"6432","24030","2014",4,4,0,97512.5,1310.5,76.25
"6433","24032","2014",2,2,0,105000,1290,81
"6434","24035","2014",8,8,0,145314.375,1304.75,120.125
"6435","24037","2014",312,250,62,120839.314102564,1373.66025641026,89.6730769230769
"6436","24038","2014",2,2,0,209060,1134,192.5
"6437","24040","2014",3,3,0,157986.666666667,2134.66666666667,79.6666666666667
"6438","24042","2014",4,4,0,130250,1238.75,106.75
"6439","24045","2014",1,1,0,306500,1858,165
"6440","24046","2014",2,2,0,125100,1262,101.5
"6441","24048","2014",2,2,0,191405.5,1856.5,101.5
"6442","24050","2014",2,2,0,120090,1446,75
"6443","24053","2014",81,72,9,150987.654320988,1517.79012345679,99.0617283950617
"6444","24054","2014",9,9,0,102666.666666667,1429.88888888889,69.5555555555556
"6445","24055","2014",6,6,0,146716.833333333,1101.33333333333,122
"6446","24056","2014",2,2,0,64250,804,77
"6447","24058","2014",2,2,0,122220,1365.5,89.5
"6448","24059","2014",1,1,0,80000,1194,67
"6449","24061","2014",1,1,0,190000,1267,150
"6450","24062","2014",4,4,0,163605,1390.25,116.75
"6451","24063","2014",2,2,0,125500,1520,98.5
"6452","24064","2014",17,17,0,126194.117647059,1690.41176470588,86.1764705882353
"6453","24066","2014",3,3,0,140666.666666667,1333.33333333333,100.333333333333
"6454","24067","2014",25,24,1,213382.16,1906.12,104.52
"6455","24068","2014",15,15,0,122200,1173.4,99.6
"6456","24069","2014",3,3,0,83666.6666666667,1091.66666666667,76
"6457","24070","2014",4,4,0,126687.5,1241.75,99
"6458","24071","2014",4,4,0,62500,968.25,66.25
"6459","24073","2014",5,5,0,230277.4,2296.2,100
"6460","24074","2014",6,6,0,159466.666666667,1671.33333333333,98.1666666666667
"6461","24075","2014",1,1,0,1e+05,775,129
"6462","24076","2014",4,4,0,122000,1659.5,71.75
"6463","24080","2014",3,3,0,212333.333333333,1226.33333333333,156
"6464","24081","2014",15,13,2,124790,1463.06666666667,92.5333333333333
"6465","24082","2014",16,16,0,138519.0625,1804,88.1875
"6466","24083","2014",1,1,0,105000,750,140
"6467","24085","2014",1,1,0,210000,875,240
"6468","24086","2014",3,3,0,256666.666666667,2722,85.6666666666667
"6469","24087","2014",10,10,0,210085,2223.1,96.7
"6470","24088","2014",3,3,0,188000,1499.33333333333,103
"6471","24090","2014",3,3,0,211666.666666667,1777.66666666667,123
"6472","24091","2014",11,11,0,137363.636363636,1244.45454545455,111.454545454545
"6473","24094","2014",1,1,0,175000,1902,92
"6474","24096","2014",6,6,0,163166.666666667,1508.5,111.166666666667
"6475","24097","2014",4,4,0,72365,765.75,95.5
"6476","24098","2014",27,26,1,143305.185185185,1411.88888888889,103.074074074074
"6477","24100","2014",3,3,0,105616.666666667,1250.66666666667,79.6666666666667
"6478","24101","2014",3,3,0,165666.666666667,1421.33333333333,113.666666666667
"6479","24102","2014",36,35,1,142691.666666667,1482.25,99.2777777777778
"6480","24104","2014",3,3,0,116340,1289.66666666667,91.3333333333333
"6481","24105","2014",3,3,0,89090,813.666666666667,96.6666666666667
"6482","24106","2014",4,4,0,152125,1743,91.5
"6483","24107","2014",4,4,0,89875,1131.5,82.5
"6484","24108","2014",10,10,0,138950,1356.9,104.2
"6485","24109","2014",2,2,0,79925,832,94
"6486","24110","2014",1,1,0,107500,977,110
"6487","24111","2014",2,2,0,143620,1166,115
"6488","24115","2014",13,13,0,166280.769230769,1593,100.230769230769
"6489","24116","2014",4,4,0,83912.5,1219.75,68
"6490","24117","2014",4,4,0,107041,1343.75,78.75
"6491","24119","2014",3,3,0,235006.666666667,1273,180.333333333333
"6492","24120","2014",4,4,0,91750,861.75,90.75
"6493","24122","2014",2,2,0,186250,1103.5,160
"6494","24124","2014",7,7,0,106542.857142857,1001.42857142857,104.857142857143
"6495","24126","2014",3,3,0,119950,1539.33333333333,79.6666666666667
"6496","24128","2014",2,2,0,106500,1207.5,93
"6497","24129","2014",2,2,0,39000,709,56
"6498","24130","2014",11,11,0,113645,1685.09090909091,75.7272727272727
"6499","24132","2014",1,1,0,160000,1538,104
"6500","24134","2014",8,8,0,117437.875,1237,96.25
"6501","24135","2014",3,3,0,114500,1166.33333333333,99.6666666666667
"6502","24136","2014",1,1,0,90000,1837,49
"6503","24137","2014",3,3,0,117666.666666667,1451.66666666667,83.3333333333333
"6504","24138","2014",57,51,6,126585.964912281,1394.43859649123,92.3333333333333
"6505","24139","2014",13,13,0,153892.307692308,1502,105.076923076923
"6506","24140","2014",6,6,0,124083.333333333,1395.16666666667,89.3333333333333
"6507","24141","2014",4,4,0,189925,1705.75,109
"6508","24142","2014",11,11,0,198381.818181818,2132.63636363636,100.454545454545
"6509","24143","2014",4,4,0,92750,1092.75,115.25
"6510","24145","2014",13,13,0,139307.692307692,1253.07692307692,123.384615384615
"6511","24146","2014",1,1,0,260000,3171,82
"6512","24147","2014",12,12,0,99270.4166666667,1152.41666666667,89.0833333333333
"6513","24148","2014",6,6,0,189908.333333333,1510.16666666667,133.166666666667
"6514","24150","2014",10,10,0,190658,1805.4,104.3
"6515","24151","2014",1,1,0,390000,3679,106
"6516","24152","2014",5,5,0,298280,2758.6,107
"6517","24153","2014",4,4,0,95553.5,1103.5,89.75
"6518","24154","2014",2,2,0,113100,1274.5,89
"6519","24156","2014",6,6,0,117125,1110.83333333333,101.5
"6520","24157","2014",6,6,0,69766.6666666667,945,78.8333333333333
"6521","24158","2014",4,4,0,63573.75,911.5,68.5
"6522","24159","2014",5,5,0,65700,834,88.2
"6523","24160","2014",1,1,0,115800,1316,88
"6524","24162","2014",2,2,0,150000,1534,97.5
"6525","24163","2014",2,2,0,66972.5,893,75
"6526","24164","2014",15,14,1,82660.6666666667,951.8,86.4
"6527","24165","2014",3,3,0,98166.6666666667,1011.66666666667,96.3333333333333
"6528","24167","2014",41,41,0,121670.756097561,1194.78048780488,102.658536585366
"6529","24168","2014",6,6,0,210240,1597.83333333333,114.5
"6530","24171","2014",3,3,0,225666.666666667,1335,139.666666666667
"6531","24172","2014",7,7,0,213642.857142857,2727.71428571429,90.1428571428571
"6532","24175","2014",1,1,0,140000,1167,120
"6533","24177","2014",11,11,0,167863.636363636,1472.45454545455,115
"6534","24179","2014",5,5,0,103537.6,1170.2,91.4
"6535","24182","2014",8,8,0,173354.125,1372.375,120.75
"6536","24183","2014",2,2,0,137000,1993,63.5
"6537","24184","2014",4,4,0,196108.75,1303.75,135
"6538","24186","2014",2,2,0,132000,1381.5,97
"6539","24188","2014",6,6,0,90333.3333333333,963.833333333333,93.5
"6540","24189","2014",4,4,0,112750,1079.25,97.75
"6541","24190","2014",2,2,0,359725,1673,191
"6542","24191","2014",1,1,0,15000,938,16
"6543","24192","2014",4,4,0,210000,2205.5,97.5
"6544","24194","2014",11,11,0,93909.0909090909,1139.63636363636,81.8181818181818
"6545","24196","2014",8,8,0,138275.875,1452.625,100.875
"6546","24197","2014",4,4,0,222007.5,1444.25,166.5
"6547","24199","2014",2,2,0,95500,742.5,145.5
"6548","24200","2014",10,10,0,111300,1187.7,101.7
"6549","24202","2014",1,1,0,75000,577,130
"6550","24205","2014",6,6,0,103833.333333333,1120.83333333333,90.5
"6551","24207","2014",3,3,0,55000,1036,55.3333333333333
"6552","24209","2014",1,1,0,117500,1175,100
"6553","24210","2014",7,6,1,116785.714285714,1023,90
"6554","24212","2014",14,13,1,138428.571428571,1460,99.7857142857143
"6555","24214","2014",6,6,0,97833.3333333333,1024.16666666667,87.5
"6556","24216","2014",2,2,0,33500,522,60.5
"6557","24217","2014",4,4,0,142500,1634.5,84.25
"6558","24218","2014",24,24,0,103644.583333333,1219.375,90.25
"6559","24220","2014",5,5,0,131600,1573.4,88.2
"6560","24222","2014",22,22,0,117818.181818182,1094.09090909091,111.363636363636
"6561","24223","2014",25,25,0,116632.72,1361.24,84.48
"6562","24224","2014",3,3,0,55000,668.666666666667,80
"6563","24225","2014",14,14,0,145491.428571429,1451.57142857143,101.428571428571
"6564","24226","2014",12,12,0,124475,1217.66666666667,98.4166666666667
"6565","24227","2014",8,8,0,79375,850.375,92.875
"6566","24228","2014",6,6,0,171616.666666667,1537.83333333333,109.833333333333
"6567","24229","2014",16,15,1,90182.1875,1192.1875,83.5625
"6568","24230","2014",1,1,0,167000,1295,129
"6569","24232","2014",2,2,0,108500,2182.5,68
"6570","24234","2014",2,2,0,118500,917.5,122.5
"6571","24236","2014",2,2,0,133500,1420,100
"6572","24237","2014",10,10,0,231320,1503.8,150.5
"6573","24238","2014",4,4,0,205705,1853.75,108.25
"6574","24240","2014",2,2,0,227500,1757,132.5
"6575","24241","2014",4,4,0,106000,1385,78.75
"6576","24242","2014",1,1,0,130400,1358,96
"6577","24243","2014",10,10,0,92135.9,921.3,99.2
"6578","24245","2014",2,2,0,240220,1931.5,105
"6579","24248","2014",1,1,0,70000,1000,70
"6580","24251","2014",3,3,0,127666.666666667,1384.33333333333,98.6666666666667
"6581","24252","2014",5,5,0,239500,2178.6,110
"6582","24253","2014",21,20,1,109295.285714286,1146.71428571429,97.7142857142857
"6583","24254","2014",2,2,0,317500,1911.5,161.5
"6584","24255","2014",4,4,0,166250,1752.25,93
"6585","24256","2014",25,23,2,145017.96,1447.52,97.8
"6586","24257","2014",1,1,0,240000,2553,94
"6587","24260","2014",2,2,0,242500,2032.5,116.5
"6588","24261","2014",4,4,0,127750,2312.5,57.5
"6589","24262","2014",1,1,0,220000,1760,125
"6590","24264","2014",14,14,0,121633.071428571,1143.78571428571,104.428571428571
"6591","24266","2014",11,11,0,108615.454545455,1160.09090909091,97.5454545454545
"6592","24268","2014",4,4,0,131250,1413,97.25
"6593","24269","2014",7,7,0,94142.8571428571,1030.71428571429,92.2857142857143
"6594","24271","2014",5,5,0,175260,1209.6,105.8
"6595","24272","2014",6,6,0,136015,1344.16666666667,105
"6596","24273","2014",3,3,0,238190,2158.66666666667,113.333333333333
"6597","24274","2014",10,10,0,190135,1342.2,131.2
"6598","24277","2014",1,1,0,177000,1106,160
"6599","24278","2014",2,2,0,293150,1900,144.5
"6600","24280","2014",4,4,0,183875,1625.25,122.25
"6601","24282","2014",3,3,0,146166.666666667,1067,151.666666666667
"6602","24284","2014",3,3,0,71833.3333333333,972,65.3333333333333
"6603","24286","2014",1,1,0,157050,1939,81
"6604","24287","2014",1,1,0,274395,2690,102
"6605","24288","2014",5,5,0,342600,1766.8,163.6
"6606","24289","2014",6,6,0,157160,1373.83333333333,109.666666666667
"6607","24290","2014",2,2,0,160000,2103.5,72.5
"6608","24291","2014",33,33,0,167086.96969697,1860.51515151515,90.4848484848485
"6609","24292","2014",4,4,0,133462.5,1039,130
"6610","24293","2014",3,3,0,183333.333333333,1705,107.666666666667
"6611","24294","2014",70,70,0,113010.928571429,1287.64285714286,95.7
"6612","24295","2014",11,11,0,88772.7272727273,1099.36363636364,83.9090909090909
"6613","24296","2014",15,15,0,108923.333333333,1238.2,87.4666666666667
"6614","24297","2014",2,2,0,137420,1216,113.5
"6615","24299","2014",32,32,0,94944.375,1009.15625,97.8125
"6616","24300","2014",6,6,0,185250,1594.66666666667,118.666666666667
"6617","24301","2014",4,4,0,137500,1786.5,91.25
"6618","24302","2014",5,5,0,185000,1156,141
"6619","24303","2014",4,4,0,211941.25,1490.5,130
"6620","24304","2014",9,9,0,97111.1111111111,999.444444444444,94.3333333333333
"6621","24305","2014",1,1,0,73025,1043,70
"6622","24307","2014",3,3,0,168577.333333333,1565.66666666667,96.3333333333333
"6623","24308","2014",7,7,0,120142.142857143,1216.71428571429,95.1428571428571
"6624","24309","2014",22,20,2,121709.090909091,1207.77272727273,102.909090909091
"6625","24311","2014",24,23,1,108525.666666667,1180.66666666667,91.6666666666667
"6626","24312","2014",47,39,8,131399.957446809,1389.1914893617,94.2553191489362
"6627","24316","2014",9,9,0,97000,914.222222222222,103.222222222222
"6628","24317","2014",1,1,0,274000,1851,148
"6629","24318","2014",3,3,0,314453.333333333,2363,125
"6630","24319","2014",7,7,0,110141.428571429,1234.14285714286,94.7142857142857
"6631","24320","2014",10,9,1,108300,1254.3,95.1
"6632","24322","2014",351,141,210,109050.293447293,1468.81196581197,77.0883190883191
"6633","24323","2014",3,3,0,136166.666666667,1173,118.666666666667
"6634","24324","2014",2,2,0,62500,753,83
"6635","24325","2014",6,6,0,109950,1221.16666666667,96.3333333333333
"6636","24326","2014",2,2,0,215300,1233,175
"6637","24328","2014",15,15,0,112206.666666667,1036.2,115.533333333333
"6638","24329","2014",3,3,0,137736.666666667,1578.33333333333,90
"6639","24330","2014",8,8,0,194801.25,1720.75,112.375
"6640","24334","2014",1,1,0,5e+05,1799,278
"6641","24335","2014",19,19,0,141115,1926.42105263158,98.5789473684211
"6642","24336","2014",1,1,0,110000,1375,80
"6643","24338","2014",4,4,0,143750,1162.5,128.25
"6644","24339","2014",1,1,0,140000,1918,73
"6645","24340","2014",27,27,0,143503.888888889,1362.33333333333,109.074074074074
"6646","24341","2014",3,3,0,175066.666666667,1986,93.3333333333333
"6647","24345","2014",4,4,0,178650,1381,119.5
"6648","24346","2014",9,8,1,120171.888888889,1243.22222222222,91.6666666666667
"6649","24347","2014",1,1,0,40000,597,67
"6650","24348","2014",4,4,0,241665,1442.5,181
"6651","24350","2014",21,21,0,123343.523809524,1374.80952380952,91
"6652","24352","2014",31,29,2,127679.290322581,1300.06451612903,91.8387096774194
"6653","24353","2014",4,4,0,128840,1169.75,121
"6654","24354","2014",30,30,0,95256.6666666667,1085.66666666667,89.8
"6655","24355","2014",3,3,0,248333.333333333,1540.33333333333,170
"6656","24356","2014",20,20,0,124295,1340.55,91.4
"6657","24359","2014",1,1,0,163500,1434,114
"6658","24360","2014",3,3,0,196000,1556.33333333333,125.666666666667
"6659","24361","2014",5,5,0,216050,1781.4,121.8
"6660","24362","2014",17,17,0,163492.882352941,1698.70588235294,100.352941176471
"6661","24365","2014",1,1,0,87000,1145,76
"6662","24366","2014",1,1,0,84000,1050,80
"6663","24370","2014",13,13,0,136729.230769231,1107.23076923077,125
"6664","24371","2014",3,3,0,271333.333333333,1804.66666666667,136.333333333333
"6665","24372","2014",40,39,1,140763.25,1512.3,90.1
"6666","24373","2014",3,3,0,259666.666666667,1371,178.666666666667
"6667","24374","2014",5,5,0,107400,1243,92.2
"6668","24375","2014",1,1,0,355000,2630,135
"6669","24376","2014",15,15,0,123953.933333333,1408.26666666667,87.8
"6670","24377","2014",1,1,0,220000,1538,143
"6671","24378","2014",2,2,0,147500,1406.5,111
"6672","24379","2014",7,7,0,220918.571428571,1835,130.714285714286
"6673","24380","2014",4,4,0,82250,1215.75,68
"6674","24382","2014",8,8,0,128812.5,1436.375,88
"6675","24383","2014",1,1,0,260000,1635,159
"6676","24386","2014",3,3,0,143666.666666667,1595.66666666667,100.666666666667
"6677","24388","2014",6,6,0,173833.333333333,1624.16666666667,115.333333333333
"6678","24390","2014",5,5,0,132760,1636.2,78.6
"6679","24392","2014",1,1,0,2e+05,1515,132
"6680","24394","2014",1,1,0,123000,1017,121
"6681","24395","2014",4,4,0,187250,2046,91
"6682","24396","2014",22,20,2,148808.954545455,1438.18181818182,96.0909090909091
"6683","24397","2014",1,1,0,111500,1664,67
"6684","24398","2014",8,8,0,99118.75,1062.125,91.375
"6685","24399","2014",2,2,0,184360,1104.5,161
"6686","24401","2014",2,2,0,90000,949.5,94.5
"6687","24403","2014",2,2,0,77500,992,74
"6688","24404","2014",1,1,0,411150,1967,209
"6689","24405","2014",5,5,0,131780,1699.4,84.8
"6690","24408","2014",2,2,0,84000,914.5,102.5
"6691","24409","2014",10,10,0,113500,1173.2,95.5
"6692","24410","2014",4,4,0,68700,858.25,76
"6693","24411","2014",1,1,0,232000,1333,174
"6694","24412","2014",8,5,3,145325,1517.625,91.125
"6695","24413","2014",4,4,0,193075,1868.25,101.75
"6696","24415","2014",1,1,0,71000,732,97
"6697","24416","2014",3,3,0,130000,1669.66666666667,72.6666666666667
"6698","24417","2014",6,6,0,133450,1184.33333333333,109
"6699","24418","2014",6,6,0,85333.3333333333,810.666666666667,110
"6700","24419","2014",6,6,0,116693.166666667,1078.83333333333,113.333333333333
"6701","24420","2014",3,3,0,127333.333333333,1224.66666666667,95
"6702","24421","2014",5,5,0,193563.4,1595.4,109.4
"6703","24423","2014",3,3,0,110000,1142.66666666667,91.3333333333333
"6704","24425","2014",8,8,0,119581.25,1353.75,92
"6705","24429","2014",2,2,0,185062.5,1480,125
"6706","24432","2014",7,7,0,120421.428571429,1437.28571428571,78.5714285714286
"6707","24434","2014",1,1,0,95000,1188,80
"6708","24436","2014",8,8,0,120062.5,1514.25,86.25
"6709","24437","2014",7,7,0,99839.2857142857,919.714285714286,107.571428571429
"6710","24438","2014",1,1,0,2e+05,5000,40
"6711","24441","2014",1,1,0,1e+05,1111,90
"6712","24442","2014",23,23,0,111201.086956522,1248.47826086957,84.5652173913043
"6713","24443","2014",4,4,0,123750,1332.75,94.25
"6714","24444","2014",3,3,0,69866.6666666667,810,83.6666666666667
"6715","24445","2014",3,3,0,120333.333333333,1807.66666666667,70.3333333333333
"6716","24448","2014",5,5,0,77300,1254.4,66.4
"6717","24449","2014",8,8,0,112925,991.125,111.5
"6718","24450","2014",9,9,0,162697.777777778,1584.22222222222,110.222222222222
"6719","24451","2014",6,6,0,101550,1074.66666666667,93.3333333333333
"6720","24452","2014",2,2,0,235755,2066.5,108.5
"6721","24453","2014",2,2,0,153900,747,204.5
"6722","24454","2014",5,5,0,72800,1009.8,89.8
"6723","24455","2014",3,3,0,71650,842.333333333333,86.6666666666667
"6724","24458","2014",1,1,0,1e+05,855,117
"6725","24459","2014",3,3,0,157333.333333333,1434.66666666667,121.666666666667
"6726","24460","2014",5,5,0,73800,879,81
"6727","24461","2014",10,9,1,130520,1336.5,99.1
"6728","24462","2014",18,18,0,109138.888888889,1325.88888888889,83.6666666666667
"6729","24463","2014",5,5,0,102600,1412,79.4
"6730","24464","2014",3,3,0,76776.6666666667,1310.33333333333,64
"6731","24465","2014",5,5,0,89500,835.2,107.8
"6732","24466","2014",4,4,0,98000,955,101.75
"6733","24468","2014",1,1,0,120000,1333,90
"6734","24470","2014",2,2,0,280000,2857.5,95.5
"6735","24471","2014",2,2,0,257500,2040,126.5
"6736","24472","2014",4,4,0,159625,1618,97.75
"6737","24473","2014",5,5,0,132300,1366.8,94.6
"6738","24474","2014",2,2,0,90500,1114,84
"6739","24476","2014",2,2,0,127965,1227,121
"6740","24477","2014",2,2,0,48750,808.5,73
"6741","24479","2014",12,11,1,81547.9166666667,1132.83333333333,82.3333333333333
"6742","24480","2014",1,1,0,18500,330,56
"6743","24482","2014",6,6,0,126250,1242.66666666667,105.833333333333
"6744","24484","2014",10,10,0,120550,1245,98.6
"6745","24485","2014",1,1,0,111630,915,122
"6746","24487","2014",9,9,0,139813.555555556,1462.77777777778,105
"6747","24488","2014",3,3,0,116666.666666667,1218.66666666667,95.6666666666667
"6748","24491","2014",4,4,0,77150,1489.75,72
"6749","24493","2014",1,1,0,30000,448,67
"6750","24494","2014",6,6,0,151303.333333333,1345,122.833333333333
"6751","24496","2014",3,3,0,154166.666666667,996,156.666666666667
"6752","24498","2014",12,12,0,111424.666666667,1243.25,87.5
"6753","24499","2014",7,7,0,191632.857142857,1817.14285714286,101.857142857143
"6754","24501","2014",4,4,0,82875,765.5,105
"6755","24502","2014",1,1,0,138700,1067,130
"6756","24504","2014",3,3,0,78900,1124.33333333333,72
"6757","24505","2014",7,7,0,99395.7142857143,1108.28571428571,97.5714285714286
"6758","24508","2014",1,1,0,58800,576,102
"6759","24509","2014",6,6,0,81093.3333333333,950.333333333333,88.5
"6760","24510","2014",6,6,0,322350,2650,129.5
"6761","24512","2014",2,2,0,193250,1881,104.5
"6762","24513","2014",3,3,0,168220,1517.33333333333,109.666666666667
"6763","24515","2014",3,3,0,108414,1412.33333333333,76
"6764","24516","2014",17,17,0,106311.764705882,1264.05882352941,85.1176470588235
"6765","24518","2014",2,2,0,95000,1261,89.5
"6766","24519","2014",4,4,0,60002.5,1126.25,59.75
"6767","24520","2014",80,56,24,157205.4875,1838.0875,85.2375
"6768","24521","2014",3,3,0,154333.333333333,1419,110
"6769","24522","2014",5,5,0,116700,1115.4,106.2
"6770","24524","2014",3,3,0,311933.333333333,2010.66666666667,170.333333333333
"6771","24525","2014",2,2,0,65500,697,102
"6772","24526","2014",8,8,0,108342,1124,101.75
"6773","24527","2014",13,13,0,93846.1538461538,1401.53846153846,73.2307692307692
"6774","24528","2014",1,1,0,145000,1368,106
"6775","24529","2014",1,1,0,70000,707,99
"6776","24531","2014",3,3,0,159666.666666667,1681.33333333333,97
"6777","24532","2014",4,4,0,333875,1685.5,195.75
"6778","24534","2014",3,3,0,144495.333333333,1218.66666666667,116.666666666667
"6779","24535","2014",1,1,0,288000,2072,139
"6780","24536","2014",3,3,0,111666.666666667,1030.33333333333,97.6666666666667
"6781","24537","2014",3,2,1,139242.666666667,1825.33333333333,79.6666666666667
"6782","24538","2014",7,7,0,137000,1425.85714285714,100.142857142857
"6783","24540","2014",16,16,0,207010.625,1961.875,99.1875
"6784","24541","2014",2,2,0,81500,916,94
"6785","24543","2014",12,12,0,108121.5,939,106.916666666667
"6786","24544","2014",1,1,0,206000,1689,122
"6787","24545","2014",3,3,0,81382.6666666667,1387.33333333333,64.6666666666667
"6788","24546","2014",1,1,0,35000,473,74
"6789","24547","2014",35,29,6,99009.6571428571,1355.51428571429,79.8571428571429
"6790","24548","2014",2,2,0,143250,1417,95.5
"6791","24550","2014",12,12,0,110140,1431.16666666667,76.9166666666667
"6792","24551","2014",32,31,1,98106.9375,972.9375,99.75
"6793","24552","2014",2,2,0,249000,1587,162.5
"6794","24553","2014",11,11,0,176727.272727273,1581.72727272727,124.545454545455
"6795","24554","2014",5,5,0,107688,1082,100.2
"6796","24555","2014",7,7,0,90657.1428571429,1209.71428571429,65
"6797","24557","2014",66,52,14,136874,1440.63636363636,96.030303030303
"6798","24558","2014",12,12,0,191500,1656.08333333333,119.083333333333
"6799","24562","2014",1,1,0,150000,1442,104
"6800","24563","2014",1,1,0,460000,4340,106
"6801","24564","2014",8,8,0,150115,2207.625,92.75
"6802","24565","2014",4,4,0,90500,635.25,129
"6803","24566","2014",7,7,0,123170,1207.28571428571,97.7142857142857
"6804","24568","2014",7,7,0,97985.7142857143,883.285714285714,104.571428571429
"6805","24570","2014",1,1,0,320000,1333,240
"6806","24571","2014",11,9,2,130500,1258.72727272727,105.636363636364
"6807","24573","2014",2,2,0,57700,593,105.5
"6808","24574","2014",1,1,0,40000,800,50
"6809","24575","2014",5,5,0,222455.4,2133.2,100.2
"6810","24576","2014",1,1,0,125500,1992,63
"6811","24577","2014",3,3,0,273333.333333333,2269.33333333333,121.666666666667
"6812","24580","2014",4,4,0,88289.5,910,97.25
"6813","24582","2014",3,3,0,131800,1162.33333333333,111.333333333333
"6814","24584","2014",9,9,0,103583.333333333,1223.33333333333,96.8888888888889
"6815","24585","2014",2,2,0,97500,912.5,100.5
"6816","24586","2014",9,9,0,130138.888888889,1400,99.6666666666667
"6817","24587","2014",5,5,0,188455,1540.8,128.8
"6818","25001","2014",1,1,0,182000,1319,138
"6819","25002","2014",1,1,0,278000,1706,163
"6820","25003","2014",2,2,0,109500,957.5,122.5
"6821","25004","2014",12,12,0,179325,1582.08333333333,122.333333333333
"6822","25006","2014",1,1,0,80675,520,155
"6823","25008","2014",4,4,0,129900,1279.5,105.5
"6824","25009","2014",1,1,0,120000,1463,82
"6825","25011","2014",4,3,1,195912.5,1575,122.5
"6826","25012","2014",2,2,0,267438.5,2272,120
"6827","25013","2014",3,3,0,184509.333333333,1364.66666666667,135.333333333333
"6828","25014","2014",3,3,0,162333.333333333,928.666666666667,140.666666666667
"6829","25015","2014",2,2,0,182000,940.5,191.5
"6830","25016","2014",2,2,0,135000,2163.5,66.5
"6831","25018","2014",8,8,0,94962.5,932.625,105.5
"6832","25019","2014",1,1,0,135000,1688,80
"6833","25020","2014",4,4,0,107525,1351.75,81
"6834","25021","2014",15,15,0,127851.266666667,1378,103.6
"6835","25022","2014",9,8,1,133617.777777778,1342,99.2222222222222
"6836","25024","2014",2,2,0,290000,2116,136.5
"6837","25025","2014",4,4,0,279062.5,2639.75,107.75
"6838","25026","2014",2,1,1,202750,1069.5,184
"6839","25029","2014",4,4,0,239250,1775,140.5
"6840","25030","2014",9,8,1,195274.444444444,1682.66666666667,118.888888888889
"6841","25031","2014",133,76,57,111400.07518797,1272.73684210526,84.5563909774436
"6842","25032","2014",4,4,0,169000,1529.75,110.25
"6843","25035","2014",10,9,1,209932,2022,109
"6844","25036","2014",10,9,1,182246,1850,95.8
"6845","25038","2014",1,1,0,182000,1750,104
"6846","25039","2014",4,4,0,179034.5,2047,91.75
"6847","25040","2014",7,4,3,144542.857142857,1453.71428571429,99.5714285714286
"6848","25041","2014",1,1,0,128000,800,160
"6849","25042","2014",1,1,0,203150,2572,79
"6850","25043","2014",16,11,5,133990.625,1523.0625,90.375
"6851","25046","2014",3,3,0,118515,1817,61.3333333333333
"6852","25047","2014",46,27,19,114422.173913043,1388.76086956522,85.0217391304348
"6853","25048","2014",22,18,4,142030.909090909,1525.04545454545,91.5909090909091
"6854","25050","2014",1,1,0,129000,1290,100
"6855","25051","2014",5,5,0,137120,1598.8,94
"6856","25052","2014",2,2,0,209525,1664,140
"6857","25054","2014",5,4,1,139340,1237.4,111.6
"6858","25055","2014",4,4,0,183132,1888.75,99.5
"6859","25056","2014",1311,170,1141,128073.798627002,1830.79481311976,69.8222730739893
"6860","25057","2014",25,20,5,122375.96,1307.44,95.84
"6861","25058","2014",16,11,5,135562.1875,1717,81.875
"6862","25059","2014",1,1,0,145000,1686,86
"6863","25060","2014",8,7,1,194062.75,1577.25,125.75
"6864","25061","2014",1,1,0,105000,1141,92
"6865","25062","2014",3,2,1,270166.666666667,2492.33333333333,109
"6866","25063","2014",10,2,8,91473,1236.1,79
"6867","25066","2014",1,1,0,171500,2018,85
"6868","25067","2014",1,1,0,50000,649,77
"6869","25070","2014",2,2,0,157283.5,1540,100
"6870","25071","2014",6,3,3,137908.333333333,1430.83333333333,97.1666666666667
"6871","25073","2014",4,4,0,146875,2117.5,69.75
"6872","25074","2014",9,9,0,235705.555555556,1767.33333333333,143
"6873","25075","2014",4,2,2,113750,1624.25,75.75
"6874","25078","2014",2,2,0,135000,1062,134
"6875","25079","2014",3,3,0,142816.666666667,1137,119.333333333333
"6876","25082","2014",6,6,0,174566.666666667,1811.33333333333,106.333333333333
"6877","25083","2014",3,3,0,119533.333333333,1256.33333333333,103.666666666667
"6878","25084","2014",11,8,3,164959.090909091,1639.27272727273,108.727272727273
"6879","25085","2014",2,2,0,153250,1136,139
"6880","25086","2014",1,1,0,235000,1416,166
"6881","25087","2014",1,1,0,185000,508,364
"6882","25090","2014",1,1,0,98000,1307,75
"6883","25091","2014",4,3,1,180190,1995.25,91.75
"6884","25093","2014",1,1,0,166850,1854,90
"6885","25094","2014",1,1,0,160000,982,163
"6886","25095","2014",3,3,0,109364.666666667,1219,92
"6887","25097","2014",3,3,0,131766.666666667,1315,99.6666666666667
"6888","25098","2014",2,2,0,117800,1367,93
"6889","25100","2014",3,3,0,235573.333333333,1892,132.666666666667
"6890","25101","2014",9,8,1,160398.888888889,1499.33333333333,110.111111111111
"6891","25102","2014",2,2,0,145000,1189.5,121
"6892","25103","2014",4,4,0,198645.75,1536.25,126.75
"6893","25104","2014",1,1,0,65000,765,85
"6894","25105","2014",3,3,0,121466.666666667,1397.33333333333,86.3333333333333
"6895","25107","2014",1,1,0,40000,533,75
"6896","25108","2014",4,3,1,236617.5,2490.75,96.5
"6897","25110","2014",2,2,0,204500,2148.5,93.5
"6898","25111","2014",2,2,0,246500,2034,122.5
"6899","25112","2014",9,5,4,135771.555555556,1387.33333333333,91
"6900","25113","2014",1,1,0,128000,1347,95
"6901","25114","2014",3,3,0,96666.6666666667,979.333333333333,103.333333333333
"6902","25115","2014",4,1,3,186500,2042.75,102.25
"6903","25116","2014",2,2,0,171000,1509,137.5
"6904","25117","2014",2,1,1,176675,1513,118
"6905","25119","2014",3,3,0,141800,1718.66666666667,81.3333333333333
"6906","25120","2014",3,3,0,98622,927.666666666667,108.333333333333
"6907","25121","2014",2,2,0,217500,3421,85.5
"6908","25122","2014",2,1,1,161000,1844.5,91
"6909","25124","2014",1,1,0,226920,2836,80
"6910","25125","2014",4,4,0,92000,924,98.25
"6911","25126","2014",1,1,0,259700,1967,132
"6912","25127","2014",29,10,19,151886.172413793,1602.20689655172,95.6896551724138
"6913","25129","2014",1,1,0,186000,1676,111
"6914","25131","2014",2,2,0,129075,1301,74
"6915","25132","2014",2,2,0,143750,1829.5,88
"6916","25133","2014",18,15,3,230266.944444444,1811.55555555556,128.722222222222
"6917","25139","2014",3,3,0,223000,1620.66666666667,181.333333333333
"6918","25141","2014",1,1,0,86000,945,91
"6919","25142","2014",4,4,0,183750,2584.25,100
"6920","25143","2014",1,1,0,218000,1362,160
"6921","25147","2014",13,13,0,213619.230769231,1989.07692307692,109
"6922","25148","2014",3,3,0,201166.666666667,1745.33333333333,117.333333333333
"6923","25149","2014",4,4,0,133100,1271,112.25
"6924","25150","2014",6,6,0,116073,1428.33333333333,81.5
"6925","25152","2014",1,1,0,305585,1898,161
"6926","25153","2014",1,1,0,316000,1708,185
"6927","25154","2014",1,1,0,166000,2306,72
"6928","25155","2014",2,2,0,72500,754,97.5
"6929","25156","2014",8,8,0,140562.5,1220.5,113.875
"6930","25157","2014",14,4,10,177380.714285714,2295.64285714286,81.8571428571429
"6931","25159","2014",6,6,0,136133.333333333,1176,110.833333333333
"6932","25160","2014",6,5,1,278308.333333333,2504.33333333333,114.666666666667
"6933","25163","2014",1,1,0,414500,2591,160
"6934","25164","2014",2,2,0,146250,929.5,156
"6935","25166","2014",1,1,0,88300,920,96
"6936","25170","2014",11,8,3,164900,1506.72727272727,109.090909090909
"6937","25171","2014",1,1,0,240000,1387,173
"6938","25173","2014",2,1,1,86500,1012,91
"6939","25174","2014",1,1,0,167300,3098,54
"6940","25176","2014",3,3,0,208066.666666667,2522.66666666667,83.3333333333333
"6941","25177","2014",1,1,0,240000,1212,198
"6942","25179","2014",3,3,0,222833.333333333,2094,107.666666666667
"6943","25180","2014",3,3,0,85866.6666666667,907.666666666667,90
"6944","25181","2014",2,2,0,65250,913.5,69
"6945","25183","2014",2,2,0,75200,735,102.5
"6946","25184","2014",1,1,0,40000,500,80
"6947","25186","2014",6,4,2,175500,1861.5,101.666666666667
"6948","25187","2014",8,8,0,173372.5,1320.625,131.5
"6949","25188","2014",11,11,0,185010.272727273,1972.36363636364,96.3636363636364
"6950","25190","2014",16,14,2,134915.625,1405.4375,112.5625
"6951","25191","2014",1,1,0,150000,1724,87
"6952","25192","2014",1,1,0,150000,1786,84
"6953","25193","2014",13,10,3,142903.846153846,1491.46153846154,96.2307692307692
"6954","25194","2014",1,1,0,165100,1543,107
"6955","25195","2014",3,3,0,258500,2319,112.666666666667
"6956","25196","2014",10,7,3,197630,1560.5,124.5
"6957","25197","2014",5,2,3,104900,1153.6,86.4
"6958","25198","2014",11,10,1,159463.636363636,1202.09090909091,136.090909090909
"6959","25199","2014",4,4,0,152432.5,1279,111.75
"6960","25200","2014",10,9,1,232230,2008.7,113.6
"6961","25201","2014",6,3,3,226650,2331.5,97.6666666666667
"6962","25203","2014",1,1,0,2e+05,1307,153
"6963","25204","2014",20,11,9,253144.25,2583.75,99.95
"6964","25207","2014",5,4,1,165600,1604.6,103.2
"6965","25208","2014",2,1,1,156900,1487,110.5
"6966","25212","2014",23,13,10,178040.869565217,1974.73913043478,90.3913043478261
"6967","25213","2014",2,2,0,237500,2250.5,108.5
"6968","25214","2014",3,2,1,131383.333333333,1331.33333333333,106.666666666667
"6969","25215","2014",2,2,0,132000,1100,120
"6970","25217","2014",6,3,3,135000,1635.33333333333,85.1666666666667
"6971","25218","2014",2,2,0,195325,1721,114
"6972","25219","2014",1,1,0,140000,1647,85
"6973","25220","2014",1,1,0,183500,1782,103
"6974","25221","2014",1,1,0,143800,934,154
"6975","25222","2014",7,5,2,167857.142857143,1773.85714285714,112.142857142857
"6976","25223","2014",1,1,0,138550,1732,80
"6977","25224","2014",2,2,0,187500,1347,140
"6978","25225","2014",1,1,0,195600,2301,85
"6979","25226","2014",2,2,0,154250,1288,128.5
"6980","25228","2014",17,10,7,152714.117647059,1462.23529411765,113.411764705882
"6981","25229","2014",3,3,0,151666.666666667,1400.66666666667,114.333333333333
"6982","25230","2014",33,30,3,131383,1523.93939393939,86.5757575757576
"6983","25231","2014",1,1,0,146000,930,157
"6984","25233","2014",1,1,0,70000,778,90
"6985","25234","2014",2,2,0,186500,2261.5,112
"6986","25235","2014",3,3,0,160173.333333333,1636.33333333333,97.3333333333333
"6987","25236","2014",5,5,0,168180,1439,119.4
"6988","25237","2014",15,12,3,104350,1323.46666666667,81.4666666666667
"6989","25240","2014",18,15,3,269847.222222222,2576,111.388888888889
"6990","25242","2014",2,2,0,107500,901,119.5
"6991","25243","2014",3,3,0,185866.666666667,1561.33333333333,131.333333333333
"6992","25244","2014",2,2,0,143650,966.5,149.5
"6993","25245","2014",4,4,0,298717.5,2251.5,131.75
"6994","25246","2014",1,1,0,20700,518,40
"6995","25248","2014",2,2,0,265050,2229.5,119.5
"6996","25251","2014",1,1,0,40000,500,80
"6997","25254","2014",20,7,13,141410.05,2111.65,75.45
"6998","25255","2014",5,2,3,137168,1814.4,69.8
"6999","25256","2014",6,6,0,132333.333333333,1569.33333333333,83
"7000","25257","2014",1,1,0,216000,1421,152
"7001","25258","2014",18,17,1,212247,1918.11111111111,109.444444444444
"7002","25259","2014",17,10,7,166326.470588235,1537.52941176471,113.235294117647
"7003","25261","2014",1,1,0,75000,765,98
"7004","25263","2014",3,3,0,292806.666666667,2814.66666666667,110.666666666667
"7005","25264","2014",1,1,0,62000,912,68
"7006","25265","2014",12,8,4,195725,1754.41666666667,105.583333333333
"7007","25267","2014",2,2,0,203426,2054.5,101
"7008","25270","2014",1,1,0,25000,676,37
"7009","25271","2014",16,13,3,225161.6875,1776.875,126.9375
"7010","25273","2014",1,1,0,45000,600,75
"7011","25274","2014",4,3,1,101000,906.5,138.75
"7012","25275","2014",2,2,0,156750,1354,125.5
"7013","25278","2014",5,5,0,141802,1453.4,103.8
"7014","25280","2014",4,3,1,159666.75,2031.75,100.5
"7015","25281","2014",1,1,0,151100,1717,88
"7016","25282","2014",8,5,3,191367.5,2010.5,112.625
"7017","25284","2014",36,17,19,98822.0833333333,1306.25,75.75
"7018","25285","2014",10,9,1,279890,2518.7,114.9
"7019","25287","2014",35,15,20,145507.571428571,2419.65714285714,76.8857142857143
"7020","25288","2014",3,2,1,246333.333333333,2666.66666666667,96.6666666666667
"7021","25290","2014",1,1,0,51300,641,80
"7022","25293","2014",8,2,6,197811.875,2406.125,89.25
"7023","25296","2014",4,3,1,176250,2109.25,81.25
"7024","25297","2014",1,1,0,159000,799,199
"7025","25298","2014",4,4,0,162250,1386,115.25
"7026","25299","2014",1,1,0,196100,1290,152
"7027","25300","2014",2,2,0,128557.5,1507,97
"7028","25301","2014",3,3,0,274666.666666667,2713,108
"7029","25304","2014",34,20,14,97288.2352941177,1236.05882352941,78.4411764705882
"7030","25305","2014",2,2,0,190000,1719,110.5
"7031","25307","2014",17,7,10,183524.705882353,2998.52941176471,62.4117647058824
"7032","25308","2014",5,3,2,198060,2662.2,76.2
"7033","25309","2014",10,9,1,262538,2268.5,118.6
"7034","25312","2014",1,1,0,16000,800,20
"7035","25313","2014",1,1,0,185000,1480,125
"7036","25314","2014",1,1,0,54900,1569,35
"7037","25315","2014",25,17,8,118594,1313.12,88.48
"7038","25318","2014",35,18,17,179101.914285714,2777.45714285714,64.4857142857143
"7039","25320","2014",16,6,10,239796.4375,2660.9375,85.25
"7040","25321","2014",31,16,15,206376.290322581,2540.03225806452,83.741935483871
"7041","25322","2014",7,7,0,130785.714285714,1294.85714285714,93.1428571428571
"7042","25323","2014",4,4,0,100715,1314,72.5
"7043","25324","2014",2,2,0,145000,1016,124.5
"7044","25325","2014",2,1,1,88500,697.5,123.5
"7045","25326","2014",1,1,0,100200,1474,68
"7046","25327","2014",1,1,0,50000,345,145
"7047","25328","2014",3,3,0,255980,2018.33333333333,125.666666666667
"7048","25329","2014",1,0,1,45000,818,55
"7049","25330","2014",2,2,0,193050,1539.5,128.5
"7050","25331","2014",4,4,0,103000,996,112
"7051","25332","2014",4,4,0,180107.5,1823.25,103.25
"7052","25333","2014",1,0,1,134000,1117,120
"7053","25334","2014",13,5,8,134746.153846154,1582.07692307692,84.0769230769231
"7054","25336","2014",5,4,1,103232,1522.6,79.2
"7055","25339","2014",8,7,1,114343.75,978.25,122.25
"7056","25340","2014",1,1,0,105000,1167,90
"7057","25341","2014",1,1,0,206610,1476,140
"7058","25342","2014",1,1,0,117000,936,125
"7059","25343","2014",1,1,0,120000,938,128
"7060","25345","2014",8,8,0,105887.5,1312,83.875
"7061","25347","2014",9,8,1,180733.333333333,2144.77777777778,81.3333333333333
"7062","25348","2014",1,1,0,305500,2350,130
"7063","25350","2014",7,6,1,134785.714285714,1362,100.428571428571
"7064","25354","2014",1,1,0,75000,938,80
"7065","25356","2014",38,24,14,171162.921052632,1743.81578947368,102.5
"7066","25357","2014",2,2,0,251500,1728,141.5
"7067","25360","2014",1,1,0,220000,1310,168
"7068","25361","2014",19,3,16,147721.157894737,2578.05263157895,58.8421052631579
"7069","25362","2014",8,0,8,134163.75,1701.25,88.5
"7070","25364","2014",17,17,0,186807.941176471,1524.88235294118,123.588235294118
"7071","25365","2014",1,1,0,127000,1427,89
"7072","25367","2014",23,18,5,112353.913043478,1256.30434782609,91.9130434782609
"7073","25368","2014",11,11,0,180933.181818182,1574.72727272727,116.818181818182
"7074","25369","2014",4,4,0,133150,1333.75,100.75
"7075","25370","2014",16,15,1,144820.9375,1459.8125,100.625
"7076","25371","2014",1,1,0,55000,714,77
"7077","25372","2014",3,3,0,92266.6666666667,1097,96
"7078","25373","2014",1,1,0,156000,3628,43
"7079","25374","2014",3,3,0,206058.333333333,1712.66666666667,124.333333333333
"7080","25375","2014",1,0,1,380000,2346,162
"7081","25376","2014",1,1,0,218694,2209,99
"7082","25377","2014",1,1,0,54000,750,72
"7083","25378","2014",2,2,0,186622,1171.5,150
"7084","25379","2014",3,3,0,113000,1022.33333333333,97
"7085","25380","2014",80,33,47,123359.925,2925.85,42.35
"7086","25381","2014",20,14,6,205387.5,1858.4,114.6
"7087","25382","2014",7,6,1,140935.714285714,1521.57142857143,94
"7088","25383","2014",3,3,0,239033.333333333,1778.66666666667,143.666666666667
"7089","25384","2014",2,2,0,97500,1047.5,93.5
"7090","25385","2014",2,1,1,252000,2274,129
"7091","25386","2014",4,3,1,127362.5,1332.25,102.75
"7092","25387","2014",2,2,0,128083.5,2247.5,56.5
"7093","25388","2014",258,69,189,104502.930232558,1248.36046511628,80.9883720930233
"7094","25389","2014",1,1,0,186000,1842,101
"7095","25390","2014",4,2,2,181912.5,2364,78
"7096","25391","2014",1,1,0,337250,3094,109
"7097","25392","2014",1,1,0,229950,2169,106
"7098","25393","2014",9,8,1,107555.555555556,1092.88888888889,106
"7099","25394","2014",11,11,0,179460.909090909,1774.90909090909,103.090909090909
"7100","25395","2014",14,11,3,264590,1925.85714285714,132.857142857143
"7101","25397","2014",16,14,2,188612.5,1931.5,111.3125
"7102","25398","2014",2,2,0,370350,2287.5,164
"7103","25400","2014",3,3,0,69666.6666666667,646,106.666666666667
"7104","25401","2014",1,1,0,190000,1727,110
"7105","25403","2014",13,10,3,232563.076923077,2667.61538461538,97.0769230769231
"7106","25405","2014",9,8,1,230691.444444444,2236,106.777777777778
"7107","25406","2014",1,1,0,165000,1299,127
"7108","25408","2014",2,2,0,118500,1000,118.5
"7109","25410","2014",12,11,1,170784.75,1641.5,106.083333333333
"7110","25411","2014",77,20,57,196163.649350649,2332.84415584416,89.3506493506493
"7111","25413","2014",21,11,10,134295.619047619,1968.61904761905,68.1428571428571
"7112","25415","2014",11,10,1,122613.636363636,1143.45454545455,116.363636363636
"7113","25417","2014",5,5,0,151103,1389.6,116.8
"7114","25418","2014",9,5,4,103555.555555556,1223,86.6666666666667
"7115","25420","2014",4,4,0,340961.25,1424.25,227.25
"7116","25422","2014",1,1,0,127000,1187,107
"7117","25424","2014",10,9,1,133857.6,1660.1,94.9
"7118","25425","2014",4,4,0,285916.25,2439.75,118.75
"7119","25426","2014",1,1,0,135000,1125,120
"7120","25427","2014",4,4,0,135342.5,1280.25,103
"7121","25428","2014",15,11,4,116910,1272.86666666667,96.3333333333333
"7122","25429","2014",6,5,1,188108.333333333,1844.83333333333,101.5
"7123","25431","2014",4,4,0,102500,1037.25,104.5
"7124","25432","2014",14,11,3,220595,1988.64285714286,115.928571428571
"7125","25433","2014",2,2,0,175615,2170.5,82.5
"7126","25434","2014",49,31,18,138038.959183673,1377.85714285714,100.571428571429
"7127","25436","2014",2,2,0,92195,1080.5,98.5
"7128","25437","2014",2,2,0,144402,1651,87.5
"7129","25438","2014",5,5,0,179600,1447.2,126.6
"7130","25440","2014",3,3,0,209900,1855.66666666667,120
"7131","25442","2014",10,5,5,210290,2119.8,104
"7132","25446","2014",1,1,0,187000,1247,150
"7133","25447","2014",1,1,0,95000,633,150
"7134","25448","2014",13,11,2,214492.230769231,1592.76923076923,136.076923076923
"7135","25450","2014",1,1,0,90000,1034,87
"7136","25451","2014",2,2,0,206150,1954.5,106
"7137","25452","2014",7,6,1,152114.285714286,1413.71428571429,110.571428571429
"7138","25453","2014",7,7,0,139500,1379.28571428571,102.571428571429
"7139","25454","2014",11,8,3,204870.090909091,1878.18181818182,112.636363636364
"7140","25455","2014",1,1,0,243000,2209,110
"7141","25456","2014",4,4,0,182610,1347.75,144.5
"7142","25459","2014",3,2,1,272640.333333333,1904.66666666667,148.666666666667
"7143","25460","2014",2,2,0,134400,1200,112
"7144","25461","2014",1,1,0,340000,1789,190
"7145","25462","2014",244,46,198,166701.651639344,2259.95901639344,74.3852459016394
"7146","25463","2014",39,13,26,95228.5384615385,1140.07692307692,84
"7147","25464","2014",2,2,0,258500,1999,138.5
"7148","25465","2014",1,1,0,65000,739,88
"7149","25466","2014",2,2,0,202500,1660,125.5
"7150","25467","2014",15,15,0,214697.666666667,1921.4,116.266666666667
"7151","25469","2014",1,1,0,160000,1818,88
"7152","25470","2014",2,2,0,74500,717.5,106.5
"7153","25473","2014",2,1,1,177500,2153.5,81
"7154","25474","2014",1,1,0,1e+05,1111,90
"7155","25475","2014",5,5,0,178240,1544.4,123.4
"7156","25476","2014",1,1,0,126000,1518,83
"7157","25477","2014",2,2,0,215000,1463.5,147.5
"7158","25478","2014",1,1,0,120000,1165,103
"7159","25479","2014",5,5,0,151680,1252,125.2
"7160","25481","2014",3,3,0,170300,1230.33333333333,157.666666666667
"7161","25482","2014",4,4,0,136187.5,1308,114.5
"7162","25486","2014",6,4,2,259365.666666667,2212.16666666667,115.333333333333
"7163","25488","2014",1,1,0,234100,1385,169
"7164","25489","2014",3,3,0,213366.666666667,1337.66666666667,163
"7165","25490","2014",3,3,0,126980,1274.33333333333,109.666666666667
"7166","25493","2014",5,4,1,129840,1592.2,83.8
"7167","25494","2014",8,4,4,183437.5,2230.875,83.875
"7168","25495","2014",23,12,11,167286.826086957,1966.39130434783,87.8260869565217
"7169","25499","2014",1,1,0,102000,1275,80
"7170","25500","2014",1,1,0,1e+05,1613,62
"7171","25502","2014",3,3,0,176150,1760.33333333333,101.333333333333
"7172","25503","2014",2,2,0,133734.5,1010,144
"7173","25504","2014",1,1,0,95000,2317,41
"7174","25505","2014",9,7,2,145149.111111111,1340.33333333333,106.555555555556
"7175","25508","2014",6,4,2,143000,1313.83333333333,113
"7176","25510","2014",2,2,0,164250,1568,105
"7177","25511","2014",2,2,0,218465,1954.5,111
"7178","25512","2014",10,9,1,220914.5,2177.2,106
"7179","25515","2014",10,4,6,185783,2196,99.7
"7180","25518","2014",1,1,0,99000,1100,90
"7181","25519","2014",6,5,1,129166.666666667,1326.83333333333,95.8333333333333
"7182","25520","2014",2,2,0,98500,817,118
"7183","25521","2014",1,1,0,340000,1889,180
"7184","25523","2014",3,3,0,179583.333333333,1394.33333333333,127.333333333333
"7185","25524","2014",9,9,0,120814.444444444,1157.11111111111,100.777777777778
"7186","25526","2014",9,5,4,80377.7777777778,1147.55555555556,73.6666666666667
"7187","25527","2014",45,32,13,162244.4,1728.46666666667,96.2444444444444
"7188","25529","2014",8,4,4,88500,1027.5,86.5
"7189","25532","2014",39,24,15,181240.512820513,1867.20512820513,100.230769230769
"7190","25533","2014",1,1,0,75000,1316,57
"7191","25535","2014",1,1,0,60000,667,90
"7192","25536","2014",1,1,0,150000,1351,111
"7193","25537","2014",1,1,0,35000,479,73
"7194","25539","2014",46,29,17,127075.108695652,1441.45652173913,86.695652173913
"7195","25540","2014",2,2,0,147500,2128.5,70
"7196","25541","2014",3,1,2,153412.333333333,1156.66666666667,126.333333333333
"7197","25542","2014",4,4,0,219687.5,2638.25,86
"7198","25544","2014",1,1,0,70000,737,95
"7199","25545","2014",1,1,0,2e+05,2353,85
"7200","25547","2014",22,6,16,77463.6363636364,1209.27272727273,70.8636363636364
"7201","25548","2014",1,1,0,145000,1239,117
"7202","25549","2014",5,4,1,166480,1557.8,106.8
"7203","25550","2014",3,3,0,181100,2108.33333333333,87.3333333333333
"7204","25553","2014",2,2,0,78635,849.5,73.5
"7205","25555","2014",15,7,8,134260,1439.2,92.2666666666667
"7206","25557","2014",6,6,0,268791.666666667,2154.16666666667,127.166666666667
"7207","25558","2014",5,4,1,180000,1890.8,95
"7208","25559","2014",3,3,0,207345,1891,110.666666666667
"7209","25560","2014",22,21,1,190206.590909091,1898.95454545455,104.090909090909
"7210","25561","2014",4,3,1,146500,1807,82.25
"7211","25562","2014",2,2,0,256500,2065,121
"7212","25563","2014",1,1,0,55000,733,75
"7213","25564","2014",6,4,2,149875,1756.66666666667,87.8333333333333
"7214","25565","2014",2,2,0,274667.5,2597.5,110.5
"7215","25566","2014",3,3,0,164376.666666667,1237,141.333333333333
"7216","25569","2014",3,2,1,158666.666666667,1558.33333333333,119
"7217","25571","2014",10,5,5,142279,1506.2,98.3
"7218","25572","2014",1,1,0,61000,610,100
"7219","25573","2014",1,1,0,270000,4821,56
"7220","25574","2014",1,1,0,134200,938,143
"7221","25575","2014",5,4,1,184800,2010.4,88
"7222","25578","2014",45,17,28,141647.777777778,1762.71111111111,85
"7223","25580","2014",75,42,33,100464.066666667,1257.50666666667,83.3866666666667
"7224","25583","2014",3,3,0,124666.666666667,854.666666666667,158.333333333333
"7225","25586","2014",3,3,0,99000,1076.66666666667,99
"7226","25588","2014",2,2,0,136000,861,157.5
"7227","25589","2014",3,3,0,76666.6666666667,1001.66666666667,76.6666666666667
"7228","25591","2014",1,1,0,82000,456,180
"7229","25594","2014",1,1,0,155000,1667,93
"7230","25595","2014",1,0,1,59750,412,145
"7231","25597","2014",2,2,0,140000,1265,118.5
"7232","25598","2014",2,2,0,135000,1233,114.5
"7233","25599","2014",4,3,1,117025,1139.25,102
"7234","25600","2014",1,1,0,50000,658,76
"7235","25601","2014",11,8,3,185718.181818182,1649.27272727273,121.818181818182
"7236","25604","2014",1,1,0,105000,955,110
"7237","25608","2014",1,1,0,172250,1656,104
"7238","25609","2014",3,2,1,274466.666666667,2900.66666666667,93.6666666666667
"7239","25611","2014",1,1,0,182900,1524,120
"7240","25612","2014",7,7,0,127800,1749.71428571429,71.8571428571429
"7241","25613","2014",2,2,0,127500,1266,98.5
"7242","25614","2014",17,13,4,130632,1555.11764705882,84.3529411764706
"7243","25615","2014",4,4,0,135375,1317.75,109
"7244","25616","2014",2,2,0,58500,662.5,84.5
"7245","25617","2014",1,1,0,70000,700,100
"7246","25619","2014",4,2,2,188500,1787,106.75
"7247","25620","2014",2,2,0,2e+05,2143.5,91.5
"7248","25621","2014",1,1,0,193000,1473,131
"7249","25622","2014",1,1,0,202500,1858,109
"7250","25623","2014",2,2,0,129500,1713.5,76
"7251","25624","2014",3,3,0,113226.666666667,1083.33333333333,97
"7252","25627","2014",3,3,0,90000,1075,78
"7253","25629","2014",2,2,0,166650,1063,156
"7254","25630","2014",1,1,0,175000,1944,90
"7255","25631","2014",3,3,0,183100,1854.33333333333,101.666666666667
"7256","25632","2014",41,33,8,135366.097560976,1452.46341463415,93.4390243902439
"7257","25633","2014",7,5,2,88862.7142857143,979.285714285714,90.5714285714286
"7258","25634","2014",2,1,1,233660,2120,112
"7259","25635","2014",1,1,0,135000,1392,97
"7260","26002","2014",15,13,2,138894,1685,86.5333333333333
"7261","26004","2014",19,19,0,175115.789473684,1797.36842105263,100.736842105263
"7262","26005","2014",6,6,0,299541.666666667,2692.33333333333,118
"7263","26006","2014",25,24,1,192051.2,1837.04,105.96
"7264","26008","2014",17,12,5,151011.764705882,1695.05882352941,85.7058823529412
"7265","26009","2014",11,11,0,154314.545454545,1336.45454545455,118.363636363636
"7266","26010","2014",22,18,4,164960.909090909,1819.40909090909,90.3636363636364
"7267","26011","2014",22,20,2,169590.909090909,1755.59090909091,96.2727272727273
"7268","26014","2014",3,3,0,188533.333333333,1684.66666666667,116.333333333333
"7269","26016","2014",3,1,2,98000,1325.33333333333,84.3333333333333
"7270","26020","2014",1,1,0,175000,1786,98
"7271","26021","2014",3,3,0,272000,2101,123.666666666667
"7272","26023","2014",4,3,1,84135.5,1133.5,76.5
"7273","26024","2014",1,1,0,258000,3851,67
"7274","26028","2014",2,2,0,214210,1990,107
"7275","26031","2014",7,7,0,288386.857142857,2621.42857142857,94.5714285714286
"7276","26033","2014",6,6,0,236749.166666667,2248.83333333333,104.666666666667
"7277","26034","2014",3,3,0,158133.333333333,1786,90
"7278","26035","2014",10,9,1,149140,1590.7,98.6
"7279","26037","2014",32,29,3,208428.6875,2056.78125,103.03125
"7280","26038","2014",2,2,0,181500,1750,102
"7281","26039","2014",7,7,0,190161.142857143,1612.14285714286,116.571428571429
"7282","26040","2014",1,1,0,1e+05,1667,60
"7283","26041","2014",9,9,0,189944.444444444,1668,121.666666666667
"7284","26042","2014",20,20,0,219690.25,2168.55,100.35
"7285","26045","2014",11,9,2,318758.636363636,2756.45454545455,119.454545454545
"7286","26049","2014",3,3,0,89686.6666666667,1386,77.3333333333333
"7287","26052","2014",5,5,0,224254,1726,131.2
"7288","26054","2014",14,13,1,217717.928571429,1957.5,112.071428571429
"7289","26056","2014",8,7,1,153657.5,1590,96.25
"7290","26057","2014",82,42,40,128124.414634146,1694.78048780488,79.719512195122
"7291","26058","2014",225,102,123,143985.497777778,1800.07111111111,78.7155555555556
"7292","26059","2014",1,0,1,35000,778,45
"7293","26060","2014",1,1,0,225000,918,245
"7294","26061","2014",5,5,0,156328,1467.2,110.4
"7295","26062","2014",1,1,0,65000,2167,30
"7296","26063","2014",18,16,2,191819.444444444,2413.33333333333,87.0555555555556
"7297","26064","2014",60,52,8,211424.733333333,2311.63333333333,94.9166666666667
"7298","26065","2014",2,2,0,179000,1788,100.5
"7299","26069","2014",2,2,0,110000,1643,65
"7300","26070","2014",7,7,0,194071.428571429,1991.42857142857,99
"7301","26071","2014",3,3,0,222500,1865.66666666667,123
"7302","26072","2014",6,5,1,194234.166666667,1528.66666666667,138.166666666667
"7303","26073","2014",4,4,0,786655,4494.5,193
"7304","26074","2014",6,6,0,152610,2301.83333333333,66.3333333333333
"7305","26077","2014",10,10,0,210055,1532.7,136.6
"7306","26078","2014",7,7,0,229681,2217.14285714286,104.428571428571
"7307","26079","2014",10,10,0,170985,1661.4,107.9
"7308","26081","2014",1,1,0,186000,2044,91
"7309","26083","2014",14,13,1,204797.142857143,1835,110.357142857143
"7310","26084","2014",20,18,2,196250.55,1917.85,95.65
"7311","26085","2014",30,23,7,163366.366666667,1745,94.2333333333333
"7312","26086","2014",11,7,4,136140.909090909,1170.36363636364,118.090909090909
"7313","26087","2014",9,9,0,189443.555555556,1892.88888888889,106
"7314","26088","2014",22,21,1,210362.954545455,1941.77272727273,109.5
"7315","26092","2014",4,4,0,300437.5,1510.5,185.5
"7316","26093","2014",1,1,0,185000,1729,107
"7317","26094","2014",7,7,0,187500,1569.42857142857,122.857142857143
"7318","26095","2014",3,3,0,179500,1691.66666666667,106.333333333333
"7319","26096","2014",25,24,1,141588.4,1568.64,91.36
"7320","26097","2014",5,5,0,174850,1865.4,94.4
"7321","26098","2014",2,2,0,207625,2059,103.5
"7322","26099","2014",6,6,0,224550,1866.33333333333,120.333333333333
"7323","26100","2014",6,6,0,219366.666666667,1871.16666666667,120
"7324","26103","2014",7,7,0,161600,2730.57142857143,70.8571428571429
"7325","26106","2014",3,2,1,62666.6666666667,1496.33333333333,42.6666666666667
"7326","26107","2014",1,1,0,130000,1368,95
"7327","26108","2014",66,35,31,150981.348484848,1827.74242424242,83.7878787878788
"7328","26110","2014",4,4,0,159952.5,1806.25,80
"7329","26111","2014",2,2,0,213000,2504.5,87.5
"7330","26113","2014",28,22,6,144167.642857143,1667.07142857143,94.1785714285714
"7331","26114","2014",25,21,4,197171.36,1980.92,98.16
"7332","26115","2014",2,2,0,147650,1755,84
"7333","26116","2014",47,41,6,173077.127659574,1818.95744680851,99.7659574468085
"7334","26117","2014",1,1,0,176000,1586,111
"7335","26118","2014",12,12,0,172605.833333333,1622.5,111.166666666667
"7336","26119","2014",4,4,0,186500,1777,98
"7337","26121","2014",7,6,1,187903.571428571,1910.14285714286,99.4285714285714
"7338","26124","2014",30,24,6,191051.466666667,2126.6,93.1
"7339","26125","2014",9,9,0,253971.666666667,2163.33333333333,122.777777777778
"7340","26129","2014",14,14,0,158029.142857143,1670.28571428571,98.8571428571429
"7341","26131","2014",1,1,0,126000,1658,76
"7342","26137","2014",3,3,0,114333.333333333,1331.66666666667,85.3333333333333
"7343","26138","2014",8,8,0,224317.5,2412.75,91.25
"7344","26139","2014",10,10,0,363890,2411.4,151.9
"7345","26140","2014",10,10,0,283652.3,2213.6,126.4
"7346","26141","2014",1,1,0,159000,1060,150
"7347","26143","2014",18,17,1,134161.888888889,1370.72222222222,94.8333333333333
"7348","26144","2014",21,15,6,169008.571428571,1567.42857142857,106.714285714286
"7349","26145","2014",9,9,0,190228.888888889,1887.55555555556,98.5555555555556
"7350","26146","2014",16,15,1,275973.75,2349.8125,120.625
"7351","26148","2014",10,10,0,174757,1411.8,134
"7352","26149","2014",7,6,1,178650,1683.42857142857,114
"7353","26155","2014",8,6,2,162000,1798,88.75
"7354","26156","2014",4,4,0,125825,1674.75,69.5
"7355","26157","2014",6,6,0,222516.666666667,2157.16666666667,100.666666666667
"7356","26159","2014",1,1,0,199770,2350,85
"7357","26160","2014",4,4,0,169437.5,1891.25,90
"7358","26162","2014",4,4,0,80937.5,1113,78.25
"7359","26165","2014",89,66,23,152271.561797753,1698.59550561798,90.3707865168539
"7360","26166","2014",62,53,9,146869.629032258,1545.33870967742,94.1612903225806
"7361","26167","2014",6,5,1,137083.333333333,1340.5,93.5
"7362","26168","2014",8,6,2,108421.375,1285.625,86.5
"7363","26169","2014",11,11,0,202184.545454545,1801.63636363636,111.363636363636
"7364","26170","2014",16,10,6,191249.0625,1873.25,100.25
"7365","26171","2014",2,2,0,480000,2212.5,195.5
"7366","26172","2014",4,4,0,257002.5,1567.5,166.25
"7367","26173","2014",7,7,0,250214.285714286,1808.28571428571,139.571428571429
"7368","26174","2014",7,7,0,230025.714285714,2031.42857142857,111.714285714286
"7369","26176","2014",13,12,1,225516.615384615,2471.30769230769,106.076923076923
"7370","26177","2014",5,5,0,160196,1626.2,104.2
"7371","26179","2014",17,16,1,232707.529411765,2282.70588235294,120.470588235294
"7372","26180","2014",1,1,0,360000,3564,101
"7373","26181","2014",1,1,0,55000,917,60
"7374","26182","2014",19,18,1,230799.473684211,2292.84210526316,102.631578947368
"7375","26183","2014",11,11,0,199873.181818182,1998.27272727273,102.090909090909
"7376","26185","2014",5,5,0,297906.2,2423.8,124.6
"7377","26188","2014",24,19,5,275931.041666667,2572.33333333333,100.458333333333
"7378","26191","2014",24,21,3,211503.958333333,2370.95833333333,90.625
"7379","26193","2014",3,3,0,199980,2953,76.6666666666667
"7380","26194","2014",3,3,0,198500,1730.33333333333,121
"7381","26195","2014",2,2,0,118750,2264,51.5
"7382","26196","2014",8,8,0,202131.25,2437.625,87.125
"7383","26197","2014",42,30,12,217037.642857143,3093.57142857143,94.8809523809524
"7384","26198","2014",430,210,220,163045.244186047,1887.45581395349,85.5860465116279
"7385","26200","2014",2,2,0,95000,1225.5,79.5
"7386","26202","2014",3,3,0,153333.333333333,1714.66666666667,98
"7387","26203","2014",6,6,0,137133.333333333,1412.66666666667,105.5
"7388","26204","2014",1,1,0,120000,1081,111
"7389","26206","2014",22,18,4,238414.545454545,2154.90909090909,113.863636363636
"7390","26207","2014",3,3,0,88333.3333333333,1217.66666666667,73.3333333333333
"7391","26208","2014",16,16,0,199212.5,2027.8125,98.3125
"7392","26210","2014",3,3,0,155000,1667,102
"7393","26211","2014",17,15,2,213416.470588235,1924.11764705882,111.470588235294
"7394","26212","2014",3,3,0,220666.666666667,1704,130.333333333333
"7395","26213","2014",3,3,0,142116.666666667,1167,122
"7396","26214","2014",1,1,0,120000,960,125
"7397","26215","2014",7,7,0,86642.8571428571,1077,82.4285714285714
"7398","26216","2014",9,9,0,142934.444444444,1458.11111111111,97.8888888888889
"7399","26217","2014",1,1,0,242000,2521,96
"7400","26218","2014",18,18,0,218548.888888889,1818.94444444444,120.777777777778
"7401","26220","2014",81,38,43,171063.777777778,2094.53086419753,80.7407407407407
"7402","26224","2014",1,1,0,230000,1797,128
"7403","26225","2014",7,7,0,200235.714285714,1879.14285714286,105.428571428571
"7404","26226","2014",5,5,0,216300,1853.2,113.2
"7405","26231","2014",17,16,1,195680.588235294,1985,101.352941176471
"7406","26232","2014",10,10,0,179590,1989.4,92
"7407","26233","2014",1,1,0,180000,3462,52
"7408","26234","2014",4,3,1,148175,1860.25,95
"7409","26235","2014",98,61,37,150461.06122449,1743.59183673469,86.0918367346939
"7410","26236","2014",2,2,0,75250,1649,45.5
"7411","26239","2014",2,2,0,135000,1837,74.5
"7412","26240","2014",2,2,0,124500,1440,85
"7413","26241","2014",1,1,0,420000,1050,400
"7414","26243","2014",11,11,0,318929.818181818,2688.27272727273,120.727272727273
"7415","26247","2014",1,1,0,325000,2006,162
"7416","26248","2014",2,2,0,172500,2045.5,77
"7417","26249","2014",6,6,0,149040,1656.33333333333,90.5
"7418","26250","2014",26,25,1,182466.846153846,1945.46153846154,95.3461538461538
"7419","26251","2014",1,1,0,289260,3013,96
"7420","26252","2014",85,42,43,152097.776470588,1874.52941176471,81.4941176470588
"7421","26257","2014",3,3,0,263076.666666667,2048,128.666666666667
"7422","26258","2014",8,8,0,184229.875,1711.875,104.125
"7423","26259","2014",2,2,0,225650,1675,142
"7424","26261","2014",5,5,0,425780,4251,124.4
"7425","26264","2014",3,2,1,127168.333333333,1243.66666666667,106.333333333333
"7426","26268","2014",3,3,0,238701.666666667,4642.33333333333,48
"7427","26271","2014",39,33,6,200622.051282051,1910.4358974359,105.25641025641
"7428","26272","2014",1,1,0,125000,1623,77
"7429","26273","2014",5,5,0,225648,2122.6,105.2
"7430","26275","2014",9,9,0,295177.333333333,2894.22222222222,104
"7431","26276","2014",4,4,0,219000,2414,85.75
"7432","26278","2014",1,1,0,257000,3134,82
"7433","26281","2014",367,143,224,122597.174386921,1534.9591280654,79.0381471389646
"7434","26284","2014",4,4,0,264875,2294,117.25
"7435","26285","2014",1,1,0,165000,1031,160
"7436","26287","2014",1,1,0,224492,2138,105
"7437","26288","2014",2,2,0,199955,1553.5,133.5
"7438","26289","2014",11,8,3,157286.363636364,2048,80.4545454545455
"7439","26290","2014",22,12,10,97663.9545454545,1504.5,68.0454545454545
"7440","26294","2014",3,3,0,210133.333333333,1607.66666666667,127.333333333333
"7441","26295","2014",14,13,1,155983.928571429,1712.28571428571,93.6428571428571
"7442","26298","2014",3,3,0,196116.666666667,1456,140
"7443","26301","2014",38,21,17,156108.605263158,1820.92105263158,88.3947368421053
"7444","26302","2014",6,6,0,131493.333333333,1402.16666666667,94
"7445","26303","2014",2,2,0,159250,1977,92
"7446","26305","2014",10,7,3,136520,1449.3,94.9
"7447","26306","2014",3,3,0,132366.666666667,1204.33333333333,106.666666666667
"7448","26307","2014",13,10,3,147090.769230769,1777.23076923077,80.5384615384615
"7449","26308","2014",1,1,0,95000,1118,85
"7450","26309","2014",4,3,1,197500,1974,115.25
"7451","26310","2014",1,1,0,204850,1781,115
"7452","26311","2014",6,6,0,113583.333333333,1565.16666666667,72
"7453","26312","2014",8,6,2,232971.25,2308,106.125
"7454","26313","2014",36,31,5,217980.277777778,2117.5,104.472222222222
"7455","26315","2014",3,3,0,106833.333333333,1182,103.333333333333
"7456","26316","2014",3,3,0,144666.666666667,1680,84
"7457","26317","2014",9,8,1,131722.222222222,1946.22222222222,74.7777777777778
"7458","26319","2014",6,6,0,193302,1771.66666666667,113.333333333333
"7459","26320","2014",7,6,1,124621.428571429,1364.71428571429,85.8571428571429
"7460","26322","2014",4,3,1,164133.75,2183.25,71.25
"7461","26323","2014",10,10,0,211115.5,1979.1,105
"7462","26324","2014",79,53,26,182484.227848101,2032.54430379747,89.7721518987342
"7463","26325","2014",44,29,15,132461.363636364,1524.34090909091,87.3409090909091
"7464","26326","2014",11,10,1,314936.363636364,2494.81818181818,124.818181818182
"7465","26327","2014",3,3,0,185000,2228.33333333333,85.3333333333333
"7466","26328","2014",1,1,0,267000,1894,141
"7467","26330","2014",12,11,1,121450.833333333,1257.16666666667,105.833333333333
"7468","26331","2014",2,2,0,148500,1581,100
"7469","26332","2014",22,20,2,131161.545454545,1533.09090909091,91.5909090909091
"7470","26333","2014",40,10,30,78341.6,1114.35,75.425
"7471","26334","2014",1,1,0,260000,4333,60
"7472","26336","2014",4,4,0,207575,2095.25,100.25
"7473","26337","2014",14,11,3,150526.428571429,1636.92857142857,93.5
"7474","26338","2014",12,12,0,249324.166666667,2463.08333333333,99.75
"7475","26339","2014",9,9,0,318405.555555556,2584.33333333333,129.777777777778
"7476","26340","2014",3,2,1,79333.3333333333,1145.66666666667,69
"7477","26341","2014",6,5,1,159683.333333333,1570.66666666667,103.166666666667
"7478","26342","2014",2,2,0,95562.5,1592.5,60
"7479","26343","2014",1,1,0,168000,1527,110
"7480","26344","2014",1,1,0,269000,1121,240
"7481","26345","2014",11,11,0,220231.818181818,1812.63636363636,122.636363636364
"7482","26346","2014",2,2,0,210000,2146,100
"7483","26347","2014",59,27,32,154735.576271186,1951.71186440678,83.4576271186441
"7484","26348","2014",18,16,2,190474.722222222,1987.05555555556,98.9444444444444
"7485","26349","2014",4,4,0,128125,1515.25,83.75
"7486","26350","2014",3,3,0,195880,2374.33333333333,88.3333333333333
"7487","26352","2014",2,2,0,289375,2685,106
"7488","26353","2014",9,6,3,129514.444444444,1502.22222222222,85.3333333333333
"7489","26355","2014",2,2,0,216489,1949,111.5
"7490","26356","2014",2,2,0,382500,2231.5,183.5
"7491","26357","2014",11,7,4,156403.181818182,1595.54545454545,95.7272727272727
"7492","26358","2014",18,18,0,263286.666666667,2173.55555555556,136.5
"7493","26360","2014",8,8,0,609890.625,4070.375,127.5
"7494","26362","2014",771,170,601,127223.677042802,1774.69001297017,71.2879377431907
"7495","26364","2014",5,5,0,171892.6,1930.4,99.4
"7496","26365","2014",5,5,0,123330,1364,90.6
"7497","26367","2014",5,5,0,279040,2934,91.8
"7498","26368","2014",4,4,0,169749,2280.75,77.25
"7499","26373","2014",3,3,0,117000,1402.33333333333,74.6666666666667
"7500","26374","2014",1,1,0,174500,2077,84
"7501","26376","2014",2,2,0,170050,3418.5,61
"7502","26377","2014",10,9,1,167350,1774.3,96
"7503","26379","2014",6,4,2,218282.5,2026.83333333333,108.166666666667
"7504","26380","2014",3,3,0,116233.333333333,1140,100.666666666667
"7505","26381","2014",4,4,0,200675,1981.25,106
"7506","26382","2014",6,6,0,208364,1873.33333333333,113.833333333333
"7507","27001","2014",2,2,0,167500,1492.5,138.5
"7508","27002","2014",6,6,0,118666.666666667,1658.66666666667,76.6666666666667
"7509","27003","2014",7,7,0,163939.857142857,1525.42857142857,108.571428571429
"7510","27004","2014",3,3,0,250733.333333333,1948,133
"7511","27005","2014",11,11,0,164618.181818182,1583,117.181818181818
"7512","27006","2014",1,1,0,167000,1856,90
"7513","27008","2014",13,13,0,151181.538461538,1739.38461538462,93.7692307692308
"7514","27009","2014",1,1,0,103000,1256,82
"7515","27010","2014",1,1,0,41000,1464,28
"7516","27011","2014",12,12,0,149183.333333333,1443.41666666667,110.083333333333
"7517","27012","2014",2,2,0,144000,1750,81.5
"7518","27014","2014",9,9,0,191791.777777778,1808,112.444444444444
"7519","27015","2014",13,13,0,162679.230769231,1955.76923076923,81.2307692307692
"7520","27016","2014",48,44,4,147526.25,1713.0625,92.5833333333333
"7521","27017","2014",10,10,0,173100,1695.5,103.1
"7522","27019","2014",2,2,0,110000,1614.5,68
"7523","27020","2014",13,13,0,153738.461538462,1712.23076923077,90.3076923076923
"7524","27022","2014",30,30,0,149784.6,1649.33333333333,96.2333333333333
"7525","27023","2014",2,2,0,92000,1396,66
"7526","27025","2014",10,9,1,179970,1706.4,112
"7527","27026","2014",8,8,0,193625,2070.375,94.125
"7528","27027","2014",2,2,0,167500,1856.5,91
"7529","27031","2014",4,4,0,204450,1750.5,112.75
"7530","27032","2014",7,7,0,144371.428571429,1890.28571428571,81.5714285714286
"7531","27033","2014",2,2,0,79000,1118.5,60
"7532","27034","2014",4,4,0,165500,1437,118.25
"7533","27036","2014",2,2,0,209500,1651.5,131
"7534","27037","2014",8,8,0,143900,1388,109.625
"7535","27038","2014",3,3,0,123116.666666667,1711,73.3333333333333
"7536","27039","2014",6,6,0,178766.666666667,1693.66666666667,112.833333333333
"7537","27043","2014",9,9,0,146222.222222222,1875.55555555556,83.8888888888889
"7538","27044","2014",1,1,0,143000,3250,44
"7539","27045","2014",4,4,0,212750,1874.75,116.25
"7540","27047","2014",2,2,0,229000,1978,117
"7541","27048","2014",1,1,0,52850,755,70
"7542","27049","2014",56,56,0,127547.321428571,1372.26785714286,98.2142857142857
"7543","27052","2014",3,3,0,179500,1344.33333333333,126.666666666667
"7544","27053","2014",2,2,0,257500,1262.5,210
"7545","27054","2014",5,5,0,137950,1375.2,103.8
"7546","27055","2014",3,3,0,182753.666666667,1953,101.333333333333
"7547","27056","2014",112,85,27,143732.5625,1563.08928571429,91.3035714285714
"7548","27057","2014",4,4,0,148000,1434.5,119.75
"7549","27058","2014",10,10,0,239980,2191.9,121
"7550","27059","2014",1,1,0,138000,1971,70
"7551","27061","2014",4,4,0,134500,1965.5,68.75
"7552","27062","2014",24,24,0,168388.291666667,1615.33333333333,106.25
"7553","27064","2014",6,6,0,134233.333333333,1367.5,104.166666666667
"7554","27065","2014",49,45,4,157143.469387755,1659.69387755102,95.0816326530612
"7555","27066","2014",2,2,0,131439,1663.5,79
"7556","27067","2014",14,14,0,171228.571428571,2097.5,92.3571428571429
"7557","27068","2014",4,4,0,95675,1420.5,66.5
"7558","27069","2014",7,7,0,98285.7142857143,1270.42857142857,75
"7559","27070","2014",15,15,0,161970,1632.86666666667,103.066666666667
"7560","27072","2014",5,5,0,136900,1592,90.4
"7561","27073","2014",11,11,0,185477.272727273,1859.54545454545,113.363636363636
"7562","27074","2014",2,2,0,181000,1863.5,100
"7563","27075","2014",6,6,0,121500,1209.5,116.166666666667
"7564","27076","2014",3,3,0,268000,2485.33333333333,104.333333333333
"7565","27077","2014",6,6,0,134983.333333333,1741.33333333333,78.3333333333333
"7566","27078","2014",2,2,0,187500,1722.5,110
"7567","27079","2014",5,5,0,91600,1129.6,80.4
"7568","27081","2014",2,2,0,366500,2640,136
"7569","27082","2014",18,18,0,122000,1765.72222222222,78.2222222222222
"7570","27085","2014",14,14,0,153611.428571429,1720.64285714286,96
"7571","27089","2014",13,13,0,171100,1756.69230769231,110.384615384615
"7572","27090","2014",27,27,0,180878.074074074,1785.66666666667,106.111111111111
"7573","27091","2014",7,7,0,165468.571428571,1666.28571428571,100.142857142857
"7574","27094","2014",1,1,0,295000,1639,180
"7575","27095","2014",4,4,0,96875,1427.5,72.25
"7576","27096","2014",6,6,0,106833.333333333,1447.16666666667,79.5
"7577","27097","2014",5,5,0,165280,1657.8,115.6
"7578","27099","2014",4,4,0,169500,1640.25,104.25
"7579","27100","2014",9,8,1,149811.111111111,1585.44444444444,95
"7580","27101","2014",7,7,0,129400,1366.71428571429,96.1428571428571
"7581","27102","2014",6,6,0,145500,1611,92.5
"7582","27103","2014",23,21,2,177038.130434783,1856.86956521739,97.5217391304348
"7583","27104","2014",3,3,0,143500,1351.66666666667,113.666666666667
"7584","27105","2014",40,35,5,159873,1904.85,90.775
"7585","27107","2014",9,9,0,186649.444444444,1864.66666666667,112.777777777778
"7586","27108","2014",7,7,0,104000,1168.42857142857,94.2857142857143
"7587","27109","2014",2,2,0,110250,1720,63.5
"7588","27110","2014",7,7,0,163328.571428571,1533.42857142857,102.857142857143
"7589","27111","2014",2,2,0,150750,1364,114.5
"7590","27112","2014",39,39,0,123078.025641026,1648.30769230769,74.1538461538462
"7591","27113","2014",1,1,0,15000,341,44
"7592","27114","2014",15,15,0,177741.2,1857.26666666667,102.6
"7593","27115","2014",6,6,0,101816.666666667,1178.83333333333,99.8333333333333
"7594","27116","2014",42,40,2,106243.571428571,1219.88095238095,90.5
"7595","27117","2014",15,15,0,128119.333333333,1366.53333333333,87.0666666666667
"7596","27118","2014",5,5,0,152248,1658.6,90
"7597","27119","2014",17,17,0,203035.294117647,2222.88235294118,98.6470588235294
"7598","27120","2014",4,4,0,165500,1416.5,119.25
"7599","27123","2014",5,5,0,166990,2016,85.2
"7600","27124","2014",2,2,0,191000,1127,166.5
"7601","27125","2014",4,4,0,140737.5,1275.75,117.75
"7602","27126","2014",14,14,0,142375.357142857,1497.92857142857,98.1428571428571
"7603","27127","2014",5,5,0,152280,1650,94.2
"7604","27129","2014",2,2,0,147500,1724,89.5
"7605","27130","2014",3,3,0,123166.666666667,1901.66666666667,69
"7606","27132","2014",10,10,0,178490,1691.6,117.5
"7607","27133","2014",8,8,0,206737.5,2222.75,109
"7608","27134","2014",3,3,0,132516.666666667,1487,88.3333333333333
"7609","27135","2014",3,3,0,165333.333333333,1507.66666666667,118
"7610","27136","2014",1,1,0,140000,1273,110
"7611","27137","2014",2,2,0,102000,922.5,110.5
"7612","27138","2014",4,4,0,81500.25,950.25,82.5
"7613","27139","2014",3,3,0,145000,1259,111.333333333333
"7614","27140","2014",4,4,0,165744.25,1641.5,109.25
"7615","27141","2014",2,2,0,173000,1396.5,124.5
"7616","27142","2014",1,1,0,125000,3289,38
"7617","27144","2014",1,1,0,2e+05,1325,151
"7618","27147","2014",2,2,0,145000,1412,102
"7619","27148","2014",3,3,0,91000,860.333333333333,107
"7620","27151","2014",13,13,0,147923.076923077,1473.61538461538,102.384615384615
"7621","27152","2014",8,8,0,173000,2166.375,82.75
"7622","27153","2014",4,4,0,186462.5,1704.75,109.5
"7623","27154","2014",6,6,0,161750,1543.5,105.666666666667
"7624","27155","2014",4,4,0,121000,1868.75,62.75
"7625","27156","2014",5,5,0,127430,1422.6,94
"7626","27157","2014",12,12,0,124208.333333333,1351.08333333333,97.3333333333333
"7627","27158","2014",5,5,0,235400,1870.6,123.6
"7628","27161","2014",10,10,0,137230,1427.4,95.9
"7629","27162","2014",2,2,0,109850,1575,71
"7630","27163","2014",1,1,0,85500,1527,56
"7631","27165","2014",44,37,7,131822.5,1647.20454545455,81.9772727272727
"7632","27168","2014",3,3,0,121900,941.333333333333,129.333333333333
"7633","27169","2014",11,11,0,129454.545454545,1620.27272727273,76.7272727272727
"7634","27171","2014",7,7,0,187528.571428571,1921.85714285714,105.142857142857
"7635","27174","2014",14,14,0,120406.857142857,1418.57142857143,84.4285714285714
"7636","27177","2014",5,5,0,185002,1472.8,133.4
"7637","27179","2014",5,5,0,149200,1687.2,90.8
"7638","27180","2014",11,10,1,180072.727272727,1803.09090909091,101.545454545455
"7639","27182","2014",2,2,0,114000,997,127.5
"7640","27183","2014",26,24,2,174657.692307692,1966.03846153846,95.6153846153846
"7641","27184","2014",1,1,0,193000,2053,94
"7642","27185","2014",1,1,0,185000,1832,101
"7643","27187","2014",3,3,0,176000,1882,93.6666666666667
"7644","27188","2014",18,18,0,173500,2053.11111111111,87
"7645","27189","2014",1,1,0,157000,1635,96
"7646","27190","2014",1,1,0,220000,2444,90
"7647","27191","2014",28,28,0,171291.678571429,1734.21428571429,101.678571428571
"7648","27192","2014",2,2,0,157900,1876.5,86.5
"7649","27193","2014",11,11,0,129861.363636364,1758.27272727273,73.9090909090909
"7650","27194","2014",2,2,0,73500,1469.5,50.5
"7651","27196","2014",12,12,0,176284.166666667,1972,91
"7652","27198","2014",46,44,2,133249.52173913,1508.0652173913,95.0652173913043
"7653","27199","2014",8,8,0,163040.625,2040.5,82.5
"7654","27201","2014",3,3,0,112000,1316.33333333333,94
"7655","27202","2014",3,3,0,160000,1929,82.3333333333333
"7656","27203","2014",3,3,0,212416.666666667,1891.33333333333,114
"7657","27204","2014",1,1,0,140000,3333,42
"7658","27205","2014",2,2,0,87500,950,92
"7659","27207","2014",4,4,0,113500,1295.5,84.5
"7660","27209","2014",6,6,0,157828,1729.16666666667,92.5
"7661","27210","2014",4,4,0,146007.5,1784,83
"7662","27212","2014",2,2,0,214500,1366.5,168
"7663","27213","2014",54,51,3,175140.740740741,1965.46296296296,95.5555555555556
"7664","27214","2014",13,13,0,98984.6153846154,1234.23076923077,83.8461538461538
"7665","27215","2014",4,4,0,158775,1757.5,99.5
"7666","27216","2014",4,4,0,161750,1403.25,105.5
"7667","27217","2014",5,5,0,120200,1239.4,99.4
"7668","27219","2014",3,3,0,128333.333333333,1679,76
"7669","27220","2014",5,5,0,177800,1820.6,101.4
"7670","27222","2014",3,3,0,209000,1642,132.333333333333
"7671","27224","2014",2,2,0,186250,1384.5,129
"7672","27226","2014",38,35,3,141259.210526316,1740.76315789474,86.4210526315789
"7673","27227","2014",6,6,0,129191.666666667,1556.16666666667,87.8333333333333
"7674","27228","2014",2,2,0,101000,1295.5,78.5
"7675","27229","2014",431,185,246,127915.183294664,1754.60556844548,73.8886310904872
"7676","27230","2014",54,46,8,140494.148148148,1870.64814814815,79.4259259259259
"7677","27231","2014",4,4,0,175250,1942,91.5
"7678","27232","2014",13,13,0,149863.076923077,1537.38461538462,101.384615384615
"7679","27233","2014",7,7,0,179071.428571429,2078.28571428571,89.7142857142857
"7680","27234","2014",3,3,0,152666.666666667,2503.66666666667,66.3333333333333
"7681","27238","2014",9,9,0,151936.111111111,1497.44444444444,104.888888888889
"7682","27240","2014",4,4,0,128750,1851,69.5
"7683","27241","2014",1,1,0,124750,1040,120
"7684","27242","2014",8,8,0,128375,1647.875,81.875
"7685","27243","2014",2,2,0,150350,1484,112
"7686","27245","2014",6,6,0,122012.5,1285.66666666667,103.833333333333
"7687","27246","2014",11,11,0,124554.545454545,1610.27272727273,80.8181818181818
"7688","27247","2014",2,2,0,113400,1672.5,68.5
"7689","27249","2014",4,4,0,199075,1684,137.25
"7690","27254","2014",12,12,0,266941.666666667,1943.91666666667,138.333333333333
"7691","27256","2014",2,2,0,152500,1749,87
"7692","27258","2014",8,8,0,140344.125,1427.75,97
"7693","27259","2014",1,1,0,135000,2700,50
"7694","27260","2014",4,4,0,167250,1662.75,108.5
"7695","27261","2014",2,2,0,155000,2011,80
"7696","27263","2014",13,13,0,149761.538461538,1571.30769230769,110.615384615385
"7697","27266","2014",2,2,0,137500,1353,98.5
"7698","27267","2014",1,1,0,120000,1714,70
"7699","27269","2014",1,1,0,177000,1967,90
"7700","27273","2014",4,4,0,217625,1898,117.25
"7701","27275","2014",68,30,38,116686.176470588,1557.32352941176,75.5441176470588
"7702","27277","2014",7,7,0,188571.428571429,1790.85714285714,107.571428571429
"7703","27278","2014",20,20,0,166610,1937.05,89.65
"7704","27279","2014",24,21,3,161442.916666667,2026,82.2083333333333
"7705","27280","2014",5,5,0,193520,2260.6,91.6
"7706","27281","2014",4,4,0,186875,1975.5,106.5
"7707","27282","2014",1,1,0,172000,1720,100
"7708","27284","2014",84,57,27,160705.595238095,2063.72619047619,82.2857142857143
"7709","27285","2014",1,1,0,205000,1798,114
"7710","27287","2014",6,6,0,192933.333333333,2389.66666666667,80.5
"7711","27289","2014",1,1,0,181000,1508,120
"7712","27290","2014",17,17,0,145674.882352941,1406.41176470588,103.176470588235
"7713","27291","2014",1,1,0,202000,1443,140
"7714","27294","2014",12,12,0,188150,1683.5,116.833333333333
"7715","27298","2014",1,1,0,1e+05,1515,66
"7716","27299","2014",45,28,17,124610,1818.88888888889,67.7777777777778
"7717","27301","2014",8,8,0,159870.75,1505.125,106.25
"7718","27302","2014",12,12,0,141147.833333333,1355.5,109.333333333333
"7719","27306","2014",9,9,0,227816.666666667,2589,99.4444444444444
"7720","27307","2014",6,6,0,124575,1238,108.5
"7721","27309","2014",4,4,0,240250,2004.5,125
"7722","27310","2014",2,2,0,143250,1333.5,112
"7723","27311","2014",6,6,0,146500,1214.16666666667,128.166666666667
"7724","27312","2014",4,4,0,188412.5,1435.75,142.5
"7725","27313","2014",5,5,0,151660,1572.2,103.4
"7726","27315","2014",3,3,0,145416.666666667,1581.66666666667,97.3333333333333
"7727","27316","2014",11,11,0,157520.909090909,1589.18181818182,99.3636363636364
"7728","27317","2014",5,5,0,154652,1778,101
"7729","27318","2014",1,1,0,96000,2182,44
"7730","27319","2014",1,1,0,22000,1833,12
"7731","27320","2014",1,1,0,180500,1543,117
"7732","27322","2014",11,11,0,150440.909090909,1812.18181818182,87.3636363636364
"7733","27323","2014",3,3,0,111000,1491.33333333333,74.6666666666667
"7734","27324","2014",3,3,0,238849.333333333,1710.33333333333,158.333333333333
"7735","27325","2014",2,2,0,120000,1028.5,114.5
"7736","27326","2014",2,2,0,100150,1257.5,92.5
"7737","27327","2014",1,1,0,104000,1529,68
"7738","27329","2014",8,8,0,160100,1737.375,98.375
"7739","27330","2014",3,3,0,515150,3661.33333333333,135
"7740","27331","2014",4,4,0,172875,1797.5,92
"7741","27332","2014",1,1,0,330500,2066,160
"7742","27333","2014",4,4,0,128625,1499.75,90.25
"7743","27335","2014",7,7,0,149257.142857143,1526.57142857143,97
"7744","27336","2014",1,1,0,550000,6875,80
"7745","27337","2014",2,2,0,142450,1475.5,98
"7746","27338","2014",4,4,0,118000,1400,85.25
"7747","27339","2014",5,5,0,158800,1856.2,90.6
"7748","27340","2014",6,6,0,179666.666666667,1928.66666666667,93.1666666666667
"7749","27341","2014",1,1,0,132000,1200,110
"7750","27342","2014",5,5,0,129020,1392.6,98.8
"7751","27343","2014",13,13,0,245993.846153846,1975.38461538462,127.769230769231
"7752","27346","2014",6,6,0,116583.333333333,1470.5,80.5
"7753","27347","2014",8,8,0,209700,1927.5,113
"7754","27348","2014",8,8,0,150212.5,2104.5,76.375
"7755","27349","2014",15,15,0,173494.666666667,1460.66666666667,120
"7756","27351","2014",10,9,1,143630,1664,90
"7757","27353","2014",3,3,0,222333.333333333,1874,119.333333333333
"7758","27354","2014",1,1,0,145000,1835,79
"7759","27355","2014",35,29,6,158954.285714286,2104.82857142857,82.3142857142857
"7760","27358","2014",6,6,0,206066.666666667,2076.16666666667,101.333333333333
"7761","27360","2014",2,2,0,110833,1483.5,78
"7762","27361","2014",3,3,0,154333.333333333,1776.66666666667,88
"7763","27363","2014",2,2,0,155100,1016,145.5
"7764","27365","2014",18,16,2,146448.5,1553.72222222222,94.6111111111111
"7765","27366","2014",3,3,0,143500,1518.66666666667,95
"7766","27367","2014",13,13,0,139792.307692308,1443.53846153846,100.538461538462
"7767","27368","2014",5,5,0,106040,1607.6,64.4
"7768","27369","2014",1,1,0,79000,1129,70
"7769","27370","2014",4,4,0,96250,1254,79.5
"7770","27372","2014",7,7,0,136857.142857143,1952.85714285714,71.8571428571429
"7771","27374","2014",4,4,0,146250,1884.75,83.5
"7772","27375","2014",128,96,32,148584.7890625,1805.578125,86.6875
"7773","27376","2014",2,2,0,73000,1526,48.5
"7774","27377","2014",8,8,0,191375,2041,88.5
"7775","27378","2014",11,11,0,157990.909090909,1435.72727272727,111.818181818182
"7776","27379","2014",2,2,0,156875,1747,97
"7777","27380","2014",2,2,0,138250,1457.5,97
"7778","27381","2014",4,4,0,127500,1506,85.5
"7779","27382","2014",1,1,0,235000,1780,132
"7780","27383","2014",5,5,0,104300,995.4,101.2
"7781","27384","2014",4,4,0,113625,1514.25,90
"7782","27385","2014",17,13,4,116818.823529412,1365.17647058824,82.8235294117647
"7783","27386","2014",10,10,0,137200,1787.6,76.8
"7784","27388","2014",9,9,0,95388.8888888889,1173.11111111111,84.2222222222222
"7785","27391","2014",13,13,0,241884.615384615,2135.69230769231,113
"7786","27393","2014",6,6,0,127000,1453.33333333333,93.5
"7787","27394","2014",1,1,0,270000,2195,123
"7788","27395","2014",2,2,0,88762.5,912.5,98
"7789","27396","2014",5,5,0,150400,1525.8,106.4
"7790","27397","2014",9,9,0,165888.888888889,1798.33333333333,88.6666666666667
"7791","27398","2014",14,14,0,150339.285714286,1507.57142857143,107.857142857143
"7792","27399","2014",1,1,0,177000,1967,90
"7793","27400","2014",4,4,0,155477.25,2179,80
"7794","27401","2014",1,1,0,215000,1807,119
"7795","27404","2014",1,1,0,63000,643,98
"7796","27405","2014",3,3,0,93683.3333333333,2058.66666666667,55.3333333333333
"7797","27406","2014",14,14,0,137392.857142857,1647.07142857143,86.7857142857143
"7798","27407","2014",4,4,0,139750,1664,82.25
"7799","27408","2014",3,3,0,194000,2127.66666666667,97.6666666666667
"7800","27410","2014",5,5,0,203560,2028,101.8
"7801","27412","2014",9,9,0,158085.444444444,1771.55555555556,92.4444444444444
"7802","27414","2014",9,9,0,129000,1093,125.777777777778
"7803","27417","2014",9,9,0,150333.333333333,1623.77777777778,93.5555555555556
"7804","27418","2014",1,1,0,2e+05,1600,125
"7805","27419","2014",6,6,0,187075,1779.33333333333,114.5
"7806","27421","2014",7,7,0,161188.571428571,1574.28571428571,107.714285714286
"7807","27422","2014",5,5,0,125100,1439.8,85.6
"7808","27424","2014",2,2,0,147500,1237.5,122
"7809","27425","2014",17,17,0,132664.705882353,1349.23529411765,97.8823529411765
"7810","27426","2014",13,13,0,200708.461538462,2062.46153846154,100.461538461538
"7811","27427","2014",6,5,1,99833.3333333333,1204.66666666667,83.8333333333333
"7812","27428","2014",42,33,9,133684.285714286,1786.04761904762,78.3095238095238
"7813","27429","2014",1,1,0,250000,1553,161
"7814","27430","2014",5,5,0,153860,1915,84.8
"7815","27431","2014",8,5,3,84625,1296.375,69.75
"7816","27432","2014",4,4,0,135250,1525.25,89.25
"7817","27433","2014",2,2,0,190000,2287,82
"7818","27436","2014",2,2,0,137000,1389,103.5
"7819","27437","2014",1,1,0,190000,1900,100
"7820","27438","2014",7,6,1,110100,1703.28571428571,67.1428571428571
"7821","27439","2014",12,12,0,186641.666666667,1881.25,104.583333333333
"7822","27440","2014",5,5,0,232400,1731.4,127.6
"7823","27441","2014",1,1,0,160000,1584,101
"7824","27442","2014",4,4,0,145650,1429,85.75
"7825","27444","2014",2,2,0,96500,1024.5,96.5
"7826","27445","2014",1,1,0,158900,1709,93
"7827","27446","2014",3,3,0,126166.666666667,1456.66666666667,87.6666666666667
"7828","27447","2014",6,6,0,150566.666666667,1511.83333333333,104.166666666667
"7829","27448","2014",46,39,7,164504.347826087,2134.63043478261,80.2391304347826
"7830","27451","2014",1,1,0,167500,1841,91
"7831","27453","2014",16,16,0,107687.5,1377.9375,76.8125
"7832","27454","2014",8,8,0,150000,1694.625,94.5
"7833","27456","2014",6,6,0,157266.666666667,1716.83333333333,96.6666666666667
"7834","27457","2014",3,3,0,211150,1234,186
"7835","27458","2014",20,20,0,152347,1657.85,93.5
"7836","27460","2014",1,1,0,750000,4412,170
"7837","27463","2014",4,4,0,129887.5,1079.25,119
"7838","27464","2014",8,8,0,157696.25,1843.375,90.25
"7839","27465","2014",11,11,0,204413.090909091,1931.81818181818,105.818181818182
"7840","27467","2014",91,68,23,125640.67032967,1653.6043956044,81.0769230769231
"7841","27468","2014",6,6,0,141116.666666667,1368.83333333333,107
"7842","27469","2014",23,23,0,184909.347826087,1921.65217391304,97.5217391304348
"7843","27470","2014",4,4,0,172750,1713.75,110
"7844","27471","2014",1,1,0,382000,1675,228
"7845","27473","2014",11,11,0,184062.272727273,1763.90909090909,109.545454545455
"7846","27474","2014",10,10,0,196165,1964.6,107.2
"7847","27476","2014",7,7,0,181828.571428571,1273.57142857143,119.857142857143
"7848","27477","2014",6,6,0,197300,2348.5,87.1666666666667
"7849","27478","2014",7,7,0,152385.714285714,1550.28571428571,106.714285714286
"7850","27480","2014",8,8,0,145243.75,1477.625,101.5
"7851","27481","2014",2,2,0,156250,1258.5,112.5
"7852","27482","2014",1,1,0,140000,1556,90
"7853","27483","2014",5,5,0,101064,1583.2,66
"7854","27485","2014",10,10,0,113570,1221.8,89.5
"7855","27486","2014",10,10,0,143820.5,1788.3,85.3
"7856","27487","2014",8,8,0,113875,1432.5,82.75
"7857","27488","2014",1,1,0,125000,1250,100
"7858","27489","2014",1,1,0,225000,2027,111
"7859","27490","2014",1,1,0,170000,2024,84
"7860","27493","2014",16,16,0,128148.125,1835.3125,78.0625
"7861","27495","2014",6,6,0,113100,2516.16666666667,62.6666666666667
"7862","27496","2014",7,7,0,109750,1581.57142857143,71.5714285714286
"7863","27497","2014",7,7,0,127371.428571429,1541.42857142857,84.7142857142857
"7864","27500","2014",16,16,0,140209.0625,1588.8125,100.5625
"7865","27502","2014",26,26,0,86327.2307692308,996.730769230769,96.2307692307692
"7866","27504","2014",5,5,0,133570,1605,84.2
"7867","27507","2014",34,32,2,148325.294117647,1639.17647058824,98.6176470588235
"7868","27508","2014",1,1,0,220000,1818,121
"7869","27511","2014",7,7,0,161285.714285714,1691.57142857143,97.2857142857143
"7870","27514","2014",5,5,0,92328,1278.4,72.6
"7871","27517","2014",11,11,0,192355.454545455,1677.18181818182,115.181818181818
"7872","27518","2014",6,6,0,157788.333333333,1332.33333333333,114.166666666667
"7873","27521","2014",3,3,0,197500,1547.33333333333,124
"7874","27524","2014",3,3,0,108800,1499,73.6666666666667
"7875","27525","2014",5,5,0,247081.2,1652.6,147
"7876","27527","2014",3,3,0,133566.666666667,1528,86.6666666666667
"7877","27528","2014",32,27,5,158526.25,1819.21875,94.09375
"7878","27529","2014",6,6,0,152833.333333333,1671.83333333333,99.8333333333333
"7879","27530","2014",2,2,0,101500,1139,112
"7880","27531","2014",1,1,0,272000,1813,150
"7881","27533","2014",3,3,0,195333.333333333,1714.66666666667,114
"7882","27534","2014",10,10,0,146770,1448.7,101.3
"7883","27535","2014",2,2,0,127500,1591,94.5
"7884","27536","2014",5,5,0,166860,1476,119.2
"7885","27537","2014",4,4,0,190000,2451.25,82.5
"7886","27539","2014",2,2,0,180200,1614.5,113
"7887","27540","2014",4,4,0,188575,2065,100.75
"7888","27543","2014",10,10,0,154850,1847.4,85.1
"7889","27544","2014",1,1,0,90000,1500,60
"7890","27547","2014",8,8,0,139750,1317.25,125.125
"7891","27548","2014",14,14,0,140027.142857143,1713.71428571429,90.7142857142857
"7892","27552","2014",4,4,0,108750,1218.5,97.75
"7893","27553","2014",7,7,0,78072,956.714285714286,70.4285714285714
"7894","27554","2014",32,32,0,229558.09375,2088.8125,112.25
"7895","27555","2014",1,1,0,190000,1881,101
"7896","27556","2014",1,1,0,140000,1022,137
"7897","27557","2014",2,2,0,62500,960,65.5
"7898","27560","2014",1,1,0,120000,1224,98
"7899","27561","2014",6,6,0,174766.666666667,2165.33333333333,91.3333333333333
"7900","27562","2014",37,29,8,188327.594594595,2069.54054054054,94.7567567567568
"7901","27563","2014",7,7,0,169821.428571429,1826.57142857143,98.7142857142857
"7902","27564","2014",4,4,0,117650,1191.25,97.25
"7903","27565","2014",6,6,0,117583.333333333,1300.16666666667,90.8333333333333
"7904","27567","2014",4,4,0,169500,2076.25,89.25
"7905","27568","2014",10,10,0,136582,1429.8,101
"7906","27569","2014",3,3,0,115500,1279.66666666667,84.3333333333333
"7907","27572","2014",3,3,0,113333.333333333,1046.33333333333,109.666666666667
"7908","27577","2014",4,4,0,153850,1517,103.5
"7909","27578","2014",3,3,0,131000,1658.66666666667,117
"7910","27580","2014",19,19,0,173067.368421053,1883.94736842105,94.2631578947368
"7911","27582","2014",17,16,1,146195.588235294,1738.05882352941,90.4117647058823
"7912","27584","2014",3,3,0,89666.6666666667,1125.33333333333,76.3333333333333
"7913","27586","2014",3,3,0,160333.333333333,1826.66666666667,88
"7914","27589","2014",7,7,0,209500,1505,156.857142857143
"7915","27590","2014",4,4,0,116625,1942,73
"7916","27592","2014",5,5,0,194400,1429.8,137.4
"7917","27593","2014",11,11,0,167936.363636364,1868.27272727273,92.6363636363636
"7918","27595","2014",12,12,0,164412.5,1586,107
"7919","27597","2014",4,4,0,328375,2200.25,146.75
"7920","27598","2014",12,12,0,139508.333333333,1793.25,83.0833333333333
"7921","27599","2014",9,9,0,155541.111111111,1977.11111111111,75.3333333333333
"7922","27601","2014",3,3,0,181766.666666667,1643,123
"7923","27602","2014",37,35,2,166516.216216216,1673.02702702703,101.621621621622
"7924","27606","2014",3,3,0,191333.333333333,1209.33333333333,159.666666666667
"7925","27608","2014",3,3,0,152000,1433.33333333333,106.333333333333
"7926","27609","2014",6,6,0,131616.666666667,1315,95
"7927","27610","2014",1,1,0,105000,1909,55
"7928","27611","2014",3,3,0,178800,1562.33333333333,157.333333333333
"7929","27612","2014",5,5,0,163324.2,1537.4,111.6
"7930","27614","2014",3,3,0,117166.666666667,1388,90
"7931","27615","2014",2,2,0,250250,1986,124.5
"7932","27616","2014",25,25,0,200338.8,1761.08,115.84
"7933","27617","2014",6,6,0,175187.166666667,1906.66666666667,92.6666666666667
"7934","27618","2014",6,6,0,107166.666666667,1478.33333333333,73.3333333333333
"7935","27620","2014",10,10,0,220770,2502.6,90.9
"7936","27621","2014",1,1,0,290000,1921,151
"7937","27623","2014",3,3,0,170154,1786.66666666667,100.333333333333
"7938","27624","2014",2,2,0,174500,1886.5,92.5
"7939","27625","2014",2,2,0,121500,1615,73.5
"7940","27631","2014",2,2,0,126000,1327.5,92
"7941","27632","2014",9,9,0,215806.666666667,1546,126.555555555556
"7942","27633","2014",8,7,1,156662.5,1707.25,100.875
"7943","27635","2014",2,2,0,159000,1859.5,85.5
"7944","27638","2014",25,25,0,175356.4,1736.44,102.92
"7945","27640","2014",2,2,0,141000,1578,90
"7946","27641","2014",1,1,0,167000,1722,97
"7947","27643","2014",10,10,0,118800,1435.5,87.1
"7948","27644","2014",4,4,0,166332.75,2210.5,90.75
"7949","27645","2014",2,2,0,90000,1399,64
"7950","27646","2014",3,3,0,147000,2102.66666666667,71.3333333333333
"7951","27649","2014",5,5,0,154040,1510.8,103
"7952","27650","2014",4,4,0,124500,1386.5,89.5
"7953","27652","2014",7,7,0,230750,1989.28571428571,119.714285714286
"7954","27654","2014",11,11,0,126909.090909091,1486.90909090909,88
"7955","27655","2014",11,11,0,150363.636363636,1459,106.454545454545
"7956","27656","2014",10,10,0,149350,1450.8,106.2
"7957","27658","2014",1,1,0,182000,1767,103
"7958","27660","2014",4,4,0,153915.5,1854.25,91
"7959","27661","2014",4,4,0,218800,1680.25,129.75
"7960","27662","2014",5,5,0,171800,1881.8,91.8
"7961","27664","2014",7,7,0,141985.714285714,1640.57142857143,99.2857142857143
"7962","27665","2014",5,5,0,114905.6,1499.2,92.4
"7963","27666","2014",6,6,0,192700,1986.83333333333,98.1666666666667
"7964","27667","2014",5,5,0,128120,1784.6,80.2
"7965","27668","2014",8,8,0,178243.75,1665.125,115.5
"7966","27669","2014",1,1,0,250000,1316,190
"7967","27670","2014",9,9,0,116833.333333333,1362.11111111111,92
"7968","27671","2014",4,4,0,143500,1834.75,82
"7969","27672","2014",4,4,0,152350,1664.5,82.75
"7970","27673","2014",4,4,0,262475,2250.5,122
"7971","27674","2014",3,3,0,272233.333333333,2895.33333333333,105
"7972","27677","2014",2,2,0,95000,1046,94
"7973","27678","2014",10,10,0,177230,1660,113.6
"7974","27679","2014",61,42,19,120489.163934426,1512.68852459016,81.2131147540984
"7975","27680","2014",1,1,0,60000,545,110
"7976","27681","2014",200,120,80,173633.39,2091.625,84.77
"7977","27682","2014",6,6,0,221750,2055.5,112.333333333333
"7978","27684","2014",9,9,0,196166.666666667,1927.33333333333,116.222222222222
"7979","27685","2014",7,7,0,143028.571428571,1238.28571428571,120.857142857143
"7980","27689","2014",1,1,0,337000,2106,160
"7981","27690","2014",4,4,0,164500,1783,100
"7982","27691","2014",12,12,0,146458.333333333,1985.25,78.3333333333333
"7983","27693","2014",10,10,0,136760,1513.6,91.1
"7984","27694","2014",2,2,0,189000,2772.5,68
"7985","27695","2014",1,1,0,80000,976,82
"7986","27696","2014",9,9,0,233727.777777778,1956.77777777778,127.777777777778
"7987","27697","2014",3,3,0,329133.333333333,2158,168
"7988","27698","2014",1,1,0,130000,1204,108
"7989","27699","2014",1,1,0,123000,1295,95
"7990","27700","2014",9,9,0,156005.555555556,1562.88888888889,103.555555555556
"7991","27701","2014",68,61,7,121652.220588235,1440.25,85.4411764705882
"7992","28001","2014",44,26,18,162280.159090909,1605.27272727273,91.5909090909091
"7993","28003","2014",2,2,0,141000,1773.5,78.5
"7994","28004","2014",2,2,0,81058,957.5,68.5
"7995","28005","2014",5,5,0,122660,1113.4,111.8
"7996","28006","2014",11,11,0,184077.272727273,2049.09090909091,93.0909090909091
"7997","28007","2014",27,26,1,187362.962962963,1957.66666666667,105.333333333333
"7998","28010","2014",1,1,0,115000,1554,74
"7999","28012","2014",48,48,0,93170.75,1258.95833333333,82.0416666666667
"8000","28013","2014",18,18,0,161012.5,1838.16666666667,95.8888888888889
"8001","28014","2014",8,8,0,108475,1197.375,98.5
"8002","28015","2014",54,37,17,164482.407407407,2023.88888888889,82.9074074074074
"8003","28016","2014",4,4,0,122750,1626.25,77.5
"8004","28018","2014",11,10,1,89090.9090909091,1060.63636363636,80.5454545454545
"8005","28019","2014",3,3,0,160900,1776.66666666667,97
"8006","28021","2014",17,17,0,161283.235294118,1753.70588235294,95
"8007","28022","2014",10,10,0,169439,1703.3,110.6
"8008","28023","2014",9,9,0,161788.888888889,2100.66666666667,80.4444444444444
"8009","28024","2014",11,11,0,190481.818181818,1902.81818181818,103.818181818182
"8010","28026","2014",3,3,0,121166.666666667,1375.66666666667,86.3333333333333
"8011","28027","2014",10,10,0,75988.6,1258.6,68.1
"8012","28028","2014",1,1,0,123000,992,124
"8013","28030","2014",6,6,0,78000,1114.66666666667,74.8333333333333
"8014","28031","2014",1,1,0,265252,1507,176
"8015","28032","2014",1,1,0,142000,1844,77
"8016","28033","2014",6,6,0,104666.666666667,1060.16666666667,104.833333333333
"8017","28034","2014",5,5,0,166200,2110,79.8
"8018","28035","2014",9,9,0,163735.555555556,1778.33333333333,94.6666666666667
"8019","28036","2014",9,9,0,265123.444444444,2532.88888888889,104.888888888889
"8020","28037","2014",5,5,0,98900,1330.2,79.2
"8021","28038","2014",3,3,0,168333.333333333,1978.33333333333,95.6666666666667
"8022","28039","2014",16,14,2,142481.25,1585.6875,96.8125
"8023","28040","2014",1,1,0,40000,392,102
"8024","28041","2014",3,3,0,288900,1750,159.666666666667
"8025","28045","2014",1,1,0,158000,2225,71
"8026","28046","2014",4,4,0,121282.5,1073.25,113.5
"8027","28047","2014",7,7,0,133285.714285714,1556.28571428571,95.4285714285714
"8028","28048","2014",9,9,0,124942.222222222,1440.44444444444,97.8888888888889
"8029","28050","2014",4,4,0,203875,1809.25,128.5
"8030","28051","2014",36,33,3,116830.25,1380.86111111111,88.6666666666667
"8031","28052","2014",11,11,0,174669.454545455,1874.54545454545,109.181818181818
"8032","28054","2014",2,2,0,180000,1828,98.5
"8033","28055","2014",5,5,0,194200,1780.6,115.2
"8034","28056","2014",17,16,1,217886.470588235,2029.70588235294,120.352941176471
"8035","28057","2014",11,11,0,103077.272727273,1253.09090909091,87.2727272727273
"8036","28058","2014",5,5,0,229800,1874.2,121.6
"8037","28059","2014",16,16,0,110293.75,1306.5,86.25
"8038","28060","2014",2,2,0,192900,1558.5,124.5
"8039","28061","2014",35,33,2,141442.857142857,1556.4,85.1428571428571
"8040","28062","2014",10,10,0,190100,2161.5,91.9
"8041","28064","2014",28,26,2,218682.928571429,2152.46428571429,104.821428571429
"8042","28065","2014",3,3,0,135333.333333333,1306.66666666667,103.666666666667
"8043","28067","2014",2,2,0,102500,1193.5,79.5
"8044","28068","2014",4,4,0,138375,1539.75,91.25
"8045","28070","2014",28,28,0,214226.785714286,2058.64285714286,107.5
"8046","28071","2014",8,8,0,121406.25,1335.75,90.875
"8047","28072","2014",3,3,0,88666.6666666667,904.333333333333,97.3333333333333
"8048","28073","2014",6,6,0,171616.666666667,2585.33333333333,77
"8049","28074","2014",2,2,0,225200,1988.5,119.5
"8050","28075","2014",8,8,0,123562.5,1419.375,90.75
"8051","28076","2014",1,1,0,216000,1440,150
"8052","28077","2014",3,3,0,200666.666666667,1751.66666666667,106.666666666667
"8053","28078","2014",3,3,0,71700,930,79
"8054","28079","2014",5,5,0,53600,953.6,56.6
"8055","28080","2014",4,4,0,163250,1596.25,106.25
"8056","28081","2014",5,5,0,159970,1459.4,111
"8057","28082","2014",9,9,0,182777.777777778,2000.55555555556,101.666666666667
"8058","28084","2014",8,8,0,184125,1866.375,103.375
"8059","28085","2014",458,165,293,165768.18558952,2265.21615720524,73.7423580786026
"8060","28086","2014",3,3,0,90000,1210,92
"8061","28087","2014",4,4,0,105625,957.25,111.5
"8062","28088","2014",105,79,26,101847.219047619,1282.20952380952,80.8571428571429
"8063","28089","2014",28,23,5,123667.857142857,1585.46428571429,84.4285714285714
"8064","28090","2014",2,2,0,50500,632.5,79
"8065","28091","2014",1,1,0,120000,2308,52
"8066","28092","2014",1,1,0,134000,1063,126
"8067","28094","2014",19,19,0,169047.368421053,1798.15789473684,97.8947368421053
"8068","28095","2014",2,2,0,116500,1479.5,72
"8069","28096","2014",8,7,1,170665,1941.625,96.375
"8070","28098","2014",20,20,0,199647.5,2004.15,101.5
"8071","28099","2014",9,9,0,130096.222222222,1459.11111111111,89.8888888888889
"8072","28100","2014",2,2,0,176500,1372.5,131
"8073","28102","2014",7,6,1,133142.857142857,1368,99.5714285714286
"8074","28103","2014",59,58,1,106474.542372881,1277.30508474576,86.4745762711864
"8075","28104","2014",3,3,0,202440,2072.66666666667,100
"8076","28105","2014",4,4,0,103450,1465.75,70
"8077","28106","2014",1,1,0,40000,625,64
"8078","28107","2014",4,4,0,187875,2212,87.5
"8079","28108","2014",3,3,0,97333.3333333333,1276.66666666667,77.3333333333333
"8080","28109","2014",4,3,1,93750,1119.25,86
"8081","28110","2014",28,23,5,223736.285714286,2187.14285714286,107.285714285714
"8082","28111","2014",2,2,0,89250,1197,83
"8083","28113","2014",21,19,2,170676.285714286,1724.66666666667,103.809523809524
"8084","28114","2014",4,4,0,100500,801.75,128.25
"8085","28116","2014",17,16,1,130141.176470588,1584.70588235294,82.9411764705882
"8086","28117","2014",2,2,0,207197.5,1651.5,136.5
"8087","28118","2014",3,3,0,279425,1913.33333333333,148.333333333333
"8088","28119","2014",4,4,0,71750,870.75,81.25
"8089","28120","2014",6,6,0,130416.666666667,1306,98.8333333333333
"8090","28122","2014",11,10,1,155548.363636364,1794.09090909091,99.1818181818182
"8091","28123","2014",3,3,0,92333.3333333333,1438.33333333333,65
"8092","28124","2014",5,5,0,116800,1345,82.8
"8093","28126","2014",2,2,0,131500,1412,92.5
"8094","28127","2014",13,13,0,97624.7692307692,1073.61538461538,90.6923076923077
"8095","28128","2014",1,1,0,181000,1547,117
"8096","28129","2014",5,5,0,149600,1576,97.6
"8097","28130","2014",11,11,0,140772.727272727,1250.18181818182,111.545454545455
"8098","28132","2014",6,6,0,132562.5,1390.5,102.5
"8099","28134","2014",255,139,116,126575.658823529,1755.94509803922,74.5254901960784
"8100","28135","2014",14,13,1,214237.142857143,2276.35714285714,95.0714285714286
"8101","28136","2014",5,5,0,200900,1594.4,121.6
"8102","28137","2014",6,6,0,212906.666666667,2137.16666666667,102.666666666667
"8103","28140","2014",60,22,38,167918.016666667,2764.31666666667,72.7166666666667
"8104","28141","2014",1,1,0,75000,1230,61
"8105","28142","2014",3,3,0,80666.6666666667,841,96.6666666666667
"8106","28143","2014",1,1,0,72000,369,195
"8107","28144","2014",1,1,0,410000,6949,59
"8108","28146","2014",13,13,0,235827.692307692,2340.53846153846,105.923076923077
"8109","28147","2014",6,6,0,134100,1264,107.5
"8110","28148","2014",5,5,0,139400,1399.6,106.2
"8111","28149","2014",8,8,0,96000,906.125,113.75
"8112","28151","2014",3,3,0,122950,1171,104.666666666667
"8113","28153","2014",5,5,0,64550,1133.8,57.2
"8114","28154","2014",10,10,0,176700,1957.9,93
"8115","28155","2014",2,2,0,131500,2055.5,64.5
"8116","28156","2014",7,7,0,148285.714285714,1125.14285714286,132.571428571429
"8117","28157","2014",2,2,0,125000,1166,105.5
"8118","28158","2014",10,10,0,226430,1941.8,120.6
"8119","28159","2014",6,6,0,119833.333333333,1410,86.8333333333333
"8120","28160","2014",4,4,0,119500,1555.75,76.25
"8121","28161","2014",5,5,0,146500,1376.8,105.4
"8122","28162","2014",3,3,0,127000,1190.66666666667,106
"8123","28163","2014",3,3,0,168900,2116.66666666667,79.6666666666667
"8124","28164","2014",10,10,0,126150,1570.7,79.8
"8125","28166","2014",2,2,0,107500,1110,93.5
"8126","28167","2014",3,3,0,151333.333333333,2086.33333333333,74.3333333333333
"8127","28168","2014",33,25,8,162540.303030303,1842.09090909091,92.2727272727273
"8128","28171","2014",8,8,0,152312.5,1581.125,104.125
"8129","28172","2014",4,4,0,247500,1938.75,129.25
"8130","28173","2014",14,13,1,187699.285714286,1897.07142857143,99.8571428571429
"8131","28175","2014",2,2,0,127750,1454,90
"8132","28176","2014",2,2,0,137000,1131.5,117.5
"8133","28178","2014",4,4,0,239000,1416.75,205.5
"8134","28180","2014",2,2,0,139750,2099.5,74
"8135","28182","2014",2,2,0,160000,918.5,181.5
"8136","28183","2014",6,6,0,144000,1497.83333333333,98.1666666666667
"8137","28184","2014",6,6,0,138166.666666667,1553.16666666667,88.5
"8138","28185","2014",11,10,1,200694.545454545,1793.09090909091,114.545454545455
"8139","28187","2014",7,7,0,168214.285714286,1551.42857142857,119.857142857143
"8140","28188","2014",9,8,1,205133.333333333,1787.44444444444,119
"8141","28189","2014",1,1,0,198000,2415,82
"8142","28190","2014",3,3,0,141333.333333333,1304.33333333333,110
"8143","28191","2014",31,30,1,216298.387096774,2295.25806451613,103.516129032258
"8144","28192","2014",3,3,0,162000,1598.33333333333,103.666666666667
"8145","28193","2014",3,3,0,225000,1560.33333333333,138.666666666667
"8146","28194","2014",1,1,0,80000,2162,37
"8147","28195","2014",4,4,0,165875,1671,103.75
"8148","28196","2014",23,22,1,103851.739130435,1329.4347826087,80.9565217391304
"8149","28197","2014",3,3,0,109333.333333333,1557.66666666667,70.6666666666667
"8150","28198","2014",3,3,0,174400,1610.66666666667,113.666666666667
"8151","28199","2014",18,17,1,135288.888888889,1538.5,88.6666666666667
"8152","28200","2014",6,6,0,129250,1272.83333333333,100.166666666667
"8153","28201","2014",15,14,1,180487,2036.8,89.3333333333333
"8154","28202","2014",2,2,0,98250,1335,73
"8155","28203","2014",7,7,0,171413.857142857,1796.28571428571,95.1428571428571
"8156","28206","2014",5,5,0,212200,1548.8,140.6
"8157","28207","2014",6,6,0,160333.333333333,1780.33333333333,90.8333333333333
"8158","28208","2014",8,8,0,228937.5,2122.625,105.375
"8159","28209","2014",38,29,9,181631.578947368,2099.02631578947,87.6578947368421
"8160","28210","2014",1,1,0,140000,1772,79
"8161","28211","2014",6,6,0,90533.3333333333,1112.5,80.1666666666667
"8162","28212","2014",1,1,0,206350,1115,185
"8163","28213","2014",4,3,1,147843.75,2240.75,67.25
"8164","28214","2014",25,23,2,118500,1342.56,88.56
"8165","28215","2014",3,3,0,70000,1466.66666666667,49.3333333333333
"8166","28216","2014",2,2,0,210500,1492,184
"8167","28217","2014",1,1,0,81000,1080,75
"8168","28218","2014",73,48,25,157888.794520548,2061.32876712329,79.0821917808219
"8169","28219","2014",8,8,0,88812.5,1252.25,71.625
"8170","28220","2014",56,45,11,203484.821428571,2163.98214285714,96.8571428571429
"8171","28222","2014",2,2,0,163960,1099,149.5
"8172","28223","2014",7,7,0,146774.571428571,1788.71428571429,82.8571428571429
"8173","28225","2014",6,6,0,155557,1482,105.833333333333
"8174","28226","2014",9,9,0,161745,1327.33333333333,128.777777777778
"8175","28227","2014",53,44,9,207094.830188679,2339.18867924528,93.5471698113208
"8176","28229","2014",68,31,37,137416.514705882,2110.86764705882,65.6029411764706
"8177","28230","2014",5,5,0,191879.8,1744,113.2
"8178","28231","2014",5,5,0,124900,1295.6,110.2
"8179","28232","2014",5,5,0,119200,1409.8,83.6
"8180","28233","2014",15,15,0,107023.333333333,1288.6,96.8
"8181","28234","2014",4,4,0,170562.5,1399.5,128.75
"8182","28235","2014",7,7,0,202339.285714286,2013.57142857143,100.857142857143
"8183","28236","2014",11,11,0,131481.818181818,1380.54545454545,95.6363636363636
"8184","28237","2014",4,4,0,127750,800.75,142.75
"8185","28239","2014",4,4,0,162100,1799.75,98.25
"8186","28240","2014",5,5,0,100900,1045.8,101.2
"8187","28242","2014",3,3,0,157333.333333333,1371.33333333333,133.333333333333
"8188","28243","2014",1,1,0,151000,1411,107
"8189","28245","2014",2,2,0,245825,2061,120.5
"8190","28246","2014",5,4,1,118360,1052,117.2
"8191","28247","2014",3,3,0,229333.333333333,2222.33333333333,106.333333333333
"8192","28248","2014",5,5,0,136400,1261.4,102.8
"8193","28249","2014",6,6,0,222500,2103.16666666667,118.5
"8194","28251","2014",11,11,0,176350,1574.54545454545,118
"8195","28252","2014",5,5,0,113700,1229.8,92.4
"8196","28253","2014",7,7,0,339004.285714286,2239.85714285714,145.857142857143
"8197","28255","2014",4,4,0,159275,1262.5,131.75
"8198","28256","2014",1,1,0,140000,1359,103
"8199","28257","2014",1,1,0,159000,1767,90
"8200","28259","2014",2,2,0,81250,1318,69
"8201","28260","2014",1,1,0,164000,891,184
"8202","28261","2014",6,6,0,144241.666666667,1641.33333333333,99
"8203","28263","2014",7,7,0,126928.571428571,1234,106.571428571429
"8204","28265","2014",4,4,0,86250,1025.5,89
"8205","28267","2014",5,5,0,165160,1740.4,95.2
"8206","28268","2014",1,1,0,255450,1703,150
"8207","28269","2014",17,17,0,233120.588235294,2006.17647058824,120.117647058824
"8208","28270","2014",1,1,0,65000,684,95
"8209","28271","2014",2,2,0,114220,2892,53.5
"8210","28273","2014",2,2,0,56000,989,56
"8211","28274","2014",4,4,0,97475,2042.25,60
"8212","28275","2014",6,6,0,159166.666666667,1835.16666666667,90.8333333333333
"8213","28276","2014",2,2,0,125500,1574.5,92.5
"8214","28277","2014",2,2,0,23000,591.5,42.5
"8215","28278","2014",19,9,10,167928.578947368,4284.21052631579,65.2631578947368
"8216","28279","2014",33,25,8,157404.484848485,1798,91.6363636363636
"8217","28280","2014",88,62,26,114281.818181818,1382.28409090909,85.7954545454545
"8218","28281","2014",2,2,0,190500,1769.5,106.5
"8219","28282","2014",8,8,0,89000,1302.75,69.25
"8220","28283","2014",5,5,0,100100,1234.2,93.8
"8221","28284","2014",5,5,0,127600,1436.6,87.8
"8222","28285","2014",3,3,0,226230,2084,117
"8223","28286","2014",8,8,0,152112.5,1740,91
"8224","28287","2014",11,11,0,96227.2727272727,1239.27272727273,82.5454545454545
"8225","28290","2014",1,1,0,125000,2907,43
"8226","28291","2014",8,8,0,109443.75,1655.875,73.375
"8227","28292","2014",7,7,0,176357.142857143,1668.42857142857,107.285714285714
"8228","28293","2014",7,7,0,183714.285714286,2034.14285714286,114.428571428571
"8229","28294","2014",6,6,0,145466.666666667,1749.16666666667,88.5
"8230","28296","2014",3,3,0,84600,1008.33333333333,82
"8231","28298","2014",28,23,5,186745.714285714,2075.03571428571,96.2142857142857
"8232","28299","2014",3,3,0,273800,2283.66666666667,132
"8233","28300","2014",2,2,0,182000,1264,188.5
"8234","28301","2014",3,3,0,185666.666666667,1968.66666666667,94.3333333333333
"8235","28302","2014",5,5,0,133200,1349.2,100.2
"8236","28303","2014",1,1,0,1e+05,1639,61
"8237","28304","2014",7,7,0,113500,1323.28571428571,84.4285714285714
"8238","28305","2014",2,2,0,95500,1006,98
"8239","28309","2014",15,15,0,141040,1486.26666666667,97.2
"8240","28310","2014",6,6,0,101333.333333333,1375.83333333333,94.1666666666667
"8241","28312","2014",2,2,0,205125,1647.5,134
"8242","28313","2014",3,3,0,137533.333333333,1502,83.3333333333333
"8243","28314","2014",3,3,0,52000,613.666666666667,84.3333333333333
"8244","28315","2014",1,1,0,105000,1641,64
"8245","28316","2014",2,2,0,80000,1341.5,59.5
"8246","28317","2014",3,3,0,203800,1686.66666666667,122
"8247","28319","2014",2,2,0,186950,1231,154
"8248","28321","2014",9,9,0,186333.333333333,1919.77777777778,101.777777777778
"8249","28322","2014",9,9,0,156444.444444444,1201.11111111111,129.777777777778
"8250","28323","2014",1,1,0,105000,1615,65
"8251","28324","2014",10,10,0,150367,1432.9,108.1
"8252","28325","2014",11,11,0,159822.727272727,1758.27272727273,90.7272727272727
"8253","28326","2014",5,5,0,112665.6,1273,86
"8254","28327","2014",2,2,0,84100,1021,81
"8255","28329","2014",1,1,0,59000,843,70
"8256","28330","2014",15,15,0,102160,1029.93333333333,103.466666666667
"8257","28331","2014",12,12,0,119598.333333333,1364.33333333333,90.25
"8258","28332","2014",7,7,0,218527.142857143,2352.71428571429,101.285714285714
"8259","28333","2014",3,3,0,145470,1126.66666666667,137.333333333333
"8260","28334","2014",12,12,0,120291.666666667,1448.33333333333,84.8333333333333
"8261","28335","2014",7,7,0,143857.142857143,1371.85714285714,109.142857142857
"8262","28337","2014",28,28,0,164726.071428571,1696.42857142857,101.964285714286
"8263","28339","2014",4,4,0,145250,1353.5,106.25
"8264","28341","2014",4,4,0,125250,1285,96
"8265","28342","2014",1,1,0,186000,1329,140
"8266","28343","2014",1,1,0,165000,2200,75
"8267","28344","2014",3,3,0,154000,1592.33333333333,96.6666666666667
"8268","28347","2014",16,14,2,188993.75,2336,84.0625
"8269","28348","2014",17,16,1,146638.823529412,1444.82352941176,106.705882352941
"8270","28350","2014",7,7,0,179742.857142857,1990.42857142857,95.2857142857143
"8271","28351","2014",1,1,0,140000,1489,94
"8272","28352","2014",22,22,0,230500,2101.09090909091,109.772727272727
"8273","28353","2014",3,3,0,91666.6666666667,1536,65.6666666666667
"8274","28354","2014",2,2,0,147341,1364,177
"8275","28355","2014",7,7,0,325032.142857143,2679.14285714286,130.857142857143
"8276","28357","2014",16,15,1,202543.75,2066.125,103.375
"8277","28358","2014",24,24,0,205067.708333333,2006.375,105.375
"8278","28359","2014",31,31,0,143033,1646.70967741935,88.5161290322581
"8279","28360","2014",6,6,0,124600,1143.16666666667,115.166666666667
"8280","28362","2014",6,6,0,117000,1429.16666666667,85.5
"8281","28363","2014",13,12,1,166313.538461538,1513,106.076923076923
"8282","28364","2014",13,13,0,122674.615384615,1192.76923076923,101.307692307692
"8283","28365","2014",1,1,0,165000,1058,156
"8284","28366","2014",2,2,0,144500,1924.5,80
"8285","28367","2014",3,3,0,154000,1320.66666666667,117.333333333333
"8286","28368","2014",1,1,0,130000,1444,90
"8287","28369","2014",7,7,0,108721.428571429,1612.14285714286,68.8571428571429
"8288","28370","2014",3,3,0,121400,1294.66666666667,92.3333333333333
"8289","28371","2014",7,7,0,137824.285714286,1880.28571428571,75.1428571428571
"8290","28372","2014",5,5,0,198292,2669.6,87
"8291","28373","2014",23,22,1,114849.260869565,1192.21739130435,101.826086956522
"8292","28374","2014",3,3,0,128833.333333333,1408.66666666667,90.6666666666667
"8293","28375","2014",4,4,0,200250,2042.5,99
"8294","28377","2014",23,22,1,177386.086956522,1808.34782608696,103.04347826087
"8295","28378","2014",9,9,0,90533.3333333333,968.888888888889,94.7777777777778
"8296","28379","2014",2,2,0,167500,2244.5,76.5
"8297","28380","2014",14,14,0,166103.571428571,1654.71428571429,107.214285714286
"8298","28382","2014",8,8,0,149890.375,1651.875,94.5
"8299","28383","2014",12,12,0,119916.666666667,1658.66666666667,77.6666666666667
"8300","28385","2014",5,5,0,144400,1389.6,122.6
"8301","28386","2014",13,13,0,136601.307692308,1367,103.307692307692
"8302","28387","2014",7,7,0,107857.142857143,1266.57142857143,85.4285714285714
"8303","28388","2014",8,8,0,164512.625,2197.5,83.75
"8304","28389","2014",4,4,0,111000,1266,84
"8305","28390","2014",4,4,0,115750,1365,83.5
"8306","28391","2014",19,17,2,160273.684210526,1783.36842105263,101.105263157895
"8307","28392","2014",1,1,0,75000,1316,57
"8308","28393","2014",22,22,0,151965.909090909,1498.63636363636,105.681818181818
"8309","28394","2014",13,13,0,156336.923076923,1761.38461538462,94
"8310","28395","2014",3,3,0,104933.333333333,847,108
"8311","28396","2014",3,3,0,138833.333333333,1378.33333333333,101
"8312","28397","2014",6,6,0,206416.666666667,1884,113
"8313","28398","2014",13,13,0,106910.153846154,1412.84615384615,85.2307692307692
"8314","28400","2014",3,3,0,131000,1198,114
"8315","28401","2014",6,6,0,111277,1575.16666666667,90
"8316","28403","2014",7,7,0,245214.285714286,2200.85714285714,111.571428571429
"8317","28404","2014",58,50,8,140402.75862069,1699.31034482759,84.7586206896552
"8318","28405","2014",13,13,0,156197.692307692,1436.30769230769,114.615384615385
"8319","28406","2014",17,17,0,116679.411764706,1253,98.7647058823529
"8320","28407","2014",3,3,0,194656.333333333,2352,95
"8321","28408","2014",1,1,0,157000,2243,70
"8322","28409","2014",6,6,0,99416.6666666667,1279,77.5
"8323","28410","2014",4,4,0,123837.5,1479.5,86.75
"8324","28411","2014",2,2,0,115000,906,125.5
"8325","28415","2014",11,11,0,120154.545454545,1614,76.5454545454545
"8326","28417","2014",13,13,0,195506.538461538,2033.61538461538,101.230769230769
"8327","28418","2014",3,3,0,131666.666666667,1071,119.666666666667
"8328","28421","2014",4,4,0,93625,1305.25,77.5
"8329","28422","2014",39,38,1,120247.615384615,1621.66666666667,78.7435897435897
"8330","28423","2014",4,4,0,201625,2210.75,93.75
"8331","28424","2014",15,14,1,118240,1336.06666666667,88.1333333333333
"8332","28425","2014",4,4,0,218650,1871.5,130
"8333","28426","2014",8,8,0,116750,1456.375,102
"8334","29001","2014",6,5,1,115500,1354,83.3333333333333
"8335","29002","2014",9,8,1,141583.333333333,2620.55555555556,94.4444444444444
"8336","29003","2014",56,45,11,130080.357142857,1596,87.2321428571429
"8337","29004","2014",55,55,0,130316.090909091,1366.21818181818,101.054545454545
"8338","29005","2014",2,2,0,165000,1748,96
"8339","29006","2014",72,35,37,185791.972222222,2669.02777777778,76.5277777777778
"8340","29007","2014",19,19,0,78544.7368421053,1039.94736842105,77.1578947368421
"8341","29008","2014",4,4,0,211750,2095.75,96.5
"8342","29010","2014",8,8,0,118875,1213.75,103.5
"8343","29011","2014",22,22,0,215468.181818182,1615.45454545455,136.909090909091
"8344","29012","2014",4,4,0,66916.75,1027.5,67.75
"8345","29014","2014",2,2,0,53000,503.5,104
"8346","29015","2014",34,31,3,157991.764705882,1571.47058823529,98.5294117647059
"8347","29016","2014",11,11,0,103651.818181818,1253.09090909091,95.3636363636364
"8348","29017","2014",6,6,0,160960,1476.66666666667,113.833333333333
"8349","29018","2014",4,4,0,64625,1026.25,66.25
"8350","29019","2014",1929,507,1422,104626.877656817,1455.87506480041,71.7376879212027
"8351","29020","2014",27,26,1,130423.444444444,1104.88888888889,118.111111111111
"8352","29021","2014",19,19,0,108207.842105263,1125.57894736842,93.2105263157895
"8353","29022","2014",34,30,4,145980.882352941,1717.47058823529,85.3823529411765
"8354","29023","2014",46,43,3,237881.456521739,2232.19565217391,109.521739130435
"8355","29024","2014",70,64,6,86843.5428571429,1037.38571428571,85.2142857142857
"8356","29025","2014",8,8,0,109875,1087.5,100.875
"8357","29026","2014",31,23,8,106417.741935484,1118.67741935484,91.8387096774194
"8358","29027","2014",34,33,1,83451.0588235294,1047.88235294118,80.5882352941177
"8359","29028","2014",15,15,0,114400,1157.6,103.533333333333
"8360","29029","2014",7,7,0,87285.7142857143,1089.85714285714,79.4285714285714
"8361","29030","2014",39,37,2,128612.307692308,1553.51282051282,94.5384615384615
"8362","29031","2014",72,67,5,190692.083333333,1822.91666666667,110.041666666667
"8363","29032","2014",20,20,0,217876.65,1772.1,123.35
"8364","29033","2014",6,6,0,82700,895.666666666667,93.5
"8365","29034","2014",5,5,0,105800,1024.2,100.6
"8366","29035","2014",10,10,0,164790,1489.1,109.5
"8367","29036","2014",5,5,0,102660,892.8,115.2
"8368","29037","2014",60,58,2,204593.033333333,2114.5,98.6833333333333
"8369","29038","2014",14,14,0,74642.8571428571,956.857142857143,81.5
"8370","29039","2014",275,175,100,176228.330909091,2004.29454545455,90.2036363636364
"8371","29040","2014",35,25,10,192670.057142857,2058.28571428571,93.0571428571429
"8372","29041","2014",11,11,0,82141.4545454545,942.636363636364,89.1818181818182
"8373","29042","2014",97,88,9,171901.855670103,2028.64948453608,86.1237113402062
"8374","29043","2014",15,15,0,148153.333333333,1473.86666666667,102.466666666667
"8375","29044","2014",8,8,0,106000,1144.75,89.625
"8376","29045","2014",13,13,0,172350,1637.23076923077,103.769230769231
"8377","29046","2014",177,131,46,108776.531073446,1311.12429378531,85.7853107344633
"8378","29047","2014",9,9,0,125912.888888889,1155.88888888889,111.111111111111
"8379","29048","2014",18,17,1,102611.111111111,1109.83333333333,93.3333333333333
"8380","29049","2014",26,26,0,119410.846153846,1145.65384615385,105.384615384615
"8381","29051","2014",56,50,6,135425.857142857,1409.60714285714,99.1785714285714
"8382","29053","2014",14,14,0,122364.285714286,1328,104.428571428571
"8383","29054","2014",7,7,0,72428.5714285714,908.428571428571,79.5714285714286
"8384","29055","2014",20,20,0,162635,1741.95,100.2
"8385","29056","2014",14,14,0,160622.571428571,1459.71428571429,106.285714285714
"8386","29057","2014",9,9,0,201055.555555556,1495.44444444444,117.666666666667
"8387","29058","2014",117,90,27,198587.41025641,2241.7094017094,94.6752136752137
"8388","29059","2014",4,4,0,99875,1452.25,67.75
"8389","29060","2014",27,25,2,203095.925925926,1890.2962962963,112.037037037037
"8390","29061","2014",49,46,3,187157.959183673,1796.04081632653,104.020408163265
"8391","29062","2014",5,5,0,84200,933,95
"8392","29063","2014",6,6,0,114985.5,1249,97.1666666666667
"8393","29064","2014",3,3,0,96000,1192,80
"8394","29065","2014",7,7,0,134204.285714286,1384.28571428571,106.428571428571
"8395","29066","2014",13,13,0,126076.923076923,1224.07692307692,109.153846153846
"8396","29067","2014",4,4,0,72000,769,87.25
"8397","29068","2014",12,12,0,112375,1139.66666666667,98.0833333333333
"8398","29069","2014",52,48,4,165284.384615385,1677.63461538462,99.6538461538462
"8399","29070","2014",1,1,0,175000,1750,100
"8400","29071","2014",5,5,0,89600,919.4,96
"8401","29072","2014",45,32,13,108091.555555556,1494.53333333333,81.6
"8402","29073","2014",11,11,0,146545.454545455,1370,111
"8403","29074","2014",10,10,0,80160,1059.7,78.2
"8404","29075","2014",101,90,11,177754.455445545,1774.15841584158,100.138613861386
"8405","29076","2014",39,39,0,170144.205128205,1533.25641025641,111.897435897436
"8406","29077","2014",27,27,0,130286.666666667,1369.18518518519,98.3333333333333
"8407","29078","2014",16,15,1,145496.5625,1662.5625,92.9375
"8408","29079","2014",12,12,0,118116.666666667,1127.75,101.166666666667
"8409","29080","2014",27,27,0,143093.703703704,1501.59259259259,97.7777777777778
"8410","29081","2014",31,29,2,103211.290322581,1056.64516129032,96
"8411","29082","2014",8,7,1,222394.25,3837,64.25
"8412","29085","2014",13,12,1,219594.615384615,2783.76923076923,86.8461538461538
"8413","29086","2014",12,12,0,163212.083333333,1623,106.333333333333
"8414","29087","2014",4,4,0,96500,905.5,110.25
"8415","29089","2014",13,13,0,111589.769230769,1030.30769230769,110.230769230769
"8416","29090","2014",5,5,0,145796,1327.4,111.8
"8417","29091","2014",26,26,0,121953.692307692,1760.23076923077,74.8076923076923
"8418","29093","2014",9,9,0,110194.555555556,1129.55555555556,99
"8419","29094","2014",5,5,0,196600,1649.2,121.4
"8420","29095","2014",15,15,0,184420.666666667,1847.73333333333,99
"8421","29097","2014",19,18,1,88512.8421052632,998.684210526316,89.1052631578947
"8422","29098","2014",29,29,0,147055.517241379,1612.55172413793,95.7241379310345
"8423","29099","2014",11,11,0,171579.090909091,1691.54545454545,108.181818181818
"8424","29100","2014",3,3,0,114750,1067,135
"8425","29102","2014",9,9,0,91916.6666666667,878.888888888889,108.333333333333
"8426","29103","2014",161,110,51,121940.186335404,1487.33540372671,84.2173913043478
"8427","29104","2014",4,4,0,122080,1813.5,74
"8428","29105","2014",79,64,15,114057.949367089,1217.51898734177,95.2911392405063
"8429","29106","2014",17,17,0,154721.176470588,1447.35294117647,111.117647058824
"8430","29107","2014",13,13,0,105038.461538462,1075.07692307692,97.9230769230769
"8431","29108","2014",11,11,0,127113.636363636,1538.90909090909,83.2727272727273
"8432","29109","2014",18,18,0,168325,1885.27777777778,93.2777777777778
"8433","29110","2014",9,9,0,127555.555555556,1241.88888888889,102.666666666667
"8434","29111","2014",5,5,0,119126.2,1154.6,100.4
"8435","29112","2014",11,11,0,213936.363636364,1582.09090909091,135.727272727273
"8436","29113","2014",20,20,0,88514.2,1083.9,84.1
"8437","29115","2014",3,3,0,42000,757.333333333333,46.6666666666667
"8438","29116","2014",2,2,0,97500,964.5,89
"8439","29117","2014",47,39,8,135890,1530.48936170213,89.8510638297872
"8440","29119","2014",11,11,0,184648,1703.72727272727,109.454545454545
"8441","29120","2014",25,18,7,108384,1062.92,96.4
"8442","29122","2014",4,4,0,70125,627,111
"8443","29123","2014",2,2,0,86000,949,88.5
"8444","29124","2014",79,68,11,128310.974683544,1359.16455696203,97.746835443038
"8445","29125","2014",6,6,0,65333.3333333333,829.5,80
"8446","29126","2014",5,5,0,126500,1339.6,91.2
"8447","29128","2014",1,1,0,140000,1148,122
"8448","29130","2014",33,31,2,176327.787878788,1831.66666666667,96.8787878787879
"8449","29132","2014",15,15,0,148708.333333333,1398,110.8
"8450","29133","2014",20,18,2,211554,2569.45,89.15
"8451","29135","2014",53,49,4,174718.113207547,1763.24528301887,106.471698113208
"8452","29136","2014",16,16,0,104565.625,1082.125,98.25
"8453","29137","2014",23,23,0,179151.086956522,1673.82608695652,109.913043478261
"8454","29139","2014",10,10,0,101150,1180,84.1
"8455","29140","2014",31,31,0,191517.741935484,1656.29032258065,115.838709677419
"8456","29141","2014",3,3,0,52000,812.666666666667,62.3333333333333
"8457","29142","2014",5,5,0,129600,1305.2,100.4
"8458","29143","2014",6,6,0,126416.666666667,1156,113.166666666667
"8459","29144","2014",6,6,0,116083.333333333,1441,93.1666666666667
"8460","29145","2014",3,3,0,136333.333333333,1413.33333333333,104.666666666667
"8461","29146","2014",32,32,0,145434.78125,1506.46875,100.875
"8462","29147","2014",15,13,2,122323.333333333,1252,102
"8463","29148","2014",10,10,0,103200,1094.2,97.4
"8464","29150","2014",92,85,7,156962.445652174,1910.91304347826,84.6739130434783
"8465","29151","2014",185,94,91,87891.5945945946,1131.17837837838,77.6054054054054
"8466","29152","2014",4,4,0,101250,877,111.25
"8467","29153","2014",41,36,5,180735.243902439,1752.65853658537,101.024390243902
"8468","29155","2014",8,8,0,142167.125,2190.75,75.875
"8469","29156","2014",16,16,0,160884.375,1384.8125,112.8125
"8470","29158","2014",86,81,5,121428.604651163,1398.83720930233,90.8837209302326
"8471","29159","2014",4,4,0,163625,1607.5,104
"8472","29160","2014",60,57,3,141046.516666667,1500.78333333333,92.9666666666667
"8473","29161","2014",7,7,0,177348.571428571,1630.14285714286,114.571428571429
"8474","29162","2014",34,34,0,94842.6470588235,1125.76470588235,88.2058823529412
"8475","29163","2014",27,27,0,95814.8148148148,1039.48148148148,98.7037037037037
"8476","29165","2014",49,48,1,171405.387755102,1710.22448979592,107.326530612245
"8477","29166","2014",9,9,0,133528.888888889,1391.55555555556,103.333333333333
"8478","29167","2014",12,12,0,125041.666666667,1332.91666666667,100.5
"8479","29168","2014",15,15,0,106800,1382.6,84.6666666666667
"8480","29169","2014",24,24,0,118837.333333333,1271.29166666667,97.6666666666667
"8481","29170","2014",30,30,0,189819.8,1662.56666666667,117.533333333333
"8482","29171","2014",29,28,1,158489.310344828,1782.06896551724,98.3103448275862
"8483","29172","2014",20,20,0,97325,1221.35,80.1
"8484","29173","2014",14,14,0,144132.5,1384.35714285714,106.214285714286
"8485","29174","2014",53,53,0,146745.188679245,1329.60377358491,113.924528301887
"8486","29175","2014",26,26,0,68663.4615384615,788.653846153846,86.2692307692308
"8487","29176","2014",13,13,0,126319.230769231,1560.30769230769,86
"8488","29177","2014",32,31,1,179438.1875,1921.53125,96.84375
"8489","29178","2014",47,47,0,148828.723404255,1552.89361702128,99.063829787234
"8490","29179","2014",23,23,0,129703.043478261,1262.13043478261,103.608695652174
"8491","29180","2014",12,12,0,107083.333333333,1104.58333333333,100.083333333333
"8492","29181","2014",28,27,1,132443.214285714,1429.67857142857,97
"8493","29182","2014",5,5,0,99494.8,1159,81.2
"8494","29183","2014",7,7,0,108142.857142857,1355.57142857143,80.5714285714286
"8495","29184","2014",9,9,0,85000,996.222222222222,101.555555555556
"8496","29185","2014",32,32,0,127241.84375,1431.53125,94.84375
"8497","29186","2014",15,15,0,129033.333333333,1412.53333333333,94.4666666666667
"8498","29187","2014",2,2,0,122500,1237,106
"8499","29188","2014",55,54,1,165896.381818182,1751.61818181818,97
"8500","29189","2014",97,86,11,220406.515463918,2052.40206185567,107.371134020619
"8501","29190","2014",62,48,14,172935.64516129,1976.16129032258,90.3548387096774
"8502","29191","2014",32,32,0,91428.75,984.125,88.71875
"8503","29192","2014",15,15,0,104862.666666667,1085.46666666667,96.8
"8504","29193","2014",1,1,0,70000,556,126
"8505","29195","2014",74,72,2,134275.662162162,1580.98648648649,87.2162162162162
"8506","29196","2014",13,12,1,104861.538461538,1213.84615384615,86.6153846153846
"8507","29197","2014",39,37,2,149634.871794872,1731.69230769231,88.1538461538462
"8508","29198","2014",10,10,0,133935,1154,122.2
"8509","29199","2014",48,47,1,127124.3125,1285.875,99.9583333333333
"8510","29201","2014",24,23,1,155252.708333333,1704.66666666667,98.2083333333333
"8511","29202","2014",10,10,0,71750,850.7,86
"8512","29204","2014",23,23,0,110503.695652174,1239.65217391304,92.1739130434783
"8513","29205","2014",3,3,0,109442.333333333,844.333333333333,134.333333333333
"8514","29206","2014",25,25,0,113272,1009.88,112.28
"8515","29207","2014",35,34,1,122192.914285714,1143.54285714286,106.628571428571
"8516","29208","2014",8,6,2,107312.5,978.75,105.875
"8517","29209","2014",35,34,1,142087.457142857,1436.34285714286,101.6
"8518","29210","2014",20,20,0,128335,1191.2,106.7
"8519","29211","2014",14,14,0,62357.1428571429,767.214285714286,83.8571428571429
"8520","29212","2014",102,100,2,171454.460784314,1657.19607843137,104.833333333333
"8521","29213","2014",14,14,0,94785.7142857143,1127.92857142857,83.1428571428571
"8522","29214","2014",8,8,0,153307.5,1594.375,96.875
"8523","29215","2014",37,37,0,139245.621621622,1433.13513513514,102.783783783784
"8524","29216","2014",29,29,0,159804.172413793,1605.58620689655,102.620689655172
"8525","29217","2014",39,35,4,138363.794871795,1488.79487179487,94.025641025641
"8526","29218","2014",13,13,0,102492.307692308,1136.38461538462,90.3846153846154
"8527","29220","2014",108,73,35,123668.925925926,1532.34259259259,84.8981481481482
"8528","29221","2014",32,32,0,166215,1809.34375,94.3125
"8529","29222","2014",4,3,1,29025,432.75,74.25
"8530","29224","2014",17,17,0,123678.588235294,1281.11764705882,96.2941176470588
"8531","29225","2014",24,24,0,104183.333333333,1188.20833333333,95.625
"8532","29226","2014",7,7,0,166571.428571429,1598,105.142857142857
"8533","29227","2014",23,23,0,61576.0869565217,825.347826086957,74.695652173913
"8534","29228","2014",12,12,0,115833.333333333,1454.33333333333,80.1666666666667
"8535","29229","2014",12,12,0,117487.5,1095.25,116.25
"8536","29230","2014",20,20,0,110325.5,1104.3,105.2
"8537","29232","2014",947,455,492,119391.4625132,1515.65997888068,78.1182682154171
"8538","29233","2014",111,92,19,134284.153153153,1420.40540540541,98.7387387387387
"8539","29234","2014",16,16,0,193125.625,1629.9375,120.125
"8540","29235","2014",112,84,28,188619.196428571,1970.29464285714,96.6339285714286
"8541","29236","2014",42,42,0,122144.166666667,1524.35714285714,87.6666666666667
"8542","29237","2014",12,12,0,142522.916666667,1246.91666666667,112.666666666667
"8543","29238","2014",19,17,2,135878.947368421,1425.05263157895,96.4736842105263
"8544","29239","2014",47,25,22,145927.872340426,2090.6170212766,80.5106382978723
"8545","29240","2014",9,9,0,169866.666666667,1481.11111111111,112.555555555556
"8546","29241","2014",78,74,4,110713.58974359,1188.89743589744,94.3589743589744
"8547","29243","2014",5,5,0,97000,856.6,123.2
"8548","29244","2014",4,4,0,58000,663,82
"8549","29245","2014",3,3,0,244500,1510.33333333333,165.666666666667
"8550","29247","2014",26,25,1,166897.192307692,1749.11538461538,97.6538461538462
"8551","29248","2014",9,9,0,97449.1111111111,1135.66666666667,89.4444444444444
"8552","29249","2014",8,8,0,72875,731.625,90.375
"8553","29250","2014",6,6,0,53083.3333333333,684.333333333333,74.3333333333333
"8554","29251","2014",10,10,0,140000,1443.6,94.3
"8555","29252","2014",12,12,0,149666.833333333,1498.41666666667,97.75
"8556","29254","2014",49,41,8,110642.387755102,1167.81632653061,96.6530612244898
"8557","29255","2014",4,4,0,162347.75,1889,92
"8558","29256","2014",13,12,1,149608.461538462,1745.30769230769,88.0769230769231
"8559","29257","2014",11,9,2,130804.545454545,1294.90909090909,104.090909090909
"8560","29259","2014",62,55,7,115450.806451613,1254.14516129032,89.6451612903226
"8561","29260","2014",62,50,12,157923.016129032,1741.75806451613,91.8064516129032
"8562","29261","2014",3,3,0,66000,904,77
"8563","29262","2014",9,9,0,78388.8888888889,836.222222222222,99.5555555555556
"8564","29263","2014",11,11,0,107472.727272727,1097.63636363636,95.9090909090909
"8565","29264","2014",4,4,0,97960,1089,89.75
"8566","29265","2014",7,7,0,134285.714285714,1215.71428571429,112.428571428571
"8567","29266","2014",16,16,0,115093.75,1288.5625,92.6875
"8568","29267","2014",10,10,0,87350,1026.8,83.4
"8569","29268","2014",10,10,0,146150,1578.2,100.7
"8570","29269","2014",12,12,0,97291.6666666667,1017.5,92.3333333333333
"8571","29270","2014",13,13,0,141634.307692308,1338.61538461538,110.384615384615
"8572","29271","2014",2,2,0,90000,797.5,112.5
"8573","29272","2014",18,18,0,112072.944444444,1333.5,88
"8574","29273","2014",18,17,1,128408.333333333,1648.61111111111,81.7777777777778
"8575","29274","2014",46,46,0,94097.5217391304,1021.97826086957,95.5652173913043
"8576","29275","2014",16,15,1,65550,1020.6875,65.5
"8577","29276","2014",9,9,0,126111.111111111,1258.66666666667,96.3333333333333
"8578","29277","2014",14,14,0,132950,1295.71428571429,107.928571428571
"8579","29278","2014",22,22,0,73549.6363636364,847.227272727273,90
"8580","29279","2014",23,23,0,110873.913043478,1217.86956521739,94.8695652173913
"8581","29280","2014",18,18,0,134399.444444444,1470.27777777778,90.3888888888889
"8582","29281","2014",9,9,0,98666.6666666667,1079.11111111111,92.1111111111111
"8583","29282","2014",1,1,0,440000,2304,191
"8584","29284","2014",30,28,2,139563.333333333,1472.96666666667,98.5333333333333
"8585","29285","2014",8,8,0,83800,1373,65
"8586","29286","2014",1,1,0,122000,1284,95
"8587","29287","2014",11,11,0,130184.090909091,1308.81818181818,93.2727272727273
"8588","29288","2014",6,6,0,178600,1528.83333333333,116.666666666667
"8589","29289","2014",3,3,0,198680,1860.33333333333,100
"8590","29290","2014",5,5,0,132400,1535.4,86
"8591","29291","2014",9,9,0,99111.1111111111,1188.44444444444,89.8888888888889
"8592","29292","2014",6,6,0,120416.666666667,1311.33333333333,95.3333333333333
"8593","29293","2014",88,80,8,187681.75,1878.52272727273,100.5
"8594","29294","2014",6,6,0,116583.333333333,1167.33333333333,99
"8595","29295","2014",5,5,0,131934.2,1361.2,100.2
"8596","29296","2014",6,6,0,118833.333333333,1411.5,87.8333333333333
"8597","29297","2014",14,13,1,147928.571428571,1516.5,103.714285714286
"8598","29298","2014",4,4,0,133875,1836,74.25
"8599","29299","2014",2,2,0,1e+05,1043.5,95
"8600","29300","2014",5,5,0,151140,1561,96.4
"8601","29302","2014",28,28,0,92787.25,1005.60714285714,91.8928571428571
"8602","2A001","2014",14,9,5,278520.714285714,2604.92857142857,113.071428571429
"8603","2A004","2014",496,34,462,215094.463709677,3185.18548387097,69.4092741935484
"8604","2A006","2014",21,19,2,287814.285714286,2986.80952380952,104.809523809524
"8605","2A008","2014",38,14,24,291293.5,4091.65789473684,66.7368421052632
"8606","2A017","2014",6,6,0,320500,3807,86.1666666666667
"8607","2A024","2014",1,1,0,15000,395,38
"8608","2A026","2014",1,0,1,80000,4706,17
"8609","2A028","2014",2,1,1,84852,1520.5,70
"8610","2A031","2014",5,4,1,75200,1057.6,66.6
"8611","2A032","2014",16,12,4,405809.375,3624.75,107.625
"8612","2A035","2014",4,3,1,331142.5,4003.75,84
"8613","2A040","2014",2,2,0,77500,1922.5,70.5
"8614","2A041","2014",30,9,21,316501.166666667,3310.83333333333,89.3333333333333
"8615","2A048","2014",9,1,8,164233.333333333,3995,44.6666666666667
"8616","2A061","2014",2,2,0,155000,1963.5,79.5
"8617","2A065","2014",15,12,3,216379.333333333,4036.6,59.5333333333333
"8618","2A070","2014",7,2,5,151666.857142857,3151.57142857143,46.5714285714286
"8619","2A071","2014",2,0,2,94250,1824.5,54
"8620","2A085","2014",11,4,7,189727.272727273,2778.27272727273,68.9090909090909
"8621","2A090","2014",8,4,4,187830,2613.25,69.75
"8622","2A091","2014",2,1,1,47831,738,64
"8623","2A092","2014",6,5,1,275905,2912.5,99
"8624","2A098","2014",14,11,3,311002.142857143,3844.78571428571,75.0714285714286
"8625","2A099","2014",2,0,2,28500,459,64
"8626","2A103","2014",9,6,3,201077.333333333,2331.11111111111,90.8888888888889
"8627","2A104","2014",3,3,0,405600,3552,123
"8628","2A114","2014",6,5,1,137250,2795.66666666667,51.5
"8629","2A115","2014",2,0,2,43000,1012.5,45
"8630","2A118","2014",1,1,0,85000,1889,45
"8631","2A119","2014",3,2,1,65000,990.666666666667,57
"8632","2A129","2014",2,1,1,65000,1359.5,42
"8633","2A130","2014",64,26,38,296480.15625,4720.0625,64.328125
"8634","2A131","2014",1,1,0,35000,461,76
"8635","2A133","2014",1,1,0,137500,1511,91
"8636","2A139","2014",23,18,5,600365.652173913,5247.17391304348,94.2173913043478
"8637","2A141","2014",2,2,0,167500,2259,75
"8638","2A142","2014",6,5,1,93953.3333333333,1445.66666666667,56
"8639","2A146","2014",1,0,1,1e+05,1087,92
"8640","2A154","2014",1,1,0,20000,513,39
"8641","2A160","2014",1,1,0,40000,952,42
"8642","2A163","2014",3,1,2,122976.666666667,1719,62.3333333333333
"8643","2A174","2014",1,0,1,80000,1739,46
"8644","2A181","2014",6,6,0,295108.333333333,2476.5,131.666666666667
"8645","2A186","2014",2,1,1,119250,1776,67
"8646","2A189","2014",10,7,3,411847,3695,107.3
"8647","2A198","2014",6,1,5,134016.666666667,2677.83333333333,41.5
"8648","2A200","2014",1,0,1,53000,1152,46
"8649","2A203","2014",6,4,2,188542.666666667,2457.83333333333,70.1666666666667
"8650","2A204","2014",2,1,1,20000,510.5,39
"8651","2A209","2014",12,9,3,208234.166666667,2789.41666666667,83
"8652","2A211","2014",1,1,0,110000,2292,48
"8653","2A212","2014",5,5,0,118000,2289.4,53.8
"8654","2A215","2014",2,2,0,595000,4683.5,128
"8655","2A228","2014",12,10,2,655250,5064.83333333333,109.583333333333
"8656","2A232","2014",1,1,0,175000,983,178
"8657","2A247","2014",112,56,56,424606.883928571,4470.90178571429,80.3303571428571
"8658","2A249","2014",36,5,31,194091.277777778,3149.16666666667,65.3611111111111
"8659","2A254","2014",3,1,2,42666.6666666667,1425.33333333333,30
"8660","2A258","2014",2,2,0,119000,1643.5,67
"8661","2A262","2014",1,1,0,83500,994,84
"8662","2A268","2014",1,1,0,250000,1923,130
"8663","2A269","2014",18,7,11,216011.944444444,2748.83333333333,71.8333333333333
"8664","2A271","2014",12,4,8,189474.833333333,3076,63.75
"8665","2A272","2014",22,8,14,158522.727272727,2093.27272727273,75.0454545454545
"8666","2A276","2014",4,2,2,168655,2400.25,67
"8667","2A278","2014",2,2,0,150000,1009,142.5
"8668","2A279","2014",1,1,0,15000,750,20
"8669","2A282","2014",3,2,1,79600,2164,35.6666666666667
"8670","2A284","2014",2,2,0,160000,2424,66
"8671","2A288","2014",8,7,1,207250,3481.875,73.125
"8672","2A300","2014",3,1,2,264899.333333333,3661,65.3333333333333
"8673","2A308","2014",5,0,5,81413.6,1633.6,45.8
"8674","2A312","2014",3,1,2,95666.6666666667,1348.66666666667,68
"8675","2A322","2014",1,0,1,136500,2167,63
"8676","2A323","2014",1,1,0,216000,2571,84
"8677","2A324","2014",1,1,0,140000,2000,70
"8678","2A326","2014",1,1,0,25000,556,45
"8679","2A330","2014",2,2,0,204000,3349,58
"8680","2A331","2014",1,1,0,1e+05,2500,40
"8681","2A336","2014",2,1,1,97300,2537,37.5
"8682","2A345","2014",2,1,1,173000,2191,63.5
"8683","2A348","2014",6,1,5,129234.333333333,2894.83333333333,49.5
"8684","2A349","2014",3,2,1,443333.333333333,3562,119.666666666667
"8685","2A351","2014",1,1,0,385000,4278,90
"8686","2A357","2014",2,1,1,22500,607,39
"8687","2A359","2014",1,1,0,123500,1235,100
"8688","2A362","2014",26,18,8,289301.269230769,3777.23076923077,79.6923076923077
"8689","2A363","2014",1,1,0,120000,5000,24
"8690","2B002","2014",1,1,0,2e+05,1980,101
"8691","2B003","2014",1,1,0,3e+05,2256,133
"8692","2B007","2014",1,1,0,70000,1167,60
"8693","2B009","2014",5,2,3,123132,1827.2,67.2
"8694","2B010","2014",5,1,4,331800,5044,58.6
"8695","2B016","2014",1,0,1,15000,375,40
"8696","2B020","2014",4,2,2,345513.75,4797.5,69.75
"8697","2B029","2014",3,3,0,440000,3852.66666666667,128.666666666667
"8698","2B030","2014",2,0,2,55000,876,63.5
"8699","2B033","2014",266,8,258,159557.146616541,2276.34586466165,72.0451127819549
"8700","2B034","2014",6,4,2,217166.666666667,2989.83333333333,80.8333333333333
"8701","2B037","2014",47,21,26,203821.021276596,2328.29787234043,91.8510638297872
"8702","2B042","2014",80,34,46,184398.8625,2793.2,68.475
"8703","2B043","2014",11,3,8,203972.727272727,2826.27272727273,63.7272727272727
"8704","2B049","2014",25,12,13,193754,2940.44,67.48
"8705","2B050","2014",89,7,82,201772.471910112,4016.3595505618,51.4719101123596
"8706","2B055","2014",1,1,0,110000,982,112
"8707","2B057","2014",3,1,2,120640,2412,47.6666666666667
"8708","2B058","2014",5,3,2,88304,2523.4,35.2
"8709","2B059","2014",3,3,0,173833.333333333,1929.66666666667,99
"8710","2B067","2014",2,2,0,95000,1220,63
"8711","2B072","2014",1,1,0,233000,2240,104
"8712","2B073","2014",1,1,0,35000,438,80
"8713","2B077","2014",16,16,0,111858.8125,4135.6875,29.3125
"8714","2B079","2014",4,3,1,127025,1947.5,78
"8715","2B080","2014",2,1,1,66500,689,97.5
"8716","2B083","2014",3,2,1,85400,1407.66666666667,53.3333333333333
"8717","2B086","2014",3,2,1,202653.333333333,2426.66666666667,91.6666666666667
"8718","2B087","2014",12,8,4,162858.333333333,1973.41666666667,81.5833333333333
"8719","2B088","2014",1,1,0,40000,588,68
"8720","2B093","2014",4,3,1,241687.5,6305.75,50
"8721","2B095","2014",1,0,1,15000,417,36
"8722","2B096","2014",51,7,44,104134.764705882,2236.82352941176,52.2549019607843
"8723","2B097","2014",1,1,0,785000,2804,280
"8724","2B105","2014",1,1,0,38000,1583,24
"8725","2B107","2014",2,0,2,17250,351.5,49
"8726","2B111","2014",1,1,0,60300,1005,60
"8727","2B112","2014",3,3,0,170000,2646.66666666667,70.3333333333333
"8728","2B113","2014",4,1,3,76500,1440.25,53.25
"8729","2B120","2014",18,12,6,247283.611111111,2877.05555555556,87.1111111111111
"8730","2B121","2014",2,2,0,260000,4255.5,63.5
"8731","2B123","2014",12,6,6,199150,2489.75,84.3333333333333
"8732","2B124","2014",2,0,2,23484,715,33
"8733","2B126","2014",3,2,1,74500,1196.33333333333,65
"8734","2B134","2014",49,0,49,172403.06122449,3669.14285714286,47.9183673469388
"8735","2B135","2014",1,1,0,148000,1973,75
"8736","2B136","2014",2,0,2,116850,2782.5,41.5
"8737","2B138","2014",1,1,0,3e+05,1667,180
"8738","2B143","2014",15,6,9,127400,2229.53333333333,62.4666666666667
"8739","2B145","2014",2,2,0,42135.5,468,90
"8740","2B147","2014",3,1,2,105333.333333333,1984.33333333333,52
"8741","2B148","2014",44,27,17,166706.681818182,2535.40909090909,71.3409090909091
"8742","2B150","2014",36,9,27,248983.111111111,4480.83333333333,54.25
"8743","2B152","2014",12,5,7,74791.6666666667,1066.5,70.75
"8744","2B155","2014",1,1,0,110000,1236,89
"8745","2B159","2014",3,3,0,130666.666666667,1316,98.3333333333333
"8746","2B162","2014",6,4,2,174833.333333333,1313.16666666667,107
"8747","2B164","2014",1,1,0,45000,900,50
"8748","2B165","2014",1,1,0,130000,4643,28
"8749","2B166","2014",2,1,1,248000,2500,104
"8750","2B167","2014",1,1,0,160000,2712,59
"8751","2B168","2014",14,7,7,300149.285714286,3667.07142857143,83.6428571428571
"8752","2B169","2014",5,2,3,144700,1830.8,78.6
"8753","2B170","2014",4,3,1,102000,1810,55.25
"8754","2B172","2014",3,2,1,87666.6666666667,1546.33333333333,57.3333333333333
"8755","2B173","2014",3,0,3,78333.3333333333,1796.33333333333,45
"8756","2B175","2014",1,0,1,15000,500,30
"8757","2B177","2014",1,1,0,2e+05,1299,154
"8758","2B178","2014",1,1,0,185000,1850,100
"8759","2B179","2014",1,0,1,40000,625,64
"8760","2B183","2014",1,0,1,77500,4306,18
"8761","2B184","2014",1,0,1,35000,814,43
"8762","2B185","2014",15,7,8,235450,3017.66666666667,79
"8763","2B187","2014",1,0,1,35000,700,50
"8764","2B188","2014",2,2,0,257500,2003.5,129.5
"8765","2B190","2014",6,5,1,154000,1412.5,95.1666666666667
"8766","2B192","2014",1,1,0,90000,1071,84
"8767","2B193","2014",4,3,1,112425,1035.25,93.75
"8768","2B201","2014",1,1,0,160000,1600,100
"8769","2B205","2014",10,7,3,226710.1,3357.9,72
"8770","2B207","2014",12,9,3,185809.833333333,1977.83333333333,94.1666666666667
"8771","2B210","2014",2,2,0,87500,1007,96
"8772","2B216","2014",1,0,1,58971,786,75
"8773","2B218","2014",3,1,2,35500,521,75
"8774","2B219","2014",2,1,1,41000,691.5,61
"8775","2B220","2014",1,1,0,115000,2875,40
"8776","2B222","2014",1,0,1,25000,595,42
"8777","2B223","2014",1,1,0,4e+05,1818,220
"8778","2B224","2014",10,5,5,133612,2520.6,61.3
"8779","2B225","2014",1,0,1,110000,2000,55
"8780","2B227","2014",1,1,0,60000,1333,45
"8781","2B229","2014",3,2,1,152333.333333333,2012.33333333333,76
"8782","2B230","2014",2,2,0,3e+05,2277,110
"8783","2B231","2014",2,2,0,242500,2510,100.5
"8784","2B235","2014",2,2,0,62500,1069,59
"8785","2B236","2014",1,0,1,50000,676,74
"8786","2B239","2014",2,1,1,81500,1897,40.5
"8787","2B242","2014",16,12,4,132752.5,3084.875,46
"8788","2B245","2014",2,2,0,62500,896,75.5
"8789","2B246","2014",1,0,1,50000,625,80
"8790","2B251","2014",21,17,4,169116.428571429,1965.33333333333,86.9047619047619
"8791","2B257","2014",1,1,0,345800,3144,110
"8792","2B261","2014",6,3,3,85166.6666666667,1266.5,68.8333333333333
"8793","2B264","2014",1,1,0,85000,1393,61
"8794","2B265","2014",2,2,0,178225,2528.5,76
"8795","2B267","2014",1,1,0,80842,1617,50
"8796","2B277","2014",1,1,0,2e+05,1754,114
"8797","2B280","2014",1,1,0,145000,2900,50
"8798","2B281","2014",13,9,4,191938.846153846,2327.76923076923,80.6153846153846
"8799","2B283","2014",3,2,1,128666.666666667,1365.33333333333,82
"8800","2B286","2014",5,2,3,144000,1783.4,74.6
"8801","2B287","2014",1,1,0,1e+05,2857,35
"8802","2B289","2014",1,1,0,19496,542,36
"8803","2B290","2014",1,0,1,30000,545,55
"8804","2B292","2014",2,0,2,19967.5,594.5,44
"8805","2B293","2014",2,2,0,134750,3517.5,47
"8806","2B297","2014",1,1,0,39300,605,65
"8807","2B298","2014",19,5,14,294581.578947368,4545.42105263158,63.7368421052632
"8808","2B299","2014",1,0,1,67586,1408,48
"8809","2B302","2014",1,1,0,169800,1415,120
"8810","2B303","2014",3,2,1,152161.333333333,1661.66666666667,95.6666666666667
"8811","2B304","2014",1,1,0,60000,659,91
"8812","2B305","2014",25,4,21,162452.2,2434.6,65.56
"8813","2B307","2014",14,3,11,115644.928571429,2310.07142857143,54.0714285714286
"8814","2B309","2014",12,5,7,290833.333333333,3662.91666666667,76.4166666666667
"8815","2B311","2014",5,4,1,151002,2085.6,86.4
"8816","2B313","2014",20,1,19,113100.4,2191.7,56.8
"8817","2B314","2014",1,1,0,210000,1654,127
"8818","2B316","2014",8,6,2,195750,2783.875,81.625
"8819","2B318","2014",3,0,3,84384.3333333333,1185.66666666667,59.6666666666667
"8820","2B319","2014",3,3,0,183486.666666667,1570.66666666667,105.666666666667
"8821","2B320","2014",4,4,0,86250,1641,51
"8822","2B327","2014",1,1,0,56000,2240,25
"8823","2B329","2014",1,1,0,120000,1500,80
"8824","2B332","2014",5,3,2,112400,1721.4,75.4
"8825","2B333","2014",1,1,0,350000,2071,169
"8826","2B334","2014",1,0,1,50000,625,80
"8827","2B335","2014",1,1,0,160000,1702,94
"8828","2B337","2014",1,1,0,75000,789,95
"8829","2B340","2014",3,2,1,59333.3333333333,893.333333333333,66
"8830","2B341","2014",8,3,5,86287.5,1769.25,65.25
"8831","2B342","2014",7,4,3,196857.142857143,3090.71428571429,102.857142857143
"8832","2B343","2014",14,9,5,136854.785714286,1975.35714285714,71.7142857142857
"8833","2B346","2014",16,9,7,162066.3125,1923.9375,81.0625
"8834","2B347","2014",2,1,1,64250,1169,53.5
"8835","2B352","2014",3,2,1,131333.333333333,2383,60.3333333333333
"8836","2B353","2014",32,5,27,225526.09375,3022.15625,76.03125
"8837","2B355","2014",2,2,0,106500,2757,37.5
"8838","2B356","2014",1,0,1,25000,781,32
"8839","2B361","2014",4,3,1,100500,1540,54.5
"8840","2B365","2014",1,1,0,39000,2053,19
"8841","2B366","2014",1,1,0,50000,1000,50
"8842","30001","2014",6,6,0,219330,2462,103.666666666667
"8843","30002","2014",4,4,0,207500,1825,107.75
"8844","30003","2014",125,103,22,253505.44,3038.12,84.152
"8845","30004","2014",28,27,1,222500.714285714,2250.92857142857,98.1428571428571
"8846","30005","2014",3,3,0,207858.333333333,2353.33333333333,83
"8847","30006","2014",64,56,8,213056.625,2255.78125,95.25
"8848","30007","2014",296,140,156,117679.969594595,1521.56418918919,78.2939189189189
"8849","30008","2014",7,7,0,180541.428571429,2133,84.4285714285714
"8850","30009","2014",1,1,0,180000,1800,100
"8851","30010","2014",21,15,6,202213.523809524,2172.47619047619,95.9523809523809
"8852","30011","2014",112,64,48,215910.553571429,2697.5625,83.3571428571429
"8853","30012","2014",22,22,0,242562.454545455,2784.86363636364,96.8181818181818
"8854","30013","2014",4,4,0,260812.5,2499.25,106.75
"8855","30014","2014",7,7,0,383928.571428571,3486.14285714286,128.142857142857
"8856","30015","2014",3,3,0,145000,3175.66666666667,52.6666666666667
"8857","30016","2014",2,1,1,59500,710,83
"8858","30017","2014",8,8,0,94161.25,1420.25,67.25
"8859","30018","2014",2,2,0,276750,2348.5,130
"8860","30019","2014",30,28,2,231939.333333333,2220.06666666667,111.766666666667
"8861","30020","2014",18,17,1,215593.777777778,2141.22222222222,101.777777777778
"8862","30022","2014",2,2,0,50000,732.5,61.5
"8863","30023","2014",14,14,0,215871.428571429,2285.42857142857,94.2857142857143
"8864","30024","2014",9,9,0,132533.333333333,1380,86.3333333333333
"8865","30025","2014",6,6,0,92546.6666666667,1546.5,78.3333333333333
"8866","30026","2014",14,12,2,121041.571428571,1517.14285714286,89.7857142857143
"8867","30027","2014",12,12,0,204516.666666667,1668.08333333333,122.583333333333
"8868","30028","2014",145,82,63,138408.717241379,1706.54482758621,79.5655172413793
"8869","30029","2014",14,8,6,142746.428571429,1911,85.7142857142857
"8870","30030","2014",2,2,0,199500,2166,94
"8871","30031","2014",1,1,0,431700,2878,150
"8872","30032","2014",96,71,25,156123.239583333,1717.22916666667,89.125
"8873","30033","2014",31,27,4,168064.032258065,1909.48387096774,88.0967741935484
"8874","30034","2014",48,46,2,179441.604166667,2000.5625,90.1666666666667
"8875","30035","2014",5,5,0,161472,1510.8,108.6
"8876","30036","2014",33,27,6,169221.242424242,2006.57575757576,84.4545454545455
"8877","30037","2014",15,11,4,98100,1292.06666666667,74.5333333333333
"8878","30038","2014",3,2,1,52693,539.333333333333,90.3333333333333
"8879","30039","2014",27,22,5,157265.185185185,1748.07407407407,92.7407407407407
"8880","30040","2014",2,2,0,134000,1279.5,103.5
"8881","30041","2014",14,14,0,379321.714285714,2774.5,118.428571428571
"8882","30042","2014",22,21,1,188853.727272727,1944.59090909091,98.5
"8883","30043","2014",2,2,0,286325,3034.5,100
"8884","30045","2014",4,4,0,160250,1816,85.75
"8885","30046","2014",6,6,0,102651.666666667,1466,67.3333333333333
"8886","30047","2014",46,35,11,207670.52173913,2100.26086956522,99.7826086956522
"8887","30048","2014",1,1,0,185000,1762,105
"8888","30049","2014",3,3,0,153866.666666667,2978,65.6666666666667
"8889","30051","2014",6,6,0,101938.666666667,1295.66666666667,81.6666666666667
"8890","30052","2014",3,2,1,68666.6666666667,1489.33333333333,69
"8891","30053","2014",5,5,0,150510,1746.6,87.6
"8892","30054","2014",3,3,0,190666.666666667,3017,99
"8893","30055","2014",6,5,1,144661.666666667,2159,74.8333333333333
"8894","30056","2014",4,4,0,196600,1877.5,88.75
"8895","30057","2014",17,17,0,238226.941176471,2347.05882352941,100.470588235294
"8896","30058","2014",2,2,0,167500,1386.5,122
"8897","30059","2014",22,19,3,220800,2060.22727272727,110.818181818182
"8898","30060","2014",32,30,2,211104.84375,2260.0625,95
"8899","30061","2014",8,6,2,164381.25,1671.625,103.375
"8900","30062","2014",53,44,9,195291.452830189,2280.11320754717,86.3207547169811
"8901","30064","2014",1,1,0,15000,714,21
"8902","30065","2014",3,2,1,125000,989.333333333333,124.666666666667
"8903","30066","2014",4,4,0,191550,2142.75,88.75
"8904","30067","2014",2,2,0,226825,2214.5,100
"8905","30068","2014",6,6,0,156250,1630.83333333333,97.3333333333333
"8906","30069","2014",5,5,0,134646.2,1982.4,68.4
"8907","30070","2014",5,5,0,178140,2006.2,88.6
"8908","30071","2014",5,4,1,150700,1755.2,86
"8909","30072","2014",5,5,0,359864,2289.4,153.6
"8910","30073","2014",14,14,0,301772.857142857,2855.92857142857,105.571428571429
"8911","30075","2014",25,24,1,273206.8,2729.68,115.96
"8912","30076","2014",5,5,0,172800,1848.8,103.2
"8913","30077","2014",8,8,0,145625,1600.375,88.5
"8914","30079","2014",2,2,0,128500,1813.5,83.5
"8915","30080","2014",9,7,2,75277.7777777778,1210.11111111111,62
"8916","30081","2014",6,5,1,183575,2016.33333333333,101.333333333333
"8917","30082","2014",21,19,2,199642.380952381,2062.61904761905,95.4761904761905
"8918","30083","2014",28,24,4,212807.107142857,2080.67857142857,103.392857142857
"8919","30084","2014",3,3,0,59733.3333333333,593,104.333333333333
"8920","30085","2014",12,10,2,164608.333333333,2128.91666666667,78.5
"8921","30086","2014",5,5,0,220553,1946.4,113.6
"8922","30087","2014",4,4,0,96250,1483.25,66.75
"8923","30088","2014",2,2,0,170222.5,1694.5,107
"8924","30089","2014",14,14,0,180855.714285714,1997.71428571429,90
"8925","30090","2014",3,3,0,77366.6666666667,945,75.6666666666667
"8926","30091","2014",14,12,2,183718.928571429,2179.21428571429,86.1428571428571
"8927","30094","2014",2,2,0,186000,2035.5,105
"8928","30095","2014",5,5,0,204000,1650.2,123.4
"8929","30096","2014",6,5,1,229317.5,1856.5,118.666666666667
"8930","30097","2014",1,1,0,322030,3067,105
"8931","30098","2014",5,4,1,216790,1613.2,135.8
"8932","30099","2014",3,3,0,80000,1479,58.3333333333333
"8933","30100","2014",3,3,0,159000,1586.66666666667,99.6666666666667
"8934","30101","2014",5,5,0,197400,2018.4,97.8
"8935","30102","2014",3,3,0,145123.333333333,1552,93.6666666666667
"8936","30103","2014",4,4,0,149500,1858.75,81.25
"8937","30104","2014",7,6,1,215235.714285714,2403.14285714286,92.8571428571429
"8938","30105","2014",6,6,0,107385,1542.33333333333,71.3333333333333
"8939","30106","2014",5,5,0,152360,2158.8,79.2
"8940","30107","2014",2,2,0,161500,2323.5,69
"8941","30108","2014",2,2,0,99205,2517.5,40
"8942","30109","2014",5,5,0,240800,2312.6,106.2
"8943","30110","2014",1,1,0,350000,2846,123
"8944","30111","2014",1,1,0,792940,3849,206
"8945","30112","2014",10,10,0,218408.5,1994.6,108.8
"8946","30113","2014",2,2,0,163000,2345,65.5
"8947","30114","2014",7,6,1,229736.571428571,1883.85714285714,125.142857142857
"8948","30115","2014",4,4,0,185542.5,2421.75,84.5
"8949","30116","2014",12,10,2,128700,1462.08333333333,79.4166666666667
"8950","30117","2014",16,15,1,181943.75,1964.5625,93.1875
"8951","30119","2014",2,2,0,133000,1577,83.5
"8952","30120","2014",10,8,2,124960,1459.7,83.5
"8953","30121","2014",3,3,0,233185.666666667,2872.66666666667,82.3333333333333
"8954","30122","2014",5,5,0,187680,1804.6,103.2
"8955","30123","2014",30,26,4,169705.333333333,2139.76666666667,80.8666666666667
"8956","30124","2014",1,1,0,125000,1190,105
"8957","30125","2014",37,31,6,188657.135135135,1961.91891891892,96.5945945945946
"8958","30126","2014",6,6,0,220190.833333333,2250.66666666667,97
"8959","30127","2014",6,6,0,226233.333333333,1953.5,110.833333333333
"8960","30128","2014",39,31,8,173229.846153846,1879.87179487179,91.974358974359
"8961","30129","2014",4,4,0,117250,1467.5,75.25
"8962","30130","2014",10,9,1,133123.5,1505.7,84.3
"8963","30131","2014",7,7,0,307600,3115,94.4285714285714
"8964","30132","2014",24,15,9,81352.5,928.208333333333,90.8333333333333
"8965","30133","2014",517,42,475,157643.471953578,3962.36750483559,40.0077369439072
"8966","30134","2014",3,3,0,138333.333333333,1491,84.6666666666667
"8967","30135","2014",24,21,3,183956.75,2013.66666666667,92.4166666666667
"8968","30136","2014",9,9,0,182512.555555556,2139.44444444444,81.8888888888889
"8969","30137","2014",1,1,0,60000,845,71
"8970","30138","2014",1,1,0,246000,2733,90
"8971","30139","2014",7,6,1,102957.142857143,1391.71428571429,72.2857142857143
"8972","30140","2014",13,10,3,118192.307692308,1323.23076923077,84.8461538461538
"8973","30141","2014",34,30,4,185323.117647059,1892.58823529412,97.6764705882353
"8974","30142","2014",7,7,0,242457.142857143,2581.85714285714,113.714285714286
"8975","30143","2014",3,3,0,148283.333333333,1354.66666666667,106.666666666667
"8976","30144","2014",3,3,0,186666.666666667,2287.33333333333,80.6666666666667
"8977","30145","2014",16,16,0,189835.9375,2147.9375,87
"8978","30146","2014",8,8,0,144221.25,1505.875,91.25
"8979","30147","2014",8,7,1,125096.875,1445.75,85.875
"8980","30148","2014",4,4,0,135000,1344,94
"8981","30149","2014",5,5,0,242400,2031.6,115.4
"8982","30150","2014",1,1,0,177000,1427,124
"8983","30151","2014",7,7,0,229142.857142857,2090.14285714286,111
"8984","30152","2014",14,13,1,127642.857142857,1360.5,90.5714285714286
"8985","30154","2014",4,4,0,112500,1044.25,94.25
"8986","30155","2014",55,55,0,195713.545454545,2141.89090909091,90.5454545454545
"8987","30156","2014",63,54,9,182855.873015873,2026.31746031746,92.2222222222222
"8988","30158","2014",2,1,1,161000,2412,67
"8989","30159","2014",5,4,1,94500,1095.2,79.6
"8990","30160","2014",1,0,1,55500,925,60
"8991","30162","2014",4,2,2,123450,1301,108.25
"8992","30163","2014",1,1,0,42000,2211,19
"8993","30164","2014",16,16,0,119605.9375,1999.8125,58.5625
"8994","30165","2014",5,4,1,242026,1766.8,129.6
"8995","30166","2014",20,18,2,166436.25,1856.75,91.95
"8996","30167","2014",3,3,0,136310,1363.66666666667,94.6666666666667
"8997","30168","2014",9,9,0,115944.444444444,1521.55555555556,74.1111111111111
"8998","30169","2014",40,36,4,183995.35,1920.075,98.7
"8999","30170","2014",1,1,0,155000,969,160
"9000","30171","2014",12,8,4,122625,1499.167,83.91667
"9001","30172","2014",6,6,0,208366.7,2218,97.16667
"9002","30173","2014",9,9,0,184300,1929,107.2222
"9003","30174","2014",17,17,0,239645.3,2218.176,108.7059
"9004","30175","2014",1,1,0,130000,4815,27
"9005","30176","2014",4,3,1,53750,938.75,56.75
"9006","30177","2014",1,1,0,213500,2053,104
"9007","30178","2014",6,6,0,172083.3,1756.833,97.16667
"9008","30179","2014",39,39,0,155612.7,1645.359,96.97436
"9009","30180","2014",3,3,0,135000,1290.667,106.6667
"9010","30181","2014",5,5,0,193700,2142.6,94
"9011","30182","2014",11,9,2,157781.8,1561.727,96.09091
"9012","30183","2014",6,6,0,163212.2,1766.167,91.16667
"9013","30184","2014",15,15,0,177123,1801.133,96.8
"9014","30185","2014",13,13,0,206206.2,1894.538,119.8462
"9015","30186","2014",15,15,0,331782,2400.4,139.0667
"9016","30187","2014",2,2,0,65550,1537.5,42.5
"9017","30188","2014",5,5,0,178580,1668,109.2
"9018","30189","2014",1484,418,1066,138156.5,1909.816,70.96563
"9019","30191","2014",9,8,1,170223.1,2007.111,87.66667
"9020","30192","2014",3,3,0,266666.7,1710.333,161.6667
"9021","30193","2014",4,3,1,152337.5,1161,127.75
"9022","30194","2014",4,4,0,129375,1085.25,118
"9023","30195","2014",1,1,0,212950,1365,156
"9024","30196","2014",2,2,0,280000,2147,132.5
"9025","30198","2014",3,2,1,97333.33,689.3333,138.6667
"9026","30199","2014",2,2,0,239397.5,2371,100
"9027","30200","2014",10,10,0,191509.5,2095.6,112.2
"9028","30201","2014",1,1,0,363636,2474,147
"9029","30202","2014",91,72,19,137078.3,1580.308,85.24176
"9030","30203","2014",4,4,0,117902.5,1434.5,80.75
"9031","30204","2014",2,2,0,110000,1344,83.5
"9032","30205","2014",1,1,0,163000,1895,86
"9033","30206","2014",32,32,0,239934.8,2405.719,102.0938
"9034","30207","2014",5,5,0,154000,1473.8,107.8
"9035","30209","2014",27,25,2,295981.5,2783.444,103.9259
"9036","30210","2014",30,27,3,144850.3,1769.433,83.9
"9037","30211","2014",25,23,2,195123.4,2371.76,88.84
"9038","30212","2014",17,12,5,175337.2,2184.588,85.52941
"9039","30213","2014",1,1,0,510000,2684,190
"9040","30214","2014",15,12,3,170846.7,1718.133,98.66667
"9041","30215","2014",7,7,0,179081.1,1497.714,115.1429
"9042","30216","2014",6,4,2,101250,1066.167,98.33333
"9043","30217","2014",65,59,6,236690,2406.877,100.1385
"9044","30218","2014",6,6,0,164670,2686.333,65.5
"9045","30219","2014",1,1,0,345000,1725,200
"9046","30221","2014",30,24,6,176132,2014.6,90.83333
"9047","30222","2014",2,2,0,247300,2826,88
"9048","30223","2014",30,30,0,182829.7,1992.567,96.63333
"9049","30224","2014",4,4,0,181625,1827.5,96.5
"9050","30225","2014",5,5,0,229797.8,1646,138.4
"9051","30226","2014",7,7,0,179862.1,1860.286,103
"9052","30227","2014",26,20,6,140277.3,1571.692,87
"9053","30228","2014",17,17,0,179283.2,2038.882,92.05882
"9054","30229","2014",9,9,0,68558.78,1108.667,66
"9055","30230","2014",8,8,0,128637.5,1816.125,71.625
"9056","30231","2014",12,8,4,85295.58,1211.917,67.33333
"9057","30232","2014",2,2,0,517985,2566.5,203
"9058","30233","2014",2,2,0,129250,1332,106
"9059","30234","2014",1,1,0,89900,1249,72
"9060","30235","2014",9,8,1,135806.7,1608.444,86
"9061","30237","2014",4,3,1,114695.2,1252,91.25
"9062","30238","2014",1,1,0,120000,2000,60
"9063","30239","2014",5,4,1,182280,1924.4,92
"9064","30240","2014",3,3,0,108953.3,1999.333,52.33333
"9065","30241","2014",16,16,0,175709.8,1928.688,96
"9066","30242","2014",2,2,0,542052.5,2288,218
"9067","30243","2014",27,24,3,165344.1,1980.37,88.81481
"9068","30244","2014",5,5,0,245500,2245.4,106.2
"9069","30245","2014",6,6,0,169290.2,2354.667,77.16667
"9070","30247","2014",5,5,0,150020,2049.4,74.2
"9071","30248","2014",5,5,0,167800,1902.4,88.6
"9072","30249","2014",7,5,2,229944.9,2290.286,98.14286
"9073","30250","2014",2,2,0,187000,2650.5,72.5
"9074","30251","2014",6,6,0,133766.7,1559.833,84.83333
"9075","30252","2014",2,2,0,1205000,7594,120
"9076","30253","2014",9,9,0,92888.89,1449,66.11111
"9077","30254","2014",8,8,0,144858.5,1773.875,84.5
"9078","30255","2014",14,14,0,131757.1,1432.5,95.42857
"9079","30256","2014",9,9,0,183888.9,1765.889,112.8889
"9080","30257","2014",16,13,3,141438.9,1755.188,85.75
"9081","30258","2014",96,83,13,166650,1975.74,84.19792
"9082","30259","2014",27,25,2,173851.9,1951.37,94.55556
"9083","30260","2014",11,9,2,275090.9,2539.727,118.4545
"9084","30261","2014",1,1,0,421980,2813,150
"9085","30262","2014",1,1,0,124000,1127,110
"9086","30263","2014",27,20,7,161764.3,1786.926,99
"9087","30264","2014",1,1,0,496000,1472,337
"9088","30265","2014",3,3,0,184706.7,1797.333,101.3333
"9089","30266","2014",9,9,0,153605.6,1646,96.55556
"9090","30267","2014",5,5,0,157930,1368,111.2
"9091","30268","2014",4,1,3,149820,1540.75,82.25
"9092","30269","2014",18,15,3,169742.8,1999.889,94.88889
"9093","30270","2014",6,6,0,178833.3,1746.833,102.8333
"9094","30271","2014",5,5,0,113460,1344,94.8
"9095","30272","2014",1,1,0,50000,581,86
"9096","30273","2014",7,7,0,206171.7,1875.143,108.7143
"9097","30274","2014",23,21,2,160980,1792.783,92.73913
"9098","30275","2014",2,2,0,185000,2228,81
"9099","30276","2014",41,40,1,200222.9,2191.902,93.63415
"9100","30277","2014",4,4,0,159300,1519.25,110.75
"9101","30278","2014",21,21,0,257596,2306.524,107.1429
"9102","30279","2014",9,8,1,191277.8,2066.778,90.11111
"9103","30280","2014",1,0,1,70000,1061,66
"9104","30281","2014",11,10,1,198913.6,1914.364,105.2727
"9105","30282","2014",3,3,0,234766.7,2434.333,90.33333
"9106","30283","2014",2,2,0,77500,1471.5,65.5
"9107","30284","2014",22,20,2,144397.7,1511.5,96.40909
"9108","30285","2014",7,7,0,193000,1940.571,104.1429
"9109","30286","2014",7,7,0,333674.3,2901.857,112.5714
"9110","30287","2014",5,5,0,140830,1688.4,88.6
"9111","30290","2014",11,10,1,292309.1,2290,113.6364
"9112","30292","2014",1,1,0,208000,3467,60
"9113","30293","2014",2,2,0,131657,1735,77
"9114","30294","2014",24,23,1,197468.8,1956.833,102.2083
"9115","30295","2014",34,30,4,237234.3,2418.647,97.55882
"9116","30296","2014",3,3,0,174000,1980,78.33333
"9117","30297","2014",2,2,0,64750,1183,52.5
"9118","30298","2014",2,2,0,125000,1147,108
"9119","30300","2014",8,6,2,207496.2,1702.5,120
"9120","30301","2014",6,6,0,217880,2552.833,77.16667
"9121","30302","2014",13,13,0,248307.7,2380.385,106.4615
"9122","30303","2014",8,8,0,146500,1608.125,91.75
"9123","30304","2014",1,1,0,178000,2342,76
"9124","30305","2014",17,13,4,134435.3,1547.235,91.58824
"9125","30306","2014",3,3,0,315000,2196,152.6667
"9126","30307","2014",9,6,3,105050,1228.667,85.88889
"9127","30308","2014",7,7,0,301122.9,2656,114.1429
"9128","30309","2014",2,2,0,187470,1578.5,119
"9129","30310","2014",3,3,0,232233.3,1877.333,115
"9130","30311","2014",14,10,4,142835.7,1502.286,98.57143
"9131","30312","2014",11,9,2,270454.5,2583.636,101
"9132","30313","2014",4,4,0,144250,1639.5,90
"9133","30314","2014",2,2,0,146250,3107,67.5
"9134","30315","2014",21,21,0,198823.8,2087.667,95.33333
"9135","30316","2014",3,3,0,106833.3,1408,78.66667
"9136","30317","2014",26,23,3,162606.7,1901.423,86.34615
"9137","30319","2014",5,5,0,320916,2550,126.2
"9138","30320","2014",3,3,0,305400,1808.667,151.3333
"9139","30321","2014",41,27,14,161426.8,2066.683,80.65854
"9140","30322","2014",3,2,1,250000,3688,111.3333
"9141","30324","2014",3,3,0,122966.7,1432.667,87
"9142","30325","2014",10,5,5,78975,1052.2,69.6
"9143","30326","2014",13,10,3,204396.7,2284.538,91.07692
"9144","30328","2014",8,8,0,190961.2,2190,90.625
"9145","30329","2014",3,3,0,150833.3,4242,79.33333
"9146","30330","2014",7,6,1,300357.1,3162.571,96.71429
"9147","30331","2014",14,13,1,189670.6,1724.714,107.3571
"9148","30332","2014",1,1,0,40000,667,60
"9149","30333","2014",44,33,11,180781.5,2103.432,85.18182
"9150","30334","2014",134,71,63,221177.8,2757.127,83.24627
"9151","30335","2014",1,1,0,170000,1700,100
"9152","30336","2014",13,11,2,172811.5,2333,90.38462
"9153","30337","2014",2,2,0,230750,2270,102
"9154","30338","2014",2,2,0,283250,2718,106
"9155","30339","2014",20,15,5,89217.5,1393.1,70.15
"9156","30340","2014",6,6,0,219747.5,2679.333,92.83333
"9157","30341","2014",76,57,19,167168.2,1884.842,87.92105
"9158","30342","2014",7,7,0,190014.3,1980.286,96.71429
"9159","30343","2014",4,4,0,283250,5172.25,60
"9160","30344","2014",45,38,7,207813.1,2314.489,94.2
"9161","30345","2014",3,3,0,76333.33,1265.333,60.66667
"9162","30346","2014",20,18,2,223251.3,2186.35,99
"9163","30347","2014",12,12,0,181066.7,2210.5,85.16667
"9164","30348","2014",11,11,0,179481.8,1649,111.0909
"9165","30349","2014",1,1,0,212000,2186,97
"9166","30350","2014",30,16,14,129548.3,1483.433,88.83333
"9167","30351","2014",121,82,39,256653.1,2844.76,90.45455
"9168","30353","2014",1,1,0,50000,1136,44
"9169","30354","2014",2,2,0,206261,1969,105
"9170","30355","2014",3,2,1,120000,1451.667,79.33333
"9171","30356","2014",20,20,0,210382.5,2101.4,99.3
"9172","31002","2014",1,1,0,174400,2180,80
"9173","31003","2014",10,9,1,357693,3122.8,116.2
"9174","31004","2014",24,23,1,231701.8,2152.583,108.4583
"9175","31005","2014",2,2,0,179000,1327.5,125
"9176","31006","2014",1,1,0,2e+05,1361,147
"9177","31008","2014",3,3,0,168666.7,1709.667,101
"9178","31009","2014",3,3,0,72540,907.3333,80.66667
"9179","31011","2014",3,3,0,89516.67,1191.333,75.66667
"9180","31012","2014",3,3,0,60000,938.3333,58.66667
"9181","31013","2014",3,3,0,70000,678,106.3333
"9182","31015","2014",1,1,0,85000,1181,72
"9183","31017","2014",1,1,0,140000,1818,77
"9184","31018","2014",1,1,0,60000,682,88
"9185","31020","2014",12,12,0,83166.67,1082.083,81.83333
"9186","31021","2014",2,2,0,136000,1410,94.5
"9187","31022","2014",127,41,86,152014.2,2313.315,66.01575
"9188","31023","2014",6,6,0,103833.3,791.6667,139.3333
"9189","31024","2014",6,6,0,172500,1780.333,87.16667
"9190","31025","2014",5,5,0,341760,2572.2,134.2
"9191","31026","2014",9,9,0,184329.4,1644.111,120.2222
"9192","31028","2014",11,11,0,136639.6,1358.818,103.6364
"9193","31032","2014",41,31,10,236100.1,2314.902,101.4878
"9194","31033","2014",3,3,0,198166.7,2052,94
"9195","31034","2014",4,4,0,151048.8,801,184.25
"9196","31035","2014",33,12,21,257646.1,3475.606,88.24242
"9197","31036","2014",10,8,2,260612.2,2424,111.3
"9198","31037","2014",11,11,0,150045.5,1897.455,84.81818
"9199","31038","2014",1,1,0,670000,4926,136
"9200","31039","2014",2,2,0,74500,648,116
"9201","31042","2014",103,27,76,107662.1,1997.184,55.95146
"9202","31044","2014",167,80,87,264987.6,2858.371,91.55689
"9203","31045","2014",3,3,0,105000,1147.667,91.66667
"9204","31048","2014",18,16,2,220732.8,2035.778,113.5556
"9205","31050","2014",4,4,0,161750,1285.75,128.75
"9206","31051","2014",3,3,0,248973.3,1828.667,139.6667
"9207","31052","2014",5,5,0,186010,1852,113.8
"9208","31054","2014",1,1,0,115000,1386,83
"9209","31055","2014",3,3,0,315866.7,2370.333,138.6667
"9210","31056","2014",46,30,16,220418.4,2443.457,89.65217
"9211","31057","2014",8,6,2,227920,2502.5,102
"9212","31058","2014",1,1,0,220000,2418,91
"9213","31059","2014",1,1,0,2e+05,840,238
"9214","31060","2014",1,1,0,165000,1447,114
"9215","31061","2014",2,2,0,388275,2491,148.5
"9216","31063","2014",1,1,0,161500,1233,131
"9217","31065","2014",23,22,1,192291.3,1794.696,111.6957
"9218","31066","2014",25,21,4,177608,1899.12,94.8
"9219","31069","2014",320,110,210,182783.5,2546.516,72.675
"9220","31070","2014",2,2,0,165000,1412.5,113
"9221","31071","2014",3,2,1,133288.3,1661.333,80
"9222","31072","2014",1,1,0,111000,1500,74
"9223","31073","2014",3,3,0,156316.7,1541,118
"9224","31074","2014",1,1,0,166400,1353,123
"9225","31075","2014",12,12,0,277733.1,2534.917,109.6667
"9226","31076","2014",1,1,0,55000,688,80
"9227","31077","2014",4,4,0,168609.8,1827.25,91.75
"9228","31078","2014",1,1,0,254420,1311,194
"9229","31079","2014",35,35,0,231665,2186.543,107.2857
"9230","31080","2014",10,9,1,161200,1518.6,109.6
"9231","31082","2014",6,6,0,294533.3,2370.833,127.8333
"9232","31083","2014",3,3,0,113333.3,865,132
"9233","31084","2014",8,8,0,121784.4,1344.5,92.5
"9234","31085","2014",16,16,0,78148.44,1175.875,71.875
"9235","31087","2014",1,1,0,255802,1599,160
"9236","31088","2014",15,14,1,301043,3042.2,100.8667
"9237","31089","2014",6,6,0,309251.7,2167.5,136
"9238","31090","2014",3,3,0,143333.3,1305.333,107.6667
"9239","31091","2014",1,1,0,258000,1940,133
"9240","31093","2014",6,6,0,228563.3,2499.833,90.16667
"9241","31094","2014",25,24,1,183262,2009.64,104.88
"9242","31095","2014",2,2,0,146500,1030.5,152
"9243","31096","2014",2,2,0,170550,1233,129.5
"9244","31097","2014",1,1,0,208900,1559,134
"9245","31098","2014",7,7,0,160885.7,1649.143,98.42857
"9246","31099","2014",2,2,0,109300.5,1365.5,77
"9247","31100","2014",24,24,0,176568.9,1668,110.9167
"9248","31101","2014",4,4,0,213069.5,1835.5,124.25
"9249","31103","2014",2,2,0,214300,1142.5,237
"9250","31104","2014",8,8,0,168939.1,1714.5,101.625
"9251","31105","2014",2,2,0,394425,2860.5,220.5
"9252","31106","2014",15,15,0,209020,1920.533,110.4
"9253","31107","2014",59,52,7,155638.7,1544.678,101.4576
"9254","31108","2014",1,1,0,149000,1380,108
"9255","31109","2014",2,2,0,213000,1646.5,110
"9256","31110","2014",5,5,0,80800,934,87.2
"9257","31111","2014",2,2,0,128500,1506.5,85
"9258","31113","2014",142,54,88,220783.1,2640.007,84.1338
"9259","31115","2014",1,1,0,112000,1191,94
"9260","31116","2014",137,67,70,166692.1,2169.095,76.22628
"9261","31117","2014",24,24,0,305492.5,3087.958,107.9167
"9262","31118","2014",52,43,9,202242.6,2093.269,97.48077
"9263","31119","2014",2,2,0,161500,1501.5,107
"9264","31120","2014",3,3,0,231253.3,2222.667,104
"9265","31124","2014",2,2,0,117000,1393,71
"9266","31126","2014",3,3,0,177491.3,1450,115.3333
"9267","31128","2014",7,7,0,156028.6,1369.714,109.8571
"9268","31131","2014",2,2,0,84000,1038,88.5
"9269","31132","2014",2,2,0,120333.5,996.5,127
"9270","31135","2014",40,36,4,161620.8,1490.9,109.1
"9271","31136","2014",10,8,2,199572,2246,90.9
"9272","31137","2014",1,1,0,258146,1912,135
"9273","31138","2014",2,2,0,85500,904,103.5
"9274","31139","2014",3,3,0,73430,831.3333,90
"9275","31140","2014",4,4,0,141282.2,1631.5,94.75
"9276","31142","2014",7,7,0,130000,1689.571,75.71429
"9277","31144","2014",16,15,1,99962.31,1200,87.0625
"9278","31145","2014",19,18,1,155335.8,1546.632,110.8421
"9279","31147","2014",6,5,1,143908.3,1312.333,103
"9280","31148","2014",4,4,0,364000,2558.5,145.25
"9281","31149","2014",356,186,170,196314.4,2324.666,83.17978
"9282","31150","2014",51,41,10,237661.1,2546.588,94.01961
"9283","31151","2014",5,3,2,227346,2242.2,111.4
"9284","31153","2014",2,2,0,78000,1170.5,65.5
"9285","31155","2014",2,2,0,119000,1027,116
"9286","31156","2014",5,5,0,109000,916,120.8
"9287","31157","2014",209,103,106,192770.6,2380.737,80.17225
"9288","31158","2014",1,1,0,128000,1939,66
"9289","31159","2014",6,6,0,116566.7,920.1667,129
"9290","31160","2014",18,17,1,245066.1,1932.167,127
"9291","31161","2014",5,4,1,257485.6,2660.6,101.8
"9292","31162","2014",7,7,0,200590.7,1865.714,111.4286
"9293","31163","2014",17,12,5,260001.7,2357.588,111
"9294","31164","2014",1,1,0,50000,781,64
"9295","31165","2014",3,3,0,282403.3,2134.333,138.3333
"9296","31166","2014",4,4,0,128473.8,1726.25,74.5
"9297","31167","2014",6,6,0,62666.67,997.6667,80
"9298","31168","2014",1,1,0,125000,1420,88
"9299","31169","2014",44,38,6,293816.8,2765.25,108.1818
"9300","31170","2014",1,1,0,150500,2007,75
"9301","31172","2014",2,2,0,203800,1133,162.5
"9302","31173","2014",2,2,0,217975,1763,123
"9303","31174","2014",8,8,0,78687.5,841.125,94.25
"9304","31175","2014",4,4,0,115646.2,1201.25,97.25
"9305","31176","2014",2,2,0,120750,1636.5,89
"9306","31178","2014",4,4,0,124534.8,1604,73.25
"9307","31179","2014",2,2,0,194350,1564.5,124.5
"9308","31181","2014",11,11,0,240520.7,2209.545,110.0909
"9309","31182","2014",37,24,13,170356.8,2155.865,80.97297
"9310","31183","2014",6,6,0,107100,1184.5,91.5
"9311","31184","2014",4,4,0,404782.5,3517,113.75
"9312","31185","2014",2,2,0,167500,1280,134
"9313","31186","2014",33,23,10,210266.7,2346.879,90.81818
"9314","31187","2014",151,93,58,185383.2,2061.974,86.82781
"9315","31188","2014",25,25,0,273018,2261.16,122.28
"9316","31189","2014",1,1,0,245000,1842,133
"9317","31190","2014",1,1,0,60000,1818,33
"9318","31192","2014",1,1,0,155000,1938,80
"9319","31193","2014",8,8,0,143587.5,1957.75,80.125
"9320","31194","2014",1,1,0,268050,1957,137
"9321","31195","2014",1,1,0,48000,495,97
"9322","31196","2014",3,3,0,175443.7,3707.333,63.33333
"9323","31197","2014",4,4,0,142012.5,1357,107
"9324","31199","2014",2,2,0,33000,660,50
"9325","31202","2014",33,27,6,192299.2,2157.303,93.9697
"9326","31203","2014",72,46,26,218773.3,2569.722,91.76389
"9327","31205","2014",28,10,18,161893.3,2139.714,74.5
"9328","31206","2014",2,2,0,105000,910,134.5
"9329","31208","2014",4,4,0,142500,1575,79
"9330","31209","2014",4,4,0,95750,1091,89.5
"9331","31210","2014",12,12,0,193750,1620.417,130.5833
"9332","31211","2014",2,2,0,249704.5,2307,108.5
"9333","31212","2014",16,11,5,183632.5,1977.5,92.875
"9334","31213","2014",1,1,0,140000,3590,39
"9335","31216","2014",2,2,0,289088,2035,125
"9336","31219","2014",3,3,0,172056.7,1948,88.66667
"9337","31220","2014",5,5,0,133779.2,1122,121
"9338","31221","2014",2,0,2,79051,2026.5,39.5
"9339","31224","2014",15,12,3,89726.67,1197.933,78.53333
"9340","31226","2014",1,1,0,199079,1422,140
"9341","31227","2014",9,9,0,385517.8,2718.667,145.7778
"9342","31228","2014",11,8,3,238512.7,2461.909,95.63636
"9343","31229","2014",5,5,0,192020,1443,113.4
"9344","31230","2014",30,29,1,250726.2,2385,108.0333
"9345","31231","2014",4,4,0,152625,1929,88
"9346","31232","2014",67,60,7,189738.8,2069.478,94.08955
"9347","31233","2014",5,5,0,218830,1919.6,114
"9348","31234","2014",2,2,0,218050,1950,112
"9349","31237","2014",2,2,0,160250,2200,75
"9350","31238","2014",5,5,0,113494,1099.2,103.2
"9351","31239","2014",19,19,0,101576.8,1070.737,102.7368
"9352","31240","2014",8,8,0,232806.2,1912.625,126.875
"9353","31241","2014",2,2,0,121790,1232,104.5
"9354","31243","2014",1,1,0,90000,865,104
"9355","31244","2014",1,1,0,90000,1000,90
"9356","31245","2014",2,2,0,95000,1060,87
"9357","31246","2014",5,5,0,174474,1145,157.8
"9358","31247","2014",9,9,0,142255.6,1956.556,78.55556
"9359","31249","2014",7,7,0,266892.9,2000.571,148.1429
"9360","31250","2014",1,1,0,1e+05,847,118
"9361","31251","2014",2,2,0,167000,1531,110
"9362","31252","2014",18,16,2,220663.8,2288.833,96
"9363","31253","2014",29,26,3,207353.9,2125.207,100.5517
"9364","31254","2014",19,15,4,252257.6,2699.842,97.57895
"9365","31255","2014",2,2,0,77500,749,93
"9366","31256","2014",1,1,0,220000,2292,96
"9367","31258","2014",3,3,0,139000,1416.333,103
"9368","31259","2014",16,15,1,308735.8,2679.562,116.25
"9369","31261","2014",6,6,0,229771.7,2016.667,116.5
"9370","31262","2014",5,5,0,271070,2109,122.4
"9371","31263","2014",28,28,0,168100.5,1901,90.57143
"9372","31264","2014",3,3,0,220133.3,2191,100
"9373","31265","2014",4,4,0,137337.5,1605,103
"9374","31268","2014",1,1,0,110000,940,117
"9375","31269","2014",4,4,0,215862.5,2335.75,96.25
"9376","31270","2014",6,6,0,154162.7,1207.167,125.8333
"9377","31271","2014",12,10,2,242652.5,2065.75,119.0833
"9378","31273","2014",15,13,2,309913.3,2352,135.3333
"9379","31275","2014",1,1,0,114000,1520,75
"9380","31276","2014",2,2,0,120000,1801,68.5
"9381","31277","2014",13,13,0,256801.2,2340.231,113.7692
"9382","31278","2014",6,6,0,124618.5,1284.667,99.83333
"9383","31280","2014",4,4,0,125500,1353,97.25
"9384","31281","2014",11,9,2,179658.5,1649.818,114.3636
"9385","31282","2014",62,41,21,190005.3,2312.968,82.09677
"9386","31283","2014",1,1,0,167000,1988,84
"9387","31284","2014",7,6,1,414901.3,2631.429,159.1429
"9388","31285","2014",4,4,0,318850,2332.25,136.25
"9389","31286","2014",5,5,0,201600.2,1419.2,138
"9390","31287","2014",16,15,1,192565.8,2255.812,84.3125
"9391","31288","2014",6,6,0,131073.3,1379.833,88
"9392","31289","2014",2,2,0,132500,1141.5,128
"9393","31290","2014",1,1,0,89481,895,100
"9394","31291","2014",80,56,24,225891.3,2320.975,97.575
"9395","31292","2014",1,1,0,180000,5143,35
"9396","31293","2014",29,20,9,190343.1,2119.897,90.65517
"9397","31294","2014",1,1,0,44000,407,108
"9398","31296","2014",2,2,0,163750,1091,200
"9399","31297","2014",22,21,1,218125,2069.318,109.4091
"9400","31299","2014",23,23,0,238454.5,1852.391,135.6522
"9401","31300","2014",1,1,0,60000,706,85
"9402","31301","2014",1,1,0,205000,1934,106
"9403","31302","2014",1,1,0,136650,1220,112
"9404","31303","2014",24,23,1,179722.2,1847.667,102.375
"9405","31304","2014",2,2,0,142750,1058.5,191
"9406","31306","2014",3,3,0,126111,1170,110.6667
"9407","31310","2014",3,3,0,153333.3,1278.667,115
"9408","31311","2014",9,8,1,191133.3,1801.556,113.7778
"9409","31314","2014",8,8,0,116912.5,1123.125,104.875
"9410","31315","2014",3,3,0,161366.7,1345.667,151
"9411","31316","2014",2,2,0,66500,1212.5,50
"9412","31317","2014",5,5,0,174060,1516.4,123.8
"9413","31318","2014",1,1,0,140000,1386,101
"9414","31320","2014",8,8,0,216481.2,2083.875,104.5
"9415","31321","2014",1,1,0,135000,1350,100
"9416","31322","2014",2,2,0,152500,1041.5,150
"9417","31324","2014",20,18,2,127246.5,1465.75,93.2
"9418","31325","2014",2,2,0,281450,1710.5,174
"9419","31327","2014",2,2,0,149060,1153,127.5
"9420","31328","2014",7,7,0,226452.9,1711.714,128.1429
"9421","31331","2014",3,3,0,306316.7,1584,193.3333
"9422","31332","2014",2,2,0,138750,1625,85
"9423","31334","2014",6,6,0,231139.2,1874.5,124.8333
"9424","31336","2014",6,6,0,108789,1097.167,93.33333
"9425","31337","2014",4,4,0,102500,1560,65.5
"9426","31338","2014",2,2,0,192500,1973,99
"9427","31339","2014",1,1,0,210000,1875,112
"9428","31341","2014",29,23,6,243430.1,2187.069,109.4138
"9429","31342","2014",6,6,0,96933.33,1236,76.83333
"9430","31344","2014",2,2,0,123525,1278.5,100
"9431","31345","2014",16,16,0,231703.8,2044.375,119.125
"9432","31346","2014",13,13,0,172516.8,1786.769,97
"9433","31347","2014",2,2,0,107000,1027.5,104
"9434","31349","2014",4,4,0,166200,1670.25,100
"9435","31351","2014",45,34,11,208630.5,2323.378,92.75556
"9436","31355","2014",14,14,0,386557.1,3168.071,130.3571
"9437","31356","2014",7,6,1,226474.3,2422,99.85714
"9438","31357","2014",3,3,0,120666.7,1356,90
"9439","31358","2014",31,25,6,217088.2,1959.226,114.7097
"9440","31360","2014",4,3,1,142057.5,1780.5,79.25
"9441","31361","2014",4,4,0,189775,1473.75,124.75
"9442","31362","2014",2,2,0,73750,1066,75.5
"9443","31363","2014",3,3,0,130333.3,1124.333,127.6667
"9444","31364","2014",1,1,0,220000,1571,140
"9445","31365","2014",2,2,0,92500,1682,55
"9446","31366","2014",3,3,0,223361.3,1863,126.3333
"9447","31367","2014",1,1,0,144000,2182,66
"9448","31368","2014",2,2,0,125000,1732.5,71.5
"9449","31370","2014",1,1,0,155000,1336,116
"9450","31371","2014",1,1,0,203200,1722,118
"9451","31372","2014",6,6,0,121816.7,1174.667,98.16667
"9452","31374","2014",10,9,1,247839,1847.6,131.1
"9453","31375","2014",35,35,0,173588.9,1816.457,100.1714
"9454","31376","2014",1,1,0,50000,1724,29
"9455","31377","2014",1,1,0,250000,1488,168
"9456","31380","2014",7,7,0,225457.1,1665.714,130.2857
"9457","31381","2014",22,22,0,237635.9,2076.773,117.1818
"9458","31382","2014",2,2,0,161500,1902.5,88
"9459","31383","2014",8,8,0,232677.5,2112.875,112.375
"9460","31384","2014",6,6,0,231037.8,2411.667,95.33333
"9461","31385","2014",3,3,0,81666.67,1047.667,73.66667
"9462","31386","2014",1,1,0,329903,3299,100
"9463","31389","2014",35,21,14,207743,2460.457,81.88571
"9464","31390","2014",19,17,2,79586.58,1075.263,73.26316
"9465","31391","2014",3,3,0,91988.33,749,124
"9466","31392","2014",1,1,0,92000,1108,83
"9467","31395","2014",218,125,93,165325.6,2064.312,79.01835
"9468","31396","2014",27,25,2,221106,1983.259,115.1111
"9469","31398","2014",3,3,0,313166.7,1653.667,184.3333
"9470","31399","2014",16,16,0,197577.5,1690.25,122.125
"9471","31400","2014",1,1,0,565000,1583,357
"9472","31401","2014",2,2,0,217150,1801,121
"9473","31402","2014",4,4,0,365350,2861,126.5
"9474","31403","2014",4,4,0,228735,1762.75,145
"9475","31404","2014",1,1,0,270000,2000,135
"9476","31405","2014",1,1,0,62800,1142,55
"9477","31406","2014",5,5,0,116960,1477.6,84.4
"9478","31407","2014",10,10,0,195651,1938.8,95.4
"9479","31408","2014",1,1,0,95300,578,165
"9480","31410","2014",25,21,4,248665.6,2208.64,114.08
"9481","31411","2014",4,4,0,347300,2501.75,143.25
"9482","31413","2014",5,5,0,205540,1877.4,116.6
"9483","31414","2014",1,1,0,80000,1053,76
"9484","31416","2014",1,1,0,210050,2165,97
"9485","31417","2014",57,43,14,270608.8,2670.825,99.52632
"9486","31418","2014",2,2,0,321000,3279,98.5
"9487","31420","2014",53,17,36,164917,2212.113,76.81132
"9488","31421","2014",26,24,2,195629.2,2213.846,89.15385
"9489","31422","2014",1,1,0,135000,1286,105
"9490","31423","2014",4,4,0,145075,1659.5,114
"9491","31424","2014",147,117,30,239104.9,2459.565,97.65306
"9492","31425","2014",8,8,0,100731.2,1304.5,77.375
"9493","31426","2014",5,5,0,119400,1020.4,118.2
"9494","31427","2014",3,3,0,122833.3,1002.333,118
"9495","31429","2014",18,9,9,217821.7,2374.333,90.55556
"9496","31430","2014",2,2,0,119892.5,969,122.5
"9497","31431","2014",2,2,0,69000,669.5,100
"9498","31433","2014",88,66,22,195272.8,2224.648,89.71591
"9499","31435","2014",8,8,0,223793.8,1857.25,128.375
"9500","31436","2014",2,2,0,151500,1531.5,99
"9501","31437","2014",1,1,0,515000,4905,105
"9502","31439","2014",3,3,0,346983.3,2341.667,151.6667
"9503","31442","2014",4,4,0,123000,1740,69
"9504","31443","2014",3,3,0,112113.3,987.6667,126.3333
"9505","31444","2014",1,1,0,153700,1727,89
"9506","31445","2014",54,35,19,236346.4,2672.593,89.16667
"9507","31446","2014",169,26,143,140134.5,2160.586,62.42012
"9508","31447","2014",1,1,0,30000,375,80
"9509","31448","2014",4,4,0,366132.5,2232,171
"9510","31449","2014",2,2,0,100500,1397,75.5
"9511","31450","2014",7,5,2,212771.4,1724.857,120.1429
"9512","31451","2014",84,71,13,142684.8,1585.429,93.89286
"9513","31452","2014",1,1,0,55000,385,143
"9514","31454","2014",19,17,2,165333.9,1804.632,98.89474
"9515","31455","2014",28,28,0,171119.6,1501.571,113.4643
"9516","31457","2014",10,10,0,100450,938.3,114.1
"9517","31458","2014",20,16,4,214971,2305,99.4
"9518","31459","2014",6,6,0,223327.5,1890.167,141.1667
"9519","31460","2014",24,23,1,231568.8,2357.667,99.70833
"9520","31461","2014",1,1,0,88000,907,97
"9521","31464","2014",1,1,0,2e+05,1342,149
"9522","31465","2014",1,1,0,260000,5000,52
"9523","31466","2014",5,5,0,205378,1979.2,103
"9524","31467","2014",29,25,4,209979.7,2354.345,90.7931
"9525","31469","2014",1,1,0,180000,1765,102
"9526","31470","2014",6,0,6,51503.33,1924.333,27.16667
"9527","31471","2014",2,2,0,109740,618.5,174.5
"9528","31472","2014",1,1,0,112900,753,150
"9529","31473","2014",4,4,0,203670.2,1880.75,115
"9530","31474","2014",2,2,0,63750,865.5,81.5
"9531","31475","2014",9,8,1,192763.3,1900.889,105.6667
"9532","31476","2014",4,4,0,195413.2,1825.5,105.5
"9533","31477","2014",1,1,0,74600,583,128
"9534","31478","2014",9,9,0,166011.1,1282.556,130.6667
"9535","31479","2014",2,2,0,84500,966.5,90.5
"9536","31480","2014",20,17,3,289765,2690.85,115.2
"9537","31481","2014",24,21,3,193647.1,1872.917,103.6667
"9538","31482","2014",1,1,0,230000,2018,114
"9539","31483","2014",84,50,34,98572.14,1182.095,86.41667
"9540","31484","2014",17,13,4,272384.2,2678.882,113.2353
"9541","31485","2014",1,1,0,284000,1893,150
"9542","31486","2014",8,7,1,212119.5,1870.625,111.625
"9543","31487","2014",3,3,0,141666.7,1307,111
"9544","31488","2014",133,72,61,201047.7,2492.045,81.71429
"9545","31489","2014",3,3,0,360000,2164.667,174
"9546","31490","2014",2,2,0,177500,1691.5,107
"9547","31491","2014",2,2,0,70500,928.5,77.5
"9548","31492","2014",4,4,0,150575,1390.75,114
"9549","31493","2014",1,1,0,80000,410,195
"9550","31494","2014",3,3,0,193333.3,1758.333,114
"9551","31495","2014",12,12,0,214062.8,2012.167,106.9167
"9552","31496","2014",2,2,0,184800,967,181
"9553","31497","2014",14,12,2,227572.9,2329.429,100.6429
"9554","31499","2014",75,64,11,183299.3,2043.013,90.68
"9555","31500","2014",10,9,1,162575.5,1810,98.1
"9556","31501","2014",1,1,0,238810,2274,105
"9557","31502","2014",4,4,0,81681.25,849,99.5
"9558","31503","2014",11,10,1,91581.82,998.8182,99
"9559","31504","2014",2,2,0,98000,762.5,120
"9560","31505","2014",4,4,0,99250,1352.5,76.75
"9561","31506","2014",121,67,54,213836.8,2557.653,83.95868
"9562","31507","2014",17,13,4,188979.5,2190.588,88.11765
"9563","31509","2014",1,1,0,195000,1258,155
"9564","31512","2014",6,6,0,3e+05,2215.5,142.5
"9565","31513","2014",5,5,0,110200,933,122.6
"9566","31515","2014",4,4,0,176365,1753.25,105
"9567","31516","2014",12,10,2,174237.5,1844.5,96.25
"9568","31517","2014",19,18,1,161964.7,1612.421,102.5789
"9569","31518","2014",4,4,0,241875,1979,133.75
"9570","31519","2014",1,1,0,90000,1169,77
"9571","31520","2014",1,1,0,260000,2016,129
"9572","31521","2014",1,1,0,74000,366,202
"9573","31522","2014",3,3,0,217746.7,1574.667,151.3333
"9574","31523","2014",15,14,1,129308.3,1135.6,131.6
"9575","31524","2014",1,1,0,117000,992,118
"9576","31525","2014",6,6,0,177575,1621.667,121.3333
"9577","31526","2014",70,58,12,234808.9,2493.243,96.31429
"9578","31527","2014",3,3,0,370566.7,2345.333,155.3333
"9579","31530","2014",2,2,0,2e+05,1592,126
"9580","31531","2014",3,3,0,149883.3,1247.667,99.33333
"9581","31532","2014",1,1,0,60000,600,100
"9582","31533","2014",9,9,0,269150.9,2326.667,119
"9583","31534","2014",1,1,0,232900,2617,89
"9584","31535","2014",5,5,0,109400,1090,124.4
"9585","31536","2014",2,2,0,171500,1017.5,171.5
"9586","31540","2014",2,2,0,153390,3199.5,65
"9587","31541","2014",69,24,45,200499.3,2580.855,76.46377
"9588","31542","2014",2,2,0,135000,1212.5,111.5
"9589","31543","2014",2,2,0,135000,1319.5,105
"9590","31544","2014",6,6,0,59563.33,722.3333,90.33333
"9591","31545","2014",2,2,0,88000,1106,86.5
"9592","31546","2014",1,1,0,231000,2852,81
"9593","31547","2014",56,48,8,214022.2,2169.929,101.1964
"9594","31548","2014",3,3,0,97566.67,1400,67.33333
"9595","31550","2014",5,5,0,126600,1174,105.2
"9596","31551","2014",1,1,0,264000,1913,138
"9597","31553","2014",7,5,2,186708.3,2483.286,77.57143
"9598","31554","2014",3,3,0,159666.7,1592.333,97.66667
"9599","31555","2014",6439,991,5448,170070.5,2760.857,62.16819
"9600","31556","2014",1,1,0,129180,1230,105
"9601","31557","2014",251,152,99,255492.7,2828.602,89.5259
"9602","31558","2014",2,2,0,233250,2132,109.5
"9603","31559","2014",1,1,0,145000,1036,140
"9604","31560","2014",2,2,0,261750,2319.5,114.5
"9605","31561","2014",128,98,30,252250.6,2725.195,96.79688
"9606","31563","2014",15,15,0,241402.2,2083.533,113.8667
"9607","31565","2014",7,7,0,104597.1,1388.143,81
"9608","31566","2014",3,3,0,212600,2144.333,98.66667
"9609","31567","2014",3,3,0,249000,2339.667,105.6667
"9610","31569","2014",3,3,0,233166.7,1628.667,144
"9611","31570","2014",4,4,0,133250,1038.25,111.5
"9612","31571","2014",2,2,0,178375,1817,106.5
"9613","31572","2014",12,11,1,189267,2395.333,82.25
"9614","31573","2014",29,27,2,213332.8,2136.897,104.2759
"9615","31574","2014",17,17,0,218872.4,2255.765,98.41176
"9616","31575","2014",4,4,0,435892.5,2548.25,173.75
"9617","31576","2014",1,1,0,220500,1378,160
"9618","31577","2014",3,3,0,217100,1928,113.3333
"9619","31578","2014",5,5,0,401217,2778.2,150.2
"9620","31579","2014",2,2,0,247725,2572,97
"9621","31580","2014",2,2,0,179000,1922.5,92.5
"9622","31581","2014",10,10,0,212660.9,1736.5,130
"9623","31582","2014",31,30,1,185064.9,1812.903,110.0323
"9624","31583","2014",9,9,0,217005.6,1999.111,115.1111
"9625","31584","2014",71,61,10,146053.6,1521.479,98.02817
"9626","31585","2014",16,14,2,144203.1,1327.938,121
"9627","31586","2014",2,2,0,113429.5,1241.5,91
"9628","31587","2014",13,13,0,258046.2,2008.462,132.7692
"9629","31588","2014",74,55,19,194296.4,2479.243,81.25676
"9630","31589","2014",10,10,0,199704.8,2157.4,93.5
"9631","31590","2014",2,2,0,114000,1464.5,79
"9632","31591","2014",2,2,0,68000,920.5,72.5
"9633","31592","2014",8,8,0,219801.5,2163,103.875
"9634","32001","2014",10,10,0,116700,1187.5,100.6
"9635","32003","2014",1,1,0,260000,1871,139
"9636","32004","2014",2,2,0,104350,1336.5,77
"9637","32005","2014",1,1,0,135000,906,149
"9638","32007","2014",1,1,0,108920,1147,95
"9639","32008","2014",1,1,0,190000,1597,119
"9640","32010","2014",1,1,0,185000,1370,135
"9641","32012","2014",5,4,1,144800,1551.6,94
"9642","32013","2014",207,123,84,121682.2,1474.749,86.18357
"9643","32014","2014",2,2,0,159000,1824.5,87.5
"9644","32016","2014",3,3,0,278683.3,1774.333,159.3333
"9645","32018","2014",3,3,0,192916.7,1958.333,105
"9646","32019","2014",2,2,0,162000,1738,93
"9647","32020","2014",3,3,0,88333.33,905.3333,98.33333
"9648","32021","2014",1,1,0,110000,1594,69
"9649","32022","2014",2,2,0,101430,2169.5,46.5
"9650","32023","2014",2,2,0,247760.5,1529.5,160
"9651","32024","2014",1,1,0,80000,1067,75
"9652","32025","2014",1,1,0,144000,1600,90
"9653","32026","2014",1,1,0,159000,1767,90
"9654","32027","2014",10,10,0,109990,1321.5,85.6
"9655","32028","2014",2,2,0,67250,930.5,75
"9656","32029","2014",3,3,0,70666.67,720.6667,101.6667
"9657","32030","2014",1,1,0,78200,543,144
"9658","32031","2014",3,3,0,128000,1383.333,86.33333
"9659","32033","2014",1,1,0,181585,1187,153
"9660","32035","2014",1,1,0,90000,592,152
"9661","32036","2014",4,4,0,138550,1237.75,114.75
"9662","32037","2014",1,1,0,179000,1377,130
"9663","32038","2014",3,3,0,207000,2329.667,89.66667
"9664","32040","2014",2,2,0,175965,2143,86.5
"9665","32042","2014",1,1,0,115000,1223,94
"9666","32043","2014",2,2,0,111936,1853.5,69.5
"9667","32045","2014",2,2,0,246416,1551,159
"9668","32046","2014",4,4,0,114072.5,1382.25,89.75
"9669","32048","2014",1,1,0,95000,826,115
"9670","32050","2014",2,2,0,90000,1911,47.5
"9671","32053","2014",2,2,0,231500,1388,152.5
"9672","32054","2014",4,3,1,93750,953,103
"9673","32055","2014",2,2,0,239166.5,1529.5,149
"9674","32057","2014",1,1,0,349603,1748,200
"9675","32059","2014",1,1,0,130000,1625,80
"9676","32064","2014",5,5,0,129000,1129,113.2
"9677","32065","2014",5,4,1,225218,1099.8,210.8
"9678","32066","2014",2,2,0,176343,1004,168
"9679","32068","2014",3,3,0,147333.3,1812,89
"9680","32069","2014",1,1,0,219000,1840,119
"9681","32070","2014",1,1,0,74000,1213,61
"9682","32071","2014",2,2,0,288445,1961.5,152
"9683","32073","2014",1,1,0,40000,615,65
"9684","32076","2014",1,1,0,335350,1677,200
"9685","32077","2014",1,1,0,190000,1407,135
"9686","32078","2014",1,1,0,127000,876,145
"9687","32079","2014",13,13,0,191432.2,1262.923,134.6154
"9688","32080","2014",2,2,0,211675,1385,151.5
"9689","32081","2014",1,1,0,140000,933,150
"9690","32082","2014",4,4,0,89250,1129,72
"9691","32083","2014",9,9,0,121888.9,1451.556,92
"9692","32085","2014",1,1,0,240000,1667,144
"9693","32086","2014",1,1,0,66136,472,140
"9694","32088","2014",1,1,0,61000,762,80
"9695","32090","2014",1,1,0,290000,3258,89
"9696","32092","2014",2,2,0,87500,1171,76.5
"9697","32094","2014",3,3,0,98333.33,675,145.3333
"9698","32095","2014",6,6,0,175872.2,1537.5,115.1667
"9699","32096","2014",39,9,30,61768.59,1261.436,47.35897
"9700","32098","2014",3,2,1,155000,1873.667,82
"9701","32099","2014",1,1,0,226000,1256,180
"9702","32100","2014",2,2,0,255000,1491.5,169
"9703","32101","2014",1,1,0,85000,1214,70
"9704","32102","2014",3,3,0,124333.3,1238.667,106.3333
"9705","32103","2014",2,2,0,175000,1477.5,160
"9706","32104","2014",2,2,0,183531.5,2019.5,90.5
"9707","32106","2014",9,9,0,153681.1,1698,93.22222
"9708","32107","2014",60,56,4,131991.2,1467.383,98.35
"9709","32109","2014",1,1,0,244000,2871,85
"9710","32110","2014",2,2,0,180000,796,245
"9711","32112","2014",2,2,0,208000,1927.5,114.5
"9712","32113","2014",1,1,0,86250,1917,45
"9713","32115","2014",2,2,0,40000,750,47.5
"9714","32117","2014",6,6,0,269550,1782.667,156
"9715","32118","2014",2,2,0,101250,1390,73.5
"9716","32119","2014",24,22,2,162792.5,1524.167,104.2083
"9717","32120","2014",2,2,0,171450,2415,71
"9718","32121","2014",5,5,0,240218,2195.4,108.8
"9719","32123","2014",4,4,0,257873.8,2581.5,114
"9720","32124","2014",1,1,0,168000,1680,100
"9721","32125","2014",2,2,0,108000,991,105
"9722","32127","2014",11,11,0,134531.4,2108.273,94
"9723","32128","2014",1,1,0,192650,1852,104
"9724","32130","2014",3,3,0,139333.3,849,170.6667
"9725","32131","2014",2,2,0,70000,790,95
"9726","32132","2014",67,58,9,116073.7,1184.806,102.1791
"9727","32134","2014",5,5,0,174800,1892.2,96.2
"9728","32135","2014",1,1,0,83500,1575,53
"9729","32136","2014",1,1,0,125000,1420,88
"9730","32138","2014",1,1,0,180000,1406,128
"9731","32139","2014",1,1,0,188000,1393,135
"9732","32141","2014",2,2,0,52500,818,67
"9733","32142","2014",2,2,0,114350,886,129.5
"9734","32143","2014",3,3,0,284000,1596.333,167.3333
"9735","32144","2014",3,3,0,170000,1211,166.3333
"9736","32145","2014",1,1,0,97000,1032,94
"9737","32146","2014",1,1,0,69000,531,130
"9738","32147","2014",30,27,3,142203.1,1502.467,102.5333
"9739","32149","2014",14,14,0,108813.1,951.0714,120.3571
"9740","32150","2014",1,1,0,90000,1000,90
"9741","32152","2014",2,2,0,86000,1285.5,68.5
"9742","32154","2014",1,1,0,250000,2809,89
"9743","32155","2014",6,5,1,107509.5,1020.667,107.3333
"9744","32158","2014",2,2,0,105000,1097,101
"9745","32159","2014",4,4,0,92500,924.75,105.5
"9746","32160","2014",71,56,15,207061.8,2465.732,88.38028
"9747","32162","2014",6,6,0,109833.3,1164.5,106.1667
"9748","32163","2014",3,3,0,85000,960.6667,86.66667
"9749","32164","2014",1,1,0,140500,1544,91
"9750","32165","2014",1,1,0,160000,1818,88
"9751","32167","2014",1,1,0,111870,1364,82
"9752","32171","2014",1,1,0,177000,2329,76
"9753","32172","2014",1,1,0,75200,684,110
"9754","32174","2014",2,2,0,144000,1300,100.5
"9755","32175","2014",1,1,0,234000,1983,118
"9756","32176","2014",1,1,0,202000,2693,75
"9757","32177","2014",1,1,0,294320,1486,198
"9758","32180","2014",2,2,0,233250,1729,135.5
"9759","32181","2014",2,2,0,225000,1395.5,157.5
"9760","32182","2014",2,2,0,172500,1631,103
"9761","32183","2014",2,2,0,216200,1717,128.5
"9762","32184","2014",1,1,0,150000,1220,123
"9763","32186","2014",1,1,0,17400,725,24
"9764","32187","2014",2,2,0,152625,1664.5,91
"9765","32188","2014",1,1,0,145000,1306,111
"9766","32189","2014",1,1,0,220460,1432,154
"9767","32190","2014",5,4,1,175280,1410.4,141.6
"9768","32191","2014",1,1,0,67000,985,68
"9769","32192","2014",2,2,0,76532.5,889,88
"9770","32193","2014",1,1,0,1e+05,962,104
"9771","32194","2014",2,2,0,111500,1438.5,79
"9772","32195","2014",1,1,0,99000,1207,82
"9773","32196","2014",2,2,0,146000,1114.5,118.5
"9774","32197","2014",1,1,0,132000,1100,120
"9775","32198","2014",2,2,0,89500,1105.5,74.5
"9776","32199","2014",3,3,0,134642.3,1536.333,101.3333
"9777","32200","2014",3,3,0,187483.3,1138,156.6667
"9778","32201","2014",1,1,0,280000,2276,123
"9779","32202","2014",5,5,0,146600,1465.6,97
"9780","32203","2014",1,1,0,218000,1847,118
"9781","32204","2014",5,5,0,132136,1421.2,103.2
"9782","32206","2014",2,2,0,145000,1375,105
"9783","32207","2014",2,2,0,264165,1753.5,165
"9784","32208","2014",34,32,2,200877.4,1756.676,109.5294
"9785","32210","2014",4,4,0,248875,1715,145.25
"9786","32211","2014",1,1,0,60000,811,74
"9787","32212","2014",3,3,0,111666.7,914,146
"9788","32213","2014",34,30,4,147203.7,1554.206,96.85294
"9789","32214","2014",2,2,0,150900,1591,104.5
"9790","32216","2014",1,1,0,146300,1463,100
"9791","32219","2014",4,4,0,270906.2,2666.75,137
"9792","32220","2014",2,2,0,81885,963.5,85
"9793","32222","2014",1,1,0,210000,1909,110
"9794","32224","2014",1,1,0,230000,1009,228
"9795","32226","2014",1,1,0,41518,593,70
"9796","32227","2014",2,2,0,242257.5,2084,114
"9797","32230","2014",1,1,0,155000,906,171
"9798","32231","2014",3,3,0,188666.7,1431,133.6667
"9799","32233","2014",15,11,4,151843.3,1267.467,124.5333
"9800","32234","2014",2,2,0,257000,2326,111.5
"9801","32235","2014",2,2,0,287500,1256,178.5
"9802","32236","2014",1,1,0,53000,757,70
"9803","32237","2014",3,3,0,103711.3,1387,81.33333
"9804","32238","2014",1,1,0,180000,1233,146
"9805","32239","2014",4,4,0,406212.5,2161.75,191
"9806","32240","2014",1,1,0,170000,1717,99
"9807","32241","2014",1,1,0,270000,2700,100
"9808","32242","2014",15,15,0,138500,1185.2,115.6667
"9809","32243","2014",1,1,0,222000,1233,180
"9810","32244","2014",2,2,0,101755.5,1221,82.5
"9811","32245","2014",1,1,0,152000,1476,103
"9812","32246","2014",1,1,0,1e+05,833,120
"9813","32247","2014",1,1,0,90000,763,118
"9814","32249","2014",17,17,0,194840.6,1758.824,128.0588
"9815","32252","2014",9,9,0,98188.89,965.2222,103.8889
"9816","32253","2014",8,8,0,101005.6,1066.375,95.625
"9817","32254","2014",2,2,0,224000,1692,139
"9818","32255","2014",2,2,0,77500,712.5,110
"9819","32256","2014",21,18,3,121686.2,1279.286,93.19048
"9820","32260","2014",2,2,0,61320,681.5,90
"9821","32261","2014",2,2,0,286255,1258.5,229.5
"9822","32262","2014",6,5,1,190399.2,1838.5,106.8333
"9823","32264","2014",1,1,0,130000,1111,117
"9824","32265","2014",1,1,0,75000,938,80
"9825","32266","2014",1,1,0,60000,1071,56
"9826","32267","2014",2,2,0,192250,2229,89
"9827","32268","2014",5,5,0,178300,1405.6,138.8
"9828","32269","2014",6,6,0,144975,1674.333,104.3333
"9829","32271","2014",2,2,0,195455,1387,135.5
"9830","32272","2014",3,3,0,90766.67,943.6667,109.3333
"9831","32273","2014",1,1,0,60000,469,128
"9832","32274","2014",5,5,0,87860,1250,76.6
"9833","32275","2014",1,1,0,50000,625,80
"9834","32276","2014",1,1,0,71000,1224,58
"9835","32277","2014",1,1,0,282400,2076,136
"9836","32278","2014",1,1,0,80000,533,150
"9837","32279","2014",2,2,0,192550,1544.5,128.5
"9838","32282","2014",5,5,0,280089.6,1745.8,155.6
"9839","32283","2014",1,1,0,95000,833,114
"9840","32285","2014",5,5,0,127677.8,944.6,162.6
"9841","32286","2014",7,6,1,98280,1083.286,93.28571
"9842","32288","2014",1,1,0,122000,718,170
"9843","32289","2014",4,4,0,97750,1063,94.25
"9844","32290","2014",11,11,0,114954.5,1026.818,115.2727
"9845","32291","2014",1,1,0,80000,1455,55
"9846","32292","2014",2,2,0,208750,1423,149.5
"9847","32293","2014",2,2,0,53050,606.5,88
"9848","32295","2014",1,1,0,309800,1534,202
"9849","32296","2014",15,12,3,93273.33,1378.8,78.4
"9850","32297","2014",2,2,0,224600,1384,195
"9851","32298","2014",3,3,0,193600,1683,105.6667
"9852","32300","2014",1,1,0,122000,1743,70
"9853","32301","2014",7,7,0,243071.4,1853.714,125.7143
"9854","32302","2014",2,2,0,94250,1117.5,78
"9855","32304","2014",3,3,0,152953,1112.667,124.6667
"9856","32305","2014",5,5,0,115270,1108.2,125.2
"9857","32306","2014",6,6,0,114565.2,1058.667,113
"9858","32307","2014",16,16,0,154133.8,1638.875,95.1875
"9859","32308","2014",2,2,0,115000,1458.5,77
"9860","32310","2014",2,2,0,99500,854.5,107
"9861","32311","2014",1,1,0,135563,990,137
"9862","32312","2014",7,7,0,175681.4,1582,122.5714
"9863","32313","2014",1,1,0,260000,1548,168
"9864","32315","2014",1,1,0,295000,1085,272
"9865","32316","2014",1,1,0,160000,1404,114
"9866","32317","2014",1,1,0,130000,1102,118
"9867","32319","2014",8,8,0,101375,1123,90.5
"9868","32320","2014",3,3,0,225000,5080.333,69
"9869","32322","2014",1,1,0,345100,4060,85
"9870","32324","2014",4,4,0,130650,933.5,143.75
"9871","32326","2014",2,2,0,137500,867.5,155
"9872","32328","2014",2,2,0,43500,407,110
"9873","32329","2014",1,1,0,192000,1333,144
"9874","32330","2014",1,1,0,115000,1667,69
"9875","32331","2014",9,9,0,174620.6,1412.556,129.2222
"9876","32333","2014",1,1,0,65000,929,70
"9877","32334","2014",6,5,1,277332.3,2631.667,104.5
"9878","32335","2014",5,5,0,137000,939.2,135.6
"9879","32336","2014",2,2,0,184777.5,1394,135
"9880","32337","2014",1,1,0,170000,2361,72
"9881","32339","2014",2,2,0,313070,2318,134.5
"9882","32340","2014",4,4,0,132000,1250.5,109.5
"9883","32342","2014",1,1,0,72000,766,94
"9884","32344","2014",19,18,1,91289.47,869.6842,112.3158
"9885","32345","2014",7,6,1,167875.1,1686.571,97.28571
"9886","32346","2014",2,2,0,137464.5,1878.5,75.5
"9887","32347","2014",1,1,0,119563,543,220
"9888","32348","2014",5,5,0,169283.6,1608.2,103.8
"9889","32350","2014",1,1,0,80000,833,96
"9890","32351","2014",1,1,0,115000,1533,75
"9891","32352","2014",1,1,0,49000,778,63
"9892","32353","2014",3,3,0,132416.7,1446.333,89.33333
"9893","32355","2014",1,1,0,47000,588,80
"9894","32358","2014",2,2,0,235000,1341.5,177.5
"9895","32359","2014",1,1,0,75000,872,86
"9896","32360","2014",1,1,0,495000,1547,320
"9897","32365","2014",3,3,0,86756.67,959,106
"9898","32368","2014",5,5,0,190400,1848.6,104
"9899","32369","2014",2,2,0,90500,892.5,100.5
"9900","32370","2014",13,13,0,109615.4,1324.077,86.38462
"9901","32373","2014",2,2,0,87500,975.5,92.5
"9902","32374","2014",1,1,0,178000,1328,134
"9903","32376","2014",1,1,0,90000,978,92
"9904","32378","2014",6,6,0,88083.33,1033.5,84.33333
"9905","32379","2014",3,3,0,164333.3,1545.667,107.3333
"9906","32380","2014",1,1,0,144000,1134,127
"9907","32381","2014",1,1,0,80000,1600,50
"9908","32382","2014",1,1,0,295000,2305,128
"9909","32383","2014",3,3,0,242000,1351.667,160.3333
"9910","32384","2014",2,2,0,423035,1797.5,215.5
"9911","32385","2014",2,2,0,177600,1391.5,141
"9912","32388","2014",3,3,0,184950,1603,119.3333
"9913","32389","2014",3,3,0,146000,1836.333,75.66667
"9914","32390","2014",1,1,0,140000,1647,85
"9915","32395","2014",1,1,0,40000,541,74
"9916","32396","2014",2,2,0,138000,1502,91.5
"9917","32397","2014",2,2,0,151000,1697,97
"9918","32399","2014",1,1,0,177000,1553,114
"9919","32400","2014",2,2,0,141765,1081,131
"9920","32404","2014",8,8,0,135475,1193.625,100.5
"9921","32406","2014",2,2,0,117000,1182.5,122.5
"9922","32407","2014",1,1,0,245000,4455,55
"9923","32408","2014",1,1,0,53000,530,100
"9924","32410","2014",21,17,4,142099.4,1466.048,99.04762
"9925","32412","2014",5,5,0,128425,1243.8,112.2
"9926","32414","2014",1,1,0,214000,2301,93
"9927","32415","2014",2,2,0,217000,1293,167.5
"9928","32416","2014",2,2,0,142427.5,1341,112.5
"9929","32417","2014",6,6,0,115491.7,1047.833,113.5
"9930","32418","2014",3,3,0,148231.7,1528.667,116
"9931","32421","2014",1,1,0,262000,1747,150
"9932","32422","2014",1,1,0,186000,1063,175
"9933","32424","2014",4,4,0,132750,1264.25,110.75
"9934","32425","2014",3,3,0,213333.3,2134,96
"9935","32426","2014",8,8,0,135212.5,1488.125,88.75
"9936","32429","2014",1,1,0,135000,1406,96
"9937","32430","2014",1,1,0,31000,431,72
"9938","32431","2014",1,1,0,1e+05,658,152
"9939","32433","2014",4,3,1,125587.5,1360.25,102.75
"9940","32434","2014",1,1,0,139000,1527,91
"9941","32437","2014",3,3,0,158666.7,1349.333,119.3333
"9942","32439","2014",3,3,0,91666.67,1077.333,90.66667
"9943","32440","2014",3,3,0,91666.67,1387,65
"9944","32442","2014",4,4,0,140187.5,1931.75,78.75
"9945","32443","2014",4,4,0,101500,869,121
"9946","32444","2014",2,2,0,215350,1930,117
"9947","32445","2014",1,1,0,235000,2136,110
"9948","32448","2014",4,4,0,144000,1311.75,120.25
"9949","32449","2014",3,3,0,92166.67,1331.667,78.66667
"9950","32450","2014",3,3,0,183333.3,1239.667,139
"9951","32451","2014",4,4,0,159875,1172.25,139.5
"9952","32452","2014",2,2,0,120250,844,145.5
"9953","32454","2014",2,2,0,188500,1612.5,116
"9954","32455","2014",1,1,0,165000,2357,70
"9955","32457","2014",5,5,0,136582,1351,101.2
"9956","32459","2014",4,4,0,106250,1257,91.75
"9957","32460","2014",2,2,0,89000,1072,87.5
"9958","32461","2014",1,1,0,140000,1429,98
"9959","32462","2014",32,32,0,133097.2,1356.312,115.8125
"9960","32463","2014",5,5,0,100500,663.4,142
"9961","32464","2014",2,2,0,79500,824,91.5
"9962","32465","2014",1,1,0,138500,1776,78
"9963","32468","2014",1,1,0,140000,1228,114
"9964","33001","2014",14,13,1,130268.6,1295.786,103
"9965","33002","2014",5,5,0,173400,1527.2,116.4
"9966","33003","2014",119,105,14,182072.8,2117.782,88.89076
"9967","33004","2014",22,18,4,139834.1,1571.545,89.09091
"9968","33005","2014",193,148,45,264800.8,3546.736,79.26425
"9969","33006","2014",13,13,0,108730.8,1149.615,94.76923
"9970","33007","2014",9,9,0,180055.6,1750.333,104
"9971","33009","2014",417,134,283,335404.1,5019.83,66.96882
"9972","33010","2014",3,3,0,195833.3,1906.333,103.6667
"9973","33011","2014",95,72,23,221270.9,3126.126,78.07368
"9974","33012","2014",24,24,0,274411.2,2075.667,130.7917
"9975","33013","2014",51,42,9,232026.5,2493.196,95.5098
"9976","33014","2014",9,9,0,213945.6,1573.333,117.3333
"9977","33015","2014",19,18,1,208789.5,1626.158,126.7368
"9978","33016","2014",3,3,0,183466.7,1830,102.6667
"9979","33017","2014",2,2,0,164000,2235.5,73.5
"9980","33018","2014",18,18,0,166447.1,1733.556,105.4444
"9981","33019","2014",101,81,20,195719.2,2263.871,88.13861
"9982","33020","2014",2,2,0,289900,2099,108
"9983","33021","2014",8,8,0,127712.5,1358.5,94.625
"9984","33022","2014",26,26,0,204522.2,2298.154,97.15385
"9985","33023","2014",6,6,0,272100,2104.833,132.3333
"9986","33024","2014",2,2,0,205000,2206,94
"9987","33025","2014",2,2,0,170775,1666.5,103
"9988","33026","2014",3,3,0,129007.3,1196,103
"9989","33027","2014",5,5,0,151602,1039.8,142
"9990","33028","2014",6,6,0,223341.7,1977.5,113.6667
"9991","33029","2014",62,48,14,198531.2,2197.806,93.98387
"9992","33030","2014",25,23,2,134415.2,1542.12,94.24
"9993","33031","2014",1,1,0,110000,1019,108
"9994","33032","2014",45,38,7,195857.1,2381.867,87.28889
"9995","33033","2014",9,9,0,274472.2,2346.778,120.1111
"9996","33034","2014",3,3,0,136666.7,1315.333,103
"9997","33035","2014",4,4,0,107000,933,115.5
"9998","33036","2014",31,25,6,118887.1,1345.677,90.35484
"9999","33037","2014",14,14,0,169059.3,1608.571,110.0714
"10000","33038","2014",12,12,0,99302.08,965.6667,100.8333
"10001","33039","2014",295,184,111,196105.9,2773.969,72.05424
"10002","33040","2014",9,9,0,140973,1769.222,91.66667
"10003","33042","2014",46,44,2,199962.8,1950.804,101.5217
"10004","33043","2014",1,1,0,90000,818,110
"10005","33044","2014",2,2,0,206100,1944.5,120
"10006","33045","2014",3,3,0,109000,1103,94.33333
"10007","33046","2014",12,12,0,124419.9,1213,103.25
"10008","33047","2014",15,15,0,158751.6,1272.133,101.7333
"10009","33048","2014",2,2,0,219000,2466.5,87.5
"10010","33049","2014",16,16,0,185084.4,1980.125,93.875
"10011","33050","2014",6,6,0,204883.3,1459.833,142.3333
"10012","33051","2014",93,78,15,193278,2272.731,88.67742
"10013","33052","2014",11,10,1,161000,1651.909,96.54545
"10014","33054","2014",1,1,0,86000,1075,80
"10015","33055","2014",2,2,0,164375,1507,112
"10016","33056","2014",115,71,44,199622.3,2370.617,84.14783
"10017","33057","2014",8,8,0,112209.8,1191.125,99.875
"10018","33058","2014",47,38,9,107184.7,1201.085,92.38298
"10019","33059","2014",4,4,0,181000,1903,96.25
"10020","33060","2014",1,1,0,110000,1833,60
"10021","33061","2014",6,6,0,181166.7,1602,114.6667
"10022","33062","2014",9,9,0,146333.3,1637.222,95
"10023","33063","2014",4197,1009,3188,219936.3,3245.335,69.08363
"10024","33064","2014",1,1,0,63000,1050,60
"10025","33065","2014",25,25,0,331505.5,2556.04,123.92
"10026","33067","2014",16,14,2,111843.8,1187.875,98.3125
"10027","33068","2014",1,1,0,178054,1576,113
"10028","33069","2014",362,155,207,260669,2917.986,85.39227
"10029","33070","2014",6,6,0,222061.7,2044.833,107
"10030","33071","2014",7,6,1,129600,1336.714,105.7143
"10031","33072","2014",1,1,0,170000,1250,136
"10032","33073","2014",7,7,0,99757.14,1155.143,98.57143
"10033","33074","2014",1,1,0,130000,570,228
"10034","33075","2014",198,97,101,232835,2796.076,82.06061
"10035","33076","2014",9,6,3,98405.33,1174.222,89
"10036","33077","2014",18,18,0,205365,1958.722,109
"10037","33078","2014",7,7,0,127847.1,1478.143,86.57143
"10038","33079","2014",2,2,0,363500,2168,170.5
"10039","33080","2014",48,37,11,195792,2390.562,85.35417
"10040","33081","2014",21,16,5,134096.7,1648.238,91.2381
"10041","33082","2014",10,10,0,179840,1606.8,111.2
"10042","33083","2014",4,4,0,244070,1945.5,126.5
"10043","33084","2014",8,8,0,216137.5,2150.375,100.5
"10044","33085","2014",26,26,0,249334.4,2458.115,100.7308
"10045","33086","2014",3,3,0,106666.7,1409.333,70.33333
"10046","33087","2014",2,2,0,110000,1023,112.5
"10047","33088","2014",2,2,0,132500,1606.5,83.5
"10048","33089","2014",1,1,0,145600,1040,140
"10049","33090","2014",26,24,2,242290.8,2608.615,94.53846
"10050","33093","2014",4,4,0,187000,1857,99.5
"10051","33094","2014",1,1,0,230000,2150,107
"10052","33095","2014",14,14,0,81741.93,886.8571,89.78571
"10053","33096","2014",88,41,47,165939.1,3981.193,62.625
"10054","33097","2014",53,38,15,185521.1,2766.434,76.37736
"10055","33098","2014",3,3,0,191466.7,1521.667,125.3333
"10056","33099","2014",11,9,2,218488.8,2106.455,102.4545
"10057","33100","2014",9,8,1,123538.9,1829.444,75.55556
"10058","33101","2014",8,8,0,87050,1017.5,90.125
"10059","33104","2014",52,48,4,174325.6,1994.712,88.40385
"10060","33105","2014",1,1,0,175000,1094,160
"10061","33106","2014",5,5,0,170100,1355.8,129.2
"10062","33108","2014",27,25,2,117268,1201.556,98.2963
"10063","33109","2014",27,27,0,194293.6,2097.037,95.2963
"10064","33111","2014",13,11,2,126000,1245.692,101
"10065","33112","2014",2,2,0,75000,633.5,115
"10066","33113","2014",1,1,0,95000,1338,71
"10067","33114","2014",13,12,1,148115.4,1335.923,121.5385
"10068","33115","2014",4,4,0,131570,1091.5,126.75
"10069","33116","2014",5,5,0,127200,1288.8,105.4
"10070","33117","2014",3,3,0,213400,1992.667,108
"10071","33118","2014",18,18,0,288943.6,2448.056,121.6667
"10072","33119","2014",261,118,143,161051.6,2208.563,75.12261
"10073","33120","2014",18,18,0,151361.9,1514.556,99.27778
"10074","33121","2014",3,3,0,126739,859.3333,145.3333
"10075","33122","2014",120,113,7,287375.8,2704.492,108.5083
"10076","33123","2014",18,18,0,166705.3,1518.5,117.7222
"10077","33124","2014",2,2,0,160000,1285,124
"10078","33125","2014",16,15,1,116161.9,1327.125,91.0625
"10079","33126","2014",5,5,0,187250,1700.8,111
"10080","33127","2014",2,2,0,97850,1266,82
"10081","33128","2014",3,3,0,196866.7,2157.667,101
"10082","33129","2014",1,1,0,384000,1477,260
"10083","33130","2014",5,5,0,159423,1613.6,99.2
"10084","33131","2014",2,2,0,101810,788,122
"10085","33132","2014",4,4,0,122391.2,1263.5,100.5
"10086","33133","2014",2,2,0,212500,1340,160.5
"10087","33134","2014",4,4,0,116700,1474.75,82.75
"10088","33135","2014",1,1,0,119800,1641,73
"10089","33136","2014",4,4,0,105000,1073.5,106.5
"10090","33137","2014",4,4,0,131875,1170,126.25
"10091","33138","2014",80,72,8,117947.7,1379.912,89.0125
"10092","33139","2014",2,2,0,282355,1401.5,205
"10093","33140","2014",52,44,8,172771.5,1950.5,90.11538
"10094","33141","2014",3,3,0,191103.3,1917.333,106.3333
"10095","33142","2014",13,13,0,174247.2,1626.923,119.2308
"10096","33143","2014",28,26,2,174272.3,1848.607,95.53571
"10097","33144","2014",6,6,0,219650,1656.833,138.1667
"10098","33145","2014",2,2,0,202000,1796,111
"10099","33146","2014",22,21,1,141470.5,1550.136,91.95455
"10100","33147","2014",5,5,0,161070,1920.4,82.6
"10101","33148","2014",1,1,0,70000,933,75
"10102","33150","2014",2,2,0,148400,1405.5,105.5
"10103","33151","2014",8,8,0,80837.5,982.875,90.625
"10104","33153","2014",3,3,0,229666.7,1433,162.6667
"10105","33154","2014",15,15,0,76468,904.3333,86.26667
"10106","33155","2014",2,2,0,91000,664,137
"10107","33156","2014",3,3,0,449916.7,2380.333,181
"10108","33157","2014",5,5,0,166690,1804.6,93
"10109","33158","2014",2,2,0,145750,1043.5,142.5
"10110","33159","2014",14,14,0,121791.4,1045.929,115.7143
"10111","33160","2014",7,7,0,132180.9,1008.286,138.4286
"10112","33161","2014",5,5,0,126300,1094.2,119
"10113","33162","2014",189,109,80,202801.2,2586.037,81.48148
"10114","33163","2014",4,4,0,209500,1619.25,129.75
"10115","33164","2014",16,16,0,177566.9,1665.25,110.875
"10116","33165","2014",35,23,12,202239.1,2220.257,91.68571
"10117","33166","2014",3,3,0,106000,978,111.6667
"10118","33167","2014",143,99,44,187903.2,2347.252,82.62238
"10119","33168","2014",9,9,0,230633.3,1555.333,152.3333
"10120","33169","2014",2,2,0,75500,666,115
"10121","33170","2014",11,11,0,173345.5,1264.182,137.6364
"10122","33171","2014",1,1,0,150000,1415,106
"10123","33172","2014",2,2,0,137500,1099.5,122.5
"10124","33173","2014",2,2,0,95000,1199,76.5
"10125","33174","2014",11,11,0,359618.2,1841.636,192.5455
"10126","33175","2014",5,5,0,104300,711.4,152.2
"10127","33176","2014",1,1,0,119410,1531,78
"10128","33177","2014",22,22,0,152633.9,1503.727,102.3636
"10129","33178","2014",2,2,0,120900,1195.5,109.5
"10130","33179","2014",34,33,1,146713.7,1521.824,95.41176
"10131","33180","2014",1,1,0,160000,1143,140
"10132","33181","2014",4,3,1,95130,1027.75,103
"10133","33182","2014",9,9,0,98772.56,1080.444,96.88889
"10134","33183","2014",2,2,0,170000,1421,120.5
"10135","33184","2014",2,2,0,177142.5,1367,126.5
"10136","33185","2014",20,19,1,195455,1953.15,103.15
"10137","33186","2014",12,12,0,93384.58,927.5,97.33333
"10138","33187","2014",9,9,0,96288.89,965.5556,108.1111
"10139","33188","2014",1,1,0,174000,1611,108
"10140","33189","2014",3,3,0,250666.7,1430.667,144.6667
"10141","33190","2014",2,2,0,139500,1560,90
"10142","33191","2014",3,3,0,99333.33,1164,90.33333
"10143","33192","2014",263,106,157,201105,2662.422,76.01141
"10144","33193","2014",12,12,0,164433.3,2219.333,84.5
"10145","33194","2014",6,6,0,115966.7,1522.833,81.66667
"10146","33195","2014",8,7,1,102955,916,118.875
"10147","33196","2014",3,3,0,156500,2123,131
"10148","33197","2014",5,5,0,152229.8,1538,104
"10149","33198","2014",19,19,0,117473.7,1284.842,92.47368
"10150","33199","2014",316,264,52,244359.8,2890.392,85.0981
"10151","33200","2014",87,63,24,239186.8,2833.586,87.47126
"10152","33201","2014",6,6,0,234791.7,2321.167,109.3333
"10153","33202","2014",18,18,0,163880.6,1753.278,97.05556
"10154","33203","2014",101,76,25,134555.2,2056.238,70.92079
"10155","33204","2014",4,4,0,104880,1026.5,102.25
"10156","33205","2014",11,11,0,143568.7,1355.455,111.8182
"10157","33206","2014",4,4,0,187887.5,1795.25,101
"10158","33207","2014",60,59,1,208189.9,2116.417,103.2667
"10159","33208","2014",15,14,1,98986.67,1152.933,99.33333
"10160","33209","2014",1,1,0,3e+05,1875,160
"10161","33210","2014",3,3,0,340300,2086.667,154.6667
"10162","33211","2014",2,2,0,139175,1997.5,67.5
"10163","33212","2014",1,1,0,160000,1088,147
"10164","33213","2014",43,40,3,278650.2,2663.837,104.8837
"10165","33214","2014",163,121,42,191852.2,3472.613,59.43558
"10166","33215","2014",1,1,0,90000,647,139
"10167","33216","2014",1,1,0,390000,1560,250
"10168","33218","2014",9,9,0,123000,1131.778,106.4444
"10169","33219","2014",21,18,3,167603.3,1819.762,92.7619
"10170","33220","2014",9,9,0,130787.8,1493.667,92.88889
"10171","33221","2014",8,8,0,77837.5,973.125,86.375
"10172","33222","2014",3,3,0,175333.3,1215.667,138.6667
"10173","33224","2014",2,2,0,245500,1538,165
"10174","33225","2014",18,18,0,153162.8,1576.722,103.7222
"10175","33226","2014",21,21,0,179511.9,1286.476,145.3333
"10176","33227","2014",56,39,17,139863.8,1718.661,85.85714
"10177","33228","2014",4,4,0,226350,1746.5,112.75
"10178","33229","2014",109,88,21,232282.9,3113.183,82.14679
"10179","33230","2014",3,3,0,120116.7,1501.667,81
"10180","33232","2014",1,1,0,134000,1396,96
"10181","33233","2014",13,13,0,151146.9,1409.231,111.1538
"10182","33234","2014",29,26,3,315006.9,2543.034,121.4138
"10183","33236","2014",79,68,11,373449.4,4424.823,95.17722
"10184","33237","2014",6,6,0,153575,1445.833,110.8333
"10185","33238","2014",74,73,1,275886.8,2575.162,110.0676
"10186","33239","2014",3,3,0,162590,1380.667,130.3333
"10187","33240","2014",51,48,3,122184.5,1447.471,88.78431
"10188","33241","2014",3,3,0,165066.7,1341.667,126
"10189","33242","2014",3,3,0,180000,1545.667,124.6667
"10190","33243","2014",288,199,89,151440.4,1857.705,85.97917
"10191","33244","2014",1,1,0,2e+05,2062,97
"10192","33245","2014",6,6,0,267761.7,2728.667,105.3333
"10193","33246","2014",1,1,0,112000,848,132
"10194","33248","2014",24,24,0,161547.7,1500.542,109.5
"10195","33249","2014",138,62,76,156537.1,2043.362,79.85507
"10196","33250","2014",2,2,0,136500,1127,125
"10197","33252","2014",3,3,0,124566.7,1321,106.6667
"10198","33253","2014",9,9,0,138205.6,1255.667,112.6667
"10199","33254","2014",2,2,0,162530,1514.5,107.5
"10200","33255","2014",2,2,0,129850,1204,104.5
"10201","33256","2014",35,29,6,207066.3,2263.171,97.11429
"10202","33257","2014",3,3,0,191666.7,2138,94.33333
"10203","33258","2014",2,2,0,178500,1801.5,98
"10204","33259","2014",6,6,0,144700,1477.333,98.16667
"10205","33260","2014",10,10,0,194640,1825.4,122.6
"10206","33261","2014",5,5,0,125250,1078.2,120.8
"10207","33262","2014",34,30,4,165163,1917.059,92.55882
"10208","33263","2014",4,4,0,203837.5,2051.5,101
"10209","33264","2014",7,7,0,118321.4,1245,101.8571
"10210","33266","2014",11,11,0,163272.7,1514.273,114.8182
"10211","33268","2014",23,20,3,179231.7,1874.783,98
"10212","33269","2014",3,3,0,131666.7,919.3333,142.3333
"10213","33270","2014",2,2,0,220025,1834,127.5
"10214","33272","2014",10,10,0,152447,1464.6,109.8
"10215","33273","2014",46,41,5,274531.6,2854.391,97.04348
"10216","33274","2014",15,13,2,217540.1,2141.2,105.8
"10217","33275","2014",3,3,0,140059.3,1377.667,101
"10218","33277","2014",1,1,0,128000,1707,75
"10219","33278","2014",1,1,0,125000,1543,81
"10220","33279","2014",3,3,0,130400,1392.667,92.33333
"10221","33280","2014",5,5,0,126230,1094.8,112.2
"10222","33281","2014",874,329,545,198140.9,2644.938,74.65446
"10223","33282","2014",3,3,0,135186.7,1114.667,126.3333
"10224","33283","2014",1,1,0,173300,1155,150
"10225","33284","2014",89,84,5,216014.4,2180.989,101.3596
"10226","33285","2014",5,5,0,162796.6,1573.2,105.2
"10227","33287","2014",2,2,0,124000,1978.5,76
"10228","33288","2014",2,2,0,133250,1375.5,93
"10229","33289","2014",20,18,2,119537.5,1132.05,103.9
"10230","33290","2014",16,16,0,129053.1,1172,111.5
"10231","33292","2014",1,1,0,146000,1622,90
"10232","33293","2014",32,29,3,213677.8,2199.031,98.0625
"10233","33294","2014",2,2,0,123000,3126,94
"10234","33296","2014",8,8,0,166893.8,1430.25,118
"10235","33297","2014",15,15,0,177844.7,1734.533,112.0667
"10236","33298","2014",9,9,0,257555.6,1833.556,133
"10237","33299","2014",4,4,0,145750,1308,120
"10238","33300","2014",14,14,0,189716.2,2363.643,95.21429
"10239","33301","2014",2,2,0,95750,1584.5,65
"10240","33302","2014",4,4,0,162262.5,1416.5,114.75
"10241","33304","2014",2,2,0,174250,978,160
"10242","33305","2014",3,3,0,149833.3,1476.667,101.3333
"10243","33306","2014",3,3,0,136666.7,920,155.3333
"10244","33307","2014",14,14,0,198360.9,2168.714,117.0714
"10245","33308","2014",1,1,0,277800,1984,140
"10246","33309","2014",2,2,0,91500,1541,59.5
"10247","33310","2014",3,3,0,141666.7,1271,108.3333
"10248","33311","2014",10,8,2,160873.9,1488.3,113.4
"10249","33312","2014",66,61,5,215775.5,2414.985,97.87879
"10250","33314","2014",41,40,1,101085.4,1304.951,86.90244
"10251","33315","2014",10,10,0,106872.4,1146.2,96.9
"10252","33316","2014",9,9,0,107850,1104,102.8889
"10253","33317","2014",6,6,0,155901.5,1502.5,102.3333
"10254","33318","2014",559,335,224,219805.4,2670.673,83.45796
"10255","33319","2014",3,3,0,75000,1127.333,67
"10256","33320","2014",3,3,0,99333.33,987.6667,102.3333
"10257","33321","2014",15,15,0,160361.4,1606.267,104.9333
"10258","33322","2014",47,45,2,246315.1,2362.468,107.8511
"10259","33324","2014",42,41,1,125725.4,1267.762,98.57143
"10260","33325","2014",16,16,0,108482,1132.5,104.5625
"10261","33326","2014",1,1,0,52000,963,54
"10262","33327","2014",19,18,1,161152.6,1633.842,105.2105
"10263","33328","2014",5,5,0,134700,987,143
"10264","33329","2014",1,1,0,119500,1683,71
"10265","33330","2014",15,14,1,268377.7,2500.6,115.6667
"10266","33332","2014",7,7,0,136842.9,1703.857,83.71429
"10267","33333","2014",20,20,0,223619.2,2128.65,106.75
"10268","33334","2014",18,18,0,178082.8,2007.833,95.72222
"10269","33335","2014",2,2,0,179500,1963,91
"10270","33336","2014",8,8,0,134162.5,1341.875,101.75
"10271","33337","2014",24,23,1,117441.7,1464.25,85.66667
"10272","33339","2014",16,15,1,156644.1,1477.312,110.125
"10273","33341","2014",13,13,0,152256.2,1583.462,95.92308
"10274","33342","2014",12,12,0,208302.2,1964.833,122.8333
"10275","33343","2014",6,6,0,135833.3,1905.167,85.16667
"10276","33344","2014",3,3,0,116583.3,732.6667,142.6667
"10277","33345","2014",5,5,0,142393,1118.8,136.6
"10278","33346","2014",1,1,0,125000,1359,92
"10279","33347","2014",3,2,1,39333.33,665.6667,60.66667
"10280","33348","2014",15,15,0,137746.6,1489.867,90.93333
"10281","33349","2014",18,17,1,284391.7,2134.611,134.7778
"10282","33350","2014",16,16,0,96748.12,1173.5,85.0625
"10283","33351","2014",7,7,0,99980,1092.714,102.4286
"10284","33352","2014",40,40,0,99445,1112.425,99.675
"10285","33353","2014",2,2,0,185900,1442.5,117.5
"10286","33354","2014",1,1,0,305714,1831,167
"10287","33355","2014",6,6,0,154150,1654,102.6667
"10288","33356","2014",4,4,0,125750,1132.75,113
"10289","33357","2014",14,14,0,201246.4,1587.857,123.3571
"10290","33358","2014",2,2,0,169715,1557.5,110
"10291","33360","2014",3,3,0,250366.7,1263,158.6667
"10292","33361","2014",6,6,0,114333.3,1254.333,98.5
"10293","33362","2014",11,11,0,123596.5,1369.091,91.18182
"10294","33363","2014",35,33,2,192249,1995.886,100.4571
"10295","33364","2014",1,1,0,750000,5859,128
"10296","33365","2014",1,1,0,250000,1471,170
"10297","33366","2014",100,92,8,169705.4,1853.75,97.88
"10298","33367","2014",1,1,0,120000,566,212
"10299","33369","2014",6,6,0,400333.3,2139.333,145.5
"10300","33370","2014",5,5,0,151280,2086.2,73
"10301","33373","2014",11,11,0,78313.64,850.0909,90.09091
"10302","33374","2014",6,6,0,116736.7,1056,113.8333
"10303","33375","2014",7,7,0,121571.4,1275.429,101.5714
"10304","33376","2014",42,42,0,382072.7,2746.952,138.5238
"10305","33377","2014",2,2,0,141500,1792,84
"10306","33378","2014",6,6,0,150166.7,1439.667,109.5
"10307","33379","2014",1,1,0,165000,685,241
"10308","33380","2014",9,9,0,96111.11,1140.556,82.11111
"10309","33381","2014",25,24,1,219126.3,2134.28,103.64
"10310","33382","2014",22,22,0,128042.8,1336.727,97.5
"10311","33383","2014",4,4,0,124025,1197.75,111
"10312","33384","2014",3,3,0,216666.7,1740.667,133.3333
"10313","33385","2014",2,2,0,107500,801,161
"10314","33386","2014",1,1,0,97000,1212,80
"10315","33387","2014",13,13,0,174538.5,1543.462,117.6923
"10316","33388","2014",7,7,0,178528.6,1821.429,102.8571
"10317","33389","2014",31,31,0,117387.4,1242.742,95.77419
"10318","33390","2014",3,3,0,171000,1755.333,94.33333
"10319","33391","2014",2,2,0,191350,1506.5,126
"10320","33392","2014",8,7,1,148612.5,1459.875,94.625
"10321","33393","2014",38,35,3,145231.7,1426.447,106.9211
"10322","33394","2014",13,13,0,278092.3,2749.769,105.2308
"10323","33395","2014",17,17,0,94847.06,1103.235,91.52941
"10324","33397","2014",41,37,4,203603.2,2024.829,101.122
"10325","33399","2014",1,1,0,190000,1044,182
"10326","33400","2014",3,3,0,296253.3,1529.667,241
"10327","33401","2014",1,1,0,230500,1152,200
"10328","33402","2014",26,20,6,87603.85,829.8846,114.5769
"10329","33405","2014",6,6,0,137473.3,1354,110.6667
"10330","33406","2014",2,2,0,394000,3027,127.5
"10331","33407","2014",6,6,0,164488,2116.167,85.66667
"10332","33408","2014",3,3,0,162100,1290,119.3333
"10333","33411","2014",1,1,0,57000,570,100
"10334","33412","2014",9,9,0,111316.7,1130.889,100.7778
"10335","33413","2014",13,13,0,197002.3,2020.077,100.7692
"10336","33414","2014",3,3,0,265666.7,1978.667,133.3333
"10337","33415","2014",16,15,1,180532.9,1584.562,114.75
"10338","33416","2014",11,11,0,123569.1,1206.364,105.7273
"10339","33417","2014",23,23,0,208456,1884.348,113.8261
"10340","33418","2014",1,1,0,95000,1939,49
"10341","33421","2014",6,6,0,150666.7,1263.333,116.5
"10342","33422","2014",48,36,12,253909.4,2625.438,97.85417
"10343","33423","2014",3,3,0,68066.67,1077,64
"10344","33424","2014",39,39,0,141571.6,1434.154,101.1026
"10345","33425","2014",16,16,0,159842.5,1846.188,87.25
"10346","33426","2014",3,3,0,178243.3,1179.333,165.6667
"10347","33427","2014",2,2,0,180750,1601,123.5
"10348","33429","2014",1,1,0,164100,1356,121
"10349","33432","2014",3,3,0,139333.3,1322.333,101
"10350","33433","2014",72,64,8,189645.8,2059.903,100.3056
"10351","33434","2014",22,22,0,169403.4,1835.591,94.72727
"10352","33435","2014",11,11,0,182374.3,1465.273,131.3636
"10353","33436","2014",10,10,0,142393,1679.5,86.8
"10354","33437","2014",16,16,0,167822.6,1622.125,100.5
"10355","33438","2014",1,1,0,595000,3696,161
"10356","33439","2014",12,12,0,159127.5,1427.167,113.75
"10357","33440","2014",3,3,0,89333.33,1049.333,71.66667
"10358","33441","2014",11,10,1,106183.8,1044.455,111.0909
"10359","33442","2014",3,3,0,148900,1672,89.33333
"10360","33443","2014",1,1,0,203000,1128,180
"10361","33444","2014",8,8,0,118276.1,965,121.125
"10362","33445","2014",4,4,0,137050,1200,119.75
"10363","33446","2014",4,4,0,131625,1168.5,111
"10364","33447","2014",15,15,0,103452.4,1261.133,90.6
"10365","33448","2014",17,17,0,217273.5,2199.529,100
"10366","33449","2014",205,184,21,274291.1,2675.946,103.7415
"10367","33450","2014",4,4,0,142575,1286.5,118.75
"10368","33451","2014",3,3,0,173666.7,1450.667,110.3333
"10369","33452","2014",2,2,0,144775,1377.5,115
"10370","33453","2014",1,1,0,50000,417,120
"10371","33454","2014",12,12,0,263626.7,2198.75,122.4167
"10372","33456","2014",2,2,0,68500,747.5,100
"10373","33457","2014",3,3,0,122166.7,1282,103.6667
"10374","33458","2014",2,2,0,80750,1008,70.5
"10375","33459","2014",1,1,0,921000,11512,80
"10376","33460","2014",5,5,0,150500,1428.2,106
"10377","33461","2014",2,2,0,108750,669.5,162.5
"10378","33462","2014",6,6,0,151616.7,1420.167,109
"10379","33463","2014",11,11,0,139549.6,1435.091,102.4545
"10380","33464","2014",2,2,0,196333.5,986,220
"10381","33465","2014",5,5,0,302243,1693.2,177.6
"10382","33466","2014",12,11,1,171451.7,1581.75,121.75
"10383","33467","2014",3,3,0,206716,1881.667,112
"10384","33468","2014",6,6,0,95916.67,1028.167,100.3333
"10385","33470","2014",8,8,0,205631.2,2389.375,100.375
"10386","33471","2014",9,9,0,115211.1,1276.889,90.88889
"10387","33472","2014",6,6,0,92533.33,1070.667,89.5
"10388","33473","2014",20,19,1,136670,1397.35,97.85
"10389","33474","2014",18,18,0,252947.5,2597.389,102.3889
"10390","33475","2014",4,4,0,218331.5,1612,133.5
"10391","33476","2014",6,6,0,125500,1599.5,98.33333
"10392","33477","2014",10,10,0,127840,1173.3,115.8
"10393","33478","2014",31,29,2,108239,1242.839,89.93548
"10394","33479","2014",1,1,0,111000,544,204
"10395","33480","2014",11,11,0,132272.7,1738.364,75
"10396","33481","2014",2,2,0,162500,1492.5,109
"10397","33482","2014",2,2,0,124500,1584.5,87.5
"10398","33483","2014",48,40,8,243555.8,2007.146,121.1875
"10399","33484","2014",21,20,1,111876.2,1291.286,90
"10400","33485","2014",16,16,0,169190.5,1636.25,105.1875
"10401","33486","2014",1,1,0,231000,2100,110
"10402","33487","2014",8,8,0,164378.8,1893.25,89.5
"10403","33488","2014",2,2,0,145675,2399,59
"10404","33489","2014",3,3,0,143333.3,1263.667,114
"10405","33490","2014",21,21,0,121411.3,1361.619,90.71429
"10406","33491","2014",2,2,0,95000,679.5,121
"10407","33492","2014",15,15,0,149397.1,1347.733,117.8
"10408","33493","2014",4,4,0,128250,950.25,149.25
"10409","33494","2014",6,6,0,237966.7,2045.5,111.8333
"10410","33496","2014",16,16,0,267185.6,2177.188,118.75
"10411","33498","2014",63,58,5,211616.3,2089.063,103.1429
"10412","33499","2014",4,4,0,130237.5,1057,144
"10413","33500","2014",4,4,0,118250,1426,102
"10414","33501","2014",27,27,0,238840.7,2139.778,116.1852
"10415","33502","2014",3,3,0,105000,1092.667,96.66667
"10416","33503","2014",4,4,0,200501.2,2125.75,104
"10417","33504","2014",10,10,0,180010,1357,140.5
"10418","33505","2014",7,6,1,134000,1247.429,104
"10419","33506","2014",13,11,2,113038.5,1230.462,97.76923
"10420","33507","2014",1,1,0,184200,1450,127
"10421","33508","2014",5,5,0,103800,989,98.2
"10422","33509","2014",3,3,0,233333.3,1614,149.6667
"10423","33510","2014",2,2,0,175000,1345,132
"10424","33511","2014",2,2,0,130750,1528,91
"10425","33512","2014",1,1,0,175000,2333,75
"10426","33514","2014",85,57,28,180283.2,2797.047,68.98824
"10427","33515","2014",2,2,0,104000,1109.5,92.5
"10428","33516","2014",1,1,0,60000,779,77
"10429","33517","2014",18,18,0,150918.2,1570.278,99
"10430","33518","2014",9,8,1,124739.3,1297.556,97.22222
"10431","33519","2014",90,81,9,265434.1,2529.756,107.9222
"10432","33520","2014",4,4,0,91355.75,958.25,98
"10433","33521","2014",9,9,0,117055.6,1347.222,90.22222
"10434","33522","2014",503,213,290,187513.5,2847.203,67.73559
"10435","33523","2014",12,11,1,161717.5,1553.667,105.8333
"10436","33524","2014",1,1,0,211150,1553,136
"10437","33525","2014",11,11,0,138670.5,1527.364,93.72727
"10438","33526","2014",1,1,0,119500,1160,103
"10439","33527","2014",76,67,9,223218.5,2581.868,86.71053
"10440","33528","2014",1,1,0,1e+05,1064,94
"10441","33529","2014",389,288,101,323139.5,3379.992,92.29306
"10442","33530","2014",7,7,0,181364.3,1403.429,132.1429
"10443","33531","2014",3,3,0,231500,1987.333,114.3333
"10444","33532","2014",4,4,0,129475,1132.25,113.25
"10445","33533","2014",19,17,2,132407.9,1634.579,83.89474
"10446","33534","2014",15,14,1,164015.3,1551.867,105
"10447","33536","2014",2,2,0,206950,1920,113
"10448","33537","2014",2,2,0,146250,1292.5,102
"10449","33538","2014",4,4,0,74750,744.25,96
"10450","33539","2014",45,37,8,174872.4,1799.889,100.7556
"10451","33540","2014",51,50,1,163030.3,1929.686,91.76471
"10452","33541","2014",13,13,0,163653.8,1766.154,96.76923
"10453","33542","2014",7,7,0,138461.1,1498.571,99.57143
"10454","33543","2014",6,6,0,111333.3,961.8333,135.8333
"10455","33544","2014",39,33,6,121411.1,1848,68.74359
"10456","33545","2014",9,9,0,128763.9,1548.222,85.66667
"10457","33546","2014",1,1,0,625000,3125,200
"10458","33547","2014",9,9,0,139166.7,1165.333,130.7778
"10459","33548","2014",6,6,0,237625,1917.167,117.6667
"10460","33549","2014",2,2,0,95000,1550.5,61
"10461","33550","2014",317,219,98,206550.8,2577.625,81.95268
"10462","33551","2014",6,6,0,144800,1089,137.1667
"10463","33552","2014",4,4,0,107750,1227,96
"10464","33553","2014",4,4,0,152625,1793.75,86
"10465","33554","2014",20,20,0,244271,2159.8,118.4
"10466","33555","2014",31,29,2,225354.1,2364.806,97.93548
"10467","34001","2014",15,15,0,154936.7,1687.6,94.8
"10468","34002","2014",7,7,0,143500,1809.143,71
"10469","34003","2014",1241,265,976,127096.6,3135.752,42.48348
"10470","34004","2014",4,4,0,163250,1619,104.25
"10471","34005","2014",3,3,0,207500,1910.667,109.6667
"10472","34006","2014",4,4,0,85500,1002.5,90.25
"10473","34007","2014",10,10,0,168280,1856.5,88.9
"10474","34008","2014",5,5,0,76880,1109.8,72.8
"10475","34009","2014",15,15,0,235762.5,2337.133,100.0667
"10476","34010","2014",31,29,2,184865.8,2418.194,76.77419
"10477","34011","2014",1,1,0,42000,840,50
"10478","34012","2014",10,10,0,163642,1835.6,92.9
"10479","34013","2014",12,12,0,159838.8,1621.583,93.66667
"10480","34014","2014",9,9,0,463022.2,3120.889,148.3333
"10481","34015","2014",3,3,0,118833.3,1278.333,93.33333
"10482","34016","2014",3,3,0,246250,1822,140.6667
"10483","34017","2014",8,7,1,180722.5,1679,112.5
"10484","34018","2014",16,16,0,121281.2,1459.875,78
"10485","34019","2014",3,3,0,62333.33,1091.667,62
"10486","34020","2014",4,4,0,97125,942.25,105
"10487","34021","2014",3,3,0,131333.3,1165,99.33333
"10488","34022","2014",67,55,12,299561.9,3030.567,97.34328
"10489","34023","2014",174,40,134,142368.7,3440.443,47.94828
"10490","34024","2014",29,22,7,256885.4,2925.345,87.06897
"10491","34025","2014",26,25,1,188876.9,1944.115,95.84615
"10492","34026","2014",3,3,0,149666.7,1514.667,90.33333
"10493","34027","2014",10,10,0,287385,3321.8,91.4
"10494","34028","2014",55,36,19,110762.4,1467.018,76.47273
"10495","34029","2014",6,5,1,131116.7,1754.667,78.16667
"10496","34030","2014",1,1,0,79000,1197,66
"10497","34031","2014",37,31,6,177106.2,2139.054,78.24324
"10498","34032","2014",764,343,421,116068.5,1534.42,76.23429
"10499","34033","2014",20,18,2,215084.6,2142.3,97.65
"10500","34035","2014",6,6,0,332590,2791,124.5
"10501","34036","2014",10,8,2,182290,1891.2,101.1
"10502","34037","2014",30,24,6,198210.7,1949.733,95.36667
"10503","34038","2014",12,12,0,136925,1372.833,96.16667
"10504","34039","2014",17,12,5,264613.5,2784.765,98.35294
"10505","34041","2014",10,10,0,175910,1912.6,90.5
"10506","34042","2014",7,5,2,153164.3,2084.571,76.28571
"10507","34043","2014",3,3,0,255333.3,2048,123.3333
"10508","34044","2014",7,7,0,83571.43,1506,63
"10509","34045","2014",4,4,0,101250,1266.25,79.5
"10510","34046","2014",2,2,0,80500,1079.5,75.5
"10511","34047","2014",12,11,1,188425.8,1954.833,95.5
"10512","34048","2014",4,4,0,258575,2221.25,128.75
"10513","34049","2014",2,1,1,66000,1255,68
"10514","34050","2014",20,14,6,227712.5,2504.05,91.35
"10515","34051","2014",31,31,0,214851.6,2098.71,103.6774
"10516","34052","2014",42,41,1,149910,1683.238,93.38095
"10517","34053","2014",4,4,0,155450,1406.75,110.25
"10518","34054","2014",4,4,0,70000,1046.75,74.75
"10519","34055","2014",2,2,0,73400,1260.5,57.5
"10520","34056","2014",8,8,0,163375,1475,109.625
"10521","34057","2014",178,75,103,273109,3213.062,83.44382
"10522","34058","2014",42,41,1,301552.7,2888.381,103.6429
"10523","34059","2014",1,1,0,85000,773,110
"10524","34060","2014",1,1,0,155000,1722,90
"10525","34061","2014",4,4,0,139900,1854.75,75.75
"10526","34063","2014",18,17,1,157096.7,1603,96.61111
"10527","34064","2014",5,4,1,78411.6,953.6,76.8
"10528","34065","2014",5,5,0,112600,1217.6,95.4
"10529","34067","2014",14,9,5,129499.3,1496,87.5
"10530","34068","2014",3,2,1,145333.3,1722.333,82.66667
"10531","34069","2014",44,44,0,150420.7,1541.318,102.4773
"10532","34070","2014",8,8,0,90531.25,1333.25,63.75
"10533","34071","2014",4,3,1,87500,1249,65
"10534","34073","2014",14,12,2,187864.3,1762.929,109.8571
"10535","34074","2014",22,21,1,130913.2,1376.182,106.3182
"10536","34075","2014",3,3,0,145666.7,1308,102
"10537","34076","2014",8,8,0,193187.5,1894.875,96.5
"10538","34077","2014",32,25,7,294259.1,2862.875,100.9375
"10539","34078","2014",11,11,0,254245.5,2736.364,98.81818
"10540","34079","2014",71,48,23,173046.9,2007.859,84.14085
"10541","34080","2014",6,6,0,159298.3,1772.333,92.83333
"10542","34081","2014",14,14,0,156598.6,1736.5,89.78571
"10543","34082","2014",6,6,0,324250,3265.333,97.83333
"10544","34083","2014",4,4,0,158000,1742.25,87.5
"10545","34084","2014",13,13,0,185508.5,1700.077,112.6154
"10546","34085","2014",4,4,0,177250,2429.25,79.5
"10547","34086","2014",9,9,0,119147.7,1291.222,92.22222
"10548","34088","2014",65,54,11,212316.6,2435.554,94.93846
"10549","34089","2014",9,9,0,146446.7,1356,92.77778
"10550","34090","2014",105,82,23,280552.5,3025.905,94.25714
"10551","34092","2014",15,13,2,132809,1519.8,87.06667
"10552","34093","2014",1,1,0,170000,1360,125
"10553","34094","2014",6,6,0,150038.3,1861.167,80.5
"10554","34095","2014",51,43,8,229992.4,2428.451,94.45098
"10555","34096","2014",7,5,2,181285.7,2026.857,87.42857
"10556","34097","2014",8,8,0,162661.2,1445.875,109.875
"10557","34098","2014",1,1,0,122500,1276,96
"10558","34099","2014",1,1,0,560000,4746,118
"10559","34100","2014",1,1,0,150000,2113,71
"10560","34101","2014",37,34,3,169688.9,1809.919,98.05405
"10561","34102","2014",1,1,0,254000,2566,99
"10562","34103","2014",14,14,0,162821.4,1897.643,85.92857
"10563","34104","2014",1,1,0,75700,1023,74
"10564","34105","2014",6,6,0,159408.3,1784.333,89.66667
"10565","34107","2014",5,5,0,88600,1411.6,64
"10566","34108","2014",284,160,124,182598.5,2857.585,68.58803
"10567","34109","2014",10,9,1,138395,2033.9,76.1
"10568","34110","2014",4,4,0,116750,1726.25,74.5
"10569","34111","2014",30,12,18,100864.7,1263.633,79
"10570","34113","2014",70,61,9,215224.8,2419.071,90.57143
"10571","34114","2014",52,42,10,175778.2,2128.558,83.86538
"10572","34115","2014",2,1,1,112000,800.5,139
"10573","34116","2014",107,33,74,171920.1,2507.346,66.26168
"10574","34117","2014",9,6,3,71777.78,836.2222,83.77778
"10575","34119","2014",13,12,1,112211.1,1250.077,88.92308
"10576","34120","2014",43,34,9,266792.4,2952.651,91.23256
"10577","34121","2014",5,4,1,83800,985.2,80.4
"10578","34122","2014",3,3,0,337833.3,2487.667,128.6667
"10579","34123","2014",88,57,31,267163.3,2968.193,92.80682
"10580","34124","2014",2,2,0,237466,3082.5,73.5
"10581","34125","2014",3,3,0,292000,2119.333,184
"10582","34126","2014",44,18,26,96705.91,1752.682,57.20455
"10583","34127","2014",32,31,1,251186.2,2646.125,92.9375
"10584","34128","2014",13,12,1,150769.2,1841.462,82.30769
"10585","34129","2014",222,93,129,246468.9,3233.356,78.5
"10586","34130","2014",18,18,0,140580.3,1559.722,89.83333
"10587","34131","2014",1,1,0,394800,3014,131
"10588","34132","2014",3,3,0,146666.7,1160,114
"10589","34134","2014",17,13,4,227661.8,2680.118,86.35294
"10590","34135","2014",36,32,4,135794.5,1693.25,78.77778
"10591","34136","2014",17,15,2,168252.9,1767.118,96.47059
"10592","34138","2014",3,3,0,149000,1665,84.33333
"10593","34139","2014",16,16,0,190960.2,1724.875,108.375
"10594","34140","2014",24,24,0,178026.7,1751.583,104.5833
"10595","34141","2014",3,3,0,316011.7,2013,164.6667
"10596","34142","2014",63,41,22,126036.6,1454.365,87.71429
"10597","34143","2014",21,18,3,141709.5,1932.619,76.52381
"10598","34144","2014",4,4,0,174737.5,1326,116.5
"10599","34145","2014",234,159,75,167317.3,2086.598,81.58547
"10600","34146","2014",32,25,7,179657.5,2061.562,90.125
"10601","34147","2014",35,33,2,172736.3,1700.657,98.02857
"10602","34148","2014",33,31,2,180307,1750.212,103
"10603","34149","2014",4,4,0,368250,2159.75,165.5
"10604","34150","2014",201,98,103,141224.9,3223.517,47.60697
"10605","34151","2014",62,48,14,178684,2235.645,83.03226
"10606","34152","2014",1,1,0,530000,2454,216
"10607","34153","2014",13,11,2,261450.3,2863.462,96.38462
"10608","34154","2014",301,101,200,208197.4,3438.711,63.60797
"10609","34155","2014",22,20,2,167262.7,1718.636,101.4545
"10610","34157","2014",134,85,49,204700.4,2607.955,81.06716
"10611","34158","2014",2,2,0,75000,1059,74
"10612","34159","2014",27,21,6,282678,2827.704,96.81481
"10613","34160","2014",7,7,0,118825.7,1440,82.14286
"10614","34161","2014",41,40,1,166437.8,1694.561,98.07317
"10615","34162","2014",41,37,4,130915.4,1772.902,75.14634
"10616","34164","2014",7,7,0,293002.9,2593.857,117.2857
"10617","34165","2014",36,26,10,185871.8,2302.389,81.5
"10618","34166","2014",22,21,1,150587.7,1749.318,86.22727
"10619","34167","2014",3,3,0,115000,1551.333,73
"10620","34168","2014",1,1,0,160000,2000,80
"10621","34169","2014",29,22,7,378162.9,3427.862,113.069
"10622","34170","2014",2,2,0,191000,1802,96.5
"10623","34172","2014",3476,398,3078,157786.1,2725.184,59.50748
"10624","34173","2014",8,7,1,148627.5,1805.625,85.625
"10625","34174","2014",5,5,0,198584,2053.6,101
"10626","34175","2014",1,1,0,1e+05,1250,80
"10627","34176","2014",21,17,4,237832.5,2633.143,94.04762
"10628","34177","2014",3,3,0,398300,2777,144.3333
"10629","34178","2014",32,32,0,139127.2,1526,94.03125
"10630","34179","2014",13,12,1,277708.5,2579.846,111.5385
"10631","34180","2014",10,9,1,121487,1452.4,91.7
"10632","34181","2014",14,14,0,188750,1872.571,104.5714
"10633","34182","2014",21,21,0,189561.9,1957.238,94.19048
"10634","34183","2014",40,39,1,143041.6,1441.35,95.475
"10635","34184","2014",3,3,0,246226.7,2208,119
"10636","34185","2014",1,0,1,1e+05,820,122
"10637","34187","2014",5,4,1,130406,1645,87.2
"10638","34188","2014",1,1,0,314800,2044,154
"10639","34189","2014",21,21,0,107685.2,1240.81,91.7619
"10640","34190","2014",4,4,0,87780,1115.5,65.5
"10641","34191","2014",5,5,0,175040,1527.6,104.8
"10642","34192","2014",185,24,161,200632.7,4169.832,47.38378
"10643","34193","2014",4,4,0,131967.5,1416,94.5
"10644","34194","2014",62,51,11,148209.9,1838.581,81.17742
"10645","34195","2014",2,2,0,56000,1470,32.5
"10646","34197","2014",10,10,0,232985,2346.4,99.2
"10647","34198","2014",84,63,21,281571.6,3235.821,88.70238
"10648","34199","2014",95,52,43,155985.7,2001.726,77.14737
"10649","34200","2014",5,5,0,145820,1451,100.2
"10650","34201","2014",3,3,0,86666.67,1364.667,59.33333
"10651","34202","2014",51,42,9,256146.4,2661.941,95.19608
"10652","34203","2014",11,11,0,120376.4,1512.091,79.72727
"10653","34204","2014",13,11,2,158696.2,1634.462,97.92308
"10654","34205","2014",2,2,0,264000,1823.5,141.5
"10655","34206","2014",6,6,0,130583.3,1259.333,103.1667
"10656","34207","2014",26,24,2,135260.4,1633.654,84.23077
"10657","34209","2014",91,83,8,155948.2,2818.418,61.85714
"10658","34211","2014",5,5,0,67600,879.4,80.2
"10659","34213","2014",69,52,17,204053.6,2438.014,86.62319
"10660","34214","2014",14,14,0,186458.2,2044.929,92.07143
"10661","34215","2014",9,9,0,136888.9,1523.333,91.33333
"10662","34217","2014",41,33,8,304350.8,3140.829,97.58537
"10663","34218","2014",1,1,0,367000,2252,163
"10664","34219","2014",8,8,0,113634.1,1449.25,89
"10665","34220","2014",1,1,0,242000,2350,103
"10666","34221","2014",1,1,0,112000,3027,37
"10667","34222","2014",3,3,0,300216.7,2170.667,132
"10668","34223","2014",9,9,0,174666.7,1759.444,95.11111
"10669","34224","2014",14,10,4,210026.2,1785,109.8571
"10670","34225","2014",30,29,1,144052.3,1447.2,98.9
"10671","34226","2014",15,15,0,120033.3,1560.333,87.2
"10672","34227","2014",18,15,3,229025.2,2535.889,92.38889
"10673","34228","2014",1,1,0,50000,450,111
"10674","34229","2014",7,6,1,123142.9,1393.429,92.71429
"10675","34230","2014",1,1,0,30000,429,70
"10676","34232","2014",8,8,0,151625,1879.125,74.75
"10677","34235","2014",5,4,1,47000,828.8,55.8
"10678","34236","2014",2,0,2,210298.5,1479,142
"10679","34237","2014",31,27,4,181710.5,1800.613,89.48387
"10680","34240","2014",38,30,8,282560.7,2865.5,100.2105
"10681","34241","2014",9,9,0,159688.9,1601.444,100.5556
"10682","34242","2014",8,7,1,298734.9,2796.125,113.625
"10683","34243","2014",15,13,2,184121.5,1922.133,97.06667
"10684","34244","2014",19,13,6,236947.9,2861.053,84.63158
"10685","34245","2014",22,21,1,152725.2,1773.818,80.63636
"10686","34246","2014",12,12,0,223382.5,2127.25,98.5
"10687","34247","2014",32,27,5,404174.2,3329.719,121.0938
"10688","34248","2014",4,4,0,329460,2845.75,116.5
"10689","34249","2014",17,13,4,320704.1,2664.706,117.6471
"10690","34250","2014",1,1,0,160000,2286,70
"10691","34251","2014",5,5,0,211300,2032.6,109.2
"10692","34252","2014",4,3,1,87375,1155.5,81.5
"10693","34254","2014",15,15,0,160238,2358,81.6
"10694","34255","2014",82,63,19,322419.3,2897.878,111.2805
"10695","34256","2014",11,9,2,270377.3,2394.727,100.7273
"10696","34257","2014",3,3,0,61333.33,953.6667,70.66667
"10697","34258","2014",22,22,0,155691.4,1644.909,94.95455
"10698","34259","2014",31,23,8,219374.5,2608.516,86.51613
"10699","34260","2014",13,12,1,76978.85,948.3846,86.15385
"10700","34261","2014",2,2,0,247500,2563,109.5
"10701","34262","2014",2,2,0,226500,2096.5,99.5
"10702","34265","2014",4,4,0,519250,3420,150
"10703","34266","2014",4,3,1,323000,4409.75,91.25
"10704","34267","2014",5,5,0,190800,1712.6,103.2
"10705","34268","2014",3,3,0,202083.3,2082.333,96.33333
"10706","34269","2014",2,2,0,210000,1620.5,125.5
"10707","34270","2014",58,46,12,299401.2,3006.707,98.94828
"10708","34271","2014",4,4,0,70750,1580.5,68
"10709","34272","2014",18,17,1,239480.6,2459.389,95.83333
"10710","34273","2014",3,3,0,122666.7,1165.667,94.66667
"10711","34274","2014",19,19,0,300137.7,3094,99.26316
"10712","34276","2014",25,16,9,241668.8,2926.52,87.68
"10713","34277","2014",2,2,0,117500,1497.5,58.5
"10714","34278","2014",1,1,0,90000,957,94
"10715","34279","2014",1,1,0,80000,1013,79
"10716","34280","2014",5,5,0,209720,2369.6,87.6
"10717","34281","2014",23,23,0,176823.5,1818.13,97
"10718","34282","2014",4,4,0,256575,2615.25,98.75
"10719","34284","2014",7,7,0,119550,944.2857,120.8571
"10720","34285","2014",9,9,0,213709.1,1966.889,101.3333
"10721","34286","2014",5,5,0,111350,1259.6,99.8
"10722","34287","2014",1,1,0,137245,762,180
"10723","34288","2014",10,7,3,290440.9,2634.7,103.1
"10724","34289","2014",22,22,0,139667.7,1612.045,90.36364
"10725","34290","2014",8,6,2,349538.8,3358.75,101.25
"10726","34291","2014",2,2,0,56500,1052.5,70
"10727","34292","2014",6,6,0,184000,1846.167,106.6667
"10728","34293","2014",16,15,1,110971.4,1375.688,87.625
"10729","34294","2014",3,2,1,143716.7,1519,102
"10730","34295","2014",13,13,0,249730.8,2280.615,106.2308
"10731","34296","2014",12,12,0,231154.2,1932.417,113.75
"10732","34297","2014",5,5,0,201200,1951.8,98
"10733","34298","2014",50,49,1,208217.6,2052.96,101.72
"10734","34299","2014",81,69,12,190580,2269.309,84.8642
"10735","34300","2014",56,53,3,176572.3,1870.643,91.96429
"10736","34301","2014",749,109,640,150780.6,2490.94,60.48732
"10737","34302","2014",15,15,0,146141.7,1187.333,121
"10738","34304","2014",5,4,1,104600,1270.6,78.6
"10739","34306","2014",3,2,1,169233.3,2647,74.33333
"10740","34307","2014",18,16,2,333240.6,2712,121.7778
"10741","34309","2014",23,19,4,337510.5,2910.87,114.5652
"10742","34310","2014",24,23,1,179551.2,1597.167,110.5
"10743","34311","2014",13,13,0,281100.5,2271.538,124.6154
"10744","34312","2014",22,20,2,151514.1,1581.455,93.90909
"10745","34313","2014",6,6,0,112500,870.3333,128
"10746","34314","2014",1,1,0,313420,2271,138
"10747","34315","2014",5,5,0,186930,1535,126.4
"10748","34316","2014",2,2,0,176500,1997.5,88
"10749","34317","2014",7,7,0,69350,903.4286,76.42857
"10750","34318","2014",6,6,0,266177.5,1738.5,145.8333
"10751","34319","2014",2,2,0,307394.5,2592.5,111.5
"10752","34320","2014",15,15,0,295898,2861.867,115.7333
"10753","34321","2014",12,10,2,252952.2,2593.917,97.33333
"10754","34322","2014",4,4,0,239000,2387.25,96.5
"10755","34324","2014",208,82,126,136346.7,2956.837,48.33654
"10756","34325","2014",18,16,2,200072.2,2054.833,99.44444
"10757","34327","2014",61,55,6,289526.2,2993,97.63934
"10758","34328","2014",9,8,1,182989.7,2069.111,92
"10759","34329","2014",38,32,6,136549.2,2598.579,62.52632
"10760","34331","2014",4,4,0,45437.5,864.5,53
"10761","34332","2014",82,68,14,151900.5,2396.415,70.08537
"10762","34333","2014",50,50,0,150973.7,3931.5,44.12
"10763","34334","2014",4,4,0,154750,2010.75,75.5
"10764","34335","2014",2,2,0,39000,1537.5,30
"10765","34336","2014",49,36,13,141372.2,1745.551,80.73469
"10766","34337","2014",79,59,20,241489.4,2753.62,88.83544
"10767","34340","2014",11,10,1,305144.5,3294.545,111.2727
"10768","34341","2014",26,25,1,220248,2202.346,101.3462
"10769","34342","2014",2,2,0,320217,1952.5,172.5
"10770","34343","2014",9,9,0,221135.9,2503.778,90.33333
"10771","34344","2014",580,42,538,158665.1,3991.379,39.43793
"10772","35001","2014",63,28,35,182800.9,2257.921,81.1746
"10773","35002","2014",10,10,0,156080,1641.3,96.6
"10774","35003","2014",5,5,0,179378,1636.6,109
"10775","35004","2014",15,14,1,104833.3,1105.133,101.2
"10776","35005","2014",1,1,0,1e+05,704,142
"10777","35006","2014",14,12,2,162553.5,1606.929,101.0714
"10778","35007","2014",4,4,0,160375,1523.75,102.5
"10779","35008","2014",6,6,0,224116.7,3140.333,109.1667
"10780","35009","2014",15,15,0,115246.7,1315.467,90.53333
"10781","35010","2014",9,9,0,123511.1,1623.778,75.77778
"10782","35012","2014",61,51,10,140824.9,1501.541,94.44262
"10783","35013","2014",27,27,0,118107,1287.778,95.25926
"10784","35014","2014",23,23,0,101111.8,1192.174,92.47826
"10785","35015","2014",11,11,0,155820.6,1442.364,108.2727
"10786","35016","2014",15,15,0,144409.3,1349.4,106.8
"10787","35017","2014",4,4,0,115563.8,1497.75,85.5
"10788","35018","2014",5,5,0,115280,1678.2,80
"10789","35019","2014",15,15,0,119833.3,1160.133,108.5333
"10790","35021","2014",14,14,0,178742.7,1574.571,112.0714
"10791","35022","2014",3,3,0,128666.7,1237.333,97.33333
"10792","35023","2014",37,31,6,166196.5,1761.838,97.21622
"10793","35024","2014",136,73,63,218644.9,2347.838,91.69853
"10794","35025","2014",2,2,0,134000,1251,105
"10795","35027","2014",17,17,0,110357.8,1256.059,87.41176
"10796","35028","2014",3,3,0,131268.7,1775.333,69.66667
"10797","35029","2014",12,11,1,88508.33,1222.917,86.75
"10798","35030","2014",6,6,0,75516.67,1688.5,48
"10799","35031","2014",21,21,0,163897.1,1614.714,97.80952
"10800","35032","2014",24,17,7,167635.6,1749.5,98.29167
"10801","35033","2014",16,16,0,166708.1,1521.375,112.8125
"10802","35034","2014",11,11,0,105909.1,1163.182,88.09091
"10803","35035","2014",5,5,0,129000,1624.8,93
"10804","35037","2014",60,43,17,157762.3,1929.717,82.2
"10805","35038","2014",6,6,0,125729.7,1257.5,99.5
"10806","35039","2014",26,25,1,196683.3,1839.769,110.4615
"10807","35040","2014",32,26,6,160139.8,1719.719,94.96875
"10808","35041","2014",2,2,0,175000,1558,117
"10809","35042","2014",4,4,0,74337.5,1017.5,78
"10810","35045","2014",6,6,0,78102,916.5,82.83333
"10811","35046","2014",3,3,0,88000,981.3333,89
"10812","35047","2014",183,96,87,194716.8,2269.306,86.28962
"10813","35049","2014",101,77,24,190597.9,2331.911,88.19802
"10814","35050","2014",6,6,0,117791.7,1669.833,72.33333
"10815","35051","2014",112,63,49,263834.6,2828.143,96.40179
"10816","35052","2014",1,1,0,120000,1277,94
"10817","35054","2014",16,16,0,179026.2,1707.188,106.125
"10818","35055","2014",91,41,50,197378.7,2377.264,84.37363
"10819","35056","2014",5,5,0,155000,1452,108
"10820","35057","2014",12,12,0,123916.7,1260.167,97.5
"10821","35058","2014",4,4,0,117750,1247.5,91.5
"10822","35059","2014",56,41,15,201493,2178.339,94.57143
"10823","35060","2014",11,11,0,124113.6,1296.182,92.72727
"10824","35061","2014",7,7,0,158271.4,1353.286,120.4286
"10825","35062","2014",12,12,0,100625,1079.917,91.08333
"10826","35063","2014",3,3,0,115666.7,1159.333,94
"10827","35064","2014",10,10,0,89250,1020.9,88.7
"10828","35065","2014",18,16,2,180977.8,1832.667,98.94444
"10829","35066","2014",78,38,40,164527.7,2284.026,75.53846
"10830","35067","2014",9,9,0,170166.7,1889.444,85.77778
"10831","35068","2014",68,48,20,175588.1,1836.25,97.83824
"10832","35069","2014",97,64,33,197401.6,2077.216,95.86598
"10833","35070","2014",11,9,2,164789.9,1863.727,93.36364
"10834","35071","2014",4,4,0,252625,3401.25,72.75
"10835","35072","2014",5,5,0,86640,1265.6,71.2
"10836","35075","2014",11,11,0,127476.7,1279.364,105.9091
"10837","35076","2014",22,14,8,183661.4,1955.864,94.81818
"10838","35077","2014",4,4,0,94125,1058.25,97.5
"10839","35078","2014",12,12,0,146491.7,1964.833,79.16667
"10840","35079","2014",17,14,3,187535.3,2052.176,95.47059
"10841","35080","2014",15,14,1,190449.3,1813.867,108.3333
"10842","35081","2014",1,1,0,120000,2857,42
"10843","35082","2014",11,11,0,126527.3,1109.818,126.9091
"10844","35084","2014",2,2,0,85600,1305,62
"10845","35085","2014",49,38,11,135385.3,1594.286,87.5102
"10846","35086","2014",6,6,0,126333.3,1309.333,94.16667
"10847","35087","2014",2,2,0,187500,1758,106
"10848","35088","2014",27,22,5,177245.1,1913.704,96.03704
"10849","35089","2014",1,1,0,160000,1839,87
"10850","35090","2014",26,23,3,171981.3,1583.423,110.9615
"10851","35091","2014",6,6,0,143188.7,1288.333,107
"10852","35092","2014",4,4,0,120000,1297,100.75
"10853","35093","2014",251,102,149,250554.3,3373.211,76.30677
"10854","35094","2014",17,16,1,109151.4,1482.941,72.70588
"10855","35095","2014",71,49,22,130285.9,1484.394,90.22535
"10856","35096","2014",14,12,2,159495.1,1533,106.1429
"10857","35097","2014",16,16,0,128977.8,1316.625,97.5
"10858","35098","2014",7,7,0,162814.3,1378.286,123.4286
"10859","35099","2014",26,22,4,199046.8,2059.692,97.88462
"10860","35101","2014",9,9,0,149477.8,1392.111,108.5556
"10861","35102","2014",5,5,0,107800,1276,87.6
"10862","35104","2014",9,9,0,122600,1108.333,110
"10863","35105","2014",10,10,0,123818.5,1395.6,89.4
"10864","35106","2014",15,14,1,78333.33,997.3333,80.06667
"10865","35107","2014",11,11,0,181772.7,1623.091,113.2727
"10866","35108","2014",6,6,0,95916.67,1109.167,84.33333
"10867","35109","2014",11,10,1,146918.2,1442.545,114.8182
"10868","35110","2014",14,14,0,124016.3,1654.214,80.5
"10869","35111","2014",7,6,1,100714.3,1080.857,93.85714
"10870","35112","2014",8,8,0,187871.9,1737.25,108.125
"10871","35114","2014",1,1,0,126000,1416,89
"10872","35115","2014",197,108,89,99013.26,1193.594,82.43147
"10873","35116","2014",19,18,1,124422.8,1354.211,92.10526
"10874","35117","2014",9,9,0,111187.8,1167,99.22222
"10875","35118","2014",18,18,0,155672.8,1348,121.5556
"10876","35119","2014",7,7,0,155557.1,1363.714,117.4286
"10877","35120","2014",37,27,10,204494.8,2079.054,100.973
"10878","35121","2014",10,10,0,180040,1544.5,118
"10879","35122","2014",9,8,1,219412.4,2186,107.4444
"10880","35123","2014",25,21,4,154944.8,1837.16,87.08
"10881","35124","2014",19,18,1,118750.5,1306.211,93.47368
"10882","35125","2014",30,24,6,103740.2,1095.9,96.36667
"10883","35126","2014",74,66,8,169311.9,1826.892,95.01351
"10884","35127","2014",36,34,2,141721.4,1631.333,90.27778
"10885","35128","2014",12,12,0,155311.2,1330.083,119.1667
"10886","35130","2014",11,10,1,124404.5,1481.818,83.81818
"10887","35131","2014",26,15,11,155901,1884.577,84.84615
"10888","35132","2014",21,21,0,144123.4,1466.619,102.8571
"10889","35133","2014",34,33,1,143149.6,1490.529,94.85294
"10890","35134","2014",1,1,0,90000,1250,72
"10891","35135","2014",9,9,0,179153.1,1742.778,104.4444
"10892","35136","2014",68,57,11,152207.2,1757.309,89.51471
"10893","35137","2014",9,8,1,123944.4,1311.667,99
"10894","35138","2014",13,13,0,128500.3,1281.077,100.5385
"10895","35139","2014",54,49,5,202122.9,1933.296,105.5741
"10896","35140","2014",6,6,0,88333.33,1362.5,64.33333
"10897","35141","2014",1,1,0,110000,1571,70
"10898","35142","2014",11,11,0,94946.91,1126.636,86.18182
"10899","35143","2014",2,2,0,157500,1476,107.5
"10900","35144","2014",9,9,0,162641.1,1626.778,103.3333
"10901","35145","2014",9,9,0,97608.44,931.3333,112.4444
"10902","35146","2014",4,4,0,145750,1575.5,89.25
"10903","35148","2014",1,1,0,125000,1623,77
"10904","35149","2014",10,10,0,138986.6,1380.5,101.8
"10905","35150","2014",19,19,0,188389.5,1702.579,110.2632
"10906","35151","2014",10,10,0,86709.2,967.3,85
"10907","35152","2014",65,60,5,189663,1964.6,99.32308
"10908","35154","2014",6,6,0,91166.67,1658.833,58.66667
"10909","35155","2014",6,5,1,119781.7,1699.667,78.83333
"10910","35156","2014",3,3,0,92666.67,1188,82.66667
"10911","35157","2014",8,8,0,84875,936.25,95.25
"10912","35159","2014",1,1,0,160000,1684,95
"10913","35160","2014",2,2,0,142500,1096.5,136.5
"10914","35161","2014",11,11,0,141000,1391.182,100.8182
"10915","35162","2014",19,18,1,90842.11,979.9474,87.68421
"10916","35163","2014",18,18,0,107202.8,1156.389,95.27778
"10917","35164","2014",10,10,0,105450,1314.2,78.3
"10918","35165","2014",10,10,0,115140,1024.5,120.1
"10919","35166","2014",9,9,0,134366.7,1427.778,90.66667
"10920","35167","2014",20,20,0,97875,1013,98.6
"10921","35168","2014",30,30,0,99732.07,1199.3,85.1
"10922","35169","2014",17,17,0,130135.3,1505.059,92.94118
"10923","35170","2014",6,6,0,130841.7,1388.833,95.66667
"10924","35171","2014",13,13,0,86476.54,1142.308,76.23077
"10925","35172","2014",15,15,0,140033.3,1475.133,106
"10926","35173","2014",50,41,9,221660.9,2376.58,99.08
"10927","35174","2014",5,5,0,78600,821.6,89.2
"10928","35175","2014",12,12,0,121957.5,1325.25,91
"10929","35176","2014",46,46,0,97366.96,1209.348,78.86957
"10930","35177","2014",31,25,6,212874.2,2275.355,96.45161
"10931","35178","2014",16,16,0,159271.1,1609,101.4375
"10932","35179","2014",40,38,2,137865.6,1543.325,96.85
"10933","35180","2014",5,5,0,135000,1268.6,105.2
"10934","35181","2014",10,10,0,265450,2871.4,89
"10935","35183","2014",5,5,0,136363.6,1338,100.4
"10936","35184","2014",30,27,3,138532,1370.233,102.2
"10937","35185","2014",1,1,0,80500,1088,74
"10938","35186","2014",5,5,0,139120,1427.8,99
"10939","35187","2014",12,12,0,142406.8,1538.417,93.75
"10940","35188","2014",67,39,28,160183.6,1831.687,90.70149
"10941","35189","2014",24,12,12,181617.1,2300.333,81.33333
"10942","35190","2014",3,3,0,92666.67,1279.667,80
"10943","35191","2014",21,21,0,94604.76,1039.429,94.90476
"10944","35192","2014",1,1,0,85000,1809,47
"10945","35193","2014",17,17,0,190683.8,1856.118,104.8235
"10946","35194","2014",5,5,0,144020.8,1383.8,103.6
"10947","35195","2014",20,20,0,140409.6,1388.1,102.4
"10948","35196","2014",66,41,25,190820,2140.121,90.75758
"10949","35197","2014",9,9,0,184600,1713.667,111.5556
"10950","35198","2014",6,5,1,161758.3,1368.167,121.3333
"10951","35199","2014",2,2,0,104500,882,114
"10952","35200","2014",6,6,0,114666.7,1101,117.6667
"10953","35201","2014",5,5,0,66000,928.4,71.6
"10954","35202","2014",7,7,0,88642.86,1453,68.28571
"10955","35204","2014",24,21,3,185262.8,1814.583,106.125
"10956","35205","2014",5,5,0,97740,1040.6,99.8
"10957","35206","2014",44,21,23,178808.8,2326.773,78.52273
"10958","35207","2014",49,33,16,201365.2,2154.755,96.22449
"10959","35208","2014",29,21,8,168953.2,1794.724,95.55172
"10960","35210","2014",81,48,33,234039.8,2363.84,98.32099
"10961","35211","2014",27,26,1,108785,1280.37,92.96296
"10962","35212","2014",2,2,0,174000,994,174
"10963","35214","2014",3,3,0,120000,1298,96
"10964","35215","2014",12,12,0,116666.7,1220.75,97.08333
"10965","35216","2014",21,13,8,171069.9,1958.286,88.19048
"10966","35217","2014",7,7,0,79598,1110.429,72.57143
"10967","35218","2014",14,14,0,151646.4,1321.571,110.5714
"10968","35219","2014",24,23,1,91424.71,1156.958,81.66667
"10969","35220","2014",24,24,0,164741.7,1622.917,101.375
"10970","35221","2014",33,33,0,132293.9,1441.939,94.75758
"10971","35222","2014",19,19,0,94305.26,1110.632,93.05263
"10972","35223","2014",36,35,1,123529.2,1611.528,79.75
"10973","35224","2014",21,21,0,135116.6,1384.524,98.19048
"10974","35225","2014",13,10,3,178531.5,1486.077,117.1538
"10975","35226","2014",17,17,0,120006.1,1518.294,89.23529
"10976","35227","2014",32,28,4,159133.7,1688.281,94.375
"10977","35228","2014",89,62,27,176511.5,1959.73,94.07865
"10978","35229","2014",4,4,0,173100,1466.25,114
"10979","35230","2014",2,2,0,102500,1026,102
"10980","35231","2014",6,6,0,169800,1412.833,115.5
"10981","35232","2014",5,5,0,65936,886,76.6
"10982","35233","2014",9,9,0,179055.6,1605.889,114.1111
"10983","35234","2014",8,8,0,118937.5,1390.75,88.5
"10984","35235","2014",9,9,0,85433.33,1162.667,78.55556
"10985","35236","2014",60,31,29,100980.1,1213.3,87.43333
"10986","35237","2014",5,5,0,80500,906.8,93.4
"10987","35238","2014",2646,383,2263,162605.7,2574.238,63.7124
"10988","35239","2014",29,28,1,132117.3,1340.138,97.72414
"10989","35240","2014",104,56,48,185314.8,2114.827,89.43269
"10990","35241","2014",22,20,2,183538.6,2109.227,87.86364
"10991","35242","2014",3,3,0,89666.67,1128.333,76
"10992","35243","2014",14,14,0,165221.4,1512.643,117.2143
"10993","35244","2014",2,2,0,42500,492.5,84.5
"10994","35245","2014",23,20,3,150765.4,1757.609,89.17391
"10995","35246","2014",12,12,0,132225,1380.417,95.75
"10996","35247","2014",5,4,1,63300,960,68
"10997","35248","2014",4,4,0,103615,985,118.5
"10998","35249","2014",5,5,0,66440,961.8,66.6
"10999","35250","2014",18,11,7,166786.9,2009.111,84.44444
"11000","35251","2014",24,16,8,172512.7,1888,92.625
"11001","35252","2014",4,4,0,118000,1100.5,98.25
"11002","35253","2014",23,22,1,153332,1724.522,91.26087
"11003","35255","2014",12,12,0,164813.3,1911.667,87.33333
"11004","35256","2014",51,34,17,260575.1,2934.627,84.80392
"11005","35257","2014",30,30,0,105179,1109.133,92.16667
"11006","35259","2014",5,5,0,86620,974.8,95.2
"11007","35260","2014",3,3,0,91333.33,841.6667,102
"11008","35262","2014",4,4,0,130000,1229.5,116.5
"11009","35263","2014",32,31,1,230811.6,2163.875,105.2188
"11010","35264","2014",9,8,1,181940,1818.222,103.7778
"11011","35265","2014",17,15,2,152041.2,1427.529,108.1176
"11012","35266","2014",20,13,7,230625,2199.4,103.95
"11013","35268","2014",6,6,0,58836.33,921.8333,71.16667
"11014","35270","2014",1,1,0,106000,1178,90
"11015","35271","2014",6,5,1,51733.33,543.3333,92.16667
"11016","35272","2014",7,7,0,124100,1282.714,93.57143
"11017","35273","2014",14,14,0,121058.9,1268.5,94.07143
"11018","35274","2014",5,4,1,177550,1739,107
"11019","35275","2014",40,35,5,190150.7,1902.3,99.575
"11020","35276","2014",4,4,0,175250,1968.5,86.25
"11021","35277","2014",4,4,0,130925,1875.5,77.25
"11022","35278","2014",72,49,23,297304.5,2801.056,107.1389
"11023","35279","2014",6,5,1,156400,1714.833,91.83333
"11024","35280","2014",5,5,0,92520,995,100.6
"11025","35281","2014",167,62,105,159581.2,2205.958,72.71257
"11026","35282","2014",18,18,0,132094.3,1225.944,108.9444
"11027","35283","2014",15,13,2,141408.7,1533.867,91.06667
"11028","35284","2014",25,22,3,200963.1,2029.88,99.2
"11029","35285","2014",10,10,0,113999,1209.2,94.6
"11030","35286","2014",1,1,0,125000,1623,77
"11031","35287","2014",35,27,8,290525.7,2950.543,104.1714
"11032","35288","2014",700,272,428,210451.9,2829.583,75.71714
"11033","35289","2014",9,9,0,104944.4,1184,86.44444
"11034","35290","2014",7,7,0,119178.6,984.4286,120.2857
"11035","35291","2014",4,4,0,64750,870.25,67.5
"11036","35292","2014",1,1,0,180000,1047,172
"11037","35294","2014",21,21,0,91409.52,1119.571,82.52381
"11038","35295","2014",4,4,0,115630,1520.5,78
"11039","35296","2014",7,7,0,154385.7,2051.714,74.28571
"11040","35297","2014",47,31,16,104691.4,1422.064,78.42553
"11041","35299","2014",47,36,11,182305.3,2055.106,92.12766
"11042","35300","2014",10,10,0,99959,1171.1,82.8
"11043","35302","2014",7,7,0,144471.4,1390.286,104.5714
"11044","35304","2014",7,7,0,163685.7,1237.714,138
"11045","35305","2014",1,1,0,65000,1667,39
"11046","35306","2014",15,14,1,128257.3,1531.733,81.73333
"11047","35307","2014",7,7,0,89500,929.4286,95.71429
"11048","35308","2014",46,46,0,132758.7,1356.217,100.087
"11049","35309","2014",5,5,0,116000,1136.6,107.4
"11050","35310","2014",5,5,0,172200,1337.2,129
"11051","35311","2014",7,7,0,64898.57,777.5714,76
"11052","35312","2014",16,16,0,127925,1841.062,87.5625
"11053","35314","2014",6,6,0,196000,1989.667,95.66667
"11054","35315","2014",16,16,0,261187.5,2253.188,117.4375
"11055","35316","2014",8,7,1,130237.9,1316.625,109.5
"11056","35317","2014",4,4,0,179812.5,2148.75,90.25
"11057","35318","2014",6,6,0,128500,1468.333,93
"11058","35319","2014",18,12,6,154855.6,1792.944,87.33333
"11059","35320","2014",7,7,0,162448.1,1360,122.5714
"11060","35321","2014",3,3,0,153500,1363,108.6667
"11061","35322","2014",8,8,0,137562.5,1293.75,109.75
"11062","35324","2014",6,6,0,157267,1331.667,118.3333
"11063","35326","2014",27,27,0,135259.7,1339.074,103.2222
"11064","35327","2014",28,20,8,165835.4,1884.429,90.85714
"11065","35328","2014",17,16,1,87805.35,966.8824,90.41176
"11066","35329","2014",5,5,0,74020,1052,86.4
"11067","35330","2014",6,6,0,141233.3,1699.5,88.16667
"11068","35331","2014",16,16,0,180734.4,1705.938,105.5625
"11069","35332","2014",9,9,0,106222.2,1147.778,90.44444
"11070","35333","2014",8,8,0,136922,1501.75,91.625
"11071","35334","2014",91,35,56,188554.7,2363.527,80.86813
"11072","35335","2014",10,10,0,134537.1,1354,101.4
"11073","35336","2014",2,2,0,77500,1164,76.5
"11074","35337","2014",28,25,3,144003,1528.929,101.0714
"11075","35338","2014",1,1,0,155000,1192,130
"11076","35339","2014",10,10,0,85450,936.7,106
"11077","35340","2014",13,13,0,162284.6,1667.538,101.7692
"11078","35342","2014",4,4,0,116000,1300.75,95
"11079","35343","2014",7,7,0,94000,1287,78.42857
"11080","35345","2014",5,5,0,146944.6,1580.8,91.4
"11081","35346","2014",2,2,0,82500,1578.5,64
"11082","35347","2014",16,15,1,126572.8,1484.688,87.375
"11083","35350","2014",3,3,0,127500,1439.667,72.33333
"11084","35351","2014",11,11,0,171915.5,1618.273,107
"11085","35352","2014",55,44,11,224417.6,2163.164,105.6909
"11086","35353","2014",54,22,32,180135.2,2192.759,84.37037
"11087","35354","2014",1,1,0,50000,379,132
"11088","35355","2014",6,6,0,141326.3,1296.833,122.6667
"11089","35356","2014",10,8,2,191469,1769.4,102.6
"11090","35357","2014",2,2,0,103667.5,950,113.5
"11091","35358","2014",14,14,0,203035.7,1983,102.2143
"11092","35359","2014",9,9,0,150594.4,1474.333,103.3333
"11093","35360","2014",148,89,59,156752,1811.061,87.84459
"11094","35361","2014",15,15,0,110846.7,1510.067,76.93333
"11095","35362","2014",11,10,1,130136.4,1352.364,95.27273
"11096","35363","2014",40,32,8,175181.5,1866.625,94.6
"11097","36001","2014",15,15,0,113236,1415.667,88.93333
"11098","36002","2014",1,1,0,135000,1688,80
"11099","36003","2014",5,5,0,79400,860.8,86.2
"11100","36004","2014",4,4,0,61750,644,95
"11101","36005","2014",23,22,1,110442.6,1330.609,84.56522
"11102","36006","2014",42,35,7,81938.1,1345.238,80.45238
"11103","36007","2014",4,4,0,58750,642,92.25
"11104","36008","2014",1,1,0,155000,1396,111
"11105","36009","2014",5,5,0,124200,1090,114
"11106","36010","2014",12,12,0,80188.33,829.6667,87.91667
"11107","36012","2014",8,8,0,68875,894.375,77.5
"11108","36013","2014",3,3,0,88200,1279.667,70
"11109","36014","2014",1,1,0,60000,1132,53
"11110","36015","2014",1,1,0,41000,603,68
"11111","36016","2014",7,7,0,133100,1254.857,94.42857
"11112","36017","2014",6,6,0,78850,870,104
"11113","36018","2014",62,58,4,93476.66,975.2903,95.01613
"11114","36019","2014",2,2,0,138900,1452,84
"11115","36021","2014",1,1,0,62000,1292,48
"11116","36022","2014",4,4,0,86750,755.75,111.5
"11117","36023","2014",3,3,0,66792.67,787.6667,79
"11118","36024","2014",4,4,0,71725,864.75,77.75
"11119","36025","2014",4,4,0,92500,850.75,126.75
"11120","36026","2014",6,6,0,86426.67,1225.333,73.66667
"11121","36027","2014",4,4,0,101750,1004.25,103
"11122","36028","2014",4,4,0,34587.5,677.25,59.5
"11123","36029","2014",5,5,0,92600,811.4,104.6
"11124","36030","2014",2,2,0,85000,1177,92.5
"11125","36031","2014",42,41,1,86979.76,978.1905,90.38095
"11126","36032","2014",13,13,0,76000,867.5385,86.46154
"11127","36033","2014",3,3,0,104333.3,827.6667,116
"11128","36034","2014",34,33,1,85930.59,1174.824,80.58824
"11129","36035","2014",13,13,0,63461.54,728.7692,88.61538
"11130","36036","2014",4,4,0,36325,670.5,57
"11131","36037","2014",1,1,0,55000,797,69
"11132","36038","2014",1,1,0,42000,467,90
"11133","36040","2014",2,2,0,112250,1009,110.5
"11134","36041","2014",2,2,0,72500,978,77.5
"11135","36042","2014",3,3,0,50566.67,933.6667,59.33333
"11136","36043","2014",7,6,1,82857.14,1538.857,72.14286
"11137","36044","2014",420,280,140,99395.55,1225.067,82.79286
"11138","36045","2014",17,16,1,101742.9,1118.176,88.23529
"11139","36046","2014",28,26,2,99323.57,1051.571,93.57143
"11140","36047","2014",9,9,0,59722.22,812.6667,70.55556
"11141","36048","2014",3,3,0,67833.33,675.6667,96.33333
"11142","36049","2014",1,1,0,90000,573,157
"11143","36050","2014",2,2,0,113500,1201.5,91.5
"11144","36051","2014",1,1,0,129000,970,133
"11145","36052","2014",1,1,0,58000,1184,49
"11146","36053","2014",2,1,1,80000,1154.5,79.5
"11147","36054","2014",2,2,0,32750,413.5,81
"11148","36055","2014",6,6,0,57666.67,841.6667,67
"11149","36056","2014",10,10,0,55146.7,797.1,68.9
"11150","36057","2014",5,5,0,109000,1278,84.2
"11151","36058","2014",9,9,0,88331.22,881.6667,99.22222
"11152","36059","2014",4,4,0,100750,1068.75,101.75
"11153","36060","2014",8,8,0,121250,1620.125,85.125
"11154","36061","2014",4,4,0,49875,823.5,61.25
"11155","36062","2014",5,5,0,111500,1515.4,82.8
"11156","36063","2014",70,69,1,117472.6,1281.843,92.78571
"11157","36064","2014",5,5,0,110140,1065.4,98.2
"11158","36065","2014",3,3,0,146666.7,1745.333,108.6667
"11159","36066","2014",8,8,0,202875,1515.125,112.5
"11160","36067","2014",3,3,0,75333.33,881.6667,92.33333
"11161","36068","2014",8,8,0,84687.5,987.625,95.5
"11162","36069","2014",6,6,0,86716.67,881.6667,88.33333
"11163","36070","2014",17,17,0,87235.29,1085,84.35294
"11164","36071","2014",9,9,0,144623.3,1438.889,100.5556
"11165","36073","2014",4,4,0,69125,1267,76.25
"11166","36074","2014",6,6,0,93333.33,1123.667,78.16667
"11167","36075","2014",1,1,0,50000,495,101
"11168","36078","2014",4,4,0,74500,1036.75,71.5
"11169","36081","2014",1,1,0,98500,2462,40
"11170","36082","2014",1,1,0,68400,1086,63
"11171","36083","2014",4,4,0,101125,1044.25,105.75
"11172","36084","2014",4,4,0,85750,786.5,103
"11173","36085","2014",3,3,0,60833.33,672.6667,97.66667
"11174","36086","2014",2,2,0,73750,961.5,77
"11175","36087","2014",3,3,0,126666.7,1229,101.3333
"11176","36088","2014",92,87,5,84211.23,1057.065,84.25
"11177","36089","2014",1,1,0,30400,434,70
"11178","36091","2014",1,1,0,185000,1434,129
"11179","36092","2014",3,3,0,119516.7,1056.667,111.6667
"11180","36093","2014",26,24,2,81752.58,1024.538,83.15385
"11181","36094","2014",7,7,0,46514.29,709,69.42857
"11182","36095","2014",1,1,0,55000,2619,21
"11183","36096","2014",3,3,0,57713.33,974,69
"11184","36097","2014",3,3,0,75500,668,105
"11185","36099","2014",1,1,0,77981,634,123
"11186","36100","2014",1,1,0,160500,1446,111
"11187","36101","2014",10,10,0,116500,1243.1,91
"11188","36103","2014",12,12,0,103083.3,1144.917,87
"11189","36104","2014",5,5,0,78420,839.2,89.4
"11190","36107","2014",11,11,0,85600,900.6364,95.54545
"11191","36108","2014",1,1,0,50000,1429,35
"11192","36109","2014",8,8,0,95359.62,1055.375,92.5
"11193","36110","2014",2,2,0,67000,591.5,114
"11194","36111","2014",3,3,0,60333.33,835.6667,62.66667
"11195","36112","2014",5,5,0,85700,1048,77
"11196","36113","2014",5,5,0,61480,909.4,70.2
"11197","36114","2014",4,4,0,45265.25,728.25,60.5
"11198","36116","2014",1,1,0,60000,345,174
"11199","36117","2014",6,6,0,113500,1013,107.6667
"11200","36118","2014",2,2,0,46000,627.5,76.5
"11201","36119","2014",8,8,0,112187.5,1352.25,96.75
"11202","36120","2014",5,5,0,68800,727,99.2
"11203","36121","2014",1,1,0,220000,1760,125
"11204","36122","2014",4,4,0,62250,650.5,89.75
"11205","36123","2014",5,5,0,64400,953.4,68
"11206","36124","2014",4,4,0,68625,891.75,82
"11207","36125","2014",2,2,0,112000,1019,110
"11208","36126","2014",10,10,0,71750,728.2,107.2
"11209","36127","2014",19,19,0,94615.26,1083.474,94
"11210","36128","2014",13,13,0,139380,1430.538,99.23077
"11211","36129","2014",3,3,0,69000,1178,58.33333
"11212","36130","2014",2,2,0,52000,609.5,92.5
"11213","36131","2014",6,6,0,64208.33,794,78.16667
"11214","36133","2014",5,5,0,55550,890.4,67.6
"11215","36134","2014",5,5,0,75400,688.2,111
"11216","36135","2014",1,1,0,70000,519,135
"11217","36136","2014",1,1,0,112000,732,153
"11218","36137","2014",4,4,0,99102.25,1206.25,84
"11219","36138","2014",5,5,0,80197,1234.4,74
"11220","36139","2014",7,7,0,100685.7,1211,95.28571
"11221","36140","2014",9,9,0,80833.33,1249.778,73.55556
"11222","36141","2014",16,16,0,72343.75,825.75,87.6875
"11223","36142","2014",14,14,0,133150.4,1377.357,95.35714
"11224","36143","2014",4,4,0,89000,1126.5,84.5
"11225","36145","2014",2,2,0,90750,795,113
"11226","36146","2014",3,3,0,56666.67,858.3333,65.33333
"11227","36147","2014",4,4,0,85250,682,128.75
"11228","36148","2014",5,5,0,80600,790.8,101.6
"11229","36149","2014",4,4,0,94375,1245.75,69.5
"11230","36150","2014",6,6,0,53333.33,637,87.5
"11231","36152","2014",5,5,0,77800,967,90.8
"11232","36153","2014",5,5,0,80880,918.6,97.2
"11233","36154","2014",21,19,2,88547.62,991.2381,89.85714
"11234","36155","2014",8,8,0,113537.5,1249.75,89.375
"11235","36156","2014",7,7,0,80761.14,1011,86.57143
"11236","36157","2014",1,1,0,103000,1212,85
"11237","36158","2014",8,8,0,83375,1001.625,71.875
"11238","36159","2014",39,39,0,153243.8,1358.41,113.4359
"11239","36161","2014",6,6,0,60333.33,828.5,75
"11240","36162","2014",5,5,0,78810.6,975.8,86.6
"11241","36163","2014",7,7,0,81628.57,1096,83.14286
"11242","36164","2014",2,2,0,48000,635.5,76
"11243","36165","2014",4,4,0,96166.25,806.5,137.25
"11244","36167","2014",2,2,0,154300,1359,104.5
"11245","36168","2014",8,8,0,61812.5,842.25,76.75
"11246","36169","2014",3,3,0,80400,769.3333,102.3333
"11247","36170","2014",1,1,0,30000,375,80
"11248","36171","2014",27,27,0,84956.93,907.3704,94.14815
"11249","36172","2014",1,1,0,84500,660,128
"11250","36173","2014",4,4,0,226825,1788,86
"11251","36174","2014",5,5,0,70930.2,703,100.8
"11252","36175","2014",4,4,0,64650,563.5,116.25
"11253","36176","2014",10,10,0,263110,1754.9,109.7
"11254","36177","2014",7,7,0,35714.29,597.7143,60
"11255","36178","2014",1,1,0,50000,833,60
"11256","36180","2014",4,4,0,62275,846.25,75.25
"11257","36181","2014",2,2,0,85500,878.5,102.5
"11258","36182","2014",5,4,1,74600,955.6,79.8
"11259","36184","2014",2,2,0,38000,853,44
"11260","36185","2014",5,5,0,72504.4,885.4,81.8
"11261","36186","2014",2,2,0,63500,990.5,77.5
"11262","36187","2014",1,1,0,25000,481,52
"11263","36188","2014",1,1,0,1e+05,943,106
"11264","36189","2014",11,11,0,94240.45,1052.182,91.81818
"11265","36190","2014",1,1,0,37000,1321,28
"11266","36191","2014",5,5,0,81440,705.6,108.4
"11267","36192","2014",23,23,0,84071.3,986.3913,91.30435
"11268","36193","2014",7,7,0,50033.43,717.5714,69.71429
"11269","36194","2014",8,8,0,50618.75,696.125,75.25
"11270","36195","2014",7,7,0,99055.86,1258.429,81.28571
"11271","36197","2014",7,7,0,78642.86,1137.429,74.85714
"11272","36198","2014",3,3,0,1e+05,1302,81.33333
"11273","36199","2014",10,10,0,130697,1167.6,108.1
"11274","36200","2014",13,13,0,77076.92,877.2308,85.15385
"11275","36202","2014",20,19,1,149431,1581.1,94.5
"11276","36203","2014",1,1,0,95000,1377,69
"11277","36204","2014",5,5,0,32560,760,43
"11278","36205","2014",1,1,0,35000,833,42
"11279","36207","2014",7,7,0,51571.43,882.2857,61
"11280","36208","2014",4,4,0,57250,779.5,76
"11281","36209","2014",2,2,0,121000,1364.5,98.5
"11282","36210","2014",2,2,0,68000,1421.5,72.5
"11283","36211","2014",5,5,0,107000,970.8,107.4
"11284","36212","2014",4,4,0,78963.25,646.75,125
"11285","36213","2014",4,4,0,108362.5,1047.25,96.75
"11286","36214","2014",5,5,0,64000,796,84
"11287","36215","2014",6,6,0,95666.67,1155.833,82.16667
"11288","36216","2014",2,2,0,82500,819.5,103
"11289","36219","2014",5,5,0,105600,1114.2,94
"11290","36220","2014",5,5,0,67900,808,80.2
"11291","36221","2014",5,5,0,71182,807.2,82.4
"11292","36222","2014",1,1,0,77000,1604,48
"11293","36223","2014",2,2,0,46250,580,75.5
"11294","36224","2014",15,15,0,73600,1138.067,76.73333
"11295","36225","2014",2,2,0,117535,1682,79.5
"11296","36226","2014",2,2,0,80137.5,964,78
"11297","36227","2014",3,3,0,51833.33,785.3333,60.33333
"11298","36228","2014",17,17,0,97426.47,958.7647,100.1765
"11299","36229","2014",5,5,0,83200,1061.4,77.2
"11300","36230","2014",19,19,0,75368.42,937.3158,81.94737
"11301","36231","2014",6,6,0,71666.67,916.6667,81.16667
"11302","36232","2014",9,9,0,79888.89,1124.778,75.77778
"11303","36233","2014",4,4,0,53637.5,857.75,62
"11304","36234","2014",4,4,0,64750,787.5,89.25
"11305","36235","2014",6,6,0,129891.7,1166.5,112.3333
"11306","36236","2014",4,4,0,95725,1451.5,61
"11307","36237","2014",7,7,0,51857.14,687.7143,69.71429
"11308","36238","2014",3,3,0,70833.33,1536.667,44
"11309","36239","2014",2,2,0,86500,1216.5,71.5
"11310","36240","2014",5,5,0,60300,1033.2,63.2
"11311","36241","2014",28,27,1,102098.2,1259.071,86.57143
"11312","36242","2014",1,1,0,115000,737,156
"11313","36243","2014",2,2,0,91000,1020.5,88.5
"11314","36244","2014",6,6,0,80300,1105.333,64
"11315","36246","2014",2,2,0,44105.5,1076.5,43
"11316","36247","2014",10,10,0,133086.5,1024.4,127.9
"11317","36248","2014",1,1,0,65000,929,70
"11318","37001","2014",9,9,0,76711.11,952.5556,77.44444
"11319","37002","2014",17,17,0,144391.2,1579.647,96.58824
"11320","37003","2014",154,121,33,162154.1,2016.753,86.87013
"11321","37004","2014",3,3,0,93333.33,1127.667,81.33333
"11322","37005","2014",3,3,0,78533.33,1191.333,68.33333
"11323","37006","2014",21,20,1,229257.1,1880.048,126.6667
"11324","37008","2014",30,30,0,173708,1835.967,100.7333
"11325","37009","2014",1,1,0,120000,1446,83
"11326","37010","2014",17,17,0,150147.1,1707.294,91.76471
"11327","37011","2014",14,14,0,145641.6,1509.5,99.57143
"11328","37012","2014",3,3,0,106666.7,882.6667,112
"11329","37013","2014",4,4,0,127000,1727.75,98
"11330","37014","2014",25,25,0,168966,1727.24,111.24
"11331","37015","2014",25,25,0,215312.4,2301.92,105.88
"11332","37016","2014",3,3,0,298333.3,1512.667,202
"11333","37018","2014",58,42,16,214943.4,2215.414,99.15517
"11334","37019","2014",2,2,0,67500,705,94.5
"11335","37020","2014",15,15,0,132700,1331.333,99.33333
"11336","37021","2014",16,16,0,158846.3,1417.75,114.8125
"11337","37022","2014",17,17,0,142861.1,1536.647,94
"11338","37023","2014",2,2,0,169500,2138.5,106
"11339","37024","2014",2,2,0,157500,1669.5,95
"11340","37025","2014",4,4,0,207227.2,1771.25,121
"11341","37026","2014",1,1,0,70000,619,113
"11342","37027","2014",51,48,3,154823.9,1785.333,89.60784
"11343","37028","2014",6,6,0,58666.67,886.5,64.66667
"11344","37029","2014",2,2,0,126500,1154,111.5
"11345","37030","2014",5,5,0,158840,1451,108.6
"11346","37031","2014",43,40,3,143655.6,1317.302,114.3721
"11347","37032","2014",1,1,0,85000,746,114
"11348","37033","2014",4,4,0,121360,1253.5,94.25
"11349","37034","2014",3,3,0,80294,876,92
"11350","37035","2014",4,4,0,90000,1326.75,79
"11351","37036","2014",1,1,0,90000,1636,55
"11352","37037","2014",7,7,0,122862.1,991.8571,105.1429
"11353","37038","2014",11,11,0,101336.4,1408.727,82.18182
"11354","37039","2014",3,3,0,108333.3,1200.667,92
"11355","37040","2014",1,1,0,236000,1735,136
"11356","37041","2014",6,6,0,116250,1071.667,107.3333
"11357","37042","2014",2,2,0,127000,1637,75.5
"11358","37043","2014",7,7,0,153420,1688.571,95.14286
"11359","37044","2014",4,4,0,58000,780,75
"11360","37045","2014",3,3,0,81000,1208.333,66
"11361","37046","2014",4,4,0,112500,1194.75,93.5
"11362","37047","2014",5,5,0,204920,2079.8,108
"11363","37048","2014",4,4,0,121375,1018.25,125
"11364","37049","2014",8,8,0,150125,1504.5,103
"11365","37050","2014",110,44,66,140620.8,1943.918,74.70909
"11366","37051","2014",10,10,0,107850,1521,77.7
"11367","37052","2014",7,7,0,178428.6,1622.429,111.8571
"11368","37054","2014",25,25,0,215219.2,2196.76,101.6
"11369","37055","2014",6,6,0,115083.3,1186.5,100.6667
"11370","37056","2014",5,5,0,133348,1636.4,88
"11371","37057","2014",2,2,0,169141.5,1201,140.5
"11372","37058","2014",12,12,0,133667.5,1319.167,105.3333
"11373","37059","2014",11,11,0,189336.4,1869.091,102.2727
"11374","37060","2014",10,10,0,166909,1879.2,91.1
"11375","37061","2014",12,12,0,89184.58,1876.833,76.08333
"11376","37062","2014",18,18,0,112722.2,1344.444,88.61111
"11377","37063","2014",41,35,6,96731.71,1190.366,84.31707
"11378","37064","2014",2,2,0,57500,724.5,79.5
"11379","37065","2014",1,1,0,81500,2547,32
"11380","37066","2014",5,5,0,142200,1594.6,92.2
"11381","37067","2014",13,13,0,132512,1674.385,89.53846
"11382","37068","2014",6,6,0,147166.7,1352.833,113.5
"11383","37069","2014",1,1,0,105000,1780,59
"11384","37070","2014",6,6,0,133966.7,2128.333,68
"11385","37071","2014",2,2,0,271000,1845,145
"11386","37072","2014",87,73,14,155063,1544.425,100.1264
"11387","37073","2014",11,11,0,136981.8,1506.182,93.81818
"11388","37074","2014",20,20,0,132960,1286.9,107.85
"11389","37075","2014",3,3,0,126666.7,992.6667,126
"11390","37076","2014",2,2,0,96000,1200,80
"11391","37077","2014",31,31,0,147653.9,1559.484,101.5484
"11392","37078","2014",5,5,0,129552,989,133.8
"11393","37079","2014",18,18,0,185200,1812.556,113.2222
"11394","37080","2014",3,3,0,95000,586.3333,156.6667
"11395","37081","2014",10,10,0,150925.3,1549.2,99.8
"11396","37082","2014",6,6,0,84416.67,1022.667,80.16667
"11397","37083","2014",12,10,2,132395.8,1575.083,85.5
"11398","37084","2014",5,5,0,82600,1041.4,83.2
"11399","37085","2014",9,9,0,193222.2,1874,106.3333
"11400","37086","2014",8,8,0,111875,1313.75,95.375
"11401","37087","2014",1,1,0,113000,1329,85
"11402","37088","2014",1,1,0,55500,1423,39
"11403","37089","2014",4,4,0,204562.5,1056.25,180
"11404","37090","2014",2,2,0,185550,2035.5,84.5
"11405","37091","2014",18,17,1,158777.8,1974.444,82.5
"11406","37092","2014",5,5,0,155200,1404.2,115.2
"11407","37093","2014",5,5,0,99100,1399.2,69.2
"11408","37094","2014",3,3,0,135500,1372.333,99
"11409","37095","2014",4,4,0,147787.5,1644,93.5
"11410","37096","2014",3,3,0,156333.3,1545,114
"11411","37097","2014",6,6,0,186358.3,1932.167,104.3333
"11412","37098","2014",4,4,0,93150,950.25,96
"11413","37099","2014",9,9,0,239503.9,2023.778,119.6667
"11414","37100","2014",1,1,0,189000,1890,100
"11415","37101","2014",2,2,0,202500,2055,100
"11416","37103","2014",2,2,0,92750,797.5,110.5
"11417","37104","2014",38,38,0,183185.3,1917.842,98.18421
"11418","37105","2014",6,6,0,140641.7,1475.333,101.5
"11419","37106","2014",4,4,0,111500,961,121.5
"11420","37107","2014",7,7,0,83285.71,1176.286,73.57143
"11421","37108","2014",4,4,0,120500,1620.25,74
"11422","37109","2014",96,90,6,230419.5,2303.635,102.7188
"11423","37110","2014",16,16,0,163926,1615.812,108.8125
"11424","37111","2014",17,17,0,112128.3,1282.647,88.76471
"11425","37112","2014",7,7,0,80514.29,797.7143,103
"11426","37113","2014",6,6,0,65233.33,970.5,70.5
"11427","37114","2014",2,2,0,84000,957.5,105
"11428","37115","2014",39,35,4,86625.64,975.4615,90.12821
"11429","37116","2014",10,10,0,135557.3,1683.1,88.1
"11430","37117","2014",8,8,0,125177.5,1206.25,108.5
"11431","37118","2014",13,13,0,128237.7,1298.308,96.23077
"11432","37119","2014",16,14,2,104093.8,997.5,105.6875
"11433","37121","2014",4,4,0,147250,1140.75,128.5
"11434","37122","2014",306,157,149,144296.1,1932.186,74.88889
"11435","37123","2014",38,37,1,151397.1,1779.211,87.36842
"11436","37124","2014",16,15,1,210203.6,1943.375,109.25
"11437","37125","2014",3,3,0,135666.7,882.3333,135.3333
"11438","37126","2014",1,1,0,312000,2229,140
"11439","37128","2014",14,14,0,125035.7,1466.429,92.64286
"11440","37129","2014",6,6,0,224654.2,1555.333,124.5
"11441","37130","2014",16,14,2,83687.5,1151.625,76.375
"11442","37131","2014",10,10,0,123028,1408.7,97.5
"11443","37132","2014",49,46,3,138358.8,1608.673,85.12245
"11444","37133","2014",6,6,0,101258.3,1125.5,89.33333
"11445","37134","2014",8,8,0,164125,1386,120.875
"11446","37136","2014",4,4,0,124782.5,1335.75,90.75
"11447","37138","2014",11,10,1,168090.9,1673.909,103.2727
"11448","37139","2014",56,51,5,187356.3,2008.839,98.80357
"11449","37140","2014",1,1,0,145000,1306,111
"11450","37141","2014",3,3,0,132950,1562,83
"11451","37142","2014",3,3,0,101666.7,1037,98.33333
"11452","37143","2014",9,9,0,132055.6,1259.556,100.2222
"11453","37144","2014",6,6,0,154200,1294.833,117.1667
"11454","37145","2014",4,4,0,164149.5,1311.25,134.75
"11455","37146","2014",4,4,0,174545,1805.25,96
"11456","37147","2014",4,4,0,111375,1736.75,66.25
"11457","37148","2014",5,5,0,155752.4,1151.8,123.6
"11458","37149","2014",5,5,0,134300,1237,110
"11459","37150","2014",7,7,0,142178.6,1519.857,97.14286
"11460","37151","2014",26,26,0,246914.2,2383.885,104.8846
"11461","37152","2014",16,16,0,227456.2,2155.062,114.3125
"11462","37153","2014",37,36,1,172847.5,1776.838,101.1622
"11463","37154","2014",43,38,5,188706.4,2140.233,92.67442
"11464","37155","2014",11,11,0,115477.3,1451.364,84
"11465","37156","2014",68,64,4,191522,2035.794,98.25
"11466","37157","2014",4,4,0,81250,903,85
"11467","37158","2014",10,10,0,182038,1651,111.7
"11468","37159","2014",63,60,3,177042.6,1792.587,99.31746
"11469","37160","2014",2,2,0,115000,965.5,115
"11470","37161","2014",8,8,0,143875,1037,132.625
"11471","37162","2014",1,1,0,140000,1573,89
"11472","37163","2014",29,27,2,163345.9,1841.172,90.03448
"11473","37165","2014",3,3,0,162866.7,1335,124
"11474","37166","2014",8,8,0,156375,1729.625,85.125
"11475","37167","2014",19,19,0,133286.8,1467.632,94.94737
"11476","37168","2014",5,5,0,78000,861.2,93.4
"11477","37169","2014",3,3,0,183333.3,1766.667,110.6667
"11478","37170","2014",10,8,2,130370,1440,96.6
"11479","37171","2014",17,17,0,171050,1745,99.64706
"11480","37172","2014",28,28,0,218627.6,2148.75,106.6071
"11481","37173","2014",5,5,0,80000,977.4,76.4
"11482","37174","2014",11,11,0,99654.55,1216.455,86.27273
"11483","37175","2014",12,12,0,205833.3,1717,148.0833
"11484","37176","2014",5,5,0,135600,1419.6,94.6
"11485","37177","2014",8,8,0,81250,1010.625,80
"11486","37178","2014",6,6,0,87812.5,1206.333,68.66667
"11487","37179","2014",12,12,0,255391.2,1923.667,135.3333
"11488","37180","2014",6,6,0,111277.8,1220.333,93.5
"11489","37181","2014",6,6,0,75250,837.6667,99.16667
"11490","37182","2014",8,8,0,173285,1639.625,109
"11491","37183","2014",10,10,0,136840,1493.8,87.8
"11492","37184","2014",7,7,0,70685.71,783,94.28571
"11493","37185","2014",12,12,0,206737.5,1708.167,125.9167
"11494","37186","2014",8,8,0,172146.5,1825.75,94.25
"11495","37187","2014",1,1,0,170000,842,202
"11496","37188","2014",10,10,0,96900,1179.1,81.6
"11497","37189","2014",12,11,1,96981.17,1137.5,89.41667
"11498","37190","2014",1,1,0,169000,977,173
"11499","37191","2014",1,1,0,130000,897,145
"11500","37192","2014",11,11,0,148586.4,1751.545,97
"11501","37193","2014",13,13,0,136908.8,1222.692,110.3846
"11502","37194","2014",16,16,0,171383.6,1638.438,108.75
"11503","37195","2014",124,32,92,123527.8,2101.565,59.92742
"11504","37196","2014",20,15,5,91540,979.65,89.45
"11505","37197","2014",4,4,0,132500,1183,117
"11506","37199","2014",7,7,0,98311.43,1182.571,83.85714
"11507","37200","2014",11,11,0,137563.6,1533.455,93.18182
"11508","37201","2014",7,7,0,181947.9,1464,131.2857
"11509","37202","2014",6,6,0,173500,1141.167,151.8333
"11510","37203","2014",34,31,3,231426.5,2303.294,105.7647
"11511","37204","2014",6,6,0,177328.3,1705.167,113.6667
"11512","37205","2014",12,12,0,166083.3,1772.667,101.8333
"11513","37206","2014",12,12,0,168266.8,1894.833,92.41667
"11514","37207","2014",1,1,0,80000,714,112
"11515","37208","2014",123,97,26,225098.9,2322.244,102.3333
"11516","37210","2014",5,5,0,208465.8,1546.6,138.2
"11517","37211","2014",18,17,1,162296.7,1740.333,101.6667
"11518","37212","2014",5,5,0,144700,1750.2,81
"11519","37213","2014",10,10,0,83750,1050.7,83.9
"11520","37214","2014",225,132,93,221556.1,2402.533,91.88
"11521","37216","2014",12,12,0,116541.7,1269.083,92.5
"11522","37217","2014",12,12,0,139976.5,1560.5,89.5
"11523","37218","2014",6,6,0,70100,826.8333,84.16667
"11524","37219","2014",8,8,0,158775,1560.875,111
"11525","37220","2014",4,4,0,106250,1458.5,77
"11526","37221","2014",7,7,0,87000,1091,76.85714
"11527","37222","2014",3,3,0,123066.7,1786,69.66667
"11528","37223","2014",2,2,0,122500,1564.5,81.5
"11529","37224","2014",5,5,0,137680,1739.2,86.6
"11530","37225","2014",22,22,0,198447.4,1807.318,113.6364
"11531","37226","2014",36,31,5,109072.2,1278.778,87.5
"11532","37228","2014",7,7,0,114214.3,1317.286,84.14286
"11533","37229","2014",5,5,0,110520,1105.8,103
"11534","37230","2014",9,9,0,176522.2,1836,104.3333
"11535","37231","2014",17,10,7,97600.76,973.6471,94.82353
"11536","37232","2014",21,21,0,133585.3,1285.19,97.33333
"11537","37233","2014",125,92,33,148290.8,1964.288,78.072
"11538","37234","2014",3,3,0,88861.33,1197.667,75.33333
"11539","37236","2014",11,9,2,185994.3,1545.727,127.2727
"11540","37237","2014",15,15,0,199752.7,2347.267,85.4
"11541","37238","2014",4,4,0,159750,1314.25,130.5
"11542","37240","2014",6,6,0,132500,1342.667,94
"11543","37241","2014",12,12,0,124254.2,1394.833,99.33333
"11544","37242","2014",10,10,0,124240,1465.3,92.8
"11545","37243","2014",26,26,0,211465.4,2233.962,105.7692
"11546","37244","2014",8,8,0,103062.5,1341.125,76.625
"11547","37245","2014",13,13,0,200846.2,1835.615,112.8462
"11548","37246","2014",1,1,0,247000,1614,153
"11549","37247","2014",4,3,1,95750,1416.5,73.75
"11550","37248","2014",5,5,0,128340,1070,114.4
"11551","37249","2014",10,10,0,179725,1450.6,96.8
"11552","37250","2014",15,15,0,189980,1677.2,119.6667
"11553","37251","2014",4,4,0,158425,1948.5,81.5
"11554","37252","2014",5,5,0,131200,1948.2,68.4
"11555","37253","2014",1,1,0,183000,1619,113
"11556","37254","2014",13,13,0,152317.4,1436.077,106.6923
"11557","37255","2014",3,3,0,115333.3,1426,82
"11558","37256","2014",2,2,0,167000,1698,107
"11559","37257","2014",15,15,0,147796.1,1434.6,101.2
"11560","37258","2014",2,2,0,135500,1063,129
"11561","37259","2014",6,6,0,71041.67,953.6667,89.16667
"11562","37260","2014",2,2,0,55000,800,67.5
"11563","37261","2014",1609,453,1156,155465.3,2415.943,65.31945
"11564","37262","2014",5,5,0,122200,1284.2,106.4
"11565","37263","2014",16,16,0,161997.1,2118.562,79.1875
"11566","37264","2014",14,14,0,204571.4,1802.286,115.8571
"11567","37265","2014",2,2,0,159000,1010,159.5
"11568","37266","2014",44,44,0,174213,1799.091,96.86364
"11569","37267","2014",31,31,0,199360.2,2212.581,91.3871
"11570","37268","2014",3,3,0,103000,1274.667,89.33333
"11571","37269","2014",3,3,0,79000,957,75.33333
"11572","37270","2014",20,20,0,237409.9,1856.35,125.8
"11573","37271","2014",12,12,0,126683.3,1414.833,91.08333
"11574","37272","2014",11,11,0,183450,1693.364,103
"11575","37273","2014",46,42,4,181582.4,2275.674,83.3913
"11576","37274","2014",8,8,0,81750,971,93.75
"11577","37275","2014",2,2,0,94500,818,110.5
"11578","37276","2014",19,19,0,150710.5,1513.158,99.68421
"11579","37277","2014",8,8,0,98448,1122.125,94.125
"11580","37278","2014",2,2,0,88500,1235,72.5
"11581","37279","2014",5,5,0,187590,1441.2,124.6
"11582","37280","2014",1,1,0,60000,811,74
"11583","37281","2014",28,23,5,184052.6,2190.429,87.92857
"11584","37282","2014",13,13,0,68465.38,804,91.15385
"11585","38001","2014",60,43,17,147320.7,1634.633,93.36667
"11586","38002","2014",54,4,50,72301.11,2425.278,29
"11587","38003","2014",8,8,0,211682.5,2034.125,104
"11588","38004","2014",11,2,9,110278,1715.273,65.90909
"11589","38005","2014",15,7,8,122166.3,1749.667,66.53333
"11590","38006","2014",62,22,40,112859.4,1812.952,62.24194
"11591","38009","2014",5,5,0,136190,1432.6,98.2
"11592","38010","2014",4,4,0,244355,2266,111.75
"11593","38011","2014",10,9,1,287967,2572.1,110.7
"11594","38012","2014",23,18,5,150359.9,1663.783,92.3913
"11595","38013","2014",33,27,6,196860.9,2064.394,97.63636
"11596","38015","2014",17,15,2,176151.8,2086.059,86.35294
"11597","38017","2014",11,11,0,208218.2,1954.273,108.1818
"11598","38018","2014",3,3,0,92166.67,1292.667,75.66667
"11599","38019","2014",15,11,4,183234,1851.8,101.1333
"11600","38020","2014",32,6,26,78935.47,2183.375,37.90625
"11601","38022","2014",94,73,21,153206.3,1617.755,94.3617
"11602","38023","2014",1,1,0,260000,2167,120
"11603","38026","2014",18,17,1,156367.3,1704.5,88.44444
"11604","38027","2014",18,17,1,232958.1,2324.556,102.7222
"11605","38029","2014",14,12,2,134392.9,1446.286,95.5
"11606","38030","2014",6,6,0,152416.7,1524.833,99.83333
"11607","38032","2014",4,4,0,145525,1512,109.25
"11608","38033","2014",3,3,0,203000,1897.333,105.3333
"11609","38034","2014",39,35,4,144699.1,1583.538,95.02564
"11610","38035","2014",4,4,0,197392.5,2044,97.5
"11611","38037","2014",6,6,0,163225,1645.333,98.33333
"11612","38038","2014",2,2,0,188859,1186.5,149.5
"11613","38039","2014",22,22,0,408443.9,3536.909,119.4091
"11614","38041","2014",1,1,0,75066,988,76
"11615","38042","2014",7,7,0,220571.4,1792.429,132.2857
"11616","38043","2014",7,6,1,223471.4,2153.857,105.7143
"11617","38044","2014",8,8,0,137677.5,1471.5,100.625
"11618","38045","2014",21,21,0,437984,4407.429,109.381
"11619","38046","2014",8,8,0,163031.2,1458.375,114.375
"11620","38047","2014",2,2,0,112000,1259,98.5
"11621","38048","2014",3,3,0,206000,1988.667,104.6667
"11622","38049","2014",1,1,0,45000,1607,28
"11623","38050","2014",6,6,0,177749.2,2222.167,87.83333
"11624","38051","2014",7,7,0,190000,1905.714,99.14286
"11625","38052","2014",34,20,14,161912,2175.5,80.76471
"11626","38053","2014",244,72,172,149228,1887.463,79.14754
"11627","38054","2014",7,7,0,112828.6,1596.714,78.28571
"11628","38055","2014",14,14,0,176526.4,1407.429,126.7857
"11629","38056","2014",1,1,0,135800,2263,60
"11630","38057","2014",7,5,2,314480.3,3168.143,103.1429
"11631","38058","2014",14,11,3,161905.4,1767.357,96.5
"11632","38059","2014",10,5,5,263515,3231,80.5
"11633","38061","2014",30,21,9,240936,2478.433,96.53333
"11634","38062","2014",5,5,0,188010,1727.4,109.4
"11635","38063","2014",6,6,0,140347.7,1151,120.5
"11636","38064","2014",13,12,1,209734.6,2159.308,102
"11637","38065","2014",15,14,1,167501,1756.933,98.26667
"11638","38066","2014",2,2,0,302625,1954,155
"11639","38067","2014",13,13,0,246177.5,2239.308,111
"11640","38068","2014",6,5,1,384400,2840.833,136.3333
"11641","38069","2014",7,7,0,150557.1,1453.714,104.5714
"11642","38070","2014",7,5,2,268342.9,2765.857,96.14286
"11643","38071","2014",20,15,5,193836,2496.65,80.6
"11644","38072","2014",17,15,2,145683.9,1776.235,84.05882
"11645","38073","2014",3,3,0,73700,1097.333,67.66667
"11646","38074","2014",2,2,0,167500,2577,65
"11647","38075","2014",15,10,5,230738.1,2877.8,83.33333
"11648","38076","2014",21,21,0,176715.8,1962,91.95238
"11649","38077","2014",7,6,1,262592.3,1904.857,137.5714
"11650","38078","2014",5,5,0,227386,2618.8,87.6
"11651","38080","2014",4,4,0,164647.5,1333.75,129
"11652","38081","2014",15,14,1,226067.3,2325.933,103.0667
"11653","38082","2014",13,11,2,155973.1,1598.308,101.9231
"11654","38083","2014",1,1,0,186200,1757,106
"11655","38084","2014",9,9,0,231583.3,2350.333,99.55556
"11656","38085","2014",64,57,7,208720.8,2290.344,92.34375
"11657","38086","2014",3,3,0,240286.7,2119.667,114.6667
"11658","38087","2014",42,27,15,199202.4,2277.571,89.42857
"11659","38089","2014",2,1,1,119570,1907,69
"11660","38090","2014",2,2,0,95500,1717.5,55.5
"11661","38091","2014",3,3,0,189718.3,2191.333,92.33333
"11662","38092","2014",1,1,0,115000,1885,61
"11663","38093","2014",3,3,0,118333.3,1322.333,107
"11664","38094","2014",11,10,1,148363.6,1730.545,96.18182
"11665","38095","2014",21,19,2,185604.4,1705.667,107.2857
"11666","38097","2014",30,21,9,190028.2,2305.533,83.73333
"11667","38098","2014",7,7,0,170700,1521.571,112.7143
"11668","38099","2014",3,3,0,196900,1746,112.6667
"11669","38100","2014",20,14,6,225739.5,2340.15,98.2
"11670","38101","2014",6,6,0,209083.3,2047.667,102.8333
"11671","38102","2014",7,7,0,235637.1,2256.857,104.7143
"11672","38103","2014",2,2,0,236000,2406,99.5
"11673","38104","2014",14,14,0,157221.4,1614.214,100.3571
"11674","38105","2014",12,11,1,197566.7,1875.833,107.5833
"11675","38106","2014",1,1,0,237500,2527,94
"11676","38107","2014",17,14,3,219080.6,2069.765,103.4706
"11677","38109","2014",9,9,0,306650,2163.889,144.1111
"11678","38110","2014",10,10,0,260499.5,2225,130.6
"11679","38111","2014",57,36,21,277616.7,2813.421,101.5263
"11680","38112","2014",2,1,1,54250,935,54.5
"11681","38113","2014",4,3,1,140500,1368.75,105
"11682","38114","2014",9,8,1,203841.1,2088.556,97.88889
"11683","38115","2014",7,7,0,176071.4,1752.286,105.1429
"11684","38117","2014",5,4,1,204980,1746.6,118.6
"11685","38118","2014",6,6,0,130908.3,1268.667,114.8333
"11686","38120","2014",3,3,0,256900,2222.333,122.3333
"11687","38124","2014",22,20,2,141387.1,1454,100.5
"11688","38126","2014",20,13,7,474026.5,3926.95,127.15
"11689","38127","2014",1,1,0,102000,3188,32
"11690","38128","2014",4,3,1,104875,1964,56.25
"11691","38129","2014",20,7,13,194241,3085.25,60.75
"11692","38130","2014",48,27,21,151035.8,1808.833,84.35417
"11693","38131","2014",13,12,1,228313.4,2088.231,109.7692
"11694","38133","2014",40,38,2,334961.9,2562.425,122.925
"11695","38134","2014",9,7,2,157641.2,1590.556,103.8889
"11696","38135","2014",9,9,0,177819.4,1773.667,99.33333
"11697","38136","2014",2,2,0,142250,2029,94
"11698","38137","2014",2,2,0,264000,2164.5,123
"11699","38138","2014",43,19,24,161077.6,2137,76.16279
"11700","38139","2014",11,6,5,118251.4,1532.909,77.27273
"11701","38140","2014",40,28,12,273105.8,3058.3,92.075
"11702","38141","2014",6,6,0,255583.3,2001.833,157
"11703","38144","2014",19,18,1,195716.6,2256.316,94.47368
"11704","38146","2014",6,6,0,227058.3,1913.833,124.8333
"11705","38147","2014",7,6,1,156095.7,1547.571,101.1429
"11706","38148","2014",24,22,2,174248.4,1837.5,96.66667
"11707","38149","2014",12,10,2,185083.3,2154.583,95.33333
"11708","38150","2014",64,22,42,190645.2,2534.031,72.89062
"11709","38151","2014",250,36,214,156716.2,2098.992,75.844
"11710","38152","2014",14,13,1,178312.5,1656.143,107.7143
"11711","38153","2014",2,2,0,273425,2360,116
"11712","38154","2014",1,1,0,155000,1422,109
"11713","38155","2014",19,14,5,156334.2,1557.158,101.5789
"11714","38156","2014",4,3,1,169500,2009.75,82.75
"11715","38157","2014",16,13,3,193530.9,2176.125,91.875
"11716","38158","2014",88,21,67,207669.9,2672.352,77.64773
"11717","38159","2014",3,3,0,159000,2003,79
"11718","38160","2014",19,16,3,179227.2,1896.526,92.89474
"11719","38161","2014",6,6,0,175428.3,1665.5,102
"11720","38162","2014",11,10,1,165278.2,1533.545,115.0909
"11721","38163","2014",10,9,1,106318.5,1493.3,81.5
"11722","38166","2014",5,5,0,201925.6,2208,92.8
"11723","38167","2014",9,9,0,202486.7,1802.556,112.3333
"11724","38169","2014",247,29,218,140633.5,2037.636,68.19433
"11725","38170","2014",26,11,15,240754.6,2826.846,83.38462
"11726","38171","2014",2,2,0,269700,2293,115
"11727","38172","2014",12,8,4,201962.5,2383.333,89.83333
"11728","38173","2014",4,4,0,167500,1764.25,105.25
"11729","38174","2014",11,10,1,163535.5,1481.727,118.1818
"11730","38175","2014",46,24,22,174543.5,2189.783,78.34783
"11731","38176","2014",12,12,0,237887.5,2210.75,108.3333
"11732","38177","2014",1,1,0,119000,1488,80
"11733","38179","2014",65,14,51,167957.1,2726.246,61.16923
"11734","38180","2014",6,6,0,177617,1686.5,109.5
"11735","38181","2014",37,12,25,179781.1,2447.216,76.08108
"11736","38182","2014",34,28,6,158284,1637.588,100.2647
"11737","38183","2014",1,1,0,227000,1876,121
"11738","38184","2014",16,15,1,235873.4,2148.562,110.4375
"11739","38185","2014",2120,58,2062,147374.6,2375.482,63.7
"11740","38186","2014",37,6,31,60780.16,1683.189,35.94595
"11741","38187","2014",21,15,6,165802.4,1696.762,94.04762
"11742","38188","2014",6,5,1,377233.3,3233.333,121.1667
"11743","38189","2014",52,43,9,218924.6,2501.538,90.61538
"11744","38190","2014",6,6,0,142550,1676.5,86.83333
"11745","38191","2014",160,6,154,155926.5,4168.012,35.25625
"11746","38192","2014",2,2,0,310975,3430.5,98
"11747","38193","2014",116,78,38,177503,2153.276,84.97414
"11748","38194","2014",19,18,1,176657.1,1751,107.7895
"11749","38195","2014",5,5,0,172540,1584.2,107.8
"11750","38197","2014",13,11,2,228404.1,2296.154,104.7692
"11751","38198","2014",13,11,2,158586.9,1589.154,99.15385
"11752","38199","2014",15,13,2,243722,2141.533,114.1333
"11753","38200","2014",38,26,12,263310.2,2845.237,92.57895
"11754","38203","2014",3,3,0,169000,2162.333,83.66667
"11755","38204","2014",2,1,1,50000,978,58.5
"11756","38205","2014",34,24,10,213333,3170.324,72.05882
"11757","38206","2014",7,7,0,286059.4,2182.714,129.5714
"11758","38207","2014",3,3,0,86666.67,1765.333,56.33333
"11759","38209","2014",2,2,0,217750,1346,161.5
"11760","38210","2014",7,7,0,248398.6,2175.143,114
"11761","38211","2014",3,3,0,144623.3,1369.667,133
"11762","38212","2014",10,8,2,103790,1575.5,68
"11763","38213","2014",2,2,0,144500,1645,87.5
"11764","38215","2014",19,18,1,239110.5,2252.421,113.7895
"11765","38218","2014",5,5,0,107680,926.8,109.4
"11766","38219","2014",5,5,0,169400,1664.6,106.4
"11767","38221","2014",1,1,0,221800,2092,106
"11768","38222","2014",5,5,0,200609.8,2160.2,96.6
"11769","38223","2014",15,15,0,318465.7,2392.867,137.6667
"11770","38225","2014",61,35,26,179977.5,2608.148,73.62295
"11771","38226","2014",11,11,0,108007.3,1638.364,73.27273
"11772","38228","2014",3,3,0,191300,1972.333,100.3333
"11773","38229","2014",180,50,130,315347.1,3375.028,91.57778
"11774","38230","2014",8,8,0,257975,2393.25,109.125
"11775","38231","2014",11,11,0,152561.7,1487,100.3636
"11776","38232","2014",5,5,0,167280.6,1690.6,103.2
"11777","38235","2014",1,1,0,272500,2547,107
"11778","38236","2014",13,11,2,162187.9,1708.308,106.2308
"11779","38238","2014",12,12,0,212452.8,1998.75,106.6667
"11780","38239","2014",58,41,17,203678.4,2150.293,95.37931
"11781","38240","2014",5,5,0,189605,1845.4,105.2
"11782","38242","2014",13,12,1,205115.4,2043.923,102.1538
"11783","38243","2014",5,4,1,136690,1508.6,89.8
"11784","38244","2014",7,7,0,194521.4,1871.857,110.1429
"11785","38245","2014",1,1,0,238150,1985,120
"11786","38246","2014",8,8,0,135527.2,1304.5,106.25
"11787","38247","2014",44,36,8,129021.2,1645.682,81.75
"11788","38248","2014",4,4,0,271450,2003.75,136.75
"11789","38249","2014",45,21,24,362582.4,3643.467,100.0667
"11790","38250","2014",4,4,0,191912.5,1738,110
"11791","38253","2014",233,9,224,121383.6,3280.365,35.93991
"11792","38254","2014",5,5,0,195960,2692.8,77.8
"11793","38255","2014",1,1,0,238000,1233,193
"11794","38256","2014",17,16,1,209687.1,2013,103.8824
"11795","38258","2014",2,2,0,217500,2727,96
"11796","38259","2014",10,10,0,171905,1916.3,93.7
"11797","38260","2014",4,4,0,273112.5,2272.5,119.5
"11798","38261","2014",42,30,12,179757.9,1938.476,95.19048
"11799","38263","2014",2,2,0,76500,719.5,106.5
"11800","38264","2014",13,4,9,95611.54,1894.923,48.53846
"11801","38265","2014",18,9,9,125115.1,1522.889,84
"11802","38266","2014",9,8,1,130777.8,1585.444,84.33333
"11803","38267","2014",6,6,0,184141.7,1657.5,113.8333
"11804","38269","2014",40,13,27,98963.02,1503.325,67.775
"11805","38270","2014",12,10,2,237433.3,2176.417,109.3333
"11806","38271","2014",2,2,0,360450,3444,105
"11807","38272","2014",2,1,1,145250,1239,117.5
"11808","38275","2014",2,2,0,187500,1821,101.5
"11809","38276","2014",20,15,5,176103.5,1877.6,93.85
"11810","38277","2014",3,3,0,237641.7,2194.333,108
"11811","38278","2014",4,4,0,227162.5,2223.25,101.5
"11812","38279","2014",9,9,0,212122.2,2395.444,87
"11813","38280","2014",2,2,0,109650,1110.5,99
"11814","38281","2014",22,13,9,188154.6,2439.364,79.95455
"11815","38282","2014",9,9,0,212554.4,1847.778,114.7778
"11816","38283","2014",1,1,0,144000,929,155
"11817","38285","2014",3,3,0,141866.7,1566.667,90
"11818","38287","2014",5,5,0,158020,1360.8,114
"11819","38288","2014",10,8,2,235282,2434,99
"11820","38289","2014",18,6,12,206246.9,4099.167,55.44444
"11821","38290","2014",3,3,0,169833.3,1585,106.6667
"11822","38291","2014",7,7,0,165484.3,1666.571,101.2857
"11823","38292","2014",25,23,2,193749.8,2003.84,100.72
"11824","38294","2014",5,5,0,300450,2337.8,131.6
"11825","38295","2014",5,5,0,139636,1527,87.2
"11826","38296","2014",5,5,0,162000.2,1912.2,95
"11827","38297","2014",25,21,4,156761,1982.48,84.44
"11828","38298","2014",41,22,19,129516.1,1524.244,90.04878
"11829","38300","2014",4,4,0,117925,1368.25,91.75
"11830","38301","2014",3,3,0,285820,3127.667,89
"11831","38303","2014",4,4,0,250725,3508.5,74
"11832","38304","2014",15,13,2,148886.3,1558.933,100
"11833","38307","2014",2,1,1,147500,2334,66.5
"11834","38308","2014",2,2,0,132100,1144.5,110
"11835","38309","2014",8,3,5,244037.1,2561.75,94.75
"11836","38310","2014",11,11,0,183372.7,1853.182,109.3636
"11837","38311","2014",3,3,0,147666.7,1646,93
"11838","38313","2014",1,1,0,117000,1258,93
"11839","38314","2014",75,35,40,167191.1,2188.467,81.05333
"11840","38315","2014",42,20,22,115240,1482.929,76
"11841","38316","2014",86,25,61,131786.7,2002.605,67.16279
"11842","38317","2014",93,13,80,126483.2,1873.613,67.92473
"11843","38318","2014",38,19,19,147122.4,1930.526,77.21053
"11844","38319","2014",5,4,1,120557,1402.4,97.6
"11845","38320","2014",22,21,1,138690.5,1516.955,90.63636
"11846","38321","2014",1,1,0,180000,989,182
"11847","38322","2014",1,1,0,150000,1364,110
"11848","38323","2014",11,11,0,175045.5,1763.182,113.7273
"11849","38324","2014",5,5,0,176424,1542.6,111.6
"11850","38325","2014",5,5,0,224225.6,2000,120.2
"11851","38326","2014",1,1,0,184000,1415,130
"11852","38328","2014",4,4,0,225875,2494.5,95.5
"11853","38329","2014",1,1,0,115000,1027,112
"11854","38331","2014",5,5,0,204760,1650.6,124.4
"11855","38332","2014",24,15,9,157617.7,1846.208,84.41667
"11856","38333","2014",2,2,0,67000,1267.5,56.5
"11857","38334","2014",10,10,0,304293.2,2457.5,121.5
"11858","38335","2014",9,9,0,158335,1895.556,93.33333
"11859","38336","2014",21,17,4,201745.5,2156.19,95.38095
"11860","38337","2014",56,28,28,161976.2,1837.75,86.53571
"11861","38338","2014",5,5,0,199518,2260.2,89.2
"11862","38339","2014",15,13,2,186824.7,1893.933,99.93333
"11863","38340","2014",20,11,9,123307.5,1555,74.75
"11864","38341","2014",10,9,1,218724,1936.6,115.3
"11865","38342","2014",1,1,0,355000,5071,70
"11866","38343","2014",14,14,0,174030.4,1973.857,92.57143
"11867","38344","2014",69,44,25,150768.3,1753,87.92754
"11868","38345","2014",7,7,0,239657.1,1978.714,125
"11869","38346","2014",4,4,0,203750,1725.5,132.75
"11870","38347","2014",5,4,1,104116,2322.4,66
"11871","38348","2014",25,25,0,213991.4,1935.4,114.56
"11872","38349","2014",14,12,2,159568.1,1971.143,81
"11873","38350","2014",3,3,0,286646.7,2627.667,116.6667
"11874","38351","2014",6,6,0,221416.7,2106.333,119.5
"11875","38352","2014",19,18,1,230315.8,2266.684,98.15789
"11876","38353","2014",3,3,0,154834.7,1893.333,81.33333
"11877","38354","2014",2,1,1,153500,1505.5,102.5
"11878","38355","2014",4,4,0,158125,2426,65
"11879","38356","2014",2,2,0,122000,1402.5,87
"11880","38357","2014",13,11,2,146038.8,1638.769,97.84615
"11881","38358","2014",3,3,0,225416.7,2212.667,102
"11882","38359","2014",9,9,0,144327.2,1518,100.7778
"11883","38360","2014",3,3,0,183700,1541.667,105
"11884","38362","2014",9,7,2,239972.2,2296.444,99.88889
"11885","38363","2014",7,7,0,147214.3,1687.429,94.57143
"11886","38364","2014",5,5,0,169856,1590.8,102.4
"11887","38365","2014",2,2,0,130750,1661,78.5
"11888","38366","2014",3,3,0,156466.7,1234.667,145
"11889","38368","2014",7,7,0,247385.7,2291,110.4286
"11890","38369","2014",8,8,0,175543.8,1709.625,101.875
"11891","38370","2014",2,2,0,277459.5,1118.5,222.5
"11892","38372","2014",6,6,0,193400,1752.333,107.8333
"11893","38373","2014",4,4,0,245763.8,2190.75,128
"11894","38374","2014",25,24,1,178372.4,1639.76,109.48
"11895","38376","2014",8,8,0,145137.5,1474.625,107.75
"11896","38377","2014",43,34,9,152496.9,1680.395,91.18605
"11897","38378","2014",31,26,5,191334.9,1879.742,104.6452
"11898","38379","2014",4,4,0,144257.5,1341.75,105.25
"11899","38381","2014",15,15,0,165404.3,1651.533,105.1333
"11900","38382","2014",145,38,107,200613.9,2526.772,79.37931
"11901","38383","2014",20,15,5,219511.5,2203.35,103.4
"11902","38384","2014",26,16,10,149858.9,1574.231,99.15385
"11903","38386","2014",10,9,1,161605,1635.7,105.1
"11904","38387","2014",8,2,6,133966.9,1809.875,86.75
"11905","38388","2014",17,16,1,262913.2,2722.824,96
"11906","38389","2014",24,22,2,173548.8,1839.167,97.625
"11907","38390","2014",5,5,0,167450,1265.2,136.2
"11908","38391","2014",2,2,0,197500,1457.5,122
"11909","38392","2014",5,5,0,235952,2235.2,100.8
"11910","38393","2014",10,8,2,171560,1663.7,107.1
"11911","38394","2014",13,13,0,183258.4,2068.385,89.76923
"11912","38395","2014",19,15,4,179974.9,2532,74.94737
"11913","38396","2014",7,4,3,103812.9,1419.571,66
"11914","38397","2014",53,38,15,450750.7,3715,125.1132
"11915","38398","2014",6,6,0,136593.3,1392.667,105.1667
"11916","38399","2014",36,26,10,171019,1803.889,99.38889
"11917","38400","2014",25,18,7,196288.1,2192.16,89.88
"11918","38401","2014",9,9,0,174167.8,1751.222,99.77778
"11919","38402","2014",6,5,1,150700,1998.833,76.16667
"11920","38403","2014",2,2,0,103250,1376,82.5
"11921","38404","2014",2,2,0,79500,673.5,118
"11922","38405","2014",14,14,0,182379.4,1926.929,98.85714
"11923","38406","2014",1,1,0,136000,1789,76
"11924","38407","2014",6,6,0,234305,2245,110
"11925","38408","2014",11,11,0,265445.9,2273.091,122.1818
"11926","38409","2014",6,6,0,178068.3,1777.5,99.33333
"11927","38410","2014",6,6,0,244000,1973.167,120.1667
"11928","38412","2014",36,29,7,137622.5,1852.778,79.52778
"11929","38413","2014",2,2,0,183000,2169,95
"11930","38415","2014",5,5,0,189240,1403,127.6
"11931","38416","2014",87,37,50,133966.2,1674.126,79.7931
"11932","38417","2014",1,1,0,440000,3492,126
"11933","38418","2014",3,3,0,120393.3,2248,52.33333
"11934","38420","2014",2,2,0,216625,2079,104.5
"11935","38421","2014",331,29,302,140512,2176.785,63.56495
"11936","38422","2014",56,35,21,297069.6,3080.982,97.60714
"11937","38423","2014",68,13,55,183401.4,2174.221,80.17647
"11938","38424","2014",2,2,0,136500,1256,108.5
"11939","38425","2014",37,30,7,173301.4,1938.081,89.02703
"11940","38426","2014",6,6,0,210913.8,2275.5,95.66667
"11941","38427","2014",3,3,0,181151.7,1621.333,112.6667
"11942","38429","2014",3,3,0,123628,1857,63.66667
"11943","38430","2014",1,1,0,252000,1518,166
"11944","38431","2014",17,17,0,413730.9,3411.588,127.1765
"11945","38432","2014",4,3,1,167875,1508.25,126.25
"11946","38433","2014",10,5,5,236140,2480.5,104
"11947","38434","2014",4,4,0,170616.2,2435.75,71.75
"11948","38436","2014",14,14,0,299405,2628.429,118
"11949","38437","2014",1,1,0,152000,1394,109
"11950","38438","2014",1,1,0,440000,9362,47
"11951","38439","2014",20,18,2,174336.5,2018.85,90.55
"11952","38440","2014",4,3,1,162775,1669,103.25
"11953","38442","2014",15,9,6,120975,1703.733,70.46667
"11954","38443","2014",3,3,0,121265,1470,89
"11955","38444","2014",1,1,0,113000,983,115
"11956","38445","2014",7,5,2,181178.6,2133.286,86.85714
"11957","38446","2014",8,7,1,149144.4,1941.75,78
"11958","38448","2014",11,9,2,208936.4,2083.727,101.7273
"11959","38449","2014",50,44,6,183621.7,2087.88,94.54
"11960","38450","2014",5,5,0,206440,2061,103.2
"11961","38451","2014",27,25,2,219012,2193.741,102.3333
"11962","38452","2014",4,4,0,250487.5,2501.75,100.25
"11963","38453","2014",10,9,1,166054,1649.1,108.4
"11964","38454","2014",7,7,0,172235,1420.571,125.4286
"11965","38455","2014",27,27,0,203114.2,2085.333,96.33333
"11966","38456","2014",4,4,0,171368.8,1715.75,104.75
"11967","38457","2014",29,22,7,127621.7,1384.034,93.10345
"11968","38458","2014",5,5,0,128935,1256.4,113.2
"11969","38459","2014",8,8,0,208247.5,1908.125,109.125
"11970","38460","2014",3,3,0,161466.7,1749,94.66667
"11971","38462","2014",3,3,0,135666.7,2647.667,56.33333
"11972","38463","2014",11,11,0,229770.5,1856.455,121.8182
"11973","38464","2014",13,13,0,169061.8,1860,90.38462
"11974","38465","2014",13,11,2,161805.4,1397.231,113.9231
"11975","38466","2014",6,3,3,210333.3,2739.333,77.33333
"11976","38467","2014",12,12,0,211613.2,1937.333,111
"11977","38468","2014",27,19,8,156166.5,1697.815,93.37037
"11978","38470","2014",1,1,0,138500,1319,105
"11979","38471","2014",13,9,4,265420.4,3153,90.84615
"11980","38472","2014",2,2,0,281100,2790,100
"11981","38473","2014",6,6,0,156265,1672.5,93.5
"11982","38474","2014",113,34,79,193248.6,2553.885,75.97345
"11983","38475","2014",13,13,0,245093.8,2345.769,105.7692
"11984","38476","2014",6,6,0,200988.3,1948,102.6667
"11985","38478","2014",9,9,0,190212.8,1838.333,109
"11986","38479","2014",13,11,2,165792.3,1601.923,103
"11987","38480","2014",16,10,6,197914.7,2237,94.3125
"11988","38481","2014",10,10,0,196485.4,1972,99.8
"11989","38483","2014",18,17,1,198645,2090.944,102.8333
"11990","38484","2014",15,14,1,233680,2352.867,100.6667
"11991","38485","2014",165,14,151,155284.7,2164.206,69.56364
"11992","38486","2014",69,31,38,285208.8,2994.841,95.66667
"11993","38487","2014",18,18,0,292433.5,2412.611,120.6667
"11994","38488","2014",3,3,0,219300,1891.667,118.6667
"11995","38490","2014",7,7,0,200685.7,1866.286,116.1429
"11996","38492","2014",6,6,0,191491.7,1862.833,102
"11997","38494","2014",6,6,0,176042.5,1526.5,110
"11998","38495","2014",1,1,0,152000,2054,74
"11999","38496","2014",8,8,0,201305.6,1815.5,111.75
"12000","38498","2014",8,8,0,161983.8,1512.75,104.125
"12001","38499","2014",9,9,0,112068.4,1286.778,95.77778
"12002","38500","2014",7,7,0,180892.9,2049.571,88.85714
"12003","38501","2014",23,17,6,191112.4,2469.87,79.86957
"12004","38503","2014",1,1,0,350000,2333,150
"12005","38504","2014",15,14,1,244463.1,2911,95.66667
"12006","38505","2014",5,5,0,119525,1274.2,102.4
"12007","38507","2014",64,51,13,209716.1,2371.922,92
"12008","38508","2014",3,3,0,110666.7,1530.333,73.66667
"12009","38509","2014",71,28,43,124232,1607.493,79.49296
"12010","38511","2014",23,14,9,222375.5,2574.957,86.95652
"12011","38512","2014",4,4,0,247650,1825.5,146.5
"12012","38513","2014",2,2,0,277825,2329.5,117.5
"12013","38514","2014",3,3,0,118333.3,2218,51.66667
"12014","38515","2014",18,16,2,178610.1,2028.722,90.05556
"12015","38516","2014",74,20,54,264835.3,2878.73,88.16216
"12016","38517","2014",68,34,34,142476.7,1745.676,85.69118
"12017","38518","2014",2,1,1,63750,934.5,67.5
"12018","38519","2014",35,24,11,235641.4,2581.343,91.71429
"12019","38520","2014",4,4,0,165425,1767,97
"12020","38522","2014",5,5,0,69650,1392,50.4
"12021","38524","2014",53,37,16,288874.7,3038.849,98.07547
"12022","38525","2014",6,3,3,158003.7,1560.667,102.6667
"12023","38527","2014",3,3,0,294000,3322,90.66667
"12024","38528","2014",5,5,0,252840,1976.4,137
"12025","38529","2014",42,22,20,251260.2,2852.595,87.5
"12026","38530","2014",23,11,12,185703.4,2378.478,84.04348
"12027","38531","2014",3,3,0,153838.3,1497.667,104
"12028","38532","2014",9,9,0,185375.6,1711.222,124.2222
"12029","38533","2014",6,4,2,345546.3,3037.167,114.1667
"12030","38535","2014",1,1,0,120000,2400,50
"12031","38536","2014",6,6,0,197475,1822.167,109
"12032","38537","2014",78,55,23,183082.8,2231.692,85.02564
"12033","38538","2014",29,14,15,233087.9,2768.759,86.31034
"12034","38539","2014",3,3,0,186883.3,1943.333,91.33333
"12035","38540","2014",9,6,3,248412.3,2682.889,93.44444
"12036","38542","2014",6,6,0,215216.7,1922.667,118.3333
"12037","38543","2014",26,21,5,195661.3,2364.115,102.2308
"12038","38544","2014",293,77,216,158065.1,1995.621,79.08191
"12039","38545","2014",67,36,31,248055.2,2839.836,88.92537
"12040","38546","2014",7,7,0,287259.3,2208,127.4286
"12041","38547","2014",75,29,46,168991.4,2268.693,74.74667
"12042","38548","2014",198,22,176,121605.3,2427.47,49.12121
"12043","38550","2014",4,2,2,193750,3967.5,45.25
"12044","38552","2014",1,1,0,75000,915,82
"12045","38553","2014",102,80,22,182389.1,1944.461,93.87255
"12046","38554","2014",6,5,1,221383.3,2309.167,95.33333
"12047","38555","2014",10,10,0,127620.7,1538.1,82.2
"12048","38556","2014",4,4,0,209175,1636.5,122.25
"12049","38557","2014",34,33,1,280765.3,2756.853,104.2353
"12050","38558","2014",14,8,6,240456.6,2825.143,85.85714
"12051","38559","2014",2,2,0,180500,1662.5,111.5
"12052","38560","2014",10,7,3,104959,1219.5,84.3
"12053","38561","2014",15,15,0,146171.3,1280.4,116.5333
"12054","38562","2014",60,17,43,136605.3,2008.133,70.08333
"12055","38563","2014",217,53,164,167238.7,2123.355,79
"12056","38564","2014",1,1,0,49000,766,64
"12057","38565","2014",93,58,35,255018.7,2707.054,96.74194
"12058","38566","2014",7,7,0,254935.7,2203.571,113.5714
"12059","38567","2014",89,3,86,77322.48,2366.742,35.07865
"12060","39001","2014",6,6,0,126333.3,1323.333,98.66667
"12061","39002","2014",1,1,0,109000,1313,83
"12062","39003","2014",1,1,0,65000,575,113
"12063","39006","2014",4,4,0,113625,1018.5,95.75
"12064","39008","2014",12,12,0,132155.9,1289.167,115.6667
"12065","39009","2014",1,1,0,115000,1198,96
"12066","39011","2014",3,3,0,97000,975.6667,99.33333
"12067","39013","2014",35,28,7,97893.71,1250.914,81.28571
"12068","39015","2014",3,3,0,112000,1457.333,77
"12069","39016","2014",14,13,1,118070.4,1061.786,114.9286
"12070","39017","2014",5,5,0,115160,1386.8,76
"12071","39018","2014",8,8,0,145125,1264.5,109.125
"12072","39020","2014",1,1,0,120000,1333,90
"12073","39021","2014",2,2,0,143750,1476,90.5
"12074","39022","2014",8,8,0,131646.2,1237.125,111.375
"12075","39024","2014",4,4,0,102500,1107.75,91
"12076","39025","2014",4,4,0,83125,850.75,91.25
"12077","39026","2014",1,0,1,98000,1324,74
"12078","39027","2014",1,1,0,130000,1566,83
"12079","39028","2014",3,3,0,95666.67,1143,107
"12080","39029","2014",3,3,0,123000,1035.667,119
"12081","39030","2014",7,7,0,177807.1,1411.143,131.8571
"12082","39031","2014",2,2,0,141750,945.5,158
"12083","39032","2014",2,2,0,260862.5,1862.5,139
"12084","39034","2014",4,4,0,147306.2,1308.5,113.25
"12085","39035","2014",2,2,0,57500,1083,51
"12086","39038","2014",3,3,0,154666.7,1420.333,109
"12087","39039","2014",1,0,1,125310,1019,123
"12088","39040","2014",1,1,0,170000,1006,169
"12089","39042","2014",7,7,0,232214.3,2138.857,109.1429
"12090","39043","2014",18,17,1,102287.6,1343.611,81.94444
"12091","39046","2014",1,1,0,1e+05,1333,75
"12092","39047","2014",7,3,4,141290.7,1938.857,77.57143
"12093","39048","2014",2,2,0,140000,1279.5,110
"12094","39049","2014",5,5,0,181380,1402.8,119.8
"12095","39050","2014",2,2,0,125850,1168.5,114.5
"12096","39051","2014",4,4,0,85775,1108.25,78
"12097","39052","2014",1,1,0,115000,1438,80
"12098","39053","2014",1,1,0,60620,1010,60
"12099","39054","2014",1,1,0,90000,900,100
"12100","39056","2014",9,8,1,104852.8,1280.111,81.11111
"12101","39059","2014",18,7,11,174583.4,2107.444,88.16667
"12102","39060","2014",1,1,0,180000,1111,162
"12103","39061","2014",1,1,0,195000,1327,147
"12104","39062","2014",2,2,0,136000,1548,88
"12105","39063","2014",4,3,1,125500,1027,114
"12106","39066","2014",1,1,0,119000,1178,101
"12107","39068","2014",1,1,0,135000,1688,80
"12108","39070","2014",2,2,0,141500,1357.5,95
"12109","39072","2014",2,2,0,95500,809.5,118
"12110","39076","2014",2,2,0,138300,1330.5,119
"12111","39077","2014",1,1,0,65000,903,72
"12112","39078","2014",9,6,3,101044.4,1290.222,81.33333
"12113","39081","2014",3,3,0,150666.7,1229,131
"12114","39083","2014",3,3,0,170516.7,1743.667,92.66667
"12115","39084","2014",1,1,0,134000,1340,100
"12116","39088","2014",6,6,0,101283.3,1088.667,96
"12117","39090","2014",2,2,0,118000,1072.5,129.5
"12118","39091","2014",1,1,0,75000,600,125
"12119","39092","2014",1,1,0,1e+05,1266,79
"12120","39093","2014",3,3,0,120000,1299.333,94
"12121","39094","2014",1,1,0,59000,656,90
"12122","39095","2014",1,1,0,70000,583,120
"12123","39096","2014",6,6,0,80666.67,1035.167,81.16667
"12124","39097","2014",71,36,35,115310.7,1337.549,85.1831
"12125","39099","2014",2,2,0,185500,1384.5,135.5
"12126","39100","2014",1,1,0,75000,714,105
"12127","39101","2014",9,9,0,143044.4,1381.889,108.1111
"12128","39102","2014",2,2,0,171110,1737,98.5
"12129","39103","2014",1,1,0,70000,473,148
"12130","39104","2014",3,3,0,56500,731.6667,75
"12131","39105","2014",1,1,0,55000,873,63
"12132","39106","2014",1,1,0,470000,2883,163
"12133","39109","2014",2,2,0,82500,1105.5,84.5
"12134","39110","2014",1,1,0,172700,1416,122
"12135","39114","2014",7,7,0,240142.9,2038.571,127.7143
"12136","39116","2014",1,1,0,192300,1602,120
"12137","39117","2014",2,1,1,117500,1698,67
"12138","39118","2014",1,1,0,182000,1159,157
"12139","39121","2014",3,3,0,139666.7,1032.667,153
"12140","39122","2014",5,5,0,89646.2,1024,92.8
"12141","39124","2014",6,6,0,90333.33,837,115.6667
"12142","39126","2014",2,1,1,102000,1860.5,50.5
"12143","39127","2014",1,1,0,72500,636,114
"12144","39128","2014",9,9,0,109888.9,1327.333,92.22222
"12145","39130","2014",3,3,0,149500,2033.667,77.33333
"12146","39131","2014",7,7,0,145678.6,1413.857,102.4286
"12147","39133","2014",2,1,1,126500,1093,105
"12148","39134","2014",3,3,0,159833.3,1105.333,145.3333
"12149","39136","2014",1,1,0,46000,622,74
"12150","39137","2014",6,6,0,115595.8,966.5,112.3333
"12151","39138","2014",3,3,0,121333.3,1288.667,99.33333
"12152","39140","2014",1,1,0,71200,757,94
"12153","39141","2014",5,5,0,131000,1189.8,111.2
"12154","39146","2014",1,0,1,92500,1652,56
"12155","39147","2014",1,1,0,221000,1727,128
"12156","39149","2014",1,1,0,91000,1820,50
"12157","39150","2014",10,9,1,123990,1632.9,77.4
"12158","39153","2014",5,5,0,158300,1683.6,96.2
"12159","39154","2014",5,4,1,116080,1220.4,91.8
"12160","39155","2014",1,1,0,70000,833,84
"12161","39157","2014",2,2,0,117100,862.5,148.5
"12162","39159","2014",3,3,0,71666.67,912,76.66667
"12163","39160","2014",8,8,0,87990,1048.875,88.875
"12164","39162","2014",1,1,0,89000,1618,55
"12165","39163","2014",1,1,0,95000,709,134
"12166","39164","2014",5,3,2,105700,1269.4,81.8
"12167","39166","2014",2,2,0,105710,867.5,113.5
"12168","39167","2014",1,1,0,40000,533,75
"12169","39169","2014",6,6,0,156650,1424.333,110.8333
"12170","39170","2014",5,5,0,134000,1307.2,100.4
"12171","39171","2014",9,9,0,146188.9,1269.556,116.7778
"12172","39172","2014",3,3,0,147333.3,1393.333,101.3333
"12173","39173","2014",9,9,0,52111.11,654.2222,83.55556
"12174","39175","2014",1,1,0,193500,3225,60
"12175","39176","2014",2,2,0,140500,1792,78
"12176","39177","2014",8,8,0,110185.8,1200.625,96.625
"12177","39178","2014",2,2,0,116590,1137.5,100.5
"12178","39179","2014",3,3,0,91666.67,1116,79.33333
"12179","39180","2014",1,1,0,60000,588,102
"12180","39182","2014",5,5,0,125260,1276.6,99.4
"12181","39183","2014",5,5,0,145310,1607.6,96.4
"12182","39184","2014",2,2,0,91068.5,824,107.5
"12183","39185","2014",2,2,0,123150,1059,111.5
"12184","39187","2014",2,2,0,269100,1969.5,136.5
"12185","39188","2014",3,3,0,135566.7,1381,98.66667
"12186","39189","2014",20,20,0,120455,1374.5,88.95
"12187","39190","2014",8,8,0,166760,1865.5,90.875
"12188","39193","2014",11,11,0,141518.2,1386.273,109.1818
"12189","39194","2014",7,7,0,134354.3,1297.143,104.5714
"12190","39197","2014",2,2,0,114000,979,105
"12191","39198","2014",237,113,124,108478.6,1327.895,83.63291
"12192","39199","2014",14,14,0,187578.6,1838.5,105.7857
"12193","39200","2014",2,2,0,118600,873.5,135.5
"12194","39201","2014",4,4,0,115000,1208.25,96.75
"12195","39202","2014",1,0,1,139775,772,181
"12196","39203","2014",1,1,0,134000,1117,120
"12197","39205","2014",3,3,0,192983.3,1380.667,138.3333
"12198","39206","2014",1,1,0,120000,2791,43
"12199","39209","2014",1,1,0,70363,506,139
"12200","39210","2014",5,5,0,137820,1415.6,97.4
"12201","39211","2014",2,2,0,127414,1180.5,102.5
"12202","39214","2014",1,1,0,89650,586,153
"12203","39216","2014",3,2,1,101666.7,1067.667,92
"12204","39217","2014",4,4,0,218762.5,1790,132.5
"12205","39218","2014",4,4,0,138750,1096,122.5
"12206","39219","2014",7,6,1,185917.1,1521.143,122.8571
"12207","39223","2014",1,1,0,124000,1148,108
"12208","39227","2014",1,0,1,30000,638,47
"12209","39228","2014",7,7,0,156142.9,1299.143,117
"12210","39229","2014",1,1,0,85050,721,118
"12211","39233","2014",27,22,5,142819.4,1554.815,96.59259
"12212","39235","2014",17,14,3,133081.5,1494.294,91.11765
"12213","39240","2014",2,2,0,136500,1602,92.5
"12214","39241","2014",6,6,0,120366.7,1130.833,102.8333
"12215","39244","2014",1,1,0,107000,1427,75
"12216","39245","2014",4,4,0,122300,1057.25,110.5
"12217","39246","2014",5,5,0,154865.2,1507.2,126.2
"12218","39249","2014",1,1,0,135000,1286,105
"12219","39250","2014",1,1,0,50000,893,56
"12220","39251","2014",8,8,0,142750,1253.875,116.125
"12221","39252","2014",7,6,1,137792.9,1204.286,113
"12222","39253","2014",1,1,0,45500,1138,40
"12223","39255","2014",1,1,0,34000,548,62
"12224","39258","2014",6,5,1,137000,1131,126.6667
"12225","39261","2014",1,1,0,135000,668,202
"12226","39262","2014",1,1,0,320000,2065,155
"12227","39263","2014",2,2,0,80000,700,110
"12228","39266","2014",5,5,0,111120,1325.6,87.6
"12229","39268","2014",1,1,0,90000,1154,78
"12230","39269","2014",1,1,0,226000,2132,106
"12231","39271","2014",2,2,0,139750,1836,101
"12232","39273","2014",3,3,0,67833.33,771.3333,86.66667
"12233","39274","2014",4,3,1,238185,3098.5,73
"12234","39275","2014",12,8,4,156735,2062.5,74.08333
"12235","39277","2014",1,1,0,135480,903,150
"12236","39278","2014",1,1,0,50000,407,123
"12237","39279","2014",6,6,0,130925,1489.333,88.16667
"12238","39283","2014",2,2,0,200925,1818.5,110.5
"12239","39284","2014",1,1,0,95000,880,108
"12240","39286","2014",14,10,4,117953.6,1336.571,89.85714
"12241","39288","2014",6,6,0,215783.3,1832.833,122
"12242","39289","2014",5,5,0,60823,945.6,64.4
"12243","39290","2014",3,3,0,47997.33,768,60.66667
"12244","39291","2014",2,2,0,57225,1196.5,48
"12245","39292","2014",1,1,0,159000,2120,75
"12246","39293","2014",3,3,0,143750,1231,114
"12247","39295","2014",3,3,0,103118,898.6667,113.3333
"12248","39296","2014",4,4,0,167250,1360,127.5
"12249","39297","2014",4,4,0,161875,1013.25,166.75
"12250","39298","2014",1,1,0,228800,2408,95
"12251","39299","2014",2,2,0,107500,1046,102.5
"12252","39300","2014",168,52,116,114252.4,1578.81,79.375
"12253","39305","2014",5,5,0,95600,1000,93.6
"12254","39306","2014",5,4,1,134600,1908.6,74.8
"12255","39307","2014",4,4,0,266745,2496,108
"12256","39308","2014",1,1,0,122000,1232,99
"12257","39310","2014",5,5,0,119472,1193.4,110.4
"12258","39313","2014",1,1,0,2e+05,760,263
"12259","39314","2014",1,1,0,205000,1025,200
"12260","39315","2014",2,2,0,185000,1700,106
"12261","39317","2014",4,4,0,131388.8,804.75,153
"12262","39318","2014",3,2,1,67833.33,724,90.33333
"12263","39319","2014",1,1,0,127000,1351,94
"12264","39320","2014",4,4,0,82000,731.25,115.75
"12265","39321","2014",1,1,0,90000,1047,86
"12266","39323","2014",4,4,0,128750,1140.75,112.5
"12267","39325","2014",11,11,0,154548.2,1370.364,111.2727
"12268","39326","2014",1,1,0,200500,1055,190
"12269","39327","2014",7,7,0,137342.9,1509.714,91.14286
"12270","39328","2014",1,1,0,145000,1450,100
"12271","39330","2014",2,2,0,15500,375,42
"12272","39331","2014",4,3,1,145150,989,164
"12273","39333","2014",15,13,2,103806.7,1190.267,88.66667
"12274","39335","2014",2,2,0,153350,1436.5,98.5
"12275","39336","2014",1,1,0,80000,800,100
"12276","39337","2014",1,1,0,107000,856,125
"12277","39338","2014",6,6,0,110073.3,1325.5,87
"12278","39339","2014",7,6,1,129392.9,1408.429,102.1429
"12279","39344","2014",5,5,0,110000,1325,85.6
"12280","39345","2014",3,3,0,196333.3,1946,106
"12281","39346","2014",1,1,0,75000,765,98
"12282","39348","2014",8,8,0,115168.8,1130.375,98.125
"12283","39350","2014",6,6,0,129050,1105.167,112.3333
"12284","39351","2014",1,1,0,145000,967,150
"12285","39352","2014",1,1,0,187040,2398,78
"12286","39354","2014",1,1,0,125000,758,165
"12287","39355","2014",1,1,0,295000,928,318
"12288","39362","2014",36,22,14,113446.4,1434.917,78.47222
"12289","39363","2014",1,1,0,179000,994,180
"12290","39364","2014",3,3,0,151333.3,1327.667,125.6667
"12291","39365","2014",12,10,2,135075,1391.333,101.9167
"12292","39366","2014",1,1,0,168000,1135,148
"12293","39367","2014",17,13,4,154095.6,1873.176,89.94118
"12294","39368","2014",41,15,26,109489,1192.951,91.02439
"12295","39370","2014",7,5,2,103368.9,1133.571,85.42857
"12296","39373","2014",2,2,0,165870,2801.5,67
"12297","39376","2014",1,1,0,216000,1440,150
"12298","39377","2014",3,3,0,118883.7,1321,86.66667
"12299","39378","2014",4,4,0,133205,1394.75,98
"12300","39379","2014",4,4,0,172175,1698,102.75
"12301","39380","2014",1,1,0,150000,1364,110
"12302","39381","2014",1,1,0,150000,1667,90
"12303","39385","2014",5,5,0,92000,969.2,95.4
"12304","39387","2014",1,1,0,109050,924,118
"12305","39388","2014",1,1,0,55000,500,110
"12306","39389","2014",2,1,1,112500,1416.5,81.5
"12307","39390","2014",1,1,0,45000,1875,24
"12308","39391","2014",4,3,1,120750,1356.5,88.25
"12309","39392","2014",4,3,1,68837.5,1167,65.25
"12310","39393","2014",2,2,0,94000,790.5,121
"12311","39396","2014",14,11,3,116803.4,1029.714,125.7857
"12312","39397","2014",23,20,3,81386.96,948.4783,84.13043
"12313","39398","2014",7,7,0,132142.9,1401,103.2857
"12314","39399","2014",2,2,0,96700,932,95
"12315","39401","2014",3,3,0,179000,1251.333,142.3333
"12316","39402","2014",3,2,1,146500,1014.667,150.6667
"12317","39403","2014",1,1,0,158979,2409,66
"12318","39404","2014",5,5,0,110480,1081.4,115.6
"12319","39405","2014",9,8,1,161395.6,1719.889,102.6667
"12320","39406","2014",2,2,0,176500,1451.5,123
"12321","39407","2014",3,3,0,98666.67,1269.333,78.66667
"12322","39408","2014",1,1,0,114000,1267,90
"12323","39411","2014",7,4,3,120812.9,1471.143,82.28571
"12324","39412","2014",3,3,0,106666.7,1281.333,85.66667
"12325","39413","2014",6,6,0,221058.3,2102,112
"12326","39415","2014",7,7,0,97525.71,1028.571,91.42857
"12327","39420","2014",4,4,0,105250,883.75,122.75
"12328","39421","2014",2,2,0,154500,1614,99
"12329","39422","2014",5,5,0,162239,1235.4,152.8
"12330","39424","2014",1,1,0,160000,1975,81
"12331","39426","2014",4,4,0,88750,1099.75,79.75
"12332","39429","2014",4,4,0,76610,947.5,80.75
"12333","39430","2014",4,4,0,95812.5,1039,107.75
"12334","39431","2014",1,1,0,120000,1667,72
"12335","39434","2014",31,24,7,121992.6,1256.419,96.70968
"12336","39435","2014",6,5,1,73083.33,1065.667,67
"12337","39436","2014",1,1,0,202500,2355,86
"12338","39437","2014",4,3,1,86875,899.25,100.75
"12339","39439","2014",3,2,1,161666.7,1467.667,113.6667
"12340","39441","2014",33,11,22,129888,2351.242,54.21212
"12341","39444","2014",1,1,0,148500,1238,120
"12342","39445","2014",4,4,0,86250,885.75,102.5
"12343","39446","2014",1,1,0,167000,988,169
"12344","39448","2014",4,3,1,85000,1157.75,79.75
"12345","39449","2014",2,2,0,120500,972.5,120
"12346","39451","2014",5,5,0,134960,1619.6,91.8
"12347","39452","2014",2,1,1,138875,1300,104.5
"12348","39453","2014",5,4,1,132090,1454.4,86
"12349","39455","2014",1,1,0,64000,889,72
"12350","39456","2014",3,3,0,108000,1064.667,90.66667
"12351","39457","2014",2,2,0,99500,1115.5,83
"12352","39458","2014",5,5,0,82260,898.8,89.2
"12353","39460","2014",3,1,2,155953.3,1205.667,125.6667
"12354","39462","2014",7,7,0,150435.7,1387.571,109.8571
"12355","39464","2014",2,2,0,164500,1506,114
"12356","39465","2014",1,1,0,157200,1727,91
"12357","39466","2014",1,1,0,98000,891,110
"12358","39467","2014",1,1,0,55000,505,109
"12359","39468","2014",4,4,0,149875,945,168.5
"12360","39469","2014",3,3,0,89333.33,1054.333,86.33333
"12361","39470","2014",68,10,58,142873.9,2380.632,60.23529
"12362","39471","2014",9,9,0,127966.7,1172.333,109.2222
"12363","39472","2014",3,3,0,121666.7,1275.333,89.33333
"12364","39474","2014",7,6,1,114771.4,1020.143,104.4286
"12365","39475","2014",18,18,0,126768.3,1287.889,99
"12366","39476","2014",11,11,0,136653.6,1327.182,110.7273
"12367","39477","2014",3,3,0,108666.7,933,112.6667
"12368","39478","2014",47,15,32,87011.7,976.4681,87.53191
"12369","39479","2014",3,3,0,1e+05,1676.333,71
"12370","39481","2014",3,3,0,186100,1948,102
"12371","39485","2014",7,7,0,76428.57,881.2857,93.42857
"12372","39487","2014",1,1,0,319500,2022,158
"12373","39489","2014",2,2,0,113500,903,125.5
"12374","39491","2014",9,9,0,159050,1410.333,126.2222
"12375","39492","2014",1,1,0,148560,1428,104
"12376","39493","2014",2,2,0,36500,740,54.5
"12377","39494","2014",3,3,0,209000,1576.333,132.6667
"12378","39495","2014",1,1,0,50000,1136,44
"12379","39497","2014",2,2,0,109600,1188,91.5
"12380","39498","2014",2,2,0,160670,1632.5,99.5
"12381","39499","2014",3,3,0,96733.33,1085,93
"12382","39500","2014",21,10,11,60121.05,939.4762,67.42857
"12383","39501","2014",8,7,1,122862.5,1229.625,98.375
"12384","39502","2014",1,1,0,155000,1632,95
"12385","39503","2014",1,1,0,134340,1210,111
"12386","39504","2014",4,4,0,123156.2,1098.5,108.5
"12387","39505","2014",1,1,0,20000,500,40
"12388","39508","2014",5,5,0,102750,1015,106
"12389","39510","2014",4,4,0,157627.5,1743.25,88.5
"12390","39512","2014",1,1,0,28200,705,40
"12391","39513","2014",2,2,0,110500,1358,81
"12392","39517","2014",3,3,0,131633.3,1367.333,99.33333
"12393","39518","2014",1,1,0,120000,741,162
"12394","39519","2014",2,2,0,209500,1601.5,134
"12395","39520","2014",2,2,0,108000,1025.5,104
"12396","39523","2014",2,2,0,196500,1739,112
"12397","39525","2014",5,5,0,101900,957.8,108.8
"12398","39526","2014",51,39,12,93292.35,1143.412,84.27451
"12399","39527","2014",1,1,0,188400,1178,160
"12400","39528","2014",5,5,0,75380,798.2,96.2
"12401","39530","2014",13,13,0,105184.6,1132.077,93.84615
"12402","39531","2014",1,1,0,125000,1042,120
"12403","39532","2014",1,1,0,40000,588,68
"12404","39533","2014",4,4,0,161900,1368.75,130
"12405","39534","2014",4,4,0,120600,961.75,129.25
"12406","39535","2014",1,1,0,131000,1456,90
"12407","39537","2014",3,3,0,79850,1243,56
"12408","39539","2014",2,2,0,128500,1184.5,106
"12409","39540","2014",1,1,0,118000,562,210
"12410","39543","2014",2,1,1,103000,1844.5,58.5
"12411","39546","2014",3,3,0,117333.3,1276.333,89.66667
"12412","39547","2014",4,4,0,143750,1394,103.25
"12413","39550","2014",1,1,0,180000,1915,94
"12414","39552","2014",1,1,0,85000,1062,80
"12415","39553","2014",2,2,0,149500,1343.5,127.5
"12416","39554","2014",2,2,0,123382,1402.5,95.5
"12417","39559","2014",1,1,0,120000,1579,76
"12418","39560","2014",8,3,5,86625,1484.625,74
"12419","39561","2014",1,0,1,65000,1083,60
"12420","39567","2014",1,0,1,163000,1495,109
"12421","39569","2014",3,3,0,137900,1604.333,86.66667
"12422","39570","2014",1,1,0,120000,1000,120
"12423","39571","2014",1,1,0,143650,1596,90
"12424","39572","2014",4,4,0,132930,1104.5,132
"12425","39573","2014",4,3,1,127175,1345,99.25
"12426","39574","2014",5,5,0,165708,1639.8,103.4
"12427","39575","2014",1,1,0,50000,694,72
"12428","39576","2014",14,14,0,100271.4,1107.143,87.5
"12429","39577","2014",1,1,0,128000,2560,50
"12430","39579","2014",6,6,0,167300,1720.5,99.5
"12431","39581","2014",4,4,0,159700,1290,123.5
"12432","39582","2014",7,6,1,107607.1,1217.429,93
"12433","39583","2014",5,5,0,124300,2334.2,71.6
"12434","39584","2014",2,2,0,129500,1157,115
"12435","39585","2014",1,1,0,127000,1176,108
"12436","40001","2014",59,51,8,125369.3,1310.254,100.6441
"12437","40002","2014",12,12,0,138441.7,1361.417,101.3333
"12438","40005","2014",2,2,0,130000,1413,90.5
"12439","40006","2014",7,7,0,151600,1450.143,105.1429
"12440","40008","2014",1,1,0,105000,1180,89
"12441","40011","2014",2,2,0,178250,1228.5,155
"12442","40012","2014",2,2,0,138000,1620,84.5
"12443","40014","2014",2,2,0,183000,1099,159
"12444","40018","2014",3,3,0,132333.3,1462.333,91.33333
"12445","40019","2014",16,12,4,165918.8,2437.125,71.375
"12446","40020","2014",4,4,0,134250,1013.75,130
"12447","40021","2014",6,6,0,242833.3,2117.167,114.1667
"12448","40023","2014",3,3,0,110000,1057,106.6667
"12449","40024","2014",2,2,0,144000,1763.5,82
"12450","40025","2014",10,10,0,134140,1414.8,105
"12451","40026","2014",3,3,0,200333.3,1740.333,122.3333
"12452","40027","2014",1,1,0,95000,1118,85
"12453","40028","2014",1,1,0,84000,1105,76
"12454","40029","2014",3,3,0,128466.7,1410.333,90.66667
"12455","40031","2014",6,6,0,119000,1253.167,92.16667
"12456","40032","2014",3,3,0,116466.7,1134,103
"12457","40033","2014",3,3,0,184666.7,1842.333,146.6667
"12458","40034","2014",2,2,0,233500,1457.5,154
"12459","40035","2014",1,1,0,2e+05,1136,176
"12460","40036","2014",13,10,3,239092.3,2295.462,112.2308
"12461","40037","2014",4,4,0,196625,2027,88.5
"12462","40038","2014",1,1,0,135000,1929,70
"12463","40039","2014",5,5,0,123600,1273.2,97.8
"12464","40040","2014",1,1,0,135000,1216,111
"12465","40042","2014",2,2,0,143000,1328,119.5
"12466","40043","2014",15,15,0,116533.3,1721.2,69
"12467","40044","2014",7,7,0,236671.4,2019.714,123
"12468","40046","2014",282,169,113,192364.1,2439.312,80.95745
"12469","40049","2014",1,1,0,23355,467,50
"12470","40050","2014",1,1,0,160000,2963,54
"12471","40051","2014",5,5,0,184000,1750.2,105.4
"12472","40053","2014",6,6,0,103516.7,1266.833,98.33333
"12473","40054","2014",4,3,1,136250,1092.5,114
"12474","40055","2014",6,6,0,197500,1674.667,118.1667
"12475","40056","2014",9,9,0,181723.3,1781,104.5556
"12476","40057","2014",1,1,0,180000,1579,114
"12477","40058","2014",1,1,0,102000,971,105
"12478","40059","2014",6,6,0,180548.3,1864,104.5
"12479","40060","2014",5,5,0,155000,1797,112
"12480","40061","2014",8,8,0,150267.5,1580.375,95.5
"12481","40062","2014",5,5,0,141597.2,1437,94.4
"12482","40063","2014",7,3,4,122285.7,1462.143,85.85714
"12483","40064","2014",3,3,0,164000,1617.667,103
"12484","40065","2014",207,81,126,215916.1,3705.251,60.77295
"12485","40066","2014",2,2,0,165609,1663.5,99.5
"12486","40067","2014",2,2,0,217000,2266.5,100.5
"12487","40068","2014",7,6,1,150993.3,1374.714,106.7143
"12488","40069","2014",1,1,0,138000,2421,57
"12489","40070","2014",1,1,0,149000,1419,105
"12490","40071","2014",2,2,0,227500,1536,148
"12491","40072","2014",3,3,0,97000,1012.667,99
"12492","40073","2014",1,1,0,240000,1529,157
"12493","40074","2014",7,7,0,154192.9,1378.714,124.8571
"12494","40075","2014",10,8,2,197137.3,1897.6,113.2
"12495","40076","2014",2,2,0,140000,1573.5,89
"12496","40078","2014",1,1,0,140000,1505,93
"12497","40080","2014",14,14,0,140607.5,1192.643,131.5714
"12498","40081","2014",3,3,0,200449,1796.667,112.6667
"12499","40082","2014",3,3,0,134365,1552,87.66667
"12500","40084","2014",1,1,0,150000,1852,81
"12501","40085","2014",2,2,0,79000,946.5,91
"12502","40086","2014",4,4,0,136865,1347.75,114.25
"12503","40087","2014",7,6,1,150857.1,1559.571,81.14286
"12504","40088","2014",308,109,199,117167.7,1860.399,66.36039
"12505","40089","2014",6,6,0,143885,1300.667,119.8333
"12506","40090","2014",3,3,0,140000,1134,130.3333
"12507","40091","2014",1,1,0,85000,944,90
"12508","40093","2014",6,6,0,170516.7,1548.667,108.8333
"12509","40094","2014",5,5,0,147800,1356.6,113.4
"12510","40095","2014",3,3,0,188633.3,1886,95.66667
"12511","40096","2014",1,1,0,119000,1352,88
"12512","40097","2014",7,5,2,115346.6,1698.143,79
"12513","40098","2014",6,6,0,75286.5,874,93.83333
"12514","40099","2014",2,2,0,97534,878.5,117.5
"12515","40100","2014",5,5,0,144300,1308,113
"12516","40101","2014",7,7,0,171837,1394.571,125.1429
"12517","40102","2014",7,7,0,89330.29,1132.571,83.85714
"12518","40103","2014",4,4,0,149500,1545,95.75
"12519","40104","2014",11,11,0,135052.3,1177.364,110
"12520","40105","2014",5,5,0,141700,1771.2,90
"12521","40108","2014",4,4,0,220400,2267.5,100.25
"12522","40109","2014",2,2,0,167000,1419.5,115.5
"12523","40110","2014",5,4,1,148000,1153.2,121.8
"12524","40111","2014",5,5,0,169120,1553.2,112
"12525","40112","2014",1,1,0,154000,1855,83
"12526","40113","2014",3,3,0,153333.3,1526.333,99.33333
"12527","40114","2014",4,4,0,138875,1045.5,128.25
"12528","40115","2014",3,3,0,187825.3,1377.333,128.6667
"12529","40117","2014",23,18,5,117718.3,1256.087,100.9565
"12530","40118","2014",9,9,0,184517.8,1754.778,115.2222
"12531","40119","2014",32,31,1,123229.4,1348.062,88.90625
"12532","40120","2014",5,5,0,200380,1386.6,150.2
"12533","40121","2014",2,2,0,72500,1128.5,68.5
"12534","40122","2014",5,5,0,352672,4105.2,99.6
"12535","40123","2014",9,9,0,211353.3,2307.778,92.88889
"12536","40124","2014",3,3,0,274000,1375.667,187
"12537","40125","2014",8,8,0,171109.4,1798.125,96.875
"12538","40126","2014",23,23,0,163688.5,1600.957,105
"12539","40127","2014",4,4,0,93000,1161,82
"12540","40128","2014",4,4,0,124500,1327.75,90.25
"12541","40129","2014",11,11,0,187300,1873.091,104.8182
"12542","40130","2014",1,1,0,152000,1520,100
"12543","40131","2014",9,9,0,112113.3,1024.222,130.5556
"12544","40132","2014",3,3,0,175116.7,1744.667,99.66667
"12545","40133","2014",76,51,25,228611,2720.789,86.94737
"12546","40134","2014",31,31,0,118171.9,1322.677,97.6129
"12547","40135","2014",2,2,0,77500,914,85.5
"12548","40137","2014",2,2,0,177000,1188,135
"12549","40139","2014",4,4,0,131431.2,1456,87.5
"12550","40141","2014",1,1,0,141810,1593,89
"12551","40142","2014",8,8,0,173625,1766.625,94
"12552","40144","2014",3,3,0,167108.3,1472.333,113.6667
"12553","40145","2014",7,6,1,101943.7,851.8571,112.5714
"12554","40146","2014",1,1,0,40000,339,118
"12555","40147","2014",2,2,0,123000,794,167.5
"12556","40149","2014",4,4,0,102750,1063,102.25
"12557","40150","2014",24,19,5,196557.8,2558.75,80.08333
"12558","40151","2014",3,3,0,139833.3,1364,107.6667
"12559","40152","2014",6,6,0,151333.3,1379.333,113
"12560","40153","2014",2,2,0,142519,1161,123
"12561","40154","2014",4,4,0,153750,1233.25,126.75
"12562","40155","2014",10,10,0,183989,1997.6,94
"12563","40156","2014",2,2,0,231000,1896.5,118
"12564","40157","2014",25,17,8,135719.6,1777.64,83.52
"12565","40158","2014",4,4,0,145375,936,152.5
"12566","40159","2014",1,0,1,80000,1538,52
"12567","40160","2014",3,3,0,147666.7,1463.333,108.6667
"12568","40161","2014",2,2,0,25000,464.5,54
"12569","40162","2014",9,9,0,125800,1405.111,88.55556
"12570","40163","2014",7,6,1,172214.3,1396.571,128.2857
"12571","40164","2014",1,1,0,125500,872,144
"12572","40165","2014",7,7,0,145521.4,1410.857,109.4286
"12573","40167","2014",8,8,0,100750,892.375,115.875
"12574","40168","2014",10,7,3,176150.8,1838.8,103.6
"12575","40170","2014",5,5,0,177720,1426,135.8
"12576","40171","2014",4,4,0,196875,1638.25,118.75
"12577","40172","2014",2,2,0,84500,1151,72.5
"12578","40173","2014",1,1,0,163100,1524,107
"12579","40174","2014",1,1,0,120000,1165,103
"12580","40175","2014",3,3,0,151333.3,1542.667,101
"12581","40178","2014",3,3,0,204000,1715.333,118.3333
"12582","40179","2014",11,11,0,214450.9,1692.091,124.2727
"12583","40180","2014",10,10,0,142800,1480.3,96.8
"12584","40181","2014",13,12,1,219461.5,2839.692,80.23077
"12585","40182","2014",9,9,0,150277.8,1524.333,99.33333
"12586","40183","2014",6,6,0,158583.3,1596.167,111.6667
"12587","40184","2014",114,60,54,148793.2,2538.096,65.27193
"12588","40185","2014",2,2,0,122875,1225.5,96.5
"12589","40186","2014",11,10,1,137818.2,1317.909,107.2727
"12590","40187","2014",95,57,38,170774,3154.947,57.15789
"12591","40188","2014",3,3,0,132833.3,1324.667,100
"12592","40189","2014",1,1,0,54500,940,58
"12593","40190","2014",1,1,0,177500,1376,129
"12594","40191","2014",5,5,0,159846,1324.2,123.6
"12595","40192","2014",368,212,156,122135.4,1620.242,77.14946
"12596","40194","2014",11,11,0,90036.36,1100.182,85
"12597","40195","2014",2,2,0,170000,1401,121
"12598","40196","2014",7,7,0,163631.3,1401.286,121.4286
"12599","40197","2014",3,3,0,189200,2419,109.6667
"12600","40198","2014",2,2,0,108000,619,202.5
"12601","40199","2014",1,1,0,61000,610,100
"12602","40200","2014",9,9,0,135821.7,1447.889,92.88889
"12603","40201","2014",8,8,0,118376.1,1230.125,103.125
"12604","40202","2014",19,16,3,181078.9,1857.474,100.8947
"12605","40203","2014",2,2,0,173515,1228.5,140.5
"12606","40204","2014",5,5,0,174268,1391.8,165.2
"12607","40205","2014",3,1,2,120666.7,1044,112.6667
"12608","40206","2014",2,2,0,116000,983.5,120
"12609","40207","2014",10,10,0,185775,1923.2,102.2
"12610","40208","2014",1,1,0,164500,1662,99
"12611","40209","2014",49,25,24,188989.4,2607.224,77.81633
"12612","40210","2014",8,8,0,146493.8,2072.125,77.875
"12613","40211","2014",3,3,0,189340,1801.667,110.3333
"12614","40212","2014",8,8,0,200050,1933.625,104.25
"12615","40214","2014",3,3,0,233333.7,1520.333,159.6667
"12616","40215","2014",4,4,0,242425,1192.5,196.5
"12617","40217","2014",70,66,4,192768.9,1947.743,99.85714
"12618","40218","2014",2,2,0,120000,885.5,135.5
"12619","40220","2014",1,1,0,75000,1042,72
"12620","40221","2014",6,6,0,163500,1211,135.6667
"12621","40222","2014",6,6,0,215982.3,1824,129.6667
"12622","40223","2014",1,1,0,69000,1725,40
"12623","40224","2014",32,23,9,127113.8,1376.812,92.125
"12624","40226","2014",1,1,0,60000,674,89
"12625","40227","2014",15,15,0,141620,1633.6,97.86667
"12626","40228","2014",12,12,0,126255.1,1153.333,114.4167
"12627","40229","2014",19,19,0,157821.1,1555.579,104.6842
"12628","40230","2014",23,23,0,184603.9,1557,121.4348
"12629","40231","2014",6,6,0,194916.7,1486.5,140.1667
"12630","40232","2014",5,5,0,155680,1240,120.2
"12631","40233","2014",18,18,0,176332.4,1538.833,118.9444
"12632","40234","2014",2,2,0,137000,1422.5,94.5
"12633","40235","2014",5,3,2,97600,1115,91
"12634","40236","2014",7,7,0,160342.9,1345.286,117.2857
"12635","40237","2014",7,7,0,153857.1,1576.857,106.2857
"12636","40238","2014",8,8,0,177975,1392.375,150.75
"12637","40239","2014",3,3,0,143823.3,1041,131.6667
"12638","40240","2014",3,3,0,159000,1324.333,126
"12639","40243","2014",30,28,2,127539.8,1389.267,95.96667
"12640","40244","2014",9,8,1,167672.2,1589.111,100.7778
"12641","40245","2014",22,21,1,117081.8,1130.091,99.18182
"12642","40246","2014",7,7,0,171691.4,1468.714,134.7143
"12643","40248","2014",12,12,0,238422.5,2273.5,107.8333
"12644","40249","2014",2,2,0,107173.5,760,128.5
"12645","40250","2014",8,8,0,198862.5,1590.75,131.75
"12646","40251","2014",1,1,0,275500,1837,150
"12647","40252","2014",3,3,0,145250,1638,88.33333
"12648","40253","2014",3,3,0,130333.3,1586.333,105.3333
"12649","40254","2014",3,3,0,133976.7,1261.667,115.6667
"12650","40255","2014",4,4,0,140375,1067.5,134
"12651","40256","2014",2,2,0,218195,1700.5,129
"12652","40257","2014",15,15,0,211986.7,1994.4,105
"12653","40258","2014",1,1,0,40000,625,64
"12654","40259","2014",2,2,0,146500,1221,120
"12655","40260","2014",2,2,0,181900,1422.5,129
"12656","40261","2014",23,20,3,202815.2,1890.565,109.1739
"12657","40262","2014",3,3,0,224000,1957.667,116.6667
"12658","40263","2014",6,6,0,130000,1190.5,113.5
"12659","40264","2014",16,14,2,231906.2,2026.375,118.6875
"12660","40265","2014",1,1,0,125000,1712,73
"12661","40266","2014",23,13,10,157615,1956.391,91.30435
"12662","40267","2014",6,5,1,118673.3,1359.167,87.16667
"12663","40268","2014",2,2,0,220000,2915.5,86.5
"12664","40269","2014",6,6,0,152313.2,1038.5,147.5
"12665","40270","2014",3,3,0,132710,1678,86.66667
"12666","40271","2014",3,3,0,237169.3,1821,131.6667
"12667","40272","2014",9,6,3,172813.3,1712.889,102.3333
"12668","40273","2014",39,28,11,242268.5,2453.282,99.89744
"12669","40274","2014",16,16,0,165187.5,1517.938,106.5625
"12670","40275","2014",5,5,0,145630,1559.4,94.2
"12671","40276","2014",4,4,0,236305,2349,101.5
"12672","40277","2014",4,4,0,200500,1806.25,111.75
"12673","40278","2014",13,13,0,171692.3,1896.077,91.07692
"12674","40279","2014",124,87,37,156644.5,2039.75,78.3871
"12675","40280","2014",13,9,4,110538.5,1523.846,73.53846
"12676","40281","2014",98,80,18,155666.4,1779.163,87.62245
"12677","40282","2014",53,46,7,113364.3,1308.717,87.69811
"12678","40283","2014",13,12,1,184435,1820.231,99.92308
"12679","40284","2014",95,60,35,170762.6,2139.337,82.69474
"12680","40285","2014",6,6,0,134608.3,1243,107.1667
"12681","40286","2014",7,7,0,116817.9,1274.429,128.4286
"12682","40287","2014",53,45,8,227127,2391.094,99.66038
"12683","40288","2014",5,5,0,87750,1068.8,80.4
"12684","40289","2014",1,1,0,148850,1654,90
"12685","40291","2014",14,14,0,278976.4,2715.571,100.4286
"12686","40292","2014",6,6,0,322136.7,2461.167,131.5
"12687","40293","2014",9,9,0,187632.8,1770.444,124.8889
"12688","40294","2014",4,4,0,181000,1711.75,105.25
"12689","40295","2014",9,9,0,162225.6,1590.111,108.1111
"12690","40296","2014",135,63,72,231756.6,3176.326,70.93333
"12691","40297","2014",2,2,0,193000,1499,127
"12692","40298","2014",1,1,0,186000,2416,77
"12693","40299","2014",3,3,0,131500,1188,111.3333
"12694","40300","2014",7,7,0,226553.3,2164.286,106.7143
"12695","40301","2014",2,2,0,163447,2035.5,84
"12696","40303","2014",3,3,0,164807.3,1471,125.3333
"12697","40304","2014",93,51,42,367036.9,4398.796,83.44086
"12698","40306","2014",4,4,0,157950,1625,98.25
"12699","40307","2014",10,10,0,152350,1604.4,102.4
"12700","40308","2014",6,6,0,194951.8,1760.333,114
"12701","40309","2014",4,4,0,150625,1201.25,153.5
"12702","40310","2014",106,61,45,198019.1,2732.538,77.61321
"12703","40311","2014",4,4,0,144000,1301.25,114.5
"12704","40312","2014",90,46,44,215599.1,2798.478,78.74444
"12705","40313","2014",30,27,3,125884.7,1303.733,102.9333
"12706","40314","2014",10,9,1,186055,1671.8,114.4
"12707","40315","2014",4,4,0,210000,1732.25,122.25
"12708","40316","2014",5,5,0,151000,1379.2,105.4
"12709","40317","2014",21,19,2,256622.1,2541.571,106.4286
"12710","40318","2014",1,1,0,140000,933,150
"12711","40319","2014",3,3,0,135333.3,1468.667,86.66667
"12712","40320","2014",4,4,0,140000,1333.25,112
"12713","40321","2014",4,4,0,114625,1126.5,98.25
"12714","40322","2014",2,2,0,238250,2085.5,121.5
"12715","40323","2014",1,1,0,135000,2077,65
"12716","40325","2014",3,3,0,153000,1303.333,126.6667
"12717","40326","2014",20,18,2,171495,2302.2,78.6
"12718","40328","2014",71,25,46,155306.5,3020.07,55.94366
"12719","40329","2014",4,4,0,137662.5,1292.25,104.25
"12720","40330","2014",2,2,0,106500,1050,99
"12721","40331","2014",19,18,1,125721.1,1292.632,105.3158
"12722","40332","2014",24,22,2,165189.6,1648.542,101.5
"12723","40333","2014",10,10,0,131270,1232.1,108.5
"12724","40334","2014",1,1,0,1e+05,1124,89
"12725","41001","2014",5,5,0,122526,1400.8,96.2
"12726","41002","2014",6,6,0,140500,1314.5,108.1667
"12727","41003","2014",3,3,0,125909,1295.667,104.3333
"12728","41004","2014",8,8,0,98042.5,1317.25,82.25
"12729","41006","2014",7,7,0,78482.14,923.5714,92.85714
"12730","41007","2014",4,4,0,88750,948.25,96.75
"12731","41008","2014",9,9,0,128587.8,1441.444,93.55556
"12732","41009","2014",8,8,0,122850,1490,89.125
"12733","41010","2014",6,6,0,113941.7,1501.333,75.5
"12734","41012","2014",1,1,0,106000,1116,95
"12735","41013","2014",2,2,0,113650,1181,95
"12736","41014","2014",2,2,0,89500,1502.5,57
"12737","41016","2014",7,7,0,112638.6,1334.714,78.57143
"12738","41017","2014",4,4,0,92175,860.25,108.5
"12739","41018","2014",482,196,286,116253.6,1512.898,77.40871
"12740","41020","2014",2,2,0,71500,889.5,79.5
"12741","41022","2014",5,5,0,96660,1048,86.8
"12742","41024","2014",1,1,0,79500,811,98
"12743","41025","2014",16,15,1,153679.4,1520.062,101.5625
"12744","41026","2014",5,5,0,85374,1404.6,70.4
"12745","41028","2014",7,7,0,143650,1393.286,104.2857
"12746","41029","2014",9,9,0,153443.7,1363.222,113.8889
"12747","41030","2014",1,1,0,54000,730,74
"12748","41031","2014",19,19,0,163607.1,1500.789,108.7895
"12749","41032","2014",20,20,0,152933.5,1548.55,101.95
"12750","41035","2014",6,6,0,117500,1384.167,85.5
"12751","41036","2014",7,7,0,180886,1842,100.1429
"12752","41037","2014",1,1,0,163000,988,165
"12753","41038","2014",4,4,0,108750,1147.5,93
"12754","41039","2014",6,6,0,139006.7,1485.833,97.66667
"12755","41040","2014",2,2,0,168200,1396,122
"12756","41041","2014",4,4,0,78250,1027.5,86
"12757","41042","2014",3,3,0,108758.3,1739.667,59.66667
"12758","41043","2014",12,12,0,131734.2,1483.167,107.6667
"12759","41044","2014",5,5,0,83600,770,123.6
"12760","41045","2014",7,7,0,134185.7,1392.143,102.5714
"12761","41046","2014",12,12,0,202708.3,2496.833,86.83333
"12762","41047","2014",55,39,16,152339.3,1684.491,91.36364
"12763","41049","2014",9,9,0,109538.9,1248.444,89
"12764","41050","2014",9,9,0,188044.4,1633.333,125.3333
"12765","41051","2014",12,12,0,132150,1228.333,105.0833
"12766","41052","2014",8,8,0,167207.5,1789.375,108.125
"12767","41053","2014",4,4,0,104550,1148,78.5
"12768","41054","2014",3,3,0,153666.7,1545.333,97
"12769","41055","2014",24,24,0,144611.1,1725.958,85.16667
"12770","41057","2014",2,2,0,136000,1308,112.5
"12771","41059","2014",38,38,0,141812.7,1483,96.71053
"12772","41060","2014",3,3,0,30333.33,603.3333,51.33333
"12773","41061","2014",5,5,0,137784,1549.4,89
"12774","41062","2014",4,4,0,90125,1727.75,55.25
"12775","41063","2014",3,3,0,233756.7,1946.667,127
"12776","41065","2014",1,1,0,83000,874,95
"12777","41066","2014",3,2,1,66000,915.3333,75.33333
"12778","41067","2014",20,20,0,185826.5,1739.5,109.95
"12779","41068","2014",3,3,0,111666.7,1321.333,86
"12780","41069","2014",1,1,0,180000,1440,125
"12781","41070","2014",5,5,0,50000,771.8,72.4
"12782","41071","2014",10,10,0,174920,1481.2,109.1
"12783","41072","2014",3,3,0,98500,1198,84
"12784","41073","2014",11,11,0,88062.82,1007.273,86.45455
"12785","41074","2014",15,15,0,127126.7,1637.333,93.06667
"12786","41075","2014",10,10,0,66809.3,907.6,76.5
"12787","41077","2014",2,2,0,71250,1402,52
"12788","41078","2014",2,2,0,77120,1136,66.5
"12789","41079","2014",3,3,0,75000,1042.667,67.66667
"12790","41080","2014",10,10,0,141160,1279.4,107.2
"12791","41081","2014",1,1,0,72000,1309,55
"12792","41083","2014",7,7,0,119021.4,1423.571,84
"12793","41084","2014",12,11,1,132555.6,1189.167,105.5
"12794","41085","2014",7,7,0,143050,1551.429,97.14286
"12795","41086","2014",5,5,0,96180,1018.8,98.6
"12796","41087","2014",2,2,0,125000,1525,86.5
"12797","41088","2014",5,5,0,39500.6,1014,39.2
"12798","41089","2014",1,1,0,40000,500,80
"12799","41090","2014",3,3,0,156666.7,1605.333,99.66667
"12800","41091","2014",9,9,0,162902.3,1570,106.3333
"12801","41094","2014",8,8,0,146187.5,1710.25,90.75
"12802","41095","2014",10,10,0,78402.1,1270.3,71.1
"12803","41096","2014",6,6,0,91833.33,933.5,111.1667
"12804","41097","2014",19,19,0,95152.11,1137.737,86.73684
"12805","41098","2014",1,1,0,140000,1167,120
"12806","41099","2014",3,3,0,77333.33,958,76.66667
"12807","41100","2014",3,3,0,140666.7,1211.333,122.6667
"12808","41101","2014",10,7,3,99588.5,1042.7,94.3
"12809","41102","2014",6,6,0,184145.5,1548.167,146.1667
"12810","41103","2014",4,4,0,117500,1403.25,81.75
"12811","41104","2014",15,13,2,135846.7,1582.933,86
"12812","41105","2014",12,12,0,138903.3,1330.25,121.4167
"12813","41106","2014",42,42,0,134430.2,1573.024,89
"12814","41107","2014",4,4,0,85050,1114.5,81.25
"12815","41108","2014",3,3,0,96666.67,1674,63
"12816","41109","2014",7,7,0,140319.7,1603.429,90.71429
"12817","41110","2014",11,11,0,85136.36,1051.455,86.54545
"12818","41113","2014",2,2,0,60000,534,98
"12819","41114","2014",1,1,0,136000,1271,107
"12820","41115","2014",2,2,0,76000,1025,75
"12821","41116","2014",1,1,0,69450,1543,45
"12822","41118","2014",2,2,0,108750,1421.5,76.5
"12823","41119","2014",2,2,0,141500,1533,93
"12824","41120","2014",10,10,0,116150,1319.8,90.9
"12825","41121","2014",1,1,0,142000,947,150
"12826","41122","2014",2,2,0,40000,600,72
"12827","41123","2014",6,6,0,96900,1052.5,95.5
"12828","41124","2014",2,2,0,72500,1296.5,53
"12829","41125","2014",4,3,1,112750,1545.25,81
"12830","41126","2014",13,13,0,113023.1,1270.385,90.92308
"12831","41127","2014",7,7,0,123571.4,1336,86.42857
"12832","41128","2014",7,7,0,172405,1886.571,91.28571
"12833","41129","2014",6,6,0,119190.8,1172.333,105.8333
"12834","41130","2014",6,6,0,132416.7,1517,101.6667
"12835","41131","2014",5,5,0,103869.6,1228.2,87.2
"12836","41134","2014",9,8,1,135266.7,1521.111,93.66667
"12837","41135","2014",8,8,0,108000,1317.875,76.875
"12838","41136","2014",48,46,2,111229.1,1459.625,79.125
"12839","41137","2014",8,8,0,109875,1306.75,75.5
"12840","41138","2014",2,2,0,117500,912,126.5
"12841","41139","2014",13,13,0,99269.23,1270.231,87.69231
"12842","41140","2014",5,5,0,79300,1340.4,58.4
"12843","41141","2014",1,1,0,70000,1167,60
"12844","41142","2014",17,17,0,150127.6,1679.941,102.4118
"12845","41143","2014",10,10,0,100130,1121,83.8
"12846","41144","2014",4,4,0,136587.5,1453.75,90.25
"12847","41145","2014",5,5,0,103640,1240.6,91.6
"12848","41146","2014",11,11,0,113909.1,1320.818,92.81818
"12849","41147","2014",17,16,1,148847.1,1428.882,107.7059
"12850","41148","2014",7,7,0,148142.9,1776.714,88.42857
"12851","41149","2014",38,36,2,134369.2,1383.632,98.18421
"12852","41150","2014",29,28,1,154705.2,1717.241,93.65517
"12853","41151","2014",34,30,4,110790.2,1368.941,79.94118
"12854","41152","2014",7,7,0,127128.6,2071,70.85714
"12855","41153","2014",4,4,0,91682.75,990.5,89.25
"12856","41154","2014",12,12,0,107416.7,1139.667,95.91667
"12857","41155","2014",14,14,0,129713.6,1350.071,95.78571
"12858","41156","2014",5,5,0,145680,1502.2,108.8
"12859","41157","2014",8,8,0,119187.5,1464,92.75
"12860","41158","2014",17,17,0,131064.7,1459.353,86.35294
"12861","41159","2014",9,9,0,140011.1,1360.333,102.1111
"12862","41160","2014",1,1,0,110000,1250,88
"12863","41161","2014",17,17,0,128864.7,1264.118,103.2941
"12864","41163","2014",3,3,0,151982.7,1116.667,137.3333
"12865","41164","2014",25,25,0,87189.72,1098.04,84.32
"12866","41166","2014",1,1,0,122000,1284,95
"12867","41167","2014",29,29,0,117803.6,1474.379,80.03448
"12868","41171","2014",13,13,0,76110.77,1203.923,68.92308
"12869","41172","2014",2,2,0,51750,979,46.5
"12870","41173","2014",45,45,0,114236.4,1134.844,103.7778
"12871","41175","2014",10,10,0,92350,1168.2,86.9
"12872","41176","2014",12,12,0,207691.7,1855.083,112.8333
"12873","41177","2014",6,6,0,56833.33,721.6667,79
"12874","41178","2014",2,2,0,90000,1144.5,78.5
"12875","41179","2014",2,2,0,87500,781,98.5
"12876","41180","2014",15,15,0,113966.2,1179.6,98.53333
"12877","41181","2014",13,13,0,125384.6,1616.308,86.53846
"12878","41182","2014",3,3,0,156666.7,1362.667,121.3333
"12879","41184","2014",7,7,0,118285.7,1143.429,109
"12880","41185","2014",32,32,0,112656.2,1077.906,107.1562
"12881","41186","2014",4,4,0,93250,1045.5,90.75
"12882","41187","2014",3,3,0,59333.33,820,67.66667
"12883","41188","2014",1,1,0,87500,694,126
"12884","41189","2014",3,3,0,118264.7,1687,84.66667
"12885","41190","2014",2,2,0,76500,1065,62.5
"12886","41192","2014",4,3,1,46750,934.75,48.25
"12887","41193","2014",6,6,0,86021.33,863.1667,90.16667
"12888","41194","2014",152,143,9,110047.9,1215.513,91.125
"12889","41196","2014",2,2,0,95037.5,1364,79
"12890","41198","2014",30,30,0,96073.4,1108.467,89.9
"12891","41199","2014",10,10,0,136150,1486,100.5
"12892","41200","2014",6,6,0,220216.7,1776.5,129
"12893","41201","2014",3,3,0,63000,1122,53.33333
"12894","41203","2014",4,4,0,130150,1603.5,84
"12895","41204","2014",6,6,0,165416.7,1822.333,93.66667
"12896","41205","2014",1,1,0,155000,1292,120
"12897","41206","2014",5,5,0,146082,1834.8,97.2
"12898","41207","2014",15,15,0,126732.3,1416.267,94.13333
"12899","41208","2014",2,2,0,136640,1534,93.5
"12900","41209","2014",4,4,0,101750,1412.25,69.5
"12901","41211","2014",32,32,0,117160.9,1615.156,78.46875
"12902","41212","2014",32,32,0,192067.4,2039.406,105.4062
"12903","41214","2014",6,6,0,77833.33,1025.167,79.33333
"12904","41216","2014",4,4,0,96625,1089.25,82.5
"12905","41217","2014",5,5,0,128600,1400.4,88.8
"12906","41218","2014",6,6,0,179800,1444.333,121.3333
"12907","41219","2014",2,2,0,95000,1044,92
"12908","41220","2014",37,37,0,125179.8,1279.649,98.91892
"12909","41221","2014",4,4,0,75700,883.75,84.75
"12910","41222","2014",1,1,0,77000,1069,72
"12911","41223","2014",5,5,0,219974,1974.4,113.4
"12912","41224","2014",3,3,0,68666.67,1263.667,55
"12913","41225","2014",2,2,0,122000,1202.5,109
"12914","41226","2014",17,17,0,156061.8,1507.588,111.1176
"12915","41228","2014",3,3,0,117666.7,1239,97.66667
"12916","41229","2014",11,11,0,103090.6,1336,80.27273
"12917","41230","2014",17,16,1,150755.9,1794.353,90.52941
"12918","41231","2014",9,9,0,126155.6,1426.556,87.55556
"12919","41232","2014",48,45,3,131859.6,1563.438,95.125
"12920","41233","2014",7,7,0,116238.4,1291,102.5714
"12921","41234","2014",3,3,0,116333.3,1345.333,86
"12922","41235","2014",11,11,0,125909.1,1356.636,86.72727
"12923","41237","2014",7,7,0,155814.3,1685.143,98.28571
"12924","41238","2014",15,15,0,109850,1097.467,100.5333
"12925","41239","2014",10,10,0,167390,1794,105.4
"12926","41241","2014",16,16,0,82703.12,1049,79.125
"12927","41242","2014",47,46,1,94992.96,1074.128,93.31915
"12928","41243","2014",6,6,0,123500,1365.167,109
"12929","41245","2014",3,3,0,120866.7,1148.333,106
"12930","41246","2014",6,6,0,126666.7,1409.833,95.66667
"12931","41247","2014",5,5,0,111160,1106.8,103.2
"12932","41248","2014",12,12,0,86375,1195.417,78.66667
"12933","41249","2014",11,11,0,134363.6,1527.727,79.63636
"12934","41250","2014",2,2,0,59500,696,85.5
"12935","41251","2014",2,2,0,117500,1580,79
"12936","41252","2014",13,13,0,130344.1,1573.385,94.38462
"12937","41253","2014",6,6,0,117903.2,1217.667,99
"12938","41254","2014",1,1,0,26000,867,30
"12939","41255","2014",3,3,0,99233.33,976,99
"12940","41256","2014",17,17,0,126038.2,1187.706,98.23529
"12941","41258","2014",9,9,0,100277.8,1510.333,69.88889
"12942","41259","2014",6,6,0,117833.3,1336.333,87.33333
"12943","41260","2014",5,5,0,104600,1440,72.4
"12944","41261","2014",1,1,0,150000,1579,95
"12945","41262","2014",6,6,0,249083.3,2233.333,133
"12946","41265","2014",6,6,0,62750,1194.5,64
"12947","41267","2014",8,8,0,164375,1605.375,97.375
"12948","41268","2014",4,4,0,270575,2188,106.5
"12949","41269","2014",140,88,52,139283.2,1772.921,79.38571
"12950","41271","2014",7,7,0,257571.4,2614.286,109.2857
"12951","41273","2014",7,7,0,74142.86,970,73.42857
"12952","41274","2014",3,3,0,187666.7,1516.333,106.3333
"12953","41275","2014",8,8,0,104761.9,1334.125,82.125
"12954","41276","2014",14,11,3,141128.6,1572.643,96.85714
"12955","41278","2014",5,5,0,106800,1034.4,99.8
"12956","41279","2014",3,3,0,90500,1279,72
"12957","41280","2014",20,20,0,105075,1178.5,86.85
"12958","41281","2014",3,3,0,124500,1542,80.33333
"12959","41282","2014",3,3,0,209180,1490,141.3333
"12960","41283","2014",2,2,0,103375,1138.5,93
"12961","41284","2014",1,1,0,163000,1358,120
"12962","41285","2014",3,3,0,115500,1086.333,111
"12963","41286","2014",1,1,0,30000,714,42
"12964","41287","2014",6,6,0,137333.3,1575.667,84.5
"12965","41288","2014",4,4,0,173500,1804.25,111
"12966","41289","2014",1,1,0,196000,1633,120
"12967","41290","2014",3,3,0,173000,1172.333,195.3333
"12968","41291","2014",2,2,0,104000,1102,94
"12969","41292","2014",2,2,0,82595,516.5,136
"12970","41293","2014",2,2,0,73500,746,109.5
"12971","41294","2014",9,9,0,120220,1270,96.44444
"12972","41295","2014",59,54,5,180207.4,1772.458,101.7627
"12973","41296","2014",9,9,0,178377.8,1668.556,108.1111
"12974","41297","2014",7,6,1,129417.1,1169,104.5714
"12975","42001","2014",2,2,0,128450,1284.5,100
"12976","42002","2014",2,2,0,110000,1420.5,77.5
"12977","42003","2014",17,17,0,120565.3,1357.647,90.88235
"12978","42005","2014",72,38,34,155213.8,1703.306,89.625
"12979","42006","2014",5,5,0,105720,863.2,111.6
"12980","42007","2014",1,1,0,39500,823,48
"12981","42008","2014",2,2,0,77000,1046.5,81.5
"12982","42009","2014",3,3,0,141456.7,1364.667,109
"12983","42010","2014",9,9,0,156400,1865.889,89.55556
"12984","42011","2014",26,25,1,123920.4,1347.115,90
"12985","42012","2014",8,8,0,149955,1616.75,99.25
"12986","42013","2014",18,18,0,177866.1,1697.278,102.8889
"12987","42014","2014",5,5,0,133030,1025.8,140.6
"12988","42015","2014",13,12,1,97284.62,927.7692,100.7692
"12989","42016","2014",4,3,1,80350,937.5,85.75
"12990","42017","2014",1,1,0,68000,819,83
"12991","42018","2014",3,3,0,143000,1646.333,78
"12992","42019","2014",26,21,5,105707.3,1123.423,89.30769
"12993","42020","2014",13,9,4,151257.7,1488.231,99.61538
"12994","42021","2014",7,7,0,173844.3,1800.714,98
"12995","42022","2014",26,23,3,178714.6,2022,93.73077
"12996","42023","2014",22,17,5,122756.9,1311.818,92.27273
"12997","42026","2014",8,8,0,129131.2,1523.5,84.875
"12998","42027","2014",6,6,0,122768.3,1518.833,88
"12999","42028","2014",1,1,0,175000,2134,82
"13000","42029","2014",15,15,0,114814.7,1344,88.53333
"13001","42030","2014",2,2,0,70000,860,80
"13002","42031","2014",2,2,0,82805,1681,55
"13003","42032","2014",4,4,0,156012.5,1855,81
"13004","42033","2014",5,5,0,133135.4,1309.2,86
"13005","42036","2014",5,5,0,247890,2399.4,107.8
"13006","42037","2014",2,2,0,128500,1289.5,98
"13007","42038","2014",10,10,0,194972,1848.9,106.9
"13008","42039","2014",4,4,0,104200,1305.5,76.5
"13009","42040","2014",1,1,0,36000,400,90
"13010","42041","2014",3,2,1,198233.3,1729.333,113.6667
"13011","42042","2014",5,5,0,193490,2023.2,96.2
"13012","42043","2014",8,8,0,194087.5,1852.875,103.875
"13013","42044","2014",68,41,27,137698.1,1512.191,91.11765
"13014","42046","2014",14,11,3,117888.2,1393.071,87.57143
"13015","42048","2014",10,10,0,132827,1428.2,98.9
"13016","42049","2014",6,6,0,100908.3,981,98.83333
"13017","42051","2014",3,3,0,223933.3,2570.333,99
"13018","42052","2014",47,24,23,119014.9,1214.617,101.6809
"13019","42056","2014",25,19,6,155009.2,1479.72,104.96
"13020","42058","2014",4,4,0,74550,818.5,79.25
"13021","42059","2014",28,23,5,133512.5,1720.143,86.64286
"13022","42060","2014",5,5,0,135020,1582.8,94.4
"13023","42062","2014",10,10,0,151453,1704.9,91.2
"13024","42063","2014",6,5,1,103133.3,1305.333,81.16667
"13025","42064","2014",2,2,0,1e+05,1875,96
"13026","42065","2014",7,7,0,172338.6,1428,117.1429
"13027","42066","2014",7,7,0,212200,1834.571,98.28571
"13028","42067","2014",1,1,0,70000,389,180
"13029","42068","2014",1,1,0,205000,2228,92
"13030","42069","2014",17,17,0,160171.4,1559.353,103.0588
"13031","42070","2014",7,7,0,101200,1185.571,81.14286
"13032","42071","2014",89,32,57,104339.8,1242.213,83.82022
"13033","42073","2014",10,8,2,134606,1188.4,109
"13034","42074","2014",8,8,0,125997.2,1254.25,105.5
"13035","42075","2014",11,11,0,197536.4,1781,113.6364
"13036","42076","2014",4,4,0,77425,743,82.5
"13037","42077","2014",1,1,0,85000,944,90
"13038","42078","2014",2,2,0,121000,1267.5,86
"13039","42079","2014",5,5,0,103400,1069.4,98
"13040","42081","2014",7,7,0,223278.6,2052.571,107.2857
"13041","42083","2014",3,3,0,180333.3,1710.333,103
"13042","42084","2014",2,2,0,71800,629,105
"13043","42085","2014",7,6,1,128068.6,1783.143,74.71429
"13044","42086","2014",9,9,0,48428.89,711.2222,67.11111
"13045","42087","2014",8,8,0,196750,1803,106.375
"13046","42088","2014",14,14,0,144245.7,1350.143,109.3571
"13047","42089","2014",5,5,0,210006,2018.8,107
"13048","42090","2014",6,6,0,181425,1441.667,127
"13049","42091","2014",6,6,0,113875,1159.5,90.16667
"13050","42092","2014",24,18,6,195406.7,2006.708,94.95833
"13051","42093","2014",7,7,0,241500,2160.429,111.7143
"13052","42094","2014",97,42,55,148705.1,1871.577,82.93814
"13053","42095","2014",89,27,62,111713.2,1309.18,84.51685
"13054","42096","2014",5,5,0,178120,1659.2,114.4
"13055","42097","2014",29,20,9,169281,1886.379,91.10345
"13056","42098","2014",5,5,0,120960.4,1165.4,110
"13057","42099","2014",21,13,8,146308.9,1549.762,94.95238
"13058","42101","2014",1,1,0,2e+05,2703,74
"13059","42102","2014",2,2,0,155250,2184.5,74.5
"13060","42103","2014",25,14,11,161207.2,1584.24,98.28
"13061","42104","2014",4,4,0,101450,1023,106.5
"13062","42107","2014",5,5,0,104700,1088.4,93.2
"13063","42108","2014",7,7,0,173342.9,1832,94.85714
"13064","42109","2014",1,1,0,36000,837,43
"13065","42110","2014",27,15,12,157910.4,1809.37,88.77778
"13066","42112","2014",1,1,0,1e+05,1064,94
"13067","42113","2014",4,4,0,105750,1205.25,99.5
"13068","42115","2014",7,6,1,155185.7,1266.286,134.7143
"13069","42116","2014",3,3,0,75633.33,1394.333,63.33333
"13070","42118","2014",5,5,0,97738.8,1128.4,84
"13071","42119","2014",3,2,1,91666.67,1187.333,78
"13072","42120","2014",19,19,0,147377.4,1424.789,107.0526
"13073","42121","2014",2,2,0,133000,1212.5,100
"13074","42122","2014",10,10,0,285779,1938.8,144.6
"13075","42123","2014",21,13,8,176605.7,1790.905,101.3333
"13076","42124","2014",2,2,0,147000,1955.5,76
"13077","42126","2014",14,14,0,156702.9,1611.786,98.64286
"13078","42127","2014",39,37,2,139656.7,1451.692,98.53846
"13079","42128","2014",1,1,0,130000,1000,130
"13080","42129","2014",11,10,1,121179.1,1572.273,82.72727
"13081","42130","2014",2,2,0,237048,2179,108.5
"13082","42131","2014",4,4,0,111375,1051.5,103.75
"13083","42132","2014",1,1,0,69000,908,76
"13084","42133","2014",5,4,1,171682,1782.6,96.6
"13085","42134","2014",10,10,0,144500,1296.1,117.9
"13086","42135","2014",3,3,0,234166.7,1845,130.6667
"13087","42136","2014",4,4,0,150925,1373.25,118.25
"13088","42137","2014",8,8,0,170788.8,1710.25,105.375
"13089","42138","2014",9,9,0,131889.9,1438.444,93.33333
"13090","42139","2014",7,7,0,194157.1,1473,127.2857
"13091","42140","2014",6,6,0,132975,1352.167,105
"13092","42141","2014",8,8,0,105037.5,1192.375,114.875
"13093","42142","2014",2,2,0,169547.5,1316.5,127
"13094","42143","2014",5,5,0,81000,1102,82.2
"13095","42145","2014",7,7,0,143014.3,1311.571,108
"13096","42147","2014",173,95,78,128941.7,1519.462,86.77457
"13097","42148","2014",6,6,0,104905.8,1432.5,74.66667
"13098","42149","2014",62,36,26,125748.8,1634.113,75.98387
"13099","42150","2014",14,14,0,142489,1461,99.14286
"13100","42151","2014",1,1,0,134000,876,153
"13101","42153","2014",3,3,0,149000,1039,141.3333
"13102","42154","2014",8,8,0,155000,1250.625,128.75
"13103","42155","2014",7,7,0,131232.9,1320.143,98.28571
"13104","42156","2014",8,8,0,93706.25,1086,92.125
"13105","42157","2014",9,9,0,115737.8,1136.667,98.22222
"13106","42158","2014",1,1,0,166700,1208,138
"13107","42159","2014",8,8,0,102771.8,969.875,124.75
"13108","42160","2014",1,1,0,168840,1563,108
"13109","42161","2014",2,2,0,242980,1757,150
"13110","42162","2014",8,8,0,152911.2,1527.5,98.125
"13111","42163","2014",6,6,0,93333.33,758.3333,129.8333
"13112","42164","2014",1,1,0,30000,400,75
"13113","42165","2014",21,19,2,115092.9,1137.048,105.3333
"13114","42166","2014",10,10,0,159840.1,1532.6,107.6
"13115","42167","2014",3,3,0,137450,1340,97
"13116","42168","2014",38,33,5,165202.6,1659.789,102.2632
"13117","42169","2014",15,15,0,164726.7,1794.267,94.06667
"13118","42170","2014",13,13,0,139823.1,1345.846,103.7692
"13119","42171","2014",3,3,0,179150,1313,131
"13120","42172","2014",2,2,0,137000,998.5,104.5
"13121","42173","2014",2,2,0,140100,1535,81.5
"13122","42174","2014",7,7,0,177485.7,1624.714,110.5714
"13123","42175","2014",7,7,0,128485.7,1516.143,87.71429
"13124","42176","2014",16,15,1,163640.3,1380.812,122.25
"13125","42177","2014",19,18,1,107315.8,1057.316,100.4211
"13126","42178","2014",3,2,1,134000,1258,103.3333
"13127","42179","2014",3,3,0,188600,1898.667,99
"13128","42180","2014",7,7,0,167362.9,1960.857,97.71429
"13129","42181","2014",7,5,2,94349.14,1201.286,91.85714
"13130","42182","2014",29,26,3,128263.6,1208.69,103.7586
"13131","42183","2014",38,23,15,116264.4,1322.395,83.84211
"13132","42184","2014",110,69,41,114987.5,1491.682,78.24545
"13133","42185","2014",4,4,0,182280.5,1722.25,109.25
"13134","42186","2014",85,49,36,150420.7,1707.812,89.58824
"13135","42187","2014",411,110,301,87589.49,1183.457,74.81995
"13136","42188","2014",1,1,0,135000,1055,128
"13137","42189","2014",72,37,35,142977.4,1629.694,90.16667
"13138","42191","2014",12,11,1,155915,1855.583,86.58333
"13139","42193","2014",12,12,0,121785.8,1394.833,91.83333
"13140","42194","2014",3,3,0,59666.67,649.6667,88.33333
"13141","42195","2014",7,7,0,78928.57,1063,73.14286
"13142","42197","2014",11,11,0,118097.3,1330.636,87.45455
"13143","42198","2014",5,5,0,172630,1206.8,141.4
"13144","42199","2014",12,11,1,119775.4,1228.5,98.83333
"13145","42200","2014",9,9,0,186733.3,1968.111,93.44444
"13146","42201","2014",3,3,0,152133.3,1720,88.66667
"13147","42202","2014",6,6,0,97000,1268,93.5
"13148","42203","2014",2,2,0,62465,1095,59.5
"13149","42204","2014",11,7,4,98981.82,1005.455,98.54545
"13150","42205","2014",4,4,0,76725,1096.5,65.5
"13151","42206","2014",9,9,0,378044.4,2189.111,170.7778
"13152","42207","2014",266,90,176,132781.9,1570.432,85.43233
"13153","42208","2014",12,11,1,160156.7,1572.5,107
"13154","42209","2014",2,1,1,96250,1079,87
"13155","42210","2014",2,2,0,199000,1335.5,162.5
"13156","42211","2014",24,12,12,170130,1826.542,96.95833
"13157","42212","2014",7,7,0,119371.4,1447.286,85.71429
"13158","42213","2014",6,6,0,94000,985.6667,100.1667
"13159","42214","2014",6,6,0,203086.7,1957,107.1667
"13160","42215","2014",8,7,1,125913.8,1194.25,103.5
"13161","42216","2014",1,1,0,159100,1768,90
"13162","42217","2014",5,5,0,82420,804.2,100.6
"13163","42218","2014",1795,196,1599,89677.29,1251.287,71.56435
"13164","42219","2014",8,8,0,156887.5,1353.125,123.875
"13165","42220","2014",8,8,0,98761.75,1070.625,92.25
"13166","42221","2014",5,5,0,150389.4,1695.8,94.6
"13167","42222","2014",33,27,6,213007.3,2055.909,106.8788
"13168","42223","2014",48,23,25,175537.5,1798.667,99.29167
"13169","42224","2014",20,16,4,182357.5,1871.9,98.3
"13170","42225","2014",19,19,0,164500,1946.368,82.94737
"13171","42226","2014",2,2,0,80000,965.5,85
"13172","42227","2014",3,3,0,112066.7,1071.667,99
"13173","42228","2014",10,10,0,152280,1727.9,89
"13174","42229","2014",1,1,0,154500,1931,80
"13175","42230","2014",6,6,0,79499.17,1028.833,84
"13176","42231","2014",3,3,0,114000,1188.667,89
"13177","42232","2014",6,5,1,213750,2330.833,88.33333
"13178","42233","2014",7,7,0,160074.3,1493.714,111.1429
"13179","42234","2014",25,21,4,246318,2224.76,115.36
"13180","42235","2014",5,5,0,73580,911,82.8
"13181","42236","2014",2,2,0,122157,919.5,127.5
"13182","42237","2014",33,23,10,175952.1,1968.242,87.45455
"13183","42238","2014",5,5,0,46000,1244.2,51
"13184","42239","2014",6,6,0,122681.7,1188.333,104.6667
"13185","42240","2014",3,3,0,83333.33,1236.667,63.33333
"13186","42241","2014",2,2,0,148000,1586.5,121
"13187","42242","2014",7,5,2,173228.6,1913,96.42857
"13188","42245","2014",5,5,0,53700,668,85.6
"13189","42246","2014",10,9,1,99590,1404.2,96.7
"13190","42248","2014",9,9,0,83000,1081.111,83.22222
"13191","42249","2014",13,13,0,108230.8,1270.154,86.53846
"13192","42251","2014",3,3,0,118266.7,1146.667,105
"13193","42252","2014",1,1,0,130966,1637,80
"13194","42253","2014",3,3,0,172446.7,1622.667,111
"13195","42254","2014",4,4,0,95250,1155,84.5
"13196","42255","2014",2,2,0,87000,1253,62.5
"13197","42256","2014",30,26,4,153109.3,1724.533,92.3
"13198","42257","2014",9,9,0,110305.6,1329.222,82.88889
"13199","42259","2014",28,26,2,210203.6,2090.214,100.6429
"13200","42260","2014",3,3,0,106436.7,1066.333,100
"13201","42261","2014",5,5,0,193040,1339.2,147
"13202","42262","2014",11,10,1,81990.91,1213.455,68.63636
"13203","42264","2014",7,7,0,141580,1641.143,84.85714
"13204","42265","2014",6,6,0,248729.2,2222,109.3333
"13205","42266","2014",4,4,0,105250,1527,68
"13206","42267","2014",11,11,0,140781.8,1149.364,120.8182
"13207","42268","2014",3,3,0,93000,854,100.6667
"13208","42270","2014",16,10,6,162884.4,1699.438,93.125
"13209","42271","2014",29,22,7,176263.8,1796.448,100.1379
"13210","42272","2014",15,14,1,141288,1487.2,96.26667
"13211","42273","2014",3,3,0,110000,1141,111.3333
"13212","42274","2014",1,1,0,151420,1682,90
"13213","42275","2014",62,23,39,197922.1,2168.694,91.87097
"13214","42276","2014",6,4,2,40833.33,546.6667,78.66667
"13215","42277","2014",2,2,0,120000,1416.5,85
"13216","42278","2014",1,1,0,123000,1281,96
"13217","42279","2014",134,87,47,183702.7,1946.134,96.82836
"13218","42280","2014",3,3,0,118470,1185.333,107
"13219","42282","2014",3,3,0,111666.7,1108,95
"13220","42283","2014",8,7,1,181950,2127.25,84
"13221","42284","2014",5,5,0,141210,1367.8,111.2
"13222","42285","2014",29,25,4,143532.8,1549.759,93.17241
"13223","42286","2014",8,8,0,165381.2,1590,112
"13224","42287","2014",4,4,0,164725,2045.5,82.5
"13225","42288","2014",4,4,0,104668.8,1263.5,83.5
"13226","42289","2014",12,11,1,114941.7,1260.333,91.16667
"13227","42290","2014",4,4,0,191700,1872.75,103
"13228","42293","2014",11,11,0,173213.6,1741,96.54545
"13229","42294","2014",6,6,0,158861.2,1387.167,112.5
"13230","42295","2014",2,2,0,68100,1144,57
"13231","42296","2014",3,3,0,131333.3,1322.667,88.66667
"13232","42297","2014",4,4,0,93125,1029.25,79
"13233","42298","2014",3,3,0,100566.7,1070.667,82.33333
"13234","42299","2014",17,11,6,163667.1,1866.059,88.88235
"13235","42300","2014",5,5,0,110528,1159.4,97.2
"13236","42301","2014",6,5,1,134700,1157.667,120.6667
"13237","42302","2014",57,40,17,199358.8,2279.07,87.33333
"13238","42303","2014",1,1,0,59000,492,120
"13239","42304","2014",47,42,5,156112.4,1713.83,92.21277
"13240","42305","2014",53,25,28,162603.7,2179.66,77.86792
"13241","42306","2014",4,4,0,101000,1926.75,55.25
"13242","42307","2014",5,5,0,278426,2583.6,101
"13243","42308","2014",8,5,3,132533.1,1536.375,80.75
"13244","42311","2014",9,4,5,193444.4,1580.667,121.5556
"13245","42312","2014",4,3,1,136050,1131.75,121
"13246","42313","2014",5,5,0,133156,1442,91.8
"13247","42314","2014",4,4,0,77747.5,817.5,97
"13248","42315","2014",2,2,0,179800,2072,86.5
"13249","42316","2014",51,35,16,150330.8,1643.608,92.84314
"13250","42317","2014",1,1,0,115000,821,140
"13251","42318","2014",12,11,1,119900,1355.667,89.25
"13252","42319","2014",6,6,0,193795,1562,130
"13253","42320","2014",5,5,0,147920,1811.2,82
"13254","42322","2014",9,9,0,163044.4,1330.778,110.4444
"13255","42323","2014",65,51,14,196920.4,2290.338,89.15385
"13256","42324","2014",8,8,0,232575,2221.5,104.375
"13257","42325","2014",3,3,0,125333.3,1552.333,72.33333
"13258","42326","2014",6,6,0,135765,1431.5,93.66667
"13259","42327","2014",6,4,2,262258.3,2249.833,100.1667
"13260","42328","2014",6,5,1,120449.7,1472.5,79.16667
"13261","42329","2014",5,5,0,126100,1302.4,107.2
"13262","42330","2014",69,33,36,145741,1573.58,87.27536
"13263","42331","2014",2,2,0,154450,1084.5,141
"13264","42332","2014",30,26,4,158888.6,1448.733,110.6333
"13265","42333","2014",3,3,0,120600,1262.667,103.6667
"13266","42334","2014",11,11,0,119410,1544.091,81.45455
"13267","42335","2014",2,2,0,159800,1296,120
"13268","42336","2014",4,4,0,108500,1347.5,84.25
"13269","42337","2014",2,2,0,119450,818,153.5
"13270","42338","2014",10,10,0,137230,1429.8,95.5
"13271","42339","2014",1,1,0,130000,929,140
"13272","43001","2014",4,4,0,53262.5,670,79.25
"13273","43002","2014",14,13,1,191392.9,1772.929,104.1429
"13274","43003","2014",7,5,2,90001.43,1053.429,89
"13275","43004","2014",2,2,0,72625,705,95
"13276","43005","2014",1,1,0,45000,523,86
"13277","43007","2014",8,8,0,126461.2,1140.25,119.125
"13278","43008","2014",1,1,0,78000,1114,70
"13279","43009","2014",1,1,0,81000,1066,76
"13280","43010","2014",6,6,0,92916.67,1159.333,78.83333
"13281","43011","2014",1,1,0,133000,887,150
"13282","43012","2014",49,40,9,159746.9,1648.449,102.0612
"13283","43013","2014",4,4,0,42750,506.25,84.25
"13284","43015","2014",1,1,0,82000,911,90
"13285","43016","2014",6,6,0,104431.7,1085.167,105.5
"13286","43017","2014",2,2,0,102500,1186,86.5
"13287","43018","2014",5,5,0,160655.8,1348.2,117.6
"13288","43020","2014",30,29,1,157790.7,1742.4,96.36667
"13289","43021","2014",7,7,0,74078.57,892.7143,83.85714
"13290","43022","2014",3,3,0,91666.67,941.3333,104.6667
"13291","43023","2014",2,2,0,87500,1501,60.5
"13292","43024","2014",7,7,0,80080.43,1003.429,81.28571
"13293","43025","2014",33,31,2,151458.2,1513.848,103.9697
"13294","43026","2014",4,4,0,54925,647.25,91
"13295","43027","2014",1,1,0,90000,600,150
"13296","43028","2014",2,2,0,136500,1094.5,115.5
"13297","43029","2014",1,1,0,55000,1100,50
"13298","43030","2014",3,3,0,135035,1349,97.66667
"13299","43031","2014",2,2,0,83000,1283,62
"13300","43032","2014",9,9,0,162653.3,1525.111,107.5556
"13301","43033","2014",7,7,0,54542.86,768.4286,72.28571
"13302","43034","2014",3,3,0,46166.67,976.3333,47
"13303","43038","2014",6,6,0,98068.33,1195.333,92
"13304","43039","2014",5,5,0,123000,1381.6,88.6
"13305","43040","2014",58,45,13,100728.8,1150.672,93.41379
"13306","43041","2014",36,14,22,129355,1646.75,92
"13307","43042","2014",2,1,1,34500,784.5,44.5
"13308","43043","2014",2,2,0,39000,566.5,69
"13309","43044","2014",1,1,0,46180,722,64
"13310","43045","2014",2,2,0,90000,977.5,91
"13311","43046","2014",22,10,12,148011.7,1672.273,92.5
"13312","43047","2014",4,4,0,95970,1158.25,76.5
"13313","43048","2014",2,1,1,50000,862.5,61
"13314","43049","2014",6,6,0,75183.33,1063.833,69.5
"13315","43051","2014",22,15,7,119190.1,1400.182,90.18182
"13316","43052","2014",4,4,0,62750,840.75,80.75
"13317","43053","2014",2,2,0,111962.5,1928,64
"13318","43054","2014",2,2,0,90075,1224.5,82
"13319","43056","2014",6,6,0,91333.33,1112.167,78
"13320","43058","2014",11,10,1,176022.7,1904.273,96.72727
"13321","43060","2014",1,1,0,45000,600,75
"13322","43061","2014",7,7,0,154857.1,1296.429,107.8571
"13323","43062","2014",5,5,0,151487.6,1094.4,159.4
"13324","43063","2014",1,1,0,60000,545,110
"13325","43064","2014",2,2,0,126367.5,1587.5,87
"13326","43065","2014",1,1,0,52700,586,90
"13327","43067","2014",2,1,1,58750,822,64
"13328","43069","2014",4,4,0,144845,1155.75,140.5
"13329","43070","2014",1,1,0,1e+05,1136,88
"13330","43071","2014",2,2,0,37500,625,60
"13331","43072","2014",1,1,0,45400,420,108
"13332","43073","2014",2,2,0,72000,1272.5,70
"13333","43074","2014",3,3,0,331666.7,3665.333,97
"13334","43076","2014",1,1,0,102000,971,105
"13335","43077","2014",4,4,0,133037.5,1362,93.25
"13336","43078","2014",17,17,0,159879.5,1596.294,98.47059
"13337","43079","2014",1,1,0,55000,591,93
"13338","43080","2014",13,13,0,103246.2,966.5385,109
"13339","43082","2014",2,2,0,19925,360,56
"13340","43083","2014",1,1,0,133000,1209,110
"13341","43084","2014",6,6,0,122016.7,1516.667,82.16667
"13342","43085","2014",1,1,0,61300,681,90
"13343","43086","2014",1,1,0,35000,422,83
"13344","43087","2014",5,5,0,115830,1235.2,104
"13345","43088","2014",1,1,0,70000,538,130
"13346","43089","2014",36,21,15,124409.7,1381,92.75
"13347","43090","2014",1,1,0,70000,778,90
"13348","43092","2014",3,3,0,74666.67,726.6667,107
"13349","43093","2014",2,2,0,60000,1209.5,70
"13350","43095","2014",2,2,0,35750,561,60.5
"13351","43096","2014",5,5,0,95800,1099.2,88.4
"13352","43097","2014",1,1,0,1e+05,2000,50
"13353","43099","2014",4,4,0,56100,740,73
"13354","43100","2014",1,1,0,70000,909,77
"13355","43101","2014",3,3,0,73000,1002,76.66667
"13356","43102","2014",7,7,0,103142.9,1275.571,82
"13357","43104","2014",1,1,0,45000,450,100
"13358","43105","2014",1,1,0,168000,1615,104
"13359","43106","2014",1,1,0,118000,1044,113
"13360","43107","2014",2,2,0,78950,818,93.5
"13361","43108","2014",1,1,0,105400,1184,89
"13362","43110","2014",7,7,0,125021.4,1261.714,103.4286
"13363","43111","2014",5,5,0,130820,1324.8,100.6
"13364","43112","2014",34,25,9,76478.65,1027.441,80.23529
"13365","43113","2014",5,5,0,148640,1804,86.2
"13366","43114","2014",20,20,0,115932.5,1119.7,107.3
"13367","43115","2014",4,3,1,102250,1567.5,62
"13368","43117","2014",5,5,0,82420,671.6,123
"13369","43118","2014",2,2,0,56710,481.5,115
"13370","43119","2014",4,4,0,140450,1521.5,89.5
"13371","43120","2014",15,15,0,84910,1004.6,86.06667
"13372","43122","2014",2,2,0,125000,1610,77.5
"13373","43124","2014",3,3,0,106795,1048,104.6667
"13374","43126","2014",7,7,0,148071.4,1209.714,127.5714
"13375","43127","2014",8,8,0,162091.2,2074.125,96.125
"13376","43130","2014",7,6,1,124145.7,1886.143,73.42857
"13377","43131","2014",1,1,0,87525,875,100
"13378","43132","2014",5,5,0,110600,953.4,112.4
"13379","43133","2014",1,1,0,83000,1169,71
"13380","43134","2014",3,3,0,134238.3,1349.333,93.33333
"13381","43135","2014",8,8,0,100768.8,1135.25,87.875
"13382","43136","2014",3,3,0,103833.3,1153,96.66667
"13383","43137","2014",65,53,12,168441.4,1751.2,96.96923
"13384","43138","2014",1,1,0,96810,880,110
"13385","43139","2014",1,1,0,180500,1433,126
"13386","43140","2014",1,1,0,35000,686,51
"13387","43141","2014",7,6,1,112071.4,1128.286,97.42857
"13388","43142","2014",3,2,1,175050,1754.667,118.6667
"13389","43143","2014",1,1,0,70000,3182,22
"13390","43144","2014",1,1,0,80000,1231,65
"13391","43145","2014",1,1,0,50000,568,88
"13392","43147","2014",1,1,0,98000,1140,86
"13393","43148","2014",7,7,0,74881.43,833,88.71429
"13394","43149","2014",2,2,0,57500,1045,83
"13395","43150","2014",4,4,0,127750,1541.75,86.5
"13396","43151","2014",3,3,0,80833.33,892,99
"13397","43152","2014",9,9,0,223900.6,1990.333,126.6667
"13398","43153","2014",11,7,4,130318.5,1336.818,97.45455
"13399","43154","2014",5,4,1,105447,1712.6,60.4
"13400","43155","2014",1,1,0,85000,1062,80
"13401","43156","2014",5,5,0,71960,1245.6,71
"13402","43157","2014",227,52,175,96433.42,1234.52,79.80176
"13403","43158","2014",1,1,0,125000,1453,86
"13404","43159","2014",3,3,0,142513.3,1278.667,112.6667
"13405","43160","2014",3,3,0,73066.67,1089.667,86.66667
"13406","43162","2014",22,21,1,116419.5,1308.818,89.63636
"13407","43163","2014",6,6,0,81712.5,900.1667,106.3333
"13408","43164","2014",5,5,0,83700,1005.6,89.4
"13409","43165","2014",14,12,2,86973.21,975.9286,93.78571
"13410","43166","2014",3,3,0,123256.7,1315,91.33333
"13411","43167","2014",2,2,0,62500,759,82.5
"13412","43170","2014",3,3,0,126266.7,1010,119.3333
"13413","43171","2014",1,1,0,57000,393,145
"13414","43172","2014",6,6,0,89816.67,877.6667,114.8333
"13415","43173","2014",1,1,0,41000,820,50
"13416","43174","2014",8,7,1,128975.9,1437.5,89.25
"13417","43177","2014",27,24,3,119548.1,1284.926,99.14815
"13418","43178","2014",1,1,0,45000,536,84
"13419","43180","2014",1,1,0,84000,2710,31
"13420","43181","2014",7,6,1,128400,1549.857,83.85714
"13421","43182","2014",1,1,0,47000,427,110
"13422","43183","2014",3,3,0,71401.33,653.3333,111.6667
"13423","43184","2014",21,15,6,179576.6,2157.952,86.09524
"13424","43185","2014",28,25,3,95991.25,1069.5,88.07143
"13425","43186","2014",2,2,0,127500,1237,101.5
"13426","43187","2014",6,6,0,69416.67,1005.167,73.33333
"13427","43188","2014",3,3,0,108166.7,1030.667,103.6667
"13428","43189","2014",3,3,0,85666.67,1061,94
"13429","43190","2014",17,17,0,176797.1,1689.706,106.0588
"13430","43192","2014",1,1,0,90000,1216,74
"13431","43193","2014",2,2,0,80000,819,96
"13432","43194","2014",4,3,1,142720,1293.25,104
"13433","43195","2014",1,1,0,35000,389,90
"13434","43196","2014",4,4,0,67000,838,80.5
"13435","43197","2014",2,2,0,77050,706.5,110
"13436","43198","2014",3,3,0,107333.3,1562.333,71.66667
"13437","43199","2014",11,11,0,106321.4,1307.455,86.63636
"13438","43200","2014",18,17,1,118991.1,1361.333,92.83333
"13439","43201","2014",3,3,0,152666.7,1631,95.66667
"13440","43202","2014",3,3,0,52866.67,524.3333,102.3333
"13441","43203","2014",2,2,0,50000,885,51.5
"13442","43204","2014",2,2,0,113500,1258.5,90
"13443","43205","2014",35,20,15,131506.4,1378.171,95.51429
"13444","43206","2014",1,1,0,97500,812,120
"13445","43207","2014",4,4,0,143908.8,1105.75,124.5
"13446","43210","2014",1,1,0,90000,1385,65
"13447","43211","2014",16,16,0,150143.4,1406.875,107.625
"13448","43212","2014",6,6,0,89566.67,929,103.6667
"13449","43213","2014",10,8,2,113889,1250.9,88.9
"13450","43214","2014",1,1,0,57000,570,100
"13451","43215","2014",2,2,0,130875,1616.5,83
"13452","43216","2014",18,18,0,137852.8,1314.056,107.3333
"13453","43217","2014",3,3,0,120373.3,1158.667,97.33333
"13454","43218","2014",5,5,0,186940,1453,123.8
"13455","43219","2014",1,1,0,62500,521,120
"13456","43220","2014",1,1,0,70000,438,160
"13457","43221","2014",4,4,0,187400,1476.5,116
"13458","43223","2014",8,8,0,141393.8,1395.375,110.25
"13459","43224","2014",29,26,3,144168.6,1579.862,95.55172
"13460","43226","2014",3,3,0,65000,924,76
"13461","43227","2014",2,1,1,101500,2083,51.5
"13462","43228","2014",4,3,1,53687.5,813.5,82.5
"13463","43229","2014",4,4,0,128587.5,1322.5,95
"13464","43230","2014",10,10,0,139115,1295.6,110.2
"13465","43231","2014",2,2,0,72500,824,90.5
"13466","43232","2014",2,2,0,73867.5,864,83
"13467","43233","2014",13,13,0,136723.7,1214.462,115
"13468","43234","2014",11,11,0,86908.18,1050.727,89.81818
"13469","43236","2014",17,6,11,107591.2,1191.765,92.41176
"13470","43237","2014",4,4,0,73250,696.25,101.25
"13471","43238","2014",5,5,0,74900,899.8,86.4
"13472","43239","2014",10,10,0,100280,948.5,104.2
"13473","43240","2014",3,3,0,67500,900.6667,73
"13474","43241","2014",9,9,0,136661.3,996.4444,136.5556
"13475","43242","2014",1,1,0,64500,896,72
"13476","43244","2014",19,17,2,109161.1,1240.263,93.52632
"13477","43245","2014",1,1,0,105500,528,200
"13478","43246","2014",3,3,0,79333.33,1056.333,84
"13479","43249","2014",2,2,0,79500,625,105.5
"13480","43250","2014",1,1,0,22500,388,58
"13481","43251","2014",35,14,21,122930.7,1354.2,90.85714
"13482","43253","2014",5,4,1,77620,1216.4,72
"13483","43254","2014",3,3,0,91666.67,913,97.66667
"13484","43257","2014",3,3,0,85187.33,1071.667,99
"13485","43258","2014",17,16,1,113210,1091.118,102.4706
"13486","43259","2014",7,7,0,107500,1113.714,86.85714
"13487","43260","2014",1,1,0,155000,871,178
"13488","43261","2014",5,5,0,89380,1053.8,81.2
"13489","43262","2014",33,11,22,60040.91,914.5455,60.36364
"13490","43263","2014",5,5,0,78200,1494.4,57.8
"13491","43264","2014",7,7,0,86042.86,927.4286,87.71429
"13492","43265","2014",6,6,0,158791.7,1771.833,94.16667
"13493","43267","2014",15,13,2,100403.3,1092.333,94.06667
"13494","43268","2014",40,31,9,125883.9,1486.925,88
"13495","44001","2014",14,14,0,98821.43,1404.643,76
"13496","44002","2014",34,34,0,204500,2065.618,101.9118
"13497","44003","2014",79,53,26,156780.4,1809.696,91.72152
"13498","44005","2014",61,60,1,158866.6,1856.672,87.7377
"13499","44006","2014",32,32,0,172073.4,2260.688,79.34375
"13500","44007","2014",28,28,0,102985.7,1192.143,88.07143
"13501","44009","2014",66,61,5,286676.5,2621.636,111.4697
"13502","44010","2014",65,58,7,202097.2,3274.862,71.18462
"13503","44012","2014",77,65,12,187578.6,2823.974,68.57143
"13504","44013","2014",22,22,0,134320.1,1614.636,87.63636
"13505","44014","2014",28,27,1,202642.9,2025.321,101.6786
"13506","44015","2014",68,60,8,143442.4,1736.706,86.69118
"13507","44016","2014",8,8,0,136018.8,1494.875,90.875
"13508","44018","2014",79,72,7,224239.1,2309.253,99.3038
"13509","44019","2014",10,10,0,165351,1818.3,91.7
"13510","44020","2014",159,138,21,207843.6,2426.415,89.89308
"13511","44021","2014",56,56,0,153423.4,1695.821,94.53571
"13512","44022","2014",11,11,0,143627.3,1384.182,106.5455
"13513","44023","2014",28,27,1,145592.9,2008.929,84.82143
"13514","44024","2014",2,2,0,167500,2869.5,59.5
"13515","44025","2014",35,35,0,158177,1643.886,97.97143
"13516","44026","2014",185,126,59,257247.4,2731.124,97.16216
"13517","44027","2014",15,15,0,180000,1843.4,99.53333
"13518","44028","2014",10,10,0,176900,1535.8,116.4
"13519","44029","2014",58,56,2,156518.5,1680.983,92.93103
"13520","44030","2014",45,44,1,136478.7,1518.289,93.22222
"13521","44031","2014",10,10,0,79330,947.5,86.7
"13522","44032","2014",45,44,1,178770.5,1976.111,92.88889
"13523","44033","2014",25,25,0,198676,1933,112.04
"13524","44035","2014",183,140,43,250750.3,2694.35,93.59016
"13525","44036","2014",126,103,23,135927.4,1583.151,90.74603
"13526","44037","2014",26,26,0,195423.1,1907.385,105.8077
"13527","44038","2014",30,30,0,151484.6,1871.6,82.43333
"13528","44039","2014",7,7,0,173802.1,1840.429,98.85714
"13529","44041","2014",3,3,0,122000,1868.333,70
"13530","44043","2014",72,61,11,192882.8,2102.903,91.375
"13531","44044","2014",7,7,0,114585.7,1100,111.2857
"13532","44045","2014",19,19,0,200262.8,1924.684,105.5789
"13533","44046","2014",17,17,0,182952.9,1751.588,105.1176
"13534","44047","2014",195,170,25,212059.2,2402.169,91.60513
"13535","44048","2014",24,24,0,146541.7,1574.708,94.375
"13536","44049","2014",102,51,51,215356.9,3062.922,74.29412
"13537","44050","2014",23,23,0,119200.1,1498.478,88.13043
"13538","44051","2014",24,24,0,127062.5,1400.167,93.25
"13539","44052","2014",72,70,2,135791.7,1488.431,92.84722
"13540","44053","2014",22,22,0,179277.3,1588.636,116.0909
"13541","44054","2014",16,16,0,121447.1,1219.375,102.8125
"13542","44055","2014",541,214,327,303327.4,4356.372,73.13124
"13543","44056","2014",36,36,0,147783.9,1617.083,98.16667
"13544","44057","2014",16,16,0,104058.1,1014.375,103.6875
"13545","44058","2014",6,6,0,82083.33,983.1667,90.5
"13546","44061","2014",28,28,0,166412.1,1623.143,108.0357
"13547","44062","2014",18,18,0,123083.3,1552.611,81.55556
"13548","44063","2014",22,21,1,150920.1,1815.318,89.77273
"13549","44064","2014",29,27,2,190124.8,1889.862,102.2069
"13550","44065","2014",10,10,0,67625,940.8,68.3
"13551","44066","2014",25,25,0,198402.4,2064.88,98.96
"13552","44067","2014",53,52,1,92405.96,1232.887,78.11321
"13553","44068","2014",40,40,0,110875.9,1342.425,82.625
"13554","44069","2014",175,137,38,249046.4,2668.834,96.39429
"13555","44070","2014",43,41,2,191676.7,2055.326,98.51163
"13556","44071","2014",38,38,0,267144.7,2415.053,111.4474
"13557","44072","2014",53,52,1,198077,2011.17,103.5849
"13558","44073","2014",27,26,1,173938.9,1903.741,95.7037
"13559","44074","2014",40,36,4,196204.2,2661,75.325
"13560","44075","2014",16,16,0,112375,1072.062,109.8125
"13561","44076","2014",11,11,0,113954.5,1253.364,97.54545
"13562","44077","2014",20,20,0,159025,1655.7,98.7
"13563","44078","2014",2,2,0,78500,981.5,80.5
"13564","44079","2014",18,18,0,2e+05,1938.111,108.3333
"13565","44080","2014",2,2,0,272500,2966.5,131
"13566","44081","2014",37,37,0,104745.9,1335.189,84.37838
"13567","44082","2014",17,17,0,189617.6,1807.647,103.7059
"13568","44083","2014",24,24,0,169424.2,1686.208,100.7083
"13569","44084","2014",70,62,8,187555.3,2013.414,94.41429
"13570","44085","2014",6,6,0,96916.67,872.8333,115
"13571","44086","2014",10,10,0,87850,1051.8,94.8
"13572","44087","2014",73,66,7,138163,1608.781,88.35616
"13573","44088","2014",22,22,0,164625,1698.136,101.4091
"13574","44089","2014",27,27,0,177018.6,2069,87.7037
"13575","44090","2014",8,8,0,134962.5,1551,95.375
"13576","44091","2014",15,15,0,130933.3,1416.4,97
"13577","44092","2014",13,13,0,87846.08,1162.154,87.61538
"13578","44094","2014",25,22,3,214460,2155.16,100.72
"13579","44095","2014",13,13,0,106880.8,1242.385,95.84615
"13580","44096","2014",34,34,0,174989.9,1805.941,104.2647
"13581","44097","2014",33,29,4,263570.3,2884.091,97.30303
"13582","44098","2014",48,47,1,137847.9,1532.271,94.83333
"13583","44099","2014",19,18,1,136578.9,1205.684,113.8947
"13584","44100","2014",22,22,0,146542.5,1662.364,89.09091
"13585","44101","2014",71,64,7,167358.6,2211.873,81
"13586","44102","2014",26,26,0,170865.4,1796.269,94.5
"13587","44103","2014",62,56,6,155081.9,1922.081,85.82258
"13588","44104","2014",6,6,0,94500,1123.5,82.33333
"13589","44105","2014",4,4,0,125375,1510,90
"13590","44106","2014",38,35,3,217529.5,2626.684,85.5
"13591","44107","2014",15,15,0,169346.7,1662,105.4
"13592","44108","2014",24,24,0,159510,1858.458,90.45833
"13593","44109","2014",4262,1095,3167,193867.2,2792.939,69.05373
"13594","44110","2014",66,59,7,164834.8,1906.424,89.69697
"13595","44111","2014",11,11,0,166194.1,1261.091,138.3636
"13596","44112","2014",8,8,0,99937.5,1016.625,100.625
"13597","44113","2014",37,35,2,145756.8,1628.973,94.72973
"13598","44114","2014",242,159,83,235293.6,2575.153,91.27273
"13599","44115","2014",22,19,3,176750.9,1890.955,95.77273
"13600","44116","2014",28,26,2,134876.1,1326.607,107.7143
"13601","44117","2014",36,35,1,160801.6,1785.778,93.36111
"13602","44118","2014",25,25,0,138349.5,1344,103.76
"13603","44119","2014",7,7,0,165607.1,1547.286,117.8571
"13604","44120","2014",37,35,2,191297.3,2320.919,85.86486
"13605","44121","2014",2,2,0,84000,1061,83
"13606","44122","2014",26,26,0,177265.9,1751.5,102.1154
"13607","44123","2014",13,13,0,89674.77,1146.923,84.38462
"13608","44124","2014",8,8,0,102625,855.375,120.875
"13609","44125","2014",48,42,6,241293.8,3151.125,86.75
"13610","44126","2014",71,66,5,182036.8,2903.085,70.95775
"13611","44127","2014",19,19,0,143107.9,1681.684,88.78947
"13612","44128","2014",60,60,0,133698.3,1364.833,100.1167
"13613","44129","2014",79,69,10,137424.9,1562.253,92.91139
"13614","44130","2014",45,45,0,192410.8,2120.733,92.77778
"13615","44131","2014",277,233,44,239828.6,2928.249,83.90253
"13616","44132","2014",249,112,137,269911.7,3822.442,74.74699
"13617","44133","2014",14,14,0,191178.6,1818.571,118.0714
"13618","44134","2014",12,12,0,124625,1169.583,110.5
"13619","44135","2014",128,73,55,300815,3883.406,78.0625
"13620","44136","2014",1,1,0,140000,2745,51
"13621","44137","2014",31,31,0,156273.1,1796.516,89.83871
"13622","44138","2014",6,6,0,160883.3,1689.667,96.66667
"13623","44139","2014",12,12,0,154463.3,1673.333,96.91667
"13624","44140","2014",22,22,0,127227.3,1569.955,80.40909
"13625","44141","2014",16,16,0,155437.5,1569.438,108.3125
"13626","44142","2014",13,13,0,141107.7,1709.923,87.84615
"13627","44143","2014",517,290,227,183974.3,2418.48,77.706
"13628","44144","2014",26,24,2,126102.4,1443.077,87.96154
"13629","44145","2014",18,18,0,167833.3,2012.167,86.66667
"13630","44146","2014",12,12,0,149433.3,1338.75,120
"13631","44148","2014",4,4,0,115750,983.25,113.25
"13632","44149","2014",24,24,0,147700,1699.458,91
"13633","44150","2014",24,24,0,207807.9,2366,90.625
"13634","44151","2014",65,61,4,262710.1,2227.246,113.4
"13635","44152","2014",15,15,0,142702.2,1493.733,100.4
"13636","44153","2014",17,17,0,121817.6,1206.765,103.1765
"13637","44154","2014",259,190,69,199658.4,2896.88,72.3668
"13638","44155","2014",25,25,0,145598.8,1609.76,89.4
"13639","44156","2014",27,27,0,109848.1,1275.852,87.14815
"13640","44157","2014",8,8,0,106500,1275.5,90
"13641","44158","2014",47,47,0,214688.4,2383.34,96.85106
"13642","44159","2014",13,12,1,195680.8,2158.385,92.23077
"13643","44161","2014",19,19,0,121642.1,1430.211,87.15789
"13644","44162","2014",504,241,263,184276.2,2276.315,81.0377
"13645","44163","2014",35,34,1,159751.4,1580.371,103.4
"13646","44164","2014",22,22,0,145868.2,1633.5,94.18182
"13647","44165","2014",13,13,0,174700,1663.385,108.1538
"13648","44166","2014",30,26,4,180083.3,2177.733,84.93333
"13649","44168","2014",40,40,0,121362.5,1399.8,88.25
"13650","44169","2014",63,63,0,180495.2,1950.81,93.42857
"13651","44170","2014",4,4,0,124250,1271.75,103
"13652","44171","2014",10,10,0,210200,2281.6,93.4
"13653","44172","2014",112,95,17,262596.8,2716.571,97.66071
"13654","44173","2014",24,24,0,161635.4,1759.375,94.08333
"13655","44174","2014",14,13,1,128071.4,1489.571,86.85714
"13656","44175","2014",47,47,0,213322.5,1934.319,116.4043
"13657","44176","2014",24,24,0,133632.1,1477.792,90.66667
"13658","44178","2014",15,15,0,191566.7,2067.2,94
"13659","44179","2014",26,26,0,175653.7,1833.5,104.1538
"13660","44180","2014",42,41,1,107957.1,1164.714,96.71429
"13661","44182","2014",104,86,18,181430,2709.683,70.78846
"13662","44183","2014",24,24,0,180040,1817.5,103.9583
"13663","44184","2014",765,404,361,148783.1,1934.566,77.68627
"13664","44185","2014",26,20,6,89003.85,1307.615,69.11538
"13665","44186","2014",58,57,1,179284.4,1876.983,98.55172
"13666","44187","2014",40,36,4,135860.9,1748.825,79.35
"13667","44188","2014",79,79,0,184127.8,1857.19,100.6456
"13668","44189","2014",28,28,0,125684.6,1417.607,91.10714
"13669","44190","2014",329,211,118,201433.8,2514.356,81.13678
"13670","44192","2014",18,18,0,142190.3,1576.722,93.66667
"13671","44193","2014",11,11,0,94317.27,1235.909,80.90909
"13672","44194","2014",58,47,11,326990.1,2945.121,106.4828
"13673","44195","2014",72,63,9,165227,1903.847,91.09722
"13674","44196","2014",19,19,0,106032.1,1391.211,87.31579
"13675","44197","2014",16,16,0,116562.5,1183.938,105.4375
"13676","44198","2014",78,52,26,188784.5,2496.474,77.02564
"13677","44199","2014",13,13,0,91353,1134.923,83.69231
"13678","44200","2014",4,4,0,86250,1470.75,68.5
"13679","44201","2014",34,29,5,267996,2727.353,104.2353
"13680","44202","2014",10,10,0,111950,1188.8,103
"13681","44203","2014",20,16,4,180179,1915.35,94.55
"13682","44204","2014",112,93,19,248474.8,2568.188,99.83929
"13683","44205","2014",14,13,1,152500,1881,84.35714
"13684","44206","2014",30,30,0,121867.3,1260.233,96.23333
"13685","44207","2014",7,7,0,195110,1335.571,140.4286
"13686","44208","2014",6,6,0,118182.5,1114,112.3333
"13687","44209","2014",9,9,0,236262.7,2600.444,94
"13688","44210","2014",65,58,7,135566.9,1661.123,84.29231
"13689","44211","2014",86,63,23,203689.9,2888.709,78.01163
"13690","44212","2014",66,63,3,173737.1,1897.939,95.89394
"13691","44213","2014",58,56,2,123675.1,1301.586,95
"13692","44214","2014",14,14,0,154450,1431.857,108.4286
"13693","44215","2014",260,212,48,239307.8,2571.165,93.55
"13694","44216","2014",33,33,0,138603,1490.182,93.63636
"13695","44217","2014",44,42,2,221493.2,2155.409,107.9318
"13696","44218","2014",8,8,0,88693.75,1099.25,82.375
"13697","44220","2014",14,14,0,122693.5,1517.357,84
"13698","44221","2014",7,7,0,132500,1397.286,101.1429
"13699","44222","2014",13,13,0,144556.9,1748.615,84.07692
"13700","44223","2014",26,22,4,167494.2,1754.231,97.15385
"13701","44224","2014",18,18,0,139758.9,1513.833,96.16667
"13702","45001","2014",1,1,0,75000,577,130
"13703","45002","2014",7,7,0,86798.71,841.1429,103.7143
"13704","45004","2014",110,101,9,136804.3,1516.536,93.67273
"13705","45005","2014",2,2,0,213000,1140,192
"13706","45006","2014",12,11,1,346901.7,2650.083,137.1667
"13707","45008","2014",20,17,3,141095,1635.4,93.4
"13708","45009","2014",7,7,0,131857.1,1588.714,84.28571
"13709","45010","2014",7,7,0,143285.7,1197,128
"13710","45011","2014",2,2,0,113469,1109,104
"13711","45012","2014",1,1,0,155000,1667,93
"13712","45013","2014",1,1,0,2e+05,2857,70
"13713","45014","2014",3,3,0,148333.3,1778.667,84.66667
"13714","45015","2014",4,4,0,183000,1544.75,118.75
"13715","45016","2014",8,8,0,98125,1311.5,76.875
"13716","45017","2014",2,2,0,141250,1127.5,124.5
"13717","45018","2014",7,7,0,129428.6,1624.857,94.71429
"13718","45019","2014",6,6,0,197825,1910.667,113
"13719","45020","2014",4,4,0,195925,1901.25,105.75
"13720","45021","2014",2,2,0,95000,1305.5,71.5
"13721","45022","2014",6,6,0,172166.7,1919.167,93.5
"13722","45023","2014",2,2,0,97500,977.5,99.5
"13723","45024","2014",16,15,1,144922.5,1806.062,82.375
"13724","45025","2014",5,5,0,128000,1284.2,93
"13725","45026","2014",5,5,0,117100,1303.6,89.4
"13726","45027","2014",6,6,0,190283.3,1480.167,122.5
"13727","45028","2014",83,54,29,136911.3,1684.542,83.96386
"13728","45029","2014",26,26,0,100988.5,1139.077,87.07692
"13729","45030","2014",12,12,0,130040.2,1352.417,108.8333
"13730","45031","2014",10,10,0,87550,1101.3,83.4
"13731","45032","2014",2,2,0,145000,932.5,151
"13732","45033","2014",6,6,0,120750,1258.167,97.66667
"13733","45034","2014",14,14,0,200351.4,2015,103.0714
"13734","45035","2014",4,4,0,108000,1724.75,78.75
"13735","45036","2014",9,9,0,168698.9,1449.556,120.1111
"13736","45037","2014",1,1,0,245000,1885,130
"13737","45038","2014",3,3,0,125166.7,1080.333,127.6667
"13738","45039","2014",7,7,0,145635.7,1564.429,94.14286
"13739","45040","2014",26,26,0,89884.23,1049,83.42308
"13740","45041","2014",2,2,0,109750,1780.5,61.5
"13741","45042","2014",23,23,0,119439.2,1432.522,87
"13742","45043","2014",9,9,0,187258.9,1786.778,110.5556
"13743","45044","2014",2,2,0,166150,1240,137.5
"13744","45045","2014",1,1,0,180000,1800,100
"13745","45046","2014",7,7,0,135679.1,1350.714,105.1429
"13746","45047","2014",2,2,0,153750,1169,137
"13747","45049","2014",11,11,0,152863.6,1405.182,115.6364
"13748","45050","2014",11,11,0,131331.9,1429.545,91.54545
"13749","45051","2014",14,14,0,147636.1,1635,96.71429
"13750","45052","2014",1,1,0,148000,3524,42
"13751","45053","2014",48,43,5,114457.4,1251.729,92.22917
"13752","45054","2014",6,6,0,159416.7,2098.167,81.33333
"13753","45055","2014",4,4,0,142450,1164,119.25
"13754","45056","2014",2,2,0,147500,1185,126
"13755","45060","2014",8,8,0,112468.8,1319.375,88.25
"13756","45061","2014",20,19,1,114721.1,1364.1,91.1
"13757","45062","2014",14,14,0,172548.6,1620.929,104.0714
"13758","45063","2014",12,12,0,185241.7,1435,123.8333
"13759","45064","2014",7,7,0,97571.43,959.4286,99.71429
"13760","45065","2014",4,4,0,152375,1721.75,91.5
"13761","45066","2014",4,4,0,92250,1182,74
"13762","45067","2014",21,20,1,213332.8,2007.476,110
"13763","45068","2014",74,65,9,110758.3,1575.081,75.91892
"13764","45069","2014",4,4,0,152750,1603.75,98.25
"13765","45070","2014",1,1,0,30000,667,45
"13766","45072","2014",4,4,0,313475,1686.5,182.5
"13767","45073","2014",7,5,2,134078.6,1066.143,111.8571
"13768","45075","2014",99,58,41,165436,1949.657,85.26263
"13769","45076","2014",1,1,0,60000,1250,48
"13770","45077","2014",7,7,0,125185.7,1189.286,114.8571
"13771","45078","2014",5,5,0,150800,1121.4,142.4
"13772","45079","2014",1,1,0,52000,416,125
"13773","45080","2014",4,4,0,155500,1282.5,124
"13774","45081","2014",6,6,0,132166.7,1324.833,104.3333
"13775","45082","2014",83,64,19,148331,1680.88,91.40964
"13776","45083","2014",16,16,0,98882.5,1115.625,87.5625
"13777","45084","2014",7,7,0,122785.7,1235,104.8571
"13778","45085","2014",10,10,0,109475,1397.2,76.6
"13779","45086","2014",3,3,0,154800,1217.333,137.3333
"13780","45087","2014",30,28,2,102045.4,1210.4,88.33333
"13781","45088","2014",5,5,0,184968.4,1503.4,132.4
"13782","45089","2014",70,61,9,168796,2209.086,87.37143
"13783","45091","2014",1,1,0,145000,1510,96
"13784","45092","2014",9,9,0,133278.9,1798.667,83.88889
"13785","45093","2014",14,13,1,166889.1,1585.786,110.7857
"13786","45094","2014",4,4,0,152875,1358.5,133.75
"13787","45095","2014",25,25,0,131364.4,1531.32,87.6
"13788","45096","2014",8,8,0,153550,2348.5,81.25
"13789","45097","2014",21,21,0,119753.3,1322.238,94.47619
"13790","45098","2014",20,20,0,196318.8,2005.6,104.25
"13791","45099","2014",5,5,0,154673.4,1411,117.2
"13792","45100","2014",4,4,0,226575,2306.75,105
"13793","45101","2014",3,3,0,206950,1735.667,145
"13794","45102","2014",1,1,0,153300,1783,86
"13795","45103","2014",11,11,0,98136.36,1093.727,95.45455
"13796","45104","2014",16,16,0,132285.3,1453.625,96.8125
"13797","45107","2014",2,2,0,195043.5,2230.5,86
"13798","45108","2014",15,15,0,122034.7,1368.2,85.4
"13799","45109","2014",1,1,0,220000,1964,112
"13800","45110","2014",3,3,0,110666.7,1265.333,91.66667
"13801","45111","2014",6,6,0,124660.2,1768.833,81.16667
"13802","45112","2014",3,3,0,136666.7,1160,118.3333
"13803","45113","2014",4,4,0,127350,1272.75,103.5
"13804","45114","2014",2,2,0,140000,1749,80
"13805","45115","2014",32,31,1,111255.6,1438.625,79.84375
"13806","45116","2014",5,5,0,106200,1071.8,95.6
"13807","45118","2014",4,4,0,130875,1506.25,101.75
"13808","45119","2014",19,19,0,157004.7,1697.632,100.7895
"13809","45121","2014",7,7,0,87330,988.2857,93.14286
"13810","45122","2014",8,8,0,151212.5,1607,98.625
"13811","45123","2014",13,13,0,199567.9,1949.231,105.1538
"13812","45124","2014",2,2,0,187250,1788,106.5
"13813","45126","2014",22,22,0,184466.1,1765.636,112.4545
"13814","45127","2014",32,32,0,158718.8,1694.875,108.0938
"13815","45129","2014",12,12,0,100950,1142.333,90.66667
"13816","45130","2014",11,11,0,156421.8,1731.273,94.18182
"13817","45131","2014",9,9,0,117900,1120.111,111.6667
"13818","45132","2014",3,3,0,127003.3,1276,100.6667
"13819","45133","2014",3,3,0,139533.3,1485.667,96.66667
"13820","45134","2014",13,13,0,142408.1,1436.308,109
"13821","45136","2014",7,7,0,129714.3,1371.857,95.42857
"13822","45138","2014",1,1,0,113500,1207,94
"13823","45139","2014",5,5,0,140802,1615.2,92.8
"13824","45141","2014",7,7,0,93314.29,925.1429,98.28571
"13825","45142","2014",23,23,0,166410.2,1717.826,102.1304
"13826","45144","2014",12,12,0,179436.7,1740.167,117
"13827","45145","2014",28,28,0,138698.6,1567.75,92.03571
"13828","45146","2014",65,64,1,157425.7,1739.431,87.72308
"13829","45147","2014",166,98,68,147688.4,1936.482,78.93976
"13830","45148","2014",23,23,0,127139,1735.087,82.69565
"13831","45149","2014",5,5,0,107000,1554.8,85.6
"13832","45151","2014",1,1,0,130000,1548,84
"13833","45152","2014",1,1,0,120000,1667,72
"13834","45153","2014",7,7,0,144971.4,1537.286,98
"13835","45154","2014",21,21,0,184909.5,1797.714,103.8571
"13836","45155","2014",113,83,30,110908.6,1350.752,88.52212
"13837","45156","2014",3,3,0,110266.7,1183.333,93.66667
"13838","45157","2014",6,6,0,111950,1072.333,103.6667
"13839","45158","2014",3,3,0,114616.7,1500,84
"13840","45159","2014",1,1,0,295000,1756,168
"13841","45160","2014",6,6,0,87345,1177,74.16667
"13842","45161","2014",5,5,0,143442,1368.8,105.8
"13843","45162","2014",8,8,0,166671.2,1482.5,116.875
"13844","45164","2014",7,7,0,140242.9,1401.714,102.5714
"13845","45165","2014",6,6,0,83543.17,1127.5,73.33333
"13846","45166","2014",1,1,0,294435,1840,160
"13847","45167","2014",16,16,0,208477.4,1893.062,114.875
"13848","45168","2014",8,8,0,133125,1645.5,86.75
"13849","45169","2014",64,57,7,188835.5,2092.859,93.10938
"13850","45171","2014",6,6,0,108416.7,1623.333,74.16667
"13851","45173","2014",53,45,8,158487.5,1786.925,93.98113
"13852","45174","2014",2,2,0,70300,1153,50
"13853","45175","2014",10,10,0,195482.2,1876.3,113.2
"13854","45176","2014",8,8,0,121250,1426.75,88
"13855","45177","2014",1,1,0,152000,1490,102
"13856","45178","2014",10,10,0,115170,1238.1,97.3
"13857","45179","2014",17,17,0,157858.2,1467.118,111.1765
"13858","45182","2014",14,14,0,170965,1513.857,107.0714
"13859","45183","2014",1,1,0,149426,1215,123
"13860","45184","2014",6,6,0,151083.3,1607.333,92.66667
"13861","45185","2014",1,1,0,70000,795,88
"13862","45186","2014",3,3,0,103000,1072,105.3333
"13863","45187","2014",38,38,0,145033.4,1379.842,107.6053
"13864","45188","2014",12,12,0,145135.8,1542,92.25
"13865","45189","2014",3,3,0,141666.7,1712,89.33333
"13866","45191","2014",81,60,21,144398.4,1732.617,85.50617
"13867","45193","2014",17,17,0,178426.4,1739.941,107.1765
"13868","45194","2014",22,20,2,171873.4,1855.864,94.31818
"13869","45195","2014",3,3,0,145000,1539,100.3333
"13870","45196","2014",4,4,0,165500,2108.5,78.25
"13871","45197","2014",4,4,0,180750,1608,116.25
"13872","45198","2014",2,2,0,142500,1041.5,140
"13873","45199","2014",6,6,0,97333.33,1218.333,85.16667
"13874","45200","2014",19,19,0,225204.6,1951.211,120.2632
"13875","45201","2014",2,2,0,119500,1249.5,104.5
"13876","45202","2014",7,6,1,171392.9,1594.143,107
"13877","45203","2014",45,38,7,138798.1,1685.6,84.08889
"13878","45204","2014",5,5,0,220052,1900.6,120.6
"13879","45205","2014",5,5,0,125220,1243.6,100.2
"13880","45206","2014",1,1,0,64000,865,74
"13881","45207","2014",2,2,0,133500,1428,93.5
"13882","45208","2014",149,51,98,91078.75,1500.134,64.09396
"13883","45209","2014",3,3,0,108000,1445,78.33333
"13884","45210","2014",7,7,0,102071.4,1391.286,74.71429
"13885","45212","2014",14,14,0,119250,1398.214,90.5
"13886","45213","2014",7,7,0,128137.9,1396.429,104.5714
"13887","45214","2014",2,2,0,136000,2194,62
"13888","45215","2014",3,3,0,103363.7,1262.333,83
"13889","45216","2014",2,2,0,113500,1197.5,94
"13890","45217","2014",1,1,0,185000,1779,104
"13891","45218","2014",1,1,0,157000,1180,133
"13892","45219","2014",1,1,0,156000,957,163
"13893","45220","2014",7,6,1,123357.1,1483.143,84.42857
"13894","45222","2014",16,16,0,139759.8,1544.188,95
"13895","45223","2014",3,3,0,137500,1352.333,103.6667
"13896","45224","2014",35,29,6,164000,1617.657,103.2857
"13897","45225","2014",3,3,0,150666.7,1386.667,119.6667
"13898","45226","2014",8,8,0,149115,1642,90.25
"13899","45227","2014",11,11,0,172763.6,1441.727,129
"13900","45228","2014",8,8,0,127000,1552,97
"13901","45229","2014",33,33,0,123872.7,1299.515,94.9697
"13902","45230","2014",9,9,0,123577.8,1228.444,100
"13903","45231","2014",1,1,0,1e+05,1667,60
"13904","45232","2014",243,123,120,170859.5,2140.51,80.06996
"13905","45234","2014",1358,328,1030,141613.3,2057.723,70.15022
"13906","45235","2014",16,16,0,194557.5,1894.625,106.3125
"13907","45237","2014",1,1,0,175000,1804,97
"13908","45238","2014",7,6,1,153142.9,1742.857,89.57143
"13909","45239","2014",6,6,0,143866.7,1586.5,105
"13910","45240","2014",12,12,0,104308.3,1285.917,83.75
"13911","45241","2014",4,4,0,196000,1725.5,119.5
"13912","45242","2014",1,0,1,237000,11286,21
"13913","45243","2014",3,3,0,146000,1423.333,102.6667
"13914","45244","2014",20,20,0,151374.8,1521,102.1
"13915","45245","2014",6,6,0,83718.33,1169.333,70.33333
"13916","45247","2014",26,26,0,127903.8,1428.115,89.57692
"13917","45248","2014",16,15,1,127859.4,1281.812,108.125
"13918","45249","2014",5,5,0,155940,1432.2,114.4
"13919","45250","2014",5,5,0,151500,1304.8,112.2
"13920","45251","2014",3,3,0,94133.33,1018.333,92.33333
"13921","45252","2014",63,42,21,119598.8,1580.444,80.36508
"13922","45253","2014",8,8,0,145537.5,1647.5,93.875
"13923","45254","2014",21,20,1,145888.2,1493.286,96.95238
"13924","45255","2014",3,3,0,246783.3,1605.667,163.3333
"13925","45256","2014",1,1,0,45000,506,89
"13926","45257","2014",3,3,0,81000,1095.333,70.66667
"13927","45258","2014",30,25,5,131883.3,1574.533,88.7
"13928","45259","2014",12,12,0,105437.5,1311.667,82.83333
"13929","45260","2014",1,1,0,74036,565,131
"13930","45261","2014",10,10,0,187745,1693.6,112.9
"13931","45262","2014",2,2,0,106000,1403.5,73
"13932","45263","2014",6,6,0,210630,2108.167,99.33333
"13933","45264","2014",1,1,0,220000,1528,144
"13934","45265","2014",5,5,0,115600,1084.4,126
"13935","45266","2014",2,2,0,159000,1341.5,128.5
"13936","45268","2014",3,3,0,102666.7,1194,86
"13937","45269","2014",28,28,0,190079.6,1865.5,102.0714
"13938","45270","2014",20,19,1,139970.5,1713.4,83.65
"13939","45271","2014",13,13,0,126149.6,1279.308,96.84615
"13940","45272","2014",21,20,1,263765.5,2214.381,125.1905
"13941","45273","2014",19,19,0,192745.5,1931.579,103.1053
"13942","45274","2014",39,38,1,218079.1,1998.949,111.8462
"13943","45275","2014",4,4,0,126250,1387,93.75
"13944","45276","2014",3,3,0,410000,1815.667,175.3333
"13945","45277","2014",8,8,0,106800,1529.25,70.375
"13946","45278","2014",13,13,0,113615.4,1097.154,98.38462
"13947","45279","2014",23,23,0,107448.9,1409.826,81.73913
"13948","45280","2014",12,12,0,118676.7,1302.083,93.08333
"13949","45281","2014",15,15,0,97533.33,1254.667,80.46667
"13950","45282","2014",30,21,9,179248.6,1869.7,95.46667
"13951","45283","2014",1,1,0,155000,1632,95
"13952","45284","2014",213,111,102,150807.4,1877.315,80.60094
"13953","45285","2014",122,73,49,137833.8,1780.992,77.42623
"13954","45286","2014",102,50,52,176774.7,2081.549,86.2549
"13955","45288","2014",4,4,0,148750,1033.5,144.5
"13956","45289","2014",6,6,0,145346.8,1374.5,106.1667
"13957","45290","2014",10,10,0,164355,1509.5,111.5
"13958","45291","2014",11,11,0,118409.1,1450,83.63636
"13959","45292","2014",4,4,0,101750,978,101.5
"13960","45293","2014",6,6,0,133885.2,1295,92
"13961","45296","2014",8,8,0,164500,1628.375,99.25
"13962","45297","2014",8,8,0,138350,1376,105.25
"13963","45298","2014",57,46,11,177374.4,1903.491,94.4386
"13964","45299","2014",1,1,0,151500,1702,89
"13965","45300","2014",1,1,0,330000,1100,300
"13966","45301","2014",3,3,0,102666.7,2062.333,44.66667
"13967","45302","2014",113,86,27,161176.8,1906.31,86.70796
"13968","45303","2014",8,8,0,145250,1369,105.375
"13969","45305","2014",3,3,0,118400,1275,94
"13970","45306","2014",8,8,0,92556.25,1215.375,79.375
"13971","45307","2014",13,13,0,155588.5,1351.462,114.3846
"13972","45308","2014",14,14,0,201967.9,2152.857,97.57143
"13973","45309","2014",3,3,0,118185,819.6667,144.6667
"13974","45310","2014",14,14,0,164155.4,1807.714,92.92857
"13975","45311","2014",4,4,0,143152.5,1681,85
"13976","45312","2014",5,5,0,107240,1134.4,94
"13977","45313","2014",5,5,0,124125.6,1369,94.6
"13978","45314","2014",4,4,0,174750,1365.75,127.5
"13979","45315","2014",33,31,2,114118.6,1411.97,82.93939
"13980","45316","2014",7,7,0,114857.1,1656.143,77.28571
"13981","45317","2014",17,17,0,220474.1,1794.294,119.5294
"13982","45320","2014",3,3,0,207666.7,1391,150.6667
"13983","45321","2014",2,2,0,232300,1553,141.5
"13984","45322","2014",2,2,0,107500,1259.5,87
"13985","45323","2014",3,3,0,76766.67,1007.667,77
"13986","45324","2014",5,5,0,168000,1684.4,103.2
"13987","45325","2014",4,4,0,164112.5,1584.5,101.25
"13988","45326","2014",7,7,0,102642.9,1152.714,87
"13989","45327","2014",22,22,0,188449.2,1539.273,128.1364
"13990","45328","2014",2,2,0,176000,1887,95
"13991","45329","2014",13,13,0,109715.4,1390.308,72.69231
"13992","45330","2014",2,2,0,172500,1609.5,120
"13993","45331","2014",6,6,0,272666.7,2113.167,112.6667
"13994","45332","2014",19,18,1,131221.1,1330.947,98.26316
"13995","45333","2014",15,14,1,159690,1775.733,88.26667
"13996","45334","2014",6,6,0,171083.3,935.5,178.1667
"13997","45335","2014",17,17,0,184364.7,1683.765,116.7647
"13998","45336","2014",5,5,0,152400,1819.6,84.6
"13999","45337","2014",3,3,0,107333.3,1380,79
"14000","45338","2014",69,67,2,140488,1652.232,92.08696
"14001","45339","2014",5,5,0,103600,1295.4,80.4
"14002","45340","2014",4,4,0,135100,1512.5,86.75
"14003","45341","2014",2,2,0,144500,1486.5,113
"14004","45342","2014",6,6,0,111500,1529.667,76.33333
"14005","45343","2014",4,4,0,136750,1222.25,125.75
"14006","45344","2014",9,9,0,155311.1,1459,108.4444
"14007","45345","2014",10,10,0,110500,1333.6,85.4
"14008","45346","2014",11,11,0,169845.5,1525.545,112.7273
"14009","45347","2014",4,4,0,189493.8,1681.25,132
"14010","45348","2014",1,1,0,55900,621,90
"14011","46001","2014",4,4,0,150000,1253.5,126.25
"14012","46003","2014",3,3,0,97166.67,1272,77.66667
"14013","46004","2014",1,1,0,145000,4143,35
"14014","46005","2014",6,6,0,99166.67,1249,81.16667
"14015","46006","2014",5,5,0,166980,2036,94.4
"14016","46007","2014",8,8,0,151635,1460.625,102.75
"14017","46009","2014",2,2,0,109000,1161.5,96
"14018","46010","2014",2,2,0,248225,1413.5,192
"14019","46011","2014",4,4,0,162865,1821.5,88.25
"14020","46012","2014",6,6,0,73875,901.5,86.66667
"14021","46013","2014",2,2,0,78000,1358,59.5
"14022","46015","2014",12,11,1,117983.3,1160.583,111.4167
"14023","46016","2014",3,3,0,243833.3,2338.667,106.6667
"14024","46017","2014",2,2,0,150000,1809.5,85
"14025","46020","2014",1,1,0,1e+05,1667,60
"14026","46021","2014",3,3,0,109833.3,1213.667,84.33333
"14027","46022","2014",2,2,0,218500,2735.5,100.5
"14028","46023","2014",2,2,0,117850,1176.5,94.5
"14029","46024","2014",4,4,0,109932.5,1330.25,78.5
"14030","46028","2014",7,7,0,93500,1540.571,68.85714
"14031","46029","2014",17,16,1,115930.6,1430.706,84.58824
"14032","46030","2014",2,2,0,85000,1082.5,80.5
"14033","46032","2014",1,1,0,179000,1845,97
"14034","46033","2014",2,2,0,133500,1308,105
"14035","46034","2014",1,1,0,250000,1667,150
"14036","46035","2014",1,1,0,140000,1750,80
"14037","46036","2014",2,2,0,131000,2233,67
"14038","46037","2014",2,2,0,115000,1343,85
"14039","46038","2014",7,6,1,101857.1,1403.714,80.57143
"14040","46040","2014",3,3,0,103466.7,1315,77.66667
"14041","46041","2014",1,1,0,80000,690,116
"14042","46042","2014",212,97,115,110416.1,1513.863,75.65094
"14043","46044","2014",4,4,0,109250,1160.75,92.5
"14044","46045","2014",18,17,1,135711.1,1444.167,96.27778
"14045","46046","2014",3,3,0,135133.3,1349.333,98.66667
"14046","46047","2014",1,1,0,170000,1118,152
"14047","46053","2014",7,7,0,184273.7,2009.571,96.71429
"14048","46054","2014",2,2,0,252500,2789,90
"14049","46055","2014",6,6,0,126336.7,1266,92.83333
"14050","46056","2014",1,1,0,142000,2448,58
"14051","46057","2014",5,5,0,161300,1690,97.4
"14052","46058","2014",6,6,0,107166.7,1660.167,77.16667
"14053","46059","2014",2,2,0,71500,921,111
"14054","46060","2014",4,4,0,118850,1290.75,91.5
"14055","46061","2014",2,2,0,127200,1598.5,87.5
"14056","46062","2014",3,3,0,116666.7,1706.333,73.33333
"14057","46063","2014",24,24,0,159375.8,1395.875,107.7917
"14058","46064","2014",9,8,1,100111.1,1099.444,93.44444
"14059","46065","2014",6,6,0,63341.33,852.8333,76.16667
"14060","46066","2014",4,4,0,138250,1522,89.75
"14061","46068","2014",2,2,0,170000,874.5,210
"14062","46069","2014",5,5,0,279929,2234,116.4
"14063","46070","2014",4,4,0,129562.5,1213.75,104.75
"14064","46072","2014",3,3,0,153950,1996.667,90.33333
"14065","46073","2014",5,5,0,85500,1031.6,78
"14066","46074","2014",4,4,0,158487.8,1648.5,105
"14067","46075","2014",2,2,0,112500,1251.5,79.5
"14068","46076","2014",3,3,0,163616.7,1781,88
"14069","46078","2014",4,4,0,112875,1818.75,72
"14070","46079","2014",1,1,0,170000,2361,72
"14071","46080","2014",2,2,0,195500,1785,110
"14072","46081","2014",1,1,0,320000,3333,96
"14073","46082","2014",4,4,0,146982.5,1398.5,106.25
"14074","46083","2014",6,5,1,107500,1190,89.83333
"14075","46084","2014",2,2,0,175500,2050.5,85.5
"14076","46086","2014",2,2,0,214800,1497,141.5
"14077","46087","2014",8,8,0,96694.38,1290.125,73.875
"14078","46088","2014",2,2,0,106000,1379,103
"14079","46089","2014",9,9,0,122212.2,1380.667,89.55556
"14080","46090","2014",2,2,0,145850,1342,141.5
"14081","46091","2014",1,1,0,144350,1604,90
"14082","46092","2014",1,1,0,154000,1363,113
"14083","46093","2014",1,1,0,65000,1121,58
"14084","46094","2014",3,3,0,299200,1983,131.6667
"14085","46095","2014",5,5,0,120380,1405.4,85.8
"14086","46097","2014",1,1,0,42000,560,75
"14087","46098","2014",2,2,0,172921,1496.5,109
"14088","46100","2014",5,5,0,103200,1019.6,100.2
"14089","46101","2014",2,2,0,117500,1132.5,103.5
"14090","46102","2014",99,52,47,110777.3,1411.687,83.06061
"14091","46103","2014",5,5,0,194790,1571.2,125.2
"14092","46104","2014",3,3,0,83666.67,1701,46.66667
"14093","46105","2014",3,3,0,147583.3,858,165.3333
"14094","46106","2014",3,3,0,62333.33,1412.667,44.33333
"14095","46107","2014",1,1,0,88000,2200,40
"14096","46108","2014",5,5,0,101000,1281.4,77
"14097","46109","2014",5,5,0,126500,1468,87.2
"14098","46112","2014",4,4,0,235650,1627.5,156.5
"14099","46113","2014",6,6,0,97666.67,830,118
"14100","46114","2014",4,4,0,120075,1483.25,95.25
"14101","46117","2014",4,4,0,63625,1263.5,53.25
"14102","46118","2014",5,5,0,174700,1512,109.8
"14103","46120","2014",3,3,0,220183.3,1468,151.6667
"14104","46121","2014",1,1,0,3e+05,2000,150
"14105","46122","2014",1,1,0,112500,2557,44
"14106","46124","2014",3,3,0,114228.3,1271.667,104
"14107","46125","2014",1,1,0,40000,667,60
"14108","46126","2014",1,1,0,350000,3125,112
"14109","46127","2014",30,26,4,144879.3,1500.767,93.93333
"14110","46128","2014",23,18,5,100220.7,1295.435,79.78261
"14111","46130","2014",5,5,0,157000,1378,117.6
"14112","46131","2014",3,3,0,171423.3,1647,99
"14113","46132","2014",3,3,0,107000,1488.333,84.66667
"14114","46133","2014",1,1,0,105000,1667,63
"14115","46134","2014",5,4,1,175680,1591.6,112.4
"14116","46135","2014",1,1,0,50000,877,57
"14117","46136","2014",4,4,0,115250,1278.25,93
"14118","46137","2014",7,7,0,192985.7,1411.571,140.2857
"14119","46138","2014",8,8,0,128533.5,1166.625,122
"14120","46139","2014",1,1,0,215000,1792,120
"14121","46143","2014",6,6,0,109500,1622.833,71
"14122","46144","2014",1,1,0,360000,2927,123
"14123","46145","2014",14,14,0,137203.9,1216.429,104.3571
"14124","46147","2014",1,1,0,150000,1000,150
"14125","46148","2014",13,13,0,142018.8,1242,117.6154
"14126","46149","2014",4,4,0,138750,1251.75,112.5
"14127","46151","2014",1,1,0,18000,450,40
"14128","46152","2014",6,6,0,152536.7,1370.333,101.3333
"14129","46153","2014",6,6,0,111683.3,1173.333,94.5
"14130","46154","2014",5,5,0,105440,1299.4,83.6
"14131","46155","2014",1,1,0,95000,979,97
"14132","46156","2014",8,8,0,138500,1487,97.875
"14133","46160","2014",2,2,0,112750,771.5,145
"14134","46161","2014",2,2,0,97500,991.5,100
"14135","46162","2014",1,1,0,56000,523,107
"14136","46163","2014",2,2,0,316500,4073.5,64
"14137","46165","2014",4,4,0,181250,1693.25,104.75
"14138","46167","2014",1,1,0,280000,1359,206
"14139","46169","2014",1,1,0,273500,1417,193
"14140","46170","2014",4,4,0,107000,1289.75,84
"14141","46171","2014",1,1,0,155000,2153,72
"14142","46172","2014",7,7,0,172385.7,1582.429,112.4286
"14143","46173","2014",7,6,1,128214.3,1811.571,74.28571
"14144","46174","2014",2,2,0,84500,939,93
"14145","46175","2014",4,4,0,155875,982.5,166.5
"14146","46176","2014",6,6,0,150083.3,1274.667,117
"14147","46177","2014",3,3,0,130816.7,1712,94
"14148","46178","2014",1,1,0,58000,744,78
"14149","46179","2014",2,2,0,93500,1910,49
"14150","46180","2014",3,3,0,183000,2088,82.66667
"14151","46181","2014",3,3,0,126333.3,1287.333,96.33333
"14152","46182","2014",13,13,0,111781.2,1152.615,101.6923
"14153","46183","2014",4,4,0,152675,1843.5,97
"14154","46184","2014",4,4,0,173875,2129.25,113
"14155","46185","2014",14,13,1,132514.3,1629.857,84.64286
"14156","46186","2014",1,1,0,141000,1175,120
"14157","46187","2014",7,6,1,125142.9,1822.571,83
"14158","46188","2014",3,3,0,194316.7,1511.667,130
"14159","46189","2014",3,3,0,77100,1035.667,71.33333
"14160","46190","2014",2,2,0,166500,1573,94
"14161","46191","2014",7,7,0,124192.6,1342.143,94.42857
"14162","46192","2014",3,3,0,109000,960.6667,111.3333
"14163","46193","2014",2,2,0,61500,1138.5,54
"14164","46194","2014",3,3,0,182163.3,2869.667,79
"14165","46195","2014",1,1,0,80000,2222,36
"14166","46197","2014",4,4,0,145875,1476.5,100.75
"14167","46198","2014",2,2,0,96192,3272,31
"14168","46199","2014",5,5,0,220155,2889,79.2
"14169","46200","2014",3,3,0,82086,1054,88.66667
"14170","46201","2014",23,21,2,150147.8,1433.957,106.0435
"14171","46202","2014",3,3,0,139803.7,1527.333,90.33333
"14172","46204","2014",3,3,0,140000,1869.333,111
"14173","46205","2014",6,6,0,156196.7,1735.333,95
"14174","46206","2014",1,1,0,165000,868,190
"14175","46207","2014",1,1,0,179650,1283,140
"14176","46208","2014",4,4,0,102247.8,1822.5,75.5
"14177","46211","2014",3,3,0,151373.3,1616.667,93.33333
"14178","46212","2014",2,2,0,94500,1426.5,66
"14179","46213","2014",2,2,0,219056.5,2216.5,104.5
"14180","46214","2014",5,5,0,202600,1607,126
"14181","46215","2014",8,8,0,109093.8,1162,88
"14182","46216","2014",3,3,0,188333.3,1556.667,119
"14183","46217","2014",1,1,0,194750,1948,100
"14184","46218","2014",2,2,0,155480,1281,121.5
"14185","46219","2014",2,2,0,121500,1299.5,94
"14186","46220","2014",6,6,0,176341.7,1563.833,113
"14187","46221","2014",5,5,0,163544.6,1479.8,113.4
"14188","46222","2014",4,4,0,163387.5,1510.5,112
"14189","46223","2014",1,1,0,210000,2917,72
"14190","46224","2014",20,18,2,137239,1515.25,90.85
"14191","46225","2014",24,24,0,162441.7,1594.042,103.1667
"14192","46226","2014",3,3,0,106376.7,704.6667,120.6667
"14193","46227","2014",1,1,0,110000,1833,60
"14194","46228","2014",4,4,0,188492,1683.5,104.5
"14195","46229","2014",11,11,0,149400,1674.364,85.27273
"14196","46230","2014",1,1,0,232250,1425,163
"14197","46231","2014",21,21,0,122341,1450.524,91.2381
"14198","46232","2014",2,2,0,129350,1058,129
"14199","46233","2014",3,3,0,107716.7,1498.667,67
"14200","46235","2014",3,3,0,82333.33,1271,60.33333
"14201","46236","2014",3,3,0,167900,1319,120
"14202","46237","2014",5,5,0,196540,1758.4,109.8
"14203","46238","2014",2,2,0,102500,1247,83.5
"14204","46239","2014",2,2,0,70000,853,85.5
"14205","46240","2014",10,9,1,142520,2669.5,79.9
"14206","46241","2014",3,3,0,77200,697.3333,116.3333
"14207","46242","2014",2,2,0,81250,1317.5,64.5
"14208","46243","2014",2,2,0,54000,486,111
"14209","46251","2014",28,26,2,106418.4,1193.857,88.60714
"14210","46252","2014",1,1,0,123000,1922,64
"14211","46253","2014",2,1,1,456000,3129.5,145.5
"14212","46255","2014",4,4,0,68000,717.75,97.25
"14213","46256","2014",3,2,1,262200,5850.333,56.33333
"14214","46257","2014",1,1,0,156000,1576,99
"14215","46258","2014",1,1,0,178100,1220,146
"14216","46259","2014",1,1,0,175000,1101,159
"14217","46260","2014",2,2,0,115000,1090.5,130
"14218","46262","2014",5,5,0,180720,1483.8,123.6
"14219","46264","2014",2,2,0,131500,1687,82.5
"14220","46265","2014",7,5,2,95571.43,924.8571,100.1429
"14221","46266","2014",4,4,0,141750,1358,103.75
"14222","46267","2014",6,6,0,79125,857.8333,93.83333
"14223","46268","2014",9,9,0,138978.9,1639.556,98.66667
"14224","46270","2014",3,3,0,129166.7,1371,97.33333
"14225","46271","2014",3,3,0,165000,1576.667,99.33333
"14226","46272","2014",2,2,0,174725,2015.5,86
"14227","46273","2014",8,8,0,148312.5,1571.375,97.875
"14228","46276","2014",4,4,0,131000,1337.75,90
"14229","46277","2014",2,2,0,305750,2068,158
"14230","46279","2014",2,2,0,52500,737.5,75.5
"14231","46281","2014",1,1,0,112000,2196,51
"14232","46283","2014",4,4,0,118750,1261.25,94
"14233","46284","2014",2,2,0,159900,1666.5,96
"14234","46286","2014",1,1,0,75000,1667,45
"14235","46288","2014",1,1,0,120000,1091,110
"14236","46290","2014",2,2,0,145600,1180,125
"14237","46293","2014",5,5,0,94100,1059,85.8
"14238","46296","2014",4,4,0,240450,1654,144.75
"14239","46297","2014",14,14,0,121917.9,1284.714,96.92857
"14240","46299","2014",3,3,0,177500,2007.333,90.66667
"14241","46301","2014",5,5,0,120310,1498.4,89.8
"14242","46304","2014",1,1,0,125000,3125,40
"14243","46305","2014",2,2,0,205500,2014,100
"14244","46307","2014",2,2,0,132250,1093,123
"14245","46309","2014",39,28,11,95471.87,1290.949,80.87179
"14246","46311","2014",12,12,0,100255,1117.417,94.33333
"14247","46312","2014",7,5,2,143642.9,1450.857,100.7143
"14248","46313","2014",7,7,0,124300,1631.857,80.14286
"14249","46314","2014",2,2,0,141103,1882,74
"14250","46316","2014",2,2,0,200575,1484.5,137
"14251","46317","2014",7,7,0,108571.4,1293.857,85
"14252","46319","2014",1,1,0,105000,477,220
"14253","46320","2014",2,2,0,146000,1418.5,115.5
"14254","46321","2014",4,4,0,79180,1262.5,61.25
"14255","46322","2014",2,2,0,153750,2100.5,83.5
"14256","46323","2014",1,1,0,82500,1179,70
"14257","46324","2014",2,2,0,90000,1550,55
"14258","46328","2014",2,2,0,116850,1119,105
"14259","46329","2014",1,1,0,168000,1888,89
"14260","46330","2014",12,12,0,118625,1312.417,93.41667
"14261","46332","2014",3,3,0,90177.67,913.6667,93.33333
"14262","46334","2014",18,18,0,154213.1,1601.056,98.11111
"14263","46335","2014",2,2,0,203110,1400,145
"14264","46337","2014",3,3,0,110166.7,1644,70
"14265","47001","2014",458,164,294,90810.96,1283.681,72.48908
"14266","47002","2014",1,1,0,159000,1445,110
"14267","47003","2014",2,2,0,149439,1252.5,120
"14268","47004","2014",37,36,1,129383.8,1115.297,121.4054
"14269","47005","2014",4,3,1,160502.5,1251.75,124.5
"14270","47006","2014",5,5,0,135072,1226.8,105.8
"14271","47009","2014",1,1,0,156000,987,158
"14272","47011","2014",5,5,0,216610,1676.2,134.8
"14273","47012","2014",2,2,0,242750,2092,122.5
"14274","47013","2014",6,6,0,118166.7,1230.5,105.6667
"14275","47014","2014",2,2,0,126500,1140,110
"14276","47015","2014",1,1,0,510000,3923,130
"14277","47016","2014",12,12,0,155395.8,1432.75,110
"14278","47017","2014",2,2,0,179800,1536,117.5
"14279","47018","2014",2,2,0,107500,1157,99.5
"14280","47019","2014",9,9,0,147211.1,1244.444,122.7778
"14281","47020","2014",1,1,0,120000,1176,102
"14282","47021","2014",22,22,0,137756,1426.545,98.63636
"14283","47022","2014",5,5,0,139640,1191.2,123
"14284","47023","2014",1,1,0,492500,4104,120
"14285","47024","2014",17,17,0,188074.3,1662.647,116.1765
"14286","47025","2014",8,8,0,136350,1551.75,102.75
"14287","47026","2014",2,2,0,157750,1119,152
"14288","47027","2014",35,35,0,141511.5,1410.971,100.5714
"14289","47028","2014",4,4,0,168275,1107.75,146.75
"14290","47029","2014",3,3,0,95000,1424,66.33333
"14291","47030","2014",2,2,0,161000,1401,115
"14292","47031","2014",49,47,2,173561.9,1632.082,102.9184
"14293","47032","2014",54,51,3,151301,1579.593,95.48148
"14294","47033","2014",3,3,0,106666.7,899.3333,119.3333
"14295","47034","2014",2,2,0,116500,1142,102
"14296","47035","2014",5,5,0,191000,1315.6,158.8
"14297","47036","2014",4,4,0,131320.5,1509.5,77.75
"14298","47037","2014",3,3,0,155000,948.3333,145.3333
"14299","47038","2014",1,1,0,125000,1330,94
"14300","47040","2014",13,13,0,223283.5,2151.615,108.9231
"14301","47041","2014",3,3,0,101666.7,1016,101
"14302","47042","2014",2,2,0,60000,671,94.5
"14303","47043","2014",12,12,0,329258.3,2856.833,108.3333
"14304","47044","2014",4,4,0,131250,1423,105
"14305","47045","2014",4,4,0,159911,1102.25,157.75
"14306","47046","2014",8,8,0,131675,1292,106
"14307","47047","2014",1,1,0,397500,2149,185
"14308","47048","2014",13,13,0,134576.9,1231.692,111.6923
"14309","47049","2014",18,17,1,103167.8,1010.722,101.0556
"14310","47051","2014",25,22,3,159137.2,1723.04,92.72
"14311","47052","2014",55,52,3,134524.1,1419.818,96.4
"14312","47053","2014",4,4,0,95125,1202,75.75
"14313","47054","2014",18,18,0,119270,1223.056,101.1111
"14314","47055","2014",7,4,3,80070.29,1601.857,66.42857
"14315","47056","2014",3,3,0,302000,2024.667,145.6667
"14316","47057","2014",10,10,0,87140,1051.4,89
"14317","47058","2014",1,1,0,70000,1273,55
"14318","47059","2014",1,1,0,50000,495,101
"14319","47060","2014",6,6,0,129166.7,1351.5,91
"14320","47061","2014",3,3,0,174333.3,1198.667,141.3333
"14321","47062","2014",2,2,0,138500,1347.5,102.5
"14322","47063","2014",1,1,0,266000,1900,140
"14323","47064","2014",2,2,0,94000,1046,90
"14324","47065","2014",35,33,2,94305.77,1060.629,100.1143
"14325","47066","2014",8,8,0,85250,968.75,108.625
"14326","47067","2014",2,2,0,77850,673,126
"14327","47068","2014",7,7,0,289000,2099.143,110.4286
"14328","47069","2014",28,24,4,126905.9,1259.571,105.8214
"14329","47070","2014",11,11,0,115588.2,1426.545,83
"14330","47071","2014",1,1,0,280000,1818,154
"14331","47072","2014",1,1,0,325000,1491,218
"14332","47074","2014",5,5,0,66200,749,87.4
"14333","47075","2014",5,5,0,152950,1477.8,103.6
"14334","47077","2014",6,6,0,122100,964,120.1667
"14335","47078","2014",13,12,1,98207.69,1007.308,99.53846
"14336","47079","2014",4,4,0,114000,966,137.5
"14337","47080","2014",1,1,0,227500,2741,83
"14338","47081","2014",9,9,0,180247.9,1609.889,114.8889
"14339","47082","2014",5,5,0,193250,1460.4,143.6
"14340","47083","2014",3,3,0,211666.7,3301,100.6667
"14341","47084","2014",5,5,0,151520,1288.2,117.6
"14342","47086","2014",9,9,0,141777.8,1535,95
"14343","47087","2014",1,1,0,149050,648,230
"14344","47088","2014",8,7,1,77300,927.75,87.25
"14345","47089","2014",3,3,0,195333.3,1167.667,164.3333
"14346","47091","2014",11,10,1,177724.1,1861,94.63636
"14347","47092","2014",1,1,0,175000,1842,95
"14348","47093","2014",3,3,0,168600,2442,98.33333
"14349","47094","2014",4,4,0,111462.5,1266.5,89.5
"14350","47095","2014",9,9,0,116430.8,1071.333,109.8889
"14351","47096","2014",4,4,0,160000,1447,112
"14352","47097","2014",4,4,0,163375,1037.5,162.5
"14353","47098","2014",1,1,0,48000,640,75
"14354","47099","2014",10,10,0,129250,1075,118.8
"14355","47100","2014",49,43,6,164615.7,1686.469,99.28571
"14356","47101","2014",14,14,0,135851.4,1459.5,91.57143
"14357","47102","2014",4,4,0,62100,745.25,93.5
"14358","47103","2014",1,0,1,40000,1000,40
"14359","47104","2014",1,1,0,44000,440,100
"14360","47106","2014",41,37,4,92920.49,961.2439,95.63415
"14361","47107","2014",7,7,0,107900,1060.714,108.4286
"14362","47109","2014",3,3,0,148333.3,1896.333,69
"14363","47110","2014",9,9,0,120983.9,1119.333,114.6667
"14364","47111","2014",7,7,0,69928.57,814,81.28571
"14365","47112","2014",3,3,0,134666.7,1015.333,126.6667
"14366","47114","2014",1,1,0,212000,1631,130
"14367","47115","2014",3,3,0,165466.7,1432.333,123.3333
"14368","47117","2014",7,7,0,183000,1731,109.1429
"14369","47118","2014",2,2,0,177000,1649,106.5
"14370","47119","2014",6,6,0,89666.67,1378.333,72.83333
"14371","47120","2014",2,2,0,65000,826,81
"14372","47121","2014",2,2,0,160000,1694,84
"14373","47122","2014",1,1,0,3e+05,1500,200
"14374","47123","2014",4,4,0,188750,1669,108.25
"14375","47124","2014",2,2,0,229100,1767,128.5
"14376","47125","2014",3,3,0,254166.7,1142.333,209.3333
"14377","47126","2014",1,1,0,50000,625,80
"14378","47127","2014",5,5,0,136400,1221.8,113.4
"14379","47128","2014",12,10,2,115229.2,1352,86.5
"14380","47129","2014",3,3,0,231043,1485.333,157.3333
"14381","47130","2014",3,3,0,172833.3,1494.333,115
"14382","47131","2014",4,4,0,102500,979.75,104.5
"14383","47132","2014",1,1,0,70000,642,109
"14384","47133","2014",7,7,0,110100,1067.286,116.5714
"14385","47134","2014",1,1,0,45000,459,98
"14386","47135","2014",8,8,0,118168.8,1112,114.875
"14387","47137","2014",11,11,0,145127.3,1193,121.1818
"14388","47138","2014",9,9,0,92044.44,1054.222,86
"14389","47139","2014",2,2,0,227500,1849,125
"14390","47140","2014",6,6,0,175083.3,1432.167,125.5
"14391","47141","2014",2,2,0,170565,1263,134
"14392","47142","2014",10,10,0,123390,937,127.2
"14393","47143","2014",16,14,2,81168.75,851.0625,97.25
"14394","47144","2014",4,4,0,110375,1105,100
"14395","47145","2014",34,33,1,165726.5,1764.941,96.35294
"14396","47146","2014",9,9,0,123133.3,1360.444,90.88889
"14397","47147","2014",5,5,0,184800,1319.6,144.8
"14398","47148","2014",2,2,0,212500,1897,141.5
"14399","47150","2014",6,6,0,127916.7,1408.667,91.16667
"14400","47151","2014",8,8,0,156456.2,1519.625,106
"14401","47152","2014",4,4,0,133750,955.75,148.25
"14402","47154","2014",2,2,0,157000,1200.5,138
"14403","47155","2014",2,2,0,296380,1655.5,168.5
"14404","47156","2014",5,5,0,150800,1423,105.6
"14405","47157","2014",196,149,47,109293.8,1226.194,90.93878
"14406","47158","2014",1,1,0,153500,908,169
"14407","47159","2014",12,11,1,85366.67,909.4167,93.5
"14408","47160","2014",1,1,0,155100,2820,55
"14409","47161","2014",1,1,0,170000,1954,87
"14410","47163","2014",4,4,0,256080,1606.75,166.5
"14411","47164","2014",4,4,0,226300,1600.5,131
"14412","47165","2014",10,10,0,150005,1470.8,118.3
"14413","47167","2014",11,11,0,96272.73,1135.545,102.1818
"14414","47168","2014",28,28,0,83483.93,940.6429,92.53571
"14415","47169","2014",11,11,0,189271.8,1441.818,130.3636
"14416","47170","2014",5,5,0,113060,1255.8,102.8
"14417","47171","2014",2,2,0,93860.5,880.5,108
"14418","47172","2014",6,6,0,150826.7,1370.667,112
"14419","47173","2014",8,8,0,117337.5,1217.875,103.125
"14420","47174","2014",4,4,0,143437.5,1475.75,96.25
"14421","47175","2014",22,22,0,193311.2,1377.545,124.8636
"14422","47177","2014",2,2,0,185800,1476.5,130.5
"14423","47178","2014",2,2,0,222000,2395,87.5
"14424","47179","2014",23,22,1,98411.3,939.0435,105
"14425","47181","2014",4,4,0,207500,1762.25,114.5
"14426","47182","2014",5,5,0,136043.2,1276.6,110.8
"14427","47183","2014",4,4,0,208500,1524,138.75
"14428","47184","2014",1,1,0,309000,3253,95
"14429","47185","2014",35,35,0,87891.43,1187.6,76.14286
"14430","47186","2014",3,3,0,93333.33,942.6667,96
"14431","47187","2014",1,1,0,37500,403,93
"14432","47188","2014",3,3,0,171666.7,1425.667,133
"14433","47189","2014",1,1,0,450000,2601,173
"14434","47190","2014",7,7,0,159257.1,1367.857,119.2857
"14435","47191","2014",3,3,0,152275,1694,93.66667
"14436","47192","2014",1,1,0,70000,378,185
"14437","47193","2014",1,1,0,150000,1200,125
"14438","47194","2014",3,3,0,261650,1409,180
"14439","47195","2014",57,52,5,123816.1,1236.614,100.6842
"14440","47196","2014",3,3,0,103833.3,1049.667,90
"14441","47197","2014",2,2,0,120000,1040.5,114.5
"14442","47198","2014",4,4,0,172875,1847,96.25
"14443","47199","2014",4,4,0,167764.5,967.75,187.75
"14444","47200","2014",2,2,0,119873,1490,83.5
"14445","47201","2014",106,95,11,127404.7,1509.972,85.18868
"14446","47202","2014",3,3,0,302733.3,1916,163.3333
"14447","47203","2014",21,21,0,135838.1,1279,106.8095
"14448","47204","2014",4,4,0,163457.5,1304.75,126.5
"14449","47205","2014",1,1,0,130000,1605,81
"14450","47206","2014",3,3,0,118661.7,1059.667,113.3333
"14451","47207","2014",3,3,0,258666.7,1536,154.6667
"14452","47208","2014",1,1,0,147000,1564,94
"14453","47209","2014",37,37,0,138458.1,1522.054,92.45946
"14454","47210","2014",16,15,1,113143.8,1104.188,112.8125
"14455","47211","2014",3,3,0,203333.3,1508.333,120.6667
"14456","47212","2014",1,1,0,260000,5000,52
"14457","47213","2014",10,10,0,202040,1589.3,140
"14458","47214","2014",3,3,0,154182.3,997.6667,152
"14459","47215","2014",40,39,1,133315.9,1342.8,100.025
"14460","47216","2014",6,6,0,214218.3,2765.5,107.3333
"14461","47217","2014",9,9,0,147591.1,1425.333,98.22222
"14462","47219","2014",1,1,0,173000,2060,84
"14463","47220","2014",3,3,0,144666.7,1501,96.33333
"14464","47221","2014",5,5,0,136940,1448,87.4
"14465","47222","2014",3,3,0,137225,1522.333,90.33333
"14466","47224","2014",2,2,0,186372.5,1513.5,125
"14467","47225","2014",18,18,0,194821.6,1880.5,104.7222
"14468","47226","2014",4,4,0,99500,999.5,102.75
"14469","47227","2014",2,2,0,74200,646.5,124
"14470","47228","2014",5,5,0,184604,1787.8,103
"14471","47229","2014",1,1,0,320000,1029,311
"14472","47230","2014",2,2,0,226450,1970,115.5
"14473","47232","2014",10,10,0,135937,1213,115.9
"14474","47233","2014",22,21,1,120609.5,1153.682,109.3182
"14475","47234","2014",6,6,0,173241.2,1298.167,125.6667
"14476","47235","2014",3,3,0,86333.33,740.3333,120.3333
"14477","47236","2014",1,1,0,535000,2306,232
"14478","47237","2014",4,4,0,259384,1504.25,172.25
"14479","47238","2014",12,12,0,252653.8,2257.5,124.1667
"14480","47239","2014",7,7,0,169092.9,1433.714,118.7143
"14481","47240","2014",2,2,0,175000,1166.5,150
"14482","47241","2014",5,5,0,166000,1146.2,144.8
"14483","47242","2014",7,7,0,101142.9,835.2857,127.5714
"14484","47244","2014",3,3,0,125333.3,1183.667,109.6667
"14485","47245","2014",1,1,0,250000,1923,130
"14486","47246","2014",7,7,0,162011.4,1344.571,126
"14487","47247","2014",3,3,0,149666.7,2015,92.33333
"14488","47248","2014",7,7,0,170050,1661.429,102
"14489","47249","2014",8,8,0,84512.5,1054.375,90.375
"14490","47250","2014",1,1,0,131500,1565,84
"14491","47251","2014",1,1,0,95000,1727,55
"14492","47252","2014",64,63,1,119847.8,1385.406,91.20312
"14493","47253","2014",3,3,0,156333.3,1305.667,126.6667
"14494","47255","2014",3,3,0,203339,2470,84.33333
"14495","47256","2014",1,1,0,98000,1400,70
"14496","47257","2014",4,4,0,97855,860.25,108.5
"14497","47258","2014",3,3,0,147666.7,1433.667,109.3333
"14498","47259","2014",1,1,0,60000,441,136
"14499","47260","2014",7,7,0,130657.1,1181.286,108.8571
"14500","47262","2014",1,1,0,60000,522,115
"14501","47263","2014",6,6,0,127666.7,1147.667,122.1667
"14502","47264","2014",14,14,0,97813.93,1163.929,83.14286
"14503","47265","2014",3,3,0,167466.7,1581,104
"14504","47266","2014",3,3,0,113333.3,1304.667,84.66667
"14505","47267","2014",5,5,0,139700,1213.2,120.4
"14506","47269","2014",12,12,0,143027.1,1327.667,111.0833
"14507","47271","2014",1,1,0,90000,1125,80
"14508","47274","2014",2,2,0,155000,1544.5,97
"14509","47276","2014",3,3,0,332918.3,2129.333,145.6667
"14510","47277","2014",2,2,0,72000,676,93
"14511","47278","2014",8,8,0,151500,1322.625,118.625
"14512","47279","2014",6,6,0,120005,1361.167,87.33333
"14513","47280","2014",15,15,0,160236.7,1444.133,112.4
"14514","47281","2014",1,1,0,50700,492,103
"14515","47282","2014",2,2,0,254675,1378.5,191
"14516","47283","2014",8,8,0,106837.5,949.125,106.125
"14517","47284","2014",3,3,0,290000,2356,129.6667
"14518","47285","2014",6,6,0,114000,1301.5,95.5
"14519","47287","2014",1,1,0,163000,1273,128
"14520","47288","2014",4,4,0,179150,1282,138.25
"14521","47289","2014",4,4,0,170806.2,1967.25,86.25
"14522","47290","2014",2,2,0,86500,945.5,96.5
"14523","47291","2014",6,6,0,157366.7,1531.5,100.5
"14524","47292","2014",8,8,0,114687.5,1294.25,94
"14525","47293","2014",1,1,0,138000,1022,135
"14526","47294","2014",2,2,0,110000,806,131.5
"14527","47295","2014",1,1,0,188000,1106,170
"14528","47296","2014",1,1,0,87000,870,100
"14529","47297","2014",1,1,0,128000,1123,114
"14530","47298","2014",2,2,0,242500,1427,166
"14531","47299","2014",2,2,0,147500,1232,124
"14532","47300","2014",13,13,0,156608.7,1470.231,113.4615
"14533","47301","2014",12,12,0,95233.33,1301.833,77.58333
"14534","47302","2014",1,1,0,47000,435,108
"14535","47303","2014",3,3,0,120136.7,973.3333,116
"14536","47305","2014",2,2,0,111500,1037.5,128
"14537","47306","2014",5,5,0,194740,1285.4,182.6
"14538","47308","2014",3,3,0,97800,1143.667,87
"14539","47309","2014",7,7,0,99631.86,1006.143,98.14286
"14540","47310","2014",121,107,14,98822.83,1129.43,90.64463
"14541","47311","2014",1,1,0,69000,556,124
"14542","47312","2014",9,9,0,147180,1302.333,103.4444
"14543","47313","2014",1,1,0,211000,1407,150
"14544","47314","2014",3,3,0,230766.7,2197.333,102.3333
"14545","47315","2014",7,7,0,144964.3,1420.429,93.85714
"14546","47316","2014",6,6,0,109333.3,865.1667,133.8333
"14547","47317","2014",3,3,0,87000,938,94.66667
"14548","47318","2014",16,14,2,115637.5,1215.812,93.9375
"14549","47319","2014",1,1,0,159500,1100,145
"14550","47320","2014",6,6,0,80916.67,1036.167,80.5
"14551","47321","2014",1,1,0,170000,1133,150
"14552","47323","2014",236,202,34,109428.8,1212.352,90.69068
"14553","47324","2014",17,16,1,117029.4,1279.824,102.2353
"14554","47325","2014",10,10,0,126460,1090.2,118.5
"14555","47326","2014",6,6,0,178166.7,1356.667,141.3333
"14556","47327","2014",3,3,0,71925.67,902.3333,106.3333
"14557","47328","2014",4,4,0,122125,1285.5,96.5
"14558","48001","2014",3,3,0,156333.3,1467.333,104.6667
"14559","48003","2014",1,1,0,110000,1000,110
"14560","48004","2014",2,2,0,69875,1247,60
"14561","48005","2014",1,1,0,315000,1731,182
"14562","48007","2014",1,1,0,122000,1694,72
"14563","48009","2014",17,16,1,75250.18,1155.118,68.82353
"14564","48010","2014",3,3,0,134333.3,1595.667,90.66667
"14565","48012","2014",1,1,0,45000,662,68
"14566","48013","2014",5,5,0,162000,1687.6,92.6
"14567","48015","2014",2,2,0,62000,744.5,75
"14568","48016","2014",6,6,0,171837,1655,102.5
"14569","48017","2014",12,9,3,109911.4,1300.25,87
"14570","48018","2014",4,4,0,127025,1347.25,90.75
"14571","48019","2014",2,2,0,81000,1047.5,65.5
"14572","48021","2014",2,1,1,103075,1606.5,70
"14573","48025","2014",3,2,1,138533.3,1761.667,80.33333
"14574","48026","2014",1,1,0,72000,1029,70
"14575","48027","2014",17,15,2,83235.88,1276,69.64706
"14576","48030","2014",2,1,1,120500,2925,48
"14577","48031","2014",2,2,0,252000,2816,101
"14578","48032","2014",1,1,0,149000,1104,135
"14579","48034","2014",15,13,2,102373.3,1562.467,72.2
"14580","48036","2014",2,2,0,137500,1508.5,95
"14581","48037","2014",2,2,0,151500,1491.5,90.5
"14582","48039","2014",8,7,1,117688.8,1263.5,97
"14583","48042","2014",2,2,0,168000,2158,81
"14584","48043","2014",3,2,1,101666.7,1327,73.33333
"14585","48044","2014",1,1,0,102000,1159,88
"14586","48048","2014",1,1,0,113000,869,130
"14587","48051","2014",9,8,1,65111.11,1068.667,60.22222
"14588","48053","2014",2,2,0,96120,1138.5,80
"14589","48055","2014",1,1,0,80000,1667,48
"14590","48056","2014",1,1,0,168000,2400,70
"14591","48061","2014",16,13,3,126329.1,1260.25,101.5625
"14592","48064","2014",2,2,0,62500,902,86
"14593","48065","2014",2,2,0,73000,1092.5,65.5
"14594","48067","2014",2,2,0,186675,1469.5,122.5
"14595","48068","2014",1,1,0,61500,820,75
"14596","48070","2014",2,2,0,89000,1244.5,70.5
"14597","48071","2014",1,1,0,94000,1237,76
"14598","48073","2014",1,1,0,31000,689,45
"14599","48074","2014",3,3,0,135666.7,1604.333,83
"14600","48075","2014",4,4,0,69025,1137,58.75
"14601","48077","2014",1,1,0,110500,978,113
"14602","48080","2014",21,12,9,103329.5,1403.048,76.14286
"14603","48082","2014",2,2,0,89000,1165.5,74
"14604","48083","2014",2,2,0,64000,860.5,79.5
"14605","48085","2014",2,2,0,100850,1282.5,64.5
"14606","48086","2014",4,3,1,69250,1224.75,61
"14607","48087","2014",1,1,0,69997,1077,65
"14608","48088","2014",5,5,0,202888.6,2879,58.4
"14609","48089","2014",4,4,0,86640,1014,89
"14610","48090","2014",8,7,1,99000,1224,79.25
"14611","48092","2014",39,24,15,84216.67,1259.051,67.12821
"14612","48094","2014",9,9,0,133182.2,1687,79.77778
"14613","48095","2014",83,40,43,136044.8,1689.41,82.50602
"14614","48096","2014",3,3,0,57000,595,83.33333
"14615","48097","2014",1,1,0,154000,2567,60
"14616","48098","2014",1,1,0,139000,2780,50
"14617","48099","2014",12,12,0,142408.3,1464.083,95.33333
"14618","48103","2014",5,5,0,140268,1224.8,110.6
"14619","48104","2014",5,4,1,87200,1221.4,72.2
"14620","48105","2014",3,3,0,60555.67,757,80
"14621","48108","2014",2,2,0,44000,872,48
"14622","48110","2014",1,0,1,72000,1674,43
"14623","48111","2014",3,3,0,89133.33,937.6667,89.33333
"14624","48112","2014",7,6,1,75571.43,1204.857,63.14286
"14625","48115","2014",2,2,0,188500,3025,62.5
"14626","48116","2014",8,7,1,104481.2,1272.125,91
"14627","48117","2014",2,2,0,155000,1179,129.5
"14628","48119","2014",2,2,0,113500,1086,117.5
"14629","48121","2014",1,1,0,168000,923,182
"14630","48123","2014",1,1,0,54000,1200,45
"14631","48124","2014",1,1,0,115000,950,121
"14632","48127","2014",3,3,0,61333.33,920.3333,69.33333
"14633","48128","2014",4,4,0,164375,1505.25,113.75
"14634","48129","2014",3,3,0,53333.33,680,78.33333
"14635","48130","2014",1,1,0,110000,1222,90
"14636","48131","2014",2,2,0,111000,1578,72
"14637","48132","2014",7,6,1,72131.29,1216.714,65.28571
"14638","48135","2014",1,1,0,187000,1396,134
"14639","48136","2014",1,1,0,68455,713,96
"14640","48137","2014",3,3,0,160333.3,1109,135.3333
"14641","48139","2014",4,4,0,95100,943.25,107.75
"14642","48140","2014",17,13,4,124901.5,1500.294,93.05882
"14643","48144","2014",4,3,1,140750.8,1492.5,93.5
"14644","48146","2014",14,11,3,73184.29,1404.643,60.57143
"14645","48147","2014",3,3,0,85000,1392,65.33333
"14646","48148","2014",1,1,0,70000,5000,14
"14647","48150","2014",1,1,0,110000,1048,105
"14648","48152","2014",8,8,0,199822.9,1711,115.125
"14649","48155","2014",8,7,1,155937.5,1816.5,82.5
"14650","48156","2014",3,3,0,60933.33,814.3333,72.33333
"14651","48158","2014",4,4,0,153000,1688.25,80.75
"14652","48160","2014",1,1,0,70000,875,80
"14653","48163","2014",1,1,0,175000,1277,137
"14654","48165","2014",1,1,0,47500,754,63
"14655","48166","2014",4,4,0,97071.25,1416.75,70.75
"14656","48168","2014",3,3,0,35666.67,569,58
"14657","48173","2014",1,1,0,113171,1433,79
"14658","48174","2014",4,4,0,74000,1204.75,61.75
"14659","48176","2014",1,1,0,105000,1050,100
"14660","48177","2014",2,2,0,106000,806,125
"14661","48178","2014",3,2,1,98800,1012.667,88
"14662","48185","2014",6,5,1,108333.3,1353.5,82.33333
"14663","48187","2014",1,1,0,50000,610,82
"14664","48188","2014",2,2,0,69000,696.5,115.5
"14665","48191","2014",1,1,0,310905,1699,183
"14666","48193","2014",4,3,1,51500,1173,43.75
"14667","48194","2014",11,9,2,91577.27,1528.091,67.36364
"14668","48198","2014",10,6,4,57880,976.3,72.5
"14669","49002","2014",19,19,0,129953.2,1340.947,101.7895
"14670","49003","2014",15,15,0,132666.7,1385,99.6
"14671","49007","2014",1759,571,1188,149090.9,1996.383,74.41558
"14672","49008","2014",6,6,0,156633.3,1213.167,131.3333
"14673","49009","2014",4,4,0,136500,1135.75,128.75
"14674","49010","2014",2,2,0,132250,1032,125.5
"14675","49011","2014",6,6,0,162416.7,1472,110.8333
"14676","49012","2014",3,3,0,256926.7,1513.333,159.6667
"14677","49015","2014",112,72,40,198668.3,2090.571,97.63393
"14678","49017","2014",4,4,0,133000,1348,102.25
"14679","49018","2014",92,90,2,111479.6,1138.348,102.7826
"14680","49020","2014",28,26,2,258510.3,2403.321,105.2857
"14681","49021","2014",58,57,1,148118.1,1372.621,110.5
"14682","49022","2014",3,3,0,210500,1533.667,132.6667
"14683","49023","2014",162,161,1,122295.2,1317.37,97.26543
"14684","49026","2014",27,27,0,143494.4,1466.407,97.62963
"14685","49027","2014",22,21,1,146427.3,1528.318,94.63636
"14686","49028","2014",1,1,0,380000,2275,167
"14687","49029","2014",5,5,0,146400,1158.6,132.4
"14688","49030","2014",6,6,0,105166.7,1189.333,86.66667
"14689","49035","2014",48,47,1,266853.9,2103.583,123.8333
"14690","49036","2014",4,4,0,135750,1403.25,95.5
"14691","49038","2014",1,1,0,90000,1233,73
"14692","49041","2014",5,5,0,158740,1422.8,121.4
"14693","49045","2014",3,3,0,72666.67,1076.667,87.66667
"14694","49048","2014",27,26,1,177814.8,1877.222,91.88889
"14695","49050","2014",84,82,2,177592.6,1585.393,112.0595
"14696","49053","2014",1,1,0,114000,966,118
"14697","49054","2014",26,25,1,89455.77,983.5385,88.92308
"14698","49055","2014",14,14,0,183128.2,1860.071,101.9286
"14699","49056","2014",2,2,0,59000,602,88.5
"14700","49058","2014",1,1,0,37000,1423,26
"14701","49060","2014",8,8,0,139250,1423.375,99.25
"14702","49061","2014",7,7,0,70214.29,778.1429,91.71429
"14703","49063","2014",49,47,2,156557.1,1511.204,107.4082
"14704","49064","2014",3,3,0,339333.3,2853.667,114
"14705","49067","2014",2,1,1,97000,894.5,87.5
"14706","49068","2014",12,12,0,156479.2,1400.25,115.0833
"14707","49069","2014",90,90,0,125236.3,1428.889,86.3
"14708","49070","2014",5,5,0,105600,1222,88.8
"14709","49076","2014",5,5,0,184800,1365,133.6
"14710","49080","2014",48,45,3,128096.4,1375.708,99.70833
"14711","49082","2014",10,10,0,110350,1063.9,113.8
"14712","49086","2014",39,37,2,140873.6,1296.051,106.2051
"14713","49089","2014",7,7,0,99857.14,992.4286,103
"14714","49090","2014",8,8,0,97937.5,1253.75,79.75
"14715","49092","2014",121,120,1,122227.3,1268.727,99.33884
"14716","49099","2014",577,419,158,132002.4,1529.834,85.81976
"14717","49100","2014",2,2,0,117750,1220,97
"14718","49102","2014",1,1,0,1e+05,714,140
"14719","49107","2014",4,4,0,157150,973,158.75
"14720","49109","2014",9,9,0,135222.2,1265.889,107.6667
"14721","49110","2014",11,11,0,157909.1,1455.636,114.8182
"14722","49112","2014",2,2,0,87500,968,93
"14723","49113","2014",4,4,0,101887.5,982.5,99
"14724","49114","2014",2,2,0,66454,1051.5,60
"14725","49120","2014",18,18,0,196023.3,1406.333,129.9444
"14726","49121","2014",5,5,0,135000,1297.2,109.4
"14727","49123","2014",11,11,0,176409.1,1618.455,109.8182
"14728","49125","2014",80,80,0,137258.1,1324.287,99.6875
"14729","49127","2014",30,30,0,125555,1202.233,110.6
"14730","49129","2014",26,26,0,211370.2,1985.577,109.6154
"14731","49130","2014",6,6,0,171583.3,1532.833,118.3333
"14732","49131","2014",6,6,0,134666.7,1244.667,114
"14733","49132","2014",10,10,0,191838.5,2175.6,103.8
"14734","49135","2014",9,9,0,167138.9,1868.444,96
"14735","49138","2014",20,20,0,148650,1344.85,109.55
"14736","49140","2014",13,13,0,116308.5,1187.462,95.07692
"14737","49155","2014",8,8,0,153875,1452.375,105.375
"14738","49160","2014",23,20,3,113778.6,1427.87,86.78261
"14739","49161","2014",7,7,0,148142.9,1705.714,87.42857
"14740","49163","2014",24,24,0,215973.9,1623.542,109.5833
"14741","49167","2014",35,33,2,245202.9,2098.514,116.8857
"14742","49170","2014",7,7,0,116428.6,1292.429,100.5714
"14743","49174","2014",9,9,0,106286.6,1137.111,97.66667
"14744","49176","2014",15,15,0,161037,1554.6,104.1333
"14745","49178","2014",9,9,0,89355.56,973.7778,89.11111
"14746","49180","2014",46,45,1,131357.3,1364.891,96.41304
"14747","49182","2014",4,4,0,108750,1104.25,93.5
"14748","49183","2014",44,43,1,120198.9,1300.205,93.15909
"14749","49188","2014",3,3,0,145843.3,1531.667,105
"14750","49192","2014",16,16,0,178806.2,1463.438,113.5
"14751","49193","2014",26,26,0,115581.5,1223.577,94.23077
"14752","49194","2014",37,36,1,149760.9,1363.919,113.2703
"14753","49195","2014",4,4,0,111946.8,1081.75,106.25
"14754","49200","2014",51,50,1,176152.2,1742.51,103.3725
"14755","49201","2014",10,9,1,134900,1396.6,105.8
"14756","49205","2014",7,7,0,107185.7,1051,102.8571
"14757","49209","2014",3,3,0,128000,1168.333,113
"14758","49211","2014",6,6,0,104333.3,1088,99.83333
"14759","49214","2014",49,42,7,208357.1,1974.02,107.9592
"14760","49215","2014",25,25,0,91460,1180.52,77.56
"14761","49216","2014",1,1,0,3e+05,1056,284
"14762","49217","2014",6,6,0,132666.7,1429.833,108.5
"14763","49218","2014",99,98,1,111468.3,1219.828,92.69697
"14764","49219","2014",8,7,1,133875,1883.5,74.5
"14765","49220","2014",31,30,1,115187.1,1209.903,101.3548
"14766","49221","2014",13,13,0,98807.69,1035.154,99.46154
"14767","49222","2014",18,18,0,182115,1615.333,113.9444
"14768","49223","2014",47,36,11,172888.3,1857.426,95.76596
"14769","49224","2014",6,6,0,121666.7,1342.333,85.33333
"14770","49228","2014",49,49,0,97141.84,1060.245,91.46939
"14771","49231","2014",9,9,0,161111.1,1469.444,113.4444
"14772","49235","2014",5,5,0,83045.6,885.4,100.2
"14773","49237","2014",2,2,0,123250,724.5,182.5
"14774","49240","2014",5,5,0,71100,946.4,79
"14775","49241","2014",19,19,0,219263.2,1915.053,116.4211
"14776","49244","2014",118,118,0,127650.5,1309.517,98.34746
"14777","49246","2014",105,88,17,190640.4,2054.667,94.26667
"14778","49247","2014",19,19,0,183947.4,1713.421,108.2632
"14779","49248","2014",83,81,2,101041.3,1062.855,99.31325
"14780","49253","2014",16,16,0,140141.9,1124.062,126
"14781","49257","2014",7,7,0,139500,1352,97
"14782","49259","2014",20,19,1,152850,1538.6,100.55
"14783","49260","2014",11,11,0,121409.1,1488,82.90909
"14784","49261","2014",73,73,0,132887.4,1369.137,97.69863
"14785","49262","2014",4,4,0,170750,1479.25,113.25
"14786","49266","2014",9,8,1,99611.11,1128.667,89.55556
"14787","49267","2014",67,52,15,185756.5,2044.552,93.86567
"14788","49269","2014",13,13,0,163500,1721.385,94.84615
"14789","49271","2014",12,12,0,190254.7,1745.667,110.6667
"14790","49272","2014",9,9,0,105666.7,1202,90.77778
"14791","49278","2014",20,17,3,216430,1910.15,110.5
"14792","49283","2014",24,24,0,145208.3,1578.708,90.33333
"14793","49284","2014",10,10,0,150550,1296.1,126.5
"14794","49288","2014",2,2,0,91000,1377.5,59.5
"14795","49291","2014",4,4,0,126500,1217.5,101.25
"14796","49292","2014",28,28,0,159710.7,1560.714,107.8214
"14797","49294","2014",18,18,0,214944.4,1879.778,117.2222
"14798","49298","2014",17,17,0,220505.9,2017.588,110.5294
"14799","49299","2014",26,26,0,147965.4,1486.154,101.4231
"14800","49301","2014",177,177,0,127633.6,1326.96,98.31073
"14801","49306","2014",8,8,0,211500,1773.75,124
"14802","49307","2014",97,97,0,182275.6,1692.825,112.6289
"14803","49308","2014",17,16,1,183205.9,1666.471,113.1176
"14804","49310","2014",3,3,0,85166.67,840.3333,100.3333
"14805","49311","2014",15,15,0,133866.7,1245.2,115.4667
"14806","49321","2014",3,3,0,148666.7,1433.667,100.6667
"14807","49323","2014",40,40,0,200696.2,1882.725,106.275
"14808","49326","2014",5,5,0,191988,1738.2,112.2
"14809","49328","2014",238,146,92,131757.7,1394.143,88.88235
"14810","49329","2014",8,8,0,212625,2148.25,102.75
"14811","49330","2014",13,13,0,155287,1629.231,89.07692
"14812","49331","2014",148,136,12,112588,1264.574,90.66892
"14813","49332","2014",29,29,0,173473.8,1762.897,104.3448
"14814","49333","2014",20,20,0,145078,1321.6,108.35
"14815","49334","2014",4,4,0,139495,1465.25,108
"14816","49336","2014",8,8,0,79785.38,802.5,105.25
"14817","49338","2014",4,4,0,213750,2019.5,104.75
"14818","49339","2014",13,13,0,145826.9,1517.154,97.92308
"14819","49341","2014",3,3,0,89666.67,1170.333,73.66667
"14820","49343","2014",27,27,0,122888.9,1370.481,91.85185
"14821","49344","2014",15,15,0,135366.7,1406.067,95.73333
"14822","49345","2014",43,43,0,142230.5,1268.302,116.7442
"14823","49347","2014",40,38,2,157167.5,1564.5,100.375
"14824","49352","2014",7,7,0,161331.4,1554.714,104.7143
"14825","49353","2014",107,101,6,169317,1803.935,95.3271
"14826","49355","2014",12,12,0,123580,1219.583,100.0833
"14827","49358","2014",4,4,0,310500,1620.25,170.75
"14828","49359","2014",6,6,0,133166.7,1058.333,126
"14829","49361","2014",11,11,0,110977.7,1370.727,86
"14830","49362","2014",6,6,0,203333.3,1734.5,113.6667
"14831","49364","2014",6,6,0,159583.3,1428,114.6667
"14832","49367","2014",45,45,0,136817.5,1424.644,99.91111
"14833","49368","2014",17,17,0,99217.65,1122.176,93.17647
"14834","49369","2014",6,6,0,81666.67,868.1667,84.83333
"14835","49370","2014",1,1,0,130000,1605,81
"14836","49371","2014",16,16,0,112468.8,1105.188,102.125
"14837","49373","2014",45,45,0,108359.8,1095.422,103.2444
"14838","49374","2014",4,4,0,128750,1395.75,89
"14839","49377","2014",33,32,1,182481.2,1700.091,107.1212
"14840","49378","2014",12,12,0,138364.2,1327.583,101.25
"14841","49381","2014",12,12,0,134825,1292.333,107.75
"14842","50002","2014",35,24,11,128417.7,1325.657,101.7143
"14843","50003","2014",62,56,6,222166.5,2524.194,90.43548
"14844","50004","2014",6,6,0,117666.7,1107,108.6667
"14845","50008","2014",5,4,1,205110,1614.8,129.8
"14846","50013","2014",2,2,0,120000,1065.5,109.5
"14847","50015","2014",4,4,0,149750,1430.25,104.75
"14848","50016","2014",3,3,0,92333.33,1216.667,84.66667
"14849","50019","2014",4,4,0,47225,585,77.25
"14850","50022","2014",3,3,0,94666.67,1441.333,63
"14851","50023","2014",8,8,0,120525,968.75,124.125
"14852","50024","2014",4,4,0,120000,1101,123.75
"14853","50025","2014",101,62,39,127206.2,1877.554,88.73267
"14854","50027","2014",7,7,0,140714.3,1293.571,119.4286
"14855","50028","2014",1,1,0,90000,1059,85
"14856","50029","2014",8,8,0,54000,948.375,62.5
"14857","50030","2014",16,12,4,166929.1,2729.438,69.5625
"14858","50031","2014",58,51,7,157296.7,2200.448,74.24138
"14859","50032","2014",4,4,0,177875,1196.5,148.5
"14860","50034","2014",3,3,0,184373.3,1365,140
"14861","50036","2014",3,3,0,106000,1177.333,87.66667
"14862","50038","2014",6,6,0,99166.67,1206.833,85
"14863","50039","2014",1,1,0,30000,517,58
"14864","50040","2014",3,3,0,83166.67,1290,68.66667
"14865","50041","2014",84,83,1,152601.8,1754.738,96.54762
"14866","50042","2014",2,2,0,132500,1400,96.5
"14867","50044","2014",5,5,0,159900,1295.8,112.4
"14868","50045","2014",3,3,0,96000,1059.667,90.66667
"14869","50046","2014",2,2,0,130350,1447.5,92.5
"14870","50048","2014",3,3,0,98666.67,810.6667,124.3333
"14871","50049","2014",4,4,0,128075,1844,81.25
"14872","50050","2014",1,1,0,150000,1027,146
"14873","50052","2014",2,2,0,134370,1566,95.5
"14874","50054","2014",1,1,0,174000,1130,154
"14875","50055","2014",1,1,0,130000,1000,130
"14876","50058","2014",23,23,0,193747.8,1682.609,133.2609
"14877","50059","2014",4,4,0,141750,1475,99.25
"14878","50060","2014",3,3,0,130881.3,954.6667,134
"14879","50062","2014",2,2,0,46500,823,62
"14880","50064","2014",3,3,0,129700,1019.333,124
"14881","50066","2014",56,50,6,218896.3,2338.018,99.51786
"14882","50069","2014",2,2,0,224500,2326.5,99.5
"14883","50072","2014",3,3,0,166000,1474.667,115.6667
"14884","50074","2014",16,16,0,115680.6,1189.375,102.9375
"14885","50076","2014",36,34,2,168117.9,2366.25,85.13889
"14886","50077","2014",8,8,0,167031.4,2071.625,80.375
"14887","50078","2014",6,6,0,91933.33,1104.5,82
"14888","50081","2014",7,7,0,215657.1,1970.571,106.1429
"14889","50082","2014",50,49,1,144477,1490.64,97.44
"14890","50083","2014",3,3,0,158333.3,1708,94
"14891","50084","2014",4,4,0,110000,1353.5,81
"14892","50085","2014",9,9,0,152850,1542,94
"14893","50086","2014",3,3,0,142633.3,2176.667,69.66667
"14894","50087","2014",11,11,0,133513.6,1587.364,86.18182
"14895","50088","2014",4,4,0,99596.5,1051.25,95.75
"14896","50090","2014",4,4,0,36335,712.75,54.75
"14897","50092","2014",5,5,0,97400,1403,69
"14898","50093","2014",3,3,0,135000,1154.667,115.6667
"14899","50094","2014",1,1,0,204000,1511,135
"14900","50095","2014",15,15,0,127641.1,1281.933,99.53333
"14901","50096","2014",1,1,0,146000,1780,82
"14902","50098","2014",4,4,0,106625,827.75,129.75
"14903","50099","2014",102,90,12,115275.4,1290.451,94.13725
"14904","50102","2014",16,16,0,146362.4,2035.75,76
"14905","50106","2014",2,2,0,85000,891.5,95
"14906","50108","2014",9,9,0,82555.56,974.7778,92.77778
"14907","50109","2014",17,17,0,98750,971.1176,102.3529
"14908","50110","2014",5,5,0,94140,907,104
"14909","50111","2014",9,9,0,111500,973.4444,132.4444
"14910","50112","2014",4,4,0,91572.5,819.25,110.25
"14911","50115","2014",1,1,0,80000,952,84
"14912","50117","2014",7,7,0,156785.7,1862.429,92.14286
"14913","50118","2014",5,5,0,70500,698.6,92.6
"14914","50120","2014",1,1,0,87500,1094,80
"14915","50121","2014",5,5,0,89300,1779,56.2
"14916","50124","2014",3,3,0,156000,1851,85.33333
"14917","50129","2014",673,520,153,139903.6,1719.235,84.58395
"14918","50130","2014",10,10,0,98530,965.4,100.9
"14919","50135","2014",3,3,0,209000,1891,104.3333
"14920","50137","2014",9,9,0,97500,1239.444,82.55556
"14921","50138","2014",5,5,0,83000,1573.2,52.8
"14922","50139","2014",29,29,0,108701.7,1156.793,94
"14923","50142","2014",10,10,0,142800,1810.7,82.6
"14924","50143","2014",9,9,0,140203.7,1741.556,98
"14925","50144","2014",8,8,0,81562.5,944.25,86.125
"14926","50145","2014",6,6,0,90970,1580.5,69
"14927","50146","2014",2,2,0,148375,1432.5,100
"14928","50147","2014",61,41,20,109424.1,1261.098,87.22951
"14929","50148","2014",2,2,0,141000,1581.5,88
"14930","50149","2014",4,4,0,226875,1532.5,146.5
"14931","50150","2014",3,3,0,117666.7,1172.667,101
"14932","50151","2014",16,16,0,108809.4,1369.062,85.25
"14933","50152","2014",5,5,0,75910,1238.4,75.6
"14934","50155","2014",1,1,0,132000,805,164
"14935","50156","2014",2,2,0,71000,1375,50.5
"14936","50158","2014",3,3,0,48333.33,883,56
"14937","50159","2014",3,3,0,105666.7,1282,90.66667
"14938","50161","2014",3,3,0,91200,1948.667,71
"14939","50162","2014",12,12,0,172779.2,1549.917,114.5
"14940","50164","2014",9,9,0,125728.4,1159.667,103.1111
"14941","50165","2014",39,22,17,170974.1,2184.436,76.51282
"14942","50166","2014",1,1,0,60000,1333,45
"14943","50167","2014",12,12,0,145535.3,1916.083,90
"14944","50168","2014",15,15,0,96013.33,1141.467,87.33333
"14945","50172","2014",7,7,0,91875.71,1139.429,79.14286
"14946","50175","2014",1,1,0,145600,1277,114
"14947","50176","2014",2,2,0,145500,1090,130
"14948","50177","2014",4,4,0,113750,1431.75,79
"14949","50178","2014",11,11,0,126163.6,1864.091,66.36364
"14950","50181","2014",1,1,0,53350,667,80
"14951","50182","2014",2,2,0,101250,1843.5,60.5
"14952","50183","2014",3,3,0,153666.7,1352.333,115.6667
"14953","50184","2014",9,9,0,144762,1710.111,87.77778
"14954","50185","2014",9,9,0,139551.1,1410.333,105.1111
"14955","50188","2014",11,11,0,97945.45,1227.455,81.27273
"14956","50190","2014",2,2,0,197500,1704.5,115.5
"14957","50193","2014",1,1,0,65000,1300,50
"14958","50194","2014",2,2,0,165500,1202,166
"14959","50195","2014",3,3,0,124333.3,1047.333,118.6667
"14960","50196","2014",7,7,0,124714.3,1369,95.71429
"14961","50197","2014",22,22,0,98104.55,1164.364,87.86364
"14962","50198","2014",2,2,0,86695,1715.5,50
"14963","50199","2014",6,6,0,112666.7,1406.333,80.16667
"14964","50200","2014",9,9,0,88377.78,845.7778,98.33333
"14965","50205","2014",2,2,0,52500,952,56.5
"14966","50207","2014",1,1,0,23000,460,50
"14967","50208","2014",2,2,0,95000,1521,57
"14968","50209","2014",9,9,0,138000,1246.778,107.1111
"14969","50210","2014",5,5,0,45000,745,63
"14970","50214","2014",1,1,0,60000,632,95
"14971","50215","2014",39,39,0,135140.7,1705.179,83
"14972","50216","2014",3,3,0,77500,616.3333,118.3333
"14973","50217","2014",7,7,0,75714.29,1040.571,75.14286
"14974","50218","2014",218,95,123,148374.2,2162.583,69.91743
"14975","50219","2014",2,2,0,143000,1178.5,121.5
"14976","50221","2014",1,1,0,2e+05,1754,114
"14977","50222","2014",1,1,0,147000,1793,82
"14978","50225","2014",1,1,0,125000,1136,110
"14979","50227","2014",3,3,0,81166.67,1111,74.66667
"14980","50228","2014",13,13,0,110269.2,1404.692,97.30769
"14981","50230","2014",9,9,0,152111.1,1409.778,111.8889
"14982","50231","2014",10,10,0,162526,2525.8,70.6
"14983","50232","2014",5,5,0,75670,989.4,83
"14984","50233","2014",1,1,0,103000,1943,53
"14985","50235","2014",1,1,0,121000,1862,65
"14986","50236","2014",35,34,1,108980.2,1351.829,83.88571
"14987","50237","2014",9,8,1,97944.44,963.7778,98.88889
"14988","50238","2014",2,2,0,73500,1458.5,57
"14989","50239","2014",12,12,0,111750,1024.75,103.3333
"14990","50240","2014",2,2,0,116500,1497.5,83
"14991","50241","2014",1,1,0,35000,330,106
"14992","50243","2014",2,2,0,184250,1939.5,95
"14993","50246","2014",1,1,0,145000,942,154
"14994","50247","2014",3,3,0,127996.7,1382.667,95.33333
"14995","50251","2014",1,1,0,120000,2400,50
"14996","50252","2014",5,5,0,130280,1415.8,89.6
"14997","50253","2014",2,2,0,125000,1071,114.5
"14998","50256","2014",30,30,0,106720,1132.867,100.4
"14999","50259","2014",5,5,0,145050,1369.8,104.6
"15000","50260","2014",20,20,0,96503.95,1107.2,100.45
"15001","50262","2014",3,3,0,91100,1005.333,86.66667
"15002","50263","2014",3,3,0,45518.33,878.6667,48.33333
"15003","50265","2014",1,1,0,110000,1294,85
"15004","50266","2014",5,5,0,81020,974.6,79.8
"15005","50267","2014",15,14,1,106673,1084.133,110.1333
"15006","50268","2014",4,4,0,214883.8,3108.25,79
"15007","50269","2014",3,3,0,68333.33,641.6667,99
"15008","50270","2014",3,3,0,110950,1389,80.33333
"15009","50271","2014",2,2,0,80500,1437,59
"15010","50272","2014",13,13,0,120807.7,1660.231,77
"15011","50273","2014",15,15,0,78200,869.6667,93.86667
"15012","50274","2014",11,11,0,96000,1153.545,80.72727
"15013","50275","2014",1,1,0,170000,1018,167
"15014","50276","2014",2,2,0,75000,1094,84.5
"15015","50277","2014",7,7,0,176428.6,1524.571,126
"15016","50278","2014",1,1,0,159000,1303,122
"15017","50279","2014",4,4,0,122500,1504.75,81
"15018","50281","2014",7,7,0,99214.29,967.1429,100.4286
"15019","50282","2014",2,2,0,142000,1033,137.5
"15020","50285","2014",3,3,0,103000,1974,55
"15021","50288","2014",10,10,0,121240,1395.4,94.3
"15022","50289","2014",4,4,0,71500,1190,66.5
"15023","50290","2014",2,2,0,85000,1044,82
"15024","50291","2014",4,4,0,56625,633,92.75
"15025","50292","2014",19,19,0,103794.7,1077.737,95.94737
"15026","50294","2014",9,9,0,160388.9,1448,115.7778
"15027","50295","2014",2,2,0,95130,593,160
"15028","50296","2014",2,2,0,260000,1550,161.5
"15029","50297","2014",9,9,0,104000,1047.444,100.3333
"15030","50298","2014",2,2,0,117500,1170.5,102
"15031","50299","2014",1,1,0,150000,1034,145
"15032","50300","2014",1,1,0,295000,1341,220
"15033","50304","2014",3,3,0,119666.7,1238,88.33333
"15034","50305","2014",8,8,0,166456.2,1459.875,116.75
"15035","50310","2014",3,3,0,73666.67,660.6667,117.6667
"15036","50311","2014",5,5,0,98000,1117,86.4
"15037","50312","2014",1,1,0,120000,1277,94
"15038","50315","2014",5,5,0,64370,772,81.2
"15039","50317","2014",5,5,0,108330,1035.4,103.2
"15040","50321","2014",5,5,0,164900,1339.6,119.4
"15041","50326","2014",2,2,0,60000,759.5,79
"15042","50327","2014",2,2,0,98000,868,111
"15043","50328","2014",4,4,0,98500,1112,92.5
"15044","50332","2014",7,7,0,132457.1,1548.143,86.85714
"15045","50334","2014",2,2,0,76000,1037.5,78.5
"15046","50335","2014",7,7,0,102210.3,1136,94.14286
"15047","50336","2014",1,1,0,115000,1173,98
"15048","50338","2014",4,4,0,82625,1626.5,74.25
"15049","50340","2014",1,1,0,45000,726,62
"15050","50341","2014",14,13,1,138675,1507.714,97.07143
"15051","50342","2014",12,12,0,181200,1714.75,108
"15052","50345","2014",4,4,0,139000,1192,114.25
"15053","50347","2014",5,5,0,193400,1829,125.6
"15054","50349","2014",17,17,0,128749.9,1647.706,79.23529
"15055","50350","2014",6,6,0,81945,849.1667,98.16667
"15056","50351","2014",2,2,0,93750,1077.5,87.5
"15057","50352","2014",5,5,0,87700,958.6,92
"15058","50356","2014",8,8,0,102875,1074.25,93.125
"15059","50357","2014",1,1,0,18000,545,33
"15060","50359","2014",33,31,2,84310.61,997.2424,86.39394
"15061","50361","2014",2,2,0,150000,1871,98
"15062","50363","2014",6,6,0,74950,785.6667,95.83333
"15063","50364","2014",3,3,0,24500,782.6667,31.66667
"15064","50365","2014",7,7,0,80528.57,777,106.2857
"15065","50368","2014",1,1,0,120000,1165,103
"15066","50369","2014",5,5,0,174226.2,2042.8,94
"15067","50370","2014",8,8,0,143000,1623.75,92.625
"15068","50371","2014",2,2,0,76500,698,119
"15069","50372","2014",2,2,0,120000,1382.5,98.5
"15070","50373","2014",1,1,0,120000,1714,70
"15071","50378","2014",3,3,0,60833.33,522.3333,119.3333
"15072","50379","2014",2,2,0,55000,826.5,66
"15073","50382","2014",6,6,0,170725,1664.667,101.8333
"15074","50384","2014",1,1,0,103000,945,109
"15075","50387","2014",3,3,0,104733.3,1233.333,85
"15076","50388","2014",5,5,0,117400,1182.4,101.2
"15077","50389","2014",4,4,0,96250,930.75,108.25
"15078","50390","2014",1,1,0,130000,855,152
"15079","50391","2014",18,17,1,74097.22,1021.444,76.94444
"15080","50393","2014",26,26,0,93365.38,1001.346,91.57692
"15081","50394","2014",17,17,0,84088.24,877.1176,94.76471
"15082","50395","2014",3,3,0,85000,1029,85
"15083","50397","2014",7,7,0,68514.29,835.7143,86.42857
"15084","50398","2014",2,2,0,167160.5,1112,151.5
"15085","50400","2014",26,26,0,110451.2,1053.423,108.4231
"15086","50402","2014",25,25,0,180414.1,1765.96,102.08
"15087","50403","2014",32,32,0,112766.9,1830.094,67.9375
"15088","50405","2014",2,2,0,131325,1270.5,106
"15089","50407","2014",9,9,0,136355.6,1198.222,120.4444
"15090","50409","2014",24,22,2,109958.3,1085.458,98.83333
"15091","50410","2014",48,46,2,90508.96,1003.167,90.3125
"15092","50411","2014",5,5,0,118130,1334.6,85.4
"15093","50412","2014",30,29,1,165338.3,1999.633,91.7
"15094","50413","2014",3,3,0,102666.7,1355.333,72.33333
"15095","50417","2014",18,18,0,159166.7,1761.722,82.5
"15096","50419","2014",10,10,0,120400,1255.4,97.5
"15097","50420","2014",9,9,0,108711.1,1079.889,95.77778
"15098","50421","2014",8,8,0,143062.5,1881.5,79.125
"15099","50422","2014",1,1,0,50000,769,65
"15100","50423","2014",1,1,0,191500,1532,125
"15101","50425","2014",8,8,0,131812.5,1242.625,105.125
"15102","50426","2014",2,2,0,87500,913.5,99
"15103","50428","2014",3,3,0,101926.7,705.6667,129.6667
"15104","50429","2014",14,14,0,147500,1735.571,87.5
"15105","50431","2014",12,12,0,93760,923.3333,107.8333
"15106","50433","2014",10,10,0,146550,1655.6,93.7
"15107","50435","2014",5,5,0,153300,1633.6,108.2
"15108","50436","2014",7,7,0,89500,888.4286,98.28571
"15109","50437","2014",8,8,0,110812.5,1180.125,92.625
"15110","50443","2014",2,2,0,248650,2086,124
"15111","50444","2014",27,27,0,118844.9,1174.63,99.81481
"15112","50445","2014",4,4,0,105000,959.75,112.75
"15113","50446","2014",4,4,0,154722.5,1242,125.25
"15114","50447","2014",8,8,0,148414.6,1468.375,100.75
"15115","50448","2014",9,9,0,77000,976.3333,79
"15116","50450","2014",4,4,0,65150,1242.5,52.5
"15117","50452","2014",7,7,0,113714.3,1128.857,94.42857
"15118","50453","2014",6,6,0,124500,1320.833,102.6667
"15119","50454","2014",6,6,0,172000,1470.833,119.5
"15120","50455","2014",9,9,0,100833.3,1040.889,96.33333
"15121","50456","2014",8,8,0,64375,831,82.75
"15122","50457","2014",1,1,0,50000,394,127
"15123","50462","2014",3,3,0,76966,847.3333,94
"15124","50463","2014",5,5,0,169012,1008.6,177.2
"15125","50464","2014",7,7,0,112026.1,1445.714,87.85714
"15126","50467","2014",3,3,0,190650,1789,106.3333
"15127","50468","2014",7,7,0,61142.86,777.1429,80.85714
"15128","50469","2014",2,2,0,128250,1445.5,84.5
"15129","50471","2014",6,6,0,91416.67,1532.5,63.33333
"15130","50472","2014",1,1,0,45000,818,55
"15131","50473","2014",7,7,0,116392.9,1012,117.1429
"15132","50474","2014",3,3,0,72033.33,896,83
"15133","50475","2014",5,5,0,135830,1178.6,114.4
"15134","50476","2014",1,1,0,66500,554,120
"15135","50478","2014",1,1,0,39000,438,89
"15136","50479","2014",3,3,0,182833.3,1583,122.3333
"15137","50480","2014",9,9,0,175027.8,1626.111,111.1111
"15138","50481","2014",24,23,1,114078.4,1805.167,70
"15139","50482","2014",2,2,0,112000,1290.5,85
"15140","50483","2014",5,5,0,113374,1387.2,84.8
"15141","50484","2014",40,33,7,90382.55,1128.4,82
"15142","50486","2014",2,2,0,145000,1784.5,80.5
"15143","50487","2014",28,28,0,111298.1,1025.75,112.4643
"15144","50488","2014",2,2,0,121750,941,129
"15145","50489","2014",3,3,0,160000,1766,93.33333
"15146","50490","2014",2,2,0,102500,2175.5,45
"15147","50491","2014",3,3,0,104000,918.6667,113.3333
"15148","50492","2014",24,24,0,116518,1189.917,103.2917
"15149","50493","2014",15,15,0,146046.7,1410.4,102.1333
"15150","50495","2014",2,2,0,72200,876,80.5
"15151","50496","2014",14,14,0,222050,1957.929,115.2857
"15152","50498","2014",4,4,0,163875,1739.5,99.75
"15153","50499","2014",8,8,0,75837.5,884.25,81.625
"15154","50500","2014",6,6,0,101308.3,952.5,105.3333
"15155","50502","2014",144,81,63,112262.1,1341.632,87.55556
"15156","50504","2014",2,2,0,77500,848,89
"15157","50505","2014",4,4,0,160300,1606.75,99.5
"15158","50506","2014",5,5,0,124550,1542.4,76.8
"15159","50507","2014",2,2,0,145000,2299.5,66.5
"15160","50509","2014",5,5,0,160740,1582,98.8
"15161","50510","2014",6,6,0,113516.7,1156.5,100.1667
"15162","50511","2014",1,1,0,46000,708,65
"15163","50512","2014",7,7,0,130214.3,1187.143,115.8571
"15164","50513","2014",6,6,0,119125,1005.833,119.3333
"15165","50514","2014",2,2,0,126500,1332,93.5
"15166","50517","2014",3,3,0,109000,1332,78.66667
"15167","50518","2014",2,2,0,81750,701,104.5
"15168","50519","2014",5,5,0,156000,1131.8,137.2
"15169","50521","2014",3,3,0,90500,918.6667,88
"15170","50522","2014",2,2,0,62500,2086.5,42.5
"15171","50523","2014",32,32,0,114859.4,1400.562,87.71875
"15172","50525","2014",6,6,0,76083.33,957.3333,74.33333
"15173","50528","2014",6,6,0,97166.67,943.5,101.6667
"15174","50529","2014",1,1,0,107000,594,180
"15175","50531","2014",6,6,0,115666.7,1411,85
"15176","50532","2014",69,56,13,215437.4,2445.623,84.97101
"15177","50533","2014",3,3,0,66000,676.3333,97.33333
"15178","50535","2014",4,4,0,50250,1163,45.75
"15179","50536","2014",2,2,0,130000,1413,91.5
"15180","50537","2014",2,2,0,163000,1813.5,90.5
"15181","50538","2014",2,2,0,113000,929.5,119
"15182","50539","2014",19,19,0,111621.1,1416.105,84.68421
"15183","50540","2014",2,2,0,159385,1466,107
"15184","50541","2014",14,14,0,154693.5,1365.571,109.7857
"15185","50542","2014",5,5,0,67000,1259,58.4
"15186","50543","2014",8,8,0,93375,1126.375,81
"15187","50546","2014",20,20,0,116863.1,1114.65,103.45
"15188","50548","2014",2,2,0,125500,1456.5,102
"15189","50549","2014",1,1,0,140000,2258,62
"15190","50550","2014",19,19,0,127470.1,1233.632,103.5789
"15191","50551","2014",16,16,0,105226.6,1054,102.375
"15192","50552","2014",1,1,0,83334,667,125
"15193","50553","2014",3,3,0,149333.3,1248,111.6667
"15194","50554","2014",8,8,0,146650,1539.125,93.75
"15195","50556","2014",5,5,0,143280,1277.2,114.2
"15196","50562","2014",24,21,3,140029.2,2123.458,74
"15197","50563","2014",4,4,0,160875,1615.75,107
"15198","50564","2014",7,7,0,85857.14,893,103.1429
"15199","50565","2014",24,21,3,168763.2,1829,100.1667
"15200","50567","2014",5,5,0,76900,1331.4,63.8
"15201","50568","2014",2,2,0,68750,912.5,74
"15202","50569","2014",5,5,0,120000,1208.8,107.8
"15203","50570","2014",3,3,0,72666.67,1288,72.33333
"15204","50574","2014",3,3,0,71666.67,990,73.66667
"15205","50575","2014",1,1,0,172900,1530,113
"15206","50576","2014",9,9,0,128387.7,1472.889,86.77778
"15207","50577","2014",2,2,0,137500,1307,102
"15208","50579","2014",12,12,0,135350,1296,103
"15209","50580","2014",5,5,0,167000,1976.8,88.8
"15210","50582","2014",31,31,0,86096.77,1125.839,84.16129
"15211","50584","2014",3,3,0,132666.7,1168,121.6667
"15212","50585","2014",9,9,0,152334.4,1843.667,91.77778
"15213","50588","2014",2,2,0,110000,1150,90
"15214","50589","2014",3,3,0,95833.33,1167,80
"15215","50590","2014",6,6,0,125750,1831.333,76.16667
"15216","50591","2014",14,14,0,74760.21,1163.214,70.85714
"15217","50592","2014",19,18,1,94576.58,1009.789,98.31579
"15218","50593","2014",3,3,0,137833.3,1147.333,125
"15219","50594","2014",8,8,0,161875,1675.5,123.625
"15220","50596","2014",1,1,0,50000,417,120
"15221","50597","2014",7,7,0,127071.4,1389,89.42857
"15222","50598","2014",1,1,0,80000,870,92
"15223","50599","2014",4,4,0,171375,1511.75,111
"15224","50601","2014",25,25,0,92744,1130.32,81.12
"15225","50603","2014",8,8,0,112500,1321.25,90.5
"15226","50604","2014",7,7,0,111428.6,1224.143,106.2857
"15227","50606","2014",2,2,0,102500,762.5,121.5
"15228","50607","2014",3,3,0,114166.7,1117,108.6667
"15229","50609","2014",2,2,0,65750,715.5,97.5
"15230","50610","2014",1,1,0,115000,1307,88
"15231","50612","2014",6,6,0,116666.7,1649,72.66667
"15232","50613","2014",3,3,0,114333.3,2136.667,60.66667
"15233","50615","2014",44,35,9,134798.9,1526.318,92.65909
"15234","50616","2014",10,10,0,200170,1648.5,120.1
"15235","50617","2014",5,5,0,75800,1013.2,86.4
"15236","50618","2014",1,1,0,165000,1571,105
"15237","50619","2014",3,3,0,163000,1458.667,108
"15238","50621","2014",1,1,0,120000,1188,101
"15239","50624","2014",2,2,0,140000,1648.5,85.5
"15240","50626","2014",4,4,0,143000,1860.25,81.75
"15241","50628","2014",1,1,0,45000,556,81
"15242","50629","2014",6,6,0,103491.7,1240.167,88.16667
"15243","50633","2014",2,2,0,132000,1664.5,78
"15244","50637","2014",5,5,0,55909.8,700.4,83.6
"15245","50639","2014",32,28,4,120975,1300.094,92.40625
"15246","50641","2014",6,6,0,117058.3,1029.667,114.1667
"15247","50643","2014",3,3,0,146666.7,1502.667,106
"15248","50647","2014",15,15,0,184080,1831.867,103.1333
"15249","50648","2014",4,4,0,131250,1490.75,90
"15250","51001","2014",1,1,0,150000,1974,76
"15251","51003","2014",1,1,0,148000,1591,93
"15252","51007","2014",5,5,0,202500,1727.6,114.2
"15253","51008","2014",3,3,0,110283.3,1155,99.33333
"15254","51013","2014",1,1,0,130000,1857,70
"15255","51014","2014",2,2,0,110250,1319,81
"15256","51017","2014",1,1,0,97000,1128,86
"15257","51018","2014",4,4,0,204025,1819.25,116.75
"15258","51019","2014",1,1,0,130000,2708,48
"15259","51023","2014",2,2,0,132500,1553.5,86.5
"15260","51025","2014",12,12,0,201805.4,1636.25,127.5
"15261","51029","2014",9,9,0,156333.3,1585.222,98.33333
"15262","51030","2014",43,36,7,177151.2,1867.767,95.95349
"15263","51031","2014",1,1,0,197000,1950,101
"15264","51036","2014",2,2,0,57750,984.5,60.5
"15265","51037","2014",4,4,0,138750,1483.25,89.25
"15266","51038","2014",1,1,0,72000,973,74
"15267","51040","2014",4,4,0,78250,1028.25,91
"15268","51042","2014",1,1,0,75500,629,120
"15269","51043","2014",20,20,0,147519,1775.7,84.95
"15270","51044","2014",4,3,1,112625,1288.5,88.5
"15271","51046","2014",9,9,0,219000,1916.333,116.8889
"15272","51049","2014",5,5,0,113464,1296.8,96.6
"15273","51050","2014",4,4,0,101712.5,1108,98.25
"15274","51051","2014",1,1,0,206000,1746,118
"15275","51052","2014",4,4,0,195000,2300.5,84.5
"15276","51054","2014",9,8,1,148388.9,1491.222,100.5556
"15277","51055","2014",50,43,7,216003.1,2161.9,100.54
"15278","51057","2014",1,1,0,245000,1531,160
"15279","51058","2014",10,7,3,317093.8,2704,115.9
"15280","51059","2014",3,3,0,119400,1202,97.66667
"15281","51060","2014",1,1,0,106000,1116,95
"15282","51065","2014",7,7,0,111935.7,1064,134
"15283","51066","2014",2,2,0,112500,870,97
"15284","51069","2014",1,1,0,155000,1890,82
"15285","51070","2014",3,3,0,140666.7,2198.333,65.33333
"15286","51073","2014",2,2,0,245082.5,1917.5,126
"15287","51074","2014",19,19,0,193980.5,1883.263,106.5789
"15288","51075","2014",8,8,0,233875,2313.125,105.75
"15289","51077","2014",2,2,0,318500,2033,158
"15290","51078","2014",2,2,0,172575,1945,89.5
"15291","51079","2014",5,5,0,169960,2026,84.6
"15292","51081","2014",1,1,0,72000,1200,60
"15293","51084","2014",1,1,0,90000,1011,89
"15294","51086","2014",1,1,0,1e+05,1429,70
"15295","51088","2014",6,6,0,154416.7,1508.333,106.3333
"15296","51089","2014",1,1,0,120000,1412,85
"15297","51093","2014",6,6,0,179666.7,1900.667,96.5
"15298","51094","2014",1,1,0,125000,1068,117
"15299","51095","2014",1,1,0,257000,1691,152
"15300","51097","2014",1,1,0,90000,1139,79
"15301","51099","2014",2,2,0,107900,922.5,117.5
"15302","51101","2014",5,5,0,231240,1817.6,129.4
"15303","51102","2014",4,4,0,214625,1826.75,117.25
"15304","51105","2014",12,12,0,266375,2480.833,116.6667
"15305","51107","2014",2,2,0,160250,1639,106.5
"15306","51108","2014",340,172,168,124859.5,1559.591,80.17353
"15307","51111","2014",1,1,0,268850,1867,144
"15308","51112","2014",2,2,0,353916,1678,233.5
"15309","51115","2014",3,3,0,283000,2250.667,132.6667
"15310","51117","2014",3,3,0,119050,1469,83
"15311","51118","2014",6,6,0,341214,2490.833,139.5
"15312","51122","2014",1,1,0,85000,1214,70
"15313","51129","2014",3,3,0,97666.67,1303.667,101
"15314","51130","2014",1,1,0,53000,883,60
"15315","51134","2014",2,2,0,138500,1307,107
"15316","51136","2014",3,3,0,88966.67,960.3333,93
"15317","51139","2014",4,4,0,150375,1204.25,121.5
"15318","51140","2014",4,4,0,214805.2,2600.75,82.25
"15319","51141","2014",8,8,0,90193.75,972,91.625
"15320","51142","2014",3,3,0,206133.3,1809.333,113
"15321","51147","2014",1,1,0,191900,1066,180
"15322","51152","2014",1,1,0,228000,2018,113
"15323","51153","2014",6,6,0,114141.7,1432.5,86
"15324","51154","2014",1,1,0,126000,1050,120
"15325","51158","2014",6,6,0,140500,1250.667,111.8333
"15326","51160","2014",17,17,0,175784.1,1774.882,101.7647
"15327","51161","2014",7,7,0,147287.9,1642.143,90.28571
"15328","51163","2014",4,4,0,104625,1005.5,130.25
"15329","51167","2014",1,1,0,120000,1200,100
"15330","51168","2014",2,2,0,151500,1435.5,104.5
"15331","51170","2014",3,3,0,94100,1187.333,78.33333
"15332","51171","2014",12,12,0,165250,1591.333,108.6667
"15333","51172","2014",46,39,7,242060.7,2425.196,98.30435
"15334","51175","2014",1,1,0,49471,495,100
"15335","51177","2014",3,3,0,366033.3,3160,131.6667
"15336","51181","2014",3,3,0,202666.7,2647,76
"15337","51182","2014",1,1,0,84000,1750,48
"15338","51183","2014",7,7,0,225592.9,2653.571,95.85714
"15339","51184","2014",1,1,0,3e+05,1357,221
"15340","51187","2014",5,5,0,152640,2226,71
"15341","51188","2014",1,1,0,365000,2645,138
"15342","51191","2014",2,2,0,73685,820.5,88.5
"15343","51193","2014",18,18,0,195930.6,1775.389,115.6111
"15344","51194","2014",5,5,0,143600,1648,92.4
"15345","51195","2014",6,6,0,126475,1342,96
"15346","51196","2014",7,6,1,140942.9,1404.429,97.71429
"15347","51198","2014",6,6,0,172666.7,1744.167,103.1667
"15348","51199","2014",4,4,0,139500,1217,112.25
"15349","51200","2014",6,6,0,176286.7,2493.833,90.33333
"15350","51201","2014",1,1,0,125500,738,170
"15351","51202","2014",7,7,0,174357.1,1583.429,130.7143
"15352","51203","2014",1,1,0,255650,1682,152
"15353","51205","2014",3,3,0,182333.3,1721.667,107.3333
"15354","51206","2014",3,3,0,131483.3,1090,128.3333
"15355","51208","2014",2,2,0,147000,1518.5,98.5
"15356","51212","2014",1,1,0,63500,713,89
"15357","51213","2014",1,1,0,90000,1125,80
"15358","51214","2014",1,1,0,112000,1018,110
"15359","51216","2014",1,1,0,167000,1590,105
"15360","51218","2014",1,1,0,196350,1044,188
"15361","51220","2014",1,1,0,335000,1106,303
"15362","51225","2014",2,2,0,225000,1986.5,111.5
"15363","51226","2014",1,1,0,62000,729,85
"15364","51227","2014",6,6,0,186100,1422,134.5
"15365","51230","2014",220,106,114,136751.6,1744.486,78.49545
"15366","51231","2014",7,7,0,156371.4,1691.571,91.14286
"15367","51238","2014",5,5,0,70200,841.4,88.6
"15368","51242","2014",38,35,3,139768.4,1487.395,94.34211
"15369","51244","2014",1,1,0,133000,1177,113
"15370","51245","2014",3,3,0,172600,1854.667,95
"15371","51248","2014",17,17,0,105805.9,1163,91.52941
"15372","51250","2014",31,30,1,135924.2,1633.032,83.09677
"15373","51251","2014",2,2,0,335250,2081,161
"15374","51262","2014",19,19,0,129531.6,1423.842,92.68421
"15375","51264","2014",2,2,0,97500,1308.5,75
"15376","51266","2014",3,3,0,242366.7,1665.333,146
"15377","51267","2014",1,1,0,267000,2263,118
"15378","51268","2014",2,2,0,130000,1408,93.5
"15379","51272","2014",6,6,0,138595.3,1996.5,95.16667
"15380","51273","2014",1,1,0,155000,1220,127
"15381","51278","2014",1,1,0,175000,1989,88
"15382","51281","2014",6,6,0,212500,1896.667,113
"15383","51282","2014",11,10,1,309900,2674.727,112.6364
"15384","51286","2014",1,1,0,158707,1167,136
"15385","51289","2014",1,1,0,95000,905,105
"15386","51290","2014",1,1,0,106400,1157,92
"15387","51291","2014",10,10,0,200195,1762.3,111.3
"15388","51295","2014",1,1,0,128000,1113,115
"15389","51299","2014",8,8,0,171902.5,1488.25,118.5
"15390","51301","2014",2,2,0,210000,1028,208
"15391","51302","2014",2,2,0,232500,1666,139.5
"15392","51303","2014",7,7,0,121038.6,1203.286,99.71429
"15393","51304","2014",1,1,0,95000,748,127
"15394","51307","2014",5,5,0,152340,1217,132.8
"15395","51308","2014",16,16,0,238068.8,1903.062,133.4375
"15396","51311","2014",2,2,0,51500,824,70
"15397","51312","2014",9,9,0,217962.2,1645.222,141.8889
"15398","51314","2014",1,1,0,215000,1629,132
"15399","51315","2014",1,1,0,90000,1552,58
"15400","51317","2014",1,1,0,115500,1100,105
"15401","51318","2014",6,6,0,369326.2,2478.833,157.5
"15402","51321","2014",1,1,0,29700,495,60
"15403","51325","2014",1,1,0,251900,1298,194
"15404","51326","2014",7,7,0,148228.6,1531,99.71429
"15405","51327","2014",2,2,0,92600,1053,98.5
"15406","51328","2014",9,9,0,129765.6,1351.667,95.22222
"15407","51329","2014",6,6,0,209411.7,2030,101.3333
"15408","51333","2014",6,6,0,246350,1981.833,126.8333
"15409","51334","2014",2,2,0,92000,1044.5,87
"15410","51338","2014",10,10,0,141350,1515.7,95.2
"15411","51340","2014",2,2,0,64500,1236.5,55
"15412","51342","2014",1,1,0,231500,2411,96
"15413","51344","2014",14,14,0,179403.6,2525.429,84.07143
"15414","51352","2014",4,4,0,118750,1182.75,102
"15415","51354","2014",4,4,0,91375,946.25,96.5
"15416","51357","2014",2,2,0,179155,1495,123.5
"15417","51359","2014",4,4,0,153000,1798.5,87
"15418","51362","2014",8,8,0,209717.5,1842.375,120.125
"15419","51364","2014",2,2,0,137000,1624.5,82
"15420","51365","2014",9,9,0,318466.7,2340.778,131.4444
"15421","51367","2014",7,7,0,175228.6,1737.286,102.5714
"15422","51370","2014",2,2,0,65250,678.5,93.5
"15423","51372","2014",6,6,0,203391.7,1746.5,116.8333
"15424","51375","2014",3,3,0,235833.3,2339.333,101.3333
"15425","51379","2014",5,5,0,223178,1651.8,139.2
"15426","51380","2014",26,26,0,119800,1182.769,107.1923
"15427","51382","2014",1,1,0,96000,1500,64
"15428","51384","2014",5,5,0,157000,1490.2,99.4
"15429","51386","2014",1,1,0,70000,959,73
"15430","51387","2014",2,2,0,193250,1510,129.5
"15431","51388","2014",15,14,1,158506.7,1718.8,101.2
"15432","51389","2014",3,3,0,108766.7,1366.333,78.66667
"15433","51390","2014",3,3,0,215333.3,1574.667,138.6667
"15434","51391","2014",19,19,0,199218.4,2133.474,94.36842
"15435","51393","2014",4,4,0,238471,1835,123.75
"15436","51397","2014",3,3,0,98666.67,1081,95.66667
"15437","51398","2014",2,2,0,132500,2343.5,71.5
"15438","51399","2014",1,1,0,107000,669,160
"15439","51403","2014",5,5,0,181200,1775.8,100.8
"15440","51413","2014",5,5,0,202540,1778.8,118.8
"15441","51414","2014",3,3,0,122166.7,1112,113
"15442","51415","2014",2,2,0,134630,1182.5,117
"15443","51418","2014",3,3,0,322566.7,2227.333,144
"15444","51422","2014",3,3,0,316466.7,1981,151.3333
"15445","51425","2014",2,2,0,48500,630,84.5
"15446","51428","2014",1,1,0,175000,1535,114
"15447","51429","2014",2,2,0,117700,1097.5,85.5
"15448","51431","2014",13,12,1,166442.3,1779.923,92.92308
"15449","51433","2014",1,1,0,145800,959,152
"15450","51434","2014",6,6,0,172916.7,1441.667,118
"15451","51435","2014",1,1,0,70000,722,97
"15452","51438","2014",2,2,0,116500,1219.5,92.5
"15453","51439","2014",7,2,5,119714.3,1129,100
"15454","51440","2014",9,9,0,139669.8,1463.444,95.11111
"15455","51441","2014",1,1,0,91800,1224,75
"15456","51442","2014",1,1,0,83780,2539,33
"15457","51444","2014",5,5,0,189682.6,2072.2,92.2
"15458","51445","2014",2,2,0,174400,1255.5,133.5
"15459","51446","2014",8,8,0,116488.9,1231.75,98
"15460","51447","2014",4,4,0,156950,1802.75,87
"15461","51448","2014",6,6,0,142416.7,1940,71.66667
"15462","51449","2014",8,8,0,353403.2,3331.75,124.25
"15463","51450","2014",5,5,0,226900,2206,117.2
"15464","51453","2014",6,6,0,213433.3,1703,126.1667
"15465","51454","2014",1683,431,1252,147060.2,2139.819,69.81165
"15466","51455","2014",4,4,0,130750,1348.5,97.5
"15467","51458","2014",2,2,0,121000,1030,127.5
"15468","51460","2014",3,3,0,88000,1109.333,92.33333
"15469","51461","2014",9,9,0,211294.4,1770.889,118.7778
"15470","51464","2014",2,2,0,183700,1523,119.5
"15471","51466","2014",4,4,0,89875,931.75,89.75
"15472","51468","2014",7,7,0,392414.3,2126.143,184.2857
"15473","51471","2014",4,4,0,227175,1691.5,140.5
"15474","51472","2014",7,7,0,175511.4,1221.714,142
"15475","51474","2014",18,11,7,204580.6,2283.333,91.72222
"15476","51476","2014",8,7,1,190775,1699.375,114.75
"15477","51477","2014",2,2,0,206350,1348.5,155
"15478","51478","2014",1,1,0,65000,663,98
"15479","51479","2014",1,1,0,308800,2595,119
"15480","51483","2014",1,1,0,213500,2033,105
"15481","51484","2014",1,1,0,160000,1032,155
"15482","51485","2014",1,1,0,1e+05,943,106
"15483","51486","2014",2,2,0,84800,982.5,106.5
"15484","51487","2014",2,2,0,76000,748,106
"15485","51491","2014",2,2,0,79000,1073,72.5
"15486","51496","2014",1,1,0,136000,1722,79
"15487","51501","2014",1,1,0,150000,1613,93
"15488","51504","2014",4,4,0,182750,1865.25,97
"15489","51505","2014",4,4,0,162025,1781.5,99.5
"15490","51506","2014",29,18,11,138923.6,1556.379,88.17241
"15491","51507","2014",31,29,2,98171.03,942.3871,104.5484
"15492","51509","2014",1,1,0,155000,951,163
"15493","51510","2014",2,2,0,131250,895,149.5
"15494","51515","2014",1,1,0,75000,708,106
"15495","51517","2014",2,2,0,125735,1087.5,120.5
"15496","51518","2014",5,5,0,172200,1615.4,121
"15497","51521","2014",2,2,0,79750,732.5,112
"15498","51522","2014",2,2,0,94000,1101,84
"15499","51523","2014",1,1,0,162000,1761,92
"15500","51525","2014",16,16,0,208935.1,1760.125,119.5
"15501","51526","2014",4,4,0,112000,1468,76.75
"15502","51527","2014",7,7,0,147857.1,1843.714,85.14286
"15503","51529","2014",1,1,0,213475,1525,140
"15504","51530","2014",5,5,0,177980,1835,100.6
"15505","51532","2014",6,6,0,142333.3,1839.667,78.33333
"15506","51534","2014",3,3,0,2e+05,1846.667,107.3333
"15507","51536","2014",9,9,0,208077.8,1996.778,107.2222
"15508","51542","2014",4,4,0,104250,855.25,117.5
"15509","51544","2014",4,4,0,141329.5,1173.5,129.25
"15510","51545","2014",6,6,0,103858.3,1194.167,87.5
"15511","51546","2014",4,4,0,174742.8,1373.75,132.75
"15512","51547","2014",1,1,0,140000,782,179
"15513","51548","2014",4,4,0,139712.5,1352.5,105.75
"15514","51552","2014",1,1,0,129000,746,173
"15515","51553","2014",1,1,0,172000,827,208
"15516","51555","2014",1,1,0,140000,725,193
"15517","51557","2014",4,4,0,104100,953.75,106.5
"15518","51559","2014",22,19,3,109877.7,1286.091,89.63636
"15519","51562","2014",17,17,0,226498.8,2016.647,113.1765
"15520","51566","2014",1,1,0,121000,1017,119
"15521","51568","2014",1,1,0,242500,2038,119
"15522","51569","2014",2,2,0,426700,2299.5,171.5
"15523","51570","2014",1,1,0,125000,893,140
"15524","51571","2014",9,8,1,189882.8,2042.556,98.22222
"15525","51572","2014",6,6,0,137166.3,1241.667,111.5
"15526","51573","2014",69,51,18,205271.9,2298.652,89.26087
"15527","51576","2014",13,13,0,162230.8,1547,107
"15528","51579","2014",2,2,0,66250,694,110.5
"15529","51580","2014",8,8,0,190525,1372.5,148.5
"15530","51581","2014",2,2,0,163250,1667.5,98
"15531","51582","2014",2,2,0,253865,2884,91.5
"15532","51584","2014",3,3,0,187666.7,2133.333,88.66667
"15533","51586","2014",2,2,0,225000,1875,120
"15534","51587","2014",1,1,0,199300,1594,125
"15535","51590","2014",4,4,0,71500,1066.5,69
"15536","51591","2014",1,1,0,188500,2094,90
"15537","51592","2014",3,3,0,167533.3,1647.333,103.6667
"15538","51595","2014",1,1,0,47000,734,64
"15539","51596","2014",6,6,0,136697.8,1244.667,127.6667
"15540","51598","2014",2,2,0,96750,807,119.5
"15541","51599","2014",1,1,0,256000,1766,145
"15542","51600","2014",2,2,0,188675,1498,133
"15543","51601","2014",1,1,0,120000,1818,66
"15544","51604","2014",4,4,0,168800,1403.5,121.75
"15545","51610","2014",4,4,0,118000,1003.25,116
"15546","51612","2014",24,22,2,142891.7,1539.042,99
"15547","51613","2014",10,10,0,149435,1723.6,100.5
"15548","51614","2014",3,3,0,126000,1341,96.33333
"15549","51617","2014",5,5,0,200700,1916.2,105.6
"15550","51622","2014",1,1,0,260000,1494,174
"15551","51624","2014",5,5,0,166700,1630,103.2
"15552","51626","2014",1,1,0,58500,1393,42
"15553","51627","2014",3,3,0,187666.7,1287,172.3333
"15554","51629","2014",2,2,0,252500,1999.5,123
"15555","51630","2014",4,4,0,130500,1502.25,86.25
"15556","51631","2014",1,1,0,160000,1569,102
"15557","51632","2014",3,3,0,88200,751.3333,120.6667
"15558","51633","2014",1,1,0,183000,1664,110
"15559","51634","2014",1,1,0,157000,1869,84
"15560","51636","2014",4,4,0,129625,1616,80.25
"15561","51640","2014",1,1,0,80600,677,119
"15562","51643","2014",5,4,1,159240,1957.4,84.6
"15563","51646","2014",1,1,0,42500,590,72
"15564","51647","2014",9,9,0,119491.7,1523.889,82.77778
"15565","51649","2014",54,31,23,92604.52,1082.241,88.12963
"15566","51654","2014",1,1,0,139250,1002,139
"15567","51655","2014",2,2,0,272000,1697,160
"15568","51656","2014",5,5,0,157600,1550.6,105.2
"15569","51657","2014",2,2,0,248500,2817.5,80
"15570","51660","2014",24,24,0,168347.9,1732.292,100.1667
"15571","51662","2014",46,36,10,195657.8,1962.304,99.47826
"15572","51663","2014",9,8,1,154144.4,1772.778,91.77778
"15573","52006","2014",4,4,0,85775,1015,87.75
"15574","52021","2014",1,1,0,111000,1088,102
"15575","52034","2014",2,2,0,58932.5,833,70.5
"15576","52045","2014",14,14,0,126942.9,1469.286,91.14286
"15577","52060","2014",14,14,0,64100,638.5714,97.71429
"15578","52061","2014",2,2,0,36000,476,75
"15579","52072","2014",3,3,0,91666.67,1073,84.66667
"15580","52079","2014",4,4,0,38000,615.5,60.75
"15581","52088","2014",3,3,0,130566.7,1019.667,117.6667
"15582","52093","2014",16,15,1,98987.5,1166.375,88.125
"15583","52104","2014",7,7,0,141278.6,1487,102.7143
"15584","52114","2014",16,16,0,84856.25,816.5625,107.8125
"15585","52121","2014",188,128,60,105454.6,1181.878,89.49468
"15586","52125","2014",7,7,0,142785.7,1344.857,109.4286
"15587","52140","2014",2,2,0,147875,1742.5,85.5
"15588","52141","2014",4,4,0,107000,1314,84
"15589","52158","2014",4,4,0,101750,980.5,119.25
"15590","52171","2014",1,1,0,90000,968,93
"15591","52175","2014",4,4,0,102192.5,1081,96.25
"15592","52182","2014",9,9,0,138477.8,1264.778,119.4444
"15593","52193","2014",2,2,0,66187,484.5,136.5
"15594","52206","2014",2,2,0,103900,897,113.5
"15595","52235","2014",2,2,0,96175,852,122
"15596","52244","2014",6,6,0,128166.7,1289,102.6667
"15597","52250","2014",23,19,4,73917.39,865.9565,87.69565
"15598","52251","2014",7,7,0,142142.9,1200.429,118.4286
"15599","52269","2014",53,36,17,105973,1282.019,93.49057
"15600","52276","2014",1,1,0,32800,1025,32
"15601","52294","2014",5,5,0,146000,1334.8,111.6
"15602","52300","2014",2,2,0,69500,691.5,100
"15603","52327","2014",3,3,0,171666.7,1762.333,98.33333
"15604","52331","2014",10,10,0,108400,1122.7,97
"15605","52341","2014",1,1,0,79100,989,80
"15606","52386","2014",6,6,0,67833.33,937,95.83333
"15607","52391","2014",3,3,0,142633.3,1248,115
"15608","52411","2014",14,14,0,76678.57,1058.429,77.78571
"15609","52419","2014",1,1,0,160000,1119,143
"15610","52421","2014",2,2,0,153500,1111.5,140
"15611","52426","2014",1,1,0,35000,522,67
"15612","52448","2014",156,113,43,95962.18,1204.519,80.62821
"15613","52469","2014",3,1,2,103433.3,882,123
"15614","52475","2014",1,1,0,138500,1099,126
"15615","52479","2014",4,4,0,121475,1118.5,125.25
"15616","52480","2014",2,2,0,49500,397,124.5
"15617","52494","2014",4,4,0,228625,1608,149.75
"15618","52497","2014",3,3,0,68433.33,635.3333,104.6667
"15619","52500","2014",10,10,0,131650,1401.6,96.6
"15620","52502","2014",1,1,0,140000,864,162
"15621","52510","2014",5,5,0,99460,856.4,120.4
"15622","52522","2014",1,1,0,119000,717,166
"15623","52528","2014",2,2,0,30000,764.5,42
"15624","52534","2014",14,14,0,90253.57,1125.357,84.71429
"15625","52535","2014",5,5,0,143660,1404,104.2
"15626","52543","2014",9,9,0,118299.4,1188.333,102.1111
"15627","52548","2014",1,1,0,75000,568,132
"15628","52550","2014",10,10,0,77343,626.8,122
"15629","53001","2014",16,16,0,135627.8,1461.375,90.25
"15630","53002","2014",5,5,0,132657.6,1087.6,120
"15631","53003","2014",34,34,0,100006.5,1042.647,97.05882
"15632","53005","2014",22,22,0,121690.9,1114.545,109.7273
"15633","53007","2014",18,18,0,152870.3,1485.944,104.6111
"15634","53008","2014",11,11,0,126930,1299.182,92.72727
"15635","53009","2014",1,1,0,110000,1467,75
"15636","53010","2014",3,3,0,93833.33,1660.667,57
"15637","53011","2014",10,9,1,96500,1058.2,94.8
"15638","53012","2014",5,5,0,110626.8,1105.2,101.8
"15639","53013","2014",4,4,0,58339.5,877.25,67.5
"15640","53015","2014",22,22,0,117340.9,1378.955,90.72727
"15641","53016","2014",9,8,1,85777.78,1156,73.11111
"15642","53017","2014",6,6,0,90500,912.5,98
"15643","53018","2014",11,11,0,93409.09,1172.727,89
"15644","53021","2014",6,6,0,180403,1376.833,132.3333
"15645","53022","2014",4,4,0,118250,1068,112.25
"15646","53023","2014",3,3,0,190000,4064,59
"15647","53025","2014",5,5,0,96060,1295.4,91.2
"15648","53026","2014",4,4,0,104300,921.75,114.25
"15649","53027","2014",2,2,0,90000,1075,83.5
"15650","53029","2014",13,13,0,117826.9,1191.692,103.5385
"15651","53030","2014",2,2,0,50000,977.5,78.5
"15652","53031","2014",4,4,0,111782.5,1067.5,108
"15653","53033","2014",1,1,0,65000,677,96
"15654","53034","2014",44,44,0,187667.4,1899.341,99.43182
"15655","53035","2014",2,2,0,75000,803.5,80
"15656","53036","2014",7,7,0,57671.43,786.2857,68.42857
"15657","53037","2014",4,4,0,90250,963.75,96
"15658","53038","2014",2,2,0,85000,1088,93.5
"15659","53039","2014",16,16,0,125375,1317,96.875
"15660","53040","2014",3,3,0,83333.33,1420.667,71.66667
"15661","53041","2014",4,4,0,94400,1007.5,93.75
"15662","53042","2014",5,5,0,65000,1205.6,62.2
"15663","53043","2014",2,2,0,110000,1278.5,86
"15664","53045","2014",6,6,0,131333.3,1853.333,75
"15665","53046","2014",1,1,0,61000,924,66
"15666","53047","2014",6,6,0,95396.67,1034,93
"15667","53048","2014",8,8,0,116163,1301.125,89.625
"15668","53049","2014",3,3,0,148666.7,1546.667,97.33333
"15669","53051","2014",4,4,0,118750,1486.25,80.75
"15670","53052","2014",3,3,0,83000,1047,82.33333
"15671","53053","2014",5,5,0,76000,1138.2,71.4
"15672","53054","2014",45,44,1,211096.4,1826.356,115.8667
"15673","53055","2014",7,7,0,68714.29,907.4286,74.85714
"15674","53056","2014",6,6,0,148083.3,1605.5,92.5
"15675","53057","2014",4,4,0,68500,1022.25,72
"15676","53058","2014",2,2,0,93500,834.5,116.5
"15677","53059","2014",6,6,0,158666.7,1637,101.3333
"15678","53061","2014",4,4,0,65043.25,782.75,81
"15679","53062","2014",154,138,16,120550.4,1292.688,92.82468
"15680","53063","2014",2,2,0,235000,1258.5,187.5
"15681","53064","2014",4,4,0,96500,1033.25,85.75
"15682","53066","2014",16,16,0,119023.6,1458.75,83.875
"15683","53067","2014",3,3,0,86000,1154.667,81.66667
"15684","53068","2014",2,2,0,71982.5,760,92
"15685","53069","2014",6,6,0,81973.33,809.6667,101.8333
"15686","53071","2014",12,12,0,90143.58,1113.25,82.33333
"15687","53072","2014",10,10,0,113650,1121.7,102.4
"15688","53073","2014",6,6,0,89083.33,857.1667,93.33333
"15689","53074","2014",8,8,0,114200,997,123
"15690","53075","2014",3,3,0,129666.7,915.3333,147
"15691","53076","2014",3,3,0,119666.7,1256,91.33333
"15692","53077","2014",30,30,0,119650,1182.633,105.6
"15693","53078","2014",10,10,0,131644,1430.1,95.3
"15694","53079","2014",11,11,0,100240.9,902.4545,109.0909
"15695","53082","2014",3,3,0,87300,1047.667,83.33333
"15696","53083","2014",5,5,0,126522,958,124.2
"15697","53084","2014",43,43,0,120421.5,1164.512,102.4186
"15698","53086","2014",4,4,0,146875,1523.25,108
"15699","53087","2014",1,1,0,20200,396,51
"15700","53088","2014",4,4,0,119925,936.5,131
"15701","53089","2014",6,6,0,91591.67,1109,81.33333
"15702","53091","2014",5,5,0,67800,907.2,81.2
"15703","53093","2014",1,1,0,115000,1250,92
"15704","53094","2014",3,3,0,148333.3,1833.667,85
"15705","53096","2014",38,38,0,110052.1,1149.789,96.55263
"15706","53097","2014",51,49,2,111986.3,1174.902,94.98039
"15707","53098","2014",5,5,0,95736.4,1125.2,85
"15708","53099","2014",5,5,0,127200,1372,96.4
"15709","53100","2014",21,21,0,82966.29,888.619,93.33333
"15710","53101","2014",9,9,0,106388.9,1202,94.22222
"15711","53102","2014",3,3,0,90000,989.6667,110.6667
"15712","53103","2014",21,21,0,119266.7,1319.81,89.04762
"15713","53104","2014",18,18,0,133061.1,1106.167,117.6111
"15714","53106","2014",7,7,0,92060.14,1039.857,90.57143
"15715","53107","2014",25,24,1,82661.6,936.84,92.88
"15716","53108","2014",4,4,0,78525,990.5,79.25
"15717","53109","2014",4,4,0,117750,1172.5,103.75
"15718","53110","2014",10,10,0,77050,831.6,94
"15719","53111","2014",5,5,0,118300,1069.6,111
"15720","53112","2014",5,5,0,58177.2,710.2,83.6
"15721","53113","2014",5,5,0,104200,1166.4,85.6
"15722","53114","2014",2,2,0,82500,1881.5,69
"15723","53115","2014",2,2,0,138983,2896,43
"15724","53116","2014",5,5,0,70400,755.6,89.6
"15725","53117","2014",4,4,0,157000,1013,145.25
"15726","53118","2014",2,2,0,86800,829.5,108
"15727","53119","2014",27,27,0,180766.9,1567.889,117.6667
"15728","53120","2014",4,4,0,107400,1256.5,81.5
"15729","53121","2014",12,12,0,104600,1044.667,98
"15730","53122","2014",8,8,0,85587.5,1112.5,77.125
"15731","53123","2014",15,15,0,114777.5,1222.133,96.2
"15732","53124","2014",10,10,0,99800,1027.8,96
"15733","53125","2014",11,11,0,101590.9,956.5455,95.81818
"15734","53126","2014",12,11,1,80845.92,1224.833,91.41667
"15735","53127","2014",26,26,0,96425,805.6154,116.6154
"15736","53128","2014",2,2,0,80250,1270,64
"15737","53129","2014",2,2,0,106500,895.5,121.5
"15738","53130","2014",555,277,278,121417,1476.912,81.16396
"15739","53131","2014",3,3,0,81000,825,96.66667
"15740","53132","2014",1,1,0,18000,333,54
"15741","53133","2014",8,8,0,69062.5,684.375,97.5
"15742","53135","2014",9,9,0,106111.1,988.4444,101.6667
"15743","53136","2014",6,6,0,120416.7,1139.833,98.16667
"15744","53137","2014",14,14,0,108821.4,1313.357,88
"15745","53139","2014",3,3,0,93000,767.6667,120
"15746","53140","2014",24,24,0,168285.2,1657.375,101.1667
"15747","53141","2014",7,7,0,160428.6,1684,94.57143
"15748","53142","2014",9,9,0,77855.56,1070.333,81.33333
"15749","53143","2014",2,2,0,47500,1333.5,38.5
"15750","53144","2014",5,5,0,99900,947.2,105.4
"15751","53145","2014",2,2,0,159500,1084,131.5
"15752","53146","2014",14,14,0,139785.7,1337,114.1429
"15753","53147","2014",95,75,20,112935.3,1309.189,91.07368
"15754","53148","2014",2,2,0,190500,1360.5,141
"15755","53150","2014",5,5,0,101500,1301.6,77.8
"15756","53151","2014",8,8,0,80500,906.25,96.75
"15757","53152","2014",15,14,1,102926.3,1156.067,90.33333
"15758","53153","2014",8,8,0,95875,1102.25,85.375
"15759","53154","2014",11,11,0,90709.09,970,91.27273
"15760","53155","2014",7,7,0,112428.6,1261.857,87.14286
"15761","53156","2014",2,2,0,77500,1124,71
"15762","53157","2014",8,8,0,148148.2,1461.75,109.875
"15763","53158","2014",9,9,0,132865.3,1098.667,113.6667
"15764","53160","2014",2,2,0,76000,772,100
"15765","53161","2014",34,34,0,109546,1202.971,96.41176
"15766","53162","2014",8,7,1,127137.5,1499.75,82.375
"15767","53163","2014",4,4,0,87375,847.75,101.5
"15768","53168","2014",12,12,0,168833.3,1336.25,121.5833
"15769","53169","2014",5,5,0,142280,1695,93.8
"15770","53170","2014",6,6,0,112833.3,1269.333,86.33333
"15771","53172","2014",1,1,0,120000,1165,103
"15772","53173","2014",1,1,0,45000,625,72
"15773","53174","2014",2,2,0,153500,1220,129.5
"15774","53175","2014",9,9,0,116173.1,1143.333,99.44444
"15775","53176","2014",5,5,0,100260,1109.4,90.6
"15776","53178","2014",6,6,0,87900,966.5,93.5
"15777","53179","2014",2,2,0,93750,1144.5,87.5
"15778","53180","2014",8,8,0,88103.75,1134,83.75
"15779","53181","2014",6,5,1,61883.33,711.1667,87.16667
"15780","53182","2014",20,19,1,70665,896.75,77.35
"15781","53185","2014",17,17,0,82135.29,898.9412,91.82353
"15782","53186","2014",19,19,0,105114.2,1229.947,86.36842
"15783","53188","2014",22,21,1,90195.45,1073.409,78.86364
"15784","53190","2014",5,5,0,95314,993,109
"15785","53191","2014",2,2,0,67500,797,98.5
"15786","53192","2014",3,3,0,58979,1289,45
"15787","53193","2014",7,7,0,189814.3,1656.286,115.5714
"15788","53195","2014",4,4,0,112000,1074.5,100.25
"15789","53196","2014",3,3,0,68533.33,1154,66
"15790","53197","2014",6,6,0,118333.3,985.3333,124
"15791","53199","2014",5,5,0,81798.2,1100.6,78.2
"15792","53200","2014",8,8,0,164687.5,1520.375,103.75
"15793","53201","2014",61,56,5,157665.1,1597.443,97.16393
"15794","53202","2014",5,5,0,94833,795.2,121.4
"15795","53203","2014",7,7,0,102485.7,905.2857,108.5714
"15796","53204","2014",4,4,0,68000,811.75,92
"15797","53208","2014",5,5,0,93800,827.2,115.2
"15798","53209","2014",5,5,0,83400,1120.6,71.4
"15799","53210","2014",16,16,0,131962.5,1120,108.6875
"15800","53211","2014",14,14,0,89702.14,896.4286,103.7143
"15801","53212","2014",2,2,0,115000,1051,102
"15802","53213","2014",5,5,0,87960,981.2,92.2
"15803","53214","2014",1,1,0,68000,773,88
"15804","53216","2014",4,4,0,57500,748.5,76.5
"15805","53218","2014",9,9,0,100270.6,1334.444,77.77778
"15806","53219","2014",15,14,1,103806.7,1210.333,83.2
"15807","53220","2014",4,4,0,132750,805,149
"15808","53221","2014",3,3,0,110000,1533.333,73.66667
"15809","53222","2014",1,1,0,46210,680,68
"15810","53223","2014",3,3,0,115400,823.6667,131.3333
"15811","53224","2014",7,6,1,118591.4,1254,101
"15812","53225","2014",6,6,0,108500,1090,91.66667
"15813","53226","2014",4,4,0,180429.8,1942,94.5
"15814","53228","2014",8,8,0,139750,1138.625,130.25
"15815","53229","2014",9,8,1,127444.4,1407.444,98.22222
"15816","53230","2014",4,4,0,49750,614.5,82
"15817","53232","2014",3,3,0,96666.67,1049.667,89
"15818","53233","2014",3,3,0,82333.33,1049,77.66667
"15819","53235","2014",1,1,0,1e+05,752,133
"15820","53236","2014",1,1,0,55000,1019,54
"15821","53237","2014",3,3,0,65500,600,100.3333
"15822","53238","2014",2,2,0,51350,1075.5,68.5
"15823","53240","2014",1,1,0,30000,429,70
"15824","53243","2014",12,12,0,134841.7,1329.417,99.83333
"15825","53245","2014",13,13,0,78730.77,884.0769,93
"15826","53246","2014",20,20,0,101997.5,1241.85,85.65
"15827","53247","2014",22,22,0,111663.6,1306.318,88.31818
"15828","53248","2014",5,5,0,125104.8,1894,69.8
"15829","53249","2014",9,9,0,87755.56,1031.778,81.11111
"15830","53250","2014",2,2,0,62500,592.5,114.5
"15831","53251","2014",5,5,0,125344.6,1097,115.2
"15832","53253","2014",4,4,0,98002.75,820.5,111.25
"15833","53255","2014",12,12,0,115308.6,1285.5,96.33333
"15834","53256","2014",5,5,0,126460,1192.2,111.8
"15835","53257","2014",2,2,0,62500,808.5,78
"15836","53258","2014",10,10,0,130490,1305.4,97.6
"15837","53259","2014",1,1,0,96750,484,200
"15838","53260","2014",4,4,0,85500,909,92.75
"15839","53261","2014",1,1,0,50000,694,72
"15840","53262","2014",12,12,0,121358.3,1078.5,113.0833
"15841","53263","2014",1,1,0,110000,1222,90
"15842","53264","2014",2,2,0,111500,705,127.5
"15843","53265","2014",13,12,1,113177.1,1166.385,105.9231
"15844","53266","2014",4,4,0,42142.5,699.5,68.25
"15845","53267","2014",15,15,0,66111.13,852.2,78.66667
"15846","53269","2014",11,11,0,77590.91,974.0909,77.72727
"15847","53271","2014",14,13,1,87923.29,917.4286,95.42857
"15848","53272","2014",2,2,0,61250,1576.5,54
"15849","53273","2014",14,14,0,102035.7,1305.714,84.92857
"15850","53276","2014",7,7,0,73814.29,914.7143,78.14286
"15851","54001","2014",1,1,0,145000,1667,87
"15852","54002","2014",2,1,1,108900,773,159.5
"15853","54004","2014",2,2,0,178550,1261.5,141
"15854","54006","2014",6,5,1,189256.7,1423,136.3333
"15855","54007","2014",7,7,0,159708.6,1365.857,123.1429
"15856","54008","2014",5,5,0,104718,997.2,104.4
"15857","54009","2014",3,3,0,98333.33,830,126.6667
"15858","54010","2014",2,2,0,119750,1128.5,104.5
"15859","54011","2014",6,5,1,158250,1235.667,119
"15860","54012","2014",1,1,0,167600,1309,128
"15861","54013","2014",1,1,0,85000,607,140
"15862","54014","2014",1,1,0,156000,2400,65
"15863","54015","2014",2,2,0,137000,1258.5,132.5
"15864","54018","2014",1,1,0,36000,514,70
"15865","54020","2014",4,4,0,159250,1541.75,112
"15866","54022","2014",6,6,0,139700,1115,129
"15867","54023","2014",2,2,0,94200,954.5,98
"15868","54024","2014",1,1,0,138400,1236,112
"15869","54025","2014",21,8,13,176637.3,2159.238,85.33333
"15870","54026","2014",2,2,0,111000,1007.5,113
"15871","54027","2014",5,5,0,155471,1355.2,118.8
"15872","54028","2014",36,27,9,84292.22,1057.111,80.25
"15873","54029","2014",22,15,7,137133.2,1438.591,101.6364
"15874","54031","2014",3,3,0,162390,1450.667,114.6667
"15875","54032","2014",3,3,0,195966.7,1266.333,139.3333
"15876","54033","2014",1,1,0,125000,1667,75
"15877","54034","2014",2,2,0,144000,1239.5,118
"15878","54035","2014",4,4,0,113662.5,1098.5,103.25
"15879","54036","2014",7,7,0,186868.6,1623.143,119.2857
"15880","54037","2014",3,3,0,194333.3,1824.667,105.6667
"15881","54038","2014",9,9,0,106777.8,1021.222,106.4444
"15882","54039","2014",31,26,5,87245.16,984.2258,93.51613
"15883","54040","2014",10,10,0,79780,797.2,106.3
"15884","54042","2014",4,3,1,112625,1096,103.25
"15885","54043","2014",9,5,4,144901.9,1476,98.11111
"15886","54044","2014",1,1,0,70000,778,90
"15887","54045","2014",6,5,1,155871.7,1280.833,120.8333
"15888","54046","2014",4,4,0,176225,1414,127
"15889","54047","2014",2,2,0,173675,1576.5,110
"15890","54048","2014",4,4,0,91575,986,94.5
"15891","54049","2014",3,3,0,101666.7,1260.333,81.66667
"15892","54051","2014",11,10,1,163310.5,1671.364,97.72727
"15893","54054","2014",13,11,2,135769.2,1271.462,116.2308
"15894","54055","2014",4,4,0,131577.5,962.5,153.5
"15895","54057","2014",1,1,0,150250,1105,136
"15896","54059","2014",8,7,1,147600,1024.625,143.75
"15897","54060","2014",14,14,0,121992.9,1452.071,86.57143
"15898","54062","2014",3,3,0,98000,816.3333,121.3333
"15899","54063","2014",1,1,0,60000,732,82
"15900","54064","2014",3,3,0,113566.7,740.3333,155.6667
"15901","54065","2014",5,5,0,1e+05,1113.2,88.4
"15902","54066","2014",3,3,0,195266.7,1764.333,113.3333
"15903","54067","2014",6,6,0,138152.8,1461.833,93.5
"15904","54069","2014",3,2,1,228500,2041.667,110
"15905","54070","2014",2,2,0,183500,1522,121
"15906","54072","2014",1,1,0,85000,810,105
"15907","54073","2014",4,4,0,145000,1324,124.25
"15908","54076","2014",35,30,5,121980.9,1319.086,97.05714
"15909","54077","2014",6,6,0,103733.3,928.6667,118.8333
"15910","54079","2014",32,22,10,113925,1277.688,91.84375
"15911","54080","2014",15,15,0,101798,1080.733,100.6
"15912","54081","2014",3,3,0,140370,1317.667,104.6667
"15913","54083","2014",2,2,0,141500,1082,130
"15914","54084","2014",10,10,0,109920,1159,92.2
"15915","54086","2014",4,4,0,121600,1044.75,127.25
"15916","54087","2014",3,3,0,64166.67,1005.667,71.66667
"15917","54088","2014",1,1,0,80500,488,165
"15918","54089","2014",8,8,0,141072.5,1381.5,106.625
"15919","54090","2014",34,30,4,169930.7,1768.294,98.11765
"15920","54091","2014",1,1,0,147200,1732,85
"15921","54092","2014",1,1,0,75000,1293,58
"15922","54093","2014",3,3,0,155666.7,1173,137.3333
"15923","54094","2014",2,2,0,160000,1139,143.5
"15924","54096","2014",5,5,0,232553.2,1556,157.6
"15925","54097","2014",1,1,0,60000,566,106
"15926","54099","2014",83,54,29,118057.2,1291.06,87.13253
"15927","54100","2014",8,8,0,118897.5,1230.25,107.625
"15928","54102","2014",4,4,0,132638.8,1081,120.75
"15929","54103","2014",1,1,0,126000,1537,82
"15930","54104","2014",6,6,0,136673,1307.833,98.83333
"15931","54105","2014",6,6,0,120754.2,829.6667,147.8333
"15932","54108","2014",1,1,0,69000,439,157
"15933","54109","2014",10,9,1,122675,1161.2,108.6
"15934","54110","2014",3,3,0,188500,1932.333,98.33333
"15935","54111","2014",26,24,2,144178,1553.846,89.92308
"15936","54112","2014",7,7,0,131931.4,1464.714,100.1429
"15937","54113","2014",6,6,0,146916.7,1609.833,89.5
"15938","54114","2014",1,1,0,101500,608,167
"15939","54115","2014",49,29,20,150651.5,1770.122,85.40816
"15940","54116","2014",15,13,2,140066.7,1265,112.7333
"15941","54118","2014",6,6,0,97000,909.6667,119.3333
"15942","54120","2014",4,4,0,119025,973,115.25
"15943","54121","2014",1,1,0,194000,2086,93
"15944","54122","2014",4,4,0,137453.8,1476.75,95.25
"15945","54123","2014",17,16,1,173601.2,1967.294,94.35294
"15946","54124","2014",1,1,0,95000,833,114
"15947","54125","2014",3,3,0,83000,654.6667,125.6667
"15948","54127","2014",2,2,0,267500,1518.5,182.5
"15949","54128","2014",8,8,0,147812.5,1370.125,118.75
"15950","54129","2014",12,12,0,77250,785,115.1667
"15951","54130","2014",1,1,0,45000,643,70
"15952","54131","2014",4,4,0,200750,1544.5,130.25
"15953","54132","2014",1,1,0,131400,1752,75
"15954","54133","2014",4,4,0,105825,646,162.25
"15955","54135","2014",11,11,0,106936.4,1054.182,102.1818
"15956","54136","2014",15,15,0,131357.3,1460.733,89.53333
"15957","54137","2014",5,5,0,129600,1491,87.8
"15958","54138","2014",29,26,3,180732.8,1740.31,109.6897
"15959","54139","2014",3,3,0,122500,1085,118.6667
"15960","54140","2014",2,2,0,125500,1110,113.5
"15961","54141","2014",1,1,0,85000,1133,75
"15962","54142","2014",1,1,0,147000,1633,90
"15963","54143","2014",4,3,1,155687.5,1240.25,134.5
"15964","54144","2014",1,1,0,219000,1460,150
"15965","54145","2014",6,4,2,99750,1121.333,104.5
"15966","54147","2014",1,1,0,65000,1548,42
"15967","54148","2014",11,11,0,120650.9,1237.636,110.4545
"15968","54149","2014",13,12,1,123507.7,1456.462,89.61538
"15969","54150","2014",26,21,5,152271.9,1713.462,88.57692
"15970","54151","2014",9,6,3,130759.4,1121,127.4444
"15971","54152","2014",27,25,2,151198.9,1418.222,105.7778
"15972","54153","2014",1,1,0,20000,1176,17
"15973","54154","2014",3,2,1,70666.67,1067,66.33333
"15974","54155","2014",1,1,0,1e+05,901,111
"15975","54156","2014",2,2,0,132500,1474.5,89.5
"15976","54157","2014",9,7,2,153755.6,1519.667,102.1111
"15977","54159","2014",82,72,10,152962.8,1525.037,102.8659
"15978","54160","2014",3,3,0,129000,1335,94
"15979","54162","2014",13,13,0,126145.7,1233,109.6154
"15980","54163","2014",2,2,0,175000,1224.5,131.5
"15981","54165","2014",9,9,0,227655.6,2158.778,111.5556
"15982","54167","2014",16,14,2,171014,1576.688,111.75
"15983","54168","2014",2,2,0,139500,2255.5,61.5
"15984","54169","2014",1,1,0,42000,700,60
"15985","54171","2014",11,9,2,124782.3,1047.909,119.6364
"15986","54172","2014",1,1,0,150000,1316,114
"15987","54174","2014",22,19,3,160404.5,1511.591,102.6818
"15988","54175","2014",4,4,0,119625,1041.25,151.75
"15989","54176","2014",5,4,1,102020,846.8,140
"15990","54178","2014",2,2,0,122325,819,149
"15991","54179","2014",7,7,0,158914.6,1031.571,167
"15992","54181","2014",4,4,0,101000,1242.75,81
"15993","54182","2014",4,3,1,141765,766,172.75
"15994","54184","2014",76,39,37,158927.9,1992.842,86.69737
"15995","54186","2014",6,6,0,281575,1943.667,164.5
"15996","54187","2014",1,1,0,109000,1090,100
"15997","54188","2014",16,15,1,149013.2,1332.875,113.1875
"15998","54189","2014",3,3,0,111800,841,130.3333
"15999","54191","2014",2,2,0,80900,605,134
"16000","54192","2014",1,1,0,147000,1838,80
"16001","54194","2014",9,8,1,131923.3,1106,131.4444
"16002","54195","2014",2,2,0,208500,1887.5,125
"16003","54196","2014",13,10,3,161061.5,1593.077,108
"16004","54197","2014",17,15,2,184973.5,1837.059,100.5882
"16005","54198","2014",3,3,0,65333.33,877.3333,74.66667
"16006","54199","2014",4,4,0,78000,1064.5,76
"16007","54200","2014",2,2,0,127750,824,156
"16008","54201","2014",3,3,0,84800,1020,82.33333
"16009","54202","2014",3,3,0,133766.7,1197,111
"16010","54203","2014",2,2,0,195330,1161,175
"16011","54204","2014",2,2,0,160000,1043.5,159.5
"16012","54205","2014",19,17,2,90620.26,1148.632,84.78947
"16013","54206","2014",3,3,0,171333.3,983.3333,187.3333
"16014","54207","2014",1,0,1,38000,458,83
"16015","54208","2014",4,4,0,70250,1320.5,73.75
"16016","54210","2014",2,2,0,84000,1123.5,80
"16017","54211","2014",2,2,0,131950,1516.5,88
"16018","54212","2014",6,6,0,99683.33,1044.5,98
"16019","54214","2014",5,5,0,168910,1418.6,122.4
"16020","54215","2014",56,41,15,142646.6,1544.036,92.03571
"16021","54217","2014",1,1,0,113000,1141,99
"16022","54221","2014",2,2,0,158680,1487,109
"16023","54222","2014",9,7,2,136291.1,1149.333,122.6667
"16024","54223","2014",3,3,0,110200,1071,98.33333
"16025","54224","2014",1,1,0,98700,1249,79
"16026","54225","2014",1,1,0,130000,793,164
"16027","54227","2014",12,12,0,117983.3,1242.75,94.58333
"16028","54229","2014",4,4,0,76512.5,947,83.75
"16029","54230","2014",1,1,0,35000,547,64
"16030","54231","2014",2,2,0,225000,1486.5,150
"16031","54232","2014",41,33,8,179269.6,1634.293,111.7561
"16032","54234","2014",12,8,4,140791.7,1515.75,91.5
"16033","54235","2014",4,4,0,137375,1389.5,97.5
"16034","54239","2014",3,2,1,122000,1126.333,108.3333
"16035","54241","2014",2,2,0,75000,1088.5,68
"16036","54243","2014",2,2,0,86250,684.5,122
"16037","54244","2014",2,2,0,144750,1320.5,106.5
"16038","54245","2014",1,1,0,178950,1243,144
"16039","54247","2014",2,2,0,63750,861,80.5
"16040","54249","2014",3,3,0,114300,1075,106.6667
"16041","54250","2014",6,6,0,176261.3,1534,118.1667
"16042","54251","2014",1,1,0,27800,386,72
"16043","54252","2014",1,1,0,55000,567,97
"16044","54253","2014",9,6,3,122155.6,1392.444,86.88889
"16045","54254","2014",29,24,5,176575.2,1578.414,112.0345
"16046","54256","2014",2,2,0,172000,1051.5,186.5
"16047","54257","2014",40,34,6,196548,2173.425,94.475
"16048","54259","2014",2,2,0,90000,1187,91
"16049","54260","2014",5,5,0,151830,1503.2,101.6
"16050","54261","2014",42,26,16,117104.4,1226.214,96.95238
"16051","54262","2014",1,0,1,90000,600,150
"16052","54263","2014",55,47,8,80720.55,1043.127,78.27273
"16053","54264","2014",2,2,0,117000,1141,96.5
"16054","54265","2014",13,11,2,216523.1,2097.385,102.3846
"16055","54266","2014",4,4,0,136760,1431,97.75
"16056","54268","2014",2,2,0,60000,561,101
"16057","54269","2014",2,2,0,167500,1696,107
"16058","54270","2014",23,18,5,115404.6,1430.652,80.78261
"16059","54272","2014",4,4,0,209350,1291.25,159.75
"16060","54273","2014",71,58,13,115904.9,1263.296,91.47887
"16061","54274","2014",84,40,44,123810.5,1682.607,71.79762
"16062","54275","2014",1,1,0,167000,1012,165
"16063","54276","2014",1,1,0,65000,1444,45
"16064","54277","2014",5,5,0,97200,940,119.8
"16065","54279","2014",7,7,0,212752.9,1678,133.2857
"16066","54280","2014",71,51,20,74582.38,950.3521,78.28169
"16067","54281","2014",7,7,0,119714.3,1192,103.1429
"16068","54283","2014",1,1,0,209500,2095,100
"16069","54284","2014",8,8,0,70487.5,749.25,91
"16070","54286","2014",9,8,1,123422.2,1623.111,77.11111
"16071","54287","2014",3,3,0,110766.7,1117.667,99
"16072","54288","2014",5,5,0,147360,1523.2,98.8
"16073","54289","2014",5,3,2,208424,1482.2,147.4
"16074","54290","2014",1,1,0,70000,1250,56
"16075","54291","2014",3,3,0,103900,815,130.3333
"16076","54292","2014",1,1,0,180500,1337,135
"16077","54293","2014",2,2,0,148910,1236,116.5
"16078","54295","2014",8,7,1,130375,1283.875,102
"16079","54296","2014",3,2,1,169483.3,1336.667,122.6667
"16080","54297","2014",5,5,0,127560,1099.8,115.6
"16081","54298","2014",2,2,0,115000,921,115
"16082","54299","2014",1,1,0,247000,1703,145
"16083","54300","2014",48,37,11,181175.3,1895.042,96.29167
"16084","54301","2014",2,2,0,89500,1318,64
"16085","54302","2014",4,4,0,182467.5,1767.5,105.25
"16086","54304","2014",126,41,85,150183.9,1771.46,82.95238
"16087","54305","2014",12,12,0,226143.8,2092.167,123.75
"16088","54306","2014",3,3,0,131533.3,879.6667,155.3333
"16089","54307","2014",2,2,0,138500,1165.5,117.5
"16090","54309","2014",2,2,0,43125,690.5,74
"16091","54311","2014",7,7,0,203974.3,1503.857,134.8571
"16092","54312","2014",3,3,0,194350,1609.333,120.3333
"16093","54314","2014",23,20,3,193969.2,1844.826,105.2174
"16094","54315","2014",8,8,0,133000,1212.25,111.625
"16095","54316","2014",2,2,0,228575,1725.5,131.5
"16096","54317","2014",1,1,0,55000,567,97
"16097","54318","2014",56,51,5,146792.4,1434.768,104.9643
"16098","54320","2014",2,2,0,132550,1122,117.5
"16099","54321","2014",12,8,4,110268.2,1462.167,73.66667
"16100","54322","2014",52,43,9,117895.5,1170,105.6346
"16101","54323","2014",112,67,45,117295.2,1352,92.04464
"16102","54325","2014",1,1,0,211500,1322,160
"16103","54326","2014",2,2,0,109000,1499,78.5
"16104","54327","2014",9,9,0,142152.2,1148.333,125.3333
"16105","54328","2014",50,40,10,196930.4,1926.68,103.04
"16106","54329","2014",141,78,63,104319.6,1094.092,93.12057
"16107","54330","2014",2,2,0,231200,1944,118.5
"16108","54331","2014",3,3,0,113000,1120,94.66667
"16109","54332","2014",16,12,4,153862.5,1579.875,102.25
"16110","54333","2014",1,1,0,85000,766,111
"16111","54334","2014",9,9,0,94066.67,815.2222,118.1111
"16112","54335","2014",3,3,0,103333.3,884.6667,115
"16113","54336","2014",4,4,0,148064.5,1530.75,101.75
"16114","54337","2014",1,1,0,85000,1024,83
"16115","54338","2014",5,5,0,178780,1921,98.8
"16116","54339","2014",76,45,31,163300.5,1844.974,88.18421
"16117","54340","2014",1,1,0,2e+05,1205,166
"16118","54344","2014",2,2,0,143500,1079.5,112.5
"16119","54345","2014",5,3,2,135000,897.8,133.6
"16120","54346","2014",1,1,0,85000,599,142
"16121","54348","2014",2,2,0,92500,1195.5,78
"16122","54349","2014",1,1,0,183000,1551,118
"16123","54350","2014",9,8,1,112327.8,1193.333,97.33333
"16124","54351","2014",7,7,0,141728.6,1584.714,89.85714
"16125","54352","2014",7,7,0,75142.86,963.2857,75.42857
"16126","54353","2014",9,9,0,126244.4,1254.889,111.1111
"16127","54355","2014",2,2,0,146500,1097,132
"16128","54356","2014",1,1,0,156050,1156,135
"16129","54357","2014",55,29,26,111898.9,1610.473,72.34545
"16130","54358","2014",1,1,0,171000,1598,107
"16131","54359","2014",1,1,0,105000,597,176
"16132","54360","2014",5,4,1,140995,1616.2,106.4
"16133","54362","2014",10,9,1,126755,1441.3,89.4
"16134","54364","2014",11,10,1,192813.9,1846.273,107.8182
"16135","54365","2014",2,2,0,97750,815.5,115
"16136","54366","2014",24,22,2,140011,1632.292,91.79167
"16137","54367","2014",18,16,2,129833.3,1423.056,91.72222
"16138","54369","2014",2,2,0,52500,700,74.5
"16139","54370","2014",2,2,0,103600,880.5,122
"16140","54371","2014",11,11,0,125887.3,1423.636,88.18182
"16141","54372","2014",3,3,0,156166.7,1483.667,104
"16142","54373","2014",3,2,1,159500,1725.333,98.66667
"16143","54374","2014",3,3,0,182333.3,1591.667,118.3333
"16144","54375","2014",4,4,0,137187.5,1584.25,91.25
"16145","54376","2014",3,3,0,189056.7,1413,128
"16146","54377","2014",1,1,0,22000,333,66
"16147","54378","2014",5,5,0,110000,1245.4,91.2
"16148","54380","2014",1,1,0,105500,681,155
"16149","54382","2014",42,34,8,115266.2,1375.167,84.52381
"16150","54383","2014",11,9,2,142989.8,1412.182,107.7273
"16151","54385","2014",6,6,0,126766.7,1076.333,112.5
"16152","54387","2014",3,3,0,160034,1032,146.6667
"16153","54390","2014",2,2,0,224750,1784,125.5
"16154","54391","2014",13,12,1,70723.08,982,72.23077
"16155","54392","2014",8,8,0,120600,1135.625,116.625
"16156","54393","2014",9,9,0,94144.44,970,102.2222
"16157","54394","2014",1,1,0,50000,588,85
"16158","54395","2014",1483,189,1294,126785.3,1938.26,66.77073
"16159","54396","2014",2,2,0,79500,681.5,122.5
"16160","54397","2014",56,45,11,128223.1,1479.375,87.42857
"16161","54398","2014",1,1,0,30000,353,85
"16162","54399","2014",1,1,0,55000,887,62
"16163","54400","2014",5,5,0,246515.2,1755.8,148.2
"16164","54402","2014",3,3,0,113000,1047.333,116.6667
"16165","54403","2014",9,8,1,183044.4,1596.333,114.8889
"16166","54404","2014",4,4,0,117175,719.25,177
"16167","54405","2014",7,7,0,155642.9,1310.286,118.8571
"16168","54406","2014",1,1,0,59000,457,129
"16169","54409","2014",1,1,0,344300,1640,210
"16170","54410","2014",6,6,0,148583.3,1162.833,132.3333
"16171","54411","2014",1,1,0,166000,1194,139
"16172","54413","2014",1,1,0,148000,1147,129
"16173","54414","2014",7,7,0,129657.1,1184.143,109.2857
"16174","54415","2014",37,27,10,142353.2,1592.108,90.56757
"16175","54416","2014",1,1,0,114000,765,149
"16176","54418","2014",1,1,0,61000,1070,57
"16177","54421","2014",3,3,0,106166.7,802.3333,117.6667
"16178","54423","2014",4,4,0,126875,871.75,149.5
"16179","54424","2014",1,1,0,140000,1538,91
"16180","54425","2014",19,18,1,97878.95,973.8421,104.8947
"16181","54426","2014",7,7,0,126571.4,1327.571,96
"16182","54427","2014",4,4,0,106775,718.5,149.25
"16183","54428","2014",6,3,3,73639.5,872.8333,79.66667
"16184","54429","2014",1,1,0,156000,1147,136
"16185","54430","2014",26,20,6,112230.2,1517.346,77.26923
"16186","54431","2014",128,77,51,131493.4,1393.469,97.27344
"16187","54432","2014",14,11,3,119107.9,1237.286,95.07143
"16188","54433","2014",2,2,0,163000,2026,80.5
"16189","54434","2014",3,3,0,149690,1261,124.6667
"16190","54435","2014",7,6,1,134292.9,1372.857,101.2857
"16191","54436","2014",3,3,0,127367.3,866,144.6667
"16192","54437","2014",9,9,0,149711.1,1446.889,102.8889
"16193","54439","2014",29,24,5,221704.1,2041.207,111.5172
"16194","54440","2014",1,1,0,1e+05,870,115
"16195","54441","2014",3,3,0,126842,1223.667,102
"16196","54443","2014",1,1,0,74000,787,94
"16197","54445","2014",1,1,0,105000,955,110
"16198","54449","2014",5,5,0,174080,1616.2,120.8
"16199","54450","2014",1,1,0,110000,982,112
"16200","54451","2014",36,28,8,126256.9,1377.333,89.83333
"16201","54453","2014",2,2,0,115500,1132.5,110
"16202","54455","2014",2,2,0,135000,1176,115.5
"16203","54456","2014",6,6,0,114300,923.1667,120.1667
"16204","54459","2014",22,21,1,183993.2,1826.273,102.4545
"16205","54460","2014",1,1,0,221500,1178,188
"16206","54462","2014",30,23,7,140045,1657.633,86.2
"16207","54463","2014",3,3,0,129466.7,1251,105.3333
"16208","54465","2014",2,2,0,141000,1437.5,96
"16209","54466","2014",5,5,0,122908,1062.2,123.4
"16210","54467","2014",1,1,0,96000,738,130
"16211","54469","2014",1,1,0,134000,1489,90
"16212","54472","2014",7,7,0,135714.3,1107.571,123
"16213","54473","2014",1,1,0,118000,590,200
"16214","54476","2014",5,5,0,110600,1098.8,100.6
"16215","54477","2014",1,1,0,92777,892,104
"16216","54480","2014",1,1,0,192500,1674,115
"16217","54482","2014",124,39,85,138661.8,1822.919,75.16129
"16218","54483","2014",54,48,6,149017.6,1486.185,104.0926
"16219","54485","2014",3,3,0,95833.33,963,118
"16220","54486","2014",3,3,0,163666.7,1138,150.6667
"16221","54487","2014",2,2,0,85000,1012.5,91
"16222","54488","2014",1,1,0,1e+05,455,220
"16223","54489","2014",2,2,0,136000,1007,128
"16224","54490","2014",20,18,2,135955,1362.25,105.65
"16225","54491","2014",1,1,0,145000,1629,89
"16226","54493","2014",25,18,7,80214,1161.36,68.48
"16227","54495","2014",23,22,1,190300,1872.957,101.2609
"16228","54496","2014",2,1,1,115000,907.5,125
"16229","54498","2014",36,32,4,167891.9,1963.333,87.47222
"16230","54500","2014",1,1,0,120000,857,140
"16231","54501","2014",2,2,0,54500,489.5,115
"16232","54502","2014",2,2,0,82400,896.5,88.5
"16233","54504","2014",2,1,1,197000,1784.5,107
"16234","54505","2014",6,6,0,135966.7,1331.5,104.5
"16235","54507","2014",2,2,0,108850,968.5,112
"16236","54509","2014",12,11,1,100558.3,1164.833,92.41667
"16237","54511","2014",1,1,0,103000,954,108
"16238","54512","2014",2,2,0,57500,467,121
"16239","54513","2014",4,4,0,176714,1681.5,113.25
"16240","54514","2014",3,2,1,133333.3,1197,123.6667
"16241","54517","2014",1,1,0,120000,1364,88
"16242","54518","2014",3,3,0,102000,1027,107.6667
"16243","54519","2014",7,6,1,101300,880.4286,120
"16244","54521","2014",14,8,6,93766.07,1014.857,90.92857
"16245","54522","2014",2,2,0,125700,807.5,161.5
"16246","54523","2014",1,1,0,203270,1799,113
"16247","54524","2014",1,1,0,80000,1000,80
"16248","54525","2014",1,1,0,180000,1682,107
"16249","54526","2014",79,50,29,160326.9,1926.532,84.01266
"16250","54527","2014",5,5,0,175240,1376.8,126.2
"16251","54528","2014",113,59,54,127925.6,1355.018,97.9469
"16252","54532","2014",5,5,0,147220,1015.2,153.2
"16253","54533","2014",15,11,4,123577.7,1344.2,87.93333
"16254","54534","2014",2,2,0,185725,1250,161
"16255","54535","2014",1,1,0,128000,1376,93
"16256","54536","2014",28,27,1,99317.5,1204.429,87.07143
"16257","54537","2014",1,0,1,221500,2701,82
"16258","54538","2014",4,4,0,110500,630.5,181
"16259","54539","2014",3,3,0,143700,1516.667,96.33333
"16260","54540","2014",3,3,0,90666.67,962,94.66667
"16261","54541","2014",1,1,0,50140,583,86
"16262","54542","2014",28,25,3,121288.9,1398.357,85.78571
"16263","54543","2014",1,1,0,54000,831,65
"16264","54544","2014",3,3,0,219333.3,1358,188.6667
"16265","54545","2014",1,1,0,40000,727,55
"16266","54546","2014",6,6,0,117416.7,1103.833,115.5
"16267","54547","2014",280,73,207,104234.2,1669.436,64.13571
"16268","54548","2014",3,3,0,85000,645.3333,136.6667
"16269","54549","2014",48,40,8,128760.2,1636.396,82.60417
"16270","54550","2014",3,3,0,108583.3,1074.333,103
"16271","54552","2014",2,2,0,121500,1617.5,100.5
"16272","54554","2014",2,2,0,142300,1216.5,100
"16273","54555","2014",1,1,0,132000,943,140
"16274","54556","2014",1,1,0,98000,576,170
"16275","54557","2014",15,15,0,212835.5,1604,144
"16276","54558","2014",1,1,0,244200,1864,131
"16277","54559","2014",3,3,0,175200,1553,116.3333
"16278","54563","2014",3,3,0,140000,1275,103.6667
"16279","54564","2014",3,3,0,134900,1207.333,107
"16280","54565","2014",1,1,0,35500,1183,30
"16281","54566","2014",2,2,0,130000,7958,21
"16282","54567","2014",4,4,0,91625,1068.5,98
"16283","54568","2014",2,2,0,92500,883.5,102
"16284","54569","2014",1,1,0,80000,661,121
"16285","54571","2014",5,5,0,201340,1789,119.4
"16286","54572","2014",9,9,0,198725,1666.222,121.3333
"16287","54573","2014",3,3,0,83950,1076.667,68.33333
"16288","54574","2014",6,6,0,156133.3,1476.333,119.5
"16289","54575","2014",9,7,2,157811.1,1395.667,116.8889
"16290","54578","2014",165,82,83,154971.8,1852.006,84.89091
"16291","54579","2014",1,1,0,118000,1073,110
"16292","54580","2014",102,74,28,116108.5,1487.137,78.98039
"16293","54581","2014",1,1,0,200350,835,240
"16294","54583","2014",4,4,0,149250,1311,113
"16295","54584","2014",9,8,1,157360,1110.111,154.2222
"16296","54585","2014",4,4,0,112817.5,1126.25,98.75
"16297","54586","2014",9,9,0,115888.9,1249.667,100.1111
"16298","54587","2014",1,1,0,189000,1350,140
"16299","54588","2014",2,2,0,181387,2173.5,85
"16300","54589","2014",3,3,0,138495.3,1561.333,122.6667
"16301","54590","2014",2,2,0,119500,1520,78.5
"16302","54591","2014",2,2,0,113450,1456,86.5
"16303","54592","2014",2,2,0,197250,1526.5,129.5
"16304","54593","2014",5,5,0,120400,1661.6,79.2
"16305","54594","2014",1,1,0,95000,594,160
"16306","54595","2014",4,4,0,156500,1121.5,156.5
"16307","54596","2014",2,2,0,170500,1625,112
"16308","54597","2014",4,4,0,115625,1375.5,80
"16309","54598","2014",3,3,0,90166.67,751.3333,152.6667
"16310","54599","2014",2,2,0,134275,983.5,136
"16311","54600","2014",3,3,0,110333.3,1119.333,93.66667
"16312","54602","2014",3,3,0,96000,793,132
"16313","55001","2014",2,2,0,70500,929,72.5
"16314","55004","2014",1,1,0,35000,636,55
"16315","55009","2014",5,5,0,131300,903.8,153.6
"16316","55010","2014",27,26,1,106441.1,1216.333,91.33333
"16317","55011","2014",4,3,1,116875,1296.5,85.75
"16318","55012","2014",3,3,0,106888.3,972,110.6667
"16319","55013","2014",1,1,0,90000,900,100
"16320","55014","2014",4,4,0,81625,1044.5,82.25
"16321","55015","2014",3,3,0,145866.7,1570,93.33333
"16322","55024","2014",2,2,0,89478,994,90
"16323","55026","2014",1,1,0,180000,1385,130
"16324","55027","2014",3,3,0,105333.3,656.6667,164
"16325","55029","2014",108,58,50,106660.4,1150.065,92.25926
"16326","55035","2014",2,2,0,40000,519,79
"16327","55036","2014",1,1,0,20000,526,38
"16328","55038","2014",1,1,0,190000,2111,90
"16329","55040","2014",2,2,0,56000,694.5,84
"16330","55041","2014",3,3,0,131650,1467.667,87.66667
"16331","55042","2014",5,5,0,162500,1655,101
"16332","55043","2014",29,20,9,133093.1,1316.897,102.9655
"16333","55046","2014",3,3,0,187082.7,1556,113
"16334","55053","2014",5,5,0,82425.4,834.6,102
"16335","55057","2014",1,1,0,103000,912,113
"16336","55058","2014",2,2,0,129000,1461.5,92
"16337","55060","2014",5,5,0,226080,1580.4,112.8
"16338","55061","2014",1,1,0,55000,705,78
"16339","55063","2014",21,21,0,73921.43,774.381,91.2381
"16340","55064","2014",3,3,0,82666.67,1168,72.66667
"16341","55066","2014",1,1,0,125000,1179,106
"16342","55069","2014",2,2,0,145000,1421,102
"16343","55070","2014",1,1,0,110000,1467,75
"16344","55071","2014",1,1,0,20000,400,50
"16345","55072","2014",1,1,0,34000,756,45
"16346","55073","2014",3,3,0,190333.3,1712.667,110.6667
"16347","55075","2014",2,2,0,77000,706.5,119.5
"16348","55077","2014",2,2,0,126500,1174,98
"16349","55078","2014",1,1,0,60000,556,108
"16350","55081","2014",1,1,0,40500,506,80
"16351","55083","2014",1,1,0,50000,505,99
"16352","55085","2014",4,4,0,76000,613.25,121.75
"16353","55087","2014",1,1,0,74000,698,106
"16354","55089","2014",1,1,0,90200,859,105
"16355","55093","2014",1,1,0,88000,1100,80
"16356","55094","2014",2,2,0,39500,474,95
"16357","55095","2014",1,1,0,85000,810,105
"16358","55096","2014",2,2,0,55000,563.5,96
"16359","55097","2014",2,2,0,73600,650.5,112
"16360","55101","2014",4,4,0,149086,1241.25,127.25
"16361","55102","2014",5,5,0,171400,1469.4,124
"16362","55106","2014",1,1,0,35000,729,48
"16363","55109","2014",3,3,0,100666.7,975,93.66667
"16364","55110","2014",1,1,0,90000,750,120
"16365","55111","2014",2,2,0,81750,1145.5,70.5
"16366","55117","2014",8,8,0,74025,800.5,88.125
"16367","55118","2014",1,1,0,40000,588,68
"16368","55119","2014",1,1,0,135000,1286,105
"16369","55120","2014",6,6,0,139473.3,1477.333,97.66667
"16370","55121","2014",1,1,0,85000,1371,62
"16371","55122","2014",50,29,21,83531.02,864.28,94.8
"16372","55123","2014",1,1,0,55000,1375,40
"16373","55124","2014",3,3,0,106000,871.3333,127
"16374","55125","2014",5,5,0,101980,1051,102.4
"16375","55129","2014",1,1,0,50000,505,99
"16376","55142","2014",2,2,0,83500,923.5,92
"16377","55143","2014",1,1,0,155500,1481,105
"16378","55144","2014",3,3,0,57690,602.3333,83.66667
"16379","55145","2014",5,5,0,107520,1444.4,86.4
"16380","55146","2014",2,2,0,127500,1047.5,120
"16381","55153","2014",4,4,0,83317.5,753.5,111.75
"16382","55154","2014",13,13,0,146132.9,1264.846,119.3846
"16383","55155","2014",2,2,0,166750,1418,121
"16384","55156","2014",2,2,0,43500,511,87
"16385","55159","2014",3,3,0,84000,895.3333,98.66667
"16386","55163","2014",2,2,0,36000,570,65
"16387","55165","2014",4,4,0,47500,830.5,69.25
"16388","55166","2014",6,6,0,134530,1302,102.1667
"16389","55167","2014",1,1,0,60000,909,66
"16390","55170","2014",2,2,0,45500,462,103.5
"16391","55171","2014",1,1,0,74135,727,102
"16392","55174","2014",1,1,0,80000,1702,47
"16393","55175","2014",2,2,0,153750,2173.5,76.5
"16394","55178","2014",1,1,0,232700,1724,135
"16395","55184","2014",16,16,0,98638.75,966.6875,102.1875
"16396","55186","2014",15,14,1,118797.9,1259.933,94.6
"16397","55198","2014",6,6,0,147166.7,1312.333,111.1667
"16398","55200","2014",1,1,0,161500,1495,108
"16399","55202","2014",5,5,0,51700,852,62.2
"16400","55204","2014",1,1,0,80100,1014,79
"16401","55206","2014",1,1,0,53000,453,117
"16402","55207","2014",1,1,0,30000,390,77
"16403","55212","2014",1,1,0,24000,480,50
"16404","55217","2014",2,2,0,76000,698.5,111
"16405","55221","2014",3,3,0,104833.3,698.6667,152.3333
"16406","55224","2014",2,1,1,81000,790,113
"16407","55225","2014",1,1,0,63000,900,70
"16408","55228","2014",4,4,0,72500,766,98
"16409","55229","2014",2,2,0,112500,1078.5,102.5
"16410","55236","2014",2,2,0,69550,819.5,107.5
"16411","55237","2014",1,1,0,170000,1214,140
"16412","55241","2014",1,1,0,95000,864,110
"16413","55242","2014",1,1,0,123000,1414,87
"16414","55243","2014",3,3,0,128900,1215.333,101.6667
"16415","55245","2014",3,3,0,87433.33,890,99
"16416","55246","2014",2,2,0,25000,384,64.5
"16417","55250","2014",2,2,0,17500,776,26
"16418","55251","2014",1,1,0,28000,467,60
"16419","55252","2014",1,1,0,42500,759,56
"16420","55253","2014",2,2,0,86000,743.5,120.5
"16421","55255","2014",2,2,0,61500,454,130.5
"16422","55256","2014",1,1,0,92000,1150,80
"16423","55258","2014",1,1,0,76150,508,150
"16424","55263","2014",2,2,0,69500,1191,62
"16425","55267","2014",2,2,0,106750,1048,101
"16426","55268","2014",3,3,0,70000,838.3333,87.33333
"16427","55271","2014",4,4,0,132750,987.5,152.5
"16428","55272","2014",2,2,0,124000,738,170
"16429","55274","2014",1,1,0,64200,642,100
"16430","55275","2014",1,1,0,72000,818,88
"16431","55276","2014",1,1,0,120000,2222,54
"16432","55279","2014",2,2,0,95500,1289,81.5
"16433","55281","2014",2,2,0,102500,936.5,102
"16434","55286","2014",1,1,0,120000,1379,87
"16435","55288","2014",10,10,0,91880,748.8,124.1
"16436","55291","2014",28,21,7,83587.5,902.9643,94.42857
"16437","55293","2014",2,2,0,60000,754,82
"16438","55296","2014",2,2,0,111500,1263,93.5
"16439","55298","2014",3,3,0,99166.67,876,121.3333
"16440","55302","2014",11,11,0,120050.2,1133.818,124
"16441","55303","2014",1,1,0,94000,623,151
"16442","55311","2014",1,1,0,214000,1783,120
"16443","55312","2014",3,3,0,59666.67,524,113
"16444","55313","2014",2,2,0,92875,973,102
"16445","55317","2014",3,3,0,88333.33,897.6667,97.33333
"16446","55323","2014",2,2,0,94500,1519.5,61.5
"16447","55324","2014",6,6,0,97833.33,1062.833,96
"16448","55328","2014",2,2,0,74000,832.5,89
"16449","55329","2014",1,1,0,80000,941,85
"16450","55335","2014",3,3,0,110600,1090,110
"16451","55338","2014",1,1,0,68000,1030,66
"16452","55340","2014",1,1,0,45000,738,61
"16453","55341","2014",1,1,0,68900,478,144
"16454","55346","2014",3,3,0,56333.33,492.3333,111.3333
"16455","55348","2014",3,3,0,81500,709,119
"16456","55351","2014",18,12,6,98551.44,1059,92.83333
"16457","55353","2014",1,1,0,60000,556,108
"16458","55355","2014",2,2,0,43750,691.5,62.5
"16459","55356","2014",1,1,0,152800,1455,105
"16460","55358","2014",2,2,0,103500,822.5,118.5
"16461","55359","2014",3,3,0,78333.33,765.3333,96
"16462","55360","2014",1,1,0,78000,672,116
"16463","55361","2014",2,2,0,150100,1471.5,101
"16464","55362","2014",1,1,0,60000,536,112
"16465","55363","2014",1,1,0,124000,2102,59
"16466","55364","2014",5,5,0,61000,538,122.4
"16467","55366","2014",7,7,0,165190.7,1393.143,118.2857
"16468","55369","2014",5,5,0,110660,1180.4,95.6
"16469","55370","2014",6,6,0,77166.67,665.5,111.6667
"16470","55372","2014",3,3,0,102033.3,780.3333,127.6667
"16471","55374","2014",1,1,0,150000,1250,120
"16472","55378","2014",1,1,0,25000,694,36
"16473","55380","2014",1,1,0,90000,833,108
"16474","55382","2014",6,6,0,98233.33,934.6667,100.6667
"16475","55386","2014",1,1,0,67620,966,70
"16476","55388","2014",2,2,0,91000,884,102.5
"16477","55389","2014",1,1,0,150000,1807,83
"16478","55391","2014",2,2,0,64500,1146,59
"16479","55399","2014",3,3,0,103333.3,1309.333,82.33333
"16480","55404","2014",1,1,0,100500,1478,68
"16481","55406","2014",1,1,0,276400,1212,228
"16482","55408","2014",2,2,0,31500,594.5,62.5
"16483","55414","2014",1,1,0,55500,496,112
"16484","55423","2014",4,4,0,80850,694.5,129.25
"16485","55426","2014",2,2,0,154050,1644.5,100
"16486","55427","2014",15,14,1,120766.7,1221.4,103.5333
"16487","55429","2014",1,1,0,301500,1436,210
"16488","55435","2014",7,7,0,95400,976.7143,99
"16489","55437","2014",1,1,0,1e+05,581,172
"16490","55442","2014",3,3,0,154083.3,1192.667,136
"16491","55444","2014",1,1,0,78000,750,104
"16492","55449","2014",2,2,0,76250,619,120
"16493","55452","2014",1,1,0,29000,414,70
"16494","55457","2014",1,1,0,45000,417,108
"16495","55458","2014",3,3,0,117600,1243.667,97.66667
"16496","55460","2014",2,2,0,175500,1092.5,152
"16497","55463","2014",27,23,4,88596,996.4815,91.81481
"16498","55466","2014",2,2,0,85000,971,94
"16499","55467","2014",6,6,0,126866.7,954.1667,123
"16500","55476","2014",7,7,0,109185.7,988,115.5714
"16501","55477","2014",2,2,0,90350,1098.5,72.5
"16502","55490","2014",2,2,0,45000,913,53.5
"16503","55492","2014",8,8,0,86875,788.875,116.5
"16504","55493","2014",1,1,0,86000,1049,82
"16505","55498","2014",2,2,0,132000,1486.5,90
"16506","55502","2014",11,11,0,87181.82,1020.091,83.72727
"16507","55504","2014",11,11,0,111243.6,1133.455,98.18182
"16508","55505","2014",18,14,4,99733.33,1161.556,89.05556
"16509","55507","2014",2,2,0,80000,1099.5,80.5
"16510","55508","2014",3,3,0,195000,1363.667,140
"16511","55514","2014",4,4,0,78750,1052.25,77.25
"16512","55515","2014",1,1,0,160000,777,206
"16513","55517","2014",4,4,0,79250,582.5,140.5
"16514","55519","2014",8,7,1,114044.1,1347.75,81.125
"16515","55520","2014",4,3,1,62875,636.25,100.75
"16516","55521","2014",5,5,0,73430,577,134.8
"16517","55526","2014",1,1,0,150200,812,185
"16518","55527","2014",4,4,0,51500,635.75,78.5
"16519","55528","2014",1,1,0,38500,558,69
"16520","55530","2014",1,1,0,109000,1211,90
"16521","55531","2014",2,2,0,181500,2298.5,86.5
"16522","55533","2014",13,13,0,105612.8,999.6154,106.3846
"16523","55541","2014",5,5,0,107100,1135,99.4
"16524","55543","2014",5,5,0,126251.8,990.4,125.6
"16525","55545","2014",163,84,79,107455,1288.571,84.44785
"16526","55551","2014",10,10,0,145405,1152.4,132.2
"16527","55553","2014",10,10,0,82389,1159.1,82.6
"16528","55557","2014",2,2,0,141250,953.5,169.5
"16529","55561","2014",1,1,0,105000,2442,43
"16530","55568","2014",2,2,0,62500,555.5,104.5
"16531","55571","2014",2,2,0,32500,408.5,80
"16532","55582","2014",2,2,0,105500,846.5,133.5
"16533","55583","2014",1,1,0,95000,516,184
"16534","55584","2014",4,4,0,37000,606.5,58
"16535","55586","2014",2,2,0,139019.5,3244,53.5
"16536","56001","2014",17,17,0,128464.1,1202.647,117.3529
"16537","56002","2014",13,13,0,155692.3,2071.385,82.69231
"16538","56003","2014",56,43,13,311032.2,2775.571,111.6071
"16539","56004","2014",16,15,1,137417.2,1558.875,102.4375
"16540","56005","2014",94,52,42,301036.2,3785.84,81.34043
"16541","56006","2014",13,13,0,93667.77,1065.692,90
"16542","56007","2014",166,82,84,171217,2208.241,79.53614
"16543","56008","2014",59,51,8,292335,2491.424,117.0508
"16544","56009","2014",11,10,1,247407.1,4023.182,77.81818
"16545","56010","2014",46,42,4,129510.9,1360.391,97.56522
"16546","56011","2014",17,17,0,95658.82,1180.235,82.35294
"16547","56012","2014",14,14,0,195500,1634.286,115.0714
"16548","56013","2014",42,38,4,198262,2144.262,94.42857
"16549","56014","2014",16,16,0,115013.8,1235.438,96.3125
"16550","56015","2014",10,10,0,139694.9,1234.1,119.1
"16551","56017","2014",20,20,0,108207.5,1281.5,81.65
"16552","56018","2014",15,15,0,206266.6,1873.333,109.8667
"16553","56019","2014",1,1,0,70500,1195,59
"16554","56020","2014",4,4,0,101660,1095.75,91.5
"16555","56021","2014",12,12,0,166383,1637.667,106.0833
"16556","56022","2014",11,11,0,143905.5,1530.455,95.81818
"16557","56023","2014",38,34,4,180368.9,1937.5,100
"16558","56024","2014",18,18,0,110306.8,1066.778,102.4444
"16559","56025","2014",2,2,0,92500,951.5,95
"16560","56026","2014",28,28,0,102993.9,1062.179,97.64286
"16561","56027","2014",1,1,0,55000,714,77
"16562","56028","2014",23,23,0,101808.8,1135.696,84.78261
"16563","56029","2014",6,6,0,144833.3,1536.833,101.6667
"16564","56030","2014",5,3,2,141400,2688.2,59
"16565","56031","2014",36,36,0,156289.2,1588.083,97.11111
"16566","56032","2014",14,14,0,113850,1071.429,100.2857
"16567","56033","2014",27,26,1,79535.15,1048.407,81.62963
"16568","56034","2014",154,76,78,267634.4,3795.753,76.0974
"16569","56035","2014",6,6,0,72955.33,1122.833,66.16667
"16570","56036","2014",36,30,6,207815.2,2022.667,107.0278
"16571","56039","2014",9,9,0,133444.4,1227.889,108.2222
"16572","56040","2014",26,24,2,140942.3,1568.692,94.76923
"16573","56041","2014",30,30,0,90020.97,986.1,94.9
"16574","56042","2014",17,17,0,129690.6,1362.647,98.88235
"16575","56043","2014",6,6,0,113344.3,1517.667,88.16667
"16576","56044","2014",6,6,0,115000,972.6667,127.6667
"16577","56045","2014",4,4,0,125550,1398,86
"16578","56046","2014",23,23,0,329694,3033.783,114.6522
"16579","56047","2014",15,15,0,84166.67,924.8667,92.4
"16580","56048","2014",5,5,0,81000,1036.2,73.6
"16581","56050","2014",10,10,0,140683,1155.7,119.6
"16582","56051","2014",14,14,0,85035.71,922.0714,93.07143
"16583","56052","2014",62,41,21,195171.1,3124.048,73.46774
"16584","56053","2014",47,44,3,171863.8,1706.298,103.5532
"16585","56054","2014",44,35,9,165032.6,2573.477,67.97727
"16586","56055","2014",36,27,9,199574.5,2397.944,92.47222
"16587","56056","2014",2,2,0,97500,1001,98
"16588","56057","2014",26,26,0,92340.38,1574.654,81.5
"16589","56058","2014",26,26,0,156797.9,1815.231,91.23077
"16590","56060","2014",12,12,0,79500,990.0833,84.83333
"16591","56061","2014",40,40,0,108206.1,1195.475,93.525
"16592","56062","2014",11,11,0,200011.4,2590.818,82.45455
"16593","56063","2014",15,13,2,176773.1,1640.8,108.1333
"16594","56065","2014",3,3,0,152054,1665.333,92.33333
"16595","56066","2014",44,42,2,72439.86,889.6591,82.68182
"16596","56067","2014",35,34,1,143640.4,1487.857,94.74286
"16597","56068","2014",3,3,0,127166.7,1323.667,95.66667
"16598","56069","2014",36,36,0,203200.5,2578.444,81.77778
"16599","56070","2014",20,20,0,95018.3,1026.65,89.85
"16600","56071","2014",7,7,0,68260.86,946.1429,74.28571
"16601","56072","2014",6,6,0,94583.33,850.8333,95.83333
"16602","56073","2014",7,7,0,70000,884,80.14286
"16603","56074","2014",10,10,0,118500,1304.7,94.2
"16604","56075","2014",36,34,2,107861.1,1287.417,84.83333
"16605","56076","2014",13,13,0,110773,901.7692,119.5385
"16606","56077","2014",5,5,0,162200,1379.8,111.2
"16607","56078","2014",121,93,28,187815.5,2376.033,84.71074
"16608","56079","2014",8,8,0,67216.88,823.875,86
"16609","56080","2014",23,23,0,89226.09,884.6087,101.6522
"16610","56081","2014",15,15,0,98266.67,871.4667,104.1333
"16611","56082","2014",5,5,0,75248.2,985.4,79.8
"16612","56083","2014",148,95,53,147161.2,1729.5,86.38514
"16613","56085","2014",1,1,0,350000,4217,83
"16614","56086","2014",3,3,0,245000,3332,73
"16615","56087","2014",10,9,1,467000,4246.2,112.2
"16616","56088","2014",9,7,2,261195.6,2974.111,110.7778
"16617","56089","2014",23,23,0,120969.3,1406.261,84.65217
"16618","56090","2014",42,42,0,143628.6,1609.857,90.2381
"16619","56091","2014",19,19,0,107557.9,1367.579,82.63158
"16620","56092","2014",2,2,0,136170,1653,82
"16621","56093","2014",9,9,0,114761.1,1214.667,99.44444
"16622","56094","2014",21,21,0,212486.2,1751.143,128.5238
"16623","56096","2014",18,18,0,181805.6,1952.944,98.55556
"16624","56097","2014",19,18,1,188040.9,1831.947,107.3158
"16625","56098","2014",200,159,41,152531.5,1761.08,89.835
"16626","56099","2014",4,4,0,74000,628,120.25
"16627","56100","2014",24,23,1,75433.33,1099.417,73.83333
"16628","56101","2014",38,37,1,134913.3,1422.263,93.60526
"16629","56102","2014",15,15,0,75379.13,811.5333,93
"16630","56103","2014",2,2,0,141250,1232,115.5
"16631","56104","2014",5,5,0,112400,1452.8,82.8
"16632","56105","2014",21,21,0,79351.43,943.619,85.95238
"16633","56106","2014",18,16,2,369475.6,3391.889,110.2778
"16634","56107","2014",99,72,27,315616.5,3060.283,102.596
"16635","56108","2014",9,9,0,192923.4,1551.778,122.5556
"16636","56109","2014",8,8,0,151462.5,1913.125,80.625
"16637","56110","2014",12,12,0,86851.25,1075.583,82.91667
"16638","56111","2014",13,13,0,157147.3,1315.538,116.7692
"16639","56112","2014",7,7,0,135765.7,1144.286,118.4286
"16640","56113","2014",6,6,0,90250,863,100.3333
"16641","56114","2014",13,13,0,302392.3,3485.769,90.69231
"16642","56115","2014",12,12,0,138551.2,1448.583,97.83333
"16643","56116","2014",24,19,5,302758.3,3077.417,105.5
"16644","56117","2014",36,33,3,121033,1440.306,90.86111
"16645","56118","2014",43,39,4,174436.5,1909.349,91.97674
"16646","56119","2014",24,24,0,232260.4,1968.625,122.25
"16647","56120","2014",14,14,0,144400,1440.357,99.14286
"16648","56121","2014",629,239,390,133902.2,1796.706,76.29571
"16649","56122","2014",18,18,0,109103.8,1137.444,101.0556
"16650","56123","2014",17,16,1,117354.7,1145,101.3529
"16651","56124","2014",19,18,1,121197.1,1358.474,98.42105
"16652","56125","2014",8,8,0,114000,1108.625,109.375
"16653","56126","2014",13,13,0,151753.8,1543.692,97.38462
"16654","56127","2014",27,26,1,96663.3,1133.296,93.85185
"16655","56128","2014",15,15,0,75221.33,978.1333,85.33333
"16656","56129","2014",14,14,0,89453.57,769.4286,115.0714
"16657","56130","2014",13,13,0,210191.2,2059.615,103.8462
"16658","56131","2014",11,11,0,1e+05,1007.091,103.0909
"16659","56132","2014",1,1,0,285000,2457,116
"16660","56133","2014",5,5,0,123600,1124.4,105.2
"16661","56134","2014",14,14,0,80915.71,797.5714,93.92857
"16662","56135","2014",14,14,0,130897.1,1306.5,101.4286
"16663","56136","2014",11,11,0,92727.27,1170.091,79.36364
"16664","56137","2014",28,27,1,172590,1625.286,109.25
"16665","56139","2014",3,3,0,108170,994,104.6667
"16666","56140","2014",16,16,0,100021.9,1089.125,90.75
"16667","56141","2014",14,14,0,117185.7,1223.143,96.21429
"16668","56143","2014",43,38,5,167916,1774.047,97.60465
"16669","56144","2014",25,25,0,92758.72,1318.72,75.84
"16670","56145","2014",6,6,0,53500,919.1667,57.33333
"16671","56146","2014",11,11,0,121831.4,1183.909,106.4545
"16672","56147","2014",22,22,0,145321.6,1577.318,89.81818
"16673","56148","2014",13,13,0,151769.2,1649,92.69231
"16674","56149","2014",12,12,0,152441.7,1623,101.1667
"16675","56151","2014",18,18,0,109500,1175.222,95.72222
"16676","56152","2014",35,23,12,214262.9,2860.457,76.05714
"16677","56153","2014",26,25,1,147626.9,1421.423,106.8462
"16678","56154","2014",15,15,0,109643.4,1147.6,96.26667
"16679","56155","2014",60,57,3,160599.4,2457.467,72.4
"16680","56156","2014",3,3,0,119500,1427.333,84.66667
"16681","56157","2014",15,15,0,133557.3,1485.733,90.06667
"16682","56158","2014",64,30,34,163627.3,2124.922,77.60938
"16683","56159","2014",12,12,0,90666.67,1025.083,91.91667
"16684","56160","2014",12,12,0,74291.67,994.25,74.08333
"16685","56161","2014",34,20,14,160582.3,2034.853,81.08824
"16686","56162","2014",153,125,28,252059.6,2676.869,98.98039
"16687","56163","2014",23,23,0,106867.1,1079.348,93.3913
"16688","56164","2014",54,48,6,247501.7,2293.389,109.7407
"16689","56165","2014",74,62,12,153063.2,1686.635,99.78378
"16690","56166","2014",48,47,1,137227.5,1380.917,98.8125
"16691","56167","2014",17,16,1,266379.5,2258.647,114.5294
"16692","56168","2014",15,13,2,214900,2221,97.8
"16693","56169","2014",57,53,4,211444,2099.667,102.614
"16694","56170","2014",14,14,0,54525,803.2143,71.21429
"16695","56171","2014",12,12,0,115254.2,1223.833,91.08333
"16696","56172","2014",26,26,0,107334.2,1091.615,99.23077
"16697","56173","2014",48,48,0,97841.46,1138.667,86.33333
"16698","56174","2014",22,22,0,141150.9,1397.864,103.1364
"16699","56175","2014",25,25,0,163660.9,1720.16,101.16
"16700","56176","2014",46,38,8,188340.4,2073,93.5
"16701","56177","2014",74,73,1,170448,1643.419,107.973
"16702","56178","2014",119,82,37,118809.7,1348.034,91.03361
"16703","56179","2014",25,25,0,194060,1854.48,105.44
"16704","56180","2014",7,7,0,104634.3,1254.429,84
"16705","56181","2014",45,30,15,172173.3,2007.089,86.51111
"16706","56182","2014",6,6,0,80783.33,1000.833,85.16667
"16707","56184","2014",65,61,4,157363.8,1582.569,99.73846
"16708","56185","2014",69,64,5,189445.5,1900.348,102.2754
"16709","56186","2014",126,65,61,236314,3698.468,69.52381
"16710","56188","2014",12,12,0,63412.5,895.5833,69.5
"16711","56189","2014",7,7,0,99054.86,1278.571,76.71429
"16712","56190","2014",17,17,0,106758.8,999.7059,111.5882
"16713","56191","2014",8,8,0,80300,942,90.25
"16714","56193","2014",37,37,0,167702,1710.649,100.1351
"16715","56194","2014",26,26,0,116869.9,1151.885,102.5385
"16716","56195","2014",13,7,6,127663.5,2024.385,74.38462
"16717","56196","2014",15,13,2,103786,1228.2,85.26667
"16718","56197","2014",28,28,0,122496.4,1234.929,94.32143
"16719","56198","2014",14,13,1,98325,1013,99.14286
"16720","56199","2014",10,10,0,72800,804.2,89.6
"16721","56200","2014",7,7,0,63224.29,991.2857,71.57143
"16722","56201","2014",6,6,0,51416.67,837.6667,62.83333
"16723","56202","2014",1,1,0,73000,1058,69
"16724","56203","2014",10,10,0,76450,993.4,82.2
"16725","56204","2014",7,7,0,68142.86,789.1429,82.57143
"16726","56205","2014",6,6,0,297250,2063.167,146.8333
"16727","56206","2014",64,55,9,227645.9,2240.75,102.7656
"16728","56207","2014",10,10,0,125200,1088.8,121.4
"16729","56208","2014",2,2,0,93000,1007.5,76
"16730","56209","2014",1,1,0,60000,1111,54
"16731","56210","2014",4,4,0,107550,1180.75,92
"16732","56211","2014",8,8,0,94271.88,976.5,99.875
"16733","56212","2014",19,19,0,99294.74,1051.947,96.89474
"16734","56213","2014",8,8,0,124675,1183.125,105.375
"16735","56214","2014",64,62,2,275990,3215.484,91.875
"16736","56215","2014",12,12,0,94083.33,1245.417,81.16667
"16737","56216","2014",4,4,0,70058.75,968.75,73.5
"16738","56218","2014",8,8,0,98093.62,1277.75,72.125
"16739","56219","2014",12,12,0,134444.5,1499.25,88.41667
"16740","56220","2014",11,11,0,181086.5,2120.909,88.72727
"16741","56221","2014",14,14,0,79672.86,1069.857,78.28571
"16742","56222","2014",19,18,1,145323.7,1484.579,102.6842
"16743","56223","2014",12,12,0,115665,1241.333,95.75
"16744","56224","2014",1,1,0,148000,1080,137
"16745","56225","2014",1,1,0,50000,694,72
"16746","56226","2014",5,5,0,134534,1523.4,86.2
"16747","56227","2014",3,3,0,57500,906,63
"16748","56228","2014",9,9,0,88740,1078.333,80.66667
"16749","56229","2014",8,8,0,70812.5,933.5,76
"16750","56230","2014",6,6,0,65958.33,855.1667,78
"16751","56231","2014",19,19,0,210931.6,1790.105,123.3684
"16752","56232","2014",6,6,0,78633.33,908.3333,80
"16753","56233","2014",22,16,6,335550,3525.455,94.04545
"16754","56234","2014",40,34,6,253849.7,3420.125,86.425
"16755","56236","2014",6,6,0,113500,1127,102.3333
"16756","56237","2014",9,9,0,119566.7,1192.889,105.6667
"16757","56238","2014",2,2,0,105500,1232,82
"16758","56239","2014",9,9,0,92833.33,1043.778,91.44444
"16759","56240","2014",162,136,26,236975.2,2904.284,88.5
"16760","56241","2014",11,9,2,328022.7,3455.455,99.72727
"16761","56242","2014",10,10,0,100647.2,978.5,99.2
"16762","56243","2014",77,55,22,222455.4,2551.286,88.72727
"16763","56244","2014",33,33,0,100073.5,1254.545,81.06061
"16764","56245","2014",10,10,0,78354.3,793.1,95.1
"16765","56246","2014",9,9,0,131168.9,1257.333,99.11111
"16766","56247","2014",23,23,0,175265.2,1881.217,97.82609
"16767","56248","2014",45,40,5,191235.2,1815.356,105.6222
"16768","56249","2014",8,8,0,97098.12,1079.875,89.625
"16769","56250","2014",5,5,0,116042.2,1234.6,98
"16770","56251","2014",51,47,4,219837.7,2015.941,113.2941
"16771","56252","2014",26,26,0,243829.7,2153.769,117.4615
"16772","56253","2014",3,3,0,71166.67,968.6667,76.66667
"16773","56254","2014",19,19,0,139415.8,1469.632,111.5263
"16774","56255","2014",15,12,3,164635.3,1640.533,101.5333
"16775","56256","2014",1,1,0,180000,896,201
"16776","56257","2014",10,10,0,60670,675.5,89.8
"16777","56258","2014",51,31,20,349219.6,4120.667,87.86275
"16778","56259","2014",1,1,0,80000,1538,52
"16779","56260","2014",688,247,441,181347.8,2332.85,75.65552
"16780","56261","2014",10,10,0,200662.5,1896.1,112.1
"16781","56262","2014",28,27,1,251951.6,2414.75,103
"16782","56263","2014",17,13,4,177782.4,1869.882,99.52941
"16783","56264","2014",4,4,0,102050,1234,85.25
"16784","58001","2014",1,1,0,38000,884,43
"16785","58002","2014",11,11,0,88063.64,1007.364,93.81818
"16786","58003","2014",6,6,0,81575,966,97.83333
"16787","58004","2014",5,5,0,103200,899,112.8
"16788","58005","2014",4,4,0,74625,932.25,81.75
"16789","58006","2014",3,3,0,48000,711.3333,69.33333
"16790","58007","2014",1,1,0,27000,600,45
"16791","58008","2014",3,3,0,48333.33,583.3333,85.33333
"16792","58009","2014",2,2,0,81000,689,106
"16793","58010","2014",8,8,0,79500,1030.125,79.875
"16794","58011","2014",6,6,0,73500,835.6667,98.33333
"16795","58012","2014",5,5,0,95000,993.2,97.8
"16796","58014","2014",1,1,0,35000,574,61
"16797","58015","2014",1,1,0,60000,789,76
"16798","58016","2014",3,3,0,60166.67,695,85.33333
"16799","58017","2014",1,1,0,133000,1662,80
"16800","58018","2014",1,1,0,40000,909,44
"16801","58019","2014",1,1,0,75000,789,95
"16802","58020","2014",2,2,0,131775,1177,110.5
"16803","58021","2014",2,2,0,227500,1985,110
"16804","58024","2014",4,4,0,68375,725.75,95.75
"16805","58025","2014",1,1,0,80000,690,116
"16806","58026","2014",2,2,0,68500,735,97
"16807","58027","2014",2,2,0,95151.5,1819,55
"16808","58030","2014",6,6,0,114706.3,1307.667,85.16667
"16809","58031","2014",4,4,0,106225,969.75,104.25
"16810","58032","2014",2,2,0,77500,602.5,135.5
"16811","58033","2014",2,2,0,52500,801,81
"16812","58034","2014",3,3,0,67386.67,898,71
"16813","58035","2014",2,2,0,36500,517,77
"16814","58036","2014",14,14,0,98572.14,1188,91.07143
"16815","58037","2014",10,10,0,92900,1217.9,79.7
"16816","58039","2014",3,3,0,69166.67,729.3333,97.33333
"16817","58040","2014",1,1,0,30000,612,49
"16818","58041","2014",3,3,0,88858.33,725,120.3333
"16819","58043","2014",1,1,0,130000,2600,50
"16820","58044","2014",12,12,0,69052.08,849,84.16667
"16821","58045","2014",5,5,0,62910,733.4,83.8
"16822","58046","2014",16,15,1,101812.5,1117.375,90.25
"16823","58047","2014",6,5,1,87916.67,1107,83.66667
"16824","58048","2014",2,2,0,56600,739.5,75
"16825","58049","2014",3,3,0,100666.7,1103,87.33333
"16826","58050","2014",2,2,0,36375.5,691,52.5
"16827","58051","2014",12,12,0,90583.33,1144.083,76.33333
"16828","58052","2014",1,1,0,156400,1043,150
"16829","58053","2014",7,7,0,53857.14,688,83.28571
"16830","58055","2014",7,7,0,83500,1264.571,69.14286
"16831","58057","2014",10,10,0,93759,1035.2,110.4
"16832","58058","2014",8,8,0,63875,892.125,70.875
"16833","58059","2014",48,40,8,82868.75,1033.771,81.64583
"16834","58060","2014",8,8,0,64312.5,836,97
"16835","58061","2014",2,2,0,20500,461,44
"16836","58062","2014",16,16,0,76312.5,959.4375,82.875
"16837","58063","2014",5,5,0,39835.8,791,52
"16838","58064","2014",4,4,0,117500,837.75,129.75
"16839","58065","2014",10,10,0,59450,793.5,73.5
"16840","58067","2014",12,12,0,100083.3,1094.167,92.83333
"16841","58068","2014",7,7,0,91357.14,1328.571,70.42857
"16842","58069","2014",1,1,0,120000,1364,88
"16843","58070","2014",3,3,0,70666.67,717.6667,103.3333
"16844","58071","2014",3,3,0,286206.7,1958.333,158
"16845","58072","2014",1,1,0,455000,2167,210
"16846","58074","2014",4,4,0,61875,865.5,70.75
"16847","58075","2014",3,2,1,65333.33,1015,63.66667
"16848","58076","2014",1,1,0,59000,1093,54
"16849","58077","2014",4,4,0,72125,1075.5,67.5
"16850","58078","2014",2,2,0,99246,715.5,127
"16851","58079","2014",27,21,6,75671.11,996.037,86.07407
"16852","58080","2014",5,5,0,47800,877.4,56.4
"16853","58081","2014",7,7,0,60810.71,755.4286,85.85714
"16854","58082","2014",1,1,0,35000,972,36
"16855","58083","2014",11,10,1,75745.45,897.7273,90.09091
"16856","58084","2014",2,2,0,50500,550,99.5
"16857","58085","2014",7,7,0,57857.14,582.2857,96.28571
"16858","58086","2014",134,112,22,95655.95,1145.784,86.67164
"16859","58087","2014",10,10,0,97948.3,998.2,96.9
"16860","58088","2014",42,39,3,121340.5,1271.333,94.45238
"16861","58089","2014",8,8,0,84750,958.75,88.875
"16862","58090","2014",3,3,0,76000,878,83.33333
"16863","58092","2014",6,6,0,89583.33,1203.667,83
"16864","58093","2014",1,1,0,1e+05,962,104
"16865","58094","2014",7,7,0,73500,1007.286,76.28571
"16866","58095","2014",53,37,16,77309.28,986.1321,76.58491
"16867","58096","2014",2,2,0,97500,1130.5,89
"16868","58097","2014",1,1,0,120000,945,127
"16869","58099","2014",5,5,0,79150,991,75.4
"16870","58101","2014",1,1,0,65000,970,67
"16871","58102","2014",23,21,2,87021.74,946.2174,91.65217
"16872","58103","2014",9,9,0,88768.89,1011.556,91.33333
"16873","58104","2014",6,6,0,54666.67,776.3333,72.5
"16874","58105","2014",2,2,0,112500,1915,57.5
"16875","58106","2014",7,7,0,89300,815.8571,104.7143
"16876","58107","2014",1,1,0,165000,1375,120
"16877","58108","2014",2,2,0,212000,896,222.5
"16878","58109","2014",8,8,0,137937.5,1206.125,110.5
"16879","58110","2014",2,2,0,70000,1000,72
"16880","58111","2014",3,3,0,66666.67,1042,69.66667
"16881","58112","2014",5,5,0,162497,1487,97.6
"16882","58114","2014",1,1,0,80000,816,98
"16883","58115","2014",5,5,0,69000,1284.4,57.4
"16884","58116","2014",3,3,0,70666.67,835,85.33333
"16885","58117","2014",33,25,8,86258.48,1178.242,73.0303
"16886","58118","2014",4,4,0,72748,1041.5,69.5
"16887","58120","2014",4,4,0,90000,943,89
"16888","58121","2014",30,27,3,88570.57,1180.7,76.46667
"16889","58122","2014",4,4,0,69625,1005,73
"16890","58123","2014",1,1,0,149000,5519,27
"16891","58124","2014",7,7,0,102597.1,1099.143,95.85714
"16892","58125","2014",2,2,0,111000,1032.5,104.5
"16893","58126","2014",2,2,0,51500,888.5,57.5
"16894","58127","2014",2,2,0,63500,807,73
"16895","58128","2014",2,2,0,95500,947,111
"16896","58129","2014",4,4,0,59375,927,67.25
"16897","58130","2014",2,2,0,85000,819,103
"16898","58131","2014",15,15,0,92413.33,1134.2,82.73333
"16899","58134","2014",22,15,7,87386.36,1199.091,73.36364
"16900","58135","2014",1,1,0,218000,1090,200
"16901","58136","2014",4,4,0,124375,1107.5,102.25
"16902","58137","2014",2,2,0,80000,895.5,89.5
"16903","58138","2014",2,2,0,57500,990,60.5
"16904","58140","2014",6,6,0,120250,1237.833,97.5
"16905","58141","2014",2,2,0,67000,765.5,92.5
"16906","58142","2014",5,5,0,58300,666.8,91.2
"16907","58143","2014",2,2,0,37750,526.5,74
"16908","58144","2014",5,5,0,80600,701,107.2
"16909","58145","2014",18,18,0,98538.89,1073.5,96.77778
"16910","58146","2014",5,5,0,45700,593.8,76
"16911","58147","2014",1,1,0,86000,989,87
"16912","58148","2014",5,5,0,81800,998.6,80.2
"16913","58149","2014",19,19,0,82393.84,995.2632,86.47368
"16914","58150","2014",1,1,0,79000,1013,78
"16915","58151","2014",35,32,3,50397.14,849.7714,58.14286
"16916","58152","2014",10,10,0,145075,1368,100.4
"16917","58153","2014",2,2,0,58500,647.5,77.5
"16918","58155","2014",12,12,0,100545.8,1009.75,104.5833
"16919","58156","2014",2,2,0,77000,716.5,91.5
"16920","58157","2014",4,4,0,69997.5,1026.5,73
"16921","58158","2014",6,6,0,57750,868.6667,71.83333
"16922","58159","2014",3,3,0,86000,1035.333,89
"16923","58160","2014",18,18,0,163081.1,1495.333,111.6667
"16924","58162","2014",2,2,0,54250,914.5,64.5
"16925","58163","2014",6,6,0,79833.33,936.8333,82.83333
"16926","58164","2014",12,12,0,76166.67,921.3333,89.33333
"16927","58165","2014",1,1,0,40000,506,79
"16928","58166","2014",5,5,0,62300,940.8,67.4
"16929","58168","2014",1,1,0,22000,407,54
"16930","58170","2014",1,1,0,1e+05,962,104
"16931","58171","2014",3,3,0,49333.33,876.3333,57
"16932","58172","2014",2,2,0,30000,663,44
"16933","58173","2014",2,2,0,76000,903,90.5
"16934","58174","2014",2,2,0,58830,988,58
"16935","58175","2014",1,1,0,85000,833,102
"16936","58176","2014",6,6,0,97276.67,1190.833,83.5
"16937","58177","2014",1,1,0,65000,844,77
"16938","58178","2014",2,2,0,71500,789.5,92.5
"16939","58179","2014",5,5,0,48800,781.6,63.8
"16940","58180","2014",13,13,0,67038.46,1161.385,65.61538
"16941","58181","2014",2,2,0,72750,953,77.5
"16942","58182","2014",13,13,0,84703.85,836.3846,96
"16943","58183","2014",2,2,0,34750,592,59
"16944","58184","2014",1,1,0,80000,800,100
"16945","58185","2014",9,9,0,82666.67,1042.778,88.77778
"16946","58186","2014",1,1,0,60000,1000,60
"16947","58187","2014",3,3,0,61666.67,842,76.33333
"16948","58188","2014",1,1,0,92000,911,101
"16949","58189","2014",6,6,0,86260,1009.333,89.33333
"16950","58190","2014",1,1,0,25000,417,60
"16951","58191","2014",1,1,0,52500,772,68
"16952","58192","2014",2,2,0,67500,930.5,69.5
"16953","58193","2014",12,12,0,73466.67,832,88
"16954","58194","2014",317,145,172,89542.54,1076.05,81.64038
"16955","58195","2014",2,1,1,41750,458,90.5
"16956","58196","2014",4,4,0,46250,911,51.75
"16957","58197","2014",1,1,0,22000,367,60
"16958","58198","2014",2,2,0,30000,641,48.5
"16959","58199","2014",1,1,0,65000,707,92
"16960","58200","2014",3,3,0,113333.3,1099.333,104.6667
"16961","58201","2014",2,2,0,94050,881,105.5
"16962","58203","2014",2,2,0,74250,580,127.5
"16963","58204","2014",6,6,0,69666.67,820.5,81.66667
"16964","58205","2014",9,8,1,75794.44,1086.778,79
"16965","58206","2014",2,2,0,106500,1787.5,60
"16966","58207","2014",12,12,0,123170.8,1346.167,95.83333
"16967","58208","2014",2,2,0,93000,1191.5,84.5
"16968","58209","2014",1,1,0,30000,857,35
"16969","58210","2014",7,7,0,74285.71,1117,73
"16970","58211","2014",3,3,0,125944.3,1205.667,102.6667
"16971","58212","2014",3,3,0,127333.3,1027.667,135.6667
"16972","58213","2014",6,6,0,76000,1006.667,72.83333
"16973","58214","2014",23,21,2,143666.1,1405.304,102.1739
"16974","58215","2014",23,23,0,104026.1,1074.391,96.34783
"16975","58216","2014",3,3,0,69666.67,1120,63.66667
"16976","58217","2014",4,4,0,86425,750.75,96.25
"16977","58218","2014",16,16,0,76281.25,905.125,85.6875
"16978","58219","2014",1,1,0,65000,560,116
"16979","58220","2014",7,7,0,96442.86,1035.571,91.57143
"16980","58222","2014",5,5,0,108600,1133.4,94.8
"16981","58223","2014",4,4,0,96750,1077,115.75
"16982","58224","2014",1,1,0,70000,700,100
"16983","58225","2014",3,3,0,91100,935,100.6667
"16984","58226","2014",1,1,0,55000,1341,41
"16985","58227","2014",18,18,0,74987.11,909.3333,79.33333
"16986","58228","2014",6,6,0,100430,1285.667,93.5
"16987","58229","2014",7,7,0,69285.71,958.1429,70.28571
"16988","58230","2014",1,1,0,105000,700,150
"16989","58231","2014",1,1,0,99000,2200,45
"16990","58232","2014",8,8,0,98875,1253.125,83
"16991","58233","2014",1,1,0,32000,653,49
"16992","58234","2014",3,3,0,54990,746,70.33333
"16993","58236","2014",2,2,0,89000,948,90
"16994","58237","2014",1,1,0,35000,350,100
"16995","58238","2014",17,17,0,161923.5,1292.529,129.5882
"16996","58239","2014",1,1,0,95000,1131,84
"16997","58240","2014",1,1,0,86000,789,109
"16998","58241","2014",6,6,0,71533.33,888.6667,80.66667
"16999","58242","2014",2,2,0,38500,524.5,78.5
"17000","58244","2014",1,1,0,1e+05,909,110
"17001","58245","2014",1,1,0,32000,421,76
"17002","58246","2014",8,8,0,76976.88,1079.75,74.625
"17003","58247","2014",5,5,0,109400,1012,112.8
"17004","58248","2014",3,3,0,84833.33,815,119.3333
"17005","58249","2014",5,5,0,71920,1252.8,60.8
"17006","58250","2014",15,13,2,73933.33,960.3333,76.06667
"17007","58251","2014",4,4,0,104375,1110.75,88.75
"17008","58253","2014",2,2,0,112500,990,124
"17009","58254","2014",2,2,0,145000,1626,89.5
"17010","58255","2014",5,5,0,82200,1203.6,69.2
"17011","58256","2014",5,5,0,168800,1256.4,109.4
"17012","58258","2014",3,3,0,95000,1053.333,89.66667
"17013","58260","2014",10,10,0,118100,1178.3,100.7
"17014","58261","2014",10,10,0,89082,1317.6,73.5
"17015","58262","2014",2,2,0,36330,647,62
"17016","58264","2014",18,18,0,102267,979,105.3333
"17017","58265","2014",1,1,0,1e+05,1408,71
"17018","58266","2014",1,1,0,73000,664,110
"17019","58267","2014",6,6,0,65166.67,616.5,127.8333
"17020","58268","2014",1,1,0,60000,462,130
"17021","58269","2014",3,3,0,65333.33,827.6667,81.33333
"17022","58270","2014",9,9,0,128211.1,1442.222,87.77778
"17023","58271","2014",2,2,0,50000,677.5,74
"17024","58272","2014",1,1,0,2e+05,1111,180
"17025","58273","2014",7,7,0,134921.4,1295.429,117.4286
"17026","58274","2014",4,4,0,94750,1260.5,73.25
"17027","58275","2014",1,1,0,55000,733,75
"17028","58276","2014",4,4,0,59750,1299.75,46
"17029","58277","2014",2,2,0,46000,952,51
"17030","58278","2014",12,12,0,123710.8,1426.583,89.41667
"17031","58279","2014",1,1,0,70000,737,95
"17032","58280","2014",3,3,0,94333.33,1023,98.33333
"17033","58281","2014",11,11,0,61018.18,834.8182,75.18182
"17034","58282","2014",4,3,1,76825,995.5,78.75
"17035","58283","2014",1,1,0,115000,1095,105
"17036","58284","2014",1,1,0,190000,974,195
"17037","58285","2014",3,3,0,58666.67,1017,55.33333
"17038","58286","2014",9,9,0,80000,974.6667,82.11111
"17039","58287","2014",4,4,0,121750,774.25,158.25
"17040","58288","2014",1,1,0,75000,974,77
"17041","58289","2014",2,2,0,60000,1177.5,51.5
"17042","58290","2014",2,2,0,60000,1591.5,85
"17043","58291","2014",2,2,0,83250,938,89
"17044","58292","2014",2,2,0,117450,753,145
"17045","58293","2014",2,2,0,74000,837.5,88.5
"17046","58294","2014",1,1,0,89346,784,114
"17047","58295","2014",15,15,0,101953.3,1311.4,79.4
"17048","58296","2014",2,2,0,78500,2061.5,64
"17049","58297","2014",5,5,0,73360,945.6,78
"17050","58298","2014",1,1,0,77500,1360,57
"17051","58299","2014",2,2,0,29050,475.5,63
"17052","58300","2014",13,13,0,140905.4,1286.308,119.3077
"17053","58301","2014",2,1,1,42500,428.5,99.5
"17054","58302","2014",14,14,0,102485.7,1099.786,93.35714
"17055","58303","2014",71,69,2,120189.7,1397,86.15493
"17056","58304","2014",14,14,0,73512.86,874.8571,88.92857
"17057","58305","2014",3,3,0,63333.33,861,74
"17058","58306","2014",3,3,0,31666.67,579.3333,55.33333
"17059","58308","2014",3,3,0,31500,593.6667,52.66667
"17060","58309","2014",11,11,0,79295.45,965.7273,82.27273
"17061","58311","2014",4,4,0,81412.5,802.5,97
"17062","58312","2014",4,4,0,92305,750.75,137.75
"17063","58313","2014",1,1,0,40000,1111,36
"17064","59001","2014",3,3,0,126666.7,951,131
"17065","59002","2014",41,39,2,120836.9,1388.537,94.09756
"17066","59003","2014",3,3,0,152383.3,1375,117
"17067","59004","2014",5,5,0,260105.2,2351.4,107.2
"17068","59005","2014",26,26,0,189097.6,1825.269,107.5385
"17069","59007","2014",5,5,0,106400,1388.4,84.8
"17070","59008","2014",80,79,1,98049.38,1045.838,97.75
"17071","59009","2014",465,324,141,223452.9,2481.396,89.16559
"17072","59011","2014",90,87,3,161104.3,1678.522,96.95556
"17073","59012","2014",26,26,0,107349.3,1275.808,98.11538
"17074","59013","2014",13,13,0,229103.8,2505.308,101.6923
"17075","59014","2014",99,94,5,95171.72,1146.101,84.34343
"17076","59015","2014",19,19,0,145342.1,1527,93.68421
"17077","59016","2014",20,20,0,165307.5,1581.05,109.4
"17078","59017","2014",301,237,64,126968.2,1600.01,82.71429
"17079","59018","2014",12,12,0,148166.7,1454.75,101.5833
"17080","59019","2014",7,7,0,145214.3,1615.143,98.28571
"17081","59021","2014",11,11,0,113236.4,1282,86.36364
"17082","59022","2014",21,21,0,213648.3,1943.238,112.6667
"17083","59023","2014",4,4,0,152500,1328.5,116.75
"17084","59024","2014",24,24,0,101358.3,1120.458,92.16667
"17085","59025","2014",16,16,0,207175,1940.438,107.1875
"17086","59026","2014",7,7,0,88428.57,990.1429,85.42857
"17087","59027","2014",12,12,0,142722.9,1717.083,94
"17088","59028","2014",48,48,0,107048.2,1275.25,85
"17089","59029","2014",9,9,0,217133.3,2632.444,96.88889
"17090","59031","2014",2,2,0,156000,1413.5,104
"17091","59032","2014",40,39,1,127044.5,1429.925,90.275
"17092","59033","2014",75,75,0,95478.01,1059.28,91.52
"17093","59034","2014",28,26,2,246623.8,2199.857,115.6429
"17094","59035","2014",20,20,0,97675,1049.05,96.4
"17095","59036","2014",30,27,3,97941.67,1202.467,87.63333
"17096","59037","2014",38,37,1,91786.84,1010.079,91.15789
"17097","59038","2014",7,7,0,151285.7,1393.143,114.1429
"17098","59039","2014",3,3,0,146000,1084.333,138.3333
"17099","59041","2014",14,14,0,100292.9,1280.786,81.21429
"17100","59042","2014",9,9,0,198444.4,2209.444,90.66667
"17101","59043","2014",141,126,15,183548.7,2120.383,91.36879
"17102","59044","2014",56,54,2,234473,2459.196,98.17857
"17103","59046","2014",3,3,0,177933.3,1598,105.6667
"17104","59047","2014",4,4,0,116625,1219.75,100.5
"17105","59048","2014",3,3,0,185666.7,1492.333,125
"17106","59049","2014",4,4,0,115875,1011,110.25
"17107","59050","2014",1,1,0,257000,3427,75
"17108","59051","2014",74,70,4,142152.4,1644.243,88.95946
"17109","59052","2014",39,39,0,139711.1,1628.821,86.15385
"17110","59053","2014",31,30,1,109889.8,1137.484,96.12903
"17111","59054","2014",3,3,0,133730,1187.667,117
"17112","59055","2014",6,6,0,91166.67,967,89.33333
"17113","59056","2014",3,3,0,128000,1706,71.33333
"17114","59057","2014",4,4,0,102701.2,989.5,111.5
"17115","59058","2014",8,8,0,169125,1463,115.375
"17116","59059","2014",4,4,0,63250,803.5,78.25
"17117","59060","2014",1,1,0,202000,1347,150
"17118","59062","2014",2,2,0,175000,1332.5,130
"17119","59063","2014",17,17,0,103970.6,1046.412,102.7059
"17120","59064","2014",5,5,0,139100,1781.2,77.6
"17121","59065","2014",8,8,0,126641.5,1023.125,127.125
"17122","59066","2014",1,1,0,85000,876,97
"17123","59067","2014",23,19,4,172162,1570.391,119.9565
"17124","59068","2014",23,23,0,105956.5,1290.217,84.43478
"17125","59069","2014",10,10,0,145100,1314.7,106.6
"17126","59070","2014",3,3,0,144865.7,1383.667,102
"17127","59071","2014",22,22,0,222579.3,2021.273,114.5909
"17128","59072","2014",2,2,0,147500,1349.5,110
"17129","59073","2014",7,7,0,268514.3,2252.857,121.1429
"17130","59074","2014",19,19,0,105184.2,1137.368,100.3684
"17131","59075","2014",7,7,0,137928.6,1088.143,130.8571
"17132","59076","2014",4,3,1,123150,2659.75,87.25
"17133","59077","2014",2,2,0,215000,1391.5,152
"17134","59078","2014",5,5,0,93221.2,758.6,105.8
"17135","59079","2014",44,42,2,116908.6,1402.295,86.18182
"17136","59080","2014",24,24,0,192485.8,1971.667,99.875
"17137","59081","2014",5,5,0,138600,1358.2,112.2
"17138","59082","2014",21,21,0,178372.9,1708.571,105.381
"17139","59083","2014",1,1,0,65000,677,96
"17140","59084","2014",19,19,0,157652.6,1747.684,96.47368
"17141","59085","2014",4,4,0,115750,1279.25,93
"17142","59086","2014",23,23,0,173350,1720.739,102.3043
"17143","59087","2014",9,9,0,156833.3,1399.667,111.8889
"17144","59088","2014",15,15,0,237246.7,2125.533,118.4
"17145","59089","2014",9,9,0,129011.1,1394.111,97.66667
"17146","59090","2014",105,105,0,391006.1,3184.01,121.8571
"17147","59091","2014",7,7,0,155657.1,1484.571,102.7143
"17148","59092","2014",25,24,1,142120,1406.36,99.36
"17149","59093","2014",1,1,0,167000,1403,119
"17150","59094","2014",40,38,2,128779,1513.775,87.325
"17151","59096","2014",10,10,0,226438.5,2063.8,106.7
"17152","59097","2014",3,3,0,88333.33,867.6667,105.6667
"17153","59098","2014",43,36,7,235014.9,2349.442,101.814
"17154","59099","2014",16,16,0,110875,1058.312,107.9375
"17155","59100","2014",2,2,0,263250,2031.5,134
"17156","59101","2014",1,1,0,20000,1333,15
"17157","59102","2014",5,5,0,123200,1064.8,110.6
"17158","59103","2014",3,3,0,135960,1112.333,153
"17159","59104","2014",27,27,0,102679.6,1056.926,99
"17160","59105","2014",14,14,0,197247.9,2133.071,99.57143
"17161","59106","2014",10,9,1,233300,2281.9,98.2
"17162","59107","2014",111,62,49,158198.6,2557.261,71.65766
"17163","59108","2014",4,4,0,87150,1142.25,77.25
"17164","59109","2014",5,5,0,205000,1830.4,113.6
"17165","59110","2014",10,10,0,169285,1681,104
"17166","59111","2014",1,1,0,150000,2239,67
"17167","59112","2014",85,81,4,113460,1230.906,93.77647
"17168","59113","2014",13,13,0,139865.9,1322.308,107
"17169","59114","2014",16,16,0,184724.6,1674.438,112.6875
"17170","59115","2014",3,3,0,121333.3,1106.667,115
"17171","59116","2014",6,6,0,173250,1401,118.6667
"17172","59117","2014",7,7,0,94256.29,1112.429,90.42857
"17173","59118","2014",16,16,0,92687.5,1167.688,88.6875
"17174","59119","2014",4,4,0,218555,1808.25,129.25
"17175","59120","2014",13,13,0,185939.2,1664.846,116.7692
"17176","59121","2014",6,6,0,135556.7,1574.167,80.83333
"17177","59122","2014",307,234,73,115146.1,1293.606,91.00651
"17178","59123","2014",19,17,2,191825.6,2160.263,98.26316
"17179","59124","2014",20,20,0,323535,2542.3,127.75
"17180","59125","2014",6,6,0,111666.7,1054.5,114.8333
"17181","59126","2014",14,14,0,141764.3,1425.714,96.42857
"17182","59127","2014",1,1,0,335700,1416,237
"17183","59128","2014",31,17,14,206216.6,2331.516,92.25806
"17184","59129","2014",22,22,0,248704.5,2186.5,111.3636
"17185","59130","2014",10,10,0,157250,1473.9,102.5
"17186","59131","2014",62,62,0,141426.7,1565.306,92.09677
"17187","59132","2014",4,4,0,88750,864.25,99.5
"17188","59133","2014",8,8,0,243755,2102.5,120.875
"17189","59134","2014",9,9,0,115322.2,1117.556,107.1111
"17190","59135","2014",23,21,2,193030.4,1718.087,113
"17191","59136","2014",45,41,4,105941.2,1052.933,89.73333
"17192","59137","2014",8,8,0,117956.2,1072.125,113.875
"17193","59138","2014",5,5,0,136800,1190.8,127.8
"17194","59139","2014",132,125,7,84755.14,983.9621,88.74242
"17195","59140","2014",2,2,0,111100,1708.5,69.5
"17196","59141","2014",1,1,0,125000,880,142
"17197","59142","2014",5,5,0,139060,1758.8,79.6
"17198","59143","2014",65,62,3,196237.1,1982.662,101.1692
"17199","59144","2014",9,9,0,136777.8,1661.556,81.11111
"17200","59145","2014",6,6,0,168499.2,1788.5,96.66667
"17201","59146","2014",32,28,4,282120.3,2683.375,104.4375
"17202","59148","2014",5,5,0,105100,938.8,115
"17203","59149","2014",9,8,1,114327.8,1069.333,110.4444
"17204","59150","2014",3,3,0,294933.3,2314.667,127.3333
"17205","59151","2014",10,10,0,121000,1414.7,90.7
"17206","59152","2014",120,116,4,191549.4,2039.7,95.49167
"17207","59153","2014",37,37,0,104292.4,1132.081,101.4865
"17208","59155","2014",173,160,13,130600.6,1472.486,90.46243
"17209","59156","2014",42,20,22,124291.8,1817.548,72.7619
"17210","59157","2014",20,20,0,126714.5,1134.9,110.45
"17211","59158","2014",29,29,0,210353.7,1922.207,108.4483
"17212","59159","2014",2,2,0,234425,2100,111.5
"17213","59160","2014",22,22,0,98534.45,1219.318,85.40909
"17214","59161","2014",4,4,0,131750,1196.75,111.25
"17215","59162","2014",6,6,0,173916.7,1373.667,128.3333
"17216","59163","2014",278,204,74,209449.4,2174.597,91.99281
"17217","59164","2014",4,4,0,125750,1109,118.25
"17218","59165","2014",60,59,1,148480.3,1572.983,94.21667
"17219","59166","2014",10,10,0,201431,1867.9,111.9
"17220","59167","2014",3,3,0,207416.7,1922.333,104.3333
"17221","59169","2014",4,4,0,151250,1222.25,118
"17222","59170","2014",39,39,0,108081,1299.128,85.97436
"17223","59172","2014",188,184,4,78407.7,968.5851,83
"17224","59173","2014",12,12,0,245833.3,2255.583,112.25
"17225","59174","2014",3,3,0,127000,1570.667,81.33333
"17226","59175","2014",2,2,0,105000,1253.5,83.5
"17227","59176","2014",4,4,0,146750,1374.5,111.5
"17228","59177","2014",4,4,0,110250,1020.75,112.75
"17229","59178","2014",278,166,112,125296.4,1623.583,82.51799
"17230","59179","2014",67,66,1,114084.3,1237.134,92.71642
"17231","59180","2014",9,9,0,189953.9,2093.556,93.22222
"17232","59181","2014",4,4,0,101750,929.5,103.5
"17233","59182","2014",2,2,0,99250,1243,74
"17234","59183","2014",774,508,266,136842.6,1650.198,85.69638
"17235","59184","2014",9,9,0,157888.9,1284,124.2222
"17236","59185","2014",9,9,0,121655.6,1455.444,87.33333
"17237","59187","2014",1,1,0,60000,1395,43
"17238","59188","2014",1,1,0,111900,1056,106
"17239","59189","2014",8,8,0,139125,1389,102.25
"17240","59190","2014",13,13,0,175068.5,1614.462,107.3077
"17241","59191","2014",3,3,0,83333.33,990,86.33333
"17242","59192","2014",2,2,0,142250,1266,112.5
"17243","59193","2014",31,31,0,177349.4,1924.387,92.35484
"17244","59194","2014",6,6,0,111625,1458.667,80.33333
"17245","59195","2014",6,6,0,290666.7,2762.333,105.3333
"17246","59196","2014",10,9,1,280274.5,2421,118.8
"17247","59197","2014",17,17,0,196238.4,1850.118,112
"17248","59198","2014",2,2,0,147500,1714,87.5
"17249","59199","2014",8,8,0,139093.8,1498.5,90
"17250","59200","2014",5,5,0,108500,1415.2,78.2
"17251","59201","2014",3,3,0,206066.7,2285.667,89.33333
"17252","59202","2014",71,43,28,158302.2,2101.915,78.29577
"17253","59203","2014",15,15,0,119111.3,1271.067,96.6
"17254","59204","2014",3,3,0,83666.67,874.3333,86.66667
"17255","59205","2014",59,59,0,100719,1145.593,91.08475
"17256","59206","2014",31,31,0,96370.71,1041.323,93.32258
"17257","59207","2014",20,19,1,95712,1338.5,77.4
"17258","59208","2014",3,3,0,340000,2208.667,140.6667
"17259","59209","2014",7,7,0,87738.29,881.1429,98.42857
"17260","59210","2014",15,15,0,189190.8,1504.467,123.3333
"17261","59211","2014",6,6,0,259850.8,1767.167,155
"17262","59212","2014",45,41,4,155366.7,1619.511,100.3778
"17263","59213","2014",7,7,0,157485.7,1477.429,107.1429
"17264","59214","2014",8,8,0,175137.5,1821.25,98.25
"17265","59215","2014",5,5,0,85700,1131.2,75.8
"17266","59216","2014",4,4,0,128875,1111.25,117.25
"17267","59217","2014",3,3,0,134766.7,1122.667,128.3333
"17268","59218","2014",10,10,0,93845.3,875.2,113.3
"17269","59219","2014",6,6,0,202230,1846.333,108.6667
"17270","59220","2014",174,153,21,175946.6,2168.046,82.46552
"17271","59221","2014",32,12,20,113193.8,1812.281,62.34375
"17272","59222","2014",21,21,0,197678.8,2163.762,94
"17273","59223","2014",6,6,0,123244.3,1425.667,89.33333
"17274","59224","2014",17,17,0,107288.2,1147,97.70588
"17275","59225","2014",61,59,2,130997.6,1357.459,101.1803
"17276","59226","2014",12,12,0,91116.67,835.0833,117.0833
"17277","59227","2014",44,44,0,133439.1,1379.795,96.59091
"17278","59228","2014",11,11,0,186104.5,1597.818,112
"17279","59229","2014",3,3,0,111300,1196.333,90.33333
"17280","59230","2014",54,42,12,94667.06,1015.204,90.37037
"17281","59231","2014",9,9,0,111000,1073.333,103.2222
"17282","59232","2014",2,2,0,110500,1232,88.5
"17283","59233","2014",1,1,0,60000,723,83
"17284","59234","2014",45,45,0,124044.2,1388.422,92.24444
"17285","59236","2014",3,3,0,86000,769.6667,111.6667
"17286","59237","2014",8,8,0,159625,1807.25,83.5
"17287","59238","2014",14,14,0,127622.9,1311.786,98.28571
"17288","59239","2014",45,44,1,181469.4,1666.467,109.8
"17289","59241","2014",4,4,0,103375,1093.25,95.5
"17290","59242","2014",2,2,0,119725,1222.5,105
"17291","59243","2014",18,18,0,96541.67,1087.278,90.61111
"17292","59244","2014",22,22,0,139557.7,1306,109.5455
"17293","59246","2014",5,5,0,89900,971.2,95.4
"17294","59247","2014",15,15,0,179046.7,2010.333,89.06667
"17295","59249","2014",88,85,3,88142.24,1010.591,92.23864
"17296","59250","2014",17,16,1,240705.9,2154.765,111.6471
"17297","59251","2014",3,3,0,190600,1233.667,157.3333
"17298","59252","2014",26,23,3,220075,2082.192,106.1154
"17299","59253","2014",40,39,1,103540,1157.175,90.425
"17300","59254","2014",9,9,0,147274,1243,121.8889
"17301","59255","2014",5,5,0,89800,1123,80.4
"17302","59256","2014",7,7,0,209921.4,2339,91
"17303","59257","2014",3,3,0,284733.3,3537,77.66667
"17304","59258","2014",15,15,0,210510,2049.133,107.8
"17305","59259","2014",6,6,0,171533.3,1374.5,130.6667
"17306","59260","2014",41,40,1,187873.2,2109.902,101.561
"17307","59261","2014",22,22,0,95459.09,899.1818,111.2727
"17308","59262","2014",21,21,0,162917.1,1715.381,99.09524
"17309","59263","2014",10,10,0,195288.5,1472.4,132.9
"17310","59264","2014",12,12,0,125872.5,1169.583,109.9167
"17311","59265","2014",27,27,0,146172.2,1287.815,118.8889
"17312","59266","2014",36,34,2,188080.9,1819.861,105.8333
"17313","59267","2014",1,1,0,61000,884,69
"17314","59268","2014",46,42,4,140667,1567.63,89.54348
"17315","59269","2014",12,12,0,113320.8,1321.333,93.91667
"17316","59270","2014",4,4,0,98250,889.5,114
"17317","59271","2014",85,79,6,129357.1,1380.294,94.61176
"17318","59272","2014",40,40,0,109577.5,1441.325,77.4
"17319","59273","2014",76,73,3,152832.2,1638.987,94.55263
"17320","59274","2014",6,6,0,108166.7,869.6667,125.1667
"17321","59275","2014",12,11,1,392895.8,3070.75,130.5
"17322","59276","2014",14,14,0,105428.6,1234.357,89.85714
"17323","59277","2014",1,1,0,60000,1667,36
"17324","59278","2014",39,36,3,192308.6,2180.103,90.66667
"17325","59279","2014",184,174,10,170410.5,1906.783,89.69022
"17326","59280","2014",6,6,0,107516.7,1402.333,71.16667
"17327","59281","2014",12,12,0,179028.5,1881.75,95.75
"17328","59282","2014",1,1,0,160000,1311,122
"17329","59283","2014",7,7,0,154000,1699.143,98.28571
"17330","59284","2014",35,35,0,165873.1,1583.714,104.6286
"17331","59285","2014",18,18,0,145805,1464.278,104
"17332","59286","2014",153,122,31,148909.7,1961.248,80.20915
"17333","59287","2014",3,3,0,114666.7,980,121.6667
"17334","59288","2014",22,22,0,117815.9,1196.545,103.1818
"17335","59289","2014",11,11,0,95045.45,1134.545,82.72727
"17336","59290","2014",1,1,0,145000,1051,138
"17337","59291","2014",94,93,1,86451.02,997.117,88.80851
"17338","59292","2014",6,6,0,78000,847,96.33333
"17339","59293","2014",16,16,0,136368.8,1389.312,100
"17340","59294","2014",1,1,0,30000,462,65
"17341","59295","2014",221,195,26,143324.2,1640.072,89.14932
"17342","59296","2014",1,1,0,168000,2024,83
"17343","59297","2014",22,22,0,103718.2,1134.273,90.86364
"17344","59299","2014",138,131,7,241444.3,2307.246,102.4928
"17345","59300","2014",1,1,0,196000,1980,99
"17346","59301","2014",41,41,0,136951.2,1428.341,96.68293
"17347","59302","2014",50,47,3,126475.2,1663.2,78.32
"17348","59303","2014",19,19,0,260552.6,2561.526,112.3158
"17349","59304","2014",3,3,0,155000,1516.333,97.33333
"17350","59305","2014",14,14,0,174882.9,1642.857,113.7143
"17351","59306","2014",2,2,0,150000,1287.5,116.5
"17352","59307","2014",7,7,0,128428.6,1171.143,113.4286
"17353","59308","2014",9,9,0,168044.4,1539,109.3333
"17354","59309","2014",29,29,0,143359.3,1276.138,114.7931
"17355","59310","2014",1,1,0,240000,2264,106
"17356","59311","2014",4,4,0,110125,753,146.5
"17357","59312","2014",6,6,0,172416.7,1493.5,112.8333
"17358","59313","2014",9,9,0,145333.3,1444.222,102.8889
"17359","59314","2014",24,24,0,142820.8,1551.333,97
"17360","59315","2014",6,6,0,112316.7,1131.333,111.1667
"17361","59316","2014",39,39,0,184602.2,1849.641,101.2564
"17362","59317","2014",72,72,0,147653.5,1852.944,80.80556
"17363","59318","2014",6,6,0,124416.7,1641.833,74
"17364","59319","2014",22,22,0,201333.2,2046.773,100.0455
"17365","59320","2014",15,15,0,192610,1937.4,102.7333
"17366","59321","2014",9,9,0,71055.56,837.8889,83.77778
"17367","59322","2014",43,40,3,96737.21,1276.349,78.95349
"17368","59323","2014",14,14,0,147541.4,1438.929,101.7857
"17369","59324","2014",71,70,1,95480.56,1092.592,90.73239
"17370","59325","2014",9,9,0,157344.4,1656.556,95.66667
"17371","59326","2014",8,8,0,151387.5,1627.125,93
"17372","59327","2014",25,25,0,149176.2,1431,109.88
"17373","59328","2014",377,268,109,227999.6,2596.053,87.62334
"17374","59329","2014",42,42,0,148588.6,1678.405,93.95238
"17375","59330","2014",26,26,0,192235.3,1988.577,100.1923
"17376","59331","2014",32,32,0,112868.8,1127.719,100.1562
"17377","59332","2014",33,15,18,120068.8,1714.455,71.87879
"17378","59333","2014",1,1,0,173000,1116,155
"17379","59334","2014",21,20,1,143792.9,1467.095,100.619
"17380","59335","2014",21,21,0,166847.5,1809.381,96.38095
"17381","59336","2014",18,18,0,78461.11,920.6111,79
"17382","59337","2014",6,6,0,132408.3,1214,112.1667
"17383","59338","2014",4,4,0,178650,1932,98.75
"17384","59339","2014",95,86,9,203936.8,2298.589,90.03158
"17385","59340","2014",36,29,7,180068.3,1891.139,100.75
"17386","59341","2014",4,4,0,135000,1344.5,112
"17387","59342","2014",1,1,0,60000,411,146
"17388","59343","2014",73,70,3,196206.1,2148.959,94.12329
"17389","59344","2014",11,11,0,101590.9,1182.091,91.90909
"17390","59345","2014",18,18,0,114563.9,1285.556,89.05556
"17391","59346","2014",29,29,0,174594.8,2258.448,78.17241
"17392","59347","2014",10,10,0,64100,799,79
"17393","59348","2014",9,9,0,134188.9,1251,98.77778
"17394","59349","2014",22,21,1,101750,1018.136,102.2273
"17395","59350","2014",3050,884,2166,169780.3,2800.118,65.41541
"17396","59351","2014",2,2,0,111500,1084,105.5
"17397","59352","2014",88,85,3,245112.8,2382.898,103.5114
"17398","59353","2014",3,3,0,86340,1548.667,59
"17399","59354","2014",1,1,0,122000,1743,70
"17400","59356","2014",17,17,0,301307.6,2482.529,122.8824
"17401","59357","2014",16,16,0,119152.5,1203.125,97.25
"17402","59358","2014",8,8,0,118875,1521,80.25
"17403","59359","2014",42,42,0,144030.9,1556.571,92.5
"17404","59360","2014",208,138,70,149755.3,2091.793,74.98077
"17405","59361","2014",24,24,0,81145.83,979.5417,82.70833
"17406","59363","2014",5,5,0,159343.8,1615.8,98
"17407","59364","2014",14,13,1,217003.6,2183.5,107.5
"17408","59365","2014",31,30,1,94274.19,1102.548,83.22581
"17409","59366","2014",6,6,0,193333.3,1713,123.3333
"17410","59367","2014",147,120,27,165955.8,1895.755,87.72109
"17411","59368","2014",335,127,208,195553.7,2500.337,78.33731
"17412","59369","2014",36,34,2,136009.6,1463.583,102.3333
"17413","59370","2014",5,5,0,77000,1089.4,79.2
"17414","59371","2014",6,6,0,368678.3,3015.5,139.3333
"17415","59372","2014",9,9,0,88257.56,918.1111,92
"17416","59374","2014",3,3,0,182000,1397.333,123.6667
"17417","59375","2014",47,46,1,160241.2,1640.191,102.617
"17418","59377","2014",18,18,0,117138.9,1169.833,102.7778
"17419","59378","2014",532,339,193,277292.2,2925.511,92.37218
"17420","59379","2014",4,4,0,151225,1494.75,107
"17421","59381","2014",8,8,0,157654.4,1381.75,113.625
"17422","59382","2014",18,18,0,85888.89,905.8333,101
"17423","59383","2014",87,79,8,121227.3,1444.483,84.13793
"17424","59384","2014",16,15,1,111423.6,1064.562,110.75
"17425","59385","2014",21,21,0,93423.81,1184.81,82.42857
"17426","59386","2014",119,113,6,201598.6,2415.681,84.72269
"17427","59387","2014",17,17,0,104761.8,1152.294,93.70588
"17428","59388","2014",25,25,0,197225.2,1999.52,101.08
"17429","59389","2014",22,22,0,122181.8,1160.909,104.7727
"17430","59390","2014",18,18,0,102136.5,1080.444,91.22222
"17431","59391","2014",9,9,0,119833.3,1258,93.44444
"17432","59392","2014",207,153,54,94336.35,1159.039,84.68116
"17433","59393","2014",8,8,0,160625,1577,106.5
"17434","59394","2014",2,2,0,79500,1016,91
"17435","59395","2014",1,1,0,80000,748,107
"17436","59396","2014",6,6,0,132833.3,1399.333,96.66667
"17437","59397","2014",2,2,0,90635,1278.5,99
"17438","59398","2014",15,14,1,405903.3,2619.533,145.8667
"17439","59399","2014",12,12,0,228583.3,1675.417,140.5
"17440","59400","2014",83,81,2,147731.9,1561.578,97.90361
"17441","59401","2014",28,28,0,174162.1,1657.036,107.9643
"17442","59402","2014",5,5,0,149386,1325.8,109
"17443","59403","2014",8,8,0,138965,1483.25,96.625
"17444","59405","2014",6,6,0,102666.7,1043.5,102.8333
"17445","59406","2014",5,5,0,142000,1386,102.6
"17446","59407","2014",2,2,0,129000,1558.5,89.5
"17447","59408","2014",14,14,0,196266.6,1906.571,113.1429
"17448","59409","2014",26,26,0,122290.4,1229.538,102.1538
"17449","59410","2014",149,109,40,179550.7,2200.973,81.09396
"17450","59411","2014",15,15,0,213533.3,2184.333,98.4
"17451","59412","2014",1,1,0,80000,563,142
"17452","59413","2014",2,2,0,67500,709,94.5
"17453","59414","2014",24,22,2,137206.7,1521.375,96.33333
"17454","59415","2014",2,2,0,120000,1690.5,64
"17455","59416","2014",20,20,0,160175,1589.35,105.65
"17456","59418","2014",17,17,0,132800,1388.059,103.0588
"17457","59419","2014",10,10,0,232638,2078.1,112.4
"17458","59420","2014",1,1,0,57000,538,106
"17459","59421","2014",204,179,25,257706.8,2541.569,100
"17460","59422","2014",4,4,0,156475,1663,96.25
"17461","59423","2014",13,13,0,161761.5,1358.615,123.6923
"17462","59424","2014",6,6,0,83912,1147.5,77.33333
"17463","59425","2014",10,10,0,171740,1312.1,129.8
"17464","59426","2014",123,114,9,205408.2,2136.431,97.13821
"17465","59427","2014",5,5,0,215490,1920.2,118
"17466","59428","2014",26,25,1,119071.1,1329.731,93.03846
"17467","59429","2014",28,28,0,87062.5,1075.786,81.14286
"17468","59430","2014",11,11,0,98581.82,961.2727,101
"17469","59431","2014",54,53,1,193925.4,1907.907,103.1111
"17470","59432","2014",1,1,0,95000,1418,67
"17471","59433","2014",14,14,0,140778.6,1511.786,96.64286
"17472","59434","2014",7,7,0,195314.3,1643.714,123.2857
"17473","59435","2014",27,26,1,258042.6,2203.926,119.6667
"17474","59436","2014",3,3,0,251933.3,1603.667,155.3333
"17475","59437","2014",8,8,0,248650,2115.375,116.125
"17476","59438","2014",5,5,0,147360,1124.2,130.2
"17477","59439","2014",1,1,0,178000,1589,112
"17478","59440","2014",10,10,0,111765,1202.7,93.2
"17479","59441","2014",7,7,0,153328.6,1571.143,98.71429
"17480","59442","2014",2,2,0,71375,1002.5,85
"17481","59443","2014",8,8,0,168021.2,1350.125,125.5
"17482","59444","2014",10,10,0,98450,1188.8,80.4
"17483","59445","2014",6,6,0,122981.7,1091,117.8333
"17484","59447","2014",58,58,0,123333.2,1301.31,98
"17485","59448","2014",4,4,0,128337.5,1739.75,76.5
"17486","59449","2014",70,62,8,161226.8,1715.857,95.57143
"17487","59450","2014",3,3,0,72666.67,920,81
"17488","59451","2014",4,4,0,133470,1447,91.25
"17489","59452","2014",32,31,1,146143.1,1581.344,97.84375
"17490","59453","2014",9,9,0,201027.8,1588.778,126.4444
"17491","59454","2014",5,5,0,131000,1764.2,85
"17492","59455","2014",9,9,0,147234.4,1307.444,112.8889
"17493","59456","2014",15,15,0,148687,1513,104.7333
"17494","59457","2014",65,62,3,196970.8,2192.969,90.04615
"17495","59458","2014",8,8,0,242750,2323.375,105.125
"17496","59459","2014",45,44,1,131149.1,1576.022,85.42222
"17497","59462","2014",67,58,9,215922.7,2163.97,103.5672
"17498","59463","2014",10,10,0,162740,1366.5,119.9
"17499","59464","2014",19,19,0,86257.89,865.9474,98.94737
"17500","59465","2014",5,5,0,137300,1439.8,102.2
"17501","59466","2014",22,19,3,215225.8,2164.545,99.77273
"17502","59467","2014",15,15,0,102800,1186.4,89.13333
"17503","59468","2014",3,3,0,212333.3,1906.667,110.3333
"17504","59469","2014",3,3,0,206016.7,1986,116.3333
"17505","59470","2014",20,20,0,245903.7,2413.15,105.25
"17506","59471","2014",28,28,0,157959.6,1521.893,105.1786
"17507","59472","2014",7,7,0,62565.14,908.7143,75
"17508","59473","2014",5,5,0,156200,1574.8,93.8
"17509","59474","2014",5,5,0,111600,951,120.8
"17510","59475","2014",13,13,0,120807.7,1398.615,90.53846
"17511","59476","2014",22,22,0,167485.1,1494.091,110.9545
"17512","59477","2014",58,58,0,150141,1766.397,88.05172
"17513","59478","2014",12,12,0,163250,1397.417,117.5
"17514","59479","2014",23,23,0,131143.5,1396.783,91.78261
"17515","59480","2014",3,3,0,140333.3,1680.667,79.33333
"17516","59481","2014",28,28,0,123055.4,1315.393,92.32143
"17517","59482","2014",62,62,0,237291.8,2218.774,105.7419
"17518","59483","2014",1,1,0,18000,450,40
"17519","59484","2014",24,22,2,100821.6,1158.625,90.625
"17520","59485","2014",11,11,0,100254.5,983.6364,101.7273
"17521","59486","2014",18,17,1,135059.6,1364.611,96.5
"17522","59487","2014",8,8,0,353375,2276.25,151.5
"17523","59488","2014",24,23,1,122272.5,1259.583,97.29167
"17524","59489","2014",35,35,0,166607.1,1719.8,99.91429
"17525","59490","2014",2,2,0,220000,1652.5,138.5
"17526","59491","2014",82,81,1,101023.5,1189.573,85.78049
"17527","59492","2014",9,9,0,107333.3,1156.222,86.77778
"17528","59493","2014",2,2,0,91500,564.5,161.5
"17529","59495","2014",15,15,0,108200,1124.2,94.33333
"17530","59496","2014",1,1,0,45000,450,100
"17531","59497","2014",17,17,0,137391.2,1662.235,88.11765
"17532","59498","2014",5,5,0,93200,933.4,98.8
"17533","59499","2014",16,16,0,125764.8,1415.5,96.25
"17534","59500","2014",5,5,0,153600,1134,136.8
"17535","59501","2014",7,7,0,154731.6,1273.714,117.8571
"17536","59502","2014",14,14,0,79392.86,1000.5,76
"17537","59503","2014",1,1,0,214020,1081,198
"17538","59504","2014",29,29,0,96678.28,1118.793,88.82759
"17539","59505","2014",4,4,0,168500,1775,93
"17540","59506","2014",6,6,0,140066.7,992.5,144.6667
"17541","59507","2014",194,149,45,169052.2,2022.825,85.97423
"17542","59508","2014",148,136,12,211273.2,2231.23,93.70946
"17543","59509","2014",48,48,0,151601.3,1491.167,103.9583
"17544","59511","2014",15,15,0,232130,1953.667,123.8
"17545","59512","2014",582,419,163,125679.7,1462.739,87.39347
"17546","59513","2014",4,4,0,150075,1449.25,111.5
"17547","59514","2014",51,47,4,130085.5,1299.51,99.35294
"17548","59515","2014",3,3,0,140333.3,1445,93.66667
"17549","59516","2014",6,6,0,109033.3,1330.333,90.5
"17550","59517","2014",7,7,0,102935.7,1073.857,93.14286
"17551","59518","2014",3,3,0,137666.7,1488.333,87.66667
"17552","59519","2014",16,15,1,169771.9,1571.812,112.3125
"17553","59520","2014",12,12,0,132716.7,1146,105.9167
"17554","59521","2014",3,3,0,103000,979.6667,97
"17555","59522","2014",18,18,0,256211.6,2544.444,100.8889
"17556","59523","2014",14,14,0,295160,2865.929,108.9286
"17557","59524","2014",55,54,1,176649.8,1927.709,91.96364
"17558","59525","2014",20,20,0,97664.05,1043.8,94.8
"17559","59526","2014",165,154,11,148750.5,1641.515,93.09091
"17560","59527","2014",164,129,35,199988.3,2506.329,81.45122
"17561","59528","2014",11,11,0,138290.9,1135.818,119
"17562","59529","2014",2,2,0,156500,1262.5,146
"17563","59531","2014",4,4,0,90000,867,98
"17564","59532","2014",1,1,0,3e+05,1935,155
"17565","59533","2014",17,17,0,90550,1040.588,90.76471
"17566","59534","2014",7,7,0,110285.7,1039.286,103.4286
"17567","59535","2014",19,19,0,210631.1,2024.737,108.6842
"17568","59536","2014",5,5,0,194500,1896.8,102.6
"17569","59537","2014",3,3,0,166666.7,1234,139
"17570","59538","2014",2,2,0,83050,1020,80
"17571","59539","2014",9,9,0,261577.8,1778.444,136.5556
"17572","59541","2014",9,9,0,110888.9,1030,106.3333
"17573","59542","2014",1,1,0,140000,1400,100
"17574","59543","2014",8,8,0,116000,1217.75,102.75
"17575","59544","2014",89,85,4,174839.6,1742.36,100.6966
"17576","59545","2014",6,6,0,126000,1371.167,79.66667
"17577","59546","2014",10,10,0,181050,1507.6,121.9
"17578","59547","2014",18,18,0,94222.22,932.7222,99.55556
"17579","59548","2014",4,4,0,132000,1821.5,71.5
"17580","59549","2014",4,4,0,137400,1242,105.75
"17581","59550","2014",27,27,0,150748.1,1813.333,83.92593
"17582","59551","2014",22,22,0,225070.9,2064.091,120.6364
"17583","59552","2014",5,5,0,168000,1156.2,154.2
"17584","59553","2014",61,57,4,197226,2087.934,95.06557
"17585","59554","2014",7,7,0,160364.3,1619.714,97
"17586","59555","2014",5,5,0,84400,815,113.4
"17587","59556","2014",1,1,0,180000,1500,120
"17588","59557","2014",12,12,0,254874.2,2295.083,107.75
"17589","59558","2014",13,13,0,155176.9,1342.231,119
"17590","59559","2014",14,14,0,233938.6,2095.571,124.3571
"17591","59560","2014",123,104,19,154374.3,2026.862,79.10569
"17592","59562","2014",1,1,0,191350,1397,137
"17593","59563","2014",1,1,0,70000,507,138
"17594","59564","2014",20,19,1,109652.2,1239.45,88.35
"17595","59565","2014",4,4,0,187025,1409.75,140.75
"17596","59566","2014",33,33,0,234284.5,2301.879,102.4848
"17597","59567","2014",5,5,0,141260,1301.4,113.8
"17598","59568","2014",3,3,0,60500,688,88.66667
"17599","59569","2014",122,105,17,107640.1,1300,84.59016
"17600","59570","2014",5,5,0,223960,1686.8,130.2
"17601","59571","2014",39,38,1,84301.54,944.1795,86.82051
"17602","59572","2014",23,23,0,103611.7,1192.565,86.3913
"17603","59574","2014",106,104,2,119301.4,1311.538,93.0566
"17604","59576","2014",10,10,0,192731.8,1930.2,100.6
"17605","59577","2014",6,6,0,150533.3,1607.167,93.66667
"17606","59578","2014",13,13,0,168062.8,1691.462,102.9231
"17607","59579","2014",16,16,0,188682.8,1760.25,106.875
"17608","59580","2014",42,41,1,162254.8,1572.619,105.6667
"17609","59581","2014",24,24,0,211671.6,2030.208,103.6667
"17610","59582","2014",10,10,0,164127,1643.8,108.1
"17611","59583","2014",6,6,0,135941.7,1593.667,83.83333
"17612","59584","2014",2,2,0,152500,1350.5,116.5
"17613","59585","2014",44,38,6,201778.1,2281.159,89.27273
"17614","59586","2014",1,1,0,103500,1294,80
"17615","59587","2014",6,6,0,188916.7,1762.167,115.1667
"17616","59588","2014",57,55,2,208467.3,1991.421,106.9298
"17617","59589","2014",19,19,0,113850,1213.053,92.47368
"17618","59590","2014",9,9,0,104466.7,1295.444,87.44444
"17619","59591","2014",3,3,0,207500,1718.667,122
"17620","59592","2014",47,45,2,185026.4,1863,100.6383
"17621","59593","2014",7,7,0,91847.29,1272.714,79
"17622","59594","2014",8,8,0,175366.8,1746.875,110.25
"17623","59595","2014",8,8,0,130907.4,1449.75,98.625
"17624","59596","2014",6,6,0,229436.7,2147.667,119.8333
"17625","59597","2014",6,6,0,142127,1143.5,124.8333
"17626","59598","2014",35,35,0,214940,2283.086,96.37143
"17627","59599","2014",1009,736,273,128065.7,1541.787,84.97126
"17628","59600","2014",6,6,0,259064.2,2040.667,125.3333
"17629","59601","2014",25,25,0,117260,1017.48,112.92
"17630","59602","2014",9,9,0,193725.9,1921.667,104.6667
"17631","59603","2014",44,43,1,107500.7,1283.932,84.90909
"17632","59604","2014",5,5,0,144341,1255.2,120
"17633","59605","2014",19,19,0,188444.7,1839.263,100.6842
"17634","59606","2014",440,256,184,133141.4,1739.9,80.50455
"17635","59607","2014",4,4,0,160250,1086,141.75
"17636","59608","2014",10,10,0,137185,1099.1,117.7
"17637","59609","2014",18,13,5,164519.4,2015.889,83.11111
"17638","59610","2014",15,15,0,142416.3,1293.267,104.4
"17639","59611","2014",19,19,0,382631.6,2870.684,128.5263
"17640","59612","2014",7,7,0,192642.9,1777.286,110.1429
"17641","59613","2014",7,7,0,108642.9,1167.857,91.57143
"17642","59614","2014",9,9,0,101000,1247.889,78.33333
"17643","59615","2014",22,21,1,164964.3,1529.818,111.2727
"17644","59616","2014",67,67,0,103874.1,1238.687,86.71642
"17645","59617","2014",5,5,0,172877.2,1804.6,91
"17646","59618","2014",10,10,0,146194,1345.6,110.4
"17647","59619","2014",7,7,0,94685.71,947,96.85714
"17648","59620","2014",5,5,0,137400,1193.6,118.4
"17649","59622","2014",14,14,0,119214.3,1146.643,107.5
"17650","59623","2014",7,7,0,129357.1,1312.857,111.5714
"17651","59624","2014",14,14,0,97357.86,927.1429,108.3571
"17652","59625","2014",1,1,0,127500,777,164
"17653","59626","2014",11,11,0,152197.5,1507,97
"17654","59627","2014",6,6,0,98050,1187.667,82.66667
"17655","59628","2014",4,4,0,137000,1297.5,107.75
"17656","59629","2014",21,21,0,123636.2,1487.476,85.09524
"17657","59630","2014",30,30,0,152808.6,1706.3,91.33333
"17658","59631","2014",23,23,0,98454.13,907.087,111.1304
"17659","59632","2014",31,31,0,110167.7,1283.258,87.35484
"17660","59633","2014",1,1,0,128000,1471,87
"17661","59634","2014",6,6,0,174533.3,1757,102.1667
"17662","59635","2014",1,1,0,130000,929,140
"17663","59636","2014",109,82,27,255979.3,2708.404,93.22018
"17664","59637","2014",14,14,0,179664.3,1569.143,113.2143
"17665","59638","2014",4,4,0,141187.5,1595,90
"17666","59639","2014",8,8,0,175075,1713.75,100.5
"17667","59640","2014",5,5,0,181610,1414.4,125.2
"17668","59641","2014",23,23,0,169635.5,1674.652,103.5652
"17669","59642","2014",9,9,0,211475.6,1740.667,122.5556
"17670","59643","2014",2,2,0,125000,1152.5,113.5
"17671","59645","2014",3,3,0,76666.67,1185,67
"17672","59646","2014",221,194,27,241223.7,2435.195,95.55204
"17673","59647","2014",19,18,1,98228.95,1249.158,80.63158
"17674","59648","2014",135,87,48,181114.4,2109.489,85.01481
"17675","59649","2014",5,5,0,161606,1323,124.4
"17676","59650","2014",379,362,17,137991.5,1700.823,83.84433
"17677","59651","2014",8,8,0,95781.25,1096.25,87
"17678","59652","2014",4,4,0,117875,1183.25,100
"17679","59654","2014",40,39,1,120386.3,1288.15,95.25
"17680","59655","2014",5,5,0,187530,1800,111.6
"17681","59656","2014",51,42,9,207066.9,2163.059,98.80392
"17682","59657","2014",6,6,0,114550,1548.833,74.5
"17683","59658","2014",3,3,0,182966.7,1700.667,107.6667
"17684","59659","2014",20,20,0,76733,871.85,87.7
"17685","59660","2014",27,27,0,301337.4,2504.741,119.5185
"17686","59661","2014",2,2,0,92500,788.5,117
"17687","59662","2014",11,11,0,134894.3,1706.273,83.63636
"17688","59663","2014",60,56,4,177815.2,1811.15,102.1
"17689","59664","2014",4,4,0,164625,1568.75,104.25
"17690","59665","2014",3,3,0,106000,1052.333,110.3333
"17691","59666","2014",11,10,1,119190.9,1400.727,87.18182
"17692","59667","2014",3,3,0,160666.7,1749.667,93.33333
"17693","59668","2014",11,10,1,248224.5,2433.364,99.18182
"17694","59669","2014",1,1,0,105000,1050,100
"17695","59670","2014",17,17,0,265938.5,1973.059,133.6471
"17696","60001","2014",3,3,0,73500,732.3333,117.3333
"17697","60002","2014",6,6,0,218833.3,1829,116
"17698","60003","2014",3,3,0,138333.3,1879.333,74.33333
"17699","60004","2014",5,5,0,120700,1593.2,80.2
"17700","60005","2014",13,13,0,137730.8,1702.154,85.92308
"17701","60006","2014",11,11,0,168636.4,2116,80.45455
"17702","60007","2014",32,32,0,218017.2,2115.094,111.4688
"17703","60008","2014",5,5,0,156730,1937.4,78.8
"17704","60009","2014",6,6,0,176000,1647.333,107.1667
"17705","60010","2014",16,16,0,182447.9,2095.625,93.0625
"17706","60012","2014",28,28,0,191538.9,2288.321,87.42857
"17707","60013","2014",19,19,0,230421.1,2449.421,100.4737
"17708","60014","2014",1,1,0,96000,1200,80
"17709","60015","2014",15,13,2,168300,1899.6,90.8
"17710","60016","2014",3,3,0,216000,2184,93.66667
"17711","60017","2014",15,15,0,151299.3,1381.2,108
"17712","60019","2014",4,4,0,152435,1628,94.25
"17713","60020","2014",3,3,0,165333.3,1855.333,80.33333
"17714","60021","2014",4,4,0,139975,1286.5,111
"17715","60022","2014",9,9,0,280155.6,3312.667,88.55556
"17716","60023","2014",3,3,0,176200,1984,88.66667
"17717","60024","2014",8,8,0,163875,1580,108.125
"17718","60025","2014",12,12,0,143758.2,1458.583,99.08333
"17719","60026","2014",2,2,0,157500,1771,92.5
"17720","60027","2014",7,7,0,268414.3,3430.143,93.28571
"17721","60028","2014",11,10,1,347413.6,2659.727,130.6364
"17722","60029","2014",17,17,0,170029.6,1828.588,97
"17723","60030","2014",8,8,0,177000,2060.75,86.25
"17724","60031","2014",7,7,0,247642.9,2046.429,127.5714
"17725","60032","2014",1,1,0,76760,791,97
"17726","60033","2014",10,9,1,355800,3117.8,111.4
"17727","60034","2014",8,8,0,182125,1881.625,101.5
"17728","60035","2014",5,5,0,150050,1186,139
"17729","60036","2014",4,4,0,193950,2298.25,84.75
"17730","60037","2014",6,6,0,144825,1343.833,109
"17731","60039","2014",5,5,0,132600,1362.4,96.6
"17732","60040","2014",6,6,0,340250,1809.833,158.3333
"17733","60041","2014",14,14,0,199753.6,2048.714,98
"17734","60042","2014",12,12,0,181791.7,2019.333,90.5
"17735","60043","2014",5,5,0,173260,1549.6,113.2
"17736","60044","2014",14,14,0,121928.6,1735,85.28571
"17737","60045","2014",7,7,0,319122.7,3359,104.8571
"17738","60046","2014",2,2,0,224000,1991.5,114.5
"17739","60047","2014",7,7,0,224214.3,2777.857,82.14286
"17740","60048","2014",3,3,0,125333.3,1736.667,72.66667
"17741","60050","2014",1,1,0,214000,2518,85
"17742","60051","2014",3,3,0,113333.3,1520,93.33333
"17743","60053","2014",8,8,0,131875,1394.875,99.375
"17744","60054","2014",5,5,0,167900,2123,88
"17745","60055","2014",1,1,0,115000,1825,63
"17746","60057","2014",423,203,220,136455,1933.409,73.44444
"17747","60058","2014",1,1,0,120000,1412,85
"17748","60059","2014",2,2,0,225000,2214.5,119
"17749","60060","2014",4,4,0,316127.5,2670.5,121
"17750","60062","2014",3,3,0,96833.33,1433.333,67.66667
"17751","60063","2014",9,9,0,129166.7,1727.667,79.66667
"17752","60064","2014",4,4,0,186890,1747.75,109.25
"17753","60065","2014",16,16,0,182215,1879.375,109
"17754","60066","2014",2,2,0,205000,2567,80.5
"17755","60067","2014",12,12,0,164541.7,1857.917,91.66667
"17756","60068","2014",30,30,0,169985.3,1984.433,86.66667
"17757","60069","2014",13,11,2,229184.5,2130.923,107.8462
"17758","60070","2014",5,5,0,220000,1898.6,108.6
"17759","60071","2014",1,1,0,145000,1189,122
"17760","60072","2014",2,2,0,131500,2321,57
"17761","60073","2014",1,1,0,220000,1341,164
"17762","60074","2014",8,8,0,204145.6,2310.125,91.5
"17763","60075","2014",2,2,0,142500,1306.5,120.5
"17764","60076","2014",2,2,0,141000,1557.5,92
"17765","60077","2014",2,2,0,142500,2255.5,63.5
"17766","60078","2014",1,1,0,179000,2034,88
"17767","60079","2014",7,7,0,209571.4,1957.286,109.7143
"17768","60081","2014",2,2,0,198500,2552.5,100.5
"17769","60082","2014",6,6,0,166500,1386.833,126.3333
"17770","60083","2014",13,13,0,172638.5,1745.462,110.7692
"17771","60084","2014",4,4,0,94500,1572.5,70.25
"17772","60086","2014",16,15,1,226406.2,2938.562,83.75
"17773","60087","2014",4,4,0,303450,3492.5,97.5
"17774","60088","2014",54,42,12,212076.5,2447.519,95
"17775","60089","2014",2,2,0,290000,3571,83.5
"17776","60090","2014",2,2,0,188500,2359.5,80
"17777","60091","2014",4,4,0,175950,1863.5,95.5
"17778","60092","2014",3,3,0,144500,1345,109.3333
"17779","60093","2014",8,8,0,130250,1548.25,92.75
"17780","60094","2014",6,6,0,135425,1645.5,85.16667
"17781","60095","2014",2,2,0,130500,1989.5,63
"17782","60097","2014",4,4,0,124000,1726,70
"17783","60099","2014",2,2,0,216750,2016.5,98
"17784","60101","2014",9,9,0,179677.8,2163.111,84.11111
"17785","60102","2014",11,11,0,196454.5,1841.727,107
"17786","60103","2014",27,24,3,159459,1939.148,87.14815
"17787","60104","2014",24,24,0,116368.8,1497.083,82.375
"17788","60105","2014",1,1,0,29000,392,74
"17789","60107","2014",1,1,0,200500,2949,68
"17790","60110","2014",2,2,0,151000,1391.5,119.5
"17791","60111","2014",1,1,0,146000,1217,120
"17792","60112","2014",4,4,0,150000,2380.25,69.25
"17793","60113","2014",2,2,0,173500,1260.5,138
"17794","60114","2014",3,3,0,140649.3,1392.333,101.6667
"17795","60115","2014",7,7,0,133385.7,1677,79.85714
"17796","60116","2014",30,30,0,151710.3,1689.2,93.3
"17797","60117","2014",1,1,0,152000,1505,101
"17798","60118","2014",3,3,0,133500,985.6667,134
"17799","60119","2014",17,17,0,162147.1,1757.294,97.05882
"17800","60120","2014",13,13,0,190502.3,1928.154,102.3846
"17801","60121","2014",1,1,0,165000,1719,96
"17802","60122","2014",5,5,0,93400,1512.6,67.4
"17803","60123","2014",2,2,0,101088.5,1173.5,91
"17804","60124","2014",1,1,0,215000,2108,102
"17805","60125","2014",4,4,0,183250,2032.5,90
"17806","60126","2014",4,4,0,122000,1836.5,66.5
"17807","60127","2014",4,4,0,133625,1460.75,94.75
"17808","60128","2014",3,3,0,122166.7,1504.333,88.33333
"17809","60129","2014",12,12,0,161300,1712.25,103
"17810","60130","2014",8,8,0,187687.5,1885.125,107.125
"17811","60131","2014",1,1,0,139000,1324,105
"17812","60132","2014",1,1,0,158000,2107,75
"17813","60133","2014",8,8,0,142625,1621.75,88
"17814","60134","2014",20,18,2,182371,2006.45,92.95
"17815","60135","2014",20,20,0,173099.8,2261.35,80.65
"17816","60136","2014",5,5,0,91100,1123.6,82
"17817","60137","2014",1,1,0,70670,768,92
"17818","60138","2014",5,5,0,297600,2723.6,109.8
"17819","60139","2014",84,45,39,184522.9,2763.202,70.86905
"17820","60140","2014",1,1,0,230000,3833,60
"17821","60141","2014",143,22,121,235155.3,3388.846,71.1958
"17822","60142","2014",32,19,13,213593.4,2762.812,79.375
"17823","60143","2014",34,29,5,174114.4,2163.294,84.85294
"17824","60144","2014",1,1,0,431500,2615,165
"17825","60145","2014",6,6,0,183636.7,1970.333,94.83333
"17826","60146","2014",1,1,0,215000,1303,165
"17827","60147","2014",10,10,0,194800,1935.4,103.7
"17828","60148","2014",3,3,0,210666.7,2692.333,80.33333
"17829","60149","2014",4,4,0,241750,2490.25,97
"17830","60150","2014",9,9,0,129866.7,1554.333,86.66667
"17831","60151","2014",25,25,0,190628.8,2048.08,99.72
"17832","60152","2014",4,4,0,191500,1656,121.5
"17833","60154","2014",13,13,0,201153.8,1984.308,101
"17834","60155","2014",26,22,4,181140.4,2116.154,87.61538
"17835","60156","2014",27,24,3,209345.2,2147.704,101.4444
"17836","60157","2014",101,46,55,127851.4,1906.624,70.49505
"17837","60158","2014",3,3,0,126000,1811.333,73.33333
"17838","60159","2014",411,131,280,196474.9,2451.998,79.67153
"17839","60160","2014",7,7,0,161142.9,1496.143,112.5714
"17840","60162","2014",1,1,0,146500,1831,80
"17841","60163","2014",4,4,0,101250,1571,74
"17842","60164","2014",3,3,0,143333.3,1825.333,77.33333
"17843","60165","2014",8,8,0,192978.6,1707,117.875
"17844","60166","2014",8,8,0,216625,1758.875,130.875
"17845","60167","2014",3,3,0,103073.3,1230.667,90.33333
"17846","60169","2014",11,11,0,200545.5,1999.455,104
"17847","60170","2014",10,10,0,300630,2896.7,109.8
"17848","60171","2014",2,2,0,165500,2117,80
"17849","60172","2014",51,34,17,268989,3132.235,91.4902
"17850","60173","2014",4,3,1,235071.8,3636.25,74.75
"17851","60174","2014",2,2,0,89000,686.5,115.5
"17852","60175","2014",138,44,94,120130.9,1922.094,63.7971
"17853","60176","2014",169,102,67,177469.6,2418.148,76.06509
"17854","60177","2014",3,3,0,149166.7,2217,68.66667
"17855","60178","2014",18,16,2,114777.8,1572,74.55556
"17856","60179","2014",1,1,0,129000,1358,95
"17857","60180","2014",4,4,0,126125,1353,96
"17858","60181","2014",8,8,0,129062.5,1287.25,104.5
"17859","60182","2014",3,3,0,102666.7,1197,86.33333
"17860","60184","2014",5,5,0,171506.2,1879.8,100.4
"17861","60185","2014",8,8,0,186589.1,1872.875,103.375
"17862","60186","2014",2,2,0,154800,2117.5,78
"17863","60187","2014",12,12,0,141194.2,2000.25,79.83333
"17864","60188","2014",18,18,0,159880.6,1907.611,89
"17865","60189","2014",13,13,0,105227.7,1297.154,92.15385
"17866","60190","2014",1,1,0,195000,1523,128
"17867","60191","2014",5,5,0,115900,1574,78.6
"17868","60192","2014",1,1,0,138000,1643,84
"17869","60193","2014",1,1,0,185000,1457,127
"17870","60194","2014",2,2,0,121000,1875.5,65
"17871","60195","2014",5,5,0,254700,2020.6,150.6
"17872","60196","2014",10,10,0,196200,1719.3,119.6
"17873","60197","2014",3,3,0,164833.3,2478.667,88.33333
"17874","60198","2014",1,1,0,160000,1905,84
"17875","60199","2014",1,1,0,81500,1181,69
"17876","60200","2014",3,3,0,204333.3,1540.333,132
"17877","60203","2014",1,0,1,73000,1490,49
"17878","60204","2014",1,1,0,140000,1842,76
"17879","60205","2014",1,1,0,95000,1056,90
"17880","60206","2014",7,7,0,155714.3,1616.143,106.7143
"17881","60207","2014",4,4,0,218250,1567.25,143
"17882","60208","2014",3,3,0,165000,1834.667,89.66667
"17883","60209","2014",3,3,0,153333.3,2221.333,68.33333
"17884","60210","2014",4,4,0,161125,1535,108.25
"17885","60211","2014",6,6,0,153000,2002.167,79.33333
"17886","60212","2014",12,12,0,189666.7,2606.667,75.75
"17887","60213","2014",8,8,0,251375,2849.375,90.625
"17888","60214","2014",2,2,0,107721,1228,87.5
"17889","60215","2014",2,2,0,192500,2157,90.5
"17890","60216","2014",4,4,0,110881,1326,86.25
"17891","60217","2014",1,1,0,115100,1096,105
"17892","60218","2014",9,9,0,216772.2,2305.778,95.33333
"17893","60220","2014",6,6,0,196651.7,1637.333,134.8333
"17894","60221","2014",6,6,0,84833.33,1186.5,79.33333
"17895","60222","2014",8,8,0,142475,1642.875,87.75
"17896","60223","2014",25,25,0,178544,1847.4,99.44
"17897","60224","2014",1,1,0,179000,1790,100
"17898","60225","2014",5,5,0,149640,1504.4,104.2
"17899","60226","2014",4,4,0,258875,2284.5,116.75
"17900","60227","2014",2,2,0,107500,949.5,112.5
"17901","60228","2014",9,9,0,213444.4,2316.778,102.6667
"17902","60229","2014",1,1,0,130000,1121,116
"17903","60230","2014",3,3,0,139500,1436.667,106.3333
"17904","60231","2014",2,2,0,217500,2630,83
"17905","60232","2014",6,6,0,133500,1589.833,81
"17906","60233","2014",10,10,0,106350,1155,91.5
"17907","60234","2014",26,17,9,147949.1,1877.346,82.69231
"17908","60235","2014",7,7,0,208542.9,1984.143,103.8571
"17909","60236","2014",2,2,0,125000,1040.5,118
"17910","60238","2014",40,36,4,250617.5,2440.05,109.925
"17911","60239","2014",3,3,0,133326.3,1546.333,88.33333
"17912","60241","2014",4,3,1,318012.5,3299.5,95.5
"17913","60242","2014",1,1,0,80000,494,162
"17914","60243","2014",1,1,0,110000,2200,50
"17915","60245","2014",13,13,0,91040.69,1107.615,83.30769
"17916","60248","2014",3,3,0,96000,1301,73.66667
"17917","60249","2014",5,5,0,192800,1868.4,105.6
"17918","60250","2014",2,2,0,138000,1661.5,83
"17919","60251","2014",2,2,0,213410,1646,129.5
"17920","60252","2014",6,6,0,135633.3,1678.833,84.16667
"17921","60253","2014",4,4,0,214500,1748,117
"17922","60254","2014",4,4,0,214750,1582.5,136.5
"17923","60255","2014",2,2,0,130550,1997,65.5
"17924","60256","2014",13,13,0,177976.2,2063.615,92.76923
"17925","60257","2014",3,3,0,167672.7,1757,94.33333
"17926","60258","2014",1,1,0,240000,1395,172
"17927","60259","2014",9,9,0,237483.3,2608.111,92.22222
"17928","60260","2014",7,7,0,205835.7,1715,129
"17929","60261","2014",3,3,0,238516.7,2151.667,116
"17930","60262","2014",2,2,0,143000,1127.5,145
"17931","60263","2014",2,2,0,98500,1144.5,94
"17932","60264","2014",9,9,0,176111.1,1738.444,105.5556
"17933","60265","2014",6,6,0,132833.3,1387,114.8333
"17934","60267","2014",1,1,0,140000,1556,90
"17935","60268","2014",2,2,0,96000,1073.5,87
"17936","60269","2014",1,1,0,75000,938,80
"17937","60270","2014",3,3,0,87333.33,1396.333,58.66667
"17938","60271","2014",1,1,0,95000,1397,68
"17939","60272","2014",10,10,0,197640,2396.2,90.8
"17940","60273","2014",2,2,0,154750,1537.5,110.5
"17941","60274","2014",4,4,0,199612.5,1768.5,115
"17942","60275","2014",3,3,0,132000,1701.667,76
"17943","60276","2014",1,1,0,178000,1254,142
"17944","60277","2014",7,7,0,143714.3,1712.857,84.85714
"17945","60278","2014",3,3,0,75666.67,915,80.33333
"17946","60279","2014",1,1,0,142000,1775,80
"17947","60280","2014",1,1,0,69000,896,77
"17948","60281","2014",4,4,0,201925,1982.75,104.25
"17949","60282","2014",82,58,24,266445.6,2952.256,95.2561
"17950","60284","2014",12,12,0,196250,2127.667,96.5
"17951","60285","2014",6,6,0,158500,1753.667,90.5
"17952","60286","2014",21,21,0,130547.6,1567.619,90.14286
"17953","60287","2014",2,2,0,68000,940.5,77
"17954","60288","2014",3,3,0,108666.7,1206.333,91.33333
"17955","60289","2014",4,4,0,121037.5,1496.75,88
"17956","60290","2014",7,7,0,205285.7,1654.286,149.4286
"17957","60291","2014",10,10,0,121350,1105.2,115.9
"17958","60293","2014",10,10,0,368317.5,2214.6,168.3
"17959","60295","2014",4,4,0,113750,1431.75,86
"17960","60296","2014",1,1,0,112000,1244,90
"17961","60297","2014",2,2,0,107000,1155.5,92.5
"17962","60298","2014",1,1,0,2e+05,1538,130
"17963","60299","2014",5,5,0,101300,1076.8,99
"17964","60302","2014",3,3,0,153575.7,2032,75.33333
"17965","60304","2014",3,3,0,168500,2029,85
"17966","60305","2014",1,1,0,250750,2559,98
"17967","60306","2014",3,3,0,127166.7,1191.667,102.6667
"17968","60307","2014",6,6,0,146833.3,1556.667,91.66667
"17969","60308","2014",11,11,0,160026.4,1702.364,97.90909
"17970","60309","2014",8,8,0,208875,2225,103.625
"17971","60310","2014",3,3,0,159000,1598,103.3333
"17972","60311","2014",1,1,0,170000,1889,90
"17973","60312","2014",1,1,0,138000,3000,46
"17974","60314","2014",1,1,0,120000,1364,88
"17975","60315","2014",1,1,0,260000,1368,190
"17976","60316","2014",2,2,0,205000,2207.5,92.5
"17977","60317","2014",3,3,0,278166.7,2326.333,125
"17978","60318","2014",7,7,0,206571.4,1960.857,107.8571
"17979","60319","2014",7,7,0,139500,1672.571,80.57143
"17980","60320","2014",4,4,0,166250,1941.75,92.5
"17981","60321","2014",12,12,0,178870.8,2327.667,86.41667
"17982","60322","2014",2,2,0,209670,2454.5,89
"17983","60323","2014",5,5,0,132800,1712,79.4
"17984","60324","2014",9,9,0,116066.7,1560.444,75.55556
"17985","60325","2014",21,20,1,219270.6,2063.381,108.8095
"17986","60326","2014",7,7,0,261177.1,1987,129.7143
"17987","60327","2014",12,12,0,186833.3,2256.833,81.91667
"17988","60328","2014",3,3,0,197000,1854.333,108.6667
"17989","60330","2014",12,12,0,169433.3,1539.167,121.0833
"17990","60331","2014",7,7,0,137142.9,1705.429,100.2857
"17991","60332","2014",6,6,0,203500,2471.833,83.16667
"17992","60333","2014",13,13,0,140603.8,1605.308,96.07692
"17993","60334","2014",11,11,0,196859.2,2065.455,104.4545
"17994","60335","2014",1,1,0,88000,1467,60
"17995","60337","2014",4,3,1,327500,2570,130
"17996","60338","2014",40,40,0,183734.5,2058.6,90.825
"17997","60340","2014",4,4,0,79000,746,91.75
"17998","60341","2014",15,15,0,216268.5,2565.867,90.86667
"17999","60342","2014",40,33,7,158340.5,2001.525,81.3
"18000","60343","2014",8,8,0,148662.5,1720.375,90.75
"18001","60344","2014",3,3,0,165970,1822.333,91
"18002","60345","2014",6,6,0,134416.7,1783.333,75.16667
"18003","60346","2014",106,70,36,353242.5,3446.717,112.8396
"18004","60347","2014",3,3,0,118333.3,1038,109
"18005","60348","2014",3,3,0,164700,1168.667,140.6667
"18006","60350","2014",7,7,0,132285.7,1582,84
"18007","60351","2014",2,2,0,170000,1928,93
"18008","60352","2014",1,1,0,225000,2368,95
"18009","60353","2014",1,1,0,118000,1255,94
"18010","60355","2014",10,10,0,198950,1963.7,106.4
"18011","60356","2014",5,4,1,207000,2905.2,73.8
"18012","60357","2014",7,7,0,137928.6,1449,100
"18013","60358","2014",16,14,2,221606.9,2373.875,101.8125
"18014","60360","2014",71,47,24,137146.5,1990.958,72.87324
"18015","60361","2014",4,4,0,188250,2325.75,90.25
"18016","60362","2014",3,3,0,99666.67,1281,79.66667
"18017","60363","2014",2,2,0,307500,1801.5,161.5
"18018","60364","2014",5,5,0,178200,1678.2,110.6
"18019","60365","2014",5,5,0,135000,1584.8,101.8
"18020","60366","2014",4,3,1,172395,2693,71.25
"18021","60367","2014",8,8,0,177650,2190.625,81.25
"18022","60368","2014",14,13,1,134967.9,1868.143,73.28571
"18023","60369","2014",15,15,0,191022.5,1903,112.5333
"18024","60370","2014",13,13,0,174307.7,1752.462,107.8462
"18025","60371","2014",1,1,0,315000,3500,90
"18026","60372","2014",2,2,0,138750,1244,119.5
"18027","60373","2014",7,7,0,149899.3,2017.286,84.57143
"18028","60374","2014",23,20,3,137500,1725.13,82.82609
"18029","60375","2014",2,2,0,213000,2548,91.5
"18030","60376","2014",3,3,0,135333.3,1561.333,89
"18031","60377","2014",1,1,0,110000,991,111
"18032","60378","2014",4,4,0,131375,1798.75,73
"18033","60379","2014",8,8,0,178812.5,1654.875,110.25
"18034","60380","2014",11,9,2,149050,1919.909,80.45455
"18035","60381","2014",1,1,0,138000,1278,108
"18036","60382","2014",82,47,35,165950.3,2252.622,75.78049
"18037","60383","2014",6,6,0,119833.3,1358,92.33333
"18038","60385","2014",8,8,0,177787.5,1967.5,93.375
"18039","60386","2014",2,2,0,208500,1903,109
"18040","60387","2014",5,5,0,93552.8,1260.2,81.8
"18041","60388","2014",2,2,0,145000,1799,84.5
"18042","60389","2014",2,2,0,136000,1140,123.5
"18043","60390","2014",2,2,0,166500,1980,84.5
"18044","60391","2014",3,3,0,161633.3,1770.667,91.33333
"18045","60392","2014",9,9,0,148944.4,1706.111,91.11111
"18046","60393","2014",4,3,1,162500,1946,84.5
"18047","60394","2014",2,2,0,162000,1604,102
"18048","60395","2014",104,80,24,164250.5,2026.702,85.13462
"18049","60396","2014",4,4,0,101875,1326.75,82.25
"18050","60397","2014",1,1,0,128000,1829,70
"18051","60398","2014",26,20,6,220954.7,2600,89.5
"18052","60400","2014",4,4,0,129312.5,1023,129.5
"18053","60401","2014",7,7,0,170785.7,1906.143,91.42857
"18054","60402","2014",15,13,2,205740,2278.933,104.4667
"18055","60403","2014",12,12,0,123625,1652.417,76.5
"18056","60404","2014",15,15,0,175226.7,1885.467,95.13333
"18057","60405","2014",13,13,0,102846.2,1257.769,80.92308
"18058","60406","2014",13,13,0,168115.4,2078.538,81.76923
"18059","60407","2014",3,3,0,136666.7,1537.667,89.66667
"18060","60408","2014",5,5,0,144400,1208,124.8
"18061","60409","2014",21,20,1,169110.7,2008.476,85.61905
"18062","60410","2014",1,1,0,120000,811,148
"18063","60411","2014",8,8,0,206762.5,2183.75,98.375
"18064","60412","2014",9,9,0,228680.3,2079.667,112
"18065","60413","2014",3,3,0,200333.3,2439,82.66667
"18066","60414","2014",76,54,22,140193.4,1881.184,79.11842
"18067","60416","2014",2,2,0,92000,1572.5,58.5
"18068","60418","2014",8,8,0,132625,1976.375,73.625
"18069","60420","2014",4,4,0,247812.5,2341,105.5
"18070","60421","2014",4,4,0,259500,2608,100.25
"18071","60422","2014",7,7,0,230457.1,2450.286,103.5714
"18072","60423","2014",9,9,0,137444.4,1656.667,85.11111
"18073","60424","2014",3,3,0,167333.3,1904.667,90.66667
"18074","60425","2014",5,5,0,94200,1756.4,64.8
"18075","60426","2014",2,2,0,206500,1945.5,106
"18076","60427","2014",4,4,0,148200,1877.75,84.25
"18077","60428","2014",2,2,0,213500,1526.5,151
"18078","60429","2014",3,3,0,255666.7,2268.667,112
"18079","60430","2014",10,10,0,198010,2032.3,100.3
"18080","60431","2014",5,5,0,124020,1368.4,90.6
"18081","60432","2014",6,5,1,254833.3,2711.5,94.33333
"18082","60433","2014",2,2,0,213750,1876,114
"18083","60434","2014",1,1,0,1e+05,2083,48
"18084","60435","2014",4,4,0,145000,1928.25,76.75
"18085","60436","2014",2,2,0,252000,1611.5,153.5
"18086","60438","2014",2,2,0,108250,1103.5,99
"18087","60439","2014",64,51,13,124616.4,1739.594,78.0625
"18088","60440","2014",6,6,0,139166.7,1572.5,91.66667
"18089","60441","2014",8,8,0,196425,1814.375,113.75
"18090","60443","2014",6,6,0,136550,1695.5,87.33333
"18091","60444","2014",3,3,0,119666.7,1989.333,69
"18092","60445","2014",1,1,0,55000,1250,44
"18093","60446","2014",36,29,7,182672.2,2290.222,82.08333
"18094","60447","2014",8,8,0,181750,1984,95.375
"18095","60448","2014",7,7,0,143741.4,1915.714,78.42857
"18096","60449","2014",3,3,0,137888.7,1474.667,119
"18097","60450","2014",44,32,12,183493.2,2412.386,79.31818
"18098","60451","2014",15,15,0,178956.7,1797.267,97.8
"18099","60452","2014",5,5,0,238600,2725,101.2
"18100","60456","2014",11,11,0,162363.6,1726.727,99.72727
"18101","60457","2014",2,2,0,132500,1435.5,96
"18102","60458","2014",3,3,0,132000,1300,109.6667
"18103","60459","2014",1,1,0,253950,2373,107
"18104","60460","2014",2,2,0,158500,1941,82.5
"18105","60461","2014",1,1,0,3e+05,2143,140
"18106","60462","2014",27,23,4,171333.3,2172.519,85.51852
"18107","60463","2014",109,66,43,142079.9,1915.55,76.38532
"18108","60464","2014",16,16,0,159875,1770.188,99.875
"18109","60465","2014",1,1,0,79200,890,89
"18110","60466","2014",2,2,0,123000,1539.5,78.5
"18111","60468","2014",4,4,0,140598.5,1483.5,92
"18112","60469","2014",4,4,0,224364.8,2123.25,104.75
"18113","60470","2014",6,6,0,134333.3,1388.667,101.6667
"18114","60471","2014",91,62,29,103591.2,1326.231,80.15385
"18115","60473","2014",1,1,0,228000,4385,52
"18116","60474","2014",2,2,0,117500,1254,97
"18117","60476","2014",2,2,0,102500,1000,104
"18118","60477","2014",13,13,0,166861.5,1912.308,88.76923
"18119","60478","2014",6,5,1,205233.3,2083.333,100
"18120","60479","2014",6,6,0,172416.7,1970.333,88.5
"18121","60480","2014",3,2,1,84333.33,1414.667,72.66667
"18122","60481","2014",4,4,0,157250,1898.5,81.75
"18123","60482","2014",31,26,5,266750,2940.129,93.25806
"18124","60483","2014",6,6,0,145791.7,1342.333,109
"18125","60484","2014",1,1,0,1e+05,769,130
"18126","60485","2014",3,3,0,126000,1147.667,112.6667
"18127","60486","2014",4,4,0,92856.25,1364.25,66.25
"18128","60487","2014",3,3,0,192666.7,1854.667,100
"18129","60488","2014",1,1,0,80000,1270,63
"18130","60489","2014",9,8,1,207444.4,2309.889,98.77778
"18131","60490","2014",2,2,0,189000,1125,168
"18132","60491","2014",14,12,2,169551.4,1946.714,94.78571
"18133","60492","2014",11,11,0,168000,1583.182,109.0909
"18134","60493","2014",4,4,0,180750,1974.5,94.75
"18135","60494","2014",11,6,5,188595.5,2758.636,72.54545
"18136","60495","2014",2,2,0,173435,1781.5,97
"18137","60496","2014",2,2,0,90000,950,97.5
"18138","60497","2014",3,3,0,110000,1357,83
"18139","60498","2014",2,2,0,72000,1434,45
"18140","60499","2014",2,2,0,161500,1660.5,97.5
"18141","60500","2014",45,28,17,193802.9,2654.778,76.35556
"18142","60501","2014",15,15,0,189227.3,1914.8,102.8667
"18143","60504","2014",7,7,0,186142.9,1709.571,113.2857
"18144","60505","2014",9,8,1,267376.7,3123.444,94.22222
"18145","60506","2014",6,6,0,99750,1754.667,63.33333
"18146","60507","2014",6,6,0,162583.3,1550.5,107
"18147","60508","2014",44,40,4,196978.2,2214.295,92.79545
"18148","60509","2014",113,76,37,156198.8,2118.434,75.97345
"18149","60510","2014",10,10,0,193990,1743.6,120.6
"18150","60511","2014",2,2,0,97000,1905,57.5
"18151","60512","2014",2,2,0,225000,1589.5,141.5
"18152","60513","2014",37,34,3,216554.1,2679.892,84.75676
"18153","60514","2014",1,1,0,110000,1833,60
"18154","60515","2014",5,5,0,179200,1696,111.2
"18155","60516","2014",3,3,0,179500,2014,89.66667
"18156","60517","2014",6,6,0,200916.7,2310.833,89
"18157","60518","2014",1,1,0,180000,1078,167
"18158","60519","2014",1,1,0,145000,1422,102
"18159","60520","2014",3,3,0,99000,1571.333,63
"18160","60521","2014",3,3,0,148833.3,1558.667,113.3333
"18161","60522","2014",6,6,0,126333.3,1549.5,82.5
"18162","60523","2014",5,5,0,148300,1800.6,85.2
"18163","60524","2014",31,16,15,147033.9,1834.258,80.80645
"18164","60525","2014",2,2,0,510000,2502,236
"18165","60526","2014",9,9,0,151278.9,1804.444,87.22222
"18166","60529","2014",1,1,0,266191,1957,136
"18167","60530","2014",1,1,0,160000,1600,100
"18168","60531","2014",17,17,0,185374.7,2085.588,95.70588
"18169","60533","2014",13,13,0,120938.3,1575.154,78.69231
"18170","60534","2014",9,9,0,180444.4,1983.333,92
"18171","60535","2014",2,2,0,122000,1063.5,115.5
"18172","60537","2014",34,32,2,138760.3,1714.853,85.79412
"18173","60538","2014",4,4,0,161250,1397.5,127
"18174","60539","2014",18,18,0,179683.3,2076.944,89.38889
"18175","60540","2014",5,5,0,163010,1659.2,89.6
"18176","60541","2014",5,5,0,177000,1925.2,103.2
"18177","60542","2014",4,4,0,156591.8,1842.5,83
"18178","60544","2014",3,3,0,111666.7,1391,87
"18179","60545","2014",7,7,0,88857.14,1026.286,88.85714
"18180","60546","2014",2,2,0,260000,2435,106.5
"18181","60547","2014",5,5,0,192600,1840.2,111.8
"18182","60548","2014",7,7,0,184214.3,2324.714,87.57143
"18183","60549","2014",2,2,0,104000,1429,72.5
"18184","60550","2014",2,2,0,157250,1707.5,93
"18185","60552","2014",1,1,0,168000,2100,80
"18186","60553","2014",1,1,0,127000,1477,86
"18187","60554","2014",4,4,0,191500,1767.25,114
"18188","60556","2014",4,4,0,123750,1385.5,95.5
"18189","60558","2014",6,6,0,161633.3,1787.333,92.33333
"18190","60559","2014",7,7,0,133030.1,1641.143,83.14286
"18191","60560","2014",8,8,0,224062.5,2715.375,92.375
"18192","60562","2014",27,27,0,174933.6,1809.852,103.8148
"18193","60563","2014",5,5,0,164300,2311.4,91.6
"18194","60564","2014",3,3,0,125000,1392.333,89.33333
"18195","60565","2014",5,5,0,133320,1595.2,85
"18196","60566","2014",1,1,0,72000,800,90
"18197","60567","2014",9,9,0,152111.1,1671.667,91.77778
"18198","60568","2014",2,2,0,178000,1885,99.5
"18199","60569","2014",2,2,0,392650,1705.5,237
"18200","60570","2014",16,16,0,173956.7,2072.562,96.4375
"18201","60571","2014",1,1,0,32500,1250,26
"18202","60572","2014",5,5,0,197900,1770,116.8
"18203","60573","2014",2,2,0,129000,1225,107.5
"18204","60574","2014",8,7,1,139875,1949.25,80.625
"18205","60575","2014",43,37,6,172181.2,1953.14,92.2093
"18206","60576","2014",8,8,0,193514,1905,114.75
"18207","60577","2014",19,19,0,136710.5,1956.842,80.68421
"18208","60578","2014",7,7,0,133142.9,1843.857,81.71429
"18209","60579","2014",3,3,0,209000,1604.667,137
"18210","60581","2014",56,48,8,132517.8,1719.5,81.91071
"18211","60582","2014",7,7,0,143214.3,1743.143,83.28571
"18212","60583","2014",1,1,0,350000,1707,205
"18213","60584","2014",41,31,10,206582.5,2579.317,91.58537
"18214","60585","2014",4,4,0,83750,1649.5,53.25
"18215","60586","2014",2,2,0,180500,2132,86.5
"18216","60587","2014",20,20,0,190700,2169.8,91.3
"18217","60588","2014",4,4,0,152500,1424,109.25
"18218","60589","2014",18,12,6,182241.7,2721.889,75.61111
"18219","60590","2014",3,3,0,125000,1746,70.33333
"18220","60591","2014",10,10,0,210039.4,2249.6,95.1
"18221","60592","2014",6,6,0,153000,1629.167,104.5
"18222","60593","2014",4,4,0,103750,1172,88.25
"18223","60594","2014",3,3,0,185266.7,1742.667,108
"18224","60595","2014",8,8,0,152825,1546.875,102.125
"18225","60596","2014",5,5,0,109000,1029,114.8
"18226","60597","2014",12,12,0,164904.2,1974.167,90
"18227","60598","2014",10,10,0,144400,1547.4,105.3
"18228","60600","2014",4,4,0,298750,2149.5,142.25
"18229","60601","2014",11,8,3,145213.6,2190.091,65.45455
"18230","60603","2014",7,6,1,114071.4,1162.429,88.42857
"18231","60604","2014",1,1,0,52500,547,96
"18232","60605","2014",3,3,0,154000,1162.667,133.6667
"18233","60608","2014",3,3,0,117333.3,1318.333,89.33333
"18234","60609","2014",5,5,0,175000,1476.8,129.4
"18235","60610","2014",7,7,0,147200,1667,91.28571
"18236","60611","2014",5,5,0,143000,1870.2,77.8
"18237","60612","2014",164,69,95,242459.7,2898.354,85.67683
"18238","60613","2014",1,1,0,401000,2554,157
"18239","60614","2014",2,2,0,221150,1751,139.5
"18240","60615","2014",2,2,0,118000,1229,109
"18241","60616","2014",24,24,0,153385.4,1802.542,91.54167
"18242","60617","2014",2,2,0,120750,1125,108
"18243","60618","2014",3,3,0,184166.7,1940,95.66667
"18244","60619","2014",12,9,3,227817.9,2553.833,90.41667
"18245","60620","2014",3,3,0,221000,2118,105
"18246","60621","2014",1,1,0,182500,1250,146
"18247","60622","2014",3,3,0,137333.3,1531,90
"18248","60623","2014",8,8,0,106333.1,1399.625,73.125
"18249","60624","2014",2,2,0,160250,1649.5,98
"18250","60625","2014",3,3,0,142333.3,1371.333,106
"18251","60626","2014",9,9,0,125388.9,1524.556,94.22222
"18252","60628","2014",6,6,0,101166.7,1670.5,64.16667
"18253","60630","2014",4,4,0,113000,1594.75,76
"18254","60631","2014",10,9,1,258412.5,2628,101.8
"18255","60632","2014",14,14,0,124428.6,1630.143,83.92857
"18256","60633","2014",1,1,0,154500,1907,81
"18257","60634","2014",3,3,0,88333.33,844,105.3333
"18258","60635","2014",5,4,1,163284,1846.4,89.4
"18259","60636","2014",37,32,5,145016.2,1789.541,82.43243
"18260","60637","2014",3,3,0,193221.7,1522.667,124
"18261","60638","2014",4,4,0,181575,2399.5,83.75
"18262","60639","2014",8,8,0,207500,2150.875,97.625
"18263","60641","2014",24,23,1,157233.3,1802.75,98.375
"18264","60642","2014",9,9,0,148222.2,1781.556,89.66667
"18265","60643","2014",10,10,0,142200,1390.4,112.2
"18266","60644","2014",23,21,2,211323.1,2198.261,104
"18267","60645","2014",6,6,0,187500,2350.167,86.5
"18268","60646","2014",9,9,0,173077.1,1557.778,118.3333
"18269","60647","2014",18,18,0,132071.3,1580.611,85.66667
"18270","60648","2014",2,2,0,86500,1656,51
"18271","60650","2014",6,6,0,249166.7,2107.333,122.6667
"18272","60651","2014",18,18,0,176205.6,2124.333,87
"18273","60652","2014",7,6,1,164357.1,1913,113.5714
"18274","60653","2014",1,1,0,190000,1583,120
"18275","60655","2014",3,3,0,104666.7,1143,93.66667
"18276","60656","2014",5,5,0,178222,3484.4,76.2
"18277","60657","2014",4,4,0,156750,1357.5,114.75
"18278","60658","2014",6,6,0,171333.3,1672,106.1667
"18279","60659","2014",2,2,0,235775,2376,101.5
"18280","60660","2014",6,6,0,221916.7,2176,115.8333
"18281","60661","2014",15,11,4,129419.7,2026.267,74.33333
"18282","60662","2014",3,3,0,136000,1697.667,79.33333
"18283","60663","2014",1,1,0,188000,1938,97
"18284","60664","2014",9,9,0,149416.7,1506.556,100.1111
"18285","60665","2014",35,30,5,176225.3,2284.571,89
"18286","60666","2014",6,6,0,257938.5,2556.667,115.1667
"18287","60667","2014",45,32,13,159505.8,2212.467,82.91111
"18288","60668","2014",5,5,0,191400,1855.6,110
"18289","60669","2014",6,6,0,191666.7,1968.333,99.16667
"18290","60670","2014",46,37,9,192099.6,2258.391,87.54348
"18291","60673","2014",4,4,0,122000,1436.75,84.75
"18292","60674","2014",6,6,0,233000,2839.167,103.3333
"18293","60676","2014",7,7,0,146721.4,1702,86.71429
"18294","60677","2014",2,2,0,181700,1678,109
"18295","60678","2014",10,9,1,189845,2750.4,75.4
"18296","60679","2014",3,3,0,178233.3,2077.667,90
"18297","60680","2014",4,4,0,203837.5,2439.5,82.5
"18298","60681","2014",3,3,0,159666.7,1287.333,124.3333
"18299","60682","2014",9,7,2,244866.7,3220,77.55556
"18300","60683","2014",3,3,0,229833.3,2301.333,103.3333
"18301","60684","2014",37,29,8,171815.3,2088.568,84.91892
"18302","60686","2014",33,30,3,244766.7,2440.273,104.6667
"18303","60687","2014",4,4,0,104843.8,1408.5,77
"18304","60689","2014",12,12,0,261450,1771.5,147.5
"18305","60692","2014",3,3,0,117333.3,1934.333,77.33333
"18306","60693","2014",6,6,0,95116.67,1026.5,101
"18307","60695","2014",14,13,1,342512.9,3071.5,118.4286
"18308","60697","2014",1,1,0,150000,3750,40
"18309","60698","2014",3,3,0,83000,1136.333,70.33333
"18310","60700","2014",14,14,0,208564.3,2110,108.0714
"18311","60701","2014",2,2,0,96000,1175,81
"18312","60702","2014",4,4,0,163500,1392,121.75
"18313","60703","2014",9,9,0,174866.7,1836.333,99.44444
"18314","61001","2014",235,157,78,105162.9,1326.557,80.38298
"18315","61002","2014",5,5,0,86200,664,127.2
"18316","61005","2014",6,6,0,140731.7,1451.5,101.6667
"18317","61006","2014",86,62,24,105081.1,1264.047,84.65116
"18318","61007","2014",39,39,0,91686.41,1127.718,86.4359
"18319","61008","2014",11,11,0,82681.82,1213.636,71.54545
"18320","61010","2014",5,5,0,106600,1062,102.2
"18321","61011","2014",4,4,0,148250,1273,136.5
"18322","61012","2014",1,1,0,43000,915,47
"18323","61013","2014",4,4,0,120375,865.25,148.75
"18324","61014","2014",1,1,0,152000,1689,90
"18325","61015","2014",2,2,0,78500,1433,63
"18326","61017","2014",2,2,0,275000,1487,177
"18327","61020","2014",2,2,0,20750,509.5,43
"18328","61021","2014",2,2,0,55000,781,65
"18329","61023","2014",9,9,0,162455.6,1235.556,123.7778
"18330","61024","2014",10,10,0,98625,921.3,109.2
"18331","61026","2014",6,6,0,87166.67,1658,61.33333
"18332","61028","2014",3,3,0,175666.7,1475.667,121
"18333","61029","2014",7,7,0,111285.7,1105,105.7143
"18334","61032","2014",2,2,0,250500,2022,109
"18335","61034","2014",4,4,0,124375,1412,88.5
"18336","61035","2014",3,3,0,116066.7,1133.333,103.6667
"18337","61036","2014",1,1,0,127000,847,150
"18338","61037","2014",1,1,0,70000,1228,57
"18339","61038","2014",15,15,0,136640,1201.267,107.6667
"18340","61039","2014",2,2,0,99000,1002.5,95
"18341","61040","2014",5,5,0,94100,831.2,105.2
"18342","61041","2014",5,5,0,123800,1166.6,103
"18343","61043","2014",9,9,0,146667.3,1359.333,109.1111
"18344","61044","2014",2,2,0,73500,917,76
"18345","61049","2014",1,1,0,113220,1258,90
"18346","61050","2014",9,9,0,105222.2,1029.778,97.33333
"18347","61051","2014",2,2,0,109250,1114,100
"18348","61052","2014",1,1,0,75000,1154,65
"18349","61053","2014",1,1,0,95000,1033,92
"18350","61054","2014",3,3,0,97666.67,1280.333,70.66667
"18351","61055","2014",3,3,0,121423.3,941.6667,134.3333
"18352","61056","2014",4,4,0,113650,1214.5,86.75
"18353","61060","2014",3,3,0,111000,1445,76
"18354","61061","2014",17,17,0,119426.5,1375.353,87.47059
"18355","61062","2014",1,1,0,105000,875,120
"18356","61063","2014",6,6,0,71866.67,829.5,95.5
"18357","61067","2014",1,1,0,120000,889,135
"18358","61068","2014",2,2,0,117500,1779.5,71.5
"18359","61069","2014",4,4,0,59100,948.5,60.75
"18360","61070","2014",7,7,0,121071.4,1136.571,109.1429
"18361","61071","2014",1,1,0,117000,2250,52
"18362","61072","2014",5,5,0,122900,951.8,121.4
"18363","61074","2014",2,2,0,88750,1027,79
"18364","61075","2014",6,6,0,45416.67,1012,45.66667
"18365","61077","2014",6,6,0,146394.2,1393,108.6667
"18366","61078","2014",1,1,0,130000,1566,83
"18367","61079","2014",20,20,0,113765,1027.4,109.2
"18368","61080","2014",2,2,0,84500,1212.5,94
"18369","61081","2014",3,3,0,108600,856.3333,133
"18370","61084","2014",1,1,0,73000,1197,61
"18371","61086","2014",1,1,0,470000,4273,110
"18372","61088","2014",3,3,0,71004.33,987.6667,66.66667
"18373","61089","2014",3,3,0,120666.7,1247,98
"18374","61091","2014",11,11,0,76690.18,916.5455,85.27273
"18375","61092","2014",8,8,0,129375,1129.75,120.875
"18376","61093","2014",11,11,0,83970.45,908,95.36364
"18377","61094","2014",5,5,0,105400,1204.4,82.2
"18378","61095","2014",8,8,0,117658.9,1200.75,99.125
"18379","61096","2014",18,18,0,90700,1000.833,89.66667
"18380","61097","2014",11,11,0,119363.6,1374.182,105.1818
"18381","61098","2014",1,1,0,90000,608,148
"18382","61099","2014",3,3,0,66523.33,813.3333,91.66667
"18383","61100","2014",2,2,0,233000,1664,147
"18384","61102","2014",2,2,0,163500,1110.5,182
"18385","61103","2014",5,5,0,87800,1426.8,65.8
"18386","61105","2014",4,4,0,121125,1772,76.5
"18387","61107","2014",5,5,0,115200,1297.4,95.4
"18388","61108","2014",4,4,0,63750,973.75,64.5
"18389","61111","2014",2,2,0,109500,1258.5,91
"18390","61113","2014",1,1,0,152000,1382,110
"18391","61114","2014",2,2,0,204400,1813.5,105
"18392","61116","2014",27,27,0,127604.2,1262.444,105.4815
"18393","61117","2014",9,8,1,116222.2,1495.222,84.44444
"18394","61118","2014",2,2,0,130000,1228.5,107.5
"18395","61121","2014",8,8,0,98937.5,1091,87.125
"18396","61124","2014",5,5,0,108680,1131.8,98.8
"18397","61126","2014",4,4,0,107650,1399,75
"18398","61129","2014",3,3,0,113706.7,1406,80.66667
"18399","61130","2014",3,3,0,99733.33,1214.667,81
"18400","61133","2014",3,3,0,107500,1606.667,76.33333
"18401","61137","2014",2,2,0,71500,785,91
"18402","61138","2014",2,2,0,220000,2268.5,144
"18403","61139","2014",7,7,0,124242.9,1140.286,109.4286
"18404","61140","2014",10,10,0,92850,1235.4,74.3
"18405","61141","2014",2,2,0,112500,1364.5,82.5
"18406","61142","2014",2,2,0,101000,2706.5,64.5
"18407","61143","2014",18,15,3,94916.67,1425.667,66.33333
"18408","61145","2014",40,36,4,88703.73,994.55,95.25
"18409","61146","2014",4,4,0,93685,1157.25,80.75
"18410","61148","2014",3,3,0,121066.7,939.6667,125.3333
"18411","61149","2014",4,4,0,60204.5,974.75,64.25
"18412","61150","2014",7,7,0,92357.14,1119.429,95.14286
"18413","61151","2014",4,4,0,118065.5,1206.5,103.25
"18414","61152","2014",1,1,0,123000,1618,76
"18415","61153","2014",18,18,0,121864.4,1005.222,123
"18416","61156","2014",5,5,0,175769.8,1314.8,131
"18417","61158","2014",1,1,0,50000,735,68
"18418","61160","2014",4,4,0,157728.2,1292.25,119.75
"18419","61162","2014",1,1,0,60000,517,116
"18420","61163","2014",14,14,0,75961.71,1024.357,76.5
"18421","61164","2014",2,2,0,132555,1168.5,122.5
"18422","61165","2014",3,3,0,161666.7,1524.667,108
"18423","61166","2014",2,2,0,152500,1616,97
"18424","61167","2014",34,34,0,98034.12,1030.735,97.94118
"18425","61168","2014",27,27,0,79659.26,970.4815,79.03704
"18426","61169","2014",100,63,37,81880,981.53,83.61
"18427","61170","2014",2,2,0,65000,780,93
"18428","61171","2014",1,1,0,106500,1420,75
"18429","61176","2014",1,1,0,120000,1263,95
"18430","61178","2014",1,1,0,20000,370,54
"18431","61180","2014",1,1,0,231400,1532,151
"18432","61181","2014",15,13,2,90366.67,992.0667,95.73333
"18433","61182","2014",4,4,0,104475,1533.75,102.75
"18434","61183","2014",2,2,0,80050,1089,71
"18435","61187","2014",2,2,0,97500,2591,37.5
"18436","61188","2014",1,1,0,46000,575,80
"18437","61189","2014",4,4,0,81000,1073.75,73
"18438","61190","2014",1,1,0,90000,1059,85
"18439","61193","2014",3,3,0,120666.7,1380.333,95.33333
"18440","61194","2014",7,7,0,217428.6,1283.571,135
"18441","61195","2014",2,2,0,92425,954.5,95
"18442","61196","2014",17,17,0,106815.3,1217.235,93.52941
"18443","61197","2014",2,2,0,122500,957.5,128
"18444","61198","2014",1,1,0,305000,3961,77
"18445","61199","2014",5,5,0,122480,1178.4,113.8
"18446","61203","2014",6,6,0,118712.3,1212.333,92.83333
"18447","61206","2014",1,1,0,180000,1286,140
"18448","61207","2014",9,9,0,169244.4,1581.111,111.5556
"18449","61208","2014",7,6,1,129468.6,1410.571,103.4286
"18450","61209","2014",2,2,0,95000,929.5,104.5
"18451","61210","2014",5,5,0,272296,2699,133.8
"18452","61211","2014",18,18,0,72401.11,886,87.33333
"18453","61213","2014",2,2,0,108500,1656,56
"18454","61214","2014",78,69,9,110841.7,1268.487,91.41026
"18455","61215","2014",6,6,0,106817.8,1445.167,82.16667
"18456","61217","2014",2,2,0,109500,1329,78.5
"18457","61218","2014",18,17,1,93760.22,1039.5,94.88889
"18458","61219","2014",4,4,0,94250,930.5,96.25
"18459","61221","2014",3,3,0,113666.7,1371.333,80
"18460","61222","2014",10,10,0,92200.4,1037.8,89.6
"18461","61224","2014",4,4,0,145333.2,1059.75,136.5
"18462","61228","2014",1,1,0,90000,1059,85
"18463","61229","2014",1,1,0,1e+05,1429,70
"18464","61230","2014",48,48,0,115109.7,1192.792,104.6667
"18465","61232","2014",10,10,0,99539.1,1249.8,84.1
"18466","61233","2014",1,1,0,104000,874,119
"18467","61234","2014",10,10,0,158264.8,1383.7,112.6
"18468","61237","2014",2,2,0,95000,1195,79
"18469","61238","2014",2,2,0,101500,793,129.5
"18470","61240","2014",5,5,0,79411.6,806.2,102.6
"18471","61241","2014",2,2,0,93750,1170,77.5
"18472","61242","2014",6,6,0,133533.3,1742.5,88.83333
"18473","61243","2014",15,15,0,141688,1381.133,97.8
"18474","61244","2014",4,4,0,136550,1369.5,108
"18475","61248","2014",7,7,0,40785.71,665.2857,66.71429
"18476","61251","2014",2,2,0,115500,952.5,127.5
"18477","61252","2014",2,2,0,129500,1698,88
"18478","61255","2014",3,3,0,112666.7,1000.333,109.3333
"18479","61256","2014",1,1,0,48000,800,60
"18480","61257","2014",2,2,0,134000,1406.5,94.5
"18481","61258","2014",9,8,1,106394,1462.444,76.77778
"18482","61259","2014",3,3,0,95000,911.3333,104.3333
"18483","61260","2014",8,8,0,61875,876.25,69.25
"18484","61261","2014",5,5,0,141400,1119.4,130
"18485","61262","2014",1,1,0,158000,1090,145
"18486","61263","2014",5,5,0,182334,2572.6,75.6
"18487","61264","2014",1,1,0,43000,1870,23
"18488","61265","2014",3,3,0,92800,905.6667,98.66667
"18489","61266","2014",1,0,1,85000,1062,80
"18490","61267","2014",2,2,0,74100.5,1215.5,59.5
"18491","61269","2014",4,4,0,58500,954.75,64.25
"18492","61272","2014",1,1,0,75000,1500,50
"18493","61273","2014",1,1,0,144400,1086,133
"18494","61275","2014",7,7,0,91571.43,1007.857,83.57143
"18495","61276","2014",4,4,0,87562.5,1344.25,59
"18496","61277","2014",4,4,0,188500,1706.75,131.25
"18497","61278","2014",11,11,0,82826.27,1025.273,76.81818
"18498","61279","2014",3,3,0,190916.7,1241,144.3333
"18499","61281","2014",2,2,0,102000,1117,92
"18500","61283","2014",1,1,0,83000,1051,79
"18501","61284","2014",3,3,0,122666.7,1119.333,114.3333
"18502","61287","2014",3,2,1,65000,772.3333,85.33333
"18503","61288","2014",4,4,0,149750,1195.25,138
"18504","61289","2014",2,2,0,3e+05,1386,178
"18505","61290","2014",1,1,0,75000,1000,75
"18506","61292","2014",5,5,0,74340,784.4,98
"18507","61293","2014",22,21,1,120427.3,1625.409,78.81818
"18508","61294","2014",9,8,1,106223.3,1060.444,111
"18509","61297","2014",4,4,0,74750,713.5,105.75
"18510","61300","2014",5,5,0,73600,1067.6,82.8
"18511","61301","2014",1,1,0,168000,933,180
"18512","61302","2014",1,1,0,68000,1236,55
"18513","61303","2014",8,8,0,95250,1117.875,91.75
"18514","61304","2014",5,5,0,104400,1255.8,92.2
"18515","61307","2014",4,4,0,90250,1004.5,98
"18516","61308","2014",2,2,0,106500,1078.5,102
"18517","61309","2014",17,17,0,178424.7,1553.118,109.7647
"18518","61310","2014",3,3,0,131000,2007.667,63.33333
"18519","61314","2014",4,4,0,118750,1321,89.5
"18520","61316","2014",2,2,0,83150,992,85
"18521","61321","2014",1,1,0,95000,1188,80
"18522","61323","2014",2,2,0,125500,1278,96
"18523","61324","2014",13,12,1,76130.77,807.4615,96.69231
"18524","61326","2014",3,3,0,63166.67,904,76.33333
"18525","61327","2014",3,3,0,146666.7,972.6667,165.3333
"18526","61329","2014",6,6,0,129803.8,1150.5,104
"18527","61330","2014",1,1,0,89000,967,92
"18528","61331","2014",1,1,0,220000,2418,91
"18529","61332","2014",2,2,0,58500,658.5,94.5
"18530","61333","2014",3,3,0,208800,1690.667,117.3333
"18531","61339","2014",24,23,1,91977.08,1101.75,83.04167
"18532","61341","2014",12,12,0,143361.4,1408.5,103.5
"18533","61342","2014",11,11,0,108906.9,1209.364,90.72727
"18534","61344","2014",10,10,0,102665,1074.1,115.8
"18535","61345","2014",21,20,1,155590.5,1333.476,120.0952
"18536","61346","2014",4,4,0,122875,1459.5,93
"18537","61347","2014",1,1,0,88500,1135,78
"18538","61348","2014",4,4,0,97125,1798,81.75
"18539","61349","2014",2,2,0,172500,1151,133.5
"18540","61350","2014",3,3,0,76333.33,1194.667,77.33333
"18541","61352","2014",1,1,0,102500,861,119
"18542","61357","2014",3,3,0,58316.67,646.3333,95.66667
"18543","61358","2014",2,2,0,136500,1077,126.5
"18544","61360","2014",1,1,0,88000,917,96
"18545","61361","2014",3,3,0,120576,1207,97
"18546","61362","2014",1,1,0,87500,795,110
"18547","61363","2014",1,1,0,149000,1419,105
"18548","61365","2014",5,5,0,98321.8,1151,85.4
"18549","61367","2014",1,1,0,170000,1371,124
"18550","61369","2014",5,5,0,88780,1067.6,87
"18551","61370","2014",1,1,0,27000,750,36
"18552","61371","2014",1,1,0,70000,707,99
"18553","61372","2014",4,4,0,133500,1805.5,76.75
"18554","61373","2014",3,3,0,137666.7,1072.333,140.6667
"18555","61374","2014",1,1,0,145000,1480,98
"18556","61375","2014",7,7,0,117714.3,1310.143,82.57143
"18557","61376","2014",4,4,0,46500,765,61.25
"18558","61379","2014",4,4,0,230000,1933.25,116.75
"18559","61382","2014",7,7,0,135501.3,977.8571,141.7143
"18560","61384","2014",3,3,0,92266.67,1084,82
"18561","61385","2014",8,8,0,117998.1,1273.875,93
"18562","61386","2014",6,6,0,109500,1379.333,86.33333
"18563","61387","2014",2,2,0,40250,812,60.5
"18564","61388","2014",1,1,0,38550,964,40
"18565","61389","2014",13,13,0,86692.31,953.9231,97.84615
"18566","61390","2014",1,1,0,140000,1429,98
"18567","61391","2014",28,28,0,121900,1231.036,98.78571
"18568","61393","2014",2,2,0,43650,1003.5,47.5
"18569","61394","2014",11,11,0,67809.09,1102.636,67.72727
"18570","61395","2014",5,5,0,135400,1874.2,74.6
"18571","61396","2014",1,1,0,186500,3730,50
"18572","61397","2014",21,21,0,129132,1346.238,95.95238
"18573","61399","2014",1,1,0,118000,1639,72
"18574","61400","2014",4,4,0,97000,1164.25,85.75
"18575","61401","2014",3,3,0,144166.7,1335.667,118.3333
"18576","61404","2014",6,6,0,102500,1313.167,76.16667
"18577","61405","2014",5,5,0,84600,1127.2,74
"18578","61406","2014",5,5,0,83500,1226,73.4
"18579","61407","2014",9,9,0,124044.4,1414.333,88.44444
"18580","61411","2014",1,1,0,269600,2106,128
"18581","61412","2014",8,8,0,134425,1132,114.375
"18582","61414","2014",9,9,0,118111.1,1316.778,104
"18583","61415","2014",3,3,0,165083.3,1547,104
"18584","61418","2014",8,8,0,92125,1152.125,79.5
"18585","61419","2014",5,5,0,101160,1063.4,102.4
"18586","61421","2014",5,5,0,90800,922.8,105
"18587","61422","2014",9,9,0,83222.22,1063.889,84
"18588","61423","2014",4,4,0,138700,1735.5,83
"18589","61425","2014",1,1,0,2e+05,1695,118
"18590","61426","2014",4,4,0,89525,987.25,86.75
"18591","61427","2014",3,3,0,96810,863,108.6667
"18592","61429","2014",8,8,0,82000,889,91.875
"18593","61432","2014",3,3,0,180333.3,1763.667,104.3333
"18594","61433","2014",4,4,0,162025,2512,59.25
"18595","61435","2014",4,4,0,93000,1788.25,56.5
"18596","61436","2014",3,3,0,86300,923,95
"18597","61438","2014",2,2,0,145000,1368.5,109
"18598","61439","2014",4,4,0,81250,999.5,81.5
"18599","61440","2014",7,7,0,161428.6,1522.714,104.5714
"18600","61442","2014",2,2,0,91500,1199,89.5
"18601","61443","2014",6,6,0,111858.3,1167,95
"18602","61444","2014",1,1,0,40000,625,64
"18603","61445","2014",7,7,0,99142.86,1009.286,98.57143
"18604","61446","2014",4,4,0,99472.75,1792.25,55.75
"18605","61447","2014",4,4,0,102250,989.25,109
"18606","61448","2014",4,4,0,135025,1172.75,112
"18607","61450","2014",2,2,0,198000,1566.5,125
"18608","61451","2014",3,3,0,89000,1040,85
"18609","61452","2014",1,1,0,30000,1667,18
"18610","61453","2014",1,1,0,150000,1829,82
"18611","61454","2014",6,6,0,157116.7,1631.833,102.8333
"18612","61456","2014",16,16,0,120906.2,1400.312,90.1875
"18613","61457","2014",4,4,0,133325,1447.5,93.5
"18614","61459","2014",2,2,0,120000,759.5,145.5
"18615","61460","2014",9,9,0,97785.56,1024.444,100.6667
"18616","61461","2014",1,1,0,48000,800,60
"18617","61462","2014",10,10,0,146355,1460.3,105.2
"18618","61463","2014",8,8,0,75250,998.75,76.625
"18619","61464","2014",26,25,1,121807.7,1319.577,90.11538
"18620","61466","2014",9,9,0,75767.56,1013.222,74.33333
"18621","61472","2014",3,3,0,143983.3,1537.667,89.66667
"18622","61473","2014",1,1,0,60000,600,100
"18623","61474","2014",32,32,0,122248.2,1263.656,98.4375
"18624","61475","2014",16,16,0,103887.5,1387,78.625
"18625","61476","2014",6,6,0,114000,1396,91.33333
"18626","61480","2014",1,1,0,2e+05,1000,200
"18627","61481","2014",1,1,0,160000,2000,80
"18628","61482","2014",2,2,0,82000,1379,58.5
"18629","61483","2014",65,19,46,85249.08,1552.754,56.04615
"18630","61484","2014",32,32,0,124689.1,1363.75,98.46875
"18631","61485","2014",2,2,0,160250,1299,121.5
"18632","61486","2014",35,34,1,81089.43,854.5714,95.91429
"18633","61487","2014",4,4,0,66450,606,113.5
"18634","61488","2014",1,1,0,95000,905,105
"18635","61491","2014",40,39,1,119516,1431.2,87.575
"18636","61492","2014",1,1,0,60000,594,101
"18637","61494","2014",11,11,0,89409.09,1047.909,96.36364
"18638","61497","2014",15,15,0,119936.5,1194.667,103.2
"18639","61498","2014",3,3,0,119833.3,1419.333,87.33333
"18640","61499","2014",1,1,0,179650,1331,135
"18641","61500","2014",1,1,0,72000,1385,52
"18642","61501","2014",4,4,0,85425,1412,60.25
"18643","61502","2014",1,1,0,65000,867,75
"18644","61503","2014",2,2,0,119900,1132.5,106
"18645","61505","2014",2,2,0,112500,1006.5,111.5
"18646","61507","2014",1,1,0,148000,1113,133
"18647","61508","2014",29,26,3,94282.34,1138,82.37931
"18648","61510","2014",3,3,0,92333.33,1096.333,97.66667
"18649","62001","2014",25,25,0,172412,1754.96,98.6
"18650","62002","2014",1,1,0,80000,708,113
"18651","62003","2014",6,6,0,208354.2,1848.333,119.1667
"18652","62004","2014",82,74,8,150534.6,1702.415,89.08537
"18653","62005","2014",13,13,0,132961.5,1285.615,107.6923
"18654","62006","2014",3,3,0,68666.67,712.6667,95
"18655","62007","2014",8,8,0,189525,1469.625,134.125
"18656","62008","2014",7,7,0,147164.3,1440.714,98.85714
"18657","62009","2014",2,2,0,202500,1718,117.5
"18658","62010","2014",1,1,0,176000,1600,110
"18659","62011","2014",5,5,0,239650,2339.4,106.6
"18660","62012","2014",4,4,0,141875,1417.5,99.25
"18661","62013","2014",9,9,0,168177.3,1646,104.8889
"18662","62014","2014",67,62,5,119700.7,1293.06,99.41791
"18663","62016","2014",1,1,0,220000,4400,50
"18664","62017","2014",2,2,0,115000,1308,86.5
"18665","62018","2014",1,1,0,178000,1633,109
"18666","62019","2014",29,27,2,136760.3,1429.31,98.37931
"18667","62020","2014",2,2,0,130000,1216,113.5
"18668","62021","2014",3,3,0,78666.67,1244.667,63.33333
"18669","62023","2014",30,30,0,122975,1213.367,104.5
"18670","62024","2014",5,5,0,151100,1159.2,132.2
"18671","62025","2014",39,26,13,190564.1,2503.436,86
"18672","62026","2014",2,2,0,81000,835.5,108.5
"18673","62027","2014",2,2,0,141500,1721.5,82
"18674","62028","2014",3,3,0,148000,1228.333,117
"18675","62029","2014",4,4,0,140000,1391.25,101.75
"18676","62030","2014",3,3,0,115433.3,1229.333,92
"18677","62031","2014",9,9,0,151677.8,1726.111,87.55556
"18678","62032","2014",30,30,0,153299.4,1582.033,96.63333
"18679","62033","2014",35,35,0,139164.6,1528.714,95.54286
"18680","62034","2014",9,9,0,116060.6,1392.333,89.66667
"18681","62035","2014",60,60,0,137362.4,1507.217,93.51667
"18682","62036","2014",7,7,0,93078.57,826,117.2857
"18683","62037","2014",21,21,0,221649.5,1985.81,115.619
"18684","62038","2014",32,32,0,151371.9,1506.312,102.0312
"18685","62039","2014",5,5,0,241200,1631.8,147
"18686","62040","2014",77,70,7,128923.7,1448.857,90.20779
"18687","62041","2014",468,202,266,132160.8,1766.105,77.3141
"18688","62042","2014",10,10,0,120100,1310.3,94.8
"18689","62043","2014",14,14,0,151466.6,1589.071,103
"18690","62044","2014",2,2,0,96500,1430.5,67.5
"18691","62045","2014",17,15,2,122860.3,1293.647,99.11765
"18692","62046","2014",9,9,0,100333.3,1219.222,88
"18693","62048","2014",67,65,2,96400.6,1007.776,97.73134
"18694","62049","2014",3,3,0,169266.7,1329.333,128.3333
"18695","62050","2014",10,10,0,108475,1048.2,104.6
"18696","62051","2014",45,44,1,134179.1,1569.511,87.26667
"18697","62052","2014",6,6,0,224416.7,1923.833,122
"18698","62053","2014",4,4,0,137500,1594,92.5
"18699","62054","2014",12,12,0,190918.3,2498.417,83.08333
"18700","62055","2014",5,5,0,130374,1387.2,91.4
"18701","62056","2014",7,7,0,169528.6,2200,79
"18702","62057","2014",35,35,0,153991.4,1521.171,102.2571
"18703","62058","2014",1,1,0,105000,814,129
"18704","62059","2014",2,2,0,261000,1997,114.5
"18705","62060","2014",17,17,0,98764.71,1207.765,82.17647
"18706","62061","2014",2,2,0,130000,1137.5,114.5
"18707","62063","2014",10,10,0,116200,1288.6,94.4
"18708","62065","2014",89,88,1,126966.3,1399.461,92.38202
"18709","62066","2014",1,1,0,136000,1133,120
"18710","62067","2014",3,3,0,170000,1937.333,93
"18711","62068","2014",2,2,0,161000,1562,104
"18712","62069","2014",3,3,0,100333.3,1177.333,78.33333
"18713","62070","2014",2,2,0,97500,1198,80
"18714","62071","2014",4,4,0,183250,1935.25,100
"18715","62072","2014",1,1,0,180000,2000,90
"18716","62073","2014",13,13,0,150511.5,1529.538,98.84615
"18717","62074","2014",1,1,0,110000,1146,96
"18718","62075","2014",13,13,0,165652.3,1913,90.61538
"18719","62077","2014",4,4,0,128250,1380.5,94.75
"18720","62078","2014",9,9,0,128556.7,1258.667,105.6667
"18721","62079","2014",1,1,0,204000,3400,60
"18722","62080","2014",24,24,0,85020.83,933.875,96.33333
"18723","62081","2014",2,2,0,181150,4009.5,70
"18724","62082","2014",4,4,0,129062.5,1032.75,131.75
"18725","62083","2014",31,31,0,98217.45,1127.871,89.74194
"18726","62084","2014",1,1,0,150000,1500,100
"18727","62086","2014",2,2,0,145900,1317.5,114.5
"18728","62087","2014",13,13,0,168814.8,1638.231,104.2308
"18729","62088","2014",3,3,0,125666.7,1473.333,104
"18730","62089","2014",9,9,0,146818.3,1424.778,107.6667
"18731","62090","2014",1,1,0,145000,1160,125
"18732","62092","2014",1,1,0,120000,1364,88
"18733","62093","2014",2,2,0,126000,1212.5,106
"18734","62094","2014",6,6,0,125500,1357.833,88.16667
"18735","62096","2014",3,3,0,90300,1469,64
"18736","62097","2014",6,6,0,191866.7,1864.5,102.5
"18737","62099","2014",41,38,3,158519.5,1758.707,92.34146
"18738","62100","2014",12,12,0,113208.3,1319.25,91.41667
"18739","62102","2014",1,1,0,95500,1061,90
"18740","62103","2014",1,1,0,150000,1327,113
"18741","62104","2014",5,5,0,195400,1928.8,111.4
"18742","62105","2014",7,7,0,208271.4,1546.143,135.8571
"18743","62107","2014",2,2,0,172450,1227.5,127
"18744","62108","2014",262,129,133,123566.4,2127.847,63.84733
"18745","62109","2014",4,4,0,97900,986.75,95.5
"18746","62111","2014",3,3,0,122000,1494.333,91.33333
"18747","62112","2014",3,3,0,135333.3,1357,106.3333
"18748","62113","2014",2,2,0,180000,1039,169
"18749","62115","2014",4,4,0,162500,1627.75,101
"18750","62116","2014",4,4,0,197500,2122.5,97.25
"18751","62117","2014",7,7,0,120857.1,977.8571,133.2857
"18752","62118","2014",1,1,0,155000,1409,110
"18753","62119","2014",225,161,64,111530.2,1405.151,83.76889
"18754","62120","2014",2,2,0,128000,1402,93
"18755","62121","2014",1,1,0,159100,1591,100
"18756","62122","2014",4,4,0,146478.8,1070.5,139.5
"18757","62123","2014",3,3,0,135486.7,1179.667,131
"18758","62124","2014",3,3,0,159666.7,1682.333,100
"18759","62125","2014",2,2,0,163000,1447,115
"18760","62126","2014",72,63,9,116120.8,1401.292,82.52778
"18761","62127","2014",1,1,0,85000,850,100
"18762","62128","2014",35,35,0,97757.14,1308.171,76.05714
"18763","62130","2014",8,8,0,213706.2,2743.125,113.25
"18764","62131","2014",3,3,0,115666.7,974.3333,114.6667
"18765","62132","2014",45,45,0,142829.5,1648.467,85.33333
"18766","62133","2014",42,41,1,113634.5,1349.714,87.11905
"18767","62134","2014",2,2,0,123250,1236,100.5
"18768","62135","2014",2,2,0,162600,1428,114
"18769","62137","2014",1,1,0,112000,1349,83
"18770","62138","2014",7,7,0,119285.7,1380.714,85
"18771","62139","2014",46,45,1,119083.3,1315.435,93.97826
"18772","62140","2014",1,1,0,207000,1380,150
"18773","62141","2014",9,9,0,134591.1,1358.111,98.88889
"18774","62143","2014",1,1,0,101400,1014,100
"18775","62144","2014",3,3,0,192666.7,1464,132.6667
"18776","62145","2014",9,9,0,145666.7,1319.333,109.5556
"18777","62146","2014",2,2,0,128500,2608,56.5
"18778","62147","2014",5,5,0,139862,1729.4,84.8
"18779","62148","2014",7,7,0,130209.7,1104.857,115.5714
"18780","62149","2014",2,2,0,127750,1375,96
"18781","62150","2014",9,9,0,144533.3,1534,98.55556
"18782","62151","2014",5,5,0,182380,1403.8,139
"18783","62152","2014",2,2,0,198500,1732,113
"18784","62153","2014",8,8,0,1e+05,1296.25,79.375
"18785","62154","2014",5,5,0,72430,856.8,87
"18786","62155","2014",5,5,0,115630,1229.4,101
"18787","62156","2014",5,5,0,235140,1858.6,125.4
"18788","62158","2014",3,3,0,107833.3,932,100.3333
"18789","62160","2014",310,180,130,121194.4,1457.748,85.20323
"18790","62161","2014",6,6,0,112124.8,1216.833,93
"18791","62162","2014",5,5,0,135940,1397.4,99
"18792","62163","2014",3,3,0,89571.67,1842.667,53.33333
"18793","62164","2014",8,8,0,130600,1555.75,85.625
"18794","62165","2014",1,1,0,140000,1556,90
"18795","62166","2014",5,5,0,122800,797.4,127.2
"18796","62167","2014",2,2,0,188500,1779,124
"18797","62168","2014",3,3,0,109333.3,1044.333,108.6667
"18798","62169","2014",1,1,0,135000,925,146
"18799","62170","2014",20,20,0,147300,1497.05,96.45
"18800","62171","2014",2,2,0,161500,1338.5,124.5
"18801","62172","2014",6,6,0,178675,1548.333,132.5
"18802","62173","2014",45,44,1,141287.8,1498.911,95.53333
"18803","62174","2014",17,17,0,159418.2,1670.882,95.17647
"18804","62175","2014",1,1,0,124000,1632,76
"18805","62176","2014",3,3,0,134333.3,2089.333,65.33333
"18806","62177","2014",12,12,0,117308.3,1560.417,84.41667
"18807","62178","2014",129,123,6,115362,1249.775,94.74419
"18808","62179","2014",2,2,0,93850,1002,94.5
"18809","62180","2014",4,4,0,123750,1308,95.5
"18810","62181","2014",18,18,0,110772.2,1095.5,102.0556
"18811","62182","2014",3,3,0,93333.33,776.3333,125.6667
"18812","62183","2014",2,2,0,73000,980.5,74
"18813","62184","2014",3,3,0,131366.7,1757.667,72.66667
"18814","62185","2014",5,5,0,136000,1534.6,87.6
"18815","62186","2014",65,59,6,120738.6,1387.154,90.73846
"18816","62188","2014",26,26,0,125727.9,1454.846,90.26923
"18817","62189","2014",1,1,0,50000,806,62
"18818","62190","2014",11,11,0,121770,1273.545,94.81818
"18819","62191","2014",1,1,0,143000,1430,100
"18820","62192","2014",2,2,0,1e+05,1313.5,77.5
"18821","62193","2014",609,494,115,115259.5,1433.099,83.53038
"18822","62194","2014",25,25,0,99044,1221.84,84.8
"18823","62195","2014",18,18,0,142450,1516.611,93.61111
"18824","62196","2014",5,5,0,178777.4,2128,90.2
"18825","62197","2014",11,11,0,118479.1,1147.091,105.5455
"18826","62198","2014",2,2,0,180000,1429,126
"18827","62199","2014",5,5,0,146600,1517.4,96.4
"18828","62200","2014",9,9,0,163722.2,1578,110.2222
"18829","62201","2014",96,56,40,121386.6,2317.562,56.64583
"18830","62202","2014",3,3,0,129000,1196.667,108
"18831","62203","2014",4,4,0,200500,2004.75,99.75
"18832","62204","2014",5,5,0,103200,991.6,104
"18833","62205","2014",9,9,0,171674.4,1752.889,98.44444
"18834","62206","2014",1,1,0,190000,1545,123
"18835","62207","2014",4,4,0,145375,1253.75,110.5
"18836","62208","2014",2,2,0,140000,1228,114
"18837","62209","2014",1,1,0,81500,815,100
"18838","62212","2014",2,2,0,142000,1538.5,91
"18839","62214","2014",3,3,0,152733.3,1307,125.6667
"18840","62215","2014",135,132,3,140977.2,1496.533,97.62963
"18841","62216","2014",1,1,0,117000,1625,72
"18842","62217","2014",18,18,0,119119.2,1244.222,97.22222
"18843","62218","2014",2,2,0,143000,1269,116.5
"18844","62219","2014",1,1,0,110000,1146,96
"18845","62220","2014",5,5,0,113650,1565.8,72.4
"18846","62223","2014",2,2,0,199500,2262,88
"18847","62224","2014",33,33,0,107852.1,1157.03,90.51515
"18848","62225","2014",1,1,0,227000,2609,87
"18849","62227","2014",4,4,0,91750,1125.75,79.25
"18850","62228","2014",3,3,0,95900,1491.667,60.33333
"18851","62229","2014",4,4,0,156050,1747.25,89.5
"18852","62230","2014",5,5,0,196920,1922,105.2
"18853","62231","2014",3,3,0,110500,1300,80.66667
"18854","62232","2014",4,4,0,97000,1052.25,99.5
"18855","62233","2014",12,12,0,144833.3,1569.167,98.25
"18856","62234","2014",2,2,0,107000,1298,83
"18857","62235","2014",18,16,2,236252.3,2071.944,110.7222
"18858","62236","2014",4,4,0,78462.5,1110.5,81
"18859","62237","2014",2,2,0,96000,1013.5,95
"18860","62238","2014",1,1,0,70000,737,95
"18861","62239","2014",22,22,0,211950,2042.455,105.4091
"18862","62240","2014",21,21,0,121711.9,1375.714,93.66667
"18863","62241","2014",2,2,0,53500,1182.5,43.5
"18864","62243","2014",1,1,0,135000,1901,71
"18865","62244","2014",38,38,0,131877.9,1609.368,82
"18866","62245","2014",6,6,0,152583.3,1415.5,112.8333
"18867","62246","2014",1,1,0,102000,816,125
"18868","62247","2014",1,1,0,125000,1488,84
"18869","62248","2014",3,3,0,104666.7,1145.667,88.33333
"18870","62249","2014",42,40,2,112869,1560.738,82.2381
"18871","62250","2014",57,56,1,147531.2,1508.982,100.5789
"18872","62251","2014",3,3,0,128266.7,1331.333,101.3333
"18873","62252","2014",8,8,0,178312.5,1873.875,94.5
"18874","62254","2014",2,2,0,98000,1203.5,77.5
"18875","62255","2014",5,5,0,193820,1699.2,118.8
"18876","62256","2014",2,2,0,172450,890.5,198
"18877","62257","2014",7,7,0,112714.3,1148,102.5714
"18878","62258","2014",1,1,0,195000,1560,125
"18879","62259","2014",11,11,0,174563.6,1527.636,113.6364
"18880","62260","2014",1,1,0,94000,696,135
"18881","62261","2014",174,92,82,166293.9,2709.707,65.38506
"18882","62262","2014",11,11,0,132331.8,1443.273,92.36364
"18883","62263","2014",37,37,0,194088.1,1838.973,99.18919
"18884","62264","2014",12,12,0,136654.2,1418.5,109.8333
"18885","62265","2014",1,1,0,268000,2436,110
"18886","62267","2014",5,5,0,135106,1906.8,74.8
"18887","62268","2014",46,46,0,100226.1,1326.87,76.91304
"18888","62269","2014",7,7,0,131557.1,1165.286,112.2857
"18889","62270","2014",37,36,1,108177.6,1278.595,86.78378
"18890","62271","2014",6,6,0,72166.67,897,79.83333
"18891","62272","2014",2,2,0,173000,1123.5,187
"18892","62273","2014",1,1,0,133450,1668,80
"18893","62274","2014",50,50,0,128474.5,1402.96,91.34
"18894","62275","2014",4,4,0,123750,1211.75,120.75
"18895","62276","2014",52,52,0,142814.5,1535.212,93.09615
"18896","62277","2014",24,24,0,124566.7,1352.792,91.04167
"18897","62278","2014",2,2,0,239700,1826,128.5
"18898","62279","2014",8,8,0,213685,1700.375,123.75
"18899","62280","2014",7,7,0,132857.1,1387,98.28571
"18900","62281","2014",5,5,0,244495,1891.2,131
"18901","62282","2014",3,3,0,120666.7,1031,123
"18902","62283","2014",2,2,0,125000,1512.5,81
"18903","62284","2014",13,13,0,107076.9,1141.462,99.69231
"18904","62285","2014",3,3,0,160333.3,1240.333,133.3333
"18905","62286","2014",1,1,0,203000,2207,92
"18906","62288","2014",17,17,0,157667.1,1765.647,91.94118
"18907","62289","2014",8,8,0,225150,1862.125,123.25
"18908","62290","2014",1,1,0,180000,2769,65
"18909","62291","2014",24,24,0,122466.7,1417.083,93.25
"18910","62292","2014",8,8,0,120381.2,1248.375,95.625
"18911","62293","2014",7,7,0,136587.1,1528.714,94.28571
"18912","62295","2014",9,9,0,112722.2,1179.222,98.44444
"18913","62296","2014",4,4,0,158250,1182.25,135.75
"18914","62297","2014",15,15,0,153198.7,1516.933,105.2
"18915","62298","2014",4,4,0,125875,1200.75,106
"18916","62300","2014",21,19,2,151529.7,1855.81,88.47619
"18917","62302","2014",4,4,0,146025,1296.25,114.25
"18918","62303","2014",4,4,0,68625,747.25,87.25
"18919","62304","2014",5,5,0,79734,873.4,93
"18920","62306","2014",7,7,0,107214.3,1094.429,97.28571
"18921","62307","2014",2,2,0,278750,2282.5,120
"18922","62308","2014",2,2,0,152050,2198.5,70
"18923","62309","2014",12,12,0,106333.3,1266.917,80.91667
"18924","62310","2014",21,21,0,144407.6,1542.19,94.57143
"18925","62311","2014",15,14,1,177360.7,1663.467,107.5333
"18926","62312","2014",1,1,0,150000,1531,98
"18927","62313","2014",2,2,0,119750,1238.5,96
"18928","62314","2014",2,2,0,152670,1090.5,141.5
"18929","62315","2014",3,3,0,191666.7,1741,112
"18930","62316","2014",2,2,0,139000,1469.5,93
"18931","62317","2014",4,4,0,114420.5,1198.5,107.25
"18932","62318","2014",60,54,6,127750,1640.717,83.25
"18933","62319","2014",3,3,0,212333.3,1767.667,114
"18934","62320","2014",4,4,0,216375,1817.5,106.5
"18935","62321","2014",32,32,0,138258.4,1492.625,99.34375
"18936","62323","2014",10,10,0,161400,1548.8,103.8
"18937","62324","2014",7,7,0,129500,1284.857,116.4286
"18938","62325","2014",6,5,1,123500,1690.833,96.5
"18939","62326","2014",2,2,0,145250,1664,82
"18940","62327","2014",5,5,0,97300,1022,99.2
"18941","62328","2014",6,6,0,93283.33,997.3333,89.33333
"18942","62329","2014",5,5,0,167700,1628.8,109.6
"18943","62330","2014",11,11,0,172822.7,1596.545,112.0909
"18944","62331","2014",9,9,0,106185.2,1197.778,88.11111
"18945","62332","2014",1,1,0,180000,1978,91
"18946","62333","2014",1,1,0,135000,912,148
"18947","62334","2014",6,6,0,157666.7,1776.167,94.5
"18948","62335","2014",5,5,0,76800,986.8,81.2
"18949","62336","2014",2,2,0,190450,1223,157
"18950","62337","2014",5,5,0,129200,1307.2,106.4
"18951","62338","2014",22,21,1,258536.4,2257.727,118.9545
"18952","62340","2014",7,7,0,141886.6,1539,101.8571
"18953","62341","2014",2,2,0,122550,875,125
"18954","62342","2014",2,2,0,63750,654,107.5
"18955","62343","2014",3,3,0,152333.3,1308,127.3333
"18956","62345","2014",2,2,0,106250,693.5,154
"18957","62346","2014",2,2,0,142196,888,152
"18958","62349","2014",14,14,0,127160.7,1345.857,95.14286
"18959","62350","2014",10,10,0,160275,1532.4,104.1
"18960","62351","2014",29,28,1,114528.3,1336.586,86.13793
"18961","62352","2014",1,1,0,115000,1150,100
"18962","62354","2014",6,6,0,141035.3,1557,85.16667
"18963","62355","2014",7,7,0,157514.3,1676.429,96.71429
"18964","62356","2014",9,9,0,117825.6,1307.111,90.66667
"18965","62359","2014",5,5,0,128000,1346.6,93
"18966","62360","2014",12,12,0,185532.2,1605.167,118.5833
"18967","62361","2014",18,18,0,73166.67,908.4444,84
"18968","62363","2014",3,3,0,162166.7,1575.667,103.3333
"18969","62364","2014",21,21,0,81320.86,838.2857,95.42857
"18970","62365","2014",2,2,0,71500,1282,56
"18971","62366","2014",1,1,0,128000,1058,121
"18972","62367","2014",4,3,1,83625,1131.75,71.75
"18973","62368","2014",2,2,0,137500,1270,118
"18974","62369","2014",2,2,0,163250,1637.5,98
"18975","62370","2014",1,1,0,160000,1481,108
"18976","62371","2014",10,10,0,197354,1717.1,125
"18977","62373","2014",4,4,0,183276.8,1591.75,114.25
"18978","62375","2014",1,1,0,72000,1143,63
"18979","62376","2014",18,18,0,150796.1,1537.444,102.6667
"18980","62377","2014",5,5,0,103000,1107.6,96.4
"18981","62378","2014",4,4,0,167250,1331,118.5
"18982","62379","2014",5,5,0,103000,1136.2,90.6
"18983","62380","2014",3,3,0,116066.7,1579.667,72.66667
"18984","62382","2014",7,7,0,149452.1,1484.143,103
"18985","62383","2014",10,10,0,147122,1457.3,104.6
"18986","62384","2014",3,3,0,114500,853.6667,118
"18987","62385","2014",2,2,0,44500,803,57
"18988","62386","2014",23,23,0,111026.1,1238.913,96.65217
"18989","62387","2014",4,4,0,135081.5,1665.5,87.5
"18990","62388","2014",5,5,0,130070,1461,94.2
"18991","62390","2014",11,11,0,186079.5,1861.818,99.45455
"18992","62391","2014",16,16,0,132182.9,1421.125,92.8125
"18993","62392","2014",2,2,0,149650,1314.5,113
"18994","62393","2014",9,9,0,116611.1,1262.556,91.11111
"18995","62395","2014",2,2,0,163000,1368.5,121.5
"18996","62397","2014",67,66,1,130165.9,1507.672,88.1791
"18997","62398","2014",1,1,0,129000,1372,94
"18998","62399","2014",6,6,0,128416.7,1425.667,91.83333
"18999","62400","2014",32,32,0,118576.6,1290.469,91.34375
"19000","62401","2014",30,30,0,153893,1612.3,95.7
"19001","62402","2014",1,1,0,174000,2289,76
"19002","62403","2014",9,9,0,123188.9,1259.889,96.77778
"19003","62404","2014",1,1,0,120000,1481,81
"19004","62405","2014",1,1,0,270000,1875,144
"19005","62406","2014",4,4,0,126250,1217.75,113.5
"19006","62407","2014",10,10,0,147735,1282.2,113.5
"19007","62408","2014",11,11,0,131090.9,1539.818,87
"19008","62409","2014",4,4,0,131000,1283.25,113.5
"19009","62410","2014",2,2,0,71000,964,73
"19010","62411","2014",1,1,0,70000,1321,53
"19011","62412","2014",9,9,0,130444.4,1445.889,98.33333
"19012","62413","2014",73,73,0,127679.5,1455.822,90.94521
"19013","62414","2014",2,2,0,150950,1189.5,123.5
"19014","62416","2014",1,1,0,150000,909,165
"19015","62421","2014",2,2,0,97500,1071.5,88
"19016","62422","2014",12,12,0,123750,1079.083,116.0833
"19017","62423","2014",13,13,0,121115.4,1469.692,85.23077
"19018","62424","2014",8,8,0,133013.1,1456.125,100.5
"19019","62425","2014",1,1,0,170000,1259,135
"19020","62427","2014",207,196,11,113861.5,1284.758,90.59903
"19021","62428","2014",2,2,0,120000,1516.5,80.5
"19022","62429","2014",2,2,0,166000,1371,127.5
"19023","62430","2014",1,1,0,130000,1250,104
"19024","62432","2014",2,2,0,145000,1271,114
"19025","62434","2014",2,2,0,51000,466.5,108
"19026","62437","2014",6,6,0,127083.3,1253.5,121.6667
"19027","62438","2014",3,3,0,236833.3,1704.333,122.6667
"19028","62439","2014",4,4,0,125750,1742,79.25
"19029","62440","2014",9,9,0,101260.6,945.6667,106.5556
"19030","62442","2014",3,3,0,93000,988,86.33333
"19031","62443","2014",39,39,0,129912.6,1451.282,92.58974
"19032","62444","2014",2,2,0,65000,748,98
"19033","62445","2014",7,7,0,181926.6,1464.429,134.1429
"19034","62446","2014",3,3,0,126000,1863.667,74.66667
"19035","62447","2014",26,23,3,97692.31,1334.231,77.76923
"19036","62448","2014",12,12,0,189629.2,1764.667,108.3333
"19037","62449","2014",1,1,0,140000,1628,86
"19038","62450","2014",1,1,0,211100,1992,106
"19039","62451","2014",5,5,0,115686,1365.6,93.2
"19040","62452","2014",8,8,0,168300,1579,108.75
"19041","62454","2014",15,15,0,224500,1926.6,118.3333
"19042","62456","2014",2,2,0,95962.5,987,97.5
"19043","62457","2014",31,31,0,135612.1,1383.968,100.6774
"19044","62458","2014",8,8,0,122150,1690.625,75.25
"19045","62460","2014",2,2,0,113500,1141,112
"19046","62461","2014",8,8,0,86187.5,1203.25,74.25
"19047","62462","2014",2,2,0,158418.5,1567.5,105.5
"19048","62463","2014",3,3,0,123000,1313,103.3333
"19049","62464","2014",11,11,0,151240.9,1744.545,90.36364
"19050","62465","2014",3,3,0,148333.3,1586.333,95
"19051","62466","2014",2,2,0,57500,778,76.5
"19052","62467","2014",5,5,0,136400,1388.8,93.8
"19053","62468","2014",2,2,0,136000,1624.5,88.5
"19054","62469","2014",4,4,0,118000,1182.25,98.5
"19055","62470","2014",1,1,0,175400,1349,130
"19056","62471","2014",2,2,0,163500,1277.5,126.5
"19057","62472","2014",3,3,0,183333.3,1183,158.3333
"19058","62473","2014",69,68,1,98676.04,1118.058,90.52174
"19059","62474","2014",13,13,0,184686.2,1994.077,92.69231
"19060","62475","2014",1,1,0,80000,1143,70
"19061","62477","2014",9,9,0,165011.1,1457.111,113.8889
"19062","62478","2014",4,4,0,124675,1287.5,98.5
"19063","62479","2014",10,10,0,138590,1507.8,97.4
"19064","62480","2014",19,19,0,145857.9,1920.789,85.36842
"19065","62481","2014",3,3,0,76666.67,752.3333,99.66667
"19066","62483","2014",4,4,0,191000,1719.25,106.75
"19067","62484","2014",3,3,0,94333.33,977,89.66667
"19068","62485","2014",2,2,0,87500,1071.5,84
"19069","62486","2014",11,11,0,118500,1212.455,105.1818
"19070","62487","2014",5,5,0,156800,1373,114.8
"19071","62488","2014",4,4,0,167350,1595,108.5
"19072","62489","2014",29,29,0,128945.6,1358.345,98.65517
"19073","62490","2014",4,4,0,165000,1565,111.75
"19074","62491","2014",33,32,1,180393.6,1652.727,107.0303
"19075","62493","2014",4,4,0,107805,953.5,113.5
"19076","62494","2014",1,1,0,222500,1147,194
"19077","62495","2014",4,4,0,129500,1358.5,97
"19078","62496","2014",3,3,0,124166.7,1378.333,89.33333
"19079","62497","2014",60,60,0,141874.2,1530.533,93.23333
"19080","62498","2014",185,132,53,130868.7,1548.573,90.3027
"19081","62500","2014",3,3,0,74000,909.6667,87.33333
"19082","62501","2014",6,6,0,147250,1306,113
"19083","62502","2014",29,29,0,185429,1798.966,104.2759
"19084","62503","2014",2,2,0,218075,1789,124
"19085","62504","2014",1,1,0,145000,1107,131
"19086","62505","2014",1,1,0,353000,4526,78
"19087","62506","2014",14,13,1,166803.6,2215.071,82.21429
"19088","62507","2014",2,2,0,167775,1591.5,107.5
"19089","62508","2014",3,3,0,122166.7,1179.333,90.66667
"19090","62510","2014",166,150,16,126617.7,1404.53,94.23494
"19091","62512","2014",4,4,0,88375,1277,67.75
"19092","62513","2014",3,3,0,151666.7,1181,130
"19093","62515","2014",2,2,0,104500,980,101.5
"19094","62516","2014",77,73,4,93810.06,1093.416,85.14286
"19095","62518","2014",2,2,0,87000,1042.5,82.5
"19096","62519","2014",4,4,0,141750,2146.5,70
"19097","62520","2014",21,21,0,173021.2,1575.762,107.2857
"19098","62521","2014",4,4,0,110000,1437,74
"19099","62522","2014",1,1,0,60000,476,126
"19100","62523","2014",53,53,0,109049.1,1354,82.86792
"19101","62524","2014",12,12,0,132219.2,1700.833,75.83333
"19102","62525","2014",61,58,3,142041,1429.82,102.1475
"19103","62526","2014",2,2,0,194710,1998,99.5
"19104","62527","2014",1,1,0,280000,2435,115
"19105","62528","2014",46,46,0,141054.7,1498.065,96.56522
"19106","62529","2014",16,16,0,192937.5,1819,104.875
"19107","62530","2014",3,3,0,126166.7,1518.333,96.66667
"19108","62531","2014",8,8,0,279000,2194.625,104.125
"19109","62532","2014",10,10,0,129271,1358.6,96.6
"19110","62533","2014",1,1,0,85000,1667,51
"19111","62534","2014",29,29,0,120017.6,1243.897,95.96552
"19112","62536","2014",4,4,0,98495,1102.25,86.25
"19113","62538","2014",4,4,0,94500,1323,71.75
"19114","62539","2014",1,1,0,60000,674,89
"19115","62540","2014",11,11,0,126232.7,1448.545,86.27273
"19116","62541","2014",2,2,0,107000,856,135
"19117","62542","2014",2,2,0,117500,1058.5,140.5
"19118","62543","2014",8,8,0,137397.5,1319,105.625
"19119","62544","2014",1,1,0,185000,2056,90
"19120","62545","2014",1,1,0,74000,525,141
"19121","62546","2014",2,2,0,191250,1855,119.5
"19122","62547","2014",3,3,0,136966.7,1756.333,78.33333
"19123","62548","2014",81,78,3,167358.7,1585.593,109.6173
"19124","62549","2014",13,13,0,130061.5,987.8462,139
"19125","62550","2014",8,8,0,115275,1139.625,100
"19126","62551","2014",2,2,0,102500,1595,73
"19127","62553","2014",2,2,0,172525,1426.5,124
"19128","62554","2014",2,2,0,301000,3112.5,108.5
"19129","62555","2014",20,20,0,105238.5,1237,83.3
"19130","62556","2014",6,6,0,116000,1251.333,97.66667
"19131","62557","2014",15,15,0,166740.5,1496.6,102
"19132","62558","2014",1,1,0,231900,1104,210
"19133","62559","2014",9,9,0,89955.56,1040.333,95.11111
"19134","62560","2014",39,37,2,130430.8,1554.462,84.51282
"19135","62561","2014",2,2,0,52500,547,95.5
"19136","62563","2014",38,36,2,141484.4,1443.053,101.7105
"19137","62564","2014",1,1,0,178000,1956,91
"19138","62565","2014",2,2,0,80000,1073.5,74
"19139","62566","2014",5,5,0,184376.2,1487,123.4
"19140","62567","2014",6,6,0,119916.7,1444.667,88.16667
"19141","62568","2014",3,3,0,160766.7,1663.333,101
"19142","62569","2014",2,2,0,122000,727,167
"19143","62570","2014",57,57,0,130437.7,1414.421,92.42105
"19144","62571","2014",101,65,36,166894,2483.079,73.70297
"19145","62572","2014",7,7,0,80285.71,849.2857,105
"19146","62573","2014",22,21,1,137195.5,1547.864,90.86364
"19147","62579","2014",3,3,0,117333.3,1500.333,83.66667
"19148","62580","2014",3,3,0,96666.67,1229,85.66667
"19149","62581","2014",1,1,0,154000,2139,72
"19150","62582","2014",2,2,0,152000,1462.5,102.5
"19151","62583","2014",4,4,0,110000,1274,93.5
"19152","62584","2014",9,9,0,182555.6,1410.111,132.5556
"19153","62585","2014",5,5,0,182500,1648.2,111.8
"19154","62586","2014",1,1,0,260000,1711,152
"19155","62587","2014",48,46,2,123017.3,1397,91.4375
"19156","62588","2014",23,20,3,166201.4,1580.261,109.913
"19157","62589","2014",11,11,0,194027.3,1792,116
"19158","62590","2014",1,1,0,67800,1012,67
"19159","62592","2014",5,5,0,161740,1427.2,123.4
"19160","62593","2014",2,2,0,127000,1262.5,101
"19161","62595","2014",8,8,0,85562.5,1484.375,56.375
"19162","62596","2014",5,5,0,104800,764.4,133
"19163","62597","2014",1,1,0,95000,1092,87
"19164","62598","2014",6,6,0,130700,1457.5,87
"19165","62599","2014",2,2,0,153745,1842.5,89
"19166","62600","2014",2,2,0,117000,1202.5,104
"19167","62601","2014",1,1,0,129986,6841,19
"19168","62602","2014",1,1,0,120000,1622,74
"19169","62603","2014",9,8,1,128664.4,1495.889,86.66667
"19170","62604","2014",107,53,54,249531.2,3377.271,80.58879
"19171","62606","2014",12,12,0,224020.8,2080.333,115.5833
"19172","62607","2014",1,1,0,180000,1636,110
"19173","62609","2014",12,12,0,201916.7,1752.583,112.8333
"19174","62610","2014",5,5,0,106250,1086,98.6
"19175","62611","2014",3,3,0,252466.7,1629.667,148.6667
"19176","62612","2014",2,1,1,161700,1927.5,85
"19177","62613","2014",9,9,0,150640,1248.444,123
"19178","62614","2014",5,5,0,162100,1643.8,104
"19179","62615","2014",1,1,0,60000,1250,48
"19180","62616","2014",1,1,0,60000,923,65
"19181","62617","2014",69,68,1,106333.8,1207.029,93.27536
"19182","62618","2014",9,9,0,167388.9,1576.556,107.7778
"19183","62620","2014",14,14,0,132073.6,1265.143,105.5
"19184","62621","2014",7,7,0,159414.3,1995.857,81.28571
"19185","62622","2014",2,2,0,102500,1151,83
"19186","62623","2014",7,7,0,170594.3,1888,92.14286
"19187","62624","2014",23,23,0,138834.8,1419.696,97.6087
"19188","62625","2014",3,3,0,105000,1258.667,85.66667
"19189","62626","2014",8,8,0,168022.8,1540.625,109.375
"19190","62627","2014",3,3,0,152000,1679.667,88.66667
"19191","62628","2014",28,27,1,116416.1,1291.393,99.25
"19192","62629","2014",1,1,0,155000,1742,89
"19193","62630","2014",2,2,0,180750,1703.5,105.5
"19194","62631","2014",4,4,0,120750,1263.5,109
"19195","62634","2014",11,11,0,153690,1482.091,100.7273
"19196","62635","2014",1,1,0,135000,1500,90
"19197","62636","2014",2,2,0,236520,2132.5,114
"19198","62637","2014",44,43,1,145374.9,1608.205,92.38636
"19199","62638","2014",7,7,0,102671.4,1178.429,87.71429
"19200","62639","2014",2,2,0,179000,1547,120
"19201","62640","2014",1,1,0,50000,649,77
"19202","62643","2014",96,86,10,119406.4,1367.135,88
"19203","62644","2014",2,2,0,105250,1125.5,89
"19204","62645","2014",36,36,0,159768.1,1684.583,95.86111
"19205","62646","2014",4,4,0,119625,1406,84.5
"19206","62647","2014",3,3,0,122333.3,1437,93
"19207","62648","2014",3,3,0,131333.3,1337.333,96.33333
"19208","62649","2014",7,7,0,95000,1106.857,86.28571
"19209","62650","2014",7,7,0,141000,1423.571,96.42857
"19210","62651","2014",4,4,0,135392.5,1377.25,97.25
"19211","62652","2014",11,11,0,112074.5,1059,105.6364
"19212","62653","2014",1,1,0,175000,2917,60
"19213","62654","2014",8,8,0,194793.8,2060.75,107.75
"19214","62655","2014",3,3,0,140833.3,1370.333,109.6667
"19215","62656","2014",4,4,0,96250,1197,77.75
"19216","62657","2014",1,1,0,192000,3200,60
"19217","62658","2014",1,1,0,560000,2445,229
"19218","62659","2014",1,1,0,74500,931,80
"19219","62660","2014",3,3,0,229500,1571.667,144.6667
"19220","62661","2014",7,7,0,133814.3,1334.857,110.1429
"19221","62662","2014",6,6,0,92016.67,1552.167,59
"19222","62663","2014",4,4,0,172500,2052.75,92
"19223","62664","2014",1,1,0,149000,931,160
"19224","62665","2014",2,2,0,70000,1137,51
"19225","62666","2014",25,25,0,130153.6,1453.8,94.24
"19226","62667","2014",71,54,17,121080.8,1488.183,88.04225
"19227","62668","2014",3,3,0,125966.7,1448,104.3333
"19228","62669","2014",1,1,0,133000,1662,80
"19229","62670","2014",3,3,0,77666.67,925.6667,85
"19230","62672","2014",2,2,0,100020,776,136.5
"19231","62673","2014",4,4,0,134425,1290.5,95.5
"19232","62674","2014",6,6,0,139778.3,1754.333,80.5
"19233","62675","2014",3,3,0,117790,1285.333,90.33333
"19234","62677","2014",2,2,0,110000,1235.5,92
"19235","62678","2014",3,3,0,196666.7,1881.333,107
"19236","62679","2014",2,2,0,182500,3042,60
"19237","62680","2014",5,5,0,150400,1358.2,111
"19238","62681","2014",3,3,0,191000,1421,134.6667
"19239","62683","2014",1,1,0,95000,922,103
"19240","62684","2014",16,16,0,131245.2,1354.25,93.6875
"19241","62685","2014",4,4,0,187750,1743,103.5
"19242","62686","2014",1,1,0,1e+05,813,123
"19243","62688","2014",50,49,1,149060.7,1669.52,90.32
"19244","62689","2014",1,1,0,151000,1841,82
"19245","62690","2014",5,5,0,129090,1570.2,81.6
"19246","62691","2014",1,1,0,144130,1441,100
"19247","62693","2014",5,5,0,171900,1246.8,137.8
"19248","62694","2014",2,2,0,92500,1065,85
"19249","62695","2014",2,2,0,135750,1168.5,100
"19250","62699","2014",7,7,0,144375.7,1975.429,74
"19251","62700","2014",1,1,0,136000,1462,93
"19252","62701","2014",2,2,0,168850,1155.5,147
"19253","62702","2014",2,2,0,115000,1413,80
"19254","62703","2014",4,4,0,148250,1763.75,82.25
"19255","62704","2014",5,5,0,144526.4,1325.4,108.6
"19256","62705","2014",8,8,0,163437.5,1770.875,86.125
"19257","62706","2014",15,15,0,221118,1987.667,115.8
"19258","62708","2014",2,2,0,88750,1153,80
"19259","62709","2014",2,2,0,52500,662,75.5
"19260","62710","2014",1,1,0,60000,833,72
"19261","62711","2014",29,28,1,123962.4,1421,89.86207
"19262","62712","2014",9,9,0,172016.7,1781.889,104
"19263","62713","2014",9,9,0,153622.2,1385.111,113.8889
"19264","62714","2014",6,6,0,168416.7,1790.333,96.66667
"19265","62715","2014",2,2,0,161000,1418,115.5
"19266","62716","2014",3,3,0,159166.7,1377.333,132
"19267","62717","2014",3,3,0,113666.7,1036,109.6667
"19268","62718","2014",12,12,0,161390.8,1540.5,103.9167
"19269","62719","2014",2,2,0,192000,1776.5,107.5
"19270","62721","2014",16,16,0,146000,1423.375,104.5
"19271","62722","2014",1,1,0,126200,1402,90
"19272","62724","2014",34,33,1,145359.7,1560.412,98.44118
"19273","62725","2014",1,1,0,135000,1452,93
"19274","62727","2014",13,13,0,143826.9,1573.231,92.07692
"19275","62728","2014",3,3,0,129666.7,1409.333,91.66667
"19276","62729","2014",2,2,0,121750,1288.5,109
"19277","62730","2014",11,11,0,153590.9,1511.545,114.7273
"19278","62731","2014",2,2,0,90000,703,129.5
"19279","62732","2014",4,4,0,180875,1281.5,141.5
"19280","62733","2014",1,1,0,135000,971,139
"19281","62734","2014",5,5,0,136620,1514.6,97.4
"19282","62735","2014",11,11,0,126827.3,1553.727,82.54545
"19283","62736","2014",38,37,1,186816.2,1772.053,106.2105
"19284","62737","2014",40,40,0,115997,1303.225,90.05
"19285","62738","2014",1,1,0,92880,1206,77
"19286","62739","2014",4,4,0,98500,887.5,110
"19287","62740","2014",1,1,0,79000,929,85
"19288","62741","2014",1,1,0,205000,1519,135
"19289","62742","2014",4,4,0,275000,1730,163.75
"19290","62743","2014",3,3,0,125756.7,1719.333,85
"19291","62744","2014",43,37,6,165362.1,1782.86,94.86047
"19292","62745","2014",2,2,0,138500,1301.5,106.5
"19293","62746","2014",42,40,2,149320.8,1746.976,86.69048
"19294","62747","2014",4,4,0,135000,1686,87
"19295","62748","2014",15,15,0,159666.7,1608.733,99.53333
"19296","62749","2014",2,2,0,203750,1736.5,120
"19297","62750","2014",3,3,0,170666.7,1896.333,90
"19298","62751","2014",9,9,0,191944.4,1800.556,107.3333
"19299","62752","2014",9,9,0,184777.8,1838.889,101.3333
"19300","62753","2014",65,49,16,157697.5,1919.277,85.69231
"19301","62754","2014",3,3,0,96933.33,1057.667,92.66667
"19302","62755","2014",35,34,1,151526.2,1670.657,91.68571
"19303","62756","2014",7,7,0,128628.6,1196.571,122.5714
"19304","62757","2014",52,52,0,156232.7,1615.75,98.51923
"19305","62758","2014",77,72,5,136367.6,1435.857,99.07792
"19306","62759","2014",5,5,0,159700,1570.6,109.6
"19307","62760","2014",3,3,0,76053.33,958.3333,79.33333
"19308","62762","2014",1,1,0,90000,900,100
"19309","62763","2014",9,9,0,143444.4,1350.667,102.8889
"19310","62764","2014",36,30,6,144006.1,1531.722,95.27778
"19311","62765","2014",113,80,33,129150.9,1388.018,95.63717
"19312","62766","2014",8,8,0,190183.8,1649.875,129.25
"19313","62767","2014",34,33,1,93944.91,1143.706,85.17647
"19314","62768","2014",1,1,0,1e+05,1250,80
"19315","62769","2014",1,1,0,180700,1825,99
"19316","62770","2014",18,17,1,115595.2,1572.389,79.33333
"19317","62771","2014",33,29,4,106489.8,1330.667,82.57576
"19318","62772","2014",3,3,0,59316.67,1512.667,40.66667
"19319","62773","2014",34,34,0,140282.1,1546.941,93.38235
"19320","62774","2014",47,46,1,186169.5,1855.83,100.8723
"19321","62776","2014",2,2,0,148105,1219.5,124
"19322","62779","2014",2,2,0,178000,1233.5,143.5
"19323","62780","2014",1,1,0,60000,3000,20
"19324","62781","2014",2,2,0,160500,1223.5,139
"19325","62782","2014",4,4,0,172500,1228,141.75
"19326","62783","2014",6,6,0,102716.7,1065.333,110.8333
"19327","62784","2014",9,9,0,148055.6,1449.556,101.3333
"19328","62785","2014",10,9,1,126830,1377.1,98.9
"19329","62787","2014",1,1,0,157000,1539,102
"19330","62788","2014",1,1,0,157000,1869,84
"19331","62789","2014",3,3,0,123333.3,1057.667,118
"19332","62791","2014",1,1,0,45000,577,78
"19333","62792","2014",16,16,0,113849.4,1374.062,90.75
"19334","62793","2014",8,8,0,148996.2,1627.75,93.875
"19335","62794","2014",6,6,0,104083.3,1362,78.83333
"19336","62795","2014",3,3,0,136666.7,1176,123
"19337","62796","2014",4,4,0,143000,1403,108.25
"19338","62797","2014",4,4,0,120250,1096.5,108.75
"19339","62798","2014",1,1,0,150000,1064,141
"19340","62799","2014",3,3,0,175000,1687.667,102
"19341","62800","2014",3,3,0,73666.67,803.3333,93.33333
"19342","62801","2014",32,31,1,166574.1,1579.094,109.4688
"19343","62803","2014",1,1,0,145700,1996,73
"19344","62805","2014",1,1,0,81000,942,86
"19345","62808","2014",2,2,0,90000,629.5,160.5
"19346","62810","2014",15,15,0,190113.3,1716.467,116.6
"19347","62811","2014",4,4,0,84250,918,82.75
"19348","62812","2014",6,6,0,123383.3,1394.333,87.5
"19349","62813","2014",2,2,0,235000,1546,157
"19350","62814","2014",1,1,0,42000,389,108
"19351","62815","2014",1,1,0,105000,1167,90
"19352","62816","2014",3,3,0,165500,1506.667,110
"19353","62817","2014",14,10,4,139310.7,1653.714,82.14286
"19354","62818","2014",2,2,0,92200,790,119.5
"19355","62819","2014",11,11,0,135218.2,1402,95.90909
"19356","62820","2014",7,7,0,111871.4,1085.857,105.8571
"19357","62821","2014",2,2,0,210000,1258,183
"19358","62823","2014",2,2,0,165000,2075,79.5
"19359","62824","2014",1,1,0,169500,1009,168
"19360","62825","2014",4,4,0,148000,1421.25,104
"19361","62826","2014",336,96,240,312922.9,4490.277,70.27083
"19362","62827","2014",10,10,0,146298,1202.9,120.6
"19363","62829","2014",2,2,0,82500,671.5,116
"19364","62830","2014",2,2,0,112500,616,183.5
"19365","62831","2014",4,4,0,115750,1331.75,91.5
"19366","62832","2014",7,7,0,190692.9,1513.286,122.4286
"19367","62835","2014",7,7,0,106085.7,1110.286,95.28571
"19368","62836","2014",7,7,0,227431,1845.143,158.8571
"19369","62837","2014",4,4,0,136925,1336.75,104.5
"19370","62839","2014",5,5,0,140638,1400.4,109.8
"19371","62840","2014",1,1,0,53000,964,55
"19372","62841","2014",25,25,0,141383.5,1519.76,93.32
"19373","62842","2014",50,50,0,155511,1613.26,97.08
"19374","62844","2014",4,4,0,109225,1026.75,103.5
"19375","62845","2014",6,6,0,162394.2,1317.667,125.8333
"19376","62846","2014",38,38,0,127414.5,1277.053,102.6053
"19377","62847","2014",9,9,0,152333.3,1708.556,95.33333
"19378","62848","2014",19,19,0,114799.5,1263.789,90.10526
"19379","62849","2014",18,18,0,174325.3,1832.667,99.11111
"19380","62850","2014",4,4,0,170375,1328.5,144
"19381","62851","2014",4,4,0,210475,1818.75,125.75
"19382","62852","2014",10,10,0,204087,2044.1,111.7
"19383","62853","2014",2,2,0,155750,1341.5,122.5
"19384","62854","2014",6,6,0,157393.3,1376.167,114
"19385","62856","2014",1,1,0,97500,1773,55
"19386","62857","2014",2,2,0,156000,1913.5,87
"19387","62859","2014",3,3,0,62500,744,79.66667
"19388","62861","2014",38,38,0,148774.1,1627.605,93.02632
"19389","62862","2014",1,1,0,105000,1842,57
"19390","62863","2014",28,28,0,160524.9,1749.571,93.75
"19391","62864","2014",7,7,0,174071.4,1666.857,104.8571
"19392","62865","2014",40,39,1,142217.1,1615.575,94.4
"19393","62868","2014",2,2,0,72000,865,91
"19394","62869","2014",7,7,0,157898.6,1513.857,107.4286
"19395","62870","2014",7,7,0,152142.9,1635.429,91.42857
"19396","62871","2014",5,5,0,104200,1214.6,86.8
"19397","62872","2014",1,1,0,96000,1263,76
"19398","62873","2014",4,4,0,157500,1741,96.25
"19399","62874","2014",9,9,0,120777.8,1337.111,87.77778
"19400","62875","2014",8,8,0,145931.2,1622.875,96.75
"19401","62876","2014",5,5,0,121000,1012.2,121.4
"19402","62877","2014",1,1,0,180000,1216,148
"19403","62878","2014",1,1,0,165000,1093,151
"19404","62879","2014",6,6,0,68500,735.1667,93.83333
"19405","62880","2014",1,1,0,160000,1616,99
"19406","62881","2014",2,2,0,104600,1435.5,67
"19407","62882","2014",6,6,0,120000,1249.5,96.83333
"19408","62883","2014",3,3,0,157333.3,1369.333,119.3333
"19409","62885","2014",1,1,0,94072,879,107
"19410","62886","2014",3,3,0,81850,1025.667,80
"19411","62887","2014",2,2,0,143685,1557,91
"19412","62888","2014",1,1,0,180000,1875,96
"19413","62889","2014",4,4,0,307750,2486.5,123.75
"19414","62890","2014",5,5,0,102760,1223.6,87.4
"19415","62892","2014",5,5,0,149480,1458.6,104
"19416","62893","2014",128,74,54,208098.6,2757.688,78.57812
"19417","62894","2014",52,51,1,154324.1,1697.019,94.07692
"19418","62895","2014",50,47,3,123991.4,1469.38,88.4
"19419","62896","2014",5,5,0,108990,872,125.6
"19420","62897","2014",1,1,0,78000,1500,52
"19421","62898","2014",2,2,0,80000,1054,77.5
"19422","62899","2014",31,17,14,247454.8,3762.387,71.41935
"19423","62900","2014",8,8,0,111250,1222.375,99.125
"19424","62901","2014",9,9,0,129877.8,1463.222,93.22222
"19425","62902","2014",29,29,0,111875.2,1272.621,87.96552
"19426","62903","2014",4,4,0,126625,988.75,135.5
"19427","62904","2014",3,3,0,115466.7,1032.333,118.3333
"19428","62905","2014",4,4,0,176125,1482.5,118.75
"19429","62906","2014",16,16,0,124396.9,1399.688,96.25
"19430","62907","2014",42,40,2,154912.1,1677.381,93.40476
"19431","62908","2014",8,8,0,211845,1796.75,127.25
"19432","62909","2014",2,2,0,96500,858.5,113.5
"19433","63001","2014",19,19,0,114051.1,1202.263,100.1053
"19434","63002","2014",3,3,0,59900,877.6667,62
"19435","63003","2014",53,38,15,106991.5,1151.755,94.01887
"19436","63004","2014",12,12,0,100125,1149.75,86.91667
"19437","63005","2014",3,3,0,123166.7,1089,110
"19438","63006","2014",4,4,0,35375,665.75,61.5
"19439","63007","2014",2,2,0,47300,782,62
"19440","63008","2014",5,5,0,141900,950.4,145.6
"19441","63009","2014",8,8,0,70250,876.375,79.125
"19442","63010","2014",9,9,0,59555.56,797.5556,76.55556
"19443","63012","2014",11,11,0,125072.7,1349.818,100.6364
"19444","63013","2014",8,8,0,189037.5,1679.375,116.75
"19445","63014","2014",99,78,21,155974.9,1931.96,80.9697
"19446","63015","2014",2,2,0,55675,801,63
"19447","63016","2014",16,15,1,76527.5,940.4375,80.6875
"19448","63017","2014",1,1,0,42000,955,44
"19449","63019","2014",27,25,2,142550,1724.481,82.37037
"19450","63020","2014",3,3,0,132560,1021,119.3333
"19451","63021","2014",7,7,0,183880,1359.714,153.1429
"19452","63022","2014",23,23,0,85237.39,1133.13,72.95652
"19453","63023","2014",6,6,0,78021.67,961.1667,81.66667
"19454","63026","2014",26,26,0,184122.3,2198.769,84.88462
"19455","63027","2014",1,1,0,38000,422,90
"19456","63028","2014",4,4,0,82000,1728,62.25
"19457","63029","2014",2,2,0,126000,1089,123.5
"19458","63031","2014",8,8,0,83053.12,924.375,82.375
"19459","63032","2014",120,57,63,181179.2,2116.75,86.35
"19460","63033","2014",2,2,0,133250,1110.5,120
"19461","63034","2014",21,21,0,183833.1,1815.857,104.1429
"19462","63035","2014",8,8,0,154768.1,1589.875,96.25
"19463","63036","2014",2,2,0,152050,1461.5,105.5
"19464","63037","2014",8,8,0,65437.5,777.875,79.75
"19465","63038","2014",64,19,45,107848.9,2639.984,42.35938
"19466","63039","2014",6,6,0,40458.33,444.1667,92.33333
"19467","63040","2014",60,49,11,128841.6,1343.2,97.11667
"19468","63041","2014",4,4,0,91750,836.25,107.75
"19469","63042","2014",25,22,3,145858.8,1902.32,77.4
"19470","63043","2014",8,8,0,89916.88,1194.375,81.875
"19471","63044","2014",2,2,0,154000,1233.5,125.5
"19472","63045","2014",5,5,0,127460,1339,100.2
"19473","63046","2014",10,10,0,83410,846.4,96.4
"19474","63047","2014",57,18,39,68250.6,1259.14,60.08772
"19475","63048","2014",8,8,0,63822.5,907.125,80.125
"19476","63049","2014",10,10,0,155966,1556.4,98.8
"19477","63050","2014",28,27,1,102288.5,1094.857,96.57143
"19478","63051","2014",1,1,0,160000,1633,98
"19479","63052","2014",9,9,0,134533.3,1612.111,87.77778
"19480","63053","2014",4,4,0,58250,712.5,95.25
"19481","63054","2014",2,2,0,172300,1346,129
"19482","63055","2014",2,2,0,69500,950,72.5
"19483","63056","2014",6,6,0,96941.67,1146,78.83333
"19484","63057","2014",3,3,0,113166.7,818,157.3333
"19485","63058","2014",6,6,0,202833.3,1558.167,131.8333
"19486","63059","2014",1,1,0,201700,2241,90
"19487","63060","2014",2,2,0,97500,1410,92
"19488","63061","2014",3,3,0,158766.7,1460.667,121.6667
"19489","63062","2014",2,2,0,147345,2192.5,65.5
"19490","63063","2014",65,59,6,176893.2,1976.031,91.01538
"19491","63065","2014",3,3,0,71866.67,943,78
"19492","63066","2014",10,9,1,75570,857.8,90.2
"19493","63067","2014",1,1,0,45000,517,87
"19494","63069","2014",38,32,6,171425.9,1941.368,88.26316
"19495","63070","2014",62,52,10,236990.6,2187.129,105.8548
"19496","63071","2014",11,11,0,149383.2,1521.909,114.2727
"19497","63072","2014",5,3,2,64580,1000.2,69
"19498","63073","2014",2,2,0,198100,1602.5,123.5
"19499","63074","2014",2,2,0,78650,804,96
"19500","63075","2014",354,52,302,151691,2072.585,70.54237
"19501","63076","2014",2,2,0,116000,1204,90
"19502","63077","2014",7,6,1,113262.9,1800.143,71
"19503","63079","2014",1,1,0,105000,1221,86
"19504","63080","2014",8,8,0,82031.25,1127.25,75.125
"19505","63081","2014",5,5,0,46600,955.2,45.8
"19506","63082","2014",8,8,0,149654.6,1173.75,130.75
"19507","63083","2014",3,3,0,219900,2192.333,100
"19508","63084","2014",14,14,0,203396.4,1908.857,103.8571
"19509","63085","2014",7,7,0,98001.43,980.8571,99.71429
"19510","63086","2014",3,3,0,122190,1032.667,122
"19511","63087","2014",1,1,0,50000,658,76
"19512","63088","2014",1,1,0,164900,2061,80
"19513","63089","2014",8,8,0,202275,1816.75,118.25
"19514","63090","2014",5,5,0,128028.8,1220.6,111.8
"19515","63091","2014",5,5,0,98200,1405,68.4
"19516","63092","2014",15,15,0,141323.3,1461,94.53333
"19517","63093","2014",15,15,0,119999.5,1171.867,102.3333
"19518","63094","2014",2,2,0,57850,667,91
"19519","63095","2014",3,3,0,80466.67,997.6667,80
"19520","63096","2014",4,4,0,110337.5,1258.5,94.25
"19521","63097","2014",1,1,0,65000,677,96
"19522","63098","2014",10,4,6,69550.5,1911.2,41.5
"19523","63099","2014",24,24,0,207974.8,1913.25,110
"19524","63100","2014",5,5,0,93680,860.4,104.6
"19525","63101","2014",2,2,0,88500,636,138
"19526","63102","2014",7,7,0,83421.43,883,88.57143
"19527","63103","2014",83,45,38,132360,1663.133,80.15663
"19528","63104","2014",1,1,0,80000,696,115
"19529","63105","2014",3,3,0,56700,719,83.33333
"19530","63106","2014",15,15,0,123220,1456.933,83.6
"19531","63107","2014",3,3,0,204533.3,1699.333,118.6667
"19532","63108","2014",6,6,0,152266.7,1755.333,87.66667
"19533","63109","2014",4,4,0,101562.5,1008,99.5
"19534","63110","2014",1,1,0,118760,1381,86
"19535","63111","2014",3,3,0,97833.33,872.3333,105.6667
"19536","63112","2014",4,4,0,197410,1730.5,114.25
"19537","63113","2014",1720,269,1451,119398.7,1844.392,65.61453
"19538","63114","2014",3,3,0,177500,1365.333,125.3333
"19539","63115","2014",2,1,1,38500,627,62
"19540","63116","2014",18,17,1,114073.1,1306.389,89.72222
"19541","63117","2014",2,2,0,49297,521,103.5
"19542","63118","2014",1,1,0,64173,361,178
"19543","63119","2014",4,4,0,55468.75,650.25,88.75
"19544","63120","2014",10,10,0,127891,1390.2,94
"19545","63121","2014",18,17,1,118993.3,1461.778,87.94444
"19546","63123","2014",8,8,0,83375,972.625,85
"19547","63124","2014",159,111,48,170132.3,1909.818,88.91824
"19548","63125","2014",33,30,3,105808,1032.848,97.87879
"19549","63126","2014",5,5,0,232400,1953.4,118
"19550","63128","2014",4,4,0,117600,1269.75,99.75
"19551","63129","2014",1,1,0,130000,2063,63
"19552","63130","2014",2,2,0,32500,529.5,63
"19553","63131","2014",9,9,0,147955.6,1473.222,100.7778
"19554","63132","2014",9,9,0,71146,995.1111,78.11111
"19555","63135","2014",6,6,0,98550,1305.667,73.5
"19556","63136","2014",5,5,0,85700,1010,93
"19557","63137","2014",2,2,0,128215,1120,112
"19558","63138","2014",6,6,0,102333.3,997.6667,100.5
"19559","63139","2014",3,3,0,37333.33,449.3333,77.33333
"19560","63140","2014",5,5,0,39780,696,58.8
"19561","63141","2014",14,14,0,225945.7,2110.214,107.3571
"19562","63142","2014",1,1,0,29000,763,38
"19563","63143","2014",10,10,0,128536.3,1539.3,87.6
"19564","63144","2014",4,4,0,102950,1691,63.5
"19565","63145","2014",3,3,0,80666.67,1204,69.33333
"19566","63146","2014",4,4,0,96750,937,102
"19567","63147","2014",4,4,0,62750,885.75,70
"19568","63148","2014",22,22,0,146129.6,1546.409,95.18182
"19569","63149","2014",6,6,0,165550.8,1611.833,101.3333
"19570","63150","2014",11,11,0,193033.2,1870.455,105.5455
"19571","63151","2014",5,4,1,81860,994.6,75
"19572","63152","2014",3,3,0,61100,694,86
"19573","63153","2014",2,2,0,34275,569.5,60
"19574","63154","2014",3,3,0,111733.3,988.6667,110.3333
"19575","63155","2014",8,8,0,154487.5,1101.375,140
"19576","63156","2014",2,2,0,97965,742.5,119
"19577","63157","2014",7,7,0,88514.29,898.8571,94.85714
"19578","63158","2014",3,3,0,70666.67,636,118.3333
"19579","63160","2014",10,10,0,157964,1511.4,104.4
"19580","63161","2014",4,4,0,100800,1159.75,83.5
"19581","63162","2014",1,1,0,110000,1000,110
"19582","63163","2014",1,1,0,37000,430,86
"19583","63164","2014",111,73,38,149102.6,1866.243,82.08108
"19584","63165","2014",5,5,0,93100,1092.4,94.4
"19585","63166","2014",2,2,0,115500,757.5,130
"19586","63167","2014",1,1,0,151950,2451,62
"19587","63168","2014",3,3,0,129583.3,1051,121.6667
"19588","63171","2014",3,3,0,66833.33,906,75.33333
"19589","63173","2014",3,3,0,32333.33,801,50
"19590","63174","2014",2,2,0,40000,733.5,55
"19591","63177","2014",3,3,0,75941.33,826,79.33333
"19592","63178","2014",147,96,51,128359.1,1566.347,80.90476
"19593","63179","2014",9,9,0,81000,1267.889,71.33333
"19594","63180","2014",13,13,0,110723.6,1619.769,73.69231
"19595","63181","2014",3,3,0,101666.7,965,99
"19596","63182","2014",7,6,1,101200,1800,73.57143
"19597","63184","2014",5,5,0,97395.8,815.6,104
"19598","63185","2014",9,9,0,94596.67,851.8889,112
"19599","63186","2014",3,3,0,104266.7,994,109.3333
"19600","63187","2014",12,12,0,74131.67,986.25,79.91667
"19601","63188","2014",9,9,0,151228.9,1369.778,120.5556
"19602","63189","2014",5,5,0,128200,1656.2,87.6
"19603","63190","2014",5,5,0,50600,1095.6,50.2
"19604","63191","2014",1,1,0,56000,718,78
"19605","63192","2014",12,12,0,92941.67,1145.25,80.5
"19606","63193","2014",61,50,11,159672.7,1840.016,87.7541
"19607","63194","2014",2,2,0,99710,784,131.5
"19608","63195","2014",43,42,1,146040.3,1672.953,91.02326
"19609","63196","2014",8,8,0,126200,1105.25,115
"19610","63197","2014",3,3,0,75033.33,1104,60.33333
"19611","63198","2014",10,9,1,160609,1805.7,93.8
"19612","63199","2014",10,10,0,117719.1,1492,77.8
"19613","63200","2014",9,9,0,123777.8,1518.889,78.77778
"19614","63201","2014",4,4,0,95556,1029.75,100
"19615","63203","2014",8,8,0,177942.5,2115.375,93.75
"19616","63204","2014",6,6,0,130705,1805.333,73.33333
"19617","63205","2014",1,1,0,160200,1820,88
"19618","63206","2014",5,5,0,159646,1277,112.6
"19619","63207","2014",8,8,0,105825,1176.875,90.375
"19620","63208","2014",5,5,0,122742,1050.8,120.4
"19621","63209","2014",1,1,0,83000,692,120
"19622","63210","2014",35,35,0,111779.1,1208.4,95.14286
"19623","63211","2014",11,11,0,80318.18,904.9091,85.90909
"19624","63212","2014",13,13,0,221306.9,1918.846,109.8462
"19625","63213","2014",21,21,0,184814.3,1759.381,104.6667
"19626","63214","2014",31,27,4,145431,1591.484,91.19355
"19627","63215","2014",7,7,0,146142.9,1490.857,95.85714
"19628","63216","2014",1,1,0,30000,1200,25
"19629","63218","2014",1,1,0,205000,1614,127
"19630","63219","2014",3,3,0,112833.3,1121,94
"19631","63220","2014",3,3,0,44466.67,575.6667,74
"19632","63222","2014",4,4,0,117600,1207.75,95.25
"19633","63223","2014",7,7,0,53071.43,1152.286,64
"19634","63224","2014",10,10,0,176211.1,1430.1,138.5
"19635","63225","2014",11,11,0,56031.82,852.5455,71.63636
"19636","63226","2014",38,38,0,194137.3,1749.5,110.7895
"19637","63228","2014",5,5,0,69670,1151.6,62.4
"19638","63229","2014",7,7,0,173357.1,1772.143,97.85714
"19639","63230","2014",3,3,0,103333.3,726.3333,142.3333
"19640","63231","2014",9,9,0,82488.33,864.7778,94.11111
"19641","63232","2014",5,5,0,127400,1316.4,91.8
"19642","63233","2014",11,11,0,64373.18,1026.091,81.90909
"19643","63234","2014",6,6,0,131875,1437.667,93.83333
"19644","63235","2014",3,3,0,160930,1497,106
"19645","63236","2014",90,12,78,85610.7,1939.944,46.2
"19646","63237","2014",6,6,0,94000.83,772.6667,110.8333
"19647","63238","2014",1,1,0,130000,867,150
"19648","63239","2014",6,6,0,125324.2,1621.167,79
"19649","63240","2014",5,5,0,147919,1056,131.2
"19650","63241","2014",3,3,0,166416.7,1896.333,85
"19651","63242","2014",3,3,0,107200,1383.667,80
"19652","63243","2014",3,3,0,78300,875.6667,87.66667
"19653","63244","2014",9,9,0,167022.2,1725.333,99.11111
"19654","63245","2014",28,28,0,185650.9,2041.071,94.57143
"19655","63246","2014",6,6,0,161610,1621,105.6667
"19656","63247","2014",10,7,3,103120,2895.1,50.3
"19657","63248","2014",7,7,0,180477.1,1502,129.7143
"19658","63249","2014",6,6,0,107600,1353.167,87.33333
"19659","63250","2014",5,5,0,136089,1434,95
"19660","63252","2014",6,6,0,131573.3,1258.667,103.5
"19661","63253","2014",2,2,0,60000,626,96
"19662","63254","2014",20,20,0,205124.6,2183.2,90.75
"19663","63255","2014",7,7,0,118542.9,1051.143,99.28571
"19664","63257","2014",9,9,0,141211.1,1365.778,100.4444
"19665","63258","2014",10,10,0,54823,702.2,74.2
"19666","63259","2014",4,4,0,154525,1859.25,92.5
"19667","63260","2014",4,4,0,92050,1136.5,72
"19668","63261","2014",7,7,0,102857.1,1425.143,69
"19669","63262","2014",24,24,0,187088,1735.958,105.4167
"19670","63263","2014",9,9,0,204404.4,1863.778,114.6667
"19671","63264","2014",1,1,0,75000,1415,53
"19672","63265","2014",21,20,1,198116.7,1623.333,126.4286
"19673","63267","2014",3,3,0,78366.67,937.6667,91.66667
"19674","63268","2014",3,3,0,196968.3,1767.333,111.3333
"19675","63269","2014",15,13,2,161023.7,1619,98.73333
"19676","63270","2014",3,3,0,84400,995,85.33333
"19677","63271","2014",10,10,0,96110,971,96.8
"19678","63272","2014",22,20,2,196588.6,1996.682,100.7727
"19679","63274","2014",3,3,0,72666.67,912.3333,74.33333
"19680","63275","2014",13,13,0,122719.2,1423.769,88
"19681","63276","2014",12,12,0,143364.6,2495.667,97.41667
"19682","63278","2014",3,3,0,204250,2199.333,94
"19683","63279","2014",9,9,0,96472.22,1430.778,67.55556
"19684","63280","2014",1,1,0,55000,833,66
"19685","63281","2014",9,9,0,77588.89,875.8889,87.33333
"19686","63282","2014",15,15,0,152806,1532.467,97.46667
"19687","63283","2014",1,1,0,58000,408,142
"19688","63284","2014",35,35,0,210557.5,2099.657,100.8
"19689","63285","2014",9,9,0,117517.2,1083.778,109.7778
"19690","63286","2014",4,4,0,84050,1425.25,68.5
"19691","63287","2014",3,3,0,95916.67,1005,119
"19692","63288","2014",3,3,0,219966.7,1786.667,123.3333
"19693","63290","2014",1,1,0,2e+05,1399,143
"19694","63291","2014",21,21,0,99947.62,1067.714,92.09524
"19695","63292","2014",1,1,0,60000,536,112
"19696","63293","2014",7,7,0,65176.43,849.7143,80.85714
"19697","63294","2014",1,1,0,42750,972,44
"19698","63295","2014",18,18,0,94288.22,1155.5,85.66667
"19699","63296","2014",5,5,0,175860,1853.4,94.2
"19700","63297","2014",6,6,0,117350,1385.333,97.83333
"19701","63298","2014",1,1,0,43000,652,66
"19702","63299","2014",2,2,0,17500,438,41.5
"19703","63300","2014",203,127,76,139887.7,1695.123,81.4335
"19704","63301","2014",10,10,0,99160,915.6,110.2
"19705","63302","2014",23,21,2,172218.3,1546.913,114.0435
"19706","63303","2014",1,1,0,69300,462,150
"19707","63305","2014",3,3,0,79390,793,95.33333
"19708","63306","2014",5,5,0,191690,1500.6,128
"19709","63307","2014",47,36,11,188980.1,2037.468,92.3617
"19710","63308","2014",82,24,58,133771,1858.195,66.15854
"19711","63309","2014",1,1,0,75500,1302,58
"19712","63310","2014",1,1,0,156800,1375,114
"19713","63311","2014",4,4,0,156027.5,1525.25,103.75
"19714","63312","2014",1,1,0,37000,822,45
"19715","63314","2014",2,2,0,44000,730,65
"19716","63315","2014",13,13,0,221750,1927.077,122.5385
"19717","63317","2014",4,4,0,105750,1469.5,70.25
"19718","63319","2014",8,7,1,90875,999.375,96.125
"19719","63321","2014",5,4,1,110820,1350.2,83.8
"19720","63322","2014",17,17,0,173204.2,1638.882,105.2941
"19721","63323","2014",2,2,0,97100,1061,95.5
"19722","63324","2014",2,2,0,63900,591.5,108.5
"19723","63325","2014",1,1,0,187200,1910,98
"19724","63326","2014",3,3,0,92733.33,999.3333,85.66667
"19725","63327","2014",13,13,0,186092.3,1893.077,99.46154
"19726","63329","2014",1,1,0,75000,1103,68
"19727","63330","2014",3,3,0,152533.3,1842.333,82.33333
"19728","63331","2014",3,3,0,112163.3,1527.333,71
"19729","63332","2014",3,3,0,128216.7,1434,87.33333
"19730","63334","2014",9,9,0,115789.4,1145,116.3333
"19731","63335","2014",7,7,0,88085.71,1345.429,64.14286
"19732","63336","2014",3,3,0,71820,1345.667,49.66667
"19733","63338","2014",26,26,0,65480.69,844.3846,77.19231
"19734","63340","2014",6,6,0,82166.67,1000,87.83333
"19735","63341","2014",2,2,0,127500,1291.5,102.5
"19736","63342","2014",4,4,0,106870,1124.5,90
"19737","63343","2014",1,1,0,24000,533,45
"19738","63344","2014",3,3,0,108333.3,1960.667,106
"19739","63345","2014",17,17,0,176764.7,2122.765,99.11765
"19740","63346","2014",3,2,1,100633.3,1782,50.33333
"19741","63347","2014",4,4,0,147762.5,1354.5,109.5
"19742","63348","2014",3,2,1,104351.3,915.6667,139.6667
"19743","63349","2014",12,11,1,117375,1202.417,105.9167
"19744","63350","2014",12,12,0,185558.3,1735,108.3333
"19745","63352","2014",21,21,0,103380.7,1236.905,87.42857
"19746","63353","2014",3,3,0,49666.67,676.3333,71.66667
"19747","63354","2014",8,8,0,49887.5,783.875,64
"19748","63355","2014",5,5,0,51214,671.8,82
"19749","63356","2014",3,3,0,80400,1140.333,71
"19750","63357","2014",1,1,0,35000,897,39
"19751","63358","2014",1,1,0,273200,1846,148
"19752","63359","2014",1,1,0,75000,577,130
"19753","63362","2014",5,5,0,171960,1763.4,106.2
"19754","63363","2014",2,2,0,95000,1034.5,101.5
"19755","63364","2014",6,6,0,117053.3,1381.333,85.66667
"19756","63365","2014",4,4,0,109750,1000.25,111.25
"19757","63366","2014",2,2,0,58500,577,95
"19758","63368","2014",13,13,0,111450.9,1354.385,90.69231
"19759","63370","2014",3,2,1,61333.33,646.3333,87.66667
"19760","63372","2014",5,5,0,165350,1747.4,95
"19761","63374","2014",1,1,0,35000,583,60
"19762","63375","2014",2,2,0,102000,1575.5,63
"19763","63376","2014",2,2,0,113650,778.5,147.5
"19764","63377","2014",8,8,0,65926.12,788.125,91.5
"19765","63378","2014",17,17,0,106994.1,1500,80.70588
"19766","63379","2014",5,5,0,147616,1461.6,115.2
"19767","63380","2014",10,8,2,125115,1773.5,74.8
"19768","63381","2014",5,5,0,138866,1297,108
"19769","63382","2014",5,5,0,88631.4,937.4,89.8
"19770","63383","2014",4,4,0,189345,1935,89.75
"19771","63384","2014",5,4,1,73385,1099,59.2
"19772","63385","2014",3,3,0,90803.33,707,131.6667
"19773","63386","2014",2,2,0,99400,2072.5,50.5
"19774","63387","2014",6,6,0,106500,1105.833,105
"19775","63388","2014",1,1,0,60000,800,75
"19776","63389","2014",3,3,0,106750,1283.333,80.33333
"19777","63390","2014",5,5,0,159400,1672.2,102.8
"19778","63391","2014",4,4,0,125000,1256.25,100.5
"19779","63392","2014",7,6,1,123042.9,1225.857,99
"19780","63393","2014",15,15,0,104262.7,1136.8,90.73333
"19781","63394","2014",1,1,0,122000,1452,84
"19782","63395","2014",7,7,0,141571.4,1556.857,89.85714
"19783","63396","2014",10,10,0,152490,1904,99.8
"19784","63397","2014",8,8,0,106000,1381.5,83.625
"19785","63400","2014",7,7,0,146214.3,1192,121.7143
"19786","63401","2014",2,2,0,51950,1767.5,29
"19787","63402","2014",2,2,0,71425,871.5,80.5
"19788","63403","2014",6,6,0,198050,1409.5,140.6667
"19789","63404","2014",6,6,0,173257.5,1499.833,110.5
"19790","63405","2014",7,7,0,119267.1,1287.143,93.57143
"19791","63408","2014",6,6,0,60008.33,872.6667,62.66667
"19792","63409","2014",3,3,0,82366.67,1404.333,61.66667
"19793","63411","2014",2,2,0,151385,1532,107
"19794","63412","2014",3,3,0,138333.3,968.6667,150
"19795","63413","2014",7,7,0,197192.9,1888.857,107.7143
"19796","63414","2014",2,2,0,69500,1098.5,85
"19797","63415","2014",19,17,2,94871.58,1152.579,83.31579
"19798","63416","2014",2,2,0,89250,912,92.5
"19799","63417","2014",19,19,0,158447.4,1838.579,89.15789
"19800","63418","2014",6,6,0,103371.7,935.8333,105
"19801","63419","2014",8,8,0,66400,735.5,91
"19802","63420","2014",1,1,0,38200,695,55
"19803","63421","2014",1,1,0,30000,750,40
"19804","63422","2014",6,6,0,178350,1346.333,141.1667
"19805","63423","2014",10,10,0,120388,1201,101
"19806","63424","2014",3,3,0,209833.3,1764.667,123.6667
"19807","63425","2014",15,14,1,199141.3,1926.933,106.0667
"19808","63426","2014",3,3,0,56666.67,850.3333,68.33333
"19809","63427","2014",3,3,0,114333.3,1527,71
"19810","63428","2014",4,4,0,60000,882.5,66.25
"19811","63430","2014",83,64,19,74180.27,981.494,76.86747
"19812","63432","2014",13,13,0,132046.2,1806.154,79.38462
"19813","63434","2014",7,7,0,57168.57,792.7143,81.14286
"19814","63435","2014",2,2,0,161750,1333,124.5
"19815","63436","2014",1,1,0,147850,739,200
"19816","63438","2014",4,4,0,123925,1202.25,98.25
"19817","63439","2014",3,3,0,97561,1429.333,71.33333
"19818","63441","2014",5,5,0,67800,1161.6,54.4
"19819","63443","2014",6,6,0,200466.7,1969.333,103.1667
"19820","63444","2014",3,3,0,139766.7,919,139
"19821","63445","2014",2,2,0,145525,1581,96
"19822","63446","2014",3,3,0,146090,1274,128.3333
"19823","63448","2014",12,12,0,91420.83,1003.167,98.41667
"19824","63449","2014",5,5,0,85620,1207.4,73.2
"19825","63450","2014",4,4,0,105000,966.5,102
"19826","63451","2014",2,2,0,99885.5,1975,82.5
"19827","63453","2014",29,27,2,140037.1,1480.276,98.55172
"19828","63454","2014",7,7,0,84285.71,807.1429,103.4286
"19829","63455","2014",26,25,1,235261.4,2106.885,112.6538
"19830","63456","2014",2,2,0,97000,958.5,106.5
"19831","63457","2014",42,39,3,161132.5,1673.048,96.52381
"19832","63458","2014",2,2,0,90975,1477.5,70
"19833","63459","2014",7,7,0,123485.7,1142.429,107.7143
"19834","63460","2014",2,2,0,41500,583,67.5
"19835","63462","2014",2,2,0,59425,877,89.5
"19836","63463","2014",2,2,0,39250,887,41
"19837","63464","2014",6,6,0,110866.7,1074.167,103.5
"19838","63465","2014",4,4,0,137500,1299.25,102
"19839","63466","2014",4,4,0,41610,694.75,63
"19840","63467","2014",1,1,0,47000,348,135
"19841","63468","2014",1,1,0,66500,1357,49
"19842","63469","2014",5,5,0,79018,1035.4,90.6
"19843","63470","2014",39,34,5,146827.9,1668.077,86.15385
"19844","63471","2014",5,5,0,78110,803.8,95.8
"19845","63472","2014",11,11,0,112690.9,1185.727,89.27273
"19846","63473","2014",5,5,0,103220,1325.6,79.8
"19847","64001","2014",1,1,0,140000,1197,117
"19848","64003","2014",2,2,0,145000,1174,125.5
"19849","64005","2014",3,3,0,172933.3,1618.667,112
"19850","64006","2014",2,2,0,140392.5,1583.5,94
"19851","64007","2014",3,3,0,166666.7,1671,105
"19852","64008","2014",1,1,0,35000,422,83
"19853","64009","2014",16,12,4,380815,2952.062,128
"19854","64010","2014",6,6,0,157916.7,1326.667,124.1667
"19855","64012","2014",1,1,0,70000,1148,61
"19856","64013","2014",3,3,0,192400,919,214.3333
"19857","64014","2014",4,4,0,285750,2348.5,126.5
"19858","64015","2014",1,1,0,2e+05,1538,130
"19859","64016","2014",4,4,0,117276,1204.5,107.5
"19860","64017","2014",5,5,0,146882,1124.8,131.6
"19861","64018","2014",3,2,1,150000,1551,93.66667
"19862","64019","2014",2,2,0,137500,1433,96.5
"19863","64021","2014",4,4,0,166700,1366.25,117.5
"19864","64022","2014",2,2,0,110000,967.5,106
"19865","64023","2014",5,5,0,182772.6,1699.2,110.8
"19866","64024","2014",487,153,334,299175.4,3743.99,78.56468
"19867","64025","2014",1,1,0,1e+05,1075,93
"19868","64026","2014",5,5,0,202200,1413.2,141.2
"19869","64027","2014",2,2,0,167385,1856.5,90
"19870","64028","2014",2,2,0,198225,2341,84.5
"19871","64029","2014",5,5,0,175740,1235.6,140.2
"19872","64031","2014",2,2,0,206000,1654.5,124.5
"19873","64032","2014",2,2,0,170653.5,1439,121
"19874","64033","2014",1,1,0,119500,664,180
"19875","64034","2014",3,3,0,220833.3,2009.667,111.3333
"19876","64035","2014",14,11,3,346514.4,4764.857,91.28571
"19877","64036","2014",2,2,0,226869.5,1880,128
"19878","64037","2014",8,8,0,249569.9,1841.375,133.75
"19879","64038","2014",26,13,13,451348.7,3858.692,107.3077
"19880","64040","2014",13,5,8,71961.38,1570.769,59.46154
"19881","64041","2014",6,4,2,186733.3,1672.667,108.5
"19882","64042","2014",3,3,0,161666.7,1441,114
"19883","64043","2014",2,2,0,238750,1758.5,138.5
"19884","64044","2014",1,1,0,126000,1008,125
"19885","64047","2014",2,2,0,91675,1499,68
"19886","64049","2014",3,3,0,195000,1077.333,184.6667
"19887","64051","2014",7,6,1,207705.9,1679.857,126.4286
"19888","64052","2014",1,1,0,90000,652,138
"19889","64053","2014",1,1,0,50000,410,122
"19890","64054","2014",3,3,0,248016.7,1707.667,162.3333
"19891","64057","2014",14,13,1,122735.7,1132.5,119.7143
"19892","64058","2014",2,2,0,91205,1065,85
"19893","64059","2014",1,1,0,377650,1234,306
"19894","64060","2014",6,5,1,217981.8,2092.333,122.5
"19895","64061","2014",14,12,2,145943.4,1688.5,88.28571
"19896","64062","2014",13,11,2,132759.9,1336.615,102.5385
"19897","64063","2014",6,6,0,179833.3,1273.667,138.5
"19898","64064","2014",2,2,0,146944.5,1585.5,94.5
"19899","64065","2014",30,22,8,338052.3,3047.367,110.3
"19900","64066","2014",2,2,0,247500,1525,158
"19901","64067","2014",16,16,0,218324.4,1827.562,118.5625
"19902","64068","2014",6,6,0,184541.7,1568.833,117.3333
"19903","64069","2014",3,3,0,109283.3,1670.667,68
"19904","64070","2014",2,2,0,267950,1949.5,165
"19905","64071","2014",2,2,0,172125,1932.5,89.5
"19906","64072","2014",3,3,0,171000,1385.667,120.3333
"19907","64073","2014",2,2,0,233930,1901.5,123
"19908","64077","2014",1,1,0,116000,1706,68
"19909","64078","2014",2,2,0,179800,1436,128.5
"19910","64080","2014",4,4,0,224562.5,1697.75,141
"19911","64081","2014",2,2,0,120000,1055.5,115
"19912","64082","2014",1,1,0,149500,1300,115
"19913","64083","2014",2,2,0,97500,599.5,204.5
"19914","64084","2014",2,2,0,83500,728,114
"19915","64085","2014",5,5,0,134938,2017.4,64
"19916","64086","2014",4,3,1,208750,2137,99.25
"19917","64087","2014",4,4,0,140000,1531.75,88.5
"19918","64088","2014",4,4,0,216556.5,1261,172.75
"19919","64090","2014",1,1,0,131000,1008,130
"19920","64092","2014",2,2,0,73000,1122,78
"19921","64093","2014",3,3,0,144000,1682.333,104.6667
"19922","64094","2014",9,9,0,215103.9,1764.222,121.3333
"19923","64095","2014",5,5,0,146908,1596.2,90
"19924","64096","2014",1,1,0,79048,790,100
"19925","64097","2014",3,3,0,192500,1571,124.6667
"19926","64099","2014",1,1,0,90000,1250,72
"19927","64100","2014",31,16,15,313001.6,2964.323,99.22581
"19928","64101","2014",1,1,0,108347,1083,100
"19929","64102","2014",570,70,500,184811.8,2659.853,69.49825
"19930","64104","2014",3,3,0,137500,1162.333,126.6667
"19931","64106","2014",5,5,0,144325,1211.8,120.2
"19932","64108","2014",11,11,0,115427.3,1104.364,108.2727
"19933","64109","2014",17,15,2,177555.9,1568.941,113.4118
"19934","64110","2014",4,4,0,153915,1457.75,107.25
"19935","64111","2014",2,2,0,153500,813.5,193
"19936","64112","2014",3,3,0,232666.7,1458.333,138.3333
"19937","64114","2014",3,3,0,180433.3,1749.333,105
"19938","64115","2014",1,1,0,58000,725,80
"19939","64117","2014",1,1,0,60200,401,150
"19940","64120","2014",3,3,0,200733.3,1340.667,158.6667
"19941","64121","2014",2,2,0,238950,2163,110
"19942","64122","2014",545,83,462,307841.7,4674.494,67.33761
"19943","64123","2014",4,3,1,208750,1807.25,114.25
"19944","64124","2014",5,5,0,370360,3077.4,126
"19945","64125","2014",92,34,58,308076.8,4174.522,76.09783
"19946","64126","2014",6,6,0,124166.7,1276.833,96.83333
"19947","64127","2014",1,1,0,237000,697,340
"19948","64128","2014",1,1,0,190000,1583,120
"19949","64129","2014",193,49,144,133456.5,1840.964,74.08808
"19950","64130","2014",10,4,6,223170,2349.7,95.3
"19951","64131","2014",5,5,0,170248,1432,126.4
"19952","64132","2014",48,32,16,183961.3,1803.292,101.9583
"19953","64133","2014",9,6,3,128148.9,1783.222,91.33333
"19954","64134","2014",2,2,0,360000,2353.5,148
"19955","64135","2014",4,4,0,205750,1940.25,112
"19956","64136","2014",2,2,0,58500,1125,52
"19957","64137","2014",4,4,0,197325,1479.5,134
"19958","64138","2014",28,28,0,174124.4,1994.607,90.71429
"19959","64139","2014",5,5,0,226000,1778.8,129.8
"19960","64140","2014",93,46,47,192206.5,2460.376,80.51613
"19961","64141","2014",3,3,0,145883.3,1923,76.66667
"19962","64142","2014",5,5,0,152000,1430.8,112.4
"19963","64144","2014",1,1,0,252700,1469,172
"19964","64145","2014",1,1,0,134231,994,135
"19965","64146","2014",1,1,0,199000,1244,160
"19966","64147","2014",14,7,7,235816.4,2359.571,107.1429
"19967","64148","2014",14,13,1,160059.6,1552.643,103.2857
"19968","64149","2014",2,2,0,174550,1057.5,164.5
"19969","64152","2014",12,12,0,313670.7,2337.833,141.25
"19970","64156","2014",3,3,0,172833.3,1164,153.3333
"19971","64157","2014",5,5,0,153974,1394.2,110
"19972","64159","2014",1,1,0,101230,912,111
"19973","64160","2014",72,27,45,177484.2,2440.778,75.48611
"19974","64161","2014",2,2,0,133000,1223,116
"19975","64165","2014",1,1,0,145000,1107,131
"19976","64167","2014",2,2,0,233930.5,1799,134
"19977","64168","2014",7,7,0,131428.6,1284.429,102.7143
"19978","64170","2014",1,1,0,1e+05,1299,77
"19979","64171","2014",1,1,0,158000,1580,100
"19980","64172","2014",2,2,0,216425,1417.5,156
"19981","64173","2014",2,2,0,111500,1281,87.5
"19982","64177","2014",3,3,0,104533.3,1201,89.66667
"19983","64178","2014",2,2,0,196000,1588,127.5
"19984","64179","2014",1,1,0,170000,1910,89
"19985","64180","2014",5,5,0,149700,1357.2,108.6
"19986","64181","2014",3,3,0,143220,1656,87
"19987","64182","2014",2,2,0,77500,1078.5,71
"19988","64183","2014",3,3,0,140333.3,1162,115.3333
"19989","64184","2014",3,3,0,224994.7,1684.667,136
"19990","64185","2014",2,2,0,85000,1129.5,72.5
"19991","64187","2014",3,3,0,115902.7,1124.333,111.3333
"19992","64188","2014",10,10,0,124800,1150,117.3
"19993","64189","2014",119,21,98,273435.5,3983.655,68.01681
"19994","64191","2014",16,14,2,152127.5,1347.938,112.25
"19995","64193","2014",1,1,0,165400,1282,129
"19996","64194","2014",2,2,0,113000,925.5,102
"19997","64197","2014",1,1,0,178000,1762,101
"19998","64198","2014",13,13,0,218647.3,2227,102.7692
"19999","64199","2014",1,1,0,1e+05,541,185
"20000","64200","2014",1,1,0,81000,1095,74
"20001","64201","2014",1,1,0,260000,1300,200
"20002","64202","2014",1,1,0,153000,1093,140
"20003","64203","2014",3,3,0,157366.7,1404.667,112.3333
"20004","64204","2014",27,5,22,98169,2084.296,50.92593
"20005","64205","2014",1,1,0,80000,1013,79
"20006","64207","2014",1,1,0,89000,593,150
"20007","64209","2014",2,2,0,155000,1073,123
"20008","64211","2014",2,2,0,278250,2165.5,129
"20009","64212","2014",2,2,0,201200,1452,139
"20010","64213","2014",6,6,0,252174.5,2702.167,96.5
"20011","64214","2014",2,2,0,125000,1307.5,100
"20012","64215","2014",1,1,0,105000,1312,80
"20013","64216","2014",6,5,1,240133.3,1687.833,141.6667
"20014","64217","2014",3,3,0,178413.3,1809.667,97.33333
"20015","64218","2014",1,1,0,60000,1000,60
"20016","64220","2014",2,2,0,260000,1733.5,152
"20017","64223","2014",2,2,0,71750,1273.5,57.5
"20018","64224","2014",2,2,0,237250,2056,115.5
"20019","64225","2014",3,2,1,100666.7,958.6667,108.6667
"20020","64226","2014",1,1,0,178000,1380,129
"20021","64227","2014",3,3,0,129500,1569.333,83
"20022","64228","2014",3,3,0,158333.3,1300.667,116.6667
"20023","64230","2014",51,45,6,182657.6,1687.569,113.6471
"20024","64231","2014",1,1,0,55000,932,59
"20025","64232","2014",2,2,0,217000,1834.5,123
"20026","64233","2014",12,12,0,135395.8,1409.5,114.5833
"20027","64234","2014",2,2,0,147110,1678,86
"20028","64237","2014",34,17,17,171245.5,1851.059,93.38235
"20029","64238","2014",9,9,0,224961.1,1820.667,125.4444
"20030","64239","2014",2,2,0,118250,1070.5,123.5
"20031","64240","2014",4,4,0,170455.2,1619,106
"20032","64241","2014",3,3,0,124666.7,1123.333,113
"20033","64242","2014",1,1,0,237000,1454,163
"20034","64243","2014",3,3,0,215466.7,1756.667,126.3333
"20035","64245","2014",6,6,0,152386.7,1692.667,93.83333
"20036","64246","2014",2,2,0,194150,1857,105
"20037","64247","2014",1,1,0,65500,720,91
"20038","64249","2014",26,9,17,492501.3,4902.154,85.03846
"20039","64250","2014",7,6,1,205403.7,1869.143,113
"20040","64252","2014",6,6,0,147000,1861.833,80.16667
"20041","64253","2014",2,2,0,142000,1740.5,82
"20042","64254","2014",3,3,0,83333.33,1219.667,71.66667
"20043","64255","2014",1,0,1,165000,1941,85
"20044","64256","2014",40,19,21,177255,2110.7,85.5
"20045","64257","2014",4,4,0,132875,1247.5,109
"20046","64258","2014",1,1,0,37000,617,60
"20047","64259","2014",3,3,0,168333.3,1361,124.6667
"20048","64260","2014",234,38,196,177321.7,2949,64.23504
"20049","64261","2014",3,3,0,147616.7,774.3333,177.6667
"20050","64262","2014",1,1,0,185000,1682,110
"20051","64263","2014",1,1,0,52800,960,55
"20052","64268","2014",2,2,0,175000,1572.5,111
"20053","64269","2014",42,29,13,223133.1,2188.381,105.0238
"20054","64270","2014",6,6,0,167205,1463.333,115.5
"20055","64273","2014",5,5,0,163240,1345.2,119.8
"20056","64274","2014",3,3,0,356400,3023.667,145.3333
"20057","64275","2014",1,0,1,220000,2444,90
"20058","64276","2014",1,1,0,50000,581,86
"20059","64279","2014",7,6,1,283014.3,2550,100.7143
"20060","64280","2014",5,5,0,114300,940.2,166
"20061","64281","2014",1,1,0,52900,529,100
"20062","64282","2014",4,4,0,517422,3420.75,142.5
"20063","64284","2014",60,43,17,160811.4,1838.517,89.83333
"20064","64286","2014",2,2,0,190000,1900,103
"20065","64288","2014",3,3,0,212245,1955.667,110
"20066","64289","2014",6,6,0,273500,1895.833,132
"20067","64290","2014",2,2,0,210650,1965,107.5
"20068","64291","2014",1,1,0,123500,980,126
"20069","64292","2014",3,3,0,224566.7,1638.333,118
"20070","64293","2014",1,1,0,66000,688,96
"20071","64295","2014",1,1,0,70000,660,106
"20072","64297","2014",1,1,0,65000,670,97
"20073","64298","2014",1,1,0,76000,809,94
"20074","64299","2014",1,1,0,209200,910,230
"20075","64300","2014",1,1,0,140000,1373,102
"20076","64301","2014",8,8,0,131750,1319.25,103.5
"20077","64302","2014",5,5,0,166700,1554.6,111.2
"20078","64304","2014",11,4,7,186045.5,2701.545,68.45455
"20079","64305","2014",6,6,0,118786.7,1266.333,99.33333
"20080","64306","2014",2,2,0,101000,1508,69.5
"20081","64307","2014",3,3,0,124333.3,1123,125.3333
"20082","64308","2014",1,1,0,177500,1972,90
"20083","64309","2014",1,1,0,80000,1270,63
"20084","64310","2014",5,5,0,95078,1064,94.4
"20085","64311","2014",1,1,0,120000,1579,76
"20086","64312","2014",1,1,0,271000,1795,151
"20087","64313","2014",1,1,0,1e+05,714,140
"20088","64314","2014",2,2,0,157500,1591.5,110
"20089","64315","2014",9,9,0,249317.8,2538.111,109.5556
"20090","64316","2014",2,2,0,67000,1109,54
"20091","64317","2014",12,8,4,210472,2293.167,99.66667
"20092","64318","2014",1,1,0,95600,1138,84
"20093","64319","2014",1,1,0,149000,968,154
"20094","64320","2014",27,10,17,102521.3,1630.037,72.55556
"20095","64322","2014",1,1,0,159400,1107,144
"20096","64324","2014",12,12,0,196950,1598.167,119.4167
"20097","64325","2014",2,2,0,225500,2222,102
"20098","64328","2014",7,7,0,155119,1566.857,103.5714
"20099","64329","2014",6,5,1,276800,2130.667,127
"20100","64330","2014",3,3,0,119666.7,1281.333,91.33333
"20101","64331","2014",4,4,0,98437.5,830.5,125
"20102","64334","2014",2,2,0,260000,1333,195
"20103","64335","2014",73,61,12,227726.8,2081.315,112.0959
"20104","64336","2014",4,4,0,103750,1857.25,54
"20105","64338","2014",1,1,0,173000,1407,123
"20106","64339","2014",6,4,2,97716.67,1092.833,93.5
"20107","64341","2014",1,1,0,284000,1420,200
"20108","64342","2014",1,1,0,130000,1000,130
"20109","64343","2014",3,3,0,183000,1435.667,161.6667
"20110","64345","2014",2,2,0,95000,989,95
"20111","64347","2014",2,2,0,233345,1636.5,143
"20112","64348","2014",102,55,47,185592.3,2011.363,92.87255
"20113","64349","2014",4,4,0,202625,1605.75,145.75
"20114","64350","2014",5,2,3,194200,2409.8,80.8
"20115","64351","2014",1,1,0,50000,417,120
"20116","64352","2014",5,5,0,207768,1766.8,117.4
"20117","64353","2014",8,5,3,122875,1649,77.25
"20118","64355","2014",1,1,0,197000,1563,126
"20119","64356","2014",1,1,0,82000,804,102
"20120","64359","2014",3,3,0,176666.7,1447,123.6667
"20121","64360","2014",2,2,0,207800,2089.5,134
"20122","64362","2014",1,1,0,216000,1964,110
"20123","64364","2014",2,2,0,263000,1660,158.5
"20124","64365","2014",1,1,0,455200,1929,236
"20125","64366","2014",1,1,0,138000,914,151
"20126","64367","2014",3,1,2,89000,975,84.66667
"20127","64368","2014",3,3,0,143333.3,1286.333,135.6667
"20128","64369","2014",2,2,0,151000,1529.5,129
"20129","64370","2014",5,5,0,168356,1603.6,109.8
"20130","64371","2014",29,23,6,99016.21,1065.828,95.51724
"20131","64372","2014",1,1,0,177000,983,180
"20132","64373","2014",11,11,0,194458.2,1820.364,107.5455
"20133","64374","2014",4,4,0,196875,1881,110.25
"20134","64375","2014",1,1,0,78299,791,99
"20135","64376","2014",2,2,0,97250,1144,85
"20136","64377","2014",1,1,0,240000,1420,169
"20137","64378","2014",1,1,0,162000,1688,96
"20138","64379","2014",1,1,0,160000,2105,76
"20139","64380","2014",1,1,0,118400,1518,78
"20140","64381","2014",3,3,0,100333.3,911.3333,133.3333
"20141","64382","2014",1,1,0,253000,1807,140
"20142","64385","2014",3,3,0,109066.7,1015,103
"20143","64386","2014",13,13,0,194298.3,1686.538,117.8462
"20144","64388","2014",1,1,0,192368,1718,112
"20145","64391","2014",2,2,0,139085,2348.5,79.5
"20146","64393","2014",29,26,3,163870,1463.621,114.4828
"20147","64395","2014",2,2,0,240000,1384,193.5
"20148","64396","2014",6,6,0,142466.7,1324.833,112.8333
"20149","64397","2014",2,2,0,107835,1035.5,102
"20150","64398","2014",3,3,0,170216.7,1388,123
"20151","64399","2014",13,11,2,240188.1,1969.538,119.6154
"20152","64400","2014",3,3,0,143336.7,1771.333,82.66667
"20153","64401","2014",3,3,0,127866.7,1039.667,130
"20154","64404","2014",1,1,0,160000,1429,112
"20155","64405","2014",23,17,6,168172.4,1536.957,110.8261
"20156","64406","2014",6,6,0,146666.7,1593.833,91.66667
"20157","64407","2014",27,16,11,212930.6,2623.296,88.44444
"20158","64409","2014",8,8,0,162931.2,1226.375,141.5
"20159","64410","2014",38,11,27,79125.79,1028.658,74.76316
"20160","64411","2014",2,2,0,115000,1912.5,70
"20161","64412","2014",1,1,0,110000,1375,80
"20162","64413","2014",3,2,1,200033.3,1702.333,114.3333
"20163","64414","2014",1,1,0,40000,1250,32
"20164","64415","2014",14,14,0,227405.3,1871.857,136.9286
"20165","64416","2014",7,7,0,116000,1176.429,99.14286
"20166","64417","2014",28,19,9,157689.6,1532.571,104.5357
"20167","64419","2014",11,10,1,214140.9,2011.909,109.2727
"20168","64420","2014",1,1,0,120000,1333,90
"20169","64421","2014",3,3,0,196450,1613,120.3333
"20170","64422","2014",89,50,39,103416.3,1283.202,87.10112
"20171","64423","2014",1,1,0,87500,1029,85
"20172","64424","2014",2,2,0,129000,1424,100
"20173","64425","2014",1,1,0,75000,938,80
"20174","64426","2014",1,1,0,158000,1699,93
"20175","64430","2014",99,69,30,133231.8,1457.222,91.60606
"20176","64431","2014",3,3,0,111000,1039.667,108.3333
"20177","64433","2014",3,3,0,92750,1390.333,98.33333
"20178","64435","2014",1,1,0,52500,795,66
"20179","64436","2014",2,2,0,239757.5,2029,118.5
"20180","64437","2014",1,1,0,142000,1203,118
"20181","64438","2014",3,3,0,248363.3,1862.667,136.6667
"20182","64439","2014",22,22,0,225628.2,1862.727,125.0909
"20183","64440","2014",1,1,0,140000,1795,78
"20184","64441","2014",1,1,0,135000,1055,128
"20185","64443","2014",7,6,1,145742.9,1110.429,143
"20186","64444","2014",2,2,0,135000,825.5,164.5
"20187","64445","2014",1177,193,984,119501.1,1714.033,69.94138
"20188","64448","2014",9,9,0,222711,2326.667,96.77778
"20189","64449","2014",1,1,0,82000,1171,70
"20190","64450","2014",1,1,0,211400,1747,121
"20191","64451","2014",3,3,0,140166.7,1133.333,126.6667
"20192","64453","2014",22,19,3,139192.7,1420.091,98.86364
"20193","64454","2014",1,1,0,223000,1858,120
"20194","64455","2014",1,1,0,143200,1989,72
"20195","64456","2014",1,1,0,214000,2140,100
"20196","64457","2014",1,1,0,82000,536,153
"20197","64460","2014",2,2,0,128000,1209,106.5
"20198","64461","2014",6,6,0,101666.7,1293.167,82
"20199","64462","2014",2,2,0,146500,1762,82.5
"20200","64463","2014",3,3,0,175811.7,1547.667,122.6667
"20201","64467","2014",3,3,0,263000,1429.667,191.3333
"20202","64470","2014",1,1,0,141000,881,160
"20203","64471","2014",5,5,0,124878.4,1084.2,114.6
"20204","64472","2014",3,3,0,213833.3,2019.667,105.3333
"20205","64473","2014",1,1,0,128000,853,150
"20206","64474","2014",1,1,0,47600,780,61
"20207","64475","2014",1,1,0,47880,365,131
"20208","64476","2014",1,1,0,110000,917,120
"20209","64477","2014",4,4,0,156250,1765.25,93.5
"20210","64478","2014",3,3,0,243160,1925.333,132.3333
"20211","64479","2014",1,1,0,208000,2080,100
"20212","64481","2014",2,1,1,240000,1494,194
"20213","64482","2014",2,2,0,169310,1716,100.5
"20214","64483","2014",235,34,201,296017.1,4526.847,65.31915
"20215","64484","2014",2,2,0,220750,1666.5,130
"20216","64485","2014",10,8,2,203629.7,1835.8,114.5
"20217","64486","2014",1,1,0,159400,886,180
"20218","64488","2014",1,1,0,221300,1941,114
"20219","64489","2014",2,2,0,2e+05,1575.5,127
"20220","64490","2014",1,1,0,98000,1167,84
"20221","64492","2014",1,1,0,168000,1388,121
"20222","64493","2014",13,8,5,154011.5,1722.385,94.92308
"20223","64495","2014",54,28,26,235230.7,2471.889,95.11111
"20224","64496","2014",44,18,26,212460.9,2568.318,84.15909
"20225","64498","2014",1,1,0,332500,2771,120
"20226","64499","2014",54,39,15,144670.8,1579.963,95.51852
"20227","64500","2014",1,1,0,50000,521,96
"20228","64501","2014",7,7,0,147783.6,1343.857,112.5714
"20229","64502","2014",2,2,0,194000,1443,123
"20230","64504","2014",6,5,1,371227.8,2575.333,151.5
"20231","64505","2014",5,5,0,113900,1717.4,65
"20232","64508","2014",1,1,0,62800,541,116
"20233","64509","2014",4,3,1,88700,1045.75,87.25
"20234","64510","2014",7,7,0,110285.7,1335.143,85
"20235","64511","2014",27,27,0,247078.9,2164.889,118.4074
"20236","64512","2014",1,1,0,220000,1606,137
"20237","64513","2014",2,2,0,146800,1756,84
"20238","64514","2014",2,2,0,75750,1829.5,41.5
"20239","64515","2014",1,1,0,228500,1799,127
"20240","64516","2014",5,5,0,199840,1862.2,112.4
"20241","64518","2014",3,3,0,348523.3,2457.667,141.6667
"20242","64519","2014",29,24,5,244819.9,2165.724,114.8276
"20243","64520","2014",5,5,0,363484,2519.6,149.2
"20244","64521","2014",1,0,1,116000,1365,85
"20245","64522","2014",4,2,2,104655,1482,65.75
"20246","64524","2014",2,2,0,132500,960,128.5
"20247","64525","2014",4,4,0,169012.5,1817,95
"20248","64526","2014",9,8,1,189388.9,1745,110.5556
"20249","64527","2014",3,3,0,338133.3,3198,106.3333
"20250","64528","2014",2,2,0,179000,1582,119.5
"20251","64529","2014",2,2,0,183148,1421.5,127.5
"20252","64530","2014",1,1,0,154256,1543,100
"20253","64533","2014",4,4,0,136250,1094.5,119.25
"20254","64534","2014",1,1,0,65000,812,80
"20255","64535","2014",2,2,0,201585,2194,94.5
"20256","64536","2014",9,9,0,162055.6,1289.778,135.7778
"20257","64537","2014",1,1,0,80000,571,140
"20258","64538","2014",8,4,4,127625,1760.125,89.25
"20259","64539","2014",1,1,0,82000,872,94
"20260","64540","2014",9,9,0,259416.7,2481,106.4444
"20261","64542","2014",1,1,0,92750,1427,65
"20262","64544","2014",1,1,0,240000,1455,165
"20263","64545","2014",95,41,54,292341,3379.042,86.97895
"20264","64546","2014",16,15,1,193584.1,2253.938,86.1875
"20265","64547","2014",70,27,43,194238.3,2413.543,82.14286
"20266","64548","2014",1,1,0,175300,1789,98
"20267","64549","2014",8,8,0,180398.8,1521.875,125.5
"20268","64550","2014",2,2,0,257650,1997.5,145.5
"20269","64551","2014",1,1,0,161650,1666,97
"20270","64554","2014",1,1,0,256800,2140,120
"20271","64555","2014",2,2,0,130000,752,171
"20272","64556","2014",1,1,0,82400,1099,75
"20273","64557","2014",3,3,0,162116.7,1508.333,106
"20274","64558","2014",26,10,16,216981.3,2150.538,100.7692
"20275","64559","2014",4,4,0,130400,1085.5,122.75
"20276","64560","2014",2,2,0,167435,1940.5,86
"20277","65001","2014",3,2,1,81300,1104,91
"20278","65002","2014",5,2,3,103480,1018.2,110.8
"20279","65004","2014",3,3,0,283333.3,2618,106
"20280","65005","2014",2,2,0,169500,2071,86.5
"20281","65006","2014",2,2,0,203500,2220.5,92.5
"20282","65007","2014",1,1,0,145000,1043,139
"20283","65009","2014",2,2,0,92500,1041,89
"20284","65010","2014",2,2,0,186590,1154,162
"20285","65014","2014",2,2,0,51000,1097.5,65.5
"20286","65016","2014",2,2,0,70655,721.5,97.5
"20287","65017","2014",22,2,20,72293.86,1814.545,39.54545
"20288","65018","2014",4,4,0,69800,958.25,79
"20289","65019","2014",2,2,0,155750,1362,110
"20290","65020","2014",1,1,0,101000,1031,98
"20291","65021","2014",2,2,0,179150.5,1576,101.5
"20292","65024","2014",1,1,0,185000,1762,105
"20293","65025","2014",30,10,20,120408.2,1681.133,74.6
"20294","65026","2014",1,1,0,1e+05,971,103
"20295","65028","2014",1,1,0,41000,456,90
"20296","65029","2014",4,4,0,235500,2020,123
"20297","65031","2014",11,7,4,117430.9,1526.182,79.81818
"20298","65032","2014",11,9,2,160113.8,1930.273,83.72727
"20299","65033","2014",2,2,0,134000,1295.5,107
"20300","65034","2014",2,2,0,87500,1116.5,61.5
"20301","65035","2014",3,3,0,159666.7,1588.667,99.33333
"20302","65036","2014",1,1,0,102000,1020,100
"20303","65040","2014",1,1,0,143000,1625,88
"20304","65042","2014",7,6,1,172746.4,1865.571,110.4286
"20305","65043","2014",1,1,0,220620,1226,180
"20306","65044","2014",2,2,0,1e+05,1021,108
"20307","65045","2014",3,2,1,164666.7,1745,101
"20308","65046","2014",1,1,0,140000,1273,110
"20309","65047","2014",62,55,7,140709.4,1494.29,96.37097
"20310","65048","2014",3,3,0,191666.7,1824,115.6667
"20311","65049","2014",2,2,0,174000,2122.5,87
"20312","65050","2014",1,1,0,221300,3161,70
"20313","65051","2014",2,2,0,94500,1077.5,100
"20314","65052","2014",1,1,0,212000,1683,126
"20315","65054","2014",3,3,0,110333.3,1117.667,100.6667
"20316","65055","2014",1,1,0,240000,2791,86
"20317","65056","2014",1,1,0,228000,2533,90
"20318","65057","2014",2,2,0,167442,1794,96
"20319","65058","2014",1,1,0,15000,429,35
"20320","65059","2014",126,35,91,74337.74,1447.167,53.97619
"20321","65062","2014",12,12,0,145293.3,1480.583,101
"20322","65064","2014",1,1,0,140750,1315,107
"20323","65068","2014",1,1,0,125000,833,150
"20324","65069","2014",14,14,0,163107.1,1383.214,125.7143
"20325","65070","2014",2,2,0,174650,1487,118.5
"20326","65072","2014",7,7,0,158271.4,1428.286,124.2857
"20327","65073","2014",3,3,0,140000,1306.667,107.6667
"20328","65074","2014",1,1,0,281000,2810,100
"20329","65076","2014",2,2,0,167500,1142.5,154.5
"20330","65077","2014",2,2,0,202000,2733.5,74
"20331","65078","2014",3,3,0,145333.3,1380.333,105.6667
"20332","65080","2014",3,3,0,149666.7,893.6667,188
"20333","65081","2014",3,3,0,145395,1601,94
"20334","65082","2014",1,1,0,338530,1628,208
"20335","65083","2014",3,3,0,224333.3,1743,129.3333
"20336","65084","2014",3,3,0,153320,1657.667,111.6667
"20337","65085","2014",1,1,0,173160,1767,98
"20338","65087","2014",1,1,0,80000,1096,73
"20339","65089","2014",2,2,0,119670,1499.5,80
"20340","65092","2014",3,3,0,110288.7,1589,63.66667
"20341","65093","2014",1,1,0,135000,1588,85
"20342","65094","2014",2,1,1,69035,1136.5,78
"20343","65095","2014",2,2,0,84000,813,95
"20344","65096","2014",1,1,0,180000,2571,70
"20345","65098","2014",1,1,0,306000,1719,178
"20346","65099","2014",5,4,1,108376,1514.2,73.2
"20347","65100","2014",39,38,1,147341.5,1612.846,93.46154
"20348","65101","2014",6,6,0,123416.7,1193.667,103
"20349","65102","2014",1,1,0,127000,814,156
"20350","65105","2014",2,2,0,110000,1139,100
"20351","65106","2014",5,4,1,207800,2080,95.6
"20352","65108","2014",5,5,0,163400,1584.6,110
"20353","65110","2014",1,1,0,135000,458,295
"20354","65111","2014",2,2,0,82500,1231.5,65.5
"20355","65114","2014",1,1,0,1e+05,1389,72
"20356","65115","2014",3,3,0,174603.3,1328,130.3333
"20357","65116","2014",4,4,0,148500,1982.25,75.75
"20358","65117","2014",1,1,0,60000,1000,60
"20359","65119","2014",2,2,0,198275,1528,130
"20360","65120","2014",3,3,0,84800,1115.333,77.33333
"20361","65121","2014",2,2,0,174000,1644.5,109
"20362","65123","2014",13,10,3,129856.9,1794.846,77.76923
"20363","65125","2014",1,1,0,133000,665,200
"20364","65126","2014",1,1,0,128680,1159,111
"20365","65127","2014",16,11,5,92833.5,1350.125,72
"20366","65128","2014",1,1,0,118000,868,136
"20367","65129","2014",7,7,0,112600,1005.429,125.1429
"20368","65130","2014",4,3,1,89150,903.25,105
"20369","65131","2014",3,3,0,214283.3,1623.667,136.3333
"20370","65133","2014",1,1,0,176000,1100,160
"20371","65138","2014",87,9,78,100425.5,2502.448,41.48276
"20372","65141","2014",1,1,0,125000,1923,65
"20373","65142","2014",1,1,0,169000,1408,120
"20374","65144","2014",1,1,0,147000,2262,65
"20375","65146","2014",1,1,0,284140,1596,178
"20376","65148","2014",1,1,0,140000,1443,97
"20377","65149","2014",1,1,0,115500,1283,90
"20378","65150","2014",2,2,0,124500,1307.5,95
"20379","65153","2014",1,1,0,147000,865,170
"20380","65156","2014",2,2,0,113750,1126,101
"20381","65158","2014",1,1,0,24000,429,56
"20382","65159","2014",4,4,0,120400,1277.75,99.5
"20383","65161","2014",3,3,0,159376.7,1404.333,117.6667
"20384","65162","2014",1,1,0,62000,1170,53
"20385","65163","2014",1,1,0,50000,455,110
"20386","65165","2014",3,3,0,137600,883.3333,173
"20387","65166","2014",2,2,0,152750,1805.5,87.5
"20388","65168","2014",12,1,11,86173.42,2533.417,33.5
"20389","65170","2014",1,1,0,309000,1282,241
"20390","65171","2014",1,1,0,84700,706,120
"20391","65173","2014",3,3,0,190495,2163,107.3333
"20392","65175","2014",3,3,0,134186.7,3034.667,56.33333
"20393","65176","2014",5,5,0,121552,1021.4,118.8
"20394","65178","2014",1,1,0,105000,1094,96
"20395","65180","2014",1,1,0,206000,2146,96
"20396","65182","2014",3,3,0,221666.7,2034,113.6667
"20397","65183","2014",6,4,2,115825,895.6667,127
"20398","65185","2014",2,2,0,166500,1613,103.5
"20399","65186","2014",1,1,0,53000,616,86
"20400","65187","2014",2,2,0,142500,1419.5,108.5
"20401","65189","2014",1,1,0,75000,938,80
"20402","65190","2014",1,1,0,120000,1111,108
"20403","65191","2014",2,2,0,52500,837.5,66.5
"20404","65192","2014",8,5,3,89519.38,1598.375,62.875
"20405","65195","2014",3,3,0,240123.3,3298.667,77
"20406","65197","2014",1,1,0,147300,1534,96
"20407","65198","2014",5,5,0,161604.6,1239.4,122.6
"20408","65199","2014",11,0,11,126830,2602.818,47
"20409","65202","2014",4,1,3,135000,1499,88.75
"20410","65203","2014",1,1,0,133000,1662,80
"20411","65205","2014",1,1,0,210000,2100,100
"20412","65206","2014",1,1,0,117000,1481,79
"20413","65208","2014",2,2,0,161335,1696.5,92.5
"20414","65209","2014",1,1,0,450000,2250,200
"20415","65211","2014",5,4,1,185004,2160,86
"20416","65212","2014",8,2,6,101643.8,2268.25,50.625
"20417","65216","2014",1,1,0,120000,1791,67
"20418","65218","2014",10,9,1,99303,1183.5,106.2
"20419","65219","2014",1,1,0,251000,1111,226
"20420","65221","2014",4,4,0,206150,1454.75,143.75
"20421","65222","2014",1,1,0,149000,1242,120
"20422","65223","2014",6,6,0,223810,1983.333,115.6667
"20423","65224","2014",3,3,0,99800,1523.333,66
"20424","65226","2014",10,10,0,160075,1567.4,102.7
"20425","65230","2014",2,2,0,97500,1582,70
"20426","65231","2014",1,1,0,150000,1181,127
"20427","65232","2014",2,2,0,185800,1517,127.5
"20428","65233","2014",1,1,0,120885,1051,115
"20429","65234","2014",2,2,0,102000,1208.5,84
"20430","65235","2014",26,26,0,186425.2,1801.154,103.4615
"20431","65236","2014",1,1,0,135000,1406,96
"20432","65237","2014",1,1,0,154000,1375,112
"20433","65239","2014",1,1,0,222500,2225,100
"20434","65240","2014",4,4,0,126257.5,1381.5,90.25
"20435","65242","2014",3,3,0,161100,1087.667,154.6667
"20436","65243","2014",2,2,0,133000,1282,117.5
"20437","65244","2014",3,3,0,65000,822,80.33333
"20438","65245","2014",2,2,0,91000,1508.5,65.5
"20439","65247","2014",2,2,0,184615,1400.5,144
"20440","65248","2014",1,1,0,1e+05,1250,80
"20441","65249","2014",1,1,0,85000,654,130
"20442","65251","2014",16,16,0,143987.5,1468.875,101.8125
"20443","65252","2014",3,3,0,130333.3,1175,113.3333
"20444","65258","2014",51,30,21,79728.9,919.098,88.80392
"20445","65259","2014",2,2,0,194935,1368,146.5
"20446","65262","2014",1,1,0,92500,746,124
"20447","65264","2014",4,4,0,149500,1626,121.25
"20448","65265","2014",1,1,0,54000,761,71
"20449","65266","2014",1,1,0,94000,553,170
"20450","65267","2014",2,2,0,162250,1596.5,95.5
"20451","65268","2014",1,1,0,205000,1881,109
"20452","65270","2014",2,2,0,249500,1353.5,184
"20453","65271","2014",2,2,0,144550,1540.5,123.5
"20454","65272","2014",1,1,0,132000,1245,106
"20455","65275","2014",1,1,0,160842,2145,75
"20456","65276","2014",1,1,0,110000,1774,62
"20457","65278","2014",1,1,0,162000,2945,55
"20458","65280","2014",3,3,0,215166.7,1768,131.6667
"20459","65281","2014",2,2,0,237000,1896,125
"20460","65282","2014",14,6,8,151911.3,3113.643,55.5
"20461","65283","2014",2,2,0,122845.5,1849,66
"20462","65284","2014",8,8,0,170536.1,1614,107.625
"20463","65285","2014",1,1,0,247750,1361,182
"20464","65286","2014",148,48,100,103763.7,1330.777,79.27027
"20465","65287","2014",4,4,0,89510,1078.5,83.75
"20466","65289","2014",1,1,0,54200,571,95
"20467","65293","2014",1,1,0,127000,841,151
"20468","65294","2014",6,6,0,128166.7,1591,90.66667
"20469","65295","2014",23,8,15,115349,2104.478,56.52174
"20470","65296","2014",2,2,0,122000,2111,57.5
"20471","65301","2014",2,2,0,106000,1199.5,89
"20472","65303","2014",2,2,0,149050,1372,109.5
"20473","65304","2014",27,26,1,102733.3,1172.926,94.11111
"20474","65305","2014",4,4,0,94000,860.75,106
"20475","65306","2014",2,2,0,113900,1288,85.5
"20476","65307","2014",3,3,0,160333.3,831.3333,183.3333
"20477","65313","2014",4,4,0,210500,2124,103.25
"20478","65314","2014",1,1,0,30000,400,75
"20479","65315","2014",2,2,0,69500,630,100
"20480","65318","2014",1,1,0,179000,1627,110
"20481","65319","2014",1,1,0,540000,5510,98
"20482","65320","2014",2,2,0,67500,1023.5,106
"20483","65322","2014",2,2,0,124750,1056,117.5
"20484","65323","2014",1,1,0,150000,1250,120
"20485","65324","2014",1,1,0,264320,1017,260
"20486","65327","2014",1,1,0,92000,920,100
"20487","65329","2014",3,3,0,109240,1120.667,99
"20488","65331","2014",35,35,0,161445.1,1489.229,112.6857
"20489","65335","2014",1,1,0,217450,2499,87
"20490","65339","2014",3,3,0,182051.3,1438.333,127
"20491","65340","2014",14,14,0,143487.6,1424.429,99.64286
"20492","65342","2014",1,1,0,99500,1244,80
"20493","65343","2014",2,2,0,93500,1223,74
"20494","65344","2014",18,17,1,153089.4,1464.778,109.2778
"20495","65347","2014",1,1,0,50000,806,62
"20496","65348","2014",1,1,0,154000,1085,142
"20497","65349","2014",1,1,0,217000,1447,150
"20498","65350","2014",10,9,1,139700,1436.4,101.6
"20499","65351","2014",3,3,0,121500,912,128
"20500","65353","2014",4,4,0,108422.5,1220.5,87.5
"20501","65360","2014",4,4,0,112500,1121.5,101
"20502","65362","2014",7,2,5,112000,1574.714,74.42857
"20503","65363","2014",1,1,0,68000,791,86
"20504","65366","2014",7,7,0,185319.7,1735.143,109.5714
"20505","65369","2014",2,2,0,145050,1730,83
"20506","65370","2014",10,9,1,122062,1466.2,86.2
"20507","65371","2014",1,1,0,160000,1441,111
"20508","65372","2014",7,7,0,147983.1,1416.857,112.4286
"20509","65373","2014",1,1,0,98000,731,134
"20510","65375","2014",11,10,1,126540.9,1246.909,104.4545
"20511","65376","2014",1,1,0,130000,929,140
"20512","65380","2014",1,1,0,201201,1765,114
"20513","65381","2014",1,1,0,125000,568,220
"20514","65382","2014",1,1,0,95000,1173,81
"20515","65383","2014",2,2,0,267500,1833,147.5
"20516","65387","2014",2,2,0,172000,1186,135
"20517","65388","2014",125,3,122,84398.42,2303.6,36.2
"20518","65389","2014",6,6,0,129616.7,1073.333,120.1667
"20519","65390","2014",3,3,0,123666.7,790.3333,153
"20520","65393","2014",1,1,0,170000,1604,106
"20521","65394","2014",1,1,0,65000,650,100
"20522","65395","2014",9,8,1,118093.3,1051.667,114.5556
"20523","65396","2014",7,3,4,135242.9,1942.286,73.57143
"20524","65397","2014",1,1,0,80000,1013,79
"20525","65398","2014",2,2,0,135350,1288.5,111.5
"20526","65399","2014",3,2,1,125511.7,1767,89.66667
"20527","65401","2014",3,3,0,192711.7,1757,111.6667
"20528","65403","2014",1,1,0,115800,1219,95
"20529","65404","2014",2,2,0,94500,1155,85
"20530","65406","2014",1,1,0,40000,513,78
"20531","65408","2014",7,4,3,96742.86,1249.143,73.85714
"20532","65409","2014",3,3,0,74333.33,1023.667,71.66667
"20533","65410","2014",5,5,0,136200,1361.8,101.4
"20534","65411","2014",1,1,0,287100,1689,170
"20535","65412","2014",2,2,0,170000,1994,109.5
"20536","65413","2014",3,1,2,133760,3084.333,46
"20537","65417","2014",42,35,7,126926.6,1508.857,83.54762
"20538","65418","2014",2,2,0,110000,915,121
"20539","65422","2014",1,1,0,159500,1139,140
"20540","65424","2014",1,1,0,165463,4137,40
"20541","65425","2014",3,3,0,114000,1291.333,86.33333
"20542","65426","2014",1,1,0,90000,938,96
"20543","65427","2014",4,4,0,93250,1343.5,77.75
"20544","65429","2014",2,2,0,165250,1112.5,120
"20545","65430","2014",1,1,0,175100,1144,153
"20546","65432","2014",1,1,0,102000,472,216
"20547","65433","2014",18,12,6,125734.4,1470.444,87.61111
"20548","65435","2014",1,0,1,102000,1855,55
"20549","65436","2014",3,3,0,284400,1308.333,221.6667
"20550","65437","2014",1,1,0,148500,928,160
"20551","65439","2014",1,1,0,70000,1167,60
"20552","65440","2014",499,157,342,96135.5,1300.437,75.67936
"20553","65442","2014",1,1,0,228100,1444,158
"20554","65443","2014",1,1,0,306000,1155,265
"20555","65444","2014",1,1,0,82000,427,192
"20556","65445","2014",5,5,0,152098,1700.4,90.8
"20557","65446","2014",4,4,0,145000,1400.5,104
"20558","65447","2014",8,7,1,119312.5,1366.875,89.125
"20559","65449","2014",2,2,0,83250,1162,70.5
"20560","65451","2014",4,4,0,130750,1368.5,87.5
"20561","65452","2014",6,6,0,115660,998.3333,110.3333
"20562","65453","2014",3,3,0,99666.67,894.3333,116.3333
"20563","65455","2014",6,6,0,137714,1369.667,104.1667
"20564","65456","2014",2,2,0,128710,1345.5,96
"20565","65458","2014",1,1,0,44500,556,80
"20566","65460","2014",30,29,1,116036.5,1278.833,92.6
"20567","65462","2014",2,2,0,155775,1424.5,111
"20568","65463","2014",1,1,0,125000,3571,35
"20569","65465","2014",13,0,13,111266.2,2650.923,42.07692
"20570","65467","2014",1,1,0,67844,1234,55
"20571","65471","2014",3,1,2,140366.7,2991,46.33333
"20572","65473","2014",3,2,1,155438.3,1904.333,87.33333
"20573","65477","2014",1,1,0,104000,800,130
"20574","65478","2014",2,2,0,199230,2434,81
"20575","65479","2014",2,2,0,244100,1623.5,142.5
"20576","65481","2014",20,2,18,71234.25,2093.55,33.95
"20577","65482","2014",2,2,0,143350,939,150.5
"20578","66002","2014",23,20,3,233467.4,2397.304,96.21739
"20579","66003","2014",113,13,100,72938.5,1419.186,49.65487
"20580","66004","2014",89,21,68,86804.26,2257.124,38.69663
"20581","66005","2014",6,5,1,157195,1948.167,85.16667
"20582","66006","2014",1,0,1,90500,1534,59
"20583","66007","2014",1,1,0,170000,1133,150
"20584","66008","2014",280,115,165,160464.7,2988.846,57.34643
"20585","66011","2014",53,51,2,166432.1,1933.717,88.62264
"20586","66012","2014",27,22,5,168418.1,1900.593,90.48148
"20587","66013","2014",1,1,0,125000,1786,70
"20588","66014","2014",24,23,1,117291.7,1480.875,82.41667
"20589","66015","2014",12,10,2,134646.7,1648.417,81.33333
"20590","66016","2014",77,21,56,166207.8,2720.208,63.36364
"20591","66017","2014",347,101,246,103545.5,2584.478,41.17579
"20592","66018","2014",1,1,0,80000,816,98
"20593","66019","2014",1,1,0,146000,2317,63
"20594","66020","2014",63,25,38,132369.5,2482.349,51.96825
"20595","66021","2014",63,60,3,158862.1,1793.73,93.57143
"20596","66022","2014",1,1,0,46500,1292,36
"20597","66023","2014",10,10,0,114700,1301.7,84.4
"20598","66024","2014",63,46,17,159545.5,1869.206,85.26984
"20599","66025","2014",13,5,8,104884.6,1609.615,69.07692
"20600","66026","2014",14,13,1,224321.8,2019.5,107.3571
"20601","66027","2014",13,11,2,183156.1,2096.462,90.30769
"20602","66028","2014",85,76,9,223722.4,2083.071,105.2706
"20603","66029","2014",7,7,0,278571.4,4591.857,75.85714
"20604","66030","2014",3,3,0,170833.3,2126,84.33333
"20605","66033","2014",3,3,0,141243.7,2170.667,59
"20606","66034","2014",5,5,0,111340,1586.8,79
"20607","66037","2014",384,113,271,151155.2,2920.672,52.78125
"20608","66038","2014",47,38,9,184933.2,2106.085,86.53191
"20609","66039","2014",2,2,0,144500,1346,102
"20610","66041","2014",7,7,0,173542.9,1356.714,116.2857
"20611","66042","2014",1,1,0,130000,942,138
"20612","66043","2014",1,1,0,70000,875,80
"20613","66044","2014",6,6,0,196016.7,1965.167,93.66667
"20614","66045","2014",4,4,0,174250,1867.25,85
"20615","66046","2014",7,7,0,88571.43,835.8571,105
"20616","66048","2014",19,4,15,104632.2,2302.737,56.78947
"20617","66049","2014",81,54,27,177545.6,2193,84.09877
"20618","66050","2014",39,38,1,170036.9,1865.128,92.17949
"20619","66051","2014",1,1,0,582525,3641,160
"20620","66052","2014",6,5,1,133083.3,1083,117.1667
"20621","66053","2014",70,19,51,246649.8,4034.014,64.98571
"20622","66054","2014",3,3,0,90916.67,2427.333,53.33333
"20623","66055","2014",7,7,0,125571.4,1372.714,93.42857
"20624","66056","2014",6,6,0,160500,1851.167,88.5
"20625","66057","2014",9,7,2,149777.8,1679.444,88.55556
"20626","66058","2014",22,21,1,152431,1491.227,100.0455
"20627","66059","2014",18,17,1,197250,2224.556,89.33333
"20628","66060","2014",2,2,0,56500,1082.5,51.5
"20629","66061","2014",3,3,0,94000,1024.667,84.33333
"20630","66062","2014",2,1,1,103500,1544.5,74.5
"20631","66063","2014",2,2,0,207500,2182.5,94.5
"20632","66064","2014",1,0,1,475000,4241,112
"20633","66065","2014",92,72,20,144912.6,1814.141,82.3913
"20634","66066","2014",9,3,6,101188.9,1627.778,59.88889
"20635","66067","2014",17,8,9,126274.8,2161.882,66.11765
"20636","66068","2014",1,1,0,153000,1275,120
"20637","66069","2014",42,37,5,139277.7,1772.738,80.35714
"20638","66070","2014",2,2,0,236500,2210.5,112.5
"20639","66072","2014",10,5,5,146817.5,2041,74.1
"20640","66074","2014",3,3,0,93666.67,1592,67.33333
"20641","66075","2014",12,12,0,131366.6,2731.417,53.75
"20642","66076","2014",1,1,0,40000,444,90
"20643","66077","2014",2,2,0,54375,990.5,55
"20644","66078","2014",2,2,0,94000,1731.5,54.5
"20645","66079","2014",4,3,1,170775,1378.75,108.75
"20646","66080","2014",4,4,0,93375,960.75,94
"20647","66081","2014",1,1,0,120000,2791,43
"20648","66082","2014",15,10,5,140943.9,2162.467,73.2
"20649","66083","2014",2,2,0,46500,894.5,48.5
"20650","66084","2014",8,8,0,152537.5,1559,94.375
"20651","66085","2014",5,5,0,102812,1439.8,73.8
"20652","66088","2014",40,34,6,112585.6,1438.7,77.3
"20653","66089","2014",6,6,0,180960.2,1699.167,118.3333
"20654","66092","2014",1,1,0,144000,1385,104
"20655","66093","2014",30,29,1,230222.2,2368.733,97.93333
"20656","66094","2014",20,19,1,212223.8,2310.8,91.55
"20657","66095","2014",7,6,1,101428.6,1199.714,81.28571
"20658","66096","2014",7,5,2,133214.3,1129.143,107.5714
"20659","66097","2014",1,1,0,48750,356,137
"20660","66098","2014",5,3,2,103747.4,2361.4,49.8
"20661","66099","2014",8,8,0,201225,1896.875,103.5
"20662","66100","2014",3,3,0,76666.67,1268.333,57.66667
"20663","66101","2014",16,16,0,184631.2,1973.562,89.75
"20664","66103","2014",9,7,2,89632.22,1105,84.22222
"20665","66104","2014",7,7,0,151685.7,1459.429,100.2857
"20666","66105","2014",7,7,0,127707.1,1843.143,76.28571
"20667","66106","2014",23,18,5,168652.1,1804.696,90.17391
"20668","66107","2014",5,5,0,64000,889.2,72.2
"20669","66108","2014",32,31,1,148131.6,1639.719,87.84375
"20670","66109","2014",4,4,0,98875,1229.75,89.25
"20671","66111","2014",4,4,0,101875,1188,82
"20672","66112","2014",3,3,0,175193.7,2328.667,76
"20673","66113","2014",3,3,0,137000,1751,81
"20674","66114","2014",10,10,0,180035,1716.4,102.4
"20675","66115","2014",15,15,0,320532.4,2549.667,124.3333
"20676","66116","2014",1,1,0,137500,1297,106
"20677","66118","2014",8,8,0,216250,2110.375,97.875
"20678","66119","2014",5,5,0,144970,2790,44.2
"20679","66120","2014",3,2,1,90000,1532.667,58.33333
"20680","66121","2014",12,10,2,141820.8,1521.333,93.91667
"20681","66123","2014",1,1,0,20000,800,25
"20682","66124","2014",88,13,75,107720.2,2087.807,52.32955
"20683","66125","2014",9,9,0,100984.3,1122.778,84.77778
"20684","66126","2014",8,8,0,161062.5,1865.25,75
"20685","66127","2014",8,8,0,201915,1603.5,121.5
"20686","66129","2014",15,14,1,205250,1657.267,123.4667
"20687","66130","2014",26,12,14,139726.7,1600.423,85.26923
"20688","66132","2014",10,4,6,141500,1998.2,71.6
"20689","66133","2014",40,37,3,214245,2278.25,93.475
"20690","66134","2014",15,15,0,161857,1838.467,90.26667
"20691","66136","2014",1332,370,962,119607.6,1606.808,73.83784
"20692","66137","2014",3,1,2,102000,1516.333,53.66667
"20693","66138","2014",14,14,0,139621.4,1579,85.64286
"20694","66140","2014",40,38,2,159899,1927.55,84.325
"20695","66141","2014",68,61,7,167605.1,1806.25,91.92647
"20696","66142","2014",1,0,1,37500,798,47
"20697","66143","2014",1,1,0,75000,938,80
"20698","66144","2014",38,33,5,170149.1,1823.711,92.02632
"20699","66145","2014",30,30,0,186781.7,2061.967,91.83333
"20700","66146","2014",2,1,1,81999.5,1328,60
"20701","66147","2014",8,5,3,84187.5,1275.625,67.75
"20702","66148","2014",59,10,49,158585,2635.729,61.62712
"20703","66149","2014",55,43,12,137757.6,1636.945,87.01818
"20704","66150","2014",18,9,9,97220.28,1780.611,79.22222
"20705","66151","2014",2,2,0,55000,1085,45
"20706","66152","2014",2,2,0,82500,819.5,102.5
"20707","66153","2014",3,3,0,102833.3,1574,59.33333
"20708","66154","2014",10,8,2,99704,2886.5,36
"20709","66155","2014",2,2,0,60500,1257,52
"20710","66158","2014",3,3,0,117166.7,1446.333,75.66667
"20711","66159","2014",3,2,1,145403.3,2332,71
"20712","66160","2014",15,15,0,250022.4,2564.6,108.6667
"20713","66161","2014",12,11,1,140605.1,1650.083,87.16667
"20714","66162","2014",11,11,0,159190.9,1415.182,104.3636
"20715","66164","2014",68,56,12,145992.5,1745,84.38235
"20716","66165","2014",5,5,0,155600,1462.6,104.4
"20717","66166","2014",5,5,0,139000,1468,85.6
"20718","66167","2014",5,4,1,180100,2516.2,75.6
"20719","66168","2014",38,33,5,183612.2,2314.237,82.13158
"20720","66169","2014",2,2,0,145000,2557.5,56
"20721","66171","2014",361,174,187,148401.3,3022.468,52.01108
"20722","66172","2014",114,84,30,173057.6,1993.667,86.82456
"20723","66173","2014",3,3,0,246333.3,2538.333,98
"20724","66174","2014",27,26,1,134227.8,1808.37,73.44444
"20725","66175","2014",31,31,0,254217.6,2425.548,106.8387
"20726","66176","2014",20,20,0,191049.8,2076.6,89.6
"20727","66177","2014",15,15,0,167712.7,1677.6,99.73333
"20728","66178","2014",2,2,0,75000,1028.5,67.5
"20729","66179","2014",17,8,9,64879.41,920.7059,71.70588
"20730","66180","2014",117,97,20,163769.5,1985.282,83.74359
"20731","66181","2014",9,5,4,131394.4,1969.889,65.33333
"20732","66182","2014",97,82,15,148707.3,2700.093,61.20619
"20733","66184","2014",1,1,0,40000,435,92
"20734","66186","2014",23,23,0,193852.2,2057.478,94.91304
"20735","66187","2014",19,16,3,77317.11,1062.316,75.68421
"20736","66188","2014",11,8,3,117862.2,2215.818,53.18182
"20737","66189","2014",50,38,12,177080,1978.06,89.72
"20738","66190","2014",18,16,2,126472.2,1794.333,68.38889
"20739","66191","2014",1,1,0,122000,1906,64
"20740","66192","2014",1,1,0,180000,2118,85
"20741","66193","2014",5,4,1,68020,989,65.8
"20742","66194","2014",5,5,0,153000,1620,91.2
"20743","66195","2014",66,62,4,183701.6,2099.258,87.28788
"20744","66196","2014",41,40,1,193936.6,2524.78,81.04878
"20745","66198","2014",4,3,1,79850,843.5,87.5
"20746","66202","2014",4,0,4,113423.8,2244.25,51
"20747","66203","2014",2,2,0,190050,1721.5,109.5
"20748","66204","2014",5,5,0,135780,1260.8,110.8
"20749","66205","2014",4,4,0,52250,992,49.25
"20750","66206","2014",2,2,0,277500,2138.5,125.5
"20751","66207","2014",7,6,1,129257.1,1831.571,74.71429
"20752","66208","2014",25,22,3,208429,1920.88,111.52
"20753","66209","2014",1,1,0,20000,769,26
"20754","66210","2014",74,68,6,172318.9,1857.014,91
"20755","66211","2014",1,1,0,194800,1020,191
"20756","66212","2014",97,92,5,134962.2,2105.835,64.87629
"20757","66213","2014",67,62,5,187920.9,2006.313,94.14925
"20758","66214","2014",12,12,0,182604.2,1949.75,94.41667
"20759","66215","2014",1,1,0,134000,1576,85
"20760","66217","2014",13,12,1,172067.5,1977,84.92308
"20761","66218","2014",6,3,3,150883.3,2163.167,68.83333
"20762","66219","2014",2,2,0,44500,547.5,79.5
"20763","66221","2014",1,1,0,15000,789,19
"20764","66222","2014",43,25,18,113259.9,1521.302,73.93023
"20765","66223","2014",3,2,1,131000,1317.667,130.3333
"20766","66224","2014",25,21,4,137003.5,1732.12,81.68
"20767","66225","2014",20,20,0,186405,2328.15,85.5
"20768","66226","2014",16,16,0,170623.8,1745.938,97.8125
"20769","66227","2014",33,30,3,273575.8,2422.97,111.4848
"20770","66230","2014",23,21,2,111339.1,1261.043,92.04348
"20771","66231","2014",5,5,0,81680,872.8,105.6
"20772","66233","2014",4,4,0,202750,2420.5,84
"20773","66234","2014",6,4,2,51666.67,739,66.83333
"20774","69001","2014",2,2,0,210850,1615,140
"20775","69002","2014",3,3,0,127000,968.3333,119.3333
"20776","69003","2014",16,13,3,339203.1,2871.75,120.75
"20777","69004","2014",8,4,4,190181.2,1655,113.875
"20778","69005","2014",6,5,1,235377.7,2174.833,109.5
"20779","69006","2014",35,27,8,96636.97,1168.657,83.31429
"20780","69007","2014",19,11,8,170600,2089.526,85.52632
"20781","69008","2014",4,4,0,196565,1919.25,102.75
"20782","69009","2014",62,39,23,216102.2,2436.371,89.06452
"20783","69010","2014",55,22,33,173238.9,2358.236,76.10909
"20784","69012","2014",3,3,0,172750,1673.667,108.6667
"20785","69013","2014",42,22,20,208475.7,2124.238,98.02381
"20786","69014","2014",6,6,0,131200,1442.5,90.5
"20787","69017","2014",5,4,1,302946,2085.2,143.8
"20788","69018","2014",24,14,10,98583.96,1231.25,83.25
"20789","69019","2014",110,73,37,170374,1946.4,90.19091
"20790","69020","2014",6,5,1,290004.2,2269.333,129
"20791","69021","2014",22,18,4,198938.2,1802.045,113.4091
"20792","69022","2014",3,3,0,206660,1948.333,124.3333
"20793","69023","2014",14,11,3,208146.9,1925.571,106.6429
"20794","69024","2014",42,36,6,238769.2,2280.571,104.7857
"20795","69026","2014",6,6,0,222886.7,2452.667,90
"20796","69027","2014",89,43,46,232789.3,2743.124,84.73034
"20797","69028","2014",36,27,9,308134.4,3006.389,104.3611
"20798","69029","2014",335,57,278,194060.6,2545.478,75.14925
"20799","69030","2014",12,8,4,117575.8,1266.5,92.41667
"20800","69031","2014",10,9,1,144500,1455.6,99.1
"20801","69032","2014",14,10,4,181856.4,2155.429,83.5
"20802","69033","2014",27,23,4,302711.3,3226.111,94.25926
"20803","69034","2014",543,69,474,254263.2,3171.849,78.09945
"20804","69035","2014",1,1,0,173000,1680,103
"20805","69036","2014",10,10,0,207500,1774.3,117.9
"20806","69037","2014",7,7,0,145328.6,1291.429,120
"20807","69038","2014",4,4,0,72061.25,852,88.75
"20808","69039","2014",10,10,0,161560,1338.6,119.7
"20809","69040","2014",56,23,33,308850,3229.393,92.57143
"20810","69042","2014",8,8,0,231338.8,2243,109.5
"20811","69043","2014",55,36,19,318566.5,3137.673,101.3091
"20812","69044","2014",45,28,17,484065.6,3672.044,130.7778
"20813","69045","2014",6,6,0,205083.3,1841.667,111.6667
"20814","69046","2014",37,30,7,311514.3,2798.432,112.2432
"20815","69047","2014",9,8,1,449277.8,2900.333,155.6667
"20816","69049","2014",24,19,5,338796.8,3060.292,114.7083
"20817","69050","2014",11,9,2,268973.2,2503.636,108.2727
"20818","69051","2014",6,6,0,250808.3,2172.667,115.5
"20819","69052","2014",39,31,8,279695.6,2903.564,96.15385
"20820","69053","2014",4,4,0,154021,1546,100.5
"20821","69054","2014",9,9,0,125761.1,1471.444,86.11111
"20822","69055","2014",17,11,6,208631.8,2618.765,79.35294
"20823","69056","2014",30,22,8,218990.1,2170.067,104.7
"20824","69057","2014",5,5,0,223794,2283.6,98.2
"20825","69058","2014",3,3,0,110833.3,1227,92.66667
"20826","69059","2014",8,5,3,260270,3015.125,89
"20827","69060","2014",1,0,1,110000,1375,80
"20828","69061","2014",11,8,3,268647.3,2307,116.3636
"20829","69062","2014",1,1,0,194400,2068,94
"20830","69063","2014",58,30,28,415716.7,3317.586,124.5172
"20831","69064","2014",30,23,7,168830.6,1792.4,103.6
"20832","69065","2014",6,6,0,255050,2140.333,115.5
"20833","69066","2014",34,33,1,102041.2,1126.088,93.26471
"20834","69067","2014",9,7,2,128627.8,1644.444,94.66667
"20835","69068","2014",27,18,9,245804.8,2813.593,87.7037
"20836","69069","2014",103,46,57,271319.6,3100.194,87.62136
"20837","69070","2014",18,16,2,115216.7,1224.056,99.61111
"20838","69071","2014",6,4,2,299966.7,2704.833,112.3333
"20839","69072","2014",92,58,34,360090.8,3368.065,104
"20840","69074","2014",11,6,5,225383.6,2197.455,102.1818
"20841","69075","2014",3,3,0,197500,1737.333,115.3333
"20842","69076","2014",24,20,4,371164.9,3093.667,119.7083
"20843","69077","2014",6,6,0,203116.7,1775.333,118.3333
"20844","69078","2014",2,2,0,160550,1460.5,111.5
"20845","69080","2014",11,9,2,236880,2090.636,113.9091
"20846","69081","2014",160,44,116,339610.7,3306.256,97.23125
"20847","69082","2014",3,3,0,139150,1599,86.33333
"20848","69083","2014",10,10,0,304684,2896.4,109.1
"20849","69084","2014",20,18,2,171232.5,1878.75,100.15
"20850","69085","2014",22,17,5,270311.4,2968.545,99.09091
"20851","69086","2014",32,22,10,228168,2442,94.125
"20852","69087","2014",9,7,2,366400.6,2948,122.4444
"20853","69088","2014",87,19,68,234982.6,2827.276,81.18391
"20854","69089","2014",142,56,86,276127.4,3007.042,91.28169
"20855","69090","2014",6,6,0,278236.7,2391.667,119.3333
"20856","69091","2014",106,57,49,142663.1,1750.123,83.78302
"20857","69092","2014",65,45,20,230264.4,2367.908,98.78462
"20858","69093","2014",15,12,3,100434.7,1228.133,85.33333
"20859","69094","2014",42,21,21,282726.9,2895.857,99.92857
"20860","69095","2014",5,5,0,141000,1600.6,89
"20861","69096","2014",104,51,53,168894.4,2062.067,81.99038
"20862","69097","2014",1,1,0,232000,2698,86
"20863","69098","2014",7,7,0,219507.1,2328,113.2857
"20864","69099","2014",10,9,1,149345,1476.7,103.8
"20865","69100","2014",62,26,36,227959.4,2417.177,93.91935
"20866","69102","2014",9,9,0,115200,1295.222,90.88889
"20867","69103","2014",4,4,0,168762.5,1686.75,97.25
"20868","69104","2014",2,2,0,212659,1420,152.5
"20869","69105","2014",7,7,0,298717.9,2461.286,127.8571
"20870","69106","2014",17,15,2,332623.2,2788.588,122.0588
"20871","69107","2014",8,8,0,169151.2,1501.25,141.875
"20872","69108","2014",9,9,0,151366.7,1883.556,81.22222
"20873","69109","2014",9,9,0,166433.3,1761.667,95.33333
"20874","69110","2014",18,17,1,158286.1,1488,108.1667
"20875","69111","2014",7,4,3,291725,2018.286,153.2857
"20876","69112","2014",44,35,9,322574.4,2735.864,122.5227
"20877","69113","2014",8,8,0,150968.8,1482.625,99.5
"20878","69115","2014",60,33,27,189053.8,2156.7,86.66667
"20879","69116","2014",35,15,20,393599.5,3970.829,105.8571
"20880","69117","2014",37,31,6,343669.2,2940.838,119.027
"20881","69118","2014",13,12,1,190057.7,2166.462,89.30769
"20882","69119","2014",7,7,0,126764.3,1999.286,59.57143
"20883","69120","2014",5,5,0,165950,1546,100.4
"20884","69121","2014",26,14,12,218107.7,2746.423,80.88462
"20885","69122","2014",20,16,4,298551.7,2458.5,126.45
"20886","69123","2014",6215,143,6072,221923.3,3352.735,66.78681
"20887","69124","2014",3,3,0,143333.3,1579.333,90.66667
"20888","69125","2014",5,4,1,390700,2542.6,149.2
"20889","69126","2014",9,9,0,331219.3,2890.667,110.2222
"20890","69127","2014",25,19,6,390777.6,3428.2,109.4
"20891","69130","2014",2,2,0,38500,820.5,64
"20892","69131","2014",20,14,6,285025.5,2721.35,104.8
"20893","69132","2014",6,6,0,154000,1756.167,87
"20894","69133","2014",48,29,19,286263,2758.167,104.625
"20895","69135","2014",20,17,3,94944.25,996.15,96.5
"20896","69136","2014",16,12,4,244326.2,2669,93.125
"20897","69137","2014",1,1,0,170000,1932,88
"20898","69138","2014",5,5,0,153780,1755.8,99.2
"20899","69139","2014",9,9,0,179905.6,1873,101
"20900","69140","2014",15,13,2,328842,3012.2,116.2667
"20901","69141","2014",52,34,18,268175.5,2807.096,95.03846
"20902","69142","2014",77,4,73,149769,2216.481,69.72727
"20903","69143","2014",70,26,44,221189.4,2631.857,84.81429
"20904","69145","2014",3,3,0,125000,1686,88.66667
"20905","69148","2014",16,12,4,264440,2667.938,98.8125
"20906","69149","2014",323,48,275,175779.8,2546.957,70.03406
"20907","69151","2014",9,9,0,186216.7,1692.778,111.3333
"20908","69152","2014",74,26,48,180616.2,2422.878,73.86486
"20909","69153","2014",6,5,1,442616.7,4972,129.1667
"20910","69154","2014",22,14,8,268981.8,2463,106.8636
"20911","69155","2014",5,5,0,171780,1640.6,97.4
"20912","69157","2014",42,32,10,194391.2,1945.429,101.0714
"20913","69159","2014",9,9,0,297583.3,2161.222,135.5556
"20914","69160","2014",14,14,0,173514.3,1428.571,125.2143
"20915","69161","2014",8,8,0,99287.5,1133.125,90.5
"20916","69162","2014",11,11,0,185935.1,1589.364,122.5455
"20917","69163","2014",15,13,2,300273.3,3117.467,101.1333
"20918","69164","2014",3,3,0,81733.33,786.6667,102
"20919","69165","2014",9,9,0,185617.8,1555.778,123.3333
"20920","69166","2014",8,8,0,180311.2,1303.125,151.125
"20921","69167","2014",1,1,0,270000,2673,101
"20922","69168","2014",16,11,5,315268.8,2799.938,111.8125
"20923","69169","2014",5,5,0,121350,1212.4,106.8
"20924","69170","2014",7,7,0,223064.3,2304.857,98
"20925","69171","2014",24,12,12,175575.4,2034.667,87.79167
"20926","69172","2014",9,9,0,226208.3,1989.667,112.2222
"20927","69173","2014",8,7,1,176500,1775.875,101.25
"20928","69174","2014",5,5,0,132480,1730.4,79.4
"20929","69175","2014",13,13,0,226888.8,2045.769,109.5385
"20930","69176","2014",36,26,10,244990.6,2739.333,93.05556
"20931","69177","2014",21,18,3,283037.1,2635.143,114.619
"20932","69178","2014",3,3,0,150000,1551.667,123.6667
"20933","69179","2014",20,17,3,231848,2321.15,96.05
"20934","69180","2014",3,3,0,200600,2015,95.33333
"20935","69181","2014",5,5,0,117141,1214.6,98.6
"20936","69182","2014",2,2,0,80000,754.5,97.5
"20937","69183","2014",3,3,0,156666.7,1473.333,127.6667
"20938","69184","2014",10,10,0,172901,1560.4,115.2
"20939","69186","2014",1,1,0,104080,1508,69
"20940","69187","2014",10,9,1,143870,1402.8,103.1
"20941","69188","2014",9,7,2,124583.3,1630.222,84.44444
"20942","69189","2014",27,6,21,185188.9,2052.148,92.7037
"20943","69190","2014",11,6,5,278005.5,2807.091,97.72727
"20944","69191","2014",55,43,12,529280,4344.2,122.3818
"20945","69192","2014",2,2,0,208550,1771,117.5
"20946","69193","2014",4,4,0,294112.5,2695,110.25
"20947","69194","2014",69,53,16,580976.7,4261.623,137.3188
"20948","69196","2014",6,4,2,120708.3,1360.5,85.33333
"20949","69197","2014",11,11,0,238500.9,2024.818,115
"20950","69198","2014",8,8,0,242970.5,2159.125,116.25
"20951","69199","2014",77,22,55,134648.4,2153.753,64.87013
"20952","69200","2014",11,10,1,129290,1559.364,81.63636
"20953","69201","2014",6,3,3,160333.3,1514.167,117.6667
"20954","69202","2014",225,43,182,259243.6,2920.507,86.04889
"20955","69203","2014",8,6,2,140870,1625.625,81.125
"20956","69204","2014",188,72,116,250492.8,2785.713,88.57979
"20957","69205","2014",40,25,15,275777.8,3075.9,88.225
"20958","69206","2014",39,33,6,211744.3,2018.333,109.6923
"20959","69207","2014",23,15,8,278706.8,2671.13,102.9565
"20960","69208","2014",19,17,2,301459.5,2784.895,120.3158
"20961","69209","2014",3,3,0,93733.33,986.6667,99.66667
"20962","69212","2014",2,2,0,493177.5,3278,150.5
"20963","69214","2014",9,8,1,141166.7,1396.444,100.6667
"20964","69215","2014",11,10,1,258034.1,2329.636,120.1818
"20965","69216","2014",3,3,0,358300,2058.333,172.3333
"20966","69217","2014",3,3,0,131455,1599.667,95.66667
"20967","69218","2014",12,11,1,161141.7,1543.167,120.3333
"20968","69219","2014",17,14,3,287796.5,3189.235,108.1765
"20969","69220","2014",15,11,4,143773.6,1719.467,83.73333
"20970","69225","2014",5,5,0,143710,1641.4,82
"20971","69227","2014",20,19,1,215010.5,2164.45,101.8
"20972","69228","2014",22,21,1,187986.4,2057.045,91
"20973","69229","2014",6,6,0,110250,1142.833,91.83333
"20974","69231","2014",14,9,5,234188.6,2383.5,100.4286
"20975","69233","2014",9,8,1,370077.8,3123.444,120.8889
"20976","69234","2014",8,8,0,191231.2,2439.375,86.25
"20977","69235","2014",11,4,7,158277.3,1886.818,86.81818
"20978","69236","2014",4,4,0,242630,2158.25,112
"20979","69238","2014",38,27,11,160600.2,1893.316,87.42105
"20980","69239","2014",14,14,0,243489.3,2097.786,121.0714
"20981","69240","2014",5,5,0,107938,1085,104.6
"20982","69241","2014",29,21,8,262813.8,2515.483,109.7931
"20983","69242","2014",8,7,1,198340,2049.75,92.875
"20984","69243","2014",69,30,39,143278.9,1637.101,88.02899
"20985","69244","2014",273,32,241,244839,3011.355,79.89011
"20986","69245","2014",12,9,3,181904.2,2155.833,87.16667
"20987","69246","2014",10,10,0,221106,2323.4,96.5
"20988","69248","2014",35,32,3,99202.57,1099.343,92.37143
"20989","69249","2014",19,16,3,200618.4,2660.053,78.05263
"20990","69250","2014",30,22,8,339302,2851.133,120.6667
"20991","69252","2014",2,2,0,182250,2026,98.5
"20992","69253","2014",4,4,0,543180,3665,146.75
"20993","69254","2014",5,5,0,166300,1661.8,99.4
"20994","69255","2014",42,28,14,246151.7,2720.405,93.33333
"20995","69256","2014",185,58,127,164986.5,2203.427,74.98919
"20996","69257","2014",8,7,1,158840.1,1924.375,87.25
"20997","69258","2014",2,2,0,163875,2506,75.5
"20998","69259","2014",117,31,86,179337,2633.761,67.5812
"20999","69260","2014",27,20,7,360999.3,3010.778,118.8889
"21000","69263","2014",10,9,1,147172.3,1505.5,106.2
"21001","69264","2014",360,58,302,142608.2,1952.011,73.78056
"21002","69265","2014",12,7,5,207007.5,2361.417,97.66667
"21003","69266","2014",1723,104,1619,170704.6,2772.053,62.91352
"21004","69267","2014",17,17,0,198412.9,1893.765,106.5882
"21005","69268","2014",37,16,21,252992,3138.784,80.91892
"21006","69269","2014",5,5,0,194380,2206.8,90
"21007","69270","2014",30,20,10,297608.4,2893.867,104.9
"21008","69271","2014",82,65,17,338420.3,3390.61,101.878
"21009","69272","2014",23,21,2,313304.3,3134.304,107.087
"21010","69273","2014",92,47,45,214398.9,2737.707,79.40217
"21011","69275","2014",242,70,172,193514.5,2604.008,75.14876
"21012","69276","2014",59,34,25,195982,2424.034,85.94915
"21013","69277","2014",101,78,23,342626.9,3318.584,104.0891
"21014","69278","2014",46,29,17,257744.8,2581.326,100.3261
"21015","69279","2014",48,44,4,294696.7,2884.688,105.2083
"21016","69280","2014",18,16,2,256655.6,2678.722,102.5556
"21017","69281","2014",8,7,1,310442.5,3079.5,98.125
"21018","69282","2014",271,186,85,247374.1,2866.76,87.13653
"21019","69283","2014",100,80,20,263983.9,2941.05,90.63
"21020","69284","2014",24,22,2,341004.6,2888,118.9167
"21021","69285","2014",32,29,3,288115.8,2848.375,101.8438
"21022","69286","2014",194,76,118,229215.4,2551.026,88.71649
"21023","69287","2014",64,38,26,279282.7,3029.031,94.04688
"21024","69288","2014",47,33,14,252833.4,2681.021,97.95745
"21025","69289","2014",35,29,6,259157,2742,96.31429
"21026","69290","2014",360,92,268,201934.5,2450.244,82.23889
"21027","69291","2014",58,33,25,225768.3,2676.017,85.7931
"21028","69292","2014",36,8,28,206987.6,2660.528,79.47222
"21029","69293","2014",30,21,9,294654.6,3017,99.86667
"21030","69294","2014",25,16,9,273553,2709.68,100.76
"21031","69295","2014",12,8,4,262433.3,2769.833,99.58333
"21032","69296","2014",22,17,5,257579.3,2868.091,94.18182
"21033","69297","2014",38,31,7,293023.9,2953.105,102.8684
"21034","69299","2014",13,11,2,271721.2,2476.308,110.3077
"21035","70004","2014",1,1,0,95000,1033,92
"21036","70005","2014",1,1,0,66000,1320,50
"21037","70006","2014",10,10,0,76289.3,924.4,86.4
"21038","70008","2014",1,1,0,95000,905,105
"21039","70011","2014",5,5,0,120672,1123.8,105.8
"21040","70013","2014",2,2,0,72500,609.5,110
"21041","70014","2014",1,1,0,121000,1375,88
"21042","70016","2014",2,2,0,160000,879,179
"21043","70017","2014",1,1,0,90000,643,140
"21044","70018","2014",3,3,0,110033.3,1049.667,104.3333
"21045","70019","2014",2,2,0,134000,1351.5,98
"21046","70020","2014",1,1,0,70000,1167,60
"21047","70021","2014",1,1,0,175000,1042,168
"21048","70022","2014",1,1,0,121850,1218,100
"21049","70024","2014",1,1,0,60000,364,165
"21050","70026","2014",9,8,1,83972.22,765.4444,109.1111
"21051","70028","2014",2,2,0,75500,660.5,113
"21052","70029","2014",2,2,0,151000,1251.5,123.5
"21053","70030","2014",1,1,0,95000,760,125
"21054","70031","2014",7,7,0,104400,1139.714,90.85714
"21055","70032","2014",1,1,0,1e+05,990,101
"21056","70037","2014",3,2,1,111933.3,1176.333,90
"21057","70039","2014",2,2,0,159000,1453,116.5
"21058","70041","2014",2,2,0,80750,774.5,104.5
"21059","70043","2014",2,2,0,69000,825.5,83
"21060","70044","2014",2,2,0,111500,1377,81
"21061","70046","2014",3,3,0,98300,1137,87
"21062","70047","2014",2,1,1,83600,747,98
"21063","70053","2014",1,1,0,1e+05,1136,88
"21064","70061","2014",1,1,0,145000,1747,83
"21065","70062","2014",2,2,0,76000,1403.5,59
"21066","70063","2014",1,1,0,105000,1010,104
"21067","70064","2014",2,2,0,128950,1200,120
"21068","70066","2014",1,1,0,31500,630,50
"21069","70071","2014",2,2,0,94500,2171.5,47
"21070","70072","2014",1,1,0,185000,1321,140
"21071","70076","2014",7,7,0,146128.6,1230.857,120
"21072","70079","2014",1,1,0,86000,789,109
"21073","70080","2014",6,6,0,103583.3,925,106.6667
"21074","70083","2014",5,5,0,69400,924.6,77
"21075","70085","2014",4,3,1,163875,1305.25,137.25
"21076","70087","2014",2,2,0,128250,918.5,153
"21077","70088","2014",1,1,0,97000,1244,78
"21078","70090","2014",2,2,0,64500,670,96.5
"21079","70094","2014",2,2,0,75000,699,123.5
"21080","70096","2014",4,4,0,94325,953,100.25
"21081","70097","2014",1,1,0,120000,1579,76
"21082","70101","2014",7,7,0,138821.4,1074.857,110.4286
"21083","70103","2014",1,1,0,55000,561,98
"21084","70104","2014",5,4,1,116380,1093.8,111.8
"21085","70105","2014",1,1,0,88890,593,150
"21086","70107","2014",4,4,0,178250,1563.5,113
"21087","70109","2014",2,2,0,185000,2148.5,84.5
"21088","70111","2014",1,1,0,70650,883,80
"21089","70116","2014",6,6,0,128908.3,1214.167,111.8333
"21090","70117","2014",3,3,0,169966.7,1531,112
"21091","70118","2014",2,2,0,116500,1635,71
"21092","70120","2014",30,28,2,123878.3,1286.1,105.6
"21093","70121","2014",7,7,0,128450,1395.429,95.57143
"21094","70124","2014",1,1,0,167900,1043,161
"21095","70125","2014",2,2,0,77500,766.5,104.5
"21096","70127","2014",1,1,0,222000,1850,120
"21097","70128","2014",2,2,0,87500,605.5,147
"21098","70130","2014",2,2,0,130000,1238,114
"21099","70132","2014",3,3,0,157000,1350.667,118
"21100","70134","2014",3,3,0,118300,1170,116.3333
"21101","70136","2014",6,5,1,121983.3,1493,86.83333
"21102","70147","2014",3,3,0,78916.67,885.3333,89.66667
"21103","70148","2014",1,1,0,170000,2125,80
"21104","70149","2014",7,7,0,110200,1158.857,88.71429
"21105","70152","2014",6,6,0,135433.3,1293.333,109.6667
"21106","70154","2014",2,2,0,125000,1271,108.5
"21107","70157","2014",3,3,0,98166.67,774,132
"21108","70158","2014",1,1,0,103150,860,120
"21109","70162","2014",3,3,0,151443.3,1466.667,110
"21110","70163","2014",5,5,0,117590,1120.8,102.8
"21111","70164","2014",1,1,0,95000,704,135
"21112","70165","2014",4,4,0,88000,766.75,125.25
"21113","70166","2014",1,1,0,145000,1394,104
"21114","70168","2014",2,1,1,44000,664.5,68.5
"21115","70169","2014",1,1,0,65000,650,100
"21116","70171","2014",11,10,1,93556.18,1009.364,94.90909
"21117","70172","2014",1,1,0,82322,1029,80
"21118","70178","2014",2,2,0,110725,1385,84
"21119","70179","2014",1,1,0,289400,1743,166
"21120","70182","2014",1,1,0,166000,1186,140
"21121","70184","2014",7,2,5,89318.86,1133.429,81.85714
"21122","70185","2014",1,1,0,105000,1750,60
"21123","70187","2014",3,3,0,133950,1660.667,82
"21124","70190","2014",2,2,0,139500,1746.5,80.5
"21125","70196","2014",1,1,0,80000,611,131
"21126","70199","2014",1,1,0,163000,1646,99
"21127","70200","2014",1,1,0,28000,350,80
"21128","70205","2014",2,2,0,112500,1812.5,75
"21129","70206","2014",4,4,0,118750,1301.5,86
"21130","70207","2014",27,26,1,122347.4,1364.778,90.92593
"21131","70211","2014",1,1,0,114500,686,167
"21132","70216","2014",4,4,0,146250,1005,162.25
"21133","70217","2014",1,1,0,152000,2980,51
"21134","70218","2014",1,1,0,170000,1635,104
"21135","70219","2014",9,9,0,92911.11,1077.444,88.77778
"21136","70220","2014",4,2,2,90625,1046.25,88.5
"21137","70221","2014",1,1,0,220000,2056,107
"21138","70222","2014",4,4,0,59375,621.75,91.25
"21139","70224","2014",2,1,1,145410,1566.5,94.5
"21140","70225","2014",2,2,0,72500,659.5,121.5
"21141","70226","2014",4,4,0,92056.25,993.5,92.25
"21142","70227","2014",2,1,1,179000,1534,127
"21143","70228","2014",5,5,0,101020,894.6,105
"21144","70232","2014",1,1,0,80000,667,120
"21145","70233","2014",2,2,0,119850,1106.5,95
"21146","70235","2014",2,2,0,74000,729,104.5
"21147","70239","2014",1,1,0,230000,3538,65
"21148","70240","2014",6,6,0,90141.67,960,97
"21149","70242","2014",2,2,0,85000,654.5,117.5
"21150","70244","2014",1,1,0,43000,426,101
"21151","70245","2014",22,21,1,103061.4,1128.364,100.6364
"21152","70248","2014",9,9,0,169577.8,1505,111.5556
"21153","70253","2014",5,5,0,144810,1333,110.6
"21154","70254","2014",5,5,0,103400,1056.8,88.4
"21155","70255","2014",3,3,0,110333.3,1047.667,113.3333
"21156","70256","2014",10,10,0,116810,1042,111.5
"21157","70257","2014",9,9,0,118777.8,1406.556,90.55556
"21158","70259","2014",2,2,0,192200,1332,144.5
"21159","70260","2014",2,2,0,117500,1002.5,116
"21160","70261","2014",10,10,0,157785,1449.8,109.6
"21161","70262","2014",2,2,0,135500,1340,101
"21162","70263","2014",3,3,0,57500,794,72.33333
"21163","70265","2014",1,1,0,67000,691,97
"21164","70267","2014",3,3,0,98333.33,909.3333,121
"21165","70269","2014",2,2,0,129500,1098,142
"21166","70271","2014",3,3,0,118666.7,1617.667,115.3333
"21167","70275","2014",4,4,0,108937.5,1099,94.25
"21168","70276","2014",1,1,0,70000,778,90
"21169","70277","2014",5,5,0,72200,708.2,105.6
"21170","70279","2014",47,27,20,106590.2,1188.532,102.8511
"21171","70280","2014",3,3,0,158333.3,1424.667,116
"21172","70282","2014",7,6,1,75000,844.7143,95.14286
"21173","70283","2014",6,6,0,98583.33,1201.333,81.16667
"21174","70284","2014",2,2,0,66500,790.5,82.5
"21175","70285","2014",64,48,16,108588.5,1268.766,87.70312
"21176","70287","2014",2,2,0,85000,883.5,100
"21177","70288","2014",2,2,0,113750,1728.5,66.5
"21178","70290","2014",1,1,0,152000,944,161
"21179","70292","2014",8,8,0,56787.5,734.5,85
"21180","70294","2014",1,1,0,120000,1538,78
"21181","70295","2014",3,3,0,138833.3,1234.333,113.3333
"21182","70306","2014",9,9,0,166544.4,1459.111,121.5556
"21183","70307","2014",1,1,0,80000,714,112
"21184","70308","2014",1,1,0,55000,474,116
"21185","70310","2014",55,43,12,98095.64,1084.636,93.72727
"21186","70312","2014",11,11,0,169068.2,1559.455,106.6364
"21187","70313","2014",4,4,0,198200,1187.5,178.75
"21188","70314","2014",1,1,0,59000,393,150
"21189","70315","2014",4,4,0,76475,799,87.25
"21190","70317","2014",3,3,0,116733.3,1061,107.6667
"21191","70318","2014",2,2,0,126750,1345,95
"21192","70319","2014",1,1,0,71000,651,109
"21193","70321","2014",9,8,1,119555.6,1251,98
"21194","70322","2014",2,2,0,126625,1340,94
"21195","70323","2014",2,2,0,40000,510,78
"21196","70324","2014",6,6,0,89000,1250,74
"21197","70325","2014",5,5,0,152700,1716.2,95.4
"21198","70326","2014",1,1,0,165000,1398,118
"21199","70328","2014",5,5,0,112080,1134,99.6
"21200","70331","2014",4,4,0,81000,982.75,84
"21201","70332","2014",1,1,0,195000,1413,138
"21202","70336","2014",1,1,0,109000,1677,65
"21203","70338","2014",1,1,0,90000,865,104
"21204","70339","2014",8,8,0,164842,1556.5,104.25
"21205","70341","2014",2,2,0,102750,850,120
"21206","70343","2014",1,1,0,267900,1294,207
"21207","70348","2014",6,6,0,98668.33,1250.167,82.83333
"21208","70349","2014",3,3,0,77666.67,745.6667,91.66667
"21209","70355","2014",5,5,0,182400,1348,139.8
"21210","70356","2014",2,2,0,179000,1494.5,117.5
"21211","70357","2014",7,7,0,108042.9,1208,93.85714
"21212","70358","2014",2,2,0,126000,1032,125
"21213","70360","2014",1,1,0,105000,963,109
"21214","70361","2014",2,2,0,86500,823,100.5
"21215","70363","2014",4,3,1,120000,1279.25,104
"21216","70366","2014",1,1,0,120000,968,124
"21217","70376","2014",4,4,0,140000,1525,100.75
"21218","70378","2014",10,9,1,151605,1489.7,104.2
"21219","70383","2014",2,2,0,154000,1108,139
"21220","70384","2014",2,2,0,41000,444,91.5
"21221","70387","2014",7,7,0,94400,1006.714,94.28571
"21222","70388","2014",19,17,2,133986.8,1296.526,101.4737
"21223","70393","2014",5,5,0,128398,1227.4,105.6
"21224","70401","2014",3,3,0,91666.67,841.3333,111
"21225","70402","2014",2,2,0,62500,754,76.5
"21226","70403","2014",4,4,0,115475,1364.5,88.5
"21227","70404","2014",5,5,0,126820,952.4,121.4
"21228","70405","2014",3,2,1,80000,827.6667,101.6667
"21229","70408","2014",9,9,0,105444.4,1192.667,84.66667
"21230","70413","2014",21,20,1,127754.8,1227.143,108.5714
"21231","70414","2014",4,4,0,67500,815,82.25
"21232","70415","2014",1,1,0,65000,722,90
"21233","70417","2014",2,2,0,160000,1240,126.5
"21234","70418","2014",1,1,0,43000,915,47
"21235","70419","2014",5,5,0,119700,964,133.4
"21236","70421","2014",32,23,9,120371.9,1316.438,92.59375
"21237","70422","2014",1,1,0,176500,1765,100
"21238","70425","2014",1,1,0,140000,1261,111
"21239","70427","2014",4,4,0,93287.5,678.75,131
"21240","70428","2014",11,11,0,176209.1,1565.182,108.8182
"21241","70429","2014",3,3,0,189783.3,1532.333,124.3333
"21242","70431","2014",2,2,0,142000,1471.5,94
"21243","70433","2014",11,11,0,186970.6,1547.273,122.9091
"21244","70435","2014",7,7,0,96500,857,111.5714
"21245","70439","2014",6,6,0,95416.67,1156.5,84.5
"21246","70444","2014",2,2,0,79000,606.5,142.5
"21247","70445","2014",1,1,0,384390,2100,183
"21248","70446","2014",4,4,0,158883.8,1586.25,110.25
"21249","70447","2014",26,21,5,156345.9,1432.731,107.4615
"21250","70451","2014",13,13,0,116730.8,1078.769,104.3846
"21251","70452","2014",4,4,0,163350,1163.5,141
"21252","70455","2014",1,1,0,115000,1292,89
"21253","70457","2014",3,3,0,52366.67,539.6667,96.33333
"21254","70459","2014",5,5,0,106777.2,941.4,111
"21255","70460","2014",2,2,0,165000,1792.5,104.5
"21256","70462","2014",2,2,0,84830,814.5,100.5
"21257","70463","2014",1,1,0,1e+05,800,125
"21258","70464","2014",12,10,2,98761.67,1106.917,94.5
"21259","70467","2014",13,11,2,95001.31,859.6923,102.3077
"21260","70469","2014",1,1,0,185000,2312,80
"21261","70472","2014",4,4,0,74875,959.25,74.5
"21262","70474","2014",1,1,0,41500,601,69
"21263","70477","2014",3,3,0,151318.3,1313.667,117.6667
"21264","70478","2014",4,4,0,128375,1084,111.75
"21265","70479","2014",1,1,0,164000,1367,120
"21266","70482","2014",7,6,1,98372.86,968.7143,107.2857
"21267","70484","2014",2,2,0,151300,1585.5,95.5
"21268","70485","2014",3,3,0,84000,613.6667,156.6667
"21269","70489","2014",5,5,0,87060,887.2,98.2
"21270","70490","2014",2,2,0,125000,1304,96
"21271","70492","2014",4,4,0,100950,844.25,118.75
"21272","70493","2014",5,5,0,151000,1606.6,90.4
"21273","70498","2014",3,3,0,162666.7,1829.667,93
"21274","70500","2014",1,1,0,90000,545,165
"21275","70504","2014",3,3,0,116666.7,1031.333,117
"21276","70505","2014",1,1,0,65000,722,90
"21277","70506","2014",2,2,0,127500,1660.5,76.5
"21278","70510","2014",2,2,0,72500,825,90
"21279","70512","2014",2,2,0,100500,841,108
"21280","70513","2014",13,11,2,127995,1328.615,95.30769
"21281","70514","2014",7,6,1,114192.9,1066.143,107
"21282","70515","2014",3,3,0,111333.3,1815,67.33333
"21283","70517","2014",1,1,0,71000,947,75
"21284","70521","2014",4,4,0,99250,1137.5,90.25
"21285","70522","2014",1,1,0,143000,1277,112
"21286","70523","2014",3,3,0,86000,717.3333,119.6667
"21287","70524","2014",1,1,0,30000,577,52
"21288","70526","2014",6,5,1,68250,774.8333,96.33333
"21289","70529","2014",2,2,0,143115,1156,119.5
"21290","70530","2014",1,1,0,70000,909,77
"21291","70532","2014",4,4,0,99250,951.25,107.75
"21292","70535","2014",2,2,0,153500,1412.5,111.5
"21293","70537","2014",3,3,0,126500,1316.333,95
"21294","70550","2014",132,41,91,97160.27,1161.621,81.65152
"21295","70552","2014",2,2,0,93500,828,119
"21296","70559","2014",3,3,0,100716.7,1047,109.6667
"21297","70561","2014",10,10,0,89675,846.7,99.1
"21298","70562","2014",4,4,0,131275,1285,103.5
"21299","70563","2014",4,4,0,221180,1173,168.25
"21300","70569","2014",1,1,0,118000,1311,90
"21301","70575","2014",8,8,0,159718.8,1592,101.5
"21302","70577","2014",5,5,0,117400,1373.6,87
"21303","70579","2014",3,3,0,134683.3,1483.667,90.33333
"21304","70580","2014",1,1,0,29000,690,42
"21305","70581","2014",6,5,1,144207,1845.333,96
"21306","71001","2014",5,5,0,138440,1132,120
"21307","71002","2014",6,6,0,108000,964.6667,115.8333
"21308","71003","2014",6,5,1,108833.3,1354.333,84.66667
"21309","71004","2014",4,4,0,111750,1168,97.75
"21310","71005","2014",1,1,0,168000,1344,125
"21311","71006","2014",1,1,0,75000,1250,60
"21312","71007","2014",3,3,0,230666.7,1740.333,145.6667
"21313","71008","2014",1,1,0,98250,982,100
"21314","71009","2014",15,15,0,81333.33,963.4667,87.66667
"21315","71010","2014",5,5,0,104640,992.6,110.8
"21316","71011","2014",1,1,0,119000,922,129
"21317","71012","2014",1,1,0,110000,1009,109
"21318","71013","2014",4,4,0,162875,1494.5,104.5
"21319","71014","2014",93,55,38,106930.9,1145.624,92.74194
"21320","71015","2014",5,5,0,90400,893,100.4
"21321","71016","2014",10,10,0,141069,1511.3,97.9
"21322","71017","2014",1,1,0,5e+05,2000,250
"21323","71018","2014",4,4,0,94500,1054,88.75
"21324","71019","2014",3,3,0,70000,937.6667,71.66667
"21325","71020","2014",1,1,0,40000,385,104
"21326","71021","2014",1,1,0,167000,2456,68
"21327","71022","2014",5,5,0,172216,1546,109.4
"21328","71023","2014",9,9,0,111194.4,1371.333,88.33333
"21329","71024","2014",2,2,0,42500,663.5,66
"21330","71025","2014",5,5,0,110760,1411.4,79
"21331","71026","2014",1,1,0,141950,1651,86
"21332","71027","2014",4,4,0,140750,1557.75,89.75
"21333","71028","2014",3,3,0,106333.3,1522,71.66667
"21334","71029","2014",5,4,1,90600,956,96.6
"21335","71031","2014",1,1,0,290000,2458,118
"21336","71032","2014",2,2,0,146000,1522,96
"21337","71033","2014",7,7,0,152535.7,1521.143,102
"21338","71034","2014",2,2,0,185050,1662.5,110
"21339","71035","2014",4,4,0,149680,1222.25,123
"21340","71036","2014",1,1,0,90000,1731,52
"21341","71037","2014",1,1,0,102000,1342,76
"21342","71038","2014",3,3,0,130043.3,1494,92.33333
"21343","71040","2014",50,48,2,114626.2,1275.98,89.86
"21344","71041","2014",1,1,0,83000,415,200
"21345","71042","2014",2,2,0,137500,1492,88
"21346","71043","2014",1,1,0,23750,742,32
"21347","71044","2014",4,4,0,74250,984,73.75
"21348","71047","2014",37,29,8,76838.59,1070.649,86
"21349","71048","2014",2,2,0,1e+05,641.5,166.5
"21350","71050","2014",4,4,0,105775.8,1765,72.5
"21351","71051","2014",1,1,0,124000,2138,58
"21352","71052","2014",10,10,0,132405,1380.4,93
"21353","71054","2014",5,5,0,81300,1035.4,77.6
"21354","71056","2014",29,29,0,109707.5,1156.69,96.24138
"21355","71057","2014",2,2,0,151400,1738,86.5
"21356","71058","2014",2,2,0,126000,1488.5,85.5
"21357","71059","2014",26,25,1,145449.2,1608.231,94.30769
"21358","71060","2014",2,2,0,97500,813.5,132.5
"21359","71061","2014",6,6,0,153000,1413.833,109
"21360","71062","2014",3,3,0,168000,1268.333,144
"21361","71063","2014",4,4,0,61625,884,68.75
"21362","71064","2014",4,4,0,97250,1250,77.75
"21363","71065","2014",1,1,0,80000,455,176
"21364","71066","2014",1,1,0,150000,1786,84
"21365","71067","2014",2,2,0,92500,1356,70.5
"21366","71069","2014",4,4,0,211769.2,1996.75,103.75
"21367","71070","2014",12,11,1,160570,1633.083,96.75
"21368","71071","2014",3,3,0,117383.3,1228.333,92.33333
"21369","71072","2014",3,3,0,114666.7,995.6667,118
"21370","71073","2014",37,32,5,137489,1462.027,91.37838
"21371","71075","2014",7,6,1,68064.29,581.4286,116.4286
"21372","71076","2014",471,85,386,98764.48,1272.27,75.85563
"21373","71077","2014",5,5,0,92399.8,812,111.2
"21374","71079","2014",5,4,1,223424.8,1891.4,116.4
"21375","71081","2014",12,10,2,135775.5,1337.417,105.0833
"21376","71084","2014",5,5,0,209660,1822.2,119.6
"21377","71085","2014",3,3,0,127346.7,1541.333,83
"21378","71086","2014",4,4,0,104200,976,104
"21379","71087","2014",5,5,0,171944,2170.8,90
"21380","71088","2014",2,2,0,137500,1464,105.5
"21381","71089","2014",2,2,0,91250,781.5,116.5
"21382","71090","2014",31,27,4,166100,1713.581,96.22581
"21383","71091","2014",5,5,0,87360,918.8,90.8
"21384","71092","2014",3,3,0,146666.7,1455.333,106.3333
"21385","71093","2014",10,10,0,94907.5,1316.1,80.7
"21386","71094","2014",2,2,0,94500,1446.5,65
"21387","71095","2014",2,2,0,85400,721.5,128.5
"21388","71096","2014",2,2,0,108200,1044,92.5
"21389","71097","2014",9,9,0,90166.67,949,92.44444
"21390","71098","2014",6,6,0,67666.67,883.3333,74.16667
"21391","71099","2014",3,3,0,214016.7,1767.667,120.3333
"21392","71100","2014",3,3,0,183406.7,1375,166.6667
"21393","71101","2014",5,5,0,80430.8,949.2,80.2
"21394","71102","2014",6,6,0,150626.7,1583.333,99
"21395","71103","2014",3,3,0,166168.3,1623.333,103
"21396","71105","2014",71,38,33,163634.3,1778.211,92.15493
"21397","71106","2014",23,16,7,119474,1316.087,93.65217
"21398","71107","2014",4,4,0,157687.5,1109.5,145.25
"21399","71108","2014",2,2,0,153625,1566,97.5
"21400","71109","2014",2,2,0,208700,1299.5,140
"21401","71110","2014",3,3,0,144266.7,1376.667,109.3333
"21402","71111","2014",1,1,0,59000,967,61
"21403","71112","2014",3,3,0,170000,1757.667,100
"21404","71113","2014",2,2,0,75000,556.5,139.5
"21405","71115","2014",1,1,0,99000,1456,68
"21406","71116","2014",2,2,0,109500,1290,85
"21407","71117","2014",9,9,0,188956.7,1668,115.7778
"21408","71118","2014",59,46,13,137742.3,1757.441,82.86441
"21409","71119","2014",11,11,0,174350.9,1670.818,105
"21410","71120","2014",41,32,9,80441.07,1042.805,78.63415
"21411","71121","2014",4,4,0,119782.5,1127,110.25
"21412","71122","2014",7,7,0,133521.4,1302,103.4286
"21413","71123","2014",5,5,0,82883,871.8,96.4
"21414","71124","2014",2,2,0,92500,937,96.5
"21415","71126","2014",2,2,0,340500,2045.5,173
"21416","71127","2014",1,1,0,167320,1268,132
"21417","71128","2014",3,3,0,130600,1394,89
"21418","71129","2014",3,3,0,41900,632.3333,65.33333
"21419","71130","2014",2,2,0,43500,822,52.5
"21420","71131","2014",5,5,0,109420,1103.4,105
"21421","71132","2014",19,18,1,75068.42,877.8421,87.78947
"21422","71133","2014",19,13,6,95624.21,1199.421,86.26316
"21423","71134","2014",7,7,0,125142.9,1256,100.1429
"21424","71135","2014",6,6,0,179333.3,1859.833,96
"21425","71136","2014",3,3,0,84666.67,1021.333,78.33333
"21426","71137","2014",40,28,12,167672.3,1600.1,103.1
"21427","71141","2014",3,3,0,65833.33,824.6667,85.33333
"21428","71142","2014",2,2,0,82005,1033,78
"21429","71145","2014",5,4,1,106000,962.8,111.4
"21430","71146","2014",1,1,0,97500,513,190
"21431","71147","2014",4,4,0,104205,877.25,110.5
"21432","71148","2014",5,5,0,73600,917.2,81
"21433","71149","2014",11,10,1,189357.3,2082.455,103.3636
"21434","71150","2014",23,17,6,127494.8,1389.087,93.26087
"21435","71152","2014",1,1,0,75000,1119,67
"21436","71153","2014",136,78,58,98126.18,1183.978,82.47794
"21437","71154","2014",15,15,0,158788.3,1536.733,105.1333
"21438","71155","2014",7,7,0,75928.57,758.2857,103.4286
"21439","71156","2014",2,2,0,158750,1606.5,99
"21440","71157","2014",16,16,0,107906.9,1344,86.3125
"21441","71158","2014",14,14,0,134971.4,1230.429,101.7857
"21442","71161","2014",3,3,0,136000,1124,131.6667
"21443","71162","2014",7,7,0,103000,1210.571,84.57143
"21444","71163","2014",2,2,0,58000,1054.5,55
"21445","71164","2014",3,3,0,106666.7,1721,64
"21446","71165","2014",8,8,0,88749.5,1221.125,70.75
"21447","71166","2014",3,3,0,236666.7,3528,76.66667
"21448","71167","2014",8,7,1,214105,2349,113.125
"21449","71168","2014",1,1,0,69000,986,70
"21450","71169","2014",4,4,0,124000,1136.5,103.25
"21451","71170","2014",9,9,0,158816.7,1545.556,111.3333
"21452","71171","2014",2,2,0,106895,1860.5,70.5
"21453","71173","2014",2,2,0,97500,946,105.5
"21454","71174","2014",3,3,0,201230.7,1347,160
"21455","71175","2014",7,7,0,122714.3,1217.429,100.5714
"21456","71176","2014",59,42,17,84482.63,963,84.79661
"21457","71177","2014",6,6,0,118398,1116.167,109
"21458","71178","2014",3,3,0,124166.7,1297,95.66667
"21459","71181","2014",2,2,0,122500,1041.5,114.5
"21460","71182","2014",18,18,0,250210,2015.333,124.6667
"21461","71183","2014",1,1,0,18000,600,30
"21462","71184","2014",5,5,0,92640,1083.8,97.6
"21463","71185","2014",7,7,0,93457.14,976.2857,91.71429
"21464","71186","2014",2,2,0,75000,1088.5,68
"21465","71187","2014",14,11,3,98306.43,1118.357,94.21429
"21466","71190","2014",8,6,2,53500,595.5,88.125
"21467","71191","2014",5,5,0,154710,1908,97
"21468","71192","2014",9,8,1,117210.6,1242,93.22222
"21469","71193","2014",6,6,0,142500,1332.167,93.5
"21470","71194","2014",8,8,0,159162.5,1574.125,109.625
"21471","71195","2014",3,3,0,172356.7,1662.333,106
"21472","71196","2014",16,16,0,117612.5,1337.5,88.6875
"21473","71198","2014",3,3,0,121000,1124.333,109
"21474","71199","2014",2,2,0,184250,1861.5,100
"21475","71200","2014",3,3,0,105266.7,894,116.3333
"21476","71201","2014",4,4,0,161973.8,1393.25,127.75
"21477","71202","2014",8,8,0,197275,1787,120.875
"21478","71203","2014",2,2,0,124000,1655.5,75
"21479","71204","2014",9,9,0,159287.8,1553.556,101.1111
"21480","71205","2014",9,9,0,114770,1120.667,104.7778
"21481","71206","2014",3,3,0,81666.67,944.3333,85
"21482","71207","2014",1,1,0,125000,1543,81
"21483","71208","2014",8,8,0,78937.5,822.875,98
"21484","71209","2014",9,9,0,84950,1069.111,76.22222
"21485","71210","2014",1,1,0,190000,2000,95
"21486","71212","2014",9,8,1,85966.67,813.1111,107.8889
"21487","71213","2014",7,7,0,104428.6,1244.143,87
"21488","71214","2014",4,4,0,78500,1145.25,78.5
"21489","71215","2014",13,12,1,112076.9,1479.769,93.53846
"21490","71216","2014",1,1,0,118000,2458,48
"21491","71217","2014",2,2,0,97465,1151.5,68
"21492","71218","2014",6,6,0,123831.7,1183.5,118.8333
"21493","71219","2014",7,7,0,123357.1,1147.714,108.2857
"21494","71220","2014",1,1,0,15000,395,38
"21495","71221","2014",30,25,5,178644.1,1859.567,98.86667
"21496","71222","2014",7,7,0,186628.6,1430,135
"21497","71223","2014",1,1,0,55000,948,58
"21498","71225","2014",4,4,0,223925,1573.5,151
"21499","71227","2014",8,8,0,88437.5,1064.375,81
"21500","71228","2014",2,2,0,164135,1326.5,118
"21501","71229","2014",3,3,0,124750,750.3333,169.3333
"21502","71230","2014",42,36,6,84593.29,927.7381,91.28571
"21503","71231","2014",3,3,0,76333.33,1138.667,66.33333
"21504","71233","2014",1,1,0,1e+05,1250,80
"21505","71234","2014",3,3,0,149333.3,1647.333,89
"21506","71235","2014",17,17,0,206105.9,1519.235,136.4118
"21507","71236","2014",13,13,0,148751.6,1311,120.8462
"21508","71237","2014",3,3,0,65333.33,947.3333,66.66667
"21509","71238","2014",12,12,0,102053.8,1001.833,104.3333
"21510","71239","2014",3,3,0,71666.67,1036.667,76
"21511","71240","2014",1,1,0,228000,2192,104
"21512","71241","2014",3,3,0,85000,1291.333,65.33333
"21513","71242","2014",4,4,0,91250,1098.25,99
"21514","71243","2014",6,6,0,98213.67,857.1667,115.8333
"21515","71244","2014",5,5,0,107500,1224.6,86.2
"21516","71245","2014",3,3,0,118843.3,1354.667,92.33333
"21517","71246","2014",4,3,1,111750,1093,103.75
"21518","71247","2014",4,4,0,97000,1038.5,95.25
"21519","71248","2014",3,3,0,66333.33,1036.667,67.66667
"21520","71249","2014",9,9,0,104144.4,1420.111,78.33333
"21521","71250","2014",8,8,0,142652.8,1495.25,93.75
"21522","71251","2014",4,4,0,157185,1723.75,97.5
"21523","71252","2014",5,5,0,83662,1028.8,89
"21524","71253","2014",5,5,0,186320,1733.2,104.6
"21525","71254","2014",1,1,0,155000,1240,125
"21526","71255","2014",2,2,0,185000,1522.5,110
"21527","71256","2014",3,3,0,111783.3,1657,71
"21528","71257","2014",8,8,0,205770.6,1633.25,125.75
"21529","71258","2014",5,5,0,236010,2228,105.4
"21530","71259","2014",7,7,0,113714.3,1014.714,110.1429
"21531","71261","2014",8,8,0,134687.5,1259.875,111.5
"21532","71263","2014",55,38,17,117860.8,1452.218,92.10909
"21533","71264","2014",5,5,0,143268,1711,88.6
"21534","71266","2014",2,2,0,108500,1478,78
"21535","71267","2014",5,5,0,146400,1501,92.8
"21536","71269","2014",11,11,0,153809.1,1615.545,97.90909
"21537","71270","2014",313,89,224,118629.9,1483.073,80.76038
"21538","71272","2014",2,1,1,60000,737,79
"21539","71273","2014",2,2,0,43000,710,59
"21540","71274","2014",4,4,0,97000,1915.75,60.25
"21541","71275","2014",9,9,0,98555.56,1095.444,91.66667
"21542","71276","2014",3,3,0,203333.3,1586.333,139.3333
"21543","71277","2014",6,6,0,134808.3,1277.167,111.6667
"21544","71278","2014",1,1,0,155250,1493,104
"21545","71279","2014",7,7,0,124857.1,2318.571,72.57143
"21546","71280","2014",1,1,0,29000,569,51
"21547","71281","2014",1,1,0,160000,1600,100
"21548","71282","2014",5,5,0,81900,756.8,108.8
"21549","71283","2014",6,6,0,123433.3,1405.833,86
"21550","71285","2014",3,3,0,97079.33,1104,90.33333
"21551","71286","2014",3,3,0,157333.3,1292,115
"21552","71287","2014",4,4,0,125500,1492.25,84.75
"21553","71289","2014",13,12,1,95008.38,1061.615,89.23077
"21554","71290","2014",3,3,0,90000,1354,80
"21555","71291","2014",7,7,0,166000,1349.714,97.14286
"21556","71292","2014",20,20,0,203228.9,1714.95,126.1
"21557","71293","2014",4,4,0,188150,1657,111.5
"21558","71294","2014",7,6,1,116142.9,1218.429,92.57143
"21559","71295","2014",18,18,0,98761.11,1122.778,86.72222
"21560","71296","2014",6,6,0,151487.5,1290.833,120.3333
"21561","71297","2014",5,5,0,62900,950.2,67.6
"21562","71300","2014",8,8,0,114787.5,1125.5,101.125
"21563","71301","2014",2,2,0,189500,1608.5,125.5
"21564","71302","2014",2,2,0,118500,1204,99
"21565","71303","2014",6,6,0,129083.3,1457.833,89.83333
"21566","71305","2014",9,8,1,110444.4,1156.333,100
"21567","71306","2014",108,76,32,81193.07,963.8889,88.52778
"21568","71307","2014",2,2,0,142550,1658.5,86
"21569","71309","2014",11,9,2,119681.8,1292.909,95.54545
"21570","71310","2014",29,28,1,96255.86,1151.793,86.17241
"21571","71311","2014",3,3,0,128333.3,1364.667,96
"21572","71312","2014",3,3,0,156833.3,1271.667,122.3333
"21573","71313","2014",5,5,0,130380,1112.2,112
"21574","71314","2014",5,5,0,141968,1342.8,117.6
"21575","71315","2014",2,2,0,140989,1165.5,129.5
"21576","71316","2014",5,5,0,138183.8,1685.2,85.2
"21577","71318","2014",16,16,0,87044.38,1134.188,81.75
"21578","71319","2014",8,8,0,107837.5,1228.875,84.375
"21579","71320","2014",1,1,0,77500,775,100
"21580","71321","2014",1,1,0,326150,2965,110
"21581","71323","2014",2,2,0,138250,1449,90.5
"21582","71324","2014",5,5,0,105200,1629.4,84
"21583","71325","2014",10,10,0,92782,981.4,88.2
"21584","71326","2014",3,3,0,113066.7,1080.667,105.6667
"21585","71327","2014",1,1,0,168000,1388,121
"21586","71328","2014",3,3,0,104166.7,1330.333,79
"21587","71329","2014",6,6,0,87833.33,944.1667,89.16667
"21588","71330","2014",8,8,0,68117.5,869.875,72.625
"21589","71331","2014",1,1,0,240000,1127,213
"21590","71332","2014",2,2,0,64750,644,95
"21591","71333","2014",5,5,0,149622,1293.2,114.2
"21592","71334","2014",3,3,0,113866.7,784,149.6667
"21593","71336","2014",15,14,1,129281.7,1302.733,94.86667
"21594","71337","2014",4,4,0,171075,1205.75,130.25
"21595","71338","2014",1,1,0,98000,1380,71
"21596","71339","2014",3,3,0,142666.7,1255,113
"21597","71340","2014",9,8,1,70277.78,732,96.77778
"21598","71341","2014",2,2,0,220990,1169.5,199
"21599","71342","2014",83,42,41,107236.5,1322.602,81.25301
"21600","71343","2014",2,2,0,187500,1150.5,181
"21601","71344","2014",3,3,0,81600,906.3333,98.33333
"21602","71345","2014",7,7,0,152828.6,1338.143,131.4286
"21603","71346","2014",12,12,0,74867,868.25,86.5
"21604","71347","2014",5,5,0,130800,1268,105.6
"21605","71348","2014",1,1,0,116000,1547,75
"21606","71350","2014",4,4,0,183302.5,1643,108
"21607","71351","2014",21,21,0,102328.6,1230,87.2381
"21608","71352","2014",2,2,0,136725,1665.5,83
"21609","71353","2014",5,5,0,137180,1391.2,101.6
"21610","71354","2014",3,3,0,72666.67,867,83.66667
"21611","71355","2014",5,5,0,106860,1194.4,105.2
"21612","71356","2014",11,11,0,112688.2,1088.727,100.9091
"21613","71357","2014",4,4,0,102125,1138.5,91.75
"21614","71358","2014",2,2,0,231106,2344,97
"21615","71359","2014",3,3,0,72166.67,1151.333,66.33333
"21616","71360","2014",12,12,0,202183.3,1841.75,111.5833
"21617","71361","2014",1,1,0,139000,1404,99
"21618","71362","2014",3,3,0,191666.7,2199.333,89.33333
"21619","71364","2014",2,2,0,127500,1348,94.5
"21620","71365","2014",6,6,0,78583.33,961.3333,80.33333
"21621","71366","2014",2,2,0,189625,1301.5,145.5
"21622","71367","2014",1,1,0,90000,738,122
"21623","71369","2014",5,5,0,157200,1816.6,84
"21624","71370","2014",6,6,0,38083.33,565,65.16667
"21625","71371","2014",16,16,0,180767.2,1645.125,115.6875
"21626","71372","2014",20,16,4,158475.8,1657,100.2
"21627","71373","2014",8,7,1,107375,1320.625,83.625
"21628","71374","2014",1,1,0,140000,2090,67
"21629","71376","2014",4,4,0,83700,1057.25,78.25
"21630","71377","2014",1,1,0,92000,773,119
"21631","71378","2014",5,5,0,198391.2,1754.6,112.8
"21632","71379","2014",20,20,0,131875,1275.2,95.2
"21633","71380","2014",7,7,0,185214.3,1646.857,122.5714
"21634","71381","2014",3,3,0,109823.3,1018.667,104.6667
"21635","71382","2014",4,4,0,68259.75,885.25,74.5
"21636","71383","2014",5,5,0,126177.2,1366.2,94.6
"21637","71384","2014",2,2,0,182550,1659.5,110
"21638","71385","2014",6,6,0,101626.7,1201.5,93.66667
"21639","71386","2014",3,3,0,63333.33,715.6667,107.3333
"21640","71387","2014",2,2,0,66000,1386,48
"21641","71388","2014",1,1,0,30000,714,42
"21642","71389","2014",2,2,0,93000,1007,92.5
"21643","71390","2014",4,4,0,109725,1095.5,102
"21644","71391","2014",5,5,0,77460,1173.6,72.6
"21645","71392","2014",4,4,0,113750,1158,97.5
"21646","71393","2014",2,2,0,90000,773.5,111.5
"21647","71394","2014",3,3,0,84900,1062,76
"21648","71395","2014",1,1,0,40000,1333,30
"21649","71396","2014",10,10,0,107275,1152.5,96.9
"21650","71397","2014",2,2,0,73000,772.5,89
"21651","71398","2014",7,7,0,110264.3,1121.143,97
"21652","71399","2014",5,5,0,136010,1714.2,79
"21653","71401","2014",4,4,0,143245.8,1210.75,119.75
"21654","71402","2014",6,6,0,159296.3,1543.667,107.5
"21655","71403","2014",5,5,0,272280,3632.8,97.4
"21656","71404","2014",4,3,1,151375,1562.5,98.5
"21657","71406","2014",1,1,0,44000,518,85
"21658","71407","2014",3,3,0,101000,772.6667,126.3333
"21659","71408","2014",1,1,0,145900,973,150
"21660","71409","2014",3,3,0,66166.67,928.3333,68
"21661","71410","2014",14,14,0,120685.7,1270.357,91.42857
"21662","71411","2014",3,3,0,118333.3,792.3333,146
"21663","71412","2014",6,6,0,77483.33,929.8333,77.83333
"21664","71413","2014",2,2,0,79000,1153.5,67.5
"21665","71414","2014",5,5,0,152400,1341.6,106.2
"21666","71415","2014",1,1,0,82000,1155,71
"21667","71416","2014",5,5,0,107769,1409,84.4
"21668","71417","2014",18,18,0,109054.4,1220.722,91
"21669","71419","2014",17,17,0,111411.8,1258.706,87.88235
"21670","71420","2014",18,18,0,170773.3,1590.722,112.6111
"21671","71421","2014",1,1,0,95750,811,118
"21672","71422","2014",3,3,0,127333.3,1680,79.33333
"21673","71423","2014",4,4,0,178000,1473,118.75
"21674","71424","2014",1,1,0,35000,700,50
"21675","71425","2014",2,2,0,126125,856,140.5
"21676","71426","2014",2,2,0,130000,1548,81
"21677","71428","2014",5,4,1,162140,1121.6,127.2
"21678","71430","2014",7,7,0,128092.9,1355.714,96
"21679","71431","2014",7,7,0,141481.4,1290.286,116.8571
"21680","71433","2014",5,5,0,186220,1457.8,109.4
"21681","71434","2014",5,5,0,123200,1022.2,111.2
"21682","71435","2014",2,2,0,51250,1209,44.5
"21683","71436","2014",1,1,0,124050,1394,89
"21684","71437","2014",4,4,0,112725,1297.25,83
"21685","71438","2014",3,3,0,55833.33,832,73
"21686","71439","2014",3,3,0,195366.7,1731.333,111.6667
"21687","71440","2014",2,2,0,52000,810.5,64
"21688","71441","2014",3,3,0,148000,1077.667,137
"21689","71442","2014",12,12,0,106495.8,1118.333,91.66667
"21690","71443","2014",12,12,0,215430,1641.417,137.8333
"21691","71444","2014",9,9,0,148755.6,1481.889,102.6667
"21692","71445","2014",50,39,11,124049.8,1385.96,89.12
"21693","71446","2014",3,3,0,156000,2493.667,87.33333
"21694","71447","2014",2,2,0,150520,1645.5,99.5
"21695","71448","2014",3,3,0,197560,1825.333,107.3333
"21696","71450","2014",1,1,0,60000,375,160
"21697","71451","2014",1,1,0,54000,600,90
"21698","71452","2014",4,4,0,95875,1076.25,90
"21699","71453","2014",1,1,0,131400,1493,88
"21700","71454","2014",1,1,0,255000,1635,156
"21701","71455","2014",2,2,0,120000,1842.5,64
"21702","71456","2014",23,23,0,142267,1463.609,101.8261
"21703","71457","2014",1,1,0,170000,1360,125
"21704","71458","2014",1,1,0,85000,1417,60
"21705","71460","2014",4,4,0,228620,1941,120
"21706","71461","2014",4,4,0,143771.8,1575.25,81.75
"21707","71462","2014",5,5,0,193670,1354.2,146
"21708","71463","2014",4,4,0,98900,881,109.25
"21709","71464","2014",2,2,0,148500,1022.5,170.5
"21710","71466","2014",1,1,0,51000,1020,50
"21711","71468","2014",3,3,0,119666.7,1057,143.3333
"21712","71469","2014",4,4,0,77375,818.75,87
"21713","71470","2014",5,5,0,141196,1441,95.2
"21714","71471","2014",1,1,0,208000,1387,150
"21715","71472","2014",2,2,0,61000,863,71.5
"21716","71473","2014",2,2,0,152500,1034,141
"21717","71474","2014",1,1,0,60000,690,87
"21718","71475","2014",54,46,8,133706.9,1477.926,90.31481
"21719","71477","2014",3,3,0,58666.67,1199.667,48.66667
"21720","71479","2014",13,12,1,144637.7,1491.923,95.61538
"21721","71480","2014",7,7,0,96285.71,1144.571,82.28571
"21722","71481","2014",9,9,0,164876.4,1844.111,88.44444
"21723","71482","2014",9,9,0,108812.8,1284.778,88
"21724","71483","2014",1,1,0,62000,689,90
"21725","71484","2014",17,17,0,120042.3,1175,101.4706
"21726","71485","2014",1,1,0,36000,364,99
"21727","71486","2014",65,64,1,97823.26,1133.446,89.44615
"21728","71488","2014",3,3,0,249200,2527,100.6667
"21729","71489","2014",7,7,0,118271.4,1503.286,81.28571
"21730","71490","2014",8,8,0,135480.6,1159.125,114
"21731","71491","2014",4,4,0,116975,1006.75,111
"21732","71492","2014",1,1,0,110000,1447,76
"21733","71493","2014",9,9,0,50444.44,881,61.55556
"21734","71494","2014",5,5,0,159241.6,1850.2,89.6
"21735","71495","2014",13,11,2,143542.3,1248.615,112.2308
"21736","71496","2014",1,1,0,130000,3714,35
"21737","71497","2014",17,17,0,187308.8,1773.412,108.2353
"21738","71498","2014",2,2,0,302250,1765,165
"21739","71499","2014",34,34,0,87067.5,967.9706,89.35294
"21740","71500","2014",3,3,0,138383.3,1449,112
"21741","71501","2014",2,2,0,260000,1488.5,130
"21742","71502","2014",11,11,0,133159.1,1477,87.81818
"21743","71504","2014",1,1,0,95000,546,174
"21744","71506","2014",10,10,0,84267,1035,92.2
"21745","71507","2014",2,2,0,138500,1671.5,81.5
"21746","71508","2014",5,5,0,98660,1383.2,71.2
"21747","71509","2014",2,2,0,101000,1060,100.5
"21748","71510","2014",5,5,0,118100,887.8,115.2
"21749","71512","2014",20,18,2,125860,1289.5,93.35
"21750","71513","2014",10,10,0,144185.4,1482.4,97.1
"21751","71514","2014",4,4,0,109500,1073,102.25
"21752","71515","2014",1,1,0,330000,1642,201
"21753","71516","2014",5,5,0,86500,900.6,100.4
"21754","71517","2014",2,2,0,94500,1035,113
"21755","71518","2014",5,5,0,84200,962,78.4
"21756","71519","2014",2,2,0,946000,7176,113.5
"21757","71520","2014",5,5,0,125080,1493.8,84.8
"21758","71522","2014",14,14,0,138257.1,1469.929,101.5
"21759","71523","2014",16,16,0,106320.6,1245.25,100.6875
"21760","71524","2014",1,1,0,190000,1188,160
"21761","71525","2014",3,3,0,131450,1327,96.66667
"21762","71526","2014",3,3,0,136666.7,1153,88.66667
"21763","71527","2014",3,3,0,177833.3,1586.333,109.3333
"21764","71528","2014",21,21,0,111100,1186.19,99.80952
"21765","71529","2014",4,4,0,81250,1187.25,76.5
"21766","71530","2014",5,5,0,116800,1309.6,99.8
"21767","71531","2014",1,1,0,55000,500,110
"21768","71532","2014",1,1,0,54000,600,90
"21769","71533","2014",4,4,0,100337.5,775.25,146.75
"21770","71535","2014",1,1,0,79804,831,96
"21771","71537","2014",2,2,0,37125,502.5,75.5
"21772","71538","2014",6,6,0,183750,1652.167,122.6667
"21773","71540","2014",14,14,0,175214.3,1427.071,113.6429
"21774","71541","2014",6,6,0,85320,1036.833,83.16667
"21775","71542","2014",9,9,0,62333.33,859.2222,72.66667
"21776","71543","2014",49,32,17,129751.7,1322.327,98.53061
"21777","71544","2014",7,7,0,109642.9,1048.286,108
"21778","71545","2014",6,5,1,71091.67,779.5,96.66667
"21779","71546","2014",1,1,0,139900,1332,105
"21780","71547","2014",3,3,0,97500,931.3333,112.6667
"21781","71549","2014",2,2,0,55500,692,87
"21782","71550","2014",9,9,0,154113.3,1091.111,138.4444
"21783","71551","2014",1,1,0,105000,1071,98
"21784","71552","2014",5,5,0,100200,957.2,103.6
"21785","71553","2014",2,2,0,105325,1225.5,86
"21786","71554","2014",1,1,0,30000,682,44
"21787","71555","2014",7,7,0,136183.6,1592.286,89
"21788","71556","2014",2,2,0,137000,797,171.5
"21789","71557","2014",2,2,0,82000,982,81
"21790","71558","2014",14,13,1,117450,1198.357,99.21429
"21791","71559","2014",8,8,0,134396.9,1100.625,117.25
"21792","71561","2014",2,2,0,29750,446,67.5
"21793","71562","2014",3,3,0,212666.7,973,208.3333
"21794","71563","2014",1,1,0,80000,2162,37
"21795","71564","2014",3,3,0,122200,1679,86.66667
"21796","71565","2014",1,1,0,280000,1273,220
"21797","71566","2014",11,7,4,102804.4,2485,83.27273
"21798","71568","2014",1,1,0,130000,1121,116
"21799","71570","2014",3,3,0,151300,1860,84.66667
"21800","71571","2014",4,4,0,141000,1235,111
"21801","71573","2014",5,5,0,98600,908.6,109.8
"21802","71574","2014",4,4,0,149125,1958.5,82.25
"21803","71576","2014",2,2,0,121000,1192,99.5
"21804","71578","2014",5,5,0,110640,971.4,115.2
"21805","71580","2014",4,4,0,121937.5,1370.25,86.5
"21806","71581","2014",1,1,0,65000,464,140
"21807","71582","2014",12,12,0,114266.7,1281.833,86.75
"21808","71583","2014",2,2,0,216290,1849,123
"21809","71584","2014",6,6,0,135967.5,1351,102.6667
"21810","71585","2014",14,14,0,164097.9,1515.714,114.2143
"21811","71586","2014",4,4,0,103975,1150.25,85.25
"21812","71588","2014",4,4,0,218500,1326.5,147.25
"21813","71589","2014",3,3,0,88833.33,1076,84.66667
"21814","71590","2014",2,2,0,163956,1446,116.5
"21815","71591","2014",5,5,0,140400,1635.4,85
"21816","72002","2014",1,1,0,20000,556,36
"21817","72003","2014",57,38,19,110389.5,1315.123,80.64912
"21818","72004","2014",5,5,0,121460,1283.8,95.6
"21819","72005","2014",9,9,0,106312.7,1181.889,89.44444
"21820","72006","2014",6,6,0,150183.3,1282.333,126.1667
"21821","72007","2014",3,3,0,174166.7,1678.333,102.6667
"21822","72008","2014",50,50,0,153065.1,1618.72,96.78
"21823","72009","2014",2,2,0,126000,962.5,133.5
"21824","72010","2014",3,3,0,105333.3,1091.333,96
"21825","72011","2014",6,6,0,101266.7,1104.333,97
"21826","72012","2014",7,7,0,122057.1,1221.857,120
"21827","72013","2014",21,21,0,78166.67,924.8095,85.95238
"21828","72015","2014",1,1,0,35000,603,58
"21829","72016","2014",8,8,0,114187.5,1304.875,84.5
"21830","72018","2014",1,1,0,82000,2562,32
"21831","72019","2014",3,3,0,70766.67,1029,68
"21832","72020","2014",5,5,0,95600,967,100.2
"21833","72021","2014",9,9,0,122944.4,1420.556,88.44444
"21834","72022","2014",5,5,0,96350,1064.2,97.8
"21835","72023","2014",19,19,0,103302.6,1223.895,85.84211
"21836","72024","2014",36,36,0,163963.7,1530.444,108.9167
"21837","72025","2014",18,18,0,112327.8,1248.944,91.05556
"21838","72026","2014",22,22,0,132156.8,1279.773,102.6364
"21839","72027","2014",1,1,0,80000,1333,60
"21840","72028","2014",1,1,0,40000,333,120
"21841","72029","2014",22,22,0,88272.73,1146.955,78.18182
"21842","72031","2014",4,4,0,88812.5,986,98.75
"21843","72032","2014",2,2,0,71500,640.5,107
"21844","72034","2014",2,2,0,135000,1154,120
"21845","72035","2014",15,15,0,82166.67,949.4,85.2
"21846","72036","2014",2,2,0,144335,978,147.5
"21847","72037","2014",2,2,0,54000,785,66
"21848","72038","2014",2,2,0,71000,945,73.5
"21849","72039","2014",42,42,0,86258.38,1080.81,83.40476
"21850","72040","2014",1,1,0,112000,1098,102
"21851","72041","2014",4,4,0,125475,1176.25,102
"21852","72042","2014",15,15,0,89780,1131.933,78.86667
"21853","72043","2014",7,7,0,89285.71,1148,80.42857
"21854","72044","2014",2,2,0,114000,1103,121
"21855","72045","2014",5,5,0,165976,1416.8,123.8
"21856","72046","2014",25,25,0,105886,1234.24,90.28
"21857","72047","2014",3,3,0,90333.33,1299.333,68.33333
"21858","72048","2014",4,4,0,148325,1648.25,93.25
"21859","72049","2014",2,2,0,107500,1285.5,81
"21860","72050","2014",9,9,0,117277.8,857.1111,126.3333
"21861","72051","2014",31,30,1,128407.3,1310.806,103.4839
"21862","72052","2014",2,2,0,65000,952.5,69
"21863","72053","2014",11,11,0,96818.18,1232.455,83
"21864","72054","2014",20,19,1,148225.8,1510.65,99.5
"21865","72056","2014",7,7,0,216029.3,1612.429,137.5714
"21866","72057","2014",1,1,0,118000,1180,100
"21867","72058","2014",35,35,0,183352.9,2030.429,104.2857
"21868","72059","2014",8,8,0,116447.6,1126.625,105.75
"21869","72060","2014",4,4,0,66250,863.75,90.75
"21870","72061","2014",13,13,0,149080.8,1254.923,115.3077
"21871","72062","2014",8,8,0,116750,1419.875,79.25
"21872","72064","2014",6,6,0,97650,968.5,101.6667
"21873","72065","2014",18,17,1,152563.3,1756.5,89.38889
"21874","72066","2014",4,4,0,101330,1160.25,87
"21875","72067","2014",6,6,0,158166.7,1496.5,106.5
"21876","72068","2014",10,9,1,72110,974.7,74.1
"21877","72070","2014",5,5,0,62900,783.4,70
"21878","72071","2014",43,41,2,78095.35,989.5581,81.53488
"21879","72072","2014",1,1,0,110000,1028,107
"21880","72073","2014",1,1,0,110000,2037,54
"21881","72074","2014",2,2,0,35500,566.5,64.5
"21882","72075","2014",7,7,0,128248.1,1157.429,114.8571
"21883","72076","2014",2,2,0,145500,1607,91.5
"21884","72077","2014",5,5,0,112560,1124.4,95.8
"21885","72078","2014",3,3,0,76333.33,855.6667,88
"21886","72079","2014",3,3,0,51000,836.6667,60.33333
"21887","72080","2014",9,9,0,144333.3,1592.556,92.77778
"21888","72083","2014",2,2,0,98350,1251.5,80
"21889","72084","2014",13,13,0,108000,1041.154,104.4615
"21890","72085","2014",2,2,0,80000,712.5,114
"21891","72086","2014",1,1,0,157000,2093,75
"21892","72087","2014",3,3,0,60000,873,70.33333
"21893","72088","2014",1,1,0,77000,1013,76
"21894","72089","2014",19,19,0,85786.84,1148.842,75.31579
"21895","72090","2014",32,32,0,101425,1279.375,83.15625
"21896","72091","2014",3,3,0,164666.7,994.6667,159.3333
"21897","72093","2014",5,5,0,171950,1701.6,90.2
"21898","72094","2014",4,4,0,81250,1052,80.5
"21899","72095","2014",43,33,10,143343,1530.465,99.06977
"21900","72096","2014",1,1,0,142732,1322,108
"21901","72098","2014",7,7,0,83214.29,922.5714,92
"21902","72099","2014",6,6,0,142025,1373.5,110.6667
"21903","72100","2014",6,6,0,111941.7,1166.5,98.33333
"21904","72101","2014",6,6,0,173000,1272.5,105.8333
"21905","72102","2014",2,2,0,157500,1605,110
"21906","72103","2014",5,5,0,218000,1305,154.8
"21907","72104","2014",8,8,0,83868.75,1066.625,75.5
"21908","72105","2014",7,7,0,91285.71,1197.429,73.14286
"21909","72106","2014",4,4,0,214125,1725,125
"21910","72107","2014",3,3,0,59366.67,898.6667,65.66667
"21911","72109","2014",7,7,0,81353.57,782.8571,105
"21912","72110","2014",6,6,0,121333.3,1229.833,101
"21913","72111","2014",4,4,0,159625,1164.5,135.5
"21914","72112","2014",4,4,0,68375,984.5,77
"21915","72114","2014",2,2,0,202609,2233,92
"21916","72115","2014",5,5,0,85000,966.4,81
"21917","72118","2014",11,11,0,104713,1152.545,91.27273
"21918","72119","2014",8,8,0,142223.1,1527.25,102.375
"21919","72120","2014",2,2,0,49625,772,68
"21920","72121","2014",3,3,0,69166.67,879,71
"21921","72122","2014",5,5,0,138000,2000.2,82.6
"21922","72124","2014",41,38,3,107692.4,1248,87.2439
"21923","72125","2014",2,2,0,100950,915,110.5
"21924","72126","2014",4,4,0,132750,1409.25,95
"21925","72127","2014",9,9,0,151265.6,1617.889,97.33333
"21926","72128","2014",3,3,0,76500,1135.667,66.66667
"21927","72129","2014",4,4,0,124250,1228.5,104.75
"21928","72130","2014",3,3,0,161216.7,1516.667,112.3333
"21929","72131","2014",4,4,0,141750,1204.5,114.75
"21930","72132","2014",89,67,22,110772.5,1453.135,76.03371
"21931","72133","2014",9,9,0,179436.1,1630.444,113.4444
"21932","72134","2014",4,4,0,83750,899.25,87.5
"21933","72135","2014",5,5,0,112500,1249.8,88.8
"21934","72137","2014",14,14,0,115432.1,1215.214,98.92857
"21935","72138","2014",23,23,0,101308.7,1099.957,93.3913
"21936","72139","2014",10,10,0,139027.5,1025.9,127.5
"21937","72141","2014",7,7,0,113742.9,1194.714,104.4286
"21938","72142","2014",2,2,0,112702.5,1004,115.5
"21939","72143","2014",13,13,0,103615.4,1044.462,94.53846
"21940","72144","2014",12,12,0,96625,1265.583,81.33333
"21941","72145","2014",2,2,0,171500,1510.5,114.5
"21942","72146","2014",23,23,0,137089.1,1586.522,88.91304
"21943","72147","2014",9,9,0,120116.7,1365.667,88.77778
"21944","72148","2014",1,1,0,85000,1062,80
"21945","72149","2014",6,6,0,83410.33,994.8333,84
"21946","72150","2014",13,13,0,136527.7,1505.462,90.46154
"21947","72151","2014",4,4,0,137250,1462.5,92.5
"21948","72152","2014",2,2,0,95000,961,105
"21949","72153","2014",6,6,0,119916.7,1143.333,110.5
"21950","72154","2014",116,103,13,118468.6,1236.638,98.12931
"21951","72155","2014",14,14,0,166464.3,1640.714,104.5
"21952","72156","2014",10,10,0,148755,1302.9,117.4
"21953","72157","2014",3,3,0,144000,1671,86.33333
"21954","72158","2014",10,10,0,74950,1084.6,73.3
"21955","72160","2014",1,1,0,140000,1077,130
"21956","72161","2014",10,10,0,100100,1223.7,83.2
"21957","72163","2014",2,2,0,157000,1164,139
"21958","72165","2014",16,16,0,113445,1240.5,96.25
"21959","72166","2014",4,4,0,141500,1210.25,118.75
"21960","72167","2014",6,6,0,152375,1485.333,105.5
"21961","72168","2014",18,18,0,114672.2,1159.5,99.22222
"21962","72169","2014",6,6,0,135838.7,1398.167,98.83333
"21963","72170","2014",2,2,0,61550,1268.5,48.5
"21964","72171","2014",2,2,0,99000,828.5,116.5
"21965","72172","2014",14,14,0,100392.9,1259.857,84.5
"21966","72173","2014",16,16,0,114468.8,1101.75,107.5625
"21967","72174","2014",1,1,0,122000,1794,68
"21968","72175","2014",15,15,0,114355.3,1155.733,103.5333
"21969","72176","2014",30,30,0,82121.4,934.4667,88.46667
"21970","72177","2014",4,4,0,143000,1266.5,118.5
"21971","72178","2014",2,2,0,83036.5,1209.5,68.5
"21972","72179","2014",20,19,1,119185,1248.7,95.7
"21973","72180","2014",33,32,1,70189.39,883.9394,77.75758
"21974","72181","2014",1647,912,735,127405.6,1623.111,77.82271
"21975","72182","2014",15,15,0,110540.7,1224.733,94
"21976","72183","2014",7,7,0,112142.9,1135.429,95.57143
"21977","72184","2014",1,1,0,1e+05,1163,86
"21978","72185","2014",4,4,0,98500,805.5,134.25
"21979","72186","2014",8,8,0,92562.5,1074,83.625
"21980","72187","2014",15,15,0,116290.1,1163.333,100.8667
"21981","72189","2014",14,14,0,86478.57,1036.786,83.92857
"21982","72191","2014",26,26,0,107625.4,1150.731,104.3462
"21983","72192","2014",2,2,0,45000,459.5,99.5
"21984","72193","2014",9,9,0,72722.22,992.3333,73.33333
"21985","72194","2014",3,3,0,127633.3,1255.667,102
"21986","72195","2014",20,20,0,119126.4,1261.9,95.7
"21987","72196","2014",3,3,0,95100,1008,93.66667
"21988","72197","2014",9,9,0,109277.8,1384.667,106.7778
"21989","72198","2014",16,16,0,177890.6,1977.938,96.375
"21990","72199","2014",4,4,0,111750,1021.25,112.25
"21991","72200","2014",20,20,0,133450,1493.65,89.65
"21992","72201","2014",1,1,0,73000,1043,70
"21993","72202","2014",4,4,0,115875,1116.5,110
"21994","72204","2014",5,5,0,76317.6,735.8,93.2
"21995","72205","2014",15,15,0,102133.3,1228.933,84.46667
"21996","72208","2014",1,1,0,85000,944,90
"21997","72209","2014",3,3,0,99533.33,2065,68.33333
"21998","72210","2014",7,7,0,90142.86,1155.143,80.14286
"21999","72211","2014",9,9,0,73722.22,857.8889,91
"22000","72212","2014",11,11,0,80146.36,1025.909,76.09091
"22001","72213","2014",38,38,0,159453.6,1541.579,101.7895
"22002","72215","2014",10,10,0,105300,1207.9,88.3
"22003","72216","2014",7,7,0,140207.1,1396.714,100.8571
"22004","72217","2014",25,25,0,184159.6,1478.36,126.44
"22005","72218","2014",6,6,0,81666.67,945.6667,85.5
"22006","72219","2014",1,1,0,150000,1364,110
"22007","72220","2014",13,13,0,95670.31,974,99
"22008","72221","2014",2,2,0,74750,1023,73
"22009","72222","2014",3,3,0,138333.3,1609.667,84.33333
"22010","72223","2014",32,32,0,92351.56,1071.969,86.21875
"22011","72224","2014",8,8,0,104743.8,1100.25,94
"22012","72225","2014",6,6,0,162500,1284.333,127
"22013","72226","2014",8,8,0,151200,1246.625,123.375
"22014","72228","2014",17,17,0,122623.5,1229.294,104.9412
"22015","72229","2014",5,5,0,120600,1018.6,115.6
"22016","72230","2014",15,15,0,159470,1466.733,108.7333
"22017","72231","2014",39,39,0,156961.7,1557.692,103.5641
"22018","72232","2014",5,5,0,122022.2,1264.6,100.4
"22019","72234","2014",4,4,0,96500,804,114.5
"22020","72235","2014",2,2,0,57400,927,79.5
"22021","72236","2014",1,1,0,1e+05,1205,83
"22022","72237","2014",3,3,0,127585,1416.667,87
"22023","72238","2014",1,1,0,133700,874,153
"22024","72239","2014",3,3,0,102666.7,1072.333,94.66667
"22025","72241","2014",21,21,0,114661.9,1247.952,94.66667
"22026","72243","2014",7,7,0,121500,1023.714,116.2857
"22027","72244","2014",11,11,0,145616.6,1459.455,106
"22028","72245","2014",5,5,0,107720,1055.8,102.8
"22029","72246","2014",7,7,0,80928.57,1110,74.85714
"22030","72247","2014",8,8,0,174840.1,1474.625,124.75
"22031","72248","2014",3,3,0,92666.67,839.6667,99
"22032","72249","2014",3,3,0,188246.7,1449.333,132
"22033","72250","2014",2,2,0,57500,677,87
"22034","72251","2014",4,4,0,141100,1125.5,117
"22035","72252","2014",5,5,0,101200,1307.6,71.8
"22036","72253","2014",8,8,0,183983.1,1426.625,127.375
"22037","72254","2014",2,2,0,137500,1267,114
"22038","72255","2014",4,4,0,78125,1185.25,76.25
"22039","72256","2014",7,7,0,79928.57,899.1429,86
"22040","72257","2014",21,17,4,237586,2791.238,114.3333
"22041","72259","2014",2,2,0,120000,961.5,127.5
"22042","72260","2014",28,25,3,165352.5,1639.357,101.8214
"22043","72261","2014",4,4,0,102450,1382.25,70.75
"22044","72262","2014",21,21,0,79130.95,1011.667,77.33333
"22045","72264","2014",67,53,14,119799.9,1373.209,88.8806
"22046","72265","2014",5,5,0,176054.8,1253.2,126.2
"22047","72266","2014",3,3,0,121000,1088,103
"22048","72267","2014",12,12,0,152541.7,1198.75,127.3333
"22049","72268","2014",7,6,1,195671.4,1665.714,127
"22050","72269","2014",20,17,3,95513.3,1148.95,84.45
"22051","72270","2014",2,2,0,64734,779.5,99.5
"22052","72271","2014",5,5,0,100500,931.6,107.8
"22053","72272","2014",6,6,0,131083.3,1506.667,87.5
"22054","72273","2014",6,6,0,106583.3,1132.333,98
"22055","72274","2014",3,3,0,81000,1097,73.33333
"22056","72275","2014",9,9,0,130584.6,1427.889,94.11111
"22057","72276","2014",20,20,0,115276.6,1150.25,99.35
"22058","72277","2014",1,1,0,117000,1158,101
"22059","72278","2014",9,9,0,88493.89,996.6667,91.44444
"22060","72279","2014",1,1,0,104000,867,120
"22061","72280","2014",20,20,0,159021.4,1576.7,100.85
"22062","72281","2014",5,5,0,87201.8,1148.2,75
"22063","72282","2014",1,1,0,85000,1090,78
"22064","72283","2014",2,2,0,70000,1023,68.5
"22065","72286","2014",1,1,0,52000,1000,52
"22066","72287","2014",16,16,0,133789.2,1256.312,106.125
"22067","72289","2014",26,26,0,128481.9,1518.115,82.46154
"22068","72290","2014",12,12,0,117850,1315.333,97.66667
"22069","72291","2014",12,12,0,96104.17,1009.417,93.91667
"22070","72292","2014",2,2,0,133050,1168,112.5
"22071","72293","2014",2,2,0,87500,1703.5,57
"22072","72294","2014",7,7,0,63285.71,1104.429,60.42857
"22073","72295","2014",2,2,0,112500,878,123
"22074","72296","2014",3,3,0,128430,1139.667,112.3333
"22075","72297","2014",5,5,0,98820,1328.8,74
"22076","72298","2014",2,2,0,92000,1185.5,77.5
"22077","72299","2014",13,13,0,124723.9,1495.077,86.53846
"22078","72300","2014",16,16,0,111549.7,1494.438,75.1875
"22079","72302","2014",1,1,0,55000,1000,55
"22080","72303","2014",6,6,0,102468.3,1136.667,93
"22081","72305","2014",5,5,0,97100,1117.8,80
"22082","72306","2014",2,2,0,150500,1502,100.5
"22083","72307","2014",2,2,0,77500,768.5,102.5
"22084","72308","2014",15,15,0,112473.3,1168.333,97
"22085","72309","2014",6,6,0,97000,800.6667,126.8333
"22086","72310","2014",9,9,0,240592.6,1748.667,137
"22087","72311","2014",2,2,0,51500,862.5,59.5
"22088","72313","2014",4,4,0,89750,1122.25,79.75
"22089","72314","2014",2,2,0,35000,886,40
"22090","72315","2014",6,6,0,88050,1033.833,84.5
"22091","72316","2014",8,8,0,75000,850,87.125
"22092","72317","2014",8,8,0,68000,762.875,90.5
"22093","72319","2014",6,6,0,169533.3,1270.5,122.5
"22094","72320","2014",37,37,0,192214.4,1962.622,104.4054
"22095","72321","2014",2,2,0,47750,824,57
"22096","72322","2014",7,7,0,62785.71,1158.714,55.28571
"22097","72324","2014",4,4,0,100875,1240.75,81.5
"22098","72325","2014",5,5,0,124144,1293.6,96
"22099","72326","2014",1,1,0,149030,1050,142
"22100","72327","2014",4,4,0,96650,1023,86.75
"22101","72328","2014",23,23,0,165129,1766.522,97.82609
"22102","72329","2014",30,29,1,163102.5,1715.5,100.8
"22103","72330","2014",1,1,0,155000,1360,114
"22104","72331","2014",6,6,0,110833.3,1231.667,86
"22105","72332","2014",7,7,0,53489.86,562.2857,91.28571
"22106","72333","2014",9,9,0,94411.11,1020,93.77778
"22107","72334","2014",17,16,1,78588.24,963.2941,86.41176
"22108","72335","2014",14,14,0,133304.3,1371.5,97.35714
"22109","72336","2014",14,14,0,187177.1,1871.643,107.3571
"22110","72337","2014",4,4,0,123750,1312.75,94.25
"22111","72338","2014",4,4,0,155325,1299,140.25
"22112","72339","2014",1,1,0,164000,1139,144
"22113","72340","2014",9,9,0,116418.9,1246,94.77778
"22114","72341","2014",4,4,0,129000,1255.75,102.5
"22115","72342","2014",3,3,0,107000,1665.333,63.66667
"22116","72343","2014",3,3,0,133666.7,1409.333,93.66667
"22117","72344","2014",23,23,0,161286.5,1548.609,104.7391
"22118","72345","2014",3,3,0,110691.7,1402,77.66667
"22119","72346","2014",34,32,2,119967.1,1364.529,89.11765
"22120","72347","2014",3,3,0,67666.67,892,84.33333
"22121","72348","2014",1,1,0,160000,1404,114
"22122","72349","2014",7,7,0,97500.29,1299.429,76
"22123","72350","2014",14,14,0,160292.9,1651.714,99.28571
"22124","72351","2014",11,11,0,144454.5,1626.909,94.63636
"22125","72352","2014",2,2,0,105600,1462,75
"22126","72353","2014",4,4,0,62000,872.5,72.75
"22127","72355","2014",4,4,0,92427,988,87.75
"22128","72356","2014",2,2,0,77750,964.5,78.5
"22129","72357","2014",6,6,0,132666.7,1495.167,92.83333
"22130","72358","2014",10,10,0,104400,1401.7,78.4
"22131","72359","2014",15,15,0,128140,1228,102.7333
"22132","72361","2014",5,5,0,103323.2,1000.2,102.4
"22133","72362","2014",4,4,0,121250,1292.5,94.75
"22134","72363","2014",21,21,0,97367.62,1119.857,87.19048
"22135","72364","2014",16,16,0,74593.75,935.3125,81.8125
"22136","72366","2014",2,2,0,81000,1053.5,78
"22137","72367","2014",4,4,0,132087.5,1655,93
"22138","72368","2014",3,3,0,114666.7,1254,103.3333
"22139","72369","2014",10,10,0,67769.8,739.4,91.3
"22140","72370","2014",7,7,0,75500,1074.714,69
"22141","72373","2014",15,14,1,81040.53,907.0667,91.66667
"22142","72374","2014",3,3,0,50166.67,634.6667,79.33333
"22143","72375","2014",3,3,0,104050,1259.333,78.66667
"22144","72376","2014",7,7,0,97714.29,1151,81.85714
"22145","72377","2014",9,9,0,113777.8,1094.444,104.6667
"22146","72378","2014",8,8,0,95187.5,1115.875,85
"22147","72380","2014",10,10,0,76170,1136,74.3
"22148","72381","2014",9,9,0,182148.9,1476.667,119
"22149","72382","2014",7,6,1,93285.71,1012.571,93.28571
"22150","72383","2014",2,2,0,92000,1322,66.5
"22151","72385","2014",15,15,0,129750,1389.733,92.06667
"22152","72386","2014",36,36,0,195747.9,1934.611,102.0556
"22153","73001","2014",3,3,0,184566.7,2252.333,82
"22154","73003","2014",24,8,16,158054.4,2433.917,64.70833
"22155","73004","2014",10,2,8,69240,1732.2,40.4
"22156","73005","2014",2,1,1,36500,742.5,53
"22157","73006","2014",106,25,81,131766.1,2833.415,51.81132
"22158","73007","2014",7,6,1,95346,1195.429,84.71429
"22159","73008","2014",498,64,434,165062.3,2767.783,60.9739
"22160","73010","2014",44,30,14,208857.8,2413.795,88.88636
"22161","73011","2014",182,38,144,130427.9,1748.868,75.67582
"22162","73012","2014",1,1,0,1e+05,2326,43
"22163","73013","2014",12,7,5,141210.8,2683.167,62
"22164","73014","2014",1,1,0,188140,2294,82
"22165","73015","2014",122,14,108,466407.6,7412.467,59.58197
"22166","73017","2014",4,3,1,276647.5,2665.5,108.75
"22167","73018","2014",6,3,3,194215,2349.5,81.66667
"22168","73019","2014",7,7,0,162397.1,1467.143,100.2857
"22169","73020","2014",1,1,0,346500,3364,103
"22170","73021","2014",6,5,1,110260,1578.833,66.83333
"22171","73022","2014",5,5,0,223770,3328,88.6
"22172","73023","2014",18,1,17,110357.2,3015.667,42.27778
"22173","73024","2014",46,5,41,124357,3377.978,39.32609
"22174","73025","2014",4,4,0,137437.5,1309.25,102.75
"22175","73026","2014",5,2,3,147456.4,1845.2,78
"22176","73027","2014",5,5,0,281660,2018.8,142.6
"22177","73028","2014",7,7,0,158871.4,1533.286,106.5714
"22178","73029","2014",51,17,34,198010.2,2529.412,78.15686
"22179","73030","2014",21,11,10,238800.5,2906.905,83.19048
"22180","73031","2014",33,9,24,195499.8,2390.394,80.66667
"22181","73032","2014",11,9,2,183484.5,1994.182,106.2727
"22182","73033","2014",5,5,0,203874.4,1798,113
"22183","73034","2014",23,4,19,177991.5,3670.087,53.17391
"22184","73036","2014",3,3,0,393819,3032.333,127.6667
"22185","73039","2014",5,5,0,205000,1784.6,116
"22186","73040","2014",7,1,6,117548.6,3344.429,33.85714
"22187","73041","2014",1,1,0,179090,1846,97
"22188","73042","2014",2,2,0,247700,2193.5,111.5
"22189","73043","2014",17,12,5,240257.9,2466.647,106.4706
"22190","73047","2014",6,0,6,125067.5,3476.667,40
"22191","73048","2014",4,4,0,135450,1879.5,71.75
"22192","73049","2014",2,2,0,127000,1672,75.5
"22193","73050","2014",5,0,5,130560,1950.8,68
"22194","73051","2014",60,18,42,239962.7,3110.967,79.36667
"22195","73052","2014",5,5,0,147874,2508.8,72.8
"22196","73053","2014",4,4,0,187121,2173.5,88
"22197","73054","2014",321,15,306,137204,3368.302,40.54829
"22198","73055","2014",17,3,14,209399.6,3713.294,65.70588
"22199","73057","2014",25,2,23,105535.1,3292.72,33.76
"22200","73058","2014",11,8,3,142772.7,1378.727,111.2727
"22201","73059","2014",24,20,4,310404.6,3349.458,93.41667
"22202","73061","2014",1,1,0,217000,2583,84
"22203","73063","2014",3,3,0,138333.3,1598.667,77.66667
"22204","73064","2014",40,15,25,261490.4,2983.925,91.875
"22205","73065","2014",647,79,568,164212.7,2347.896,71.58887
"22206","73067","2014",3,1,2,72591.67,1311.333,65.33333
"22207","73068","2014",6,5,1,146757.5,2185.167,66.5
"22208","73069","2014",12,9,3,133320.8,1556.25,89.58333
"22209","73070","2014",3,3,0,99033.33,1275.667,83.33333
"22210","73071","2014",13,3,10,160610.4,3329.692,48.76923
"22211","73073","2014",7,7,0,157911.7,2040.571,83.85714
"22212","73074","2014",2,2,0,158500,1670.5,95
"22213","73075","2014",2,2,0,115000,1744,65.5
"22214","73076","2014",3,3,0,228666.7,2401.667,92.66667
"22215","73077","2014",4,2,2,206737.5,2765.75,72.5
"22216","73078","2014",1,1,0,191270,2174,88
"22217","73079","2014",5,5,0,201250,1505.6,149.8
"22218","73081","2014",10,9,1,191697,1761.2,122.9
"22219","73082","2014",5,4,1,269630,2430,109.2
"22220","73083","2014",3,3,0,125666.7,1553.333,78.33333
"22221","73084","2014",3,2,1,246811,2534,100.6667
"22222","73085","2014",12,7,5,159541.7,1757.833,89
"22223","73086","2014",3,3,0,201353,2282.333,89.66667
"22224","73087","2014",54,17,37,194766.8,2714.741,74.57407
"22225","73088","2014",17,3,14,149887.6,3460.176,42.05882
"22226","73089","2014",8,7,1,178561.2,1779.25,101.875
"22227","73091","2014",5,5,0,341500,4397.4,105
"22228","73092","2014",4,4,0,178608.8,2312.75,83.75
"22229","73094","2014",10,4,6,208686,3410.4,62.6
"22230","73096","2014",7,7,0,201212.9,2006.143,107
"22231","73097","2014",6,6,0,300753.3,2304.833,130.5
"22232","73098","2014",21,14,7,171874.8,2773.714,67.38095
"22233","73099","2014",3,2,1,160700,1941.333,81
"22234","73100","2014",11,11,0,163328.2,1518,113.3636
"22235","73101","2014",1,1,0,170900,1486,115
"22236","73103","2014",22,7,15,231658,2871.136,81.18182
"22237","73104","2014",4,4,0,167500,1744.5,95.75
"22238","73105","2014",12,7,5,118025,1518,72.91667
"22239","73106","2014",3,3,0,86533.33,969.6667,85.66667
"22240","73107","2014",7,7,0,132991.4,1368.857,100.1429
"22241","73109","2014",5,5,0,145340,1603.2,95.6
"22242","73110","2014",5,5,0,142460,1387.2,99
"22243","73114","2014",26,3,23,167149.5,3160.962,50.42308
"22244","73116","2014",43,9,34,117161.4,2879.326,40.44186
"22245","73117","2014",2,0,2,41310,714,66
"22246","73120","2014",6,6,0,101500,1487.333,69.83333
"22247","73121","2014",10,6,4,206889.2,2692,83.1
"22248","73122","2014",3,3,0,137666.7,1571,100
"22249","73123","2014",11,3,8,171627.3,2534.545,73.09091
"22250","73124","2014",29,15,14,180994.8,2158.138,87.13793
"22251","73128","2014",29,15,14,255986.1,2898.69,89.03448
"22252","73129","2014",19,14,5,157906.9,2044.526,82.68421
"22253","73130","2014",11,11,0,196046.9,1941.455,103.3636
"22254","73131","2014",3,3,0,103333.3,3048,43.66667
"22255","73132","2014",74,5,69,175963.3,4925.122,37.68919
"22256","73133","2014",2,1,1,95750,1425,67.5
"22257","73135","2014",10,8,2,153545,1815,82.9
"22258","73137","2014",39,9,30,193028.5,2694.744,71.71795
"22259","73138","2014",6,6,0,180070,3264.5,57.83333
"22260","73139","2014",3,3,0,154093.3,1292,128
"22261","73140","2014",1,1,0,93000,2583,36
"22262","73141","2014",6,6,0,206658.3,2141,99.16667
"22263","73142","2014",26,9,17,275601.8,4559.346,67.80769
"22264","73145","2014",8,6,2,143779.2,1765.875,90.25
"22265","73146","2014",6,6,0,227378.3,2180,106.1667
"22266","73147","2014",1,1,0,315000,1821,173
"22267","73149","2014",2,2,0,176475,1907,98
"22268","73150","2014",203,10,193,128235,3376.729,39.10837
"22269","73151","2014",25,12,13,218939.1,2902.76,76.28
"22270","73152","2014",3,3,0,207183.3,2603,92.66667
"22271","73153","2014",9,9,0,172526.9,1899.333,90
"22272","73154","2014",33,15,18,205549.8,2127.545,93.24242
"22273","73155","2014",14,9,5,209963,2352.071,90.28571
"22274","73156","2014",1,1,0,211550,1763,120
"22275","73157","2014",56,8,48,76974.79,1704.518,48.25
"22276","73159","2014",3,3,0,201906.7,1811.333,112.3333
"22277","73161","2014",3,2,1,229227,2331.667,106.3333
"22278","73162","2014",5,5,0,182430,2131.4,87.4
"22279","73164","2014",7,7,0,261134.3,3438.857,85
"22280","73166","2014",1,1,0,1e+05,1250,80
"22281","73168","2014",2,2,0,151300,1491.5,90.5
"22282","73170","2014",3,3,0,268500,2539.667,104.3333
"22283","73171","2014",25,4,21,129293.8,1853.4,69.64
"22284","73173","2014",2,2,0,77500,1087,66.5
"22285","73175","2014",2,2,0,90800,3510,32.5
"22286","73176","2014",70,8,62,158407.3,3737.871,41.18571
"22287","73178","2014",4,4,0,202348.8,1965,109.75
"22288","73179","2014",96,29,67,208378.9,2619.833,80.625
"22289","73180","2014",2,2,0,107000,2407,43
"22290","73181","2014",28,3,25,102982.1,1673.107,63.71429
"22291","73182","2014",26,8,18,251290.8,2959.846,85.38462
"22292","73183","2014",13,7,6,241007.7,2692.308,94.07692
"22293","73184","2014",4,4,0,242955,2807.5,92.25
"22294","73186","2014",27,4,23,150465.9,3723.63,41.66667
"22295","73187","2014",16,9,7,146824.2,2607.062,58
"22296","73188","2014",10,9,1,185025,2136.3,88.6
"22297","73189","2014",2,2,0,227087.5,2131.5,109.5
"22298","73190","2014",2,0,2,46565,1862.5,25
"22299","73191","2014",17,12,5,168248.2,2079.941,80.94118
"22300","73192","2014",2,2,0,209400,1969.5,104
"22301","73193","2014",1,1,0,144890,3220,45
"22302","73194","2014",14,3,11,87230.86,2300.429,41.78571
"22303","73196","2014",9,8,1,240093.7,2403.333,96
"22304","73197","2014",19,4,15,159598.2,3444.211,47.57895
"22305","73200","2014",2,2,0,248125,2833,87.5
"22306","73201","2014",6,4,2,177274.8,2149.833,87.5
"22307","73202","2014",3,2,1,162333.3,1771.667,91
"22308","73204","2014",14,9,5,153418.9,1581.5,95.21429
"22309","73205","2014",2,2,0,69700,1770,45
"22310","73206","2014",34,5,29,146583.6,3561.441,40.32353
"22311","73207","2014",6,6,0,161991.7,2179.833,77.5
"22312","73208","2014",7,7,0,335132.9,2841.429,125
"22313","73210","2014",3,3,0,273166.7,2153,129.3333
"22314","73211","2014",7,6,1,193151.1,2756.714,73.85714
"22315","73212","2014",18,13,5,166224.2,1884,94.83333
"22316","73213","2014",67,22,45,230466.4,2707.821,85.31343
"22317","73215","2014",3,3,0,188066.7,1666.333,117
"22318","73216","2014",5,5,0,135000,1835.4,76.6
"22319","73217","2014",1,1,0,127000,1270,100
"22320","73218","2014",6,4,2,221225,2128.333,101.5
"22321","73219","2014",7,7,0,176545.7,1953.571,89.14286
"22322","73220","2014",4,4,0,103147.5,1292.75,74
"22323","73221","2014",2,2,0,140000,3068,46
"22324","73222","2014",48,32,16,236716.1,2728.312,91.47917
"22325","73223","2014",3,3,0,96930,1081.333,86.33333
"22326","73224","2014",1,1,0,92200,1537,60
"22327","73225","2014",20,12,8,255070.2,2752.55,96.4
"22328","73226","2014",10,9,1,181990,1684.5,109.2
"22329","73227","2014",109,21,88,424597.1,6933.972,60.3945
"22330","73228","2014",1,0,1,120000,1846,65
"22331","73229","2014",4,4,0,190825,1790.5,112.75
"22332","73230","2014",2,1,1,90000,1925.5,44.5
"22333","73231","2014",5,5,0,107200,1653.4,62.4
"22334","73232","2014",28,10,18,414810.2,4278.857,87.75
"22335","73233","2014",1,1,0,210000,2308,91
"22336","73234","2014",2,2,0,207960,1475.5,168.5
"22337","73235","2014",40,5,35,99762.3,2667.675,37.975
"22338","73236","2014",24,23,1,163718.8,1629.458,100.375
"22339","73237","2014",9,7,2,96368.22,1351.444,71.33333
"22340","73240","2014",4,3,1,217250,2056.75,103.75
"22341","73241","2014",6,6,0,167916.7,1887.5,93.33333
"22342","73242","2014",10,3,7,109880,2904.3,42.9
"22343","73243","2014",18,10,8,269101.4,2802,95.66667
"22344","73245","2014",3,3,0,135601.7,1919,78
"22345","73246","2014",1,1,0,212000,1683,126
"22346","73247","2014",9,9,0,218800.1,1947.667,118.7778
"22347","73248","2014",39,3,36,125322.4,1707.026,76.23077
"22348","73249","2014",15,5,10,197223.4,2702,76.73333
"22349","73250","2014",13,5,8,121667.7,1294.231,92
"22350","73252","2014",2,2,0,179500,1738,106
"22351","73253","2014",9,6,3,133065.3,1706,81.11111
"22352","73254","2014",1,1,0,227500,2275,100
"22353","73255","2014",5,5,0,69240,894.6,64.2
"22354","73256","2014",1,0,1,48000,1067,45
"22355","73257","2014",345,17,328,145945.8,4018.275,33.81159
"22356","73259","2014",4,3,1,187575,1785.25,113.25
"22357","73261","2014",17,13,4,114460.6,1251.412,88.82353
"22358","73262","2014",6,6,0,291320.7,2529.5,120.8333
"22359","73263","2014",8,6,2,276856.9,2254.375,123.5
"22360","73265","2014",5,4,1,181250,1718.6,110.4
"22361","73267","2014",5,4,1,80700,2270.8,39.4
"22362","73268","2014",4,4,0,59125,892.75,67.25
"22363","73269","2014",2,2,0,201150,2339,85.5
"22364","73270","2014",21,18,3,149385.5,1855.381,83.47619
"22365","73271","2014",5,5,0,244706,2346.6,113
"22366","73272","2014",3,3,0,127550,1395.333,91
"22367","73273","2014",3,1,2,147266.7,2376.333,60.33333
"22368","73274","2014",8,8,0,116698.8,1667.75,71.625
"22369","73275","2014",2,2,0,202500,2644,83.5
"22370","73276","2014",5,5,0,125880,1590.6,76
"22371","73278","2014",12,11,1,140206.7,1882.25,73.91667
"22372","73280","2014",19,0,19,108327.3,3100.895,34.89474
"22373","73281","2014",5,5,0,358560,3196.4,111
"22374","73282","2014",9,8,1,168416.7,2082.222,83.22222
"22375","73283","2014",4,4,0,179393.8,1429.25,125
"22376","73284","2014",10,5,5,149259,1846.3,86.2
"22377","73285","2014",25,8,17,174681.6,2247.24,78.76
"22378","73286","2014",7,6,1,202810.7,1834.286,104
"22379","73288","2014",9,6,3,287477.8,2815.111,101.1111
"22380","73289","2014",4,4,0,111891.2,1439.5,80
"22381","73290","2014",43,10,33,178570.6,3273.884,59.48837
"22382","73292","2014",7,7,0,105258.3,1644,68.85714
"22383","73293","2014",2,2,0,54081,876.5,63.5
"22384","73294","2014",3,3,0,224903.3,1731.333,132.6667
"22385","73296","2014",114,1,113,166505.3,4146.456,36.7807
"22386","73297","2014",8,7,1,265818.8,2174,121.375
"22387","73298","2014",6,6,0,178975,2010.333,89.66667
"22388","73299","2014",1,1,0,120000,1379,87
"22389","73300","2014",33,16,17,340760.3,3459.727,102.1212
"22390","73301","2014",7,6,1,310827.9,2475.571,128.4286
"22391","73302","2014",4,4,0,227270,1957.75,122.25
"22392","73303","2014",37,14,23,128877.6,1639.973,81.59459
"22393","73304","2014",92,0,92,317873.7,6973.326,45.75
"22394","73306","2014",60,0,60,177460.6,4091.617,45.81667
"22395","73307","2014",48,2,46,92525.69,2675.417,35.0625
"22396","73308","2014",1,0,1,76000,1118,68
"22397","73309","2014",3,3,0,164436.7,1827,90
"22398","73310","2014",3,3,0,247666.7,3156.333,88.66667
"22399","73312","2014",5,5,0,209780,2640,81.4
"22400","73313","2014",1,1,0,178000,1874,95
"22401","73315","2014",3,3,0,124056,1290,93
"22402","73316","2014",5,3,2,152950,1515.8,105.8
"22403","73317","2014",23,6,17,262507,4499.217,67.56522
"22404","73318","2014",84,2,82,50840.52,1888.702,26.72619
"22405","73320","2014",6,4,2,178758.3,2000,93.16667
"22406","73322","2014",35,7,28,104485.3,2171.943,58.48571
"22407","73323","2014",3,3,0,452333.3,3841,121
"22408","73326","2014",15,12,3,301590.7,2860.867,116.8667
"22409","73327","2014",3,3,0,120666.7,1576,82
"22410","73328","2014",18,8,10,211922.8,2681.778,83.16667
"22411","73329","2014",10,6,4,251747.7,3068.3,86.7
"22412","73330","2014",21,10,11,130206.7,1856.381,68.61905
"22413","74001","2014",37,16,21,161465.3,2817.432,58.16216
"22414","74002","2014",24,14,10,218044.4,2565.292,85.83333
"22415","74003","2014",9,6,3,274023.9,3138.667,99.44444
"22416","74004","2014",5,5,0,148786,2367.6,68.2
"22417","74005","2014",33,22,11,290039.1,3099.576,97.18182
"22418","74006","2014",21,8,13,282250.7,3896.095,75.7619
"22419","74007","2014",15,9,6,324120.2,3259.267,99.33333
"22420","74008","2014",46,7,39,234121.2,3506.826,65.26087
"22421","74009","2014",5,4,1,373280,4162.2,89.6
"22422","74010","2014",1407,133,1274,256810.2,3669.382,70.73063
"22423","74012","2014",312,20,292,195491.7,3051.881,64.15705
"22424","74013","2014",22,19,3,405638.6,3735.455,105.6818
"22425","74014","2014",149,16,133,184816.5,3894.221,45.15436
"22426","74015","2014",8,7,1,295942.5,3642.625,87
"22427","74016","2014",23,8,15,415883,4108.087,105.6087
"22428","74018","2014",10,7,3,283020,3018.4,99.5
"22429","74019","2014",26,8,18,341917.3,3690.038,89.42308
"22430","74020","2014",11,7,4,330990.9,2976.727,108.4545
"22431","74021","2014",22,13,9,285466.6,3199.818,100
"22432","74024","2014",12,9,3,251370,2849.417,88.75
"22433","74025","2014",8,8,0,270337.5,3480.875,78.25
"22434","74026","2014",46,15,31,249726.9,3170,80.5
"22435","74027","2014",1,1,0,332350,2702,123
"22436","74029","2014",5,5,0,124760,2028,69.8
"22437","74030","2014",1,1,0,341100,2915,117
"22438","74031","2014",21,11,10,429947.1,4136.571,102.0952
"22439","74032","2014",29,5,24,83195.69,2256.828,35.51724
"22440","74033","2014",33,13,20,147532.1,2689.697,57.66667
"22441","74034","2014",12,6,6,180263.3,2988.417,54.41667
"22442","74035","2014",2,2,0,334617.5,3653,99.5
"22443","74036","2014",2,1,1,402625,7487.5,52
"22444","74037","2014",14,9,5,297250.9,3002.143,105.1429
"22445","74038","2014",13,7,6,161386.2,2507.308,60.07692
"22446","74040","2014",29,16,13,298036.5,3678.034,84.34483
"22447","74041","2014",2,2,0,205000,3312.5,64
"22448","74042","2014",113,52,61,202206.1,2594.681,81.39823
"22449","74043","2014",37,23,14,276259.7,3334.622,85.51351
"22450","74044","2014",13,7,6,448247.3,3915.538,112.3077
"22451","74045","2014",6,5,1,185331.7,2438.167,85.83333
"22452","74046","2014",1,1,0,2e+05,2083,96
"22453","74048","2014",2,2,0,311290,2910.5,107.5
"22454","74049","2014",8,8,0,149952.5,2075.5,76.75
"22455","74050","2014",5,5,0,320320,3446,94
"22456","74052","2014",7,7,0,428102.1,3528.571,125.7143
"22457","74053","2014",4,4,0,304250,2950.25,105.5
"22458","74054","2014",6,6,0,346158.3,3046.333,118.6667
"22459","74055","2014",9,8,1,182555.6,2046,84
"22460","74056","2014",309,52,257,396494.6,6095.382,58.40777
"22461","74057","2014",9,9,0,287672.2,3334.111,86.44444
"22462","74058","2014",22,3,19,173190.5,3782.682,43.54545
"22463","74059","2014",2,2,0,235000,2313,106
"22464","74061","2014",2,1,1,358328,3740,99.5
"22465","74062","2014",14,7,7,274942.2,3039.071,96.28571
"22466","74063","2014",83,3,80,155852.6,4008.024,37.6506
"22467","74064","2014",12,10,2,280553.8,2607.25,115.75
"22468","74065","2014",4,4,0,465700,2850.5,165
"22469","74066","2014",1,1,0,534120,4273,125
"22470","74068","2014",3,2,1,454000,5306.333,103.3333
"22471","74069","2014",9,5,4,348866.7,3672.444,98.66667
"22472","74070","2014",19,8,11,393224.9,4076.947,89.89474
"22473","74072","2014",2,2,0,219200,2116,110
"22474","74073","2014",4,4,0,294250,3739,82.5
"22475","74074","2014",5,4,1,418940,3090.8,120.6
"22476","74075","2014",10,9,1,337293.5,3301.8,106.5
"22477","74076","2014",8,7,1,341925.6,3171.5,109.625
"22478","74077","2014",3,3,0,263666.7,2459.333,115.6667
"22479","74078","2014",4,3,1,230412.5,3112.75,91
"22480","74079","2014",5,5,0,319950,3810,89.4
"22481","74080","2014",65,11,54,358498.5,6320.031,55.53846
"22482","74081","2014",169,32,137,146884.7,1971.266,74.47337
"22483","74082","2014",46,13,33,291495.2,4027.652,69.34783
"22484","74083","2014",50,14,36,371020.1,4532.3,71.24
"22485","74085","2014",61,9,52,183478.9,3649.754,52.88525
"22486","74086","2014",3,3,0,299633.3,3556.333,89
"22487","74087","2014",15,10,5,300225.7,3699.333,84.66667
"22488","74088","2014",11,7,4,287191.1,3415.455,85.72727
"22489","74089","2014",20,6,14,426970.8,3921.35,92
"22490","74090","2014",11,6,5,313652.3,3567.455,88.54545
"22491","74091","2014",6,3,3,173153.3,3153.333,49
"22492","74094","2014",39,21,18,336861.6,3875.949,89.89744
"22493","74095","2014",5,5,0,263880,2299.4,118
"22494","74096","2014",38,17,21,302466.9,3346.289,94.86842
"22495","74097","2014",10,8,2,311780,2734.9,116.9
"22496","74098","2014",6,5,1,567775,3891.5,144.5
"22497","74099","2014",34,8,26,534766.9,5713.294,69.52941
"22498","74100","2014",6,6,0,173500,2287.5,81.83333
"22499","74101","2014",3,3,0,424666.7,3087,140.3333
"22500","74102","2014",7,4,3,258821.4,3535.429,73.85714
"22501","74103","2014",12,10,2,361699.2,3505.75,101.25
"22502","74104","2014",30,22,8,296251,3070.467,101.2667
"22503","74105","2014",77,29,48,270224.7,3517.857,78.90909
"22504","74106","2014",7,6,1,301000,2989.143,101.7143
"22505","74108","2014",12,6,6,321002.5,3821.75,87
"22506","74109","2014",3,3,0,257500,3234.333,80.33333
"22507","74111","2014",3,2,1,134666.7,2526,58.33333
"22508","74112","2014",59,13,46,288519.2,3446.102,84.84746
"22509","74114","2014",5,4,1,396308,3676,112.8
"22510","74116","2014",8,7,1,280287.5,2837.625,103.625
"22511","74118","2014",28,7,21,240949.3,3642.179,65.71429
"22512","74119","2014",142,15,127,218931.1,3427.268,65.11972
"22513","74121","2014",5,5,0,394100,3356.6,135
"22514","74122","2014",1,1,0,475000,3146,151
"22515","74123","2014",66,35,31,188907.4,2400.788,81.78788
"22516","74124","2014",11,8,3,444213.8,4877.364,90.72727
"22517","74126","2014",9,9,0,272891.7,2638.333,108.4444
"22518","74127","2014",8,8,0,279757.5,3053.625,93.875
"22519","74128","2014",27,19,8,292649.3,3315.074,88.77778
"22520","74129","2014",1,1,0,1e+05,909,110
"22521","74130","2014",3,3,0,218300,2630,88
"22522","74131","2014",18,11,7,214601.1,2529.222,83.88889
"22523","74133","2014",140,21,119,194122.7,3133.586,59.54286
"22524","74134","2014",94,25,69,350363.8,5283.053,68.01064
"22525","74135","2014",7,1,6,123904.3,1945.571,72.42857
"22526","74136","2014",73,12,61,229688,4482.164,51.06849
"22527","74137","2014",24,16,8,334341.9,3372.625,104.375
"22528","74138","2014",18,5,13,239202.3,2971.111,80.16667
"22529","74139","2014",7,7,0,197154.3,2425.857,89.42857
"22530","74140","2014",25,9,16,157165.7,2480.08,58.16
"22531","74141","2014",6,4,2,251991.7,2615.167,96.66667
"22532","74142","2014",8,5,3,273091.2,2328.75,118
"22533","74143","2014",108,33,75,276719.8,4524.083,62.71296
"22534","74144","2014",3,1,2,321100,4024.667,80.66667
"22535","74145","2014",3,2,1,394166.7,2774,139.6667
"22536","74146","2014",11,8,3,290704.5,2907.727,110
"22537","74147","2014",10,5,5,220259,2894.5,74.3
"22538","74148","2014",5,4,1,252978,1999.4,116
"22539","74150","2014",10,8,2,417686.8,3869.8,113.6
"22540","74151","2014",6,6,0,242275,2581.333,92.5
"22541","74152","2014",12,7,5,304620.8,3151.5,92.25
"22542","74153","2014",19,11,8,311931.6,3491.789,90.63158
"22543","74154","2014",22,15,7,295100,3117.955,96.86364
"22544","74155","2014",10,10,0,212060.5,2299.8,90.2
"22545","74156","2014",1,1,0,415800,3436,121
"22546","74157","2014",7,6,1,307586,2920.429,108.5714
"22547","74158","2014",14,10,4,257562.9,2742.071,95.64286
"22548","74159","2014",29,19,10,195803.6,2539.31,80.48276
"22549","74160","2014",40,7,33,202056.4,4241.975,44.35
"22550","74161","2014",12,10,2,307613.9,2844.417,107
"22551","74162","2014",8,3,5,387005.4,3568.375,123.5
"22552","74163","2014",25,21,4,270074,3059.64,89.32
"22553","74164","2014",59,27,32,176719.4,2622.576,71.13559
"22554","74165","2014",3,3,0,298775,2740,104
"22555","74166","2014",8,5,3,303942,3901.875,95
"22556","74167","2014",7,5,2,194255.7,1793.571,107.1429
"22557","74168","2014",3,3,0,308166.7,3071.667,101
"22558","74169","2014",47,19,28,198525.6,2186.745,89.46809
"22559","74170","2014",1,1,0,216600,2145,101
"22560","74171","2014",12,12,0,341128.6,3785,89
"22561","74172","2014",18,11,7,268128.8,3255.056,84.44444
"22562","74173","2014",131,12,119,486965.3,7287.366,61.24427
"22563","74174","2014",6,6,0,251241.7,2713.333,95.66667
"22564","74175","2014",4,4,0,701500,4391,151.75
"22565","74176","2014",18,11,7,560384.9,4308.5,126.0556
"22566","74177","2014",8,7,1,285241.2,2219.625,122.125
"22567","74178","2014",8,7,1,264600,2546.75,107.25
"22568","74179","2014",7,5,2,295596.3,2882,109.8571
"22569","74180","2014",21,18,3,556011.2,4000.429,134
"22570","74183","2014",30,12,18,161461.6,2890.433,59.93333
"22571","74184","2014",4,2,2,176625,1846.5,107.75
"22572","74185","2014",15,11,4,257644.2,2991.933,101.3333
"22573","74186","2014",3,2,1,320333.3,2860.667,111.6667
"22574","74188","2014",25,17,8,465018.9,4666.16,92.28
"22575","74189","2014",25,8,17,133599.6,2372.68,61.2
"22576","74190","2014",52,7,45,141959.9,3501.385,40.71154
"22577","74191","2014",248,22,226,227562.6,5048.718,44.79839
"22578","74192","2014",8,8,0,306058.8,2564.75,109.75
"22579","74193","2014",9,6,3,308910,4039.333,81.33333
"22580","74194","2014",2,2,0,362200,3240,112
"22581","74195","2014",1,1,0,320000,3404,94
"22582","74196","2014",6,4,2,155333.3,1660.5,108.1667
"22583","74197","2014",6,4,2,244136.7,4440,67.5
"22584","74198","2014",5,3,2,334248,3350.6,99.8
"22585","74199","2014",11,5,6,652570,6136.636,98.63636
"22586","74200","2014",33,23,10,449430.2,4057.152,107.8182
"22587","74201","2014",12,9,3,528392.4,4990.333,106.4167
"22588","74202","2014",4,3,1,201783.5,2635.25,80.5
"22589","74205","2014",32,12,20,121474,2468.031,47.375
"22590","74206","2014",5,2,3,187600,2622.6,72
"22591","74208","2014",123,53,70,215438.1,2927.545,74.56098
"22592","74209","2014",6,6,0,311583.3,3611.5,92.16667
"22593","74210","2014",12,8,4,254355.8,2857.417,90.16667
"22594","74211","2014",20,15,5,321688.1,3117.3,104.45
"22595","74212","2014",12,11,1,186659.6,2602.25,71.33333
"22596","74213","2014",60,18,42,313085.4,3738.7,81.98333
"22597","74215","2014",65,5,60,230375.6,4233.738,49.75385
"22598","74216","2014",4,3,1,255295.2,2818.5,86.25
"22599","74218","2014",82,41,41,303906.9,3504.951,86.32927
"22600","74219","2014",7,7,0,452966.6,3266.571,138.7143
"22601","74220","2014",56,21,35,279290.7,3347.679,86.14286
"22602","74221","2014",2,2,0,192500,1327,144.5
"22603","74222","2014",8,5,3,208293.8,2478,91.25
"22604","74223","2014",5,5,0,274600,3623.4,82.8
"22605","74224","2014",106,28,78,249207.9,3045.594,81.41509
"22606","74225","2014",190,60,130,170741.5,2293.589,76.68947
"22607","74226","2014",5,5,0,290156,3578.4,89.2
"22608","74228","2014",5,4,1,264289,3226.2,79.8
"22609","74229","2014",23,18,5,335024.9,3346.652,100.913
"22610","74231","2014",4,4,0,260762.5,3393.5,92.25
"22611","74232","2014",8,5,3,189014.8,2357.375,76.25
"22612","74233","2014",12,7,5,208487.5,2369.417,91
"22613","74234","2014",9,6,3,214010.6,2179.222,97.66667
"22614","74235","2014",6,5,1,302701.7,2601.167,118.8333
"22615","74236","2014",208,45,163,206211.5,3674.562,55.13942
"22616","74237","2014",18,6,12,233750.3,3061.056,72
"22617","74238","2014",54,16,38,200916.6,3236.352,63.22222
"22618","74239","2014",30,12,18,271801.4,4646.833,58.26667
"22619","74240","2014",9,8,1,225377.8,2404.444,97.33333
"22620","74241","2014",49,24,25,159264.8,2211.388,71.08163
"22621","74242","2014",49,30,19,348978.9,3770.633,92.42857
"22622","74243","2014",140,14,126,261809.9,3747.629,67.27857
"22623","74244","2014",5,3,2,319935.8,2673.8,120
"22624","74249","2014",29,25,4,259072.8,2864.31,99.82759
"22625","74250","2014",56,26,30,209925.4,2597.161,81.89286
"22626","74252","2014",8,8,0,358254.5,2878.875,136.125
"22627","74253","2014",8,8,0,301334.4,3428.375,93.75
"22628","74254","2014",3,3,0,258766.7,2854.333,81
"22629","74255","2014",13,9,4,247003.2,2304.846,113.4615
"22630","74256","2014",199,32,167,184333.2,2813.774,67.80402
"22631","74257","2014",8,3,5,197966.2,2671.875,72.125
"22632","74258","2014",86,19,67,192847.5,3949.756,47.05814
"22633","74259","2014",5,5,0,224140,3162.4,68.6
"22634","74260","2014",5,4,1,304540,3448.2,103.8
"22635","74261","2014",3,3,0,210333.3,2439.333,86.33333
"22636","74262","2014",10,4,6,287329.1,3165.7,89.5
"22637","74263","2014",63,47,16,305790.7,3630.333,87.30159
"22638","74264","2014",66,22,44,174878.4,2279.424,79.27273
"22639","74265","2014",6,4,2,198615,2163.833,93.5
"22640","74266","2014",9,4,5,306903.9,3949.222,77.55556
"22641","74267","2014",42,19,23,399075.7,4278.667,87.57143
"22642","74269","2014",20,13,7,175467.2,2290.75,79.55
"22643","74271","2014",7,7,0,278664.3,3296.143,103.2857
"22644","74272","2014",38,22,16,276601.2,3659.605,83.15789
"22645","74273","2014",8,6,2,167187.5,2357,83.125
"22646","74275","2014",28,10,18,387596.4,4606.071,79.57143
"22647","74276","2014",65,13,52,144582.4,2638.138,56.73846
"22648","74278","2014",45,20,25,224972.8,2730.578,82.62222
"22649","74279","2014",39,8,31,107014.3,2606.462,41.28205
"22650","74280","2014",65,25,40,241326.1,3569.185,71.67692
"22651","74281","2014",399,66,333,216461.9,3016.464,70.97494
"22652","74282","2014",63,48,15,313859.7,3252.159,97.52381
"22653","74283","2014",6,5,1,268141.5,2769.167,95.66667
"22654","74284","2014",12,8,4,250153.2,2477.333,103
"22655","74285","2014",2,2,0,226500,2075,111
"22656","74286","2014",12,9,3,180148.3,3160.417,66.83333
"22657","74287","2014",4,4,0,157000,2035.5,75
"22658","74288","2014",49,21,28,313337.2,3546.714,91.06122
"22659","74289","2014",14,8,6,200618.6,2645.714,83.64286
"22660","74290","2014",6,2,4,256200,4444.333,52.5
"22661","74291","2014",4,4,0,143725,2251.75,84.5
"22662","74292","2014",7,7,0,327303.7,2812.714,119.5714
"22663","74293","2014",35,19,16,393823.2,4255.857,94.25714
"22664","74294","2014",18,12,6,327188.3,4583.222,78.83333
"22665","74295","2014",2,2,0,232650,2928.5,78
"22666","74296","2014",10,7,3,381035.6,3652.6,112.1
"22667","74297","2014",10,9,1,213805.1,2090,105.9
"22668","74298","2014",63,27,36,322185.2,3667.619,87.46032
"22669","74299","2014",28,15,13,612721.4,5601.5,114.5357
"22670","74301","2014",5,3,2,175714,3388.6,55.8
"22671","74302","2014",9,6,3,221514.4,3588.333,61.33333
"22672","74303","2014",25,9,16,324169.6,3981,83
"22673","74304","2014",5,2,3,241770,2521.8,96.2
"22674","74305","2014",67,22,45,275073.3,3587.881,75.0597
"22675","74306","2014",1,1,0,3e+05,3659,82
"22676","74307","2014",5,3,2,363964.6,2975.6,122
"22677","74308","2014",4,4,0,287375,2851.25,107.5
"22678","74309","2014",27,14,13,302500.7,3317.222,90.7037
"22679","74310","2014",8,5,3,307160,3508.625,85.25
"22680","74311","2014",42,20,22,233735.3,2823.952,85.04762
"22681","74312","2014",10,7,3,244510,2638.6,94.8
"22682","74313","2014",2,2,0,283500,3754,65
"22683","74314","2014",12,10,2,302864.2,3799.167,90.5
"22684","74315","2014",10,7,3,331810,4097.1,89
"22685","75056","2014",24693,95,24598,434432,8079.005,53.21589
"22686","76001","2014",12,12,0,173136.7,1690.75,105.75
"22687","76002","2014",5,5,0,154440,1478.2,108.2
"22688","76004","2014",2,2,0,145150,1570.5,92.5
"22689","76005","2014",29,28,1,173741.4,1944.241,92.17241
"22690","76006","2014",2,2,0,217500,1701,130
"22691","76007","2014",7,7,0,132457.1,1623.429,82.85714
"22692","76008","2014",7,7,0,184314.3,1559.714,121.4286
"22693","76009","2014",3,3,0,120333.3,1416,88.33333
"22694","76010","2014",2,2,0,167800,2218.5,77.5
"22695","76012","2014",4,4,0,184750,1660.25,112.5
"22696","76013","2014",10,10,0,155172.7,1649,96.9
"22697","76014","2014",9,9,0,183762.2,1982.778,94.77778
"22698","76017","2014",8,8,0,198990.6,2072.375,106.125
"22699","76018","2014",10,10,0,105005,1140.2,95
"22700","76019","2014",1,1,0,93500,1558,60
"22701","76020","2014",7,7,0,147221.4,1744.571,87.71429
"22702","76021","2014",4,4,0,150450,1727.75,93
"22703","76022","2014",2,2,0,153000,1420,114
"22704","76023","2014",3,3,0,111333.3,1244.667,93
"22705","76024","2014",1,1,0,219700,1427,154
"22706","76025","2014",4,4,0,78775,1146.5,76.25
"22707","76026","2014",24,23,1,118015.8,1518.5,79.66667
"22708","76028","2014",1,1,0,126000,1260,100
"22709","76029","2014",3,3,0,98000,898.3333,110.3333
"22710","76030","2014",5,5,0,120400,1253.2,101
"22711","76033","2014",4,4,0,172625,2071.5,83.5
"22712","76034","2014",13,12,1,158853.8,1600.308,105.9231
"22713","76035","2014",13,11,2,111730.8,1154.231,102.2308
"22714","76036","2014",6,6,0,146937,1667.833,96.16667
"22715","76038","2014",5,5,0,228900,1697.6,135.2
"22716","76039","2014",16,16,0,224606.2,1773,133.9375
"22717","76040","2014",1,1,0,90000,1216,74
"22718","76041","2014",9,9,0,185877.8,1576.778,121.1111
"22719","76043","2014",8,8,0,190450,2040.125,96.75
"22720","76045","2014",2,2,0,197000,1894.5,104.5
"22721","76046","2014",1,1,0,165000,1875,88
"22722","76047","2014",2,2,0,132500,1576.5,83.5
"22723","76048","2014",3,3,0,96316.67,905.6667,105.6667
"22724","76049","2014",5,5,0,70050,959.8,66.8
"22725","76050","2014",8,8,0,120250,1339.125,91.125
"22726","76051","2014",13,13,0,126274.6,1403.846,94.92308
"22727","76052","2014",2,2,0,95000,1253,82.5
"22728","76054","2014",9,9,0,169888.9,1455.111,102.1111
"22729","76055","2014",2,2,0,204900,1519.5,136.5
"22730","76056","2014",11,11,0,146772.7,1546.636,96.63636
"22731","76057","2014",75,71,4,152588.2,1906.28,88.13333
"22732","76058","2014",1,1,0,88000,1397,63
"22733","76059","2014",1,1,0,1e+05,3030,33
"22734","76060","2014",2,2,0,170000,1597.5,107
"22735","76062","2014",2,2,0,132500,1691.5,73
"22736","76063","2014",1,1,0,75000,1210,62
"22737","76064","2014",3,3,0,244666.7,1560,186.3333
"22738","76065","2014",3,3,0,125000,1524,89.66667
"22739","76066","2014",2,2,0,204850,1540.5,135
"22740","76067","2014",7,7,0,119428.6,1505.714,85.57143
"22741","76068","2014",7,7,0,145228.6,1694.429,86
"22742","76069","2014",20,20,0,267810.9,2114.5,127.15
"22743","76070","2014",4,4,0,100500,1137.75,92
"22744","76071","2014",2,2,0,161250,1250.5,131
"22745","76072","2014",7,7,0,167957.1,1566,110.2857
"22746","76074","2014",1,1,0,105000,2188,48
"22747","76075","2014",1,1,0,55000,579,95
"22748","76076","2014",1,1,0,120000,1600,75
"22749","76077","2014",1,1,0,120000,2000,60
"22750","76079","2014",1,1,0,160000,2222,72
"22751","76082","2014",4,4,0,141000,2078.75,69
"22752","76085","2014",2,2,0,135235,1545,90
"22753","76087","2014",4,4,0,158875,1145.5,149.5
"22754","76088","2014",4,4,0,155125,1775.75,89.25
"22755","76090","2014",4,4,0,126000,1450,86.5
"22756","76091","2014",2,2,0,143835,1518.5,97
"22757","76093","2014",5,5,0,133810,1667.4,79.6
"22758","76094","2014",1,1,0,191500,1408,136
"22759","76095","2014",83,50,33,198908.2,2262.566,90
"22760","76096","2014",5,5,0,88044.8,1174,93.2
"22761","76099","2014",7,7,0,198428.6,1904.857,112.4286
"22762","76100","2014",8,8,0,195835.6,1669,137.375
"22763","76101","2014",22,21,1,100663.6,1119.182,91.04545
"22764","76103","2014",84,48,36,204397.6,2172.988,95.95238
"22765","76104","2014",5,5,0,125000,1579.2,78.4
"22766","76105","2014",5,5,0,196495,1805.2,113
"22767","76106","2014",8,8,0,173569.1,1663.75,112.375
"22768","76107","2014",2,2,0,164150,1706,97.5
"22769","76108","2014",156,95,61,250649.5,2436.41,103.1218
"22770","76109","2014",1,1,0,133950,2270,59
"22771","76110","2014",1,1,0,173500,1606,108
"22772","76111","2014",2,2,0,229000,1623,141
"22773","76112","2014",3,3,0,130233.3,1506.667,81.33333
"22774","76113","2014",3,3,0,184400,1450,127
"22775","76114","2014",102,81,21,99249.13,1423.275,73.91176
"22776","76115","2014",5,5,0,237440,2027.8,113.8
"22777","76116","2014",24,23,1,197259.4,1835.875,109.7917
"22778","76117","2014",4,4,0,172250,1439.5,131
"22779","76118","2014",6,6,0,124333.3,1651,72.66667
"22780","76120","2014",3,3,0,119933.3,1391,85
"22781","76121","2014",5,5,0,156400,1492.2,104.2
"22782","76122","2014",1,1,0,110000,1146,96
"22783","76123","2014",6,6,0,209741.7,1715.5,117.8333
"22784","76124","2014",3,3,0,128000,1471.333,89
"22785","76125","2014",15,15,0,150174.8,1667,99.4
"22786","76126","2014",3,3,0,131000,1205.333,116.3333
"22787","76128","2014",7,7,0,126000,1801.571,79.71429
"22788","76129","2014",1,1,0,120000,1333,90
"22789","76131","2014",8,8,0,162080,1764.5,92.625
"22790","76132","2014",4,4,0,117000,1086.25,113.5
"22791","76133","2014",3,3,0,153250,1055,135.6667
"22792","76134","2014",2,2,0,110500,1331,83
"22793","76135","2014",7,7,0,166642.9,1696.286,98.71429
"22794","76136","2014",5,5,0,123739.4,1331.4,107
"22795","76138","2014",2,2,0,149500,1378.5,98
"22796","76139","2014",2,2,0,167500,1731.5,105
"22797","76140","2014",1,1,0,151732,2168,70
"22798","76141","2014",15,15,0,150300,2092.8,81.13333
"22799","76142","2014",4,4,0,91000,1039.25,78.25
"22800","76143","2014",10,10,0,196250,1888.3,131.1
"22801","76144","2014",1,1,0,75000,1154,65
"22802","76146","2014",27,26,1,157038.9,1547.778,101.3704
"22803","76147","2014",6,5,1,104309.2,1039.333,90.66667
"22804","76148","2014",3,3,0,95000,1018,89.66667
"22805","76149","2014",4,4,0,145250,1171.5,125.25
"22806","76151","2014",2,2,0,223900,1813.5,115
"22807","76152","2014",5,5,0,143000,1689.4,87.4
"22808","76153","2014",1,1,0,189616,1975,96
"22809","76154","2014",4,4,0,74750,1047.25,77.5
"22810","76155","2014",3,3,0,121300,1409.333,86
"22811","76156","2014",2,2,0,95000,1214.5,111.5
"22812","76157","2014",52,32,20,151248.9,1642.404,94.65385
"22813","76158","2014",3,3,0,98333.33,991,104
"22814","76159","2014",14,13,1,135564.6,1530.286,91.71429
"22815","76160","2014",2,2,0,213700,1339.5,163
"22816","76161","2014",3,3,0,130333.3,1599,98
"22817","76162","2014",3,3,0,164666.7,1190.667,130.3333
"22818","76163","2014",7,7,0,159218.6,1459.714,112.8571
"22819","76164","2014",43,32,11,151088.4,1715.07,90.76744
"22820","76165","2014",74,59,15,124668.3,1608.851,79.24324
"22821","76166","2014",4,4,0,102500,870.5,128.75
"22822","76167","2014",16,16,0,214941.9,1994.062,110.375
"22823","76169","2014",8,8,0,192750,2343.5,106.25
"22824","76170","2014",1,1,0,210500,1413,149
"22825","76171","2014",1,1,0,150000,1200,125
"22826","76172","2014",5,5,0,288940,2237.4,137
"22827","76173","2014",3,3,0,136333.3,1200.667,116
"22828","76174","2014",3,3,0,174846.7,1381.333,152
"22829","76175","2014",2,2,0,215000,1369,159.5
"22830","76176","2014",4,4,0,90750,1199,76.5
"22831","76178","2014",17,16,1,185234.1,2198.706,92.52941
"22832","76179","2014",11,11,0,165531.8,1603.818,108.0909
"22833","76181","2014",1,1,0,105500,1598,66
"22834","76182","2014",1,1,0,283000,1415,200
"22835","76183","2014",3,3,0,237333.3,1836.667,124
"22836","76186","2014",6,6,0,106933.3,1069.5,103.5
"22837","76187","2014",2,2,0,294500,1610,182
"22838","76188","2014",5,5,0,141425,1884.2,78.6
"22839","76189","2014",4,4,0,106460,1257,86.75
"22840","76190","2014",6,6,0,128266.7,1430.333,92.16667
"22841","76192","2014",73,60,13,105803.9,1745.178,65.21918
"22842","76193","2014",4,4,0,146250,1402.25,106.5
"22843","76196","2014",23,21,2,168157.3,1949.391,92.56522
"22844","76197","2014",1,1,0,195000,1912,102
"22845","76198","2014",2,2,0,215500,2119.5,102
"22846","76199","2014",6,6,0,76860.67,1151,73.33333
"22847","76200","2014",3,3,0,209633.3,1333.667,155
"22848","76201","2014",5,5,0,140260,1764.4,90.2
"22849","76202","2014",3,3,0,102616.7,1710.333,60.33333
"22850","76203","2014",9,9,0,164522.2,1608,108.4444
"22851","76204","2014",4,4,0,176448.5,1476.5,116.5
"22852","76205","2014",1,1,0,210000,1615,130
"22853","76206","2014",2,2,0,183000,1722,109.5
"22854","76208","2014",2,2,0,135000,1754,83
"22855","76209","2014",6,6,0,128485,1478.667,90
"22856","76210","2014",3,3,0,149000,1520.333,98
"22857","76211","2014",6,6,0,78500,966.5,80
"22858","76212","2014",75,58,17,143285.9,1844.853,81.08
"22859","76213","2014",3,3,0,121666.7,1577.333,78
"22860","76214","2014",1,1,0,78500,1744,45
"22861","76216","2014",111,74,37,121326.2,1800.703,71.27928
"22862","76217","2014",309,131,178,123269.8,1880.424,68.51456
"22863","76219","2014",20,20,0,129063.1,1401.7,92
"22864","76220","2014",4,4,0,121550,1371.75,88
"22865","76221","2014",2,2,0,223500,1258,179
"22866","76222","2014",29,28,1,145758.6,1701.552,89.89655
"22867","76223","2014",3,3,0,154900,2001.333,84
"22868","76224","2014",9,9,0,208700,2135.667,103.4444
"22869","76225","2014",5,5,0,115800,1233,101.2
"22870","76226","2014",2,2,0,154425,1831,84.5
"22871","76227","2014",7,7,0,167864.3,1712,98
"22872","76228","2014",5,5,0,160050,1479.4,113
"22873","76229","2014",2,2,0,217500,1441.5,148
"22874","76230","2014",3,3,0,131533.3,1222.667,109.3333
"22875","76231","2014",94,62,32,143808.3,1634.287,90.15957
"22876","76232","2014",7,7,0,115478.6,1487.571,77.71429
"22877","76233","2014",1,1,0,90000,1000,90
"22878","76234","2014",5,5,0,149200,1802.2,81.6
"22879","76235","2014",17,17,0,130041.8,1328.353,102.1765
"22880","76236","2014",4,4,0,196850,1443,134.75
"22881","76237","2014",3,3,0,160333.3,1527.667,105.3333
"22882","76238","2014",17,15,2,191548.2,1743.824,113.3529
"22883","76239","2014",8,8,0,249875,2396.625,117.125
"22884","76240","2014",10,9,1,154180,1735.4,93.7
"22885","76242","2014",1,1,0,187000,1670,112
"22886","76243","2014",1,1,0,133000,2660,50
"22887","76244","2014",3,3,0,159166.7,1244,126.6667
"22888","76245","2014",14,14,0,177810.7,1830.357,98.5
"22889","76247","2014",4,4,0,136312.5,1471,100.5
"22890","76249","2014",6,6,0,183875,1621.667,119.1667
"22891","76250","2014",5,5,0,211600,2078.6,106
"22892","76251","2014",6,6,0,139033.3,1500,97
"22893","76252","2014",8,8,0,199269,1579.625,129.75
"22894","76253","2014",7,5,2,186770,1668.857,109.8571
"22895","76254","2014",37,30,7,144574.2,2303.297,74.05405
"22896","76255","2014",74,49,25,97638.19,1426.176,69.7027
"22897","76257","2014",1,1,0,31500,750,42
"22898","76258","2014",28,26,2,154017.9,1483.214,108.6429
"22899","76259","2014",202,151,51,124949.4,1700.906,74.79703
"22900","76260","2014",10,10,0,140006.6,1636.4,88
"22901","76261","2014",2,2,0,247250,1513.5,164.5
"22902","76262","2014",2,2,0,134500,1708,85
"22903","76263","2014",8,8,0,130062.5,1326.75,100.625
"22904","76264","2014",3,3,0,152533.3,1843.667,91
"22905","76265","2014",1,1,0,35000,500,70
"22906","76266","2014",5,5,0,148440,1437.4,106.8
"22907","76268","2014",1,1,0,173000,1922,90
"22908","76269","2014",2,2,0,139000,1829,76
"22909","76270","2014",20,19,1,233860,2506.8,97.65
"22910","76271","2014",10,10,0,162870,1878.4,88.7
"22911","76272","2014",6,6,0,108048.3,1125.5,89.33333
"22912","76273","2014",6,6,0,204666.7,1846.667,111.3333
"22913","76275","2014",9,9,0,250911.1,2258.222,116.7778
"22914","76276","2014",31,30,1,125612.9,1357.581,93.67742
"22915","76278","2014",6,6,0,128233.3,1148.833,118.3333
"22916","76280","2014",2,2,0,117500,1094,110
"22917","76281","2014",13,13,0,160626.9,1603.077,101.6923
"22918","76282","2014",4,4,0,2e+05,1705,118
"22919","76283","2014",1,1,0,132000,2200,60
"22920","76284","2014",3,3,0,92566.67,1520,58
"22921","76285","2014",1,1,0,210000,1680,125
"22922","76286","2014",6,6,0,96948.67,971.1667,103.3333
"22923","76287","2014",5,5,0,166180,2015,82.2
"22924","76288","2014",3,3,0,90600,1007.667,90
"22925","76289","2014",12,12,0,171420.8,1508.25,112.1667
"22926","76290","2014",3,3,0,148333.3,1899.333,81.66667
"22927","76291","2014",8,8,0,156027.8,1638.875,97.25
"22928","76292","2014",2,2,0,100550,1492,65
"22929","76293","2014",2,2,0,263000,1835,154
"22930","76295","2014",6,6,0,95433.33,1300.5,73.5
"22931","76296","2014",18,18,0,217844.4,1952.611,113.6111
"22932","76297","2014",1,1,0,1e+05,1111,90
"22933","76298","2014",3,3,0,148966.7,1682.333,89
"22934","76299","2014",4,4,0,139750,1841.25,75.5
"22935","76300","2014",2,2,0,191100,1582,125.5
"22936","76302","2014",20,18,2,164265,1922.3,91.15
"22937","76303","2014",6,6,0,194908.3,1947.833,101.6667
"22938","76304","2014",4,4,0,185250,1852.25,104.75
"22939","76305","2014",23,23,0,154517.7,1817,88.13043
"22940","76306","2014",2,2,0,159250,1101,156.5
"22941","76307","2014",10,10,0,132200,1766.2,77.6
"22942","76308","2014",2,2,0,141750,1278,124
"22943","76311","2014",2,2,0,151900,2030,81
"22944","76312","2014",42,35,7,123311.4,1564.024,79.11905
"22945","76313","2014",8,6,2,203556.2,1790,116.125
"22946","76314","2014",11,11,0,195318.2,1554.545,141.1818
"22947","76315","2014",10,10,0,104919.2,1296.2,88
"22948","76316","2014",3,3,0,220483.3,1469,151
"22949","76317","2014",6,6,0,175474,1754.167,110
"22950","76318","2014",5,5,0,188770,1882.2,104.2
"22951","76319","2014",55,55,0,155040.4,1696.909,95.07273
"22952","76320","2014",3,3,0,151666.7,1306,111.6667
"22953","76321","2014",20,20,0,114568.5,1264.75,94.95
"22954","76322","2014",107,64,43,157469.8,2226.617,75.33645
"22955","76324","2014",7,7,0,153428.6,1555.286,100.7143
"22956","76325","2014",6,6,0,140250,1422,99.5
"22957","76327","2014",4,4,0,151975,1724.25,94.25
"22958","76328","2014",1,1,0,221500,1288,172
"22959","76329","2014",23,23,0,131069.6,1536.304,87.13043
"22960","76330","2014",6,6,0,109000,1109,103.5
"22961","76331","2014",3,3,0,124333.3,1842.333,77
"22962","76332","2014",8,8,0,123568.8,2010.375,86
"22963","76333","2014",2,2,0,141750,1486,95.5
"22964","76334","2014",7,7,0,108792.9,1179.714,95.85714
"22965","76336","2014",4,4,0,107575,1457.75,75.75
"22966","76338","2014",1,1,0,64800,736,88
"22967","76339","2014",2,2,0,119900,1642.5,84
"22968","76340","2014",3,3,0,133666.7,1669.667,81
"22969","76341","2014",43,33,10,137865.3,1935.349,72.72093
"22970","76342","2014",7,7,0,136217.7,1288.857,107
"22971","76343","2014",1,1,0,120000,1000,120
"22972","76344","2014",6,6,0,99550,1481.667,78.33333
"22973","76345","2014",3,3,0,93333.33,1139.333,84.33333
"22974","76346","2014",4,4,0,133500,1208.75,111.75
"22975","76347","2014",4,4,0,163582.5,1712.25,106.5
"22976","76348","2014",2,2,0,155000,1377.5,111.5
"22977","76349","2014",28,24,4,181464.6,1909.107,102.0357
"22978","76350","2014",3,3,0,140887.3,1362.333,103.6667
"22979","76351","2014",1747,666,1081,132025.7,1919.518,69.02118
"22980","76352","2014",4,4,0,108875,1294.25,86.5
"22981","76353","2014",3,3,0,124666.7,1317,95.33333
"22982","76354","2014",10,10,0,241945,2150.9,115.2
"22983","76355","2014",8,8,0,116750,1379.5,83.25
"22984","76357","2014",2,2,0,225469,1289.5,196.5
"22985","76358","2014",5,5,0,93400,1374.2,83.2
"22986","76360","2014",5,5,0,93400,1331.8,74.4
"22987","76361","2014",9,9,0,191222.2,2492,85.77778
"22988","76362","2014",2,2,0,133500,1429,93.5
"22989","76363","2014",5,5,0,103360,1174.8,86.8
"22990","76364","2014",4,4,0,123750,1402.5,92
"22991","76366","2014",43,43,0,131095.2,1768.14,82.83721
"22992","76367","2014",31,31,0,220051.5,1967.29,116.3548
"22993","76368","2014",2,2,0,160650,1534,107.5
"22994","76369","2014",7,7,0,120928.6,1398.429,87.71429
"22995","76370","2014",3,3,0,160763.3,1295,124
"22996","76372","2014",6,6,0,84666.67,885.8333,98.33333
"22997","76373","2014",2,2,0,114500,1268,97
"22998","76374","2014",8,8,0,75918.75,1309,58.875
"22999","76375","2014",2,2,0,158000,1539,105
"23000","76377","2014",26,24,2,265844.2,2396.5,112.3462
"23001","76378","2014",17,15,2,145714.7,1660.529,94.11765
"23002","76379","2014",1,1,0,90000,643,140
"23003","76380","2014",4,4,0,152650,1464,97.5
"23004","76381","2014",2,2,0,113000,1219,116.5
"23005","76382","2014",11,11,0,124631.8,1626.182,79.27273
"23006","76384","2014",72,62,10,123216.3,1631.833,82.04167
"23007","76385","2014",14,14,0,177832.1,1708.643,109.4286
"23008","76386","2014",5,5,0,121340,1338.2,89.2
"23009","76387","2014",3,3,0,140800,2086,73.66667
"23010","76388","2014",7,7,0,131642.9,1502.286,91
"23011","76389","2014",1,1,0,179000,1673,107
"23012","76390","2014",9,9,0,150444.4,1540.444,101.6667
"23013","76391","2014",30,30,0,204782.4,1822.867,114.6
"23014","76392","2014",13,13,0,92696.15,1144.769,83.53846
"23015","76394","2014",7,7,0,83237.14,1287.286,66.85714
"23016","76395","2014",4,4,0,107500,1171.5,91.25
"23017","76396","2014",2,2,0,147000,2048.5,72
"23018","76397","2014",7,7,0,85857.14,1483.143,59
"23019","76398","2014",6,6,0,155266.7,1884.833,83.33333
"23020","76399","2014",2,2,0,197500,2150,141
"23021","76400","2014",16,15,1,152751.8,1561.562,99.75
"23022","76401","2014",19,19,0,135194.7,1486.263,91.68421
"23023","76402","2014",44,42,2,152662.5,1851.455,88.04545
"23024","76403","2014",2,2,0,132000,1465.5,90
"23025","76404","2014",10,10,0,173930,1891.6,91.9
"23026","76405","2014",1,1,0,1e+05,1370,73
"23027","76406","2014",1,1,0,169000,1352,125
"23028","76407","2014",3,3,0,180640,1216.333,150
"23029","76408","2014",5,5,0,152500,1632.4,106.2
"23030","76409","2014",11,11,0,239312.3,2501.636,101.9091
"23031","76410","2014",78,52,26,131866.2,1796.769,76.0641
"23032","76411","2014",1,1,0,39000,867,45
"23033","76412","2014",4,4,0,175037.5,2182.75,81.25
"23034","76413","2014",2,2,0,109686.5,1444,74
"23035","76414","2014",9,9,0,177282.7,1741.778,103
"23036","76415","2014",3,3,0,135696.7,1501.333,101
"23037","76416","2014",5,5,0,152900,1470.8,112.6
"23038","76417","2014",2,2,0,80500,993,81
"23039","76418","2014",8,8,0,121526.5,1500.375,81.25
"23040","76419","2014",2,2,0,246000,3039.5,90.5
"23041","76420","2014",4,4,0,188405,1648.75,122.75
"23042","76421","2014",7,7,0,194857.1,1766.143,112
"23043","76423","2014",6,6,0,115666.7,2005.5,58.66667
"23044","76424","2014",3,3,0,93333.33,943.3333,108
"23045","76425","2014",5,5,0,225460,1668,139.6
"23046","76426","2014",3,3,0,80876.67,1009,75.33333
"23047","76427","2014",4,4,0,143000,1661.5,83.25
"23048","76428","2014",1,1,0,120000,1091,110
"23049","76429","2014",70,60,10,253586,2304.057,113.6
"23050","76431","2014",1,1,0,78100,822,95
"23051","76432","2014",1,1,0,148000,2114,70
"23052","76433","2014",3,3,0,161583.3,1412.333,111.6667
"23053","76434","2014",6,6,0,217550,2047.5,106.6667
"23054","76435","2014",5,5,0,108350,1342.6,80
"23055","76437","2014",2,2,0,146000,1448.5,105
"23056","76438","2014",1,1,0,190000,1267,150
"23057","76439","2014",3,3,0,179783.3,1521.667,124
"23058","76440","2014",1,1,0,99000,1833,54
"23059","76441","2014",6,6,0,111550,1326.833,92.66667
"23060","76443","2014",3,3,0,245533.3,1675,142.3333
"23061","76445","2014",4,4,0,160125,1440.25,104.75
"23062","76446","2014",12,12,0,207083.3,2378.583,85.5
"23063","76447","2014",106,84,22,175334.5,2068.302,88.45283
"23064","76448","2014",10,10,0,189200,1770.5,113.3
"23065","76449","2014",7,7,0,182885.7,2082.429,88.85714
"23066","76450","2014",5,5,0,171600,1797.4,97.6
"23067","76451","2014",200,85,115,215618,2273.33,92.41
"23068","76452","2014",39,38,1,168642.3,1854.154,92.12821
"23069","76453","2014",5,5,0,177590,1974.8,92
"23070","76455","2014",3,3,0,139316.7,1579.333,89
"23071","76456","2014",5,5,0,119720,1520.4,80.6
"23072","76457","2014",11,9,2,137090.9,1488.273,92.27273
"23073","76458","2014",3,3,0,162600,2019.667,92.66667
"23074","76459","2014",3,3,0,136666.7,1246,105
"23075","76460","2014",6,6,0,73916.67,840.1667,85.16667
"23076","76461","2014",4,4,0,123500,1155,109.25
"23077","76462","2014",34,29,5,142119.1,1564.824,96.55882
"23078","76463","2014",4,4,0,110750,2032,56.5
"23079","76464","2014",12,12,0,173658.3,1820.25,98.33333
"23080","76465","2014",4,4,0,78250,1051.5,76
"23081","76467","2014",9,9,0,126568.9,1652.889,80
"23082","76468","2014",10,10,0,170010,1468.2,114.4
"23083","76469","2014",1,1,0,113000,779,145
"23084","76470","2014",6,6,0,190471.3,1732.167,107.3333
"23085","76471","2014",5,5,0,151150,1817,83.6
"23086","76472","2014",8,8,0,132581.2,1446.625,89.75
"23087","76473","2014",3,3,0,133833.3,1505,89
"23088","76474","2014",52,47,5,158250,1798.058,90.69231
"23089","76475","2014",52,51,1,264380.3,2209.904,120.7115
"23090","76476","2014",102,98,4,133738.2,1513.039,90.33333
"23091","76477","2014",3,2,1,177000,1968.667,112
"23092","76478","2014",5,5,0,125500,1230.4,105.2
"23093","76480","2014",4,4,0,184067.5,2148.75,89.75
"23094","76481","2014",58,56,2,246206,2331.655,111.1034
"23095","76482","2014",22,22,0,200743.7,2084.591,95.77273
"23096","76484","2014",74,71,3,135876,1662.311,83.67568
"23097","76485","2014",2,2,0,120325,1733,89
"23098","76486","2014",10,10,0,137830,1870.9,74.7
"23099","76487","2014",2,2,0,131300,1187,111.5
"23100","76488","2014",6,6,0,168991.7,1303.667,132
"23101","76489","2014",5,5,0,155400,1367.6,115.8
"23102","76490","2014",5,5,0,140780,1519.6,90.8
"23103","76491","2014",9,9,0,127222.2,1138.667,110.4444
"23104","76492","2014",2,2,0,137500,1487.5,92.5
"23105","76493","2014",3,3,0,178650,1455,114.3333
"23106","76494","2014",3,3,0,170500,1717,101.6667
"23107","76495","2014",58,54,4,146345.1,1581.552,93.74138
"23108","76497","2014",61,44,17,154052.3,1719.639,90.70492
"23109","76498","2014",182,142,40,118762.1,1675.599,72.3022
"23110","76499","2014",7,7,0,131192.9,1716.714,77.14286
"23111","76500","2014",4,4,0,107010,1054,102.25
"23112","76501","2014",2,2,0,153000,1745.5,87.5
"23113","76502","2014",5,5,0,171429,1474,118
"23114","76503","2014",12,11,1,176516.7,1720,103
"23115","76504","2014",2,2,0,111000,1333.5,86
"23116","76505","2014",1,1,0,40000,1000,40
"23117","76506","2014",4,4,0,83038.75,927.5,102.25
"23118","76507","2014",13,13,0,92086.77,1246,76.23077
"23119","76508","2014",6,6,0,154716.7,1761.667,95.66667
"23120","76509","2014",13,13,0,239669.2,2271.077,112.3077
"23121","76510","2014",4,4,0,128750,1424.25,94
"23122","76511","2014",2,2,0,132500,1785,78
"23123","76513","2014",5,5,0,206590,1884.4,108
"23124","76514","2014",4,4,0,194637.5,1707.75,115.75
"23125","76515","2014",11,11,0,161760.9,2276.818,69.90909
"23126","76516","2014",3,3,0,145800,1492.667,99.66667
"23127","76517","2014",19,19,0,207508.9,1978.579,113.0526
"23128","76518","2014",8,8,0,144712.5,1678.25,87.875
"23129","76519","2014",1,1,0,440000,1630,270
"23130","76520","2014",5,5,0,196680,1422.6,123.2
"23131","76521","2014",3,3,0,98550,1284.333,78.66667
"23132","76522","2014",10,10,0,200300,2126,105.1
"23133","76523","2014",3,3,0,62833.33,1073.667,59
"23134","76524","2014",3,3,0,130666.7,1779.333,71
"23135","76526","2014",2,2,0,119000,1583.5,76.5
"23136","76527","2014",5,5,0,88560,1256.8,72.2
"23137","76528","2014",4,4,0,108625,1172.5,94.25
"23138","76529","2014",4,4,0,128375,1726.5,78
"23139","76530","2014",2,2,0,177500,1596,123.5
"23140","76531","2014",4,4,0,137175,1380,103
"23141","76532","2014",4,4,0,149500,1228.5,124.25
"23142","76533","2014",16,16,0,154893.8,1933.25,84.3125
"23143","76534","2014",8,8,0,178625,1907,95.75
"23144","76535","2014",4,4,0,113752.5,1091.5,109.25
"23145","76536","2014",12,12,0,210125,1946.083,110.75
"23146","76537","2014",5,5,0,104400,914,114.6
"23147","76538","2014",2,2,0,164000,1536.5,106.5
"23148","76540","2014",1518,321,1197,138827.4,2288.363,63.0448
"23149","76541","2014",10,10,0,250030,2044.1,122.7
"23150","76542","2014",2,2,0,127000,1060,125
"23151","76543","2014",4,4,0,167601.5,1658.5,101.25
"23152","76544","2014",1,1,0,153500,1687,91
"23153","76545","2014",11,11,0,166206.4,1602.545,105.0909
"23154","76546","2014",3,3,0,115333.3,1005,116
"23155","76547","2014",4,4,0,140250,2073.5,72.25
"23156","76548","2014",5,5,0,156920,1668,92.6
"23157","76549","2014",1,1,0,125000,1000,125
"23158","76550","2014",8,8,0,191806.2,1764.375,112.875
"23159","76551","2014",7,7,0,173176.3,2237.143,78.71429
"23160","76552","2014",97,56,41,282840.1,2686.515,103.1649
"23161","76553","2014",3,3,0,68666.67,888.3333,76
"23162","76554","2014",6,6,0,177608.3,1625,111
"23163","76555","2014",5,5,0,284600,1938.4,148
"23164","76556","2014",12,12,0,182647.5,1642.833,120.5833
"23165","76557","2014",5,5,0,145940,1607.8,88
"23166","76558","2014",7,7,0,174771.4,1863.714,97.28571
"23167","76559","2014",5,5,0,123000,1491,83.2
"23168","76560","2014",6,5,1,246433.3,2028.333,121.8333
"23169","76561","2014",64,45,19,134245.2,1765.094,78.90625
"23170","76562","2014",6,6,0,133316.5,1607.167,87.16667
"23171","76563","2014",12,12,0,162662.5,1834.333,89.08333
"23172","76564","2014",4,4,0,263602.5,2119.5,127.5
"23173","76565","2014",5,5,0,184260,1664.6,120.2
"23174","76566","2014",5,5,0,128420,1370.8,94
"23175","76567","2014",1,1,0,52800,1173,45
"23176","76569","2014",1,1,0,160000,1649,97
"23177","76571","2014",9,9,0,151444.4,1510.889,103.6667
"23178","76572","2014",1,1,0,75000,915,82
"23179","76573","2014",5,5,0,206605,1574,135.2
"23180","76574","2014",6,6,0,171000,1939.167,89.16667
"23181","76575","2014",199,161,38,132860.6,1756.266,77.11055
"23182","76576","2014",7,7,0,131785.7,1377.571,101.2857
"23183","76577","2014",4,4,0,105625,975,101
"23184","76578","2014",4,4,0,201875,2352.75,85.25
"23185","76580","2014",6,6,0,258650,1737.333,147.6667
"23186","76581","2014",6,6,0,149875,1981.167,85
"23187","76582","2014",1,1,0,146000,2246,65
"23188","76583","2014",5,5,0,164420,1422.8,118.8
"23189","76584","2014",1,1,0,73000,839,87
"23190","76585","2014",3,3,0,262326.7,2025.333,131
"23191","76586","2014",4,4,0,174200,1943,94.25
"23192","76587","2014",4,4,0,92250,1274.75,78.75
"23193","76588","2014",5,5,0,136800,1452.2,98.6
"23194","76590","2014",2,2,0,157400,1787.5,89.5
"23195","76591","2014",16,16,0,231918.8,2001.562,118.3125
"23196","76592","2014",9,9,0,185944.4,1916.889,100.7778
"23197","76593","2014",2,2,0,195000,2081.5,89
"23198","76594","2014",11,11,0,219122.7,2045.545,107.7273
"23199","76595","2014",18,17,1,204175,2198.222,101.1111
"23200","76596","2014",16,16,0,177036.9,2387.625,80.125
"23201","76597","2014",5,4,1,110200,1139.8,95.4
"23202","76598","2014",2,2,0,106500,957,114
"23203","76599","2014",31,30,1,170687.3,2034.097,85.80645
"23204","76600","2014",15,14,1,141578.7,1595.933,87.26667
"23205","76602","2014",6,6,0,115175,1218.5,95.66667
"23206","76603","2014",3,3,0,98666.67,1099,80.33333
"23207","76604","2014",2,2,0,85000,1447,65
"23208","76605","2014",1,1,0,176000,1956,90
"23209","76606","2014",2,2,0,89500,1235.5,66.5
"23210","76608","2014",14,14,0,185065,1801.429,106
"23211","76609","2014",4,4,0,184750,2286.25,91.25
"23212","76610","2014",18,18,0,153311.1,1901.278,81.83333
"23213","76612","2014",1,1,0,130860,928,141
"23214","76613","2014",13,13,0,165630.8,1957.846,91.15385
"23215","76614","2014",16,16,0,233411.2,2122.125,115.875
"23216","76615","2014",3,3,0,219466.7,2000.333,113.6667
"23217","76616","2014",12,12,0,212808.3,2168.917,102.3333
"23218","76617","2014",12,12,0,319991.7,2182.25,149.25
"23219","76618","2014",61,61,0,134996.8,1620.951,87.21311
"23220","76620","2014",3,3,0,137333.3,1163.333,113.6667
"23221","76621","2014",7,7,0,143814.3,1719,91.71429
"23222","76622","2014",4,4,0,171625,1542.75,112.75
"23223","76624","2014",26,25,1,106449.2,1495.462,73.42308
"23224","76626","2014",2,2,0,167950,1484.5,112.5
"23225","76627","2014",12,12,0,173220.8,1648.75,112.9167
"23226","76628","2014",10,10,0,145740,1358.5,116.5
"23227","76629","2014",4,4,0,95250,1347.75,70.25
"23228","76631","2014",15,14,1,188536.9,1971,114.0667
"23229","76632","2014",2,2,0,147000,1463,104.5
"23230","76634","2014",10,10,0,140402.5,1645.3,88.9
"23231","76636","2014",21,21,0,182909.5,1771.524,102.5714
"23232","76637","2014",15,15,0,149203.3,1624.067,99.53333
"23233","76638","2014",3,3,0,153166.7,1404,108.3333
"23234","76640","2014",42,39,3,170858.3,2137.571,86.95238
"23235","76644","2014",6,6,0,130818.3,1625.167,86.16667
"23236","76646","2014",4,4,0,129250,1097.25,119
"23237","76647","2014",41,32,9,174001.4,2184.951,86.2439
"23238","76648","2014",15,15,0,121612.2,1601.8,76.06667
"23239","76649","2014",5,5,0,98100,1278,74.6
"23240","76650","2014",10,10,0,200575,2016.9,103.3
"23241","76652","2014",8,8,0,108612.5,1185.625,90.625
"23242","76653","2014",2,2,0,207250,1280.5,165
"23243","76654","2014",6,6,0,141916.7,1170.167,123.1667
"23244","76655","2014",37,28,9,156884.7,1804.703,91.56757
"23245","76656","2014",6,6,0,141566.7,1741.333,86.33333
"23246","76657","2014",8,8,0,201465,1743.625,127.375
"23247","76658","2014",4,4,0,186858.8,2054,96.5
"23248","76660","2014",10,10,0,164200,1743.9,98
"23249","76662","2014",1,1,0,118000,1639,72
"23250","76663","2014",9,9,0,136277.8,1867.444,76.33333
"23251","76664","2014",3,3,0,125666.7,1612.333,79.33333
"23252","76665","2014",2,2,0,138700,1605,88.5
"23253","76666","2014",6,6,0,136000,1242.833,108.8333
"23254","76667","2014",2,2,0,234830,1662.5,140
"23255","76668","2014",5,5,0,149210,1507.8,99.2
"23256","76669","2014",2,2,0,178000,1887,102.5
"23257","76670","2014",6,6,0,136970.8,1557.167,104.6667
"23258","76671","2014",3,3,0,98500,996.6667,118.6667
"23259","76672","2014",9,9,0,89055.56,1149.111,77.77778
"23260","76673","2014",9,9,0,196252.9,1726.667,116.8889
"23261","76675","2014",5,5,0,155200,1971.6,82.4
"23262","76676","2014",8,8,0,91937.5,1499.625,63.375
"23263","76677","2014",4,4,0,94250,1300.25,71.75
"23264","76678","2014",7,7,0,124077.1,1546,80
"23265","76681","2014",274,207,67,146947.4,1965.438,76.81387
"23266","76682","2014",6,6,0,161556.7,1823.667,90.66667
"23267","76683","2014",6,6,0,118280,2311,56.66667
"23268","76684","2014",11,11,0,170281.8,1668.455,100
"23269","76685","2014",1,1,0,160000,2353,68
"23270","76686","2014",2,2,0,108000,1440,75
"23271","76688","2014",3,3,0,193666.7,1456.667,121
"23272","76689","2014",3,3,0,129000,1169,109.6667
"23273","76690","2014",6,6,0,141403.3,1211.333,112.3333
"23274","76691","2014",6,6,0,137065.8,1342.333,96.66667
"23275","76692","2014",2,2,0,107500,1059.5,95
"23276","76693","2014",7,7,0,177071.4,2186.571,87.42857
"23277","76694","2014",3,3,0,309000,4391.333,94.66667
"23278","76695","2014",2,2,0,145500,1561,98
"23279","76697","2014",6,6,0,152131.2,1537.833,103.3333
"23280","76698","2014",6,6,0,93916.67,1037.833,96
"23281","76699","2014",3,3,0,130500,1473,88.33333
"23282","76700","2014",8,7,1,151062.5,1758.875,87.625
"23283","76702","2014",3,3,0,189333.3,1599.333,115
"23284","76703","2014",1,1,0,97000,1540,63
"23285","76705","2014",13,12,1,124615.4,1671.538,77.61538
"23286","76706","2014",7,7,0,182314.3,1909.714,104.7143
"23287","76707","2014",6,6,0,166933.3,1881.167,94.83333
"23288","76708","2014",6,6,0,132000,1696.833,81.66667
"23289","76709","2014",39,39,0,111597.1,1398.256,82.17949
"23290","76710","2014",2,2,0,90000,1011.5,89
"23291","76711","2014",75,40,35,87984.09,1576.44,60.41333
"23292","76712","2014",9,9,0,142444.4,1646,92.88889
"23293","76714","2014",1,1,0,136000,1838,74
"23294","76715","2014",5,5,0,146600,1440.2,102
"23295","76716","2014",13,13,0,194769.2,2129.462,92.92308
"23296","76717","2014",1,1,0,160000,2025,79
"23297","76718","2014",8,8,0,198375,1664.875,120.75
"23298","76719","2014",8,8,0,195937.5,1832.375,119.25
"23299","76720","2014",14,14,0,238178.6,2336.429,107.8571
"23300","76721","2014",4,4,0,141500,1471,98
"23301","76723","2014",4,4,0,130500,1362,97.25
"23302","76725","2014",4,4,0,144375,1426.25,102.75
"23303","76726","2014",5,5,0,185305,2217.2,100.8
"23304","76727","2014",15,15,0,143289.8,1456.4,117.2
"23305","76728","2014",6,6,0,154755.7,1807.5,86.83333
"23306","76730","2014",2,2,0,97500,1052.5,110
"23307","76731","2014",1,1,0,55000,846,65
"23308","76732","2014",2,2,0,94000,912.5,120.5
"23309","76733","2014",2,2,0,257375,1788.5,143
"23310","76734","2014",5,5,0,187600,1813,112.2
"23311","76735","2014",13,13,0,184471.4,1932,90.61538
"23312","76736","2014",8,5,3,151333.2,2114.375,83.875
"23313","76737","2014",7,7,0,131342.9,1346.429,97.71429
"23314","76738","2014",9,9,0,185812.2,1896.111,102.2222
"23315","76739","2014",3,3,0,77833.33,1072,75.66667
"23316","76740","2014",4,4,0,215275,2177.75,104.25
"23317","76741","2014",2,2,0,196000,1552.5,127.5
"23318","76743","2014",17,17,0,147035.3,1786.765,82.29412
"23319","76744","2014",1,1,0,90000,857,105
"23320","76745","2014",1,1,0,118000,1326,89
"23321","76747","2014",5,5,0,187710,2268.2,83
"23322","76748","2014",7,7,0,104428.6,1296.571,84.71429
"23323","76749","2014",2,2,0,105000,1745,58.5
"23324","76750","2014",12,12,0,120364.6,1524.5,81.58333
"23325","76751","2014",10,10,0,154650,1604.6,98.2
"23326","76752","2014",15,14,1,147804.8,1858.267,81.13333
"23327","76754","2014",28,27,1,168615.1,2152.893,81.28571
"23328","76755","2014",9,9,0,126955.6,1383.778,99.88889
"23329","76756","2014",2,2,0,213000,1591,122
"23330","76757","2014",2,2,0,107625,1582,67.5
"23331","76758","2014",99,68,31,154054.6,1956.222,83.15152
"23332","76759","2014",3,3,0,172000,1905.333,87.33333
"23333","77001","2014",19,19,0,242557.9,2232.632,112.6842
"23334","77002","2014",6,6,0,188500,2522.333,82
"23335","77003","2014",4,4,0,185625,1759.75,106
"23336","77004","2014",2,2,0,207500,2709,76.5
"23337","77005","2014",42,31,11,272879.5,2955.071,95.7619
"23338","77006","2014",13,12,1,302761.5,3256.231,98.07692
"23339","77007","2014",8,8,0,185125,2303.875,87.125
"23340","77008","2014",10,10,0,234900,2364.7,109.1
"23341","77009","2014",3,2,1,274333.3,2616.667,120.6667
"23342","77010","2014",6,5,1,210883.3,2787.167,81.83333
"23343","77011","2014",5,5,0,166578.8,1019.2,150
"23344","77012","2014",3,3,0,166666.7,1417,123.6667
"23345","77014","2014",196,42,154,170050.2,2540.801,68.10714
"23346","77015","2014",1,1,0,220000,1243,177
"23347","77016","2014",9,9,0,168988.9,1560.556,117.5556
"23348","77018","2014",76,45,31,289774.6,3329.447,88.46053
"23349","77019","2014",3,3,0,150666.7,1725.333,85.33333
"23350","77020","2014",10,10,0,197175,1978.7,106.9
"23351","77022","2014",25,17,8,353412,2976.48,115.08
"23352","77023","2014",1,1,0,141000,1424,99
"23353","77024","2014",4,4,0,187750,1453.75,146
"23354","77025","2014",13,13,0,149480.8,1699.308,95.23077
"23355","77026","2014",1,1,0,92000,1278,72
"23356","77027","2014",8,8,0,162875,1498.75,110.5
"23357","77029","2014",5,5,0,189800,1879.6,105.4
"23358","77030","2014",9,9,0,148000,1740.889,86.77778
"23359","77031","2014",2,2,0,101500,1416.5,68.5
"23360","77032","2014",11,11,0,158463.6,1566.455,116.4545
"23361","77033","2014",3,3,0,189333.3,2035.667,102.3333
"23362","77034","2014",9,8,1,206061.3,2075.111,104
"23363","77035","2014",4,4,0,174750,1570.75,110
"23364","77036","2014",3,3,0,186666.7,2295,83.33333
"23365","77037","2014",84,74,10,313714.3,3431.202,97.41667
"23366","77038","2014",2,2,0,327500,3677.5,89
"23367","77039","2014",5,5,0,249080,2533,99.6
"23368","77040","2014",23,22,1,296157.1,2637.043,118.3043
"23369","77041","2014",3,3,0,251833.3,3169.667,81.33333
"23370","77042","2014",26,25,1,214452.7,1972,110.4231
"23371","77043","2014",5,5,0,223222,1445.4,151.8
"23372","77044","2014",10,10,0,190552,2104.9,92.2
"23373","77045","2014",9,9,0,153333.3,1756.889,93
"23374","77046","2014",7,7,0,207857.1,1775.286,122
"23375","77047","2014",10,8,2,263986.6,2963.2,93.4
"23376","77048","2014",35,33,2,302197.7,2478.886,126.9143
"23377","77049","2014",5,5,0,262240,2148.4,121
"23378","77050","2014",7,7,0,108950.1,1021.429,115.4286
"23379","77051","2014",15,15,0,149225.7,1566.733,98.4
"23380","77052","2014",4,4,0,296405,2321,130.25
"23381","77053","2014",205,103,102,214680.1,3020.059,74.75122
"23382","77054","2014",3,3,0,204666.7,2324.333,81
"23383","77055","2014",50,10,40,181909.6,2601.28,70.2
"23384","77056","2014",4,4,0,209650,2059.25,105.5
"23385","77057","2014",1,1,0,248000,1837,135
"23386","77058","2014",342,99,243,243276.7,3283.143,76.52632
"23387","77059","2014",4,4,0,433120,4210.5,117.25
"23388","77060","2014",12,10,2,143666.7,1557.917,95
"23389","77061","2014",15,14,1,139230,1894,76.13333
"23390","77062","2014",7,7,0,248214.3,2822.714,92
"23391","77063","2014",5,5,0,200800,1981,111
"23392","77065","2014",13,13,0,301962.7,2825.308,111.6923
"23393","77066","2014",2,2,0,153250,1825.5,84
"23394","77067","2014",94,83,11,254743.3,2823.245,97.61702
"23395","77068","2014",5,5,0,190930,1759.6,116.4
"23396","77069","2014",12,11,1,301195.8,2701.417,112.1667
"23397","77070","2014",15,15,0,196266.7,2147.733,96.13333
"23398","77071","2014",6,6,0,144183.3,1554.333,97.16667
"23399","77072","2014",7,7,0,149400,1339.857,116.4286
"23400","77073","2014",3,3,0,164866.7,1102.667,145.6667
"23401","77075","2014",17,14,3,228970.6,2960.765,83.82353
"23402","77076","2014",4,4,0,171750,2338.5,75.5
"23403","77077","2014",14,14,0,234765.2,2168.5,110.0714
"23404","77078","2014",11,10,1,232818.2,2415.545,102.6364
"23405","77079","2014",46,36,10,141486.7,2063.978,71.91304
"23406","77080","2014",2,2,0,221275,1415,156.5
"23407","77081","2014",8,7,1,216487.5,2836.125,78.75
"23408","77082","2014",6,2,4,158899.3,2590.5,66.33333
"23409","77083","2014",194,65,129,226131.2,3010.938,78.64948
"23410","77084","2014",14,10,4,167078.9,1893,91.5
"23411","77085","2014",29,18,11,259955.3,3206.483,84.86207
"23412","77086","2014",11,10,1,178772.7,2116.727,87.09091
"23413","77087","2014",3,3,0,157166.7,2187.667,76
"23414","77088","2014",23,19,4,163960.4,1873.87,93.08696
"23415","77089","2014",9,9,0,238555.6,2243.111,110.2222
"23416","77090","2014",2,2,0,229000,1804,128.5
"23417","77091","2014",3,3,0,272333.3,2655.667,103.6667
"23418","77093","2014",3,3,0,159333.3,1463.667,113
"23419","77094","2014",3,3,0,230050,2909.333,79
"23420","77095","2014",13,11,2,224326.9,2761.615,85.46154
"23421","77096","2014",23,22,1,317020.5,3152.391,108.9565
"23422","77097","2014",2,2,0,151000,1793.5,99
"23423","77098","2014",7,7,0,170357.1,1633.571,107.1429
"23424","77099","2014",36,33,3,139277.8,1599.833,89.27778
"23425","77100","2014",41,38,3,182047.9,2316.659,80.4878
"23426","77101","2014",15,15,0,148296.7,1687.267,98.6
"23427","77102","2014",2,2,0,151750,2330,65
"23428","77104","2014",8,8,0,262350,2599.625,103.625
"23429","77106","2014",9,9,0,177388.9,1989.667,94
"23430","77107","2014",36,25,11,188383.9,2552.472,80.19444
"23431","77108","2014",551,260,291,222366,3132.258,74.42287
"23432","77109","2014",17,17,0,169247.1,1775.588,101.4706
"23433","77111","2014",64,24,40,293460.5,3506.438,88.78125
"23434","77112","2014",5,5,0,240543,1963.2,119.2
"23435","77113","2014",10,10,0,178379,1797.3,100
"23436","77114","2014",35,26,9,293277.1,3157.314,101.1143
"23437","77115","2014",2,2,0,247500,1609,135
"23438","77116","2014",21,20,1,179427.4,1984.333,104.5238
"23439","77117","2014",11,10,1,128772.7,1371.182,96.09091
"23440","77118","2014",142,92,50,257749.7,3194.021,85.97183
"23441","77119","2014",1,1,0,172000,3440,50
"23442","77120","2014",4,4,0,203037.5,2197.5,94.75
"23443","77121","2014",40,31,9,285793.9,3266.125,89.225
"23444","77122","2014",216,119,97,203319.5,2788.935,77.27778
"23445","77123","2014",7,6,1,168142.9,2514.286,74.71429
"23446","77124","2014",12,12,0,328683.3,2955.667,117.6667
"23447","77125","2014",14,13,1,292276.1,2790.429,106.6429
"23448","77126","2014",18,18,0,218684.9,2399.944,93.44444
"23449","77127","2014",14,8,6,225938.6,2785.571,84.85714
"23450","77128","2014",21,18,3,238395.2,2773.381,92.90476
"23451","77129","2014",11,11,0,140345.5,2510.727,78.36364
"23452","77130","2014",3,3,0,194333.3,2316.667,111.3333
"23453","77131","2014",118,62,56,178687.4,2543.932,76.59322
"23454","77132","2014",27,24,3,265668.4,3123.667,89.51852
"23455","77133","2014",3,3,0,161666.7,1422.333,117.3333
"23456","77134","2014",1,1,0,181878,4436,41
"23457","77135","2014",15,15,0,234763.9,2800.4,106.6
"23458","77136","2014",2,2,0,222500,1898.5,117.5
"23459","77137","2014",3,3,0,201333.3,1647.667,122.6667
"23460","77138","2014",2,2,0,165500,2536,72
"23461","77139","2014",45,41,4,270335.6,2985.444,95.06667
"23462","77140","2014",3,3,0,280176.7,3094,117.6667
"23463","77141","2014",15,12,3,239927.9,2749.667,89.66667
"23464","77142","2014",55,43,12,211837.7,2623.036,86.65455
"23465","77143","2014",45,31,14,179522.2,2575.556,77.37778
"23466","77144","2014",4,4,0,292225,2734.25,107.25
"23467","77145","2014",7,7,0,232378.6,2416,97.42857
"23468","77146","2014",15,15,0,313073.3,3280.467,99.66667
"23469","77147","2014",6,5,1,132333.3,1859.667,70
"23470","77148","2014",25,18,7,124318,1692.32,78.44
"23471","77150","2014",2,2,0,269250,2565.5,106.5
"23472","77151","2014",3,3,0,184400,2293.333,81.33333
"23473","77152","2014",138,54,84,170611.1,2547.862,70.43478
"23474","77153","2014",104,63,41,214123.4,2895.5,77.49038
"23475","77154","2014",17,17,0,237745.8,2575.353,94.76471
"23476","77155","2014",47,39,8,261807.7,3163.489,88.02128
"23477","77156","2014",9,9,0,174222.2,2137.667,82
"23478","77157","2014",1,1,0,180000,2571,70
"23479","77158","2014",3,3,0,116666.7,867,130.3333
"23480","77159","2014",32,32,0,147773.8,1728.781,89.75
"23481","77161","2014",11,11,0,192646.9,1653.727,128.1818
"23482","77162","2014",14,14,0,175678.6,1887.143,95.71429
"23483","77163","2014",4,4,0,190150,1924.75,113
"23484","77164","2014",6,6,0,203166.7,2037.5,114.5
"23485","77165","2014",3,3,0,240000,2615.333,101.3333
"23486","77167","2014",3,3,0,119333.3,1311.333,87.33333
"23487","77168","2014",17,17,0,138358.8,1566.176,90.52941
"23488","77169","2014",66,27,39,236770.2,2877.258,84.12121
"23489","77171","2014",81,60,21,211686.4,3050.765,74.45679
"23490","77172","2014",10,10,0,200380,2311.4,88.9
"23491","77173","2014",9,9,0,198500,2269.889,86.77778
"23492","77174","2014",4,4,0,128000,1391,99
"23493","77175","2014",23,22,1,261943.7,3098.087,95.13043
"23494","77176","2014",37,35,2,193482.6,2129.811,97.02703
"23495","77177","2014",11,10,1,250315.5,2773.455,109.3636
"23496","77178","2014",1,1,0,185000,1341,138
"23497","77179","2014",6,6,0,227308.3,1813.667,128
"23498","77180","2014",7,7,0,351214.3,2753.857,126
"23499","77181","2014",27,10,17,245651.7,3676.185,69
"23500","77182","2014",29,21,8,138012.2,1860.655,76.7931
"23501","77183","2014",114,75,39,172525,2182.693,87.74561
"23502","77184","2014",6,6,0,186333.3,1799.167,106.8333
"23503","77185","2014",9,8,1,345752.2,4006.333,106.3333
"23504","77186","2014",239,66,173,273267.6,3427.808,79.82008
"23505","77187","2014",6,6,0,116500,1447.833,86.83333
"23506","77188","2014",13,11,2,234161.5,2788.846,84.92308
"23507","77190","2014",4,4,0,197675,1565.25,146.5
"23508","77191","2014",11,10,1,152209.1,1876.364,80.72727
"23509","77192","2014",71,44,27,210153.5,2488.479,92.02817
"23510","77193","2014",3,3,0,229333.3,1761,140
"23511","77194","2014",2,2,0,155000,1893.5,77.5
"23512","77195","2014",6,6,0,208664,2338.333,92.16667
"23513","77196","2014",10,7,3,245925,2804.7,91
"23514","77197","2014",3,3,0,195833.3,1666.333,127.6667
"23515","77199","2014",9,9,0,196774.1,1980,103.3333
"23516","77200","2014",3,3,0,147000,879.6667,153
"23517","77201","2014",10,9,1,169400,2075.6,84.7
"23518","77202","2014",10,10,0,205340,2113.2,99
"23519","77203","2014",12,12,0,277421.7,2593.5,113
"23520","77204","2014",1,1,0,163000,1614,101
"23521","77205","2014",1,1,0,263000,3985,66
"23522","77207","2014",1,1,0,155000,1220,127
"23523","77208","2014",12,11,1,155129.6,1668,96.41667
"23524","77209","2014",15,13,2,271731,2868.6,100.1333
"23525","77210","2014",27,27,0,190791.1,2315.185,87.88889
"23526","77211","2014",8,8,0,182401.2,1935,93.75
"23527","77212","2014",3,3,0,120333.3,2135.667,53
"23528","77214","2014",9,5,4,256146,3025.778,90.66667
"23529","77215","2014",85,51,34,210770.5,2907.129,76.83529
"23530","77216","2014",11,11,0,212777.7,2289.909,91.36364
"23531","77217","2014",25,24,1,263218,2783.6,97.56
"23532","77218","2014",3,3,0,78666.67,1689.667,50
"23533","77219","2014",37,37,0,223983.2,2600.243,98.16216
"23534","77220","2014",8,8,0,182531.2,1805.375,102.625
"23535","77221","2014",17,16,1,290505.9,2831.765,106.9412
"23536","77222","2014",34,22,12,190177.1,2496.235,80.08824
"23537","77223","2014",7,7,0,176714.3,1572.571,118.1429
"23538","77224","2014",2,2,0,253500,3437,83
"23539","77225","2014",2,2,0,101833.5,1046.5,102
"23540","77226","2014",28,28,0,235122.9,2743.929,98.89286
"23541","77227","2014",6,6,0,128166.7,1095.167,130.3333
"23542","77228","2014",6,6,0,198500,1677.333,129.3333
"23543","77229","2014",17,16,1,230323.5,2450,98.70588
"23544","77230","2014",4,4,0,113250,1228.75,90
"23545","77231","2014",5,5,0,189000,2304.4,84.4
"23546","77232","2014",10,9,1,239956.6,2666.4,88.5
"23547","77233","2014",3,3,0,295000,2129.333,138
"23548","77234","2014",6,6,0,229033.3,2681.5,94
"23549","77235","2014",8,8,0,161125,1612.75,95.125
"23550","77236","2014",5,5,0,153800,1576.8,102.4
"23551","77237","2014",6,4,2,252383.3,3594.833,72.5
"23552","77238","2014",42,41,1,180797.6,2034.905,95.04762
"23553","77239","2014",16,15,1,174316.9,1833.938,99.125
"23554","77240","2014",31,31,0,150496.2,1912.387,85.6129
"23555","77241","2014",16,14,2,227318.8,2609.812,89.6875
"23556","77242","2014",3,3,0,167666.7,1713.333,99.33333
"23557","77243","2014",221,106,115,235476.5,3404.507,73.31222
"23558","77244","2014",6,6,0,253000,2197.333,113.1667
"23559","77245","2014",1,1,0,210000,1391,151
"23560","77246","2014",6,6,0,142333.3,1532.667,101.3333
"23561","77247","2014",4,4,0,180906.5,1725.75,112
"23562","77248","2014",5,5,0,238700,2039.2,118.2
"23563","77249","2014",81,76,5,314943.1,2976.802,106.8642
"23564","77251","2014",139,68,71,195253.6,2758.187,73.48201
"23565","77252","2014",3,3,0,343706.7,2154.333,160.6667
"23566","77253","2014",1,1,0,3e+05,3750,80
"23567","77254","2014",11,10,1,242300,2408.091,111
"23568","77255","2014",14,14,0,236800,2743.714,89.78571
"23569","77256","2014",1,1,0,165200,1332,124
"23570","77257","2014",20,14,6,134400,1973.55,69.25
"23571","77258","2014",104,21,83,196596.3,2802.067,71.93269
"23572","77259","2014",23,8,15,166511.5,2402.043,73.34783
"23573","77260","2014",6,5,1,156166.7,1897.333,91.66667
"23574","77261","2014",7,7,0,150853.6,1430.857,110.7143
"23575","77262","2014",5,5,0,145400,1487.8,102
"23576","77263","2014",1,1,0,288000,1485,194
"23577","77264","2014",21,19,2,228704.8,2095.429,108.7143
"23578","77265","2014",15,15,0,166383.3,1687,102.1333
"23579","77266","2014",6,6,0,238833.3,2178.167,116.3333
"23580","77267","2014",5,5,0,203780,1654.2,136.4
"23581","77268","2014",99,46,53,290901.5,3911.444,83.08081
"23582","77269","2014",17,12,5,171985.5,2548.529,67.82353
"23583","77270","2014",8,8,0,255500,2047.75,125.625
"23584","77271","2014",1,1,0,77500,842,92
"23585","77272","2014",7,7,0,159000,1701.143,97.57143
"23586","77273","2014",1,1,0,315500,3506,90
"23587","77274","2014",4,4,0,202000,1974,108
"23588","77276","2014",19,15,4,245505.3,2365.947,105.7368
"23589","77277","2014",18,16,2,212774.5,2210.444,105
"23590","77278","2014",2,2,0,207500,1166,194.5
"23591","77279","2014",9,9,0,185222.2,2206.778,87.77778
"23592","77280","2014",16,14,2,171343.8,1891,96.3125
"23593","77281","2014",5,5,0,227300,1813,127.4
"23594","77282","2014",1,1,0,80000,952,84
"23595","77283","2014",12,12,0,172416.7,1821.667,95.25
"23596","77284","2014",410,110,300,174842.6,2638.195,70.39268
"23597","77285","2014",116,50,66,148470.3,2015.362,75.69828
"23598","77286","2014",3,3,0,121666.7,1228.667,96.33333
"23599","77287","2014",8,8,0,151250,1567.125,101.875
"23600","77288","2014",320,60,260,148321.4,2606.975,61.5
"23601","77289","2014",1,1,0,225000,2206,102
"23602","77290","2014",5,5,0,141800,2063.2,76.4
"23603","77291","2014",5,5,0,185516.4,4683.6,49.6
"23604","77292","2014",12,10,2,208347.3,2513.167,86.66667
"23605","77293","2014",9,9,0,179016.7,2204.556,91.11111
"23606","77294","2014",154,118,36,216813.2,2962.24,78.24675
"23607","77295","2014",8,6,2,210268.8,1976.75,105.75
"23608","77296","2014",199,105,94,192283.1,2614.844,77.22111
"23609","77297","2014",3,3,0,204000,1449,143.6667
"23610","77298","2014",2,2,0,130000,1593.5,90.5
"23611","77300","2014",3,3,0,217666.7,1899,118.3333
"23612","77301","2014",1,1,0,330000,1919,172
"23613","77302","2014",24,23,1,195655.4,2008.958,105.625
"23614","77303","2014",2,2,0,133500,1844,71.5
"23615","77304","2014",1,1,0,185000,1321,140
"23616","77305","2014",115,41,74,119377.1,1992.287,63.74783
"23617","77306","2014",4,4,0,259600,2005.75,142.25
"23618","77307","2014",126,44,82,245114.7,3543.651,72.03968
"23619","77308","2014",6,6,0,225530.7,2916,76.83333
"23620","77309","2014",19,17,2,201565.8,2402.947,88.89474
"23621","77310","2014",3,3,0,113200,1430,78.66667
"23622","77311","2014",18,16,2,170227.8,1887.722,97.61111
"23623","77312","2014",26,20,6,258985,2898.038,98.03846
"23624","77313","2014",1,1,0,210000,955,220
"23625","77314","2014",3,3,0,123333.3,1167.333,106.6667
"23626","77315","2014",48,42,6,248130.8,2975.917,89.25
"23627","77316","2014",146,113,33,195684.3,2487.021,84.79452
"23628","77317","2014",28,24,4,192413.3,2267.25,87.71429
"23629","77318","2014",14,8,6,171607.1,2380.786,75.14286
"23630","77319","2014",4,4,0,152250,1651,92.75
"23631","77320","2014",62,55,7,182657.7,2182.242,88.46774
"23632","77321","2014",12,6,6,106694.2,1533.5,68
"23633","77322","2014",41,34,7,239005.4,2959.488,86.07317
"23634","77323","2014",16,12,4,207032.5,3075.5,72.875
"23635","77325","2014",4,4,0,122250,1395.5,89.75
"23636","77326","2014",53,41,12,228818.7,2503.906,94.60377
"23637","77327","2014",46,37,9,159592.7,2085.804,81.58696
"23638","77328","2014",4,4,0,171216.5,2084,91.5
"23639","77329","2014",4,4,0,249250,1857.75,139.75
"23640","77330","2014",60,50,10,224946,2815.883,86.3
"23641","77331","2014",11,7,4,126318.2,2175.364,67.45455
"23642","77332","2014",2,2,0,245000,2512.5,98
"23643","77333","2014",101,64,37,164916.5,2254.545,77.52475
"23644","77335","2014",14,10,4,224317.1,2419.214,98.42857
"23645","77336","2014",11,10,1,233090.9,2366.909,100.0909
"23646","77337","2014",80,22,58,203616.9,2726.787,77.5375
"23647","77338","2014",1,1,0,75000,1136,66
"23648","77339","2014",29,23,6,300432.8,2686.724,132.1724
"23649","77340","2014",8,8,0,223718.8,1920.5,127.875
"23650","77341","2014",7,7,0,134685.7,1502,90.85714
"23651","77342","2014",1,1,0,85000,944,90
"23652","77343","2014",5,5,0,161160,1408.4,108.4
"23653","77344","2014",16,16,0,240312.5,2632.75,93.375
"23654","77345","2014",6,6,0,212000,1644.833,130.6667
"23655","77347","2014",5,5,0,160400,1484,113
"23656","77348","2014",3,3,0,124333.3,1646.333,77.33333
"23657","77349","2014",78,72,6,229562.1,2498.538,94.17949
"23658","77350","2014",188,145,43,285075.4,3168.468,95.78723
"23659","77352","2014",25,25,0,256576,2509.76,105.44
"23660","77353","2014",5,5,0,181110.6,2475.4,79.2
"23661","77354","2014",10,10,0,169946.9,2392.1,75.5
"23662","77355","2014",3,3,0,122666.7,1174.667,110
"23663","77356","2014",1,1,0,155000,2067,75
"23664","77357","2014",7,7,0,197285.7,1993.143,111.1429
"23665","77358","2014",10,10,0,176550,2216.8,84.2
"23666","77359","2014",18,17,1,273238.9,2688.278,105.1111
"23667","77360","2014",5,5,0,220460,2279.4,107.2
"23668","77361","2014",1,0,1,190000,1863,102
"23669","77363","2014",15,10,5,231038.7,2859.133,85.6
"23670","77364","2014",3,3,0,232333.3,2656,97.66667
"23671","77365","2014",5,5,0,228760,2217.8,106.4
"23672","77366","2014",3,2,1,195333.3,2299.667,88.66667
"23673","77368","2014",4,4,0,190425,1985.25,96.25
"23674","77369","2014",4,4,0,228500,2236,111
"23675","77370","2014",9,8,1,171444.4,1599,110
"23676","77371","2014",26,23,3,182811.5,2418.885,80.61538
"23677","77372","2014",42,30,12,387187.6,3367.119,117.8333
"23678","77373","2014",356,204,152,233333.5,3339.59,73.98315
"23679","77374","2014",27,21,6,244571.5,2586.185,100.3704
"23680","77376","2014",6,6,0,299416.7,3569.667,83.33333
"23681","77377","2014",17,16,1,242688.2,2520.647,103.7059
"23682","77378","2014",36,19,17,205323.5,3010.528,77.30556
"23683","77379","2014",88,46,42,158074.6,1924.08,87.34091
"23684","77381","2014",2,2,0,211245,1797,117.5
"23685","77382","2014",53,38,15,204544,2563,85.56604
"23686","77383","2014",8,8,0,204665.6,1748.75,108.625
"23687","77384","2014",14,14,0,204128.4,2973.429,77.64286
"23688","77385","2014",14,13,1,159535.7,2060.357,91.21429
"23689","77386","2014",9,9,0,220150,1857.556,132.5556
"23690","77387","2014",3,3,0,198333.3,2887.333,73.33333
"23691","77388","2014",15,15,0,171060.2,2046.467,85.66667
"23692","77389","2014",42,23,19,222414,2974.19,78.66667
"23693","77390","2014",202,136,66,231331.9,2835.985,85.85644
"23694","77391","2014",3,3,0,167666.7,1739.667,95
"23695","77392","2014",4,4,0,272875,2365.25,119
"23696","77393","2014",32,28,4,216481.6,2504.094,88.875
"23697","77394","2014",13,12,1,263115.4,2261.923,117.5385
"23698","77395","2014",1,1,0,240000,3000,80
"23699","77396","2014",1,1,0,180000,1667,108
"23700","77397","2014",17,15,2,130000,1923.706,74.29412
"23701","77398","2014",12,12,0,142791.7,1525.25,111.5
"23702","77400","2014",28,27,1,253671.4,2379.321,116.8929
"23703","77401","2014",15,15,0,162033.3,1965.067,81.73333
"23704","77402","2014",4,4,0,154500,1488,107.75
"23705","77403","2014",9,9,0,192205.6,1722.778,111
"23706","77404","2014",14,14,0,231285.7,2308.286,91.92857
"23707","77405","2014",20,20,0,173395.5,1551,109.95
"23708","77406","2014",14,14,0,170428.6,1764.857,96.07143
"23709","77407","2014",124,70,54,227851,2783.806,85.45968
"23710","77408","2014",2,2,0,228000,2941.5,77.5
"23711","77409","2014",21,21,0,173371.4,2027.571,89.38095
"23712","77410","2014",6,6,0,267950,2543.5,117.1667
"23713","77411","2014",6,6,0,207091.7,2003.167,105.8333
"23714","77412","2014",4,4,0,334750,2056,158.75
"23715","77413","2014",43,41,2,259142.6,2854.791,95.95349
"23716","77414","2014",4,4,0,135000,1553.5,84.5
"23717","77415","2014",9,9,0,170222.2,2190.556,87.11111
"23718","77416","2014",4,4,0,164000,2159.5,79.5
"23719","77418","2014",7,6,1,147142.9,1605.143,97.14286
"23720","77419","2014",36,29,7,163874.9,2286.083,73.52778
"23721","77420","2014",35,28,7,209235,2879.114,78.25714
"23722","77421","2014",4,4,0,123500,1512.5,80.5
"23723","77423","2014",4,4,0,95812.5,1644,59
"23724","77424","2014",4,4,0,160750,1629.75,100.25
"23725","77425","2014",7,7,0,273764.3,2328,120.1429
"23726","77426","2014",7,7,0,189552.9,2542,82.85714
"23727","77427","2014",6,6,0,241916.7,2687,94.16667
"23728","77428","2014",2,2,0,157000,1673,91
"23729","77429","2014",9,9,0,197222.2,2531.778,94.77778
"23730","77430","2014",65,63,2,244705,2499.708,100.9077
"23731","77431","2014",49,42,7,166122.4,1821.367,93.26531
"23732","77432","2014",18,15,3,172325,1858.944,96.66667
"23733","77433","2014",19,19,0,178726.4,2314.474,86.31579
"23734","77434","2014",7,7,0,124428.6,2317.286,56.42857
"23735","77435","2014",8,8,0,345675,2350.5,155.875
"23736","77436","2014",13,13,0,170461.5,1766.692,100.5385
"23737","77437","2014",40,32,8,222177.5,2623.475,86.85
"23738","77438","2014",60,43,17,263567.4,2876.8,92.88333
"23739","77439","2014",6,6,0,155833.3,1524.5,109.5
"23740","77440","2014",13,13,0,329977.7,3055.308,99.23077
"23741","77441","2014",20,20,0,259670,2645.5,102.75
"23742","77442","2014",17,17,0,256682.4,2422.941,113.7059
"23743","77443","2014",5,5,0,227535,2034,130.2
"23744","77444","2014",2,2,0,237500,1731,140.5
"23745","77445","2014",222,140,82,201014.4,2432.014,85.13514
"23746","77446","2014",8,8,0,175508,1521.375,119.875
"23747","77447","2014",22,18,4,291351,3025.409,104.2273
"23748","77448","2014",5,5,0,242750,2347.8,106.6
"23749","77449","2014",111,17,94,224144.2,3667.297,64.54054
"23750","77450","2014",30,25,5,290910.3,2690.167,112.9667
"23751","77451","2014",5,5,0,206440,1890.2,108.8
"23752","77453","2014",7,7,0,243471.4,2449.286,110.8571
"23753","77454","2014",5,5,0,153960,2080.4,79.2
"23754","77455","2014",29,20,9,192322.5,2488.276,92.75862
"23755","77456","2014",4,4,0,165000,1935.5,84.5
"23756","77457","2014",12,7,5,222250,2519.75,90.16667
"23757","77458","2014",47,44,3,141666,1767.362,87.65957
"23758","77459","2014",14,14,0,148335.4,1352.5,109.7857
"23759","77460","2014",5,5,0,200600,1842.4,112.8
"23760","77461","2014",7,7,0,154357.1,1338.571,119.1429
"23761","77462","2014",8,6,2,208312.5,2749.625,83.25
"23762","77463","2014",46,41,5,236250.5,2757.696,95.19565
"23763","77464","2014",101,55,46,235694.7,2997.782,82.08911
"23764","77465","2014",6,6,0,137116.7,1718.167,76.16667
"23765","77466","2014",3,2,1,163333.3,2470.667,68.66667
"23766","77467","2014",3,3,0,213000,2942.333,77.66667
"23767","77468","2014",178,56,122,208059,2967.742,72.92697
"23768","77469","2014",12,12,0,227841.7,2536.917,102.8333
"23769","77470","2014",77,46,31,241156.8,3091.688,81.80519
"23770","77471","2014",2,2,0,187000,1724.5,118.5
"23771","77472","2014",1,1,0,235000,1567,150
"23772","77473","2014",6,6,0,207750,2358.667,90.66667
"23773","77474","2014",10,5,5,157200,2566.5,68.4
"23774","77475","2014",41,36,5,206709.8,2683.585,86.39024
"23775","77476","2014",2,2,0,216500,2054.5,106
"23776","77477","2014",7,7,0,249287.3,2394.286,104.7143
"23777","77478","2014",12,12,0,195799,1624,127.6667
"23778","77479","2014",113,55,58,235992.8,3115.336,79.0177
"23779","77480","2014",5,5,0,187200,2065,103
"23780","77481","2014",2,2,0,197500,1656,120.5
"23781","77482","2014",34,29,5,153643.4,2145.382,76.61765
"23782","77483","2014",25,20,5,193366,2252.92,87.44
"23783","77484","2014",4,4,0,193655,1794.25,114.75
"23784","77485","2014",9,8,1,278638.9,2961.889,94.88889
"23785","77486","2014",9,9,0,194355.6,2356.889,98.33333
"23786","77487","2014",85,58,27,223151.9,2607.153,89.09412
"23787","77489","2014",5,5,0,115918,876.4,135.6
"23788","77490","2014",7,7,0,140428.6,1597.857,93.14286
"23789","77492","2014",11,11,0,171454.5,1472.091,123.0909
"23790","77493","2014",23,20,3,212249.1,2783.652,82
"23791","77494","2014",32,32,0,196018.3,2224.5,92.5625
"23792","77495","2014",58,57,1,236065,2666.983,91.46552
"23793","77496","2014",1,1,0,140000,1538,91
"23794","77498","2014",3,3,0,202616.7,2320.667,90
"23795","77500","2014",7,7,0,182585.7,2040.714,94.85714
"23796","77501","2014",10,10,0,211500,1774.4,123.1
"23797","77504","2014",5,5,0,192580,1550.2,127.6
"23798","77505","2014",3,3,0,114100,1166.333,86.66667
"23799","77506","2014",6,6,0,174350,1864.833,95.66667
"23800","77507","2014",1,1,0,30000,2000,15
"23801","77508","2014",28,20,8,262774.9,2671.393,102.0357
"23802","77509","2014",6,6,0,170500,1747.5,99.16667
"23803","77510","2014",7,6,1,215857.1,1906.857,131.2857
"23804","77511","2014",3,3,0,244000,2584,103
"23805","77512","2014",9,9,0,149328.4,1599.667,98.44444
"23806","77513","2014",47,28,19,182286,2640.213,73.3617
"23807","77514","2014",245,130,115,191916.9,3015.192,67.85306
"23808","77515","2014",8,8,0,248593.8,2500.375,107
"23809","77516","2014",3,3,0,141666.7,1729,98.33333
"23810","77517","2014",14,13,1,294025.7,2615.929,120.5714
"23811","77518","2014",2,2,0,288240,2683.5,109.5
"23812","77519","2014",11,10,1,179181.8,1296.818,130.5455
"23813","77520","2014",10,10,0,276830,2108.1,133.5
"23814","77521","2014",16,14,2,276268.8,2702.125,108
"23815","77522","2014",4,4,0,140000,1380,98.75
"23816","77523","2014",5,5,0,150800,1379.4,111.8
"23817","77524","2014",3,3,0,150833.3,1231.667,125
"23818","77525","2014",2,2,0,236500,2608,92.5
"23819","77526","2014",5,5,0,128000,1425.2,92.8
"23820","77527","2014",2,2,0,273500,1966,139
"23821","77528","2014",5,5,0,195100,2459.6,83.8
"23822","77529","2014",15,15,0,260186.7,2847.667,102.2667
"23823","77530","2014",1,1,0,210000,1615,130
"23824","77531","2014",22,21,1,121976.5,1610.318,82.59091
"23825","77533","2014",30,29,1,257102,2492.867,104.7667
"23826","77534","2014",10,9,1,262373.3,2712.6,107.5
"23827","78003","2014",31,29,2,223209.7,2316.032,102.7419
"23828","78005","2014",122,66,56,257362.4,3382.68,78.41803
"23829","78006","2014",6,6,0,301116.7,2648,121
"23830","78007","2014",8,8,0,592856.2,3898,154.75
"23831","78009","2014",3,3,0,188400,2233.333,86.66667
"23832","78010","2014",8,8,0,391750,3323.25,129.75
"23833","78015","2014",148,73,75,283631.7,3349.649,87.67568
"23834","78020","2014",10,9,1,224180.6,2233.8,111.1
"23835","78029","2014",96,48,48,189832.5,2506.271,77.54167
"23836","78030","2014",21,18,3,285474.7,2833.81,121.5238
"23837","78031","2014",7,7,0,160857.1,2262.286,78.14286
"23838","78033","2014",10,10,0,299092,2594.5,120.8
"23839","78034","2014",4,4,0,279375,3756.25,73.75
"23840","78036","2014",4,4,0,290675,2817.5,149.5
"23841","78043","2014",43,19,24,400304.2,4327.558,92.23256
"23842","78048","2014",20,19,1,271549.9,2385.6,119.6
"23843","78049","2014",4,4,0,302437.5,3600.75,91.25
"23844","78050","2014",2,1,1,263600,2452.5,106
"23845","78053","2014",5,5,0,333640,3250,105.4
"23846","78057","2014",21,21,0,178031.7,2038.81,93.14286
"23847","78062","2014",91,65,26,244632.9,3008.582,86.62637
"23848","78068","2014",2,2,0,266575,1628,157.5
"23849","78070","2014",4,4,0,336150,2073.25,165.5
"23850","78071","2014",3,3,0,203666.7,1594.333,127.3333
"23851","78072","2014",2,2,0,248860,2574,97.5
"23852","78073","2014",189,47,142,234536.1,3327.233,71.52381
"23853","78076","2014",5,5,0,222770,2550,87.8
"23854","78077","2014",5,5,0,233420,1820.2,130.4
"23855","78082","2014",6,6,0,245333.3,2221.5,121.8333
"23856","78084","2014",4,4,0,226600,2394.75,97
"23857","78087","2014",20,20,0,319885,2870.9,114.9
"23858","78089","2014",29,23,6,179165.5,2121.379,91.55172
"23859","78092","2014",98,35,63,440700.8,4398.429,98.10204
"23860","78096","2014",6,6,0,360525,3928.667,110.8333
"23861","78104","2014",7,7,0,229300,2177.571,118
"23862","78107","2014",16,16,0,217290.6,2324.125,99.5
"23863","78108","2014",10,8,2,369594.2,3415.3,108.5
"23864","78113","2014",6,6,0,243500,2674.667,95.66667
"23865","78117","2014",60,30,30,423776.5,4780.117,90.43333
"23866","78118","2014",12,12,0,275062.5,2677.25,104
"23867","78120","2014",22,22,0,322971.4,2750.091,123.4091
"23868","78123","2014",130,56,74,227608.2,3357.808,70.36154
"23869","78124","2014",166,69,97,358241.5,4649.114,78.43976
"23870","78125","2014",6,6,0,329083.3,3658.833,89.66667
"23871","78126","2014",186,56,130,407280,4407.435,88.56989
"23872","78128","2014",11,10,1,333913.9,2881.091,119.8182
"23873","78133","2014",44,22,22,501798,4147.318,115.2955
"23874","78138","2014",47,38,9,229865,2776.915,86.61702
"23875","78140","2014",12,12,0,298616.7,2801.75,107
"23876","78143","2014",19,14,5,389239.5,4224.737,105.3684
"23877","78146","2014",349,108,241,397180.4,4894.052,80.00287
"23878","78147","2014",5,5,0,223600,1874.2,127.8
"23879","78152","2014",19,19,0,573157.1,3923.842,154.2632
"23880","78158","2014",195,57,138,477876.9,5442.349,84.6
"23881","78160","2014",66,42,24,335155.3,3608.091,105.0758
"23882","78162","2014",5,5,0,428460,3333.6,129.2
"23883","78163","2014",5,5,0,231140,1967.8,117.6
"23884","78164","2014",9,7,2,344827.8,3245.111,117.2222
"23885","78165","2014",189,79,110,242665.5,3318.513,75.12698
"23886","78168","2014",28,20,8,279924.8,3040.714,93.07143
"23887","78171","2014",7,7,0,307352.9,2526.714,123.1429
"23888","78172","2014",376,229,147,252814.9,3546.62,74.74734
"23889","78188","2014",3,3,0,276930,2509,110.3333
"23890","78189","2014",8,8,0,618477,4091.625,167.875
"23891","78190","2014",121,51,70,517217.7,5450.81,94.17355
"23892","78192","2014",7,7,0,286642.9,2357,125
"23893","78193","2014",9,8,1,466024.4,3834.667,124.6667
"23894","78194","2014",2,2,0,259875,2393,108.5
"23895","78196","2014",3,1,2,184006.7,2715.333,68
"23896","78202","2014",2,2,0,264500,2491.5,106.5
"23897","78208","2014",360,109,251,215388.1,2761.203,79.74444
"23898","78209","2014",9,8,1,238188.9,2394.222,103
"23899","78217","2014",62,52,10,229914.3,2696.5,90.29032
"23900","78220","2014",82,60,22,286788.4,3057.061,98.2439
"23901","78224","2014",49,26,23,402000.3,4367.245,91.26531
"23902","78227","2014",8,8,0,302106.2,3111.25,102.25
"23903","78230","2014",6,5,1,302716.7,2074.167,157.1667
"23904","78233","2014",21,20,1,512017.6,4616.667,120.381
"23905","78234","2014",2,2,0,189360,2076.5,123.5
"23906","78236","2014",3,3,0,288066.7,2994.333,113.3333
"23907","78237","2014",4,4,0,235125,2096.25,121.5
"23908","78238","2014",1,1,0,3e+05,3488,86
"23909","78239","2014",9,8,1,160038.9,2265.889,83.88889
"23910","78242","2014",118,27,91,228327.6,3296.737,68.09322
"23911","78245","2014",1,1,0,98500,724,136
"23912","78246","2014",10,10,0,322022,2287.1,144.2
"23913","78255","2014",31,29,2,184853.2,2230.258,85.22581
"23914","78261","2014",4,4,0,247277.5,2332.5,112.75
"23915","78262","2014",12,12,0,297181.2,3304.833,92.58333
"23916","78263","2014",32,31,1,373799.2,2906.875,133.7188
"23917","78264","2014",1,1,0,768100,4267,180
"23918","78265","2014",19,17,2,277507.9,3311.579,90.05263
"23919","78267","2014",49,44,5,222091.3,2713.776,90.18367
"23920","78269","2014",10,9,1,235590,2590.7,96.7
"23921","78276","2014",7,7,0,247314.3,2195.429,122.1429
"23922","78278","2014",4,4,0,340000,2477.75,143
"23923","78281","2014",4,4,0,405250,2057,197.75
"23924","78283","2014",2,2,0,218800,1970,111.5
"23925","78285","2014",7,7,0,353992.9,2570.714,148.7143
"23926","78289","2014",9,8,1,520487.2,4155.889,114.2222
"23927","78290","2014",7,7,0,192057.1,2074.571,94
"23928","78291","2014",17,13,4,173832.4,2446.235,74.17647
"23929","78296","2014",4,4,0,223175,1885,135.5
"23930","78297","2014",213,57,156,273059.5,3669.178,75.74178
"23931","78299","2014",20,15,5,193190,2122.9,95.75
"23932","78300","2014",3,3,0,228800,2272.667,101.6667
"23933","78302","2014",2,2,0,1025000,5277.5,177.5
"23934","78305","2014",3,3,0,399333.3,3633,112.3333
"23935","78307","2014",12,12,0,244980,3267.25,89.08333
"23936","78310","2014",45,26,19,231334.5,3037.978,81.33333
"23937","78311","2014",391,191,200,292133.3,4469.616,67.6266
"23938","78314","2014",26,25,1,206988.5,2273.154,92.46154
"23939","78317","2014",8,8,0,254025,2212.125,118
"23940","78320","2014",3,2,1,225000,2100,111.3333
"23941","78321","2014",63,51,12,313318.9,3364.667,101.0476
"23942","78322","2014",61,24,37,388647.6,4188.59,93.4918
"23943","78324","2014",3,3,0,235266.7,2322.333,109.3333
"23944","78325","2014",7,7,0,266857.1,2777.571,105
"23945","78327","2014",28,23,5,222971.4,2572.964,89.67857
"23946","78329","2014",5,5,0,182200,1620.8,106.4
"23947","78334","2014",15,15,0,391272.7,3236.467,134.0667
"23948","78335","2014",99,71,28,183509,2262.758,83.9798
"23949","78337","2014",19,19,0,238625.8,2500.474,113.1579
"23950","78343","2014",11,8,3,562559.1,4979.727,108.7273
"23951","78344","2014",6,6,0,165000,2433.5,68.33333
"23952","78346","2014",12,12,0,233833.3,2096.333,126.3333
"23953","78349","2014",6,6,0,265750,2455.667,117.1667
"23954","78350","2014",53,15,38,464246.9,4559.547,102.8679
"23955","78354","2014",53,49,4,217370.2,2521.585,89.09434
"23956","78356","2014",72,49,23,311286.3,3306.694,99.38889
"23957","78358","2014",299,71,228,394395.4,4915.234,79.93645
"23958","78361","2014",261,76,185,163378.3,2439.736,68.12644
"23959","78362","2014",130,89,41,184100.8,2407.808,80.04615
"23960","78364","2014",7,7,0,255014.3,2447,118.7143
"23961","78366","2014",1,1,0,125000,710,176
"23962","78367","2014",43,25,18,470624.4,4370,106.1163
"23963","78368","2014",17,16,1,358301.8,3030.765,123.8824
"23964","78372","2014",206,40,166,319174.2,3940.961,79.56796
"23965","78380","2014",53,48,5,307813.3,2978.057,110.3019
"23966","78381","2014",9,9,0,279036.7,2710.333,105.8889
"23967","78382","2014",40,26,14,273074,3629.325,79.475
"23968","78383","2014",228,106,122,233865.1,2853.724,84.61842
"23969","78384","2014",12,12,0,407928.3,3644.75,122
"23970","78385","2014",3,3,0,265833.3,3015.667,95.66667
"23971","78389","2014",18,17,1,452912.3,3492.556,125.0556
"23972","78391","2014",8,8,0,150875,2734.75,62.25
"23973","78396","2014",76,36,40,441467.6,4520.079,96.97368
"23974","78397","2014",92,73,19,319725.9,3158.924,104.663
"23975","78398","2014",9,9,0,576955.6,3836.111,148
"23976","78401","2014",96,36,60,186277.3,2762.427,74.22917
"23977","78402","2014",38,26,12,220967.1,2801.053,82.15789
"23978","78403","2014",28,25,3,270473.2,2548.893,112.7143
"23979","78404","2014",1,1,0,292800,3660,80
"23980","78407","2014",4,4,0,272000,2985.75,115.75
"23981","78410","2014",16,16,0,234750,2119.812,114.125
"23982","78413","2014",6,6,0,227166.7,1870.167,122.3333
"23983","78415","2014",2,2,0,274000,2983,93.5
"23984","78416","2014",2,2,0,217500,2916.5,75
"23985","78417","2014",6,6,0,251350,2195.833,131.6667
"23986","78418","2014",162,92,70,381787.5,4318.883,89.92593
"23987","78420","2014",20,11,9,453860,3731.35,114.05
"23988","78423","2014",349,104,245,285148.8,3639.808,80.18338
"23989","78431","2014",24,24,0,409237.5,3463.042,122.2083
"23990","78437","2014",6,6,0,255995,2243,122.5
"23991","78439","2014",2,2,0,268125,2030.5,132
"23992","78440","2014",154,79,75,155561.8,2255.773,72.5
"23993","78442","2014",38,14,24,255469.1,3564.947,73.92105
"23994","78444","2014",9,9,0,222253.7,2237.111,104.4444
"23995","78451","2014",14,12,2,209357.1,2364.643,94.42857
"23996","78455","2014",51,39,12,526072.2,4766.706,113.3922
"23997","78460","2014",13,10,3,193538.1,2804.923,75
"23998","78464","2014",10,10,0,266700,2249.7,121.1
"23999","78465","2014",18,17,1,272944.4,2574.5,110.6667
"24000","78466","2014",62,57,5,514959,4239.919,131.9839
"24001","78470","2014",8,8,0,234425,2344.375,114.375
"24002","78472","2014",4,4,0,176800,1990.75,92.25
"24003","78474","2014",8,8,0,237250,2797.125,91.875
"24004","78475","2014",3,3,0,236766.7,3086.333,72.33333
"24005","78478","2014",2,2,0,190500,2272.5,82.5
"24006","78481","2014",164,30,134,319715.9,4346.122,73.18293
"24007","78484","2014",4,4,0,211625,2156.25,108.75
"24008","78490","2014",300,108,192,231913.8,2984.657,79.24
"24009","78497","2014",10,10,0,273310,2946.9,105.3
"24010","78498","2014",308,74,234,245088.5,3655.282,68.47727
"24011","78499","2014",9,9,0,266250,2197.222,128.2222
"24012","78501","2014",29,26,3,190063.5,2461.897,83.89655
"24013","78502","2014",52,7,45,270000.7,3614.596,76.15385
"24014","78505","2014",5,5,0,280200,2608.4,112.4
"24015","78506","2014",13,13,0,257018.6,2214.385,119.0769
"24016","78513","2014",20,14,6,303226,3457.85,92
"24017","78516","2014",11,11,0,318756.4,2159.273,164
"24018","78517","2014",310,125,185,252954.8,3302.506,79.14839
"24019","78518","2014",3,3,0,655000,3370.667,195
"24020","78520","2014",11,10,1,318839.6,2660,125.5455
"24021","78522","2014",11,9,2,358254.5,2965.364,131
"24022","78528","2014",4,4,0,135800,2044,66.25
"24023","78530","2014",5,5,0,235400,2141.8,125.2
"24024","78531","2014",64,48,16,180155.5,2407.906,80.6875
"24025","78536","2014",6,4,2,228166.7,2585.333,96.5
"24026","78537","2014",72,59,13,256277.2,2673.097,102.7083
"24027","78545","2014",169,44,125,255004.3,3751.29,70.20118
"24028","78548","2014",3,3,0,535000,3233,168.3333
"24029","78550","2014",14,14,0,335221.4,3217,109.2143
"24030","78551","2014",447,83,364,459057.4,5471.094,83.51678
"24031","78557","2014",6,6,0,247841.7,2193.333,134.1667
"24032","78558","2014",4,4,0,215000,2260.25,102.25
"24033","78559","2014",3,2,1,176000,2239.667,93.33333
"24034","78561","2014",5,5,0,432600,3579.6,135.6
"24035","78562","2014",7,5,2,309614.3,3102.429,95.14286
"24036","78564","2014",10,10,0,216638.3,2154.3,100
"24037","78565","2014",2,2,0,381800,2970,127
"24038","78567","2014",7,7,0,216857.1,2583.429,94
"24039","78569","2014",10,10,0,244710,2482.4,101.1
"24040","78571","2014",47,40,7,597310.7,4347.702,143.5106
"24041","78575","2014",78,59,19,384594.7,4076.372,101.3333
"24042","78576","2014",21,15,6,334971.9,3382.095,108.8571
"24043","78586","2014",532,234,298,265529,3855.951,71.11278
"24044","78588","2014",5,5,0,340610,3702,96.6
"24045","78590","2014",3,3,0,342333.3,3407,116.6667
"24046","78591","2014",17,16,1,235688.2,2352.471,114.3529
"24047","78597","2014",4,4,0,199950,2048.25,100.75
"24048","78601","2014",14,14,0,272054.3,2577.571,109.2143
"24049","78605","2014",8,8,0,276177.5,3136.25,93
"24050","78608","2014",1,1,0,92500,1171,79
"24051","78609","2014",10,10,0,251215,2726.3,95.7
"24052","78615","2014",8,7,1,335126.2,4049.75,82.75
"24053","78616","2014",18,15,3,258285,2746.889,118.6111
"24054","78618","2014",9,9,0,205705.6,2346.556,88.44444
"24055","78620","2014",8,8,0,481437.5,4024.5,124.75
"24056","78621","2014",161,44,117,182738.5,2767.689,68.85093
"24057","78624","2014",134,87,47,253023.7,3199.634,82.67164
"24058","78638","2014",44,34,10,234607.4,3169.136,79.72727
"24059","78640","2014",158,31,127,300087,4092.81,73.29747
"24060","78642","2014",164,71,93,266925.9,3303.049,83.92073
"24061","78643","2014",73,55,18,303344.8,3144.575,102.6986
"24062","78644","2014",10,6,4,209752.8,3409.2,62.4
"24063","78646","2014",878,104,774,435658.1,5735.997,75.2631
"24064","78647","2014",9,9,0,211388.9,2432.333,95.11111
"24065","78650","2014",193,80,113,631997.7,6002.394,99.81865
"24066","78653","2014",3,3,0,198000,2795,76.66667
"24067","78655","2014",5,5,0,380600,4046.8,128.8
"24068","78668","2014",2,2,0,221000,1726,135.5
"24069","78672","2014",44,23,21,393500.8,4437.25,95.20455
"24070","78674","2014",115,96,19,309426.6,3527.896,88.13913
"24071","78677","2014",6,6,0,263916.7,2120.667,127.6667
"24072","78681","2014",5,5,0,299144,2788.6,121
"24073","78686","2014",205,56,149,398180.1,5366.81,72.26829
"24074","78688","2014",119,86,33,397097.8,4210.269,97.35294
"24075","79001","2014",10,10,0,95540,1002.4,97.5
"24076","79002","2014",1,1,0,33600,425,79
"24077","79003","2014",32,32,0,202820.3,1734.062,117.25
"24078","79005","2014",30,30,0,78866.67,826.8,92.96667
"24079","79007","2014",6,6,0,136833.3,1010.333,139.5
"24080","79008","2014",6,6,0,94833.33,1045.167,90.83333
"24081","79009","2014",1,1,0,120000,960,125
"24082","79010","2014",7,7,0,112528.6,1370.571,85.71429
"24083","79012","2014",8,8,0,107875,1037.75,108.625
"24084","79013","2014",27,27,0,69523.78,801.2593,87.37037
"24085","79014","2014",21,21,0,81935.05,823.1905,100.7143
"24086","79015","2014",1,1,0,140000,1458,96
"24087","79016","2014",4,4,0,82125,722.25,108.75
"24088","79018","2014",2,2,0,97250,975,97
"24089","79019","2014",2,2,0,47500,746,66.5
"24090","79020","2014",5,5,0,108876.4,1224,93.6
"24091","79022","2014",2,2,0,73000,1015.5,74
"24092","79023","2014",3,3,0,91666.67,1181.667,79.33333
"24093","79024","2014",11,11,0,126745.5,1191.545,104.8182
"24094","79025","2014",12,12,0,96129.17,1070.833,95.41667
"24095","79029","2014",6,6,0,137620,1148.167,121.8333
"24096","79030","2014",8,8,0,102125,963,109
"24097","79031","2014",19,19,0,154377.6,1356,119.5789
"24098","79032","2014",7,7,0,143214.3,1307,114.1429
"24099","79034","2014",8,8,0,156087.5,1466.75,104.375
"24100","79038","2014",4,4,0,98287.5,1106.5,96.5
"24101","79046","2014",6,6,0,252716.7,1713.5,149.5
"24102","79047","2014",7,7,0,74071.43,946.5714,77.42857
"24103","79048","2014",53,53,0,150591.5,1555.66,99.86792
"24104","79049","2014",144,130,14,111666.2,1209.528,93.41667
"24105","79050","2014",6,6,0,91133.33,878.6667,103
"24106","79056","2014",4,4,0,83000,919.5,87
"24107","79057","2014",12,12,0,93791.67,1034.167,91
"24108","79058","2014",4,4,0,121740,1233.25,101.75
"24109","79059","2014",3,3,0,71500,1301.333,90.66667
"24110","79060","2014",2,2,0,84850,633.5,134
"24111","79061","2014",33,33,0,124289.8,1133.667,109.7879
"24112","79062","2014",22,22,0,83659.09,997.3182,83.86364
"24113","79063","2014",21,21,0,79852.38,879.9048,88.95238
"24114","79064","2014",2,2,0,127500,1249,102
"24115","79066","2014",14,14,0,116375,1005.786,122.5714
"24116","79069","2014",2,2,0,132000,1055.5,125
"24117","79070","2014",3,3,0,175261.7,1289,142.3333
"24118","79071","2014",3,3,0,103666.7,929.6667,116
"24119","79074","2014",5,5,0,89500,1042.8,81.4
"24120","79076","2014",18,18,0,94805.56,1000.056,94.55556
"24121","79077","2014",10,10,0,94749.5,898.9,106.7
"24122","79078","2014",13,13,0,142869.2,1099.231,132.6923
"24123","79079","2014",47,47,0,118598.9,1119.894,108.5532
"24124","79080","2014",19,19,0,119761.1,1205.263,102.6316
"24125","79081","2014",43,43,0,170525.4,1625.674,105.2558
"24126","79083","2014",17,17,0,85798.59,996,90.41176
"24127","79084","2014",6,6,0,99616.67,925.8333,105.8333
"24128","79085","2014",3,3,0,176083.3,1178,157.3333
"24129","79086","2014",12,12,0,104145.8,1022.25,111.5
"24130","79087","2014",5,5,0,90600,988,83
"24131","79088","2014",9,9,0,138694.4,1076.444,124.2222
"24132","79089","2014",2,2,0,107500,812.5,154
"24133","79090","2014",8,8,0,92250,810.5,119.125
"24134","79091","2014",7,7,0,103461.1,943.5714,105.8571
"24135","79092","2014",3,3,0,76566.67,1240.667,66
"24136","79094","2014",3,3,0,139333.3,1162.667,122
"24137","79095","2014",14,14,0,107578.6,892.6429,123.7857
"24138","79096","2014",7,7,0,110471.4,821.4286,119.5714
"24139","79100","2014",23,23,0,163374.6,1359.217,115.913
"24140","79101","2014",22,22,0,100211.4,1095.727,99.5
"24141","79102","2014",2,2,0,46500,528.5,97
"24142","79103","2014",22,22,0,97845.91,995.7273,97.5
"24143","79105","2014",5,5,0,83800,1028.6,108.6
"24144","79106","2014",4,4,0,50075,572,85.5
"24145","79108","2014",3,3,0,65400.67,660.6667,102
"24146","79109","2014",31,31,0,147395.2,1277.161,125.0323
"24147","79111","2014",4,4,0,51075,798.5,64.25
"24148","79112","2014",11,10,1,114926.4,1119.909,104.7273
"24149","79114","2014",11,11,0,140727.3,1297.545,111.2727
"24150","79115","2014",4,4,0,52750,699,67
"24151","79116","2014",7,7,0,99428.57,1012.143,102.7143
"24152","79117","2014",6,6,0,121025,1180,105.1667
"24153","79118","2014",3,3,0,94666.67,935.6667,102.6667
"24154","79119","2014",11,11,0,74727.27,755.4545,100.9091
"24155","79120","2014",9,9,0,79994.44,969.2222,77.44444
"24156","79121","2014",3,3,0,69373.67,678,93
"24157","79122","2014",6,6,0,71725,822,83.5
"24158","79123","2014",22,22,0,92731.82,903.3636,103.5455
"24159","79124","2014",5,4,1,93862.8,1066.6,83.4
"24160","79125","2014",17,17,0,116447.1,1213.412,96.82353
"24161","79126","2014",2,2,0,57500,1110,50
"24162","79127","2014",13,13,0,135802.9,1106,121.7692
"24163","79128","2014",6,6,0,135833.3,1454.833,93.66667
"24164","79129","2014",10,10,0,144080,1199.6,124.4
"24165","79130","2014",26,26,0,152425,1424,112.5769
"24166","79131","2014",1,1,0,60000,674,89
"24167","79132","2014",2,2,0,105000,899,112.5
"24168","79133","2014",14,14,0,121910.7,1175,98.28571
"24169","79134","2014",1,1,0,125000,1389,90
"24170","79135","2014",12,12,0,105327.2,1055.667,105
"24171","79136","2014",7,7,0,91000,905.2857,97.28571
"24172","79137","2014",7,7,0,152223.3,1309.286,124.1429
"24173","79140","2014",4,4,0,66250,781.25,82.5
"24174","79141","2014",3,3,0,97000,968,99.66667
"24175","79144","2014",2,2,0,155000,1332.5,112
"24176","79145","2014",1,1,0,70000,443,158
"24177","79147","2014",5,5,0,104900,1007,104.4
"24178","79148","2014",28,28,0,94965.36,980.8571,96.17857
"24179","79150","2014",13,13,0,84833.69,1029.231,91.23077
"24180","79152","2014",3,3,0,136333.3,882,149.3333
"24181","79154","2014",4,4,0,78125,632,119.5
"24182","79156","2014",7,7,0,98928.57,1081.143,94
"24183","79157","2014",6,6,0,99166.67,1002.333,99.5
"24184","79158","2014",1,1,0,140000,1273,110
"24185","79159","2014",5,5,0,133500,1118,115.8
"24186","79160","2014",1,1,0,150000,915,164
"24187","79162","2014",30,30,0,175166.7,1570.967,112.7
"24188","79163","2014",4,4,0,101000,1218.25,88.5
"24189","79165","2014",1,1,0,359000,1026,350
"24190","79166","2014",1,1,0,140000,1573,89
"24191","79167","2014",3,3,0,28935,521.3333,56
"24192","79170","2014",34,34,0,122735.9,1302.941,100.8824
"24193","79172","2014",9,9,0,96649.56,890.5556,117.2222
"24194","79174","2014",30,30,0,110598.7,1047.7,112.5667
"24195","79175","2014",5,5,0,119128,919,134.8
"24196","79176","2014",11,11,0,77359.09,963.9091,78.72727
"24197","79177","2014",2,2,0,211545,1354.5,168.5
"24198","79179","2014",33,32,1,88704.55,987.0606,90.12121
"24199","79180","2014",2,2,0,105125,877,117
"24200","79183","2014",3,3,0,104333.3,1041.667,97.66667
"24201","79184","2014",15,15,0,104834,954.1333,115.4
"24202","79185","2014",37,37,0,126576.5,1116.135,120.1892
"24203","79189","2014",11,11,0,124181.8,1128.182,112.6364
"24204","79190","2014",7,7,0,94928.57,710.8571,135.1429
"24205","79191","2014",740,532,208,122325.5,1479.043,82.35405
"24206","79195","2014",25,25,0,102584,941,109.2
"24207","79196","2014",17,17,0,55852.94,648.2941,85.88235
"24208","79197","2014",1,1,0,175000,1944,90
"24209","79198","2014",3,3,0,77133.33,732.6667,106.6667
"24210","79200","2014",7,7,0,91192,1027.857,88.14286
"24211","79201","2014",12,12,0,104583.3,1015.167,110.8333
"24212","79202","2014",111,96,15,91458.43,1124.586,82.54054
"24213","79203","2014",5,5,0,79200,900,85.4
"24214","79204","2014",6,6,0,119583.3,1240.667,112.1667
"24215","79207","2014",3,3,0,131666.7,1311,99.66667
"24216","79208","2014",5,5,0,1e+05,1007.8,98
"24217","79209","2014",4,4,0,51950,527.75,94
"24218","79210","2014",12,12,0,106192.4,1100.917,97.33333
"24219","79212","2014",3,3,0,70538.33,643,107
"24220","79213","2014",17,17,0,115029.4,1198.588,97.76471
"24221","79215","2014",3,3,0,66000,701,100
"24222","79216","2014",12,12,0,159841.7,1340.667,117
"24223","79217","2014",10,10,0,92728,1180.5,102.9
"24224","79218","2014",1,1,0,22000,458,48
"24225","79220","2014",1,1,0,153500,1668,92
"24226","79223","2014",1,1,0,1e+05,833,120
"24227","79225","2014",3,3,0,82000,839,96
"24228","79226","2014",3,3,0,130333.3,896.3333,151.6667
"24229","79229","2014",4,4,0,148250,1211,117.25
"24230","79230","2014",9,9,0,80547.78,884.6667,98.88889
"24231","79231","2014",4,4,0,169500,1417.75,133.75
"24232","79235","2014",15,15,0,106606.7,1072.133,97.46667
"24233","79236","2014",3,3,0,91833.33,816.3333,115.3333
"24234","79238","2014",5,5,0,133600,1346.8,96
"24235","79239","2014",15,15,0,94060.47,923.1333,103.1333
"24236","79241","2014",3,3,0,115000,1095,115.6667
"24237","79242","2014",6,6,0,77533.33,689.6667,112.5
"24238","79243","2014",4,4,0,101125,655,142.25
"24239","79244","2014",4,4,0,94562.5,799,121.75
"24240","79246","2014",2,2,0,161000,1065,165.5
"24241","79249","2014",20,20,0,155955,1502.35,109.25
"24242","79250","2014",2,2,0,103500,876.5,118
"24243","79251","2014",1,1,0,170000,1018,167
"24244","79252","2014",3,3,0,95666.67,959.3333,97.33333
"24245","79253","2014",3,3,0,133896,1171.333,161.3333
"24246","79254","2014",2,2,0,184500,1664.5,109
"24247","79255","2014",3,3,0,114333.3,976.6667,110.6667
"24248","79256","2014",1,1,0,85000,616,138
"24249","79257","2014",11,11,0,117227.3,1185.636,107.5455
"24250","79258","2014",5,5,0,108300,846,127.6
"24251","79259","2014",11,11,0,90954.55,1068,97.09091
"24252","79263","2014",6,6,0,104140,964.5,106
"24253","79265","2014",9,9,0,88500,1028.778,87.66667
"24254","79267","2014",3,3,0,100200,1312,81.33333
"24255","79268","2014",12,12,0,90458.33,908.9167,95.75
"24256","79269","2014",3,3,0,136666.7,1103.667,140.3333
"24257","79270","2014",63,59,4,100028.7,953.1746,108.1111
"24258","79271","2014",5,5,0,79990,1235.4,70
"24259","79273","2014",8,8,0,171187.5,1366.125,132.25
"24260","79274","2014",1,1,0,106000,1247,85
"24261","79276","2014",5,5,0,119899.2,1184.4,110.4
"24262","79277","2014",8,8,0,92812.5,1152.25,83.5
"24263","79278","2014",4,4,0,83250,932.75,91.75
"24264","79280","2014",5,5,0,96490,972.2,93.6
"24265","79281","2014",6,6,0,166058.3,1303.167,138.3333
"24266","79283","2014",15,15,0,135380,1213.067,110.7333
"24267","79284","2014",11,11,0,132227.3,1150.364,115
"24268","79285","2014",15,14,1,88940,792.6667,105.7333
"24269","79286","2014",3,3,0,105000,948.3333,113
"24270","79289","2014",8,8,0,142737.5,1070,128.625
"24271","79290","2014",11,11,0,115780.9,1227.727,97.36364
"24272","79293","2014",5,4,1,110405.4,1050.6,106.6
"24273","79294","2014",2,2,0,115250,1195.5,97.5
"24274","79295","2014",6,6,0,112033.3,988.8333,119.5
"24275","79297","2014",4,4,0,51223.75,896.25,69
"24276","79298","2014",13,13,0,155165.5,1368.769,119.5385
"24277","79299","2014",20,20,0,85365,891.3,94.65
"24278","79300","2014",14,14,0,136180.4,1246.214,112.7857
"24279","79301","2014",9,9,0,115443.2,1013.778,122.2222
"24280","79302","2014",15,15,0,127577.3,1140.533,113.4667
"24281","79303","2014",5,5,0,100200,953.2,101.6
"24282","79304","2014",5,3,2,125800,1818.8,90.8
"24283","79306","2014",1,1,0,155000,1107,140
"24284","79307","2014",14,14,0,95107.14,876.6429,110.7857
"24285","79308","2014",2,2,0,146000,1169,125
"24286","79309","2014",4,4,0,86845,1332.25,78.25
"24287","79310","2014",6,6,0,98000,896.5,114.8333
"24288","79311","2014",13,13,0,72992.08,790.7692,95.15385
"24289","79313","2014",2,2,0,90000,878,103
"24290","79316","2014",5,5,0,108000,1071.2,102.8
"24291","79319","2014",5,5,0,145500,970.6,156.6
"24292","79320","2014",9,9,0,132587.8,1025,126.8889
"24293","79322","2014",12,12,0,115528.3,1186.417,102.5833
"24294","79326","2014",12,12,0,80833.33,869,94.33333
"24295","79329","2014",120,112,8,89073.17,981.0583,90.275
"24296","79331","2014",1,1,0,163500,1386,118
"24297","79332","2014",1,1,0,130000,949,137
"24298","79334","2014",6,6,0,100583.3,1002.667,109.3333
"24299","79335","2014",4,4,0,133240.2,1050,149.75
"24300","79336","2014",5,5,0,82830,1737.6,88
"24301","79337","2014",7,7,0,90971.43,1253.143,86.71429
"24302","79338","2014",5,5,0,56050,631.8,89.8
"24303","79339","2014",21,20,1,108307.7,1150.571,98.2381
"24304","79340","2014",4,4,0,111979.8,900.5,120
"24305","79341","2014",1,1,0,50000,617,81
"24306","79342","2014",3,3,0,94583.33,876.6667,104
"24307","79343","2014",1,1,0,95000,660,144
"24308","79345","2014",9,9,0,82422.22,653.6667,119.8889
"24309","79346","2014",3,3,0,167333.3,1771.333,101.3333
"24310","79347","2014",8,8,0,103718.8,1138.375,85.25
"24311","79348","2014",1,1,0,83000,755,110
"24312","79349","2014",2,2,0,125250,1922,67
"24313","79350","2014",1,1,0,80000,842,95
"24314","79351","2014",8,8,0,138000,1345.25,100.5
"24315","79352","2014",2,2,0,99000,968,100.5
"24316","79354","2014",4,4,0,67000,792.25,81.5
"24317","79355","2014",34,33,1,181619.1,1739.147,114.3235
"24318","79357","2014",1,1,0,130000,1083,120
"24319","80001","2014",149,121,28,115973.5,1443.074,85.67114
"24320","80002","2014",3,3,0,81333.33,1369.333,56
"24321","80003","2014",2,2,0,105000,1042,85.5
"24322","80004","2014",6,6,0,133708.3,1492.667,89
"24323","80008","2014",7,7,0,115457.1,1167.714,102.5714
"24324","80009","2014",7,7,0,141585.7,1295.714,112.5714
"24325","80010","2014",24,24,0,148612.8,1588.625,97.375
"24326","80011","2014",23,23,0,116403.5,1479,78.95652
"24327","80013","2014",18,18,0,114500,1195.556,101.8333
"24328","80014","2014",1,1,0,83000,1221,68
"24329","80015","2014",1,1,0,130000,1262,103
"24330","80016","2014",97,89,8,108680.1,1486.66,81.41237
"24331","80017","2014",3,3,0,125000,1065,108.3333
"24332","80018","2014",2,2,0,116000,1473.5,77
"24333","80019","2014",3,3,0,89666.67,1419.667,65.66667
"24334","80020","2014",6,6,0,203683.3,1991,101.8333
"24335","80021","2014",1210,703,507,148306.4,2198.1,70.89421
"24336","80023","2014",3,3,0,147333.3,1509.667,98
"24337","80024","2014",1,1,0,105000,2188,48
"24338","80025","2014",2,2,0,131250,1109,118.5
"24339","80026","2014",1,1,0,41000,774,53
"24340","80028","2014",1,1,0,124250,1218,102
"24341","80029","2014",9,9,0,105055.6,1140.111,90.22222
"24342","80030","2014",1,1,0,130000,1688,77
"24343","80031","2014",8,8,0,98051.25,1215.75,81.875
"24344","80032","2014",1,1,0,113000,1487,76
"24345","80033","2014",1,1,0,276560,1240,223
"24346","80034","2014",2,2,0,90750,952.5,87
"24347","80036","2014",7,7,0,130571.4,1334.286,91.85714
"24348","80037","2014",1,1,0,170000,1214,140
"24349","80038","2014",2,2,0,179200,1421,128.5
"24350","80039","2014",55,40,15,100371.4,1499.782,68.32727
"24351","80040","2014",2,2,0,70000,875,80
"24352","80041","2014",3,3,0,116050,1296.333,89.66667
"24353","80042","2014",2,2,0,73500,1124,65.5
"24354","80043","2014",4,4,0,90925,897.25,107.25
"24355","80044","2014",5,5,0,125480,1626,76
"24356","80045","2014",1,1,0,214200,1508,142
"24357","80047","2014",5,5,0,115720,1319.6,90
"24358","80048","2014",1,1,0,190000,1727,110
"24359","80049","2014",1,1,0,79000,988,80
"24360","80050","2014",4,4,0,243500,1820.5,132
"24361","80051","2014",1,1,0,113000,1141,99
"24362","80052","2014",2,2,0,183000,1809.5,100.5
"24363","80053","2014",2,2,0,105000,1068.5,101
"24364","80054","2014",2,2,0,62500,583,106.5
"24365","80055","2014",1,1,0,90000,1139,79
"24366","80058","2014",6,6,0,111333.3,1236.167,92
"24367","80059","2014",1,1,0,114200,1029,111
"24368","80060","2014",3,3,0,110000,1386.667,79.33333
"24369","80061","2014",1,1,0,2e+05,2326,86
"24370","80062","2014",10,10,0,96100,1096.8,90.4
"24371","80063","2014",3,3,0,76768.67,884,82.66667
"24372","80064","2014",3,3,0,182790,1705,107
"24373","80065","2014",2,2,0,167750,1656.5,110.5
"24374","80067","2014",4,4,0,89125,952,89.75
"24375","80068","2014",1,1,0,80000,602,133
"24376","80069","2014",5,5,0,75529.6,1030.2,72
"24377","80070","2014",5,5,0,105800,1162.8,94
"24378","80071","2014",10,10,0,93100,1048.5,89.5
"24379","80074","2014",2,2,0,95000,1086,103
"24380","80076","2014",4,4,0,99425,993,98
"24381","80078","2014",3,3,0,188500,1306,148.6667
"24382","80079","2014",3,3,0,162573.3,1332.667,128.3333
"24383","80080","2014",4,4,0,148000,1284.75,106.25
"24384","80082","2014",7,7,0,173457.1,1795.571,101.8571
"24385","80083","2014",1,1,0,59000,678,87
"24386","80084","2014",2,2,0,87500,1034,84.5
"24387","80086","2014",7,7,0,125857.1,1256,107.5714
"24388","80087","2014",5,5,0,116000,1514,79.8
"24389","80088","2014",4,4,0,139200,1060.25,143.75
"24390","80089","2014",2,2,0,125125,1378,89
"24391","80092","2014",5,5,0,151100,1611.4,93.8
"24392","80093","2014",4,4,0,66500,719.75,87.75
"24393","80094","2014",1,1,0,204025,2318,88
"24394","80095","2014",2,2,0,102000,1093.5,96
"24395","80096","2014",5,5,0,85800,873.6,97.6
"24396","80097","2014",3,3,0,79333.33,901,88
"24397","80098","2014",1,1,0,89000,2171,41
"24398","80099","2014",2,2,0,112975,1073.5,102
"24399","80100","2014",5,5,0,132890,1632.2,89
"24400","80101","2014",7,7,0,110804.1,1103.143,101.5714
"24401","80102","2014",5,5,0,103000,1418.6,73.4
"24402","80104","2014",1,1,0,90000,1071,84
"24403","80107","2014",4,4,0,222205.5,1581.75,139.25
"24404","80109","2014",2,2,0,90000,1096.5,82
"24405","80110","2014",5,5,0,128700,1433.6,92.6
"24406","80112","2014",3,3,0,171666.7,1693.667,101.3333
"24407","80114","2014",4,4,0,155250,1810.5,87.25
"24408","80115","2014",1,1,0,105000,981,107
"24409","80116","2014",4,4,0,127500,1261,101
"24410","80117","2014",1,1,0,55000,733,75
"24411","80118","2014",1,1,0,1e+05,935,107
"24412","80119","2014",2,2,0,70500,1182,63
"24413","80120","2014",2,2,0,147000,1358,116.5
"24414","80121","2014",1,1,0,185000,1370,135
"24415","80122","2014",2,2,0,100500,946.5,107.5
"24416","80123","2014",4,4,0,126750,1318.25,108.75
"24417","80124","2014",10,10,0,120110,1304.7,99.4
"24418","80127","2014",6,6,0,108783.3,1775.5,68.83333
"24419","80129","2014",2,2,0,95500,827,118
"24420","80130","2014",2,2,0,179750,2436.5,82.5
"24421","80131","2014",21,20,1,180754.8,1972.619,92.66667
"24422","80132","2014",1,1,0,111000,1110,100
"24423","80133","2014",3,3,0,169500,1186.333,141
"24424","80135","2014",4,4,0,136250,1656,84.75
"24425","80136","2014",17,17,0,110045.9,1318.176,85.47059
"24426","80137","2014",4,4,0,102800,1524.75,69.25
"24427","80138","2014",3,3,0,113666.7,1000.667,114.3333
"24428","80141","2014",2,2,0,82500,801,103
"24429","80144","2014",4,4,0,93000,1112.25,81.25
"24430","80146","2014",1,1,0,164700,2059,80
"24431","80147","2014",1,1,0,79000,1039,76
"24432","80148","2014",1,1,0,80000,1000,80
"24433","80149","2014",3,3,0,130000,1438.667,87.33333
"24434","80150","2014",2,2,0,80000,927,88.5
"24435","80151","2014",5,5,0,154200,1338.8,117.2
"24436","80152","2014",1,1,0,38000,339,112
"24437","80153","2014",1,1,0,70000,714,98
"24438","80154","2014",1,1,0,20000,333,60
"24439","80155","2014",2,2,0,136355.5,977,135
"24440","80159","2014",1,1,0,35000,368,95
"24441","80160","2014",11,11,0,162863.6,1797.091,92.09091
"24442","80161","2014",4,4,0,113375,1506.5,74
"24443","80162","2014",2,2,0,70000,776.5,94
"24444","80163","2014",5,5,0,108000,1399.2,75.6
"24445","80164","2014",34,33,1,180594.6,2358.441,84.67647
"24446","80165","2014",2,2,0,121000,1929.5,79.5
"24447","80166","2014",7,7,0,153887.9,1294.857,121.7143
"24448","80167","2014",4,4,0,135230,1553,86.75
"24449","80168","2014",7,7,0,141371.4,1326.857,112.2857
"24450","80169","2014",2,2,0,81500,798,96
"24451","80170","2014",2,2,0,146000,1186.5,123
"24452","80171","2014",1,1,0,120000,1165,103
"24453","80172","2014",6,6,0,98033.33,1411.667,72.66667
"24454","80173","2014",6,6,0,218776.8,1771.5,125.1667
"24455","80176","2014",3,3,0,71666.67,1161.333,67.33333
"24456","80177","2014",6,6,0,82000,1048,75
"24457","80179","2014",3,3,0,159000,1879.667,86.33333
"24458","80181","2014",4,4,0,87000,995,107
"24459","80182","2014",63,49,14,111661.3,1816.492,69.14286
"24460","80183","2014",1,1,0,115000,1597,72
"24461","80184","2014",2,2,0,73000,1208,65
"24462","80185","2014",3,3,0,163666.7,1240,133.6667
"24463","80186","2014",17,17,0,86888.24,1001.235,89.94118
"24464","80187","2014",8,8,0,154718.8,1492,111.375
"24465","80188","2014",8,8,0,136606.2,1609.375,89.875
"24466","80189","2014",2,2,0,152000,1830,83
"24467","80190","2014",6,6,0,88500,1157.667,77.33333
"24468","80191","2014",1,1,0,138000,1624,85
"24469","80192","2014",3,3,0,119000,1417,81
"24470","80193","2014",2,2,0,186850,1176,159
"24471","80194","2014",1,1,0,68000,1097,62
"24472","80195","2014",3,3,0,82260,851.3333,107.6667
"24473","80196","2014",2,2,0,108750,1018.5,106
"24474","80198","2014",3,3,0,244466.7,1721,142
"24475","80199","2014",3,3,0,104947.3,1746.333,76.33333
"24476","80200","2014",5,5,0,143300,1396.6,99.8
"24477","80202","2014",1,1,0,232000,1050,221
"24478","80203","2014",1,1,0,140000,1308,107
"24479","80204","2014",8,8,0,84537.5,910.375,91.5
"24480","80205","2014",8,8,0,131171.9,1298.25,108.875
"24481","80207","2014",4,4,0,151600,1666.5,92.25
"24482","80208","2014",1,1,0,133000,1330,100
"24483","80211","2014",19,19,0,120952.6,1798.579,80.31579
"24484","80212","2014",65,65,0,125447.4,1505.015,86.29231
"24485","80213","2014",3,3,0,139066.7,1568,89.66667
"24486","80214","2014",3,3,0,118333.3,1542.667,75.33333
"24487","80218","2014",1,1,0,95000,1159,82
"24488","80221","2014",2,2,0,70000,1101.5,68
"24489","80222","2014",12,12,0,140512.5,1296,107.9167
"24490","80223","2014",1,1,0,481700,2604,185
"24491","80224","2014",2,2,0,61500,820.5,71
"24492","80225","2014",1,1,0,180000,2045,88
"24493","80226","2014",2,2,0,88500,1226.5,70
"24494","80227","2014",5,5,0,114600,1407,78.8
"24495","80228","2014",78,55,23,173394.8,2997.756,60.52564
"24496","80229","2014",3,3,0,123333.3,1879.667,70
"24497","80230","2014",3,3,0,137833.3,1336.333,118.3333
"24498","80231","2014",2,2,0,98000,1064,93.5
"24499","80232","2014",1,1,0,180000,1636,110
"24500","80233","2014",1,1,0,195000,1291,151
"24501","80234","2014",6,6,0,153883.3,1563.333,99.16667
"24502","80235","2014",7,7,0,83571.43,1065.857,79
"24503","80236","2014",5,5,0,76200,1061.4,71.8
"24504","80237","2014",2,2,0,159295,1387.5,114
"24505","80238","2014",3,3,0,141616.7,2038,68
"24506","80240","2014",8,8,0,112125,2355.75,63.75
"24507","80241","2014",2,2,0,127000,1040,128
"24508","80242","2014",4,4,0,130825,1568.75,89
"24509","80244","2014",3,3,0,124500,1337.667,91
"24510","80245","2014",1,1,0,65000,546,119
"24511","80246","2014",2,2,0,86750,1380.5,62.5
"24512","80247","2014",4,4,0,116675,1270.75,90.75
"24513","80248","2014",8,8,0,84687.5,1468.25,66
"24514","80249","2014",5,5,0,108600,1079,104
"24515","80250","2014",2,2,0,132050,1148.5,114
"24516","80251","2014",4,4,0,117500,1605.25,74.5
"24517","80253","2014",33,26,7,91651.52,1287.576,73.15152
"24518","80256","2014",12,11,1,179104.2,1815,101.1667
"24519","80259","2014",1,1,0,62000,1088,57
"24520","80260","2014",6,6,0,164083.3,1459.5,113.3333
"24521","80261","2014",14,14,0,241285.7,2267.214,115.2143
"24522","80262","2014",2,2,0,192000,2207.5,87
"24523","80265","2014",1,1,0,95000,1284,74
"24524","80266","2014",1,1,0,155000,1409,110
"24525","80267","2014",4,4,0,111000,1619.5,67.25
"24526","80268","2014",7,7,0,201264.3,1660.286,111.5714
"24527","80269","2014",1,1,0,130000,1150,113
"24528","80271","2014",11,11,0,83136.36,991.2727,80.36364
"24529","80272","2014",1,1,0,93000,939,99
"24530","80273","2014",2,2,0,173250,1104,165
"24531","80274","2014",13,12,1,75307.69,1065.846,72.61538
"24532","80275","2014",4,4,0,98040,1120.25,87.25
"24533","80276","2014",3,3,0,91000,978.3333,94.33333
"24534","80278","2014",4,4,0,109500,1582,74.75
"24535","80279","2014",3,3,0,85000,968.3333,87.33333
"24536","80281","2014",1,1,0,70000,636,110
"24537","80282","2014",5,5,0,105500,1446.4,73.4
"24538","80283","2014",1,1,0,75000,1705,44
"24539","80284","2014",10,10,0,66650,812.3,88.9
"24540","80285","2014",2,2,0,157000,1549.5,111
"24541","80290","2014",5,5,0,120260,1083.2,115.2
"24542","80291","2014",1,1,0,80000,1053,76
"24543","80292","2014",2,2,0,102500,1074,104
"24544","80294","2014",1,1,0,128000,1753,73
"24545","80295","2014",4,4,0,128750,1321.25,102
"24546","80296","2014",11,11,0,80709.09,944.1818,84.90909
"24547","80298","2014",3,3,0,102000,1643.333,65.66667
"24548","80299","2014",1,1,0,141000,600,235
"24549","80301","2014",3,3,0,110833.3,1772.333,62.33333
"24550","80303","2014",7,7,0,136142.9,1558.286,87.28571
"24551","80304","2014",2,2,0,165500,878,191
"24552","80305","2014",1,1,0,235000,2670,88
"24553","80306","2014",1,1,0,73000,702,104
"24554","80307","2014",1,1,0,50000,806,62
"24555","80308","2014",13,13,0,95203.85,1094.769,85.84615
"24556","80310","2014",6,6,0,128666.7,1297.667,100.3333
"24557","80311","2014",1,1,0,150000,1724,87
"24558","80313","2014",3,3,0,71666.67,925.3333,78.33333
"24559","80314","2014",3,3,0,77833.33,789,99.33333
"24560","80316","2014",15,15,0,156203.3,1720.667,93.93333
"24561","80317","2014",2,2,0,149000,1330,107.5
"24562","80318","2014",22,22,0,116977.7,1347.364,87.72727
"24563","80320","2014",2,2,0,111300,1327.5,84.5
"24564","80322","2014",1,1,0,50000,556,90
"24565","80324","2014",2,2,0,81925,1315,62.5
"24566","80327","2014",2,2,0,184000,1845,96.5
"24567","80328","2014",7,7,0,115142.9,1481.286,95.14286
"24568","80329","2014",1,1,0,92000,1227,75
"24569","80330","2014",2,2,0,65250,1175,52.5
"24570","80331","2014",2,2,0,146500,1224,122.5
"24571","80332","2014",2,2,0,212500,1984.5,100
"24572","80333","2014",85,42,43,146568,2953.329,52.09412
"24573","80335","2014",3,3,0,105000,775.3333,140.6667
"24574","80336","2014",1,1,0,160000,2025,79
"24575","80338","2014",18,16,2,147794.4,1580.333,94.5
"24576","80339","2014",2,2,0,147500,1711.5,85
"24577","80340","2014",1,1,0,57000,695,82
"24578","80342","2014",5,5,0,135500,1340.2,102.4
"24579","80343","2014",1,1,0,163000,2117,77
"24580","80344","2014",2,2,0,216000,1950,110.5
"24581","80345","2014",1,1,0,85000,988,86
"24582","80346","2014",1,1,0,202850,1764,115
"24583","80347","2014",2,2,0,150000,1985.5,77.5
"24584","80348","2014",1,1,0,146000,1123,130
"24585","80349","2014",1,1,0,150000,1376,109
"24586","80350","2014",1,1,0,142000,1671,85
"24587","80352","2014",1,1,0,141000,1549,91
"24588","80353","2014",1,1,0,85000,780,109
"24589","80354","2014",1,1,0,65000,1327,49
"24590","80355","2014",1,1,0,170000,1518,112
"24591","80357","2014",2,2,0,112500,1282,84
"24592","80358","2014",1,1,0,175590,1463,120
"24593","80359","2014",3,3,0,119666.7,1508,75.66667
"24594","80360","2014",16,16,0,93750,1147.062,84.3125
"24595","80362","2014",1,1,0,115000,2018,57
"24596","80364","2014",6,6,0,129400,1428.833,91.5
"24597","80365","2014",1,1,0,150000,1829,82
"24598","80366","2014",1,1,0,155000,1270,122
"24599","80367","2014",2,2,0,116400,1271.5,86.5
"24600","80368","2014",28,28,0,104517.9,1207.857,88.46429
"24601","80369","2014",3,3,0,86833.33,945,91.66667
"24602","80371","2014",1,1,0,34000,944,36
"24603","80372","2014",3,3,0,132900,1201,108.6667
"24604","80373","2014",19,19,0,92400,991.7368,89.36842
"24605","80375","2014",1,1,0,18000,474,38
"24606","80376","2014",8,8,0,134918.8,1724.375,75.875
"24607","80377","2014",2,2,0,92500,825,114.5
"24608","80379","2014",3,3,0,164333.3,2364,67.33333
"24609","80380","2014",2,2,0,107750,1298.5,81
"24610","80384","2014",2,2,0,93750,1068,80
"24611","80385","2014",4,4,0,134700,1383.25,97.75
"24612","80386","2014",2,2,0,97500,1016.5,96
"24613","80387","2014",3,3,0,147666.7,1652.667,91.66667
"24614","80390","2014",2,2,0,236875,1343,166.5
"24615","80391","2014",1,1,0,39500,1097,36
"24616","80392","2014",3,3,0,167333.3,1994.667,90
"24617","80393","2014",5,5,0,102725,1013.2,99
"24618","80395","2014",5,5,0,118200,1171.4,102.8
"24619","80396","2014",8,8,0,98700,1038.25,96.875
"24620","80397","2014",1,1,0,110000,1375,80
"24621","80399","2014",2,2,0,110000,1135.5,109
"24622","80400","2014",10,10,0,109310,1310.2,85
"24623","80401","2014",2,2,0,144500,1387,104.5
"24624","80403","2014",2,2,0,83000,1018,81.5
"24625","80404","2014",1,1,0,80000,879,91
"24626","80405","2014",3,3,0,127000,1446,86.33333
"24627","80406","2014",10,10,0,104830,1126.6,99.5
"24628","80407","2014",1,1,0,136000,1511,90
"24629","80408","2014",1,1,0,60000,1017,59
"24630","80410","2014",35,35,0,90558.71,1117.343,86.14286
"24631","80411","2014",2,2,0,47500,964.5,51
"24632","80415","2014",11,11,0,134588.2,1503.545,89.90909
"24633","80416","2014",4,4,0,111400,2146.75,68.25
"24634","80417","2014",14,14,0,104455.7,1449,81.64286
"24635","80418","2014",2,2,0,222500,2719,75.5
"24636","80421","2014",4,4,0,112125,1246.25,92.25
"24637","80422","2014",1,1,0,80000,800,100
"24638","80424","2014",1,1,0,204000,2372,86
"24639","80426","2014",3,3,0,86766.67,1313.333,65.66667
"24640","80427","2014",2,2,0,151650,1381.5,110
"24641","80429","2014",2,2,0,114000,1176.5,86
"24642","80430","2014",2,2,0,132750,974.5,137.5
"24643","80432","2014",1,1,0,108000,735,147
"24644","80434","2014",1,1,0,70000,614,114
"24645","80436","2014",3,3,0,107183.3,1457,66.66667
"24646","80437","2014",1,1,0,80000,808,99
"24647","80438","2014",3,3,0,67000,834.3333,81
"24648","80440","2014",4,4,0,164000,1554,104
"24649","80442","2014",6,6,0,89203.33,815.3333,112.3333
"24650","80443","2014",11,11,0,93400,1184.364,79.63636
"24651","80444","2014",7,7,0,127928.6,1729.714,89.28571
"24652","80445","2014",5,5,0,91500,863.6,103.4
"24653","80446","2014",4,4,0,166875,1699,100.25
"24654","80450","2014",2,2,0,106150,1807.5,62.5
"24655","80451","2014",2,2,0,35080,655,51
"24656","80452","2014",2,2,0,213950,1904,114.5
"24657","80453","2014",1,1,0,88000,978,90
"24658","80455","2014",1,1,0,180000,1161,155
"24659","80456","2014",3,3,0,87666.67,972,95.66667
"24660","80459","2014",1,1,0,165200,1544,107
"24661","80461","2014",3,3,0,173333.3,2415.333,70.33333
"24662","80462","2014",2,2,0,97500,1447.5,66
"24663","80463","2014",4,4,0,130125,1654.25,79
"24664","80464","2014",9,9,0,146711.1,1570.556,99.22222
"24665","80465","2014",4,4,0,84875,999.5,80.75
"24666","80466","2014",1,1,0,114000,1253,91
"24667","80467","2014",1,1,0,145000,863,168
"24668","80472","2014",1,1,0,323000,1648,196
"24669","80473","2014",3,3,0,105533.3,1473.333,70.66667
"24670","80474","2014",6,6,0,88666.67,882.5,102.8333
"24671","80475","2014",3,3,0,98666.67,1046.333,98.66667
"24672","80476","2014",1,1,0,92500,784,118
"24673","80477","2014",3,3,0,119000,1629,75.33333
"24674","80478","2014",1,1,0,70000,1000,70
"24675","80479","2014",2,2,0,116500,1415,83
"24676","80481","2014",1,1,0,94000,940,100
"24677","80482","2014",1,1,0,1e+05,1389,72
"24678","80484","2014",2,2,0,88000,917.5,94.5
"24679","80485","2014",9,9,0,141922.2,1527,102.6667
"24680","80486","2014",6,6,0,103269.3,1314.333,98
"24681","80487","2014",1,1,0,115000,1369,84
"24682","80488","2014",14,14,0,112052.4,1631,72.35714
"24683","80489","2014",53,51,2,192981.8,2099.245,89.26415
"24684","80490","2014",2,2,0,48000,769.5,64.5
"24685","80491","2014",1,1,0,229000,1672,137
"24686","80493","2014",4,4,0,133875,1394.5,96
"24687","80494","2014",1,1,0,128000,1829,70
"24688","80495","2014",4,4,0,83250,932,92.75
"24689","80497","2014",2,2,0,152500,1286.5,125.5
"24690","80498","2014",7,7,0,125728.6,1216,104.5714
"24691","80500","2014",8,8,0,97750,1329,75.25
"24692","80501","2014",3,3,0,46433.33,852.3333,58.33333
"24693","80502","2014",1,1,0,150000,1154,130
"24694","80504","2014",1,1,0,158000,1927,82
"24695","80505","2014",4,4,0,162750,1709.5,98.5
"24696","80507","2014",12,12,0,108165,1402.083,77.16667
"24697","80508","2014",1,1,0,120000,694,173
"24698","80509","2014",7,7,0,94542.86,979.2857,98.28571
"24699","80511","2014",1,1,0,150000,1630,92
"24700","80512","2014",8,8,0,86500,1548.5,63.875
"24701","80513","2014",4,4,0,60000,884.75,67
"24702","80514","2014",1,1,0,166000,1153,144
"24703","80516","2014",5,5,0,70080,704.2,92.6
"24704","80517","2014",4,4,0,101000,1270.5,87.75
"24705","80518","2014",4,4,0,92355,1259,68.25
"24706","80519","2014",6,6,0,88333.33,954.3333,88.66667
"24707","80520","2014",2,2,0,76000,1023.5,73
"24708","80521","2014",5,5,0,136400,1035.6,123.6
"24709","80522","2014",1,1,0,70000,1207,58
"24710","80523","2014",7,7,0,140571.4,1562,88.42857
"24711","80524","2014",4,4,0,112500,1023,133
"24712","80526","2014",2,2,0,130500,1233.5,104.5
"24713","80529","2014",2,2,0,119685,1324,98.5
"24714","80530","2014",5,5,0,89000,931.6,102.6
"24715","80531","2014",1,1,0,167000,1590,105
"24716","80533","2014",78,35,43,82011.88,1568.744,54.9359
"24717","80536","2014",1,1,0,105000,1641,64
"24718","80538","2014",1,1,0,80000,741,108
"24719","80540","2014",3,3,0,140333.3,1377.667,100.6667
"24720","80541","2014",4,4,0,116500,988.75,113.75
"24721","80542","2014",3,3,0,57933.33,705,84.66667
"24722","80543","2014",2,2,0,80000,955,84
"24723","80544","2014",3,3,0,85333.33,1914,61.66667
"24724","80545","2014",6,6,0,135793.3,1662.667,83
"24725","80546","2014",6,6,0,92666.67,1234,72.5
"24726","80547","2014",4,4,0,108500,1007.25,104
"24727","80548","2014",3,3,0,129921.7,1572,87
"24728","80549","2014",8,8,0,112937.5,1110.75,99.875
"24729","80552","2014",7,7,0,88357.14,1039.429,91.14286
"24730","80554","2014",5,5,0,152320,1314.4,112
"24731","80555","2014",8,8,0,93312.5,1248.125,79.25
"24732","80556","2014",2,2,0,105000,1506,74.5
"24733","80557","2014",4,4,0,112500,1165,99
"24734","80558","2014",1,1,0,67000,1340,50
"24735","80560","2014",3,3,0,132833.3,1294.333,114
"24736","80561","2014",31,31,0,116336.9,1307.935,90.06452
"24737","80565","2014",1,1,0,252500,1791,141
"24738","80566","2014",2,2,0,115000,1297,94.5
"24739","80568","2014",2,2,0,114000,1140.5,99.5
"24740","80569","2014",5,5,0,93700,1542.4,67
"24741","80570","2014",32,31,1,138120,1578.969,98.25
"24742","80571","2014",2,2,0,140940,1308,105.5
"24743","80572","2014",4,4,0,124500,1190.5,101.25
"24744","80573","2014",3,3,0,110500,1305.667,86.33333
"24745","80576","2014",2,2,0,59500,697,80.5
"24746","80577","2014",3,3,0,101666.7,1172.667,89
"24747","80578","2014",4,4,0,116250,1216.25,97
"24748","80579","2014",7,7,0,89285.71,1021.429,95
"24749","80580","2014",5,5,0,297682.2,2908.4,84.2
"24750","80582","2014",7,7,0,160935.7,1394.714,115
"24751","80584","2014",7,7,0,120142.9,1185.286,118.1429
"24752","80585","2014",15,15,0,92366.67,1019.4,93.06667
"24753","80586","2014",2,2,0,119000,1322.5,80.5
"24754","80588","2014",1,1,0,258000,1804,143
"24755","80589","2014",1,1,0,2e+05,1005,199
"24756","80590","2014",4,4,0,88100,1084,83.25
"24757","80592","2014",7,7,0,77871.43,969.1429,77.14286
"24758","80593","2014",5,5,0,95000,1214.4,71.8
"24759","80595","2014",1,1,0,98700,1473,67
"24760","80596","2014",1,1,0,55000,440,125
"24761","80598","2014",3,3,0,143333.3,1482.667,98
"24762","80600","2014",7,7,0,126428.6,1595.286,83.71429
"24763","80601","2014",3,3,0,113333.3,1043.333,105.6667
"24764","80602","2014",1,1,0,96026,768,125
"24765","80603","2014",2,2,0,116250,1203,87.5
"24766","80605","2014",2,2,0,91750,1444.5,67
"24767","80606","2014",10,10,0,74800,888.3,91
"24768","80607","2014",2,2,0,46500,618.5,77
"24769","80609","2014",3,3,0,112666.7,1101.333,98
"24770","80611","2014",9,8,1,133405.6,1401.222,98.55556
"24771","80613","2014",4,4,0,125500,1490.75,84.25
"24772","80615","2014",2,2,0,158500,1798,87.5
"24773","80616","2014",1,1,0,110000,1964,56
"24774","80617","2014",1,1,0,2e+05,1515,132
"24775","80618","2014",12,12,0,111803.3,1635.167,72.75
"24776","80619","2014",3,3,0,132833.3,1730.667,80.66667
"24777","80620","2014",59,56,3,116199.7,1263.051,92.45763
"24778","80622","2014",12,12,0,104262.5,1166.25,92.5
"24779","80623","2014",4,4,0,136250,1577.25,95.25
"24780","80625","2014",3,3,0,158333.3,1761,104
"24781","80627","2014",8,8,0,168837.5,1916.125,89.125
"24782","80628","2014",11,11,0,125235.5,1250.545,102.8182
"24783","80629","2014",1,1,0,75000,560,134
"24784","80630","2014",5,5,0,143800,1421,132
"24785","80631","2014",5,5,0,106680,1139.2,87
"24786","80632","2014",16,15,1,243311.9,2404.125,104.5
"24787","80633","2014",7,7,0,121437.9,1364.286,92.28571
"24788","80634","2014",6,6,0,148461.2,1599.667,96.16667
"24789","80635","2014",7,7,0,124214.3,1200.857,99.14286
"24790","80637","2014",4,4,0,134125,1829,72.75
"24791","80638","2014",2,2,0,64750,825.5,77
"24792","80639","2014",11,11,0,155231.8,1685.727,88.90909
"24793","80640","2014",1,1,0,205500,1370,150
"24794","80642","2014",3,3,0,131666.7,1101.333,129
"24795","80643","2014",6,6,0,184566.7,2138,90.5
"24796","80644","2014",5,5,0,103152,1510,68.4
"24797","80645","2014",5,5,0,90900,1144.2,78.8
"24798","80646","2014",1,1,0,120000,1017,118
"24799","80647","2014",1,1,0,68000,680,100
"24800","80648","2014",1,1,0,120000,1333,90
"24801","80649","2014",40,33,7,156865.5,2500.55,67.85
"24802","80650","2014",11,11,0,156777.3,1603.818,95.36364
"24803","80651","2014",1,1,0,70000,778,90
"24804","80652","2014",11,11,0,91070,960.3636,98.45455
"24805","80654","2014",4,4,0,144750,1423.75,108.5
"24806","80655","2014",5,5,0,106300,1543.8,85.4
"24807","80656","2014",16,9,7,108207.8,1444.562,77.25
"24808","80657","2014",5,5,0,375182.4,2588.6,129.8
"24809","80658","2014",3,3,0,70000,698.3333,94.66667
"24810","80659","2014",4,4,0,89250,921.25,96
"24811","80661","2014",9,9,0,198144.4,1686.667,115.5556
"24812","80662","2014",1,1,0,180000,1224,147
"24813","80663","2014",1,1,0,37000,457,81
"24814","80664","2014",2,2,0,105000,939.5,112
"24815","80665","2014",2,2,0,130000,1880,68.5
"24816","80667","2014",1,1,0,86000,1830,47
"24817","80668","2014",6,6,0,136150,1490.667,85.16667
"24818","80669","2014",2,2,0,142250,1372.5,116
"24819","80670","2014",3,3,0,102666.7,1300,81
"24820","80672","2014",4,3,1,113750,1167.75,95.25
"24821","80674","2014",29,27,2,167559.7,1993.793,84.03448
"24822","80676","2014",2,2,0,132500,2095.5,64
"24823","80677","2014",13,13,0,80169.23,888.8462,95.15385
"24824","80678","2014",9,9,0,118111.1,1417.667,92.55556
"24825","80679","2014",4,4,0,56000,782,70
"24826","80680","2014",25,25,0,107804.9,1251.76,89.72
"24827","80682","2014",4,4,0,126625,1577.5,83.75
"24828","80683","2014",2,2,0,106000,1157.5,85
"24829","80685","2014",30,29,1,90633.33,1200.933,81.2
"24830","80686","2014",4,4,0,156027.5,1633,90.25
"24831","80687","2014",2,2,0,90000,906.5,98
"24832","80688","2014",25,24,1,130447.7,1582.08,84.56
"24833","80690","2014",3,3,0,200833.3,1961.667,105.6667
"24834","80691","2014",5,5,0,120200,1466,84.2
"24835","80692","2014",7,7,0,108714.3,1593,68.85714
"24836","80693","2014",5,5,0,105250,1453.4,69
"24837","80694","2014",4,4,0,140887.5,1549,92.75
"24838","80695","2014",2,2,0,60500,586,102.5
"24839","80696","2014",5,5,0,203040,1811.4,119.8
"24840","80697","2014",1,1,0,69000,1045,66
"24841","80698","2014",1,1,0,150000,1415,106
"24842","80700","2014",9,9,0,91944.44,1140,79.11111
"24843","80701","2014",3,3,0,140333.3,1431.667,102.3333
"24844","80702","2014",8,8,0,380671.2,2631.25,141.375
"24845","80705","2014",1,1,0,92000,885,104
"24846","80706","2014",12,12,0,92333.33,1155.417,75.41667
"24847","80709","2014",1,1,0,25000,385,65
"24848","80710","2014",5,5,0,124000,1413.4,88.6
"24849","80711","2014",20,20,0,101575,1249.8,78.75
"24850","80713","2014",3,3,0,236666.7,4256.667,59.33333
"24851","80714","2014",15,15,0,135326.7,1491.6,94.53333
"24852","80716","2014",3,3,0,108333.3,1018.667,112
"24853","80717","2014",8,8,0,165673.5,1639.875,104.125
"24854","80718","2014",9,9,0,152593.4,1587.778,96.55556
"24855","80719","2014",1,1,0,60000,1000,60
"24856","80721","2014",44,33,11,149446.6,2563.523,62.02273
"24857","80722","2014",7,7,0,102107.1,940.2857,106.8571
"24858","80723","2014",1,1,0,242250,1533,158
"24859","80724","2014",17,17,0,196723.5,2108,92.11765
"24860","80725","2014",19,18,1,238961.3,2472.947,96.89474
"24861","80726","2014",2,2,0,165000,1346,123
"24862","80730","2014",3,3,0,248800,2350,110.6667
"24863","80732","2014",7,7,0,92642.86,952.4286,102.1429
"24864","80734","2014",2,2,0,109000,1872.5,90
"24865","80737","2014",2,2,0,125000,1151.5,112.5
"24866","80738","2014",1,1,0,193000,858,225
"24867","80741","2014",1,1,0,85000,759,112
"24868","80742","2014",1,1,0,125000,2551,49
"24869","80743","2014",4,4,0,48766.25,667.75,79.75
"24870","80746","2014",7,7,0,149500,1544,104.5714
"24871","80748","2014",1,1,0,43500,388,112
"24872","80749","2014",8,8,0,98449.75,1050.25,93.75
"24873","80751","2014",4,4,0,216875,1517,152.25
"24874","80752","2014",3,3,0,193333.3,1863.667,102.6667
"24875","80753","2014",1,1,0,120000,1250,96
"24876","80754","2014",2,2,0,96205,808.5,125
"24877","80758","2014",2,2,0,72500,1097,68.5
"24878","80759","2014",1,1,0,115000,1855,62
"24879","80760","2014",1,1,0,20000,435,46
"24880","80762","2014",2,2,0,125507,1971,88.5
"24881","80763","2014",1,1,0,85000,664,128
"24882","80764","2014",3,3,0,131533.3,1390.333,94.33333
"24883","80765","2014",3,3,0,98900,1107.667,79.66667
"24884","80766","2014",2,2,0,87500,703.5,128.5
"24885","80767","2014",4,4,0,89000,1161.25,74.25
"24886","80770","2014",5,5,0,123800,1359.8,91.6
"24887","80774","2014",4,4,0,179250,1919.75,97
"24888","80775","2014",4,4,0,117000,1163.75,100
"24889","80776","2014",1,1,0,125000,822,152
"24890","80777","2014",1,1,0,155000,1033,150
"24891","80778","2014",2,2,0,91000,884,100
"24892","80779","2014",7,7,0,111428.6,1361.571,76.28571
"24893","80780","2014",4,4,0,94269,1121,94
"24894","80781","2014",1,1,0,115000,2300,50
"24895","80782","2014",4,4,0,144000,1335.5,109.75
"24896","80784","2014",2,2,0,139000,1499.5,90
"24897","80785","2014",3,3,0,118333.3,1270,93
"24898","80786","2014",2,2,0,98500,1512,91
"24899","80788","2014",2,2,0,72000,656.5,110
"24900","80789","2014",2,2,0,130000,1577,84
"24901","80790","2014",1,1,0,90000,1500,60
"24902","80791","2014",8,8,0,140000,1514.125,87.75
"24903","80792","2014",2,2,0,98500,1367.5,73
"24904","80793","2014",18,18,0,148482.2,1552.944,99.38889
"24905","80795","2014",4,4,0,95250,1042,87.75
"24906","80796","2014",1,1,0,32000,400,80
"24907","80797","2014",2,2,0,147500,1470,101.5
"24908","80798","2014",13,13,0,154507.7,1756,88.69231
"24909","80799","2014",50,50,0,149566.5,1735.96,90.54
"24910","80800","2014",1,1,0,60000,1000,60
"24911","80801","2014",3,3,0,50000,526.3333,80
"24912","80802","2014",7,7,0,89571.43,1046.714,89.28571
"24913","80804","2014",1,1,0,40000,833,48
"24914","80805","2014",3,3,0,155950,1283.667,130.3333
"24915","80806","2014",3,3,0,206000,1766.333,116.6667
"24916","80807","2014",5,5,0,95400,1395.8,72.6
"24917","80808","2014",1,1,0,450000,2500,180
"24918","80809","2014",3,3,0,90000,1022,85.66667
"24919","80810","2014",3,3,0,159575,1409,122.6667
"24920","80811","2014",3,3,0,106333.3,812.3333,134.3333
"24921","80812","2014",1,1,0,75000,560,134
"24922","80813","2014",1,1,0,120000,1081,111
"24923","80814","2014",5,5,0,67140,944.4,73
"24924","80815","2014",8,8,0,94125,1328.375,74.125
"24925","80820","2014",4,4,0,154287.5,1164.5,129
"24926","80821","2014",1,1,0,99000,1320,75
"24927","80823","2014",1,1,0,150000,750,200
"24928","80824","2014",6,6,0,104583.3,1364.667,72.5
"24929","80825","2014",1,1,0,110000,1294,85
"24930","80826","2014",10,7,3,72832.5,1475,52.9
"24931","80827","2014",5,5,0,100820,1348.6,77
"24932","80828","2014",1,1,0,165000,1320,125
"24933","80829","2014",1,1,0,45000,750,60
"24934","80830","2014",2,2,0,121000,1459.5,76.5
"24935","80832","2014",1,1,0,127500,2024,63
"24936","80833","2014",2,2,0,38500,602,62.5
"24937","80835","2014",1,1,0,70000,1667,42
"24938","80836","2014",2,2,0,197750,1664,119
"24939","81002","2014",18,18,0,135958.7,1335.611,104.1111
"24940","81003","2014",4,3,1,156385,1673.25,87.75
"24941","81004","2014",533,305,228,144693.5,1775.901,85.71107
"24942","81005","2014",6,6,0,104166.7,1064.667,96.5
"24943","81006","2014",2,2,0,171835,1112,155
"24944","81007","2014",1,1,0,158700,1322,120
"24945","81008","2014",2,2,0,163777.5,1274,131
"24946","81010","2014",6,6,0,92833.33,1166.833,81
"24947","81011","2014",8,8,0,239011.2,1808.5,133.625
"24948","81013","2014",4,4,0,136125,1120,133
"24949","81014","2014",5,4,1,153800,1097.2,126.4
"24950","81016","2014",4,4,0,64651.25,889.75,77.5
"24951","81017","2014",1,1,0,45000,1071,42
"24952","81018","2014",18,18,0,137261.1,1464,98.05556
"24953","81019","2014",3,3,0,170750,1668.667,105
"24954","81021","2014",43,43,0,100555.6,1065.953,93.67442
"24955","81022","2014",2,2,0,258700,1642,163
"24956","81023","2014",2,2,0,77250,1071,80
"24957","81025","2014",1,1,0,192300,1849,104
"24958","81026","2014",3,3,0,129916.7,1228.667,115
"24959","81031","2014",10,10,0,98950,1149.6,85.7
"24960","81032","2014",6,6,0,127866.7,1394,94.5
"24961","81033","2014",20,20,0,100282.1,1141.1,87.45
"24962","81034","2014",2,1,1,59750,906,68
"24963","81035","2014",2,2,0,94900,1208.5,70
"24964","81036","2014",10,10,0,141963.5,1422.1,97.5
"24965","81037","2014",14,14,0,74703.64,898.5,88.57143
"24966","81038","2014",17,17,0,192441.8,1705.765,110.8235
"24967","81039","2014",11,11,0,126845.5,1257.727,108.2727
"24968","81040","2014",1,1,0,163500,1652,99
"24969","81041","2014",1,1,0,270650,2506,108
"24970","81042","2014",16,16,0,146846.9,1315.125,112.75
"24971","81043","2014",5,5,0,190120,1346.2,141.2
"24972","81044","2014",1,1,0,50000,625,80
"24973","81045","2014",2,2,0,172500,1445,119.5
"24974","81046","2014",9,9,0,183111.1,1560.556,126.8889
"24975","81047","2014",2,2,0,74500,952.5,77.5
"24976","81048","2014",20,19,1,135787.3,1584.2,88
"24977","81049","2014",1,1,0,140500,1579,89
"24978","81050","2014",3,3,0,306200,1856.333,204.6667
"24979","81051","2014",11,11,0,239425.5,1673.182,142.0909
"24980","81052","2014",18,18,0,204481.2,1956.056,107.1667
"24981","81053","2014",2,2,0,141000,1417.5,99.5
"24982","81054","2014",3,3,0,140666.7,1504.667,95.33333
"24983","81055","2014",6,6,0,76882.5,1001.667,76.33333
"24984","81056","2014",1,1,0,123000,1295,95
"24985","81058","2014",4,4,0,218250,1564.25,137
"24986","81059","2014",5,5,0,272140,2282.2,119.2
"24987","81060","2014",87,77,10,103317.5,1080.034,96.37931
"24988","81061","2014",1,1,0,199000,1777,112
"24989","81062","2014",10,10,0,65478,907.4,70.5
"24990","81063","2014",7,7,0,137514.3,1377.143,107.8571
"24991","81064","2014",13,13,0,206192.3,1716.769,119.9231
"24992","81065","2014",421,286,135,115186.8,1341.974,87.37292
"24993","81066","2014",3,2,1,143666.7,1652.333,93.33333
"24994","81067","2014",7,7,0,133500,1482,86.71429
"24995","81069","2014",9,9,0,144555.6,1190.556,125.5556
"24996","81070","2014",19,19,0,188217.9,1948.211,108.3684
"24997","81071","2014",1,1,0,28000,459,61
"24998","81074","2014",6,6,0,179908.3,1547.333,118.1667
"24999","81075","2014",1,1,0,136000,1259,108
"25000","81076","2014",4,3,1,173075,1270,146
"25001","81077","2014",4,4,0,114500,1187.75,93.25
"25002","81078","2014",5,5,0,118839.8,1474.2,79.8
"25003","81079","2014",3,3,0,147800,1214,116.3333
"25004","81081","2014",11,11,0,96496.55,1062.545,90.54545
"25005","81083","2014",1,1,0,65000,520,125
"25006","81084","2014",8,8,0,139125,1373.75,96.875
"25007","81085","2014",2,2,0,112262,2308.5,48
"25008","81086","2014",3,3,0,76716.67,1005,79.33333
"25009","81087","2014",3,3,0,207666.7,1826,122.3333
"25010","81088","2014",8,8,0,173225,1518,115.625
"25011","81090","2014",2,2,0,130500,1376,80.5
"25012","81092","2014",4,4,0,140475,1538,91.25
"25013","81093","2014",6,6,0,190455.5,1455.833,137.1667
"25014","81094","2014",1,1,0,250000,1381,181
"25015","81095","2014",1,1,0,208000,2080,100
"25016","81096","2014",2,2,0,90737.5,1262,73
"25017","81097","2014",6,6,0,210162,1892,114
"25018","81098","2014",2,2,0,145275,1218,119
"25019","81099","2014",136,111,25,144378.4,1532.11,94.73529
"25020","81100","2014",3,3,0,130496.7,1213.333,97.33333
"25021","81101","2014",9,9,0,118638.9,1175.556,107.1111
"25022","81102","2014",4,4,0,267450,2074.5,136.75
"25023","81103","2014",2,2,0,42500,452.5,94.5
"25024","81104","2014",9,8,1,199778.9,1877.667,118.6667
"25025","81105","2014",114,108,6,99054.54,1061.781,97.22807
"25026","81106","2014",4,4,0,237500,1275.75,195.5
"25027","81108","2014",4,4,0,170625,2165.25,82.5
"25028","81110","2014",1,1,0,171000,919,186
"25029","81112","2014",4,4,0,197837.5,1735.5,109.5
"25030","81114","2014",1,1,0,1e+05,794,126
"25031","81115","2014",24,23,1,61206.25,749.9583,79.33333
"25032","81116","2014",13,13,0,192907.7,1757.385,111.6154
"25033","81117","2014",3,3,0,116243.3,1049.667,100.6667
"25034","81118","2014",1,1,0,84600,470,180
"25035","81119","2014",3,3,0,122975,1105.333,118
"25036","81120","2014",57,51,6,123857.9,1239.754,103.6316
"25037","81121","2014",5,5,0,73480,791.8,96.8
"25038","81123","2014",1,1,0,212000,1656,128
"25039","81124","2014",23,20,3,91258.09,1021.13,94.43478
"25040","81125","2014",7,7,0,83771.43,1046.143,89
"25041","81126","2014",1,1,0,20000,513,39
"25042","81128","2014",11,11,0,97181.82,836.1818,126.0909
"25043","81129","2014",2,2,0,135750,1449,96
"25044","81130","2014",9,6,3,117019.3,1341,88.22222
"25045","81131","2014",13,13,0,172963.8,1624.923,105.0769
"25046","81132","2014",5,5,0,101140,1027,105
"25047","81133","2014",1,1,0,80000,889,90
"25048","81136","2014",3,3,0,51666.67,840,70.66667
"25049","81138","2014",6,6,0,79166.67,881.5,105.8333
"25050","81139","2014",5,5,0,169200,1387.8,123.8
"25051","81140","2014",114,89,25,157973.8,1699.623,92.60526
"25052","81142","2014",8,8,0,155906.2,1528.875,100.75
"25053","81143","2014",2,2,0,199000,1522.5,129.5
"25054","81144","2014",19,19,0,157553.2,1488.158,110.5789
"25055","81145","2014",45,41,4,152292.5,1582.622,95.53333
"25056","81147","2014",2,2,0,170000,1367.5,124.5
"25057","81148","2014",1,1,0,212800,2800,76
"25058","81149","2014",4,4,0,187465,1661.25,110.5
"25059","81150","2014",3,3,0,280950,2097,137.3333
"25060","81151","2014",1,1,0,311000,1192,261
"25061","81152","2014",3,3,0,201833.3,1939,103.3333
"25062","81154","2014",1,1,0,350000,2121,165
"25063","81156","2014",37,36,1,164498,1635.892,103.1892
"25064","81157","2014",2,2,0,211500,1849,114.5
"25065","81159","2014",2,2,0,247500,1574,165
"25066","81160","2014",4,4,0,90399.75,1201.5,77.25
"25067","81161","2014",3,3,0,60000,914,78.33333
"25068","81162","2014",1,1,0,730000,2005,364
"25069","81163","2014",80,65,15,87627.62,979.2,92.1625
"25070","81164","2014",6,6,0,126083.3,1277.333,98.66667
"25071","81165","2014",2,2,0,317725,2113,151.5
"25072","81166","2014",1,1,0,221600,1894,117
"25073","81167","2014",2,2,0,104000,927,107
"25074","81168","2014",11,11,0,117100,1045.727,102.3636
"25075","81170","2014",13,13,0,164642.3,1340,128.0769
"25076","81171","2014",13,13,0,173035.8,1595.846,110.7692
"25077","81172","2014",1,1,0,80000,1143,70
"25078","81173","2014",1,1,0,190790,1734,110
"25079","81174","2014",1,1,0,250000,3125,80
"25080","81175","2014",2,2,0,111250,1063.5,107
"25081","81176","2014",3,3,0,377333.3,2055,179.6667
"25082","81177","2014",2,2,0,179000,1398,134.5
"25083","81178","2014",2,2,0,225475,1788.5,116
"25084","81179","2014",1,1,0,317950,1700,187
"25085","81180","2014",4,4,0,132240,1312,99.5
"25086","81181","2014",2,2,0,395000,1488.5,237.5
"25087","81182","2014",18,18,0,124416.7,1361.778,91.55556
"25088","81183","2014",3,3,0,92666.67,1550,56
"25089","81184","2014",2,2,0,69500,1091,57.5
"25090","81185","2014",1,1,0,287736,3029,95
"25091","81186","2014",2,2,0,87500,674.5,131.5
"25092","81188","2014",4,4,0,63500,856.25,80
"25093","81189","2014",1,1,0,140000,1474,95
"25094","81190","2014",2,2,0,112500,858.5,141
"25095","81191","2014",3,3,0,172666.7,1572.667,110.3333
"25096","81192","2014",7,7,0,86415.71,1191.429,89.14286
"25097","81193","2014",10,10,0,139646.4,1397.1,108.2
"25098","81195","2014",4,4,0,211750,1779.75,123
"25099","81196","2014",3,3,0,149933.3,1714.667,87.66667
"25100","81197","2014",1,1,0,170000,1650,103
"25101","81198","2014",3,3,0,192133.3,1808.667,107
"25102","81199","2014",1,1,0,80000,930,86
"25103","81200","2014",3,3,0,121200,1574,77
"25104","81201","2014",6,6,0,101941.7,750.8333,145.3333
"25105","81202","2014",6,6,0,222399.7,1854.333,117.1667
"25106","81203","2014",5,5,0,112400,1203.4,92.6
"25107","81204","2014",13,13,0,154438.5,1254,121.6154
"25108","81205","2014",2,2,0,156500,1595.5,111
"25109","81206","2014",7,7,0,75911.43,1170.571,60.71429
"25110","81208","2014",4,4,0,263910,1990.5,132.75
"25111","81209","2014",23,23,0,147776.1,1472.87,98.52174
"25112","81210","2014",1,1,0,168000,1302,129
"25113","81211","2014",1,1,0,177000,1825,97
"25114","81212","2014",1,1,0,174900,1767,99
"25115","81213","2014",1,1,0,3e+05,2500,120
"25116","81214","2014",1,1,0,48930,489,100
"25117","81215","2014",6,6,0,211101.7,1456.333,150.6667
"25118","81217","2014",3,3,0,82000,1513.333,55
"25119","81218","2014",24,24,0,199583.4,1723.042,115.1667
"25120","81219","2014",11,11,0,147590.9,1407.909,120.1818
"25121","81220","2014",53,50,3,157868.2,1498.189,109.3396
"25122","81221","2014",2,2,0,79500,882.5,93.5
"25123","81222","2014",28,26,2,150505.7,1540.25,96.10714
"25124","81225","2014",8,8,0,135712.5,1262.375,109.5
"25125","81227","2014",15,15,0,101067.3,995.7333,102.8
"25126","81228","2014",1,1,0,210000,1154,182
"25127","81229","2014",1,1,0,231000,2243,103
"25128","81230","2014",2,2,0,104500,1045.5,104
"25129","81231","2014",6,6,0,59500,695.6667,85.83333
"25130","81232","2014",2,2,0,207000,1492.5,140
"25131","81233","2014",20,20,0,117960,1195.05,96.45
"25132","81234","2014",1,1,0,359854,2856,126
"25133","81235","2014",4,4,0,152475,1433,105.25
"25134","81236","2014",3,3,0,202433.3,1736.333,122
"25135","81238","2014",11,11,0,81509.09,806.0909,99.90909
"25136","81239","2014",13,12,1,79841.77,953.2308,87.23077
"25137","81240","2014",1,1,0,23000,418,55
"25138","81243","2014",3,3,0,93687.33,1250.667,71
"25139","81244","2014",12,12,0,86104.17,1007.25,81.91667
"25140","81246","2014",2,2,0,135650,1092.5,131
"25141","81247","2014",1,1,0,120000,1111,108
"25142","81248","2014",7,7,0,150788.6,1352.571,114.2857
"25143","81249","2014",7,7,0,129761.4,1448.286,90.85714
"25144","81250","2014",1,1,0,130000,1444,90
"25145","81251","2014",5,5,0,161500,1574,102.4
"25146","81254","2014",3,3,0,115333.3,1731.333,70.33333
"25147","81255","2014",2,2,0,245300,1454,169
"25148","81256","2014",2,2,0,175100,1595,110
"25149","81257","2014",39,36,3,132980.1,1465.821,92.12821
"25150","81258","2014",4,4,0,82212.5,1120.5,79.75
"25151","81259","2014",1,1,0,23993,800,30
"25152","81261","2014",5,5,0,200600,1551.6,137
"25153","81262","2014",3,3,0,233383.3,2429.667,117.6667
"25154","81263","2014",1,1,0,80000,816,98
"25155","81264","2014",1,1,0,283000,2021,140
"25156","81265","2014",1,1,0,92000,541,170
"25157","81266","2014",6,6,0,113016.7,1276.5,91.16667
"25158","81267","2014",3,3,0,76553.33,1167.333,71
"25159","81269","2014",8,8,0,97387.5,922.25,94.625
"25160","81270","2014",1,1,0,153000,1800,85
"25161","81271","2014",85,73,12,174931.8,1806.318,96.77647
"25162","81273","2014",23,22,1,175306.5,1713.304,110.6087
"25163","81274","2014",4,4,0,194487.5,2021.25,104.25
"25164","81275","2014",2,2,0,91000,1241.5,78.5
"25165","81276","2014",10,10,0,177338.5,1374.8,125.1
"25166","81277","2014",3,3,0,133333.3,1500.667,89
"25167","81279","2014",3,3,0,163656.7,1507.667,118.3333
"25168","81280","2014",1,1,0,44000,880,50
"25169","81281","2014",21,21,0,126257.1,1334.095,95.28571
"25170","81283","2014",11,11,0,216815.2,1840.273,127.2727
"25171","81284","2014",15,13,2,156466.7,1706.6,92.66667
"25172","81285","2014",1,1,0,35000,467,75
"25173","81286","2014",2,1,1,202250,1312.5,108
"25174","81287","2014",2,2,0,145500,1466.5,99
"25175","81288","2014",30,28,2,147511.5,1394.9,104.5333
"25176","81289","2014",22,21,1,136881.8,1221.864,109.6364
"25177","81290","2014",1,1,0,167000,1606,104
"25178","81291","2014",3,3,0,146333.3,1555.667,92.33333
"25179","81292","2014",8,8,0,122190,1208.875,96.625
"25180","81293","2014",2,2,0,152125,1523,102.5
"25181","81294","2014",6,6,0,191816.7,1493.333,146
"25182","81295","2014",4,4,0,89423.5,896.25,94.75
"25183","81297","2014",9,9,0,217933.3,1906.444,117.7778
"25184","81298","2014",3,3,0,258500,2174,115
"25185","81299","2014",1,1,0,236000,2107,112
"25186","81300","2014",1,1,0,235700,3571,66
"25187","81302","2014",3,3,0,135633.3,1044,147
"25188","81303","2014",8,8,0,76337.5,1169.25,67.375
"25189","81305","2014",4,4,0,84125,657,135.75
"25190","81306","2014",1,1,0,112290,802,140
"25191","81307","2014",7,7,0,115992.9,1167.286,108.4286
"25192","81308","2014",5,5,0,84400,727,108.6
"25193","81309","2014",7,7,0,125250.1,1210.286,97.14286
"25194","81311","2014",9,9,0,127086,1122.222,114.5556
"25195","81312","2014",3,3,0,91666.67,1100.667,83
"25196","81313","2014",2,2,0,194177.5,1347,144
"25197","81314","2014",8,7,1,69325,805.625,79.75
"25198","81315","2014",9,9,0,155766.7,1479.667,103.7778
"25199","81316","2014",3,3,0,150000,1558.667,90.33333
"25200","81317","2014",7,7,0,116471.4,1081.143,123.8571
"25201","81318","2014",2,2,0,254860,2615.5,92
"25202","81319","2014",3,3,0,154100,1643.333,89.33333
"25203","81320","2014",2,2,0,213000,1468,146.5
"25204","81321","2014",3,3,0,104333.3,1095,106.3333
"25205","81323","2014",2,2,0,163800,1773.5,93
"25206","81324","2014",1,1,0,95000,731,130
"25207","81325","2014",16,16,0,167418.8,1654.5,101
"25208","82001","2014",2,2,0,136000,1494.5,91.5
"25209","82002","2014",17,17,0,154461.8,1566.647,104.8824
"25210","82003","2014",2,2,0,205000,1598.5,131
"25211","82004","2014",2,2,0,103500,1255,82.5
"25212","82005","2014",9,9,0,221519.3,1901.444,126.8889
"25213","82008","2014",10,10,0,125825,1151.7,108.2
"25214","82010","2014",1,1,0,170000,680,250
"25215","82011","2014",9,9,0,156275.6,1579.556,104.4444
"25216","82012","2014",2,2,0,138000,1317.5,106
"25217","82013","2014",33,30,3,85813.94,981.5758,88.33333
"25218","82014","2014",3,3,0,204916.7,1764.333,118.3333
"25219","82016","2014",1,1,0,535000,2306,232
"25220","82017","2014",9,9,0,163538.9,1514.778,110.3333
"25221","82018","2014",9,8,1,172238.9,1414.333,119.4444
"25222","82019","2014",4,4,0,104848.8,923.5,127
"25223","82020","2014",4,4,0,142150,1404.5,97.75
"25224","82021","2014",5,5,0,185484.6,1467.6,164.4
"25225","82022","2014",7,7,0,85853.14,939.8571,87.42857
"25226","82023","2014",8,8,0,155181.2,1246.25,123.875
"25227","82024","2014",1,1,0,79000,367,215
"25228","82025","2014",30,30,0,148778.2,1503.467,104.1667
"25229","82026","2014",9,8,1,149084.4,1389.556,108.3333
"25230","82027","2014",9,9,0,184741.1,1741.444,108.7778
"25231","82028","2014",4,4,0,169005.2,1679.75,100.5
"25232","82029","2014",3,3,0,225049.3,1799.333,116
"25233","82030","2014",1,1,0,110000,1222,90
"25234","82031","2014",7,7,0,135810,1303.143,114.4286
"25235","82032","2014",4,4,0,176793.8,1166.5,146.25
"25236","82033","2014",116,97,19,122403.7,1292.569,99.97414
"25237","82035","2014",4,4,0,181900,1870.25,103.5
"25238","82036","2014",2,2,0,210000,1716.5,140
"25239","82037","2014",63,58,5,128923.3,1519.127,85.5873
"25240","82038","2014",25,25,0,125734.4,1332.16,99.72
"25241","82039","2014",3,3,0,214166.7,1995.667,105.3333
"25242","82040","2014",2,2,0,93750,949,107.5
"25243","82041","2014",3,3,0,92700,1196,74.66667
"25244","82042","2014",8,8,0,141843.8,1453.125,94.125
"25245","82043","2014",2,2,0,221494,1662,135
"25246","82044","2014",11,11,0,189868.2,1649.273,113.3636
"25247","82045","2014",5,5,0,175400,1479.8,120.8
"25248","82047","2014",1,1,0,210000,2100,100
"25249","82048","2014",15,15,0,161739.7,1571.867,105.9333
"25250","82049","2014",7,7,0,150071.4,1259.857,121
"25251","82050","2014",8,8,0,113937.5,1173.25,101.875
"25252","82051","2014",2,2,0,399475,1874.5,199
"25253","82052","2014",11,11,0,131091.1,1384.091,97.09091
"25254","82053","2014",2,2,0,145000,1739.5,82.5
"25255","82054","2014",1,1,0,155000,1099,141
"25256","82055","2014",3,3,0,190000,1965.667,103.3333
"25257","82056","2014",1,1,0,75000,3571,21
"25258","82057","2014",5,5,0,198694,1730,116.2
"25259","82058","2014",1,1,0,147000,1960,75
"25260","82059","2014",1,1,0,173000,1504,115
"25261","82060","2014",2,2,0,247500,1518.5,155.5
"25262","82061","2014",2,2,0,203326,1260,133.5
"25263","82062","2014",25,25,0,150464.4,1381.04,112.76
"25264","82063","2014",3,3,0,86833.33,1317,77
"25265","82064","2014",1,1,0,170000,1133,150
"25266","82065","2014",5,5,0,83983,1255,65.6
"25267","82066","2014",2,2,0,147500,1501.5,97
"25268","82067","2014",1,1,0,230000,1825,126
"25269","82068","2014",1,1,0,55000,611,90
"25270","82069","2014",4,4,0,104783,1343.5,78.5
"25271","82072","2014",8,8,0,119612.5,1319.75,94.75
"25272","82073","2014",7,7,0,166963.4,1543.857,106
"25273","82074","2014",2,2,0,156760,1311,134
"25274","82075","2014",2,2,0,236740,1939,128.5
"25275","82076","2014",9,9,0,128826.7,1375.444,98.88889
"25276","82077","2014",4,4,0,117762.5,1079.25,110.75
"25277","82078","2014",1,1,0,337000,2592,130
"25278","82079","2014",27,24,3,154541.7,1676.741,93.40741
"25279","82080","2014",3,3,0,138000,1339.667,106
"25280","82081","2014",3,3,0,41333.33,636.6667,62.66667
"25281","82082","2014",3,3,0,130666.7,2024.333,68.33333
"25282","82083","2014",1,1,0,330000,1269,260
"25283","82084","2014",1,1,0,195000,1950,100
"25284","82085","2014",8,8,0,145847.5,1475.375,103.875
"25285","82086","2014",2,2,0,130000,1408.5,92
"25286","82087","2014",14,13,1,106321.4,1324.429,78.78571
"25287","82088","2014",7,6,1,133893.9,1376.571,110.2857
"25288","82089","2014",13,11,2,86410.69,810.6923,114.4615
"25289","82090","2014",10,10,0,170510,1884.6,104.2
"25290","82091","2014",1,1,0,157000,1121,140
"25291","82092","2014",5,5,0,174243,1614.8,104
"25292","82093","2014",2,2,0,111700,504,212.5
"25293","82094","2014",16,16,0,85281.25,950.25,102.125
"25294","82095","2014",1,1,0,119000,3306,36
"25295","82096","2014",21,19,2,144706.7,1492.476,104.0952
"25296","82097","2014",7,6,1,124209.1,1496.286,105
"25297","82098","2014",7,7,0,159271.4,1509.714,101.7143
"25298","82099","2014",2,2,0,184750,1555,112.5
"25299","82101","2014",6,6,0,106103.3,1087,104
"25300","82102","2014",2,2,0,208950,1843.5,106
"25301","82103","2014",1,1,0,150000,1500,100
"25302","82105","2014",8,8,0,251125,2294.25,122.375
"25303","82106","2014",2,2,0,87000,953.5,116.5
"25304","82108","2014",8,8,0,123937.5,1153.75,106.875
"25305","82109","2014",1,1,0,171500,858,200
"25306","82110","2014",6,6,0,156583.3,1415.5,115.5
"25307","82111","2014",4,4,0,140375,1513,99.25
"25308","82112","2014",108,89,19,118212,1265.324,99.30556
"25309","82113","2014",10,9,1,96400,1510.3,74.4
"25310","82114","2014",4,4,0,184975,1489.5,126.25
"25311","82115","2014",10,10,0,167452,1865.1,92
"25312","82116","2014",2,2,0,194000,1919.5,115.5
"25313","82117","2014",12,11,1,133454.1,1137.583,120
"25314","82119","2014",2,2,0,124500,1505.5,80
"25315","82120","2014",1,1,0,161500,1009,160
"25316","82121","2014",705,389,316,133638.5,1539.56,85.83404
"25317","82123","2014",7,7,0,150971.4,1731.714,87.57143
"25318","82124","2014",29,25,4,154164.4,1471.138,107.3103
"25319","82125","2014",49,45,4,163250.9,1737.673,94.79592
"25320","82126","2014",7,7,0,192128.6,1891.857,103.1429
"25321","82127","2014",3,3,0,116666.7,1093,122
"25322","82128","2014",1,1,0,54000,900,60
"25323","82129","2014",1,1,0,115000,821,140
"25324","82130","2014",3,3,0,132000,1328,100
"25325","82131","2014",17,17,0,132300.8,1327.941,100.1765
"25326","82132","2014",13,12,1,126811.5,1363.769,92.76923
"25327","82134","2014",33,33,0,140308.8,1293.97,111.3333
"25328","82135","2014",9,9,0,174500,1820.778,99.77778
"25329","82136","2014",12,12,0,162008.3,1543.75,106.75
"25330","82137","2014",2,2,0,157405,1263.5,125
"25331","82138","2014",1,1,0,165200,1073,154
"25332","82139","2014",2,2,0,152500,1659.5,97
"25333","82140","2014",3,3,0,116900,995.6667,113.6667
"25334","82141","2014",1,1,0,86000,623,138
"25335","82142","2014",14,13,1,197871.4,1723.429,117.7857
"25336","82144","2014",6,6,0,150050,1558.667,98
"25337","82145","2014",1,1,0,179000,1989,90
"25338","82146","2014",1,1,0,160000,952,168
"25339","82147","2014",6,6,0,221350,2246.667,105.5
"25340","82148","2014",15,15,0,136983,1440.133,99.33333
"25341","82149","2014",12,11,1,167255,1848.75,97
"25342","82150","2014",9,9,0,159140,1660.333,106
"25343","82151","2014",8,8,0,167875,1277.125,131.375
"25344","82152","2014",2,1,1,59000,656.5,93.5
"25345","82153","2014",5,5,0,89090,1173,88.8
"25346","82154","2014",3,3,0,294666.7,3051.333,109.3333
"25347","82155","2014",39,37,2,140663.6,1649.128,87.41026
"25348","82156","2014",1,1,0,125750,1258,100
"25349","82158","2014",3,3,0,98733.33,1322.667,72.66667
"25350","82159","2014",3,3,0,213166.7,1488,134
"25351","82160","2014",2,2,0,192500,1260,169.5
"25352","82161","2014",30,30,0,167332.8,1601.2,107.1
"25353","82162","2014",2,2,0,151150,1661.5,91
"25354","82164","2014",1,1,0,90000,909,99
"25355","82165","2014",4,4,0,99875,1026.5,87.25
"25356","82166","2014",1,1,0,60000,706,85
"25357","82167","2014",7,7,0,156157.1,1463.857,111.7143
"25358","82169","2014",13,13,0,108318.5,1153.462,98.61538
"25359","82170","2014",3,3,0,108333.3,1169,102.6667
"25360","82171","2014",10,10,0,137380,1222.2,116.8
"25361","82172","2014",6,6,0,280150,1962.833,138.3333
"25362","82173","2014",8,8,0,129775,1129,122.75
"25363","82174","2014",1,1,0,159500,1772,90
"25364","82176","2014",5,5,0,114200,1291.4,83.8
"25365","82177","2014",2,2,0,135000,1123,123.5
"25366","82178","2014",6,6,0,183857.5,1378,132.1667
"25367","82179","2014",24,24,0,99695.83,1102.958,89.08333
"25368","82180","2014",6,6,0,136011.3,859.3333,159.1667
"25369","82181","2014",3,3,0,179333.3,1603,111.6667
"25370","82182","2014",1,1,0,145000,1611,90
"25371","82183","2014",2,2,0,174700,1573,110
"25372","82184","2014",7,7,0,153462.7,1102,140.5714
"25373","82185","2014",5,5,0,121420,1620.4,74.8
"25374","82186","2014",46,42,4,101678.3,1101.217,94.52174
"25375","82187","2014",11,10,1,130496,1658.091,94.81818
"25376","82188","2014",6,6,0,173612.3,1172.667,142.6667
"25377","82189","2014",7,7,0,179738.7,1680.429,107.8571
"25378","82190","2014",40,37,3,160496.4,1684.225,97.975
"25379","82191","2014",8,8,0,115666,1127.75,137.125
"25380","82192","2014",7,7,0,158028.6,1416.714,118
"25381","82193","2014",2,2,0,117500,1468.5,80
"25382","82194","2014",11,9,2,148924.7,1697.273,86.90909
"25383","82195","2014",7,7,0,148601.4,1566.429,96.85714
"25384","83001","2014",28,27,1,383742.1,3719.893,105.7857
"25385","83002","2014",1,1,0,135500,2606,52
"25386","83003","2014",14,12,2,186915,2302.357,88
"25387","83004","2014",83,49,34,247229.6,2694.916,90.0241
"25388","83005","2014",3,3,0,183000,2188,85
"25389","83006","2014",3,3,0,282183.3,2177.667,129.3333
"25390","83007","2014",25,17,8,206972.8,2499.68,85.64
"25391","83008","2014",46,36,10,294363.1,3035.348,97.6087
"25392","83009","2014",281,47,234,288866.6,5180.527,57.63345
"25393","83010","2014",3,3,0,126386.7,2866.333,50
"25394","83011","2014",15,8,7,224266,2193.733,95.33333
"25395","83012","2014",42,27,15,154563.3,2273.667,75.40476
"25396","83013","2014",5,4,1,145000,2154.4,75
"25397","83014","2014",4,4,0,229250,2575.75,73.5
"25398","83015","2014",6,4,2,210416.7,3158.833,67.33333
"25399","83016","2014",117,75,42,308983.5,3584.179,83.00855
"25400","83017","2014",23,17,6,251819.6,2766.261,97.43478
"25401","83018","2014",27,22,5,257821.1,2581.333,98.44444
"25402","83019","2014",202,58,144,278531.5,4890.525,54.84653
"25403","83021","2014",45,44,1,219756.9,2562.4,91.51111
"25404","83023","2014",151,78,73,175319.7,2271.887,79.53642
"25405","83025","2014",14,10,4,172795,2094,85.57143
"25406","83026","2014",23,20,3,165189.1,1956.565,88.34783
"25407","83027","2014",40,36,4,516014.4,4610.85,104.675
"25408","83028","2014",23,19,4,212457.7,2583.522,89.86957
"25409","83029","2014",37,28,9,302616.8,3343.946,96.40541
"25410","83030","2014",22,16,6,130511.4,1760.818,75.72727
"25411","83031","2014",39,25,14,247259.1,2589.897,94.84615
"25412","83032","2014",43,33,10,225836.7,2329.395,102.8837
"25413","83033","2014",53,40,13,175891.8,2243.943,83.77358
"25414","83034","2014",124,55,69,360886.5,4332.161,83.54032
"25415","83035","2014",37,31,6,311934.8,3805.703,78.64865
"25416","83036","2014",1,0,1,280000,4000,70
"25417","83037","2014",14,7,7,246843.1,3067.929,84.92857
"25418","83038","2014",2,2,0,297500,2167,140.5
"25419","83039","2014",1,1,0,130000,1912,68
"25420","83041","2014",7,5,2,221057.1,2408.143,89.42857
"25421","83042","2014",119,47,72,238278.3,3617.647,68.72269
"25422","83043","2014",20,17,3,357112.5,3099.2,95.7
"25423","83044","2014",5,5,0,174800,1888.8,93.4
"25424","83045","2014",6,6,0,197274.3,2494.167,78.83333
"25425","83046","2014",32,27,5,302967.2,2812.312,110.0312
"25426","83047","2014",136,93,43,274208.4,3209.684,85.625
"25427","83048","2014",121,61,60,431189.7,5730.983,69.13223
"25428","83049","2014",10,10,0,331780,3764.7,99.4
"25429","83050","2014",383,138,245,178459.2,2281.809,77.01828
"25430","83051","2014",18,17,1,311686.7,2875.611,100.5
"25431","83052","2014",9,9,0,162200.9,2303.444,89.11111
"25432","83053","2014",13,10,3,341981.5,3946.462,94.38462
"25433","83054","2014",65,47,18,286394.6,3073.154,96.29231
"25434","83055","2014",83,62,21,300229.3,3390.675,96.55422
"25435","83056","2014",23,22,1,235181.5,2654.826,92.52174
"25436","83057","2014",38,34,4,217864.5,2285.947,91.97368
"25437","83058","2014",43,35,8,277155.8,3076.419,93.09302
"25438","83059","2014",30,25,5,221100.3,2729.333,90.8
"25439","83060","2014",5,5,0,252000,2727.8,99.6
"25440","83061","2014",776,185,591,244189.1,3810.871,65.34149
"25441","83062","2014",227,79,148,225136,2958.463,76.61233
"25442","83063","2014",27,18,9,407738.5,3480.407,99.48148
"25443","83064","2014",50,48,2,269473.7,2763.66,99.4
"25444","83065","2014",45,32,13,524766.2,6222.689,74.77778
"25445","83066","2014",18,17,1,207745,2394.944,92.22222
"25446","83067","2014",41,36,5,157276.6,2073.585,81.63415
"25447","83068","2014",166,77,89,481515,6536.904,72.61446
"25448","83069","2014",679,138,541,244105.5,3667.473,66.49043
"25449","83070","2014",191,35,156,281163.2,5428.634,52.12565
"25450","83071","2014",152,75,77,262592.3,4469.664,60.03947
"25451","83072","2014",110,73,37,275681.8,2767.464,94.84545
"25452","83073","2014",94,67,27,181817.9,2404.968,78.12766
"25453","83074","2014",3,3,0,223333.3,2973.667,99
"25454","83075","2014",7,6,1,186000,2019.143,83.71429
"25455","83076","2014",13,12,1,174702.2,2352.154,86.38462
"25456","83077","2014",17,16,1,314337.1,2719.235,117.4118
"25457","83078","2014",8,8,0,215446.9,2280.5,93.25
"25458","83079","2014",14,5,9,390071.4,4626.143,74.21429
"25459","83080","2014",11,10,1,320000,2789,109.2727
"25460","83081","2014",90,64,26,285614.1,3349.5,86.93333
"25461","83082","2014",1,1,0,405000,2893,140
"25462","83083","2014",15,12,3,189026.7,2029.933,89.73333
"25463","83084","2014",11,11,0,155272.7,1671.273,86.18182
"25464","83085","2014",42,34,8,294966.9,3443.381,89.80952
"25465","83086","2014",85,59,26,216797.7,2653.929,79.85882
"25466","83087","2014",39,29,10,250618.6,2703.385,96.17949
"25467","83088","2014",21,20,1,317911.4,3049.381,108.9048
"25468","83089","2014",5,3,2,212000,1899.6,82.6
"25469","83090","2014",90,46,44,258617.2,3415.011,75.18889
"25470","83091","2014",60,45,15,261708.9,2729.45,93.93333
"25471","83092","2014",41,35,6,205219.4,2465.171,87.07317
"25472","83093","2014",28,22,6,239501.9,3218.429,82.14286
"25473","83094","2014",45,31,14,393200.7,4274.044,91.6
"25474","83095","2014",6,6,0,264266.7,2529.333,107
"25475","83096","2014",10,9,1,181486,2492.1,76.4
"25476","83097","2014",50,43,7,307770.9,2953.54,105.28
"25477","83098","2014",130,46,84,257518.1,3476.315,74.34615
"25478","83099","2014",61,35,26,275947.7,2906.836,87.60656
"25479","83100","2014",43,30,13,196455.3,2446.233,89.51163
"25480","83101","2014",28,25,3,1130948,8566.607,125.8571
"25481","83102","2014",47,47,0,230664.1,2449.064,96.91489
"25482","83103","2014",23,20,3,301599.2,3375.348,92.78261
"25483","83104","2014",50,44,6,171450.6,2006.68,85.84
"25484","83106","2014",43,37,6,225965.8,2835.023,82.55814
"25485","83107","2014",269,159,110,321223.1,4103.699,77.54647
"25486","83108","2014",26,24,2,266928.8,2862.385,98.84615
"25487","83109","2014",6,5,1,164000,1775.667,90
"25488","83110","2014",19,13,6,210545.3,2422.789,93.94737
"25489","83111","2014",17,14,3,223935.3,2520.882,92.17647
"25490","83112","2014",208,79,129,323492.8,4610.668,71.28846
"25491","83113","2014",32,32,0,165714.4,2373.875,76.125
"25492","83114","2014",5,4,1,152800,1780.4,77.2
"25493","83115","2014",304,96,208,367229.1,4856.944,71.24342
"25494","83116","2014",151,122,29,255509.2,2783.583,93.22517
"25495","83117","2014",15,14,1,365350.7,4089.6,95.13333
"25496","83118","2014",777,194,583,305699.2,4162.642,72.44015
"25497","83119","2014",79,4,75,453658.8,7880.456,58.37975
"25498","83120","2014",54,26,28,240669,2917.519,85.16667
"25499","83121","2014",37,26,11,208142.5,2516.216,86.21622
"25500","83122","2014",7,4,3,150671.4,2441.143,65.85714
"25501","83123","2014",332,97,235,301423.7,4632.907,66.1988
"25502","83124","2014",24,20,4,406938.5,3239.417,118.9583
"25503","83125","2014",22,19,3,227079,2505.636,94
"25504","83126","2014",709,209,500,194607.4,3003.243,66.05501
"25505","83127","2014",21,17,4,229835.5,2680.524,85.47619
"25506","83128","2014",11,11,0,216370.5,1915.273,115.4545
"25507","83129","2014",596,205,391,251329.4,3907.342,67.29027
"25508","83130","2014",102,56,46,238235,2897.304,82.98039
"25509","83132","2014",21,15,6,251348.1,2700.762,95.90476
"25510","83133","2014",13,12,1,499115.4,3529.231,128.4615
"25511","83134","2014",22,18,4,294274.5,2855.545,106.0455
"25512","83135","2014",10,10,0,200950,2619.8,88.8
"25513","83136","2014",33,30,3,257065.5,2700.152,94.84848
"25514","83137","2014",2058,323,1735,167135.9,2518.544,65.43975
"25515","83138","2014",30,28,2,495518.3,3875.433,111.7
"25516","83139","2014",8,8,0,264312.5,2762.25,105.875
"25517","83140","2014",67,50,17,195799.2,2279.746,89.79104
"25518","83141","2014",54,38,16,206453.2,2480.907,84.64815
"25519","83142","2014",3,2,1,280000,5339.333,50.33333
"25520","83143","2014",52,46,6,230423.1,2502.519,93.82692
"25521","83144","2014",267,74,193,206230.5,2902.004,73.53933
"25522","83145","2014",23,19,4,118776.1,2109.696,61.47826
"25523","83146","2014",25,23,2,235118.7,2369.6,100.56
"25524","83148","2014",115,95,20,227359,2663.939,85.9913
"25525","83149","2014",13,10,3,252178.5,2401.923,112
"25526","83150","2014",44,34,10,194257.5,2310.295,86.25
"25527","83151","2014",6,6,0,205826.7,2254.333,97.5
"25528","83152","2014",14,10,4,989560.7,7241.786,136
"25529","83154","2014",11,11,0,332928.2,3297.455,116.6364
"25530","84001","2014",30,12,18,215596.7,2558.033,81
"25531","84002","2014",13,11,2,271665.4,2948.538,95
"25532","84003","2014",82,44,38,159545.9,1973.537,78.97561
"25533","84004","2014",18,18,0,264588.9,2478.944,112.6111
"25534","84005","2014",2,2,0,122155,3119.5,50
"25535","84007","2014",1099,303,796,139052.3,2281.964,64.44313
"25536","84008","2014",7,6,1,445607.6,2800.714,143.7143
"25537","84009","2014",15,12,3,147279.3,1951.333,73.86667
"25538","84010","2014",7,6,1,254542.9,3083.143,87.71429
"25539","84011","2014",7,6,1,206842.9,2848.286,74.71429
"25540","84012","2014",11,5,6,173539.5,2297.455,83.18182
"25541","84013","2014",2,2,0,395000,3061.5,112.5
"25542","84014","2014",8,7,1,239178.8,2619.625,92
"25543","84015","2014",1,1,0,155000,1938,80
"25544","84016","2014",41,31,10,214224.1,2161.122,101.4146
"25545","84017","2014",34,29,5,256031.8,2916.118,91.41176
"25546","84018","2014",1,1,0,554735,4109,135
"25547","84019","2014",99,79,20,148373.7,1663.343,89.83838
"25548","84020","2014",16,16,0,714702.8,4833.938,143.375
"25549","84022","2014",2,2,0,212000,2060.5,95
"25550","84024","2014",4,1,3,175500,2934.25,56.5
"25551","84025","2014",18,18,0,420265.8,3256.667,121.2778
"25552","84026","2014",39,29,10,318708.5,2987.077,101.0256
"25553","84027","2014",17,16,1,165769.4,1917.353,93.64706
"25554","84028","2014",4,4,0,451904.2,3674.5,110.75
"25555","84029","2014",38,38,0,179819.6,1972.421,91.78947
"25556","84030","2014",26,22,4,255608.5,2425.308,100.3462
"25557","84031","2014",236,143,93,176293.9,1958.047,88.3178
"25558","84032","2014",4,4,0,236750,1710.75,136.5
"25559","84033","2014",3,3,0,154666.7,2439.333,72.66667
"25560","84034","2014",28,22,6,194575.7,2112.607,94.78571
"25561","84035","2014",202,104,98,145650.5,1866.911,76.5
"25562","84036","2014",19,15,4,268394.7,2778.211,102.5789
"25563","84037","2014",9,9,0,175333.3,1881.111,94.88889
"25564","84038","2014",18,17,1,297625.9,2611.222,112.8333
"25565","84039","2014",36,31,5,216861.3,2043.694,88.86111
"25566","84040","2014",2,2,0,334000,2842.5,118
"25567","84041","2014",3,3,0,410333.3,3776.667,109.3333
"25568","84042","2014",15,11,4,356614,3355,95.06667
"25569","84043","2014",83,60,23,208777.8,2460.193,85.63855
"25570","84044","2014",7,5,2,309088.6,2375.571,115.5714
"25571","84045","2014",6,6,0,349583.3,2642.167,124
"25572","84046","2014",4,4,0,190325,1573.75,121.5
"25573","84047","2014",24,24,0,190794.9,2020.958,93.66667
"25574","84049","2014",1,1,0,190000,2500,76
"25575","84050","2014",30,29,1,702366.7,5044.833,139.4333
"25576","84051","2014",9,8,1,471026,3342.667,122.5556
"25577","84052","2014",10,10,0,236735.5,2860.3,89.2
"25578","84053","2014",10,10,0,183482,1921.1,98.1
"25579","84054","2014",200,136,64,232874.9,2826.785,83.16
"25580","84055","2014",6,6,0,284146.3,2494.167,113.6667
"25581","84056","2014",40,29,11,150162.6,2057.825,74.975
"25582","84057","2014",2,2,0,527675,4667,107.5
"25583","84058","2014",6,5,1,832000,4404.667,149.6667
"25584","84061","2014",6,6,0,290265.8,1973.333,144.8333
"25585","84062","2014",5,4,1,290428,3367.8,95.4
"25586","84063","2014",2,2,0,576500,5001,113
"25587","84064","2014",21,17,4,132476.2,1504.571,93.7619
"25588","84065","2014",38,34,4,265909.9,2922.079,96.55263
"25589","84066","2014",1,1,0,337400,2934,115
"25590","84067","2014",13,13,0,213600,2252.692,100.4615
"25591","84068","2014",16,9,7,418218.4,4470.25,89.3125
"25592","84069","2014",22,20,2,208074,2323.455,86.5
"25593","84070","2014",9,9,0,188337,2220.778,94.33333
"25594","84071","2014",14,12,2,292357.1,3076.071,99.85714
"25595","84072","2014",11,11,0,348186.4,2798.818,121.0909
"25596","84073","2014",8,7,1,434812.5,4105.25,98.25
"25597","84074","2014",22,21,1,333186.6,3086,101.6818
"25598","84075","2014",4,4,0,126000,1998.5,60.25
"25599","84076","2014",17,16,1,224715.9,2881.765,87.52941
"25600","84077","2014",3,3,0,227925.7,2613.333,78.33333
"25601","84078","2014",35,28,7,152748.4,1677.114,88.91429
"25602","84079","2014",5,5,0,225300,2960,87.4
"25603","84080","2014",78,57,21,180332.2,2208.551,83.0641
"25604","84081","2014",89,64,25,206529.3,2348.449,88.8427
"25605","84082","2014",17,15,2,255714.7,2376.471,104.4118
"25606","84083","2014",20,18,2,172800,1777.05,95.75
"25607","84084","2014",14,12,2,251990.7,2908,84
"25608","84085","2014",7,7,0,621698.6,4391.857,149.7143
"25609","84086","2014",14,13,1,480424.6,3916.571,132.0714
"25610","84087","2014",211,120,91,151151.4,1837.36,81.85782
"25611","84088","2014",90,73,17,260670.4,2604.489,99.03333
"25612","84089","2014",186,108,78,206441.7,2648.973,78.62903
"25613","84090","2014",9,9,0,259163.3,3249.889,83.88889
"25614","84091","2014",33,32,1,180351,1933.242,96.21212
"25615","84092","2014",141,86,55,155363.5,1959.844,80.37589
"25616","84093","2014",14,14,0,330571.8,2741.571,126.7857
"25617","84094","2014",8,8,0,351412.5,2427.75,146.625
"25618","84095","2014",10,10,0,253525,2290,157.9
"25619","84096","2014",6,6,0,248911.7,3816.5,70.66667
"25620","84097","2014",6,6,0,245333.3,2229.5,108.6667
"25621","84098","2014",8,8,0,213531.2,2719.875,79.125
"25622","84099","2014",41,38,3,231908.5,2581.024,89.68293
"25623","84102","2014",17,15,2,457054.8,3721.471,118.7059
"25624","84103","2014",10,9,1,286160,3128.2,89.6
"25625","84104","2014",7,6,1,278514.3,1834.143,139.2857
"25626","84105","2014",10,10,0,239596.7,2314.7,93.8
"25627","84106","2014",20,15,5,138731.7,1950.65,78.55
"25628","84107","2014",7,6,1,105428.6,1132.857,88.14286
"25629","84108","2014",16,16,0,276526.9,2828.562,97.1875
"25630","84110","2014",1,1,0,27000,730,37
"25631","84112","2014",14,13,1,202910.7,2454.5,81.14286
"25632","84113","2014",10,8,2,142290,2348.9,63
"25633","84115","2014",4,4,0,275600,2099.25,129.75
"25634","84116","2014",11,11,0,294103.6,2318,127.1818
"25635","84117","2014",2,2,0,210000,1562.5,128
"25636","84118","2014",30,25,5,267888.8,3067.867,91.73333
"25637","84119","2014",43,32,11,203112.6,2260.163,89.06977
"25638","84122","2014",39,29,10,194944.4,1992.923,94.92308
"25639","84123","2014",15,11,4,153401.7,1813.6,82.6
"25640","84124","2014",14,8,6,202908.6,2848.071,78.71429
"25641","84125","2014",2,2,0,217250,1820.5,115
"25642","84126","2014",5,5,0,465990,3215.6,155.6
"25643","84127","2014",26,26,0,193066.2,2168.423,91.96154
"25644","84129","2014",132,88,44,154275.6,1808.492,86.59848
"25645","84130","2014",1,1,0,665000,3694,180
"25646","84131","2014",18,17,1,245898.1,2505,101.1111
"25647","84132","2014",77,58,19,247551,2515.883,99.23377
"25648","84133","2014",42,33,9,217042.9,2407.429,88.92857
"25649","84134","2014",3,3,0,252500,2802.333,101
"25650","84135","2014",11,11,0,260090.9,2378.636,109.3636
"25651","84136","2014",7,6,1,292928.6,2205,131.4286
"25652","84137","2014",71,40,31,203580.3,2646.563,77.6338
"25653","84138","2014",81,49,32,119072.2,1410.025,81.61728
"25654","84139","2014",5,4,1,227600,4235.2,67.6
"25655","84140","2014",5,5,0,282600,2752.4,101
"25656","84141","2014",94,82,12,210353.4,2234,96.65957
"25657","84142","2014",12,12,0,266802.8,2369,114.75
"25658","84143","2014",8,6,2,399978.1,3522,103.375
"25659","84144","2014",8,7,1,161161.6,2833.375,61.125
"25660","84145","2014",7,7,0,289285.7,2374.286,119.1429
"25661","84146","2014",5,5,0,297655.8,2384.2,129.8
"25662","84147","2014",24,18,6,237784.6,3023.042,85.375
"25663","84148","2014",11,11,0,198763.6,2748.909,77.27273
"25664","84149","2014",11,10,1,206090.9,2252.455,95.18182
"25665","84150","2014",18,17,1,178466.7,1700.111,103.7778
"25666","84151","2014",4,4,0,325750,2506.5,122.5
"25667","85001","2014",68,66,2,148205.9,2146.221,70.04412
"25668","85002","2014",23,23,0,133130.4,1736.478,77.91304
"25669","85003","2014",69,68,1,150121.9,1633.435,95.57971
"25670","85004","2014",53,53,0,141285.5,1730.226,84.49057
"25671","85005","2014",7,7,0,108278.6,921.4286,114.8571
"25672","85006","2014",17,17,0,121458.4,1415.882,87.82353
"25673","85008","2014",42,41,1,161819,1966.833,90.85714
"25674","85009","2014",3,3,0,86500,655,137
"25675","85010","2014",5,5,0,182600,1751.6,101.8
"25676","85011","2014",43,41,2,193872.8,2919.884,68.83721
"25677","85012","2014",54,43,11,138339.9,2048.852,70.83333
"25678","85013","2014",14,14,0,116737.5,1142.286,96.14286
"25679","85014","2014",12,12,0,105866.7,1111.917,99.08333
"25680","85015","2014",4,4,0,126500,1350.5,90
"25681","85016","2014",16,16,0,125606.2,1526.75,86.375
"25682","85017","2014",8,8,0,156500,1405.5,116.625
"25683","85018","2014",46,45,1,127430.1,1455.304,93.56522
"25684","85019","2014",36,36,0,132599.4,1430.917,94.19444
"25685","85020","2014",32,32,0,123837.2,1298.125,99.0625
"25686","85021","2014",10,9,1,142910,1523.7,94.9
"25687","85022","2014",16,16,0,133802.5,1562.312,94.4375
"25688","85023","2014",5,5,0,91400,1038.6,82.4
"25689","85024","2014",3,3,0,109083.3,856.6667,136
"25690","85025","2014",18,18,0,121032.1,1254.333,98.5
"25691","85026","2014",11,11,0,160327.4,1506.636,98.18182
"25692","85028","2014",4,4,0,118425,1006.75,119
"25693","85029","2014",25,25,0,116236,1657.6,75.48
"25694","85031","2014",16,16,0,104425,1063.188,101.0625
"25695","85033","2014",1,1,0,120000,857,140
"25696","85034","2014",28,28,0,120554.6,1232.357,100.1429
"25697","85035","2014",162,138,24,178156.9,2713.148,70.20988
"25698","85036","2014",5,5,0,149400,1291.6,115.6
"25699","85037","2014",6,6,0,99099.83,844.5,131
"25700","85038","2014",24,24,0,101747.6,1124.292,91.83333
"25701","85039","2014",26,25,1,120058,1387.577,88.5
"25702","85040","2014",12,12,0,113083.3,1079.833,113.4167
"25703","85041","2014",1,1,0,110000,1294,85
"25704","85042","2014",18,18,0,114027.8,1167.278,101
"25705","85045","2014",14,13,1,154850.1,1773.571,89.78571
"25706","85046","2014",17,17,0,134500,1456,93.23529
"25707","85047","2014",190,158,32,165382.3,1893.174,87.56842
"25708","85049","2014",12,12,0,127743.5,1334.333,96.16667
"25709","85050","2014",29,29,0,97842.21,1101.931,92.65517
"25710","85051","2014",64,60,4,105849.8,1256.438,84.82812
"25711","85053","2014",1,1,0,110000,647,170
"25712","85054","2014",11,11,0,134272.7,1370.909,100.2727
"25713","85055","2014",2,2,0,144000,2368,86
"25714","85056","2014",2,2,0,72000,961,74
"25715","85059","2014",23,23,0,70623.91,775.1739,94.26087
"25716","85061","2014",1,1,0,133000,2111,63
"25717","85062","2014",10,10,0,144336,1437.3,100
"25718","85064","2014",12,12,0,118875.6,1334.333,92.08333
"25719","85065","2014",23,23,0,116163,1342.391,87.56522
"25720","85066","2014",5,5,0,78490,733,105
"25721","85067","2014",8,8,0,66050,792.625,85.125
"25722","85070","2014",34,34,0,127709.1,1540.471,84.82353
"25723","85071","2014",34,33,1,146071.3,1644.853,89.29412
"25724","85072","2014",10,10,0,101910,1118.5,100.9
"25725","85073","2014",6,6,0,135000,1381.833,98.16667
"25726","85074","2014",1,1,0,177000,1863,95
"25727","85076","2014",35,35,0,168368.1,1689.714,104.8286
"25728","85077","2014",4,4,0,91375,1158,81.25
"25729","85078","2014",14,14,0,97010.71,1164.786,91.71429
"25730","85080","2014",14,14,0,115285.7,1123,109.0714
"25731","85081","2014",25,25,0,161820.9,1628.16,101.48
"25732","85082","2014",13,13,0,116819.2,1295.538,95.46154
"25733","85083","2014",27,27,0,258870.4,3519.259,79.37037
"25734","85084","2014",53,53,0,138172.8,1437.453,95.66038
"25735","85086","2014",6,6,0,76416.67,878.5,86.33333
"25736","85087","2014",1,1,0,105000,714,147
"25737","85088","2014",49,49,0,232777.8,2252.694,104.4286
"25738","85089","2014",52,50,2,144165.4,1517.154,97.03846
"25739","85090","2014",37,37,0,114027.8,1230.973,93.35135
"25740","85092","2014",110,92,18,115123.4,1187.436,95.98182
"25741","85093","2014",15,15,0,105766.7,1270.667,92.66667
"25742","85094","2014",12,12,0,110416.7,888.9167,132.5833
"25743","85095","2014",11,11,0,115988.2,1356.455,86.18182
"25744","85096","2014",43,43,0,154197.7,1517.814,104.2791
"25745","85097","2014",9,9,0,126222.2,1224.667,105.2222
"25746","85098","2014",13,13,0,147461.5,1444.231,101.4615
"25747","85099","2014",14,14,0,113146.4,1266.571,89
"25748","85100","2014",23,19,4,183127,2897.261,85.95652
"25749","85101","2014",7,7,0,169000,1476.714,111.4286
"25750","85102","2014",8,8,0,112062.5,1289.25,90
"25751","85103","2014",12,12,0,123916.7,1285.917,100.1667
"25752","85104","2014",16,16,0,101656.2,1268.875,81.25
"25753","85105","2014",3,3,0,173633.3,1478.667,117.3333
"25754","85106","2014",36,35,1,215842.5,2827.306,76.47222
"25755","85108","2014",18,18,0,165601.8,1847.167,105.2222
"25756","85109","2014",111,102,9,158550.5,1673.991,96.21622
"25757","85110","2014",13,13,0,96176.92,837.8462,114.7692
"25758","85111","2014",22,22,0,89336.36,1132,84.04545
"25759","85112","2014",41,41,0,183639,1987.122,93.41463
"25760","85113","2014",94,91,3,321542.6,3780.362,86.64894
"25761","85114","2014",76,68,8,169718.8,2473.618,75.67105
"25762","85115","2014",10,10,0,88450,1053.4,87.5
"25763","85116","2014",2,2,0,122500,1585,84.5
"25764","85117","2014",6,6,0,115833.3,1099.833,104.8333
"25765","85118","2014",16,16,0,162593.8,1529.938,109.8125
"25766","85119","2014",16,16,0,119087.5,1239.125,97.1875
"25767","85120","2014",18,18,0,179163.6,1869.611,103.7778
"25768","85121","2014",6,6,0,87466.67,1077.333,95.5
"25769","85123","2014",2,2,0,147850,1195,116
"25770","85125","2014",3,3,0,87333.33,842.3333,105.3333
"25771","85126","2014",6,6,0,123666.7,1293,94.66667
"25772","85127","2014",73,66,7,140904.8,2098.521,72.84932
"25773","85128","2014",88,75,13,119803.9,1363.841,90.82955
"25774","85129","2014",23,23,0,146008.7,1435.13,108.2609
"25775","85130","2014",16,14,2,132781.2,1412.875,95.4375
"25776","85131","2014",18,18,0,114677.8,1257.722,91.66667
"25777","85132","2014",8,8,0,77125,818.375,95
"25778","85133","2014",6,6,0,80000,958.1667,88.33333
"25779","85134","2014",4,4,0,62560,751,76.5
"25780","85135","2014",29,29,0,115279.3,1234.034,98
"25781","85136","2014",2,2,0,69950,618.5,96
"25782","85137","2014",7,7,0,119314.3,1105.286,110.4286
"25783","85138","2014",6,6,0,129416.7,1644.333,77.33333
"25784","85139","2014",8,8,0,132625,1269.125,112.25
"25785","85140","2014",11,11,0,113763.6,1268.727,89.63636
"25786","85141","2014",8,8,0,89862.5,846.125,109.75
"25787","85142","2014",12,12,0,138250,1416.667,95.58333
"25788","85143","2014",14,14,0,110142.9,1093.643,99.57143
"25789","85144","2014",8,8,0,126750,1348.5,95.5
"25790","85145","2014",6,6,0,98083.33,969,106.6667
"25791","85146","2014",57,45,12,146982.5,1790.579,81.35088
"25792","85147","2014",13,13,0,64180.77,898.5385,79.84615
"25793","85148","2014",8,8,0,138375,1144.25,128.25
"25794","85149","2014",8,8,0,113500,1081,102.625
"25795","85151","2014",34,34,0,127052.9,1470.618,87
"25796","85152","2014",50,48,2,153479,1617.48,98.4
"25797","85153","2014",16,16,0,97211.25,1043.875,91.75
"25798","85154","2014",19,19,0,123894.7,1166.316,113.0526
"25799","85155","2014",41,41,0,185625.4,1791.22,104.5122
"25800","85156","2014",23,22,1,138957.1,1548.261,94.17391
"25801","85157","2014",5,5,0,131000,1232.6,108.2
"25802","85158","2014",7,7,0,70157.14,812.5714,93.28571
"25803","85159","2014",17,17,0,129294.1,1088.059,125.0588
"25804","85160","2014",10,10,0,132200.1,1378.6,95.9
"25805","85161","2014",20,19,1,126611.5,1463,91.5
"25806","85162","2014",14,14,0,135071.4,1169.857,118.6429
"25807","85163","2014",113,95,18,289823.2,3540.761,85.38053
"25808","85164","2014",61,38,23,139863.8,2481.967,61.11475
"25809","85167","2014",6,6,0,105966.7,1166,87
"25810","85169","2014",17,17,0,131000,1414.294,98.70588
"25811","85171","2014",4,4,0,109862.5,1260.75,103
"25812","85172","2014",28,28,0,128175,1593,83.03571
"25813","85174","2014",3,3,0,93666.67,1134.667,80
"25814","85175","2014",5,5,0,121387.2,1072.2,110.6
"25815","85176","2014",9,9,0,113833.3,1040.889,108.3333
"25816","85177","2014",7,7,0,92328.57,915.2857,102
"25817","85178","2014",59,59,0,165627.7,1693.322,98.64407
"25818","85179","2014",10,10,0,120855,1298.9,88.5
"25819","85181","2014",5,5,0,145552,1167.6,139.2
"25820","85182","2014",39,37,2,95110.77,1115.564,89.71795
"25821","85184","2014",5,5,0,124000,920.6,136.6
"25822","85185","2014",11,11,0,137498,1456.182,100.5455
"25823","85186","2014",7,7,0,114500,1240.714,93.14286
"25824","85187","2014",6,6,0,76666.67,778.8333,106.3333
"25825","85188","2014",10,10,0,104815,1211.7,87.1
"25826","85189","2014",22,22,0,154181.8,1908.818,83.5
"25827","85190","2014",19,19,0,124394.8,1580.947,88
"25828","85191","2014",583,363,220,133238.1,1600.852,84.01201
"25829","85192","2014",4,4,0,93675,1133,78.5
"25830","85193","2014",3,3,0,104333.3,976,112
"25831","85194","2014",523,259,264,197353.9,3299.849,63.89866
"25832","85196","2014",18,18,0,121702.3,1201,101.3889
"25833","85197","2014",34,34,0,125505.9,1261.853,100.8235
"25834","85198","2014",12,12,0,132191.7,1423.417,94.25
"25835","85199","2014",5,5,0,87104,1080.2,84.2
"25836","85200","2014",14,14,0,132950,1408.071,94.85714
"25837","85201","2014",8,8,0,134487.5,1635.25,84.5
"25838","85202","2014",16,16,0,143088.8,1310.25,111.3125
"25839","85204","2014",14,14,0,151500,1504.143,108.2143
"25840","85205","2014",3,3,0,64666.67,811.3333,75.33333
"25841","85206","2014",9,9,0,99301.67,944.5556,95.55556
"25842","85207","2014",12,12,0,99750,1397.25,81.5
"25843","85208","2014",13,13,0,141154.2,1149.846,121.4615
"25844","85209","2014",4,4,0,109625,713,151.25
"25845","85210","2014",14,14,0,104482.1,1283.643,82.35714
"25846","85211","2014",16,16,0,166381.4,1616.125,107.25
"25847","85213","2014",36,35,1,147853.3,1410.111,109.9444
"25848","85214","2014",17,17,0,151911.8,1666.941,94.11765
"25849","85215","2014",31,31,0,107412.9,1337.516,85.58065
"25850","85216","2014",13,13,0,149276.9,1709.462,97.07692
"25851","85218","2014",19,19,0,118368.4,1258.158,99.10526
"25852","85220","2014",8,8,0,132625,1447.625,95.625
"25853","85221","2014",26,26,0,147229.7,1573.538,98.23077
"25854","85222","2014",155,106,49,211987.4,3073.2,74.30323
"25855","85223","2014",16,14,2,123887.5,1186.125,106.5
"25856","85226","2014",376,206,170,139365.7,2423.019,58.36702
"25857","85227","2014",13,13,0,101366.2,987.4615,106.3846
"25858","85229","2014",4,4,0,80000,1073.25,74.75
"25859","85231","2014",1,1,0,150000,1875,80
"25860","85232","2014",10,10,0,117800,1351.7,87.7
"25861","85233","2014",6,6,0,130166.7,1298.5,107.8333
"25862","85234","2014",241,123,118,142333.2,2427.025,62.14523
"25863","85235","2014",6,6,0,55033.33,875.1667,67.66667
"25864","85236","2014",23,23,0,140496,1722.957,86.69565
"25865","85237","2014",2,2,0,95500,888,107
"25866","85238","2014",35,34,1,138947.1,1443.229,101.5143
"25867","85239","2014",8,8,0,160250,1421.5,120
"25868","85240","2014",9,9,0,115444.4,1079.333,107.6667
"25869","85242","2014",4,4,0,96812.5,1098,93.75
"25870","85243","2014",50,49,1,154566,2168.54,75.88
"25871","85244","2014",5,5,0,132200,1349,98.8
"25872","85245","2014",4,4,0,126250,1007,119.75
"25873","85246","2014",15,15,0,125636.7,1367.733,94.53333
"25874","85247","2014",7,7,0,131071.4,1216.857,99.71429
"25875","85248","2014",4,4,0,92000,1159.75,75.5
"25876","85250","2014",18,18,0,192038.9,1863.833,102.4444
"25877","85251","2014",8,8,0,88312.5,808.625,110.5
"25878","85252","2014",4,4,0,95000,1014.5,105
"25879","85254","2014",13,13,0,125330.8,1386.077,101.3077
"25880","85255","2014",23,23,0,119558.3,1508.174,84.56522
"25881","85256","2014",12,12,0,126166.7,1042,119.25
"25882","85259","2014",10,10,0,149400,1348.5,110
"25883","85260","2014",9,9,0,102488.9,1233.444,83.22222
"25884","85261","2014",2,2,0,199150,1942.5,102.5
"25885","85262","2014",21,20,1,144469,1632.905,95.33333
"25886","85264","2014",7,7,0,99285.71,1057.286,96.57143
"25887","85265","2014",6,6,0,108066.7,917.8333,113.5
"25888","85266","2014",7,7,0,64357.14,885.8571,68.42857
"25889","85267","2014",11,11,0,145851.8,1561.818,93.90909
"25890","85268","2014",18,18,0,135138.9,1506.778,92.72222
"25891","85269","2014",6,6,0,161126.7,1457.5,139.1667
"25892","85271","2014",5,5,0,83400,882.2,95
"25893","85273","2014",19,19,0,168048.4,1580.105,108.2632
"25894","85274","2014",3,3,0,136116.7,1054,125
"25895","85276","2014",8,8,0,84187.5,877.375,97
"25896","85277","2014",13,13,0,139896.5,1421.308,96.61538
"25897","85278","2014",45,39,6,177512.8,2724.933,69.11111
"25898","85280","2014",23,23,0,169332.6,1708.652,99.26087
"25899","85281","2014",9,9,0,128306.6,1153.444,115
"25900","85282","2014",7,7,0,104857.1,1076.143,101.5714
"25901","85284","2014",37,37,0,182181.1,1878.703,97.75676
"25902","85285","2014",3,3,0,115000,1006,114
"25903","85286","2014",4,4,0,87000,1002.75,103.25
"25904","85287","2014",6,6,0,103083.3,921.3333,110.1667
"25905","85288","2014",153,124,29,170880.3,2267.418,79.37255
"25906","85289","2014",5,5,0,136700,1538.6,87.2
"25907","85290","2014",7,7,0,128528.6,1247.857,102.5714
"25908","85291","2014",7,6,1,151500,1291,104
"25909","85292","2014",5,5,0,75820,896,105.4
"25910","85293","2014",9,9,0,136311.1,1441.444,94
"25911","85294","2014",119,110,9,162678.1,2758.588,62.73109
"25912","85295","2014",22,22,0,134990.9,1508.545,90.77273
"25913","85296","2014",7,7,0,134357.1,923.8571,140.4286
"25914","85297","2014",14,14,0,124937,1349.071,94.85714
"25915","85298","2014",12,12,0,163083.3,1500.417,104.5833
"25916","85300","2014",33,33,0,161699.2,1639.939,102.0909
"25917","85301","2014",6,6,0,112594.5,1140.5,103.5
"25918","85302","2014",43,43,0,124328.2,1293.884,103.6512
"25919","85303","2014",15,15,0,99220,1034,101.2667
"25920","85304","2014",11,11,0,133400,1321.182,103.5455
"25921","85305","2014",11,11,0,99272.73,1038.091,95
"25922","85306","2014",6,6,0,93416.67,1090.167,81.66667
"25923","86001","2014",5,5,0,94400,969.6,93
"25924","86002","2014",8,8,0,84112.5,1067.375,77.625
"25925","86003","2014",3,3,0,52500,524.3333,94.33333
"25926","86004","2014",3,3,0,77666.67,1067,81.66667
"25927","86005","2014",7,6,1,82480.86,975.8571,99.57143
"25928","86006","2014",7,7,0,82285.71,994.7143,94.28571
"25929","86007","2014",10,10,0,132640,1385.7,97.4
"25930","86008","2014",4,4,0,97500,730.5,124.5
"25931","86009","2014",10,10,0,73820,928.1,71.8
"25932","86010","2014",8,8,0,110312.5,1219.875,89.25
"25933","86011","2014",3,3,0,59666.67,778.3333,80
"25934","86013","2014",1,1,0,55000,786,70
"25935","86014","2014",11,11,0,127863.6,1344.909,95.72727
"25936","86015","2014",22,21,1,84991.41,946.9091,87.45455
"25937","86016","2014",16,16,0,156727,1661.188,99.3125
"25938","86017","2014",1,1,0,163742,1170,140
"25939","86019","2014",26,26,0,131394.6,1342,98.61538
"25940","86020","2014",1,1,0,202500,1702,119
"25941","86022","2014",1,1,0,127200,1767,72
"25942","86023","2014",2,2,0,155000,1123,146
"25943","86024","2014",11,11,0,171645.5,1501.455,114.3636
"25944","86025","2014",5,5,0,55200,1257.8,45.2
"25945","86026","2014",2,2,0,142100,1182,125.5
"25946","86027","2014",14,14,0,186847.9,1892.929,98.5
"25947","86028","2014",13,13,0,164640.4,1710.769,97.53846
"25948","86029","2014",10,10,0,103350,993,108.8
"25949","86031","2014",8,8,0,112750,1247.5,85.375
"25950","86032","2014",16,16,0,133812.5,1378.25,101.4375
"25951","86034","2014",6,6,0,99166.67,954.5,103.6667
"25952","86036","2014",7,7,0,106285.7,872.8571,128
"25953","86037","2014",9,9,0,68611.11,872.5556,83.22222
"25954","86038","2014",2,2,0,68250,583.5,120
"25955","86039","2014",11,11,0,110128.2,905.7273,122.6364
"25956","86040","2014",7,7,0,62957.14,960.8571,74.57143
"25957","86041","2014",94,68,26,138663.9,1693.138,82.20213
"25958","86042","2014",9,9,0,77783.33,993.8889,78.55556
"25959","86044","2014",4,4,0,88825,966.25,90.5
"25960","86045","2014",16,15,1,121531.2,1307.812,93.9375
"25961","86046","2014",15,15,0,124458,1336.667,93.4
"25962","86047","2014",6,6,0,109050,1284.833,88.5
"25963","86048","2014",10,10,0,155103,1534.1,111.9
"25964","86049","2014",3,3,0,76000,933.3333,87.66667
"25965","86050","2014",5,5,0,65800,991,67
"25966","86051","2014",2,2,0,105250,1723.5,72.5
"25967","86052","2014",10,10,0,99450,1052,90.5
"25968","86053","2014",3,3,0,93333.33,1234.333,73.66667
"25969","86054","2014",6,6,0,94333.33,887.1667,107.6667
"25970","86055","2014",3,3,0,50000,667,78.66667
"25971","86058","2014",9,9,0,132267.2,1396.778,106.1111
"25972","86059","2014",7,7,0,91742.86,951.8571,94.28571
"25973","86061","2014",11,11,0,99045.45,1040,87.27273
"25974","86062","2014",39,30,9,126811.8,1807.41,74.51282
"25975","86063","2014",7,7,0,108942.9,963.7143,106.2857
"25976","86064","2014",7,7,0,98571.43,1119.429,84.42857
"25977","86065","2014",7,7,0,162571.4,1932.714,115.8571
"25978","86066","2014",284,247,37,101889,1220.715,84.04577
"25979","86068","2014",10,10,0,84590.6,781,113.9
"25980","86069","2014",2,2,0,42000,722.5,56.5
"25981","86070","2014",77,74,3,121755.8,1402.844,87.75325
"25982","86072","2014",3,3,0,130000,1165.667,110.6667
"25983","86073","2014",3,3,0,93333.33,1324.667,71.33333
"25984","86074","2014",2,2,0,140975,1444.5,97.5
"25985","86075","2014",7,7,0,115928.6,1054.286,109.1429
"25986","86076","2014",22,22,0,174222,1618.955,110.0909
"25987","86077","2014",7,7,0,82142.86,1043.143,79.28571
"25988","86078","2014",28,28,0,75503.04,926.2143,89.60714
"25989","86079","2014",8,8,0,92656.25,915.875,86.875
"25990","86080","2014",9,9,0,115555.6,1308.333,93.44444
"25991","86081","2014",5,5,0,108400,953,110.6
"25992","86082","2014",41,41,0,95926.83,1019.024,97.36585
"25993","86083","2014",12,12,0,106371.8,1059.583,107.0833
"25994","86084","2014",4,4,0,124250,775.75,147.25
"25995","86085","2014",4,4,0,83962.5,945.75,92.5
"25996","86086","2014",5,5,0,180600,1345,135.6
"25997","86087","2014",1,1,0,85000,1062,80
"25998","86088","2014",5,5,0,204698,2063.2,100.8
"25999","86089","2014",6,6,0,117088.8,957.6667,134.8333
"26000","86090","2014",2,2,0,52000,598.5,85
"26001","86091","2014",1,1,0,127500,1054,121
"26002","86092","2014",25,25,0,99892,1118.76,88.32
"26003","86093","2014",2,2,0,90500,801.5,126
"26004","86095","2014",29,29,0,137331.5,1611.931,87.10345
"26005","86096","2014",5,5,0,70000,732.4,85.4
"26006","86097","2014",1,1,0,92000,697,132
"26007","86098","2014",1,1,0,75000,1500,50
"26008","86099","2014",4,4,0,148750,1177.5,132
"26009","86100","2014",32,30,2,171954.1,1721.688,96.875
"26010","86102","2014",1,1,0,171000,2111,81
"26011","86103","2014",14,13,1,114035.7,1260.714,90.64286
"26012","86104","2014",8,8,0,117702.5,1245.75,103.75
"26013","86105","2014",3,3,0,148333.3,1079.333,133.3333
"26014","86106","2014",1,1,0,125000,1136,110
"26015","86107","2014",2,2,0,50500,625,85
"26016","86108","2014",3,3,0,82166.67,826.3333,116.6667
"26017","86109","2014",3,3,0,36666.67,498,72.33333
"26018","86110","2014",2,2,0,97500,742,120.5
"26019","86111","2014",5,5,0,105953.8,1194.6,84.4
"26020","86112","2014",8,8,0,85081.25,1037.75,92.625
"26021","86113","2014",20,20,0,150496.2,1495.5,104
"26022","86114","2014",6,6,0,147083.3,1530.167,95.83333
"26023","86115","2014",62,58,4,136320.7,1543.726,90.41935
"26024","86116","2014",12,12,0,116203.3,1098.5,103.6667
"26025","86117","2014",6,6,0,87833.33,826,108.5
"26026","86118","2014",3,3,0,117033.3,1591,70.66667
"26027","86119","2014",3,3,0,80266.67,991.6667,73.33333
"26028","86120","2014",12,12,0,79047.5,791.8333,95.58333
"26029","86121","2014",2,2,0,166850,1584.5,108.5
"26030","86122","2014",2,2,0,95900,1350,72.5
"26031","86123","2014",5,5,0,125880,1184.2,107.6
"26032","86124","2014",6,6,0,155833.3,1393.667,119.8333
"26033","86125","2014",3,3,0,109166.7,1318.667,84.66667
"26034","86126","2014",6,6,0,121483.7,1503.5,105.3333
"26035","86128","2014",27,27,0,92158.15,991.1111,95.22222
"26036","86129","2014",3,3,0,108333.3,964.6667,104.6667
"26037","86130","2014",3,3,0,76666.67,707.6667,103
"26038","86131","2014",5,5,0,114600,1115.4,102
"26039","86132","2014",3,3,0,84666.67,799.6667,105.3333
"26040","86133","2014",38,36,2,143898.8,1617.158,92.21053
"26041","86134","2014",5,5,0,64400,660.2,97
"26042","86135","2014",2,2,0,139000,1297.5,109.5
"26043","86136","2014",3,3,0,93533.33,888,111.6667
"26044","86137","2014",36,33,3,104377.2,1086.972,99.19444
"26045","86138","2014",2,2,0,75000,718.5,101
"26046","86139","2014",22,22,0,96911.64,1093.409,92.5
"26047","86140","2014",24,24,0,91412.83,1143.083,87.83333
"26048","86141","2014",4,4,0,89525,898.5,95.75
"26049","86143","2014",1,1,0,22000,367,60
"26050","86144","2014",4,4,0,115650,1101.25,111.5
"26051","86145","2014",12,12,0,119541.7,1329.5,93.75
"26052","86147","2014",3,3,0,119833.3,1257.333,90.66667
"26053","86148","2014",7,7,0,125442.9,1085.857,116.5714
"26054","86150","2014",6,6,0,97758,1390.5,79.83333
"26055","86151","2014",2,2,0,108750,1166.5,116
"26056","86152","2014",6,6,0,145781.8,1272.833,114.6667
"26057","86153","2014",10,10,0,83586,835.3,94
"26058","86154","2014",2,2,0,72500,1159.5,66
"26059","86156","2014",1,1,0,142000,1014,140
"26060","86157","2014",25,21,4,166334,1704.52,98.56
"26061","86158","2014",64,63,1,155938.8,1620.609,95.78125
"26062","86159","2014",4,4,0,59375,891.75,67
"26063","86160","2014",28,28,0,111514.3,996.2143,124.7143
"26064","86161","2014",7,7,0,124622.9,872.4286,135.5714
"26065","86162","2014",2,2,0,163500,1264.5,122.5
"26066","86163","2014",23,22,1,161434.8,1651.957,97.82609
"26067","86164","2014",2,2,0,151500,1387,106.5
"26068","86165","2014",65,60,5,101061.9,1039.415,99.63077
"26069","86167","2014",5,5,0,84559,870.8,116.4
"26070","86169","2014",3,3,0,133000,1219.333,121.3333
"26071","86170","2014",6,6,0,40416.67,582.1667,71.83333
"26072","86171","2014",6,6,0,93000,1225,101.3333
"26073","86172","2014",3,3,0,243333.3,2555.667,94
"26074","86173","2014",2,2,0,31000,710,49
"26075","86174","2014",47,46,1,126316.4,1317.723,95.78723
"26076","86175","2014",3,3,0,57666.67,566,99.33333
"26077","86176","2014",2,2,0,43250,434.5,99
"26078","86177","2014",48,44,4,153539.4,1577.271,101.2083
"26079","86178","2014",12,12,0,141045.8,1521.083,94
"26080","86180","2014",17,15,2,151977.8,1711.706,91.64706
"26081","86181","2014",4,4,0,93500,1183.5,84
"26082","86182","2014",3,3,0,85666.67,875.6667,102.6667
"26083","86183","2014",10,10,0,78750,1022.2,76.9
"26084","86184","2014",8,8,0,131437.5,1182.125,107.125
"26085","86186","2014",10,10,0,141302.5,1089.1,133.9
"26086","86187","2014",3,3,0,96666.67,810.3333,118
"26087","86189","2014",5,5,0,71882.6,675.8,112
"26088","86190","2014",12,12,0,117975.9,1091.25,104.6667
"26089","86191","2014",3,3,0,81666.67,963,108.3333
"26090","86192","2014",2,2,0,140000,1221.5,118.5
"26091","86193","2014",6,6,0,103133.3,1292.333,84.66667
"26092","86194","2014",1034,410,624,114669.4,1728.055,67.6499
"26093","86195","2014",8,8,0,58468.75,956.25,63.5
"26094","86196","2014",1,1,0,75000,424,177
"26095","86198","2014",5,5,0,168495,1290.6,128.6
"26096","86200","2014",11,11,0,94725.36,889.4545,98.72727
"26097","86201","2014",2,2,0,98000,1094,89.5
"26098","86202","2014",2,2,0,77000,1004.5,83.5
"26099","86203","2014",4,4,0,62752.5,753.25,79.25
"26100","86204","2014",14,14,0,149750,1576.929,104
"26101","86205","2014",1,1,0,99000,1112,89
"26102","86207","2014",30,18,12,79674.33,1196.533,69.63333
"26103","86209","2014",15,15,0,150220.4,1558.267,96.2
"26104","86210","2014",9,9,0,80555.56,985.2222,79.33333
"26105","86211","2014",13,13,0,99012.77,1040.308,105.5385
"26106","86213","2014",26,26,0,108785.2,1096.5,99.88462
"26107","86214","2014",68,44,24,149136.9,1788.029,84.27941
"26108","86217","2014",3,3,0,69333.33,824,84.33333
"26109","86218","2014",3,3,0,91666.67,1549.333,95.33333
"26110","86220","2014",2,2,0,104000,1122,94
"26111","86221","2014",6,6,0,97516.67,920,98.5
"26112","86222","2014",32,32,0,160089.1,1748.219,91.90625
"26113","86223","2014",13,13,0,74840,879.9231,85.84615
"26114","86224","2014",12,11,1,91184.58,948.3333,89.25
"26115","86225","2014",10,10,0,83379,1017.1,95.6
"26116","86226","2014",25,25,0,159509.4,1387.04,115.04
"26117","86229","2014",3,3,0,82333.33,978,88.66667
"26118","86230","2014",1,1,0,33400,630,53
"26119","86231","2014",11,11,0,116541.4,1187.091,113.3636
"26120","86233","2014",24,24,0,89333.33,1011.5,89.54167
"26121","86234","2014",5,5,0,75370,982,83.2
"26122","86235","2014",11,11,0,175020,1373.455,131.7273
"26123","86236","2014",8,8,0,98368.75,767.5,111.75
"26124","86237","2014",7,7,0,67638.43,783.8571,89.28571
"26125","86241","2014",4,4,0,110500,1376.25,80.25
"26126","86242","2014",7,7,0,83435.71,749.5714,113.5714
"26127","86244","2014",12,12,0,81708.33,845.3333,93.33333
"26128","86245","2014",10,10,0,134548.3,1558.8,88.9
"26129","86246","2014",12,12,0,102462.9,1024.25,110
"26130","86247","2014",3,3,0,97333.33,866.3333,106.3333
"26131","86248","2014",4,4,0,79000,978,78.75
"26132","86249","2014",2,2,0,54000,615,90
"26133","86250","2014",4,4,0,149500,1318,115.5
"26134","86252","2014",5,5,0,102380,1238.6,83.4
"26135","86253","2014",6,6,0,85860.83,1080.167,77.66667
"26136","86254","2014",8,8,0,82291.5,1024.75,76.125
"26137","86255","2014",13,13,0,95030.77,1755.462,93.23077
"26138","86256","2014",9,9,0,175159.7,1583.667,115.4444
"26139","86257","2014",5,5,0,75400,1041,84.2
"26140","86258","2014",11,11,0,128800,1332.273,102.9091
"26141","86260","2014",4,4,0,207500,1882.5,110
"26142","86261","2014",24,24,0,191109.5,1612.625,126.0417
"26143","86262","2014",6,6,0,98508.33,1041.5,93.16667
"26144","86263","2014",19,19,0,209952.6,1686.316,129
"26145","86264","2014",7,7,0,121950,902.2857,115.8571
"26146","86266","2014",2,2,0,113500,605.5,171
"26147","86268","2014",10,10,0,157150,1358.8,109.6
"26148","86269","2014",1,1,0,30000,484,62
"26149","86270","2014",2,2,0,60000,1012.5,65
"26150","86271","2014",7,7,0,137000,1246.857,117.1429
"26151","86272","2014",22,21,1,129723.9,1343.909,106.1364
"26152","86273","2014",11,11,0,87685.91,839.9091,105.0909
"26153","86274","2014",11,11,0,95606.82,1063,101.4545
"26154","86275","2014",4,4,0,84737.5,1065.5,76.25
"26155","86276","2014",7,7,0,54571.43,1003.857,57.71429
"26156","86279","2014",3,3,0,154933.3,1609,95.33333
"26157","86280","2014",3,3,0,61666.67,789.3333,76.66667
"26158","86281","2014",39,39,0,148047.9,1246.231,121
"26159","86284","2014",5,5,0,121900,1279,96.2
"26160","86285","2014",10,10,0,111970,1047.1,105.2
"26161","86286","2014",8,8,0,87706.25,925.25,86.75
"26162","86287","2014",4,4,0,110775,831.75,125.5
"26163","86288","2014",9,9,0,72181.11,1069,71.66667
"26164","86289","2014",5,5,0,91400,1019.8,95.2
"26165","86290","2014",11,11,0,126272.7,1374.364,89.81818
"26166","86291","2014",1,1,0,22500,703,32
"26167","86292","2014",4,4,0,120487.5,1133.75,108.25
"26168","86293","2014",27,27,0,112806.9,1321.259,86.77778
"26169","86294","2014",26,26,0,150640.5,1401.846,106.2308
"26170","86295","2014",8,8,0,104657.5,1092.875,93.75
"26171","86296","2014",8,8,0,116375,1242.375,89.625
"26172","86297","2014",44,40,4,176070.9,1724.523,105.5682
"26173","86298","2014",13,13,0,132830.8,1160.615,115.2308
"26174","86299","2014",3,3,0,159000,1131.667,147.3333
"26175","86300","2014",2,2,0,177700,1592.5,106
"26176","87001","2014",49,45,4,113904.1,1342.429,85.26531
"26177","87002","2014",43,43,0,110722.3,1289.116,87.86047
"26178","87003","2014",5,5,0,75480,754.6,111.2
"26179","87005","2014",7,7,0,143622.9,1130.571,131.1429
"26180","87006","2014",1,1,0,44000,364,121
"26181","87007","2014",1,1,0,25000,463,54
"26182","87008","2014",1,1,0,21000,955,22
"26183","87009","2014",7,6,1,106483,1371.286,83
"26184","87011","2014",28,28,0,94248.64,1143.643,84.82143
"26185","87012","2014",2,2,0,172500,1753,95
"26186","87013","2014",6,6,0,105082.8,1209.667,98.16667
"26187","87014","2014",19,18,1,87594.74,1021.158,97.52632
"26188","87015","2014",6,6,0,135891.7,1396.5,91.5
"26189","87016","2014",5,5,0,88100,1188,83.8
"26190","87017","2014",2,2,0,59625,1022.5,69
"26191","87018","2014",6,6,0,80250,1146.167,71
"26192","87019","2014",20,20,0,173679,1725.1,101.65
"26193","87020","2014",12,12,0,136295.8,1417.75,97.91667
"26194","87021","2014",21,21,0,165067.1,1513.667,108.8571
"26195","87022","2014",1,1,0,150000,1579,95
"26196","87023","2014",1,1,0,20000,392,51
"26197","87024","2014",3,3,0,61000,1003.667,60.66667
"26198","87025","2014",3,3,0,154566.7,1425,107.3333
"26199","87027","2014",7,7,0,106492.9,1613,85.85714
"26200","87028","2014",13,13,0,89989.23,928,101.1538
"26201","87029","2014",6,6,0,118725,1149.5,105.3333
"26202","87030","2014",7,7,0,111200,1328.857,79.28571
"26203","87031","2014",3,3,0,60333.33,1545.333,51.33333
"26204","87032","2014",21,19,2,71051.19,875.6667,82.57143
"26205","87033","2014",5,5,0,58600,768.4,77.6
"26206","87034","2014",5,5,0,65300,868.6,85.4
"26207","87035","2014",7,7,0,174220.4,1322.857,136.5714
"26208","87036","2014",13,13,0,76246.15,1212,76.07692
"26209","87037","2014",2,2,0,99115,1159,84
"26210","87038","2014",12,12,0,175837.5,1656.083,108.3333
"26211","87039","2014",7,7,0,86087.14,1005.857,86.28571
"26212","87040","2014",7,7,0,88000,1188.143,76.85714
"26213","87041","2014",12,11,1,56650,700.75,77
"26214","87042","2014",2,2,0,276000,1207,194
"26215","87043","2014",3,3,0,64666.67,1024,66
"26216","87044","2014",6,6,0,54250,789.6667,67.33333
"26217","87045","2014",14,14,0,70721.43,918.6429,81.14286
"26218","87046","2014",11,11,0,100781.8,1114.818,89.18182
"26219","87047","2014",22,22,0,94327.27,1230.045,73.81818
"26220","87048","2014",40,38,2,158411.5,1567.15,103.95
"26221","87049","2014",22,21,1,98022.27,1025.273,94.77273
"26222","87050","2014",61,50,11,165891.3,1796.508,100.8197
"26223","87051","2014",7,7,0,123357.1,1452.286,113.4286
"26224","87052","2014",2,2,0,77200,989,76.5
"26225","87053","2014",7,7,0,82619.14,1070.143,85.57143
"26226","87054","2014",7,7,0,103211.4,1210,96.71429
"26227","87056","2014",7,7,0,128002.4,1261.143,103.8571
"26228","87057","2014",3,3,0,63666.67,624.3333,95.33333
"26229","87058","2014",2,2,0,82000,935.5,87.5
"26230","87059","2014",11,9,2,67954.55,898.0909,80.90909
"26231","87060","2014",12,12,0,74075,1000.167,77.91667
"26232","87061","2014",1,1,0,160000,1000,160
"26233","87062","2014",3,3,0,94166.67,1320,72.66667
"26234","87063","2014",6,6,0,178275,1474.167,123
"26235","87064","2014",25,24,1,89860,982.92,89.68
"26236","87065","2014",31,30,1,180456.4,1650.613,113.1613
"26237","87066","2014",12,12,0,108579.2,1089.667,95.41667
"26238","87067","2014",1,1,0,105000,583,180
"26239","87068","2014",6,6,0,66166.67,1101.833,65.5
"26240","87069","2014",1,1,0,244200,1299,188
"26241","87070","2014",12,12,0,115775,1177.833,107
"26242","87071","2014",6,6,0,124666.7,1166.833,100.5
"26243","87072","2014",3,3,0,83666.67,699.3333,124
"26244","87073","2014",7,7,0,118714.3,1087.714,116.2857
"26245","87074","2014",3,3,0,78366.67,1205.667,63
"26246","87075","2014",50,46,4,141814,1499.68,96.02
"26247","87076","2014",6,6,0,74383.33,963.6667,83.33333
"26248","87077","2014",3,3,0,94000,750.6667,124.3333
"26249","87078","2014",6,6,0,116383.3,1247.167,94.5
"26250","87079","2014",6,6,0,126500,1467.833,105.8333
"26251","87080","2014",5,5,0,72917.6,804.8,96.2
"26252","87081","2014",5,5,0,157860,1316.8,113.8
"26253","87082","2014",17,17,0,96331.18,1058.294,88.64706
"26254","87083","2014",1,1,0,115000,1513,76
"26255","87084","2014",1,1,0,60000,857,70
"26256","87085","2014",1269,447,822,103925.5,1419.892,72.99606
"26257","87086","2014",8,8,0,99187.5,1209.75,77.625
"26258","87087","2014",6,6,0,67447.17,931.6667,67.33333
"26259","87088","2014",7,7,0,105142.9,1146.714,97.42857
"26260","87089","2014",19,19,0,76548.42,900.5789,86.31579
"26261","87090","2014",5,5,0,94982.2,964.8,103.2
"26262","87091","2014",8,8,0,48125,681.75,75.25
"26263","87092","2014",10,10,0,97767.5,1330.5,74.7
"26264","87093","2014",6,6,0,92475,989.1667,100.5
"26265","87094","2014",1,1,0,85600,1502,57
"26266","87095","2014",6,6,0,73408.33,1072,78.5
"26267","87096","2014",4,4,0,124250,1410.25,109
"26268","87097","2014",8,8,0,63202.5,647.25,101.375
"26269","87099","2014",2,2,0,99000,1052.5,96
"26270","87100","2014",1,1,0,38000,475,80
"26271","87101","2014",1,1,0,89575,1828,49
"26272","87103","2014",16,15,1,99750,1072.625,96.5
"26273","87104","2014",7,7,0,88500,1160.857,73.42857
"26274","87105","2014",13,13,0,90461.54,1023.308,84.84615
"26275","87106","2014",12,11,1,97583.33,1161.583,85.91667
"26276","87107","2014",5,5,0,148290,1480,95.8
"26277","87108","2014",4,4,0,74750,797.25,92.5
"26278","87109","2014",7,7,0,129642.9,1077.571,114.7143
"26279","87110","2014",23,22,1,108017.4,1230.87,89.13043
"26280","87111","2014",22,22,0,88523.95,984.2727,92.54545
"26281","87112","2014",10,10,0,94600,994.8,84.6
"26282","87113","2014",46,46,0,130501.2,1450.435,89.95652
"26283","87114","2014",99,88,11,158411.4,1602.879,97.27273
"26284","87115","2014",2,2,0,185690,1623,115
"26285","87116","2014",6,6,0,76333.33,898.3333,83.83333
"26286","87117","2014",18,18,0,73193.44,1026.444,80.33333
"26287","87118","2014",14,14,0,89250,1148.5,88.57143
"26288","87119","2014",6,5,1,85500,992.6667,87.5
"26289","87120","2014",7,7,0,84328.57,1058.286,76.71429
"26290","87121","2014",7,7,0,52928.57,637.1429,85.42857
"26291","87122","2014",6,6,0,105180,1026.833,101.8333
"26292","87123","2014",1,1,0,33000,786,42
"26293","87124","2014",2,2,0,71005,902,91.5
"26294","87125","2014",34,34,0,159379.5,1528.118,105.2941
"26295","87126","2014",32,31,1,88655.31,1107.906,81.34375
"26296","87127","2014",11,11,0,98954.55,1132.818,92.27273
"26297","87128","2014",9,9,0,111789.2,1282.667,92
"26298","87129","2014",4,4,0,141400,1434.25,104
"26299","87130","2014",2,2,0,90000,1214,103.5
"26300","87131","2014",4,4,0,81090,948.75,84.25
"26301","87132","2014",2,2,0,34250,921,42.5
"26302","87133","2014",5,5,0,104200,923.4,112.6
"26303","87134","2014",2,2,0,132500,2474,48.5
"26304","87135","2014",11,11,0,105451,1030.727,103
"26305","87137","2014",1,1,0,127500,1203,106
"26306","87138","2014",1,1,0,114800,1435,80
"26307","87139","2014",6,6,0,103750,1041.5,81.66667
"26308","87140","2014",7,7,0,82670,1180.143,70
"26309","87141","2014",12,12,0,105781.1,1162.25,101.75
"26310","87142","2014",5,5,0,105938,1092.4,97.8
"26311","87143","2014",16,16,0,116572.6,1332.812,87.9375
"26312","87144","2014",3,3,0,160333.3,895.3333,186
"26313","87145","2014",4,4,0,150125,1682.75,81.5
"26314","87146","2014",9,9,0,109144.4,1033.444,111.1111
"26315","87148","2014",5,5,0,248714,2306,98.6
"26316","87149","2014",4,4,0,89525,967,92.75
"26317","87150","2014",4,4,0,99875,998.75,106
"26318","87151","2014",4,4,0,97700,998,107.75
"26319","87152","2014",11,11,0,115927.3,1402.455,82.18182
"26320","87153","2014",6,6,0,50623.33,773.3333,64.66667
"26321","87154","2014",81,74,7,124005.6,1382.42,95.08642
"26322","87156","2014",9,9,0,185006.1,1333.667,153.6667
"26323","87157","2014",6,6,0,122806.7,1326.833,86.16667
"26324","87158","2014",15,15,0,93564.73,1074.8,93.6
"26325","87159","2014",4,4,0,95950,1184,93.5
"26326","87160","2014",6,6,0,113316.7,1027.5,111.8333
"26327","87161","2014",30,24,6,110484.4,1190.667,96.2
"26328","87162","2014",3,3,0,96550,945,90
"26329","87163","2014",2,2,0,82990.5,809,106.5
"26330","87164","2014",9,9,0,111357.8,1290.222,84.55556
"26331","87165","2014",2,2,0,78250,1439,58.5
"26332","87166","2014",6,6,0,153983.3,1119.167,138.5
"26333","87167","2014",8,8,0,122875,1266.25,97.875
"26334","87168","2014",7,7,0,94450.71,951.4286,93.57143
"26335","87170","2014",2,2,0,69000,641,125
"26336","87172","2014",3,3,0,142615,1278,99.66667
"26337","87174","2014",10,10,0,119300,1097.5,105.4
"26338","87176","2014",6,6,0,118750,1101.667,104.6667
"26339","87177","2014",16,16,0,113286.6,1266.812,91.9375
"26340","87178","2014",21,21,0,116519,1443.524,91.66667
"26341","87179","2014",1,1,0,249407,2494,100
"26342","87180","2014",5,5,0,65068,868.2,75.6
"26343","87181","2014",5,5,0,75940,1107.4,80.8
"26344","87182","2014",12,12,0,93767.83,1125.583,76
"26345","87183","2014",13,13,0,104369.2,1296.462,85
"26346","87185","2014",16,16,0,96281.25,1129.562,83.1875
"26347","87186","2014",6,6,0,68000,980.6667,71
"26348","87187","2014",60,56,4,116900.5,1235.85,100.2667
"26349","87188","2014",3,3,0,99333.33,1450.333,64
"26350","87189","2014",3,3,0,114833.3,1124,103.3333
"26351","87190","2014",9,9,0,90888.89,910.6667,107.4444
"26352","87191","2014",20,20,0,116675.4,1181.45,98.35
"26353","87192","2014",7,7,0,118532.9,1064,122.7143
"26354","87193","2014",2,2,0,128525,1230,122
"26355","87194","2014",5,5,0,117400,827.8,144.8
"26356","87195","2014",1,1,0,75000,789,95
"26357","87197","2014",8,8,0,78687.5,1356.125,63
"26358","87198","2014",6,6,0,55166.67,624.1667,93
"26359","87199","2014",12,12,0,94562.5,1161.917,92
"26360","87200","2014",3,3,0,169239.3,1779.333,87
"26361","87201","2014",39,39,0,163600.2,1582.641,107.8718
"26362","87202","2014",13,13,0,121246.2,1164.462,104.0769
"26363","87203","2014",12,12,0,85304.58,1041,80.16667
"26364","87204","2014",2,2,0,38743,541,68.5
"26365","87205","2014",23,23,0,154517.4,1408.261,115.3043
"26366","87206","2014",3,3,0,70500,811.3333,101.3333
"26367","88005","2014",7,7,0,89857.14,983.7143,90.71429
"26368","88006","2014",2,2,0,118250,1205,134
"26369","88009","2014",36,31,5,100950,1192.389,87.61111
"26370","88010","2014",2,2,0,38000,743,58
"26371","88011","2014",4,4,0,121925,1251,104.5
"26372","88012","2014",10,8,2,106753,1307.3,78.6
"26373","88013","2014",1,1,0,80000,476,168
"26374","88014","2014",2,2,0,78500,1997,73.5
"26375","88015","2014",3,3,0,91333.33,926.3333,115.3333
"26376","88016","2014",1,1,0,120000,1121,107
"26377","88017","2014",2,2,0,75000,1187.5,70
"26378","88019","2014",2,2,0,95700,1782,70
"26379","88020","2014",3,3,0,113724.7,1073,98.33333
"26380","88022","2014",1,1,0,184250,1212,152
"26381","88023","2014",2,2,0,124250,1129.5,110
"26382","88024","2014",1,1,0,123000,1079,114
"26383","88025","2014",1,1,0,105000,875,120
"26384","88026","2014",7,7,0,129428.6,1057.714,127
"26385","88028","2014",1,1,0,189050,1616,117
"26386","88029","2014",17,14,3,63652.94,804.8235,84.47059
"26387","88032","2014",13,13,0,134630.8,1387.308,113.3846
"26388","88033","2014",3,3,0,110166.7,926,112.6667
"26389","88035","2014",1,1,0,165000,2463,67
"26390","88037","2014",12,10,2,115778.3,1671.667,76.91667
"26391","88039","2014",5,5,0,92610,763,118.2
"26392","88041","2014",2,2,0,108200,846.5,124.5
"26393","88042","2014",1,1,0,160000,1720,93
"26394","88045","2014",1,1,0,37000,925,40
"26395","88046","2014",2,2,0,124500,853.5,145
"26396","88048","2014",6,6,0,121311.3,1429,98.5
"26397","88050","2014",1,1,0,118900,1585,75
"26398","88053","2014",2,2,0,97550,970,139.5
"26399","88054","2014",1,1,0,215000,1547,139
"26400","88055","2014",1,1,0,185000,1095,169
"26401","88056","2014",1,1,0,98500,921,107
"26402","88058","2014",1,1,0,66961,683,98
"26403","88059","2014",3,3,0,83333.33,955.6667,94
"26404","88061","2014",1,1,0,60361,755,80
"26405","88065","2014",2,2,0,108750,710,163
"26406","88066","2014",1,1,0,50000,500,100
"26407","88068","2014",9,9,0,118642.9,1080.111,103.4444
"26408","88069","2014",1,1,0,195000,1639,119
"26409","88070","2014",3,3,0,89333.33,1483.333,125
"26410","88073","2014",4,4,0,123562.5,1036,127.25
"26411","88075","2014",78,32,46,107276.4,1637.423,69.16667
"26412","88076","2014",3,3,0,88100,1056.333,82.33333
"26413","88077","2014",2,2,0,132200,787.5,176.5
"26414","88078","2014",15,13,2,86438,821.4667,114.8667
"26415","88079","2014",15,12,3,121749.7,1181.4,101.1333
"26416","88081","2014",22,19,3,108804.5,1276.955,96.13636
"26417","88082","2014",9,9,0,109688.9,1149.111,95.55556
"26418","88083","2014",1,1,0,1e+05,1667,60
"26419","88084","2014",3,3,0,127333.3,1327.333,95.33333
"26420","88085","2014",3,3,0,138000,1146.667,138.3333
"26421","88086","2014",2,2,0,114750,1454.5,80.5
"26422","88087","2014",24,9,15,92994.58,1292.917,71.91667
"26423","88088","2014",1,1,0,50000,439,114
"26424","88089","2014",5,5,0,72558,798.2,87.2
"26425","88090","2014",37,27,10,94291.24,1160,87.45946
"26426","88091","2014",1,1,0,292000,2561,114
"26427","88092","2014",3,3,0,159333.3,1000.667,136.3333
"26428","88093","2014",1,1,0,362000,1508,240
"26429","88094","2014",12,9,3,116363.3,1238.25,93.91667
"26430","88095","2014",9,9,0,114911.1,991.8889,113.6667
"26431","88096","2014",1,1,0,30000,375,80
"26432","88098","2014",9,6,3,91200,1034.889,83
"26433","88099","2014",18,15,3,121365.9,1261.833,96
"26434","88101","2014",6,5,1,95337.5,949.8333,102.8333
"26435","88105","2014",1,1,0,71000,522,136
"26436","88106","2014",15,14,1,158673.3,1596.267,97.06667
"26437","88108","2014",3,3,0,66333.33,822,99
"26438","88109","2014",1,1,0,155000,1348,115
"26439","88111","2014",2,2,0,125000,1009.5,120
"26440","88114","2014",13,10,3,106100,1232.077,85.69231
"26441","88115","2014",13,11,2,117666.9,1053.077,110.3077
"26442","88116","2014",23,21,2,118697.8,1355.261,96.73913
"26443","88117","2014",1,1,0,140000,933,150
"26444","88118","2014",2,2,0,190000,1308,155
"26445","88120","2014",8,6,2,81287.38,938.25,91.625
"26446","88121","2014",2,2,0,60000,504,123.5
"26447","88122","2014",3,3,0,114000,1344,83
"26448","88123","2014",1,1,0,73400,429,171
"26449","88124","2014",2,2,0,62000,833,74.5
"26450","88125","2014",1,1,0,80000,762,105
"26451","88126","2014",10,8,2,128834.7,1250.2,102.6
"26452","88127","2014",1,1,0,58000,935,62
"26453","88129","2014",1,1,0,20000,333,60
"26454","88130","2014",2,2,0,140000,1180.5,118.5
"26455","88131","2014",1,1,0,112000,1018,110
"26456","88132","2014",11,11,0,151227.3,1544.091,98.18182
"26457","88133","2014",2,2,0,126250,1203.5,104.5
"26458","88134","2014",4,4,0,87875,1192.5,75.5
"26459","88135","2014",10,7,3,107050,1056.9,99.1
"26460","88138","2014",1,1,0,104000,1284,81
"26461","88140","2014",2,2,0,67500,627.5,125.5
"26462","88143","2014",1,1,0,152000,1448,105
"26463","88145","2014",2,2,0,97450,848,115
"26464","88147","2014",2,2,0,147250,1038,147
"26465","88148","2014",19,14,5,160084.7,1510.211,111.3158
"26466","88150","2014",1,1,0,204800,1288,159
"26467","88151","2014",5,4,1,114351,1219,96.2
"26468","88152","2014",1,1,0,142000,893,159
"26469","88153","2014",2,2,0,99775,816,110
"26470","88154","2014",1,1,0,25000,556,45
"26471","88156","2014",1,1,0,52000,495,105
"26472","88157","2014",8,8,0,147212.5,1528.875,95.75
"26473","88158","2014",15,8,7,122918.7,1195.533,99.2
"26474","88159","2014",2,2,0,96800,1164.5,85
"26475","88160","2014",309,122,187,110167.1,1252.382,86.39482
"26476","88161","2014",1,1,0,25000,625,40
"26477","88163","2014",2,2,0,119150,1049.5,96.5
"26478","88165","2014",18,16,2,88288.89,1043,86.05556
"26479","88166","2014",3,3,0,81566.67,914.6667,87.33333
"26480","88167","2014",1,1,0,119000,1526,78
"26481","88169","2014",4,4,0,144147.5,1213.25,119.75
"26482","88170","2014",6,6,0,100250.8,1013.667,99
"26483","88172","2014",2,2,0,73250,781,93.5
"26484","88173","2014",1,1,0,60000,600,100
"26485","88174","2014",1,1,0,82500,550,150
"26486","88175","2014",1,1,0,110000,733,150
"26487","88176","2014",8,8,0,68181.25,623.5,111.375
"26488","88177","2014",3,3,0,212603.3,1933.333,112.3333
"26489","88178","2014",14,14,0,159266.4,1478.929,108.2857
"26490","88181","2014",20,11,9,77895,958.35,78.2
"26491","88183","2014",1,1,0,160000,1379,116
"26492","88184","2014",1,1,0,45000,682,66
"26493","88188","2014",12,12,0,111574.2,1217.917,99.33333
"26494","88192","2014",1,1,0,196000,1420,138
"26495","88193","2014",2,2,0,63500,985,57.5
"26496","88195","2014",1,1,0,48000,686,70
"26497","88196","2014",115,38,77,135641.6,2155.887,66.15652
"26498","88197","2014",5,5,0,135800,1408.2,94.4
"26499","88198","2014",10,10,0,92815,1721.4,60
"26500","88201","2014",4,4,0,122250,1074.75,112.5
"26501","88205","2014",2,2,0,103580,1640.5,68
"26502","88206","2014",6,6,0,132030.8,987.5,135
"26503","88208","2014",1,1,0,40000,571,70
"26504","88209","2014",67,43,24,132913.9,1344.716,96.65672
"26505","88210","2014",2,2,0,73000,1025.5,71
"26506","88212","2014",2,2,0,84500,743,123
"26507","88213","2014",4,4,0,104875,810.25,147.75
"26508","88214","2014",1,1,0,15000,341,44
"26509","88216","2014",9,9,0,101022.2,979,105
"26510","88218","2014",21,20,1,100707.1,1020.048,102.2857
"26511","88221","2014",1,1,0,26000,371,70
"26512","88224","2014",6,6,0,119166.7,1194.667,100.1667
"26513","88225","2014",15,15,0,136926.7,1230.933,109.9333
"26514","88228","2014",1,1,0,68000,544,125
"26515","88229","2014",1,1,0,220000,891,247
"26516","88230","2014",1,1,0,55000,423,130
"26517","88231","2014",4,4,0,143975,1363,104.25
"26518","88232","2014",1,1,0,65000,542,120
"26519","88233","2014",3,3,0,77666.67,934.3333,77.33333
"26520","88236","2014",2,2,0,70000,1178.5,57.5
"26521","88237","2014",3,3,0,212100,1329.333,160.3333
"26522","88240","2014",2,2,0,87500,857.5,90
"26523","88241","2014",2,2,0,52500,544.5,96
"26524","88242","2014",1,1,0,80000,552,145
"26525","88243","2014",2,2,0,62800,481.5,123.5
"26526","88244","2014",6,6,0,94633.33,862,118.3333
"26527","88245","2014",1,1,0,170000,1018,167
"26528","88246","2014",1,0,1,58000,892,65
"26529","88247","2014",7,7,0,136628.6,1147,121
"26530","88248","2014",1,1,0,75000,652,115
"26531","88250","2014",3,3,0,89833.33,725,124
"26532","88251","2014",7,7,0,133516.1,1206.429,113.8571
"26533","88252","2014",2,2,0,77250,841.5,82
"26534","88253","2014",5,3,2,230900,1447.2,174.6
"26535","88257","2014",2,2,0,93950,628,147
"26536","88258","2014",6,6,0,69500,628.3333,109.5
"26537","88259","2014",1,1,0,18000,514,35
"26538","88260","2014",1,1,0,106000,1140,93
"26539","88261","2014",5,5,0,101100,1068,105.6
"26540","88263","2014",2,2,0,131250,1408.5,94.5
"26541","88266","2014",2,1,1,99350,949,101.5
"26542","88267","2014",2,2,0,125500,820.5,154
"26543","88268","2014",1,1,0,175000,1250,140
"26544","88269","2014",7,6,1,157690,1581.429,101.1429
"26545","88270","2014",9,9,0,89444.44,878.4444,109.7778
"26546","88271","2014",2,2,0,96412,924,114.5
"26547","88273","2014",1,1,0,301000,1917,157
"26548","88275","2014",1,1,0,98000,784,125
"26549","88276","2014",4,4,0,83000,804.5,107.5
"26550","88277","2014",3,3,0,75166.67,901.6667,94.66667
"26551","88279","2014",1,1,0,73750,600,123
"26552","88280","2014",2,2,0,179000,1435.5,130.5
"26553","88281","2014",1,1,0,87400,865,101
"26554","88284","2014",6,5,1,109354.2,868.1667,120
"26555","88285","2014",5,5,0,131067.4,1157,115.2
"26556","88286","2014",2,2,0,107307,659,163
"26557","88289","2014",3,3,0,71966.67,594.6667,109.6667
"26558","88291","2014",1,1,0,21000,420,50
"26559","88292","2014",4,4,0,91324.5,1135,82.25
"26560","88293","2014",4,4,0,29375,414.25,75.25
"26561","88295","2014",1,1,0,34000,680,50
"26562","88297","2014",2,2,0,132500,1392.5,95
"26563","88300","2014",4,4,0,86250,741.25,115.25
"26564","88301","2014",2,2,0,94250,1062.5,99
"26565","88302","2014",19,18,1,135849.4,1547.316,90.21053
"26566","88303","2014",1,1,0,85000,1771,48
"26567","88304","2014",24,13,11,78726.08,958.125,84.125
"26568","88306","2014",1,1,0,120000,1091,110
"26569","88309","2014",2,2,0,115000,602,200
"26570","88310","2014",7,7,0,78022.86,883,90
"26571","88311","2014",1,1,0,43000,782,55
"26572","88312","2014",3,3,0,123000,982.3333,118.3333
"26573","88313","2014",1,1,0,50000,685,73
"26574","88314","2014",1,1,0,33000,412,80
"26575","88315","2014",2,2,0,124500,1613.5,77.5
"26576","88317","2014",5,5,0,62000,670,92
"26577","88318","2014",1,1,0,60991,459,133
"26578","88319","2014",15,14,1,94099.33,914.5333,107.8667
"26579","88320","2014",6,6,0,153025,1544.333,97.16667
"26580","88321","2014",38,31,7,86494.74,970.5,87.31579
"26581","88322","2014",3,3,0,161033.3,1583,105.6667
"26582","88324","2014",3,3,0,61666.67,721.3333,84.66667
"26583","88326","2014",4,4,0,113375,1165.75,95.25
"26584","88327","2014",15,14,1,92313.33,1053.2,91.8
"26585","88328","2014",4,4,0,110396.8,1083.25,98.75
"26586","88332","2014",1,1,0,144340,1458,99
"26587","88333","2014",1,1,0,163000,867,188
"26588","88334","2014",1,1,0,61000,555,110
"26589","88336","2014",1,1,0,23000,365,63
"26590","88338","2014",2,2,0,101500,1037,98.5
"26591","88340","2014",2,2,0,146000,1499.5,94
"26592","88341","2014",1,1,0,120000,1263,95
"26593","88343","2014",2,2,0,101975,950.5,108
"26594","88345","2014",3,3,0,131666.7,1945,79
"26595","88346","2014",6,5,1,104883.3,1039.833,100
"26596","88347","2014",2,2,0,103600,841,111
"26597","88349","2014",18,10,8,79081.94,1101.778,78.44444
"26598","88350","2014",2,2,0,65350,710.5,87
"26599","88351","2014",12,9,3,95125,1117.083,99.41667
"26600","88354","2014",1,1,0,68500,548,125
"26601","88355","2014",7,6,1,114621.4,1158.714,91.14286
"26602","88356","2014",1,1,0,53000,964,55
"26603","88357","2014",5,4,1,86920,1014.2,87.2
"26604","88358","2014",12,12,0,107625,1153.417,95.08333
"26605","88359","2014",1,1,0,130000,1477,88
"26606","88360","2014",1,1,0,60000,545,110
"26607","88361","2014",15,14,1,108147.7,1230.533,95.53333
"26608","88362","2014",3,3,0,96666.67,979.3333,106.3333
"26609","88363","2014",2,2,0,82500,790,106
"26610","88364","2014",1,1,0,63000,788,80
"26611","88365","2014",1,1,0,23000,383,60
"26612","88367","2014",35,30,5,87136.57,925.7143,95.42857
"26613","88369","2014",9,8,1,109111.1,946.6667,128.3333
"26614","88370","2014",2,2,0,67500,746.5,91
"26615","88371","2014",6,6,0,171333.3,1347.167,133.5
"26616","88372","2014",50,40,10,87741.4,968.36,92.58
"26617","88373","2014",3,3,0,151666.7,1342.667,114
"26618","88377","2014",1,1,0,15000,366,41
"26619","88379","2014",3,3,0,105666.7,1071.333,97
"26620","88380","2014",3,3,0,134000,1770.333,77
"26621","88383","2014",74,21,53,106220,1245.797,88.74324
"26622","88385","2014",6,6,0,111433.3,1003.833,111.5
"26623","88386","2014",4,4,0,167500,1697.5,96.25
"26624","88387","2014",2,2,0,104500,805,125
"26625","88388","2014",1,1,0,90240,1128,80
"26626","88389","2014",1,1,0,152200,1507,101
"26627","88390","2014",1,1,0,104000,1040,100
"26628","88391","2014",7,7,0,130960,1487.857,90.42857
"26629","88393","2014",1,1,0,141000,1165,121
"26630","88395","2014",5,4,1,98730,1200.8,95.4
"26631","88399","2014",3,3,0,95000,991.6667,91
"26632","88400","2014",4,4,0,91500,1239.5,73.25
"26633","88401","2014",2,2,0,83500,743.5,112
"26634","88404","2014",1,1,0,45000,500,90
"26635","88407","2014",1,1,0,110000,846,130
"26636","88408","2014",35,20,15,104982.5,1080.714,100.7429
"26637","88409","2014",19,14,5,123121.3,1330.947,93.10526
"26638","88410","2014",3,3,0,83666.67,754.6667,108
"26639","88412","2014",2,2,0,104500,901,114.5
"26640","88413","2014",139,58,81,86727.45,969.0072,90.05036
"26641","88415","2014",19,17,2,176719.6,2398.579,97.89474
"26642","88417","2014",3,3,0,90033.33,710.6667,120.6667
"26643","88418","2014",2,2,0,150450,1706,87.5
"26644","88419","2014",2,2,0,173129.5,1884.5,95
"26645","88423","2014",14,12,2,101781.8,1070.929,106.5
"26646","88424","2014",16,13,3,115426,1349.5,95.375
"26647","88425","2014",1,1,0,84000,955,88
"26648","88426","2014",20,15,5,95342.5,1326.65,73
"26649","88428","2014",11,11,0,120627.3,1148.364,106.3636
"26650","88429","2014",20,19,1,143850.2,1329.05,111.95
"26651","88430","2014",5,5,0,63588,591.2,107
"26652","88431","2014",1,1,0,88000,489,180
"26653","88432","2014",1,1,0,134000,912,147
"26654","88433","2014",2,2,0,86000,867,95
"26655","88434","2014",2,2,0,140725,1491,94.5
"26656","88435","2014",4,4,0,142825,1527.5,94.5
"26657","88437","2014",1,1,0,95000,1188,80
"26658","88438","2014",2,2,0,111750,1430.5,78.5
"26659","88439","2014",12,12,0,115765.3,1831.5,68.91667
"26660","88440","2014",1,1,0,35000,398,88
"26661","88442","2014",3,3,0,135000,959.6667,141
"26662","88444","2014",5,4,1,139800,1676,83.6
"26663","88445","2014",18,16,2,110216.7,1206.778,92.05556
"26664","88447","2014",17,16,1,100858.8,1318.059,83
"26665","88448","2014",1,1,0,20000,339,59
"26666","88449","2014",1,1,0,189200,1051,180
"26667","88450","2014",1,1,0,120000,1319,91
"26668","88451","2014",15,15,0,59406.67,850.4,75.6
"26669","88452","2014",1,1,0,101500,521,195
"26670","88454","2014",2,1,1,102750,1376.5,71.5
"26671","88456","2014",1,1,0,57500,587,98
"26672","88457","2014",1,1,0,148000,1057,140
"26673","88458","2014",1,1,0,164000,970,169
"26674","88460","2014",8,8,0,109081.2,1134.875,101.5
"26675","88461","2014",2,2,0,110000,953.5,124.5
"26676","88462","2014",16,14,2,152269.4,1443.812,105.8125
"26677","88463","2014",12,12,0,129000,1226,106.4167
"26678","88464","2014",4,3,1,123000,1620.25,76
"26679","88465","2014",59,44,15,96506.47,1075.797,90.15254
"26680","88466","2014",4,4,0,92875,950.5,101.75
"26681","88467","2014",6,5,1,119666.7,1278.167,100
"26682","88468","2014",20,18,2,100013.5,1241.5,83.9
"26683","88470","2014",24,14,10,97116.5,1409,83.125
"26684","88471","2014",1,1,0,48500,1032,47
"26685","88473","2014",1,1,0,49000,790,62
"26686","88474","2014",1,1,0,40000,500,80
"26687","88476","2014",4,4,0,59825,767.25,78.25
"26688","88479","2014",2,2,0,95000,1087.5,90
"26689","88480","2014",1,1,0,109400,1013,108
"26690","88481","2014",9,9,0,113157.2,1263.667,88.77778
"26691","88483","2014",15,13,2,139094.1,1385.6,102.3333
"26692","88484","2014",9,9,0,147611.1,1195.222,127.8889
"26693","88485","2014",1,1,0,1e+05,800,125
"26694","88486","2014",15,14,1,136933.3,1222.733,121.1333
"26695","88487","2014",22,20,2,114806.2,1026.909,115.7727
"26696","88488","2014",4,4,0,91002.5,811,114.75
"26697","88489","2014",1,1,0,145800,1458,100
"26698","88490","2014",1,1,0,150650,1100,137
"26699","88491","2014",1,1,0,123000,1150,107
"26700","88495","2014",1,1,0,161750,2216,73
"26701","88496","2014",1,1,0,256200,2562,100
"26702","88497","2014",6,5,1,140041.7,1230.667,108.1667
"26703","88498","2014",3,3,0,204333.3,1202,183
"26704","88499","2014",1,1,0,201500,1292,156
"26705","88500","2014",14,12,2,140171.5,1683.357,91.07143
"26706","88501","2014",1,1,0,75000,1014,74
"26707","88502","2014",1,1,0,110000,1467,75
"26708","88503","2014",1,1,0,84000,977,86
"26709","88504","2014",1,1,0,144000,1067,135
"26710","88505","2014",4,4,0,90250,1027.25,90
"26711","88506","2014",4,4,0,120537.5,1068.5,117.5
"26712","88508","2014",1,1,0,51000,850,60
"26713","88509","2014",1,1,0,170000,1932,88
"26714","88510","2014",1,1,0,22000,550,40
"26715","88512","2014",3,3,0,118466.7,872.3333,137.6667
"26716","88513","2014",19,19,0,111587.4,1149.421,99.68421
"26717","88515","2014",2,2,0,93500,904,105
"26718","88516","2014",53,29,24,96864.15,1140.453,86.66038
"26719","88517","2014",2,2,0,90050,758,117.5
"26720","88519","2014",6,6,0,123000,1023.333,123
"26721","88521","2014",1,1,0,26410,377,70
"26722","88522","2014",1,1,0,20000,1053,19
"26723","88523","2014",3,3,0,107833.3,744.3333,151.3333
"26724","88524","2014",2,2,0,70900,797.5,93
"26725","88525","2014",1,1,0,53300,444,120
"26726","88526","2014",2,2,0,81000,1562.5,54
"26727","88527","2014",1,1,0,72000,720,100
"26728","88529","2014",1,1,0,139000,1433,97
"26729","88530","2014",18,18,0,104944.4,1049.167,105.1667
"26730","88531","2014",32,21,11,144162,1888,82.4375
"26731","88532","2014",1,1,0,90000,1111,81
"26732","89002","2014",2,2,0,125000,742.5,172
"26733","89003","2014",23,23,0,128299.5,1451.217,88.43478
"26734","89004","2014",1,1,0,1e+05,847,118
"26735","89005","2014",9,8,1,41525.56,589.2222,71.11111
"26736","89007","2014",7,7,0,65428.57,965.5714,78.42857
"26737","89009","2014",3,3,0,109666.7,1188.333,88.33333
"26738","89010","2014",3,3,0,63000,787,75.33333
"26739","89011","2014",1,1,0,180000,1895,95
"26740","89013","2014",30,30,0,132179.1,1555.7,84.93333
"26741","89014","2014",6,6,0,77916.67,740.6667,107.6667
"26742","89015","2014",14,14,0,76468.93,925.3571,84.35714
"26743","89016","2014",1,1,0,111000,638,174
"26744","89017","2014",4,4,0,87225,989,83
"26745","89018","2014",12,12,0,98037.5,1384.333,75.16667
"26746","89019","2014",2,2,0,111000,1132.5,98.5
"26747","89020","2014",1,1,0,190000,664,286
"26748","89021","2014",1,1,0,141405,2209,64
"26749","89022","2014",1,1,0,116500,1059,110
"26750","89023","2014",14,14,0,125564.3,1470.143,86.42857
"26751","89024","2014",360,173,187,122834.8,1606.747,77.64722
"26752","89025","2014",51,30,21,94077.06,1311.686,73.94118
"26753","89027","2014",3,3,0,86000,1352.667,66.66667
"26754","89029","2014",12,12,0,105333.3,1090.25,98.5
"26755","89030","2014",7,7,0,147714.3,1050.286,133.2857
"26756","89031","2014",3,3,0,78333.33,1160.667,73
"26757","89033","2014",2,2,0,53489,879,58.5
"26758","89034","2014",6,6,0,118333.3,1270.167,97.5
"26759","89035","2014",7,7,0,102730.6,1092,90.85714
"26760","89036","2014",3,3,0,118666.7,1510.333,81.33333
"26761","89037","2014",2,2,0,117500,1243.5,94
"26762","89039","2014",3,3,0,59333.33,994,60.66667
"26763","89040","2014",1,1,0,92000,1353,68
"26764","89042","2014",1,1,0,80000,1026,78
"26765","89043","2014",1,1,0,130000,1182,110
"26766","89044","2014",1,1,0,40000,800,50
"26767","89045","2014",2,2,0,106900,1348.5,79
"26768","89046","2014",15,15,0,77880,1087.733,74.8
"26769","89048","2014",6,6,0,107166.7,1085.167,102.5
"26770","89050","2014",11,11,0,91973.64,1226.273,77.72727
"26771","89051","2014",10,10,0,109200,1288.1,91.5
"26772","89053","2014",3,3,0,150666.7,1706,91.66667
"26773","89054","2014",15,15,0,109458.1,1537.733,70.93333
"26774","89055","2014",19,18,1,71511.26,1089.368,66.73684
"26775","89056","2014",6,6,0,154000,1398.5,104.6667
"26776","89057","2014",5,5,0,63000,836.4,78
"26777","89058","2014",1,1,0,172000,1075,160
"26778","89059","2014",5,5,0,103050,1006.6,104
"26779","89060","2014",6,6,0,128500,1431.5,91
"26780","89062","2014",3,3,0,109000,1211.667,98.66667
"26781","89063","2014",13,13,0,130223.1,1367.615,99.76923
"26782","89065","2014",1,1,0,155000,1033,150
"26783","89066","2014",11,11,0,80820.18,985,81.45455
"26784","89067","2014",10,10,0,85050,1420.9,64.5
"26785","89068","2014",26,25,1,140936.7,1401.192,95.11538
"26786","89069","2014",2,2,0,59750,922,77
"26787","89071","2014",3,3,0,43000,687.6667,62.66667
"26788","89072","2014",4,4,0,66075,793,89.25
"26789","89073","2014",16,16,0,100162.5,1451.75,75.25
"26790","89074","2014",23,22,1,118855.7,1673.478,77.13043
"26791","89075","2014",3,3,0,107833.3,1851.333,81
"26792","89076","2014",12,12,0,114416.7,1173.083,98.83333
"26793","89077","2014",17,17,0,142273.5,1687.529,86.29412
"26794","89079","2014",5,5,0,133200,1695.6,79.8
"26795","89080","2014",5,5,0,120600,1380.4,91.4
"26796","89081","2014",1,1,0,180000,2069,87
"26797","89083","2014",10,10,0,226938,1455.9,167.6
"26798","89084","2014",3,3,0,100133.3,1040.333,100
"26799","89085","2014",11,11,0,105781.8,1394.636,73.81818
"26800","89086","2014",69,69,0,106088.4,1242.797,88.24638
"26801","89087","2014",2,2,0,48500,759.5,64
"26802","89088","2014",8,7,1,111202.5,1287.625,95.5
"26803","89089","2014",3,3,0,150133.3,1164.333,147.6667
"26804","89091","2014",9,9,0,91653.33,1078.556,94.55556
"26805","89092","2014",2,2,0,122000,1165,118.5
"26806","89093","2014",9,9,0,118066.7,1837.333,69.44444
"26807","89094","2014",9,9,0,108700,1350.667,99.22222
"26808","89096","2014",8,8,0,121825,1398.375,85.5
"26809","89098","2014",2,2,0,157500,1525.5,104.5
"26810","89099","2014",13,13,0,100876.9,1340.769,84.46154
"26811","89100","2014",32,30,2,127771.9,1574.656,83.28125
"26812","89101","2014",1,1,0,82000,854,96
"26813","89102","2014",18,18,0,131450,1403.944,98.66667
"26814","89104","2014",3,3,0,115000,1433,86.66667
"26815","89105","2014",7,7,0,170534.3,1417.857,120.1429
"26816","89108","2014",8,8,0,105437.5,1004,97.875
"26817","89111","2014",1,1,0,110000,1000,110
"26818","89112","2014",2,2,0,86500,989,95
"26819","89113","2014",7,7,0,161428.6,1248.714,130.8571
"26820","89115","2014",1,1,0,65000,844,77
"26821","89116","2014",4,4,0,94468.75,1056.5,102.5
"26822","89117","2014",4,4,0,73375,926.5,93.75
"26823","89118","2014",6,6,0,110195,1314.167,82.66667
"26824","89120","2014",2,2,0,75000,877.5,83
"26825","89122","2014",6,6,0,84750,1121.333,76.5
"26826","89123","2014",6,6,0,102000,1078.667,95
"26827","89124","2014",6,6,0,172833.3,1606.667,108.6667
"26828","89125","2014",6,6,0,78500,1240.667,71.16667
"26829","89127","2014",5,5,0,127400,1486.8,92.2
"26830","89128","2014",1,1,0,165000,1701,97
"26831","89129","2014",6,6,0,94088.33,1062.167,88.33333
"26832","89130","2014",17,17,0,83033.53,1072.118,72.41176
"26833","89131","2014",1,0,1,45000,433,104
"26834","89132","2014",1,1,0,1e+05,1250,80
"26835","89133","2014",1,1,0,107000,764,140
"26836","89134","2014",2,2,0,163000,1768,91.5
"26837","89136","2014",5,5,0,146600,1740.6,89.6
"26838","89137","2014",1,1,0,45000,750,60
"26839","89139","2014",10,10,0,149220,1611.2,104.8
"26840","89141","2014",2,2,0,108125,1131.5,96
"26841","89142","2014",10,10,0,90850,1350.2,77.4
"26842","89143","2014",5,5,0,124010,1289.8,99.6
"26843","89144","2014",7,7,0,96625,1141.571,84.42857
"26844","89145","2014",5,5,0,69490,1353.4,49.2
"26845","89146","2014",2,2,0,41000,568,72
"26846","89147","2014",3,3,0,115000,1511,75.66667
"26847","89148","2014",3,3,0,89333.33,1281.333,76.66667
"26848","89149","2014",2,2,0,110500,926.5,124.5
"26849","89150","2014",2,2,0,192500,1068,182.5
"26850","89151","2014",8,8,0,111687.5,1480.75,75.25
"26851","89152","2014",14,14,0,86892.21,1278.214,69.42857
"26852","89153","2014",2,2,0,61000,625.5,128
"26853","89154","2014",12,12,0,130162.5,1272.5,102.5
"26854","89155","2014",5,5,0,175780,1348,119.6
"26855","89156","2014",4,4,0,88200,1009,96
"26856","89158","2014",7,7,0,64000,692.1429,95.57143
"26857","89159","2014",8,8,0,104516.2,1202.25,87.5
"26858","89160","2014",1,1,0,71000,1315,54
"26859","89161","2014",3,3,0,79333.33,1039,83
"26860","89162","2014",7,7,0,179107.1,1556.143,116.4286
"26861","89163","2014",9,9,0,138116.1,1216,100.6667
"26862","89167","2014",7,7,0,144378.6,1456.857,113.2857
"26863","89168","2014",1,1,0,131200,643,204
"26864","89169","2014",3,3,0,104000,1331,79
"26865","89170","2014",1,1,0,46410,566,82
"26866","89171","2014",7,7,0,77504.29,791.8571,105.1429
"26867","89172","2014",4,4,0,211125,1689.75,125
"26868","89173","2014",5,5,0,106400,938,109.4
"26869","89175","2014",1,1,0,50000,549,91
"26870","89176","2014",1,1,0,60000,500,120
"26871","89177","2014",1,1,0,128150,821,156
"26872","89179","2014",2,2,0,116000,1253,95
"26873","89180","2014",3,3,0,174000,1305.333,156.6667
"26874","89181","2014",4,4,0,108500,1120.25,96
"26875","89182","2014",2,2,0,94900,845.5,111
"26876","89183","2014",1,1,0,90000,1324,68
"26877","89184","2014",2,2,0,60125,848.5,77.5
"26878","89186","2014",6,6,0,111166.7,1159.333,99.5
"26879","89187","2014",1,1,0,90500,503,180
"26880","89189","2014",3,3,0,126500,1622,76.33333
"26881","89190","2014",1,1,0,44850,1121,40
"26882","89194","2014",1,1,0,65000,970,67
"26883","89195","2014",6,6,0,120633.3,1452.5,79.33333
"26884","89196","2014",12,12,0,118633.3,1208.833,105.25
"26885","89197","2014",8,8,0,118877.5,1469.625,79.75
"26886","89198","2014",27,26,1,139405.9,1591.222,88.7037
"26887","89199","2014",1,1,0,117000,1376,85
"26888","89200","2014",2,2,0,116250,1370,86
"26889","89201","2014",24,22,2,115222.9,1246.708,93.70833
"26890","89202","2014",10,10,0,114405,1194.9,89.7
"26891","89203","2014",1,1,0,60000,1250,48
"26892","89204","2014",8,6,2,106775,1357.25,85.75
"26893","89205","2014",4,4,0,68750,868,77.25
"26894","89206","2014",69,43,26,97786.52,1341.507,74.01449
"26895","89208","2014",6,6,0,56450,796,70.5
"26896","89209","2014",2,2,0,114500,1513,74
"26897","89211","2014",1,1,0,28000,389,72
"26898","89212","2014",1,1,0,85000,934,91
"26899","89214","2014",1,1,0,104000,963,108
"26900","89215","2014",3,3,0,109000,965,117
"26901","89216","2014",2,2,0,115500,1473,74.5
"26902","89217","2014",1,1,0,105000,1346,78
"26903","89218","2014",18,18,0,97889.17,1121.5,87.16667
"26904","89219","2014",2,2,0,112500,679.5,130
"26905","89220","2014",6,6,0,52000,1412.5,45.66667
"26906","89221","2014",4,4,0,69500,1497.75,48
"26907","89222","2014",2,2,0,127500,1271.5,97.5
"26908","89223","2014",4,4,0,104500,1074.75,102
"26909","89224","2014",1,1,0,175000,1786,98
"26910","89225","2014",2,2,0,121500,980,129
"26911","89226","2014",2,2,0,75000,695.5,107.5
"26912","89227","2014",10,10,0,101460,1063.3,98.2
"26913","89228","2014",15,15,0,171027.8,1478.2,116
"26914","89229","2014",2,2,0,96000,1043,92.5
"26915","89230","2014",4,4,0,102750,985.75,108.75
"26916","89232","2014",2,2,0,120875,1335.5,89.5
"26917","89233","2014",4,3,1,81875,1395.25,62.75
"26918","89234","2014",1,1,0,90035,979,92
"26919","89235","2014",8,8,0,76596.62,967.5,80.625
"26920","89236","2014",13,13,0,119338.5,1614.692,73.15385
"26921","89237","2014",9,9,0,90277.78,896.7778,100.6667
"26922","89238","2014",9,9,0,82044.44,688.6667,109.8889
"26923","89239","2014",11,11,0,118727.3,1692.818,73.54545
"26924","89240","2014",5,5,0,123400,1370.8,95.2
"26925","89242","2014",6,6,0,96833.33,1040.167,90.16667
"26926","89245","2014",7,7,0,130714.3,1220.286,110.7143
"26927","89246","2014",7,7,0,58711.43,758.4286,80.57143
"26928","89247","2014",1,1,0,65000,474,137
"26929","89248","2014",2,2,0,34100,462.5,72.5
"26930","89250","2014",1,1,0,80000,1000,80
"26931","89251","2014",5,5,0,130120,1207,116.4
"26932","89253","2014",4,4,0,123000,909.75,139.25
"26933","89254","2014",10,10,0,86520,1054.6,86
"26934","89255","2014",11,11,0,132510.9,1486.364,95.72727
"26935","89256","2014",6,6,0,109933.3,1226.833,89.66667
"26936","89257","2014",52,42,10,98028.9,1391.615,71.32692
"26937","89261","2014",3,3,0,68143.33,715.3333,91.33333
"26938","89262","2014",1,1,0,115000,1353,85
"26939","89263","2014",36,35,1,142108.9,1554,95.11111
"26940","89264","2014",7,7,0,124714.3,1649.714,76.57143
"26941","89265","2014",5,5,0,138800,1267.2,109.8
"26942","89266","2014",2,2,0,77455,824.5,96
"26943","89267","2014",1,1,0,3e+05,1622,185
"26944","89268","2014",13,13,0,109700,1228.077,92.15385
"26945","89270","2014",2,2,0,120250,1086,111
"26946","89272","2014",1,1,0,135000,1239,109
"26947","89273","2014",5,5,0,79400,1415.6,57.8
"26948","89274","2014",15,15,0,178626.7,1587.733,118.2
"26949","89276","2014",13,13,0,104846.2,891.6154,118
"26950","89277","2014",2,2,0,31500,567.5,58
"26951","89278","2014",6,6,0,110445.8,1235.167,86.83333
"26952","89279","2014",9,8,1,123646.9,1053.556,140.8889
"26953","89280","2014",1,1,0,21000,333,63
"26954","89281","2014",3,3,0,169210.3,1540,109
"26955","89282","2014",5,5,0,87000,1138.2,79.6
"26956","89283","2014",4,4,0,113750,803.5,126.75
"26957","89284","2014",1,1,0,104000,634,164
"26958","89285","2014",1,1,0,115000,927,124
"26959","89286","2014",14,14,0,119562.4,1228.071,104.1429
"26960","89287","2014",49,45,4,139554.7,1573.531,91.44898
"26961","89288","2014",1,1,0,36000,507,71
"26962","89289","2014",5,5,0,143760,1123.6,125.8
"26963","89290","2014",1,1,0,102000,408,250
"26964","89291","2014",1,1,0,46000,622,74
"26965","89292","2014",2,2,0,65000,902,69.5
"26966","89295","2014",11,10,1,136109.1,1694.273,82.18182
"26967","89297","2014",1,1,0,70000,1400,50
"26968","89298","2014",8,8,0,143375,1492,91.25
"26969","89300","2014",1,1,0,89500,716,125
"26970","89302","2014",2,2,0,215000,1698.5,127.5
"26971","89303","2014",1,1,0,75000,904,83
"26972","89304","2014",5,5,0,196110,1484.6,117.6
"26973","89307","2014",7,7,0,93214.29,936.2857,104.1429
"26974","89308","2014",3,3,0,144833.3,1107.667,129.6667
"26975","89309","2014",33,29,4,115386.7,1484.303,82.93939
"26976","89310","2014",5,5,0,123600,1193,110.2
"26977","89311","2014",9,9,0,167400,1236.222,120.5556
"26978","89312","2014",5,5,0,112600,1032,98
"26979","89313","2014",5,5,0,108700,1367,80.8
"26980","89314","2014",1,1,0,80000,1067,75
"26981","89315","2014",3,3,0,1e+05,837.3333,144.3333
"26982","89316","2014",7,7,0,63828.57,1054.571,65.57143
"26983","89318","2014",7,7,0,66928.57,934.2857,81.57143
"26984","89319","2014",1,1,0,110000,1222,90
"26985","89321","2014",10,10,0,68091,833.8,81.6
"26986","89323","2014",4,4,0,88750,915.25,111.75
"26987","89324","2014",8,8,0,64750,811.875,75.375
"26988","89325","2014",1,1,0,78500,1208,65
"26989","89326","2014",9,9,0,103055.6,1355.111,79.11111
"26990","89327","2014",5,5,0,80800,881.4,96.4
"26991","89328","2014",1,1,0,85000,1308,65
"26992","89329","2014",1,1,0,63000,656,96
"26993","89331","2014",4,4,0,77650,935.25,78.75
"26994","89332","2014",3,3,0,155050,1590,98.66667
"26995","89333","2014",1,1,0,67000,788,85
"26996","89334","2014",5,5,0,104400,1066.8,101
"26997","89335","2014",7,7,0,62542.86,885.7143,80.57143
"26998","89336","2014",1,1,0,170000,988,172
"26999","89337","2014",8,8,0,96375,1123.375,90
"27000","89338","2014",21,19,2,148166.7,1673.429,92.90476
"27001","89339","2014",3,3,0,151701.7,1528.333,98
"27002","89341","2014",6,6,0,86416.67,728.8333,132.8333
"27003","89342","2014",1,1,0,130000,1461,89
"27004","89344","2014",21,20,1,105239,1013.095,110.1429
"27005","89345","2014",31,25,6,80154.84,969.4516,86.3871
"27006","89346","2014",23,21,2,184282.6,1904.174,97.17391
"27007","89347","2014",2,2,0,61000,925,67
"27008","89348","2014",16,16,0,98198.75,1562,71.25
"27009","89349","2014",7,7,0,98714.29,1023.857,102.2857
"27010","89350","2014",6,6,0,130250,1348.167,101.6667
"27011","89351","2014",5,5,0,89200,1281.4,67.4
"27012","89352","2014",2,2,0,260000,2065,132
"27013","89353","2014",6,6,0,110500,1114,98.16667
"27014","89354","2014",12,12,0,146000,1470.917,100.5833
"27015","89355","2014",2,2,0,64500,976,66.5
"27016","89359","2014",3,3,0,114333.3,1078.333,120
"27017","89360","2014",3,3,0,142113.3,1222,121.3333
"27018","89361","2014",1,1,0,180000,1324,136
"27019","89362","2014",3,3,0,145333.3,1510,97.33333
"27020","89363","2014",1,1,0,170000,2099,81
"27021","89364","2014",5,5,0,67200,1034.8,70
"27022","89365","2014",7,7,0,97677.86,1369.429,83.14286
"27023","89367","2014",7,7,0,83571.43,1155,76.85714
"27024","89368","2014",7,7,0,103614.3,1169,99.71429
"27025","89369","2014",12,12,0,105416.7,1310.667,81.58333
"27026","89370","2014",12,11,1,129678.3,1468.083,93
"27027","89371","2014",2,2,0,72500,1163,73
"27028","89373","2014",1,1,0,149000,993,150
"27029","89374","2014",1,1,0,143000,1051,136
"27030","89375","2014",2,2,0,60000,983.5,61
"27031","89376","2014",2,2,0,119950,1092,110
"27032","89377","2014",1,1,0,162400,829,196
"27033","89378","2014",5,5,0,137440,1412,94.6
"27034","89379","2014",1,1,0,50000,1000,50
"27035","89380","2014",29,12,17,154952.1,2976.586,47.68966
"27036","89382","2014",14,14,0,126251.8,1119.286,108.8571
"27037","89383","2014",1,1,0,55000,846,65
"27038","89384","2014",3,3,0,126566.7,1096.333,127
"27039","89385","2014",2,2,0,51000,646.5,75
"27040","89386","2014",1,1,0,60000,353,170
"27041","89387","2014",273,117,156,117453.3,1612.799,74.22711
"27042","89388","2014",4,4,0,102500,1536,73.5
"27043","89390","2014",19,18,1,137373.7,1628.684,91.21053
"27044","89391","2014",8,8,0,125295,1266.875,101.875
"27045","89392","2014",4,4,0,107200,1291.5,80
"27046","89393","2014",3,3,0,113291.7,860.3333,123.3333
"27047","89394","2014",1,1,0,24250,516,47
"27048","89395","2014",6,6,0,96483.33,1154.167,86.66667
"27049","89397","2014",7,7,0,105142.9,1266.429,88.57143
"27050","89398","2014",3,3,0,97000,1125.667,90.33333
"27051","89399","2014",9,9,0,137155.6,1494.111,94.22222
"27052","89400","2014",3,3,0,102500,1256.667,86.66667
"27053","89402","2014",2,2,0,56775,776.5,77.5
"27054","89403","2014",1,1,0,36000,480,75
"27055","89404","2014",4,4,0,158250,1315.25,118
"27056","89405","2014",2,2,0,91500,1171,76
"27057","89407","2014",6,6,0,111300,1173.5,100.8333
"27058","89408","2014",2,2,0,93000,973,91.5
"27059","89410","2014",2,2,0,205551.5,1285.5,170
"27060","89411","2014",6,6,0,92283.33,1008.833,90.33333
"27061","89412","2014",1,1,0,275000,1627,169
"27062","89414","2014",12,11,1,106666.7,1309.917,104.0833
"27063","89415","2014",4,4,0,118225.2,1154.5,107.5
"27064","89416","2014",5,5,0,81600,916,89.6
"27065","89417","2014",1,1,0,20000,571,35
"27066","89418","2014",32,28,4,82383.97,1066.438,81.59375
"27067","89419","2014",21,17,4,110610,1113.333,103
"27068","89420","2014",22,22,0,71363.64,1084.682,77.40909
"27069","89422","2014",1,1,0,72000,667,108
"27070","89423","2014",3,3,0,58500,692.3333,80.66667
"27071","89424","2014",2,2,0,47500,780.5,73.5
"27072","89425","2014",10,10,0,100766,1150.8,85.8
"27073","89426","2014",7,7,0,98857.14,1042.571,94.14286
"27074","89427","2014",7,7,0,108785.7,1772.571,64.28571
"27075","89428","2014",1,1,0,90000,1200,75
"27076","89430","2014",5,5,0,161592,1585.2,112
"27077","89431","2014",2,2,0,95750,1029.5,95
"27078","89432","2014",9,9,0,102247.2,1228.778,97.66667
"27079","89434","2014",4,4,0,146750,1062.5,139
"27080","89436","2014",10,10,0,68100,969.7,68.3
"27081","89437","2014",4,4,0,136430,1415.5,102
"27082","89438","2014",12,12,0,134612.5,1458.917,93.5
"27083","89439","2014",21,21,0,106228.6,1249.524,95
"27084","89440","2014",6,6,0,126750,1290.833,100
"27085","89441","2014",15,15,0,82453.33,976.5333,88.8
"27086","89442","2014",2,2,0,82500,644,137.5
"27087","89443","2014",13,13,0,149138.1,1519.923,100.8462
"27088","89446","2014",3,3,0,172763.3,2248.333,83.66667
"27089","89449","2014",30,28,2,138706.7,1665.667,90.86667
"27090","89450","2014",4,3,1,148625,1264.5,117.25
"27091","89451","2014",1,1,0,115500,1444,80
"27092","89452","2014",2,2,0,100500,1373.5,73
"27093","89453","2014",5,5,0,184694,2002.6,92.2
"27094","89456","2014",3,3,0,133666.7,2129,88.33333
"27095","89459","2014",2,2,0,124450,1516,82
"27096","89460","2014",30,28,2,150196.3,1620.267,92.73333
"27097","89461","2014",8,8,0,91091.25,985.875,104.875
"27098","89462","2014",6,6,0,123333.3,922.3333,116.8333
"27099","89463","2014",1,1,0,144000,1455,99
"27100","89464","2014",60,52,8,113613.9,1416.133,85.03333
"27101","89465","2014",2,2,0,43750,1094,40
"27102","89466","2014",4,4,0,204375,1663.5,121.75
"27103","89467","2014",9,9,0,151955.6,1450.333,105.7778
"27104","89468","2014",8,8,0,109625,1480.25,79.25
"27105","89469","2014",12,12,0,111770.8,1194.667,105.5
"27106","89471","2014",3,3,0,100666.7,1110.333,92
"27107","89472","2014",10,10,0,134377.3,1326.7,97.6
"27108","89474","2014",2,2,0,41750,1028,47
"27109","89475","2014",3,3,0,71166.67,699,101.6667
"27110","89477","2014",1,1,0,72000,1309,55
"27111","89478","2014",10,9,1,90700,1020.1,90
"27112","89479","2014",5,3,2,120740,1402.2,79.6
"27113","89480","2014",13,13,0,188669.2,1986.538,100.6923
"27114","89483","2014",11,11,0,165228.2,1394.636,128
"27115","89485","2014",4,4,0,76600,789.5,103
"27116","89486","2014",2,2,0,115000,821,141
"27117","90001","2014",15,11,4,133185.2,1427.133,92.4
"27118","90002","2014",3,3,0,215166.7,1585,136.6667
"27119","90003","2014",8,6,2,134500,1399.75,95.75
"27120","90004","2014",3,3,0,168633.3,1570.333,109.3333
"27121","90005","2014",4,4,0,75350,849.5,93.5
"27122","90006","2014",3,3,0,129833.3,1504,88.66667
"27123","90007","2014",1,1,0,171000,2515,68
"27124","90008","2014",30,20,10,166196,1784.833,96.33333
"27125","90009","2014",36,26,10,136429,1348.278,100.5556
"27126","90010","2014",432,72,360,100963.7,1340.794,75.44444
"27127","90011","2014",1,1,0,82000,863,95
"27128","90012","2014",6,6,0,167980.8,1500.333,111.8333
"27129","90013","2014",2,2,0,235750,1803,134.5
"27130","90014","2014",1,1,0,245520,1461,168
"27131","90017","2014",11,6,5,146911.8,1507.909,93.09091
"27132","90018","2014",1,1,0,110000,692,159
"27133","90019","2014",2,2,0,205000,1439,141.5
"27134","90021","2014",4,4,0,181725,1349,136
"27135","90022","2014",30,19,11,132290.3,1476.333,93.2
"27136","90023","2014",8,7,1,159592.6,1190.875,138.375
"27137","90026","2014",10,10,0,189309,1675.2,114.4
"27138","90027","2014",2,2,0,151500,1520.5,108.5
"27139","90028","2014",3,2,1,138333.3,1264.333,109.6667
"27140","90029","2014",10,5,5,147445,1668.1,90.8
"27141","90030","2014",1,1,0,60000,545,110
"27142","90032","2014",31,17,14,147041.3,1487.806,97.67742
"27143","90033","2014",57,27,30,111096.2,1494.509,74.59649
"27144","90035","2014",1,1,0,250000,1016,246
"27145","90037","2014",8,8,0,170137.5,1423.75,115.125
"27146","90039","2014",27,17,10,174812.1,1868.519,96.85185
"27147","90041","2014",10,6,4,167250,1349.1,125
"27148","90042","2014",12,9,3,206316.1,1748.667,114.6667
"27149","90043","2014",6,6,0,182953.2,1830.833,101
"27150","90044","2014",3,3,0,182333.3,1324,140
"27151","90045","2014",6,6,0,167666.7,1666,97.83333
"27152","90046","2014",2,2,0,224000,2168.5,103.5
"27153","90047","2014",6,6,0,179083.3,1398.667,138.3333
"27154","90049","2014",18,14,4,126569.4,1350.389,96.38889
"27155","90051","2014",5,3,2,124800,1165,107.8
"27156","90052","2014",29,17,12,116565.5,1170.034,102.1724
"27157","90053","2014",17,11,6,108752.9,1224,92.52941
"27158","90054","2014",5,5,0,118320,1232.6,103.6
"27159","90055","2014",2,2,0,181495,1193.5,141
"27160","90056","2014",15,13,2,162788.7,1521,109.8
"27161","90057","2014",4,4,0,257475,1591.25,161.75
"27162","90058","2014",4,4,0,162222.5,1555.5,102.25
"27163","90062","2014",5,5,0,155308,2063.6,95
"27164","90063","2014",3,3,0,128000,1250.667,99.66667
"27165","90064","2014",1,1,0,236200,1817,130
"27166","90065","2014",12,12,0,138229.2,1112.75,122.5
"27167","90066","2014",4,4,0,144750,1763.25,87
"27168","90067","2014",2,2,0,191500,1777.5,117.5
"27169","90068","2014",8,8,0,205942.5,1659.375,132.5
"27170","90069","2014",13,10,3,121119.8,1430.462,86.46154
"27171","90070","2014",6,6,0,155800,1086.5,142
"27172","90071","2014",4,4,0,93875,1011.75,92.5
"27173","90072","2014",6,5,1,172836.7,1463,115
"27174","90074","2014",2,2,0,236950,1453.5,166.5
"27175","90075","2014",21,15,6,170272.4,1569.286,109.1429
"27176","90076","2014",6,5,1,179900,1572.333,108.3333
"27177","90077","2014",1,1,0,186200,1605,116
"27178","90078","2014",2,2,0,165250,2067,76.5
"27179","90079","2014",3,3,0,146900,1149.333,131.6667
"27180","90080","2014",4,4,0,165750,1389.5,118.75
"27181","90081","2014",3,3,0,111586.7,1173.333,90
"27182","90082","2014",1,1,0,70000,1373,51
"27183","90084","2014",3,3,0,183000,1586,113
"27184","90085","2014",1,1,0,34000,850,40
"27185","90086","2014",2,2,0,116000,1318,80
"27186","90087","2014",2,2,0,246175,1686.5,145.5
"27187","90088","2014",4,4,0,147256.2,1550.25,95.5
"27188","90089","2014",15,8,7,98760,1258.267,83.8
"27189","90090","2014",4,4,0,123750,1037.25,118.25
"27190","90091","2014",7,7,0,196714.3,1396,146.4286
"27191","90093","2014",7,4,3,118614.3,1343.429,88.14286
"27192","90094","2014",7,4,3,176307.1,1898.143,96
"27193","90095","2014",3,3,0,132666.7,1820.667,74
"27194","90096","2014",3,3,0,241866.7,1908.667,128
"27195","90097","2014",9,7,2,143922.2,1460.444,97.77778
"27196","90099","2014",62,34,28,127131.1,1633.048,79.3871
"27197","90100","2014",2,2,0,195000,1442,136.5
"27198","90101","2014",2,2,0,165500,2027,82.5
"27199","90102","2014",5,5,0,183650,1124.8,155.6
"27200","90103","2014",2,2,0,183000,1935,92.5
"27201","90104","2014",3,2,1,172018,1560,111.3333
"27202","90105","2014",4,4,0,171950,1326.75,126.25
"27203","91001","2014",6,6,0,204666.7,2390.5,99.33333
"27204","91017","2014",12,12,0,254875,2607.833,100.1667
"27205","91021","2014",93,29,64,195507.9,3291.753,62.07527
"27206","91022","2014",1,1,0,173000,2932,59
"27207","91027","2014",230,93,137,216948.8,3466.878,65.93043
"27208","91035","2014",6,6,0,193400,2480.167,89.66667
"27209","91037","2014",2,2,0,332500,2189.5,151
"27210","91038","2014",13,12,1,266054,3204.692,85.30769
"27211","91041","2014",2,2,0,182601.5,2608.5,70
"27212","91045","2014",62,48,14,222279.2,2484.048,92.98387
"27213","91047","2014",14,8,6,180550,2830.286,71
"27214","91064","2014",21,16,5,414615.2,4514.952,96.28571
"27215","91067","2014",1,1,0,60000,1111,54
"27216","91069","2014",4,4,0,159875,1920.5,86
"27217","91075","2014",1,1,0,108000,3273,33
"27218","91079","2014",3,3,0,201521.7,2381,95.33333
"27219","91080","2014",21,13,8,193516,2286.143,86.90476
"27220","91081","2014",2,2,0,253500,2041.5,130
"27221","91085","2014",41,36,5,236965.9,2902.171,85.58537
"27222","91086","2014",97,73,24,246928.4,2687.918,95.2268
"27223","91093","2014",5,5,0,419140,3218,134.8
"27224","91095","2014",9,8,1,230420.2,2505.111,102.2222
"27225","91097","2014",67,24,43,181581.4,2498.179,74.37313
"27226","91098","2014",3,3,0,175000,2028,84
"27227","91099","2014",37,29,8,215783.8,2768.432,84.45946
"27228","91100","2014",5,5,0,222716,2992.4,83.8
"27229","91103","2014",242,108,134,214043.5,2991.417,73.80992
"27230","91105","2014",62,58,4,251338.7,2967.242,91.03226
"27231","91106","2014",8,8,0,208750,2102.25,107.625
"27232","91109","2014",10,7,3,190757,2436.8,84.9
"27233","91111","2014",31,25,6,253467.4,3210.806,84.6129
"27234","91112","2014",2,2,0,114150,1327.5,85
"27235","91114","2014",234,119,115,241990.8,3072.748,80.86752
"27236","91115","2014",33,21,12,202068.9,3019.939,72.33333
"27237","91121","2014",4,4,0,168000,1684.25,97
"27238","91122","2014",88,56,32,297612.8,3838.159,82.64773
"27239","91129","2014",30,25,5,220308.3,2452.733,92.4
"27240","91130","2014",7,5,2,160854,2329.857,70
"27241","91131","2014",5,5,0,156098,1781.2,87.2
"27242","91132","2014",12,10,2,225000,2655,88.16667
"27243","91135","2014",25,24,1,225232.4,2834.88,83.6
"27244","91137","2014",3,3,0,166900,1939.667,85.66667
"27245","91148","2014",1,1,0,327400,2034,161
"27246","91156","2014",29,18,11,206903.4,2911.828,72.93103
"27247","91159","2014",17,14,3,261988.2,2804.353,95.11765
"27248","91161","2014",223,34,189,176920.5,2755.457,67.81166
"27249","91174","2014",431,157,274,157158,2604.316,63.61485
"27250","91175","2014",8,7,1,215506.2,2533.625,97.25
"27251","91179","2014",52,33,19,233221.2,2703.423,89.61538
"27252","91180","2014",4,4,0,288875,2848.5,108
"27253","91184","2014",2,2,0,229500,1711,134
"27254","91186","2014",7,5,2,282714.3,2569.286,112
"27255","91191","2014",91,35,56,200738.3,2862.835,72.76923
"27256","91195","2014",11,11,0,224690.9,2439.909,95
"27257","91198","2014",19,15,4,208326.3,2539.316,87.05263
"27258","91200","2014",93,50,43,202506,2705.129,81.2043
"27259","91201","2014",232,156,76,247601.2,3217.711,81.94397
"27260","91207","2014",28,17,11,216689.1,3064.821,81.75
"27261","91215","2014",75,20,55,149535.3,2018.573,74.46667
"27262","91216","2014",102,67,35,230579.1,3364.735,70.98039
"27263","91223","2014",246,93,153,146536.7,2249.524,69.03659
"27264","91225","2014",45,27,18,338125.6,3004.556,115.4444
"27265","91226","2014",73,52,21,210113.1,2984.37,75.10959
"27266","91228","2014",540,111,429,154180.7,2208.631,72.3
"27267","91232","2014",44,30,14,196332,2804.5,74
"27268","91235","2014",12,11,1,215238,2564,84
"27269","91240","2014",2,1,1,279500,3518,78
"27270","91243","2014",13,12,1,279303.8,3176.462,93.30769
"27271","91244","2014",17,16,1,240738.2,2579.235,95.82353
"27272","91247","2014",4,4,0,243000,2158.25,119.5
"27273","91248","2014",2,1,1,182500,1835,100
"27274","91249","2014",38,27,11,263930.4,2853.684,95.34211
"27275","91272","2014",210,115,95,375054,3732.429,103.1333
"27276","91273","2014",12,9,3,183319.2,2527.917,90.08333
"27277","91274","2014",9,8,1,300183.3,3270.667,98.77778
"27278","91275","2014",12,11,1,331750,3328.167,105.5
"27279","91284","2014",11,11,0,245181.8,2453.364,105.8182
"27280","91286","2014",29,21,8,183541.4,2297.448,88.48276
"27281","91292","2014",7,7,0,273378.6,2734,100.5714
"27282","91293","2014",14,11,3,233460.7,2369.5,102
"27283","91294","2014",5,5,0,215900,3486.6,71
"27284","91312","2014",102,78,24,326679.7,4231.588,81.95098
"27285","91315","2014",70,63,7,243885.4,2790.343,93.11429
"27286","91318","2014",23,18,5,214839.1,2912.217,77.04348
"27287","91319","2014",5,5,0,316060,3208.4,114.8
"27288","91326","2014",166,38,128,193096.9,3197.5,61.87952
"27289","91330","2014",50,48,2,264253.5,3089.4,92.82
"27290","91332","2014",12,7,5,205618.3,2979.5,72.5
"27291","91333","2014",48,33,15,234847,2831.25,83.89583
"27292","91338","2014",65,48,17,254493.7,3362.877,81.67692
"27293","91339","2014",79,56,23,235207,2870.215,85.13924
"27294","91340","2014",75,59,16,226746.6,2789.08,85.85333
"27295","91345","2014",179,75,104,224020.8,3017.006,76.49162
"27296","91347","2014",76,56,20,260493.6,2985.158,92.39474
"27297","91359","2014",50,33,17,194592,3777.7,75.56
"27298","91363","2014",69,53,16,262040.4,3182.652,87.92754
"27299","91374","2014",4,4,0,150375,1661.5,94.5
"27300","91376","2014",40,30,10,234768.8,2859.975,85.225
"27301","91377","2014",106,20,86,249949,3654.783,68.60377
"27302","91378","2014",3,3,0,203533.3,2717.333,88
"27303","91386","2014",133,95,38,244622.2,2637.534,97.78947
"27304","91390","2014",41,35,6,171157,1956.317,94.46341
"27305","91393","2014",8,8,0,202687.5,2394.75,103.125
"27306","91399","2014",3,3,0,156666.7,1789.667,89
"27307","91405","2014",53,43,10,228961.3,2899.509,89.30189
"27308","91408","2014",13,12,1,303119.8,3028.923,106.5385
"27309","91411","2014",14,14,0,393289.3,3470.643,117.7857
"27310","91412","2014",3,2,1,198666.7,2094,96.66667
"27311","91414","2014",5,4,1,105800,1832.6,64
"27312","91421","2014",213,124,89,238525.6,3419.948,73.91549
"27313","91425","2014",86,48,38,242118,3038.43,85.02326
"27314","91432","2014",98,68,30,251775.2,3599.408,76.70408
"27315","91433","2014",49,36,13,219184,2502.592,94.28571
"27316","91434","2014",194,109,85,230016,3031.861,78.24742
"27317","91435","2014",3,3,0,245333.3,1842.667,130.6667
"27318","91441","2014",1,1,0,192000,3097,62
"27319","91457","2014",43,38,5,274998.5,2905.581,97.30233
"27320","91458","2014",50,30,20,261274.4,2998.04,86.78
"27321","91461","2014",33,28,5,243527.3,2711.485,95.69697
"27322","91463","2014",8,8,0,292350,2308.75,133.25
"27323","91468","2014",23,22,1,249948.9,2741.739,95.91304
"27324","91469","2014",3,3,0,251666.7,2343.667,113
"27325","91471","2014",148,74,74,299682.9,3904.723,80.53378
"27326","91473","2014",1,1,0,211000,1936,109
"27327","91477","2014",305,94,211,249439.4,3393.161,74.9082
"27328","91479","2014",61,45,16,257445.1,3843.934,71.40984
"27329","91482","2014",11,9,2,239909.1,2467.636,103.9091
"27330","91494","2014",30,26,4,262528.3,2781.2,98.73333
"27331","91495","2014",3,3,0,186000,2124.333,93
"27332","91507","2014",4,4,0,251175,2211.5,117.75
"27333","91508","2014",2,2,0,280800,2595.5,114
"27334","91511","2014",29,20,9,147456.9,2004.483,77.7931
"27335","91514","2014",72,49,23,229695.2,3076.347,77.19444
"27336","91519","2014",5,5,0,209100,2027,120.2
"27337","91521","2014",294,101,193,164950.1,2351.905,71.54422
"27338","91525","2014",13,11,2,280530.8,3089.231,99.61538
"27339","91526","2014",3,3,0,219333.3,1967.333,145.3333
"27340","91533","2014",23,23,0,220808.5,2420.391,99.95652
"27341","91534","2014",20,14,6,347244,3956.2,88
"27342","91538","2014",9,8,1,385688.9,3482.111,111.4444
"27343","91540","2014",37,26,11,212860.6,2677.054,84.40541
"27344","91544","2014",6,6,0,262000,2537.833,107.6667
"27345","91546","2014",10,10,0,254269.5,2747.5,112
"27346","91547","2014",4,4,0,191250,2018,101.75
"27347","91549","2014",286,174,112,231099.3,3088.413,77.35664
"27348","91552","2014",99,72,27,218617.8,2920.505,78.55556
"27349","91553","2014",102,73,29,269910.1,3012.373,94.58824
"27350","91556","2014",6,6,0,194666.7,2378.667,86.16667
"27351","91560","2014",6,3,3,238000,2759.833,85.83333
"27352","91568","2014",12,11,1,276379.2,2885.333,98.75
"27353","91570","2014",187,74,113,197379.3,2551.62,79.46524
"27354","91573","2014",95,69,26,234822.6,2769.789,86.08421
"27355","91577","2014",47,40,7,227487.9,2765.255,91.2766
"27356","91578","2014",3,3,0,309333.3,2045.667,153.6667
"27357","91579","2014",27,16,11,242381.5,3183.407,75.55556
"27358","91581","2014",10,10,0,265760,2761.1,101.4
"27359","91587","2014",51,35,16,277201.9,3200,90.88235
"27360","91589","2014",320,186,134,228847.2,3302.3,72.66563
"27361","91593","2014",18,18,0,293359.4,2601.111,118.2778
"27362","91599","2014",19,19,0,251405.3,3140.947,88.42105
"27363","91600","2014",87,48,39,272341.7,3145.931,89.66667
"27364","91602","2014",3,3,0,191666.7,2307.667,88.33333
"27365","91613","2014",2,2,0,264500,2307,113
"27366","91617","2014",33,27,6,259961.4,3100.061,89.30303
"27367","91619","2014",2,2,0,308500,2670,117
"27368","91629","2014",10,10,0,194809,2085.6,90.6
"27369","91630","2014",16,11,5,291218.8,3024.5,108.75
"27370","91631","2014",17,16,1,328193.8,3448.824,100.8235
"27371","91634","2014",15,12,3,268050,2722.2,103.6
"27372","91635","2014",18,16,2,397519.4,4732.278,84.22222
"27373","91639","2014",5,5,0,191782,2408,81.4
"27374","91645","2014",133,64,69,402413.1,4301.541,92.24812
"27375","91648","2014",20,9,11,206172.5,2891.9,77.35
"27376","91649","2014",29,23,6,209810.3,2435.586,86.96552
"27377","91654","2014",6,6,0,190500,2813,70.83333
"27378","91657","2014",184,131,53,217672.4,3304.712,70.94022
"27379","91659","2014",43,37,6,230753.5,2826.442,85.48837
"27380","91661","2014",91,42,49,262770.6,3339.538,82.50549
"27381","91662","2014",8,8,0,282500,3181.875,94.75
"27382","91665","2014",57,52,5,265171.5,2846.175,95.73684
"27383","91666","2014",14,12,2,258971.1,3601.571,80.85714
"27384","91667","2014",66,51,15,257521.2,3193.288,84.22727
"27385","91671","2014",1,1,0,189000,1454,130
"27386","91679","2014",9,7,2,291316.7,3398.444,90.11111
"27387","91685","2014",27,19,8,266915.6,3178.407,85
"27388","91687","2014",242,111,131,205678.5,2959.764,72.3595
"27389","91689","2014",80,35,45,301571.5,3893.6,78.6875
"27390","91691","2014",292,147,145,247831,3109.336,81.98973
"27391","91692","2014",166,18,148,169687.4,2288.837,75.37952
"27392","92002","2014",499,193,306,357578.7,4729.591,76.08818
"27393","92004","2014",1090,114,976,312463.4,5176.817,59.7633
"27394","92007","2014",214,52,162,268646.9,4366.495,62.33178
"27395","92009","2014",370,84,286,365152.3,5231.365,67.65676
"27396","92012","2014",1510,32,1478,427346.9,7072.577,59.02318
"27397","92014","2014",211,40,171,353257,5095.365,70.2891
"27398","92019","2014",263,36,227,301774.1,4255.213,69.92776
"27399","92020","2014",385,60,325,321837.1,5167.275,61.71688
"27400","92022","2014",192,56,136,384339.3,5338.375,71.0625
"27401","92023","2014",492,168,324,373886.7,5412.579,67.55488
"27402","92024","2014",502,4,498,215620.5,5009.954,43.4004
"27403","92025","2014",881,292,589,308416.2,4721.646,64.73099
"27404","92026","2014",1067,41,1026,343480.5,5761.022,59.33083
"27405","92032","2014",202,40,162,300778,4521.965,67.44554
"27406","92033","2014",189,48,141,504666.6,5483.54,90.97354
"27407","92035","2014",362,44,318,351015.1,5441.312,62.18232
"27408","92036","2014",196,30,166,222756.2,3638.668,61.31122
"27409","92040","2014",662,40,622,389942.6,6390.467,60.32326
"27410","92044","2014",822,10,812,408239.8,7536.303,53.71776
"27411","92046","2014",231,56,175,280407.6,5618.554,50.15584
"27412","92047","2014",8,5,3,720687.5,5300.375,137.75
"27413","92048","2014",438,59,379,379255.4,5036.192,72.9726
"27414","92049","2014",508,24,484,331360.3,6027.002,54.16535
"27415","92050","2014",434,136,298,319460.6,4997.332,65.22811
"27416","92051","2014",799,16,783,740066.6,8512.013,84.97372
"27417","92060","2014",283,43,240,355892.4,4842.445,72.77739
"27418","92062","2014",472,17,455,330597.8,5762.521,57.59534
"27419","92063","2014",774,204,570,441274.3,5606.932,77.63049
"27420","92064","2014",352,57,295,504988.9,6043.949,81.49716
"27421","92071","2014",181,43,138,477033.4,5906.685,78.38674
"27422","92072","2014",212,47,165,469499.4,5440.92,83.91509
"27423","92073","2014",461,77,384,407773.7,5878.755,67.71367
"27424","92075","2014",282,23,259,325321.3,5586.865,58.14184
"27425","92076","2014",97,29,68,544674,5337.722,98.53608
"27426","92077","2014",87,15,72,479087.8,5279.034,89.90805
"27427","92078","2014",109,12,97,210380.5,3176.862,66.26606
"27428","93001","2014",389,39,350,154859.8,3095.357,51.20051
"27429","93005","2014",541,334,207,206624.4,3008.63,72.63216
"27430","93006","2014",230,60,170,247397.2,4492.378,58.17391
"27431","93007","2014",279,189,90,216661.8,3233.796,70.93548
"27432","93008","2014",149,68,81,195193.2,3042.06,68.28188
"27433","93010","2014",330,146,184,191146.5,3168.064,62.74545
"27434","93013","2014",98,25,73,177025.9,3079.643,59.79592
"27435","93014","2014",83,61,22,198162.4,2709.59,79.85542
"27436","93015","2014",47,22,25,188086.2,2743.128,73.95745
"27437","93027","2014",101,27,74,168139.5,2931.02,60.9901
"27438","93029","2014",447,232,215,185278.2,3236.758,60.21924
"27439","93030","2014",21,5,16,161076.7,2589.81,62.28571
"27440","93031","2014",289,60,229,157867.1,2554.616,63.71972
"27441","93032","2014",382,225,157,225754.1,3164.366,74.49738
"27442","93033","2014",88,55,33,273209.1,3650.966,79.35227
"27443","93039","2014",30,4,26,183417.9,2987.8,61.3
"27444","93045","2014",192,28,164,287696.3,5320.177,55.5625
"27445","93046","2014",391,156,235,191601.4,2967.238,67.67263
"27446","93047","2014",167,142,25,227755,2957.263,82.75449
"27447","93048","2014",919,228,691,272659.9,4594.361,60.8444
"27448","93049","2014",232,97,135,242861.9,3587.043,69.75862
"27449","93050","2014",264,70,194,193520.6,2966.663,67.57197
"27450","93051","2014",567,158,409,221382.1,3539.206,65.97354
"27451","93053","2014",248,104,144,221974,3487.258,66.35081
"27452","93055","2014",460,23,437,203614.3,4206.757,48.3413
"27453","93057","2014",262,122,140,205147.6,3248.607,65.87405
"27454","93059","2014",118,63,55,186351.7,2914.246,68.33051
"27455","93061","2014",145,13,132,250524,4872.566,51
"27456","93062","2014",169,51,118,276171.9,3823.237,73.0355
"27457","93063","2014",170,65,105,250019.3,4259.776,62.08824
"27458","93064","2014",467,106,361,203108.4,3351.353,62.12634
"27459","93066","2014",645,67,578,167946.2,3176.14,53.7814
"27460","93070","2014",376,23,353,189716.8,4104.479,45.94947
"27461","93071","2014",267,152,115,185060.1,2653.996,74.02247
"27462","93072","2014",113,60,53,176129.4,2960.752,65.47788
"27463","93073","2014",233,165,68,210716.6,2876.815,77.70815
"27464","93074","2014",67,30,37,197519.2,3199.791,66.34328
"27465","93077","2014",296,127,169,230634.9,3593.159,65.31757
"27466","93078","2014",197,115,82,190452.7,2695.223,74.3198
"27467","93079","2014",29,14,15,195952.4,3534.966,64.72414
"27468","94001","2014",46,21,25,211121.4,3012.717,74.3913
"27469","94002","2014",348,48,300,236502.3,4294.549,55.72126
"27470","94003","2014",129,35,94,286364.6,4660.798,62.45736
"27471","94004","2014",118,33,85,195376.2,2982.695,69.47458
"27472","94011","2014",108,32,76,228354.6,3301.509,70.46296
"27473","94015","2014",197,56,141,325033.1,4427.787,74.41624
"27474","94016","2014",224,53,171,281285.6,4559.031,63.11161
"27475","94017","2014",554,221,333,234791.1,3450.24,71.97292
"27476","94018","2014",307,8,299,369783.5,6081.358,60.59609
"27477","94019","2014",187,64,123,236690.8,3319.797,73.50267
"27478","94021","2014",116,26,90,230545.6,3287.612,72.42241
"27479","94022","2014",407,71,336,197279.6,3431.17,59.73219
"27480","94028","2014",560,60,500,226820.3,3472.086,66.875
"27481","94033","2014",518,162,356,333034.3,5003.932,67.30309
"27482","94034","2014",201,31,170,207759.2,3067.05,68.65174
"27483","94037","2014",105,10,95,233740.4,4967.076,49.18095
"27484","94038","2014",215,74,141,287615.1,4056.247,72.95814
"27485","94041","2014",461,36,425,213331.6,4294.957,51.0846
"27486","94042","2014",219,66,153,334308.2,4979.315,67.75799
"27487","94043","2014",181,9,172,243172.8,5112.122,49.40331
"27488","94044","2014",282,76,206,201704.6,3143.103,66.19858
"27489","94046","2014",560,90,470,271069.9,4703.055,58.35
"27490","94047","2014",41,29,12,281537.1,3073.902,91.68293
"27491","94048","2014",44,40,4,321559.5,2686.955,123.8182
"27492","94052","2014",473,68,405,369800.9,5329.376,68.4778
"27493","94053","2014",45,25,20,268286.2,3305.889,85.48889
"27494","94054","2014",94,47,47,211172.3,3239.926,66.28723
"27495","94055","2014",95,88,7,334471.2,3767.105,96.65263
"27496","94056","2014",22,17,5,270909.1,3086.591,92
"27497","94058","2014",433,114,319,305319.7,4631.762,65.52656
"27498","94059","2014",250,74,176,255466.8,3209.572,81.044
"27499","94060","2014",128,107,21,250380.1,2869.938,93.30469
"27500","94065","2014",33,14,19,338933.3,4148.818,82.30303
"27501","94067","2014",258,4,254,441440.9,7096.45,62.08527
"27502","94068","2014",980,323,657,348272.8,4972.203,70.63776
"27503","94069","2014",151,5,146,312961.3,5237.96,60.31126
"27504","94070","2014",39,29,10,368314.6,3285,126.4103
"27505","94071","2014",229,126,103,282608.3,3478.721,85.06987
"27506","94073","2014",265,60,205,231004.2,3637.638,67.40755
"27507","94074","2014",41,29,12,220575.6,3020.268,77.19512
"27508","94075","2014",110,76,34,268903.2,3419.345,88.3
"27509","94076","2014",372,92,280,250611.7,4219.847,60.84946
"27510","94077","2014",138,78,60,213118.5,3360.71,66.35507
"27511","94078","2014",192,60,132,155802.4,2800.13,57.77604
"27512","94079","2014",288,120,168,245048.1,3429.955,72.88194
"27513","94080","2014",742,24,718,375434.6,6958.616,53.48652
"27514","94081","2014",494,131,363,230670.1,3773.095,63.04858
"27515","95002","2014",12,11,1,284875,3135,106.25
"27516","95008","2014",8,7,1,279365,1915,144.125
"27517","95011","2014",5,5,0,289580,3029.6,103.8
"27518","95012","2014",1,1,0,109000,1817,60
"27519","95014","2014",28,19,9,332567.2,3410.679,102.3929
"27520","95018","2014",762,335,427,202399.6,3175.621,67.27165
"27521","95019","2014",141,93,48,202423.4,2861.028,74.50355
"27522","95023","2014",6,6,0,242525,2410.833,108.5
"27523","95024","2014",3,3,0,154966.7,1601.333,97.66667
"27524","95026","2014",37,32,5,270208.9,2647.216,110.8919
"27525","95028","2014",12,12,0,257572.5,2707.083,96.58333
"27526","95039","2014",82,62,20,237857.2,3408.402,74.37805
"27527","95040","2014",8,7,1,286750,2700.125,122.75
"27528","95042","2014",12,9,3,244325,2981.167,88.16667
"27529","95046","2014",1,1,0,170000,2000,85
"27530","95051","2014",77,58,19,274288.3,3629.571,80.58442
"27531","95052","2014",96,47,49,182340.2,2712.021,73.61458
"27532","95054","2014",5,5,0,194046,1822.6,106.2
"27533","95055","2014",3,3,0,249000,3411.333,73.33333
"27534","95056","2014",28,25,3,205593.8,2544.036,85.03571
"27535","95058","2014",14,14,0,226257.1,2639.929,87.07143
"27536","95059","2014",6,6,0,195333.3,2957.5,71.66667
"27537","95060","2014",51,36,15,230951,3328.941,74.45098
"27538","95061","2014",9,6,3,267437.8,3406.222,82.66667
"27539","95063","2014",220,114,106,239533.7,3699.045,66.75
"27540","95074","2014",4,3,1,349250,4097.75,108.5
"27541","95078","2014",11,8,3,188498.5,2501.182,76.45455
"27542","95088","2014",6,5,1,226500,3317.5,70.66667
"27543","95091","2014",47,43,4,255038.9,2639.447,97.93617
"27544","95094","2014",1,1,0,220000,2933,75
"27545","95101","2014",7,7,0,173758.6,2334.714,81.14286
"27546","95102","2014",5,5,0,259000,2372.6,108.6
"27547","95110","2014",2,2,0,210000,1920.5,123
"27548","95116","2014",33,29,4,204355.9,2690.636,77.93939
"27549","95119","2014",3,3,0,223333.3,2268.667,99.33333
"27550","95120","2014",17,15,2,252091.2,3648.235,78.05882
"27551","95127","2014",453,125,328,188856.2,2893.135,70.34437
"27552","95134","2014",46,37,9,271381.5,3079.348,93.97826
"27553","95139","2014",1,1,0,208000,2600,80
"27554","95141","2014",1,1,0,110000,2200,50
"27555","95142","2014",21,17,4,200478.6,2448.333,88.85714
"27556","95144","2014",1,1,0,95360,1589,60
"27557","95149","2014",32,31,1,270629.1,2731.875,103.5
"27558","95150","2014",8,8,0,156250,1881.25,84.5
"27559","95151","2014",4,4,0,318325,3379.75,94.25
"27560","95157","2014",2,2,0,276500,1823.5,157
"27561","95169","2014",7,6,1,183457.1,2171.429,85
"27562","95170","2014",3,2,1,175700,3399,54.33333
"27563","95176","2014",235,133,102,278850.6,3634.46,79.62553
"27564","95177","2014",13,12,1,255995.4,2750.692,96.84615
"27565","95181","2014",1,1,0,2e+05,2353,85
"27566","95183","2014",66,39,27,227193.9,2961.576,79.57576
"27567","95197","2014",232,88,144,224823.9,3215.198,72.60345
"27568","95199","2014",148,62,86,228373.9,3083.331,76.22973
"27569","95203","2014",234,123,111,275527.6,3569.449,79.74359
"27570","95205","2014",62,33,29,219482.6,2907.645,77.79032
"27571","95210","2014",147,32,115,299257.1,4260.925,70.91837
"27572","95211","2014",14,14,0,296078.4,2807.857,109.7143
"27573","95213","2014",6,6,0,274316.7,2737.5,101
"27574","95218","2014",136,79,57,241764.7,2969.074,83.06618
"27575","95219","2014",260,93,167,249461.4,3422.696,75.03077
"27576","95229","2014",116,49,67,210670.4,2918.552,74.73276
"27577","95241","2014",19,18,1,226878.9,2654.789,88.31579
"27578","95250","2014",82,78,4,213719.5,2701.707,83.9878
"27579","95252","2014",409,107,302,199015.6,2849.017,70.73594
"27580","95253","2014",5,5,0,281200,2285.6,124.6
"27581","95254","2014",4,4,0,284050,2378.75,121.25
"27582","95256","2014",30,25,5,233917.1,2830.933,87
"27583","95257","2014",42,30,12,278786.7,3949.81,73.2619
"27584","95268","2014",142,50,92,162405.8,2427.542,69.69718
"27585","95270","2014",4,3,1,259875,2257,118.25
"27586","95271","2014",6,6,0,317645.7,3154.833,102.8333
"27587","95277","2014",144,84,60,192553.8,2652.049,76.19444
"27588","95280","2014",198,177,21,195016,2964.253,71.00505
"27589","95282","2014",2,2,0,402500,2918.5,139
"27590","95287","2014",7,7,0,239172.9,3045.857,83.57143
"27591","95288","2014",70,29,41,246554.5,3152.714,78.88571
"27592","95295","2014",1,1,0,238000,2106,113
"27593","95298","2014",9,9,0,320000,2335.111,141.7778
"27594","95301","2014",5,5,0,136205.2,2023.6,86
"27595","95303","2014",2,1,1,121150,2099,57.5
"27596","95304","2014",3,3,0,262000,2902,106
"27597","95306","2014",255,164,91,257255.2,3450.569,78.21961
"27598","95308","2014",6,4,2,269500,3526,86.83333
"27599","95309","2014",1,1,0,272000,2142,127
"27600","95313","2014",123,65,58,291517.5,3677,82.79675
"27601","95316","2014",2,2,0,330000,1944.5,180
"27602","95323","2014",144,124,20,237502.1,2558.333,95.34722
"27603","95328","2014",8,7,1,254925,2729.875,101.75
"27604","95331","2014",1,1,0,278000,2574,108
"27605","95341","2014",6,6,0,284883.3,3431.5,89.33333
"27606","95348","2014",2,2,0,182000,3368.5,66.5
"27607","95351","2014",86,47,39,185409.6,2647.942,72.5
"27608","95352","2014",54,31,23,275130.6,3452.963,80.72222
"27609","95353","2014",22,16,6,253652.3,3234.227,81.95455
"27610","95355","2014",42,36,6,196894.4,2354.333,90.78571
"27611","95365","2014",6,6,0,369071.7,2829.5,139.6667
"27612","95369","2014",36,20,16,315484.6,3493.833,92.77778
"27613","95370","2014",30,24,6,232362.4,2731.8,91.23333
"27614","95371","2014",36,31,5,227154.2,3052.306,83.75
"27615","95379","2014",2,2,0,203500,3145.5,64.5
"27616","95387","2014",1,1,0,225000,2500,90
"27617","95388","2014",45,38,7,222868.3,2658.067,84.48889
"27618","95392","2014",46,38,8,248238.7,3315.087,82.02174
"27619","95394","2014",105,70,35,251194.9,3145.81,84.48571
"27620","95395","2014",6,6,0,245500,2592.833,104
"27621","95409","2014",13,7,6,166427.7,3318,54.46154
"27622","95422","2014",4,3,1,254375,2576,104.5
"27623","95424","2014",160,84,76,207748,2796.55,76.48125
"27624","95426","2014",29,22,7,333051,3363.103,102.3103
"27625","95427","2014",125,52,73,202227.3,2654.896,80.048
"27626","95428","2014",269,98,171,312298.2,3718.606,84.67286
"27627","95429","2014",8,8,0,168712.5,1659.25,99.75
"27628","95430","2014",34,32,2,276097.4,2850.735,101.0882
"27629","95436","2014",10,6,4,218048,2672.2,93
"27630","95438","2014",1,1,0,240000,1714,140
"27631","95445","2014",3,2,1,216000,2808,79
"27632","95446","2014",14,14,0,286007.1,3911.143,83.92857
"27633","95447","2014",2,2,0,193000,2799,77.5
"27634","95450","2014",20,19,1,358142.5,3329.9,113.7
"27635","95452","2014",11,6,5,270009.1,2791.818,94.90909
"27636","95456","2014",5,5,0,224172,2991.2,77.8
"27637","95459","2014",3,3,0,261533.3,3215.667,85.33333
"27638","95462","2014",1,1,0,375000,2500,150
"27639","95476","2014",147,101,46,240624.7,2918.565,88.38776
"27640","95480","2014",57,54,3,270753.3,3129.421,94.85965
"27641","95483","2014",7,7,0,284901,2856.714,104.7143
"27642","95487","2014",63,29,34,178304,2777.222,67.33333
"27643","95488","2014",60,42,18,245535.1,3271.867,82.35
"27644","95489","2014",9,9,0,343094.4,3374.667,103.5556
"27645","95491","2014",103,39,64,226624,3071.252,73.93204
"27646","95493","2014",1,0,1,147000,2450,60
"27647","95500","2014",302,102,200,206840.9,2965.136,73.31788
"27648","95504","2014",45,36,9,243784.8,3236.533,78.17778
"27649","95509","2014",36,32,4,224186.4,2685.694,86.11111
"27650","95510","2014",4,4,0,389787.5,3031.75,128.5
"27651","95523","2014",3,2,1,126666.7,2018.333,61.33333
"27652","95527","2014",16,9,7,239825,3327.25,78.4375
"27653","95529","2014",6,6,0,323333.3,3491.5,100.8333
"27654","95535","2014",9,9,0,274977.8,2719.889,99.66667
"27655","95539","2014",145,64,81,235450,3093.455,77.04828
"27656","95541","2014",10,10,0,159050,1771.3,94.7
"27657","95543","2014",7,7,0,252483.6,2373.429,102.5714
"27658","95554","2014",6,6,0,187300,2913.833,77.33333
"27659","95555","2014",204,63,141,242423.5,3498.672,70.02451
"27660","95563","2014",187,123,64,263380.3,3455.604,80.86096
"27661","95566","2014",22,17,5,219255.5,2514.318,90.95455
"27662","95572","2014",231,93,138,196382.7,2860.359,70.82684
"27663","95574","2014",72,63,9,359720,3599.458,105.625
"27664","95580","2014",23,17,6,348978.7,3052.826,118.2609
"27665","95582","2014",273,103,170,238002.6,3326.432,72.52747
"27666","95584","2014",4,4,0,167762.5,2238.25,76
"27667","95585","2014",244,63,181,154121.5,2257.791,70.52459
"27668","95592","2014",12,12,0,271916.7,2703.583,110.5833
"27669","95594","2014",15,9,6,200517.3,2890.2,78.8
"27670","95598","2014",183,88,95,277578.2,3347.213,85.36612
"27671","95604","2014",38,10,28,172655.3,2475.158,76
"27672","95607","2014",290,124,166,219945.3,3008.183,75.35172
"27673","95610","2014",1,1,0,234000,3120,75
"27674","95612","2014",35,23,12,211245.8,3055.629,73.65714
"27675","95625","2014",22,21,1,240475.5,2462.045,99.04545
"27676","95627","2014",4,3,1,248750,2627.75,100.5
"27677","95628","2014",9,8,1,255333.3,3480.556,82.55556
"27678","95633","2014",4,4,0,242500,1797.25,129
"27679","95637","2014",132,99,33,247278.4,2886.515,89.35606
"27680","95641","2014",26,23,3,223566.5,2857.038,86.5
"27681","95651","2014",10,9,1,206730,2878.8,78.7
"27682","95652","2014",48,45,3,243865.4,3035.833,89.20833
"27683","95656","2014",11,11,0,260448.2,2394.273,112.6364
"27684","95658","2014",4,4,0,280675,3308,87
"27685","95660","2014",3,2,1,276833.3,3051,92
"27686","95675","2014",6,5,1,278366.7,2995.333,97
"27687","95676","2014",8,8,0,217075,2370.375,94.25
"27688","95678","2014",9,9,0,314095.3,3422.889,95.22222
"27689","95680","2014",109,54,55,169073.9,2213.45,79.45872
"27690",NA,"2014",6175,NA,NA,175807.4,2443.387,74.30397
