"","INSEE_COM","Annee","Nb_mutations","NbMaisons","NbApparts","PrixMoyen","Prixm2Moyen","SurfaceMoy"
"1","01001","2015",10,10,0,177600.1,1729.1,104.7
"2","01002","2015",5,5,0,184260,1189,154.6
"3","01004","2015",156,99,57,155901.442307692,1922.19230769231,83.6282051282051
"4","01005","2015",24,18,6,194855.625,1799.25,112.875
"5","01006","2015",2,0,2,82000,924,89
"6","01007","2015",18,17,1,154663.333333333,1641.05555555556,95.8333333333333
"7","01008","2015",13,13,0,186382.307692308,1596.23076923077,120.307692307692
"8","01009","2015",2,2,0,244300,1964,125
"9","01010","2015",25,21,4,170090,1912.88,95.56
"10","01011","2015",4,4,0,162500,1692.75,102
"11","01012","2015",2,2,0,148000,1990,77
"12","01013","2015",5,5,0,114877.4,1301.4,80
"13","01014","2015",29,23,6,150181.034482759,1569.79310344828,96.7586206896552
"14","01015","2015",5,5,0,181400,1356,148.2
"15","01016","2015",5,5,0,129224,1293.2,102.6
"16","01017","2015",6,5,1,97575.8333333333,1084.33333333333,88
"17","01019","2015",1,0,1,55000,743,74
"18","01021","2015",6,5,1,289500,2511.66666666667,116.333333333333
"19","01022","2015",8,8,0,149150,1741.875,87.625
"20","01023","2015",4,4,0,82750,946,91.25
"21","01024","2015",18,15,3,157722.222222222,1709.55555555556,92.2777777777778
"22","01025","2015",32,32,0,173622.8125,1602.34375,115.8125
"23","01026","2015",7,6,1,148567.857142857,1478.71428571429,102.857142857143
"24","01027","2015",12,10,2,214064.833333333,2350.91666666667,97.5
"25","01028","2015",6,6,0,198325,1784.83333333333,110.166666666667
"26","01029","2015",6,6,0,121666.666666667,972.833333333333,134.5
"27","01030","2015",8,4,4,113312.5,1579.375,71.25
"28","01031","2015",19,9,10,123629.473684211,1495.26315789474,78.1578947368421
"29","01032","2015",23,17,6,248624.826086957,2442.78260869565,101.826086956522
"30","01033","2015",121,48,73,180916.20661157,2189.47933884298,84.5702479338843
"31","01034","2015",53,28,25,151044.886792453,1610.94339622642,98.4905660377358
"32","01035","2015",2,2,0,185500,1447.5,123
"33","01036","2015",14,14,0,155655.714285714,1646.78571428571,98.0714285714286
"34","01037","2015",3,3,0,139833.333333333,1291.33333333333,113.666666666667
"35","01038","2015",4,4,0,134837.5,1366,146.5
"36","01039","2015",11,11,0,148713.636363636,1370.36363636364,111
"37","01040","2015",5,5,0,153312,1338.8,137
"38","01041","2015",8,8,0,127420,1431.5,91
"39","01043","2015",38,31,7,296685.868421053,2671.73684210526,114.868421052632
"40","01044","2015",4,4,0,242500,2823.25,78.75
"41","01045","2015",3,3,0,156000,1162.33333333333,133
"42","01046","2015",9,9,0,173412.222222222,1630.66666666667,116.111111111111
"43","01047","2015",10,10,0,249078.6,2126.9,114.9
"44","01049","2015",32,30,2,233849.25,2249.71875,107.625
"45","01050","2015",3,3,0,188788.333333333,1575.66666666667,120.333333333333
"46","01051","2015",4,4,0,49726.25,1267,43.75
"47","01052","2015",4,4,0,268750,2135.75,116.75
"48","01053","2015",462,118,344,125241.313852814,1632.62770562771,77.4329004329004
"49","01054","2015",16,16,0,210947.1875,1864.1875,115.875
"50","01056","2015",3,3,0,91666.6666666667,1118.33333333333,86.6666666666667
"51","01057","2015",6,6,0,122118.333333333,1649,79.8333333333333
"52","01058","2015",11,10,1,124272.727272727,1327.18181818182,88.1818181818182
"53","01060","2015",4,4,0,259400,2271.75,122
"54","01061","2015",17,16,1,170976.352941176,1680.94117647059,102.176470588235
"55","01062","2015",13,13,0,216329.923076923,2198.15384615385,100.076923076923
"56","01063","2015",2,2,0,146000,1574.5,92.5
"57","01064","2015",5,5,0,151408,1470.4,107
"58","01065","2015",15,15,0,210917,1884.13333333333,115.533333333333
"59","01066","2015",2,2,0,25500,597,44.5
"60","01067","2015",2,2,0,123500,1517.5,82.5
"61","01068","2015",10,10,0,85580,1122,77.5
"62","01069","2015",15,10,5,156987.8,1709,90.3333333333333
"63","01071","2015",48,29,19,463311.395833333,4249.41666666667,109.083333333333
"64","01072","2015",32,31,1,188860.28125,1820.375,101.96875
"65","01073","2015",6,5,1,181575,1865,105.666666666667
"66","01074","2015",22,19,3,172310.454545455,1836.36363636364,96.6363636363636
"67","01075","2015",10,10,0,266143.5,2108,128.9
"68","01076","2015",5,4,1,79180,1042.6,79.8
"69","01077","2015",2,2,0,102000,1209.5,85
"70","01078","2015",16,11,5,369428.0625,4029.125,91.875
"71","01079","2015",4,4,0,89705.75,759.75,131
"72","01080","2015",7,7,0,146658.571428571,993.571428571429,148.714285714286
"73","01081","2015",10,9,1,283981,2406.2,119.6
"74","01082","2015",7,6,1,160157.142857143,1588,98
"75","01083","2015",11,11,0,247831.454545455,1842,138.818181818182
"76","01084","2015",11,11,0,215644.545454545,1717.27272727273,136.909090909091
"77","01085","2015",3,3,0,211666.666666667,1926,111.666666666667
"78","01087","2015",1,1,0,224000,2286,98
"79","01088","2015",5,5,0,217393.8,2292.2,102.6
"80","01089","2015",13,13,0,220913.846153846,2013.38461538462,114.076923076923
"81","01090","2015",3,3,0,217866.666666667,1679,137
"82","01092","2015",24,22,2,189966.041666667,2148.91666666667,95.25
"83","01093","2015",45,33,12,193151.777777778,2058.4,95.9111111111111
"84","01094","2015",7,7,0,123415.714285714,1325,91.1428571428571
"85","01095","2015",9,9,0,116555.555555556,1418.55555555556,82.8888888888889
"86","01096","2015",6,6,0,140775,1216.33333333333,108.166666666667
"87","01098","2015",3,3,0,181133.333333333,1774.66666666667,106.333333333333
"88","01099","2015",18,17,1,182119.444444444,1783.72222222222,103.666666666667
"89","01100","2015",1,1,0,235000,3615,65
"90","01101","2015",2,2,0,275000,1861.5,151.5
"91","01102","2015",9,9,0,164634.444444444,1473.66666666667,112.444444444444
"92","01103","2015",8,3,5,331196.75,3432.625,91.75
"93","01104","2015",2,1,1,152531.5,2526.5,55.5
"94","01105","2015",14,13,1,255849.714285714,2174.28571428571,115.357142857143
"95","01106","2015",2,2,0,157042.5,1867.5,85
"96","01108","2015",13,12,1,122242.307692308,1166,100
"97","01109","2015",28,22,6,301628.071428571,3269.64285714286,93.2142857142857
"98","01110","2015",4,3,1,111250,1238.5,92
"99","01111","2015",3,3,0,111733.333333333,1212.66666666667,90
"100","01112","2015",6,6,0,165500,1604.33333333333,103.666666666667
"101","01113","2015",10,10,0,167482.5,1703.2,101.4
"102","01114","2015",3,2,1,301500,2822,111.333333333333
"103","01115","2015",13,11,2,149122.538461538,1451.38461538462,110.153846153846
"104","01116","2015",9,9,0,118877.777777778,1515.11111111111,82.5555555555556
"105","01118","2015",12,12,0,159000.416666667,1697.41666666667,98.0833333333333
"106","01123","2015",6,6,0,182150,1745.16666666667,103.5
"107","01124","2015",8,8,0,117078,1129.125,107.125
"108","01125","2015",7,7,0,98147.5714285714,1313.85714285714,79.2857142857143
"109","01127","2015",3,3,0,164666.666666667,1440,116.666666666667
"110","01128","2015",2,2,0,89500,960,92
"111","01129","2015",3,3,0,167000,2216.33333333333,75.3333333333333
"112","01130","2015",20,20,0,181209.7,1581.85,113.6
"113","01133","2015",7,7,0,126234.714285714,1423.57142857143,85
"114","01134","2015",17,16,1,177817.941176471,1745.35294117647,102.235294117647
"115","01135","2015",19,19,0,566351.631578947,4109.73684210526,137.842105263158
"116","01136","2015",4,4,0,175500,1825.5,94.5
"117","01138","2015",39,28,11,119156.153846154,1437.46153846154,84
"118","01139","2015",7,7,0,131086.428571429,1370.42857142857,107.142857142857
"119","01140","2015",4,4,0,180305,1498.25,126.5
"120","01141","2015",4,4,0,100125,1134,95.25
"121","01142","2015",65,47,18,202082.692307692,2361.95384615385,87.6461538461539
"122","01143","2015",140,60,80,591490.85,5103.56428571429,113.614285714286
"123","01145","2015",6,5,1,186100,1944.33333333333,99.5
"124","01146","2015",1,1,0,151400,2019,75
"125","01147","2015",7,7,0,141825.714285714,1162.42857142857,122
"126","01148","2015",6,6,0,158933.333333333,1415.33333333333,121.5
"127","01149","2015",13,11,2,157359.230769231,1785.07692307692,88.5384615384615
"128","01150","2015",5,5,0,166206,1297.2,119.4
"129","01151","2015",11,11,0,188259.090909091,1594.27272727273,116.909090909091
"130","01152","2015",11,11,0,174783.636363636,1857.09090909091,98.3636363636364
"131","01153","2015",22,19,3,478818.909090909,4141,117.636363636364
"132","01155","2015",5,5,0,95580,882,95.8
"133","01156","2015",5,5,0,189052.8,1629.4,122.6
"134","01157","2015",18,18,0,249234.555555556,2297.16666666667,111.055555555556
"135","01158","2015",9,8,1,310992.777777778,2720.77777777778,107.444444444444
"136","01159","2015",27,22,5,138340.740740741,1381.18518518519,105.111111111111
"137","01160","2015",115,6,109,270944.547826087,3902.97391304348,70.1478260869565
"138","01163","2015",12,11,1,144034.083333333,1675.41666666667,85.8333333333333
"139","01165","2015",14,14,0,205517.285714286,1833.42857142857,113.642857142857
"140","01166","2015",20,17,3,256805,2208.5,118.3
"141","01167","2015",5,5,0,168468.6,2054.4,85.6
"142","01169","2015",5,5,0,214710,2060.6,106
"143","01170","2015",6,5,1,207416.666666667,2159,100.666666666667
"144","01171","2015",2,1,1,107500,1135.5,104.5
"145","01173","2015",121,33,88,306689.388429752,3557.0826446281,85.1157024793388
"146","01174","2015",1,1,0,296860,925,321
"147","01175","2015",1,1,0,165300,1109,149
"148","01177","2015",3,3,0,117566.666666667,1861.66666666667,62
"149","01179","2015",16,16,0,167926.25,1734.1875,99.1875
"150","01180","2015",5,4,1,410600,4773.4,82.6
"151","01181","2015",2,2,0,210500,1707.5,127
"152","01183","2015",12,12,0,233186.666666667,2410.58333333333,93.0833333333333
"153","01184","2015",12,12,0,103010.416666667,1467.91666666667,77.3333333333333
"154","01185","2015",47,38,9,122336.382978723,1161.34042553191,105.914893617021
"155","01187","2015",6,3,3,176830.833333333,1770.83333333333,102
"156","01188","2015",9,9,0,150609.111111111,1647.44444444444,102.777777777778
"157","01189","2015",7,6,1,146742.857142857,1874.28571428571,70.8571428571429
"158","01191","2015",2,2,0,157000,1021.5,158
"159","01192","2015",7,6,1,178944.571428571,1851.71428571429,96.1428571428571
"160","01193","2015",2,2,0,179800,2490,76.5
"161","01194","2015",74,32,42,184247.824324324,2161.77027027027,86.7432432432432
"162","01195","2015",11,10,1,170622.727272727,1563.45454545455,112.636363636364
"163","01196","2015",4,4,0,184220.75,1742.25,106.75
"164","01197","2015",2,2,0,143626,2316.5,64
"165","01198","2015",1,1,0,257000,2380,108
"166","01199","2015",19,17,2,119600,1460.26315789474,84.1578947368421
"167","01200","2015",2,2,0,84000,807,105
"168","01202","2015",77,45,32,153450.337662338,1683.93506493506,92.2857142857143
"169","01203","2015",5,5,0,184540,1754,104.8
"170","01204","2015",8,7,1,185287.5,1604.5,112
"171","01206","2015",4,4,0,136950,1350.25,113.75
"172","01207","2015",2,2,0,349600,2054,170
"173","01208","2015",1,1,0,67425,843,80
"174","01209","2015",10,9,1,254260,2651.8,93.3
"175","01210","2015",12,2,10,89837.5,2420.5,38
"176","01211","2015",10,10,0,245714.6,2137.9,102.5
"177","01212","2015",10,10,0,119077,1082.2,112.6
"178","01213","2015",18,18,0,150919.444444444,1693.66666666667,97.3333333333333
"179","01214","2015",2,2,0,66750,723,78.5
"180","01215","2015",2,2,0,184500,2028,90
"181","01216","2015",2,2,0,137500,1300.5,97.5
"182","01219","2015",1,1,0,60000,1224,49
"183","01224","2015",45,33,12,181091.866666667,2045.57777777778,93.6444444444444
"184","01225","2015",4,2,2,172351.25,1527.75,113.5
"185","01227","2015",8,8,0,173116.25,1403.75,129.5
"186","01228","2015",1,1,0,180000,3103,58
"187","01229","2015",7,7,0,166640,1544.85714285714,103.714285714286
"188","01230","2015",5,5,0,125471.6,1199,108.8
"189","01231","2015",9,8,1,161000,1728.44444444444,101.555555555556
"190","01232","2015",13,13,0,204851.538461538,1796.61538461538,114.230769230769
"191","01233","2015",1,1,0,147600,1135,130
"192","01234","2015",2,2,0,120500,938.5,131
"193","01235","2015",9,9,0,231555.555555556,1888.77777777778,131.888888888889
"194","01236","2015",6,6,0,154383.333333333,1623.33333333333,95.8333333333333
"195","01237","2015",16,14,2,193350.5625,1684.25,108.875
"196","01238","2015",17,15,2,289890,2582.64705882353,113.882352941176
"197","01239","2015",7,7,0,163597.142857143,1875.71428571429,98.2857142857143
"198","01240","2015",10,10,0,106720,1103.5,98.2
"199","01241","2015",9,9,0,197600,1604.66666666667,126
"200","01242","2015",1,1,0,65000,714,91
"201","01243","2015",17,17,0,255645.647058824,2181.05882352941,122.294117647059
"202","01244","2015",63,48,15,195990.714285714,1956.50793650794,100.31746031746
"203","01245","2015",9,9,0,187360,1462.55555555556,127.222222222222
"204","01246","2015",20,18,2,149939.5,1488.7,107.9
"205","01247","2015",15,8,7,199443.466666667,2382.93333333333,76.6666666666667
"206","01248","2015",29,21,8,237213.620689655,2658.06896551724,88.8275862068966
"207","01249","2015",100,64,36,271963.6,2747.64,101.24
"208","01250","2015",19,19,0,225761.578947368,2203.84210526316,103.894736842105
"209","01252","2015",15,15,0,228916.8,1917.73333333333,119.2
"210","01254","2015",9,9,0,253203.333333333,2106.77777777778,122
"211","01255","2015",8,8,0,146217.5,1603.25,92.625
"212","01257","2015",6,6,0,264583.333333333,3140.83333333333,85
"213","01258","2015",12,12,0,223748.166666667,1999.58333333333,112.333333333333
"214","01259","2015",5,5,0,186800,1548.6,126.6
"215","01260","2015",2,2,0,202000,2189,92
"216","01261","2015",4,4,0,235581.25,2260.25,104.5
"217","01262","2015",71,38,33,189745.535211268,2108.94366197183,90.169014084507
"218","01263","2015",36,32,4,211809.166666667,2173.47222222222,98.7222222222222
"219","01264","2015",8,8,0,160812.5,1669.25,106
"220","01265","2015",27,11,16,122678.62962963,1416.51851851852,86.4814814814815
"221","01266","2015",15,9,6,126954.8,1538.26666666667,90.2
"222","01267","2015",4,4,0,163350,1553,110.25
"223","01268","2015",1,1,0,102000,1121,91
"224","01269","2015",25,3,22,92346.8,1133.04,86.76
"225","01272","2015",19,16,3,170832.631578947,1689.26315789474,103.526315789474
"226","01273","2015",16,16,0,179252.1875,1872.125,98.0625
"227","01274","2015",5,5,0,160200,2181,80.2
"228","01275","2015",19,13,6,254122.631578947,2765.21052631579,90.1578947368421
"229","01276","2015",15,14,1,209419.666666667,2155.73333333333,99.1333333333333
"230","01277","2015",2,2,0,87500,1023,85.5
"231","01281","2015",37,24,13,478792.891891892,4344.56756756757,112.891891891892
"232","01282","2015",2,2,0,163450,2043,80
"233","01283","2015",136,62,74,138799,1504.63235294118,89.6911764705882
"234","01284","2015",3,3,0,163343.333333333,1406.66666666667,116.666666666667
"235","01285","2015",12,11,1,233428.333333333,2528.08333333333,91.6666666666667
"236","01286","2015",9,9,0,185077.777777778,1803.33333333333,110.555555555556
"237","01288","2015",27,18,9,420112.962962963,3365.44444444444,125
"238","01289","2015",54,38,16,161420.518518519,1714.31481481481,95.2037037037037
"239","01290","2015",9,7,2,210867.777777778,2373.88888888889,95.1111111111111
"240","01291","2015",5,5,0,185904,2122.4,98.8
"241","01293","2015",2,1,1,130450,1025,119
"242","01294","2015",14,14,0,140752.142857143,1409.21428571429,104.285714285714
"243","01295","2015",8,8,0,182636.25,1672.125,113
"244","01296","2015",2,2,0,77500,754,103.5
"245","01297","2015",9,9,0,209169.555555556,2410.33333333333,89.2222222222222
"246","01298","2015",1,1,0,117000,1232,95
"247","01299","2015",5,5,0,184300,1742,111.4
"248","01301","2015",17,17,0,177808.823529412,1640.94117647059,108.823529411765
"249","01303","2015",20,17,3,107321.25,1224.15,88.95
"250","01304","2015",34,24,10,126901.029411765,1412.85294117647,92
"251","01305","2015",18,12,6,145042.222222222,1366.61111111111,107.777777777778
"252","01306","2015",14,7,7,121002.142857143,1477,82.4285714285714
"253","01307","2015",9,6,3,171923.333333333,1537.55555555556,113.666666666667
"254","01308","2015",3,3,0,384966.666666667,2765.66666666667,150
"255","01310","2015",3,3,0,137200,1400,102.666666666667
"256","01311","2015",2,2,0,129500,1109.5,112.5
"257","01313","2015",93,45,48,423126.784946237,4419.06451612903,95.3010752688172
"258","01314","2015",22,20,2,136513.636363636,1560.04545454545,86.1818181818182
"259","01317","2015",3,3,0,162666.666666667,1368.66666666667,108.333333333333
"260","01318","2015",5,5,0,219776,2157.6,106.4
"261","01319","2015",6,6,0,222825,2051.66666666667,99.1666666666667
"262","01320","2015",27,24,3,195111.518518519,1730.62962962963,113.074074074074
"263","01321","2015",9,9,0,216369.666666667,1824.55555555556,120.222222222222
"264","01322","2015",38,36,2,267982.973684211,2405.65789473684,116.473684210526
"265","01323","2015",9,9,0,137730,1393.44444444444,97.6666666666667
"266","01325","2015",7,7,0,205907.142857143,2510.14285714286,95.1428571428571
"267","01328","2015",3,3,0,166000,1357.66666666667,121
"268","01329","2015",4,4,0,76050,894,89.5
"269","01330","2015",3,3,0,158390,994,148.666666666667
"270","01331","2015",1,1,0,118500,1394,85
"271","01332","2015",5,5,0,161350,1690,94.8
"272","01333","2015",27,22,5,230628.518518519,2419.03703703704,96.7777777777778
"273","01334","2015",3,3,0,124683.333333333,1114,112.666666666667
"274","01335","2015",6,4,2,159258.333333333,1712.66666666667,94
"275","01336","2015",7,6,1,159692.857142857,1620.57142857143,100
"276","01337","2015",16,16,0,148320,1554.6875,97.625
"277","01338","2015",8,8,0,157856.25,1690.375,93.625
"278","01339","2015",15,15,0,287832,2612.2,114.333333333333
"279","01342","2015",5,5,0,292406,2673.8,106.8
"280","01343","2015",13,13,0,207771.923076923,1668.84615384615,126.153846153846
"281","01344","2015",48,31,17,167169.895833333,1789.66666666667,92.8125
"282","01345","2015",25,18,7,146475.2,1581.36,92.64
"283","01346","2015",9,7,2,143594.444444444,1551,95.6666666666667
"284","01347","2015",12,12,0,262199.333333333,2281,111.583333333333
"285","01348","2015",29,27,2,174335.931034483,1605.86206896552,115.586206896552
"286","01349","2015",3,3,0,204533.333333333,1992.66666666667,102.333333333333
"287","01350","2015",21,21,0,206960.476190476,1730.33333333333,123.714285714286
"288","01351","2015",14,13,1,194789.285714286,1785.5,111.285714285714
"289","01352","2015",5,5,0,117700,1364.6,87.2
"290","01353","2015",11,10,1,252825,2453.90909090909,105.090909090909
"291","01354","2015",161,35,126,326174.347826087,3531.6149068323,91.8074534161491
"292","01355","2015",2,2,0,188460,1624,122
"293","01356","2015",6,6,0,177825,1865.5,97.6666666666667
"294","01357","2015",4,4,0,147300,1561,94.25
"295","01358","2015",4,4,0,124850,1385.75,96
"296","01359","2015",5,5,0,263050,2322,123.2
"297","01360","2015",14,10,4,382125,3768.64285714286,101
"298","01361","2015",15,13,2,226113.533333333,2249.6,100.8
"299","01362","2015",10,10,0,254332.2,2286.8,113.4
"300","01363","2015",14,13,1,143105,1456.78571428571,104.5
"301","01364","2015",8,8,0,131025,1373,98.375
"302","01365","2015",10,10,0,167645,1437.2,121
"303","01366","2015",14,14,0,199361.071428571,1692,122.928571428571
"304","01367","2015",9,9,0,165398.888888889,1510.44444444444,111.444444444444
"305","01368","2015",4,4,0,201971.25,1572,125.75
"306","01369","2015",11,7,4,202506.363636364,1510.63636363636,134.454545454545
"307","01370","2015",30,3,27,98104.7,1343.23333333333,74.8
"308","01371","2015",19,11,8,211653.157894737,2467.42105263158,90.8421052631579
"309","01372","2015",3,3,0,150936.666666667,1663,98.3333333333333
"310","01373","2015",6,6,0,158450,1483.5,106.833333333333
"311","01374","2015",18,18,0,177122.666666667,1538.22222222222,115.222222222222
"312","01375","2015",3,3,0,241816.666666667,1632.33333333333,150.666666666667
"313","01376","2015",32,17,15,187831.875,2172.46875,88.65625
"314","01378","2015",25,25,0,219297.8,2061.96,109.68
"315","01379","2015",11,8,3,125790.909090909,1625.27272727273,89.0909090909091
"316","01380","2015",4,4,0,104245,1113.5,89
"317","01381","2015",3,3,0,241666.666666667,1691.66666666667,144.666666666667
"318","01383","2015",12,12,0,213642.916666667,1765.25,128.916666666667
"319","01384","2015",17,13,4,92729.4117647059,1192.05882352941,81.4705882352941
"320","01385","2015",4,4,0,218475,2047.5,108.25
"321","01386","2015",12,9,3,191547.25,1947.66666666667,100.166666666667
"322","01387","2015",4,4,0,202375,1331.25,155.25
"323","01388","2015",11,11,0,116405.818181818,1286.45454545455,91.3636363636364
"324","01389","2015",16,13,3,184558.25,1761,104.625
"325","01390","2015",13,11,2,188684.615384615,1841.46153846154,105.538461538462
"326","01391","2015",3,3,0,87333.3333333333,2751,49.3333333333333
"327","01392","2015",8,8,0,164250,1593.75,102.75
"328","01393","2015",2,2,0,171075,1077,169.5
"329","01396","2015",6,5,1,117214.166666667,1096,112.5
"330","01397","2015",10,10,0,522876,4100.7,125.8
"331","01398","2015",12,11,1,234067,2332.25,99.5
"332","01399","2015",24,19,5,490955.208333333,4176,118.125
"333","01401","2015",17,9,8,406547.470588235,3911.88235294118,107.823529411765
"334","01402","2015",11,11,0,125040,1383.81818181818,88.0909090909091
"335","01403","2015",13,11,2,128704.615384615,1289.30769230769,106.769230769231
"336","01404","2015",2,2,0,44500,1800,25.5
"337","01405","2015",12,11,1,160416.666666667,1709.83333333333,95.1666666666667
"338","01406","2015",1,1,0,84000,1615,52
"339","01407","2015",21,11,10,155639.285714286,1700.66666666667,97.2857142857143
"340","01408","2015",3,3,0,91333.3333333333,1050.66666666667,81.6666666666667
"341","01410","2015",4,4,0,118433.25,901,133.5
"342","01411","2015",1,1,0,166840,2139,78
"343","01412","2015",3,3,0,228800,2267,98.3333333333333
"344","01415","2015",6,5,1,138166.666666667,1642.5,86.5
"345","01416","2015",7,6,1,43804.2857142857,611.857142857143,79.4285714285714
"346","01418","2015",12,11,1,287959.166666667,2944.16666666667,102.666666666667
"347","01419","2015",55,34,21,411228.618181818,3914.56363636364,106.472727272727
"348","01420","2015",16,5,11,104817.5,1683.1875,67.875
"349","01421","2015",5,5,0,130437,1207.2,107.4
"350","01422","2015",14,12,2,180489.428571429,1650.64285714286,110.714285714286
"351","01423","2015",8,8,0,246750,2518.25,97.875
"352","01424","2015",13,12,1,299344.846153846,2405.46153846154,133.230769230769
"353","01425","2015",3,3,0,170333.333333333,1642.33333333333,103
"354","01426","2015",20,20,0,160652,1534.55,104.6
"355","01427","2015",79,40,39,188989.075949367,2134.62025316456,87.126582278481
"356","01428","2015",2,2,0,292325,2896,105.5
"357","01429","2015",3,3,0,171266.666666667,2246.66666666667,80
"358","01430","2015",4,4,0,183050,1430.75,130.5
"359","01431","2015",12,11,1,152570.833333333,1773,89.5833333333333
"360","01432","2015",5,4,1,122716,1269.4,91.8
"361","01433","2015",3,3,0,124000,1421,104.333333333333
"362","01434","2015",4,4,0,268350,1888.75,157
"363","01435","2015",21,16,5,406601.333333333,4001.90476190476,105.52380952381
"364","01436","2015",2,1,1,464450,3633.5,125
"365","01437","2015",1,1,0,882500,6788,130
"366","01441","2015",4,4,0,133450,1357.25,100.75
"367","01443","2015",67,43,24,193084.925373134,2122.05970149254,92.5223880597015
"368","01444","2015",13,12,1,181692.307692308,1658.76923076923,102.384615384615
"369","01445","2015",4,4,0,200350,1797.75,110
"370","01446","2015",15,13,2,221288,1915.66666666667,119.8
"371","01447","2015",14,13,1,132554.642857143,1192.64285714286,117.857142857143
"372","01448","2015",1,1,0,346537,4125,84
"373","01449","2015",8,8,0,174095.625,1833.25,108.875
"374","01450","2015",33,31,2,215691.848484848,2004.57575757576,110.666666666667
"375","01451","2015",36,31,5,170655.777777778,1722.38888888889,101.305555555556
"376","01452","2015",12,9,3,99029.1666666667,1219.16666666667,85.1666666666667
"377","01453","2015",8,8,0,118250,1284.125,90.25
"378","01454","2015",21,18,3,169780.380952381,1625.71428571429,106.047619047619
"379","01456","2015",1,1,0,160000,1301,123
"380","01457","2015",35,30,5,170103.057142857,1609.68571428571,105.971428571429
"381","02001","2015",6,6,0,90250,1198.16666666667,75.3333333333333
"382","02002","2015",3,3,0,132500,1113.33333333333,126.333333333333
"383","02003","2015",4,4,0,172750,1769,97.5
"384","02004","2015",1,1,0,43000,606,71
"385","02005","2015",1,1,0,145050,1495,97
"386","02006","2015",1,1,0,155000,1040,149
"387","02008","2015",3,3,0,142143,1405.33333333333,115
"388","02009","2015",8,8,0,141923.375,1166.75,123.375
"389","02010","2015",3,3,0,105833.333333333,1226.66666666667,89.6666666666667
"390","02011","2015",8,8,0,149625,1303.5,115.375
"391","02013","2015",5,5,0,124260,1326.6,96.2
"392","02014","2015",7,7,0,100714.285714286,1029,93.8571428571429
"393","02015","2015",2,2,0,90000,1416.5,62.5
"394","02016","2015",4,4,0,98325,995.75,96.25
"395","02017","2015",4,4,0,87750,676.25,126
"396","02018","2015",24,24,0,107679.166666667,1259.70833333333,87.7916666666667
"397","02019","2015",5,5,0,96600,1035.2,96.8
"398","02020","2015",3,3,0,119333.333333333,975,135
"399","02021","2015",1,1,0,75000,949,79
"400","02022","2015",3,3,0,53000,642,83.3333333333333
"401","02025","2015",3,3,0,89000,944,95.3333333333333
"402","02027","2015",2,2,0,138500,1622,81.5
"403","02028","2015",23,23,0,128500.869565217,1393.13043478261,95.4347826086957
"404","02029","2015",3,3,0,146100,1241,120
"405","02030","2015",1,1,0,340000,2615,130
"406","02031","2015",5,5,0,87600,748.8,113.6
"407","02032","2015",1,1,0,1e+05,1471,68
"408","02033","2015",3,3,0,148333.333333333,1201,123.333333333333
"409","02034","2015",2,2,0,137500,1419.5,116
"410","02035","2015",2,2,0,131250,642,173.5
"411","02036","2015",1,1,0,50000,1111,45
"412","02037","2015",15,15,0,127386.666666667,1244.6,100.6
"413","02039","2015",1,1,0,130000,1182,110
"414","02040","2015",8,8,0,110300,968.875,123
"415","02041","2015",9,9,0,120555.555555556,1332.55555555556,93.7777777777778
"416","02042","2015",2,2,0,37500,1695.5,22
"417","02043","2015",1,1,0,2e+05,1538,130
"418","02046","2015",7,7,0,89142.8571428571,1225.42857142857,73.8571428571429
"419","02047","2015",1,1,0,40000,444,90
"420","02048","2015",1,1,0,160000,1649,97
"421","02049","2015",5,5,0,145800,1261.4,108.8
"422","02050","2015",4,4,0,95750,1118.5,88
"423","02051","2015",2,2,0,130750,1537,85
"424","02052","2015",1,1,0,58000,866,67
"425","02053","2015",4,4,0,113215,1127.75,97
"426","02054","2015",7,7,0,130728.571428571,1572.85714285714,83.1428571428571
"427","02056","2015",2,2,0,91500,1029,88
"428","02057","2015",14,14,0,71885.7142857143,720.714285714286,102.571428571429
"429","02058","2015",8,7,1,167250,1112.25,148.75
"430","02059","2015",14,13,1,75864.2857142857,1014.28571428571,79.5
"431","02060","2015",3,3,0,109000,1188,92
"432","02061","2015",2,2,0,61000,478,129
"433","02062","2015",3,3,0,158666.666666667,1393.33333333333,118.666666666667
"434","02063","2015",4,4,0,80000,1018.75,79
"435","02064","2015",24,24,0,119675.833333333,1417.58333333333,84.4166666666667
"436","02065","2015",3,3,0,107166.666666667,842,129.666666666667
"437","02066","2015",1,1,0,147500,1317,112
"438","02067","2015",3,3,0,155000,1078.66666666667,150
"439","02068","2015",1,1,0,80000,1111,72
"440","02069","2015",1,1,0,124000,821,151
"441","02071","2015",3,3,0,66666.6666666667,1160,55.3333333333333
"442","02072","2015",2,2,0,62500,649.5,96.5
"443","02073","2015",6,6,0,151500,1992.83333333333,88.6666666666667
"444","02074","2015",5,5,0,123258,1261.4,96.6
"445","02076","2015",1,1,0,2e+05,1923,104
"446","02077","2015",6,5,1,114163.333333333,1426.33333333333,81.3333333333333
"447","02078","2015",1,1,0,75000,882,85
"448","02079","2015",2,2,0,125600,906,135
"449","02080","2015",4,4,0,219675,1469.75,150.5
"450","02081","2015",3,3,0,127733.333333333,1419.66666666667,101.666666666667
"451","02083","2015",10,10,0,165210,1272.8,127.2
"452","02084","2015",1,1,0,226000,2825,80
"453","02085","2015",11,11,0,159985,1710.45454545455,95.6363636363636
"454","02086","2015",8,8,0,106250,1027.125,109.625
"455","02089","2015",8,8,0,119038.5,1370.5,88.75
"456","02090","2015",1,1,0,125000,887,141
"457","02093","2015",16,14,2,122875,1659.1875,83.5
"458","02094","2015",4,4,0,213425,2387.25,85.5
"459","02095","2015",54,53,1,63557.4074074074,802.092592592593,86.1111111111111
"460","02096","2015",4,4,0,79625,878.5,90.5
"461","02097","2015",1,1,0,65000,464,140
"462","02098","2015",3,3,0,90000,1742.33333333333,51
"463","02099","2015",5,5,0,119400,896,133.6
"464","02101","2015",3,3,0,80000,874.333333333333,96.6666666666667
"465","02103","2015",13,13,0,82811.5384615385,939.615384615385,90.6923076923077
"466","02105","2015",3,3,0,123333.333333333,1651.33333333333,74.6666666666667
"467","02106","2015",5,5,0,83460,1242.8,71.8
"468","02108","2015",2,2,0,103000,1648.5,63
"469","02109","2015",3,3,0,71666.6666666667,794.666666666667,99
"470","02110","2015",24,24,0,121008.333333333,1343.75,94.7083333333333
"471","02111","2015",8,8,0,115162.5,1310.25,89.5
"472","02112","2015",5,5,0,82400,816.4,104.4
"473","02114","2015",10,10,0,127471.1,1531.8,94.7
"474","02115","2015",2,2,0,68500,1017,67
"475","02119","2015",2,2,0,132000,1704.5,83
"476","02120","2015",1,1,0,95000,1105,86
"477","02123","2015",1,1,0,125000,1116,112
"478","02124","2015",6,6,0,85333.3333333333,937,87.8333333333333
"479","02125","2015",2,2,0,132500,1295,102
"480","02126","2015",2,2,0,51500,583,88
"481","02127","2015",2,2,0,172627.5,1534.5,108
"482","02128","2015",8,8,0,132893.75,1102,121.75
"483","02130","2015",2,2,0,101000,821,123
"484","02131","2015",19,19,0,137386.842105263,1380.94736842105,100.894736842105
"485","02132","2015",1,1,0,36000,766,47
"486","02133","2015",3,3,0,73933.3333333333,1729.66666666667,47.3333333333333
"487","02134","2015",6,6,0,90833.3333333333,951,85
"488","02135","2015",15,15,0,106906,939.333333333333,107.066666666667
"489","02136","2015",1,1,0,120000,1091,110
"490","02137","2015",1,1,0,110000,1375,80
"491","02138","2015",1,1,0,175000,1136,154
"492","02139","2015",4,4,0,142075,1300,111
"493","02140","2015",3,3,0,83333.3333333333,830,105.333333333333
"494","02141","2015",13,13,0,90585.9230769231,802.615384615385,118.923076923077
"495","02142","2015",3,3,0,96666.6666666667,905.333333333333,92.3333333333333
"496","02143","2015",2,2,0,57500,585.5,98
"497","02145","2015",5,5,0,113700,1172.4,95.2
"498","02149","2015",1,1,0,132500,1380,96
"499","02151","2015",3,3,0,115666.666666667,990.666666666667,93
"500","02152","2015",1,1,0,130000,839,155
"501","02153","2015",5,5,0,128000,1123.2,117.4
"502","02154","2015",4,4,0,108250,1273.5,87.5
"503","02155","2015",3,3,0,114666.666666667,1379.33333333333,83.3333333333333
"504","02156","2015",2,2,0,61250,785.5,79.5
"505","02157","2015",4,4,0,146500,1502.25,95
"506","02158","2015",6,6,0,118583.333333333,1367.16666666667,86
"507","02159","2015",2,2,0,84500,791,107.5
"508","02160","2015",2,2,0,125000,716.5,175.5
"509","02162","2015",2,2,0,163250,1598.5,102.5
"510","02163","2015",10,10,0,137665,1461.7,90.2
"511","02164","2015",2,2,0,133500,1552.5,87
"512","02165","2015",21,21,0,93904.7619047619,980.714285714286,100.952380952381
"513","02166","2015",3,3,0,115333.333333333,1802.33333333333,65
"514","02167","2015",8,8,0,103537.5,1103,94.625
"515","02168","2015",98,58,40,123761.693877551,1588.78571428571,79.3673469387755
"516","02169","2015",1,1,0,40800,756,54
"517","02170","2015",1,1,0,153500,1096,140
"518","02171","2015",1,1,0,188000,1469,128
"519","02172","2015",4,4,0,132962.5,1368.5,100.75
"520","02173","2015",118,102,16,115783.186440678,1231.34745762712,95.6949152542373
"521","02174","2015",10,10,0,100150,1180.5,85.6
"522","02175","2015",3,3,0,87666.6666666667,861,102.666666666667
"523","02176","2015",1,1,0,140000,1400,100
"524","02178","2015",1,1,0,102500,795,129
"525","02179","2015",1,1,0,101000,1554,65
"526","02180","2015",5,5,0,76500,896.2,85.6
"527","02183","2015",1,1,0,140000,1556,90
"528","02185","2015",3,3,0,184333.333333333,1616.66666666667,114.333333333333
"529","02186","2015",14,13,1,140678.571428571,1851.07142857143,80.6428571428571
"530","02187","2015",18,17,1,157341.333333333,1736.33333333333,93.3888888888889
"531","02188","2015",2,2,0,57500,642,86
"532","02189","2015",6,6,0,106559.833333333,1135,93.3333333333333
"533","02190","2015",6,6,0,178016.666666667,1710.16666666667,107
"534","02191","2015",2,2,0,89575,1317.5,70
"535","02192","2015",6,6,0,140000,992.333333333333,156
"536","02193","2015",1,1,0,322500,2389,135
"537","02194","2015",2,2,0,41500,620,69
"538","02195","2015",8,8,0,178306.25,1536.75,117.25
"539","02196","2015",4,4,0,119750,1236.5,97.5
"540","02197","2015",3,3,0,112000,1441.33333333333,77.3333333333333
"541","02198","2015",3,3,0,134666.666666667,1366.33333333333,98
"542","02199","2015",7,7,0,102428.571428571,1025.28571428571,92.8571428571429
"543","02201","2015",10,10,0,152600,1314.7,128.2
"544","02203","2015",13,13,0,90230.7692307692,1083.76923076923,80.6923076923077
"545","02204","2015",3,3,0,81200,1075.33333333333,81
"546","02205","2015",3,3,0,136400,1368,103.666666666667
"547","02207","2015",5,5,0,127980,1541.6,84.4
"548","02208","2015",1,1,0,155000,1449,107
"549","02209","2015",2,2,0,99355,1085.5,88.5
"550","02210","2015",3,3,0,153900,1059,145.666666666667
"551","02211","2015",1,1,0,105100,1401,75
"552","02212","2015",5,5,0,89200,1194.6,80.6
"553","02214","2015",2,2,0,50500,653.5,76
"554","02215","2015",10,10,0,122898.5,1292.7,94.7
"555","02216","2015",4,4,0,152875,1644.25,93.5
"556","02217","2015",8,8,0,82200,1133.625,75.625
"557","02218","2015",4,4,0,107700,1044.75,101.75
"558","02220","2015",2,2,0,181000,1190,151
"559","02222","2015",1,1,0,135000,794,170
"560","02223","2015",5,5,0,191400,1338.8,108.4
"561","02224","2015",2,2,0,122500,1805.5,66
"562","02225","2015",1,1,0,155000,963,161
"563","02226","2015",24,22,2,130009.333333333,1359.08333333333,97.4166666666667
"564","02228","2015",1,1,0,158000,1436,110
"565","02229","2015",2,2,0,97750,1103,87.5
"566","02230","2015",2,2,0,47500,589.5,80.5
"567","02231","2015",7,7,0,109357.142857143,1250.14285714286,88
"568","02232","2015",4,4,0,180250,1938,98.25
"569","02233","2015",2,2,0,150000,1263.5,115.5
"570","02234","2015",1,1,0,92000,939,98
"571","02235","2015",1,1,0,210000,1180,178
"572","02236","2015",3,3,0,125333.333333333,1097.66666666667,115
"573","02237","2015",8,8,0,76250,808.625,97.625
"574","02238","2015",21,21,0,118242.857142857,1160.14285714286,109.142857142857
"575","02239","2015",11,11,0,141497.818181818,1359.72727272727,103.636363636364
"576","02240","2015",2,2,0,80750,976,85.5
"577","02241","2015",1,1,0,70000,875,80
"578","02242","2015",5,5,0,69545,975.6,72.8
"579","02243","2015",25,23,2,126988,1513.04,86.36
"580","02245","2015",16,16,0,128293.75,1414.375,92.125
"581","02246","2015",5,5,0,86200,976.4,82
"582","02248","2015",1,1,0,77000,906,85
"583","02249","2015",1,1,0,340000,1360,250
"584","02251","2015",1,1,0,145000,1115,130
"585","02253","2015",7,7,0,128314.285714286,1417.42857142857,97
"586","02254","2015",2,2,0,1e+05,1141.5,86.5
"587","02255","2015",1,1,0,53000,815,65
"588","02257","2015",8,8,0,177312.5,1648,119.625
"589","02258","2015",5,5,0,174200,1718.2,100.4
"590","02259","2015",8,8,0,195331.25,1866.5,121.5
"591","02260","2015",5,5,0,56000,908.6,63.2
"592","02261","2015",7,7,0,81571.4285714286,816.428571428571,95.4285714285714
"593","02262","2015",1,1,0,80000,1000,80
"594","02263","2015",2,2,0,107000,903,119.5
"595","02264","2015",2,2,0,76500,994.5,77.5
"596","02265","2015",1,1,0,110000,815,135
"597","02267","2015",1,1,0,255000,2629,97
"598","02268","2015",7,7,0,133142.857142857,1682.14285714286,81.2857142857143
"599","02269","2015",2,2,0,128750,776.5,167.5
"600","02270","2015",1,1,0,117000,2786,42
"601","02271","2015",1,1,0,128050,1094,117
"602","02272","2015",2,2,0,120000,1144.5,105
"603","02275","2015",3,3,0,48000,574.666666666667,80.3333333333333
"604","02276","2015",2,2,0,125000,747.5,167.5
"605","02277","2015",6,6,0,138403.333333333,1573.83333333333,94.6666666666667
"606","02279","2015",8,8,0,119875,1162.625,107.125
"607","02280","2015",5,5,0,144600,1470,100.2
"608","02281","2015",2,2,0,59250,826.5,70.5
"609","02282","2015",5,5,0,115100,925.8,124.8
"610","02283","2015",3,3,0,93400,1001.66666666667,90
"611","02284","2015",2,2,0,89000,672.5,137.5
"612","02286","2015",6,6,0,69533.3333333333,702,96.8333333333333
"613","02287","2015",15,15,0,131963.333333333,1153.6,117.266666666667
"614","02288","2015",5,5,0,95000,833.2,124.2
"615","02289","2015",14,14,0,137085.714285714,1536,90.7142857142857
"616","02290","2015",22,22,0,198131.818181818,2083.5,99.2727272727273
"617","02291","2015",3,3,0,86000,606.333333333333,130
"618","02292","2015",4,4,0,157250,2103.25,73
"619","02293","2015",4,4,0,87925,875.5,98.5
"620","02294","2015",1,1,0,150000,1648,91
"621","02295","2015",11,11,0,74217.0909090909,679.727272727273,111.727272727273
"622","02296","2015",7,7,0,121928.571428571,1035.28571428571,111.857142857143
"623","02298","2015",10,10,0,91375,964.6,99.6
"624","02299","2015",5,5,0,147060,1509.2,102.8
"625","02302","2015",4,4,0,139000,1683.25,84.75
"626","02303","2015",8,8,0,177331.875,1510.25,111.75
"627","02304","2015",22,17,5,76727.2727272727,798.318181818182,94.3181818181818
"628","02305","2015",20,19,1,107825,1202.5,93
"629","02306","2015",5,5,0,64200,742.2,86.4
"630","02307","2015",24,23,1,123389.083333333,1686.95833333333,79.75
"631","02308","2015",4,4,0,76875,957.25,80.5
"632","02309","2015",5,5,0,138100,1391,102.8
"633","02310","2015",4,4,0,82250,881.75,92.25
"634","02311","2015",1,1,0,189000,1929,98
"635","02312","2015",7,7,0,108742.857142857,962,119.428571428571
"636","02313","2015",4,4,0,92000,901.5,104.25
"637","02315","2015",16,16,0,133011.875,1058.625,123.5
"638","02316","2015",1,1,0,210000,1615,130
"639","02317","2015",3,3,0,112666.666666667,1255.33333333333,82.6666666666667
"640","02318","2015",19,18,1,94505.2631578947,1190.42105263158,87.1052631578947
"641","02319","2015",5,5,0,112020,772.2,141
"642","02320","2015",2,2,0,164500,1482,113
"643","02321","2015",10,10,0,105000,847.4,131.2
"644","02322","2015",3,3,0,94000,715.333333333333,129.666666666667
"645","02323","2015",1,1,0,140000,1667,84
"646","02324","2015",2,2,0,104867,739,143.5
"647","02326","2015",7,7,0,165357.142857143,1483.71428571429,116.428571428571
"648","02328","2015",2,2,0,142500,1231,106.5
"649","02329","2015",2,2,0,71300,831.5,103.5
"650","02330","2015",5,5,0,130780,1314.4,100.8
"651","02331","2015",1,1,0,80000,576,139
"652","02332","2015",2,2,0,142500,1861.5,85.5
"653","02333","2015",2,2,0,112500,1681,95.5
"654","02334","2015",14,14,0,78250,822.285714285714,92.8571428571429
"655","02335","2015",1,1,0,60000,923,65
"656","02336","2015",5,5,0,122000,1030.2,116.2
"657","02337","2015",1,1,0,51000,864,59
"658","02338","2015",1,1,0,93000,1081,86
"659","02339","2015",8,7,1,118259,1355.375,86
"660","02340","2015",54,54,0,100731.037037037,1132.98148148148,90.8888888888889
"661","02341","2015",4,4,0,58537.5,639,91
"662","02342","2015",1,1,0,298500,3731,80
"663","02346","2015",3,3,0,105333.333333333,1029.33333333333,105
"664","02347","2015",1,1,0,94000,1808,52
"665","02351","2015",2,2,0,130925,1324,97.5
"666","02352","2015",5,5,0,112900,892.6,132.8
"667","02353","2015",3,3,0,54500,768.333333333333,70.3333333333333
"668","02355","2015",20,20,0,126538.9,1234.2,99.85
"669","02356","2015",3,3,0,104833.333333333,1621.66666666667,77
"670","02358","2015",2,2,0,60000,630,95
"671","02359","2015",7,7,0,158351.428571429,1521.42857142857,103.714285714286
"672","02360","2015",24,24,0,161839.583333333,1683.91666666667,98.1666666666667
"673","02361","2015",31,31,0,77841.935483871,837.225806451613,92
"674","02362","2015",1,1,0,34000,453,75
"675","02363","2015",2,2,0,70250,1153.5,73
"676","02364","2015",1,1,0,170600,1917,89
"677","02366","2015",2,2,0,74000,602,136.5
"678","02368","2015",5,5,0,165400,1649.4,106
"679","02369","2015",3,3,0,79976.6666666667,793.333333333333,94.3333333333333
"680","02370","2015",6,6,0,75833.3333333333,785.166666666667,92.6666666666667
"681","02371","2015",14,14,0,144553.571428571,1515.42857142857,90.6428571428571
"682","02372","2015",6,6,0,118666.666666667,1433.33333333333,84.3333333333333
"683","02373","2015",4,4,0,147500,1007.5,125.75
"684","02374","2015",2,2,0,120000,1348.5,89
"685","02375","2015",1,1,0,95000,621,153
"686","02376","2015",2,2,0,71250,727,98
"687","02377","2015",1,1,0,53000,427,124
"688","02378","2015",1,1,0,18000,346,52
"689","02379","2015",1,1,0,168000,1826,92
"690","02381","2015",52,51,1,66778.8461538462,725.75,89.9615384615385
"691","02382","2015",7,7,0,115285.714285714,1115.14285714286,103
"692","02383","2015",9,9,0,140205.555555556,1377.22222222222,113.888888888889
"693","02386","2015",1,1,0,110000,1100,100
"694","02387","2015",8,8,0,160384.625,1427.125,114.25
"695","02388","2015",1,1,0,50000,746,67
"696","02389","2015",4,4,0,161625,1021.75,143
"697","02390","2015",2,2,0,76000,619.5,125
"698","02391","2015",3,3,0,93000,783.666666666667,123
"699","02392","2015",1,1,0,102000,675,151
"700","02393","2015",1,1,0,159600,887,180
"701","02396","2015",2,2,0,141000,1012,142.5
"702","02397","2015",5,5,0,102200,1029.2,104.2
"703","02399","2015",5,5,0,118740,1267.2,97.2
"704","02401","2015",3,3,0,70000,748,95.3333333333333
"705","02403","2015",1,1,0,86000,977,88
"706","02405","2015",5,5,0,121430,1099,111.2
"707","02406","2015",2,2,0,118000,2162,57
"708","02407","2015",5,5,0,148340,1299.2,118
"709","02408","2015",167,113,54,95406.6826347305,1151.4371257485,84.5209580838323
"710","02410","2015",4,4,0,164000,2058,88
"711","02411","2015",4,4,0,133750,1121.25,120
"712","02412","2015",1,1,0,67000,1811,37
"713","02413","2015",1,1,0,2e+05,935,214
"714","02415","2015",3,3,0,241333.333333333,1863.33333333333,117.666666666667
"715","02416","2015",5,5,0,101760,1304,79
"716","02418","2015",2,2,0,64500,998.5,68.5
"717","02419","2015",1,1,0,123600,824,150
"718","02420","2015",11,11,0,148128.181818182,1282,117.545454545455
"719","02422","2015",5,5,0,88730,1009.4,88.6
"720","02423","2015",3,3,0,149666.666666667,1047.33333333333,137.666666666667
"721","02424","2015",1,1,0,156000,1147,136
"722","02426","2015",2,2,0,60000,804.5,65.5
"723","02427","2015",2,2,0,126000,1023,125
"724","02429","2015",1,1,0,62490,812,77
"725","02430","2015",6,6,0,96765,1179.66666666667,81.6666666666667
"726","02431","2015",5,5,0,79870,1136,74.2
"727","02432","2015",1,1,0,144250,2003,72
"728","02433","2015",2,2,0,63000,786,80
"729","02438","2015",6,6,0,129166.666666667,1427.33333333333,98.8333333333333
"730","02439","2015",15,15,0,120264,1100.2,113.666666666667
"731","02440","2015",1,1,0,150000,1596,94
"732","02441","2015",3,3,0,216666.666666667,1165.33333333333,186.666666666667
"733","02442","2015",1,1,0,1e+05,1087,92
"734","02443","2015",2,2,0,152250,1019,149.5
"735","02444","2015",2,2,0,51500,459.5,112.5
"736","02445","2015",2,2,0,127000,935,138
"737","02446","2015",1,1,0,160000,941,170
"738","02450","2015",4,4,0,61730,727,82
"739","02451","2015",1,1,0,30000,417,72
"740","02452","2015",2,2,0,112500,735,153
"741","02453","2015",4,4,0,143750,1149.25,147.5
"742","02454","2015",5,5,0,141480,1155.6,126.4
"743","02455","2015",2,2,0,130000,1230,108.5
"744","02456","2015",1,1,0,138000,1266,109
"745","02457","2015",2,2,0,84400,1097.5,77.5
"746","02458","2015",20,20,0,144850,1362.9,115.7
"747","02459","2015",2,2,0,72500,670,113.5
"748","02460","2015",5,5,0,76320,870,94.6
"749","02461","2015",7,7,0,91714.2857142857,1144.71428571429,81.7142857142857
"750","02462","2015",3,3,0,81000,852.333333333333,91
"751","02463","2015",1,1,0,92000,876,105
"752","02464","2015",2,2,0,135000,1295.5,107
"753","02465","2015",6,6,0,157833.333333333,1546.66666666667,107.333333333333
"754","02467","2015",2,2,0,135000,1290.5,105.5
"755","02468","2015",18,18,0,88861.1111111111,930.777777777778,97
"756","02469","2015",5,5,0,80600,761,116.8
"757","02470","2015",3,3,0,94400,755,121
"758","02471","2015",2,2,0,120000,1342.5,93.5
"759","02472","2015",2,2,0,74250,832.5,86.5
"760","02473","2015",4,4,0,154712.5,1216.25,122.25
"761","02474","2015",4,4,0,115375,1245.75,93
"762","02476","2015",5,5,0,73740,714.6,101.2
"763","02477","2015",8,8,0,154662.25,1789.625,87.25
"764","02478","2015",2,2,0,172500,1162.5,162.5
"765","02480","2015",4,4,0,66000,904.5,78.25
"766","02481","2015",3,3,0,183460,1305.66666666667,137.666666666667
"767","02482","2015",1,1,0,38000,760,50
"768","02483","2015",6,6,0,107583.333333333,1074.33333333333,101.666666666667
"769","02484","2015",2,2,0,99000,906,113
"770","02485","2015",2,2,0,175000,920,187
"771","02486","2015",1,1,0,65000,929,70
"772","02487","2015",9,8,1,137555.666666667,1484.77777777778,99.2222222222222
"773","02488","2015",2,2,0,64000,763.5,95.5
"774","02489","2015",2,2,0,141000,1581.5,90.5
"775","02490","2015",1,1,0,195000,747,261
"776","02491","2015",1,1,0,58000,892,65
"777","02492","2015",1,1,0,45000,529,85
"778","02493","2015",5,5,0,100200,922.6,111
"779","02494","2015",3,3,0,105666.666666667,1315.33333333333,83
"780","02495","2015",11,11,0,86636.3636363636,855.545454545455,109.545454545455
"781","02497","2015",13,13,0,147800,1346.92307692308,114.153846153846
"782","02498","2015",4,4,0,102625,927.25,112.5
"783","02500","2015",7,7,0,119210,967.857142857143,118.857142857143
"784","02502","2015",9,8,1,79777.7777777778,778.444444444444,105.222222222222
"785","02503","2015",7,7,0,135571.428571429,1015.14285714286,124.285714285714
"786","02504","2015",18,18,0,108208.611111111,1095.33333333333,99.2777777777778
"787","02505","2015",4,4,0,96968,1700.75,60.75
"788","02506","2015",3,3,0,181333.333333333,2443.33333333333,76.6666666666667
"789","02508","2015",2,2,0,132000,1375,96
"790","02509","2015",2,2,0,140650,1666.5,84.5
"791","02511","2015",3,3,0,111333.333333333,933,103
"792","02512","2015",6,6,0,122333.333333333,1447,86
"793","02513","2015",2,2,0,71500,642.5,122.5
"794","02514","2015",7,7,0,181142.857142857,1605.28571428571,111.142857142857
"795","02515","2015",1,1,0,138000,1551,89
"796","02517","2015",2,2,0,80500,767.5,119
"797","02518","2015",3,3,0,108500,1007.33333333333,101.666666666667
"798","02519","2015",2,2,0,96500,941,102.5
"799","02520","2015",5,5,0,107644,1052.4,98.2
"800","02521","2015",15,15,0,172890.333333333,1559.66666666667,109.133333333333
"801","02522","2015",1,1,0,55000,1058,52
"802","02523","2015",1,1,0,157850,1315,120
"803","02524","2015",8,8,0,158600,1655.625,104.875
"804","02525","2015",5,5,0,170900,1702.8,108.4
"805","02527","2015",8,8,0,109012.5,1274.125,88.625
"806","02528","2015",4,4,0,132062.5,1582,83
"807","02529","2015",2,2,0,89375,843.5,116
"808","02530","2015",1,1,0,105000,1615,65
"809","02531","2015",2,2,0,131500,1393,96.5
"810","02532","2015",12,12,0,123617.916666667,1056.16666666667,115.166666666667
"811","02535","2015",3,3,0,45333.3333333333,579.333333333333,80
"812","02536","2015",1,1,0,110000,859,128
"813","02537","2015",4,4,0,175700,2209,86
"814","02538","2015",2,2,0,80700,1112.5,68.5
"815","02539","2015",11,11,0,88060.9090909091,978.272727272727,101.636363636364
"816","02540","2015",6,6,0,170625,1732.16666666667,101.666666666667
"817","02541","2015",4,4,0,114625,1153,95.75
"818","02543","2015",20,19,1,118099.5,1371.55,86.75
"819","02544","2015",8,8,0,101787.5,1243.75,80
"820","02545","2015",1,1,0,68000,389,175
"821","02546","2015",4,4,0,103000,955.5,108
"822","02547","2015",1,1,0,52600,877,60
"823","02548","2015",5,5,0,133100,1708.2,123
"824","02549","2015",12,12,0,119545,1148.83333333333,109.333333333333
"825","02550","2015",1,1,0,163400,1816,90
"826","02551","2015",1,1,0,179000,1455,123
"827","02552","2015",2,2,0,90000,703,127.5
"828","02554","2015",10,9,1,156761.5,1526.4,109.1
"829","02555","2015",23,20,3,117170.434782609,1475.91304347826,78.5652173913043
"830","02558","2015",16,16,0,80825,777,106.0625
"831","02559","2015",7,7,0,51342.8571428571,902.857142857143,71.1428571428571
"832","02560","2015",5,5,0,72300,1030.4,80
"833","02561","2015",2,2,0,151500,1687,102.5
"834","02562","2015",2,2,0,110750,1097.5,99.5
"835","02563","2015",2,2,0,59500,703,86
"836","02564","2015",7,7,0,161650.142857143,1374.57142857143,118.714285714286
"837","02566","2015",14,14,0,136657.142857143,1228.5,115.071428571429
"838","02567","2015",2,2,0,71000,812.5,88
"839","02568","2015",2,2,0,430100,2187,242.5
"840","02569","2015",8,8,0,69178.5,785.125,86.25
"841","02570","2015",2,2,0,60500,984.5,61
"842","02571","2015",5,5,0,114187,1234.2,89.6
"843","02572","2015",4,4,0,150650,1835.25,89
"844","02573","2015",2,2,0,151000,1246.5,119
"845","02574","2015",12,12,0,92472.9166666667,905,101.5
"846","02575","2015",16,16,0,59769.9375,779.5625,77.3125
"847","02576","2015",4,4,0,170962.5,1630.5,126
"848","02577","2015",2,2,0,80000,1607.5,56.5
"849","02579","2015",1,1,0,117000,1300,90
"850","02580","2015",11,11,0,107000,1230.18181818182,93.8181818181818
"851","02581","2015",5,5,0,109800,1420.4,79.4
"852","02582","2015",1,1,0,55000,3667,15
"853","02585","2015",3,3,0,145333.333333333,1189.66666666667,129.666666666667
"854","02586","2015",2,2,0,65000,777.5,83
"855","02587","2015",4,4,0,105750,1057,101.5
"856","02589","2015",6,6,0,144500,1245.83333333333,119.5
"857","02590","2015",1,1,0,140000,1167,120
"858","02591","2015",3,3,0,90666.6666666667,794.666666666667,105
"859","02593","2015",6,6,0,146666.666666667,1501.5,97.1666666666667
"860","02596","2015",11,11,0,125409.090909091,1396.09090909091,95.7272727272727
"861","02598","2015",10,10,0,116883.2,1665.1,82.2
"862","02599","2015",5,5,0,117800,1254.4,92.4
"863","02600","2015",5,5,0,120800,963.2,133.4
"864","02601","2015",1,1,0,186200,1201,155
"865","02602","2015",11,11,0,119190.909090909,1230.18181818182,93.6363636363636
"866","02605","2015",2,2,0,80250,747,107
"867","02607","2015",2,2,0,175500,1511,116.5
"868","02608","2015",6,6,0,70300,772.333333333333,86.3333333333333
"869","02610","2015",7,7,0,147207.142857143,1477.57142857143,102.571428571429
"870","02613","2015",9,9,0,146600,1632,92.4444444444444
"871","02614","2015",3,3,0,96666.6666666667,794.666666666667,119
"872","02615","2015",3,3,0,192833.333333333,1193.66666666667,160.666666666667
"873","02616","2015",1,1,0,58000,372,156
"874","02617","2015",5,5,0,81800,672.6,119.4
"875","02618","2015",10,10,0,86050,758.7,110.6
"876","02619","2015",1,1,0,72000,828,87
"877","02620","2015",2,2,0,47500,420.5,113
"878","02621","2015",6,6,0,154850,1266.66666666667,126.5
"879","02622","2015",2,2,0,94125,980.5,95
"880","02623","2015",1,1,0,129000,2150,60
"881","02624","2015",8,8,0,68062.5,751.5,85.25
"882","02625","2015",1,1,0,58000,580,100
"883","02626","2015",3,3,0,194250,958,207
"884","02628","2015",3,3,0,135000,1535,98.3333333333333
"885","02629","2015",1,1,0,135000,823,164
"886","02631","2015",2,2,0,237250,1554,188
"887","02633","2015",1,1,0,72000,783,92
"888","02634","2015",1,1,0,1e+05,1149,87
"889","02635","2015",4,4,0,95462.5,1000.75,94.5
"890","02636","2015",1,1,0,105500,787,134
"891","02637","2015",3,3,0,156133.333333333,1010,149.333333333333
"892","02638","2015",4,4,0,75000,970.75,78
"893","02639","2015",5,5,0,118770,1437.8,83.8
"894","02640","2015",1,1,0,50000,417,120
"895","02641","2015",1,1,0,32000,356,90
"896","02642","2015",3,3,0,102833.333333333,1077,93.3333333333333
"897","02643","2015",4,4,0,175850,1878.25,102.75
"898","02644","2015",4,4,0,145875,1363.5,107
"899","02645","2015",4,4,0,118563.25,1316.5,102
"900","02647","2015",2,2,0,180500,768,230
"901","02648","2015",22,21,1,81331.8181818182,832.090909090909,98.0909090909091
"902","02649","2015",3,3,0,82000,817,102.333333333333
"903","02650","2015",3,3,0,132666.666666667,1071.33333333333,123
"904","02652","2015",2,2,0,38500,598.5,64.5
"905","02653","2015",6,6,0,139333.333333333,1674.5,89.1666666666667
"906","02656","2015",8,8,0,98725,1162.875,89.125
"907","02657","2015",3,3,0,105000,811.333333333333,126.666666666667
"908","02658","2015",1,1,0,165000,757,218
"909","02659","2015",1,1,0,160000,1311,122
"910","02662","2015",2,2,0,98850,965,103.5
"911","02664","2015",1,1,0,156500,2445,64
"912","02666","2015",3,3,0,116833.333333333,937.333333333333,128.666666666667
"913","02668","2015",5,5,0,78800,863.2,87.2
"914","02670","2015",2,2,0,40000,428,100
"915","02672","2015",3,3,0,187000,1893.66666666667,102
"916","02673","2015",1,1,0,103000,1392,74
"917","02674","2015",3,3,0,86000,928,94.6666666666667
"918","02675","2015",2,2,0,133500,828.5,182.5
"919","02676","2015",23,23,0,100823.47826087,1165.78260869565,88.6086956521739
"920","02677","2015",1,1,0,99000,1414,70
"921","02678","2015",2,2,0,69410.5,731,96
"922","02679","2015",1,1,0,230000,1917,120
"923","02680","2015",18,16,2,75972.2222222222,1001.94444444444,82.7222222222222
"924","02681","2015",2,2,0,67500,944.5,70.5
"925","02683","2015",2,2,0,88000,1018,86.5
"926","02684","2015",21,21,0,79009.5238095238,820.238095238095,98.5714285714286
"927","02686","2015",1,1,0,70000,778,90
"928","02687","2015",4,4,0,247250,2187.5,109.5
"929","02688","2015",1,1,0,38000,567,67
"930","02690","2015",2,2,0,99500,689,140
"931","02691","2015",529,447,82,95733.1890359168,1055.55009451796,90.34404536862
"932","02693","2015",3,3,0,107537.333333333,1020,106.666666666667
"933","02694","2015",8,8,0,70750,1032.625,71.875
"934","02696","2015",3,3,0,75650,1028.66666666667,71.3333333333333
"935","02697","2015",4,4,0,141150,1155,144.75
"936","02698","2015",1,1,0,172000,1911,90
"937","02699","2015",1,1,0,105000,1000,105
"938","02701","2015",12,11,1,121708.333333333,1294,102.75
"939","02702","2015",2,2,0,165000,1168.5,121.5
"940","02703","2015",7,7,0,105928.571428571,1039.14285714286,102.142857142857
"941","02704","2015",3,3,0,82233.3333333333,926.666666666667,92.6666666666667
"942","02705","2015",2,2,0,95050,797,117.5
"943","02706","2015",4,4,0,208875,1726.75,130.5
"944","02707","2015",1,1,0,88000,759,116
"945","02708","2015",2,2,0,266250,1516,173
"946","02709","2015",4,4,0,78250,559.5,133
"947","02710","2015",11,11,0,114240.454545455,897.272727272727,126.909090909091
"948","02711","2015",2,2,0,182500,1542.5,115
"949","02712","2015",2,2,0,62500,729.5,96
"950","02713","2015",2,2,0,92500,753.5,127
"951","02714","2015",1,1,0,95000,1583,60
"952","02715","2015",2,2,0,149025,2250.5,66
"953","02716","2015",1,1,0,170000,1635,104
"954","02717","2015",6,6,0,115500,894.333333333333,131.5
"955","02719","2015",26,26,0,103869,1140.19230769231,89.9615384615385
"956","02720","2015",7,7,0,100550,753.857142857143,130.857142857143
"957","02721","2015",5,5,0,98600,767,139
"958","02722","2015",212,125,87,125912.009433962,1588.5141509434,82.3066037735849
"959","02723","2015",1,1,0,88000,587,150
"960","02725","2015",3,3,0,131333.333333333,1016,130
"961","02726","2015",1,1,0,75000,1071,70
"962","02727","2015",1,1,0,68200,758,90
"963","02728","2015",2,2,0,27850,421.5,65
"964","02730","2015",3,3,0,95866.6666666667,1613.33333333333,60
"965","02734","2015",1,1,0,44000,1517,29
"966","02736","2015",2,2,0,122250,1396.5,89
"967","02737","2015",1,1,0,70000,761,92
"968","02738","2015",119,119,0,82756.7731092437,1018.82352941176,83.6302521008403
"969","02739","2015",3,3,0,117500,1386,90.3333333333333
"970","02740","2015",3,3,0,80000,1081,72.3333333333333
"971","02741","2015",4,4,0,53500,610,84.25
"972","02745","2015",1,1,0,103000,928,111
"973","02746","2015",5,5,0,86800,1150,72.8
"974","02747","2015",2,2,0,95000,993,90
"975","02748","2015",11,11,0,113743.636363636,1342.09090909091,82.3636363636364
"976","02749","2015",2,2,0,142500,1375,105
"977","02750","2015",7,7,0,118071.428571429,992.285714285714,123.714285714286
"978","02751","2015",2,2,0,118000,1193,101
"979","02752","2015",1,1,0,161000,2205,73
"980","02753","2015",4,4,0,66900,732.25,98.75
"981","02754","2015",2,2,0,80000,645,125.5
"982","02755","2015",2,2,0,142250,1486.5,99
"983","02756","2015",5,5,0,120300,954.2,122.8
"984","02757","2015",6,6,0,63266.6666666667,827.166666666667,78.3333333333333
"985","02758","2015",17,17,0,139476.470588235,1233.88235294118,118.352941176471
"986","02759","2015",4,4,0,68125,691,100.25
"987","02760","2015",3,3,0,124583.333333333,1288.66666666667,96.3333333333333
"988","02761","2015",1,1,0,185000,2372,78
"989","02763","2015",2,2,0,207375,892,246
"990","02764","2015",2,2,0,95000,866,109
"991","02765","2015",2,2,0,102500,1167,88
"992","02766","2015",2,2,0,145000,1040,141.5
"993","02767","2015",4,4,0,134175,1504.25,92.25
"994","02768","2015",7,7,0,100914.285714286,1203.28571428571,87.2857142857143
"995","02769","2015",11,9,2,65220,1261.63636363636,75.7272727272727
"996","02770","2015",6,6,0,176333.333333333,1583.5,113.333333333333
"997","02773","2015",1,1,0,115000,1095,105
"998","02775","2015",8,8,0,131487.5,1324.75,106.125
"999","02776","2015",5,5,0,108534,1089.2,114.4
"1000","02777","2015",4,4,0,169500,1712,112.25
"1001","02779","2015",1,1,0,42000,467,90
"1002","02780","2015",2,2,0,274900,1487,218
"1003","02781","2015",3,3,0,131333.333333333,1531.66666666667,86
"1004","02783","2015",2,2,0,69000,637.5,108
"1005","02784","2015",3,3,0,97333.3333333333,768.666666666667,118.333333333333
"1006","02785","2015",7,7,0,122821.428571429,1456.14285714286,83.2857142857143
"1007","02786","2015",1,1,0,119000,1400,85
"1008","02787","2015",2,2,0,96000,1445.5,66.5
"1009","02788","2015",2,2,0,75000,730,115
"1010","02789","2015",20,19,1,83812.5,909.8,90.1
"1011","02790","2015",3,3,0,110666.666666667,1358.33333333333,87.3333333333333
"1012","02791","2015",4,4,0,103450,987.25,104
"1013","02792","2015",1,1,0,53000,946,56
"1014","02793","2015",2,2,0,139100,1325.5,111.5
"1015","02794","2015",2,2,0,98260,1008.5,95
"1016","02795","2015",9,9,0,152164.333333333,1415.55555555556,119
"1017","02796","2015",2,2,0,140500,1709,85.5
"1018","02797","2015",2,2,0,147000,1784.5,83.5
"1019","02798","2015",13,13,0,172192.307692308,1860.23076923077,93.7692307692308
"1020","02799","2015",6,5,1,86000,1258.5,76.6666666666667
"1021","02800","2015",3,3,0,147666.666666667,1364.66666666667,113.666666666667
"1022","02801","2015",6,6,0,85316.6666666667,759.166666666667,105
"1023","02802","2015",2,2,0,115500,1432.5,85
"1024","02803","2015",1,1,0,217000,1299,167
"1025","02804","2015",2,2,0,105000,1491.5,72
"1026","02805","2015",19,13,6,113705.263157895,1338.63157894737,80.5263157894737
"1027","02806","2015",2,2,0,69500,775,90
"1028","02807","2015",5,5,0,104000,1092.6,101.4
"1029","02809","2015",1,1,0,90000,2045,44
"1030","02810","2015",91,63,28,157329.637362637,1946.56043956044,89.956043956044
"1031","02812","2015",2,2,0,139000,1361.5,105
"1032","02813","2015",4,4,0,85500,939,88.5
"1033","02814","2015",1,1,0,80000,1600,50
"1034","02815","2015",5,5,0,106300,1117.8,93.6
"1035","02816","2015",2,2,0,87500,1365.5,64.5
"1036","02818","2015",14,13,1,149547.142857143,1855.57142857143,85.0714285714286
"1037","02819","2015",1,1,0,60000,723,83
"1038","02820","2015",17,17,0,133857.647058824,1223,112.882352941176
"1039","02821","2015",5,4,1,89400,1036.6,87.2
"1040","02822","2015",6,6,0,164500,1962,95
"1041","02824","2015",2,2,0,211000,1895,134.5
"1042","02826","2015",2,2,0,132500,1451,90
"1043","02827","2015",2,2,0,133750,1066.5,122
"1044","02828","2015",3,3,0,112666.666666667,1561,80
"1045","02830","2015",2,2,0,112500,1256,96
"1046","02831","2015",3,3,0,99666.6666666667,1233,89.6666666666667
"1047","02832","2015",5,5,0,90900,953.4,114.4
"1048","02833","2015",4,4,0,125000,1351.5,95.5
"1049","02834","2015",2,2,0,186800,1354.5,150
"1050","03001","2015",33,33,0,112568.787878788,1185.66666666667,98.5757575757576
"1051","03002","2015",2,2,0,254233.5,1311,199
"1052","03003","2015",6,6,0,59800,702,86.1666666666667
"1053","03004","2015",1,1,0,73000,1217,60
"1054","03005","2015",4,4,0,97000,935.75,100
"1055","03006","2015",8,8,0,50577.5,694.375,77.75
"1056","03007","2015",2,2,0,1e+05,1122.5,112
"1057","03008","2015",1,1,0,104200,1532,68
"1058","03010","2015",6,6,0,112916.666666667,1402.5,78.3333333333333
"1059","03011","2015",8,8,0,127750,1180.25,109.5
"1060","03012","2015",2,2,0,150100,810.5,185.5
"1061","03013","2015",46,46,0,125572.891304348,1356.34782608696,92.4130434782609
"1062","03014","2015",1,1,0,1e+05,800,125
"1063","03015","2015",2,2,0,33750,1000,47.5
"1064","03016","2015",3,3,0,136666.666666667,1270.33333333333,113.666666666667
"1065","03017","2015",3,3,0,60833.3333333333,577,102
"1066","03018","2015",5,5,0,138954,1337.8,105.4
"1067","03019","2015",14,14,0,70721.4285714286,779.857142857143,89.9285714285714
"1068","03020","2015",4,4,0,136800,1091.25,120.25
"1069","03021","2015",4,4,0,71250,1104.25,65
"1070","03022","2015",11,11,0,76820,1103.72727272727,70.9090909090909
"1071","03023","2015",103,82,21,139386.747572816,1423.09708737864,95.2427184466019
"1072","03024","2015",6,6,0,69667.3333333333,808.833333333333,85
"1073","03025","2015",12,12,0,103252.5,1027.66666666667,99.75
"1074","03026","2015",7,7,0,109842,955.714285714286,121.714285714286
"1075","03027","2015",14,14,0,85445.7142857143,950.142857142857,104.5
"1076","03028","2015",5,5,0,95530,1046.2,89.6
"1077","03029","2015",6,6,0,88783.3333333333,1011,86.8333333333333
"1078","03030","2015",8,8,0,141875,1152.375,126
"1079","03032","2015",1,1,0,41000,500,82
"1080","03033","2015",1,1,0,83000,629,132
"1081","03034","2015",5,5,0,87880,753.6,103.2
"1082","03035","2015",3,2,1,84000,661,135.333333333333
"1083","03036","2015",14,14,0,107337.5,1126.57142857143,89.6428571428571
"1084","03037","2015",3,3,0,168866.666666667,1471,114
"1085","03038","2015",12,11,1,76291.6666666667,1343.08333333333,70.5833333333333
"1086","03039","2015",4,4,0,61950,927.25,71.25
"1087","03040","2015",5,5,0,193600,1497.6,138.2
"1088","03041","2015",4,4,0,105500,1031,106
"1089","03042","2015",6,6,0,84225,985.5,85.3333333333333
"1090","03043","2015",9,9,0,105244.444444444,892.222222222222,124.222222222222
"1091","03044","2015",14,14,0,132520.285714286,1352.57142857143,96.9285714285714
"1092","03045","2015",11,11,0,116791.363636364,1406.36363636364,87.5454545454545
"1093","03046","2015",10,10,0,78500,977.9,84.3
"1094","03047","2015",4,4,0,54625,678,81.5
"1095","03048","2015",15,15,0,89633.3333333333,957.666666666667,89.4666666666667
"1096","03049","2015",4,4,0,105625,965,127.25
"1097","03050","2015",3,3,0,41000,795.333333333333,57.6666666666667
"1098","03051","2015",1,1,0,538000,3710,145
"1099","03052","2015",17,17,0,96147.0588235294,1087.17647058824,89.7058823529412
"1100","03053","2015",12,12,0,62116.6666666667,725,89.0833333333333
"1101","03054","2015",2,2,0,122500,2367.5,62.5
"1102","03055","2015",6,6,0,102777.5,1303.33333333333,75.5
"1103","03056","2015",2,2,0,89560,1266.5,59.5
"1104","03057","2015",2,2,0,117500,2114.5,61.5
"1105","03059","2015",7,7,0,134374.285714286,1251.42857142857,104.285714285714
"1106","03060","2015",13,12,1,140825,1476.92307692308,93.7692307692308
"1107","03061","2015",2,2,0,142250,1395,103
"1108","03062","2015",6,6,0,159916.666666667,1218.66666666667,119.166666666667
"1109","03063","2015",7,7,0,103500,1022,103.571428571429
"1110","03064","2015",4,4,0,95250,1324.5,64.75
"1111","03065","2015",2,2,0,68500,476.5,145.5
"1112","03066","2015",2,2,0,143087,1189.5,105
"1113","03067","2015",2,2,0,100250,779.5,127.5
"1114","03069","2015",5,5,0,72980,597,115.8
"1115","03070","2015",1,1,0,70000,854,82
"1116","03071","2015",4,4,0,41225,490,85.75
"1117","03072","2015",5,5,0,80612,758,97.2
"1118","03073","2015",2,2,0,153500,1298.5,124
"1119","03074","2015",8,8,0,90375,891,106.875
"1120","03075","2015",1,1,0,118000,983,120
"1121","03076","2015",3,3,0,151666.666666667,1184,126.333333333333
"1122","03077","2015",6,6,0,63500,767.833333333333,87.6666666666667
"1123","03078","2015",7,7,0,62540,678.428571428571,95.4285714285714
"1124","03079","2015",2,2,0,56000,813,69.5
"1125","03081","2015",7,7,0,108342.857142857,1175,101
"1126","03082","2015",48,44,4,80175.625,1006.875,79.6041666666667
"1127","03083","2015",7,7,0,94273.5714285714,936,102.857142857143
"1128","03084","2015",32,31,1,75922.65625,907.5,81.6875
"1129","03085","2015",7,7,0,133071.428571429,1141.85714285714,124.285714285714
"1130","03086","2015",1,1,0,73000,1043,70
"1131","03087","2015",7,7,0,57600,717.142857142857,78.7142857142857
"1132","03088","2015",3,3,0,53000,612,83
"1133","03089","2015",3,3,0,46333.3333333333,583.666666666667,84.6666666666667
"1134","03090","2015",4,4,0,83000,999.25,81.75
"1135","03091","2015",4,4,0,108182.5,1058.75,99.25
"1136","03092","2015",4,4,0,46850,812.5,57.5
"1137","03093","2015",15,15,0,143976.266666667,1322.26666666667,106.666666666667
"1138","03094","2015",21,20,1,135874.285714286,1457.80952380952,97.6190476190476
"1139","03095","2015",139,103,36,104056.90647482,1243.28057553957,85.6690647482014
"1140","03097","2015",2,2,0,100500,1232,70.5
"1141","03098","2015",53,48,5,83793.7735849057,1098.32075471698,75.7358490566038
"1142","03099","2015",4,4,0,59050,933.5,60
"1143","03100","2015",9,9,0,90423.3333333333,885.333333333333,102.777777777778
"1144","03101","2015",83,78,5,110469.879518072,1212.51807228916,93.6265060240964
"1145","03102","2015",23,23,0,96734.7826086956,1097.26086956522,89.8260869565217
"1146","03103","2015",7,7,0,92492.8571428571,884.285714285714,109.571428571429
"1147","03104","2015",16,16,0,76842.9375,839.5625,91.6875
"1148","03105","2015",3,3,0,65833.3333333333,755.666666666667,82
"1149","03106","2015",10,10,0,132220,1215.7,111
"1150","03107","2015",11,11,0,100127.272727273,944.909090909091,111.727272727273
"1151","03108","2015",5,5,0,45840,649.6,71.8
"1152","03109","2015",16,16,0,113820.625,1178.375,95.3125
"1153","03110","2015",10,10,0,132526,1040.5,114.5
"1154","03111","2015",16,16,0,110325,1137.875,99.375
"1155","03112","2015",6,6,0,80750,919.666666666667,86.1666666666667
"1156","03113","2015",9,9,0,72057.7777777778,767,93.5555555555556
"1157","03114","2015",3,3,0,88333.3333333333,837.333333333333,101.333333333333
"1158","03115","2015",4,4,0,69500,832.75,84.75
"1159","03116","2015",2,2,0,94500,707.5,136
"1160","03117","2015",7,7,0,94528.5714285714,914.428571428571,99
"1161","03118","2015",44,41,3,90114.7727272727,1053.15909090909,88.6818181818182
"1162","03119","2015",2,2,0,119000,764.5,157
"1163","03120","2015",6,6,0,71000,828.333333333333,84.8333333333333
"1164","03121","2015",3,3,0,166100,1535.66666666667,116.333333333333
"1165","03122","2015",4,4,0,67837.5,851.75,76.5
"1166","03124","2015",1,1,0,275000,1618,170
"1167","03125","2015",2,2,0,34750,473,73.5
"1168","03126","2015",11,10,1,96327.2727272727,1106.90909090909,90.9090909090909
"1169","03127","2015",8,8,0,40531.25,613.375,77.75
"1170","03128","2015",19,19,0,101045.631578947,1037.94736842105,97.2105263157895
"1171","03130","2015",5,5,0,58950,909.2,66.6
"1172","03131","2015",5,5,0,80200,940.2,82.4
"1173","03132","2015",4,4,0,56125,711.75,76
"1174","03133","2015",4,4,0,88617.5,869,94.75
"1175","03134","2015",2,2,0,279950,1796,156
"1176","03135","2015",5,5,0,74650,883.8,92.2
"1177","03136","2015",1,1,0,120000,597,201
"1178","03138","2015",31,27,4,95655.1935483871,1072.51612903226,86.6774193548387
"1179","03139","2015",7,7,0,63028.5714285714,669.428571428571,94.5714285714286
"1180","03140","2015",11,10,1,84745.4545454545,1060.90909090909,86
"1181","03141","2015",2,2,0,58000,715,77.5
"1182","03142","2015",2,2,0,87250,1268.5,74.5
"1183","03143","2015",1,1,0,85000,817,104
"1184","03144","2015",2,2,0,138500,1539,90
"1185","03145","2015",4,4,0,113250,934.75,116.75
"1186","03146","2015",1,1,0,118500,1823,65
"1187","03147","2015",4,4,0,37787.5,419,91.5
"1188","03148","2015",2,2,0,66000,1146.5,59
"1189","03149","2015",8,8,0,139725,1207.375,114.375
"1190","03150","2015",2,2,0,181550,930.5,230
"1191","03152","2015",1,1,0,48000,889,54
"1192","03154","2015",5,5,0,87500,867,102.4
"1193","03155","2015",25,24,1,85554,841.16,110.6
"1194","03156","2015",13,13,0,109100,1172.30769230769,101.538461538462
"1195","03157","2015",25,24,1,134144.24,1266.24,110.36
"1196","03158","2015",4,4,0,67347,500,135.75
"1197","03159","2015",5,5,0,114138,1260.8,91.2
"1198","03160","2015",3,3,0,145533.333333333,1342.66666666667,93.3333333333333
"1199","03161","2015",8,8,0,79562.5,824.125,97.5
"1200","03162","2015",1,1,0,155000,1107,140
"1201","03163","2015",8,8,0,75434.375,1023.5,76.5
"1202","03164","2015",1,1,0,109000,820,133
"1203","03165","2015",10,10,0,56500,716.1,79.2
"1204","03166","2015",4,4,0,45000,450.75,101.25
"1205","03167","2015",9,9,0,68175,799.333333333333,81.2222222222222
"1206","03168","2015",11,11,0,86481.8181818182,915.272727272727,92.7272727272727
"1207","03169","2015",1,1,0,132000,985,134
"1208","03170","2015",2,2,0,44000,486,93.5
"1209","03171","2015",6,6,0,103333.333333333,886.833333333333,124.5
"1210","03172","2015",1,1,0,67015,745,90
"1211","03173","2015",6,6,0,70483.3333333333,855.166666666667,80.8333333333333
"1212","03174","2015",8,8,0,89150,901.25,100.375
"1213","03175","2015",3,3,0,75483.3333333333,1011.33333333333,85
"1214","03176","2015",5,5,0,143350,1010.2,148.8
"1215","03177","2015",3,3,0,115500,948,132
"1216","03178","2015",2,2,0,53000,856,57
"1217","03179","2015",7,6,1,53611.4285714286,916,59.5714285714286
"1218","03180","2015",2,2,0,132400,1146,117
"1219","03181","2015",9,9,0,74055.5555555556,859.333333333333,85.3333333333333
"1220","03182","2015",3,3,0,124866.666666667,1451.33333333333,82.3333333333333
"1221","03183","2015",3,3,0,68000,843,80.3333333333333
"1222","03184","2015",5,5,0,90700,836.2,109.8
"1223","03185","2015",381,204,177,72080.1968503937,921.635170603675,77.7847769028871
"1224","03186","2015",14,13,1,71464.2857142857,859.357142857143,83.7142857142857
"1225","03187","2015",5,5,0,55135.8,747,68.2
"1226","03188","2015",1,1,0,35000,522,67
"1227","03189","2015",12,12,0,94750,954.083333333333,99.1666666666667
"1228","03190","2015",219,91,128,95595.6621004566,1236.51598173516,77.8447488584475
"1229","03191","2015",2,2,0,55000,829.5,70.5
"1230","03192","2015",1,1,0,250036,1749,143
"1231","03193","2015",4,4,0,95250,1132,81.5
"1232","03194","2015",2,2,0,99000,1284.5,73.5
"1233","03195","2015",28,25,3,85782.8571428571,1025.71428571429,88.3214285714286
"1234","03196","2015",1,1,0,27500,474,58
"1235","03197","2015",11,11,0,98063.6363636364,1183.27272727273,81.4545454545455
"1236","03198","2015",3,3,0,133977.666666667,1209,96.3333333333333
"1237","03200","2015",4,4,0,167000,1832.5,96.25
"1238","03202","2015",7,7,0,53071.4285714286,589.714285714286,87.2857142857143
"1239","03203","2015",4,4,0,91250,904.5,95.75
"1240","03204","2015",5,5,0,74600,762.6,97.8
"1241","03205","2015",3,3,0,113333.333333333,789.333333333333,124.666666666667
"1242","03206","2015",2,2,0,81500,713,124
"1243","03207","2015",4,4,0,75700,648.75,105.25
"1244","03208","2015",5,5,0,83940,660.8,128
"1245","03210","2015",4,4,0,49250,566,93
"1246","03211","2015",14,14,0,110078.571428571,1224.07142857143,91.4285714285714
"1247","03212","2015",12,12,0,152083.333333333,1472.25,102.833333333333
"1248","03213","2015",1,1,0,435000,1450,300
"1249","03214","2015",1,1,0,149300,1310,114
"1250","03215","2015",7,7,0,133145.714285714,1232.85714285714,114.714285714286
"1251","03216","2015",5,5,0,92682,1099,85.4
"1252","03217","2015",6,6,0,102108.333333333,890.166666666667,110.666666666667
"1253","03218","2015",2,2,0,97500,1179,69
"1254","03219","2015",3,3,0,84643.3333333333,789,108.666666666667
"1255","03220","2015",4,4,0,57175,914.75,62.25
"1256","03221","2015",12,12,0,117602.5,1098.58333333333,99.75
"1257","03223","2015",3,3,0,76000,1124.33333333333,66
"1258","03224","2015",8,8,0,74902.5,783.5,98.625
"1259","03225","2015",10,10,0,107530,1140.4,100.2
"1260","03226","2015",3,3,0,54066.6666666667,694.666666666667,80
"1261","03227","2015",6,6,0,104116.666666667,1077,99.5
"1262","03229","2015",7,7,0,90071.4285714286,820.857142857143,110.428571428571
"1263","03230","2015",3,3,0,78610,698.333333333333,112.333333333333
"1264","03232","2015",2,2,0,154140,1170.5,141.5
"1265","03233","2015",5,5,0,109200,1129.2,99.6
"1266","03234","2015",6,6,0,158541.666666667,1445.5,101.5
"1267","03235","2015",5,5,0,88400,919.6,99.2
"1268","03236","2015",34,29,5,83152.6470588235,1125.5,75
"1269","03237","2015",4,4,0,121207.5,983,152.75
"1270","03238","2015",5,5,0,47020,636,79.2
"1271","03239","2015",4,4,0,89662.5,1309.5,65
"1272","03240","2015",6,6,0,68500,847.5,86
"1273","03241","2015",5,5,0,101132,691.4,136
"1274","03242","2015",9,9,0,93682.2222222222,1168.77777777778,83.1111111111111
"1275","03243","2015",1,1,0,82000,1640,50
"1276","03244","2015",1,1,0,37000,529,70
"1277","03245","2015",2,2,0,113842.5,938,95
"1278","03246","2015",3,3,0,95747.6666666667,1214,74.3333333333333
"1279","03247","2015",12,12,0,112375,1074.5,118.75
"1280","03248","2015",3,3,0,41666.6666666667,713.666666666667,63.3333333333333
"1281","03249","2015",3,3,0,51500,794.333333333333,62.6666666666667
"1282","03250","2015",3,3,0,122333.333333333,1123.33333333333,109
"1283","03251","2015",6,6,0,57833.3333333333,1022.16666666667,63
"1284","03252","2015",7,7,0,106630,1134.71428571429,90.8571428571429
"1285","03253","2015",8,8,0,116581.25,1032.75,118.5
"1286","03254","2015",54,45,9,119152.777777778,1262.12962962963,97.1296296296296
"1287","03255","2015",1,1,0,65000,714,91
"1288","03256","2015",2,2,0,80975,713.5,120.5
"1289","03257","2015",6,6,0,75466.6666666667,924.666666666667,86.6666666666667
"1290","03258","2015",19,19,0,129610.526315789,1363.31578947368,94.9473684210526
"1291","03259","2015",4,4,0,89250,1240.5,67.75
"1292","03261","2015",1,1,0,102170,1075,95
"1293","03262","2015",15,13,2,129383.333333333,1929.86666666667,78.9333333333333
"1294","03264","2015",24,23,1,91548.125,1042.95833333333,92.875
"1295","03265","2015",6,6,0,123166.666666667,1223.5,106.333333333333
"1296","03266","2015",2,2,0,122700,1480.5,84.5
"1297","03267","2015",5,5,0,138700,1384.2,104.6
"1298","03268","2015",4,4,0,106725,1123.5,103
"1299","03269","2015",1,1,0,50000,625,80
"1300","03270","2015",2,2,0,167500,1733,100.5
"1301","03271","2015",5,5,0,100152,1216,86.4
"1302","03272","2015",2,2,0,56500,481,115
"1303","03273","2015",4,4,0,117625,1100.25,103
"1304","03274","2015",1,1,0,52000,658,79
"1305","03275","2015",18,18,0,127209.444444444,1146.72222222222,102.833333333333
"1306","03276","2015",2,2,0,45000,510.5,91
"1307","03277","2015",3,3,0,112750,1233.33333333333,92
"1308","03278","2015",1,1,0,38500,494,78
"1309","03279","2015",6,6,0,124150,1252.83333333333,101
"1310","03280","2015",4,4,0,90750,816,101.25
"1311","03281","2015",4,4,0,110375,1059.75,108.5
"1312","03282","2015",4,3,1,177023,2922.5,90.75
"1313","03283","2015",10,10,0,106953,1383.1,83
"1314","03284","2015",3,3,0,103333.333333333,1414,77.3333333333333
"1315","03285","2015",4,4,0,78187.5,1343.25,76.5
"1316","03286","2015",6,6,0,101666.666666667,1153,86.6666666666667
"1317","03287","2015",6,6,0,93750,1305.5,82.8333333333333
"1318","03288","2015",7,6,1,84539.4285714286,1196.42857142857,80.1428571428571
"1319","03289","2015",3,3,0,44000,988,46.6666666666667
"1320","03290","2015",13,13,0,137287.461538462,1530,90.6153846153846
"1321","03291","2015",6,6,0,68166.6666666667,834,84
"1322","03292","2015",7,7,0,85717.1428571429,772.857142857143,106.142857142857
"1323","03293","2015",3,3,0,82866.6666666667,810.666666666667,102.333333333333
"1324","03294","2015",3,3,0,127866.666666667,1042.66666666667,116.666666666667
"1325","03295","2015",1,1,0,20000,400,50
"1326","03296","2015",4,4,0,64525,852.25,76.75
"1327","03297","2015",23,23,0,91526.7391304348,954.521739130435,95.9130434782609
"1328","03298","2015",31,24,7,77114.4193548387,952.935483870968,80.8709677419355
"1329","03299","2015",1,1,0,75000,872,86
"1330","03300","2015",8,8,0,104362.5,1152.75,83.75
"1331","03301","2015",9,9,0,108333.333333333,1048.77777777778,114.666666666667
"1332","03302","2015",2,2,0,34640,512.5,69
"1333","03303","2015",2,2,0,69250,719.5,82
"1334","03304","2015",21,21,0,157642.380952381,1434.80952380952,114.285714285714
"1335","03305","2015",4,4,0,88262.5,1179.75,74.25
"1336","03306","2015",18,18,0,178856.722222222,1409.83333333333,124.055555555556
"1337","03307","2015",3,3,0,63216.6666666667,759.333333333333,82
"1338","03308","2015",1,1,0,85000,1000,85
"1339","03309","2015",8,8,0,83438.75,953.625,87.875
"1340","03310","2015",497,137,360,98687.6418511066,1348.80080482897,71.9879275653924
"1341","03311","2015",2,2,0,233500,2420,95.5
"1342","03312","2015",2,2,0,41750,822.5,50.5
"1343","03313","2015",6,6,0,75869.1666666667,830,91.6666666666667
"1344","03314","2015",13,13,0,167332.692307692,1417.53846153846,116.153846153846
"1345","03315","2015",7,7,0,75461.4285714286,983.714285714286,76.7142857142857
"1346","03316","2015",12,12,0,101133.333333333,1142.66666666667,95
"1347","03317","2015",6,6,0,71283.3333333333,1065.5,77
"1348","03319","2015",5,5,0,78590,953.4,76.4
"1349","03320","2015",6,6,0,54833.3333333333,677.5,80.6666666666667
"1350","03321","2015",142,118,24,120919.788732394,1340.10563380282,89.4154929577465
"1351","04001","2015",6,6,0,206525,2018.16666666667,102.166666666667
"1352","04004","2015",5,5,0,192288.6,2275.6,90.4
"1353","04006","2015",102,11,91,71007.7156862745,2120.09803921569,32.843137254902
"1354","04007","2015",2,2,0,85370,1195,71.5
"1355","04008","2015",8,7,1,105875,1857.25,61.375
"1356","04013","2015",5,5,0,267388,2228.4,129.2
"1357","04016","2015",1,1,0,95000,1727,55
"1358","04017","2015",2,2,0,52500,619,82
"1359","04018","2015",10,10,0,158296,2096.3,81.8
"1360","04019","2015",48,11,37,111543.333333333,1908.91666666667,61.6875
"1361","04021","2015",1,1,0,220000,2115,104
"1362","04022","2015",7,5,2,76814.2857142857,1068.71428571429,73.4285714285714
"1363","04023","2015",5,5,0,130220,1856,75.2
"1364","04025","2015",7,7,0,174600,2495.42857142857,75.2857142857143
"1365","04027","2015",3,3,0,183333.333333333,2251.33333333333,83.3333333333333
"1366","04031","2015",3,2,1,140000,2089,65.3333333333333
"1367","04032","2015",2,2,0,88727.5,1869.5,49.5
"1368","04033","2015",5,5,0,227000,2269.2,105.8
"1369","04034","2015",8,7,1,194012.5,2272.25,97.375
"1370","04035","2015",3,2,1,86333.3333333333,1085.66666666667,78.3333333333333
"1371","04036","2015",8,8,0,172312.5,1511.625,119.25
"1372","04039","2015",11,9,2,118476.363636364,1711.81818181818,68.5454545454545
"1373","04041","2015",2,2,0,103000,1407,69
"1374","04042","2015",1,0,1,20000,500,40
"1375","04043","2015",1,1,0,2e+05,1143,175
"1376","04045","2015",16,15,1,131955.9375,1879.1875,74.3125
"1377","04046","2015",3,3,0,140300,1609.66666666667,85
"1378","04047","2015",5,5,0,231516,2138.8,103.8
"1379","04049","2015",52,24,28,130353.173076923,1657.07692307692,80.4230769230769
"1380","04053","2015",3,1,2,109000,1045,91.3333333333333
"1381","04054","2015",2,2,0,244000,2240,99
"1382","04055","2015",3,3,0,328816.666666667,2472.33333333333,123
"1383","04057","2015",1,0,1,180000,7200,25
"1384","04058","2015",2,2,0,58485,1088,56
"1385","04061","2015",6,4,2,151920,2050.66666666667,67
"1386","04062","2015",4,1,3,88475,1220,68
"1387","04063","2015",11,10,1,178987,2235.27272727273,81.8181818181818
"1388","04065","2015",13,13,0,157497.307692308,1924.76923076923,81.5384615384615
"1389","04066","2015",3,3,0,235000,2055,115
"1390","04068","2015",7,6,1,157271.428571429,2014.28571428571,84.1428571428571
"1391","04069","2015",1,1,0,25100,628,40
"1392","04070","2015",131,45,86,106268.755725191,1581.76335877863,67.4732824427481
"1393","04072","2015",1,1,0,234440,2664,88
"1394","04073","2015",29,5,24,79262.6896551724,1913,40.448275862069
"1395","04075","2015",3,3,0,161666.666666667,2171.66666666667,62.3333333333333
"1396","04076","2015",8,6,2,125695,1853.125,71
"1397","04077","2015",1,1,0,110000,1279,86
"1398","04079","2015",8,4,4,125250,1815.25,68.75
"1399","04081","2015",9,9,0,169253.333333333,2405.33333333333,72.1111111111111
"1400","04084","2015",6,5,1,99666.6666666667,1344.66666666667,70.6666666666667
"1401","04086","2015",4,4,0,218375,1907.75,109.75
"1402","04087","2015",1,1,0,260000,2203,118
"1403","04088","2015",63,43,20,177977.126984127,2117.95238095238,84.6507936507936
"1404","04090","2015",2,2,0,104755,1545.5,74
"1405","04091","2015",1,1,0,185000,2126,87
"1406","04092","2015",3,3,0,143283.333333333,1674.66666666667,77.3333333333333
"1407","04094","2015",65,16,49,122649.830769231,2234.10769230769,54.4461538461538
"1408","04095","2015",4,4,0,102000,1261.75,81.5
"1409","04096","2015",13,4,9,119096.153846154,1677.38461538462,71.3076923076923
"1410","04097","2015",1,1,0,165000,2750,60
"1411","04101","2015",3,3,0,154666.666666667,1976,81
"1412","04102","2015",3,3,0,123333.333333333,1786.33333333333,60.6666666666667
"1413","04104","2015",4,4,0,141783.75,1997.25,72.5
"1414","04106","2015",4,4,0,200754,2263,82.25
"1415","04108","2015",9,8,1,141126.666666667,1851.88888888889,76.7777777777778
"1416","04109","2015",5,5,0,214460,1809.2,120.2
"1417","04110","2015",5,4,1,215280,2745.2,80.2
"1418","04111","2015",11,11,0,194154.545454545,2425.36363636364,84
"1419","04112","2015",223,85,138,166194.744394619,2076.44394618834,78.542600896861
"1420","04113","2015",2,2,0,284435,1850.5,154
"1421","04115","2015",1,1,0,15000,429,35
"1422","04116","2015",27,22,5,151594.444444444,1685.18518518519,90.037037037037
"1423","04121","2015",3,2,1,70333.3333333333,1248.33333333333,53
"1424","04122","2015",3,2,1,150560,1610.66666666667,93
"1425","04123","2015",7,7,0,168485.714285714,2114.42857142857,90.5714285714286
"1426","04124","2015",9,9,0,159666.666666667,1983.44444444444,81.6666666666667
"1427","04126","2015",14,4,10,104028.571428571,2057,51.2142857142857
"1428","04127","2015",1,1,0,210000,2658,79
"1429","04130","2015",3,3,0,254666.666666667,2500,100.666666666667
"1430","04133","2015",2,2,0,65000,1061,59
"1431","04134","2015",6,6,0,75948.3333333333,1335.33333333333,69.3333333333333
"1432","04135","2015",3,3,0,271000,2530.33333333333,99
"1433","04136","2015",1,1,0,110000,786,140
"1434","04138","2015",6,6,0,252500,1670.16666666667,134.5
"1435","04139","2015",4,4,0,159000,1553.75,108.25
"1436","04141","2015",1,1,0,195000,3197,61
"1437","04143","2015",65,52,13,175236.738461538,2156.38461538462,81.8615384615385
"1438","04144","2015",1,1,0,80000,1739,46
"1439","04145","2015",4,3,1,163112.5,1378.25,124.25
"1440","04148","2015",5,4,1,77600,1221.6,61.6
"1441","04149","2015",24,22,2,179607.875,1854.375,96.7083333333333
"1442","04150","2015",2,2,0,271750,2109,126
"1443","04151","2015",6,5,1,164500,2397,71.5
"1444","04152","2015",30,28,2,250562.333333333,2476.63333333333,100.666666666667
"1445","04155","2015",2,1,1,46250,826.5,55.5
"1446","04156","2015",2,2,0,122500,2303.5,54.5
"1447","04157","2015",7,7,0,153507.142857143,1995.71428571429,79.2857142857143
"1448","04158","2015",3,2,1,108666.666666667,1726,59.6666666666667
"1449","04159","2015",1,1,0,360000,3273,110
"1450","04160","2015",10,9,1,249185,2525.9,97.2
"1451","04161","2015",5,3,2,172990,1464.8,101.4
"1452","04162","2015",4,4,0,265250,3312.25,81.5
"1453","04163","2015",6,6,0,104666.666666667,1312.33333333333,74.8333333333333
"1454","04164","2015",1,1,0,1e+05,752,133
"1455","04166","2015",7,7,0,189047.714285714,2322.42857142857,80.8571428571429
"1456","04167","2015",1,1,0,95000,2111,45
"1457","04169","2015",2,2,0,167100,1781,90
"1458","04170","2015",1,0,1,64000,1778,36
"1459","04171","2015",2,2,0,47500,1562.5,32
"1460","04172","2015",1,1,0,1e+05,971,103
"1461","04173","2015",11,8,3,131494.545454545,1675.18181818182,85.0909090909091
"1462","04174","2015",3,3,0,203000,2653.66666666667,82.3333333333333
"1463","04175","2015",1,1,0,139940,1428,98
"1464","04176","2015",1,0,1,69000,2156,32
"1465","04177","2015",2,2,0,103750,1727.5,63
"1466","04178","2015",13,12,1,155727.846153846,2098.07692307692,80
"1467","04179","2015",1,1,0,137280,3922,35
"1468","04180","2015",2,2,0,116500,1902,61
"1469","04181","2015",2,2,0,72000,1073.5,75
"1470","04182","2015",3,3,0,190000,2074,95.6666666666667
"1471","04183","2015",1,1,0,140000,1667,84
"1472","04184","2015",1,1,0,110000,846,130
"1473","04186","2015",1,1,0,50000,893,56
"1474","04188","2015",8,7,1,162840,1638.875,96.25
"1475","04189","2015",5,4,1,80020,2004.8,39.6
"1476","04190","2015",1,1,0,159000,2650,60
"1477","04191","2015",1,1,0,116500,4660,25
"1478","04192","2015",6,6,0,151250,1675.16666666667,88.8333333333333
"1479","04193","2015",3,3,0,193333.333333333,1758.66666666667,107.333333333333
"1480","04195","2015",10,8,2,184500,2201.6,82.4
"1481","04197","2015",21,16,5,162353.761904762,2052.95238095238,75.2857142857143
"1482","04199","2015",2,2,0,123500,1784.5,77
"1483","04200","2015",4,4,0,359875,3022.75,110.5
"1484","04201","2015",2,2,0,103800,1526.5,67.5
"1485","04202","2015",1,0,1,30000,909,33
"1486","04203","2015",5,4,1,146400,2021.2,81.6
"1487","04204","2015",1,1,0,160000,1839,87
"1488","04205","2015",17,8,9,108110.882352941,1605.70588235294,67.5882352941177
"1489","04206","2015",5,4,1,175448,2132.8,72.4
"1490","04208","2015",5,5,0,234040,2758.6,84.2
"1491","04209","2015",53,29,24,141050.377358491,1824.96226415094,77.9433962264151
"1492","04210","2015",4,3,1,69000,1350.25,54
"1493","04214","2015",3,3,0,104333.333333333,1326.66666666667,70.6666666666667
"1494","04216","2015",1,0,1,79500,1136,70
"1495","04217","2015",1,1,0,1e+05,1020,98
"1496","04218","2015",4,4,0,83625,1535,57
"1497","04219","2015",6,4,2,87926.6666666667,1425.16666666667,61.5
"1498","04220","2015",4,2,2,97996.5,1537.75,60.75
"1499","04224","2015",1,0,1,40000,2222,18
"1500","04226","2015",83,11,72,101875.385542169,2350.26506024096,42.566265060241
"1501","04227","2015",7,7,0,159282.285714286,2150.57142857143,71.4285714285714
"1502","04230","2015",32,27,5,168905.9375,2087.125,84
"1503","04231","2015",1,1,0,66000,1100,60
"1504","04233","2015",1,1,0,153000,1821,84
"1505","04234","2015",1,1,0,168500,2675,63
"1506","04235","2015",1,1,0,50000,1064,47
"1507","04236","2015",1,1,0,76900,1282,60
"1508","04237","2015",4,3,1,103750,1671.75,62
"1509","04240","2015",6,5,1,143833.333333333,1855.83333333333,83.6666666666667
"1510","04241","2015",1,1,0,190000,2639,72
"1511","04242","2015",33,32,1,201073.333333333,2508.87878787879,85.2424242424242
"1512","04244","2015",14,14,0,148435.142857143,2017.71428571429,70
"1513","04245","2015",34,27,7,216426.088235294,2236.79411764706,97.3823529411765
"1514","05001","2015",16,2,14,134720.9375,2403.125,58.0625
"1515","05003","2015",13,1,12,62529.6153846154,1114.15384615385,59
"1516","05004","2015",43,5,38,97491.7441860465,2245.13953488372,45.2325581395349
"1517","05006","2015",22,9,13,132171.454545455,1750.13636363636,74.2727272727273
"1518","05007","2015",5,1,4,116000,1866.4,62
"1519","05008","2015",2,2,0,99043,1422,69
"1520","05009","2015",2,2,0,112500,1646.5,69.5
"1521","05010","2015",14,14,0,108282.5,1368.64285714286,78.8571428571429
"1522","05012","2015",13,6,7,214863.076923077,2719.38461538462,80.0769230769231
"1523","05013","2015",4,3,1,149000,1776.5,82.75
"1524","05014","2015",4,4,0,142975,2465.5,63.5
"1525","05016","2015",1,1,0,270000,2328,116
"1526","05017","2015",26,20,6,201002.692307692,2211.88461538462,98.6923076923077
"1527","05018","2015",3,3,0,387550,2177.33333333333,195.666666666667
"1528","05019","2015",4,4,0,54641.25,894.75,58
"1529","05021","2015",4,4,0,177000,1406.5,116.5
"1530","05022","2015",1,1,0,130000,1092,119
"1531","05023","2015",173,35,138,152114.086705202,2305.4450867052,66.1040462427746
"1532","05024","2015",2,2,0,199700,1864.5,100
"1533","05025","2015",2,1,1,215000,1805.5,114
"1534","05026","2015",6,3,3,158236.666666667,3047.5,57.8333333333333
"1535","05028","2015",3,3,0,178193,1975.33333333333,91
"1536","05029","2015",8,5,3,206597.5,1911.75,113.625
"1537","05031","2015",5,3,2,157611,1495,92.8
"1538","05033","2015",3,3,0,132686.666666667,1669,83
"1539","05036","2015",13,11,2,167792.461538462,1799.61538461538,96.6153846153846
"1540","05037","2015",3,3,0,281300,2235.33333333333,120.333333333333
"1541","05038","2015",3,2,1,56666.6666666667,1231,52.6666666666667
"1542","05039","2015",3,2,1,107235,1249.33333333333,78.3333333333333
"1543","05040","2015",28,19,9,193941.178571429,2868.17857142857,74.5
"1544","05044","2015",1,1,0,145000,2417,60
"1545","05045","2015",6,5,1,240718.333333333,2789.83333333333,90
"1546","05046","2015",97,21,76,145698,2429.84536082474,61.639175257732
"1547","05047","2015",2,2,0,125472,1687.5,84
"1548","05048","2015",3,3,0,203333.333333333,2523.66666666667,88.6666666666667
"1549","05050","2015",3,3,0,154100,1800.33333333333,77
"1550","05051","2015",1,1,0,24000,800,30
"1551","05052","2015",5,2,3,124200,1503.2,82.4
"1552","05053","2015",3,3,0,218333.333333333,2268,98
"1553","05054","2015",3,3,0,118433.333333333,1916.33333333333,63
"1554","05055","2015",4,4,0,85185,1180,67.25
"1555","05056","2015",1,1,0,244600,1235,198
"1556","05057","2015",2,2,0,314882.5,2959.5,113
"1557","05058","2015",2,2,0,180030,2423,74
"1558","05059","2015",8,7,1,182223.125,2033.875,89.875
"1559","05060","2015",1,0,1,79000,1013,78
"1560","05061","2015",453,113,340,160372.633554084,2093.72847682119,77.271523178808
"1561","05062","2015",2,2,0,135000,1292,98.5
"1562","05063","2015",10,7,3,109385,1889.8,55.1
"1563","05065","2015",33,11,22,109576.96969697,1876.21212121212,61.8484848484849
"1564","05066","2015",1,1,0,170000,895,190
"1565","05068","2015",1,0,1,24500,766,32
"1566","05070","2015",27,17,10,127657.407407407,1489.03703703704,89.3333333333333
"1567","05071","2015",2,1,1,363500,4779,82
"1568","05072","2015",12,1,11,58210.5,1772.33333333333,32
"1569","05073","2015",3,3,0,156833.333333333,1619.66666666667,89.6666666666667
"1570","05074","2015",1,1,0,121070,2201,55
"1571","05075","2015",7,6,1,225735.714285714,1754.42857142857,126.428571428571
"1572","05076","2015",1,1,0,50000,500,100
"1573","05077","2015",7,2,5,167727.142857143,2526.28571428571,66.8571428571429
"1574","05078","2015",2,2,0,188600,2147.5,88.5
"1575","05079","2015",53,18,35,221302.452830189,3338.79245283019,67.9622641509434
"1576","05084","2015",2,1,1,136290,2519,58.5
"1577","05085","2015",35,4,31,193231.142857143,3786.45714285714,48.6285714285714
"1578","05086","2015",5,5,0,106493.2,1302.4,80.8
"1579","05087","2015",3,2,1,158916.666666667,1649.66666666667,86.3333333333333
"1580","05089","2015",1,1,0,115000,1597,72
"1581","05092","2015",5,5,0,329800,2552.4,147.2
"1582","05093","2015",4,2,2,264340,2748.5,92
"1583","05095","2015",3,2,1,113000,1399,84.6666666666667
"1584","05096","2015",87,4,83,76046.2528735632,1821.81609195402,43.4942528735632
"1585","05097","2015",5,4,1,123750,1215.4,94.6
"1586","05098","2015",57,2,55,86133.9298245614,2396.36842105263,36.6140350877193
"1587","05099","2015",3,2,1,205333.333333333,1412.66666666667,150.666666666667
"1588","05100","2015",3,3,0,309333.333333333,2913.66666666667,103
"1589","05101","2015",30,11,19,134033.166666667,2558.96666666667,64.1666666666667
"1590","05102","2015",2,2,0,177250,1840,89
"1591","05103","2015",3,3,0,127333.333333333,1693.66666666667,74.6666666666667
"1592","05104","2015",9,9,0,155616.666666667,2152,76.5555555555556
"1593","05106","2015",2,1,1,257320,2709,80
"1594","05107","2015",6,6,0,256700,2749.33333333333,96.5
"1595","05108","2015",2,2,0,274150,2237,121.5
"1596","05109","2015",5,3,2,275780,2787.8,101.4
"1597","05110","2015",84,12,72,81388.4285714286,2046.39285714286,39.2023809523809
"1598","05111","2015",2,1,1,239500,2744.5,90.5
"1599","05113","2015",2,1,1,145000,1362,107.5
"1600","05114","2015",11,2,9,69160.4545454545,1845,43.8181818181818
"1601","05115","2015",5,4,1,117804.6,1519,73.2
"1602","05116","2015",3,2,1,142000,2067.33333333333,75.3333333333333
"1603","05118","2015",10,8,2,148838,1377,110
"1604","05119","2015",81,1,80,92038.3086419753,2881.37037037037,33
"1605","05121","2015",3,3,0,159266.666666667,2069.66666666667,76
"1606","05122","2015",5,1,4,138942,1838.8,77.6
"1607","05123","2015",17,16,1,217754.941176471,2279.52941176471,100.647058823529
"1608","05124","2015",4,1,3,181100,1699,106.25
"1609","05126","2015",9,7,2,96691.1111111111,1438,68
"1610","05127","2015",2,0,2,100550,1257,80
"1611","05128","2015",8,6,2,188721.25,2775.625,70.5
"1612","05129","2015",3,2,1,233333.333333333,1792.33333333333,101.666666666667
"1613","05130","2015",4,4,0,413607.5,3916.25,112.5
"1614","05131","2015",1,1,0,280000,1667,168
"1615","05132","2015",21,9,12,141384.761904762,1843.09523809524,77.4285714285714
"1616","05133","2015",64,10,54,178090.140625,3243.375,53.921875
"1617","05134","2015",4,4,0,113500,1944.5,67.75
"1618","05136","2015",8,7,1,209935,2900.625,81.25
"1619","05139","2015",115,12,103,78996.9913043478,1999.86956521739,36.0608695652174
"1620","05140","2015",3,0,3,84066.6666666667,1600,57.6666666666667
"1621","05142","2015",10,7,3,128660,1436.9,84.2
"1622","05144","2015",1,1,0,129000,1870,69
"1623","05145","2015",15,11,4,159458.466666667,2173.4,74
"1624","05146","2015",1,1,0,2e+05,1333,150
"1625","05147","2015",2,2,0,225936,1650.5,139
"1626","05148","2015",1,1,0,185000,2079,89
"1627","05149","2015",22,5,17,85508.8636363636,1845.90909090909,42.8181818181818
"1628","05151","2015",16,13,3,154485.625,2139.3125,77.125
"1629","05152","2015",2,2,0,125000,2064.5,61.5
"1630","05153","2015",12,3,9,76088.3333333333,1932.33333333333,36.75
"1631","05154","2015",1,1,0,65000,722,90
"1632","05156","2015",5,3,2,203472.4,1919.6,107.4
"1633","05157","2015",6,2,4,292883.333333333,3597.5,85.5
"1634","05160","2015",1,1,0,202420,1425,142
"1635","05161","2015",83,11,72,205517.265060241,3546.72289156626,56.5301204819277
"1636","05162","2015",15,10,5,192338.266666667,1942.8,102.933333333333
"1637","05163","2015",4,3,1,208215,2732.25,86.5
"1638","05164","2015",23,11,12,182504.739130435,2742.47826086957,69.0434782608696
"1639","05165","2015",1,1,0,56000,737,76
"1640","05166","2015",12,7,5,111562.5,1255.75,92.1666666666667
"1641","05168","2015",1,1,0,179900,1146,157
"1642","05169","2015",1,1,0,85000,1288,66
"1643","05170","2015",18,17,1,196973.055555556,2399.72222222222,82.0555555555556
"1644","05171","2015",3,3,0,156378.333333333,1317.33333333333,121.666666666667
"1645","05172","2015",1,1,0,1e+05,1010,99
"1646","05173","2015",6,6,0,137998.666666667,1591.83333333333,86.6666666666667
"1647","05174","2015",7,5,2,189393.714285714,2422.85714285714,75.5714285714286
"1648","05176","2015",3,2,1,103266.666666667,1642.66666666667,73
"1649","05177","2015",107,4,103,139796.635514019,3575.76635514019,39.018691588785
"1650","05178","2015",5,5,0,137200,1540.8,85.6
"1651","05179","2015",23,9,14,107605.217391304,1467.91304347826,70.7391304347826
"1652","05180","2015",3,1,2,289000,2075,147
"1653","05181","2015",2,2,0,1e+05,3625,30
"1654","05182","2015",1,1,0,50000,667,75
"1655","05183","2015",7,6,1,193771.428571429,2321.28571428571,88.7142857142857
"1656","05184","2015",1,1,0,150000,2500,60
"1657","06001","2015",1,1,0,140000,1750,80
"1658","06002","2015",2,2,0,106250,2656.5,40
"1659","06003","2015",13,6,7,91692.3076923077,1342.69230769231,66.5384615384615
"1660","06004","2015",1521,141,1380,276215.836291913,4419.63182117028,60.1735700197239
"1661","06005","2015",5,2,3,103658,1705.8,57.4
"1662","06006","2015",19,16,3,466236.842105263,4054.94736842105,119.105263157895
"1663","06007","2015",32,24,8,292889.6875,3939.6875,80.65625
"1664","06009","2015",1,1,0,65909,1198,55
"1665","06010","2015",38,30,8,336059.631578947,3978.10526315789,92.7105263157895
"1666","06011","2015",80,7,73,523827.825,5825.3875,80.35
"1667","06012","2015",217,11,206,289034.101382489,5332.87557603687,52.5576036866359
"1668","06013","2015",16,8,8,103792.5,1565.875,67.5
"1669","06014","2015",10,4,6,214340,3024.4,75.2
"1670","06015","2015",16,12,4,261515.625,3579.75,83.875
"1671","06016","2015",15,7,8,109500,2581.66666666667,44.8666666666667
"1672","06017","2015",2,2,0,235000,4439,70
"1673","06018","2015",102,67,35,575900.31372549,5149.28431372549,108.343137254902
"1674","06019","2015",12,4,8,188925,2829.66666666667,73.5
"1675","06020","2015",9,7,2,140444.444444444,2613.33333333333,57.4444444444444
"1676","06021","2015",7,5,2,219785.714285714,2519.28571428571,83.4285714285714
"1677","06022","2015",12,10,2,149000,2571.25,63.3333333333333
"1678","06023","2015",31,14,17,120885.483870968,2160.41935483871,60.7741935483871
"1679","06024","2015",1,1,0,55000,1375,40
"1680","06025","2015",16,9,7,230351.25,2942.125,82.75
"1681","06026","2015",25,21,4,440410,3925.76,112.04
"1682","06027","2015",821,124,697,233115.30816078,3949.80267965895,59.8026796589525
"1683","06028","2015",11,11,0,186839.090909091,2540.09090909091,79.8181818181818
"1684","06029","2015",1846,81,1765,291198.423076923,4637.15167930661,61.4230769230769
"1685","06030","2015",768,58,710,201541.138020833,3275.05338541667,60.56640625
"1686","06031","2015",5,4,1,275791.6,3750.4,71.2
"1687","06032","2015",72,6,66,431459.027777778,7087.70833333333,57.8194444444444
"1688","06033","2015",82,32,50,248368.963414634,3120.9512195122,81.7317073170732
"1689","06034","2015",16,14,2,328011.25,3777.5625,93.875
"1690","06035","2015",17,6,11,238158.823529412,2886.76470588235,72.2352941176471
"1691","06036","2015",5,1,4,217400,3257.8,67.2
"1692","06037","2015",9,9,0,216555.555555556,2805.22222222222,79
"1693","06038","2015",27,24,3,709085.925925926,4690.25925925926,139.925925925926
"1694","06039","2015",12,11,1,295225,3298.25,96.5833333333333
"1695","06041","2015",3,1,2,138793,2124.66666666667,70
"1696","06042","2015",8,7,1,149750,1891,84.625
"1697","06043","2015",16,13,3,233443.75,2724.4375,92.375
"1698","06044","2015",75,53,22,508063.866666667,4764.61333333333,100.52
"1699","06046","2015",21,18,3,397923.666666667,3685.80952380952,116.809523809524
"1700","06047","2015",1,0,1,87000,1036,84
"1701","06048","2015",54,30,24,239421.537037037,2918.24074074074,83.2962962962963
"1702","06049","2015",2,1,1,318750,2861.5,103.5
"1703","06050","2015",9,6,3,142207.777777778,1861.88888888889,79.2222222222222
"1704","06051","2015",1,1,0,88000,957,92
"1705","06052","2015",1,1,0,42500,850,50
"1706","06054","2015",39,15,24,212137.179487179,3202.94871794872,71.6923076923077
"1707","06056","2015",2,1,1,157500,1654.5,92.5
"1708","06057","2015",17,5,12,188717.647058824,2646.70588235294,69.5882352941177
"1709","06058","2015",3,3,0,278333.333333333,2736.33333333333,103.666666666667
"1710","06059","2015",53,20,33,670191.132075472,7214.83018867925,89.9622641509434
"1711","06060","2015",9,8,1,671197.777777778,4842.77777777778,140.888888888889
"1712","06061","2015",2,1,1,87775,1330,68
"1713","06062","2015",4,0,4,50000,985,52.25
"1714","06063","2015",1,1,0,125000,3571,35
"1715","06064","2015",27,22,5,383804.074074074,4166.07407407407,95.962962962963
"1716","06065","2015",52,38,14,376450.307692308,3941.38461538462,98.1923076923077
"1717","06066","2015",17,10,7,178015.176470588,2797.47058823529,63
"1718","06067","2015",22,2,20,266226.590909091,4514.22727272727,60.3636363636364
"1719","06068","2015",11,11,0,320145.454545455,4009,101.545454545455
"1720","06069","2015",661,197,464,226100.889561271,2936.1845688351,73.5990922844176
"1721","06070","2015",19,6,13,93816.0526315789,1792.57894736842,48.8421052631579
"1722","06071","2015",21,3,18,151495.238095238,3038.04761904762,51.2857142857143
"1723","06073","2015",107,6,101,109898.962616822,3166.55140186916,33.6728971962617
"1724","06074","2015",16,13,3,116612.5,1883.1875,68.3125
"1725","06075","2015",39,31,8,291589.871794872,3399.41025641026,91.4871794871795
"1726","06076","2015",1,1,0,140000,1944,72
"1727","06077","2015",10,4,6,135060,2071.2,61.7
"1728","06078","2015",4,3,1,153850,1965.75,71
"1729","06079","2015",601,84,517,264378.955074875,4176.01164725458,62.1547420965058
"1730","06080","2015",1,1,0,110000,733,150
"1731","06081","2015",2,2,0,126000,2379,50
"1732","06082","2015",2,2,0,172670,2543,73
"1733","06083","2015",652,37,615,236482.634969325,4383.66411042945,55.1871165644172
"1734","06084","2015",100,56,44,408824.24,4149.15,99.55
"1735","06085","2015",252,103,149,435246.05952381,4547.29365079365,89.1825396825397
"1736","06086","2015",2,1,1,53000,1540.5,35
"1737","06088","2015",6087,269,5818,225394.151798916,3753.99835715459,59.6339740430425
"1738","06089","2015",24,23,1,759799.25,5468.25,135.75
"1739","06090","2015",91,53,38,296638.802197802,3859.49450549451,76.6153846153846
"1740","06091","2015",26,15,11,273426.923076923,3391.19230769231,79.1153846153846
"1741","06092","2015",8,6,2,212750,2456.875,79.25
"1742","06093","2015",1,1,0,231620,1963,118
"1743","06094","2015",47,6,41,139578.063829787,2943.23404255319,48.6170212765957
"1744","06095","2015",105,67,38,296747.238095238,3246.61904761905,90.8
"1745","06097","2015",4,4,0,202125,2864.25,71.25
"1746","06098","2015",1,1,0,195000,1612,121
"1747","06099","2015",16,4,12,131282,1644.6875,74.125
"1748","06102","2015",3,1,2,80666.6666666667,1521,55
"1749","06103","2015",20,8,12,104561.25,1763.7,57.55
"1750","06104","2015",314,18,296,345187.589171975,5424.75159235669,60.859872611465
"1751","06105","2015",90,81,9,585689.855555556,4295.71111111111,134.177777777778
"1752","06106","2015",7,5,2,82857.1428571429,1148.42857142857,85.4285714285714
"1753","06108","2015",35,23,12,345424.314285714,3792.68571428571,90.9142857142857
"1754","06109","2015",8,6,2,284375,2900.25,112.25
"1755","06110","2015",7,7,0,140142.857142857,2228.28571428571,58.4285714285714
"1756","06111","2015",7,4,3,74428.5714285714,1645.14285714286,44
"1757","06113","2015",13,9,4,221615.384615385,5193.38461538462,49.9230769230769
"1758","06114","2015",36,10,26,249307.5,3585.11111111111,69.1944444444444
"1759","06116","2015",2,2,0,70500,1411,52.5
"1760","06117","2015",3,3,0,337400,4272.66666666667,78
"1761","06118","2015",51,43,8,282870.392156863,3210.11764705882,100.960784313725
"1762","06119","2015",2,1,1,140000,1664,98.5
"1763","06120","2015",66,4,62,184489.651515152,3884.01515151515,42.2575757575758
"1764","06121","2015",23,2,21,746413.043478261,9665.86956521739,74.4347826086957
"1765","06122","2015",44,35,9,383956.204545455,3872.31818181818,99.0454545454545
"1766","06123","2015",467,55,412,245825.083511777,3904.29978586724,62.0085653104925
"1767","06124","2015",1,1,0,72500,1208,60
"1768","06125","2015",2,1,1,57500,958.5,56.5
"1769","06126","2015",19,7,12,217321.368421053,2816,74.8947368421053
"1770","06127","2015",39,17,22,148692.820512821,2293.64102564103,64.7179487179487
"1771","06128","2015",33,28,5,697001.515151515,5307.69696969697,124.242424242424
"1772","06129","2015",1,0,1,50000,1471,34
"1773","06130","2015",45,38,7,245577.777777778,3030.53333333333,86.6444444444444
"1774","06131","2015",2,2,0,107000,2406.5,54
"1775","06132","2015",7,2,5,117714.285714286,2073.85714285714,59.7142857142857
"1776","06134","2015",7,4,3,134771.428571429,1662,80.8571428571429
"1777","06135","2015",2,1,1,160000,3423,46
"1778","06136","2015",40,21,19,229316.25,2824.025,79.025
"1779","06137","2015",19,17,2,634269.473684211,4737.47368421053,147.210526315789
"1780","06138","2015",86,16,70,442208.034883721,6091.94186046512,63.6046511627907
"1781","06140","2015",41,34,7,379713.87804878,3514.73170731707,108.780487804878
"1782","06141","2015",3,1,2,40333.3333333333,1023.66666666667,39.6666666666667
"1783","06142","2015",3,3,0,176333.333333333,2918.66666666667,61
"1784","06143","2015",8,5,3,148018.75,2224,68.875
"1785","06144","2015",5,5,0,189000,2416.8,77.8
"1786","06145","2015",1,0,1,85895,781,110
"1787","06146","2015",2,2,0,131000,1981,65
"1788","06147","2015",45,31,14,265606.777777778,3086.08888888889,87.6444444444444
"1789","06148","2015",58,52,6,641364.275862069,4744.37931034483,136.275862068966
"1790","06149","2015",72,23,49,203529.472222222,2832,74.3472222222222
"1791","06150","2015",28,19,9,503084.107142857,6167.21428571429,82.4285714285714
"1792","06151","2015",8,2,6,107697.5,2138.25,50
"1793","06152","2015",133,59,74,359287.759398496,4328.3007518797,81.3007518796992
"1794","06153","2015",24,12,12,118524.291666667,2033.45833333333,57.7916666666667
"1795","06154","2015",7,6,1,159643.714285714,2060.57142857143,78.1428571428571
"1796","06155","2015",507,87,420,271954.631163708,3809.83037475345,65.8974358974359
"1797","06156","2015",2,1,1,51500,1901,29.5
"1798","06157","2015",275,102,173,307880.087272727,3779.69090909091,79.7454545454545
"1799","06158","2015",11,10,1,115136.363636364,1605.27272727273,80.9090909090909
"1800","06159","2015",121,19,102,538877.099173554,6840.35537190083,75.8760330578512
"1801","06161","2015",394,76,318,291764.664974619,4782.51269035533,61.256345177665
"1802","06162","2015",9,2,7,72666.6666666667,1066.55555555556,66.2222222222222
"1803","06163","2015",31,7,24,66917.7419354839,1303.06451612903,53.7096774193548
"1804","07001","2015",3,2,1,129666.666666667,1620.33333333333,75.3333333333333
"1805","07002","2015",9,8,1,148888.888888889,1757.33333333333,99.6666666666667
"1806","07003","2015",2,2,0,117500,1391,89.5
"1807","07004","2015",1,1,0,40000,400,100
"1808","07005","2015",8,8,0,189500.625,1641.125,109.5
"1809","07007","2015",6,6,0,124166.666666667,1268,95
"1810","07008","2015",11,11,0,201965.454545455,1876.63636363636,108
"1811","07009","2015",11,6,5,106413.181818182,1079.90909090909,93.0909090909091
"1812","07010","2015",129,50,79,97662.3100775194,1190.16279069767,82.6201550387597
"1813","07011","2015",9,8,1,132644.444444444,1988,87.4444444444444
"1814","07012","2015",3,3,0,68666.6666666667,1058.66666666667,66.6666666666667
"1815","07013","2015",8,8,0,121718.75,1323.75,94.375
"1816","07014","2015",2,2,0,47833.5,1688,27.5
"1817","07015","2015",2,2,0,120075,1836.5,60.5
"1818","07017","2015",8,8,0,160584.375,1517.875,109.125
"1819","07018","2015",2,2,0,180000,2396,126
"1820","07019","2015",111,36,75,110683.423423423,1520.27927927928,70.1711711711712
"1821","07020","2015",2,2,0,141000,1113,106.5
"1822","07022","2015",9,9,0,125346.666666667,1476.33333333333,83.6666666666667
"1823","07023","2015",3,3,0,121150,2185.33333333333,63.6666666666667
"1824","07024","2015",6,6,0,234333.333333333,2634.5,95.1666666666667
"1825","07025","2015",2,2,0,194000,1584.5,121.5
"1826","07026","2015",4,4,0,123962.5,1383.75,81
"1827","07027","2015",22,16,6,136263.636363636,1614.54545454545,85.0454545454545
"1828","07028","2015",6,6,0,135240,1338.83333333333,93
"1829","07029","2015",3,3,0,136000,1638,83.6666666666667
"1830","07030","2015",3,3,0,86833.3333333333,1765.33333333333,51.6666666666667
"1831","07031","2015",7,7,0,155242.857142857,2046.85714285714,82.1428571428571
"1832","07032","2015",1,1,0,75000,1042,72
"1833","07033","2015",1,1,0,180000,1385,130
"1834","07034","2015",1,1,0,329790,3664,90
"1835","07035","2015",6,6,0,163470.833333333,1746.33333333333,109.833333333333
"1836","07036","2015",1,1,0,182000,1936,94
"1837","07039","2015",4,4,0,124675,1217.75,105.5
"1838","07040","2015",3,3,0,67000,1018.66666666667,62.3333333333333
"1839","07041","2015",17,16,1,154051.294117647,1585.64705882353,96.4705882352941
"1840","07042","2015",68,38,30,113447.058823529,1417.17647058824,79.5735294117647
"1841","07044","2015",2,2,0,185650,1236.5,157
"1842","07045","2015",7,7,0,96428.5714285714,1224.28571428571,85.1428571428571
"1843","07047","2015",2,2,0,244730,1783.5,158.5
"1844","07048","2015",6,4,2,159333.333333333,1600,92
"1845","07050","2015",12,12,0,178332.75,2011.33333333333,89.3333333333333
"1846","07051","2015",3,3,0,151666.666666667,1518.33333333333,106.666666666667
"1847","07052","2015",9,9,0,155411.111111111,1460.77777777778,125.555555555556
"1848","07053","2015",3,3,0,126333.333333333,1837,69.3333333333333
"1849","07054","2015",2,2,0,130000,3289,39
"1850","07055","2015",17,15,2,172105.882352941,1769.82352941176,100.411764705882
"1851","07056","2015",6,6,0,168883.333333333,1836,93.1666666666667
"1852","07058","2015",6,6,0,206616.666666667,2139.5,95.5
"1853","07059","2015",1,1,0,98800,988,100
"1854","07060","2015",2,2,0,136000,1835.5,86
"1855","07061","2015",6,6,0,172083.333333333,2197,81.6666666666667
"1856","07063","2015",2,2,0,215150,1771.5,132.5
"1857","07064","2015",12,9,3,90958.3333333333,1139.25,75.3333333333333
"1858","07065","2015",2,2,0,127500,1429,89
"1859","07066","2015",29,21,8,146815,1634.37931034483,88.8620689655172
"1860","07067","2015",4,4,0,89375,1151.25,70
"1861","07068","2015",6,6,0,102910.166666667,1496.83333333333,92.1666666666667
"1862","07069","2015",4,4,0,93750,1432.75,72.75
"1863","07070","2015",21,20,1,174061.904761905,1949.7619047619,95.4761904761905
"1864","07071","2015",9,9,0,80488.8888888889,1139.88888888889,70.6666666666667
"1865","07072","2015",12,12,0,113041.666666667,1439.41666666667,78.8333333333333
"1866","07073","2015",7,7,0,88428.5714285714,1103.14285714286,74.8571428571429
"1867","07075","2015",2,2,0,104000,2075.5,52
"1868","07076","2015",23,22,1,132745.47826087,1514.82608695652,86.6086956521739
"1869","07077","2015",1,1,0,190000,2533,75
"1870","07078","2015",24,18,6,175933.916666667,1794.16666666667,97.8333333333333
"1871","07079","2015",10,10,0,120986.5,1935.7,64.8
"1872","07080","2015",10,10,0,129001.5,1592.1,93.9
"1873","07081","2015",2,2,0,99200,1820,56.5
"1874","07082","2015",2,2,0,123625,1819,65
"1875","07083","2015",5,4,1,190380,1659.6,114.2
"1876","07084","2015",6,6,0,116750,1424.83333333333,83.3333333333333
"1877","07085","2015",4,4,0,222507.5,2291.25,97.5
"1878","07086","2015",1,1,0,166000,1596,104
"1879","07087","2015",2,2,0,130000,2509.5,51.5
"1880","07088","2015",1,1,0,85000,2073,41
"1881","07089","2015",7,7,0,187742.857142857,2198.28571428571,96.1428571428571
"1882","07090","2015",9,8,1,150744.444444444,1401.22222222222,109.222222222222
"1883","07091","2015",4,4,0,120500,1220.25,87
"1884","07093","2015",3,3,0,85666.6666666667,1655.33333333333,49
"1885","07094","2015",3,3,0,59166.6666666667,1377.33333333333,49.3333333333333
"1886","07095","2015",5,5,0,81600,1003.6,85.8
"1887","07096","2015",6,6,0,115846.666666667,1654.83333333333,69.1666666666667
"1888","07097","2015",7,7,0,170128.571428571,3474.57142857143,78.5714285714286
"1889","07098","2015",1,1,0,412800,3175,130
"1890","07099","2015",2,2,0,248500,1564,151
"1891","07100","2015",4,4,0,89500,1539.75,59.75
"1892","07101","2015",12,11,1,205117.5,2500.41666666667,84.6666666666667
"1893","07102","2015",196,53,143,140837.270408163,1841.85204081633,76.8877551020408
"1894","07103","2015",4,4,0,115375,1543,71
"1895","07104","2015",1,1,0,60000,1000,60
"1896","07105","2015",1,1,0,105000,1000,105
"1897","07106","2015",1,1,0,39800,724,55
"1898","07107","2015",9,8,1,107668.444444444,1843.55555555556,59.5555555555556
"1899","07108","2015",1,1,0,183500,1390,132
"1900","07109","2015",2,1,1,174500,3595,46
"1901","07110","2015",22,14,8,145967.272727273,2049.86363636364,71.7727272727273
"1902","07111","2015",1,1,0,1e+05,1724,58
"1903","07112","2015",2,2,0,103225,1464.5,75
"1904","07113","2015",7,7,0,156571.428571429,1527.57142857143,95.5714285714286
"1905","07114","2015",2,1,1,195000,2966.5,85
"1906","07115","2015",7,7,0,241485.714285714,2589,105.714285714286
"1907","07116","2015",14,7,7,102857.142857143,1381.42857142857,73.3571428571429
"1908","07117","2015",20,17,3,186255,2136.5,95.95
"1909","07118","2015",3,3,0,119566.666666667,1798.66666666667,65.6666666666667
"1910","07119","2015",2,1,1,73000,1066.5,75.5
"1911","07120","2015",2,2,0,360000,3488.5,98
"1912","07121","2015",2,2,0,68575,1274.5,49.5
"1913","07122","2015",3,3,0,255766.666666667,1858,134.333333333333
"1914","07124","2015",1,1,0,20000,1000,20
"1915","07126","2015",5,4,1,188000,2011.6,93.2
"1916","07127","2015",8,7,1,93820,1338.125,72.25
"1917","07128","2015",5,3,2,71740,854.2,83.8
"1918","07129","2015",16,14,2,96406.25,1200.5,87.4375
"1919","07130","2015",3,2,1,75952,1329,57.3333333333333
"1920","07131","2015",1,1,0,83000,1660,50
"1921","07132","2015",16,14,2,146353.125,1746.4375,86.5
"1922","07134","2015",3,3,0,66666.6666666667,1463.33333333333,60.3333333333333
"1923","07138","2015",12,12,0,182750,1999.33333333333,93.4166666666667
"1924","07139","2015",3,3,0,70953.3333333333,1115.66666666667,57
"1925","07140","2015",2,2,0,224225,2288.5,103.5
"1926","07142","2015",2,2,0,86550,1113,70
"1927","07143","2015",5,5,0,162845,2109.4,81.6
"1928","07145","2015",6,6,0,132720,1635.33333333333,84.5
"1929","07146","2015",14,10,4,129821.428571429,1386.64285714286,96.8571428571429
"1930","07147","2015",4,3,1,132800,2624.75,68.25
"1931","07149","2015",1,1,0,45000,643,70
"1932","07150","2015",2,1,1,106500,1183.5,90
"1933","07151","2015",4,4,0,104000,1694.25,109.75
"1934","07152","2015",7,6,1,137428.571428571,1371.85714285714,102.857142857143
"1935","07153","2015",4,4,0,89500,1977.75,46.25
"1936","07154","2015",2,2,0,110000,1891.5,55
"1937","07155","2015",3,3,0,195666.666666667,2014.33333333333,96.3333333333333
"1938","07156","2015",11,9,2,98807.7272727273,1668.54545454545,60.6363636363636
"1939","07157","2015",6,6,0,135015,1504.5,89.1666666666667
"1940","07158","2015",2,2,0,26120,1080.5,31.5
"1941","07159","2015",3,3,0,151333.333333333,2102.33333333333,70.6666666666667
"1942","07160","2015",1,1,0,49500,707,70
"1943","07161","2015",8,7,1,160303.75,1626.375,92.25
"1944","07162","2015",5,5,0,165400.2,1657.2,114.8
"1945","07163","2015",1,1,0,55000,500,110
"1946","07165","2015",8,8,0,134037.5,1728.375,78.375
"1947","07167","2015",8,7,1,157625,2198.5,76.625
"1948","07168","2015",9,9,0,217788.888888889,2016.22222222222,111.333333333333
"1949","07169","2015",2,2,0,207000,1784,116
"1950","07170","2015",5,5,0,114068,1283.4,84.6
"1951","07171","2015",7,7,0,174564.285714286,1649.14285714286,115.142857142857
"1952","07172","2015",15,15,0,197890,2080.66666666667,100.066666666667
"1953","07173","2015",1,1,0,110000,2200,50
"1954","07174","2015",6,5,1,67691.6666666667,947.666666666667,69.8333333333333
"1955","07175","2015",1,1,0,165444,1103,150
"1956","07176","2015",2,2,0,198000,3089,65
"1957","07177","2015",3,3,0,172166.666666667,1273,135.333333333333
"1958","07178","2015",4,4,0,71125,1206.5,64.75
"1959","07179","2015",1,1,0,140000,1373,102
"1960","07181","2015",16,7,9,110337.5,1377.4375,78.9375
"1961","07182","2015",7,7,0,132850,1804,74.1428571428571
"1962","07183","2015",4,4,0,196780.25,2380,89.25
"1963","07184","2015",6,6,0,158916.666666667,1719,87.8333333333333
"1964","07185","2015",5,5,0,138640,1202.4,114
"1965","07186","2015",90,41,49,106896.722222222,1261.65555555556,83.9
"1966","07187","2015",3,3,0,156666.666666667,1918,91.6666666666667
"1967","07188","2015",14,14,0,133982.857142857,1498.07142857143,97.2142857142857
"1968","07189","2015",10,9,1,154087.4,1737.5,97.4
"1969","07190","2015",1,1,0,266600,1666,160
"1970","07191","2015",19,16,3,184324.210526316,1827.78947368421,100.684210526316
"1971","07192","2015",3,3,0,133596.666666667,1290,103.333333333333
"1972","07193","2015",4,4,0,174500,2192,76.75
"1973","07194","2015",4,4,0,118500,2312,62.25
"1974","07195","2015",3,3,0,184100,1801.66666666667,138
"1975","07196","2015",2,2,0,375000,2376,131
"1976","07197","2015",17,16,1,144312.882352941,1492.35294117647,95.8235294117647
"1977","07198","2015",9,9,0,159622.222222222,1758.66666666667,93.2222222222222
"1978","07199","2015",5,5,0,187527,1971.4,94.4
"1979","07200","2015",2,2,0,110000,2266.5,65
"1980","07201","2015",20,15,5,136922.5,1769,76
"1981","07202","2015",5,5,0,149080,2350.6,62.8
"1982","07203","2015",3,3,0,94000,1137.66666666667,84.3333333333333
"1983","07204","2015",21,12,9,102169.047619048,1358.42857142857,77.8095238095238
"1984","07205","2015",8,8,0,141745,1944,78.25
"1985","07207","2015",14,13,1,161385,1924.14285714286,86.3571428571429
"1986","07208","2015",1,1,0,150000,375,400
"1987","07210","2015",6,6,0,113850,1344.66666666667,86
"1988","07211","2015",4,4,0,257420,2192.75,115
"1989","07212","2015",1,1,0,66000,1650,40
"1990","07213","2015",4,4,0,166875,1704,81.5
"1991","07214","2015",3,3,0,120560,1349,86
"1992","07215","2015",1,1,0,214700,3520,61
"1993","07216","2015",2,2,0,142000,918,152
"1994","07217","2015",2,2,0,160250,1822.5,88.5
"1995","07218","2015",4,4,0,182250,2676.25,86
"1996","07219","2015",3,3,0,286933.333333333,2618.66666666667,107
"1997","07220","2015",2,2,0,190600,1724,107
"1998","07221","2015",3,2,1,66333.3333333333,1084.33333333333,61
"1999","07222","2015",3,3,0,169333.333333333,1598.33333333333,106.666666666667
"2000","07223","2015",2,1,1,195250,2074.5,95
"2001","07224","2015",3,2,1,74333.3333333333,1030,79
"2002","07225","2015",7,7,0,191577.714285714,1665.85714285714,113
"2003","07226","2015",1,1,0,150000,1875,80
"2004","07227","2015",5,5,0,150160,1643.2,90.4
"2005","07228","2015",6,6,0,184816.666666667,1839.33333333333,97.6666666666667
"2006","07229","2015",1,1,0,237600,3771,63
"2007","07230","2015",3,2,1,144000,2106.33333333333,73.3333333333333
"2008","07231","2015",12,12,0,191750,1847.83333333333,109.416666666667
"2009","07232","2015",2,2,0,135250,2703,62.5
"2010","07233","2015",2,2,0,55000,1035,62.5
"2011","07234","2015",1,1,0,127900,1599,80
"2012","07235","2015",6,5,1,119000,1132,113.5
"2013","07236","2015",6,5,1,91808.3333333333,966.666666666667,89.3333333333333
"2014","07237","2015",9,9,0,98166.6666666667,1375.11111111111,67.5555555555556
"2015","07239","2015",3,3,0,111666.666666667,1375.66666666667,68
"2016","07240","2015",14,13,1,238195.142857143,2299.92857142857,109.214285714286
"2017","07241","2015",2,2,0,190500,1873.5,101.5
"2018","07243","2015",2,2,0,128500,1317.5,95.5
"2019","07245","2015",19,17,2,143942.105263158,1519.10526315789,97.0526315789474
"2020","07247","2015",5,5,0,172742,1802,96.2
"2021","07248","2015",1,1,0,80000,1905,42
"2022","07249","2015",2,2,0,95700,1217.5,80
"2023","07250","2015",3,3,0,147333.333333333,3015,71.6666666666667
"2024","07251","2015",1,1,0,125000,1543,81
"2025","07253","2015",2,2,0,81000,1151,82
"2026","07254","2015",1,1,0,283800,2365,120
"2027","07255","2015",11,10,1,109636.363636364,1685.36363636364,61.7272727272727
"2028","07258","2015",3,3,0,146666.666666667,1571.33333333333,94
"2029","07259","2015",18,15,3,127701.666666667,1443.88888888889,91.8888888888889
"2030","07260","2015",7,7,0,177240,2110,83.4285714285714
"2031","07261","2015",9,9,0,169111.111111111,1869,92.2222222222222
"2032","07262","2015",2,2,0,138960,1818,76.5
"2033","07263","2015",1,1,0,105000,2234,47
"2034","07264","2015",15,14,1,184600.2,1892.8,94.8
"2035","07265","2015",6,5,1,138953.333333333,1481.83333333333,93.8333333333333
"2036","07266","2015",1,1,0,65000,1806,36
"2037","07267","2015",1,1,0,69000,1045,66
"2038","07268","2015",11,11,0,120870.909090909,2838.81818181818,42.9090909090909
"2039","07269","2015",7,5,2,126664.285714286,1482.28571428571,85.7142857142857
"2040","07270","2015",4,4,0,191282.5,2123,86.5
"2041","07272","2015",2,2,0,267500,1786.5,148.5
"2042","07273","2015",2,2,0,274000,2850,103.5
"2043","07274","2015",5,5,0,62400,854,75.4
"2044","07275","2015",1,1,0,75000,1667,45
"2045","07276","2015",1,1,0,42000,636,66
"2046","07277","2015",1,1,0,24000,533,45
"2047","07278","2015",6,6,0,140516.666666667,1396.5,103.666666666667
"2048","07279","2015",13,13,0,149817.307692308,1679.38461538462,90.1538461538462
"2049","07280","2015",8,8,0,170437.5,1670.5,93.75
"2050","07281","2015",98,81,17,227761.62244898,2156.01020408163,107.795918367347
"2051","07282","2015",1,1,0,40000,571,70
"2052","07284","2015",3,3,0,120000,1408,82
"2053","07285","2015",3,3,0,84900,1579.66666666667,64.6666666666667
"2054","07286","2015",6,6,0,112500,1321.16666666667,83.8333333333333
"2055","07287","2015",2,2,0,141250,1527.5,97.5
"2056","07288","2015",4,3,1,132825,1342.75,97.25
"2057","07289","2015",11,11,0,132390.909090909,1689.36363636364,79.0909090909091
"2058","07290","2015",5,5,0,135300,1649.6,92.4
"2059","07291","2015",10,10,0,199621,2434.3,86.2
"2060","07292","2015",5,5,0,171480.4,1900.8,93.8
"2061","07293","2015",6,6,0,197466.666666667,1934.66666666667,108.5
"2062","07294","2015",1,1,0,195000,2167,90
"2063","07295","2015",9,8,1,136344.444444444,1538.22222222222,87.3333333333333
"2064","07296","2015",8,8,0,190518.75,1904.875,99.25
"2065","07297","2015",4,4,0,107819.5,1598.5,69.25
"2066","07298","2015",6,6,0,168266.666666667,1456.33333333333,129.333333333333
"2067","07299","2015",3,3,0,191333.333333333,2352,80
"2068","07300","2015",6,6,0,191296.666666667,1940.5,107
"2069","07301","2015",6,6,0,96783.3333333333,1400.66666666667,71.8333333333333
"2070","07302","2015",4,4,0,145228.75,1373,104
"2071","07303","2015",3,3,0,165333.333333333,1844.33333333333,91.6666666666667
"2072","07304","2015",23,10,13,118673.304347826,1886.95652173913,68.304347826087
"2073","07305","2015",7,7,0,147571.428571429,1651.57142857143,86.8571428571429
"2074","07306","2015",4,4,0,163750,1842.25,103.75
"2075","07307","2015",2,2,0,88139,846.5,100.5
"2076","07308","2015",20,11,9,130310,1726.15,88.95
"2077","07309","2015",14,13,1,126850,1418.35714285714,96.2142857142857
"2078","07310","2015",3,3,0,210333.333333333,1456.33333333333,140.666666666667
"2079","07311","2015",2,2,0,199000,2037,93
"2080","07312","2015",4,4,0,241875,1426,165
"2081","07313","2015",10,7,3,108570.7,1143.7,99.7
"2082","07314","2015",8,8,0,104491.25,1456,74
"2083","07315","2015",5,5,0,128300,1539.8,79.6
"2084","07316","2015",19,15,4,148793.473684211,1682.57894736842,86.5263157894737
"2085","07317","2015",9,9,0,171605.555555556,1687.88888888889,100
"2086","07319","2015",84,54,30,130919.011904762,1616.91666666667,83.7976190476191
"2087","07321","2015",1,1,0,190000,2088,91
"2088","07322","2015",13,13,0,84115.3846153846,1096.92307692308,76.8461538461538
"2089","07323","2015",8,8,0,228765,1930.625,120.625
"2090","07324","2015",99,41,58,131602.686868687,1573.39393939394,82.5454545454545
"2091","07325","2015",11,9,2,142863.636363636,1872.09090909091,78
"2092","07326","2015",1,1,0,85000,2125,40
"2093","07327","2015",2,2,0,137000,1393,105
"2094","07328","2015",4,4,0,223391.25,2242.75,100.25
"2095","07329","2015",6,6,0,97083.3333333333,1754.16666666667,60
"2096","07330","2015",37,33,4,189524.594594595,2346.27027027027,86.7027027027027
"2097","07331","2015",47,19,28,101712.042553191,1424.08510638298,72.7446808510638
"2098","07332","2015",2,2,0,325000,1900,160
"2099","07333","2015",3,2,1,137333.333333333,1289,106
"2100","07334","2015",31,24,7,229678.387096774,2129.77419354839,106.677419354839
"2101","07335","2015",5,4,1,72800,900.8,102.8
"2102","07336","2015",1,1,0,50000,2000,25
"2103","07337","2015",14,14,0,171485.714285714,1678.21428571429,104.5
"2104","07338","2015",23,22,1,145901.086956522,1932.47826086957,81.7826086956522
"2105","07339","2015",15,15,0,168568.6,1639.26666666667,102.533333333333
"2106","07340","2015",13,13,0,166711.538461538,1728.46153846154,98.6923076923077
"2107","07341","2015",33,32,1,127803.636363636,1482.0303030303,89.030303030303
"2108","07342","2015",4,4,0,158250,1709,93.5
"2109","07343","2015",5,5,0,171320,1961.2,93.6
"2110","07344","2015",7,7,0,190980.714285714,1831.71428571429,99.4285714285714
"2111","07345","2015",7,7,0,101785.714285714,1253,83.4285714285714
"2112","07346","2015",27,22,5,139324.444444444,1552.55555555556,87.7037037037037
"2113","07347","2015",9,9,0,142081.111111111,1374.22222222222,105.222222222222
"2114","07348","2015",10,9,1,118830,1503.3,82
"2115","07349","2015",55,31,24,126674.272727273,1416.18181818182,90.7636363636364
"2116","08001","2015",2,2,0,179000,1314.5,140.5
"2117","08003","2015",22,22,0,136147.727272727,1437.22727272727,92.2272727272727
"2118","08004","2015",2,2,0,140400,1711,93.5
"2119","08005","2015",2,2,0,68411,704.5,100
"2120","08008","2015",9,9,0,122611.111111111,1529.33333333333,79.5555555555556
"2121","08010","2015",3,3,0,61473.3333333333,848.666666666667,72.6666666666667
"2122","08011","2015",2,2,0,78000,1263.5,62
"2123","08014","2015",1,1,0,3e+05,1345,223
"2124","08021","2015",1,1,0,126500,1782,71
"2125","08022","2015",2,2,0,202000,1677,115.5
"2126","08024","2015",15,14,1,124966.666666667,1493.8,93.0666666666667
"2127","08028","2015",8,8,0,104812.5,1119.75,93.625
"2128","08032","2015",1,1,0,165000,1650,100
"2129","08038","2015",4,4,0,121150,1487.5,83.5
"2130","08039","2015",4,4,0,140375,1387,107
"2131","08040","2015",6,6,0,131750,1374.33333333333,98.3333333333333
"2132","08043","2015",13,11,2,124638.461538462,1134.30769230769,110.615384615385
"2133","08044","2015",1,1,0,52000,929,56
"2134","08046","2015",1,1,0,30000,612,49
"2135","08048","2015",3,3,0,178500,1383.66666666667,130.333333333333
"2136","08053","2015",19,19,0,115294.210526316,1167.94736842105,101.894736842105
"2137","08058","2015",2,2,0,118500,1091,116.5
"2138","08062","2015",1,1,0,205000,1577,130
"2139","08064","2015",4,4,0,187650,1394.25,133.75
"2140","08066","2015",1,1,0,120000,960,125
"2141","08070","2015",5,5,0,97567.2,1253,76.8
"2142","08078","2015",8,8,0,84625,905.5,94.875
"2143","08081","2015",30,29,1,72736.6666666667,893.133333333333,82.5666666666667
"2144","08084","2015",6,6,0,143200,1525,100.5
"2145","08096","2015",4,4,0,115000,1368.25,94
"2146","08101","2015",1,1,0,49000,538,91
"2147","08105","2015",379,197,182,105164.176781003,1258.93139841689,83.9788918205805
"2148","08107","2015",11,11,0,127648.727272727,1186.72727272727,82.4545454545455
"2149","08111","2015",8,8,0,169650,1701.5,99.875
"2150","08119","2015",4,4,0,103750,867.75,115.5
"2151","08122","2015",9,9,0,138224.444444444,1269.11111111111,103.888888888889
"2152","08125","2015",2,2,0,152375,1334,121
"2153","08126","2015",1,1,0,25000,735,34
"2154","08133","2015",3,3,0,151300,905.666666666667,166.666666666667
"2155","08136","2015",2,2,0,78650,688,109
"2156","08137","2015",5,5,0,203800,1606.8,129.2
"2157","08140","2015",8,8,0,121437.5,1018.5,125.375
"2158","08142","2015",8,6,2,131587.5,1464.625,89.25
"2159","08148","2015",2,2,0,155500,1269,127
"2160","08150","2015",5,5,0,92200,996.6,92.8
"2161","08162","2015",4,4,0,122000,1662.75,80.75
"2162","08166","2015",1,1,0,15000,517,29
"2163","08169","2015",1,1,0,60000,600,100
"2164","08170","2015",4,4,0,103657.5,1038.5,109.5
"2165","08173","2015",15,15,0,132333.333333333,1235.86666666667,108.733333333333
"2166","08174","2015",26,25,1,117252.692307692,1168.61538461538,104.807692307692
"2167","08179","2015",6,6,0,62468.3333333333,815.166666666667,78.1666666666667
"2168","08180","2015",10,10,0,148565,1491.7,105.5
"2169","08183","2015",8,8,0,127707.5,1114.5,115.75
"2170","08185","2015",23,21,2,66730.3913043478,757.173913043478,84.9130434782609
"2171","08187","2015",2,2,0,218500,1439.5,149.5
"2172","08188","2015",11,11,0,59037.8181818182,701.727272727273,87.9090909090909
"2173","08190","2015",30,23,7,83937.3333333333,1131,86.5333333333333
"2174","08191","2015",8,6,2,120187.5,1149.125,107.125
"2175","08194","2015",5,5,0,115800,1351.8,110.2
"2176","08195","2015",3,3,0,64000,953.666666666667,66.3333333333333
"2177","08199","2015",3,3,0,137333.333333333,975,160.333333333333
"2178","08202","2015",1,1,0,40800,567,72
"2179","08203","2015",4,4,0,118562.5,1359.25,96.75
"2180","08207","2015",1,1,0,30000,469,64
"2181","08209","2015",2,2,0,122000,1174.5,105
"2182","08210","2015",1,1,0,94000,752,125
"2183","08214","2015",5,5,0,102400,814.2,129
"2184","08216","2015",4,4,0,147250,1208.25,123.5
"2185","08218","2015",5,5,0,92800,1010.2,96.4
"2186","08219","2015",3,3,0,86666.6666666667,917.333333333333,89.6666666666667
"2187","08222","2015",17,17,0,115110.470588235,1138.23529411765,98.8235294117647
"2188","08226","2015",1,1,0,60000,984,61
"2189","08229","2015",3,3,0,102933.333333333,1363.33333333333,77.6666666666667
"2190","08230","2015",2,2,0,90350,834,106
"2191","08232","2015",2,2,0,53460,1577,34
"2192","08234","2015",3,3,0,145500,1172.33333333333,131.666666666667
"2193","08235","2015",2,2,0,65000,3026,51.5
"2194","08239","2015",8,8,0,145868.75,1018.5,148.25
"2195","08246","2015",2,2,0,49500,409.5,121.5
"2196","08247","2015",1,1,0,122000,1794,68
"2197","08248","2015",7,7,0,115857.142857143,1179.28571428571,102.142857142857
"2198","08262","2015",4,4,0,107000,1026.25,101
"2199","08263","2015",4,4,0,117000,1332.25,89.5
"2200","08284","2015",13,13,0,101020.923076923,880.692307692308,109.538461538462
"2201","08286","2015",1,1,0,70000,625,112
"2202","08289","2015",5,5,0,68200,735.4,91.4
"2203","08294","2015",2,2,0,74000,716.5,97.5
"2204","08298","2015",24,21,3,121757.625,1306.125,97.2916666666667
"2205","08304","2015",3,3,0,95933.3333333333,998.333333333333,95.6666666666667
"2206","08306","2015",1,1,0,136000,1333,102
"2207","08311","2015",9,9,0,119672.222222222,1152.11111111111,105.333333333333
"2208","08313","2015",5,5,0,121940,1349.4,96.6
"2209","08314","2015",6,6,0,110880,1171.5,94.5
"2210","08316","2015",4,4,0,96675,880.25,106
"2211","08320","2015",3,3,0,136766.666666667,1403.33333333333,107.333333333333
"2212","08327","2015",8,7,1,125137.625,1371.5,89.5
"2213","08328","2015",39,34,5,91636.7692307692,989.205128205128,89.8717948717949
"2214","08330","2015",5,5,0,134290,1408.8,96.2
"2215","08331","2015",6,6,0,113563,1166.5,96.1666666666667
"2216","08339","2015",7,7,0,157757.142857143,1443.28571428571,119.285714285714
"2217","08340","2015",1,1,0,157000,1510,104
"2218","08342","2015",2,2,0,119500,711,166.5
"2219","08343","2015",12,12,0,66750,809.25,85.1666666666667
"2220","08346","2015",10,10,0,168850,1417.2,119.7
"2221","08349","2015",6,6,0,78166.6666666667,908.666666666667,82
"2222","08350","2015",2,2,0,52500,615.5,81
"2223","08353","2015",9,9,0,126934.777777778,1263.55555555556,99.7777777777778
"2224","08361","2015",11,11,0,102263.636363636,874.636363636364,120.727272727273
"2225","08362","2015",70,44,26,114907.071428571,1286.34285714286,89.0714285714286
"2226","08363","2015",44,40,4,71352.2727272727,973.431818181818,73.0454545454545
"2227","08367","2015",11,9,2,108045.454545455,1032.09090909091,110.454545454545
"2228","08368","2015",1,1,0,127000,847,150
"2229","08380","2015",4,4,0,61000,916.75,66
"2230","08381","2015",12,12,0,117645.833333333,1267.16666666667,94.4166666666667
"2231","08385","2015",5,5,0,96600,1169.6,81.2
"2232","08386","2015",1,1,0,162000,1256,129
"2233","08391","2015",6,6,0,78500,1017.16666666667,83.6666666666667
"2234","08396","2015",3,3,0,81666.6666666667,835,103
"2235","08400","2015",4,4,0,90000,1033.5,83.75
"2236","08402","2015",10,10,0,140120,1485.5,97.7
"2237","08403","2015",14,14,0,129253.571428571,1546.35714285714,90.2142857142857
"2238","08408","2015",5,5,0,166400,1366.6,135.6
"2239","08409","2015",109,51,58,98283.1926605505,1103.24770642202,91.0917431192661
"2240","08413","2015",1,1,0,55000,423,130
"2241","08415","2015",3,3,0,79166.6666666667,922.666666666667,87.6666666666667
"2242","08418","2015",1,1,0,70000,1000,70
"2243","08420","2015",9,9,0,73444.4444444444,964,79
"2244","08427","2015",2,2,0,117145,1033,113.5
"2245","08435","2015",7,7,0,135343.428571429,1395.14285714286,93.5714285714286
"2246","08438","2015",2,2,0,119500,1305.5,94
"2247","08445","2015",3,3,0,116900,1093.66666666667,100
"2248","08448","2015",9,8,1,93638.8888888889,948.444444444444,97.6666666666667
"2249","08452","2015",1,1,0,190000,1387,137
"2250","08457","2015",4,4,0,167787.5,1428.25,138.25
"2251","08473","2015",3,3,0,116500,1580.66666666667,73.3333333333333
"2252","08476","2015",6,6,0,115233.333333333,1214.66666666667,96.6666666666667
"2253","08480","2015",25,25,0,127784,1350.44,96.08
"2254","08481","2015",3,3,0,142833.333333333,1136,125.333333333333
"2255","08483","2015",7,6,1,148114.285714286,1520.42857142857,104.285714285714
"2256","08486","2015",11,10,1,74500,890,82.2727272727273
"2257","08487","2015",9,9,0,117777.777777778,1226.33333333333,97.7777777777778
"2258","08488","2015",17,17,0,149127.058823529,1243.58823529412,121.470588235294
"2259","08490","2015",27,25,2,97721.8518518519,1041.11111111111,93.2222222222222
"2260","08491","2015",25,25,0,145692.56,1514.92,95.44
"2261","08492","2015",1,1,0,146000,890,164
"2262","08494","2015",2,2,0,139000,1423,97.5
"2263","08497","2015",9,9,0,210666.666666667,1683.11111111111,101
"2264","08498","2015",3,3,0,158000,1416.33333333333,115.666666666667
"2265","09001","2015",1,1,0,30000,698,43
"2266","09002","2015",5,5,0,208349.2,1737.4,119
"2267","09003","2015",7,7,0,93442.8571428571,804.428571428571,115.428571428571
"2268","09004","2015",2,2,0,94060,1334,70.5
"2269","09005","2015",3,3,0,66166.6666666667,1397,52.3333333333333
"2270","09008","2015",3,3,0,99733.3333333333,1382.66666666667,76
"2271","09009","2015",1,1,0,165000,1387,119
"2272","09014","2015",2,2,0,93500,1007.5,80
"2273","09015","2015",5,5,0,93800,1122.2,86
"2274","09016","2015",1,1,0,110000,815,135
"2275","09017","2015",1,1,0,70000,778,90
"2276","09019","2015",6,6,0,157539.166666667,1005.66666666667,158.833333333333
"2277","09020","2015",1,1,0,80000,909,88
"2278","09023","2015",5,5,0,57840,792.2,78.6
"2279","09024","2015",2,2,0,105100,829.5,129.5
"2280","09025","2015",1,1,0,70000,1167,60
"2281","09026","2015",6,6,0,111583.333333333,1710.83333333333,66.6666666666667
"2282","09029","2015",6,2,4,66594.1666666667,960.5,67.3333333333333
"2283","09030","2015",4,4,0,50625,1115,51.25
"2284","09032","2015",80,17,63,86650.5125,2036.4125,49.2875
"2285","09035","2015",2,2,0,84500,1037,81
"2286","09037","2015",2,2,0,110500,1213.5,88.5
"2287","09038","2015",6,6,0,95930,984.333333333333,93.8333333333333
"2288","09039","2015",3,3,0,89333.3333333333,982.666666666667,90.6666666666667
"2289","09040","2015",3,3,0,157290.666666667,1403,113
"2290","09041","2015",4,4,0,107000,1003.75,104.75
"2291","09042","2015",7,7,0,68578.5714285714,909.285714285714,77.5714285714286
"2292","09043","2015",9,8,1,64662.2222222222,722.555555555556,86.2222222222222
"2293","09044","2015",3,3,0,207811,1711.66666666667,106.666666666667
"2294","09045","2015",4,4,0,1e+05,1203.5,80
"2295","09046","2015",1,1,0,70000,614,114
"2296","09047","2015",7,6,1,72282.8571428571,944,86.2857142857143
"2297","09049","2015",3,3,0,68666.6666666667,1425.33333333333,46.6666666666667
"2298","09050","2015",2,1,1,73280,1015.5,118
"2299","09051","2015",1,1,0,230000,1243,185
"2300","09052","2015",3,3,0,141333.333333333,1237.33333333333,111.333333333333
"2301","09054","2015",3,3,0,157666.666666667,1037.33333333333,149.666666666667
"2302","09055","2015",1,1,0,60000,2000,30
"2303","09057","2015",10,10,0,93000,1568,61
"2304","09058","2015",2,2,0,109350,1188.5,92
"2305","09059","2015",1,1,0,133000,1662,80
"2306","09060","2015",10,10,0,129600,1310.1,108.5
"2307","09061","2015",3,3,0,58666.6666666667,1030,62.3333333333333
"2308","09062","2015",6,6,0,95795,1195.33333333333,79.3333333333333
"2309","09063","2015",1,1,0,50000,769,65
"2310","09064","2015",3,3,0,105000,1225,87
"2311","09065","2015",12,12,0,73557.5,1149.75,73.6666666666667
"2312","09066","2015",2,2,0,170500,1223,137.5
"2313","09067","2015",1,1,0,78000,619,126
"2314","09068","2015",2,2,0,109500,1682,63.5
"2315","09069","2015",1,1,0,138000,1062,130
"2316","09070","2015",4,4,0,86670,762.75,112.25
"2317","09073","2015",1,1,0,138000,1353,102
"2318","09074","2015",4,4,0,92518.75,1074.75,82.5
"2319","09075","2015",3,3,0,85476.6666666667,729.666666666667,112.666666666667
"2320","09076","2015",1,1,0,99000,1100,90
"2321","09077","2015",2,2,0,56000,777,73.5
"2322","09078","2015",1,1,0,172000,1811,95
"2323","09079","2015",8,8,0,195762.5,1778.75,110.375
"2324","09080","2015",2,2,0,119200,1005,124
"2325","09081","2015",1,1,0,240000,1600,150
"2326","09082","2015",5,5,0,97245.2,1199.2,87.6
"2327","09085","2015",4,4,0,106250,1122.25,97.25
"2328","09086","2015",3,3,0,126333.333333333,1225.33333333333,93.6666666666667
"2329","09091","2015",1,1,0,167000,1193,140
"2330","09093","2015",2,2,0,117871.5,2062.5,64
"2331","09094","2015",1,1,0,69600,1160,60
"2332","09095","2015",3,3,0,125683.333333333,1685.33333333333,75.3333333333333
"2333","09099","2015",2,2,0,117500,1361,85
"2334","09100","2015",2,1,1,37170,1115.5,38
"2335","09101","2015",2,2,0,130000,1592,100.5
"2336","09102","2015",1,1,0,1e+05,917,109
"2337","09103","2015",7,7,0,177878.571428571,1417.57142857143,136.142857142857
"2338","09104","2015",3,3,0,114333.333333333,1387,78.6666666666667
"2339","09105","2015",6,6,0,79583.3333333333,1108.83333333333,78.1666666666667
"2340","09107","2015",10,10,0,81600,895,90.2
"2341","09108","2015",3,3,0,54000,478.666666666667,109.666666666667
"2342","09109","2015",3,3,0,155300,1471.33333333333,96
"2343","09110","2015",2,2,0,128000,1180,108
"2344","09111","2015",1,1,0,142000,1614,88
"2345","09113","2015",2,2,0,79000,742.5,92
"2346","09114","2015",1,1,0,120000,2264,53
"2347","09115","2015",1,1,0,140000,1373,102
"2348","09116","2015",3,3,0,154666.666666667,1449,110
"2349","09117","2015",1,1,0,255000,1645,155
"2350","09118","2015",2,2,0,114000,1314.5,78
"2351","09119","2015",7,7,0,68785.7142857143,944.571428571429,71.5714285714286
"2352","09121","2015",8,8,0,128000,1276,106
"2353","09122","2015",95,57,38,111388.894736842,1307.84210526316,85.6526315789474
"2354","09123","2015",2,1,1,159757.5,1735,103
"2355","09124","2015",14,14,0,131753.571428571,1465.21428571429,92.2857142857143
"2356","09125","2015",5,5,0,115741.6,992.8,120.8
"2357","09127","2015",1,1,0,50000,357,140
"2358","09128","2015",2,2,0,137500,1582,88.5
"2359","09129","2015",2,2,0,94500,1829,50
"2360","09130","2015",10,10,0,105710,1157.9,87.3
"2361","09131","2015",2,2,0,119475,817.5,144
"2362","09136","2015",3,3,0,68666.6666666667,1014.33333333333,71.6666666666667
"2363","09137","2015",1,1,0,132000,754,175
"2364","09138","2015",3,3,0,185366.666666667,1729.66666666667,121
"2365","09139","2015",1,1,0,81700,527,155
"2366","09140","2015",1,1,0,371550,2308,161
"2367","09141","2015",2,2,0,66400,1309,54
"2368","09142","2015",2,2,0,116500,1358.5,97.5
"2369","09145","2015",3,3,0,117666.666666667,1105,116.333333333333
"2370","09147","2015",3,3,0,247666.666666667,2188.33333333333,119.333333333333
"2371","09148","2015",2,2,0,80000,1090,78
"2372","09149","2015",2,2,0,62325,686.5,89.5
"2373","09150","2015",1,1,0,41000,342,120
"2374","09151","2015",2,2,0,103750,1033,98.5
"2375","09152","2015",1,1,0,70000,1400,50
"2376","09153","2015",1,1,0,115000,1438,80
"2377","09155","2015",3,3,0,89913.3333333333,1304,70
"2378","09156","2015",1,1,0,110000,1170,94
"2379","09157","2015",21,21,0,73000,900.238095238095,82.0952380952381
"2380","09158","2015",2,2,0,226250,1597.5,127.5
"2381","09160","2015",61,57,4,88155.2459016393,946.032786885246,91.4590163934426
"2382","09161","2015",11,11,0,130772.727272727,1224.27272727273,98.2727272727273
"2383","09164","2015",5,5,0,95560,1082.2,92.2
"2384","09165","2015",2,2,0,116000,750,148
"2385","09166","2015",1,1,0,54500,924,59
"2386","09167","2015",12,12,0,172250,1742.16666666667,106.5
"2387","09168","2015",1,1,0,122500,817,150
"2388","09169","2015",1,1,0,268000,1605,167
"2389","09170","2015",5,5,0,105400,1266.4,82.6
"2390","09173","2015",2,2,0,180212.5,918,233
"2391","09174","2015",2,2,0,186500,1953.5,95.5
"2392","09176","2015",8,7,1,98822.5,1191.375,80
"2393","09177","2015",2,2,0,162500,1366.5,118
"2394","09178","2015",1,1,0,295000,2458,120
"2395","09179","2015",4,4,0,225075,1524.75,146.5
"2396","09180","2015",3,3,0,189000,1476,130
"2397","09181","2015",15,14,1,104500.066666667,1207.33333333333,88.4666666666667
"2398","09182","2015",9,9,0,101572.222222222,1637.33333333333,74.7777777777778
"2399","09185","2015",39,37,2,143098.051282051,1444.20512820513,103
"2400","09186","2015",1,1,0,245000,4083,60
"2401","09187","2015",2,2,0,95827.5,1067.5,93
"2402","09188","2015",11,11,0,93093.6363636364,1306,75.2727272727273
"2403","09189","2015",2,2,0,95570,1278.5,77
"2404","09192","2015",2,2,0,69250,1350,53
"2405","09193","2015",3,3,0,81333.3333333333,2075.66666666667,43.3333333333333
"2406","09194","2015",40,32,8,123790,1379.225,90.475
"2407","09196","2015",1,1,0,47510,792,60
"2408","09197","2015",1,1,0,61000,1130,54
"2409","09198","2015",4,4,0,48625,538.75,93.75
"2410","09199","2015",3,3,0,79777.6666666667,973,87
"2411","09200","2015",2,2,0,101000,833,122
"2412","09202","2015",3,3,0,82333.3333333333,919.666666666667,103
"2413","09203","2015",1,1,0,175000,1458,120
"2414","09205","2015",2,2,0,129000,1699.5,74
"2415","09206","2015",24,8,16,57035.3333333333,1472.58333333333,43.2916666666667
"2416","09207","2015",25,25,0,103606,1210.4,91.72
"2417","09209","2015",9,9,0,130884.444444444,1492.88888888889,89.5555555555556
"2418","09210","2015",4,4,0,144250,1132,127.75
"2419","09211","2015",3,3,0,72333.3333333333,1164,59.6666666666667
"2420","09212","2015",2,2,0,119500,1086.5,98
"2421","09213","2015",2,2,0,144500,1420,102
"2422","09214","2015",10,10,0,110211.9,1280,84.1
"2423","09215","2015",2,2,0,85000,1382,62
"2424","09217","2015",3,3,0,57466.6666666667,973,60.6666666666667
"2425","09218","2015",4,4,0,134892.5,1606.75,84.75
"2426","09219","2015",2,2,0,94437.5,1106.5,84.5
"2427","09220","2015",2,2,0,53492.5,1094,46.5
"2428","09221","2015",3,2,1,108200,1251,85
"2429","09222","2015",1,1,0,110000,1341,82
"2430","09223","2015",7,7,0,98557.1428571429,1245,90.8571428571429
"2431","09224","2015",8,8,0,109250,1148.625,92.5
"2432","09225","2015",121,87,34,110042.05785124,1310.09917355372,85.1074380165289
"2433","09226","2015",2,2,0,68500,709.5,90.5
"2434","09227","2015",1,1,0,106200,1002,106
"2435","09229","2015",4,4,0,191750,1613,115.5
"2436","09230","2015",2,2,0,90000,1180,75
"2437","09231","2015",5,5,0,51400,1165.8,49.6
"2438","09232","2015",2,2,0,64875,1266.5,52.5
"2439","09233","2015",2,2,0,134000,1294,104
"2440","09234","2015",1,1,0,35200,429,82
"2441","09235","2015",9,9,0,104924.555555556,1026.77777777778,100.222222222222
"2442","09236","2015",5,5,0,146040,1888.2,78.8
"2443","09237","2015",1,1,0,1e+05,800,125
"2444","09238","2015",7,7,0,161870,1233,136.428571428571
"2445","09239","2015",7,7,0,87002.8571428571,1021,87.2857142857143
"2446","09241","2015",2,2,0,44112.5,621.5,67
"2447","09244","2015",7,7,0,95035.7142857143,1071.71428571429,89.7142857142857
"2448","09245","2015",6,6,0,161871.666666667,1399.66666666667,103.333333333333
"2449","09246","2015",2,2,0,103250,1348,77
"2450","09247","2015",1,1,0,45000,1000,45
"2451","09249","2015",5,5,0,141200,1460.6,106.6
"2452","09250","2015",2,2,0,82100,1160,76
"2453","09251","2015",2,2,0,87714.5,967.5,92.5
"2454","09252","2015",1,1,0,90000,1059,85
"2455","09253","2015",2,2,0,64500,727,83.5
"2456","09254","2015",1,1,0,195000,1625,120
"2457","09256","2015",1,1,0,72500,462,157
"2458","09257","2015",5,5,0,89400,975.2,95.2
"2459","09258","2015",4,4,0,146000,1550,100
"2460","09261","2015",61,42,19,99105.0819672131,1159.5737704918,84.9180327868852
"2461","09263","2015",1,1,0,90000,1698,53
"2462","09264","2015",13,13,0,157265.384615385,1699.76923076923,95.1538461538462
"2463","09265","2015",32,32,0,150181.65625,1434.03125,107.03125
"2464","09267","2015",3,3,0,74166.6666666667,907.333333333333,76.3333333333333
"2465","09268","2015",8,8,0,110656.25,1181.125,93
"2466","09269","2015",3,3,0,199966.666666667,1626.33333333333,133.666666666667
"2467","09270","2015",2,2,0,119000,1225,91.5
"2468","09272","2015",10,10,0,127500,1377.1,93
"2469","09273","2015",8,8,0,127700,1275.25,105.125
"2470","09274","2015",2,2,0,117500,1237,95
"2471","09275","2015",3,3,0,233833.333333333,1548,170.666666666667
"2472","09276","2015",2,2,0,98387.5,769.5,118
"2473","09277","2015",6,6,0,104166.666666667,1241.5,80.8333333333333
"2474","09280","2015",5,5,0,70020,935.8,71.6
"2475","09281","2015",1,1,0,54890,508,108
"2476","09282","2015",39,38,1,139838.948717949,1559.35897435897,90.7179487179487
"2477","09283","2015",4,1,3,69250,1661.75,48
"2478","09285","2015",10,10,0,98302.5,1353,77
"2479","09289","2015",13,13,0,128692.307692308,1143.46153846154,113.923076923077
"2480","09290","2015",4,4,0,67250,891.75,71
"2481","09291","2015",3,3,0,100610,1780.66666666667,54.6666666666667
"2482","09293","2015",21,21,0,98272.8095238095,1032.80952380952,106.809523809524
"2483","09295","2015",2,2,0,157000,1396,114
"2484","09296","2015",1,1,0,66000,569,116
"2485","09298","2015",6,6,0,83850,1258.16666666667,72
"2486","09299","2015",12,12,0,94041.6666666667,1437.33333333333,65.9166666666667
"2487","09300","2015",1,1,0,180000,1731,104
"2488","09301","2015",6,6,0,78000,1282,62
"2489","09303","2015",1,1,0,80000,1600,50
"2490","09305","2015",6,6,0,105266.666666667,1014.16666666667,105.833333333333
"2491","09306","2015",14,10,4,89032.5,1127.42857142857,83.8571428571429
"2492","09312","2015",36,36,0,166081.305555556,1635.30555555556,101.555555555556
"2493","09314","2015",4,4,0,147620,1327.5,117.25
"2494","09315","2015",1,1,0,95000,594,160
"2495","09316","2015",1,1,0,63000,750,84
"2496","09318","2015",1,1,0,160200,8010,20
"2497","09319","2015",2,2,0,117500,1049.5,101
"2498","09320","2015",1,1,0,30000,600,50
"2499","09321","2015",1,1,0,70000,1000,70
"2500","09322","2015",37,25,12,71060.0810810811,1576.35135135135,48.1351351351351
"2501","09324","2015",37,36,1,153863.513513514,1619.54054054054,99.5135135135135
"2502","09325","2015",1,1,0,64000,1067,60
"2503","09326","2015",1,1,0,233000,2026,115
"2504","09327","2015",2,2,0,100750,891.5,111
"2505","09328","2015",4,4,0,120381.25,1202.25,91.25
"2506","09329","2015",3,3,0,127933.333333333,1271.33333333333,106
"2507","09330","2015",1,1,0,26000,394,66
"2508","09331","2015",5,5,0,172300,1603.4,110.8
"2509","09332","2015",24,23,1,166226,1410.83333333333,123.25
"2510","09334","2015",6,5,1,84286.6666666667,1470,69.1666666666667
"2511","09336","2015",10,10,0,75115,782.2,95.4
"2512","09338","2015",1,1,0,273000,2395,114
"2513","09339","2015",8,8,0,143029.25,1364.25,102.875
"2514","09340","2015",2,2,0,59500,923,64
"2515","09342","2015",3,3,0,120333.333333333,1315,90.3333333333333
"2516","10002","2015",3,3,0,126500,1362,95
"2517","10003","2015",37,36,1,90627.027027027,1067.51351351351,88.2162162162162
"2518","10004","2015",1,1,0,55000,1078,51
"2519","10005","2015",2,2,0,120000,966.5,147
"2520","10006","2015",24,21,3,92478.3333333333,1068.66666666667,83.8333333333333
"2521","10008","2015",1,1,0,140000,1400,100
"2522","10011","2015",2,2,0,162462.5,993.5,161
"2523","10012","2015",3,3,0,112666.666666667,1149.66666666667,96.3333333333333
"2524","10014","2015",3,3,0,156700,1454.66666666667,109.333333333333
"2525","10015","2015",7,7,0,166800,1547,110.285714285714
"2526","10018","2015",8,8,0,95031.25,815.25,120.75
"2527","10023","2015",2,2,0,133750,1261,113.5
"2528","10024","2015",1,1,0,115000,1117,103
"2529","10030","2015",8,8,0,187945,1949.375,94.625
"2530","10031","2015",3,3,0,97566.6666666667,1557.66666666667,66.3333333333333
"2531","10033","2015",28,27,1,104388.428571429,1012.5,106.892857142857
"2532","10034","2015",23,21,2,102139.130434783,1155.5652173913,87.6521739130435
"2533","10035","2015",10,10,0,83137,880.9,95.5
"2534","10037","2015",3,3,0,160666.666666667,1413.33333333333,117.333333333333
"2535","10038","2015",2,2,0,81000,1112,73
"2536","10040","2015",2,2,0,42500,473.5,86
"2537","10042","2015",4,4,0,74750,671.5,104.75
"2538","10043","2015",4,4,0,50125,620.75,84
"2539","10045","2015",1,1,0,90000,750,120
"2540","10049","2015",7,7,0,159971.428571429,1509.71428571429,109
"2541","10051","2015",9,9,0,117111.111111111,1129.33333333333,108.888888888889
"2542","10052","2015",3,3,0,151333.333333333,1430.33333333333,115.666666666667
"2543","10053","2015",3,3,0,214333.333333333,1957.33333333333,106.333333333333
"2544","10054","2015",1,1,0,148000,1276,116
"2545","10055","2015",2,2,0,144500,1386,107
"2546","10056","2015",2,2,0,157425,1764,89.5
"2547","10060","2015",27,23,4,148557.037037037,1722.92592592593,90.5925925925926
"2548","10061","2015",3,3,0,56333.3333333333,906,61
"2549","10062","2015",2,2,0,141500,1608.5,88
"2550","10066","2015",4,4,0,127500,1106,114.5
"2551","10067","2015",28,13,15,121591.071428571,1253.17857142857,97.6785714285714
"2552","10074","2015",3,3,0,199176.666666667,1572.33333333333,119.333333333333
"2553","10079","2015",1,1,0,30000,500,60
"2554","10080","2015",8,8,0,93612.5,1112.25,78.125
"2555","10081","2015",73,41,32,109873.01369863,1350,79.4657534246575
"2556","10082","2015",2,2,0,144000,1492,96
"2557","10083","2015",4,4,0,123222.5,1044,111
"2558","10084","2015",9,9,0,165284.444444444,1669.77777777778,104.333333333333
"2559","10085","2015",1,1,0,1e+05,1176,85
"2560","10089","2015",7,7,0,102469,1090.71428571429,89.1428571428571
"2561","10090","2015",1,1,0,51600,344,150
"2562","10091","2015",2,2,0,107500,844.5,128
"2563","10092","2015",1,1,0,110000,2000,55
"2564","10095","2015",4,4,0,70500,865.25,83
"2565","10096","2015",2,2,0,205000,1154,185
"2566","10098","2015",4,4,0,68000,455,151
"2567","10099","2015",10,10,0,90600,951.8,91.1
"2568","10100","2015",10,10,0,136105,1317,108.6
"2569","10101","2015",1,1,0,110000,728,151
"2570","10104","2015",4,4,0,133875,1485.75,90
"2571","10106","2015",1,1,0,150000,1172,128
"2572","10107","2015",2,2,0,54500,512.5,114.5
"2573","10110","2015",4,4,0,207562.5,1903,98.75
"2574","10112","2015",1,1,0,29000,604,48
"2575","10113","2015",1,1,0,114800,1320,87
"2576","10114","2015",5,4,1,122800,1297.2,95.4
"2577","10115","2015",14,14,0,205989.285714286,1810.5,116.214285714286
"2578","10116","2015",1,1,0,52000,650,80
"2579","10117","2015",2,2,0,115000,912,147.5
"2580","10118","2015",2,2,0,92500,981.5,105
"2581","10120","2015",1,1,0,86000,956,90
"2582","10121","2015",2,2,0,127775,771,163.5
"2583","10122","2015",1,1,0,33560,373,90
"2584","10124","2015",2,2,0,95420,890.5,94
"2585","10125","2015",1,1,0,278000,1448,192
"2586","10129","2015",3,3,0,140666.666666667,1311.33333333333,107
"2587","10131","2015",1,1,0,136700,1139,120
"2588","10132","2015",2,2,0,85000,1184,71.5
"2589","10133","2015",5,5,0,102321.4,962.8,113
"2590","10135","2015",2,2,0,150000,1553.5,124.5
"2591","10139","2015",2,2,0,85500,916.5,88
"2592","10140","2015",8,8,0,72125,715.25,105.625
"2593","10141","2015",3,3,0,63333.3333333333,868.666666666667,69.3333333333333
"2594","10142","2015",11,11,0,89672.7272727273,946.636363636364,98.5454545454545
"2595","10144","2015",1,1,0,141200,1412,100
"2596","10145","2015",3,3,0,97333.3333333333,1180.33333333333,86.6666666666667
"2597","10146","2015",4,4,0,100850,1072.25,100.5
"2598","10147","2015",1,1,0,157500,808,195
"2599","10148","2015",4,4,0,131750,1071.5,129
"2600","10149","2015",1,1,0,167000,1505,111
"2601","10150","2015",1,1,0,180000,1111,162
"2602","10151","2015",11,11,0,89645.4545454545,987,106.090909090909
"2603","10156","2015",9,8,1,133055.555555556,1158.88888888889,121.666666666667
"2604","10157","2015",4,4,0,128098.75,987.5,125
"2605","10158","2015",8,8,0,152888.625,1846.25,99.125
"2606","10163","2015",1,1,0,93000,1240,75
"2607","10164","2015",7,7,0,111142.857142857,1344.14285714286,83.4285714285714
"2608","10165","2015",7,7,0,154490,1646.28571428571,103.571428571429
"2609","10166","2015",3,3,0,122666.666666667,1341.33333333333,94
"2610","10170","2015",4,4,0,97500,1103.5,93
"2611","10171","2015",2,2,0,76500,988.5,79
"2612","10172","2015",2,2,0,92650,1382.5,62.5
"2613","10174","2015",4,4,0,111375,793.75,133.5
"2614","10176","2015",1,1,0,144700,1148,126
"2615","10177","2015",4,4,0,156500,1558,100.25
"2616","10178","2015",1,1,0,135000,794,170
"2617","10179","2015",3,3,0,132666.666666667,1116.66666666667,130
"2618","10181","2015",3,3,0,109700,1465,84
"2619","10184","2015",3,3,0,93500,1061.33333333333,88.3333333333333
"2620","10185","2015",3,3,0,109833.333333333,1022.66666666667,100.666666666667
"2621","10186","2015",7,6,1,167844.285714286,1203.14285714286,145
"2622","10187","2015",3,3,0,136500,806.333333333333,169.333333333333
"2623","10190","2015",5,5,0,186612,1796.6,115.8
"2624","10191","2015",6,6,0,258000,2031.16666666667,128.166666666667
"2625","10194","2015",1,1,0,78000,975,80
"2626","10196","2015",1,1,0,47000,456,103
"2627","10197","2015",4,4,0,66250,724,92.25
"2628","10198","2015",1,1,0,275000,1562,176
"2629","10199","2015",2,2,0,40000,738,63.5
"2630","10205","2015",2,2,0,105000,811.5,132
"2631","10207","2015",2,2,0,74000,1788.5,76.5
"2632","10208","2015",3,3,0,142666.666666667,1511.33333333333,100
"2633","10209","2015",15,13,2,197666.666666667,1635.66666666667,123.6
"2634","10210","2015",8,8,0,177912.5,1479,120.875
"2635","10211","2015",14,14,0,154310,1474.92857142857,101.928571428571
"2636","10213","2015",1,1,0,130000,1083,120
"2637","10214","2015",3,3,0,61333.3333333333,917,70
"2638","10215","2015",3,3,0,1e+05,904.333333333333,118.333333333333
"2639","10216","2015",9,8,1,90505.5555555556,938.777777777778,101.333333333333
"2640","10218","2015",1,1,0,114000,1163,98
"2641","10220","2015",11,11,0,111000.909090909,1291.36363636364,84.7272727272727
"2642","10222","2015",6,6,0,159666.666666667,1223.5,134.5
"2643","10223","2015",5,5,0,115218.6,1268.2,93
"2644","10224","2015",15,15,0,121377,1012.13333333333,122.4
"2645","10225","2015",5,5,0,102936,1562.8,69.6
"2646","10227","2015",2,2,0,89000,1239.5,71.5
"2647","10229","2015",1,1,0,120000,1364,88
"2648","10230","2015",1,1,0,345000,1597,216
"2649","10233","2015",14,14,0,95927.8571428571,963.214285714286,101.357142857143
"2650","10234","2015",3,3,0,182666.666666667,1332.33333333333,139.333333333333
"2651","10237","2015",8,8,0,148762.5,1374.5,110.625
"2652","10238","2015",6,6,0,125666.666666667,1600.5,78.3333333333333
"2653","10239","2015",10,10,0,143385,1572.3,89.9
"2654","10240","2015",4,4,0,108500,1187.75,91.25
"2655","10243","2015",2,2,0,112500,950,100
"2656","10245","2015",5,4,1,156648.6,1324.4,116.4
"2657","10246","2015",5,5,0,134000,1377,101.4
"2658","10248","2015",2,2,0,222500,1793,123
"2659","10249","2015",1,1,0,2e+05,1439,139
"2660","10250","2015",1,1,0,135000,1038,130
"2661","10251","2015",3,3,0,171666.666666667,1329,131.666666666667
"2662","10254","2015",3,3,0,81833.3333333333,1167.66666666667,86
"2663","10255","2015",4,4,0,84625,980.75,82.75
"2664","10256","2015",3,3,0,164473.333333333,1237,153.666666666667
"2665","10257","2015",1,1,0,35000,515,68
"2666","10258","2015",2,2,0,96000,1108,86
"2667","10259","2015",2,2,0,171250,1773.5,99.5
"2668","10260","2015",3,3,0,196233.333333333,1603,122.333333333333
"2669","10261","2015",5,5,0,132000,1442.6,100.8
"2670","10263","2015",5,5,0,139700,1153.2,122.6
"2671","10265","2015",17,16,1,136135.294117647,1689.41176470588,84.4117647058823
"2672","10267","2015",2,2,0,69000,894.5,77
"2673","10268","2015",41,39,2,133240.731707317,1548.12195121951,88.5121951219512
"2674","10271","2015",7,7,0,116440,1151.28571428571,104.428571428571
"2675","10272","2015",1,1,0,55000,688,80
"2676","10274","2015",4,4,0,74250,658.5,110.25
"2677","10275","2015",3,3,0,136566.666666667,1067.33333333333,134.666666666667
"2678","10276","2015",9,9,0,90000,1125.66666666667,84.3333333333333
"2679","10278","2015",1,1,0,114000,942,121
"2680","10280","2015",7,7,0,110714.285714286,1210.14285714286,88.8571428571429
"2681","10281","2015",1,1,0,135000,2109,64
"2682","10282","2015",7,7,0,181255.714285714,1794.42857142857,105.714285714286
"2683","10287","2015",6,6,0,100266.666666667,1416.83333333333,69.1666666666667
"2684","10288","2015",2,2,0,80000,652,143.5
"2685","10290","2015",5,5,0,76660,622,126.4
"2686","10293","2015",2,2,0,70000,887.5,83
"2687","10296","2015",4,4,0,141625,1864.75,91
"2688","10297","2015",36,29,7,170013.666666667,1824.16666666667,96.5
"2689","10299","2015",6,6,0,155333.333333333,1904,92.3333333333333
"2690","10300","2015",2,2,0,60000,702,76
"2691","10301","2015",2,2,0,102500,1175,90
"2692","10305","2015",1,1,0,81000,827,98
"2693","10306","2015",2,2,0,75500,940,89.5
"2694","10307","2015",1,1,0,115000,1075,107
"2695","10310","2015",2,2,0,145000,970.5,149.5
"2696","10312","2015",2,2,0,111000,870.5,122.5
"2697","10314","2015",3,3,0,101166.666666667,1134,111.333333333333
"2698","10316","2015",2,2,0,105000,1052.5,106
"2699","10317","2015",13,13,0,76278.6153846154,805.461538461538,96.1538461538462
"2700","10318","2015",3,3,0,131333.333333333,1034.66666666667,127.333333333333
"2701","10319","2015",4,4,0,87000,598.25,132.75
"2702","10320","2015",3,3,0,124333.333333333,945.666666666667,141
"2703","10321","2015",22,22,0,192361.363636364,1768.18181818182,113.818181818182
"2704","10323","2015",150,123,27,81558.5866666667,1038.66666666667,79.82
"2705","10325","2015",29,28,1,189415.862068966,1893.62068965517,103.655172413793
"2706","10329","2015",4,4,0,197312.5,1751.5,115
"2707","10330","2015",1,1,0,72000,600,120
"2708","10331","2015",5,5,0,149624,1084.6,153
"2709","10332","2015",2,2,0,187500,1643,122.5
"2710","10333","2015",163,89,74,118373.588957055,1471.46012269939,80.2944785276074
"2711","10338","2015",1,1,0,125000,1136,110
"2712","10339","2015",1,1,0,130000,1368,95
"2713","10340","2015",27,26,1,153166.666666667,1454.51851851852,106.851851851852
"2714","10341","2015",1,1,0,142000,631,225
"2715","10342","2015",5,5,0,109600,1085.8,100.6
"2716","10343","2015",80,58,22,162115,1640.7625,96.0625
"2717","10344","2015",5,5,0,208000,1504.2,152.8
"2718","10347","2015",4,4,0,138750,1614,93.5
"2719","10348","2015",1,1,0,140000,1474,95
"2720","10349","2015",27,27,0,168842.259259259,1594.74074074074,106.925925925926
"2721","10350","2015",10,10,0,91600,911.5,111.7
"2722","10351","2015",2,2,0,152075,1564,97.5
"2723","10352","2015",10,10,0,201030,1610,127.9
"2724","10353","2015",7,7,0,130814.285714286,1386.85714285714,94.4285714285714
"2725","10356","2015",6,6,0,102166.666666667,1093,97.1666666666667
"2726","10357","2015",34,34,0,166970.205882353,1814.08823529412,100.882352941176
"2727","10359","2015",2,2,0,112000,816.5,127
"2728","10360","2015",7,7,0,194757.142857143,1683.28571428571,118.571428571429
"2729","10362","2015",173,93,80,121964.924855491,1571.52601156069,76.3294797687861
"2730","10363","2015",1,1,0,65000,855,76
"2731","10366","2015",1,1,0,32700,409,80
"2732","10368","2015",7,7,0,152285.714285714,1462.14285714286,106
"2733","10369","2015",1,1,0,64225,756,85
"2734","10371","2015",1,1,0,179000,1072,167
"2735","10373","2015",3,3,0,125333.333333333,1138,106.666666666667
"2736","10375","2015",2,2,0,145500,1644,88
"2737","10376","2015",2,2,0,98000,1027,95
"2738","10378","2015",1,1,0,110000,688,160
"2739","10379","2015",2,2,0,119150,1477,81
"2740","10380","2015",1,1,0,113333,640,177
"2741","10381","2015",6,5,1,108333.333333333,1436.16666666667,76.3333333333333
"2742","10387","2015",876,208,668,96628.4166666667,1437.69292237443,67.5810502283105
"2743","10389","2015",1,1,0,85000,977,87
"2744","10391","2015",2,2,0,150000,1663,91.5
"2745","10392","2015",2,2,0,122000,1664,74
"2746","10394","2015",1,1,0,52000,693,75
"2747","10395","2015",1,1,0,210000,1615,130
"2748","10396","2015",2,2,0,130000,1290.5,100
"2749","10398","2015",1,1,0,77000,1055,73
"2750","10401","2015",15,15,0,83820,1006.13333333333,83.2
"2751","10402","2015",1,1,0,145000,1686,86
"2752","10404","2015",2,2,0,88250,637.5,153.5
"2753","10406","2015",18,18,0,145675.555555556,1435.33333333333,99
"2754","10408","2015",1,1,0,93500,714,131
"2755","10409","2015",5,5,0,204300,1424.8,140
"2756","10411","2015",1,1,0,58100,880,66
"2757","10412","2015",4,4,0,156287.5,1352.75,118.5
"2758","10416","2015",4,4,0,187700,1281.25,135.25
"2759","10422","2015",3,3,0,84333.3333333333,954.333333333333,93.3333333333333
"2760","10423","2015",2,2,0,104750,1407.5,74
"2761","10424","2015",1,1,0,30000,545,55
"2762","10425","2015",2,2,0,129000,1208.5,108.5
"2763","10428","2015",1,1,0,40000,580,69
"2764","10430","2015",1,1,0,88000,710,124
"2765","10431","2015",1,1,0,52140,501,104
"2766","10433","2015",3,3,0,104333.333333333,1819.66666666667,55.3333333333333
"2767","10435","2015",1,1,0,180300,1821,99
"2768","10436","2015",1,1,0,135000,1406,96
"2769","10437","2015",5,4,1,87200,1156.8,88.4
"2770","10439","2015",4,4,0,195585,1128,156
"2771","10440","2015",2,2,0,135650,1440.5,94
"2772","10441","2015",2,2,0,105990,969,107
"2773","10442","2015",8,8,0,134425,1284.75,106.875
"2774","10444","2015",3,3,0,93333.3333333333,829.666666666667,109
"2775","11001","2015",2,2,0,114000,1201,97
"2776","11002","2015",2,1,1,96250,1281,69.5
"2777","11003","2015",1,1,0,54000,684,79
"2778","11004","2015",3,3,0,60666.6666666667,684.666666666667,90
"2779","11005","2015",9,9,0,157044.444444444,1708.55555555556,92.1111111111111
"2780","11007","2015",3,3,0,181466.666666667,1594.33333333333,116.333333333333
"2781","11008","2015",7,7,0,88596.4285714286,1121.42857142857,73.1428571428571
"2782","11009","2015",12,12,0,101775,1017.33333333333,100.583333333333
"2783","11010","2015",6,6,0,124666.666666667,1619.83333333333,79.3333333333333
"2784","11011","2015",4,4,0,240500,1775,130.75
"2785","11012","2015",26,25,1,163879.846153846,1782.53846153846,94.8076923076923
"2786","11013","2015",6,6,0,162833.333333333,1654,96.8333333333333
"2787","11014","2015",20,20,0,193512.5,1929.65,102.15
"2788","11018","2015",13,13,0,126461.538461538,1199.23076923077,107.153846153846
"2789","11020","2015",1,1,0,121000,1729,70
"2790","11021","2015",7,7,0,90857.1428571429,792.142857142857,124.285714285714
"2791","11022","2015",20,19,1,92767.5,1107.7,85.45
"2792","11023","2015",5,5,0,125600,1040.8,121
"2793","11024","2015",7,5,2,180771.428571429,2144,83.4285714285714
"2794","11025","2015",4,4,0,101750,956.75,100
"2795","11027","2015",4,3,1,113001.5,911.25,118.75
"2796","11028","2015",12,12,0,93583.3333333333,974.083333333333,104.333333333333
"2797","11029","2015",1,1,0,690000,4792,144
"2798","11032","2015",6,6,0,212351.833333333,1528.83333333333,131.5
"2799","11033","2015",11,11,0,121954.545454545,1079.90909090909,111
"2800","11034","2015",14,14,0,116357.142857143,1164.92857142857,106
"2801","11036","2015",3,3,0,96333.3333333333,1039.66666666667,99
"2802","11037","2015",6,6,0,141495,1370,104.833333333333
"2803","11038","2015",3,3,0,60000,1026.66666666667,63.3333333333333
"2804","11040","2015",21,21,0,107333.333333333,1331.85714285714,88.7142857142857
"2805","11041","2015",20,19,1,178764,1801.6,106.35
"2806","11043","2015",1,1,0,30000,750,40
"2807","11045","2015",3,3,0,54000,963,51.6666666666667
"2808","11048","2015",6,6,0,132581.666666667,1207,115.833333333333
"2809","11049","2015",31,27,4,133591.129032258,1736.48387096774,91.5161290322581
"2810","11051","2015",3,3,0,117833.333333333,1086.66666666667,106.666666666667
"2811","11052","2015",5,5,0,113800,1396.2,83.8
"2812","11053","2015",5,5,0,148180,1537.2,93.4
"2813","11054","2015",1,1,0,42000,339,124
"2814","11055","2015",6,6,0,148926,1267.66666666667,108.166666666667
"2815","11056","2015",2,2,0,49800,378,140
"2816","11058","2015",4,4,0,128125,1328.5,98.75
"2817","11059","2015",1,1,0,150000,938,160
"2818","11061","2015",5,5,0,164400,1088.4,170.2
"2819","11062","2015",1,1,0,90370,807,112
"2820","11063","2015",9,9,0,109533.333333333,1330.33333333333,77.2222222222222
"2821","11064","2015",1,1,0,98400,863,114
"2822","11066","2015",3,3,0,72470,1179.66666666667,62.6666666666667
"2823","11067","2015",18,17,1,139115.444444444,1542,90.9444444444444
"2824","11068","2015",10,10,0,75790,959.7,80.1
"2825","11069","2015",525,331,194,109147.434285714,1263.13523809524,86.1180952380952
"2826","11070","2015",4,4,0,95250,1427.75,77.25
"2827","11071","2015",1,1,0,57000,553,103
"2828","11072","2015",3,3,0,214533.333333333,1444.66666666667,154
"2829","11074","2015",2,2,0,192680,1912.5,102
"2830","11075","2015",3,3,0,95000,805.666666666667,130.333333333333
"2831","11076","2015",109,85,24,109840.733944954,1258.76146788991,87.8256880733945
"2832","11077","2015",8,8,0,99433.75,1155,86.375
"2833","11078","2015",1,1,0,185000,1423,130
"2834","11079","2015",2,2,0,79750,914,84
"2835","11080","2015",1,1,0,112500,1654,68
"2836","11081","2015",24,23,1,144918.125,1795.83333333333,88.1666666666667
"2837","11083","2015",2,2,0,87500,835.5,123
"2838","11084","2015",10,10,0,154165,1498.3,99.1
"2839","11085","2015",9,9,0,121888.888888889,1380.55555555556,95.6666666666667
"2840","11086","2015",16,16,0,188016.25,2114.125,88.4375
"2841","11088","2015",14,14,0,178678.857142857,1588,112.428571428571
"2842","11089","2015",7,6,1,90362.8571428571,841.857142857143,98.5714285714286
"2843","11090","2015",3,3,0,101666.666666667,1588.66666666667,61.6666666666667
"2844","11091","2015",12,10,2,77900.1666666667,922.916666666667,83.1666666666667
"2845","11093","2015",1,1,0,50000,1250,40
"2846","11094","2015",1,1,0,32500,417,78
"2847","11095","2015",3,3,0,172076.666666667,1633,106
"2848","11096","2015",1,1,0,106000,707,150
"2849","11098","2015",9,9,0,135805.555555556,1483.11111111111,89.3333333333333
"2850","11099","2015",30,30,0,146274.233333333,1309.5,101.266666666667
"2851","11102","2015",5,5,0,109040,1167.2,92.6
"2852","11103","2015",13,13,0,99015.3846153846,1002.76923076923,102
"2853","11104","2015",1,1,0,27000,643,42
"2854","11105","2015",6,6,0,123191.666666667,1352.33333333333,101.833333333333
"2855","11106","2015",53,49,4,144114.433962264,1632.67924528302,89.5094339622642
"2856","11110","2015",2,2,0,150500,1306,113
"2857","11111","2015",6,6,0,126455,1352.83333333333,88.5
"2858","11113","2015",1,1,0,50000,588,85
"2859","11114","2015",1,1,0,230000,2035,113
"2860","11115","2015",16,15,1,113072.8125,1252.0625,91.125
"2861","11116","2015",38,35,3,141944.657894737,1422.21052631579,95.2631578947368
"2862","11117","2015",1,1,0,110000,1410,78
"2863","11119","2015",4,4,0,161000,1826.75,100
"2864","11120","2015",4,4,0,178000,1626.5,109.75
"2865","11121","2015",3,3,0,101000,848,127.666666666667
"2866","11122","2015",13,12,1,119346.153846154,1339.92307692308,92.7692307692308
"2867","11123","2015",4,4,0,114000,1387.25,79.25
"2868","11124","2015",8,8,0,130750,1182.125,106.125
"2869","11125","2015",3,3,0,101333.333333333,899,111
"2870","11126","2015",6,6,0,76600,872.666666666667,89.3333333333333
"2871","11127","2015",1,1,0,16000,372,43
"2872","11128","2015",7,7,0,94571.4285714286,1250.85714285714,85.7142857142857
"2873","11129","2015",28,27,1,102576.785714286,1088.21428571429,98.4642857142857
"2874","11130","2015",4,4,0,62840,1044.25,74
"2875","11131","2015",9,9,0,104488.888888889,1084.22222222222,98.7777777777778
"2876","11132","2015",14,14,0,117357.5,1301.42857142857,98.6428571428571
"2877","11133","2015",1,1,0,130000,2063,63
"2878","11134","2015",1,1,0,265850,2462,108
"2879","11135","2015",1,1,0,65000,714,91
"2880","11136","2015",4,4,0,173125,1212.25,133.75
"2881","11137","2015",2,2,0,116125,1136,91.5
"2882","11138","2015",7,7,0,106371.428571429,1134.14285714286,92
"2883","11140","2015",11,11,0,145054.545454545,1432.72727272727,95.7272727272727
"2884","11141","2015",1,1,0,227500,1507,151
"2885","11142","2015",1,1,0,273400,2734,100
"2886","11144","2015",20,16,4,139770.6,1724.15,81.15
"2887","11145","2015",214,123,91,121540.457943925,2702.78971962617,50.2242990654206
"2888","11146","2015",3,3,0,154335,1386.33333333333,114
"2889","11148","2015",6,6,0,155833.333333333,1383.66666666667,109.5
"2890","11150","2015",6,6,0,127833.333333333,1268.83333333333,98.5
"2891","11151","2015",8,8,0,142168.375,1481.75,96.875
"2892","11153","2015",2,2,0,134500,1395,93
"2893","11156","2015",2,2,0,161500,1281.5,113
"2894","11157","2015",6,5,1,152099,1446.83333333333,103.666666666667
"2895","11158","2015",4,4,0,138500,1255.5,114.75
"2896","11159","2015",1,1,0,147500,1867,79
"2897","11163","2015",3,3,0,71666.6666666667,794.333333333333,91.6666666666667
"2898","11164","2015",17,17,0,178074.705882353,1510.52941176471,121.058823529412
"2899","11165","2015",5,5,0,116600,1109.2,116
"2900","11167","2015",1,1,0,140000,1414,99
"2901","11168","2015",1,1,0,210000,1400,150
"2902","11169","2015",2,2,0,178000,1283.5,143
"2903","11170","2015",319,137,182,123992.705329154,2922.46394984326,42.9686520376176
"2904","11172","2015",5,5,0,161200,1507.6,104
"2905","11173","2015",2,2,0,91020,1157,86
"2906","11174","2015",1,1,0,167000,1815,92
"2907","11175","2015",3,3,0,140433.333333333,1321.66666666667,118.333333333333
"2908","11176","2015",1,1,0,120000,857,140
"2909","11177","2015",1,1,0,52000,963,54
"2910","11178","2015",15,15,0,199510,1515.06666666667,128.866666666667
"2911","11179","2015",5,5,0,171700,1330,138
"2912","11181","2015",1,1,0,60000,600,100
"2913","11182","2015",9,9,0,97095.5555555556,1079.55555555556,86.4444444444444
"2914","11183","2015",3,3,0,142762.666666667,1149,123
"2915","11184","2015",7,7,0,132485.714285714,1460.14285714286,101.285714285714
"2916","11185","2015",10,10,0,175860,1584.6,107.9
"2917","11186","2015",1,1,0,198000,1100,180
"2918","11187","2015",4,4,0,102500,1029.5,97
"2919","11188","2015",14,13,1,145791.714285714,1634.35714285714,83.5
"2920","11189","2015",8,8,0,80585,1309.375,60.25
"2921","11190","2015",14,14,0,129031.714285714,1191.71428571429,113.357142857143
"2922","11191","2015",3,3,0,101300,1248.33333333333,81.3333333333333
"2923","11192","2015",7,6,1,105417.857142857,1070.42857142857,101.857142857143
"2924","11193","2015",1,1,0,170000,1932,88
"2925","11195","2015",5,5,0,158000,1945.2,88.4
"2926","11196","2015",1,1,0,140000,1505,93
"2927","11197","2015",13,11,2,125716.153846154,1359.07692307692,95
"2928","11198","2015",9,9,0,115666.666666667,1144.88888888889,92.7777777777778
"2929","11199","2015",8,8,0,180087.5,1680,104.875
"2930","11200","2015",3,3,0,88000,1079.66666666667,80
"2931","11201","2015",5,5,0,121920,1362.2,90.2
"2932","11202","2015",372,144,228,98480.7123655914,2658.18548387097,37.5645161290323
"2933","11203","2015",107,88,19,133265.336448598,1518.27102803738,89.6355140186916
"2934","11206","2015",110,92,18,121314.963636364,1296.20909090909,92.8272727272727
"2935","11207","2015",4,4,0,91000,1008.25,81.25
"2936","11208","2015",2,2,0,167000,1083,156
"2937","11209","2015",2,2,0,157475,1236.5,112.5
"2938","11210","2015",8,8,0,128218.75,1202.25,100.75
"2939","11211","2015",7,7,0,153788.571428571,1215.85714285714,111.142857142857
"2940","11212","2015",8,7,1,152489.375,1525.875,112
"2941","11213","2015",1,1,0,39000,672,58
"2942","11214","2015",1,1,0,4e+05,3150,127
"2943","11215","2015",11,11,0,123318.181818182,1187.72727272727,99.4545454545455
"2944","11216","2015",3,3,0,157600,1506.33333333333,104.333333333333
"2945","11217","2015",14,13,1,179548.571428571,1912.57142857143,93.5
"2946","11218","2015",2,2,0,257525,2412,109
"2947","11220","2015",7,6,1,145507.142857143,1343.85714285714,127.142857142857
"2948","11221","2015",5,5,0,66499.2,954.2,68.8
"2949","11222","2015",3,3,0,63895,636.666666666667,94.3333333333333
"2950","11224","2015",2,2,0,127400,1725,96.5
"2951","11225","2015",10,10,0,149200.4,1627.3,100.1
"2952","11228","2015",3,3,0,154188.666666667,937.666666666667,142.333333333333
"2953","11231","2015",1,1,0,62000,488,127
"2954","11232","2015",1,1,0,37000,617,60
"2955","11233","2015",3,3,0,100666.666666667,1246,77.6666666666667
"2956","11234","2015",1,1,0,85000,966,88
"2957","11235","2015",1,1,0,142366,1070,133
"2958","11236","2015",4,4,0,102862.5,1242.25,77.75
"2959","11239","2015",1,1,0,15000,469,32
"2960","11240","2015",4,4,0,173975,1336.75,138.25
"2961","11241","2015",5,5,0,206400,1717.2,113.8
"2962","11242","2015",2,2,0,110677,1042.5,94.5
"2963","11243","2015",5,5,0,128950,1506.8,83
"2964","11244","2015",4,4,0,37750,881.75,45
"2965","11248","2015",1,1,0,99000,1125,88
"2966","11249","2015",1,1,0,58000,460,126
"2967","11251","2015",17,17,0,92892.6470588235,945.117647058824,104.529411764706
"2968","11252","2015",4,4,0,184025,1156.75,170.75
"2969","11253","2015",8,8,0,132500,1116.625,115.875
"2970","11254","2015",18,18,0,117898.111111111,1410.83333333333,87.6111111111111
"2971","11255","2015",17,14,3,184048.764705882,1664.94117647059,112.588235294118
"2972","11256","2015",5,5,0,181960,1238.6,160.2
"2973","11257","2015",6,6,0,151873.333333333,1318,128.333333333333
"2974","11258","2015",25,24,1,147057.6,1502.56,98.08
"2975","11259","2015",12,11,1,114672.5,1347.66666666667,91.1666666666667
"2976","11260","2015",1,1,0,93100,1209,77
"2977","11261","2015",11,11,0,100264.818181818,1205.27272727273,85.4545454545455
"2978","11262","2015",822,367,455,141316.901459854,2079.78832116788,70.1289537712895
"2979","11263","2015",4,4,0,137625,1376.5,110
"2980","11264","2015",14,12,2,136975,1514.92857142857,92.3571428571429
"2981","11265","2015",2,2,0,36000,671.5,54.5
"2982","11266","2015",140,68,72,113009.242857143,2155.25,53.7857142857143
"2983","11267","2015",12,12,0,129342.5,1280.08333333333,105.25
"2984","11268","2015",1,1,0,60000,845,71
"2985","11269","2015",21,21,0,112035.714285714,1415.95238095238,78.8571428571429
"2986","11270","2015",5,5,0,43000,687.8,67
"2987","11272","2015",20,20,0,196488.9,1918.3,107.8
"2988","11273","2015",12,12,0,140095.833333333,1644.25,90.5
"2989","11274","2015",6,6,0,129360,1419.33333333333,84.6666666666667
"2990","11276","2015",7,7,0,69110.7142857143,929,70.1428571428571
"2991","11278","2015",2,2,0,124000,945,153.5
"2992","11279","2015",16,15,1,122837.6875,1260,98.875
"2993","11280","2015",11,11,0,117227.272727273,1313.54545454545,101.818181818182
"2994","11281","2015",6,6,0,135935.166666667,1499.66666666667,89.3333333333333
"2995","11283","2015",1,1,0,212500,4830,44
"2996","11284","2015",2,2,0,163725,1828,88.5
"2997","11285","2015",20,20,0,258374,2214,124.5
"2998","11286","2015",10,10,0,88540,935.2,95.1
"2999","11288","2015",22,22,0,139841.636363636,1312.5,106.136363636364
"3000","11289","2015",17,17,0,123303.882352941,1395.47058823529,88.8235294117647
"3001","11290","2015",4,4,0,142000,1239.25,110
"3002","11291","2015",2,2,0,138500,821.5,168.5
"3003","11292","2015",1,1,0,130000,807,161
"3004","11293","2015",8,8,0,141648.75,1378.25,107.5
"3005","11294","2015",1,1,0,5e+05,1449,345
"3006","11295","2015",14,14,0,125979.642857143,1309.35714285714,98.6428571428571
"3007","11296","2015",4,4,0,237905,2332,100
"3008","11297","2015",7,7,0,52428.5714285714,1001.42857142857,59
"3009","11299","2015",6,6,0,167750,1457.66666666667,123
"3010","11300","2015",1,1,0,148060,1007,147
"3011","11301","2015",17,17,0,95791.1764705882,1009.17647058824,96.1176470588235
"3012","11302","2015",6,6,0,101166.666666667,1533.66666666667,66.3333333333333
"3013","11303","2015",12,12,0,124716.666666667,1264.75,101
"3014","11304","2015",52,46,6,99062.3846153846,1047.76923076923,97.4615384615385
"3015","11305","2015",1,1,0,113675,1093,104
"3016","11306","2015",1,1,0,65000,867,75
"3017","11307","2015",4,4,0,86325,896.25,94.75
"3018","11308","2015",5,5,0,79300,876.4,96.8
"3019","11309","2015",3,3,0,89333.3333333333,914,94.6666666666667
"3020","11310","2015",10,3,7,38340,1038.1,39.9
"3021","11311","2015",7,7,0,91285.7142857143,1176.71428571429,94.8571428571429
"3022","11312","2015",2,2,0,129000,1086,124
"3023","11313","2015",2,2,0,198500,1585.5,147.5
"3024","11314","2015",2,2,0,56000,948.5,53
"3025","11315","2015",20,20,0,104851,1001.55,99.15
"3026","11316","2015",6,6,0,123036.666666667,1172.16666666667,110.666666666667
"3027","11317","2015",4,4,0,83250,723.75,106.5
"3028","11318","2015",1,1,0,80000,1000,80
"3029","11320","2015",2,2,0,41500,397,103.5
"3030","11321","2015",3,3,0,42000,745.333333333333,55.6666666666667
"3031","11322","2015",9,9,0,175640.555555556,2341.11111111111,87.5555555555556
"3032","11323","2015",1,1,0,122500,1392,88
"3033","11324","2015",3,3,0,64333.3333333333,800.666666666667,80.6666666666667
"3034","11325","2015",4,4,0,170712.5,1540.75,105.5
"3035","11326","2015",2,2,0,166750,1582,107.5
"3036","11327","2015",4,4,0,169300,1809.25,93.5
"3037","11328","2015",3,3,0,97633.3333333333,1051.33333333333,92
"3038","11330","2015",7,7,0,142214.285714286,1424.42857142857,98.1428571428571
"3039","11332","2015",19,19,0,117053.684210526,1388,91
"3040","11334","2015",1,1,0,158490,1781,89
"3041","11336","2015",2,2,0,117000,899,136
"3042","11337","2015",5,5,0,131000,1264,110.4
"3043","11339","2015",8,8,0,104056.25,1109.375,94.125
"3044","11340","2015",2,2,0,135500,1252.5,101
"3045","11341","2015",1,1,0,54000,600,90
"3046","11342","2015",1,1,0,150000,1744,86
"3047","11343","2015",1,1,0,182900,1925,95
"3048","11344","2015",11,11,0,128927.272727273,1263.63636363636,102.909090909091
"3049","11345","2015",4,3,1,87772,1003,84.25
"3050","11346","2015",3,3,0,1e+05,1093.33333333333,91
"3051","11347","2015",2,2,0,95000,1834.5,56.5
"3052","11348","2015",1,1,0,30000,667,45
"3053","11350","2015",1,1,0,90000,1607,56
"3054","11351","2015",17,16,1,94662.3529411765,1206.64705882353,81.7647058823529
"3055","11352","2015",1,1,0,60000,706,85
"3056","11353","2015",26,24,2,148579.615384615,1671.23076923077,94.8076923076923
"3057","11355","2015",1,1,0,130000,1000,130
"3058","11356","2015",12,12,0,204598.666666667,1561.33333333333,132.25
"3059","11357","2015",3,3,0,111816.666666667,1104.66666666667,99.6666666666667
"3060","11359","2015",6,6,0,207783.333333333,1547.33333333333,137.666666666667
"3061","11360","2015",21,21,0,189648.904761905,1670.47619047619,112.285714285714
"3062","11361","2015",3,3,0,173333.333333333,1326,125
"3063","11362","2015",3,3,0,200300,1569,126.333333333333
"3064","11364","2015",3,3,0,110000,1241,84.3333333333333
"3065","11366","2015",7,7,0,159301,1619.42857142857,91.4285714285714
"3066","11367","2015",11,11,0,82819.0909090909,839.363636363636,105.454545454545
"3067","11368","2015",3,3,0,128600,1533.66666666667,84.3333333333333
"3068","11369","2015",31,30,1,161282.258064516,1714.35483870968,95.7096774193548
"3069","11370","2015",44,39,5,174946.340909091,1937.29545454545,95.6136363636364
"3070","11371","2015",7,7,0,150857.142857143,1383.28571428571,128.714285714286
"3071","11372","2015",2,2,0,87500,1076,81
"3072","11373","2015",3,3,0,60000,1009.33333333333,57.6666666666667
"3073","11375","2015",1,1,0,227000,1681,135
"3074","11377","2015",1,1,0,30000,789,38
"3075","11378","2015",3,3,0,83333.3333333333,970.333333333333,83.3333333333333
"3076","11379","2015",65,58,7,146174.830769231,1645.55384615385,90.7230769230769
"3077","11380","2015",1,1,0,38000,376,101
"3078","11382","2015",3,3,0,151533.333333333,1361.66666666667,111.666666666667
"3079","11384","2015",1,1,0,40000,404,99
"3080","11385","2015",2,2,0,123775,1022,120.5
"3081","11386","2015",1,1,0,77700,762,102
"3082","11388","2015",1,1,0,45000,833,54
"3083","11390","2015",19,19,0,129959.631578947,1248.36842105263,99.4736842105263
"3084","11391","2015",2,2,0,122287.5,627.5,187.5
"3085","11392","2015",4,4,0,165620.25,1383.75,120.75
"3086","11393","2015",9,9,0,115688.222222222,1106.66666666667,95.4444444444444
"3087","11394","2015",4,4,0,80777.5,862.5,96
"3088","11396","2015",5,5,0,119940,1284,88.6
"3089","11397","2015",58,53,5,110261.206896552,1225.79310344828,89.5689655172414
"3090","11398","2015",3,3,0,235013.333333333,2218,113.333333333333
"3091","11400","2015",3,3,0,90055.6666666667,1275.66666666667,65.6666666666667
"3092","11401","2015",13,12,1,73730.7692307692,937.615384615385,78.9230769230769
"3093","11402","2015",2,2,0,109730,1196.5,89
"3094","11404","2015",10,9,1,128989.8,1158.2,112.1
"3095","11405","2015",11,11,0,141916.363636364,1608.36363636364,89.3636363636364
"3096","11406","2015",2,2,0,91250,1248.5,79.5
"3097","11407","2015",3,3,0,159471.666666667,2252.33333333333,81.6666666666667
"3098","11408","2015",3,3,0,65957.3333333333,554.666666666667,106.666666666667
"3099","11409","2015",3,3,0,104666.666666667,975,108.666666666667
"3100","11410","2015",15,15,0,79375.8,1093.73333333333,70.6666666666667
"3101","11411","2015",4,4,0,80375,1189.75,66.75
"3102","11412","2015",2,2,0,83800,793,104
"3103","11413","2015",5,5,0,132700,1324.6,101.6
"3104","11415","2015",4,4,0,50150,975.25,65
"3105","11416","2015",2,2,0,112500,1331,79
"3106","11417","2015",1,1,0,220000,2075,106
"3107","11418","2015",11,11,0,104540.909090909,1038,109.363636363636
"3108","11420","2015",3,3,0,110133.333333333,1346.66666666667,76.3333333333333
"3109","11421","2015",7,7,0,189319.428571429,1517.42857142857,125.571428571429
"3110","11422","2015",2,2,0,193500,1208,158
"3111","11423","2015",1,1,0,95000,1203,79
"3112","11425","2015",15,15,0,120006.666666667,1227.8,97.2666666666667
"3113","11426","2015",11,9,2,135190.454545455,1574.72727272727,88.5454545454545
"3114","11427","2015",1,1,0,285000,2192,130
"3115","11428","2015",2,2,0,53000,806,66.5
"3116","11429","2015",56,51,5,149997.660714286,1467.08928571429,99.4821428571429
"3117","11430","2015",8,8,0,153705,1429.875,117.625
"3118","11431","2015",1,1,0,170000,1619,105
"3119","11432","2015",1,1,0,185000,1542,120
"3120","11433","2015",7,7,0,135571.428571429,1275.14285714286,109.428571428571
"3121","11434","2015",15,15,0,106844.8,1158.86666666667,95.2
"3122","11436","2015",9,8,1,84559.4444444444,1338.22222222222,79.7777777777778
"3123","11437","2015",7,7,0,180654.285714286,1882.85714285714,96.4285714285714
"3124","11438","2015",1,1,0,125000,1250,100
"3125","11439","2015",7,7,0,101400,960.142857142857,111.285714285714
"3126","11441","2015",31,29,2,185109.193548387,2051.29032258065,94.2258064516129
"3127","12001","2015",3,3,0,145283.333333333,1516.33333333333,88
"3128","12002","2015",13,11,2,140308.846153846,1528.07692307692,94.5384615384615
"3129","12003","2015",2,2,0,58000,890,67.5
"3130","12004","2015",3,3,0,41166.6666666667,740.666666666667,65.6666666666667
"3131","12006","2015",2,2,0,196250,1888.5,105
"3132","12007","2015",2,2,0,86857,1144.5,72.5
"3133","12008","2015",6,6,0,151333.333333333,1294.5,109
"3134","12010","2015",1,1,0,131000,1213,108
"3135","12011","2015",10,10,0,242477,1720.1,108.1
"3136","12012","2015",5,5,0,127690,1504.8,102.4
"3137","12013","2015",35,35,0,70817.5714285714,814.142857142857,87.1714285714286
"3138","12016","2015",7,6,1,109871.428571429,1121.85714285714,97.7142857142857
"3139","12018","2015",6,6,0,162416.666666667,1283.83333333333,137.166666666667
"3140","12019","2015",1,1,0,41450,715,58
"3141","12021","2015",11,11,0,117148.636363636,1243.18181818182,95.7272727272727
"3142","12024","2015",1,1,0,24000,1000,24
"3143","12025","2015",5,5,0,72500,671.2,99.8
"3144","12026","2015",4,4,0,97410,1067.75,99.5
"3145","12027","2015",1,1,0,110000,1294,85
"3146","12028","2015",1,1,0,83020,1012,82
"3147","12029","2015",1,1,0,80000,1231,65
"3148","12030","2015",6,6,0,49870,684.5,75
"3149","12031","2015",4,4,0,127472.5,917.5,150.25
"3150","12032","2015",2,2,0,86800,1314,69
"3151","12033","2015",23,18,5,132987.826086957,1297.86956521739,101.695652173913
"3152","12034","2015",3,3,0,143383.333333333,1310,106
"3153","12036","2015",4,4,0,128875,1263.25,104.75
"3154","12037","2015",7,7,0,66571.4285714286,921.428571428571,72.5714285714286
"3155","12038","2015",3,3,0,37666.6666666667,994,46
"3156","12039","2015",4,4,0,56632.75,1147.75,55.75
"3157","12041","2015",1,1,0,95000,1080,88
"3158","12042","2015",1,1,0,127000,1176,108
"3159","12043","2015",11,11,0,151779.272727273,1459.81818181818,102.272727272727
"3160","12044","2015",6,5,1,149757.333333333,905.833333333333,151.666666666667
"3161","12045","2015",4,4,0,135575,1570.25,94.75
"3162","12046","2015",3,3,0,77868.3333333333,1226.33333333333,83.6666666666667
"3163","12047","2015",1,1,0,73500,865,85
"3164","12048","2015",6,6,0,84956.6666666667,908.666666666667,108.333333333333
"3165","12049","2015",4,3,1,108900,1293.75,79
"3166","12050","2015",1,1,0,97600,651,150
"3167","12051","2015",2,2,0,112120,1283.5,104.5
"3168","12052","2015",37,33,4,123095.054054054,1353.45945945946,89.2432432432432
"3169","12053","2015",5,5,0,101200,1120.2,100.6
"3170","12054","2015",5,5,0,75900,974.2,81.2
"3171","12056","2015",25,23,2,147937.8,1529.04,97.08
"3172","12057","2015",10,10,0,102825,1397.7,73
"3173","12058","2015",1,1,0,105000,784,134
"3174","12059","2015",3,3,0,129826.666666667,1538,107
"3175","12061","2015",3,3,0,75000,1637.33333333333,50
"3176","12062","2015",1,1,0,101140,843,120
"3177","12063","2015",6,6,0,111603.333333333,985.833333333333,112.666666666667
"3178","12064","2015",2,2,0,92990,1204.5,76
"3179","12065","2015",5,5,0,98280,1281,99.2
"3180","12066","2015",11,11,0,159432.727272727,1450.27272727273,104.454545454545
"3181","12067","2015",1,1,0,80000,784,102
"3182","12068","2015",4,4,0,138342.5,1324.75,105.25
"3183","12069","2015",2,2,0,85200,1134,77
"3184","12070","2015",4,4,0,225125,1649.5,144.5
"3185","12071","2015",3,3,0,87316.6666666667,1046.33333333333,87.3333333333333
"3186","12072","2015",4,4,0,159437.5,1996.75,88
"3187","12073","2015",6,6,0,126950,1550.5,86
"3188","12074","2015",2,2,0,102250,1080.5,95
"3189","12075","2015",1,1,0,15000,750,20
"3190","12076","2015",12,11,1,166650,1532.41666666667,102.75
"3191","12077","2015",1,1,0,81000,1080,75
"3192","12078","2015",3,3,0,64500,720,90
"3193","12079","2015",5,5,0,110900,1191,106.6
"3194","12080","2015",3,3,0,61666.6666666667,1004.33333333333,58.3333333333333
"3195","12082","2015",2,2,0,105000,976.5,105.5
"3196","12083","2015",13,12,1,76420.7692307692,935.153846153846,86.3076923076923
"3197","12084","2015",32,30,2,149355.375,1707,87.5625
"3198","12085","2015",4,4,0,57625,589.75,94
"3199","12086","2015",1,1,0,251500,1543,163
"3200","12088","2015",2,2,0,55000,497.5,108.5
"3201","12089","2015",40,24,16,79267.625,1001.3,77.4
"3202","12090","2015",24,24,0,190378.166666667,1976.04166666667,98.2083333333333
"3203","12091","2015",2,2,0,71500,899,79.5
"3204","12092","2015",1,1,0,70000,1014,69
"3205","12093","2015",1,1,0,276477,2304,120
"3206","12094","2015",6,6,0,103115,1179.16666666667,90.5
"3207","12095","2015",3,3,0,84333.3333333333,966,87
"3208","12096","2015",42,20,22,118008.80952381,1355.40476190476,84.8571428571429
"3209","12098","2015",2,2,0,101500,1383.5,75.5
"3210","12099","2015",5,5,0,80500,1274,87.8
"3211","12100","2015",23,22,1,90758.6956521739,1034.26086956522,88.304347826087
"3212","12101","2015",2,2,0,163750,1160,143.5
"3213","12102","2015",12,11,1,138768.75,1761.25,81.5
"3214","12103","2015",3,3,0,130000,1281.33333333333,111.666666666667
"3215","12104","2015",2,2,0,114740,721,149
"3216","12105","2015",15,15,0,152823.6,1376.13333333333,108.2
"3217","12106","2015",2,2,0,188000,1627.5,111.5
"3218","12107","2015",3,3,0,90000,907.333333333333,105.333333333333
"3219","12108","2015",7,7,0,145664.285714286,1374,121.857142857143
"3220","12110","2015",2,2,0,54500,1171,55
"3221","12111","2015",5,5,0,81200,907.8,100.6
"3222","12113","2015",2,2,0,115900,1355.5,81.5
"3223","12115","2015",4,4,0,95182.5,1119.25,91
"3224","12118","2015",6,6,0,81946.3333333333,819.666666666667,105.833333333333
"3225","12119","2015",10,6,4,123707,1145,96.5
"3226","12120","2015",17,12,5,113685.882352941,1372.35294117647,88.2352941176471
"3227","12121","2015",9,9,0,126861.222222222,1147.44444444444,111.222222222222
"3228","12122","2015",1,1,0,50000,350,143
"3229","12124","2015",6,6,0,176833.333333333,1328.5,124.333333333333
"3230","12125","2015",6,6,0,85600,1068.83333333333,107.833333333333
"3231","12127","2015",9,9,0,88550,852,107.888888888889
"3232","12128","2015",1,1,0,115000,1322,87
"3233","12130","2015",8,8,0,79479.125,868.25,88.875
"3234","12131","2015",8,8,0,167475,1848.25,93.5
"3235","12133","2015",43,33,10,159184.418604651,1714.60465116279,96.3953488372093
"3236","12134","2015",1,1,0,40000,364,110
"3237","12135","2015",5,5,0,176820,1269.6,118.8
"3238","12136","2015",10,10,0,99681,1173.6,86
"3239","12137","2015",5,5,0,141650,1500,94.8
"3240","12138","2015",7,6,1,136935.714285714,1211.42857142857,119.714285714286
"3241","12139","2015",2,2,0,84700,1098,77.5
"3242","12140","2015",8,8,0,161053.5,1272.75,128.5
"3243","12141","2015",1,1,0,63000,573,110
"3244","12142","2015",4,4,0,149243.75,1531.75,100.75
"3245","12144","2015",1,1,0,92000,484,190
"3246","12145","2015",240,94,146,114786.183333333,1442.4875,78.4208333333333
"3247","12146","2015",19,13,6,132318.421052632,1511.84210526316,88.2631578947368
"3248","12147","2015",4,4,0,79000,963.5,84.25
"3249","12148","2015",6,4,2,72750,1043.16666666667,67
"3250","12149","2015",1,1,0,51000,1133,45
"3251","12150","2015",2,1,1,139500,4177.5,66
"3252","12151","2015",3,3,0,74500,839.333333333333,82.6666666666667
"3253","12152","2015",3,3,0,51666.6666666667,936.666666666667,57
"3254","12153","2015",7,6,1,74878.5714285714,1037.71428571429,69.1428571428571
"3255","12154","2015",2,2,0,124760,823,145
"3256","12155","2015",3,3,0,83333.3333333333,1461.33333333333,61.6666666666667
"3257","12156","2015",1,1,0,55000,733,75
"3258","12157","2015",18,18,0,149800,1601.83333333333,94.2222222222222
"3259","12158","2015",3,3,0,144800,1661,80
"3260","12159","2015",3,3,0,78800,892,90.3333333333333
"3261","12160","2015",4,4,0,113100,1262.25,83.75
"3262","12161","2015",4,4,0,67175,1388.25,67.5
"3263","12162","2015",8,8,0,163055.625,1255.375,136
"3264","12163","2015",3,3,0,48409.6666666667,637.666666666667,72
"3265","12164","2015",7,7,0,90114.2857142857,824.285714285714,105.285714285714
"3266","12165","2015",2,2,0,253750,2728,78
"3267","12166","2015",3,3,0,89000,1403.66666666667,77.6666666666667
"3268","12167","2015",7,7,0,99571.4285714286,998.285714285714,98.5714285714286
"3269","12168","2015",15,14,1,113532,1555.46666666667,80.2666666666667
"3270","12169","2015",20,19,1,140692.5,1570.3,99.95
"3271","12170","2015",1,1,0,176430,1446,122
"3272","12171","2015",5,5,0,160820,1893,87.4
"3273","12172","2015",1,1,0,170000,1012,168
"3274","12174","2015",31,18,13,151145.161290323,1924.29032258065,81.8387096774194
"3275","12175","2015",1,1,0,276400,2211,125
"3276","12176","2015",116,60,56,139545.232758621,1714.21551724138,82.9051724137931
"3277","12177","2015",6,6,0,66208.3333333333,990.333333333333,68.6666666666667
"3278","12178","2015",2,2,0,151500,1515,100
"3279","12181","2015",6,6,0,111516.666666667,1568.33333333333,70
"3280","12182","2015",3,3,0,88561.6666666667,1122.66666666667,78.6666666666667
"3281","12183","2015",2,2,0,35955,751.5,50
"3282","12184","2015",1,1,0,15000,429,35
"3283","12185","2015",11,9,2,128135.454545455,1546.09090909091,88.7272727272727
"3284","12186","2015",3,3,0,54333.3333333333,533.333333333333,93.3333333333333
"3285","12187","2015",8,5,3,66560.625,1345.625,50.5
"3286","12188","2015",2,2,0,84090,856.5,96
"3287","12189","2015",4,4,0,89250,1026.75,86.75
"3288","12190","2015",4,4,0,59750,703,84.5
"3289","12191","2015",4,4,0,112750,1013,110.75
"3290","12192","2015",4,4,0,36750,618.25,67
"3291","12193","2015",3,3,0,176666.666666667,1811.33333333333,100.666666666667
"3292","12194","2015",9,9,0,137863.333333333,1272.55555555556,107.444444444444
"3293","12195","2015",7,7,0,104142.857142857,1093.71428571429,90.1428571428571
"3294","12197","2015",12,12,0,115100,1074.83333333333,120.5
"3295","12198","2015",9,9,0,74611.1111111111,891.111111111111,89.5555555555556
"3296","12199","2015",14,12,2,163592.857142857,1343.28571428571,124
"3297","12200","2015",9,9,0,106848.888888889,1395.11111111111,71.8888888888889
"3298","12201","2015",9,9,0,198351.111111111,1432.66666666667,140.444444444444
"3299","12202","2015",452,61,391,99646.4225663717,1466.91814159292,68.7920353982301
"3300","12203","2015",1,1,0,126750,1646,77
"3301","12205","2015",6,6,0,159000,1345.83333333333,116.833333333333
"3302","12206","2015",6,6,0,82166.6666666667,1034,79.8333333333333
"3303","12207","2015",3,3,0,98333.3333333333,1350.33333333333,109.333333333333
"3304","12208","2015",95,66,29,113511.452631579,1411.69473684211,82.2631578947368
"3305","12209","2015",4,3,1,66987.5,1036.5,65.5
"3306","12210","2015",4,4,0,198042.75,1325,164.75
"3307","12211","2015",2,2,0,122000,757.5,140.5
"3308","12212","2015",1,1,0,20000,571,35
"3309","12213","2015",7,7,0,86714.2857142857,981.714285714286,90.5714285714286
"3310","12214","2015",7,7,0,98214.2857142857,2401.42857142857,66.4285714285714
"3311","12215","2015",5,4,1,123050,1421.4,91
"3312","12216","2015",11,9,2,120080.909090909,1732.45454545455,68.8181818181818
"3313","12217","2015",9,9,0,142750,1328.11111111111,108
"3314","12219","2015",5,5,0,117500,1285,100.2
"3315","12220","2015",5,5,0,87600,1322.2,59.8
"3316","12221","2015",2,2,0,126220,2176.5,56.5
"3317","12222","2015",1,1,0,37000,336,110
"3318","12223","2015",8,8,0,80937.5,926.25,97.625
"3319","12224","2015",17,13,4,97488.5882352941,1236.94117647059,83.7058823529412
"3320","12225","2015",10,8,2,172119.4,1629.2,102.5
"3321","12226","2015",3,2,1,109333.333333333,1367.66666666667,78.3333333333333
"3322","12228","2015",5,4,1,74480,931.4,94.2
"3323","12229","2015",2,2,0,156500,1451.5,105
"3324","12230","2015",2,2,0,79390,1423,54.5
"3325","12231","2015",7,6,1,89603.4285714286,1363.57142857143,63.1428571428571
"3326","12232","2015",2,2,0,89150,1144,105
"3327","12233","2015",2,2,0,53600,499,112.5
"3328","12234","2015",6,6,0,105083.333333333,1225.5,90.8333333333333
"3329","12235","2015",2,2,0,104094.5,830,124
"3330","12236","2015",1,1,0,137500,917,150
"3331","12237","2015",6,5,1,75933.3333333333,1320.66666666667,54.5
"3332","12238","2015",4,4,0,101337.5,1089.75,87.75
"3333","12239","2015",1,1,0,224500,1810,124
"3334","12240","2015",8,8,0,85856.25,987.375,83.625
"3335","12241","2015",13,13,0,235765.384615385,1917.38461538462,123.307692307692
"3336","12242","2015",2,2,0,107850,1328.5,89
"3337","12243","2015",7,7,0,171142.857142857,1710.28571428571,97.8571428571429
"3338","12244","2015",11,10,1,93181.8181818182,1100.18181818182,88
"3339","12246","2015",3,3,0,167000,1658,108.333333333333
"3340","12247","2015",3,3,0,70000,881,76.6666666666667
"3341","12248","2015",5,5,0,73520,971.4,91.8
"3342","12249","2015",1,1,0,46000,351,131
"3343","12250","2015",2,2,0,102500,957,106.5
"3344","12251","2015",4,4,0,118037.5,1245,93.5
"3345","12252","2015",6,6,0,120700,1119.33333333333,98.6666666666667
"3346","12253","2015",7,6,1,141070,1832.14285714286,107.714285714286
"3347","12254","2015",10,10,0,170635,2008.4,91.4
"3348","12255","2015",6,5,1,120091.666666667,1313.33333333333,101.666666666667
"3349","12256","2015",5,5,0,108400,1582.2,65.6
"3350","12257","2015",5,5,0,113436,1351.2,83.8
"3351","12258","2015",12,12,0,111550,893.916666666667,118.833333333333
"3352","12259","2015",5,5,0,124700,1335.6,109.2
"3353","12261","2015",1,1,0,663000,2786,238
"3354","12262","2015",8,8,0,111650,1226.625,87.125
"3355","12263","2015",2,2,0,148550,1600,102
"3356","12264","2015",26,23,3,195657.807692308,1974.34615384615,101.307692307692
"3357","12265","2015",2,2,0,116500,1365,85.5
"3358","12266","2015",5,5,0,88500,1008,96.6
"3359","12267","2015",3,3,0,103833.333333333,806.666666666667,111
"3360","12269","2015",1,1,0,55000,786,70
"3361","12270","2015",28,23,5,108291.785714286,1305.53571428571,84.1785714285714
"3362","12272","2015",4,4,0,94450,1215.25,77.75
"3363","12273","2015",2,2,0,143750,1347,102.5
"3364","12276","2015",1,1,0,173000,1602,108
"3365","12277","2015",3,3,0,68183.3333333333,548.666666666667,112
"3366","12278","2015",1,1,0,70000,432,162
"3367","12280","2015",4,4,0,72500,1037.25,66.75
"3368","12281","2015",4,4,0,175692.5,1343.75,126.5
"3369","12282","2015",7,6,1,120309.714285714,1374.85714285714,95.2857142857143
"3370","12283","2015",1,1,0,36000,400,90
"3371","12284","2015",1,1,0,87000,1500,58
"3372","12286","2015",8,8,0,94925,1017.625,85.75
"3373","12287","2015",9,9,0,143522,1514.66666666667,98.7777777777778
"3374","12288","2015",19,19,0,177319,1766.78947368421,103.421052631579
"3375","12290","2015",4,4,0,91875,1021.75,93.75
"3376","12291","2015",1,1,0,90500,1293,70
"3377","12292","2015",9,9,0,130866.666666667,1411.44444444444,94.1111111111111
"3378","12294","2015",4,4,0,100487.5,1111.5,96.75
"3379","12296","2015",5,5,0,74767.6,915.8,83.4
"3380","12297","2015",3,3,0,133366.666666667,1346.33333333333,91.6666666666667
"3381","12298","2015",2,2,0,29500,483.5,61
"3382","12299","2015",13,13,0,95715.7692307692,973.923076923077,114.230769230769
"3383","12300","2015",93,65,28,132030.365591398,1342.31182795699,98.1182795698925
"3384","12301","2015",15,15,0,125953.333333333,1256.66666666667,96.4666666666667
"3385","12303","2015",3,3,0,133333.333333333,1080.33333333333,115
"3386","12305","2015",13,13,0,95292.3076923077,954.846153846154,101.769230769231
"3387","12307","2015",4,4,0,167517.5,1291,112.25
"3388","13001","2015",1738,248,1490,261843.127157652,3950.89930955121,66.0494821634062
"3389","13002","2015",84,62,22,301501.011904762,3489.4880952381,88.5595238095238
"3390","13003","2015",30,29,1,263688.333333333,2945.6,92.1333333333333
"3391","13004","2015",424,263,161,172549.386792453,2226.13679245283,78.5660377358491
"3392","13005","2015",370,128,242,218664.97027027,2842.18108108108,76.0459459459459
"3393","13006","2015",13,12,1,310053.846153846,2990.92307692308,99.8461538461538
"3394","13007","2015",77,63,14,314324.935064935,3355.36363636364,95.4545454545455
"3395","13008","2015",7,6,1,372703.428571429,2705.85714285714,144
"3396","13009","2015",7,7,0,287697.142857143,3253.28571428571,88.2857142857143
"3397","13010","2015",25,21,4,216946,2537.28,80.72
"3398","13011","2015",3,2,1,1015233.33333333,4636,149
"3399","13012","2015",5,4,1,431000,4411,99.2
"3400","13013","2015",15,13,2,351997,3592.73333333333,100.8
"3401","13014","2015",89,57,32,197945.06741573,2337.56179775281,85.6516853932584
"3402","13015","2015",114,90,24,379444.526315789,3904.94736842105,98.3245614035088
"3403","13016","2015",53,41,12,258087.169811321,3160.56603773585,83.3396226415094
"3404","13017","2015",6,6,0,170500,2236.66666666667,84
"3405","13018","2015",1,1,0,175000,2188,80
"3406","13019","2015",79,68,11,413499.113924051,3915.72151898734,107.518987341772
"3407","13020","2015",22,17,5,272531.818181818,3042.68181818182,94.2727272727273
"3408","13021","2015",91,44,47,369400.604395604,4603.41758241758,81.956043956044
"3409","13022","2015",121,28,93,467661.32231405,5765.87603305785,75.8595041322314
"3410","13023","2015",50,40,10,358917,3793.62,93.92
"3411","13024","2015",21,17,4,215742.857142857,2709.38095238095,87.1904761904762
"3412","13025","2015",15,13,2,394502.666666667,3631.2,117.066666666667
"3413","13026","2015",142,83,59,210242.563380282,2818.54929577465,76.7816901408451
"3414","13027","2015",144,111,33,229290.923611111,2395.72222222222,95.2916666666667
"3415","13028","2015",610,138,472,244910.739344262,3921.72295081967,63.2147540983607
"3416","13029","2015",12,11,1,253171.666666667,2542.91666666667,106.333333333333
"3417","13030","2015",40,25,15,219274.125,3096.425,71.025
"3418","13031","2015",40,25,15,266892.325,3220.85,85.1
"3419","13032","2015",86,61,25,389907.465116279,4002.52325581395,98.2325581395349
"3420","13033","2015",60,50,10,348403.9,4063.25,89.4166666666667
"3421","13034","2015",19,18,1,839872.894736842,5433.1052631579,146.947368421053
"3422","13035","2015",66,59,7,245686.060606061,3136.69696969697,82.9545454545455
"3423","13036","2015",37,34,3,259299.324324324,2500.91891891892,101.756756756757
"3424","13037","2015",96,75,21,258223.489583333,3108.36458333333,85.6458333333333
"3425","13038","2015",32,28,4,209714.0625,2655.8125,86.125
"3426","13039","2015",141,97,44,221990.872340426,2849.72340425532,81.5531914893617
"3427","13040","2015",83,64,19,313151.626506024,3606.22891566265,91.0843373493976
"3428","13041","2015",187,91,96,218441.941176471,2991.76470588235,76.2406417112299
"3429","13042","2015",45,38,7,422566.355555556,4122.82222222222,108.133333333333
"3430","13043","2015",78,68,10,260761.230769231,2936.20512820513,90
"3431","13044","2015",43,40,3,292158.720930233,3027.90697674419,99.2093023255814
"3432","13045","2015",38,35,3,207835.526315789,2461,86.1578947368421
"3433","13046","2015",32,26,6,336907.5,3492.84375,94.75
"3434","13047","2015",394,238,156,213223.111675127,2595.57868020305,81.8248730964467
"3435","13048","2015",38,30,8,277408.289473684,3087.52631578947,94.0263157894737
"3436","13049","2015",19,14,5,211540.526315789,2706.42105263158,79.2631578947368
"3437","13050","2015",87,58,29,258991.609195402,3068.31034482759,84.9655172413793
"3438","13051","2015",92,75,17,267382.673913043,3126.26086956522,90.2065217391304
"3439","13052","2015",18,17,1,332507.944444444,2928.72222222222,120.388888888889
"3440","13053","2015",72,55,17,243451.638888889,2836.93055555556,90.7222222222222
"3441","13054","2015",320,132,188,192191.228125,2530.215625,75.41875
"3442","13055","2015",9302,1264,8038,177363.175123629,2618.73575575145,66.0547194151795
"3443","13056","2015",465,179,286,199682.720430108,2916.68602150538,72.5612903225806
"3444","13057","2015",1,1,0,427900,2853,150
"3445","13058","2015",38,31,7,323939.736842105,3727.97368421053,85.3421052631579
"3446","13059","2015",40,29,11,274937.2,2859.175,92.175
"3447","13060","2015",40,30,10,318877.5,3780.15,91.35
"3448","13061","2015",1,1,0,250000,1667,150
"3449","13062","2015",47,41,6,341037.021276596,3589.72340425532,97.8085106382979
"3450","13063","2015",170,99,71,173861.505882353,2310.08823529412,76.8647058823529
"3451","13064","2015",23,23,0,273424.782608696,2950.17391304348,93.695652173913
"3452","13065","2015",31,28,3,287913.516129032,3094.67741935484,87.3870967741936
"3453","13066","2015",8,8,0,247677.5,2205.875,117.25
"3454","13067","2015",28,27,1,186090.571428571,2177.67857142857,84.8928571428571
"3455","13068","2015",26,25,1,447219.615384615,3704.42307692308,117.846153846154
"3456","13069","2015",100,82,18,282448.94,2867.42,98.72
"3457","13070","2015",40,20,20,232860,2915.75,79.725
"3458","13071","2015",179,124,55,266829.446927374,3163.7374301676,85.2290502793296
"3459","13072","2015",51,44,7,337328.647058824,3280.74509803922,103.156862745098
"3460","13073","2015",61,44,17,263910.163934426,3324.68852459016,83.8524590163934
"3461","13074","2015",47,31,16,251864.021276596,2563.25531914894,96.6808510638298
"3462","13075","2015",101,56,45,265696.831683168,3443.51485148515,80.7425742574257
"3463","13076","2015",23,19,4,186029.130434783,2010.17391304348,94.304347826087
"3464","13077","2015",142,85,57,165513.64084507,2192.24647887324,76.4929577464789
"3465","13078","2015",43,27,16,160854.651162791,2107.53488372093,78.6046511627907
"3466","13079","2015",10,9,1,253275,2644.3,101.3
"3467","13080","2015",40,26,14,255342.225,3079.325,85.4
"3468","13081","2015",119,77,42,237355.12605042,2925.63865546218,82.6890756302521
"3469","13082","2015",50,41,9,440594.22,3448.72,122.24
"3470","13083","2015",29,25,4,210152.724137931,2456.27586206897,84.7931034482759
"3471","13084","2015",47,42,5,220160.531914894,2379.87234042553,92.5106382978723
"3472","13085","2015",47,32,15,304066.808510638,3750.3829787234,84.3404255319149
"3473","13086","2015",65,42,23,266315.923076923,3256.46153846154,82.9538461538462
"3474","13087","2015",39,24,15,244229.487179487,3502.28205128205,73.3076923076923
"3475","13088","2015",41,33,8,274196.756097561,3194.41463414634,94.2439024390244
"3476","13089","2015",18,15,3,211253.333333333,2081.44444444444,101.388888888889
"3477","13090","2015",1,1,0,440000,5500,80
"3478","13091","2015",55,45,10,321200.2,3276.23636363636,99.6
"3479","13092","2015",77,56,21,233155.727272727,2881,84.7012987012987
"3480","13093","2015",2,2,0,311265,3094.5,103.5
"3481","13094","2015",19,15,4,392107.263157895,3267.31578947368,110.157894736842
"3482","13095","2015",12,12,0,900835.833333333,4504.16666666667,207.833333333333
"3483","13096","2015",56,15,41,163004.5,3572.58928571429,48.375
"3484","13097","2015",119,94,25,237646.016806723,2626.80672268908,92.344537815126
"3485","13098","2015",78,72,6,274711.884615385,3235.02564102564,91.2564102564103
"3486","13099","2015",4,4,0,161000,2433.75,64.25
"3487","13100","2015",100,76,24,441539.75,3943.91,106.12
"3488","13101","2015",37,21,16,223206.486486486,3078.86486486487,76.6486486486486
"3489","13102","2015",42,32,10,242057.142857143,2836.54761904762,85.6904761904762
"3490","13103","2015",472,177,295,191836.906779661,2547.58474576271,74.5783898305085
"3491","13104","2015",161,77,84,289251.347826087,5080.42857142857,60.4968944099379
"3492","13105","2015",43,38,5,206487.23255814,2558.6976744186,85.2790697674419
"3493","13106","2015",104,50,54,206951.490384615,2650.96153846154,78.5673076923077
"3494","13107","2015",36,30,6,328222.083333333,3873.83333333333,85.5555555555556
"3495","13108","2015",145,91,54,139607.193103448,1623.14482758621,84.6
"3496","13109","2015",26,20,6,594112.423076923,4525.96153846154,124.884615384615
"3497","13110","2015",114,82,32,276523.929824561,3139.07894736842,88.9385964912281
"3498","13111","2015",10,5,5,311320.5,4247.8,76.4
"3499","13112","2015",84,72,12,346285.25,3433.34523809524,103.666666666667
"3500","13113","2015",102,76,26,319168.745098039,3603.57843137255,88.3137254901961
"3501","13114","2015",36,32,4,434287.527777778,4223.25,106.277777777778
"3502","13115","2015",16,15,1,265830.75,2904.125,94.9375
"3503","13116","2015",7,7,0,225173.714285714,2302.14285714286,93.1428571428571
"3504","13117","2015",386,190,196,205889.694300518,2685.76424870466,78.5077720207254
"3505","13118","2015",42,28,14,300054.69047619,3672.30952380952,84.7380952380952
"3506","13119","2015",70,42,28,298457.685714286,3266.8,89.8714285714286
"3507","14001","2015",12,12,0,182508.333333333,1840.5,101.916666666667
"3508","14005","2015",22,22,0,169380.954545455,1540.63636363636,110.772727272727
"3509","14006","2015",11,11,0,167377.272727273,1444.36363636364,117.909090909091
"3510","14007","2015",5,5,0,150200,1329,110.2
"3511","14009","2015",15,15,0,195000,2165.4,105.866666666667
"3512","14011","2015",17,17,0,127595.411764706,1263.76470588235,100.647058823529
"3513","14012","2015",4,4,0,229500,1645.5,139.25
"3514","14014","2015",18,18,0,237608.333333333,2084.94444444444,115.666666666667
"3515","14015","2015",9,9,0,352930,2570.77777777778,137.888888888889
"3516","14016","2015",7,7,0,172214.285714286,1758.28571428571,108.571428571429
"3517","14019","2015",1,1,0,145000,1151,126
"3518","14020","2015",2,2,0,147500,1689,95.5
"3519","14021","2015",10,9,1,178556,1917.9,89.1
"3520","14022","2015",11,8,3,89354.5454545455,2110.90909090909,45.4545454545455
"3521","14023","2015",2,2,0,163000,1683,120.5
"3522","14024","2015",7,7,0,345150.142857143,3402.28571428571,106.142857142857
"3523","14025","2015",5,5,0,180400,1480.6,118
"3524","14026","2015",11,11,0,174118.181818182,1443.54545454545,120.818181818182
"3525","14027","2015",47,44,3,117713.553191489,1276.91489361702,93.1702127659574
"3526","14030","2015",21,21,0,232030.80952381,2213.71428571429,108.52380952381
"3527","14032","2015",4,4,0,191700,2009.5,107
"3528","14033","2015",3,3,0,251333.333333333,1773.33333333333,147.666666666667
"3529","14034","2015",3,3,0,118333.333333333,1603,85.3333333333333
"3530","14035","2015",12,12,0,127541.666666667,1234.08333333333,104.25
"3531","14036","2015",1,1,0,158500,1481,107
"3532","14037","2015",3,3,0,134800,1142.66666666667,120
"3533","14038","2015",7,7,0,216646.428571429,2230.57142857143,99.1428571428571
"3534","14039","2015",9,9,0,157525.555555556,1750.66666666667,94.7777777777778
"3535","14040","2015",2,2,0,195175,1749.5,122.5
"3536","14041","2015",1,1,0,360000,2011,179
"3537","14042","2015",11,11,0,157133.818181818,1712.54545454545,92.8181818181818
"3538","14044","2015",12,12,0,242960.833333333,2024.33333333333,117.083333333333
"3539","14046","2015",14,14,0,241315.071428571,2317.78571428571,101.857142857143
"3540","14047","2015",173,90,83,149710.653179191,1743.75144508671,83.7687861271676
"3541","14049","2015",2,2,0,188250,1103,175
"3542","14050","2015",2,2,0,135350,1009.5,130.5
"3543","14053","2015",1,1,0,136000,925,147
"3544","14054","2015",2,2,0,212500,1576.5,134
"3545","14055","2015",12,10,2,175916.666666667,2269.16666666667,77.9166666666667
"3546","14057","2015",20,20,0,150854,1571.35,97.5
"3547","14059","2015",22,8,14,289940.909090909,3998.90909090909,70.1818181818182
"3548","14060","2015",18,18,0,254388.888888889,1975,128.277777777778
"3549","14061","2015",85,84,1,106793.847058824,1043.81176470588,104.858823529412
"3550","14062","2015",4,4,0,192750,1666.75,109.75
"3551","14063","2015",1,1,0,65000,929,70
"3552","14064","2015",1,1,0,112500,1250,90
"3553","14066","2015",64,44,20,148495.515625,2060.921875,74.0625
"3554","14068","2015",39,30,9,262191.076923077,2292.38461538462,110.153846153846
"3555","14069","2015",12,9,3,95958.3333333333,1364,67.4166666666667
"3556","14070","2015",3,3,0,288000,2250.33333333333,128.333333333333
"3557","14076","2015",40,30,10,190839.45,2116.375,90.075
"3558","14077","2015",12,12,0,187583.333333333,2043.41666666667,93.5
"3559","14078","2015",1,1,0,194000,1347,144
"3560","14079","2015",82,24,58,161827.073170732,2925.85365853659,54.8048780487805
"3561","14080","2015",3,3,0,51543.3333333333,1004.33333333333,56
"3562","14082","2015",2,2,0,149861,1911,91.5
"3563","14083","2015",6,6,0,163583.333333333,1796,86.8333333333333
"3564","14084","2015",4,4,0,175625,1190.5,147.25
"3565","14085","2015",23,23,0,215920.043478261,1739.17391304348,130.826086956522
"3566","14086","2015",3,3,0,314833.333333333,3047,161.333333333333
"3567","14088","2015",3,3,0,145166.666666667,1689.33333333333,105.666666666667
"3568","14089","2015",4,4,0,192900,1937.25,100.75
"3569","14090","2015",5,5,0,153640,1627.4,96.2
"3570","14091","2015",2,2,0,160000,1728,92.5
"3571","14092","2015",17,15,2,246461.470588235,2274.23529411765,107.941176470588
"3572","14093","2015",4,4,0,196826.25,2118.75,96.5
"3573","14096","2015",2,2,0,179900,1199,160
"3574","14097","2015",4,4,0,141000,1219,120.25
"3575","14098","2015",62,61,1,200330.161290323,1951.11290322581,104.870967741935
"3576","14100","2015",5,5,0,177640,1373.8,128.8
"3577","14101","2015",47,46,1,202195.531914894,2112.27659574468,99.3617021276596
"3578","14102","2015",9,9,0,150277.777777778,1435.55555555556,105.777777777778
"3579","14103","2015",3,3,0,117753.666666667,890.666666666667,134
"3580","14104","2015",2,2,0,149500,1980.5,75.5
"3581","14106","2015",10,10,0,190650,1839.5,103.5
"3582","14107","2015",2,2,0,115750,1172.5,94.5
"3583","14110","2015",1,1,0,1255000,4883,257
"3584","14111","2015",4,4,0,190812.5,1796.5,108.25
"3585","14116","2015",4,4,0,143750,1699.25,85.5
"3586","14117","2015",349,70,279,152291.186246418,3141.28653295129,49.2406876790831
"3587","14118","2015",1672,341,1331,132756.083133971,2063.86303827751,65.9706937799043
"3588","14119","2015",12,12,0,166666.666666667,1689.66666666667,104.75
"3589","14120","2015",20,20,0,131677.5,1287.1,101.65
"3590","14121","2015",2,2,0,185500,1604.5,115.5
"3591","14122","2015",1,1,0,53500,991,54
"3592","14123","2015",20,20,0,277362.5,2001.2,139.9
"3593","14124","2015",6,6,0,91952.5,1151.16666666667,79
"3594","14125","2015",31,22,9,216475.193548387,2255.83870967742,98.0322580645161
"3595","14126","2015",15,15,0,186347.466666667,1692,113.666666666667
"3596","14127","2015",3,3,0,100166.666666667,1171.66666666667,83.3333333333333
"3597","14130","2015",2,2,0,163750,1207.5,120
"3598","14131","2015",2,2,0,271550,2799,101
"3599","14132","2015",1,1,0,80000,842,95
"3600","14137","2015",25,24,1,194416,1941.52,100.6
"3601","14138","2015",3,3,0,102666.666666667,872.666666666667,116.666666666667
"3602","14140","2015",5,5,0,176200,1362.6,130
"3603","14141","2015",5,5,0,109800,1153.6,103.2
"3604","14143","2015",28,28,0,106882.142857143,1212.53571428571,93.1785714285714
"3605","14145","2015",7,7,0,153395.142857143,1664.57142857143,101.857142857143
"3606","14146","2015",1,1,0,51500,858,60
"3607","14147","2015",4,4,0,118250,1573.5,76.75
"3608","14149","2015",4,4,0,163500,1652.5,102.75
"3609","14150","2015",12,12,0,107500,1175.58333333333,94.0833333333333
"3610","14159","2015",1,1,0,62000,969,64
"3611","14161","2015",3,3,0,347200,2477.33333333333,136.333333333333
"3612","14162","2015",20,19,1,118578,1200.8,100.65
"3613","14163","2015",4,4,0,122250,1218.25,94.5
"3614","14165","2015",2,2,0,200200,1894,108
"3615","14166","2015",31,28,3,196952.419354839,2336.06451612903,93.5483870967742
"3616","14167","2015",44,36,8,161463.386363636,1989.09090909091,84.6590909090909
"3617","14168","2015",1,1,0,80324,609,132
"3618","14169","2015",1,1,0,195000,1681,116
"3619","14172","2015",5,5,0,140460,1196.4,111.6
"3620","14173","2015",4,4,0,182050,1305.5,146.25
"3621","14174","2015",48,38,10,91941.1666666667,1001,89.0625
"3622","14177","2015",9,9,0,221924.333333333,2419.77777777778,89.5555555555556
"3623","14179","2015",2,2,0,109150,763.5,134.5
"3624","14180","2015",2,2,0,103500,1644,63
"3625","14181","2015",44,32,12,162343.75,1798.09090909091,91.8863636363636
"3626","14182","2015",2,2,0,56750,979.5,74
"3627","14183","2015",3,3,0,56000,763.333333333333,73.3333333333333
"3628","14184","2015",3,3,0,140000,1263.66666666667,111.333333333333
"3629","14191","2015",183,56,127,112973.699453552,2303.12568306011,51.5409836065574
"3630","14193","2015",4,4,0,111750,1767.75,64.25
"3631","14194","2015",7,7,0,115200,1225.85714285714,92.5714285714286
"3632","14195","2015",4,4,0,153725,1232.5,124.5
"3633","14196","2015",4,4,0,162250,1477,114
"3634","14197","2015",7,7,0,198857.142857143,2029.28571428571,96.7142857142857
"3635","14198","2015",3,3,0,149333.333333333,1093.66666666667,137
"3636","14200","2015",25,25,0,183472.12,1789.96,106.96
"3637","14202","2015",3,3,0,454666.666666667,4077.33333333333,109.666666666667
"3638","14203","2015",2,2,0,249500,1451.5,181
"3639","14204","2015",2,2,0,89595,1156,79
"3640","14205","2015",1,1,0,182000,2304,79
"3641","14206","2015",4,4,0,120550,1019,128
"3642","14207","2015",5,5,0,137500,991,153.2
"3643","14209","2015",8,8,0,145687.5,1493.625,98.125
"3644","14211","2015",13,13,0,119376.923076923,1274.92307692308,94.3076923076923
"3645","14214","2015",3,3,0,222000,1348,162.666666666667
"3646","14215","2015",12,12,0,201458.333333333,2154.66666666667,100.666666666667
"3647","14216","2015",2,2,0,131500,1206,118
"3648","14218","2015",6,6,0,209400,2261.16666666667,93.3333333333333
"3649","14220","2015",173,41,132,295327.161849711,4471.39306358382,63.4971098265896
"3650","14221","2015",30,29,1,183036.666666667,1924,96.3
"3651","14224","2015",3,3,0,149966.666666667,1177.66666666667,113.666666666667
"3652","14225","2015",92,68,24,149317.608695652,2585.57608695652,63.5434782608696
"3653","14226","2015",4,4,0,125750,1595.75,79.25
"3654","14227","2015",3,3,0,215000,2154.66666666667,101
"3655","14228","2015",57,45,12,194887.561403509,2144.43859649123,91.5964912280702
"3656","14229","2015",18,18,0,163814.333333333,2071.16666666667,81.2222222222222
"3657","14231","2015",5,5,0,193720,1550.8,138
"3658","14232","2015",2,2,0,85500,1008.5,68
"3659","14236","2015",7,7,0,170742.857142857,1586.42857142857,107.428571428571
"3660","14237","2015",8,8,0,199591.25,1874.25,109.75
"3661","14238","2015",1,1,0,103000,2575,40
"3662","14240","2015",3,3,0,141000,1260.66666666667,116.666666666667
"3663","14241","2015",10,10,0,139800,1271.9,113.9
"3664","14242","2015",21,19,2,219529.619047619,1893.04761904762,117.190476190476
"3665","14243","2015",15,13,2,276013.333333333,2202.6,125.666666666667
"3666","14244","2015",4,4,0,145750,1521.5,97.75
"3667","14245","2015",2,2,0,90250,1085,97.5
"3668","14246","2015",12,12,0,192241.5,2172.08333333333,89.1666666666667
"3669","14248","2015",3,3,0,196666.666666667,1445.66666666667,135
"3670","14249","2015",12,12,0,205440,2007.08333333333,107.666666666667
"3671","14250","2015",3,3,0,189166.666666667,1918.66666666667,104.333333333333
"3672","14251","2015",1,1,0,163850,1332,123
"3673","14252","2015",5,5,0,133200,1988.8,71.2
"3674","14254","2015",6,4,2,200640,1997.83333333333,108
"3675","14256","2015",3,3,0,106575,1148,93.3333333333333
"3676","14257","2015",14,14,0,199564.285714286,1956.92857142857,109.5
"3677","14260","2015",3,3,0,207366.666666667,1954.33333333333,108.333333333333
"3678","14261","2015",4,4,0,366000,2166,164
"3679","14266","2015",10,10,0,185809.4,2132,88.7
"3680","14269","2015",3,3,0,100666.666666667,938.333333333333,104
"3681","14270","2015",4,4,0,160470.5,1591,98
"3682","14271","2015",39,34,5,221496.153846154,2143.61538461538,99.1282051282051
"3683","14272","2015",2,2,0,73000,1203,63
"3684","14273","2015",3,3,0,124633.333333333,1567,80
"3685","14274","2015",24,23,1,227170.416666667,2037.66666666667,117.875
"3686","14275","2015",1,1,0,140000,1346,104
"3687","14276","2015",3,3,0,161200,1637.33333333333,100.666666666667
"3688","14277","2015",18,18,0,157111.611111111,1699.94444444444,96.5555555555556
"3689","14278","2015",12,12,0,189758.333333333,1882.91666666667,105.25
"3690","14280","2015",1,1,0,208600,2674,78
"3691","14281","2015",5,5,0,122800,1230.6,109.6
"3692","14282","2015",2,2,0,110810.5,874.5,121.5
"3693","14283","2015",4,4,0,120375,1146.75,107.5
"3694","14284","2015",1,1,0,120000,923,130
"3695","14285","2015",1,1,0,220000,2316,95
"3696","14286","2015",4,4,0,343750,2648.25,139
"3697","14287","2015",17,17,0,169368.823529412,1876.70588235294,92.7058823529412
"3698","14288","2015",10,10,0,185690,1747.7,108.7
"3699","14289","2015",4,4,0,124225,1212.25,102.75
"3700","14290","2015",10,10,0,150440,1541.1,100.6
"3701","14291","2015",10,10,0,158631.5,1573,107.9
"3702","14293","2015",6,6,0,152250,1702.66666666667,92.1666666666667
"3703","14297","2015",4,4,0,185550,1694,115.25
"3704","14298","2015",1,1,0,78000,876,89
"3705","14299","2015",6,6,0,3e+05,3047,107
"3706","14301","2015",30,30,0,162725.566666667,2223.83333333333,79.4
"3707","14302","2015",4,4,0,406750,3046.75,134.5
"3708","14303","2015",11,11,0,129727.272727273,1331.36363636364,96.4545454545455
"3709","14304","2015",14,14,0,273514.285714286,2144.78571428571,128.642857142857
"3710","14305","2015",11,11,0,322272.727272727,2474.27272727273,127.636363636364
"3711","14306","2015",2,2,0,204000,1590.5,134
"3712","14308","2015",1,1,0,180000,1500,120
"3713","14309","2015",10,7,3,125215,1632.4,80.6
"3714","14310","2015",2,2,0,115850,881,122
"3715","14311","2015",10,10,0,143516.7,1542.9,100.9
"3716","14312","2015",67,50,17,86632.5970149254,1332.76119402985,61.8955223880597
"3717","14316","2015",2,2,0,135000,1566,87
"3718","14318","2015",12,12,0,177731.666666667,1629.75,115
"3719","14319","2015",13,13,0,197600,1735.38461538462,114.692307692308
"3720","14320","2015",2,2,0,67500,1118.5,63
"3721","14325","2015",56,49,7,165065.232142857,1981.39285714286,81.5178571428571
"3722","14326","2015",7,7,0,130000.142857143,1345.42857142857,101.428571428571
"3723","14327","2015",194,58,136,112267.201030928,1630.80412371134,69.9329896907217
"3724","14328","2015",13,13,0,183917.769230769,1862.84615384615,100.538461538462
"3725","14329","2015",4,4,0,201180.75,2000.75,100.75
"3726","14332","2015",4,4,0,89325,1150.25,75.75
"3727","14333","2015",147,77,70,171950.353741497,2350.19727891156,72.9183673469388
"3728","14334","2015",1,1,0,180000,1525,118
"3729","14336","2015",5,5,0,193200,1553.4,122.6
"3730","14337","2015",1,1,0,159000,1325,120
"3731","14338","2015",150,60,90,168037.22,2744.00666666667,61.5666666666667
"3732","14341","2015",100,71,29,153713,1792.33,86.8
"3733","14342","2015",40,34,6,108404.225,1191.65,92.475
"3734","14344","2015",4,4,0,196750,2165,101.25
"3735","14345","2015",4,4,0,131225,1071.25,132
"3736","14346","2015",11,11,0,134652.272727273,1297.18181818182,104.272727272727
"3737","14347","2015",7,7,0,101542.857142857,913.714285714286,108
"3738","14348","2015",1,1,0,137000,2686,51
"3739","14349","2015",20,20,0,180525,1897.05,96.9
"3740","14352","2015",11,11,0,80840.9090909091,790.272727272727,105.727272727273
"3741","14353","2015",5,5,0,134160,1387,90
"3742","14354","2015",31,25,6,171785.161290323,2164.8064516129,84.3225806451613
"3743","14355","2015",15,15,0,194220.666666667,1678.06666666667,119.6
"3744","14357","2015",9,9,0,96455.5555555556,1085.88888888889,97
"3745","14358","2015",1,1,0,115000,1264,91
"3746","14360","2015",3,3,0,149000,1382.66666666667,107
"3747","14362","2015",3,3,0,259833.333333333,2026,134.333333333333
"3748","14364","2015",7,7,0,145458.571428571,1579.28571428571,98.1428571428571
"3749","14365","2015",70,45,25,188623,2397.55714285714,82.4857142857143
"3750","14366","2015",203,82,121,104806.655172414,1347.69458128079,78.0886699507389
"3751","14367","2015",5,5,0,53520,603.8,84.2
"3752","14368","2015",3,3,0,104000,1228.33333333333,84
"3753","14369","2015",3,3,0,87938.6666666667,893.666666666667,85.6666666666667
"3754","14370","2015",23,23,0,137869.565217391,1343.04347826087,105.739130434783
"3755","14371","2015",70,70,0,139163,1280.92857142857,109.585714285714
"3756","14374","2015",2,2,0,147500,1380,99.5
"3757","14375","2015",1,1,0,151000,1557,97
"3758","14377","2015",6,6,0,121666.666666667,1482.33333333333,86.1666666666667
"3759","14378","2015",4,4,0,113375,1043.5,106.25
"3760","14379","2015",4,4,0,137475,1198.25,124
"3761","14380","2015",3,3,0,221000,1477.66666666667,160.333333333333
"3762","14383","2015",20,17,3,209842,2090.7,98.4
"3763","14384","2015",64,43,21,168618.75,2408.953125,71.734375
"3764","14385","2015",1,1,0,161500,1442,112
"3765","14389","2015",3,3,0,158100,1399.66666666667,119.333333333333
"3766","14390","2015",1,1,0,64000,970,66
"3767","14391","2015",1,1,0,115000,1643,70
"3768","14393","2015",3,3,0,224666.666666667,1842.66666666667,124
"3769","14394","2015",5,5,0,144587.8,1369.8,108
"3770","14396","2015",9,9,0,218433.555555556,2183.77777777778,102.444444444444
"3771","14397","2015",4,4,0,125587.5,1428.75,87
"3772","14398","2015",4,4,0,148750,1658,91.75
"3773","14399","2015",5,5,0,212060,1557,130.4
"3774","14400","2015",4,4,0,113750,1003.25,109.25
"3775","14401","2015",2,2,0,137500,1020.5,130
"3776","14402","2015",1,1,0,135000,900,150
"3777","14403","2015",11,11,0,111135.272727273,1279.36363636364,86.4545454545455
"3778","14404","2015",2,2,0,120000,1120.5,107
"3779","14405","2015",1,1,0,185000,2256,82
"3780","14406","2015",17,17,0,190213.529411765,1711.23529411765,115.294117647059
"3781","14407","2015",29,27,2,278911.896551724,2156.34482758621,127.48275862069
"3782","14408","2015",16,15,1,140606.25,1619.0625,92
"3783","14409","2015",79,36,43,152641.772151899,2533.9746835443,62.3544303797468
"3784","14410","2015",14,14,0,140703.571428571,1410.64285714286,98.9285714285714
"3785","14411","2015",2,2,0,194600,1377.5,147
"3786","14419","2015",2,2,0,131500,1078,127
"3787","14421","2015",11,11,0,158200,1375.72727272727,122
"3788","14424","2015",3,3,0,120666.666666667,1275,95.6666666666667
"3789","14425","2015",2,2,0,571000,4605,141
"3790","14426","2015",2,2,0,459850,2331.5,217
"3791","14427","2015",6,6,0,84198.6666666667,1130.5,81.5
"3792","14430","2015",1,1,0,113000,1687,67
"3793","14431","2015",46,45,1,146490.195652174,1413.28260869565,106.369565217391
"3794","14435","2015",1,1,0,135000,1125,120
"3795","14437","2015",5,4,1,195800,1944.2,107.4
"3796","14438","2015",8,8,0,185975,1900.875,102.75
"3797","14439","2015",1,1,0,47000,825,57
"3798","14445","2015",5,5,0,63300,1108.4,63.8
"3799","14446","2015",1,1,0,150000,1240,121
"3800","14449","2015",3,3,0,146933.333333333,1592.33333333333,96.6666666666667
"3801","14452","2015",5,5,0,83520,1181,88
"3802","14453","2015",7,7,0,173742.857142857,1369.85714285714,126.571428571429
"3803","14454","2015",15,12,3,175632.333333333,1961.2,96.4
"3804","14455","2015",2,2,0,137500,1036,128
"3805","14456","2015",34,34,0,156289.117647059,1593.82352941176,100.647058823529
"3806","14457","2015",3,3,0,60833.3333333333,1068.66666666667,55.6666666666667
"3807","14458","2015",4,4,0,127629.25,1196.5,109.75
"3808","14460","2015",24,24,0,136894.166666667,1389.70833333333,104.791666666667
"3809","14461","2015",5,5,0,183360,1585.2,117.4
"3810","14465","2015",4,4,0,242750,1578.75,149.75
"3811","14466","2015",5,5,0,193700,1557.4,124
"3812","14467","2015",1,1,0,163000,1646,99
"3813","14468","2015",1,1,0,287790,2148,134
"3814","14469","2015",4,4,0,114375,1141,91.25
"3815","14473","2015",1,1,0,70000,686,102
"3816","14474","2015",2,2,0,198605.5,1633,100.5
"3817","14475","2015",18,18,0,162472.222222222,1525.77777777778,112.777777777778
"3818","14476","2015",1,1,0,370000,1745,212
"3819","14478","2015",19,19,0,86705.2631578947,974.157894736842,83.0526315789474
"3820","14480","2015",5,5,0,300360,1665,146.4
"3821","14482","2015",2,2,0,174250,1090.5,159.5
"3822","14484","2015",1,1,0,315000,1969,160
"3823","14486","2015",5,5,0,162930,1501,109.6
"3824","14487","2015",10,10,0,174375,1728.1,99.2
"3825","14488","2015",188,107,81,169912.659574468,2413.53191489362,72.9148936170213
"3826","14491","2015",2,2,0,154000,1778,86.5
"3827","14492","2015",7,7,0,224615.714285714,2207.14285714286,108.142857142857
"3828","14494","2015",2,2,0,242900,1511.5,158
"3829","14495","2015",4,4,0,291325,2035.75,145.5
"3830","14496","2015",1,1,0,132000,1389,95
"3831","14497","2015",2,2,0,93250,780,120
"3832","14498","2015",1,1,0,65000,812,80
"3833","14499","2015",5,5,0,269420,2190.2,137.4
"3834","14500","2015",3,3,0,277233.333333333,2659,111.666666666667
"3835","14501","2015",4,4,0,121750,1070,110.75
"3836","14502","2015",4,4,0,126250,1062.25,111.5
"3837","14504","2015",12,12,0,150965.833333333,1420.33333333333,109.333333333333
"3838","14506","2015",3,3,0,111666.666666667,1226,91.3333333333333
"3839","14509","2015",4,4,0,194250,1740.75,108.75
"3840","14510","2015",2,2,0,96000,624,182.5
"3841","14511","2015",3,3,0,92833.3333333333,866.333333333333,110
"3842","14514","2015",44,38,6,174345.386363636,1924.84090909091,95.2727272727273
"3843","14515","2015",21,14,7,144545.476190476,1546.61904761905,98.5714285714286
"3844","14516","2015",21,21,0,114621.428571429,1720.09523809524,71.5714285714286
"3845","14520","2015",3,3,0,164833.333333333,1675.33333333333,98.6666666666667
"3846","14522","2015",5,5,0,189462.4,1662.8,114
"3847","14524","2015",1,1,0,145000,2231,65
"3848","14527","2015",1,1,0,85000,850,100
"3849","14528","2015",12,12,0,222541.666666667,1721.33333333333,132.916666666667
"3850","14529","2015",2,2,0,154550,1515,116
"3851","14530","2015",14,13,1,172285.714285714,2105.14285714286,90.0714285714286
"3852","14531","2015",1,1,0,65000,1083,60
"3853","14534","2015",3,3,0,258000,1695.66666666667,140.333333333333
"3854","14535","2015",7,7,0,145500,1997.85714285714,85.8571428571429
"3855","14538","2015",16,13,3,177743.75,1708.5625,105.1875
"3856","14540","2015",3,3,0,222400,1717.66666666667,116.333333333333
"3857","14541","2015",1,1,0,370700,2942,126
"3858","14542","2015",5,5,0,220990,2072.4,105.8
"3859","14543","2015",18,18,0,186844.444444444,1746.88888888889,109.722222222222
"3860","14546","2015",1,1,0,1e+05,1538,65
"3861","14547","2015",1,1,0,110000,738,149
"3862","14552","2015",5,5,0,208420,1739.2,137.2
"3863","14554","2015",8,8,0,136256.25,1496.125,84.625
"3864","14555","2015",6,6,0,247500,2322.16666666667,106
"3865","14556","2015",20,20,0,163843.65,1793.65,95.15
"3866","14557","2015",13,6,7,228230.769230769,3063.84615384615,65.7692307692308
"3867","14558","2015",12,12,0,234495,1924.66666666667,124.25
"3868","14559","2015",3,3,0,133333.333333333,1213.66666666667,111.666666666667
"3869","14562","2015",63,47,16,167397.619047619,2293.66666666667,75.2222222222222
"3870","14563","2015",8,8,0,139693.125,1655.375,83.875
"3871","14565","2015",7,7,0,128857.142857143,1885.28571428571,72.1428571428571
"3872","14566","2015",18,17,1,272925,2240.83333333333,124.166666666667
"3873","14569","2015",3,3,0,130166.666666667,1322.66666666667,109.333333333333
"3874","14570","2015",32,32,0,138297.03125,1424.4375,103.34375
"3875","14571","2015",4,4,0,143625,1731.75,84.5
"3876","14572","2015",14,14,0,122982.071428571,1123.71428571429,108
"3877","14574","2015",11,11,0,184722.727272727,1523.27272727273,130.272727272727
"3878","14575","2015",6,6,0,441375,2600,150.666666666667
"3879","14576","2015",3,3,0,155000,1261.33333333333,124.333333333333
"3880","14578","2015",9,9,0,216500,2169.22222222222,104.555555555556
"3881","14579","2015",10,10,0,138780,1057.9,135.9
"3882","14582","2015",9,9,0,128505.666666667,1266.88888888889,105.111111111111
"3883","14587","2015",7,7,0,181028.571428571,1994.14285714286,90.1428571428571
"3884","14588","2015",6,6,0,130816.666666667,1101.5,121.333333333333
"3885","14589","2015",15,15,0,111321.333333333,1422.46666666667,80.8666666666667
"3886","14590","2015",1,1,0,170000,1848,92
"3887","14591","2015",10,10,0,150882.5,1894.5,82.2
"3888","14592","2015",12,12,0,166527.5,1866.41666666667,90
"3889","14593","2015",9,9,0,239388.888888889,2258,100.444444444444
"3890","14595","2015",1,1,0,110000,1692,65
"3891","14598","2015",1,1,0,340000,2329,146
"3892","14601","2015",3,3,0,231666.666666667,2225,109
"3893","14602","2015",5,5,0,73497.2,981,81.8
"3894","14603","2015",5,5,0,176320,1676.8,105.4
"3895","14605","2015",2,2,0,258500,2384,96
"3896","14606","2015",2,2,0,242275,1949,121.5
"3897","14607","2015",1,1,0,75000,862,87
"3898","14609","2015",1,1,0,334000,1898,176
"3899","14610","2015",24,21,3,176961.958333333,1935.83333333333,95.4166666666667
"3900","14613","2015",1,1,0,1e+05,893,112
"3901","14614","2015",6,6,0,139916.666666667,1407.83333333333,103.333333333333
"3902","14620","2015",5,5,0,205590,2014.8,101.4
"3903","14621","2015",5,5,0,75000,1125.2,77
"3904","14622","2015",3,3,0,106000,1387,81
"3905","14623","2015",27,27,0,168064.074074074,1854.85185185185,91.2592592592593
"3906","14625","2015",9,9,0,161555.555555556,1667.11111111111,97.3333333333333
"3907","14626","2015",6,6,0,132833.333333333,1530.16666666667,89.6666666666667
"3908","14630","2015",5,5,0,187540,1852.2,104.6
"3909","14635","2015",2,2,0,165000,1147,146
"3910","14637","2015",1,1,0,150000,3333,45
"3911","14639","2015",4,4,0,215700,1921,109.25
"3912","14640","2015",3,3,0,230166.666666667,1633.66666666667,144.333333333333
"3913","14643","2015",9,9,0,136166.666666667,1410.22222222222,101.777777777778
"3914","14644","2015",13,13,0,147557.692307692,1615.84615384615,94.6153846153846
"3915","14645","2015",4,4,0,171875,2021.75,85
"3916","14646","2015",6,6,0,157500,1270,126.333333333333
"3917","14648","2015",4,4,0,210145,1637.25,137
"3918","14649","2015",3,3,0,139000,1143.66666666667,136
"3919","14650","2015",1,1,0,146000,1553,94
"3920","14651","2015",2,2,0,86000,1789,52
"3921","14652","2015",2,2,0,98000,1176.5,94
"3922","14654","2015",49,49,0,146978.591836735,1310.5306122449,106.918367346939
"3923","14656","2015",13,13,0,82319.6153846154,1093.30769230769,78.8461538461538
"3924","14657","2015",3,3,0,199600,1721,116.333333333333
"3925","14658","2015",51,51,0,112364.431372549,1048.72549019608,101.764705882353
"3926","14659","2015",9,9,0,142977.777777778,1577.22222222222,95.6666666666667
"3927","14661","2015",4,4,0,142500,1551.5,90.5
"3928","14663","2015",24,22,2,165489.166666667,1702.04166666667,98.0416666666667
"3929","14664","2015",1,1,0,86000,956,90
"3930","14665","2015",10,10,0,204770,2045,102.1
"3931","14666","2015",16,15,1,168918.75,2119.375,82.875
"3932","14667","2015",7,7,0,129342.857142857,1409.57142857143,97.2857142857143
"3933","14668","2015",2,2,0,171700,1548.5,111
"3934","14669","2015",1,1,0,50000,746,67
"3935","14672","2015",13,13,0,115576.923076923,1242,101.615384615385
"3936","14675","2015",10,9,1,185270,2212.1,84.1
"3937","14676","2015",19,19,0,186207.894736842,1643.89473684211,116.789473684211
"3938","14677","2015",4,4,0,129310,1145.5,106.25
"3939","14678","2015",3,3,0,96666.6666666667,1329.33333333333,73
"3940","14679","2015",3,3,0,154833.333333333,1540.33333333333,99
"3941","14680","2015",3,3,0,186100,1929.66666666667,107.333333333333
"3942","14681","2015",4,4,0,82550,810.5,112
"3943","14682","2015",6,6,0,196375,2109.33333333333,97
"3944","14685","2015",16,16,0,201726.875,1970.3125,119.4375
"3945","14687","2015",1,1,0,30000,462,65
"3946","14689","2015",41,40,1,142976.048780488,1351.0243902439,111.926829268293
"3947","14692","2015",18,18,0,161688.888888889,1530.72222222222,110.611111111111
"3948","14694","2015",7,7,0,234285.714285714,2057,117.857142857143
"3949","14698","2015",8,8,0,197018.75,1990,98.625
"3950","14699","2015",58,31,27,187142.5,2713.25862068966,71.5
"3951","14700","2015",3,3,0,155933.333333333,1400,112
"3952","14701","2015",62,14,48,246120.564516129,3984.01612903226,64.0806451612903
"3953","14707","2015",14,14,0,182948.571428571,1919.92857142857,99.3571428571429
"3954","14708","2015",3,3,0,149333.333333333,1103,139
"3955","14709","2015",2,2,0,130550,2019.5,66.5
"3956","14711","2015",12,12,0,139633.333333333,1414.91666666667,102
"3957","14712","2015",27,27,0,178770.37037037,1955.74074074074,92.7777777777778
"3958","14713","2015",3,3,0,196666.666666667,1535,125.666666666667
"3959","14714","2015",10,10,0,142895.4,1265.9,118.5
"3960","14715","2015",243,96,147,196498.75308642,3618.87654320988,58.2510288065844
"3961","14716","2015",3,3,0,153753.333333333,1600.66666666667,109
"3962","14719","2015",2,2,0,114500,1272,90
"3963","14720","2015",12,12,0,109700,1157.83333333333,92.25
"3964","14721","2015",3,3,0,203771.333333333,1256.33333333333,171.666666666667
"3965","14723","2015",4,4,0,192250,1862.5,101.25
"3966","14724","2015",35,27,8,239342.142857143,3082.51428571429,80.1428571428571
"3967","14726","2015",61,61,0,94848.1475409836,910.098360655738,103.819672131148
"3968","14728","2015",4,4,0,189875,1495.25,127.5
"3969","14731","2015",2,2,0,342500,2758.5,130
"3970","14732","2015",3,3,0,148000,1402.66666666667,109.333333333333
"3971","14733","2015",3,3,0,162950,1920.33333333333,93.3333333333333
"3972","14734","2015",1,1,0,101000,1403,72
"3973","14735","2015",8,8,0,150306.25,1287.75,122.375
"3974","14737","2015",4,4,0,162250,1404,119.5
"3975","14738","2015",32,30,2,189005.96875,1731.71875,109.96875
"3976","14739","2015",36,35,1,179781.944444444,1900.52777777778,104.638888888889
"3977","14740","2015",10,10,0,163350,1354.5,107.7
"3978","14741","2015",3,3,0,84666.6666666667,1151,75
"3979","14743","2015",2,2,0,126500,1408,90
"3980","14744","2015",6,6,0,224233.333333333,1490.33333333333,155.5
"3981","14745","2015",5,5,0,204248,1872.2,105.2
"3982","14747","2015",4,4,0,166050,1566.5,108.25
"3983","14751","2015",4,4,0,167350,1520.25,96.25
"3984","14753","2015",3,3,0,155000,1701.33333333333,91.3333333333333
"3985","14754","2015",279,42,237,124361.956989247,2863.91397849462,43.5770609318996
"3986","14755","2015",24,16,8,169380.458333333,2910.95833333333,66.375
"3987","14758","2015",2,2,0,311125,2368,133.5
"3988","14759","2015",3,3,0,69000,1109,69.3333333333333
"3989","14760","2015",16,16,0,169100,1644.6875,107
"3990","14761","2015",8,8,0,175000,1731,102.75
"3991","14762","2015",165,119,46,100524,1201.77575757576,85.7515151515152
"3992","14764","2015",10,9,1,56900,716.4,80.7
"3993","15001","2015",9,9,0,81955.5555555556,1095,84.5555555555556
"3994","15002","2015",1,1,0,76470,944,81
"3995","15003","2015",5,5,0,105000,1035.4,97.8
"3996","15004","2015",1,1,0,210000,1338,157
"3997","15005","2015",3,3,0,161006.666666667,1542.33333333333,117.666666666667
"3998","15006","2015",4,2,2,150350,1730.25,81.25
"3999","15007","2015",1,1,0,152600,1541,99
"4000","15008","2015",4,4,0,89100,986,96.75
"4001","15009","2015",3,3,0,82333.3333333333,1398,57.6666666666667
"4002","15010","2015",2,2,0,82350,1155,84
"4003","15011","2015",1,1,0,80000,1013,79
"4004","15012","2015",51,32,19,113138.647058824,1354.88235294118,88.6862745098039
"4005","15013","2015",2,2,0,152000,1761,85
"4006","15014","2015",363,82,281,90762.6831955923,1216.26721763085,74.0661157024793
"4007","15015","2015",2,2,0,65000,704.5,86
"4008","15016","2015",10,10,0,145378.5,1090.4,136.5
"4009","15017","2015",3,3,0,78833.3333333333,1539.66666666667,56.6666666666667
"4010","15018","2015",1,1,0,29000,349,83
"4011","15020","2015",2,2,0,85250,991.5,86
"4012","15021","2015",2,2,0,39000,546.5,80.5
"4013","15022","2015",2,1,1,63500,988,79
"4014","15024","2015",1,1,0,124830,873,143
"4015","15025","2015",1,1,0,63000,913,69
"4016","15027","2015",3,3,0,93333.3333333333,868,114.666666666667
"4017","15029","2015",4,4,0,95787.5,882.75,103.5
"4018","15030","2015",2,2,0,185500,1693.5,109.5
"4019","15032","2015",1,1,0,30000,667,45
"4020","15034","2015",2,2,0,165500,1124,147.5
"4021","15036","2015",2,2,0,135200,984.5,128.5
"4022","15037","2015",11,10,1,72545.4545454545,889.818181818182,83.1818181818182
"4023","15038","2015",10,10,0,61900,918.4,71.4
"4024","15040","2015",2,2,0,77500,1433.5,55
"4025","15042","2015",2,2,0,74617.5,751,104
"4026","15043","2015",1,1,0,80000,870,92
"4027","15045","2015",9,8,1,87484.4444444444,1233.44444444444,79.8888888888889
"4028","15046","2015",3,3,0,41666.6666666667,657.333333333333,72
"4029","15049","2015",5,5,0,86654,1535.4,63.4
"4030","15050","2015",2,2,0,68500,1233.5,60
"4031","15051","2015",1,1,0,63000,759,83
"4032","15052","2015",4,4,0,58500,809.25,83
"4033","15053","2015",1,1,0,90000,1500,60
"4034","15054","2015",6,5,1,46383.3333333333,773.166666666667,57.8333333333333
"4035","15055","2015",1,1,0,79720,1329,60
"4036","15056","2015",6,6,0,163366.666666667,1431.5,108.833333333333
"4037","15057","2015",1,1,0,96000,1129,85
"4038","15061","2015",3,3,0,82166.6666666667,1369,58.3333333333333
"4039","15063","2015",3,3,0,78500,568.666666666667,146.666666666667
"4040","15066","2015",4,4,0,84831.25,907.25,85.5
"4041","15067","2015",1,1,0,60000,857,70
"4042","15069","2015",2,2,0,158000,1854.5,90
"4043","15070","2015",4,4,0,51075,1157,48.25
"4044","15072","2015",2,2,0,38750,745,55
"4045","15074","2015",1,1,0,179800,1427,126
"4046","15075","2015",1,1,0,110000,833,132
"4047","15076","2015",1,1,0,65000,1444,45
"4048","15078","2015",1,1,0,127000,934,136
"4049","15081","2015",2,2,0,66500,657,102
"4050","15082","2015",2,2,0,46750,793.5,59
"4051","15083","2015",21,20,1,132419.047619048,1332.80952380952,102.190476190476
"4052","15084","2015",1,1,0,190000,1450,131
"4053","15085","2015",1,1,0,66000,1467,45
"4054","15086","2015",1,1,0,35000,500,70
"4055","15087","2015",1,1,0,80000,1702,47
"4056","15088","2015",4,4,0,103325,906.75,120.25
"4057","15089","2015",4,3,1,91162.5,1567.5,60.75
"4058","15090","2015",3,3,0,105666.666666667,1363,76
"4059","15091","2015",1,1,0,27000,415,65
"4060","15092","2015",7,7,0,94142.8571428571,1308.14285714286,69.2857142857143
"4061","15094","2015",3,2,1,107416.666666667,959,112.666666666667
"4062","15095","2015",2,2,0,40000,721.5,51.5
"4063","15096","2015",2,2,0,58500,752,77
"4064","15098","2015",1,1,0,62000,861,72
"4065","15100","2015",2,2,0,72500,1280.5,71
"4066","15101","2015",43,6,37,83350.3488372093,2164.93023255814,38.0697674418605
"4067","15102","2015",1,1,0,95000,792,120
"4068","15103","2015",1,1,0,50500,561,90
"4069","15106","2015",2,2,0,96500,1099,95
"4070","15107","2015",1,1,0,51000,1275,40
"4071","15108","2015",7,6,1,102571.428571429,1036.28571428571,92.1428571428571
"4072","15110","2015",5,5,0,44800,451.2,102.6
"4073","15112","2015",2,2,0,202500,3194,77
"4074","15113","2015",2,2,0,69165,1009,66.5
"4075","15114","2015",2,2,0,59000,1554.5,64
"4076","15116","2015",3,3,0,74166.6666666667,760.666666666667,101.666666666667
"4077","15117","2015",4,4,0,111500,1005,108.75
"4078","15118","2015",7,6,1,245670,2886.42857142857,87.4285714285714
"4079","15119","2015",21,18,3,104590.952380952,1249.33333333333,95.8095238095238
"4080","15120","2015",19,14,5,77508.4210526316,1047.47368421053,76.0526315789474
"4081","15122","2015",11,10,1,83232.7272727273,1059.27272727273,76.2727272727273
"4082","15123","2015",1,1,0,70000,1167,60
"4083","15124","2015",8,8,0,74662.5,919.125,93.25
"4084","15126","2015",1,1,0,33000,440,75
"4085","15127","2015",1,1,0,158625,1983,80
"4086","15129","2015",2,2,0,41500,776.5,53
"4087","15130","2015",1,1,0,60000,500,120
"4088","15131","2015",2,2,0,82650,1512,54
"4089","15134","2015",6,6,0,89189,1083.33333333333,80.3333333333333
"4090","15135","2015",1,1,0,35000,556,63
"4091","15137","2015",4,4,0,83250,1226.75,68.25
"4092","15138","2015",22,17,5,118242.727272727,1513.27272727273,94.6363636363636
"4093","15140","2015",14,14,0,131328.571428571,1299.14285714286,98.3571428571429
"4094","15141","2015",8,8,0,95587.5,1133.75,82.375
"4095","15142","2015",13,12,1,97100,1079.61538461538,87.6923076923077
"4096","15143","2015",1,1,0,35000,500,70
"4097","15144","2015",3,3,0,91666.6666666667,1994.66666666667,49.3333333333333
"4098","15146","2015",2,1,1,60000,865.5,70.5
"4099","15147","2015",4,3,1,95117.5,1220.75,72.75
"4100","15148","2015",2,2,0,128575,911.5,140
"4101","15149","2015",2,2,0,60050,857.5,75
"4102","15152","2015",7,7,0,82171.4285714286,785.285714285714,103.428571428571
"4103","15153","2015",18,18,0,73322.2222222222,843.444444444444,83.7777777777778
"4104","15154","2015",8,8,0,112681.25,1268.625,89.875
"4105","15155","2015",2,2,0,68000,896.5,77.5
"4106","15156","2015",5,5,0,154250,1523.2,104.2
"4107","15157","2015",1,1,0,62000,1033,60
"4108","15159","2015",2,2,0,77500,877,82
"4109","15160","2015",12,12,0,136345.833333333,1278.5,104.666666666667
"4110","15161","2015",1,1,0,40000,494,81
"4111","15162","2015",24,20,4,84233.3333333333,1035.58333333333,81.625
"4112","15163","2015",7,7,0,88802,953.714285714286,89.7142857142857
"4113","15164","2015",2,2,0,170450,2449.5,75
"4114","15166","2015",2,2,0,72250,881,80
"4115","15167","2015",2,2,0,115500,1565,74
"4116","15168","2015",3,1,2,68666.6666666667,778.333333333333,93
"4117","15169","2015",4,4,0,84000,1100.25,83.25
"4118","15170","2015",3,2,1,112833.333333333,1147,88.3333333333333
"4119","15173","2015",4,3,1,86891.25,727,106.25
"4120","15174","2015",2,2,0,99300,1170.5,79.5
"4121","15175","2015",6,6,0,68436.6666666667,1005.16666666667,70
"4122","15176","2015",3,3,0,116493.333333333,1493.66666666667,77.6666666666667
"4123","15178","2015",4,3,1,110125,1372.75,76.5
"4124","15179","2015",4,4,0,128620,1533.5,85.25
"4125","15181","2015",3,3,0,80000,1006.33333333333,80.3333333333333
"4126","15182","2015",2,2,0,63075,753.5,82.5
"4127","15183","2015",1,1,0,19000,396,48
"4128","15184","2015",5,5,0,161260,1446.8,116.8
"4129","15185","2015",2,2,0,52000,658.5,78.5
"4130","15186","2015",3,3,0,62983.3333333333,708.333333333333,82
"4131","15187","2015",39,26,13,115481.538461538,1400.02564102564,85.1538461538462
"4132","15188","2015",5,5,0,140524,1081,133.6
"4133","15189","2015",8,8,0,118937.5,1764.125,67.625
"4134","15191","2015",7,7,0,90168.5714285714,988.285714285714,86.8571428571429
"4135","15192","2015",2,2,0,81000,1367.5,61.5
"4136","15196","2015",14,14,0,119519.285714286,1152.35714285714,98.7857142857143
"4137","15200","2015",1,1,0,259100,1472,176
"4138","15201","2015",1,1,0,170500,1740,98
"4139","15202","2015",8,7,1,96375,930.75,104.625
"4140","15204","2015",16,16,0,147948.125,1516.4375,100.6875
"4141","15205","2015",2,2,0,95000,881,106
"4142","15207","2015",2,2,0,68300,1281,50.5
"4143","15208","2015",1,1,0,26000,473,55
"4144","15209","2015",1,1,0,50000,510,98
"4145","15211","2015",4,4,0,60000,650.75,89.75
"4146","15213","2015",2,2,0,68000,832,85
"4147","15214","2015",1,1,0,88700,745,119
"4148","15215","2015",9,9,0,163088.888888889,1340,107.444444444444
"4149","15216","2015",4,4,0,77250,1186.25,66.5
"4150","15217","2015",1,1,0,126000,1575,80
"4151","15219","2015",5,5,0,88500,1273,64
"4152","15221","2015",9,9,0,126495.555555556,1349.33333333333,94.3333333333333
"4153","15223","2015",3,3,0,81333.3333333333,795.333333333333,106.666666666667
"4154","15225","2015",5,5,0,61494,1129.4,61.6
"4155","15226","2015",1,1,0,175175,1317,133
"4156","15228","2015",3,3,0,89000,841.333333333333,110.666666666667
"4157","15230","2015",1,1,0,35000,875,40
"4158","15231","2015",5,5,0,71300,692.8,114.2
"4159","15233","2015",3,3,0,173636.666666667,1420,121.666666666667
"4160","15234","2015",4,4,0,156600,1544.5,102.75
"4161","15235","2015",5,5,0,117300,1369.6,89.8
"4162","15236","2015",3,3,0,69966.6666666667,748.333333333333,96.3333333333333
"4163","15237","2015",1,1,0,162200,1287,126
"4164","15238","2015",2,2,0,94575,1408.5,68.5
"4165","15240","2015",5,5,0,173180,1787.4,95
"4166","15243","2015",6,6,0,75250,806.666666666667,90.8333333333333
"4167","15244","2015",5,5,0,98970,1026.2,100.8
"4168","15246","2015",3,2,1,110000,2077,66
"4169","15248","2015",3,3,0,83000,1280.66666666667,65.6666666666667
"4170","15249","2015",2,2,0,135000,1119.5,136
"4171","15250","2015",3,3,0,104716.666666667,990,108.666666666667
"4172","15252","2015",4,4,0,179750,1498.5,116.25
"4173","15254","2015",2,2,0,60000,538,106.5
"4174","15255","2015",7,7,0,122791.142857143,1229.14285714286,94.8571428571429
"4175","15256","2015",1,1,0,57000,740,77
"4176","15258","2015",14,10,4,94682.1428571429,1135.14285714286,79.8571428571429
"4177","15259","2015",1,1,0,50000,685,73
"4178","15260","2015",3,2,1,93000,964.666666666667,92
"4179","15261","2015",6,6,0,128383.333333333,925,161.833333333333
"4180","15262","2015",2,2,0,120000,1194.5,90
"4181","15264","2015",3,2,1,247900,3668,83.6666666666667
"4182","15265","2015",10,9,1,105333.5,1234.5,84.2
"4183","15266","2015",4,4,0,190128.75,1604.25,112.75
"4184","15267","2015",26,26,0,142490,1557.65384615385,93.4230769230769
"4185","15268","2015",7,7,0,85562.8571428571,1497.71428571429,60.5714285714286
"4186","16001","2015",3,3,0,76000,790.333333333333,93
"4187","16002","2015",13,13,0,101361.538461538,993.076923076923,105
"4188","16003","2015",11,11,0,97918.1818181818,1098.36363636364,88.9090909090909
"4189","16005","2015",6,6,0,109101.666666667,1025.16666666667,103.166666666667
"4190","16007","2015",4,4,0,84625,787.5,96.5
"4191","16008","2015",5,5,0,90400,796.8,117.6
"4192","16009","2015",6,6,0,55000,678.333333333333,80.8333333333333
"4193","16011","2015",4,4,0,113250,1094,96.75
"4194","16012","2015",5,5,0,127230,2012.8,96.2
"4195","16013","2015",2,2,0,133250,1215.5,114
"4196","16015","2015",523,363,160,109065.625239006,1323.53537284895,84.0095602294455
"4197","16016","2015",7,7,0,114007.142857143,1289.14285714286,92
"4198","16018","2015",2,2,0,162465,1618,100.5
"4199","16019","2015",12,12,0,99338.3333333333,1187,85.1666666666667
"4200","16020","2015",8,8,0,149247.5,1014.875,154.625
"4201","16023","2015",5,5,0,86200,895.4,100
"4202","16024","2015",5,5,0,163050,1438.6,105.8
"4203","16025","2015",10,10,0,113860,1002.2,113.7
"4204","16026","2015",12,12,0,152608.333333333,1334.5,116.5
"4205","16027","2015",2,2,0,209025,1195,150
"4206","16028","2015",46,45,1,115073.913043478,1096.32608695652,109.826086956522
"4207","16029","2015",2,2,0,215500,1339,186
"4208","16030","2015",11,11,0,101632.636363636,874.636363636364,121.909090909091
"4209","16031","2015",2,2,0,65000,682,95.5
"4210","16032","2015",9,9,0,135694.444444444,1028.77777777778,123.444444444444
"4211","16034","2015",2,2,0,79000,707,105
"4212","16035","2015",2,2,0,201050,1175.5,152
"4213","16036","2015",5,5,0,187674.2,1567.4,114.8
"4214","16037","2015",2,2,0,220000,1528,142.5
"4215","16038","2015",6,6,0,94333.3333333333,935,98.8333333333333
"4216","16039","2015",6,6,0,97500.5,997.333333333333,104
"4217","16040","2015",3,3,0,219000,1121.33333333333,200.333333333333
"4218","16041","2015",2,2,0,159000,1170.5,146
"4219","16044","2015",2,2,0,183750,1080,175
"4220","16045","2015",3,3,0,126533.333333333,977,132
"4221","16046","2015",8,8,0,88231.25,948.125,90
"4222","16047","2015",4,4,0,60527.75,885.5,68.5
"4223","16049","2015",6,6,0,102125,997,100.5
"4224","16050","2015",1,1,0,361516,1464,247
"4225","16052","2015",5,5,0,81600,1164.4,73.8
"4226","16053","2015",1,1,0,133000,1304,102
"4227","16054","2015",4,4,0,118375,886.25,129
"4228","16055","2015",7,7,0,158601.142857143,1388.57142857143,129.285714285714
"4229","16056","2015",8,8,0,145175,1143.875,117.5
"4230","16057","2015",1,1,0,505000,3079,164
"4231","16058","2015",12,12,0,122966.666666667,1351.33333333333,92
"4232","16059","2015",1,1,0,159170,727,219
"4233","16060","2015",2,2,0,91000,918.5,93
"4234","16061","2015",37,37,0,135627.459459459,1325.2972972973,104.432432432432
"4235","16062","2015",1,1,0,130000,850,153
"4236","16063","2015",2,2,0,234594.5,1835.5,133
"4237","16064","2015",11,11,0,114227.272727273,1251.45454545455,97.8181818181818
"4238","16065","2015",15,15,0,111168.8,1221.06666666667,90.4
"4239","16066","2015",7,7,0,204571.428571429,1316,147
"4240","16067","2015",3,3,0,154666.666666667,1374.33333333333,111.333333333333
"4241","16068","2015",9,9,0,57960,672.333333333333,86.2222222222222
"4242","16069","2015",4,4,0,69750,810,86.5
"4243","16070","2015",14,14,0,91671.4285714286,970.428571428571,97.2857142857143
"4244","16071","2015",5,5,0,81400,899.4,94.4
"4245","16072","2015",1,1,0,198160,1415,140
"4246","16073","2015",17,17,0,91998.2941176471,805.352941176471,113.235294117647
"4247","16074","2015",9,9,0,170594.444444444,1147.66666666667,150.333333333333
"4248","16075","2015",1,1,0,62000,590,105
"4249","16076","2015",10,10,0,79640,806.1,108.2
"4250","16077","2015",3,3,0,122000,880.333333333333,131
"4251","16078","2015",48,48,0,128566.166666667,1292.33333333333,102.8125
"4252","16079","2015",4,4,0,72500,626.75,108.5
"4253","16081","2015",3,3,0,69066.6666666667,767.333333333333,88
"4254","16082","2015",6,6,0,97808.3333333333,1167.66666666667,85
"4255","16083","2015",6,6,0,117000,1124.5,104.166666666667
"4256","16084","2015",4,2,2,78595,1034.25,77.25
"4257","16085","2015",30,29,1,88181.8,999.233333333333,89.2666666666667
"4258","16086","2015",9,9,0,102772.222222222,1074,97.4444444444444
"4259","16087","2015",1,1,0,30000,462,65
"4260","16088","2015",11,11,0,113436.363636364,1166.54545454545,102.909090909091
"4261","16089","2015",41,38,3,137383.073170732,1558.92682926829,94.7560975609756
"4262","16090","2015",28,28,0,125155.214285714,1120.21428571429,118.607142857143
"4263","16091","2015",2,2,0,117500,960.5,122
"4264","16093","2015",12,12,0,132125,1293.66666666667,106.333333333333
"4265","16095","2015",1,1,0,219766,1221,180
"4266","16096","2015",3,3,0,54333.3333333333,707.333333333333,79
"4267","16097","2015",20,19,1,120414.6,1049.95,114.4
"4268","16099","2015",2,2,0,151050,1271,122
"4269","16100","2015",11,11,0,118304.090909091,1148.54545454545,99.0909090909091
"4270","16101","2015",12,12,0,108965.166666667,1308.33333333333,83.9166666666667
"4271","16102","2015",246,207,39,116435.398373984,1317.43495934959,90.5813008130081
"4272","16103","2015",2,2,0,69000,823.5,70.5
"4273","16104","2015",7,7,0,133650,999.571428571429,139.714285714286
"4274","16105","2015",7,7,0,142655.714285714,1003.28571428571,145.142857142857
"4275","16106","2015",31,30,1,108025.806451613,1056.22580645161,101.741935483871
"4276","16107","2015",1,1,0,173000,1169,148
"4277","16108","2015",2,2,0,61000,650.5,93.5
"4278","16109","2015",4,4,0,134250,1359.75,110
"4279","16110","2015",2,2,0,101900,932.5,105
"4280","16112","2015",1,1,0,1e+05,901,111
"4281","16113","2015",51,49,2,125633.333333333,1276.88235294118,100.254901960784
"4282","16114","2015",2,2,0,127500,908,135
"4283","16116","2015",1,1,0,160000,889,180
"4284","16117","2015",1,1,0,189620,1459,130
"4285","16118","2015",2,2,0,168100,1342.5,115
"4286","16119","2015",6,6,0,123508.333333333,987.666666666667,136
"4287","16120","2015",7,7,0,146728.571428571,1390.42857142857,106.857142857143
"4288","16121","2015",5,5,0,157426,1286,123.4
"4289","16122","2015",1,1,0,69000,676,102
"4290","16123","2015",2,2,0,102000,1206.5,84
"4291","16124","2015",15,15,0,95028.3333333333,922.866666666667,102.933333333333
"4292","16125","2015",1,1,0,117000,907,129
"4293","16127","2015",2,2,0,72250,1275.5,56
"4294","16128","2015",6,6,0,80150,907.666666666667,91.6666666666667
"4295","16130","2015",5,5,0,110300,891.8,108
"4296","16131","2015",3,3,0,81090,1006.66666666667,79.3333333333333
"4297","16132","2015",6,6,0,121758.333333333,1429.33333333333,99
"4298","16134","2015",5,5,0,87500,864.8,96.6
"4299","16135","2015",5,5,0,106984,883.6,125.8
"4300","16136","2015",4,4,0,107575,1000.75,109.25
"4301","16137","2015",8,8,0,84449.875,918.75,97.875
"4302","16138","2015",32,29,3,145845.0625,1431.625,103.34375
"4303","16139","2015",2,2,0,126275,1357,83
"4304","16140","2015",3,3,0,80728.3333333333,850.333333333333,94.3333333333333
"4305","16141","2015",5,5,0,127035.4,920.8,130.6
"4306","16142","2015",1,1,0,30000,667,45
"4307","16143","2015",2,2,0,157305,2043.5,95.5
"4308","16144","2015",5,5,0,83765.2,997.8,91
"4309","16145","2015",11,11,0,167050.909090909,1302.36363636364,130.090909090909
"4310","16146","2015",10,10,0,166105,1497.3,111.4
"4311","16147","2015",2,2,0,89950,1310.5,69.5
"4312","16148","2015",11,11,0,113909.090909091,817.272727272727,151.636363636364
"4313","16150","2015",8,8,0,170987.5,1524.25,112.25
"4314","16151","2015",4,4,0,199387.5,1180,174.25
"4315","16152","2015",6,6,0,125833.333333333,1126.5,109.666666666667
"4316","16153","2015",1,1,0,115000,1438,80
"4317","16154","2015",65,62,3,104432.107692308,1308.98461538462,81.6615384615385
"4318","16157","2015",6,6,0,99133.3333333333,966.833333333333,106.833333333333
"4319","16158","2015",4,4,0,148750,1272.5,117.5
"4320","16160","2015",4,4,0,104250,958.25,126.5
"4321","16161","2015",1,1,0,152400,1249,122
"4322","16162","2015",1,1,0,80000,615,130
"4323","16163","2015",10,10,0,137500,1386.3,100.2
"4324","16164","2015",2,2,0,35730,696.5,52.5
"4325","16165","2015",6,6,0,123666.666666667,925,128
"4326","16166","2015",44,41,3,127845.75,1367.56818181818,91.7727272727273
"4327","16167","2015",67,63,4,109074.776119403,1133.98507462687,97
"4328","16168","2015",12,12,0,117622.5,1286.25,92.75
"4329","16169","2015",7,7,0,74442.8571428571,858.285714285714,86.1428571428571
"4330","16170","2015",5,5,0,114040,1148,113.8
"4331","16171","2015",5,5,0,332072.8,3026.6,111.6
"4332","16173","2015",4,4,0,154037.5,1531.25,130
"4333","16174","2015",3,3,0,148333.333333333,1158.33333333333,131.333333333333
"4334","16175","2015",6,6,0,129261.666666667,1060.16666666667,123
"4335","16176","2015",5,5,0,170356.2,1439.8,113.6
"4336","16177","2015",1,1,0,220000,1528,144
"4337","16178","2015",1,1,0,172700,1371,126
"4338","16180","2015",2,2,0,235927.5,1227.5,203
"4339","16181","2015",6,6,0,59883.3333333333,688.833333333333,85.3333333333333
"4340","16182","2015",5,5,0,49000,643.8,79.4
"4341","16183","2015",1,1,0,29500,843,35
"4342","16184","2015",1,1,0,26500,1262,21
"4343","16185","2015",2,2,0,127500,2394.5,84.5
"4344","16186","2015",3,3,0,160000,1165,136
"4345","16187","2015",20,20,0,126460,1173,103.2
"4346","16188","2015",5,5,0,130570,1655.2,81.4
"4347","16189","2015",2,2,0,93575,1184,86
"4348","16190","2015",3,3,0,28750,393.666666666667,72.3333333333333
"4349","16191","2015",2,2,0,42000,933.5,55
"4350","16192","2015",15,15,0,107263.333333333,1235.33333333333,88.2
"4351","16193","2015",6,6,0,154181.666666667,1167,137.666666666667
"4352","16194","2015",1,1,0,93000,816,114
"4353","16195","2015",1,1,0,132750,830,160
"4354","16196","2015",5,5,0,92940,1023.6,88.6
"4355","16197","2015",1,1,0,96880,781,124
"4356","16198","2015",4,4,0,103550,943,104.25
"4357","16199","2015",37,37,0,129577.945945946,1298.2972972973,97.4594594594595
"4358","16200","2015",6,6,0,94750,1110,88.8333333333333
"4359","16203","2015",2,2,0,70000,774,92
"4360","16204","2015",7,7,0,196249.285714286,1163.14285714286,168
"4361","16205","2015",7,7,0,60695,747.571428571429,90.7142857142857
"4362","16206","2015",19,19,0,108975,1153.78947368421,100.789473684211
"4363","16207","2015",3,3,0,50666.6666666667,486,110
"4364","16208","2015",3,3,0,174333.333333333,1622,112
"4365","16209","2015",9,9,0,98465.5555555556,1180.33333333333,88.5555555555556
"4366","16210","2015",6,6,0,174200,1079,152.5
"4367","16211","2015",5,5,0,111540,1105.2,96.8
"4368","16212","2015",8,8,0,123225,1139.5,111.125
"4369","16213","2015",6,6,0,130953.333333333,1314.83333333333,111
"4370","16215","2015",2,2,0,51000,480,102
"4371","16216","2015",5,5,0,224800,1550.4,142.2
"4372","16217","2015",7,7,0,93785.7142857143,980.428571428571,98.7142857142857
"4373","16218","2015",7,7,0,140320,992.857142857143,150.714285714286
"4374","16220","2015",5,5,0,151320,1290.4,124.2
"4375","16222","2015",4,4,0,60250,808,77
"4376","16223","2015",15,15,0,117800,1186.8,104.666666666667
"4377","16224","2015",7,7,0,118054.285714286,1085.71428571429,111.142857142857
"4378","16225","2015",9,9,0,51011.1111111111,632.666666666667,82
"4379","16226","2015",11,11,0,121678.181818182,1152.63636363636,109.727272727273
"4380","16227","2015",3,3,0,228866.666666667,1764,131.333333333333
"4381","16229","2015",3,3,0,143100,1183.66666666667,118.666666666667
"4382","16230","2015",23,23,0,113828.043478261,947.304347826087,125.260869565217
"4383","16231","2015",4,4,0,71875,694,107.25
"4384","16232","2015",16,16,0,142906.25,1388.375,105
"4385","16233","2015",10,10,0,152272,1281.1,123.3
"4386","16234","2015",3,3,0,54333.3333333333,485.333333333333,117.333333333333
"4387","16236","2015",17,17,0,118605.882352941,1185,96.8235294117647
"4388","16237","2015",2,2,0,35000,617.5,53
"4389","16238","2015",4,4,0,95595,1115.75,102.75
"4390","16239","2015",1,1,0,137569,649,212
"4391","16240","2015",1,1,0,90000,1364,66
"4392","16241","2015",4,4,0,100500,1108.75,90.25
"4393","16242","2015",25,25,0,91165.8,868.88,101.36
"4394","16243","2015",10,10,0,168833.4,1403.1,120.4
"4395","16244","2015",16,16,0,106425,1236.5,84.8125
"4396","16245","2015",5,5,0,55400,814.4,73.4
"4397","16246","2015",4,4,0,182932.5,1444.25,129.75
"4398","16248","2015",1,1,0,43500,494,88
"4399","16249","2015",4,4,0,163325,1360,122.5
"4400","16250","2015",3,3,0,115000,733,147.666666666667
"4401","16251","2015",1,1,0,155000,1107,140
"4402","16253","2015",8,8,0,80703.75,985.5,92.875
"4403","16254","2015",2,2,0,79000,1016,78
"4404","16255","2015",5,5,0,88790,1048.6,87
"4405","16260","2015",3,3,0,89679.6666666667,912.666666666667,98
"4406","16261","2015",4,4,0,87037,1375.75,74
"4407","16263","2015",4,4,0,145825,1161.75,140
"4408","16264","2015",4,4,0,102402.5,1002.75,117.25
"4409","16267","2015",1,1,0,70000,654,107
"4410","16268","2015",4,4,0,190758.75,1375.5,129.75
"4411","16269","2015",7,7,0,100857.142857143,948.571428571429,104
"4412","16270","2015",7,7,0,81321.4285714286,680.857142857143,130.571428571429
"4413","16271","2015",22,22,0,187557.909090909,1614.04545454545,119.681818181818
"4414","16272","2015",9,9,0,114227.777777778,1096.55555555556,102.333333333333
"4415","16273","2015",1,1,0,55000,786,70
"4416","16275","2015",3,3,0,96000,1184.33333333333,80.3333333333333
"4417","16276","2015",5,5,0,101200,1324.4,80.4
"4418","16277","2015",7,7,0,134928.571428571,1175.57142857143,116.714285714286
"4419","16279","2015",5,5,0,110170,1067.8,111
"4420","16280","2015",24,24,0,122483.333333333,1089.29166666667,110.958333333333
"4421","16281","2015",33,31,2,93340.6060606061,1004.0303030303,94.6969696969697
"4422","16282","2015",7,7,0,90142.8571428571,949.142857142857,95.2857142857143
"4423","16283","2015",2,2,0,74210.5,594.5,121.5
"4424","16284","2015",1,1,0,174550,1098,159
"4425","16285","2015",8,8,0,127756.875,871.25,121.75
"4426","16286","2015",20,20,0,100289.3,904.1,120.55
"4427","16287","2015",39,39,0,128493.435897436,1239.76923076923,106.871794871795
"4428","16289","2015",5,5,0,126780,1195.6,97.6
"4429","16290","2015",4,4,0,66250,670.75,108.75
"4430","16291","2015",89,89,0,107108.359550562,1203.01123595506,89.0112359550562
"4431","16292","2015",50,48,2,86636.54,1073.14,81.38
"4432","16293","2015",6,6,0,77319.6666666667,957.666666666667,76.5
"4433","16295","2015",9,9,0,111116.666666667,1293.22222222222,92
"4434","16297","2015",4,4,0,136625,1125.5,97.75
"4435","16298","2015",2,2,0,61650,644.5,95
"4436","16300","2015",11,11,0,101914.090909091,998.909090909091,104.818181818182
"4437","16301","2015",3,3,0,74000,811.333333333333,98
"4438","16302","2015",4,4,0,133157.5,1029.5,138
"4439","16303","2015",4,4,0,78000,903.5,86
"4440","16304","2015",14,14,0,181287.142857143,1446.92857142857,128.142857142857
"4441","16306","2015",3,3,0,77000,660,120.666666666667
"4442","16307","2015",3,3,0,109650,1537,76.6666666666667
"4443","16308","2015",14,14,0,67892.8571428571,739.857142857143,86.9285714285714
"4444","16312","2015",9,9,0,104105.555555556,1124.11111111111,105
"4445","16315","2015",4,4,0,72500,808.5,88
"4446","16316","2015",4,4,0,78500,724.75,108.25
"4447","16317","2015",3,3,0,192666.666666667,1202.33333333333,149
"4448","16318","2015",2,2,0,132150,1264,104
"4449","16320","2015",5,5,0,69950,977,113.4
"4450","16323","2015",3,3,0,60666.6666666667,693.666666666667,86
"4451","16325","2015",1,1,0,45000,643,70
"4452","16326","2015",2,2,0,110000,1474.5,114.5
"4453","16329","2015",6,6,0,91229.6666666667,980.166666666667,90.1666666666667
"4454","16330","2015",4,4,0,79375,857.5,90.25
"4455","16331","2015",4,4,0,203250,1023.5,205.5
"4456","16334","2015",1,1,0,1e+05,935,107
"4457","16335","2015",1,1,0,116500,1239,94
"4458","16336","2015",2,2,0,55500,859.5,66.5
"4459","16337","2015",12,12,0,129208.333333333,920.083333333333,115.833333333333
"4460","16338","2015",2,2,0,194000,1238.5,147
"4461","16339","2015",2,2,0,46000,462,99
"4462","16340","2015",7,7,0,115002.428571429,1129.71428571429,100.857142857143
"4463","16341","2015",38,32,6,106281.315789474,1339.18421052632,79
"4464","16343","2015",1,1,0,362611,2554,142
"4465","16345","2015",4,4,0,70000,793.75,84.5
"4466","16346","2015",2,2,0,212290,977.5,218
"4467","16347","2015",9,9,0,134616.888888889,1551.55555555556,95.3333333333333
"4468","16348","2015",8,8,0,127787.5,1251.125,95.375
"4469","16349","2015",5,5,0,125000,1649.8,104.6
"4470","16350","2015",17,17,0,141900.941176471,1116.58823529412,125.882352941176
"4471","16352","2015",7,7,0,132270,1367.71428571429,92.1428571428571
"4472","16353","2015",11,11,0,98863.6363636364,1065.63636363636,89
"4473","16355","2015",11,11,0,120554.545454545,1165.18181818182,112
"4474","16356","2015",1,1,0,87000,696,125
"4475","16358","2015",60,60,0,158358.95,1470.68333333333,105.5
"4476","16359","2015",7,7,0,169651.428571429,1635.85714285714,120.285714285714
"4477","16360","2015",5,5,0,91930,1009.2,92.8
"4478","16361","2015",3,3,0,117057.666666667,2140.33333333333,71
"4479","16362","2015",4,4,0,78500,687,110.25
"4480","16363","2015",9,9,0,93365.4444444444,738.888888888889,116.444444444444
"4481","16364","2015",2,2,0,184500,2234.5,98.5
"4482","16365","2015",1,1,0,127000,1460,87
"4483","16366","2015",21,21,0,133283.333333333,1131.71428571429,120.142857142857
"4484","16368","2015",12,12,0,141296.333333333,1392.25,99
"4485","16369","2015",12,12,0,106334.166666667,1077.41666666667,92.25
"4486","16370","2015",14,14,0,113614.285714286,1237.64285714286,94.8571428571429
"4487","16372","2015",3,3,0,161666.666666667,1278.33333333333,107.333333333333
"4488","16373","2015",2,2,0,106000,1220.5,87.5
"4489","16374","2015",92,83,9,111883.086956522,1249.01086956522,88.9239130434783
"4490","16375","2015",6,6,0,136183.333333333,933.5,138.5
"4491","16377","2015",1,1,0,91000,867,105
"4492","16378","2015",6,6,0,126666.666666667,1092.5,118
"4493","16379","2015",16,16,0,110975,1116.25,98.25
"4494","16380","2015",3,3,0,95666.6666666667,888,113.333333333333
"4495","16381","2015",6,6,0,141833.333333333,1006.5,127.166666666667
"4496","16382","2015",4,4,0,109250,1147.25,92.25
"4497","16383","2015",13,13,0,118242.307692308,1157.53846153846,108.076923076923
"4498","16384","2015",6,6,0,98450.8333333333,858.333333333333,114
"4499","16385","2015",9,9,0,150188.888888889,1680.44444444444,88.4444444444444
"4500","16387","2015",1,1,0,126000,1340,94
"4501","16388","2015",13,13,0,137230.769230769,1245.30769230769,108.538461538462
"4502","16390","2015",2,2,0,137500,926,151
"4503","16392","2015",4,4,0,99762.5,818.5,111
"4504","16393","2015",23,23,0,109725,1102.26086956522,102.260869565217
"4505","16394","2015",1,1,0,114400,1204,95
"4506","16395","2015",1,1,0,108000,1049,103
"4507","16396","2015",2,2,0,161500,1109.5,137
"4508","16397","2015",6,6,0,98765.8333333333,1046.33333333333,99.1666666666667
"4509","16398","2015",1,1,0,35000,700,50
"4510","16399","2015",2,2,0,177170,1569.5,112.5
"4511","16400","2015",7,7,0,130101.428571429,1006.42857142857,120.285714285714
"4512","16401","2015",3,3,0,83000,1089,74.3333333333333
"4513","16402","2015",1,1,0,299000,1699,176
"4514","16403","2015",1,1,0,160400,2005,80
"4515","16404","2015",3,3,0,69000,1111.33333333333,63.3333333333333
"4516","16405","2015",1,1,0,1e+05,1250,80
"4517","16408","2015",10,10,0,143450,1409,115.3
"4518","16409","2015",9,9,0,116650,913.111111111111,128.444444444444
"4519","16412","2015",1,1,0,102000,936,109
"4520","16413","2015",5,5,0,92670,1104.6,96.8
"4521","16414","2015",3,3,0,71700,735.666666666667,94.6666666666667
"4522","16415","2015",13,13,0,131015.384615385,1194.15384615385,109.923076923077
"4523","16416","2015",6,6,0,93500,1001,97.5
"4524","16418","2015",16,16,0,127581.25,1213.9375,98.5625
"4525","16419","2015",4,4,0,68000,1148,58.25
"4526","16420","2015",1,1,0,82000,1139,72
"4527","16422","2015",10,10,0,150619.2,1195.8,124.2
"4528","16423","2015",4,4,0,99075,1110,99.75
"4529","16424","2015",8,8,0,125812.5,1137.5,121.5
"4530","16425","2015",5,5,0,95840,942.2,103.6
"4531","17002","2015",2,2,0,112790,1120,97
"4532","17003","2015",43,42,1,188084.651162791,1985.62790697674,102.186046511628
"4533","17004","2015",3,2,1,206153.333333333,4463.33333333333,50.6666666666667
"4534","17005","2015",2,2,0,99500,999,99.5
"4535","17006","2015",1,1,0,136000,1545,88
"4536","17007","2015",3,3,0,167000,1579,108
"4537","17008","2015",31,31,0,184643.290322581,1730.61290322581,110.709677419355
"4538","17009","2015",15,15,0,182333.533333333,1718.6,106.4
"4539","17010","2015",43,42,1,259983.069767442,2611.67441860465,99.8372093023256
"4540","17011","2015",2,2,0,63500,1096.5,62.5
"4541","17012","2015",1,1,0,31000,517,60
"4542","17015","2015",10,10,0,126250,1535.3,87.6
"4543","17016","2015",7,7,0,79025,1203.14285714286,72.5714285714286
"4544","17017","2015",7,7,0,117875.142857143,1224.28571428571,94.7142857142857
"4545","17018","2015",11,11,0,160460,1401.72727272727,111.727272727273
"4546","17019","2015",23,22,1,429574.217391304,4946.69565217391,89.7391304347826
"4547","17020","2015",1,1,0,210900,1935,109
"4548","17021","2015",43,41,2,162068.604651163,1852.76744186047,89.3953488372093
"4549","17022","2015",7,7,0,92600,916.428571428571,101.142857142857
"4550","17023","2015",7,7,0,140638.571428571,1118.42857142857,126.857142857143
"4551","17024","2015",7,7,0,106614.285714286,1058.71428571429,105.428571428571
"4552","17025","2015",14,14,0,153926.428571429,1067.28571428571,139.357142857143
"4553","17026","2015",2,2,0,87500,1005.5,88.5
"4554","17027","2015",2,2,0,120164,1204.5,99.5
"4555","17028","2015",142,89,53,178744.732394366,2495.97887323944,73.6267605633803
"4556","17030","2015",6,6,0,116833.333333333,1469,95.8333333333333
"4557","17031","2015",4,4,0,88875,923.75,98.25
"4558","17032","2015",3,3,0,121166.666666667,1448.66666666667,85
"4559","17033","2015",1,1,0,20000,385,52
"4560","17034","2015",6,6,0,106500,1254.5,83.5
"4561","17035","2015",2,2,0,127500,912,148
"4562","17036","2015",11,11,0,154405.454545455,1502.45454545455,104.272727272727
"4563","17037","2015",5,5,0,122000,1076.2,112.4
"4564","17038","2015",7,7,0,136857.142857143,1179.14285714286,116.428571428571
"4565","17039","2015",1,1,0,3e+05,1562,192
"4566","17041","2015",21,21,0,141950.333333333,1543.80952380952,91.7142857142857
"4567","17042","2015",4,4,0,163625,1713.5,114.75
"4568","17043","2015",10,10,0,130437.5,1195.4,106.4
"4569","17044","2015",9,9,0,165583.222222222,1468.77777777778,115.777777777778
"4570","17045","2015",7,7,0,128000,1319.57142857143,97.7142857142857
"4571","17046","2015",1,1,0,90000,776,116
"4572","17047","2015",2,2,0,203575,1275,158
"4573","17048","2015",2,2,0,1e+05,862,115
"4574","17050","2015",5,5,0,99540,646.8,145.8
"4575","17051","2015",45,45,0,557698.822222222,4841.17777777778,126.911111111111
"4576","17052","2015",9,9,0,95093.3333333333,1072.44444444444,90
"4577","17053","2015",9,9,0,142777.777777778,1606.66666666667,105
"4578","17054","2015",4,4,0,138738.25,963.75,147.75
"4579","17055","2015",2,2,0,77500,726.5,98
"4580","17056","2015",9,9,0,152573.333333333,1079.44444444444,142.888888888889
"4581","17057","2015",8,8,0,180256.25,1453.625,120.625
"4582","17058","2015",58,58,0,145902.379310345,1700.46551724138,88.9310344827586
"4583","17059","2015",10,10,0,265601,2097.7,126.4
"4584","17060","2015",5,5,0,130700,1200.2,92
"4585","17061","2015",1,1,0,145000,906,160
"4586","17062","2015",2,2,0,84000,840,103
"4587","17063","2015",3,3,0,172833.333333333,1208.33333333333,150
"4588","17064","2015",38,38,0,241877.5,2092.21052631579,112.131578947368
"4589","17065","2015",16,16,0,176055.6875,1779,97.625
"4590","17066","2015",1,1,0,108000,624,173
"4591","17068","2015",3,3,0,102950.333333333,792.333333333333,161
"4592","17069","2015",1,1,0,143100,1192,120
"4593","17070","2015",7,7,0,87181.7142857143,893,99.1428571428571
"4594","17071","2015",4,4,0,103250,1001.75,92.25
"4595","17072","2015",9,9,0,138222.222222222,1115.22222222222,124.888888888889
"4596","17073","2015",17,17,0,173753.529411765,1616.35294117647,114.529411764706
"4597","17074","2015",7,6,1,124637.142857143,1170.42857142857,114.428571428571
"4598","17075","2015",14,14,0,143358.571428571,1428.14285714286,100.857142857143
"4599","17076","2015",5,5,0,118386.8,1240.8,91.6
"4600","17077","2015",9,9,0,137633.333333333,1292.11111111111,104.333333333333
"4601","17078","2015",3,3,0,140350,1205,138.666666666667
"4602","17079","2015",18,18,0,193612.333333333,1773.5,109.444444444444
"4603","17080","2015",9,9,0,137722.222222222,1271.88888888889,111.777777777778
"4604","17081","2015",3,3,0,98500,876.666666666667,107.333333333333
"4605","17082","2015",2,2,0,66000,584.5,111
"4606","17083","2015",8,8,0,120854.125,1150,103.125
"4607","17084","2015",10,10,0,109800,1093.4,105.6
"4608","17085","2015",1,1,0,133000,1547,86
"4609","17086","2015",28,28,0,135273.928571429,1305.60714285714,104.464285714286
"4610","17087","2015",1,1,0,88000,595,148
"4611","17089","2015",3,3,0,159950,1339.33333333333,135.666666666667
"4612","17091","2015",21,21,0,146972.476190476,1446.14285714286,102.333333333333
"4613","17093","2015",59,55,4,180798.813559322,2300.67796610169,81.1186440677966
"4614","17094","2015",133,88,45,225025.436090226,3506.48872180451,68.5488721804511
"4615","17095","2015",2,2,0,64500,699.5,82
"4616","17096","2015",2,2,0,155000,1699,110.5
"4617","17097","2015",15,15,0,155053.333333333,1662.13333333333,95.7333333333333
"4618","17098","2015",10,10,0,161040,1450.2,107.6
"4619","17099","2015",8,8,0,115437.5,1139.5,103.75
"4620","17100","2015",13,13,0,145368.461538462,1393.69230769231,110.307692307692
"4621","17101","2015",5,5,0,82211,882,99.2
"4622","17102","2015",15,15,0,179573.333333333,1527.46666666667,122.8
"4623","17104","2015",7,7,0,87000,991.714285714286,86.1428571428571
"4624","17105","2015",7,7,0,105214.285714286,1030.14285714286,98.7142857142857
"4625","17106","2015",4,4,0,102250,862.25,120.5
"4626","17107","2015",20,19,1,138548.2,1472.75,95.15
"4627","17108","2015",1,1,0,115000,1855,62
"4628","17109","2015",19,18,1,187288.421052632,2231.57894736842,87.6315789473684
"4629","17110","2015",9,9,0,101374.444444444,1075.55555555556,104.444444444444
"4630","17111","2015",7,7,0,136500,1677.14285714286,83.4285714285714
"4631","17112","2015",4,4,0,121500,1204.5,108.25
"4632","17113","2015",4,4,0,120000,1138,100.25
"4633","17114","2015",1,1,0,152000,1476,103
"4634","17115","2015",6,6,0,114000,1194.83333333333,99.3333333333333
"4635","17117","2015",2,2,0,59000,477.5,124.5
"4636","17119","2015",12,12,0,168658.333333333,1590.75,108.916666666667
"4637","17120","2015",21,20,1,131932.619047619,1448.14285714286,92.4285714285714
"4638","17121","2015",46,41,5,378708.673913043,4622.80434782609,86.3478260869565
"4639","17122","2015",5,5,0,193106,1285.8,164.4
"4640","17124","2015",3,3,0,82333.3333333333,673.333333333333,122.333333333333
"4641","17125","2015",4,4,0,123250,1098,112.25
"4642","17126","2015",2,2,0,118000,1276.5,90.5
"4643","17127","2015",22,22,0,162744.454545455,1397.95454545455,115.363636363636
"4644","17128","2015",7,7,0,207283,1479.28571428571,140.857142857143
"4645","17129","2015",4,4,0,102943.75,1044,103
"4646","17130","2015",4,4,0,102750,981.75,108.75
"4647","17131","2015",17,17,0,149490.352941176,1576.58823529412,100.764705882353
"4648","17132","2015",7,7,0,136628.571428571,1156,116.857142857143
"4649","17133","2015",8,8,0,88625,1007.25,89.75
"4650","17134","2015",5,5,0,138400,1478.8,97.4
"4651","17135","2015",2,2,0,89520,654.5,125
"4652","17136","2015",12,12,0,187530.166666667,1849.66666666667,100.666666666667
"4653","17137","2015",1,1,0,137850,1532,90
"4654","17138","2015",2,2,0,56500,858.5,72
"4655","17139","2015",2,2,0,99250,949,99.5
"4656","17140","2015",75,67,8,171426.053333333,2850.41333333333,66.1733333333333
"4657","17141","2015",3,3,0,98333.3333333333,831.333333333333,130
"4658","17142","2015",62,56,6,226943.370967742,2225.09677419355,101.161290322581
"4659","17143","2015",3,0,3,87750,1060,83
"4660","17145","2015",3,3,0,164333.333333333,1289.33333333333,120
"4661","17146","2015",32,26,6,128682.9375,1698.84375,79.78125
"4662","17147","2015",8,8,0,138750,1222.625,135.125
"4663","17148","2015",1,1,0,96000,1215,79
"4664","17149","2015",1,1,0,42500,773,55
"4665","17150","2015",3,3,0,151000,998.666666666667,146.333333333333
"4666","17151","2015",15,15,0,156573.333333333,1565.86666666667,101.066666666667
"4667","17152","2015",4,4,0,179700,1315,130.5
"4668","17153","2015",32,32,0,206043.84375,2054.96875,99.71875
"4669","17154","2015",5,5,0,187746.2,1353.6,140.8
"4670","17155","2015",24,24,0,181257.916666667,1528.91666666667,118
"4671","17156","2015",2,2,0,246350,879.5,285.5
"4672","17157","2015",3,3,0,56333.3333333333,1530.66666666667,61
"4673","17158","2015",20,20,0,167620.35,1596.1,109
"4674","17159","2015",6,6,0,103716.666666667,838,123
"4675","17160","2015",10,10,0,120911.6,1127.9,106.9
"4676","17161","2015",57,50,7,452050.350877193,4784.64912280702,90.6140350877193
"4677","17163","2015",1,1,0,155000,1449,107
"4678","17164","2015",26,26,0,165719.615384615,1517.84615384615,111.269230769231
"4679","17165","2015",6,6,0,121633.333333333,1194.5,105.333333333333
"4680","17166","2015",14,14,0,149250,1499.42857142857,100.928571428571
"4681","17167","2015",11,11,0,96545.4545454545,886.090909090909,108.090909090909
"4682","17168","2015",92,81,11,211621.260869565,2754.40217391304,80.5434782608696
"4683","17171","2015",7,7,0,161142.857142857,1564.85714285714,104.285714285714
"4684","17172","2015",44,43,1,145726.886363636,1389.63636363636,111.795454545455
"4685","17173","2015",3,2,1,116098.333333333,1844.33333333333,71.3333333333333
"4686","17174","2015",8,8,0,116212.5,1168.875,106.125
"4687","17175","2015",8,8,0,171834.25,1313.5,121.625
"4688","17176","2015",2,2,0,216200,2015,131.5
"4689","17177","2015",1,1,0,144000,4114,35
"4690","17178","2015",1,1,0,35000,778,45
"4691","17179","2015",12,12,0,168134.916666667,1481.58333333333,119.166666666667
"4692","17180","2015",1,1,0,79000,658,120
"4693","17181","2015",6,6,0,131358.333333333,1150.16666666667,117.666666666667
"4694","17182","2015",6,6,0,118375,977.5,125
"4695","17183","2015",13,13,0,137534.615384615,1497.07692307692,90.5384615384615
"4696","17184","2015",12,12,0,159640.583333333,1352.75,114.083333333333
"4697","17185","2015",33,33,0,156448.606060606,1895.54545454545,92.2727272727273
"4698","17186","2015",8,8,0,201625,1820.5,124.75
"4699","17187","2015",5,5,0,101040,1026.2,96.6
"4700","17188","2015",7,7,0,136881.571428571,1117,119.714285714286
"4701","17190","2015",26,25,1,255663.692307692,2522.15384615385,100.576923076923
"4702","17191","2015",4,4,0,127625,1209.25,101.75
"4703","17192","2015",12,12,0,160125,1319.08333333333,131.416666666667
"4704","17193","2015",26,26,0,225486.538461538,2111.03846153846,111.423076923077
"4705","17194","2015",31,31,0,192581.741935484,1964.41935483871,100.129032258065
"4706","17195","2015",5,5,0,109730,837,130.2
"4707","17196","2015",3,3,0,116440,877.666666666667,138
"4708","17197","2015",43,35,8,113793.023255814,1288.53488372093,97.1395348837209
"4709","17198","2015",5,5,0,110200,1475,77.2
"4710","17200","2015",86,68,18,244783.604651163,2560.51162790698,96.4767441860465
"4711","17201","2015",5,5,0,188340,1509.6,119.4
"4712","17202","2015",1,1,0,70000,972,72
"4713","17203","2015",13,13,0,171573.076923077,1342.38461538462,120
"4714","17204","2015",1,1,0,40000,1111,36
"4715","17205","2015",4,4,0,170337.5,1789,95.5
"4716","17206","2015",4,4,0,89250,722.75,122
"4717","17207","2015",22,21,1,455165.454545455,4545.63636363636,98.5909090909091
"4718","17208","2015",8,8,0,163137.5,1767,108.125
"4719","17210","2015",5,5,0,124400,1130.6,97.2
"4720","17211","2015",5,5,0,103600,975.6,99.6
"4721","17212","2015",3,3,0,125000,1162.33333333333,113
"4722","17213","2015",1,1,0,62000,539,115
"4723","17214","2015",3,3,0,159566.666666667,1482,111
"4724","17216","2015",9,9,0,137733.333333333,1375.22222222222,101
"4725","17217","2015",3,3,0,51566.6666666667,1167,63.3333333333333
"4726","17218","2015",47,44,3,125592.340425532,1534.44680851064,84.3829787234042
"4727","17219","2015",77,74,3,147425.194805195,1799.85714285714,85.3246753246753
"4728","17220","2015",4,4,0,147600,1381.5,107.75
"4729","17221","2015",10,10,0,130450,1076.5,130.4
"4730","17222","2015",39,39,0,287580.051282051,2547.30769230769,113.589743589744
"4731","17224","2015",20,18,2,94265,1015.3,93.85
"4732","17225","2015",101,88,13,190471.247524752,3371.23762376238,63.029702970297
"4733","17226","2015",7,7,0,95357.1428571429,900.428571428571,111.142857142857
"4734","17228","2015",24,22,2,167512.916666667,2037.70833333333,83.875
"4735","17229","2015",2,2,0,67500,605,115
"4736","17230","2015",101,82,19,184658.742574257,2494.58415841584,80.1881188118812
"4737","17231","2015",1,1,0,50000,714,70
"4738","17232","2015",12,11,1,202366.666666667,1692.91666666667,117
"4739","17233","2015",2,2,0,138500,1557,94.5
"4740","17234","2015",2,2,0,1e+05,1253,86
"4741","17235","2015",4,4,0,118750,1041.25,112.25
"4742","17236","2015",15,14,1,74666.6666666667,865.466666666667,103.4
"4743","17237","2015",4,4,0,148250,1499.25,109
"4744","17239","2015",2,2,0,195500,1034,187
"4745","17240","2015",32,30,2,98633.75,1001,96.78125
"4746","17241","2015",8,8,0,104500,1223.75,88.25
"4747","17242","2015",6,6,0,85782.1666666667,1089,84.1666666666667
"4748","17243","2015",10,10,0,89585.8,999.8,88.3
"4749","17244","2015",7,7,0,72428.5714285714,1126.57142857143,62.7142857142857
"4750","17245","2015",10,10,0,179650,1886.3,96.4
"4751","17246","2015",1,1,0,140000,1944,72
"4752","17247","2015",11,11,0,186231.818181818,1950.63636363636,95.1818181818182
"4753","17248","2015",19,19,0,172037.368421053,1438.42105263158,109.684210526316
"4754","17249","2015",2,2,0,52000,916.5,64
"4755","17250","2015",7,7,0,122457.142857143,1071.42857142857,116.428571428571
"4756","17252","2015",2,2,0,88550,1376.5,75.5
"4757","17253","2015",8,8,0,116625,1492,75.625
"4758","17254","2015",3,3,0,123000,1205.66666666667,102.666666666667
"4759","17255","2015",9,9,0,151051.111111111,1477.66666666667,105.777777777778
"4760","17256","2015",3,3,0,182333.333333333,1177.33333333333,161.333333333333
"4761","17257","2015",7,7,0,99785.7142857143,900,115.714285714286
"4762","17258","2015",2,2,0,208652.5,1517,137
"4763","17259","2015",1,1,0,124500,1132,110
"4764","17260","2015",1,1,0,94000,1119,84
"4765","17261","2015",4,4,0,97687.5,828.75,128.25
"4766","17262","2015",10,10,0,131600,1387.6,93.8
"4767","17263","2015",6,6,0,155666.666666667,1135.66666666667,134.666666666667
"4768","17264","2015",86,81,5,226630.465116279,2364.26744186047,97.4069767441861
"4769","17265","2015",16,16,0,183410.625,1782.8125,104.1875
"4770","17266","2015",8,8,0,92125,1003.125,97.375
"4771","17267","2015",12,10,2,186459.5,1654.08333333333,110.75
"4772","17268","2015",2,2,0,92000,758.5,123.5
"4773","17269","2015",5,5,0,183400,1301.2,130.6
"4774","17270","2015",17,17,0,46735.2941176471,1117.76470588235,43.8235294117647
"4775","17271","2015",1,1,0,144000,1500,96
"4776","17273","2015",7,7,0,204342.857142857,1235.14285714286,158.857142857143
"4777","17274","2015",104,86,18,267265.711538462,2615.94230769231,105.625
"4778","17275","2015",6,6,0,155450,1548.66666666667,97.1666666666667
"4779","17276","2015",1,1,0,123000,961,128
"4780","17277","2015",11,11,0,107542,832.727272727273,122.363636363636
"4781","17278","2015",5,4,1,134023,1317.4,103
"4782","17279","2015",12,12,0,129137.5,1367.08333333333,97.3333333333333
"4783","17280","2015",3,3,0,128333.333333333,840,152.666666666667
"4784","17281","2015",2,2,0,107500,1248.5,87.5
"4785","17282","2015",2,2,0,135500,976,145.5
"4786","17283","2015",33,31,2,127373.484848485,1157.60606060606,118.424242424242
"4787","17284","2015",24,23,1,153610.416666667,1566.29166666667,105.083333333333
"4788","17285","2015",12,12,0,167750,1366.91666666667,125.833333333333
"4789","17286","2015",31,31,0,663821.935483871,5827.74193548387,109.322580645161
"4790","17287","2015",2,2,0,116152,1385.5,84
"4791","17288","2015",1,1,0,151000,1049,144
"4792","17289","2015",3,3,0,219866.666666667,1285,152
"4793","17290","2015",2,2,0,75500,1073,70
"4794","17291","2015",61,49,12,243627.737704918,2346.70491803279,104.213114754098
"4795","17292","2015",7,7,0,108142.857142857,1250.42857142857,87
"4796","17293","2015",4,4,0,148062.25,1215.5,121.75
"4797","17294","2015",3,3,0,86666.6666666667,989.333333333333,80
"4798","17295","2015",1,1,0,120000,1000,120
"4799","17296","2015",14,14,0,154913.571428571,1408.14285714286,111.357142857143
"4800","17297","2015",44,41,3,393788.227272727,4377.18181818182,89.9772727272727
"4801","17298","2015",4,4,0,225738.75,1577.25,156.25
"4802","17299","2015",407,197,210,112412.523341523,1612.18673218673,72.1179361179361
"4803","17300","2015",1267,432,835,191447.089976322,3165.93528018942,63.3725335438043
"4804","17301","2015",2,2,0,90000,1093.5,82
"4805","17302","2015",7,7,0,136542,1448.57142857143,97.2857142857143
"4806","17303","2015",18,18,0,110277.777777778,1334.66666666667,87.6666666666667
"4807","17304","2015",4,4,0,106075,823.25,125.25
"4808","17305","2015",2,2,0,75000,958,90
"4809","17306","2015",554,236,318,192016.086642599,2746.95306859206,72.4314079422383
"4810","17308","2015",32,32,0,164437.5,1629.53125,102.4375
"4811","17309","2015",15,15,0,91346.6666666667,921.733333333333,102.8
"4812","17310","2015",20,20,0,131534,1365.8,99.85
"4813","17311","2015",16,16,0,139219.375,2250.1875,69.4375
"4814","17312","2015",6,6,0,82541.6666666667,887.5,93.6666666666667
"4815","17313","2015",7,7,0,131757.142857143,1369.42857142857,99.2857142857143
"4816","17314","2015",11,11,0,105318.181818182,1297.63636363636,81.3636363636364
"4817","17315","2015",1,1,0,250000,1497,167
"4818","17316","2015",4,4,0,160855.75,1169,141.75
"4819","17317","2015",10,10,0,139159.1,1145.7,121.5
"4820","17318","2015",28,28,0,378074.642857143,4017.85714285714,94.7857142857143
"4821","17319","2015",1,1,0,61000,1130,54
"4822","17320","2015",5,5,0,175600,2081,92.2
"4823","17321","2015",2,2,0,95800,989,109.5
"4824","17322","2015",10,10,0,132925,1381.5,98.3
"4825","17323","2015",45,45,0,188408.555555556,2787.88888888889,68.3333333333333
"4826","17324","2015",1,1,0,110410,1227,90
"4827","17325","2015",10,10,0,184927.5,1149.1,140.4
"4828","17326","2015",2,2,0,81712.5,1149,76
"4829","17327","2015",3,3,0,2e+05,1393.33333333333,143.666666666667
"4830","17328","2015",18,18,0,126682.222222222,1193.44444444444,103.666666666667
"4831","17329","2015",5,5,0,139940,1711.4,80.8
"4832","17330","2015",12,12,0,135250,1427,102.916666666667
"4833","17331","2015",4,4,0,190025,1429.25,133.75
"4834","17332","2015",1,1,0,120000,719,167
"4835","17333","2015",208,131,77,193235.158653846,3157.23076923077,64.6153846153846
"4836","17334","2015",1,1,0,40000,833,48
"4837","17335","2015",4,4,0,112128.75,902.25,127.25
"4838","17336","2015",30,30,0,168334.4,1552.26666666667,108.6
"4839","17337","2015",125,119,6,176801.096,2798.456,67.016
"4840","17338","2015",17,16,1,117352.941176471,1139.64705882353,99.0588235294118
"4841","17339","2015",12,12,0,158658.333333333,1331.25,131.25
"4842","17340","2015",12,12,0,128400,1104.66666666667,109
"4843","17341","2015",2,2,0,192040,1349.5,139.5
"4844","17342","2015",4,4,0,73125,1297.5,54.5
"4845","17344","2015",15,15,0,123706.066666667,1229.93333333333,96.1333333333333
"4846","17345","2015",2,2,0,135500,1097.5,125.5
"4847","17346","2015",14,14,0,158142.857142857,1471.71428571429,107.071428571429
"4848","17347","2015",82,78,4,116558.817073171,1165.21951219512,104.463414634146
"4849","17348","2015",4,4,0,146000,1415.25,103.5
"4850","17349","2015",31,31,0,157273.677419355,1577.58064516129,105.967741935484
"4851","17350","2015",3,3,0,140833.333333333,1393.66666666667,98.3333333333333
"4852","17351","2015",17,17,0,154111.764705882,1661.58823529412,102.647058823529
"4853","17353","2015",28,28,0,216351.357142857,2284.07142857143,96.3571428571429
"4854","17354","2015",3,3,0,114333.333333333,1363.33333333333,85.6666666666667
"4855","17355","2015",1,1,0,52000,525,99
"4856","17356","2015",3,3,0,133666.666666667,1201.33333333333,111.666666666667
"4857","17357","2015",2,2,0,174320,1070,163
"4858","17358","2015",1,1,0,35000,547,64
"4859","17359","2015",9,9,0,117244.444444444,1021.55555555556,106.555555555556
"4860","17360","2015",48,47,1,466152.083333333,4844.75,103.8125
"4861","17362","2015",1,1,0,140000,940,149
"4862","17363","2015",4,4,0,168250,1343.25,122.25
"4863","17364","2015",1,1,0,133000,1108,120
"4864","17365","2015",6,6,0,117916.666666667,1102.16666666667,108.833333333333
"4865","17366","2015",3,3,0,114666.666666667,928.666666666667,131
"4866","17367","2015",1,1,0,71000,780,91
"4867","17369","2015",47,27,20,399738.595744681,5199.65957446809,76.3829787234042
"4868","17374","2015",2,2,0,128100,1372.5,93
"4869","17375","2015",19,19,0,136555.263157895,1532.10526315789,89.4736842105263
"4870","17376","2015",19,19,0,179770.263157895,2052.73684210526,90.9473684210526
"4871","17378","2015",1,1,0,89470,1065,84
"4872","17379","2015",4,4,0,199117,1475.75,135.25
"4873","17380","2015",148,98,50,220212.168918919,3312.72297297297,71.8513513513514
"4874","17381","2015",2,2,0,77500,766.5,90.5
"4875","17382","2015",8,8,0,106623,991,110.125
"4876","17383","2015",3,3,0,114966.666666667,826.666666666667,139.333333333333
"4877","17384","2015",4,4,0,98750,1038,94.75
"4878","17385","2015",123,120,3,181363.227642276,2658.9918699187,72.7886178861789
"4879","17386","2015",2,2,0,66750,663,101
"4880","17387","2015",15,15,0,140058,1299.66666666667,108.933333333333
"4881","17388","2015",5,5,0,116800,1005.2,127
"4882","17389","2015",4,4,0,151000,1487.75,108.25
"4883","17390","2015",2,2,0,111950,702.5,159.5
"4884","17391","2015",12,12,0,269387.5,2582.41666666667,105.916666666667
"4885","17393","2015",20,20,0,162182.25,1524.4,104.7
"4886","17394","2015",7,7,0,115100,914,125
"4887","17395","2015",7,7,0,146100,1382.14285714286,107.571428571429
"4888","17396","2015",11,11,0,179954.545454545,1582.27272727273,121
"4889","17397","2015",28,27,1,113966.642857143,1264.14285714286,96.6071428571429
"4890","17398","2015",2,2,0,155915,1413,112
"4891","17400","2015",6,6,0,169283.333333333,1353.83333333333,133
"4892","17401","2015",2,2,0,112000,1202.5,97
"4893","17403","2015",2,2,0,184600,1658,112
"4894","17404","2015",7,7,0,147321.428571429,1297,113.285714285714
"4895","17405","2015",2,2,0,129365,1056.5,139.5
"4896","17406","2015",3,3,0,99650,1693.66666666667,89.3333333333333
"4897","17407","2015",30,30,0,213255.833333333,1957.06666666667,109.433333333333
"4898","17408","2015",5,5,0,138756,1501.6,94.6
"4899","17409","2015",33,33,0,222992.757575758,2256.54545454545,103.212121212121
"4900","17410","2015",13,13,0,157391,1348.69230769231,117.461538461538
"4901","17411","2015",24,21,3,176711.333333333,2604.54166666667,69.1666666666667
"4902","17412","2015",2,2,0,196000,1284,159.5
"4903","17413","2015",11,10,1,222752.727272727,2258,99.4545454545455
"4904","17414","2015",55,55,0,225993.381818182,2274.21818181818,101.781818181818
"4905","17415","2015",358,296,62,144035.240223464,1606.08100558659,91.0754189944134
"4906","17416","2015",1,1,0,160000,1839,87
"4907","17418","2015",7,7,0,140464.285714286,1151,130.428571428571
"4908","17420","2015",26,25,1,232255,2165,105.269230769231
"4909","17421","2015",129,111,18,158410.829457364,1855.14728682171,90.2713178294574
"4910","17423","2015",1,1,0,135000,1688,80
"4911","17424","2015",4,4,0,162000,1617,105.25
"4912","17425","2015",31,31,0,175378.387096774,1915.09677419355,95.1612903225806
"4913","17426","2015",3,3,0,95000,904.666666666667,111
"4914","17427","2015",4,4,0,105250,573.25,171.25
"4915","17428","2015",2,2,0,102500,728,142
"4916","17429","2015",30,30,0,166531.5,1923.56666666667,94.4333333333333
"4917","17430","2015",3,3,0,113000,864.333333333333,133.666666666667
"4918","17431","2015",8,8,0,148224.125,1556.375,97.875
"4919","17432","2015",7,7,0,130971.428571429,1248.42857142857,102.857142857143
"4920","17434","2015",74,71,3,136014.148648649,1411.12162162162,100.5
"4921","17435","2015",2,2,0,142500,1283.5,114
"4922","17436","2015",10,10,0,142954,1176.6,124.3
"4923","17437","2015",3,3,0,233738.666666667,4977.33333333333,49.3333333333333
"4924","17438","2015",3,3,0,138000,1562.33333333333,89
"4925","17439","2015",15,15,0,103014,1166.06666666667,92.9333333333333
"4926","17440","2015",1,1,0,104000,1072,97
"4927","17441","2015",8,8,0,158637.5,1543.25,110
"4928","17442","2015",1,1,0,145000,1526,95
"4929","17443","2015",23,23,0,182382.47826087,1876.13043478261,100.347826086957
"4930","17444","2015",14,14,0,145721.428571429,1470.14285714286,102.928571428571
"4931","17445","2015",4,4,0,145350,1339.5,115.25
"4932","17446","2015",2,2,0,125000,864,133
"4933","17447","2015",17,17,0,166780.117647059,1523.88235294118,112.823529411765
"4934","17448","2015",11,9,2,132904,1249.63636363636,110.454545454545
"4935","17449","2015",79,65,14,118115.924050633,1364.88607594937,88.4683544303797
"4936","17450","2015",3,3,0,122950,1189.66666666667,102
"4937","17451","2015",5,5,0,83800,1076.6,79
"4938","17452","2015",111,106,5,199069.171171171,2394.58558558559,88.054054054054
"4939","17453","2015",17,17,0,171211.764705882,1509.23529411765,117.705882352941
"4940","17454","2015",4,4,0,117500,980.25,120.25
"4941","17455","2015",6,6,0,114983.333333333,1143.66666666667,95.6666666666667
"4942","17457","2015",19,19,0,134131.578947368,1479.84210526316,97.4736842105263
"4943","17458","2015",4,4,0,118750,788.75,147
"4944","17459","2015",2,2,0,95000,1488.5,71.5
"4945","17460","2015",8,8,0,94687.5,1016.5,93.5
"4946","17461","2015",155,88,67,227895.4,3409.58709677419,67.0645161290323
"4947","17462","2015",6,6,0,103491.333333333,942.166666666667,111.333333333333
"4948","17463","2015",12,12,0,168620.833333333,1580.16666666667,108.166666666667
"4949","17464","2015",1,1,0,1e+05,617,162
"4950","17465","2015",7,7,0,110142.857142857,862.428571428571,113.714285714286
"4951","17466","2015",24,24,0,178586.625,1704.5,116.041666666667
"4952","17468","2015",1,1,0,1e+05,1000,100
"4953","17469","2015",6,6,0,189416.666666667,1291.66666666667,151.333333333333
"4954","17470","2015",4,4,0,95500,1098.25,85
"4955","17471","2015",2,2,0,143375,785.5,154
"4956","17472","2015",39,39,0,184900.641025641,1949.71794871795,97.3846153846154
"4957","17474","2015",5,5,0,158920,1009.4,159.8
"4958","17476","2015",2,2,0,128050,1111.5,99
"4959","17477","2015",5,5,0,91274,855,106.6
"4960","17478","2015",2,2,0,38450,440,87.5
"4961","17479","2015",3,3,0,137333.333333333,1040,126
"4962","17480","2015",10,10,0,162500,1616,105.9
"4963","17482","2015",4,4,0,128675,1067.5,109.75
"4964","17483","2015",20,20,0,159031,1880.45,86.95
"4965","17484","2015",33,32,1,135133.333333333,1695.21212121212,79.1818181818182
"4966","17485","2015",26,25,1,221929.615384615,3209,76.6923076923077
"4967","17486","2015",21,21,0,233260.476190476,3070.80952380952,82.4761904761905
"4968","18001","2015",5,5,0,79000,1083.6,76
"4969","18002","2015",3,3,0,70000,862,98.6666666666667
"4970","18003","2015",15,15,0,89124.4666666667,1248.26666666667,75.9333333333333
"4971","18004","2015",13,13,0,163115.384615385,1286,129.923076923077
"4972","18005","2015",6,6,0,109916.666666667,1022.33333333333,100.666666666667
"4973","18006","2015",3,3,0,134833.333333333,1594,84.6666666666667
"4974","18008","2015",6,6,0,126000,1269,98.3333333333333
"4975","18009","2015",1,1,0,64000,831,77
"4976","18010","2015",2,2,0,70500,846,84
"4977","18011","2015",16,16,0,115893.0625,1192.5625,99.75
"4978","18012","2015",5,5,0,68300,722,94.6
"4979","18013","2015",1,1,0,30000,612,49
"4980","18014","2015",3,3,0,69000,1073,68.6666666666667
"4981","18015","2015",52,51,1,117195.384615385,1275.09615384615,94.9038461538462
"4982","18016","2015",2,2,0,41000,592.5,75
"4983","18017","2015",2,2,0,90000,850.5,108
"4984","18018","2015",23,23,0,110465.869565217,1373.60869565217,85.6086956521739
"4985","18019","2015",2,2,0,92500,1292,69
"4986","18020","2015",12,12,0,101333.333333333,1085.58333333333,88.5833333333333
"4987","18021","2015",3,3,0,81000,956,85.3333333333333
"4988","18022","2015",5,5,0,72500,597.6,133
"4989","18023","2015",15,15,0,104253.333333333,1125.6,88.4666666666667
"4990","18024","2015",1,1,0,175000,670,261
"4991","18025","2015",7,7,0,67857.1428571429,707.571428571429,94.5714285714286
"4992","18026","2015",7,7,0,99857.1428571429,1045.85714285714,95.8571428571429
"4993","18027","2015",4,4,0,88000,1021,95.25
"4994","18028","2015",7,7,0,141228.571428571,1467.14285714286,97.1428571428571
"4995","18029","2015",2,2,0,169000,1274,112
"4996","18030","2015",11,11,0,92636.3636363636,1099.54545454545,84.6363636363636
"4997","18031","2015",3,3,0,124000,1229.33333333333,117.666666666667
"4998","18032","2015",16,16,0,98750,1211.125,83.4375
"4999","18033","2015",748,405,343,115059.39973262,1454.98128342246,79.1483957219251
"5000","18034","2015",1,1,0,130000,1429,91
"5001","18035","2015",10,10,0,110210,1307.1,82.6
"5002","18036","2015",3,3,0,117833.333333333,811.666666666667,153
"5003","18037","2015",3,3,0,356333.333333333,1811.33333333333,142.666666666667
"5004","18039","2015",3,3,0,146666.666666667,1560,109
"5005","18040","2015",2,2,0,69000,686,100.5
"5006","18041","2015",5,5,0,139215.4,2036.6,70.2
"5007","18042","2015",5,5,0,84276,1064.4,73.4
"5008","18043","2015",2,2,0,45848.5,1022.5,47
"5009","18044","2015",6,6,0,88000,1090.33333333333,80.6666666666667
"5010","18045","2015",3,3,0,90833.3333333333,665.333333333333,134
"5011","18046","2015",2,2,0,83500,893.5,78
"5012","18047","2015",4,4,0,95500,1009.25,91.75
"5013","18048","2015",4,4,0,100203.25,866.75,110.25
"5014","18049","2015",4,4,0,38250,531.5,81
"5015","18050","2015",26,26,0,125038.461538462,1479.96153846154,87.4230769230769
"5016","18052","2015",10,10,0,95150,902.2,114.8
"5017","18053","2015",3,3,0,78666.6666666667,1133.66666666667,67.3333333333333
"5018","18054","2015",2,2,0,67500,839,70
"5019","18055","2015",9,9,0,53485,928.444444444444,65.1111111111111
"5020","18056","2015",4,4,0,77250,812.75,94.75
"5021","18057","2015",16,16,0,71562.5,903.4375,84.375
"5022","18058","2015",10,10,0,97585,1087.7,93.6
"5023","18059","2015",6,6,0,74433.3333333333,756.833333333333,98
"5024","18060","2015",1,1,0,165000,1542,107
"5025","18062","2015",4,4,0,99750,1156.75,87.5
"5026","18063","2015",2,2,0,90154,766.5,106.5
"5027","18064","2015",1,1,0,160000,1798,89
"5028","18065","2015",5,5,0,67400,820.2,81.2
"5029","18066","2015",8,7,1,77975,1131.125,77.375
"5030","18067","2015",7,7,0,145742.857142857,1610.28571428571,94.4285714285714
"5031","18068","2015",1,1,0,60000,1500,40
"5032","18069","2015",6,6,0,83683.3333333333,949.666666666667,90.5
"5033","18073","2015",2,2,0,125750,1460.5,88
"5034","18074","2015",1,1,0,78500,924,85
"5035","18075","2015",11,11,0,96909.0909090909,1100.81818181818,85.8181818181818
"5036","18076","2015",3,3,0,133333.333333333,1122,100
"5037","18077","2015",3,3,0,61000,745,81.6666666666667
"5038","18079","2015",5,5,0,118894,1106.6,98.8
"5039","18080","2015",2,2,0,83500,731,115
"5040","18081","2015",3,3,0,101066.666666667,968,104
"5041","18082","2015",7,7,0,77314.2857142857,914.571428571429,84.7142857142857
"5042","18083","2015",6,6,0,130833.333333333,1012.83333333333,119
"5043","18084","2015",3,3,0,108000,931.333333333333,109.666666666667
"5044","18085","2015",2,2,0,134500,1393,102.5
"5045","18086","2015",6,6,0,99166.6666666667,1103.66666666667,82.8333333333333
"5046","18087","2015",41,41,0,96711.3902439024,1003.43902439024,93.8292682926829
"5047","18088","2015",2,2,0,60000,495.5,121.5
"5048","18089","2015",8,8,0,62662.5,953.25,69.625
"5049","18090","2015",4,4,0,319632.75,3509.5,91
"5050","18091","2015",3,3,0,54666.6666666667,804.666666666667,67.6666666666667
"5051","18092","2015",12,11,1,125875,1363.58333333333,100.583333333333
"5052","18093","2015",2,2,0,50750,1134,49.5
"5053","18094","2015",5,5,0,100510,874.8,116.8
"5054","18095","2015",3,3,0,89333.3333333333,797,111.333333333333
"5055","18096","2015",19,19,0,97782.0526315789,1105.15789473684,85.2105263157895
"5056","18097","2015",20,19,1,132058,1327.95,101.2
"5057","18098","2015",2,2,0,100800,1006,99.5
"5058","18099","2015",2,2,0,46500,1119,46
"5059","18100","2015",5,5,0,71486,905.6,81.4
"5060","18101","2015",3,3,0,82166.6666666667,685,111
"5061","18102","2015",5,5,0,52000,659.2,87
"5062","18103","2015",26,26,0,84173.0769230769,844.269230769231,96.8076923076923
"5063","18104","2015",1,1,0,57500,429,134
"5064","18105","2015",2,2,0,117000,1184.5,96
"5065","18106","2015",2,2,0,96000,1923.5,62.5
"5066","18107","2015",1,1,0,70000,1373,51
"5067","18108","2015",40,40,0,97623.925,980.975,97.925
"5068","18109","2015",16,15,1,78093.75,950.75,85.4375
"5069","18110","2015",17,17,0,79558.8235294118,824.176470588235,93.9411764705882
"5070","18112","2015",2,2,0,131500,1878.5,70
"5071","18114","2015",2,2,0,117500,1034.5,112
"5072","18115","2015",13,13,0,95153.8461538462,924.846153846154,95.8461538461538
"5073","18116","2015",1,1,0,170000,1417,120
"5074","18117","2015",3,3,0,120066.666666667,1261.66666666667,103
"5075","18118","2015",24,23,1,95452.0833333333,967.708333333333,104.708333333333
"5076","18119","2015",3,3,0,116500,1080,128
"5077","18120","2015",6,6,0,102833.333333333,1165.16666666667,91.6666666666667
"5078","18121","2015",1,1,0,130000,1083,120
"5079","18122","2015",1,1,0,45000,918,49
"5080","18124","2015",2,2,0,76000,1087,63.5
"5081","18125","2015",17,17,0,96435.2941176471,1036.88235294118,94.6470588235294
"5082","18126","2015",9,9,0,131972,1530.66666666667,87.7777777777778
"5083","18127","2015",12,12,0,71500,921.916666666667,72.6666666666667
"5084","18128","2015",3,3,0,136166.666666667,1076.66666666667,121.333333333333
"5085","18129","2015",1,1,0,153000,1443,106
"5086","18130","2015",1,1,0,66500,482,138
"5087","18133","2015",14,14,0,80871.4285714286,1060.5,74.5714285714286
"5088","18134","2015",5,5,0,71000,882.2,77.2
"5089","18135","2015",4,4,0,66625,791.25,87.25
"5090","18136","2015",5,5,0,78979.6,673.2,126
"5091","18137","2015",5,5,0,44000,686.6,65.6
"5092","18138","2015",29,29,0,145740.172413793,1400.55172413793,106.758620689655
"5093","18139","2015",9,9,0,95077.7777777778,1248.22222222222,84.5555555555556
"5094","18140","2015",12,11,1,163391.666666667,1864.58333333333,98.25
"5095","18141","2015",68,67,1,112512.044117647,1242.88235294118,90.1029411764706
"5096","18142","2015",7,7,0,169021.428571429,1266.14285714286,146.571428571429
"5097","18143","2015",8,7,1,69937.5,749.5,89.375
"5098","18144","2015",2,2,0,93375,1319,68
"5099","18145","2015",14,14,0,103662.142857143,1071.35714285714,93.5714285714286
"5100","18146","2015",8,8,0,49387.5,784.875,66
"5101","18147","2015",5,5,0,75686,952.6,92
"5102","18148","2015",22,22,0,125003.181818182,1219.72727272727,102.363636363636
"5103","18149","2015",8,8,0,211000,2056.625,89.625
"5104","18150","2015",8,8,0,121733.75,1106.125,119.5
"5105","18151","2015",6,5,1,63750,829.833333333333,80.8333333333333
"5106","18152","2015",2,2,0,102500,1019.5,106
"5107","18153","2015",3,3,0,131666.666666667,959,133.333333333333
"5108","18154","2015",6,6,0,71166.6666666667,808.166666666667,89.1666666666667
"5109","18155","2015",3,3,0,84666.6666666667,917,91.6666666666667
"5110","18156","2015",7,7,0,78171.4285714286,1065.42857142857,71.4285714285714
"5111","18157","2015",11,11,0,148509.090909091,1557.45454545455,96.4545454545455
"5112","18158","2015",6,6,0,170953.333333333,1541,109.5
"5113","18159","2015",7,7,0,186628.571428571,1665.85714285714,113.857142857143
"5114","18160","2015",21,20,1,128988.095238095,1082.38095238095,104.619047619048
"5115","18161","2015",4,4,0,54900,898.25,62.5
"5116","18162","2015",3,3,0,67666.6666666667,833.666666666667,75.3333333333333
"5117","18163","2015",2,2,0,81500,1386.5,68.5
"5118","18164","2015",1,1,0,82000,745,110
"5119","18165","2015",18,18,0,93073.3888888889,1091.88888888889,89
"5120","18167","2015",2,2,0,125000,1385.5,90.5
"5121","18168","2015",6,6,0,71483.3333333333,1208.16666666667,75.3333333333333
"5122","18169","2015",1,1,0,75000,1042,72
"5123","18170","2015",1,1,0,72260,938,77
"5124","18171","2015",1,1,0,60000,1071,56
"5125","18172","2015",17,17,0,89990,984.941176470588,93.1176470588235
"5126","18173","2015",3,3,0,86000,1294.66666666667,78
"5127","18174","2015",1,1,0,315800,1410,224
"5128","18175","2015",7,7,0,78142.8571428571,944.142857142857,79.1428571428571
"5129","18176","2015",3,3,0,31950.6666666667,669,48.3333333333333
"5130","18177","2015",1,1,0,1e+05,787,127
"5131","18178","2015",3,3,0,50666.6666666667,689,63
"5132","18179","2015",11,11,0,154151.818181818,1320.09090909091,118.363636363636
"5133","18180","2015",22,22,0,160497,1574.5,102.318181818182
"5134","18181","2015",3,3,0,148000,1369,107
"5135","18182","2015",4,4,0,56750,686,77.25
"5136","18183","2015",1,1,0,130000,1140,114
"5137","18184","2015",2,2,0,127000,1056,121
"5138","18185","2015",1,1,0,51440,635,81
"5139","18186","2015",2,2,0,77000,864,96
"5140","18187","2015",11,11,0,57168.1818181818,730.818181818182,76.1818181818182
"5141","18189","2015",10,10,0,150020,1200.4,120
"5142","18190","2015",2,2,0,121000,1156,98
"5143","18192","2015",3,3,0,83000,988.333333333333,81.3333333333333
"5144","18193","2015",1,1,0,55000,458,120
"5145","18194","2015",5,5,0,74204,1042.4,76.2
"5146","18195","2015",5,5,0,65000,679.6,90.4
"5147","18196","2015",1,1,0,69000,1113,62
"5148","18197","2015",88,79,9,89158.9772727273,1165.42045454545,81.5568181818182
"5149","18198","2015",7,7,0,104500,785.428571428571,125.285714285714
"5150","18199","2015",1,1,0,50000,568,88
"5151","18200","2015",4,4,0,55375,571.5,94
"5152","18201","2015",5,5,0,135000,1787,81
"5153","18203","2015",3,3,0,36433.3333333333,678,53.3333333333333
"5154","18204","2015",1,1,0,120000,1062,113
"5155","18205","2015",86,84,2,146519.976744186,1517.20930232558,97.8837209302326
"5156","18206","2015",12,12,0,136996,1414.91666666667,99.6666666666667
"5157","18207","2015",59,53,6,91987.1186440678,1184.08474576271,79.4745762711864
"5158","18208","2015",7,7,0,121578.857142857,1051.14285714286,116.142857142857
"5159","18209","2015",6,6,0,101091.666666667,1092,95.5
"5160","18210","2015",6,6,0,77121.8333333333,921.5,84.1666666666667
"5161","18211","2015",12,12,0,124391.666666667,1296.41666666667,108.916666666667
"5162","18212","2015",5,5,0,75000,1166.2,78.8
"5163","18213","2015",38,37,1,124454.210526316,1393.73684210526,89.2105263157895
"5164","18214","2015",4,4,0,109000,1232.25,88.5
"5165","18216","2015",4,4,0,73002.5,739,103.75
"5166","18218","2015",4,4,0,99125,918.25,109.75
"5167","18219","2015",2,2,0,124950,1486.5,94
"5168","18220","2015",8,8,0,56625,837.25,74
"5169","18221","2015",3,3,0,60333.3333333333,684.333333333333,85.6666666666667
"5170","18223","2015",23,22,1,125913.043478261,1351,104.565217391304
"5171","18224","2015",3,3,0,76333.3333333333,994.333333333333,74.6666666666667
"5172","18225","2015",3,3,0,124000,1724.66666666667,74
"5173","18226","2015",3,3,0,183800,1932.33333333333,92.3333333333333
"5174","18227","2015",2,2,0,467442.5,4062.5,134.5
"5175","18228","2015",5,5,0,88100,967.2,93.6
"5176","18229","2015",3,3,0,142000,1251.33333333333,117.333333333333
"5177","18230","2015",2,2,0,118000,2054.5,62
"5178","18231","2015",11,11,0,121181.818181818,1109.81818181818,111.272727272727
"5179","18232","2015",1,1,0,67500,964,70
"5180","18233","2015",16,16,0,90714.75,1086,79.5
"5181","18234","2015",5,5,0,51263.6,1074.2,65.6
"5182","18235","2015",12,12,0,123245.416666667,1355.16666666667,91
"5183","18236","2015",1,1,0,50000,1220,41
"5184","18237","2015",1,1,0,158500,1441,110
"5185","18238","2015",3,3,0,116000,1002,110
"5186","18240","2015",7,7,0,66142.8571428571,803.571428571429,82.1428571428571
"5187","18241","2015",23,23,0,132894.782608696,1322.95652173913,93.5652173913043
"5188","18242","2015",37,36,1,66771.6216216216,881.378378378378,78.5405405405405
"5189","18243","2015",6,6,0,145416.666666667,1844,85.1666666666667
"5190","18244","2015",1,1,0,57800,980,59
"5191","18245","2015",4,4,0,65000,804.5,76.5
"5192","18246","2015",16,16,0,77081.25,933.0625,83.4375
"5193","18247","2015",11,11,0,132554.545454545,1303.63636363636,99.3636363636364
"5194","18248","2015",5,5,0,128260,1135.6,114.8
"5195","18249","2015",8,8,0,99750,1012.625,102.375
"5196","18250","2015",2,2,0,306150,2161.5,147
"5197","18251","2015",2,2,0,67500,775,75.5
"5198","18252","2015",3,3,0,118500,1066,121.666666666667
"5199","18253","2015",5,5,0,131280,1283.2,98.6
"5200","18254","2015",9,9,0,138733.333333333,1264.88888888889,108.333333333333
"5201","18255","2015",11,11,0,163238.909090909,1365.90909090909,118.272727272727
"5202","18256","2015",2,2,0,86500,1219,70.5
"5203","18257","2015",11,11,0,112496.545454545,1140.63636363636,95.1818181818182
"5204","18258","2015",8,8,0,96241.625,1078.25,95.75
"5205","18259","2015",4,4,0,90175,750.75,115
"5206","18260","2015",1,1,0,157000,1208,130
"5207","18261","2015",5,5,0,88240,753.6,116.2
"5208","18262","2015",3,3,0,79500,1166.33333333333,69.3333333333333
"5209","18263","2015",8,8,0,108242.25,1410.5,74.625
"5210","18264","2015",2,2,0,76250,1231,63
"5211","18265","2015",4,4,0,85975,928.5,88.5
"5212","18266","2015",1,1,0,150000,1364,110
"5213","18267","2015",38,38,0,156018.815789474,1475.21052631579,106.552631578947
"5214","18268","2015",7,7,0,66711.4285714286,729.428571428571,90.5714285714286
"5215","18269","2015",5,5,0,89300,832.8,133.6
"5216","18270","2015",5,5,0,73412.8,770.8,87
"5217","18271","2015",10,10,0,143963,1381.5,107.1
"5218","18272","2015",8,8,0,118750,1103.5,110.625
"5219","18273","2015",9,9,0,85111.1111111111,973,87.1111111111111
"5220","18274","2015",1,1,0,120000,1212,99
"5221","18275","2015",4,4,0,78125,772.25,104.75
"5222","18278","2015",5,5,0,76300,884,87.8
"5223","18279","2015",259,224,35,78111.2548262548,1018.69111969112,78.6911196911197
"5224","18280","2015",4,4,0,104456.5,1385.25,81.25
"5225","18281","2015",12,12,0,109916.666666667,1159,95.6666666666667
"5226","18282","2015",7,7,0,108785.714285714,1078.14285714286,97.5714285714286
"5227","18283","2015",1,1,0,28000,509,55
"5228","18284","2015",1,1,0,78000,1026,76
"5229","18285","2015",4,4,0,140750,1458.5,98.25
"5230","18286","2015",4,4,0,49475,699.25,69.25
"5231","18287","2015",3,3,0,82380,758.333333333333,107
"5232","18288","2015",1,1,0,110000,1078,102
"5233","18289","2015",7,7,0,93685.7142857143,933.857142857143,101.285714285714
"5234","18290","2015",4,4,0,129250,1281.75,101.75
"5235","19002","2015",2,2,0,113950,1196.5,104.5
"5236","19004","2015",5,5,0,128700,1200.8,112
"5237","19005","2015",39,35,4,119800.384615385,1191.4358974359,98.8974358974359
"5238","19007","2015",14,14,0,96481.5,1198.28571428571,83.5
"5239","19008","2015",3,3,0,120500,1170.66666666667,102.666666666667
"5240","19010","2015",41,35,6,109036.243902439,1154.14634146341,97.0731707317073
"5241","19011","2015",7,4,3,71028.5714285714,834.571428571429,90.1428571428571
"5242","19012","2015",2,2,0,87500,1359,63
"5243","19013","2015",8,8,0,162453,1403.875,117.75
"5244","19014","2015",6,6,0,115041.666666667,1266.33333333333,87.1666666666667
"5245","19015","2015",11,11,0,144900,1539.54545454545,93.7272727272727
"5246","19016","2015",8,8,0,106091.25,1043.75,127.375
"5247","19018","2015",2,2,0,89750,1252,72.5
"5248","19019","2015",11,11,0,98245.4545454545,1122.18181818182,90.2727272727273
"5249","19020","2015",3,3,0,85166.6666666667,698,127
"5250","19021","2015",1,1,0,182000,1071,170
"5251","19022","2015",3,3,0,91500,1123,76.6666666666667
"5252","19023","2015",9,9,0,162172.222222222,1653.77777777778,101.444444444444
"5253","19024","2015",1,1,0,48000,800,60
"5254","19025","2015",1,1,0,152000,1101,138
"5255","19026","2015",3,3,0,80333.3333333333,1162,73.6666666666667
"5256","19027","2015",4,4,0,73925,561.75,134
"5257","19029","2015",6,6,0,122833.333333333,1493.66666666667,82.5
"5258","19030","2015",7,7,0,108857.142857143,1140.71428571429,93.8571428571429
"5259","19031","2015",574,302,272,118277.68989547,1501.27526132404,80.1602787456446
"5260","19033","2015",8,8,0,101556.25,1035.5,110.75
"5261","19035","2015",6,6,0,91741.6666666667,941.666666666667,86.5
"5262","19036","2015",18,18,0,75861.1111111111,835.166666666667,94.5555555555556
"5263","19037","2015",16,16,0,82318.75,1009.75,82.3125
"5264","19038","2015",5,5,0,117400,1100.4,110.6
"5265","19039","2015",2,2,0,82500,868.5,94.5
"5266","19041","2015",2,2,0,107250,975,110
"5267","19042","2015",5,5,0,93400,1000.8,100.2
"5268","19043","2015",6,6,0,165176.666666667,1468,105.166666666667
"5269","19044","2015",1,1,0,97000,1212,80
"5270","19045","2015",2,2,0,102500,1342.5,72
"5271","19047","2015",4,4,0,175250,2614.75,80.75
"5272","19048","2015",1,1,0,85000,752,113
"5273","19049","2015",12,12,0,150308.333333333,1436,102.833333333333
"5274","19050","2015",3,3,0,148793.333333333,1691.66666666667,92
"5275","19051","2015",3,2,1,72666.6666666667,933.666666666667,89.6666666666667
"5276","19053","2015",1,1,0,85000,850,100
"5277","19054","2015",1,1,0,190000,1397,136
"5278","19055","2015",1,1,0,65000,855,76
"5279","19056","2015",7,7,0,102785.714285714,1213,83.8571428571429
"5280","19057","2015",1,1,0,275000,2052,134
"5281","19058","2015",5,5,0,61400,944.8,62.8
"5282","19059","2015",3,3,0,59333.3333333333,679.666666666667,93.6666666666667
"5283","19060","2015",5,5,0,114000,1205.6,110.4
"5284","19061","2015",9,9,0,161652.777777778,1544.66666666667,108.222222222222
"5285","19062","2015",13,11,2,86484.6153846154,1060.15384615385,87.4615384615385
"5286","19063","2015",27,24,3,177981.481481481,2132.07407407407,106.222222222222
"5287","19064","2015",1,1,0,43000,538,80
"5288","19066","2015",13,13,0,115520,1274.30769230769,91.8461538461538
"5289","19067","2015",3,3,0,105463.333333333,1553,64.3333333333333
"5290","19068","2015",4,4,0,260700,1944.25,147.25
"5291","19070","2015",2,2,0,55850,930.5,60
"5292","19072","2015",26,26,0,116038.461538462,1231.69230769231,94.3076923076923
"5293","19073","2015",23,18,5,78956.7826086956,1025.30434782609,78.1304347826087
"5294","19075","2015",4,4,0,79735.75,1129.25,69.75
"5295","19076","2015",1,1,0,50000,331,151
"5296","19077","2015",2,2,0,212500,1866,110.5
"5297","19078","2015",3,3,0,129833.333333333,1217.33333333333,110
"5298","19079","2015",2,2,0,61750,1219,51.5
"5299","19080","2015",4,4,0,134612.5,1297.75,126.5
"5300","19081","2015",3,3,0,82800,1099.33333333333,76.6666666666667
"5301","19082","2015",7,7,0,151462.857142857,1361.42857142857,108.285714285714
"5302","19083","2015",1,1,0,80000,1143,70
"5303","19084","2015",1,1,0,168000,2400,70
"5304","19085","2015",5,5,0,160600,1568.6,101
"5305","19087","2015",1,1,0,60000,750,80
"5306","19089","2015",4,4,0,85900,1442.5,65.75
"5307","19093","2015",3,3,0,164516.666666667,1786,92
"5308","19094","2015",10,10,0,90650,1087.1,104.7
"5309","19096","2015",1,1,0,121500,980,124
"5310","19097","2015",4,4,0,64950,752.75,82.75
"5311","19098","2015",7,7,0,91500,1195.14285714286,75.7142857142857
"5312","19099","2015",2,2,0,108000,1063.5,91
"5313","19100","2015",17,17,0,83678.2352941177,873.588235294118,101.647058823529
"5314","19101","2015",12,12,0,108089.583333333,1172.08333333333,91.0833333333333
"5315","19102","2015",1,1,0,90000,1023,88
"5316","19103","2015",1,1,0,37886,758,50
"5317","19105","2015",5,5,0,147290,1855.6,95
"5318","19106","2015",2,2,0,114518,972,121
"5319","19107","2015",19,16,3,136713.157894737,1537.94736842105,90.8947368421053
"5320","19108","2015",1,1,0,58500,532,110
"5321","19109","2015",3,3,0,178900,2029,103
"5322","19110","2015",5,5,0,84500,896.4,104.8
"5323","19111","2015",2,2,0,76000,1555,53.5
"5324","19112","2015",2,2,0,107500,883,121.5
"5325","19113","2015",8,8,0,89693.75,1291.5,85.875
"5326","19115","2015",2,2,0,280100,1827.5,155.5
"5327","19116","2015",4,4,0,110000,1273,94
"5328","19117","2015",8,8,0,140400,1356.25,87.875
"5329","19119","2015",1,1,0,116960,1218,96
"5330","19120","2015",2,2,0,76600,1104,69
"5331","19121","2015",26,26,0,122561.538461538,1125.96153846154,110.076923076923
"5332","19123","2015",70,63,7,139142.828571429,1451.74285714286,97.2285714285714
"5333","19124","2015",7,7,0,119531.428571429,1595.71428571429,83.5714285714286
"5334","19125","2015",16,15,1,93841.9375,1271.8125,73.75
"5335","19126","2015",3,3,0,133333.333333333,1476.33333333333,83
"5336","19128","2015",1,1,0,65000,1444,45
"5337","19129","2015",11,11,0,87575.7272727273,964,96.8181818181818
"5338","19131","2015",4,4,0,76250,978.5,75.25
"5339","19132","2015",4,4,0,195281.25,1227.75,185.25
"5340","19134","2015",4,4,0,64000,1038.75,65.5
"5341","19135","2015",1,1,0,110000,1310,84
"5342","19136","2015",15,15,0,86366.6666666667,960.866666666667,88.0666666666667
"5343","19138","2015",10,10,0,140864,1730.7,89.2
"5344","19140","2015",2,1,1,118500,1195,103.5
"5345","19143","2015",7,7,0,68214.2857142857,864.714285714286,77
"5346","19144","2015",1,1,0,38000,679,56
"5347","19145","2015",1,1,0,83000,1169,71
"5348","19146","2015",11,11,0,135448.181818182,1341.72727272727,100.454545454545
"5349","19147","2015",3,3,0,203250,2279.33333333333,93.3333333333333
"5350","19148","2015",11,11,0,70147.2727272727,877.181818181818,82
"5351","19149","2015",3,3,0,206611.666666667,1541.33333333333,117
"5352","19150","2015",3,3,0,157333.333333333,2643.66666666667,75.6666666666667
"5353","19151","2015",4,4,0,157875,1792,88
"5354","19152","2015",4,4,0,129400,1179.25,109
"5355","19153","2015",31,24,7,106943.548387097,1455.09677419355,81.9032258064516
"5356","19154","2015",4,4,0,64375,855.5,84
"5357","19155","2015",1,1,0,146500,1495,98
"5358","19158","2015",5,5,0,55400,1090.2,49.8
"5359","19159","2015",1,1,0,175000,1042,168
"5360","19160","2015",5,5,0,56840,658.2,98
"5361","19161","2015",4,4,0,97875,943.25,107
"5362","19162","2015",13,13,0,137038.461538462,1255.69230769231,109.384615384615
"5363","19163","2015",5,5,0,89800,956.6,95.8
"5364","19164","2015",8,8,0,75125,835.5,96.625
"5365","19166","2015",1,1,0,81000,1588,51
"5366","19167","2015",1,1,0,165000,2115,78
"5367","19169","2015",4,4,0,107500,1646.5,70.75
"5368","19170","2015",2,2,0,67750,1169.5,62.5
"5369","19175","2015",2,2,0,81250,550,147.5
"5370","19176","2015",6,6,0,112533.333333333,1192,109.5
"5371","19177","2015",2,2,0,124000,1967.5,77
"5372","19178","2015",4,4,0,113250,923,112
"5373","19180","2015",5,4,1,111388,1123.4,106.2
"5374","19181","2015",6,6,0,84585,1099.16666666667,76.3333333333333
"5375","19182","2015",7,7,0,147502.142857143,1333.14285714286,116.142857142857
"5376","19186","2015",1,1,0,145000,1648,88
"5377","19187","2015",3,3,0,92333.3333333333,1014,91.6666666666667
"5378","19188","2015",3,3,0,106500,1554.33333333333,68.6666666666667
"5379","19190","2015",3,3,0,69833.3333333333,904.666666666667,70
"5380","19191","2015",7,7,0,183312.857142857,1632.85714285714,112.714285714286
"5381","19192","2015",6,5,1,111466.666666667,1378.83333333333,86.5
"5382","19194","2015",10,10,0,149972.3,1224.4,120.2
"5383","19195","2015",3,3,0,164106.666666667,1344.66666666667,123
"5384","19196","2015",2,2,0,138025,1696,75
"5385","19199","2015",4,4,0,100950,1024.5,93.5
"5386","19200","2015",1,1,0,99000,990,100
"5387","19201","2015",2,2,0,128575,1497,85.5
"5388","19202","2015",12,12,0,139583.333333333,1235.58333333333,114.833333333333
"5389","19203","2015",9,9,0,72022.2222222222,940.888888888889,73.1111111111111
"5390","19204","2015",1,1,0,40000,1667,24
"5391","19207","2015",13,12,1,123183.769230769,1088,116.153846153846
"5392","19208","2015",3,3,0,97166.6666666667,1336.33333333333,76
"5393","19211","2015",11,11,0,119240.909090909,1151.90909090909,104.545454545455
"5394","19212","2015",1,1,0,302000,2288,132
"5395","19213","2015",6,6,0,70466.6666666667,842.166666666667,83.1666666666667
"5396","19216","2015",3,3,0,114333.333333333,1148.33333333333,108.666666666667
"5397","19217","2015",1,1,0,97000,1617,60
"5398","19220","2015",7,7,0,117000,1346.71428571429,89.8571428571429
"5399","19222","2015",3,3,0,88000,1185.66666666667,72.3333333333333
"5400","19223","2015",4,4,0,91380,793.75,119.75
"5401","19225","2015",4,4,0,62000,873.25,78
"5402","19226","2015",3,3,0,84666.6666666667,1216.66666666667,65.6666666666667
"5403","19227","2015",11,11,0,148441.181818182,1337,112.363636363636
"5404","19229","2015",50,42,8,148421,1816.14,89.06
"5405","19230","2015",2,2,0,93750,843,96.5
"5406","19231","2015",1,1,0,24000,1200,20
"5407","19232","2015",1,1,0,17000,680,25
"5408","19233","2015",1,1,0,150000,1579,95
"5409","19234","2015",3,3,0,172528.333333333,1820,98
"5410","19235","2015",3,3,0,91666.6666666667,1182.66666666667,74
"5411","19236","2015",4,4,0,127750,929.25,149.25
"5412","19237","2015",10,10,0,121840,1298.4,98
"5413","19238","2015",1,1,0,160000,1455,110
"5414","19239","2015",2,2,0,47000,552.5,94
"5415","19240","2015",6,6,0,75255,895.166666666667,82.5
"5416","19241","2015",1,1,0,145000,986,147
"5417","19242","2015",4,4,0,80000,769,111.25
"5418","19243","2015",9,8,1,100544.444444444,1219.11111111111,84.7777777777778
"5419","19245","2015",1,1,0,62000,775,80
"5420","19246","2015",12,12,0,162170.833333333,1480.33333333333,112.75
"5421","19247","2015",1,1,0,48500,808,60
"5422","19248","2015",7,7,0,135085.714285714,1593.57142857143,95.7142857142857
"5423","19249","2015",2,2,0,38000,603.5,65
"5424","19250","2015",9,9,0,103300,946.111111111111,111.888888888889
"5425","19251","2015",4,4,0,103937.5,904.25,112.75
"5426","19252","2015",8,8,0,92562.5,1170,75.875
"5427","19253","2015",1,1,0,50000,833,60
"5428","19254","2015",9,9,0,108277.777777778,991.555555555556,114
"5429","19255","2015",16,16,0,97546.875,1178.8125,85.25
"5430","19256","2015",2,2,0,109900,1037,125
"5431","19260","2015",1,1,0,66000,1179,56
"5432","19261","2015",7,7,0,95214.2857142857,996.857142857143,98
"5433","19263","2015",2,2,0,166000,1176.5,142.5
"5434","19264","2015",3,3,0,75000,1044.66666666667,72.6666666666667
"5435","19265","2015",3,3,0,88666.6666666667,1125.33333333333,81.3333333333333
"5436","19269","2015",13,13,0,95606.6923076923,990.230769230769,95.7692307692308
"5437","19270","2015",9,9,0,66222.2222222222,998.333333333333,69.4444444444444
"5438","19271","2015",3,3,0,149666.666666667,2244.33333333333,64.3333333333333
"5439","19272","2015",146,63,83,78441.5547945205,979.13698630137,80.9246575342466
"5440","19273","2015",8,8,0,138037.5,1327.375,102.125
"5441","19274","2015",26,26,0,185647.307692308,1671.73076923077,110.769230769231
"5442","19275","2015",58,50,8,101558.448275862,1135.31034482759,88
"5443","19276","2015",23,23,0,82195.652173913,880,96.0869565217391
"5444","19278","2015",16,16,0,163339.75,1473.5625,114.0625
"5445","19279","2015",8,7,1,142351.5,1989,99.25
"5446","19280","2015",3,3,0,136333.333333333,1252.66666666667,117.666666666667
"5447","19285","2015",9,9,0,82283.3333333333,1018.55555555556,81.8888888888889
"5448","19286","2015",7,7,0,111008.571428571,1445.14285714286,80.7142857142857
"5449","19287","2015",2,2,0,62750,1081,70
"5450","19288","2015",13,12,1,95744.3846153846,1080.84615384615,89.3076923076923
"5451","19289","2015",2,2,0,194450,1777,109
"5452","21001","2015",1,1,0,164000,1072,153
"5453","21002","2015",1,1,0,113450,1773,64
"5454","21003","2015",13,8,5,251061.538461538,2176,113.538461538462
"5455","21004","2015",2,1,1,62500,788,89
"5456","21005","2015",13,12,1,264545.384615385,2627.07692307692,99.1538461538462
"5457","21007","2015",1,1,0,50000,526,95
"5458","21008","2015",7,7,0,114914.285714286,1381.28571428571,80.7142857142857
"5459","21009","2015",4,4,0,43250,596.75,73
"5460","21010","2015",3,3,0,158333.333333333,1419.33333333333,109
"5461","21011","2015",1,1,0,55000,561,98
"5462","21012","2015",2,2,0,107500,1202.5,89.5
"5463","21013","2015",4,4,0,127800,1817.5,74
"5464","21016","2015",8,7,1,214237.5,2059.75,108.25
"5465","21017","2015",6,6,0,167500,1707.5,100.333333333333
"5466","21018","2015",1,1,0,82000,456,180
"5467","21021","2015",16,14,2,220245.3125,1970.5,113.25
"5468","21022","2015",4,4,0,151175,1824.25,86.25
"5469","21023","2015",9,7,2,85230.8888888889,1194.33333333333,77.8888888888889
"5470","21024","2015",1,1,0,60000,1154,52
"5471","21025","2015",1,1,0,75000,1316,57
"5472","21026","2015",1,1,0,165000,1684,98
"5473","21027","2015",12,10,2,310544.166666667,2199.41666666667,136.916666666667
"5474","21028","2015",6,6,0,145317.5,1629,95.5
"5475","21030","2015",1,1,0,146000,1281,114
"5476","21031","2015",10,10,0,166376,1830.5,96
"5477","21032","2015",3,3,0,90000,1184,76.3333333333333
"5478","21033","2015",4,4,0,118051.5,1035.25,112
"5479","21034","2015",1,1,0,184000,825,223
"5480","21035","2015",7,7,0,130000,1417.71428571429,95.2857142857143
"5481","21036","2015",1,1,0,88000,822,107
"5482","21037","2015",2,2,0,196560,1576.5,122.5
"5483","21038","2015",60,38,22,132457.666666667,1423.96666666667,95.7666666666667
"5484","21040","2015",1,1,0,75000,1014,74
"5485","21041","2015",1,1,0,186500,1469,127
"5486","21042","2015",1,1,0,150000,1471,102
"5487","21043","2015",2,2,0,58750,557,106
"5488","21044","2015",5,5,0,62036,1013.6,76
"5489","21045","2015",3,3,0,74670,1270.66666666667,62
"5490","21046","2015",3,3,0,52333.3333333333,679.666666666667,78
"5491","21048","2015",9,9,0,213280,1947.66666666667,111.222222222222
"5492","21049","2015",1,1,0,420000,9130,46
"5493","21053","2015",3,3,0,104333.333333333,1265.33333333333,80
"5494","21054","2015",264,101,163,167734.401515152,2048.56818181818,81.8257575757576
"5495","21056","2015",8,8,0,165875,1658.125,103.375
"5496","21057","2015",6,6,0,169875,1569.83333333333,107.666666666667
"5497","21059","2015",2,2,0,323750,2355.5,137.5
"5498","21061","2015",1,1,0,43000,538,80
"5499","21062","2015",2,2,0,79800,724.5,106
"5500","21063","2015",1,1,0,60260,1004,60
"5501","21066","2015",1,1,0,152000,792,192
"5502","21067","2015",7,7,0,185348.571428571,2060,90.2857142857143
"5503","21068","2015",1,1,0,26000,578,45
"5504","21069","2015",2,2,0,50000,771,74
"5505","21070","2015",5,5,0,100815.2,1017.2,101.2
"5506","21071","2015",7,7,0,186014.285714286,1554.28571428571,122.285714285714
"5507","21072","2015",1,1,0,176900,1685,105
"5508","21074","2015",3,3,0,145666.666666667,1396,103
"5509","21075","2015",2,2,0,65000,754,90.5
"5510","21076","2015",9,9,0,169100,2372.77777777778,78.7777777777778
"5511","21077","2015",1,1,0,142850,1587,90
"5512","21078","2015",2,2,0,41495,1006.5,49.5
"5513","21080","2015",6,6,0,107195.833333333,1058.83333333333,103
"5514","21081","2015",2,2,0,203750,2609.5,78.5
"5515","21083","2015",1,1,0,77500,467,166
"5516","21086","2015",6,6,0,183125,2035.5,97.3333333333333
"5517","21087","2015",10,10,0,97530,1330,69.2
"5518","21088","2015",2,2,0,193000,1664.5,117
"5519","21089","2015",4,4,0,138875,1124.75,122
"5520","21092","2015",2,2,0,145500,1301,112.5
"5521","21093","2015",2,2,0,103500,834.5,124
"5522","21094","2015",3,3,0,90333.3333333333,1103.33333333333,83
"5523","21096","2015",1,1,0,112000,896,125
"5524","21098","2015",2,2,0,82500,713,129.5
"5525","21099","2015",6,6,0,120166.666666667,1317.5,92.3333333333333
"5526","21100","2015",1,1,0,111000,653,170
"5527","21101","2015",3,3,0,152333.333333333,1138.33333333333,116.333333333333
"5528","21102","2015",2,2,0,125300,896,109.5
"5529","21103","2015",18,18,0,157672.222222222,1585.61111111111,105
"5530","21105","2015",11,11,0,218310,1941.36363636364,114.545454545455
"5531","21106","2015",8,8,0,225893.75,2026.875,117.875
"5532","21107","2015",5,5,0,247570,2046.6,124
"5533","21108","2015",1,1,0,85000,833,102
"5534","21109","2015",1,1,0,80000,398,201
"5535","21110","2015",6,6,0,199216.666666667,2305.5,87.5
"5536","21111","2015",3,3,0,144366.666666667,1476.66666666667,106
"5537","21112","2015",5,5,0,150700,1582.2,93.2
"5538","21113","2015",3,3,0,183333.333333333,2034.33333333333,90
"5539","21114","2015",2,1,1,149795,2197,70.5
"5540","21115","2015",8,8,0,142770.625,1370.625,99.375
"5541","21119","2015",1,1,0,80000,825,97
"5542","21120","2015",4,4,0,105000,1385.5,80.5
"5543","21121","2015",1,1,0,45000,938,48
"5544","21122","2015",3,3,0,54000,966,57
"5545","21124","2015",4,4,0,84356.25,907.5,90.25
"5546","21125","2015",2,2,0,64500,550,131.5
"5547","21126","2015",8,8,0,190787.5,1597.125,115
"5548","21127","2015",2,2,0,186250,1272.5,155.5
"5549","21128","2015",3,3,0,102866.666666667,812,138.666666666667
"5550","21129","2015",1,1,0,280000,1167,240
"5551","21130","2015",3,3,0,162333.333333333,1931.66666666667,84.6666666666667
"5552","21131","2015",5,5,0,119590,1291.4,102.2
"5553","21132","2015",4,4,0,194075,1681.25,132.5
"5554","21133","2015",2,1,1,63730,1338,48.5
"5555","21134","2015",2,2,0,138000,892.5,157.5
"5556","21135","2015",1,1,0,148000,1423,104
"5557","21136","2015",2,2,0,52500,660,79.5
"5558","21137","2015",1,1,0,180000,1364,132
"5559","21138","2015",11,11,0,140940.909090909,1520.72727272727,97.9090909090909
"5560","21139","2015",5,5,0,91400,1110.4,90
"5561","21140","2015",2,2,0,82000,1357,57
"5562","21141","2015",2,2,0,38500,743,54.5
"5563","21142","2015",3,3,0,77666.6666666667,1024.33333333333,74.6666666666667
"5564","21148","2015",2,2,0,102500,1526.5,66
"5565","21149","2015",2,2,0,35000,465.5,75.5
"5566","21150","2015",2,2,0,127500,1450.5,95.5
"5567","21152","2015",3,3,0,144000,1660,93.6666666666667
"5568","21153","2015",2,2,0,67150,1029.5,76
"5569","21154","2015",59,34,25,89801.2372881356,988.949152542373,89.4576271186441
"5570","21155","2015",1,1,0,44080,408,108
"5571","21158","2015",2,2,0,86500,747,125
"5572","21160","2015",1,1,0,40000,976,41
"5573","21162","2015",5,5,0,105320,1480.8,66.4
"5574","21164","2015",2,2,0,128500,1150,125.5
"5575","21166","2015",137,48,89,135412.335766423,1718.98540145985,80.3722627737226
"5576","21167","2015",2,2,0,152750,1520,100.5
"5577","21169","2015",3,3,0,185966.666666667,1214.66666666667,154.333333333333
"5578","21170","2015",4,4,0,154000,1768.25,88.5
"5579","21171","2015",95,25,70,157543.884210526,1872.78947368421,83.6631578947368
"5580","21172","2015",4,4,0,202500,1208.25,151.25
"5581","21173","2015",8,8,0,202440,2060.25,100.375
"5582","21175","2015",4,4,0,145750,1601.25,91.5
"5583","21176","2015",2,2,0,164198.5,1409,116.5
"5584","21177","2015",3,3,0,84100,1304.33333333333,86.6666666666667
"5585","21178","2015",1,1,0,160000,2000,80
"5586","21179","2015",9,9,0,238388.888888889,2202.11111111111,110.666666666667
"5587","21180","2015",4,4,0,132750,1299.25,104.5
"5588","21181","2015",1,1,0,150000,1579,95
"5589","21182","2015",1,1,0,160000,2286,70
"5590","21183","2015",6,6,0,176333.333333333,1918.66666666667,92.3333333333333
"5591","21184","2015",1,1,0,342000,2012,170
"5592","21185","2015",4,4,0,245200,2064.75,121.75
"5593","21186","2015",6,6,0,121900,1209.16666666667,97.6666666666667
"5594","21189","2015",3,3,0,193566.666666667,1370.33333333333,148
"5595","21190","2015",4,4,0,199350,1890.5,111.5
"5596","21191","2015",7,6,1,196464.285714286,1834.28571428571,112.285714285714
"5597","21192","2015",10,10,0,272475,2393,122.6
"5598","21193","2015",6,6,0,180000,1698.33333333333,109.333333333333
"5599","21194","2015",5,5,0,124200,1665.6,73.8
"5600","21195","2015",5,5,0,125466,1339.4,88.8
"5601","21196","2015",10,10,0,144467.3,1509,98.9
"5602","21198","2015",2,2,0,135000,1986,67.5
"5603","21199","2015",1,1,0,149000,1656,90
"5604","21200","2015",13,12,1,182846.153846154,1796.53846153846,98.3846153846154
"5605","21201","2015",1,1,0,47000,810,58
"5606","21202","2015",2,2,0,425000,2965,139.5
"5607","21203","2015",2,2,0,95000,1088,83
"5608","21204","2015",3,3,0,78950,1293.33333333333,62.6666666666667
"5609","21207","2015",2,2,0,104850,737,144
"5610","21208","2015",4,4,0,116376.25,1306.5,92.75
"5611","21209","2015",28,26,2,248255.75,2465.17857142857,107.678571428571
"5612","21210","2015",5,5,0,1e+05,1425.8,75.4
"5613","21211","2015",2,2,0,110000,1178.5,93
"5614","21212","2015",3,3,0,119800,1032.33333333333,114.333333333333
"5615","21214","2015",1,1,0,65000,793,82
"5616","21215","2015",3,3,0,110389,1111.33333333333,100.666666666667
"5617","21216","2015",2,2,0,37500,903,39
"5618","21217","2015",1,1,0,186300,1620,115
"5619","21218","2015",1,1,0,195000,1639,119
"5620","21219","2015",4,4,0,173750,1450.5,125.5
"5621","21220","2015",2,2,0,97625,1069.5,114
"5622","21221","2015",1,1,0,68400,1954,35
"5623","21222","2015",2,2,0,134500,932,144
"5624","21223","2015",13,12,1,358903.846153846,2706.15384615385,135.769230769231
"5625","21224","2015",1,1,0,53038,964,55
"5626","21225","2015",3,3,0,84266.6666666667,1040,74.6666666666667
"5627","21227","2015",4,4,0,276375,2402,117.25
"5628","21228","2015",3,3,0,163333.333333333,1662.33333333333,114.666666666667
"5629","21230","2015",1,1,0,409000,2272,180
"5630","21231","2015",2577,436,2141,135545.579743888,2162.11719053163,63.53434225844
"5631","21233","2015",3,3,0,125388,1311.66666666667,92
"5632","21234","2015",2,2,0,176075,1727.5,101.5
"5633","21236","2015",2,2,0,147000,1783.5,80
"5634","21238","2015",4,4,0,143700,1064.75,122.5
"5635","21239","2015",9,9,0,105788.888888889,1232.55555555556,86.3333333333333
"5636","21240","2015",6,5,1,151066.666666667,1590.16666666667,103.666666666667
"5637","21241","2015",5,5,0,174334,1763.6,104.2
"5638","21242","2015",2,2,0,142500,1017,136
"5639","21244","2015",1,1,0,296000,1254,236
"5640","21246","2015",2,2,0,117675,1366.5,92
"5641","21247","2015",6,6,0,113666.666666667,1232.83333333333,92.1666666666667
"5642","21249","2015",10,10,0,155555,1422.2,106.2
"5643","21250","2015",1,1,0,55000,917,60
"5644","21251","2015",3,3,0,207500,1873,106
"5645","21252","2015",2,2,0,62500,652.5,84
"5646","21254","2015",1,1,0,148000,1973,75
"5647","21255","2015",1,1,0,170000,1097,155
"5648","21256","2015",3,3,0,126666.666666667,1434.33333333333,92
"5649","21258","2015",3,3,0,124166.666666667,1161,106
"5650","21259","2015",4,4,0,105250,1257.25,85.5
"5651","21260","2015",2,2,0,88250,1011,93
"5652","21261","2015",11,11,0,240568.181818182,2304.18181818182,103.363636363636
"5653","21263","2015",10,10,0,211518.5,2045.8,113.5
"5654","21264","2015",1,1,0,80500,894,90
"5655","21265","2015",5,5,0,250160,1931.2,115.8
"5656","21266","2015",1,1,0,293005,2108,139
"5657","21267","2015",4,4,0,248440,1802.25,139.5
"5658","21268","2015",1,1,0,60000,375,160
"5659","21269","2015",6,6,0,124350,1315.16666666667,93.5
"5660","21270","2015",1,1,0,130000,839,155
"5661","21271","2015",4,4,0,213888.75,1670.5,144.5
"5662","21273","2015",21,19,2,173829.761904762,1745.95238095238,95.9047619047619
"5663","21274","2015",2,2,0,122500,1049.5,119.5
"5664","21276","2015",3,3,0,80666.6666666667,722.333333333333,109.333333333333
"5665","21277","2015",9,7,2,110111.111111111,1315.44444444444,84.4444444444444
"5666","21278","2015",112,55,57,219899.053571429,2260.21428571429,98.7053571428571
"5667","21279","2015",1,1,0,115000,1162,99
"5668","21280","2015",5,5,0,66598,1134.4,59.6
"5669","21281","2015",3,3,0,80333.3333333333,1347.66666666667,67.3333333333333
"5670","21283","2015",1,1,0,50000,714,70
"5671","21284","2015",2,2,0,167500,1477,114
"5672","21285","2015",4,4,0,122750,1241.25,103
"5673","21286","2015",1,1,0,80000,714,112
"5674","21287","2015",2,2,0,95500,1155,79.5
"5675","21288","2015",4,4,0,129575,1263,94.75
"5676","21290","2015",10,9,1,117380,1288.4,96.7
"5677","21291","2015",6,6,0,108833.333333333,1588.16666666667,68.8333333333333
"5678","21292","2015",58,41,17,132011.379310345,1627.75862068966,80.1379310344828
"5679","21294","2015",1,1,0,75000,463,162
"5680","21295","2015",12,5,7,149400,2007.66666666667,75.5
"5681","21296","2015",1,1,0,75000,536,140
"5682","21297","2015",11,9,2,219501.272727273,2325.90909090909,93.2727272727273
"5683","21298","2015",2,2,0,73500,1331,67.5
"5684","21300","2015",7,7,0,126428.571428571,1482.57142857143,85.4285714285714
"5685","21301","2015",2,2,0,69000,1094,66
"5686","21302","2015",1,1,0,59000,711,83
"5687","21304","2015",3,3,0,82800,762.666666666667,117
"5688","21305","2015",3,3,0,68000,649.333333333333,100.333333333333
"5689","21306","2015",3,3,0,108551.666666667,1136,92.3333333333333
"5690","21307","2015",4,4,0,102000,1135.25,87.5
"5691","21308","2015",1,1,0,217800,1715,127
"5692","21309","2015",1,1,0,123700,803,154
"5693","21310","2015",1,1,0,170000,1241,137
"5694","21311","2015",1,1,0,112100,1246,90
"5695","21312","2015",1,1,0,45000,360,125
"5696","21314","2015",1,1,0,80000,615,130
"5697","21315","2015",8,7,1,320987,2422.75,135.25
"5698","21316","2015",2,2,0,116500,1306.5,90
"5699","21317","2015",38,31,7,147571.789473684,1643.81578947368,91.8947368421053
"5700","21319","2015",10,10,0,185355.7,1810.6,106.7
"5701","21320","2015",8,8,0,174862.5,1640.25,110.5
"5702","21322","2015",2,1,1,76550,1116.5,72.5
"5703","21323","2015",1,1,0,121800,864,141
"5704","21325","2015",3,3,0,94333.3333333333,1260.66666666667,58.6666666666667
"5705","21327","2015",2,2,0,84000,1189.5,72
"5706","21328","2015",1,1,0,28000,538,52
"5707","21330","2015",2,2,0,184500,1887.5,99.5
"5708","21331","2015",2,2,0,160000,1799,89
"5709","21332","2015",12,11,1,129208.333333333,936.416666666667,144.5
"5710","21333","2015",3,3,0,94600,1351,70
"5711","21334","2015",2,1,1,80800,1050,67
"5712","21335","2015",2,2,0,33000,524.5,62.5
"5713","21336","2015",9,9,0,97411.1111111111,962.888888888889,106.222222222222
"5714","21337","2015",26,26,0,111259.038461538,1209.34615384615,97.7307692307692
"5715","21338","2015",2,2,0,92000,740,122
"5716","21339","2015",2,1,1,216000,1502,149
"5717","21341","2015",2,2,0,181000,1499,120.5
"5718","21342","2015",2,2,0,149050,1303,112
"5719","21343","2015",1,1,0,42000,933,45
"5720","21344","2015",8,8,0,98137.5,1372,79
"5721","21345","2015",4,4,0,68925,848.25,82.75
"5722","21346","2015",3,3,0,75066.6666666667,741.333333333333,103.333333333333
"5723","21347","2015",5,5,0,128300,1216.4,100
"5724","21349","2015",5,5,0,66900,999,65.2
"5725","21350","2015",1,1,0,74700,911,82
"5726","21351","2015",7,7,0,173961.428571429,1903.42857142857,92
"5727","21352","2015",9,9,0,169528.888888889,1761.77777777778,100.666666666667
"5728","21353","2015",19,18,1,176115.263157895,1838.10526315789,99.3157894736842
"5729","21354","2015",1,1,0,60000,706,85
"5730","21355","2015",60,31,29,157351,1903.61666666667,83.4666666666667
"5731","21356","2015",16,16,0,122018.75,1205.875,104.3125
"5732","21357","2015",2,2,0,112500,822.5,137.5
"5733","21358","2015",2,2,0,108500,1195,87.5
"5734","21360","2015",2,2,0,143457.5,1515,99.5
"5735","21361","2015",5,5,0,137800,1466.8,94
"5736","21363","2015",1,1,0,128000,1684,76
"5737","21365","2015",1,1,0,166047,983,169
"5738","21367","2015",2,2,0,125500,1268,97.5
"5739","21368","2015",3,3,0,124370,1164.66666666667,111
"5740","21369","2015",8,8,0,163060.25,1269.5,137
"5741","21370","2015",7,7,0,172671.428571429,1624.71428571429,101.285714285714
"5742","21371","2015",10,10,0,86100,1188.1,84.7
"5743","21373","2015",6,5,1,118956.666666667,1760.5,75
"5744","21374","2015",1,1,0,1e+05,935,107
"5745","21375","2015",2,2,0,25687.5,492,52
"5746","21378","2015",1,1,0,56000,622,90
"5747","21379","2015",2,2,0,39650,749,56
"5748","21381","2015",2,2,0,93600,605.5,137.5
"5749","21382","2015",3,3,0,72333.3333333333,750.333333333333,110
"5750","21383","2015",19,19,0,156978.684210526,1793.21052631579,89.5263157894737
"5751","21385","2015",6,6,0,134583.333333333,1055.83333333333,136.333333333333
"5752","21386","2015",6,6,0,118208.333333333,1114.5,103
"5753","21387","2015",2,2,0,210704,2083.5,100
"5754","21388","2015",1,1,0,182000,1596,114
"5755","21389","2015",1,1,0,250000,1799,139
"5756","21390","2015",56,52,4,168976.678571429,1994.57142857143,85.4285714285714
"5757","21391","2015",16,16,0,233042.625,1887.625,129.9375
"5758","21393","2015",1,1,0,50000,1190,42
"5759","21394","2015",1,1,0,139100,1405,99
"5760","21397","2015",1,1,0,171000,1900,90
"5761","21398","2015",2,2,0,112666.5,1200.5,100
"5762","21401","2015",8,8,0,179331.25,1662.375,115.5
"5763","21404","2015",5,5,0,152680,1612.8,98.6
"5764","21405","2015",4,4,0,164151.25,1640.75,102.5
"5765","21406","2015",1,1,0,240000,1348,178
"5766","21407","2015",1,1,0,188500,1885,100
"5767","21408","2015",14,13,1,271714.285714286,2473.64285714286,112.357142857143
"5768","21409","2015",7,6,1,124774.285714286,1554.28571428571,81.2857142857143
"5769","21411","2015",5,5,0,185538,1452,123.4
"5770","21412","2015",13,10,3,192769.230769231,2085.69230769231,89.0769230769231
"5771","21413","2015",2,2,0,268370,1858.5,150
"5772","21415","2015",2,2,0,92235,1059.5,87.5
"5773","21416","2015",22,20,2,174541.136363636,1594.95454545455,109.909090909091
"5774","21417","2015",1,1,0,78000,975,80
"5775","21419","2015",1,1,0,72900,819,89
"5776","21420","2015",1,1,0,64000,727,88
"5777","21421","2015",3,3,0,81333.3333333333,1085.33333333333,82
"5778","21422","2015",3,3,0,101333.333333333,1265.33333333333,86.3333333333333
"5779","21423","2015",10,10,0,176928,1966.9,95.3
"5780","21424","2015",1,1,0,149000,876,170
"5781","21425","2015",50,37,13,116934,1276.6,92.2
"5782","21426","2015",1,1,0,49000,612,80
"5783","21427","2015",2,2,0,127500,1209,103
"5784","21429","2015",3,3,0,176626.666666667,1206,156.666666666667
"5785","21431","2015",1,1,0,92540,995,93
"5786","21432","2015",3,3,0,53666.6666666667,957,61.3333333333333
"5787","21433","2015",1,1,0,80000,1000,80
"5788","21434","2015",1,1,0,65630,729,90
"5789","21435","2015",2,2,0,81250,770.5,102.5
"5790","21436","2015",2,2,0,232000,1542.5,150
"5791","21437","2015",1,1,0,110000,1209,91
"5792","21439","2015",1,1,0,146000,1718,85
"5793","21440","2015",2,2,0,152350,1568.5,96.5
"5794","21441","2015",4,4,0,132000,1176.75,114.5
"5795","21442","2015",5,5,0,133940,1398.4,102.2
"5796","21445","2015",2,2,0,51600,654.5,88.5
"5797","21446","2015",1,1,0,47500,565,84
"5798","21451","2015",3,3,0,178050,2248.33333333333,88.6666666666667
"5799","21452","2015",18,18,0,217733.277777778,2275.38888888889,96.7777777777778
"5800","21455","2015",2,2,0,63500,1042,61.5
"5801","21458","2015",16,16,0,218053.75,1956.375,109.6875
"5802","21459","2015",1,1,0,92000,1296,71
"5803","21461","2015",24,23,1,122572.5,1294.375,92.4583333333333
"5804","21462","2015",8,5,3,207080,1882.75,107.125
"5805","21464","2015",63,38,25,140295.238095238,1702.77777777778,86.4761904761905
"5806","21466","2015",2,2,0,91775,681.5,128
"5807","21468","2015",1,1,0,62000,539,115
"5808","21469","2015",2,2,0,208400,1735,120
"5809","21470","2015",1,1,0,65000,542,120
"5810","21472","2015",1,1,0,113100,1067,106
"5811","21473","2015",9,9,0,199805.555555556,1850.66666666667,112.333333333333
"5812","21474","2015",4,4,0,122187.5,859,157.5
"5813","21475","2015",5,5,0,76600,918,87.4
"5814","21476","2015",2,2,0,76275,799.5,95
"5815","21478","2015",3,3,0,229468,2589.33333333333,88
"5816","21479","2015",1,1,0,40000,851,47
"5817","21480","2015",1,1,0,135000,1154,117
"5818","21481","2015",12,12,0,243077.083333333,2238.08333333333,109.666666666667
"5819","21482","2015",7,7,0,142123.571428571,1603,88.4285714285714
"5820","21483","2015",3,3,0,160973.333333333,1053.66666666667,170.333333333333
"5821","21485","2015",27,22,5,152412.777777778,2015.33333333333,77
"5822","21487","2015",2,2,0,165750,1226,135.5
"5823","21488","2015",1,1,0,61800,651,95
"5824","21492","2015",6,4,2,210333.333333333,2068,105.333333333333
"5825","21493","2015",12,11,1,113435.25,1296.5,91.75
"5826","21494","2015",1,1,0,123500,1038,119
"5827","21496","2015",18,17,1,99960.8333333333,1231.27777777778,85.8888888888889
"5828","21497","2015",1,1,0,172500,862,200
"5829","21498","2015",2,2,0,166226.5,1463.5,127
"5830","21499","2015",2,2,0,98500,1304,74.5
"5831","21500","2015",7,6,1,104783.428571429,1203.85714285714,94.1428571428571
"5832","21501","2015",15,10,5,137180,1416.06666666667,101
"5833","21502","2015",7,6,1,95900,889.285714285714,113.428571428571
"5834","21503","2015",1,1,0,85000,1417,60
"5835","21504","2015",1,1,0,80000,1143,70
"5836","21505","2015",4,4,0,129500,1507.75,81.5
"5837","21506","2015",3,3,0,158000,2059.66666666667,78.6666666666667
"5838","21508","2015",3,3,0,208166.666666667,1957.66666666667,105.333333333333
"5839","21510","2015",1,1,0,128000,1438,89
"5840","21511","2015",1,1,0,60000,395,152
"5841","21512","2015",5,5,0,91600,1320.2,66.2
"5842","21514","2015",3,3,0,112983.333333333,774,138.333333333333
"5843","21515","2015",88,42,46,155094.386363636,1838.42045454545,83.4772727272727
"5844","21516","2015",1,1,0,226000,1404,161
"5845","21517","2015",3,2,1,76666.6666666667,1999,49
"5846","21518","2015",4,4,0,114750,1290,84.75
"5847","21519","2015",3,3,0,1e+05,1036,110
"5848","21521","2015",13,13,0,177903.846153846,1789.30769230769,104.384615384615
"5849","21522","2015",4,4,0,124881,1105,120
"5850","21523","2015",3,3,0,165000,1586,95.6666666666667
"5851","21524","2015",3,3,0,54500,726.333333333333,69
"5852","21525","2015",6,6,0,57250,720,82.5
"5853","21526","2015",1,1,0,65000,812,80
"5854","21527","2015",3,3,0,208500,1476.33333333333,96.3333333333333
"5855","21528","2015",1,1,0,44900,499,90
"5856","21530","2015",3,3,0,104000,1380,76.3333333333333
"5857","21531","2015",2,2,0,69500,1025.5,70.5
"5858","21532","2015",5,5,0,174502,2007.2,85.8
"5859","21533","2015",1,1,0,40000,1000,40
"5860","21534","2015",4,4,0,205950,1735,115.5
"5861","21535","2015",13,13,0,216525,2254,96.3076923076923
"5862","21536","2015",3,3,0,112090,791,146.666666666667
"5863","21537","2015",1,1,0,28500,570,50
"5864","21538","2015",1,1,0,50000,556,90
"5865","21539","2015",1,1,0,165000,1269,130
"5866","21540","2015",76,43,33,193153.934210526,2240.15789473684,86.6973684210526
"5867","21541","2015",4,4,0,162080,1486.75,110.5
"5868","21542","2015",6,6,0,181583.333333333,1478.16666666667,131.666666666667
"5869","21543","2015",1,1,0,60000,690,87
"5870","21545","2015",9,9,0,67405.5555555556,805.888888888889,84.7777777777778
"5871","21546","2015",2,2,0,163000,1327,117
"5872","21547","2015",2,2,0,121225,1527,79.5
"5873","21548","2015",3,3,0,103500,1289,86.3333333333333
"5874","21549","2015",2,2,0,99585,557,155
"5875","21550","2015",1,1,0,102000,927,110
"5876","21553","2015",3,3,0,122033.333333333,1455.33333333333,89.3333333333333
"5877","21554","2015",17,5,12,68499.4117647059,1084.82352941176,66.1176470588235
"5878","21555","2015",11,10,1,209372.090909091,2096.18181818182,111.727272727273
"5879","21556","2015",2,2,0,200225,1470.5,137
"5880","21558","2015",15,14,1,223028.666666667,1845.53333333333,120.933333333333
"5881","21559","2015",8,8,0,170812.5,1878.5,89.25
"5882","21560","2015",3,3,0,80000,1057,75
"5883","21561","2015",2,2,0,138348,1199.5,126
"5884","21562","2015",5,5,0,88420,736.8,122.2
"5885","21563","2015",4,4,0,76000,992.25,92.5
"5886","21564","2015",1,1,0,176500,1358,130
"5887","21565","2015",1,1,0,270000,2250,120
"5888","21566","2015",2,2,0,112500,1142,101
"5889","21567","2015",2,2,0,52500,815.5,65
"5890","21568","2015",7,6,1,80571.4285714286,1141.42857142857,77.4285714285714
"5891","21569","2015",4,4,0,153250,1210.5,124.25
"5892","21570","2015",2,2,0,147500,1260.5,117
"5893","21571","2015",3,3,0,81666.6666666667,1055.66666666667,71.6666666666667
"5894","21572","2015",5,5,0,121940,1318.6,101.8
"5895","21573","2015",3,3,0,91666.6666666667,807.333333333333,115.333333333333
"5896","21574","2015",8,8,0,95381.25,996.875,98.25
"5897","21575","2015",3,3,0,110333.333333333,1174.66666666667,91.6666666666667
"5898","21576","2015",2,2,0,103425,907,120.5
"5899","21577","2015",19,19,0,133252.631578947,1675.05263157895,80.1052631578947
"5900","21578","2015",7,7,0,175920.857142857,1716.71428571429,107.142857142857
"5901","21580","2015",3,2,1,48833.3333333333,835.666666666667,58.6666666666667
"5902","21581","2015",2,2,0,95000,911,102
"5903","21582","2015",10,9,1,116426,1516.2,82.2
"5904","21584","2015",21,21,0,80890.4761904762,946.238095238095,95.1904761904762
"5905","21585","2015",10,8,2,174665,1745,102.3
"5906","21586","2015",9,8,1,175527.777777778,1661.66666666667,105.888888888889
"5907","21587","2015",2,2,0,190910,1325,148
"5908","21589","2015",1,1,0,210000,2019,104
"5909","21590","2015",16,16,0,239983.125,2446.3125,106.625
"5910","21591","2015",7,7,0,225314.285714286,2010,118.857142857143
"5911","21592","2015",2,2,0,124500,1227,121
"5912","21594","2015",2,2,0,92500,1238.5,82.5
"5913","21596","2015",4,3,1,210337.5,1739,127.5
"5914","21598","2015",1,1,0,90000,652,138
"5915","21599","2015",29,27,2,130742.75862069,1348.51724137931,99.9310344827586
"5916","21600","2015",2,2,0,133065,1025,132
"5917","21601","2015",1,1,0,135000,1800,75
"5918","21603","2015",36,27,9,155104.027777778,1590.61111111111,100.222222222222
"5919","21604","2015",2,2,0,87000,799.5,113.5
"5920","21605","2015",19,19,0,214978.947368421,2135.42105263158,102.315789473684
"5921","21606","2015",17,17,0,168221.588235294,1866.94117647059,94
"5922","21607","2015",26,21,5,113481.153846154,1349.07692307692,87.6923076923077
"5923","21608","2015",3,3,0,1e+05,935.666666666667,118
"5924","21609","2015",3,3,0,244716.666666667,1889.33333333333,130.333333333333
"5925","21610","2015",2,2,0,181000,1425.5,124.5
"5926","21611","2015",8,8,0,172543.875,1553.75,124.375
"5927","21612","2015",1,1,0,147000,1598,92
"5928","21613","2015",2,2,0,92830.5,1099.5,72
"5929","21614","2015",2,2,0,203633.5,1174,204.5
"5930","21615","2015",1,1,0,36500,521,70
"5931","21616","2015",1,1,0,185000,1796,103
"5932","21617","2015",120,53,67,182948.316666667,2107.85833333333,87.5
"5933","21618","2015",7,5,2,96457.1428571429,998,97.1428571428571
"5934","21619","2015",2,2,0,110575,1106,100
"5935","21622","2015",2,2,0,207000,953,201.5
"5936","21623","2015",11,11,0,183504.545454545,1800.27272727273,103
"5937","21624","2015",2,2,0,232125,1742,142.5
"5938","21626","2015",1,1,0,42600,507,84
"5939","21627","2015",1,1,0,52000,776,67
"5940","21628","2015",1,1,0,40773,715,57
"5941","21630","2015",3,3,0,128850,1180,113
"5942","21632","2015",14,13,1,200035.857142857,1865,107.214285714286
"5943","21633","2015",4,4,0,55250,854.75,64.5
"5944","21634","2015",1,1,0,149000,1774,84
"5945","21635","2015",1,1,0,176000,989,178
"5946","21636","2015",1,1,0,134000,893,150
"5947","21637","2015",3,3,0,89166.6666666667,1015,99
"5948","21638","2015",12,11,1,169120,1532,111.666666666667
"5949","21639","2015",6,6,0,143777,1538.16666666667,93.1666666666667
"5950","21640","2015",1,1,0,41000,891,46
"5951","21641","2015",6,6,0,116830,1155.5,101.666666666667
"5952","21642","2015",2,2,0,125500,1169.5,106.5
"5953","21643","2015",6,6,0,117250,1253.33333333333,95.8333333333333
"5954","21644","2015",2,2,0,169500,1722.5,106.5
"5955","21645","2015",7,7,0,88178.5714285714,1216.14285714286,79.1428571428571
"5956","21646","2015",1,1,0,47000,495,95
"5957","21647","2015",1,1,0,62000,1033,60
"5958","21649","2015",1,1,0,45000,577,78
"5959","21650","2015",1,1,0,111000,2176,51
"5960","21651","2015",2,2,0,194000,1580,129.5
"5961","21652","2015",6,5,1,102833.333333333,1299.33333333333,81.3333333333333
"5962","21656","2015",12,11,1,207444.583333333,1474.33333333333,143.916666666667
"5963","21657","2015",24,23,1,249484.916666667,2332,110.25
"5964","21661","2015",19,17,2,195602.105263158,1875,105.894736842105
"5965","21663","2015",14,14,0,116664.285714286,1557.57142857143,80.2857142857143
"5966","21664","2015",2,2,0,70000,788.5,89
"5967","21665","2015",2,2,0,85950,922.5,88
"5968","21667","2015",1,1,0,25000,439,57
"5969","21670","2015",3,3,0,142216.666666667,931.333333333333,160
"5970","21673","2015",6,6,0,114583.333333333,1005.5,119
"5971","21674","2015",2,2,0,107000,780,118.5
"5972","21675","2015",2,2,0,109000,1246.5,88.5
"5973","21676","2015",2,1,1,108500,803,149.5
"5974","21677","2015",1,1,0,154000,1252,123
"5975","21678","2015",2,2,0,163375,679.5,185
"5976","21680","2015",7,6,1,104722.142857143,815.285714285714,126.285714285714
"5977","21681","2015",2,2,0,71000,965.5,87.5
"5978","21682","2015",2,2,0,152500,1359,115.5
"5979","21683","2015",3,3,0,148966.666666667,1339.66666666667,107.333333333333
"5980","21684","2015",4,4,0,199887.5,1758.75,116
"5981","21685","2015",1,1,0,220000,1467,150
"5982","21686","2015",1,1,0,225000,1480,152
"5983","21687","2015",1,1,0,207500,1729,120
"5984","21688","2015",1,1,0,340000,2519,135
"5985","21689","2015",2,2,0,142500,1354.5,107.5
"5986","21690","2015",2,2,0,49500,697.5,81.5
"5987","21691","2015",3,3,0,218666.666666667,1859.66666666667,117.666666666667
"5988","21692","2015",2,2,0,183065,1303.5,140
"5989","21693","2015",5,5,0,31600,1058.6,33.8
"5990","21698","2015",2,2,0,146000,1022,165
"5991","21699","2015",13,13,0,142446.153846154,1434.15384615385,102.461538461538
"5992","21701","2015",1,1,0,117000,1300,90
"5993","21702","2015",4,4,0,136250,1528.5,84
"5994","21703","2015",1,1,0,50000,602,83
"5995","21705","2015",2,2,0,54500,698,77.5
"5996","21706","2015",1,1,0,128000,711,180
"5997","21707","2015",2,2,0,86000,870,96.5
"5998","21708","2015",5,5,0,175300,1697.6,103.8
"5999","21709","2015",2,2,0,173575,1265.5,135.5
"6000","21710","2015",8,5,3,73781.25,1074.25,85
"6001","21711","2015",1,1,0,120000,1263,95
"6002","21712","2015",3,3,0,187831.666666667,1724.66666666667,106.666666666667
"6003","21713","2015",3,3,0,104933.333333333,1064,94.6666666666667
"6004","21715","2015",1,1,0,208000,1541,135
"6005","21716","2015",2,2,0,155000,1341,116.5
"6006","21717","2015",1,1,0,55000,487,113
"6007","22001","2015",5,5,0,82780,933.8,88.4
"6008","22002","2015",8,8,0,160625,1546.5,103
"6009","22003","2015",6,6,0,143966.666666667,1656.16666666667,100.5
"6010","22004","2015",66,65,1,95401.9696969697,1070.83333333333,94.1363636363636
"6011","22005","2015",23,23,0,108382.608695652,1181.86956521739,95.3913043478261
"6012","22006","2015",5,5,0,80058.4,726.6,112.6
"6013","22008","2015",8,8,0,151154.5,1624.375,94.75
"6014","22009","2015",7,7,0,102604.285714286,1305.28571428571,87
"6015","22011","2015",11,11,0,128522.727272727,1157,109.090909090909
"6016","22012","2015",7,7,0,135607.142857143,1426,104
"6017","22013","2015",26,25,1,85543.7307692308,969.230769230769,89.3461538461538
"6018","22014","2015",5,5,0,104400,1251.4,92.4
"6019","22015","2015",18,18,0,115311.833333333,1193.16666666667,103.833333333333
"6020","22016","2015",11,11,0,329500,4022,80.9090909090909
"6021","22018","2015",4,4,0,88750,940.25,97.75
"6022","22019","2015",3,3,0,100666.666666667,850.666666666667,113.333333333333
"6023","22020","2015",20,19,1,101000,1167.15,87.8
"6024","22021","2015",10,10,0,132145,1282.4,101.2
"6025","22023","2015",1,1,0,38000,380,100
"6026","22024","2015",4,4,0,79975,877,90.25
"6027","22025","2015",44,44,0,82950.5227272727,907.522727272727,91.8636363636364
"6028","22026","2015",8,8,0,123922.5,1214.25,103.875
"6029","22027","2015",8,8,0,63500,726.375,91.875
"6030","22028","2015",12,12,0,123834.583333333,1393.66666666667,90.6666666666667
"6031","22029","2015",4,4,0,121500,1871.75,78.75
"6032","22030","2015",11,11,0,117450,1203.72727272727,97.6363636363636
"6033","22031","2015",10,9,1,50080,711.4,77
"6034","22032","2015",20,20,0,111182.5,1133.15,98.1
"6035","22033","2015",2,2,0,66150,977.5,69
"6036","22034","2015",17,17,0,105585.294117647,1294.82352941176,82.9411764705882
"6037","22035","2015",12,12,0,113266.666666667,1227.16666666667,93.3333333333333
"6038","22036","2015",2,2,0,144500,1182.5,128
"6039","22037","2015",7,7,0,54371.4285714286,754.857142857143,69.1428571428571
"6040","22039","2015",8,8,0,66500,815.25,80.25
"6041","22040","2015",4,4,0,90125,802.5,111.25
"6042","22041","2015",3,3,0,63333.3333333333,1006,61.6666666666667
"6043","22042","2015",5,5,0,183600,1454.8,113.4
"6044","22043","2015",6,6,0,102043.333333333,823.666666666667,114.833333333333
"6045","22044","2015",9,9,0,165895.444444444,1566.88888888889,107.444444444444
"6046","22045","2015",3,3,0,149666.666666667,1320,115.666666666667
"6047","22046","2015",54,54,0,74666.5740740741,805.611111111111,90.6851851851852
"6048","22047","2015",7,7,0,108978.571428571,1090,100.571428571429
"6049","22048","2015",8,8,0,157625,1477.125,110.125
"6050","22049","2015",25,25,0,127980,1348.24,97.76
"6051","22050","2015",212,115,97,153074.882075472,1713.85377358491,90.5
"6052","22052","2015",5,5,0,86196,1098.8,76.2
"6053","22053","2015",6,6,0,98083.3333333333,922.833333333333,100.833333333333
"6054","22054","2015",89,61,28,178940.078651685,2303.69662921348,85.1460674157303
"6055","22055","2015",98,88,10,173740.306122449,1972.78571428571,91.1224489795918
"6056","22056","2015",25,25,0,118361.6,1299.4,96
"6057","22057","2015",4,4,0,1e+05,1081.5,92.5
"6058","22059","2015",8,8,0,109375,1100.125,99.375
"6059","22060","2015",11,11,0,86560.6363636364,894,92.5454545454545
"6060","22061","2015",19,19,0,66941.8421052632,826.210526315789,79.0526315789474
"6061","22062","2015",5,5,0,52200,557.6,92.4
"6062","22063","2015",9,9,0,86222.2222222222,973.666666666667,88.4444444444444
"6063","22064","2015",12,12,0,66354.1666666667,724.583333333333,90.5
"6064","22065","2015",12,12,0,157416.666666667,1429.58333333333,111.166666666667
"6065","22067","2015",17,17,0,105814.705882353,1333.23529411765,84.3529411764706
"6066","22068","2015",5,5,0,84437.6,783,115.4
"6067","22069","2015",3,3,0,80458.3333333333,1298.66666666667,74.6666666666667
"6068","22070","2015",87,62,25,87416.3218390805,1153.08045977011,78.7816091954023
"6069","22071","2015",6,6,0,130500,1149.33333333333,121.333333333333
"6070","22072","2015",1,1,0,55000,671,82
"6071","22073","2015",7,7,0,91428.5714285714,1181.85714285714,84.5714285714286
"6072","22074","2015",4,4,0,80750,813.75,107
"6073","22076","2015",14,14,0,129959.071428571,1322.07142857143,104.857142857143
"6074","22077","2015",5,5,0,118480,1208.6,100.2
"6075","22079","2015",14,14,0,107632.142857143,1035.78571428571,101
"6076","22081","2015",29,26,3,114150.413793103,1343.48275862069,89.8620689655172
"6077","22082","2015",5,5,0,184600,1591.2,113.2
"6078","22083","2015",3,3,0,94000,1193.33333333333,83.6666666666667
"6079","22084","2015",28,27,1,99092.8571428571,1244.92857142857,80.4642857142857
"6080","22085","2015",4,4,0,131400,1536.5,79.75
"6081","22086","2015",10,9,1,102850,1299.6,84.7
"6082","22087","2015",12,12,0,174725,1474.66666666667,99
"6083","22088","2015",4,4,0,70250,829.75,88.25
"6084","22090","2015",9,9,0,168039.444444444,1504.88888888889,115
"6085","22091","2015",1,1,0,130100,765,170
"6086","22092","2015",7,7,0,63708.1428571429,827.142857142857,74.7142857142857
"6087","22093","2015",175,147,28,143420.782857143,1693.24571428571,89.7142857142857
"6088","22094","2015",47,44,3,283707.574468085,3083.55319148936,99.4042553191489
"6089","22095","2015",2,2,0,79500,1467.5,59
"6090","22096","2015",6,6,0,110833.333333333,1181.5,100.666666666667
"6091","22097","2015",7,7,0,157285.714285714,1589.57142857143,96.4285714285714
"6092","22098","2015",14,14,0,124788.571428571,1198.85714285714,114
"6093","22099","2015",12,12,0,120568.5,1093,103.083333333333
"6094","22101","2015",17,17,0,104117.647058824,1212.41176470588,88.2352941176471
"6095","22103","2015",11,11,0,140772.727272727,1487.45454545455,96.3636363636364
"6096","22104","2015",7,7,0,116885.714285714,1344.71428571429,84
"6097","22105","2015",10,10,0,163295,1767.2,103.4
"6098","22106","2015",67,49,18,145451.358208955,1757.49253731343,87.4477611940299
"6099","22107","2015",21,20,1,95548.6666666667,1011.09523809524,99.7619047619048
"6100","22108","2015",2,2,0,104500,975.5,111
"6101","22109","2015",5,5,0,74200,1097,75.6
"6102","22110","2015",6,6,0,156666.666666667,1315.66666666667,116.666666666667
"6103","22111","2015",2,2,0,127000,1373.5,95.5
"6104","22112","2015",4,4,0,64691.5,1065.5,74.75
"6105","22113","2015",187,133,54,118230.898395722,1394.04278074866,87.2887700534759
"6106","22114","2015",11,11,0,98100,1165.63636363636,91.8181818181818
"6107","22115","2015",7,7,0,98503.4285714286,988.857142857143,99.4285714285714
"6108","22116","2015",8,8,0,125000,1043.375,118.375
"6109","22117","2015",20,20,0,161547.5,1442.4,110.15
"6110","22118","2015",22,18,4,134243.181818182,1482.68181818182,94.9545454545455
"6111","22119","2015",7,7,0,87642.8571428571,975.571428571429,83.2857142857143
"6112","22121","2015",22,21,1,111954.545454545,1047.09090909091,108.727272727273
"6113","22122","2015",8,8,0,83312.5,836.625,101.25
"6114","22124","2015",2,2,0,65000,634.5,102
"6115","22126","2015",1,1,0,15000,375,40
"6116","22127","2015",25,25,0,135212,1589.44,86.32
"6117","22128","2015",3,3,0,59666.6666666667,616,99.3333333333333
"6118","22129","2015",2,2,0,89000,1136.5,79
"6119","22131","2015",13,13,0,66990.3846153846,939.615384615385,90.2307692307692
"6120","22132","2015",3,3,0,38500,419.333333333333,89
"6121","22133","2015",6,6,0,74250,800.833333333333,85.5
"6122","22134","2015",33,33,0,189592.151515152,1703.90909090909,109.878787878788
"6123","22135","2015",27,27,0,82096.2962962963,976.296296296296,85.6296296296296
"6124","22136","2015",87,71,16,91466.2068965517,1042.94252873563,89.5287356321839
"6125","22137","2015",33,32,1,67923.8484848485,886.424242424242,77.1818181818182
"6126","22138","2015",6,6,0,63250,789.333333333333,82.6666666666667
"6127","22139","2015",1,1,0,25000,439,57
"6128","22140","2015",5,4,1,132860,1462.4,104.6
"6129","22141","2015",3,3,0,143000,1304.33333333333,109.333333333333
"6130","22143","2015",18,17,1,175606.777777778,1661.66666666667,109.222222222222
"6131","22144","2015",5,5,0,147700,1605,96
"6132","22145","2015",8,8,0,125425,1275.25,93.5
"6133","22146","2015",10,10,0,50850,707.9,76
"6134","22147","2015",28,26,2,103353.928571429,1162.07142857143,96.7142857142857
"6135","22148","2015",4,4,0,50500,933.25,59.75
"6136","22149","2015",6,6,0,100298.333333333,1069.66666666667,102.166666666667
"6137","22150","2015",7,7,0,108121,1199.71428571429,87.7142857142857
"6138","22152","2015",7,7,0,139713.857142857,1553.85714285714,91.7142857142857
"6139","22153","2015",9,9,0,86111.1111111111,961.111111111111,92.8888888888889
"6140","22155","2015",7,7,0,79430,889,89.5714285714286
"6141","22156","2015",5,5,0,97000,1034,89.6
"6142","22157","2015",7,7,0,103685.714285714,1145,89.4285714285714
"6143","22158","2015",28,28,0,87215.7857142857,969.928571428571,94.3214285714286
"6144","22160","2015",2,2,0,194560,1379,140.5
"6145","22161","2015",37,37,0,123277.945945946,1274.02702702703,98.4054054054054
"6146","22162","2015",109,74,35,152172.614678899,1843.5871559633,86.9082568807339
"6147","22163","2015",12,12,0,97528.3333333333,947.083333333333,106.333333333333
"6148","22164","2015",15,15,0,98673.3333333333,1038.46666666667,94
"6149","22165","2015",3,3,0,87933.3333333333,1761,58
"6150","22166","2015",34,32,2,172006.323529412,1996.32352941176,96.3529411764706
"6151","22168","2015",162,108,54,179657.950617284,2194.04938271605,85.320987654321
"6152","22169","2015",2,2,0,59999,771,76
"6153","22170","2015",11,11,0,105937.272727273,1202.27272727273,89.5454545454545
"6154","22171","2015",29,26,3,119707.586206897,1221.8275862069,100.827586206897
"6155","22172","2015",34,25,9,122111.764705882,1489.5,94.7058823529412
"6156","22174","2015",6,6,0,165333.333333333,1549.5,114.833333333333
"6157","22175","2015",8,8,0,86693.75,1271.625,68.25
"6158","22176","2015",61,60,1,128940.786885246,1392.18032786885,95
"6159","22177","2015",17,17,0,140102.941176471,1528.70588235294,101.705882352941
"6160","22178","2015",16,16,0,113912.5,1229.125,96.875
"6161","22179","2015",41,36,5,168767.390243902,1990.24390243902,89.2682926829268
"6162","22180","2015",21,21,0,139278.571428571,1296.04761904762,112.333333333333
"6163","22181","2015",4,4,0,92820,805,115.5
"6164","22182","2015",23,23,0,140493.47826087,1281.95652173913,110.391304347826
"6165","22183","2015",37,37,0,76148.6486486487,951.783783783784,80.7027027027027
"6166","22184","2015",13,13,0,98115.3846153846,958,102.384615384615
"6167","22185","2015",20,19,1,78214,856.7,94.2
"6168","22186","2015",107,67,40,207269.990654206,2727.21495327103,80.1869158878505
"6169","22187","2015",155,134,21,172457.729032258,1759.0064516129,99.9612903225807
"6170","22188","2015",4,4,0,171250,1653.75,103.75
"6171","22189","2015",9,9,0,62566.6666666667,833.333333333333,79.4444444444444
"6172","22190","2015",41,41,0,154214.170731707,1547.12195121951,100.487804878049
"6173","22193","2015",14,12,2,124078.571428571,1557.5,83.8571428571429
"6174","22194","2015",55,52,3,144935.618181818,1423.47272727273,102.290909090909
"6175","22195","2015",37,36,1,115443.513513514,1332.13513513514,88.4324324324324
"6176","22196","2015",16,16,0,103606.0625,1229.625,86.9375
"6177","22197","2015",37,37,0,200818.918918919,1759,118.135135135135
"6178","22198","2015",52,52,0,192152.692307692,1962.76923076923,102.557692307692
"6179","22199","2015",12,12,0,99425,1159.75,89.6666666666667
"6180","22200","2015",5,4,1,74705,889.2,81.2
"6181","22201","2015",9,9,0,162000,2080.33333333333,80.3333333333333
"6182","22202","2015",10,10,0,67242,748.3,94.5
"6183","22203","2015",33,33,0,102681.96969697,1044.09090909091,103.515151515152
"6184","22204","2015",15,15,0,100846.666666667,1163.8,96.7333333333333
"6185","22205","2015",5,5,0,86600,1232,74
"6186","22206","2015",21,21,0,151503.142857143,1459.2380952381,106.285714285714
"6187","22207","2015",30,30,0,87357.6666666667,1056.8,83.4
"6188","22208","2015",21,21,0,104833.333333333,1242.80952380952,92
"6189","22209","2015",47,41,6,174250.85106383,1845,99.1063829787234
"6190","22210","2015",43,42,1,198793.651162791,2028.58139534884,101.697674418605
"6191","22211","2015",38,38,0,147008.315789474,1366.60526315789,111.184210526316
"6192","22212","2015",16,16,0,88419.375,1059.8125,88.25
"6193","22213","2015",44,44,0,201253.977272727,1843.63636363636,108.545454545455
"6194","22214","2015",60,59,1,154050.916666667,1546.2,102.433333333333
"6195","22215","2015",106,101,5,138985.141509434,1590.35849056604,95.1603773584906
"6196","22216","2015",7,7,0,57519,899.714285714286,76.7142857142857
"6197","22217","2015",5,5,0,121600,1408.8,92.2
"6198","22218","2015",26,26,0,184440,1884.80769230769,99.2692307692308
"6199","22219","2015",19,19,0,130992.105263158,1346.15789473684,116.105263157895
"6200","22220","2015",24,24,0,79171.0833333333,821.041666666667,98.3333333333333
"6201","22221","2015",18,18,0,102750.555555556,1279.22222222222,87.4444444444444
"6202","22222","2015",93,92,1,133318.11827957,1502.37634408602,90.3655913978495
"6203","22223","2015",14,14,0,109753.571428571,1205.92857142857,94.1428571428571
"6204","22224","2015",18,18,0,162611.111111111,1553,110.277777777778
"6205","22225","2015",41,38,3,110636.585365854,1209.80487804878,89.390243902439
"6206","22226","2015",29,29,0,138156.206896552,1368.37931034483,99.2758620689655
"6207","22227","2015",6,6,0,78416.6666666667,1009.5,77.1666666666667
"6208","22228","2015",16,16,0,90625,1235,86.0625
"6209","22229","2015",14,14,0,72440.2857142857,896.928571428571,82
"6210","22231","2015",3,3,0,58213.3333333333,1121,54.6666666666667
"6211","22232","2015",30,29,1,174741.666666667,1517.76666666667,114.266666666667
"6212","22233","2015",26,26,0,127192.307692308,1380.57692307692,95
"6213","22234","2015",10,10,0,115208,1265.2,97.9
"6214","22235","2015",1,1,0,49000,576,85
"6215","22236","2015",9,9,0,141055.555555556,1404.11111111111,96.5555555555556
"6216","22237","2015",13,13,0,145276.923076923,1408,108.692307692308
"6217","22238","2015",13,12,1,103174.615384615,1243.38461538462,86
"6218","22239","2015",13,13,0,106150,1086.07692307692,93.9230769230769
"6219","22240","2015",11,11,0,95531.8181818182,878.454545454545,110.909090909091
"6220","22241","2015",8,8,0,105390.125,1238.125,88.75
"6221","22242","2015",14,14,0,158547.285714286,1766.35714285714,90.9285714285714
"6222","22243","2015",11,11,0,67927.2727272727,813.363636363636,92.6363636363636
"6223","22244","2015",4,4,0,75462.5,741.75,93
"6224","22245","2015",9,9,0,103297.777777778,1227.88888888889,93
"6225","22246","2015",18,17,1,149077.777777778,1592.22222222222,96.7222222222222
"6226","22248","2015",30,30,0,101993.333333333,1048.43333333333,102.933333333333
"6227","22249","2015",4,4,0,34250,592.25,57.75
"6228","22250","2015",13,13,0,86223.0769230769,928.461538461538,97.6923076923077
"6229","22251","2015",60,56,4,170089.833333333,1702.6,102.8
"6230","22254","2015",18,18,0,89038.8888888889,1207.94444444444,82.7777777777778
"6231","22255","2015",12,12,0,79283.3333333333,919.916666666667,84.1666666666667
"6232","22256","2015",10,10,0,102200,959.6,109.7
"6233","22257","2015",10,10,0,101650,1002,98.4
"6234","22258","2015",36,35,1,125750.777777778,1429.16666666667,91.2222222222222
"6235","22259","2015",39,37,2,154543.58974359,1576.79487179487,102.666666666667
"6236","22260","2015",5,5,0,136680,1189.4,107.2
"6237","22261","2015",5,5,0,108300,1087.8,95
"6238","22262","2015",34,29,5,103728.235294118,1173.67647058824,92.6176470588235
"6239","22263","2015",6,6,0,125333.333333333,974.833333333333,117.833333333333
"6240","22264","2015",40,40,0,108836.15,1197.075,93.8
"6241","22265","2015",19,19,0,118315.789473684,1329.73684210526,95.6315789473684
"6242","22266","2015",39,39,0,67703.8461538462,882.717948717949,80.2564102564103
"6243","22267","2015",2,2,0,121500,914,142
"6244","22268","2015",6,6,0,165675,1286.33333333333,126.666666666667
"6245","22269","2015",3,3,0,238333.333333333,1692.33333333333,116.666666666667
"6246","22272","2015",17,16,1,130916.470588235,1382.88235294118,95.2352941176471
"6247","22273","2015",14,14,0,146041.928571429,1386.92857142857,116.642857142857
"6248","22274","2015",1,1,0,110000,1222,90
"6249","22275","2015",9,9,0,89888.8888888889,992.444444444444,92.8888888888889
"6250","22277","2015",24,24,0,123637.875,1176.04166666667,101.416666666667
"6251","22278","2015",656,329,327,100858.413109756,1314.95426829268,77.8368902439024
"6252","22279","2015",12,12,0,84969.8333333333,915.833333333333,92.5833333333333
"6253","22280","2015",6,5,1,159333.333333333,1628.83333333333,111
"6254","22281","2015",17,17,0,120794.117647059,1339.41176470588,88.5882352941177
"6255","22282","2015",75,49,26,183439.826666667,2576.12,76.96
"6256","22283","2015",10,10,0,65250,894.6,80.2
"6257","22284","2015",6,6,0,63007,1111.5,61.5
"6258","22285","2015",5,5,0,80400,960.2,83
"6259","22286","2015",3,3,0,126666.666666667,1351.33333333333,86
"6260","22287","2015",12,12,0,114316.666666667,1089.16666666667,106.25
"6261","22288","2015",5,5,0,52200,671.6,83
"6262","22289","2015",1,1,0,70000,1667,42
"6263","22291","2015",1,1,0,185000,1423,130
"6264","22293","2015",4,4,0,59462.5,716.5,85.5
"6265","22294","2015",6,6,0,35666.6666666667,611,59.3333333333333
"6266","22295","2015",6,6,0,75916.6666666667,815,96
"6267","22296","2015",7,7,0,150000,1133,142
"6268","22299","2015",13,13,0,168330.769230769,1541,112.307692307692
"6269","22300","2015",4,4,0,121750,1234.25,98.75
"6270","22302","2015",21,16,5,177628.571428571,2626.7619047619,80.7142857142857
"6271","22305","2015",6,6,0,67916.6666666667,810.5,80.8333333333333
"6272","22306","2015",9,9,0,145503.333333333,1213.33333333333,121.666666666667
"6273","22307","2015",19,18,1,128044.894736842,1265.05263157895,103.631578947368
"6274","22308","2015",5,5,0,135000,1122.2,120.4
"6275","22309","2015",1,1,0,50000,500,100
"6276","22310","2015",4,4,0,64600,996.5,58.75
"6277","22311","2015",12,12,0,205650,1599.25,126.75
"6278","22312","2015",1,1,0,78000,396,197
"6279","22313","2015",4,4,0,53750,901.5,65
"6280","22314","2015",5,5,0,97100,980.4,97.2
"6281","22315","2015",3,3,0,125050,891,126.666666666667
"6282","22316","2015",4,4,0,71250,957.75,70.25
"6283","22317","2015",1,1,0,185000,1796,103
"6284","22318","2015",6,6,0,113383.333333333,1159.83333333333,104.666666666667
"6285","22319","2015",9,8,1,123366.666666667,1597.88888888889,78.3333333333333
"6286","22320","2015",1,1,0,45000,938,48
"6287","22321","2015",20,20,0,69950,895.45,89.1
"6288","22322","2015",4,4,0,108000,1044.25,100
"6289","22323","2015",4,4,0,109500,1285.75,79.75
"6290","22324","2015",16,16,0,182405,1588.1875,110.5
"6291","22325","2015",124,80,44,170601.451612903,2157.04838709677,83.5403225806452
"6292","22326","2015",3,3,0,126065.666666667,1304.33333333333,97.3333333333333
"6293","22327","2015",17,17,0,154647.058823529,1681.35294117647,93.6470588235294
"6294","22328","2015",8,8,0,71371.25,870,83.5
"6295","22330","2015",1,1,0,70000,1000,70
"6296","22331","2015",3,3,0,52333.3333333333,1004,55.6666666666667
"6297","22332","2015",4,4,0,124168.25,1166.25,105.75
"6298","22333","2015",10,10,0,63503.7,1000.7,76.4
"6299","22334","2015",3,3,0,50166.6666666667,717,69.6666666666667
"6300","22335","2015",3,3,0,162083.333333333,1222.66666666667,144.333333333333
"6301","22337","2015",6,6,0,90000,1001.16666666667,91.6666666666667
"6302","22338","2015",11,11,0,120545.454545455,1137.18181818182,108.636363636364
"6303","22339","2015",23,23,0,166482.608695652,1622,104.869565217391
"6304","22340","2015",14,14,0,107535.714285714,1187,91.2142857142857
"6305","22341","2015",10,10,0,122680,1232.1,101.7
"6306","22342","2015",5,5,0,104200,1118.2,95.6
"6307","22343","2015",73,54,19,153640,2123.87671232877,83.4109589041096
"6308","22344","2015",5,5,0,71506,858.4,87.6
"6309","22345","2015",6,6,0,74933.3333333333,921,82.1666666666667
"6310","22346","2015",6,6,0,128500,1261.83333333333,96.8333333333333
"6311","22347","2015",10,10,0,122401,1175,99.7
"6312","22348","2015",1,1,0,115000,1065,108
"6313","22349","2015",22,22,0,144293.181818182,1451.86363636364,101.409090909091
"6314","22351","2015",6,6,0,125500,1265,94.6666666666667
"6315","22352","2015",2,2,0,82500,1005.5,70.5
"6316","22353","2015",44,34,10,207246.090909091,2482.84090909091,81.3181818181818
"6317","22354","2015",8,8,0,114437.5,1098,108.5
"6318","22356","2015",5,5,0,97100,1139.8,85.6
"6319","22358","2015",4,4,0,105000,946,110.75
"6320","22359","2015",8,8,0,84687.5,1212.5,67.125
"6321","22360","2015",62,56,6,149103.322580645,1524.59677419355,100.41935483871
"6322","22361","2015",8,8,0,93625,1163,80.875
"6323","22362","2015",31,25,6,95452.7419354839,1236.83870967742,80.8387096774194
"6324","22363","2015",15,15,0,165742.933333333,1693.8,102
"6325","22364","2015",30,30,0,166740.5,1560.56666666667,105.1
"6326","22365","2015",3,3,0,116666.666666667,1423.66666666667,104
"6327","22366","2015",4,4,0,140000,1338.75,99.75
"6328","22368","2015",10,10,0,149600,1446.9,104.2
"6329","22369","2015",6,6,0,149333.333333333,1185.66666666667,125.833333333333
"6330","22370","2015",5,5,0,101700,1057.6,98.2
"6331","22371","2015",20,20,0,129645,1173.1,105.25
"6332","22372","2015",25,25,0,131158,1506,89.16
"6333","22375","2015",6,6,0,81666.6666666667,983.166666666667,95
"6334","22376","2015",12,12,0,102750,1041.66666666667,99.4166666666667
"6335","22377","2015",6,6,0,212333.333333333,1916.16666666667,106.5
"6336","22378","2015",5,5,0,86600,1566.6,85.2
"6337","22379","2015",32,28,4,145183.875,1959.71875,80.875
"6338","22380","2015",3,3,0,119000,1296.66666666667,91.6666666666667
"6339","22381","2015",3,3,0,149133.333333333,1386.33333333333,108.666666666667
"6340","22383","2015",7,6,1,136215.714285714,1110.28571428571,103.571428571429
"6341","22384","2015",9,9,0,90400,980.222222222222,99.4444444444444
"6342","22385","2015",13,12,1,143384.615384615,1497.61538461538,94.6153846153846
"6343","22386","2015",8,8,0,123837.5,1047,112.125
"6344","22387","2015",15,15,0,110020.933333333,1118.06666666667,102.733333333333
"6345","22388","2015",11,11,0,133390.909090909,1138.27272727273,109.545454545455
"6346","22389","2015",51,47,4,158360.176470588,1636.41176470588,99.3137254901961
"6347","22390","2015",9,9,0,109555.555555556,1118.44444444444,102.555555555556
"6348","22391","2015",16,16,0,111828.125,1045.625,107.5
"6349","23001","2015",14,14,0,80735.7142857143,744.785714285714,98.4285714285714
"6350","23002","2015",5,5,0,97000,825,111.4
"6351","23004","2015",8,8,0,94112.5,955.125,102.5
"6352","23005","2015",3,3,0,57833.3333333333,962,66
"6353","23006","2015",3,3,0,72586.6666666667,1039.66666666667,73
"6354","23007","2015",3,3,0,71666.6666666667,870.333333333333,109.333333333333
"6355","23008","2015",23,15,8,60774.1304347826,811.826086956522,76.5217391304348
"6356","23010","2015",1,1,0,60000,1364,44
"6357","23011","2015",1,1,0,50000,926,54
"6358","23012","2015",4,4,0,45662.5,1008.5,46.25
"6359","23013","2015",9,9,0,70788.8888888889,712.222222222222,99.5555555555556
"6360","23014","2015",2,2,0,72780,589.5,122
"6361","23015","2015",7,7,0,79571.4285714286,807.857142857143,99.5714285714286
"6362","23016","2015",3,3,0,66066.6666666667,568.333333333333,121
"6363","23017","2015",3,3,0,71583.3333333333,906.333333333333,78.3333333333333
"6364","23018","2015",3,3,0,97272.6666666667,1134.33333333333,89
"6365","23020","2015",2,2,0,37500,491,79.5
"6366","23021","2015",9,9,0,79222.2222222222,574.666666666667,128.888888888889
"6367","23022","2015",7,7,0,65642.8571428571,977.714285714286,66.4285714285714
"6368","23023","2015",2,2,0,41000,523.5,74
"6369","23024","2015",3,3,0,104000,917.333333333333,127.666666666667
"6370","23025","2015",14,14,0,80607.1428571429,820,104
"6371","23026","2015",6,6,0,77833.3333333333,601.166666666667,128.833333333333
"6372","23027","2015",3,3,0,74916.6666666667,993,70
"6373","23028","2015",2,2,0,39000,712,55
"6374","23029","2015",4,4,0,67250,807.5,87
"6375","23030","2015",18,18,0,61738.8888888889,690.722222222222,89.4444444444444
"6376","23031","2015",12,11,1,78930.5,876.666666666667,98.0833333333333
"6377","23032","2015",7,7,0,120428.571428571,1242,103.428571428571
"6378","23033","2015",3,3,0,70750,1150.66666666667,65
"6379","23035","2015",5,5,0,129360,989.4,118.6
"6380","23036","2015",14,14,0,69583.3571428571,994.714285714286,66.2857142857143
"6381","23038","2015",1,1,0,46000,920,50
"6382","23039","2015",7,7,0,75007.1428571429,958.714285714286,87.8571428571429
"6383","23040","2015",2,2,0,136500,1671.5,90.5
"6384","23041","2015",5,5,0,80177.4,1017.8,78.4
"6385","23042","2015",3,3,0,59056.6666666667,726.666666666667,84.6666666666667
"6386","23043","2015",1,1,0,49481,575,86
"6387","23044","2015",1,1,0,59669,542,110
"6388","23045","2015",8,8,0,55243.75,780.625,75.75
"6389","23046","2015",1,1,0,46000,383,120
"6390","23047","2015",1,1,0,70000,875,80
"6391","23048","2015",6,6,0,105664.166666667,890.666666666667,124.666666666667
"6392","23049","2015",6,6,0,63050,540.166666666667,115.5
"6393","23050","2015",3,3,0,58333.3333333333,932.666666666667,75.6666666666667
"6394","23052","2015",3,3,0,66666.6666666667,720,83.3333333333333
"6395","23054","2015",2,2,0,60000,814.5,78.5
"6396","23056","2015",10,10,0,84035,958,103.9
"6397","23057","2015",7,7,0,62957.1428571429,642.428571428571,97
"6398","23061","2015",6,6,0,60716.6666666667,628,103.666666666667
"6399","23062","2015",4,4,0,65975,691,81.5
"6400","23063","2015",1,1,0,65000,691,94
"6401","23064","2015",7,7,0,73357.1428571429,819.285714285714,83.2857142857143
"6402","23065","2015",3,3,0,101818.333333333,1007.66666666667,101.666666666667
"6403","23067","2015",5,5,0,90240,1105.6,82.2
"6404","23068","2015",3,3,0,56100,421,132
"6405","23069","2015",2,2,0,62500,856.5,71
"6406","23070","2015",5,5,0,85960,1163.8,78.8
"6407","23071","2015",2,2,0,39250,466.5,80
"6408","23072","2015",6,6,0,81748.3333333333,889.166666666667,93
"6409","23074","2015",2,2,0,31000,487.5,69.5
"6410","23075","2015",9,9,0,84666.6666666667,872.555555555556,97.1111111111111
"6411","23076","2015",12,11,1,67041.6666666667,803.5,90.25
"6412","23077","2015",9,9,0,59611.1111111111,720.222222222222,84.1111111111111
"6413","23079","2015",17,16,1,75792.9411764706,840,95.4705882352941
"6414","23080","2015",1,1,0,78520,924,85
"6415","23081","2015",3,3,0,49000,712.333333333333,87.6666666666667
"6416","23083","2015",1,1,0,40000,488,82
"6417","23086","2015",4,4,0,73875,776.5,89.75
"6418","23087","2015",9,9,0,64271.4444444444,928,64.5555555555556
"6419","23088","2015",1,1,0,40000,488,82
"6420","23089","2015",3,2,1,106860,1766.66666666667,55
"6421","23090","2015",4,4,0,75250,658.25,110
"6422","23091","2015",2,2,0,105500,1039,115
"6423","23092","2015",7,7,0,94357.1428571429,808.142857142857,116.285714285714
"6424","23093","2015",10,10,0,79250,963.5,83.8
"6425","23095","2015",11,11,0,85370,819,102.636363636364
"6426","23096","2015",112,76,36,103804.375,1152.15178571429,92.8125
"6427","23097","2015",4,4,0,78500,798.75,96.5
"6428","23099","2015",6,6,0,70129.6666666667,705.333333333333,91.3333333333333
"6429","23100","2015",6,5,1,63516.6666666667,701.5,89.8333333333333
"6430","23101","2015",2,2,0,68500,766,92.5
"6431","23102","2015",5,5,0,93500,1084.6,96.6
"6432","23103","2015",8,8,0,98511.25,978.25,111.875
"6433","23104","2015",6,6,0,58233.3333333333,574.333333333333,102.833333333333
"6434","23105","2015",7,7,0,75785.7142857143,810.142857142857,91
"6435","23106","2015",1,1,0,40000,440,91
"6436","23108","2015",1,1,0,38000,535,71
"6437","23109","2015",4,4,0,81056.75,1252.25,67.25
"6438","23110","2015",1,1,0,175880,1180,149
"6439","23111","2015",2,2,0,78500,607,135
"6440","23112","2015",9,8,1,51055.5555555556,838.666666666667,65.3333333333333
"6441","23113","2015",6,6,0,119716.166666667,924.333333333333,121.5
"6442","23114","2015",2,2,0,62700,722,84
"6443","23115","2015",2,2,0,49000,670,77.5
"6444","23116","2015",1,1,0,37000,974,38
"6445","23117","2015",3,3,0,83666.6666666667,1232,73.6666666666667
"6446","23118","2015",1,1,0,23000,548,42
"6447","23120","2015",3,3,0,104666.666666667,902,129.333333333333
"6448","23123","2015",2,2,0,40000,874.5,49.5
"6449","23124","2015",3,3,0,105166.666666667,995.666666666667,115
"6450","23127","2015",1,1,0,109655,783,140
"6451","23128","2015",3,3,0,51333.3333333333,544,99.3333333333333
"6452","23129","2015",2,2,0,57500,468.5,119.5
"6453","23130","2015",4,4,0,38550,652,63
"6454","23131","2015",5,5,0,93675,1029.6,93
"6455","23132","2015",3,3,0,88533.3333333333,1013,85.6666666666667
"6456","23133","2015",5,5,0,47900,707.8,66.4
"6457","23134","2015",1,1,0,60000,1000,60
"6458","23136","2015",5,5,0,50500,680.4,77
"6459","23137","2015",3,3,0,118333.333333333,1163,89
"6460","23138","2015",1,1,0,6e+05,2098,286
"6461","23139","2015",6,6,0,62433,937.5,69
"6462","23140","2015",3,3,0,103666.666666667,1088.66666666667,94
"6463","23141","2015",7,7,0,67144.2857142857,1061.14285714286,74.7142857142857
"6464","23142","2015",2,2,0,80500,671.5,118
"6465","23143","2015",3,3,0,94000,984,98.3333333333333
"6466","23144","2015",5,5,0,64800,777,79.8
"6467","23145","2015",1,1,0,63534,629,101
"6468","23146","2015",7,7,0,69000,873.142857142857,93.4285714285714
"6469","23147","2015",1,1,0,56000,1217,46
"6470","23148","2015",4,4,0,59000,775.25,81.75
"6471","23149","2015",8,8,0,83730.125,1043.375,81.375
"6472","23150","2015",3,3,0,108566.666666667,1166.66666666667,91
"6473","23151","2015",2,2,0,61500,778.5,80
"6474","23152","2015",1,1,0,43000,672,64
"6475","23154","2015",10,10,0,79997,842.4,96.1
"6476","23155","2015",2,2,0,99500,771,109
"6477","23157","2015",1,1,0,68500,856,80
"6478","23159","2015",1,1,0,52000,693,75
"6479","23160","2015",3,3,0,44066.6666666667,554,82
"6480","23162","2015",1,1,0,169850,1231,138
"6481","23165","2015",13,13,0,71205,1216.30769230769,62.6153846153846
"6482","23166","2015",1,1,0,16000,348,46
"6483","23167","2015",5,5,0,45200,621.8,73.4
"6484","23168","2015",6,5,1,82044.3333333333,772.166666666667,104.333333333333
"6485","23169","2015",4,4,0,131750,1098,127.25
"6486","23170","2015",1,1,0,58000,725,80
"6487","23172","2015",1,1,0,80000,1143,70
"6488","23173","2015",1,1,0,21500,347,62
"6489","23174","2015",5,5,0,80400,1173.2,76.2
"6490","23175","2015",2,2,0,94250,1707.5,60.5
"6491","23176","2015",50,47,3,90873.34,874.98,103.64
"6492","23177","2015",11,11,0,96072.7272727273,926.272727272727,107.363636363636
"6493","23178","2015",3,3,0,81000,844.666666666667,93.3333333333333
"6494","23179","2015",3,3,0,109666.666666667,1125.33333333333,100.666666666667
"6495","23180","2015",1,1,0,99000,1100,90
"6496","23181","2015",2,2,0,43250,503,88.5
"6497","23182","2015",2,2,0,204750,1090.5,169.5
"6498","23183","2015",2,2,0,115600,1120,107.5
"6499","23184","2015",1,1,0,37000,394,94
"6500","23185","2015",3,3,0,102222.333333333,914.666666666667,112.333333333333
"6501","23188","2015",2,2,0,89900,707,115
"6502","23189","2015",17,17,0,76057.6470588235,854.117647058824,87.4705882352941
"6503","23190","2015",3,3,0,71000,602.333333333333,116.666666666667
"6504","23191","2015",1,1,0,18000,643,28
"6505","23192","2015",14,13,1,88164.2857142857,1008.92857142857,83.7142857142857
"6506","23193","2015",22,22,0,116044.772727273,1041.45454545455,107.227272727273
"6507","23194","2015",2,2,0,57550,641.5,87
"6508","23195","2015",6,6,0,92686.5,979,90.1666666666667
"6509","23196","2015",1,1,0,63000,450,140
"6510","23197","2015",2,2,0,68750,498,139.5
"6511","23198","2015",1,1,0,21000,1167,18
"6512","23199","2015",2,2,0,68049,611,102.5
"6513","23200","2015",6,6,0,60239.8333333333,680.166666666667,90.5
"6514","23201","2015",5,5,0,50400,720.8,78.2
"6515","23202","2015",3,3,0,91666.6666666667,1348.66666666667,63.3333333333333
"6516","23203","2015",2,2,0,45350,663,70
"6517","23205","2015",2,2,0,82000,1150.5,70.5
"6518","23206","2015",3,3,0,145400,1379.66666666667,108
"6519","23207","2015",2,2,0,72500,519.5,138
"6520","23208","2015",2,2,0,36250,592,62
"6521","23209","2015",1,1,0,45000,536,84
"6522","23210","2015",3,2,1,96000,1123,83
"6523","23211","2015",6,6,0,98583.3333333333,1049.66666666667,95.1666666666667
"6524","23212","2015",3,3,0,84320,875,96.3333333333333
"6525","23213","2015",3,3,0,55000,658,92.3333333333333
"6526","23214","2015",3,3,0,126666.666666667,1217,101.333333333333
"6527","23215","2015",1,1,0,55000,632,87
"6528","23216","2015",3,3,0,40833.3333333333,868,50.6666666666667
"6529","23217","2015",3,3,0,62333.3333333333,656.666666666667,96
"6530","23219","2015",17,17,0,79102.9411764706,872.352941176471,94.5882352941177
"6531","23220","2015",5,5,0,57680,540,101.6
"6532","23221","2015",1,1,0,45000,375,120
"6533","23222","2015",2,2,0,77500,898,102
"6534","23223","2015",2,2,0,23750,465.5,52.5
"6535","23224","2015",2,2,0,35000,450,83
"6536","23225","2015",2,2,0,86128,806.5,112
"6537","23227","2015",3,3,0,109446.666666667,980,108.666666666667
"6538","23228","2015",3,3,0,1e+05,867.333333333333,138.666666666667
"6539","23229","2015",4,4,0,75950,890.75,79.25
"6540","23230","2015",2,2,0,66250,716.5,95
"6541","23232","2015",3,3,0,50833.3333333333,639,81
"6542","23233","2015",1,1,0,92000,807,114
"6543","23234","2015",2,2,0,109000,961,112.5
"6544","23235","2015",2,2,0,180000,866.5,209
"6545","23236","2015",1,1,0,90000,833,108
"6546","23237","2015",1,1,0,50000,500,100
"6547","23238","2015",6,6,0,98083.3333333333,1195.83333333333,89.3333333333333
"6548","23239","2015",11,11,0,58500,752.090909090909,79.6363636363636
"6549","23240","2015",4,4,0,61875,899,69
"6550","23241","2015",2,2,0,38500,429,90
"6551","23242","2015",1,1,0,77000,546,141
"6552","23243","2015",4,4,0,133475,1009,118.5
"6553","23244","2015",8,8,0,56043.75,823.5,65.625
"6554","23245","2015",13,13,0,108741.923076923,1061.07692307692,103.076923076923
"6555","23246","2015",3,3,0,99586.6666666667,1153,101.333333333333
"6556","23247","2015",10,10,0,78870,745.6,113
"6557","23248","2015",2,2,0,198500,1229.5,159
"6558","23249","2015",4,4,0,70750,747.75,93.25
"6559","23250","2015",7,7,0,88107.1428571429,1045.28571428571,91.4285714285714
"6560","23252","2015",3,3,0,56666.6666666667,580.333333333333,105
"6561","23253","2015",2,2,0,41750,413,92.5
"6562","23254","2015",5,5,0,103968.2,1294,87.6
"6563","23255","2015",2,2,0,43500,838,52
"6564","23257","2015",7,7,0,80724.7142857143,881.142857142857,98.1428571428571
"6565","23258","2015",6,6,0,70321.6666666667,728.5,91.6666666666667
"6566","23259","2015",1,1,0,27000,519,52
"6567","23260","2015",7,7,0,45785.7142857143,610.428571428571,74.8571428571429
"6568","23261","2015",2,2,0,45000,913,49.5
"6569","23263","2015",2,2,0,96950,1047.5,83
"6570","23266","2015",2,2,0,77000,739,103
"6571","24001","2015",8,8,0,121835,1346.625,104
"6572","24002","2015",13,13,0,117469.461538462,1237.76923076923,99.6923076923077
"6573","24004","2015",3,3,0,145000,898,145.666666666667
"6574","24005","2015",9,9,0,162543.888888889,1179.11111111111,129.777777777778
"6575","24006","2015",5,5,0,213320,1612.8,135.2
"6576","24007","2015",6,6,0,147598.333333333,1305.16666666667,106.5
"6577","24008","2015",7,7,0,76785.7142857143,1015.85714285714,74.7142857142857
"6578","24009","2015",4,4,0,118125,1200.75,88.5
"6579","24010","2015",13,13,0,123519.230769231,1325.07692307692,92
"6580","24011","2015",10,9,1,124680,1571.3,79.7
"6581","24012","2015",3,3,0,253000,1991,123.666666666667
"6582","24014","2015",6,6,0,288768.666666667,2412.66666666667,122
"6583","24015","2015",1,1,0,1e+05,1389,72
"6584","24016","2015",11,11,0,124611.363636364,1216.36363636364,103.636363636364
"6585","24018","2015",1,1,0,142500,2457,58
"6586","24019","2015",2,2,0,171000,2094,81
"6587","24020","2015",11,11,0,107415.454545455,1214.63636363636,86.8181818181818
"6588","24021","2015",5,5,0,77016.4,953.2,80
"6589","24022","2015",2,2,0,265000,2282,116
"6590","24023","2015",3,3,0,194333.333333333,1924,102
"6591","24025","2015",1,1,0,171900,1398,123
"6592","24026","2015",37,37,0,159799.513513514,1432.83783783784,113.378378378378
"6593","24027","2015",4,4,0,141250,1371.25,106.25
"6594","24028","2015",14,14,0,147739.214285714,1310,120.857142857143
"6595","24029","2015",3,3,0,152066.666666667,1259.33333333333,110.666666666667
"6596","24030","2015",7,7,0,115891.428571429,1270.28571428571,97.8571428571429
"6597","24032","2015",5,5,0,94700,933.4,103.4
"6598","24035","2015",16,15,1,100127.8125,993.3125,102.4375
"6599","24036","2015",3,3,0,128500,1659,77.6666666666667
"6600","24037","2015",361,281,80,119638.745152355,1409.45706371191,85.9168975069252
"6601","24038","2015",3,3,0,143016.666666667,1861.66666666667,81.3333333333333
"6602","24039","2015",2,2,0,208550,2129.5,93
"6603","24040","2015",5,4,1,308856,3386,97.8
"6604","24042","2015",6,6,0,85446.6666666667,1082.33333333333,79.8333333333333
"6605","24043","2015",2,2,0,115750,961,122.5
"6606","24045","2015",1,1,0,120600,1171,103
"6607","24046","2015",2,2,0,137500,1366.5,103.5
"6608","24048","2015",1,1,0,125000,1250,100
"6609","24050","2015",3,3,0,231666.666666667,2284.66666666667,103.333333333333
"6610","24051","2015",1,1,0,60000,857,70
"6611","24052","2015",1,1,0,203000,906,224
"6612","24053","2015",93,78,15,147761.612903226,1559.35483870968,94.6451612903226
"6613","24054","2015",4,4,0,134168.75,1186.5,121.5
"6614","24055","2015",5,5,0,177460,1383.4,122.2
"6615","24056","2015",3,3,0,106166.666666667,1277,98
"6616","24058","2015",1,1,0,30000,517,58
"6617","24059","2015",5,5,0,103600,1386,72.8
"6618","24060","2015",1,1,0,350000,1786,196
"6619","24061","2015",3,3,0,132083.333333333,921,157.666666666667
"6620","24062","2015",11,11,0,122502.181818182,1199.90909090909,104.090909090909
"6621","24063","2015",2,2,0,121000,1078,105
"6622","24064","2015",37,37,0,131369.486486486,1246.08108108108,105.837837837838
"6623","24066","2015",4,4,0,100875,1080.25,94.5
"6624","24067","2015",27,26,1,142903.703703704,1390.66666666667,103.222222222222
"6625","24068","2015",31,30,1,124230.290322581,1316.29032258065,92.2258064516129
"6626","24069","2015",4,4,0,106000,1216,85.25
"6627","24070","2015",5,5,0,98376,932,94.2
"6628","24071","2015",9,9,0,110598.333333333,928.777777777778,131
"6629","24073","2015",4,4,0,127000,1370.5,97.75
"6630","24074","2015",2,2,0,2e+05,1693,110
"6631","24075","2015",3,3,0,236666.666666667,2635,91
"6632","24076","2015",5,5,0,216158,1883.2,117.8
"6633","24080","2015",3,3,0,79000,1351.33333333333,62.6666666666667
"6634","24081","2015",7,6,1,169021.285714286,2073,95.1428571428571
"6635","24082","2015",11,11,0,217480.363636364,1881.18181818182,114.454545454545
"6636","24084","2015",4,4,0,206050,1680.25,139
"6637","24086","2015",6,6,0,213889.833333333,1847.33333333333,111.833333333333
"6638","24087","2015",9,9,0,168790,1291.77777777778,134.222222222222
"6639","24088","2015",3,3,0,204333.333333333,2719,92.6666666666667
"6640","24090","2015",4,4,0,90711.25,1240,88.75
"6641","24091","2015",10,10,0,208800,1930.6,112.7
"6642","24094","2015",3,3,0,95000,1314,67
"6643","24096","2015",2,2,0,128500,1404.5,91.5
"6644","24097","2015",7,7,0,119070.714285714,1261.28571428571,95.1428571428571
"6645","24098","2015",25,25,0,171582,1633.2,105.96
"6646","24100","2015",4,4,0,113985,1007.5,115.25
"6647","24101","2015",7,7,0,148302.428571429,1188.42857142857,116.142857142857
"6648","24102","2015",44,44,0,149674.954545455,1530.06818181818,99.5681818181818
"6649","24104","2015",4,4,0,165750,1084.5,154.75
"6650","24105","2015",1,1,0,160000,1260,127
"6651","24106","2015",2,2,0,180500,1566,112
"6652","24107","2015",3,3,0,136950,1336.66666666667,100
"6653","24108","2015",10,10,0,198870,1659.9,119
"6654","24109","2015",1,1,0,77000,975,79
"6655","24110","2015",1,1,0,70000,673,104
"6656","24111","2015",1,1,0,136000,2833,48
"6657","24113","2015",1,1,0,220000,1438,153
"6658","24115","2015",15,15,0,104626.666666667,1092.46666666667,96.7333333333333
"6659","24116","2015",2,2,0,91297.5,735.5,123
"6660","24117","2015",5,5,0,146574.6,1348.8,109
"6661","24119","2015",6,6,0,123325,1119.33333333333,107.5
"6662","24120","2015",10,10,0,125694.5,1353.2,103.7
"6663","24121","2015",1,1,0,185000,925,200
"6664","24124","2015",3,3,0,95744,1202,91
"6665","24126","2015",2,2,0,107100,979,112.5
"6666","24129","2015",3,3,0,122666.666666667,948.333333333333,137.333333333333
"6667","24130","2015",4,4,0,60250,732.75,90.5
"6668","24132","2015",1,1,0,182500,1404,130
"6669","24134","2015",10,10,0,91600,1022.6,89.3
"6670","24135","2015",5,5,0,159200,1623.8,100
"6671","24136","2015",1,1,0,398000,1272,313
"6672","24137","2015",7,7,0,122048.571428571,1257.14285714286,98.7142857142857
"6673","24138","2015",74,68,6,129358.256756757,1435.63513513514,90.2837837837838
"6674","24139","2015",22,22,0,152335.454545455,1492.40909090909,106.318181818182
"6675","24140","2015",8,8,0,145928.5,1253.375,109.125
"6676","24141","2015",3,3,0,253333.333333333,1541.66666666667,157.333333333333
"6677","24142","2015",16,16,0,151067.1875,1435.3125,104.5625
"6678","24143","2015",8,8,0,129095.625,1595.625,84.25
"6679","24145","2015",18,18,0,120433.333333333,1360.22222222222,86.3888888888889
"6680","24146","2015",1,1,0,186000,1114,167
"6681","24147","2015",10,10,0,145855,1242.6,110.1
"6682","24148","2015",4,4,0,117000,939.5,115
"6683","24150","2015",15,14,1,191914,1502,122.6
"6684","24151","2015",1,1,0,135000,2250,60
"6685","24152","2015",10,10,0,201362.5,1886.5,95.3
"6686","24153","2015",4,4,0,143350,1305,114
"6687","24154","2015",6,6,0,105230,895.666666666667,122.166666666667
"6688","24156","2015",6,6,0,124966.666666667,1216.83333333333,101.833333333333
"6689","24157","2015",7,7,0,92500,1076.42857142857,83.4285714285714
"6690","24158","2015",4,4,0,66087.5,941,69.75
"6691","24159","2015",6,6,0,78207.3333333333,824,95
"6692","24160","2015",2,2,0,183500,1473.5,124.5
"6693","24162","2015",4,4,0,164150,1711.75,96.75
"6694","24163","2015",1,1,0,120000,1500,80
"6695","24164","2015",10,9,1,114500,1602.8,75.1
"6696","24165","2015",3,3,0,142333.333333333,1058.66666666667,139
"6697","24167","2015",34,33,1,127970.588235294,1117.79411764706,115.117647058824
"6698","24168","2015",4,4,0,211392.75,1303.75,146.5
"6699","24171","2015",6,6,0,92000,1142.83333333333,84.3333333333333
"6700","24172","2015",10,9,1,129596.3,1483.1,85.4
"6701","24175","2015",3,3,0,126500,1202.33333333333,105.333333333333
"6702","24177","2015",10,10,0,137030.5,1010.4,132.2
"6703","24179","2015",7,7,0,171357.142857143,1395.85714285714,120.428571428571
"6704","24182","2015",18,18,0,106575,1119.38888888889,97.3333333333333
"6705","24183","2015",4,4,0,239657.5,1894.5,112.75
"6706","24184","2015",3,3,0,136043.333333333,1801.33333333333,81.3333333333333
"6707","24186","2015",3,3,0,258973.333333333,1392.33333333333,184.666666666667
"6708","24188","2015",5,5,0,83400,1019.2,82.2
"6709","24189","2015",3,3,0,154800,1217.66666666667,127
"6710","24190","2015",2,2,0,242500,4594,60
"6711","24191","2015",1,1,0,91500,1173,78
"6712","24192","2015",1,1,0,184000,1533,120
"6713","24194","2015",15,15,0,97283.3333333333,1091.13333333333,90.4
"6714","24195","2015",1,1,0,59000,983,60
"6715","24196","2015",6,6,0,97283.3333333333,1012.83333333333,102.833333333333
"6716","24197","2015",2,2,0,88700,770,118
"6717","24199","2015",1,1,0,220000,1294,170
"6718","24200","2015",3,3,0,109050,1425.66666666667,89.6666666666667
"6719","24202","2015",1,1,0,240000,1846,130
"6720","24205","2015",6,6,0,149833.333333333,1165.83333333333,127.5
"6721","24206","2015",1,1,0,145000,1611,90
"6722","24207","2015",8,8,0,170375,1669.625,100.375
"6723","24208","2015",4,4,0,99150,1221.75,89.25
"6724","24210","2015",15,15,0,108776.666666667,1116.13333333333,102.666666666667
"6725","24212","2015",21,20,1,134358.571428571,1246.42857142857,110.142857142857
"6726","24213","2015",1,1,0,210000,1458,144
"6727","24214","2015",4,4,0,94575,670.5,130.25
"6728","24215","2015",1,1,0,168000,1175,143
"6729","24217","2015",2,2,0,162697.5,1768,89
"6730","24218","2015",15,15,0,71400,967.866666666667,80.9333333333333
"6731","24220","2015",5,5,0,163270,1415.2,133
"6732","24222","2015",20,20,0,135485,1300.5,108.85
"6733","24223","2015",34,33,1,129765.205882353,1322.5,100.970588235294
"6734","24224","2015",6,6,0,198083.333333333,1304.16666666667,170.166666666667
"6735","24225","2015",23,23,0,148393.260869565,1392.47826086957,108.347826086957
"6736","24226","2015",23,23,0,128776.52173913,1155.34782608696,111.173913043478
"6737","24227","2015",7,7,0,135191.428571429,1099.42857142857,113.571428571429
"6738","24228","2015",4,4,0,128500,1227.5,100.5
"6739","24229","2015",15,15,0,88651.3333333333,992.8,97.1333333333333
"6740","24230","2015",2,2,0,217540,2068,101
"6741","24232","2015",2,2,0,108500,1127,103
"6742","24234","2015",6,6,0,134550,1313,104.666666666667
"6743","24236","2015",11,11,0,103117.090909091,1048.63636363636,100
"6744","24237","2015",11,11,0,154918.181818182,1446.63636363636,103.363636363636
"6745","24238","2015",2,2,0,102500,988.5,100
"6746","24240","2015",2,2,0,208500,2146.5,96.5
"6747","24241","2015",5,5,0,113400,1132.8,99.2
"6748","24242","2015",3,3,0,176580,1801.66666666667,93.6666666666667
"6749","24243","2015",10,10,0,105100,1045,101.5
"6750","24244","2015",3,3,0,120000,1038.66666666667,106
"6751","24245","2015",4,3,1,154500,1220.75,123.5
"6752","24246","2015",1,1,0,166000,1203,138
"6753","24247","2015",3,2,1,108666.666666667,1573,76.6666666666667
"6754","24248","2015",1,1,0,40000,400,100
"6755","24251","2015",3,3,0,204666.666666667,1614.66666666667,115
"6756","24252","2015",4,4,0,194000,1723.25,116.25
"6757","24253","2015",20,20,0,124990.15,943.7,129.5
"6758","24254","2015",2,2,0,158250,1299.5,125.5
"6759","24255","2015",4,4,0,233500,1792.25,111.75
"6760","24256","2015",45,45,0,144573.333333333,1450.51111111111,100.044444444444
"6761","24257","2015",2,2,0,175850,1554,114
"6762","24260","2015",7,7,0,149285.714285714,1887.85714285714,88
"6763","24261","2015",1,1,0,96000,1524,63
"6764","24262","2015",2,2,0,82500,979,85
"6765","24263","2015",1,1,0,46000,1095,42
"6766","24264","2015",19,19,0,106145.263157895,1342.42105263158,84.1578947368421
"6767","24266","2015",15,15,0,107562.466666667,1073.46666666667,99.4666666666667
"6768","24268","2015",10,10,0,197304.5,2061.1,111.8
"6769","24269","2015",10,8,2,76750,1052.6,74.9
"6770","24271","2015",5,5,0,106580,1148.6,93.2
"6771","24272","2015",6,6,0,100750,1083.5,103.166666666667
"6772","24273","2015",3,3,0,141666.666666667,1415.66666666667,106.333333333333
"6773","24274","2015",6,6,0,200333.333333333,1277.5,141.166666666667
"6774","24277","2015",5,5,0,105400,1213.4,84
"6775","24278","2015",1,1,0,150000,1429,105
"6776","24280","2015",8,8,0,168162.5,1721.75,99
"6777","24281","2015",1,1,0,130000,1226,106
"6778","24282","2015",1,1,0,335000,1196,280
"6779","24286","2015",5,5,0,115960,1006,116.4
"6780","24288","2015",3,3,0,268333.333333333,1768.33333333333,160.333333333333
"6781","24289","2015",16,16,0,148565.625,1279.5625,120.5
"6782","24290","2015",3,3,0,171666.666666667,1405.66666666667,135
"6783","24291","2015",20,20,0,120350,1413.3,85.8
"6784","24292","2015",5,5,0,133236,1267.2,104
"6785","24294","2015",75,74,1,109789.866666667,1185.69333333333,94.3333333333333
"6786","24295","2015",8,8,0,123882.5,1526.375,80
"6787","24296","2015",13,12,1,118355.307692308,1262.46153846154,92.2307692307692
"6788","24297","2015",12,12,0,110414.166666667,1310.33333333333,86.3333333333333
"6789","24299","2015",37,35,2,99563.4594594595,1029.05405405405,104.351351351351
"6790","24300","2015",3,3,0,293806.333333333,2052.66666666667,139.333333333333
"6791","24301","2015",6,6,0,81966.6666666667,1068,75.1666666666667
"6792","24302","2015",6,6,0,92686.6666666667,1308.33333333333,78.3333333333333
"6793","24303","2015",4,4,0,185652.5,1707,111.25
"6794","24304","2015",8,8,0,113406.25,1102.125,110.125
"6795","24306","2015",1,1,0,191000,1736,110
"6796","24307","2015",2,2,0,31000,404.5,75
"6797","24308","2015",6,6,0,138500,1326,100
"6798","24309","2015",25,23,2,104202.8,1162.64,93.6
"6799","24311","2015",32,31,1,110088.84375,1109.875,98.8125
"6800","24312","2015",42,39,3,137828.5,1537.66666666667,90.5476190476191
"6801","24316","2015",6,6,0,91333.3333333333,777,99.6666666666667
"6802","24318","2015",2,2,0,135000,2090.5,65
"6803","24319","2015",7,7,0,100757.142857143,1011.14285714286,105.857142857143
"6804","24320","2015",13,13,0,104753.846153846,1388.23076923077,76.2307692307692
"6805","24322","2015",431,195,236,114320.795823666,1485.04408352668,79.262180974478
"6806","24323","2015",2,2,0,77500,640,121
"6807","24324","2015",4,4,0,112100,1230.25,96.75
"6808","24325","2015",9,9,0,175598.888888889,1543.88888888889,113.666666666667
"6809","24326","2015",1,1,0,4e+05,2286,175
"6810","24327","2015",3,3,0,333163.666666667,1349.66666666667,216.666666666667
"6811","24328","2015",16,16,0,117460.625,1132.5,99
"6812","24329","2015",13,13,0,98456.9230769231,1043.46153846154,93.5384615384615
"6813","24330","2015",8,8,0,142812.5,1679.25,101.75
"6814","24335","2015",24,24,0,119990.041666667,1122.125,104.458333333333
"6815","24336","2015",2,2,0,315945,2176.5,139
"6816","24338","2015",9,9,0,173839.444444444,1127.77777777778,128.111111111111
"6817","24340","2015",38,38,0,132150,1375,95.9210526315789
"6818","24341","2015",7,7,0,238259.285714286,2202.28571428571,118.142857142857
"6819","24345","2015",8,8,0,181493.75,1406.25,127.625
"6820","24346","2015",1,1,0,215000,1303,165
"6821","24348","2015",6,6,0,93933.3333333333,1037.5,94.6666666666667
"6822","24350","2015",21,21,0,123688.571428571,1289.80952380952,96.4761904761905
"6823","24352","2015",30,30,0,105901.333333333,1180.46666666667,93.9666666666667
"6824","24353","2015",10,10,0,102235.5,1142.5,99.6
"6825","24354","2015",25,24,1,114995.8,1226.84,100.44
"6826","24355","2015",8,8,0,221625,1854.5,116.875
"6827","24356","2015",13,13,0,162606.846153846,1902.92307692308,92.1538461538462
"6828","24360","2015",1,1,0,98000,1400,70
"6829","24361","2015",7,7,0,126140,1312.85714285714,98.2857142857143
"6830","24362","2015",13,13,0,216797.692307692,1587.23076923077,124
"6831","24364","2015",2,2,0,115900,1175.5,110
"6832","24365","2015",3,3,0,169333.333333333,1130.33333333333,149
"6833","24366","2015",6,6,0,272758.333333333,1783,147.333333333333
"6834","24367","2015",1,1,0,1e+05,1250,80
"6835","24370","2015",13,13,0,161146.153846154,1815.69230769231,95.6153846153846
"6836","24371","2015",7,7,0,102858.571428571,1270.14285714286,83.7142857142857
"6837","24372","2015",52,46,6,120365.576923077,1238.05769230769,97.7307692307692
"6838","24373","2015",7,7,0,236767.142857143,1446.57142857143,163.285714285714
"6839","24374","2015",7,7,0,184805.714285714,1342.14285714286,140.857142857143
"6840","24375","2015",1,1,0,660000,3511,188
"6841","24376","2015",21,21,0,113404.761904762,1085.2380952381,107.761904761905
"6842","24378","2015",1,1,0,43500,989,44
"6843","24379","2015",4,4,0,122625,1479.5,85.75
"6844","24380","2015",4,4,0,121000,1061.5,109.5
"6845","24381","2015",4,4,0,109000,1209.75,87
"6846","24382","2015",8,6,2,146200,1371.25,103.875
"6847","24386","2015",3,3,0,99333.3333333333,1110,74
"6848","24388","2015",9,9,0,236700,1662.66666666667,124.333333333333
"6849","24390","2015",1,1,0,130830,1504,87
"6850","24392","2015",3,3,0,184666.666666667,1900.66666666667,101
"6851","24393","2015",3,3,0,120666.666666667,1411.66666666667,85.3333333333333
"6852","24395","2015",4,4,0,178750,1852.75,101.75
"6853","24396","2015",19,18,1,136052.631578947,1649.36842105263,81.7368421052632
"6854","24397","2015",3,3,0,59416.6666666667,1118,64.6666666666667
"6855","24398","2015",7,6,1,79890,955.285714285714,77
"6856","24399","2015",1,1,0,137000,1142,120
"6857","24401","2015",6,6,0,88416.6666666667,946.666666666667,92.6666666666667
"6858","24403","2015",1,1,0,280000,1290,217
"6859","24405","2015",2,2,0,232500,1344,148.5
"6860","24406","2015",1,1,0,150000,721,208
"6861","24407","2015",3,3,0,292500,2679.66666666667,105.666666666667
"6862","24408","2015",2,2,0,92500,817.5,112.5
"6863","24409","2015",10,10,0,109850,1122.9,96.7
"6864","24410","2015",7,7,0,76657.1428571429,791.857142857143,93.2857142857143
"6865","24411","2015",1,1,0,168000,832,202
"6866","24412","2015",5,3,2,147567.4,2007.2,68.8
"6867","24413","2015",3,3,0,118383.333333333,1363.33333333333,88.3333333333333
"6868","24415","2015",3,3,0,126166.666666667,1197.33333333333,105
"6869","24416","2015",5,5,0,234100,1520.8,155
"6870","24417","2015",6,6,0,135383.333333333,1204.16666666667,120
"6871","24418","2015",8,8,0,99500,1166.125,85.125
"6872","24419","2015",6,6,0,168913.333333333,1568.33333333333,101.666666666667
"6873","24420","2015",2,2,0,155000,1398.5,112.5
"6874","24421","2015",1,1,0,161000,2012,80
"6875","24423","2015",2,2,0,473500,1795.5,263
"6876","24424","2015",2,2,0,175000,1619.5,112.5
"6877","24425","2015",8,8,0,205562.5,1618.875,123
"6878","24429","2015",1,1,0,170000,1518,112
"6879","24432","2015",6,6,0,188283.333333333,1655.33333333333,117.666666666667
"6880","24436","2015",12,12,0,109768.333333333,1012.41666666667,107
"6881","24437","2015",7,7,0,170030,1290.14285714286,137.857142857143
"6882","24441","2015",3,3,0,111166.666666667,1364,105
"6883","24442","2015",17,16,1,129411.764705882,1289.58823529412,97.8823529411765
"6884","24443","2015",12,12,0,168711.666666667,1638.33333333333,111.166666666667
"6885","24444","2015",1,1,0,150000,1027,146
"6886","24445","2015",1,1,0,595707,13238,45
"6887","24448","2015",5,5,0,147544.8,1505.2,101.6
"6888","24449","2015",10,10,0,121311,1076.2,113.6
"6889","24450","2015",6,6,0,148750,1714,97.1666666666667
"6890","24451","2015",4,4,0,75530,945.75,87.5
"6891","24452","2015",1,1,0,250000,1543,162
"6892","24453","2015",5,5,0,95100,1250,79.8
"6893","24454","2015",5,5,0,145200,1098.6,131.8
"6894","24455","2015",5,5,0,98494,787.8,116
"6895","24457","2015",1,1,0,150000,1923,78
"6896","24458","2015",3,3,0,159666.666666667,1291.33333333333,126
"6897","24459","2015",1,1,0,472500,3214,147
"6898","24460","2015",4,4,0,102000,958.25,105
"6899","24461","2015",11,11,0,101095.454545455,1029,93.8181818181818
"6900","24462","2015",14,13,1,110989.285714286,1294.28571428571,92.1428571428571
"6901","24463","2015",6,6,0,133666.666666667,1298.5,102
"6902","24464","2015",2,2,0,45000,643,71
"6903","24465","2015",3,3,0,84666.6666666667,820,111.666666666667
"6904","24466","2015",1,1,0,285500,1393,205
"6905","24468","2015",2,2,0,99000,1377,70.5
"6906","24470","2015",1,1,0,190000,1016,187
"6907","24471","2015",5,5,0,290200,2115.4,136.2
"6908","24472","2015",7,7,0,205000,1352.57142857143,151.285714285714
"6909","24473","2015",6,6,0,99666.6666666667,1037.66666666667,95.6666666666667
"6910","24477","2015",3,3,0,106333.333333333,1364.33333333333,84
"6911","24479","2015",21,21,0,89011.4285714286,978.190476190476,95.3333333333333
"6912","24480","2015",1,1,0,106000,1631,65
"6913","24482","2015",6,6,0,129505,999.833333333333,135.666666666667
"6914","24484","2015",7,7,0,98857.1428571429,1052.14285714286,113.857142857143
"6915","24485","2015",10,10,0,82800,1034.5,80.9
"6916","24487","2015",26,26,0,115678.846153846,1266.23076923077,92.3076923076923
"6917","24488","2015",7,7,0,175712.142857143,1508.57142857143,116.428571428571
"6918","24491","2015",11,11,0,116513.636363636,1743.63636363636,70.6363636363636
"6919","24493","2015",3,3,0,142133.333333333,1293.66666666667,130.666666666667
"6920","24494","2015",4,4,0,242962.5,1535.25,155
"6921","24495","2015",1,1,0,85000,867,98
"6922","24496","2015",1,1,0,153000,1142,134
"6923","24498","2015",10,10,0,127870,1409.4,88.1
"6924","24499","2015",6,6,0,156875,1611.83333333333,93.8333333333333
"6925","24501","2015",4,4,0,146750,1118,142.5
"6926","24502","2015",2,2,0,153230,989.5,156.5
"6927","24504","2015",3,3,0,139000,1236.33333333333,117
"6928","24505","2015",5,5,0,173562,1411.6,122.8
"6929","24507","2015",1,1,0,137300,1716,80
"6930","24508","2015",4,4,0,160457.25,1255.25,122.25
"6931","24509","2015",3,3,0,65333.3333333333,901,82
"6932","24510","2015",3,3,0,158666.666666667,1790,90
"6933","24512","2015",2,2,0,220015,1848,123.5
"6934","24513","2015",4,4,0,83750,864,109.75
"6935","24514","2015",2,2,0,121000,922.5,120
"6936","24515","2015",3,3,0,80000,1304.66666666667,61.3333333333333
"6937","24516","2015",12,11,1,124704.416666667,1362.41666666667,99.6666666666667
"6938","24518","2015",1,1,0,132000,880,150
"6939","24519","2015",10,10,0,101190,1323.4,80.1
"6940","24520","2015",97,68,29,149011.484536082,1733.87628865979,86.5670103092783
"6941","24521","2015",6,6,0,136362.5,1183.5,114.166666666667
"6942","24522","2015",5,4,1,98200,1273.8,73
"6943","24525","2015",3,3,0,86700,1267.66666666667,71
"6944","24526","2015",10,10,0,89200,1296.2,71.5
"6945","24527","2015",9,9,0,163361.555555556,1052.88888888889,148.888888888889
"6946","24528","2015",1,1,0,31000,620,50
"6947","24529","2015",1,1,0,70000,579,121
"6948","24532","2015",3,3,0,188500,1339.33333333333,125.666666666667
"6949","24534","2015",1,1,0,526253,3759,140
"6950","24535","2015",2,2,0,283835,1750.5,160.5
"6951","24536","2015",1,1,0,130000,1313,99
"6952","24537","2015",2,2,0,95000,616.5,152.5
"6953","24538","2015",9,9,0,164333.333333333,1217.22222222222,127.777777777778
"6954","24540","2015",17,17,0,124994.117647059,1391,94.4117647058823
"6955","24542","2015",1,1,0,128000,1255,102
"6956","24543","2015",14,14,0,97244.1428571429,1011.35714285714,93.6428571428571
"6957","24546","2015",1,1,0,50000,500,100
"6958","24547","2015",59,39,20,111855.525423729,1990.10169491525,77.1525423728814
"6959","24548","2015",6,6,0,118969.833333333,1216.5,99
"6960","24550","2015",8,8,0,127187.5,1173.875,121.25
"6961","24551","2015",22,21,1,92568.1818181818,982.590909090909,91.0454545454545
"6962","24552","2015",2,2,0,104000,2889,38.5
"6963","24553","2015",23,23,0,121966.956521739,1202.4347826087,99.6521739130435
"6964","24554","2015",5,5,0,147821.4,1010.4,149.6
"6965","24555","2015",12,12,0,90611.25,944.666666666667,99.0833333333333
"6966","24557","2015",68,56,12,132000.735294118,1409.80882352941,92.0735294117647
"6967","24558","2015",4,4,0,297602.5,1860,168.25
"6968","24559","2015",6,6,0,303980.833333333,2854.66666666667,114.666666666667
"6969","24562","2015",2,2,0,135250,1181,123
"6970","24563","2015",2,2,0,132500,1629,83
"6971","24564","2015",5,5,0,119188.8,959.6,138.4
"6972","24565","2015",4,4,0,97525,1013,95.25
"6973","24566","2015",1,1,0,70000,1077,65
"6974","24567","2015",1,1,0,108000,1049,103
"6975","24568","2015",6,6,0,103418.333333333,916.833333333333,119.5
"6976","24569","2015",3,3,0,93933.3333333333,1032.33333333333,100
"6977","24570","2015",1,1,0,95000,1173,81
"6978","24571","2015",9,9,0,90222.2222222222,866.777777777778,103.444444444444
"6979","24573","2015",13,13,0,83073.0769230769,819.923076923077,113.461538461538
"6980","24574","2015",4,4,0,306500,2109.5,112.5
"6981","24575","2015",3,3,0,232196.666666667,1781,132.333333333333
"6982","24576","2015",2,2,0,161000,1718,93
"6983","24577","2015",3,3,0,213766.666666667,2010.33333333333,103
"6984","24580","2015",4,4,0,109000,1055.25,100
"6985","24582","2015",3,3,0,84233.3333333333,831.333333333333,91.6666666666667
"6986","24584","2015",9,9,0,115344.444444444,1274.11111111111,92.2222222222222
"6987","24585","2015",6,6,0,122166.666666667,1137,109.833333333333
"6988","24586","2015",7,7,0,114224.285714286,1065.71428571429,114
"6989","24587","2015",12,11,1,236320.416666667,2064.83333333333,123.916666666667
"6990","25001","2015",1,1,0,217000,2067,105
"6991","25002","2015",2,2,0,2e+05,1452.5,127.5
"6992","25003","2015",4,2,2,91500,1032,89
"6993","25004","2015",10,9,1,158925,1377.8,114.3
"6994","25008","2015",4,4,0,104232.5,1175,90.75
"6995","25011","2015",5,4,1,146860,1212.2,127.6
"6996","25012","2015",1,1,0,245000,1828,134
"6997","25013","2015",2,2,0,175250,1575,101.5
"6998","25014","2015",9,9,0,121666.666666667,1138,110.111111111111
"6999","25015","2015",3,2,1,92500,913.666666666667,101.666666666667
"7000","25016","2015",3,3,0,169500,1154.33333333333,144.666666666667
"7001","25018","2015",7,7,0,118392.857142857,1357.71428571429,91.7142857142857
"7002","25019","2015",1,1,0,78000,1000,78
"7003","25020","2015",12,4,8,90766.6666666667,1142.5,79.0833333333333
"7004","25021","2015",14,14,0,148105.214285714,1426.92857142857,107
"7005","25022","2015",18,16,2,143235.333333333,1218.16666666667,114.666666666667
"7006","25025","2015",8,8,0,177922,1750.25,127.25
"7007","25026","2015",4,4,0,132825,1776,83.5
"7008","25030","2015",5,4,1,186630,1732.2,110.8
"7009","25031","2015",105,55,50,103517.714285714,1290.31428571429,81.0952380952381
"7010","25032","2015",4,4,0,115250,999.75,116.5
"7011","25035","2015",12,11,1,237250,1968.58333333333,133.666666666667
"7012","25036","2015",20,17,3,179701.6,1850.85,94.45
"7013","25038","2015",3,3,0,98300,1161,84.6666666666667
"7014","25039","2015",4,3,1,194400,2157,96.75
"7015","25040","2015",4,4,0,128435,1422.5,86
"7016","25041","2015",4,3,1,122062.5,1203.5,95.5
"7017","25042","2015",2,2,0,278500,2526,115.5
"7018","25043","2015",15,14,1,129753.333333333,1444.66666666667,88.2666666666667
"7019","25044","2015",1,1,0,80000,593,135
"7020","25045","2015",1,1,0,148000,2691,55
"7021","25047","2015",49,27,22,99076.5306122449,1283.16326530612,77.6530612244898
"7022","25048","2015",35,30,5,136763.228571429,1491.74285714286,91.9714285714286
"7023","25049","2015",4,4,0,187560,1435.5,130.75
"7024","25051","2015",2,2,0,114000,856.5,133
"7025","25054","2015",9,9,0,139216.666666667,1276,111.111111111111
"7026","25055","2015",4,4,0,161475,1808.5,93.25
"7027","25056","2015",1518,183,1335,124183.957839262,1781.43214756258,70.7898550724638
"7028","25057","2015",36,25,11,108975.861111111,1229.58333333333,87.8611111111111
"7029","25058","2015",9,5,4,144253.333333333,1650.88888888889,86.8888888888889
"7030","25059","2015",1,1,0,181000,1534,118
"7031","25060","2015",5,3,2,143901.8,1544.8,85.8
"7032","25062","2015",1,1,0,195000,2407,81
"7033","25063","2015",8,6,2,150894.75,1802.75,111.25
"7034","25065","2015",1,1,0,151938,1670,91
"7035","25067","2015",2,2,0,84000,898,98.5
"7036","25070","2015",2,2,0,55250,1014.5,63
"7037","25071","2015",6,4,2,134750,1149,123.166666666667
"7038","25073","2015",10,9,1,173825,1728.2,98.9
"7039","25074","2015",12,11,1,184600,1745.33333333333,109.083333333333
"7040","25075","2015",3,3,0,132113,1675,92
"7041","25078","2015",6,6,0,178608.333333333,1584.66666666667,114.666666666667
"7042","25079","2015",6,6,0,134566.666666667,1086.5,120.333333333333
"7043","25082","2015",4,4,0,158875,1928.5,85.25
"7044","25083","2015",1,1,0,137000,806,170
"7045","25084","2015",7,5,2,169270.857142857,1655,98.2857142857143
"7046","25085","2015",1,0,1,127300,1430,89
"7047","25086","2015",1,1,0,215480,2155,100
"7048","25087","2015",3,3,0,107733.333333333,846.666666666667,133.333333333333
"7049","25089","2015",1,1,0,182000,1273,143
"7050","25090","2015",2,2,0,149250,1311.5,110.5
"7051","25091","2015",3,2,1,160800,1194.66666666667,147.666666666667
"7052","25092","2015",2,2,0,120075,1127.5,114
"7053","25093","2015",2,2,0,272400,1920,137
"7054","25094","2015",1,1,0,35000,438,80
"7055","25095","2015",2,2,0,119500,1526,78.5
"7056","25096","2015",4,4,0,187450,2018.75,97.5
"7057","25097","2015",3,3,0,186000,1320,134.333333333333
"7058","25098","2015",1,1,0,147000,860,171
"7059","25100","2015",1,1,0,2e+05,1176,170
"7060","25101","2015",4,4,0,168450,1365.75,124
"7061","25103","2015",7,6,1,166971.428571429,1433.14285714286,117.857142857143
"7062","25105","2015",2,2,0,192925,1874,105.5
"7063","25107","2015",3,3,0,173980,1362.66666666667,119.666666666667
"7064","25109","2015",2,2,0,35392.5,721.5,48.5
"7065","25110","2015",4,1,3,222883,2288.75,103
"7066","25111","2015",7,6,1,162714.285714286,1305.71428571429,126.142857142857
"7067","25112","2015",5,2,3,165885.8,1767.8,98.2
"7068","25113","2015",1,1,0,180000,1200,150
"7069","25114","2015",1,1,0,136000,1619,84
"7070","25115","2015",4,3,1,220250,1875.25,120
"7071","25116","2015",1,1,0,105000,1591,66
"7072","25117","2015",1,1,0,91000,1011,90
"7073","25119","2015",2,2,0,223250,1747.5,129.5
"7074","25120","2015",2,2,0,90500,649,151
"7075","25121","2015",1,1,0,297000,3667,81
"7076","25122","2015",4,3,1,112000,1035.5,112.5
"7077","25124","2015",2,2,0,157000,1350,115
"7078","25126","2015",4,4,0,164725,1682.5,102
"7079","25127","2015",30,15,15,148253.666666667,1633.1,91.6666666666667
"7080","25131","2015",1,1,0,47000,409,115
"7081","25133","2015",20,18,2,207854.95,1861.4,114
"7082","25136","2015",4,4,0,200325,1851.75,117.25
"7083","25139","2015",3,3,0,145948.666666667,1559,101.666666666667
"7084","25141","2015",1,1,0,111000,1009,110
"7085","25142","2015",3,2,1,170166.666666667,2349.33333333333,79.6666666666667
"7086","25143","2015",2,2,0,138310,1314.5,110.5
"7087","25147","2015",11,9,2,220539.090909091,2311.45454545455,96.9090909090909
"7088","25148","2015",3,3,0,216383.333333333,2197,98.3333333333333
"7089","25149","2015",5,5,0,49650,935.4,50.8
"7090","25150","2015",1,1,0,130000,1512,86
"7091","25151","2015",3,3,0,168850,1805.33333333333,94.6666666666667
"7092","25152","2015",1,1,0,270000,2126,127
"7093","25153","2015",1,1,0,57000,1140,50
"7094","25154","2015",1,1,0,67000,1489,45
"7095","25155","2015",1,1,0,65000,747,87
"7096","25156","2015",10,9,1,87440,1022.6,88
"7097","25157","2015",12,4,8,207875,2416.16666666667,86.5
"7098","25159","2015",3,2,1,89500,829,106
"7099","25160","2015",4,4,0,203587.5,1757.25,117.75
"7100","25166","2015",1,1,0,216000,1350,160
"7101","25170","2015",16,11,5,124593.4375,1365.375,90.9375
"7102","25171","2015",1,1,0,155500,2101,74
"7103","25172","2015",5,2,3,80516.8,1394,70
"7104","25173","2015",1,1,0,115000,1307,88
"7105","25174","2015",2,2,0,93000,1160,78.5
"7106","25176","2015",3,2,1,238333.333333333,1686.66666666667,144.666666666667
"7107","25177","2015",2,2,0,104500,792.5,127.5
"7108","25179","2015",1,1,0,45900,706,65
"7109","25181","2015",1,1,0,138000,1255,110
"7110","25183","2015",1,0,1,175000,2917,60
"7111","25184","2015",2,2,0,101000,940,108.5
"7112","25186","2015",7,6,1,146344.285714286,1415.85714285714,106.571428571429
"7113","25187","2015",4,4,0,121500,1161.25,103.25
"7114","25188","2015",8,6,2,135695,1476.625,92.375
"7115","25189","2015",1,1,0,2e+05,1370,146
"7116","25190","2015",17,13,4,129264.705882353,1278.94117647059,96.5882352941177
"7117","25191","2015",1,1,0,140000,1972,71
"7118","25193","2015",16,14,2,187050.1875,1984.125,101.3125
"7119","25194","2015",2,2,0,92830,1290.5,75
"7120","25195","2015",5,5,0,221506,2273.6,99.4
"7121","25196","2015",12,8,4,116343.333333333,1169.83333333333,96.8333333333333
"7122","25197","2015",5,3,2,116140,1320.4,87.8
"7123","25198","2015",1,1,0,80000,1600,50
"7124","25199","2015",3,2,1,161576.666666667,1156.33333333333,145.333333333333
"7125","25200","2015",12,8,4,207363.75,1699.75,115.416666666667
"7126","25201","2015",5,3,2,258913.6,2479.8,107.8
"7127","25203","2015",2,2,0,133500,908,140.5
"7128","25204","2015",25,13,12,225876.2,2458.6,92.64
"7129","25207","2015",7,6,1,146385.714285714,1525.71428571429,101.285714285714
"7130","25208","2015",2,2,0,144500,1743.5,87.5
"7131","25209","2015",1,1,0,148000,1644,90
"7132","25210","2015",2,2,0,165450,1377.5,126
"7133","25211","2015",1,1,0,172000,930,185
"7134","25212","2015",18,14,4,223877.777777778,2004.5,109.055555555556
"7135","25213","2015",4,4,0,262500,2398,116
"7136","25214","2015",3,3,0,196801.333333333,1583.33333333333,122.666666666667
"7137","25215","2015",2,2,0,103550,1033,100
"7138","25216","2015",1,1,0,145000,1835,79
"7139","25217","2015",5,4,1,144480,1821.2,105.8
"7140","25218","2015",1,1,0,40000,571,70
"7141","25219","2015",4,4,0,194725,1277,156
"7142","25220","2015",3,3,0,203931,1812.33333333333,125.666666666667
"7143","25221","2015",2,2,0,43250,1724,35.5
"7144","25222","2015",7,7,0,206964.285714286,1632,121.428571428571
"7145","25224","2015",9,7,2,140623.222222222,1310.22222222222,109.222222222222
"7146","25228","2015",35,22,13,140814.857142857,1530.91428571429,92.8
"7147","25230","2015",29,25,4,126645.206896552,1383.13793103448,92.2758620689655
"7148","25232","2015",3,2,1,87000,1022,85
"7149","25233","2015",1,1,0,230000,1438,160
"7150","25235","2015",5,4,1,189690,1508.4,129.2
"7151","25236","2015",5,5,0,115744,1314.6,94.4
"7152","25237","2015",21,13,8,85195.2380952381,1080.38095238095,80.8571428571429
"7153","25238","2015",4,4,0,147844.25,1935.75,74
"7154","25239","2015",1,1,0,160000,1345,119
"7155","25240","2015",24,19,5,241025.208333333,2449.70833333333,110.25
"7156","25242","2015",1,1,0,131500,1445,91
"7157","25243","2015",5,5,0,165910,1215,143.6
"7158","25244","2015",1,1,0,111500,697,160
"7159","25245","2015",15,15,0,244481.8,1823,139.4
"7160","25246","2015",5,2,3,86602,888,98
"7161","25247","2015",3,1,2,61900,508.666666666667,118.333333333333
"7162","25248","2015",6,6,0,208699.666666667,2237.33333333333,95
"7163","25251","2015",1,1,0,160071,1569,102
"7164","25252","2015",3,3,0,293250,2889.66666666667,102.666666666667
"7165","25253","2015",4,4,0,158631.25,1768.75,96.25
"7166","25254","2015",24,11,13,159318.125,1851.33333333333,88.75
"7167","25255","2015",1,1,0,63000,1750,36
"7168","25256","2015",10,3,7,147070,1451.7,94.3
"7169","25257","2015",3,3,0,145371,1428.33333333333,101
"7170","25258","2015",15,11,4,192137.533333333,1803.2,111.8
"7171","25259","2015",20,13,7,165112,1753.15,101.15
"7172","25262","2015",3,3,0,230000,1655.33333333333,136
"7173","25264","2015",1,1,0,114400,1707,67
"7174","25265","2015",14,11,3,224678.571428571,1817.28571428571,125.857142857143
"7175","25266","2015",1,1,0,65000,1000,65
"7176","25267","2015",2,2,0,165500,1878,73
"7177","25269","2015",2,2,0,72500,650,111.5
"7178","25271","2015",10,7,3,202740,2117.3,106.6
"7179","25273","2015",3,3,0,102183.333333333,1306.33333333333,73.6666666666667
"7180","25274","2015",4,1,3,100187.5,1074.75,98
"7181","25275","2015",1,1,0,15000,682,22
"7182","25276","2015",1,1,0,130000,1477,88
"7183","25278","2015",1,1,0,152500,1425,107
"7184","25279","2015",3,3,0,191300,1221,156.666666666667
"7185","25281","2015",4,1,3,73750,871,92.25
"7186","25282","2015",4,2,2,233375,2142.5,120.25
"7187","25284","2015",38,21,17,119756.657894737,1294.97368421053,95.4473684210526
"7188","25285","2015",13,8,5,215892.076923077,2000,123.846153846154
"7189","25287","2015",15,9,6,156555,1586.33333333333,101.333333333333
"7190","25288","2015",3,3,0,174333.333333333,1959,120.333333333333
"7191","25290","2015",3,3,0,165426.666666667,1181,140
"7192","25293","2015",11,5,6,221099.090909091,2612.45454545455,87.8181818181818
"7193","25296","2015",3,2,1,195000,2072,102.666666666667
"7194","25297","2015",1,1,0,426220,2450,174
"7195","25300","2015",3,3,0,168333.333333333,1518.33333333333,111.333333333333
"7196","25301","2015",6,6,0,211516.666666667,1807.66666666667,115.5
"7197","25303","2015",1,1,0,248900,2348,106
"7198","25304","2015",41,31,10,123787.317073171,1309.68292682927,93.8292682926829
"7199","25305","2015",4,4,0,129550,1303.25,99.25
"7200","25306","2015",2,2,0,105000,1197,86.5
"7201","25307","2015",40,13,27,178781.7,2555.5,69.55
"7202","25308","2015",6,4,2,178750,2277.66666666667,74
"7203","25309","2015",11,9,2,270578.636363636,2480.72727272727,119.545454545455
"7204","25311","2015",3,3,0,114000,1152.66666666667,101.333333333333
"7205","25313","2015",1,1,0,57400,574,100
"7206","25314","2015",1,1,0,120000,594,202
"7207","25315","2015",23,19,4,97764.1304347826,1077.34782608696,89.5217391304348
"7208","25316","2015",1,1,0,148394,1686,88
"7209","25318","2015",21,12,9,178910.476190476,2359.42857142857,88.0476190476191
"7210","25320","2015",21,5,16,175311.19047619,2282.66666666667,78.9523809523809
"7211","25321","2015",52,30,22,217676.807692308,2496.05769230769,89.7307692307692
"7212","25322","2015",1,1,0,185000,1850,100
"7213","25323","2015",4,3,1,106375,959.75,112.75
"7214","25325","2015",1,1,0,183000,1089,168
"7215","25326","2015",7,7,0,178808.428571429,1644,108
"7216","25328","2015",5,5,0,208000,1620.8,125.6
"7217","25330","2015",2,2,0,255000,1567,178.5
"7218","25331","2015",1,1,0,160000,1067,150
"7219","25332","2015",6,5,1,184146.666666667,1543.66666666667,115.5
"7220","25333","2015",1,1,0,150000,1442,104
"7221","25334","2015",18,12,6,132245.833333333,1302.27777777778,104.611111111111
"7222","25335","2015",2,2,0,110000,1409.5,82
"7223","25336","2015",2,2,0,134500,1221,114
"7224","25338","2015",1,1,0,170000,7083,24
"7225","25339","2015",5,4,1,139610,1263.2,102.4
"7226","25340","2015",3,3,0,171073.333333333,1581.33333333333,110
"7227","25343","2015",3,2,1,136033.333333333,1378.33333333333,100.666666666667
"7228","25345","2015",6,6,0,151042,1974,82.3333333333333
"7229","25347","2015",7,6,1,187750,1978.85714285714,92.7142857142857
"7230","25348","2015",8,3,5,174696.25,2399.875,76.5
"7231","25350","2015",6,6,0,182983.333333333,1849.16666666667,104.833333333333
"7232","25354","2015",2,2,0,94500,1070.5,84
"7233","25356","2015",36,21,15,159969.222222222,2160.97222222222,89.8055555555556
"7234","25357","2015",5,5,0,190170,2000,99.2
"7235","25361","2015",13,3,10,162278.307692308,2913.76923076923,58.0769230769231
"7236","25362","2015",8,2,6,163562.5,1970.625,80.375
"7237","25364","2015",10,9,1,188729.9,2118.8,89.7
"7238","25365","2015",2,2,0,106100,1475.5,95
"7239","25366","2015",2,2,0,201750,2044.5,104
"7240","25367","2015",43,26,17,98210.7441860465,1162.3488372093,89.3953488372093
"7241","25368","2015",10,10,0,182810,1692,108.3
"7242","25369","2015",2,2,0,140500,1185,124
"7243","25370","2015",18,17,1,148127.777777778,1575.5,93.1111111111111
"7244","25371","2015",1,1,0,229200,1685,136
"7245","25372","2015",1,1,0,57000,1140,50
"7246","25373","2015",2,2,0,263100,1797,146
"7247","25374","2015",5,5,0,167500,1320,147.6
"7248","25375","2015",2,2,0,215000,1871,115
"7249","25378","2015",5,4,1,101020,1208.6,95.8
"7250","25380","2015",72,22,50,122503.833333333,2826.41666666667,42.5972222222222
"7251","25381","2015",20,12,8,152855,1497.55,102.45
"7252","25382","2015",9,8,1,117905.555555556,1450.77777777778,79.7777777777778
"7253","25384","2015",1,1,0,133000,1446,92
"7254","25386","2015",2,1,1,237500,1702.5,141.5
"7255","25387","2015",1,1,0,55500,617,90
"7256","25388","2015",222,67,155,99081.9774774775,1218.61261261261,81.7567567567568
"7257","25389","2015",1,1,0,218000,1946,112
"7258","25390","2015",4,4,0,236805,2262.75,111
"7259","25392","2015",2,2,0,213500,1854,124
"7260","25393","2015",7,6,1,159971.428571429,1253.85714285714,122
"7261","25394","2015",8,8,0,155725,1522.625,104
"7262","25395","2015",7,6,1,214535.714285714,1565.28571428571,132.571428571429
"7263","25397","2015",15,9,6,139530,1713.06666666667,82.4666666666667
"7264","25400","2015",1,1,0,105000,1500,70
"7265","25402","2015",2,2,0,122500,1017.5,113.5
"7266","25403","2015",13,8,5,230620.461538462,2552.92307692308,91.5384615384615
"7267","25405","2015",10,8,2,254776.6,3355.7,82.3
"7268","25410","2015",13,11,2,160512.307692308,1724.07692307692,92.7692307692308
"7269","25411","2015",91,19,72,161580.428571429,2226.40659340659,75.4945054945055
"7270","25413","2015",26,5,21,139534.769230769,2226.84615384615,63.3846153846154
"7271","25414","2015",4,4,0,161137.5,2278.5,82.75
"7272","25415","2015",6,5,1,94000,1016,91.8333333333333
"7273","25416","2015",1,1,0,120000,938,128
"7274","25417","2015",7,6,1,204084.285714286,1721,125.142857142857
"7275","25418","2015",5,4,1,157883,1416.8,109
"7276","25419","2015",1,1,0,109990,1279,86
"7277","25422","2015",1,1,0,50000,420,119
"7278","25424","2015",12,9,3,161333.333333333,1478.41666666667,114.333333333333
"7279","25425","2015",2,2,0,100225,1075.5,90
"7280","25426","2015",1,1,0,120000,1333,90
"7281","25427","2015",3,2,1,191833.333333333,1641.33333333333,117.333333333333
"7282","25428","2015",15,15,0,137660,1392.73333333333,102.8
"7283","25429","2015",11,8,3,162977.272727273,1696.63636363636,94.6363636363636
"7284","25431","2015",2,2,0,127500,975,139
"7285","25432","2015",18,12,6,154369.444444444,1691.94444444444,100.5
"7286","25433","2015",1,1,0,130350,2556,51
"7287","25434","2015",49,33,16,119884.530612245,1401.22448979592,87.734693877551
"7288","25436","2015",1,1,0,92000,958,96
"7289","25437","2015",2,2,0,130740,1705,81
"7290","25438","2015",5,5,0,160330,1375.2,122.2
"7291","25440","2015",7,5,2,152992.857142857,1257.85714285714,125.714285714286
"7292","25441","2015",1,1,0,108000,701,154
"7293","25442","2015",9,4,5,224416.666666667,2354.44444444444,91.8888888888889
"7294","25445","2015",1,1,0,387500,1384,280
"7295","25447","2015",3,3,0,104342,1013.66666666667,114.666666666667
"7296","25448","2015",14,13,1,211270.071428571,1706.71428571429,125.142857142857
"7297","25449","2015",1,1,0,95400,1026,93
"7298","25450","2015",1,1,0,126200,1052,120
"7299","25452","2015",8,6,2,116803.75,1332.75,88
"7300","25453","2015",19,19,0,121316.052631579,1234.84210526316,103.736842105263
"7301","25454","2015",12,9,3,178462.5,1729.33333333333,105.833333333333
"7302","25455","2015",3,3,0,191870,1613,134.666666666667
"7303","25456","2015",4,2,2,212884,1639.5,131.75
"7304","25458","2015",2,2,0,104750,1492,71.5
"7305","25459","2015",9,2,7,149166.666666667,1374.55555555556,109
"7306","25460","2015",1,1,0,145000,1151,126
"7307","25462","2015",299,54,245,160123.170568562,2188.07023411371,75.866220735786
"7308","25463","2015",49,29,20,110034.93877551,1287.36734693878,86.5102040816327
"7309","25465","2015",2,2,0,151750,1028,148
"7310","25466","2015",9,8,1,197055.555555556,1711.66666666667,120.222222222222
"7311","25467","2015",19,16,3,160668.631578947,1575.78947368421,100.263157894737
"7312","25469","2015",2,2,0,147000,1412,104
"7313","25470","2015",1,1,0,151120,1136,133
"7314","25473","2015",3,3,0,196071.666666667,1543.33333333333,130.666666666667
"7315","25475","2015",8,7,1,137912.5,1442.375,95.375
"7316","25476","2015",1,1,0,155750,1266,123
"7317","25477","2015",4,4,0,221470,1896.5,127.5
"7318","25478","2015",1,1,0,60000,480,125
"7319","25479","2015",6,5,1,95666.6666666667,1226.5,81.8333333333333
"7320","25481","2015",7,7,0,212355,1961.14285714286,108.285714285714
"7321","25482","2015",6,6,0,191075,1528,130.833333333333
"7322","25483","2015",2,2,0,235000,2327,106
"7323","25485","2015",2,2,0,187850,1231,150.5
"7324","25486","2015",2,2,0,225060,2012.5,106
"7325","25488","2015",2,2,0,102150,3042,75
"7326","25489","2015",1,1,0,85000,654,130
"7327","25490","2015",4,4,0,156000,1354.25,113.25
"7328","25493","2015",6,5,1,200562.5,1452.83333333333,136.5
"7329","25494","2015",12,7,5,223695,2415.66666666667,92
"7330","25495","2015",23,18,5,157497.826086957,1716.95652173913,94.0434782608696
"7331","25497","2015",3,3,0,126666.666666667,1789.66666666667,73.6666666666667
"7332","25499","2015",1,1,0,49000,612,80
"7333","25501","2015",1,1,0,275350,3824,72
"7334","25503","2015",2,2,0,85750,762,115.5
"7335","25504","2015",4,4,0,130025,1237,107.75
"7336","25505","2015",5,3,2,87400,998.4,82.4
"7337","25508","2015",10,10,0,171175,1418.7,121.5
"7338","25510","2015",3,2,1,153016.666666667,1668.66666666667,93.3333333333333
"7339","25511","2015",2,2,0,106550,948.5,117
"7340","25512","2015",15,13,2,200535.866666667,2051.33333333333,102.4
"7341","25514","2015",2,0,2,100500,2881,34
"7342","25515","2015",5,2,3,163920,2292.8,75.6
"7343","25516","2015",1,1,0,53333,606,88
"7344","25519","2015",9,4,5,96777.7777777778,988.777777777778,101.555555555556
"7345","25520","2015",1,1,0,1e+05,901,111
"7346","25521","2015",1,1,0,68500,1370,50
"7347","25523","2015",8,6,2,113175,1199.25,90.125
"7348","25524","2015",10,10,0,106570,1099.1,102
"7349","25525","2015",2,1,1,213885,2589.5,79
"7350","25526","2015",11,5,6,95295.4545454545,1298,74.0909090909091
"7351","25527","2015",41,34,7,179165.609756098,1817.0487804878,100.390243902439
"7352","25529","2015",7,6,1,102928.571428571,1201.28571428571,93.5714285714286
"7353","25532","2015",30,20,10,173050.766666667,1737.26666666667,104.066666666667
"7354","25534","2015",1,1,0,215680,1269,170
"7355","25536","2015",2,2,0,50000,713,73
"7356","25537","2015",3,3,0,137666.666666667,1681.33333333333,83
"7357","25538","2015",1,1,0,188170,1436,131
"7358","25539","2015",51,29,22,126536.490196078,1466.92156862745,88.3725490196078
"7359","25540","2015",7,7,0,108950,1036.42857142857,101.142857142857
"7360","25541","2015",3,3,0,211666.666666667,2138,100
"7361","25542","2015",12,10,2,201362.5,1996.58333333333,98.8333333333333
"7362","25544","2015",2,2,0,113604.5,828.5,133.5
"7363","25545","2015",2,2,0,198500,1362.5,136.5
"7364","25547","2015",34,3,31,79172.0588235294,901.705882352941,87.4117647058823
"7365","25548","2015",2,2,0,166000,1766.5,88
"7366","25549","2015",3,2,1,224510,1942.33333333333,115.666666666667
"7367","25550","2015",1,1,0,148000,1233,120
"7368","25551","2015",3,3,0,141610,1334.66666666667,107.666666666667
"7369","25553","2015",2,2,0,185330,1433,129
"7370","25554","2015",1,1,0,40000,1538,26
"7371","25555","2015",11,6,5,147283.454545455,1434.27272727273,101
"7372","25557","2015",2,2,0,352250,2005,182
"7373","25558","2015",8,8,0,162011.875,1501.125,114.625
"7374","25560","2015",25,19,6,218899.8,2190.28,104.12
"7375","25561","2015",5,0,5,110415,1406.6,77.2
"7376","25562","2015",1,1,0,231000,2200,105
"7377","25564","2015",9,7,2,152228.333333333,1419.77777777778,105.888888888889
"7378","25565","2015",3,3,0,306950,2532,123.333333333333
"7379","25566","2015",4,4,0,139425,1455.25,101.25
"7380","25567","2015",1,1,0,130000,1066,122
"7381","25569","2015",3,3,0,134833.333333333,1034.33333333333,126
"7382","25570","2015",1,1,0,19000,380,50
"7383","25571","2015",4,3,1,201675,1756,115.5
"7384","25574","2015",1,1,0,101400,704,144
"7385","25575","2015",6,5,1,170191,1683.33333333333,113
"7386","25578","2015",51,21,30,148486.705882353,1753.23529411765,89.0980392156863
"7387","25579","2015",1,1,0,163500,1703,96
"7388","25580","2015",95,68,27,113456.778947368,1285.69473684211,88.7052631578947
"7389","25582","2015",1,1,0,168000,2435,69
"7390","25584","2015",1,1,0,176000,1266,139
"7391","25586","2015",9,8,1,129922.222222222,1323.55555555556,104.222222222222
"7392","25588","2015",1,1,0,114000,1839,62
"7393","25592","2015",3,3,0,290793.333333333,2123.33333333333,144.333333333333
"7394","25594","2015",2,2,0,251575,2059.5,127
"7395","25595","2015",1,1,0,47500,466,102
"7396","25597","2015",3,3,0,93140,889.666666666667,111.333333333333
"7397","25598","2015",2,2,0,131500,1261,103.5
"7398","25599","2015",4,3,1,165500,1798.25,95
"7399","25600","2015",1,1,0,60000,594,101
"7400","25601","2015",20,13,7,137779.65,1437.3,98.4
"7401","25604","2015",1,1,0,239000,1494,160
"7402","25607","2015",1,1,0,72500,1576,46
"7403","25608","2015",3,3,0,135443.333333333,1314,102.333333333333
"7404","25609","2015",1,1,0,241300,2135,113
"7405","25611","2015",6,6,0,183211.666666667,1646.66666666667,114.666666666667
"7406","25612","2015",8,8,0,167943.75,1615.5,108.875
"7407","25613","2015",1,1,0,80000,816,98
"7408","25614","2015",28,22,6,135116.892857143,1455.25,91.6785714285714
"7409","25615","2015",3,3,0,130416.666666667,1343.66666666667,97
"7410","25616","2015",5,5,0,156390,1490,103.4
"7411","25617","2015",1,1,0,30000,968,31
"7412","25618","2015",6,6,0,165816.666666667,1343.33333333333,123.5
"7413","25619","2015",1,0,1,55500,2523,22
"7414","25620","2015",1,1,0,296350,2297,129
"7415","25621","2015",1,1,0,172000,1720,100
"7416","25622","2015",1,1,0,128000,1174,109
"7417","25623","2015",2,2,0,83500,896,95.5
"7418","25624","2015",3,3,0,137923.333333333,1379.33333333333,98
"7419","25625","2015",2,2,0,146500,1018.5,143
"7420","25627","2015",3,3,0,131000,900.333333333333,155.666666666667
"7421","25629","2015",3,3,0,110733.333333333,1098.33333333333,107.666666666667
"7422","25631","2015",6,6,0,169175,1477,120.166666666667
"7423","25632","2015",22,18,4,122209.090909091,1575.81818181818,79.5
"7424","25633","2015",9,8,1,162305.555555556,1662,113.222222222222
"7425","25634","2015",5,0,5,201690,2475.2,90.4
"7426","25635","2015",1,1,0,1e+05,943,106
"7427","26001","2015",3,3,0,178735,1166.66666666667,180.666666666667
"7428","26002","2015",21,17,4,142973.80952381,1447.09523809524,101.238095238095
"7429","26003","2015",1,1,0,2e+05,1695,118
"7430","26004","2015",23,23,0,216535.869565217,1965,114.304347826087
"7431","26005","2015",7,6,1,256044.285714286,2486.14285714286,111.142857142857
"7432","26006","2015",25,24,1,209179,1873.44,115.64
"7433","26007","2015",2,2,0,213085,2043.5,105.5
"7434","26008","2015",13,11,2,163421.538461538,1753.53846153846,92.3076923076923
"7435","26009","2015",10,7,3,127910,1253,112.7
"7436","26010","2015",33,25,8,130693.212121212,1485.21212121212,89.0606060606061
"7437","26011","2015",27,25,2,168143.333333333,1724.25925925926,97.3703703703704
"7438","26014","2015",5,5,0,207592,1735.2,123.2
"7439","26016","2015",1,1,0,291000,1993,146
"7440","26017","2015",1,1,0,120000,3429,35
"7441","26020","2015",2,2,0,460700,2026.5,226
"7442","26021","2015",2,2,0,85640,1498,65
"7443","26023","2015",10,9,1,162546,1832,92.1
"7444","26024","2015",2,2,0,244000,2125,117
"7445","26028","2015",1,1,0,159000,1500,106
"7446","26031","2015",6,6,0,239241.666666667,2199.33333333333,98.6666666666667
"7447","26032","2015",4,4,0,207750,2325.25,104.5
"7448","26033","2015",27,3,24,144412.888888889,6610.03703703704,28.4074074074074
"7449","26034","2015",8,7,1,191300,2038.125,92.375
"7450","26035","2015",8,8,0,148200,1470.875,105.125
"7451","26037","2015",21,20,1,261549.285714286,2361.90476190476,115.047619047619
"7452","26038","2015",6,6,0,203416.666666667,1807.33333333333,113
"7453","26039","2015",9,9,0,240095.555555556,1804.22222222222,140.777777777778
"7454","26040","2015",1,1,0,1e+05,1111,90
"7455","26041","2015",15,14,1,150016.666666667,1368.66666666667,113.933333333333
"7456","26042","2015",14,13,1,241304.928571429,2245.35714285714,102.857142857143
"7457","26045","2015",17,16,1,244339.411764706,2724.29411764706,99.4117647058823
"7458","26049","2015",7,5,2,163128.571428571,2241.28571428571,80.2857142857143
"7459","26052","2015",6,6,0,214585,1979,130.666666666667
"7460","26054","2015",18,18,0,229788.666666667,2267.72222222222,106.5
"7461","26056","2015",3,3,0,255023.333333333,2654.66666666667,108
"7462","26057","2015",105,54,51,128019.923809524,1589.62857142857,81.0761904761905
"7463","26058","2015",203,85,118,140337.103448276,1760.20689655172,79.423645320197
"7464","26059","2015",1,1,0,52478,673,78
"7465","26060","2015",2,2,0,354450,2082,169
"7466","26061","2015",2,1,1,176000,1446,134.5
"7467","26063","2015",29,27,2,209191.379310345,2121.31034482759,101.724137931034
"7468","26064","2015",67,58,9,216333.089552239,2136.35820895522,98.3283582089552
"7469","26065","2015",2,2,0,127500,1379.5,92.5
"7470","26066","2015",1,1,0,70000,500,140
"7471","26068","2015",2,2,0,143750,1986,73
"7472","26070","2015",5,5,0,306080,1808,160.8
"7473","26071","2015",8,8,0,184831.75,1672.5,112.125
"7474","26072","2015",10,10,0,183810,1663.5,108.6
"7475","26073","2015",1,1,0,264000,2095,126
"7476","26074","2015",6,5,1,119066.666666667,1339.66666666667,90.1666666666667
"7477","26077","2015",7,6,1,155237.142857143,1531.14285714286,99.1428571428571
"7478","26078","2015",5,5,0,527140,3708.6,106.6
"7479","26079","2015",13,13,0,175212.307692308,1937.46153846154,96.5384615384615
"7480","26081","2015",4,4,0,250675,2531.5,98.75
"7481","26083","2015",8,7,1,194324.75,1941.625,99.875
"7482","26084","2015",25,18,7,154324.44,1740.16,89.12
"7483","26085","2015",22,19,3,166880,1805.54545454545,91.1363636363636
"7484","26086","2015",10,9,1,182215,2510.4,90.9
"7485","26087","2015",12,12,0,200839.166666667,1775.58333333333,119.416666666667
"7486","26088","2015",40,39,1,195857.6,2000.75,99.6
"7487","26092","2015",7,5,2,165159.142857143,1469.42857142857,115.285714285714
"7488","26094","2015",3,3,0,200500,1593.33333333333,129.666666666667
"7489","26095","2015",13,12,1,194669.230769231,1883.61538461538,105
"7490","26096","2015",17,16,1,189602.941176471,1671.58823529412,109.588235294118
"7491","26097","2015",7,7,0,249607.142857143,2833.14285714286,100.428571428571
"7492","26098","2015",2,2,0,165000,1806.5,91
"7493","26099","2015",5,5,0,170200,2152.4,79.6
"7494","26100","2015",4,4,0,216375,1633.75,140.75
"7495","26102","2015",1,1,0,434250,4136,105
"7496","26103","2015",9,9,0,207944.444444444,2217.11111111111,97.4444444444444
"7497","26106","2015",12,11,1,179325.833333333,1509.5,117.083333333333
"7498","26107","2015",4,4,0,299082.5,2445.75,122.75
"7499","26108","2015",86,43,43,145036.23255814,1699.94186046512,88.3372093023256
"7500","26110","2015",3,3,0,269671.666666667,2441.66666666667,110.333333333333
"7501","26113","2015",48,39,9,161928.958333333,1780.125,96.0208333333333
"7502","26114","2015",46,33,13,182403.608695652,2248.34782608696,89.7391304347826
"7503","26115","2015",6,6,0,227053.333333333,3176.83333333333,89.5
"7504","26116","2015",52,43,9,163493.653846154,1755.86538461538,92.6346153846154
"7505","26117","2015",1,1,0,85000,2024,42
"7506","26118","2015",11,11,0,176487.363636364,1763.54545454545,102.909090909091
"7507","26119","2015",7,6,1,151957.142857143,1464.71428571429,95.1428571428571
"7508","26121","2015",16,16,0,204447.9375,2140.375,96.375
"7509","26122","2015",1,1,0,86367,455,190
"7510","26124","2015",37,34,3,223375,2038.21621621622,110.675675675676
"7511","26125","2015",14,14,0,192002.285714286,2096.57142857143,92.7142857142857
"7512","26127","2015",1,1,0,281750,2846,99
"7513","26129","2015",13,13,0,178414.307692308,1556.38461538462,109.307692307692
"7514","26133","2015",1,1,0,170000,895,190
"7515","26134","2015",2,2,0,131785,1367.5,87
"7516","26135","2015",12,1,11,221530.583333333,4224.16666666667,54.6666666666667
"7517","26137","2015",2,2,0,180750,1861.5,99
"7518","26138","2015",10,9,1,183991.5,1884.2,105.4
"7519","26139","2015",17,17,0,218527.647058824,2048.23529411765,107.117647058824
"7520","26140","2015",4,4,0,176950,1449.25,129.5
"7521","26143","2015",13,13,0,115855.384615385,1347.38461538462,88.3846153846154
"7522","26144","2015",15,13,2,223766.666666667,2463.33333333333,97.4666666666667
"7523","26145","2015",12,12,0,200585,2102.16666666667,103.916666666667
"7524","26146","2015",17,16,1,295909.470588235,2504.41176470588,117.764705882353
"7525","26148","2015",13,13,0,173865.384615385,2048.23076923077,90.3076923076923
"7526","26149","2015",10,6,4,162816.2,1648.4,95.9
"7527","26154","2015",3,3,0,44833.3333333333,1468,38.6666666666667
"7528","26155","2015",12,12,0,149835,1691.33333333333,88.4166666666667
"7529","26156","2015",2,2,0,218500,1831,119.5
"7530","26157","2015",9,9,0,222450,2325.11111111111,97.3333333333333
"7531","26159","2015",1,1,0,318000,2718,117
"7532","26160","2015",7,5,2,131042.857142857,1394.42857142857,91.2857142857143
"7533","26162","2015",11,11,0,140316.454545455,1709.18181818182,87.2727272727273
"7534","26165","2015",123,95,28,154561.479674797,1706.50406504065,90.7560975609756
"7535","26166","2015",67,56,11,160171.044776119,1661.26865671642,94.7910447761194
"7536","26167","2015",10,8,2,116100,1381.5,83.1
"7537","26168","2015",9,7,2,141082.777777778,1851.88888888889,76.6666666666667
"7538","26169","2015",19,17,2,199246.842105263,1788.42105263158,114.210526315789
"7539","26170","2015",20,20,0,218457.85,2020.7,108.1
"7540","26171","2015",3,3,0,124556.666666667,1384,87.6666666666667
"7541","26172","2015",6,6,0,129895,1453.33333333333,87.3333333333333
"7542","26173","2015",2,2,0,201500,1789.5,110
"7543","26174","2015",12,12,0,180217.5,1780.5,102.916666666667
"7544","26175","2015",2,2,0,122750,1927.5,72
"7545","26176","2015",12,12,0,263541.666666667,1916.5,141
"7546","26177","2015",6,6,0,264312,2084.83333333333,125.166666666667
"7547","26179","2015",17,17,0,214635.294117647,1859.94117647059,118.588235294118
"7548","26181","2015",1,1,0,18000,562,32
"7549","26182","2015",21,19,2,237780,2451.38095238095,94.6666666666667
"7550","26183","2015",11,11,0,192990,1857.54545454545,107.818181818182
"7551","26185","2015",13,11,2,243608.769230769,4053.07692307692,87.1538461538462
"7552","26188","2015",19,12,7,147217.894736842,2187.94736842105,69.4210526315789
"7553","26191","2015",28,24,4,230793.892857143,2301.07142857143,102.571428571429
"7554","26192","2015",2,2,0,218000,1958,111
"7555","26193","2015",5,0,5,81846.4,2636.2,37.8
"7556","26194","2015",5,5,0,175620,1684.8,115.6
"7557","26195","2015",2,2,0,79950,1012,77.5
"7558","26196","2015",22,17,5,202009.090909091,1913.81818181818,111.272727272727
"7559","26197","2015",39,31,8,265139.820512821,2853.30769230769,102.487179487179
"7560","26198","2015",452,218,234,157459.14380531,1809.95575221239,87.0199115044248
"7561","26200","2015",3,3,0,126786.666666667,1655.33333333333,89.3333333333333
"7562","26202","2015",3,3,0,219966.666666667,1806,121.666666666667
"7563","26203","2015",2,2,0,154700,1973,91
"7564","26206","2015",31,26,5,241266.774193548,2146.12903225806,116.193548387097
"7565","26207","2015",8,7,1,210787.5,2043.125,112.5
"7566","26208","2015",12,12,0,225056.666666667,1898.25,116.083333333333
"7567","26209","2015",1,1,0,175000,2273,77
"7568","26210","2015",4,3,1,151625,1295.5,126.75
"7569","26211","2015",7,5,2,247418.571428571,2295.71428571429,121.142857142857
"7570","26212","2015",5,4,1,195260,1760.6,111.8
"7571","26213","2015",10,10,0,147273,1820.1,84
"7572","26215","2015",4,4,0,106000,1273.25,75.75
"7573","26216","2015",7,7,0,128078.571428571,1248.42857142857,107.428571428571
"7574","26217","2015",1,1,0,90000,638,141
"7575","26218","2015",24,23,1,213094.75,1995,108.625
"7576","26220","2015",99,50,49,180018.434343434,2236.27272727273,81.7272727272727
"7577","26221","2015",2,2,0,91035,1023,70
"7578","26222","2015",1,1,0,528000,2933,180
"7579","26223","2015",3,3,0,189033.333333333,1567,125.333333333333
"7580","26224","2015",1,1,0,350000,2448,143
"7581","26225","2015",6,6,0,144000,1715.5,90.3333333333333
"7582","26226","2015",4,4,0,172750,1735.75,86.75
"7583","26231","2015",23,20,3,185758.260869565,1760.26086956522,106.826086956522
"7584","26232","2015",6,5,1,199283.333333333,1348.5,147.5
"7585","26233","2015",3,3,0,260900,2090.33333333333,103.666666666667
"7586","26234","2015",5,5,0,251205,2399.4,105.2
"7587","26235","2015",99,71,28,153519.717171717,1780.62626262626,87.7777777777778
"7588","26236","2015",4,4,0,133737.5,1340.25,105.25
"7589","26241","2015",1,1,0,50000,625,80
"7590","26243","2015",8,7,1,354291.875,2202.75,162.625
"7591","26244","2015",1,1,0,247250,2909,85
"7592","26247","2015",5,4,1,134700,1176.2,101.8
"7593","26248","2015",2,2,0,130250,1265,92.5
"7594","26249","2015",9,9,0,240046.444444444,2041.22222222222,132.666666666667
"7595","26250","2015",28,19,9,176292.678571429,2091.35714285714,88.1785714285714
"7596","26251","2015",2,2,0,214250,1905,104.5
"7597","26252","2015",101,50,51,146212.99009901,1833.0495049505,78.7326732673267
"7598","26257","2015",4,4,0,350900,2377.75,126
"7599","26258","2015",9,9,0,268884.777777778,2681.77777777778,99.3333333333333
"7600","26259","2015",1,1,0,125700,1571,80
"7601","26261","2015",6,6,0,262633.333333333,2445,104.333333333333
"7602","26263","2015",1,1,0,122000,1848,66
"7603","26264","2015",5,4,1,132109,1349.2,86.2
"7604","26268","2015",3,2,1,172500,1438,105.333333333333
"7605","26270","2015",2,2,0,140500,1365.5,122
"7606","26271","2015",24,20,4,199412.75,1943.75,102.583333333333
"7607","26272","2015",2,2,0,242500,1793.5,142
"7608","26273","2015",9,9,0,206450,1710.44444444444,116.777777777778
"7609","26275","2015",12,10,2,274564.75,2463.25,113.75
"7610","26276","2015",11,11,0,279652.090909091,2144.90909090909,119.090909090909
"7611","26278","2015",1,1,0,308000,2200,140
"7612","26281","2015",412,161,251,117867.298543689,1487.67233009709,77.7257281553398
"7613","26282","2015",4,4,0,107250,1639,63.5
"7614","26284","2015",2,2,0,135050,1253,95
"7615","26285","2015",5,5,0,199130,2597.6,87.2
"7616","26287","2015",4,4,0,254075,2991,91.5
"7617","26288","2015",5,5,0,174400,1375,133
"7618","26289","2015",20,19,1,133157.85,1802.3,75.25
"7619","26290","2015",10,6,4,86930.5,1266.2,67.8
"7620","26292","2015",1,1,0,251250,1675,150
"7621","26293","2015",2,2,0,200110,1980,100.5
"7622","26294","2015",4,4,0,297365,2142.75,135
"7623","26295","2015",10,10,0,153620,1588.9,100.2
"7624","26298","2015",3,3,0,145833.333333333,1675,88.6666666666667
"7625","26300","2015",2,2,0,103425,1617.5,66
"7626","26301","2015",52,40,12,164871.788461538,1841.71153846154,91.5961538461538
"7627","26302","2015",3,3,0,119780,1276.66666666667,96.6666666666667
"7628","26305","2015",7,7,0,204976.142857143,1694.57142857143,114.428571428571
"7629","26306","2015",4,4,0,285875,2098.25,129.25
"7630","26307","2015",20,14,6,125173.75,1482.2,85.9
"7631","26308","2015",2,2,0,216500,2412.5,130
"7632","26310","2015",2,2,0,327609.5,2462.5,131
"7633","26311","2015",9,8,1,135111.111111111,1320.44444444444,110.666666666667
"7634","26312","2015",17,15,2,213239.411764706,2151.41176470588,105.823529411765
"7635","26313","2015",48,46,2,205522.041666667,1919.125,112.395833333333
"7636","26314","2015",3,3,0,194333.333333333,1519.66666666667,136
"7637","26315","2015",5,5,0,65460,662.6,90.4
"7638","26316","2015",1,1,0,170000,1771,96
"7639","26317","2015",12,11,1,150383.333333333,1578.83333333333,95
"7640","26319","2015",4,4,0,165800,1668.25,111
"7641","26320","2015",11,9,2,134263.636363636,1400.54545454545,95.1818181818182
"7642","26321","2015",1,1,0,60000,1000,60
"7643","26322","2015",5,3,2,198520,2326,85.2
"7644","26323","2015",13,12,1,191063.846153846,1716.69230769231,109.538461538462
"7645","26324","2015",77,49,28,198281.038961039,2064.45454545455,95.4285714285714
"7646","26325","2015",61,48,13,137707.950819672,1543.55737704918,90.1967213114754
"7647","26326","2015",9,8,1,231132.222222222,2567.55555555556,89.1111111111111
"7648","26327","2015",2,2,0,145500,1773,82.5
"7649","26328","2015",1,1,0,85000,4250,20
"7650","26330","2015",20,19,1,147636.25,1673.3,90.9
"7651","26331","2015",5,5,0,198750,1929.2,101.2
"7652","26332","2015",14,14,0,144471.428571429,1269.64285714286,112.928571428571
"7653","26333","2015",40,15,25,84835,1106.425,76.675
"7654","26335","2015",5,5,0,268824.4,2151.6,109.8
"7655","26336","2015",11,11,0,188296.363636364,2201.90909090909,87.9090909090909
"7656","26337","2015",16,13,3,168900,1870.5625,92.6875
"7657","26338","2015",11,8,3,158400,1769.36363636364,92.8181818181818
"7658","26339","2015",9,8,1,202966.666666667,1737.44444444444,120.444444444444
"7659","26340","2015",1,1,0,27000,1688,16
"7660","26341","2015",3,3,0,156333.333333333,1005.33333333333,156.666666666667
"7661","26342","2015",1,1,0,150000,1667,90
"7662","26344","2015",5,5,0,239600,2498,107.2
"7663","26345","2015",20,20,0,211560.25,1826.5,116.3
"7664","26346","2015",1,1,0,560000,2705,207
"7665","26347","2015",68,36,32,176561.632352941,1886.58823529412,87.4117647058823
"7666","26348","2015",20,20,0,247448,1963.3,125.75
"7667","26349","2015",3,3,0,194353.333333333,1941.33333333333,100
"7668","26350","2015",2,2,0,170000,2228,75.5
"7669","26351","2015",1,1,0,195000,2378,82
"7670","26352","2015",5,5,0,157568,1570.6,105
"7671","26353","2015",6,6,0,177233.333333333,1801.5,98.8333333333333
"7672","26355","2015",1,1,0,50000,400,125
"7673","26356","2015",2,2,0,412500,2662,141.5
"7674","26357","2015",16,11,5,169861.25,1896.9375,91.375
"7675","26358","2015",11,11,0,281922.727272727,2466.27272727273,119.272727272727
"7676","26360","2015",2,2,0,140000,1482,98.5
"7677","26362","2015",816,198,618,130139.455882353,1704.32107843137,76.4301470588235
"7678","26364","2015",4,3,1,167000,3217,65
"7679","26365","2015",8,8,0,192062.5,2195.875,95.875
"7680","26367","2015",9,8,1,193805.555555556,1772.22222222222,110.888888888889
"7681","26368","2015",2,2,0,114425,1398,80.5
"7682","26373","2015",3,3,0,184166.666666667,1676.33333333333,97
"7683","26374","2015",1,1,0,176885,1565,113
"7684","26376","2015",1,1,0,393700,3281,120
"7685","26377","2015",10,10,0,202095,2066.9,97
"7686","26378","2015",2,2,0,57075,952.5,69
"7687","26379","2015",8,8,0,202291.5,1868.25,111.375
"7688","26380","2015",6,6,0,198625,1833.66666666667,105.666666666667
"7689","26381","2015",2,2,0,187500,1826,104
"7690","26382","2015",5,5,0,247546,2147,111.6
"7691","27001","2015",4,4,0,121000,1345,84.75
"7692","27002","2015",8,8,0,88375,1164.375,74.25
"7693","27003","2015",14,14,0,192971.428571429,1784,112
"7694","27004","2015",2,2,0,188750,1870,101
"7695","27005","2015",15,15,0,204964,1810.6,119.666666666667
"7696","27006","2015",4,4,0,177875,1663.5,125.25
"7697","27008","2015",8,8,0,163825,1759.125,100.125
"7698","27009","2015",5,5,0,96000,1097,90.4
"7699","27010","2015",5,5,0,140028,2198.8,71.6
"7700","27011","2015",10,10,0,144580,1438.4,104
"7701","27012","2015",1,1,0,161000,2927,55
"7702","27013","2015",3,3,0,117166.666666667,1519.66666666667,75.3333333333333
"7703","27014","2015",5,5,0,164660,1430.8,119.4
"7704","27015","2015",18,18,0,185402.222222222,1807.22222222222,106.944444444444
"7705","27016","2015",49,45,4,137869.795918367,1520.81632653061,95.2448979591837
"7706","27017","2015",8,8,0,200412.5,1717.25,118.75
"7707","27019","2015",2,2,0,160000,1435.5,112
"7708","27020","2015",19,19,0,157531.578947368,1854.21052631579,88.3684210526316
"7709","27022","2015",42,42,0,168264.80952381,1861.42857142857,93.9285714285714
"7710","27023","2015",6,6,0,195383.333333333,1719.66666666667,121.166666666667
"7711","27025","2015",10,10,0,188300,1642.3,132.2
"7712","27026","2015",4,4,0,216250,2218,109.75
"7713","27027","2015",3,3,0,140366.666666667,1157,130.333333333333
"7714","27031","2015",8,8,0,189018.75,1673.5,115.5
"7715","27032","2015",8,8,0,132334.375,1576.75,89.625
"7716","27033","2015",1,1,0,165500,1547,107
"7717","27034","2015",6,6,0,141783.333333333,1558.33333333333,94.5
"7718","27036","2015",3,3,0,145000,2084,69.3333333333333
"7719","27037","2015",7,7,0,133525.428571429,1792.28571428571,79.8571428571429
"7720","27038","2015",2,2,0,62500,1088,62
"7721","27039","2015",2,2,0,161000,1381.5,117
"7722","27043","2015",8,8,0,150002.5,1433.25,116.5
"7723","27044","2015",8,8,0,174812.5,1857,98.125
"7724","27045","2015",4,4,0,151025,2150.75,69.5
"7725","27047","2015",4,4,0,124950,1036.25,126.5
"7726","27048","2015",4,4,0,147250,1290.5,117
"7727","27049","2015",63,63,0,133101.317460317,1370.74603174603,103.873015873016
"7728","27052","2015",6,6,0,125483.333333333,1406.5,93.6666666666667
"7729","27053","2015",2,2,0,201000,1325.5,157
"7730","27054","2015",4,4,0,97683.25,1574.5,83.25
"7731","27056","2015",104,80,24,126819.240384615,1514.375,83.7884615384615
"7732","27057","2015",1,1,0,153000,2096,73
"7733","27058","2015",15,15,0,176476.666666667,1347.26666666667,138.6
"7734","27061","2015",7,7,0,248285.714285714,1978.85714285714,122.857142857143
"7735","27062","2015",18,18,0,187958.333333333,1769.55555555556,106.833333333333
"7736","27064","2015",11,11,0,171436.363636364,1733.90909090909,100.181818181818
"7737","27065","2015",51,46,5,144405.490196078,1678.62745098039,88.4509803921569
"7738","27066","2015",4,4,0,149000,1443.75,108
"7739","27067","2015",18,17,1,170376.055555556,1866.61111111111,94.1111111111111
"7740","27068","2015",2,2,0,77750,1070.5,73.5
"7741","27069","2015",4,4,0,119270.25,1296.5,92
"7742","27070","2015",11,11,0,154500,1831.09090909091,102.272727272727
"7743","27072","2015",7,7,0,244785.714285714,2128.71428571429,117.714285714286
"7744","27073","2015",13,13,0,152107.692307692,1802.07692307692,90.3076923076923
"7745","27074","2015",2,2,0,175000,1515.5,118
"7746","27075","2015",7,7,0,128050,1378.71428571429,99.4285714285714
"7747","27076","2015",3,3,0,301143.333333333,2310.66666666667,158
"7748","27077","2015",10,10,0,136534,1352.7,104
"7749","27078","2015",1,1,0,188000,2321,81
"7750","27079","2015",5,5,0,187200,2259.2,119.6
"7751","27081","2015",4,4,0,185625,1569,125.25
"7752","27082","2015",16,15,1,146143.75,1803.8125,82.6875
"7753","27083","2015",3,3,0,165100,1302.66666666667,142.333333333333
"7754","27085","2015",11,11,0,173143.545454545,1355.81818181818,127
"7755","27089","2015",10,10,0,159725,1866.4,91.9
"7756","27090","2015",26,26,0,177834.615384615,1850.92307692308,101.115384615385
"7757","27091","2015",7,7,0,125407.142857143,1639,78
"7758","27095","2015",5,5,0,113800,1271,89
"7759","27096","2015",4,4,0,142500,1513.25,95.75
"7760","27097","2015",9,9,0,376528.333333333,4606.33333333333,90.4444444444444
"7761","27099","2015",4,4,0,133500,1504.75,89.25
"7762","27100","2015",10,9,1,169562,1588.1,117.9
"7763","27101","2015",5,5,0,141800,1465.8,102
"7764","27102","2015",4,4,0,144750,1915.75,73.25
"7765","27103","2015",38,36,2,179637.631578947,1864.10526315789,100.815789473684
"7766","27104","2015",7,7,0,154550,1542,101.142857142857
"7767","27105","2015",34,32,2,160928.441176471,1779.70588235294,96.5882352941177
"7768","27107","2015",13,13,0,153092.307692308,1851.92307692308,98
"7769","27108","2015",11,11,0,115014.545454545,1265.45454545455,92.4545454545455
"7770","27109","2015",1,1,0,147000,896,164
"7771","27110","2015",7,7,0,125985.714285714,1362,87.2857142857143
"7772","27111","2015",2,2,0,222000,1968,112
"7773","27112","2015",37,36,1,105029.72972973,1361.16216216216,82.4864864864865
"7774","27113","2015",1,1,0,120500,1674,72
"7775","27114","2015",16,16,0,232099.8125,2182,109.25
"7776","27115","2015",8,8,0,118946.25,1242.625,100.875
"7777","27116","2015",38,36,2,104517.894736842,1342.78947368421,82.4736842105263
"7778","27117","2015",6,6,0,70583.3333333333,791.833333333333,79.8333333333333
"7779","27118","2015",6,6,0,179325,1690.16666666667,106.666666666667
"7780","27119","2015",13,13,0,186300,1997.61538461538,98.3076923076923
"7781","27120","2015",5,5,0,129500,1653.8,79.4
"7782","27123","2015",3,3,0,246333.333333333,2297,103
"7783","27124","2015",3,3,0,182000,1793.33333333333,103
"7784","27125","2015",5,5,0,134000,1233,112.8
"7785","27126","2015",9,9,0,220277.777777778,1579.22222222222,141.555555555556
"7786","27127","2015",10,10,0,140911,1566.2,96.2
"7787","27129","2015",4,4,0,178575,1186.25,144.5
"7788","27130","2015",2,2,0,143670,1386.5,133
"7789","27132","2015",8,8,0,182937.5,1747,108.25
"7790","27133","2015",6,6,0,245833.333333333,2370.33333333333,131
"7791","27134","2015",1,1,0,128000,1684,76
"7792","27135","2015",2,2,0,145950,1659,93.5
"7793","27136","2015",1,1,0,145000,2302,63
"7794","27137","2015",3,3,0,131333.333333333,1117.33333333333,117.666666666667
"7795","27138","2015",3,3,0,98038.3333333333,1165.66666666667,85
"7796","27139","2015",1,1,0,85000,1635,52
"7797","27140","2015",2,2,0,167700,1998,84.5
"7798","27141","2015",1,1,0,87500,673,130
"7799","27142","2015",2,2,0,196500,2088.5,94.5
"7800","27147","2015",2,2,0,80000,915.5,80.5
"7801","27148","2015",3,3,0,132666.666666667,1022.66666666667,131.666666666667
"7802","27151","2015",17,17,0,125748.823529412,1622.11764705882,82
"7803","27152","2015",11,10,1,151410.818181818,1494.81818181818,107.727272727273
"7804","27153","2015",7,7,0,151142.857142857,2004.28571428571,84.1428571428571
"7805","27154","2015",7,7,0,148000,1557,98.1428571428571
"7806","27155","2015",3,3,0,113283.333333333,558.333333333333,172.666666666667
"7807","27156","2015",6,6,0,94783.3333333333,1216.16666666667,82.3333333333333
"7808","27157","2015",12,12,0,114416.666666667,1511.5,87.5
"7809","27158","2015",4,4,0,177017.5,1872,97.75
"7810","27161","2015",10,10,0,154126.2,1617,95.3
"7811","27162","2015",3,3,0,133000,1479,90.3333333333333
"7812","27165","2015",32,28,4,109818.75,1562.34375,74.8125
"7813","27168","2015",4,4,0,233753.25,1436,181.25
"7814","27169","2015",15,15,0,165345.4,1831.8,97
"7815","27171","2015",4,4,0,170250,1544,111.75
"7816","27174","2015",17,17,0,174385.294117647,1573.17647058824,114.058823529412
"7817","27176","2015",3,3,0,105333.333333333,2031.33333333333,55.6666666666667
"7818","27177","2015",10,10,0,194509,1897.4,99
"7819","27179","2015",6,6,0,171358.333333333,1426,118.666666666667
"7820","27180","2015",20,20,0,160024.95,1830.65,84.95
"7821","27182","2015",1,1,0,110600,647,171
"7822","27183","2015",18,18,0,154647.222222222,1937.61111111111,83.5
"7823","27184","2015",1,1,0,153000,1430,107
"7824","27187","2015",2,2,0,185500,1417.5,129
"7825","27188","2015",16,15,1,173103.75,1790.75,96.625
"7826","27189","2015",1,1,0,152100,1237,123
"7827","27190","2015",2,2,0,244989.5,2216,110
"7828","27191","2015",23,23,0,169813.043478261,1887.39130434783,96.9565217391304
"7829","27192","2015",6,6,0,136833.333333333,1462,92.3333333333333
"7830","27193","2015",11,11,0,141654.545454545,1706.90909090909,92.5454545454545
"7831","27194","2015",2,2,0,137000,1737.5,80.5
"7832","27196","2015",16,16,0,194197.625,1871.6875,109.25
"7833","27198","2015",63,60,3,121870.634920635,1304.07936507937,98.9047619047619
"7834","27199","2015",9,9,0,180877.777777778,1643.22222222222,119.333333333333
"7835","27200","2015",1,1,0,180000,1286,140
"7836","27201","2015",3,3,0,157633.333333333,1575,105.666666666667
"7837","27202","2015",5,5,0,115940,1871,63.8
"7838","27203","2015",5,5,0,197180,1941.4,111.6
"7839","27204","2015",7,7,0,175692.857142857,1577.42857142857,115.428571428571
"7840","27205","2015",2,2,0,96750,1675,56
"7841","27207","2015",4,4,0,145739.5,1314,113.25
"7842","27209","2015",5,5,0,116400,1514.6,87.6
"7843","27210","2015",8,8,0,152625,1913.375,89.625
"7844","27212","2015",2,2,0,154250,1417.5,110
"7845","27213","2015",67,66,1,178541.417910448,1990.89552238806,99.6865671641791
"7846","27214","2015",5,5,0,143819.6,1339.6,106.6
"7847","27215","2015",2,2,0,150500,2023,85.5
"7848","27216","2015",7,7,0,179721.428571429,1661.85714285714,107.571428571429
"7849","27217","2015",2,2,0,122000,1135.5,135.5
"7850","27219","2015",6,6,0,131583.333333333,1324.83333333333,96
"7851","27220","2015",2,2,0,175000,2594.5,78.5
"7852","27222","2015",4,4,0,178750,1539.75,120.75
"7853","27224","2015",5,5,0,205266.6,1469.4,142.2
"7854","27226","2015",32,31,1,157332.0625,1981.0625,86.875
"7855","27227","2015",9,9,0,92600,1165.66666666667,82.2222222222222
"7856","27228","2015",2,2,0,129750,1396,94
"7857","27229","2015",472,221,251,122813.898305085,1681.10593220339,75.0466101694915
"7858","27230","2015",61,49,12,148993.93442623,1815.24590163934,88.4590163934426
"7859","27231","2015",6,6,0,152216.666666667,1624.16666666667,96.5
"7860","27232","2015",6,6,0,160583.333333333,1971.66666666667,81.8333333333333
"7861","27233","2015",14,14,0,182148.571428571,2048.85714285714,96.4285714285714
"7862","27234","2015",2,2,0,129000,1661.5,81.5
"7863","27235","2015",3,3,0,117333.333333333,1078,117
"7864","27238","2015",16,16,0,164795.625,1678.625,99.0625
"7865","27240","2015",5,5,0,105800,1319.2,85.8
"7866","27241","2015",1,1,0,95000,2111,45
"7867","27242","2015",12,12,0,129679.166666667,1394.08333333333,95.1666666666667
"7868","27243","2015",15,15,0,157114.666666667,1809.33333333333,85.3333333333333
"7869","27245","2015",3,3,0,161333.333333333,1332,121.666666666667
"7870","27246","2015",18,18,0,114194.444444444,1550.61111111111,76.5555555555556
"7871","27247","2015",4,4,0,227100,1789.25,141
"7872","27249","2015",9,9,0,171327.777777778,1567.55555555556,113.444444444444
"7873","27254","2015",10,10,0,229900,1883,114
"7874","27256","2015",6,6,0,170558.333333333,1577.83333333333,110.166666666667
"7875","27258","2015",5,5,0,209740,2334.8,94.4
"7876","27259","2015",1,1,0,230000,1901,121
"7877","27260","2015",8,8,0,149837.5,1727.75,83.75
"7878","27261","2015",5,5,0,147240,1679.6,88.4
"7879","27263","2015",9,9,0,146855.555555556,1583.11111111111,97
"7880","27266","2015",2,2,0,142500,1770,80.5
"7881","27271","2015",3,3,0,142866.666666667,1837.33333333333,79
"7882","27273","2015",3,3,0,132500,1643.33333333333,80
"7883","27275","2015",71,37,34,112653.23943662,1559.15492957746,73.6056338028169
"7884","27277","2015",5,5,0,197000,1825.8,109.4
"7885","27278","2015",19,19,0,162586.842105263,1894,91.6842105263158
"7886","27279","2015",35,32,3,186614.571428571,2043.28571428571,95.8571428571429
"7887","27280","2015",2,2,0,190725,2125,89.5
"7888","27282","2015",3,3,0,193333.333333333,2160.66666666667,96.6666666666667
"7889","27284","2015",120,86,34,152962.133333333,1995.09166666667,79.9916666666667
"7890","27285","2015",9,8,1,197511.111111111,2200.88888888889,101.333333333333
"7891","27287","2015",5,5,0,173560,2110.6,88.2
"7892","27289","2015",5,5,0,125400,1198.8,115.8
"7893","27290","2015",5,5,0,106600,1529.2,83.2
"7894","27291","2015",4,4,0,134000,1078.75,129.75
"7895","27294","2015",7,7,0,106471.428571429,1309.71428571429,80.8571428571429
"7896","27298","2015",3,3,0,173833.333333333,1747.33333333333,99.3333333333333
"7897","27299","2015",33,28,5,153328.787878788,1975.69696969697,80.7272727272727
"7898","27301","2015",15,15,0,161493.333333333,1633.2,102.866666666667
"7899","27302","2015",14,14,0,138214.285714286,1389.07142857143,107.357142857143
"7900","27304","2015",1,1,0,305000,2259,135
"7901","27306","2015",20,20,0,183920,1973.2,94.65
"7902","27307","2015",4,4,0,137750,1299,115.75
"7903","27309","2015",6,6,0,169691.666666667,1730.66666666667,101.5
"7904","27310","2015",2,2,0,101500,1021.5,98.5
"7905","27311","2015",3,3,0,175500,1557,112.666666666667
"7906","27312","2015",2,2,0,141000,2075,69.5
"7907","27313","2015",5,5,0,87400,1183.2,82.2
"7908","27316","2015",20,20,0,159067.6,1726.35,103.85
"7909","27317","2015",3,3,0,164903.333333333,1506.66666666667,113
"7910","27318","2015",5,5,0,124613.4,1347,94.8
"7911","27319","2015",1,1,0,151500,1530,99
"7912","27320","2015",2,2,0,128500,1092.5,117
"7913","27321","2015",1,1,0,360000,1946,185
"7914","27322","2015",22,22,0,155309.090909091,1669.5,96.1363636363636
"7915","27323","2015",5,5,0,83640,1037.6,81
"7916","27324","2015",11,11,0,156636,1999.81818181818,88
"7917","27325","2015",1,1,0,148000,1873,79
"7918","27326","2015",6,6,0,255943.333333333,1831.33333333333,153.5
"7919","27327","2015",1,1,0,130700,1634,80
"7920","27329","2015",2,2,0,119000,1543,86.5
"7921","27330","2015",2,2,0,105500,1729.5,61
"7922","27331","2015",6,6,0,156683.333333333,2057.83333333333,75.1666666666667
"7923","27332","2015",6,6,0,177191.166666667,2150,92.1666666666667
"7924","27333","2015",12,12,0,153525,1794.75,101.5
"7925","27335","2015",9,9,0,173516.666666667,1581.66666666667,109.111111111111
"7926","27336","2015",3,3,0,145333.333333333,1455.66666666667,109.666666666667
"7927","27337","2015",5,5,0,164440,1543.6,107.8
"7928","27338","2015",10,10,0,145793.3,1779.9,86.6
"7929","27339","2015",9,9,0,182531.111111111,1173.11111111111,166.333333333333
"7930","27340","2015",9,9,0,278635.555555556,2971.88888888889,124.222222222222
"7931","27342","2015",4,4,0,140625,1512.5,102.5
"7932","27343","2015",13,13,0,241986.538461538,2020.15384615385,122.769230769231
"7933","27346","2015",2,2,0,154405.5,1677,93
"7934","27347","2015",7,7,0,213380.857142857,1829.14285714286,118.571428571429
"7935","27348","2015",13,12,1,142520,1544.53846153846,94.5384615384615
"7936","27349","2015",14,14,0,198054.571428571,1862.85714285714,113.928571428571
"7937","27351","2015",12,12,0,188845.833333333,1622,119.916666666667
"7938","27353","2015",3,3,0,206733.333333333,2085,100.666666666667
"7939","27354","2015",4,4,0,112375,1338.25,83.75
"7940","27355","2015",43,33,10,133035.488372093,1956.02325581395,75.5813953488372
"7941","27358","2015",2,2,0,1e+05,844,110.5
"7942","27359","2015",4,4,0,95525,1021.75,88.5
"7943","27360","2015",3,3,0,134666.666666667,1807,74
"7944","27361","2015",7,7,0,165712.857142857,1639.28571428571,106.142857142857
"7945","27363","2015",3,3,0,108500,1245,82.6666666666667
"7946","27365","2015",14,14,0,167500,1808.28571428571,107.642857142857
"7947","27367","2015",12,12,0,151383.333333333,1605.41666666667,96.6666666666667
"7948","27368","2015",1,1,0,140000,1556,90
"7949","27369","2015",1,1,0,170000,950,179
"7950","27370","2015",2,2,0,156000,1490,105
"7951","27371","2015",7,7,0,90557.1428571429,1648.57142857143,57
"7952","27372","2015",7,7,0,145857.142857143,1829,81.1428571428571
"7953","27373","2015",2,2,0,85000,1678.5,51.5
"7954","27374","2015",7,7,0,139797.428571429,1404.28571428571,99.5714285714286
"7955","27375","2015",153,121,32,141201.058823529,1720.50980392157,84.3267973856209
"7956","27376","2015",2,2,0,163500,1642,99.5
"7957","27377","2015",11,11,0,195141.272727273,1686.81818181818,114.454545454545
"7958","27378","2015",11,11,0,146545.454545455,1703.27272727273,102.545454545455
"7959","27379","2015",6,6,0,167341.666666667,1683.33333333333,101.833333333333
"7960","27380","2015",5,5,0,132640,1360,96.4
"7961","27381","2015",2,2,0,109250,749.5,144.5
"7962","27382","2015",2,2,0,119000,1214.5,102.5
"7963","27383","2015",1,1,0,115000,2091,55
"7964","27384","2015",8,8,0,247750,2144.625,121.125
"7965","27385","2015",17,16,1,125493.823529412,1339.94117647059,98.0588235294118
"7966","27386","2015",9,9,0,125522.222222222,1672.44444444444,76.4444444444444
"7967","27388","2015",9,9,0,130288.333333333,1381.77777777778,93.7777777777778
"7968","27389","2015",6,6,0,139493.5,1487.5,93.3333333333333
"7969","27391","2015",21,21,0,185657.142857143,1876.19047619048,101.904761904762
"7970","27393","2015",2,2,0,116250,1933.5,74.5
"7971","27394","2015",4,4,0,120825,2457.75,48.5
"7972","27395","2015",2,2,0,116500,623.5,185
"7973","27396","2015",3,3,0,159000,1367,117.666666666667
"7974","27397","2015",18,17,1,192458.333333333,1970.77777777778,108.388888888889
"7975","27398","2015",14,14,0,170835.357142857,1739.14285714286,100.928571428571
"7976","27399","2015",1,1,0,60000,1500,40
"7977","27400","2015",6,6,0,200068.166666667,2349,83.5
"7978","27401","2015",1,1,0,125000,1562,80
"7979","27403","2015",1,1,0,261150,1612,162
"7980","27404","2015",3,3,0,99000,999.333333333333,104.333333333333
"7981","27405","2015",4,4,0,147662.5,1622.25,88
"7982","27406","2015",11,11,0,166481.818181818,1739.90909090909,100.545454545455
"7983","27407","2015",2,2,0,170000,1320.5,138.5
"7984","27408","2015",13,13,0,164000,1797.23076923077,94.5384615384615
"7985","27410","2015",3,3,0,137000,1592.66666666667,88.3333333333333
"7986","27412","2015",7,7,0,159214.285714286,1804,88.8571428571429
"7987","27414","2015",11,11,0,88963.6363636364,1111.27272727273,79.9090909090909
"7988","27417","2015",6,6,0,121475.666666667,1598.5,81.3333333333333
"7989","27418","2015",1,1,0,107500,1853,58
"7990","27419","2015",6,6,0,133833.333333333,1644.66666666667,85.3333333333333
"7991","27420","2015",2,2,0,127000,2018,62.5
"7992","27421","2015",9,9,0,200333.333333333,1710.55555555556,117.555555555556
"7993","27422","2015",8,8,0,164056.25,1546.125,116.875
"7994","27424","2015",5,5,0,143438.8,1141.8,126.2
"7995","27425","2015",20,20,0,120592.1,1349.15,94.9
"7996","27426","2015",14,14,0,173767.571428571,1647.64285714286,111
"7997","27427","2015",2,2,0,86500,1434.5,59
"7998","27428","2015",39,27,12,115394.153846154,1670.17948717949,76.1282051282051
"7999","27430","2015",7,7,0,137771.428571429,1582.85714285714,88.5714285714286
"8000","27431","2015",5,5,0,65820,1232.2,62.2
"8001","27432","2015",7,7,0,187850,1501.14285714286,122.571428571429
"8002","27436","2015",5,5,0,140000,1352.4,105.8
"8003","27437","2015",2,2,0,123500,1115.5,126.5
"8004","27438","2015",14,14,0,153192.857142857,1521.78571428571,106
"8005","27439","2015",10,10,0,212087.5,1734.4,119.6
"8006","27440","2015",10,10,0,215882.5,1892.2,114.5
"8007","27441","2015",1,1,0,130000,1250,104
"8008","27442","2015",7,7,0,112849.857142857,1279.57142857143,89.2857142857143
"8009","27444","2015",6,6,0,131166.666666667,1377.16666666667,95.3333333333333
"8010","27445","2015",2,2,0,147900,2363,63.5
"8011","27446","2015",2,2,0,160000,1274.5,127
"8012","27447","2015",8,8,0,154625,1928.625,85.875
"8013","27448","2015",55,47,8,162257.181818182,2022.92727272727,86.6
"8014","27451","2015",5,5,0,108500,1480,74.4
"8015","27453","2015",20,20,0,135267.5,1576,91.25
"8016","27454","2015",5,5,0,171000,1361.2,127.6
"8017","27456","2015",4,4,0,489400,4894,88
"8018","27457","2015",7,7,0,148245,1732.71428571429,101.571428571429
"8019","27458","2015",15,15,0,147353.8,1480,107.266666666667
"8020","27460","2015",3,3,0,161000,1439.33333333333,113
"8021","27463","2015",7,7,0,152842.857142857,1461.85714285714,107.857142857143
"8022","27464","2015",13,13,0,152823.076923077,1608.07692307692,102.384615384615
"8023","27465","2015",3,3,0,165333.333333333,1762.33333333333,93.3333333333333
"8024","27467","2015",116,84,32,137082.879310345,1719.27586206897,86.948275862069
"8025","27468","2015",6,6,0,107456.333333333,1278.5,96
"8026","27469","2015",32,29,3,160529.6875,1921.0625,88.875
"8027","27470","2015",14,14,0,138884.285714286,1588.21428571429,86.5
"8028","27471","2015",1,1,0,240000,2143,112
"8029","27472","2015",7,7,0,165118,1626,102.571428571429
"8030","27473","2015",11,11,0,175243.636363636,1736.90909090909,104.545454545455
"8031","27474","2015",15,15,0,193650,2011.6,97.1333333333333
"8032","27476","2015",7,7,0,140435.714285714,1778.42857142857,86.7142857142857
"8033","27477","2015",7,7,0,213821.428571429,1798.71428571429,118
"8034","27478","2015",10,10,0,185314.5,1765.4,111.1
"8035","27480","2015",5,5,0,161596.8,1678,104.4
"8036","27481","2015",4,4,0,161475,1470.25,111
"8037","27483","2015",5,5,0,169210,1531.2,107.6
"8038","27485","2015",9,8,1,60644.4444444444,780,76
"8039","27486","2015",4,4,0,156988.25,1962.25,93.5
"8040","27487","2015",3,3,0,119000,1512.66666666667,81.3333333333333
"8041","27488","2015",1,1,0,138750,1713,81
"8042","27489","2015",2,2,0,135750,1903.5,72
"8043","27490","2015",3,3,0,164864.666666667,1514,127.333333333333
"8044","27493","2015",36,36,0,150795.416666667,1552.75,99.2222222222222
"8045","27495","2015",2,2,0,63000,1134.5,67.5
"8046","27496","2015",15,15,0,125820,1616,83
"8047","27497","2015",15,15,0,143666.666666667,1564.6,93.6666666666667
"8048","27500","2015",13,13,0,136019.230769231,1332.46153846154,109.538461538462
"8049","27501","2015",3,3,0,210483.333333333,1933,112
"8050","27502","2015",20,19,1,101957.95,1173.85,84.25
"8051","27504","2015",7,7,0,196480,1724,118.714285714286
"8052","27505","2015",1,1,0,170000,2179,78
"8053","27507","2015",31,26,5,150901.612903226,1986.25806451613,85.5161290322581
"8054","27508","2015",2,2,0,136000,1577,86.5
"8055","27511","2015",9,9,0,144467.777777778,1396.44444444444,106
"8056","27514","2015",5,5,0,97520,1132,89
"8057","27517","2015",9,9,0,174555.555555556,1822.55555555556,103.222222222222
"8058","27518","2015",2,2,0,143000,1220,128
"8059","27524","2015",7,7,0,181957.142857143,2167.14285714286,85.7142857142857
"8060","27525","2015",3,3,0,199166.666666667,1810.33333333333,110.333333333333
"8061","27527","2015",2,2,0,102750,840,122
"8062","27528","2015",34,30,4,187733.529411765,1757.5,107.529411764706
"8063","27529","2015",6,6,0,183000,1512.16666666667,138.833333333333
"8064","27530","2015",1,1,0,570650,1756,325
"8065","27531","2015",1,1,0,177000,1526,116
"8066","27533","2015",8,7,1,190750,1872.625,109.625
"8067","27534","2015",11,11,0,172354.545454545,1811.36363636364,96.8181818181818
"8068","27535","2015",3,3,0,160143.333333333,1571,105
"8069","27536","2015",4,4,0,89801.25,1069.5,100
"8070","27537","2015",12,12,0,173677.083333333,2005.58333333333,89.9166666666667
"8071","27539","2015",1,1,0,268000,2351,114
"8072","27540","2015",10,10,0,177350,1673.7,112.4
"8073","27543","2015",10,10,0,163335,1603.2,104.5
"8074","27544","2015",3,3,0,157000,1772.33333333333,95.6666666666667
"8075","27546","2015",1,1,0,154500,873,177
"8076","27547","2015",14,14,0,171420,1421.92857142857,131.142857142857
"8077","27548","2015",9,9,0,167444.444444444,1409.44444444444,119.333333333333
"8078","27552","2015",2,2,0,112500,1706.5,67
"8079","27553","2015",3,3,0,110773.333333333,985.666666666667,94.6666666666667
"8080","27554","2015",31,31,0,182428.387096774,1911.45161290323,100.032258064516
"8081","27555","2015",5,5,0,235998,1897.4,128.2
"8082","27557","2015",5,5,0,103900,1130.6,97.8
"8083","27560","2015",8,8,0,165756.25,1618,111.125
"8084","27561","2015",6,6,0,170416.666666667,1986.83333333333,97
"8085","27562","2015",40,31,9,177411.05,1889.75,96.675
"8086","27563","2015",6,6,0,143083.333333333,1381.16666666667,104
"8087","27564","2015",6,6,0,140599.5,1674.33333333333,83.5
"8088","27565","2015",2,2,0,140950,2096,66.5
"8089","27567","2015",4,4,0,111500,2179,55.5
"8090","27568","2015",3,3,0,104333.333333333,1257.33333333333,83.6666666666667
"8091","27569","2015",2,2,0,151750,1646.5,92.5
"8092","27570","2015",1,1,0,170000,850,200
"8093","27572","2015",2,2,0,215000,1407.5,154
"8094","27577","2015",7,7,0,117392.857142857,1120.28571428571,106.571428571429
"8095","27578","2015",5,5,0,105100,1017.6,111.8
"8096","27580","2015",19,19,0,145143.473684211,1711.73684210526,91.2105263157895
"8097","27582","2015",15,15,0,180159.333333333,1886.73333333333,100.133333333333
"8098","27584","2015",3,3,0,136000,1417.33333333333,95
"8099","27586","2015",1,1,0,175750,1302,135
"8100","27589","2015",7,7,0,203857.142857143,2151.28571428571,93.8571428571429
"8101","27590","2015",3,3,0,74710,912,82
"8102","27592","2015",2,2,0,108000,1743.5,67
"8103","27593","2015",20,20,0,155305.6,1719.95,94.15
"8104","27595","2015",8,8,0,156600,1614.5,96.875
"8105","27597","2015",10,10,0,206695,1530.3,128.4
"8106","27598","2015",17,17,0,158911.764705882,1614.05882352941,110.176470588235
"8107","27599","2015",6,6,0,190183.333333333,1998.66666666667,95.8333333333333
"8108","27601","2015",5,5,0,172440,1529,117.6
"8109","27602","2015",39,39,0,160889.743589744,1603.94871794872,101.820512820513
"8110","27604","2015",2,2,0,116500,1323.5,89.5
"8111","27606","2015",7,7,0,154423.714285714,1444.42857142857,116
"8112","27608","2015",5,5,0,148666,1697.6,95.8
"8113","27609","2015",4,4,0,161700,1589.25,98.25
"8114","27610","2015",1,1,0,171000,1368,125
"8115","27611","2015",3,3,0,171000,1369.66666666667,115
"8116","27612","2015",2,2,0,138350,1220,111.5
"8117","27614","2015",3,3,0,159920,1208.33333333333,136.333333333333
"8118","27615","2015",3,3,0,186000,1909.33333333333,98.6666666666667
"8119","27616","2015",16,16,0,169684.375,1769.8125,101.4375
"8120","27617","2015",1,1,0,95000,679,140
"8121","27618","2015",9,9,0,126033.333333333,1413.22222222222,96.7777777777778
"8122","27620","2015",7,7,0,131792.857142857,1584.71428571429,91
"8123","27623","2015",5,5,0,142256.2,1358.4,103.4
"8124","27624","2015",4,4,0,170975,1527.25,121
"8125","27625","2015",4,4,0,155125,1609.25,103
"8126","27631","2015",3,3,0,133333.333333333,1693.66666666667,83.6666666666667
"8127","27632","2015",9,9,0,158657.777777778,1519.44444444444,111.777777777778
"8128","27633","2015",5,2,3,92200,1374.2,78.2
"8129","27638","2015",24,24,0,182105.833333333,1779.375,107.083333333333
"8130","27641","2015",1,1,0,117000,1410,83
"8131","27643","2015",11,11,0,98662.0909090909,1120.54545454545,88.6363636363636
"8132","27644","2015",6,6,0,145250,1429.83333333333,103.166666666667
"8133","27645","2015",1,1,0,210000,1909,110
"8134","27646","2015",10,10,0,154370,1581,100.4
"8135","27649","2015",4,4,0,145160,1502.75,97
"8136","27650","2015",1,1,0,140000,2333,60
"8137","27652","2015",4,4,0,216125,1485.25,146
"8138","27654","2015",7,7,0,155375,1305,115.571428571429
"8139","27655","2015",6,6,0,192730.666666667,1878.5,99.1666666666667
"8140","27656","2015",15,15,0,128321.333333333,1649.86666666667,80.9333333333333
"8141","27658","2015",5,5,0,115348.4,1294.4,86.8
"8142","27659","2015",2,2,0,184700,2149.5,90.5
"8143","27660","2015",2,2,0,79000,878,90.5
"8144","27661","2015",2,2,0,278750,2102.5,134
"8145","27662","2015",9,9,0,147988.888888889,1912.22222222222,79.5555555555556
"8146","27664","2015",5,5,0,131400,1745.8,83.6
"8147","27665","2015",8,8,0,142812.5,1169.125,127.75
"8148","27666","2015",8,8,0,212473.75,1902.625,118.125
"8149","27667","2015",3,3,0,149000,1532,97.6666666666667
"8150","27668","2015",11,11,0,152818.181818182,1561,99
"8151","27669","2015",4,4,0,117750,1914.5,61.5
"8152","27670","2015",9,9,0,155644.444444444,1712.55555555556,94.8888888888889
"8153","27671","2015",3,3,0,187378.333333333,1145,161.333333333333
"8154","27672","2015",5,5,0,157900,1355.2,124.6
"8155","27674","2015",2,2,0,228250,2113.5,100
"8156","27677","2015",5,5,0,170200,1886.2,90.6
"8157","27678","2015",12,12,0,176543.25,1615.25,109.75
"8158","27679","2015",63,52,11,125539.841269841,1571.79365079365,82.1746031746032
"8159","27680","2015",7,7,0,132071.428571429,1134.57142857143,117.142857142857
"8160","27681","2015",245,125,120,166634.959183673,2101.16734693878,82.2734693877551
"8161","27682","2015",8,8,0,201380,1666.75,125.375
"8162","27683","2015",2,2,0,131000,1646,80.5
"8163","27684","2015",10,10,0,153440,1566.3,101.2
"8164","27685","2015",8,8,0,96875,1292,85
"8165","27686","2015",1,1,0,277765,1984,140
"8166","27689","2015",3,3,0,162666.666666667,2084,80.3333333333333
"8167","27690","2015",2,2,0,148500,1552.5,97.5
"8168","27691","2015",5,5,0,104661.8,970.6,103.4
"8169","27692","2015",3,3,0,111000,1317.66666666667,84
"8170","27693","2015",16,16,0,165918.75,1576.1875,112.25
"8171","27694","2015",2,2,0,150500,1240,120.5
"8172","27695","2015",1,1,0,140000,1842,76
"8173","27696","2015",5,5,0,169000,2521.4,67.2
"8174","27697","2015",4,4,0,160820,1542.5,100.25
"8175","27698","2015",4,4,0,108547.5,1076.75,103.75
"8176","27700","2015",5,5,0,180100,1719,107.6
"8177","27701","2015",53,48,5,116879.245283019,1359.45283018868,85.5094339622642
"8178","28001","2015",56,25,31,122669.321428571,1325.57142857143,80.875
"8179","28003","2015",1,1,0,110000,601,183
"8180","28004","2015",7,7,0,128500,1573.85714285714,82
"8181","28005","2015",7,7,0,130292.857142857,1233.57142857143,107.714285714286
"8182","28006","2015",11,11,0,184063.636363636,2085.18181818182,97.3636363636364
"8183","28007","2015",34,34,0,178592.647058824,1929.88235294118,95.9411764705882
"8184","28008","2015",4,4,0,128250,1536,87.75
"8185","28009","2015",1,1,0,150000,1531,98
"8186","28010","2015",4,4,0,76625,918.25,87.75
"8187","28012","2015",43,43,0,80544.4651162791,1051.6976744186,81.2093023255814
"8188","28013","2015",19,19,0,158819.210526316,1823.05263157895,91.8947368421053
"8189","28014","2015",4,4,0,122625,1658.5,73.5
"8190","28015","2015",52,48,4,191896.730769231,2059.76923076923,97.0769230769231
"8191","28016","2015",1,1,0,147000,955,154
"8192","28018","2015",25,25,0,86472,961.16,93.96
"8193","28019","2015",5,5,0,159660,1532.2,123.8
"8194","28021","2015",15,15,0,141323.333333333,1725.93333333333,83.2
"8195","28022","2015",10,10,0,186500,1579.7,115
"8196","28023","2015",17,15,2,181866.176470588,1796.82352941176,106.823529411765
"8197","28024","2015",10,10,0,235950,1921.4,124.6
"8198","28026","2015",3,3,0,193333.333333333,1274,157
"8199","28027","2015",11,11,0,102931.818181818,1193.45454545455,90.8181818181818
"8200","28028","2015",2,2,0,64350,1000.5,79
"8201","28029","2015",4,4,0,123375,1439,93.5
"8202","28030","2015",1,1,0,125000,962,130
"8203","28031","2015",3,3,0,89530,1296.66666666667,73.3333333333333
"8204","28032","2015",3,3,0,124333.333333333,1496,83
"8205","28033","2015",9,9,0,91361,1108.66666666667,86.2222222222222
"8206","28034","2015",4,4,0,174750,2152,90.25
"8207","28035","2015",9,9,0,171033.333333333,1692.33333333333,108
"8208","28036","2015",13,13,0,213038.461538462,2466.84615384615,93.3846153846154
"8209","28037","2015",2,2,0,144000,1259,120
"8210","28038","2015",2,2,0,160500,1216,124.5
"8211","28039","2015",19,16,3,211113.684210526,2065.73684210526,101.368421052632
"8212","28040","2015",4,4,0,155750,1693.5,96.25
"8213","28041","2015",1,1,0,132000,1737,76
"8214","28045","2015",2,2,0,146000,1943,75
"8215","28046","2015",3,3,0,118991.666666667,1073.66666666667,107
"8216","28047","2015",6,6,0,97916.6666666667,1593.33333333333,63.5
"8217","28048","2015",5,5,0,115660,1384.6,84.6
"8218","28050","2015",6,6,0,189941.666666667,1811.16666666667,113.833333333333
"8219","28051","2015",47,46,1,116061.085106383,1363.70212765957,89.9148936170213
"8220","28052","2015",9,9,0,168554.444444444,1630.33333333333,107.777777777778
"8221","28053","2015",1,1,0,50000,549,91
"8222","28054","2015",5,5,0,126200,1325.2,100.4
"8223","28055","2015",8,8,0,150687.5,1137.75,132.625
"8224","28056","2015",19,18,1,262583.947368421,2059.10526315789,129.052631578947
"8225","28057","2015",4,4,0,120720,1234.5,100.25
"8226","28058","2015",3,3,0,256783.333333333,1662.66666666667,166.666666666667
"8227","28059","2015",21,20,1,112476.19047619,1256.42857142857,90.5714285714286
"8228","28060","2015",3,3,0,164400,1249.33333333333,133.666666666667
"8229","28061","2015",36,34,2,104122.777777778,1179.13888888889,89.3333333333333
"8230","28062","2015",12,12,0,224109.166666667,2180.08333333333,101.416666666667
"8231","28064","2015",33,31,2,201508.515151515,2160.45454545455,98.1515151515152
"8232","28068","2015",2,2,0,182500,1831,99.5
"8233","28070","2015",32,31,1,217039.625,2321.4375,98.84375
"8234","28071","2015",7,7,0,109957.142857143,1491.28571428571,79.7142857142857
"8235","28072","2015",5,5,0,109620,1334.2,81
"8236","28073","2015",3,3,0,189666.666666667,2193.66666666667,86.3333333333333
"8237","28074","2015",5,5,0,193810,1900.8,103.2
"8238","28075","2015",10,10,0,116571.7,1296.1,89.3
"8239","28076","2015",5,5,0,193644,1690.8,121.2
"8240","28077","2015",2,2,0,79500,1585,51.5
"8241","28078","2015",2,2,0,49000,659.5,74.5
"8242","28079","2015",7,7,0,75571.4285714286,1042.57142857143,78.5714285714286
"8243","28080","2015",3,3,0,56283.3333333333,915.666666666667,59.3333333333333
"8244","28081","2015",1,1,0,127000,1984,64
"8245","28082","2015",10,10,0,193231.4,1524,130.5
"8246","28084","2015",5,5,0,194100,2030.8,96.2
"8247","28085","2015",548,185,363,149596.208029197,2136.26094890511,72.1021897810219
"8248","28086","2015",5,5,0,109320,1026.6,108.6
"8249","28087","2015",1,1,0,103000,705,146
"8250","28088","2015",106,86,20,99325.9622641509,1173.91509433962,87
"8251","28089","2015",21,17,4,118464.761904762,1576.28571428571,86.8571428571429
"8252","28090","2015",1,1,0,81500,791,103
"8253","28091","2015",1,1,0,146000,936,156
"8254","28092","2015",3,3,0,120666.666666667,1272.33333333333,98.6666666666667
"8255","28094","2015",35,34,1,168571.2,1802.4,96.5142857142857
"8256","28095","2015",3,3,0,173523.333333333,1893,92.6666666666667
"8257","28096","2015",21,19,2,151685.714285714,1943.42857142857,81.9047619047619
"8258","28098","2015",20,20,0,188480,2151.35,92.45
"8259","28099","2015",6,6,0,143108.333333333,1287,112.5
"8260","28100","2015",6,6,0,186143.333333333,2022.83333333333,92.5
"8261","28102","2015",7,7,0,134878.571428571,1530,90.5714285714286
"8262","28103","2015",59,59,0,96877.6271186441,1236.61016949153,80.4576271186441
"8263","28104","2015",9,9,0,165277.777777778,1530.55555555556,108.555555555556
"8264","28105","2015",3,3,0,118566.666666667,1682,69.3333333333333
"8265","28106","2015",5,5,0,135600,1421.2,100.4
"8266","28107","2015",4,4,0,188225,2095.5,93.5
"8267","28108","2015",2,2,0,97500,1206,80
"8268","28109","2015",8,8,0,102125,1096.625,96
"8269","28110","2015",34,18,16,194244.705882353,2487.47058823529,82.6470588235294
"8270","28111","2015",2,2,0,84250,1149.5,78.5
"8271","28113","2015",24,22,2,182091.666666667,1767.66666666667,103.958333333333
"8272","28114","2015",1,1,0,88000,2256,39
"8273","28116","2015",21,21,0,129071.428571429,1567.28571428571,87.9523809523809
"8274","28117","2015",2,2,0,86000,1204.5,81
"8275","28118","2015",3,3,0,245633.333333333,1698.66666666667,166.666666666667
"8276","28119","2015",3,3,0,90333.3333333333,1163.66666666667,78.6666666666667
"8277","28120","2015",9,9,0,126555.555555556,1211.77777777778,115.222222222222
"8278","28121","2015",1,1,0,1e+05,714,140
"8279","28122","2015",10,10,0,149130,1576.3,94.6
"8280","28123","2015",3,3,0,118333.333333333,1401,87.6666666666667
"8281","28124","2015",14,14,0,146535.714285714,1232.21428571429,120.928571428571
"8282","28126","2015",2,2,0,148444.5,973.5,168
"8283","28127","2015",15,15,0,115603.333333333,1314.8,95.1333333333333
"8284","28128","2015",5,5,0,184170,1651,115.6
"8285","28129","2015",11,11,0,160000,1794.72727272727,94.6363636363636
"8286","28130","2015",17,17,0,137823.529411765,1453.58823529412,101.764705882353
"8287","28132","2015",11,11,0,117711.363636364,1260.63636363636,95.5454545454545
"8288","28134","2015",274,143,131,123732.737226277,1644.78832116788,77.5875912408759
"8289","28135","2015",10,9,1,273313.7,2303.2,123.3
"8290","28136","2015",1,1,0,196000,2882,68
"8291","28137","2015",10,10,0,193929,2360,88.4
"8292","28139","2015",1,1,0,95000,1188,80
"8293","28140","2015",82,34,48,151101.817073171,2305.07317073171,70.4756097560976
"8294","28141","2015",3,3,0,128500,1677.66666666667,80
"8295","28142","2015",6,6,0,128883.333333333,1399.66666666667,95.8333333333333
"8296","28143","2015",3,3,0,228666.666666667,1688.33333333333,138
"8297","28144","2015",5,5,0,89760,1598.6,69.4
"8298","28146","2015",12,12,0,240722,1888.91666666667,130.083333333333
"8299","28147","2015",9,9,0,144477.777777778,1428.88888888889,111.111111111111
"8300","28148","2015",5,5,0,136120,1478.8,92
"8301","28149","2015",16,16,0,121062.5,1275.5,101.625
"8302","28151","2015",3,3,0,126666.666666667,1238,103
"8303","28153","2015",1,1,0,83000,954,87
"8304","28154","2015",14,14,0,197966.928571429,1825.21428571429,111.571428571429
"8305","28155","2015",1,1,0,110000,1250,88
"8306","28156","2015",9,9,0,117777.777777778,1137.11111111111,109.222222222222
"8307","28157","2015",2,2,0,91500,1376,67
"8308","28158","2015",5,5,0,195420,2152,93.4
"8309","28159","2015",5,5,0,182100,2309.4,97.8
"8310","28160","2015",15,15,0,142806.666666667,1637.66666666667,95.0666666666667
"8311","28161","2015",8,8,0,112500,1013.25,113.75
"8312","28162","2015",4,4,0,128853,1375.5,101.25
"8313","28163","2015",1,1,0,142000,1340,106
"8314","28164","2015",6,6,0,131977.666666667,1544.33333333333,89.6666666666667
"8315","28166","2015",1,1,0,30000,1034,29
"8316","28167","2015",6,6,0,137833.333333333,1545.16666666667,95.3333333333333
"8317","28168","2015",37,29,8,171671.135135135,2055.27027027027,87.5675675675676
"8318","28169","2015",3,3,0,211358.333333333,1852.33333333333,119.333333333333
"8319","28170","2015",2,2,0,143962.5,1585,90
"8320","28171","2015",7,7,0,133357.142857143,1660.71428571429,82
"8321","28172","2015",9,9,0,213305.555555556,2189.44444444444,98.6666666666667
"8322","28173","2015",15,15,0,217062,1979.13333333333,114.266666666667
"8323","28175","2015",2,2,0,97500,949,101.5
"8324","28176","2015",6,6,0,120516.666666667,1325.33333333333,92.6666666666667
"8325","28177","2015",4,4,0,164500,1724.25,101
"8326","28178","2015",3,3,0,140666.666666667,1137.33333333333,148.333333333333
"8327","28180","2015",4,4,0,184475,1591.25,113.75
"8328","28182","2015",5,5,0,117640,1265.8,91
"8329","28183","2015",8,8,0,152030.625,1689.625,91
"8330","28184","2015",6,6,0,131833.333333333,1260.66666666667,105.166666666667
"8331","28185","2015",15,15,0,263656.666666667,2327.66666666667,122.533333333333
"8332","28187","2015",6,6,0,217568.666666667,2161.33333333333,101.833333333333
"8333","28188","2015",19,19,0,193365.105263158,1786.21052631579,111.789473684211
"8334","28189","2015",2,2,0,118000,1670.5,70.5
"8335","28190","2015",8,8,0,131256.25,1186.625,113.25
"8336","28191","2015",27,25,2,204485.185185185,2406.18518518519,95.5185185185185
"8337","28192","2015",9,9,0,115933.333333333,1357.66666666667,98.3333333333333
"8338","28193","2015",1,1,0,285000,2227,128
"8339","28194","2015",7,7,0,175714.285714286,1876.71428571429,95
"8340","28195","2015",6,6,0,183836.666666667,2117.66666666667,90.1666666666667
"8341","28196","2015",33,31,2,117658.272727273,1314.84848484848,93.7272727272727
"8342","28197","2015",1,1,0,55000,743,74
"8343","28198","2015",5,5,0,137010,1366.4,99.2
"8344","28199","2015",19,19,0,130621.052631579,1363.68421052632,99.7894736842105
"8345","28200","2015",6,6,0,125833.333333333,1389.5,91.8333333333333
"8346","28201","2015",18,17,1,217077.777777778,2009.94444444444,110.222222222222
"8347","28202","2015",4,4,0,138750,1559.25,90.75
"8348","28203","2015",5,5,0,157800,1420.2,113.2
"8349","28206","2015",8,8,0,119375,1496.125,84.625
"8350","28207","2015",4,4,0,171750,1485.25,121
"8351","28208","2015",5,5,0,206300,1916,109.6
"8352","28209","2015",52,44,8,207117.307692308,2041.55769230769,102.519230769231
"8353","28210","2015",3,3,0,148166.666666667,1791.33333333333,82.6666666666667
"8354","28211","2015",7,7,0,111171.428571429,1211.28571428571,90.1428571428571
"8355","28212","2015",2,2,0,125000,1463,88
"8356","28213","2015",10,7,3,118068,1837.7,64
"8357","28214","2015",30,29,1,91083.3333333333,1115.83333333333,96.2666666666667
"8358","28215","2015",4,4,0,116750,1138.5,103.5
"8359","28216","2015",1,1,0,190000,2714,70
"8360","28217","2015",3,3,0,141586.666666667,1105.66666666667,121
"8361","28218","2015",102,67,35,147773.039215686,2004.77450980392,76.1274509803922
"8362","28219","2015",5,5,0,83080,966.2,89.6
"8363","28220","2015",75,62,13,198804.173333333,2136.52,96.68
"8364","28221","2015",2,2,0,60000,663.5,98
"8365","28222","2015",6,6,0,162183.333333333,1804.16666666667,100.666666666667
"8366","28223","2015",13,13,0,148307.692307692,1662.15384615385,91.6923076923077
"8367","28225","2015",4,4,0,135750,1613,82.5
"8368","28226","2015",8,8,0,160500,1246,138.5
"8369","28227","2015",54,42,12,177942.37037037,2289.94444444444,81.9444444444444
"8370","28229","2015",116,62,54,157215.525862069,2076.44827586207,76.2672413793103
"8371","28230","2015",4,4,0,206000,1950.25,106.5
"8372","28231","2015",2,2,0,102222.5,1012,103.5
"8373","28232","2015",7,7,0,125214.285714286,2069.28571428571,78.7142857142857
"8374","28233","2015",14,14,0,98139.1428571429,1052,98.1428571428571
"8375","28234","2015",5,5,0,149000,2335.4,72.8
"8376","28235","2015",3,3,0,261000,1889.66666666667,141.666666666667
"8377","28236","2015",26,26,0,111211.538461538,1202.57692307692,94.6538461538462
"8378","28237","2015",5,5,0,137740,1021.4,117
"8379","28239","2015",7,7,0,131428.571428571,1457.85714285714,94.1428571428571
"8380","28240","2015",8,8,0,113500,1156.25,99.875
"8381","28242","2015",1,1,0,78000,886,88
"8382","28243","2015",2,2,0,115050,1262.5,101.5
"8383","28245","2015",3,3,0,155166.666666667,1750,90
"8384","28246","2015",7,7,0,163791.428571429,1568.42857142857,105.714285714286
"8385","28247","2015",5,5,0,250800,1941.2,133.2
"8386","28248","2015",2,2,0,134352.5,1415.5,94
"8387","28249","2015",4,3,1,143750,2327.25,61.75
"8388","28251","2015",4,4,0,169375,1981.5,99
"8389","28252","2015",3,3,0,157833.333333333,1317.66666666667,124.666666666667
"8390","28253","2015",12,12,0,171522,1773.08333333333,101.583333333333
"8391","28254","2015",5,5,0,204600,1617.4,144.4
"8392","28255","2015",3,3,0,169666.666666667,1912.33333333333,98.3333333333333
"8393","28256","2015",6,6,0,106125,1192.66666666667,89.1666666666667
"8394","28259","2015",3,3,0,153200,1114.66666666667,138.666666666667
"8395","28261","2015",8,8,0,97681.25,1149.125,87.875
"8396","28263","2015",2,2,0,139000,1513.5,92.5
"8397","28264","2015",1,1,0,55000,362,152
"8398","28265","2015",1,1,0,87000,888,98
"8399","28267","2015",11,11,0,143500,1203.18181818182,124.545454545455
"8400","28269","2015",10,10,0,191991,1993,101.1
"8401","28270","2015",5,5,0,143972.4,1501.2,101.2
"8402","28271","2015",5,5,0,107800,1232.4,96.4
"8403","28272","2015",6,6,0,101833.333333333,1426.5,81.6666666666667
"8404","28273","2015",2,2,0,120000,1286,92.5
"8405","28274","2015",4,4,0,130500,1378.5,106.5
"8406","28275","2015",4,4,0,167250,1722.75,98.75
"8407","28276","2015",1,1,0,40000,833,48
"8408","28277","2015",2,2,0,107500,1342,96
"8409","28278","2015",10,6,4,200228,3532,87.7
"8410","28279","2015",47,38,9,158482.234042553,1816.31914893617,91.2127659574468
"8411","28280","2015",105,80,25,101633.066666667,1195.13333333333,84.6666666666667
"8412","28281","2015",6,6,0,195266.666666667,1513.16666666667,127.833333333333
"8413","28282","2015",6,6,0,116500,1170.83333333333,98.8333333333333
"8414","28283","2015",2,2,0,203025,1353,161.5
"8415","28284","2015",4,4,0,143750,1512.25,94.75
"8416","28285","2015",8,8,0,196331.25,2063.875,100.75
"8417","28286","2015",5,5,0,128200,1832.6,81.6
"8418","28287","2015",12,12,0,114266.666666667,1341.91666666667,88.5833333333333
"8419","28289","2015",1,1,0,155000,1435,108
"8420","28290","2015",3,3,0,99166.6666666667,1178.33333333333,86.6666666666667
"8421","28291","2015",8,8,0,156262.5,1621.375,101.25
"8422","28292","2015",8,8,0,229125,1723.75,146.125
"8423","28293","2015",14,14,0,194285.714285714,1995.28571428571,109.214285714286
"8424","28294","2015",7,7,0,154571.428571429,1676,102.571428571429
"8425","28296","2015",1,1,0,97000,404,240
"8426","28298","2015",25,21,4,170608,2148.64,81.92
"8427","28299","2015",3,3,0,221000,1951,114.666666666667
"8428","28300","2015",3,3,0,169958.333333333,1738.33333333333,98
"8429","28301","2015",1,1,0,173000,1880,92
"8430","28302","2015",15,15,0,99693.3333333333,1147.66666666667,90.5333333333333
"8431","28304","2015",8,8,0,108875,1273,91.375
"8432","28305","2015",1,1,0,90000,1250,72
"8433","28306","2015",2,2,0,85500,1230.5,67.5
"8434","28308","2015",3,3,0,130000,1057.33333333333,122.333333333333
"8435","28309","2015",9,9,0,162444.444444444,1527.22222222222,104.555555555556
"8436","28310","2015",4,4,0,124000,1116.25,110
"8437","28314","2015",4,4,0,51875,1513.25,51.5
"8438","28315","2015",1,1,0,102000,990,103
"8439","28316","2015",3,3,0,102333.333333333,981,101
"8440","28317","2015",9,9,0,149527.777777778,1968.22222222222,84.6666666666667
"8441","28319","2015",6,6,0,162749.166666667,1452.16666666667,116.166666666667
"8442","28321","2015",14,14,0,194272.142857143,1965.14285714286,99.7142857142857
"8443","28322","2015",6,6,0,126833.333333333,1315.66666666667,104
"8444","28323","2015",4,4,0,190300,2416.75,81
"8445","28324","2015",5,5,0,131400,1352.6,97.4
"8446","28325","2015",11,11,0,176020.909090909,1745.90909090909,103.727272727273
"8447","28326","2015",2,2,0,106500,898,118.5
"8448","28327","2015",1,1,0,15000,349,43
"8449","28329","2015",1,1,0,75000,1119,67
"8450","28330","2015",16,16,0,110174.4375,1060.5625,109.1875
"8451","28331","2015",13,13,0,100950,1491.69230769231,73.3076923076923
"8452","28332","2015",13,13,0,181093.307692308,1742.61538461538,104.076923076923
"8453","28333","2015",3,3,0,81666.6666666667,1212.66666666667,67.3333333333333
"8454","28334","2015",12,12,0,122895.833333333,1377.58333333333,90.5
"8455","28335","2015",8,8,0,137568.75,1245,109.875
"8456","28336","2015",2,2,0,122000,1726.5,72
"8457","28337","2015",24,24,0,237001.041666667,1989.20833333333,109.541666666667
"8458","28339","2015",1,1,0,226000,1507,150
"8459","28341","2015",1,1,0,195000,1950,100
"8460","28342","2015",1,1,0,191500,1451,132
"8461","28343","2015",7,7,0,248414.285714286,1997.28571428571,126.714285714286
"8462","28344","2015",5,5,0,104400,1171.6,88.2
"8463","28347","2015",11,11,0,264777.272727273,2406.09090909091,122.727272727273
"8464","28348","2015",30,30,0,125200,1489.53333333333,89.6
"8465","28349","2015",1,1,0,276200,2092,132
"8466","28350","2015",10,10,0,184548.5,1670.2,112.9
"8467","28351","2015",4,4,0,247100,1645.5,159.5
"8468","28352","2015",25,25,0,213682,2016.6,108.6
"8469","28353","2015",9,9,0,125333.333333333,1355.22222222222,93.8888888888889
"8470","28354","2015",3,3,0,99666.6666666667,1268.33333333333,78.3333333333333
"8471","28355","2015",4,4,0,256287.5,2066.25,127
"8472","28357","2015",16,16,0,202845,2054.875,101.8125
"8473","28358","2015",17,15,2,231320.588235294,1757.58823529412,136.705882352941
"8474","28359","2015",28,28,0,133603.571428571,1530.85714285714,89.8571428571429
"8475","28360","2015",14,14,0,140642.857142857,1477.21428571429,97.7142857142857
"8476","28362","2015",8,8,0,107375,1287.375,84
"8477","28363","2015",12,12,0,218833.333333333,1801.08333333333,126.583333333333
"8478","28364","2015",8,8,0,101625,1206.125,84.25
"8479","28365","2015",2,2,0,173500,1446,120
"8480","28366","2015",2,2,0,178902.5,2652.5,72
"8481","28367","2015",4,4,0,127125,1129.25,107.75
"8482","28368","2015",1,1,0,136000,1333,102
"8483","28369","2015",7,7,0,157192.857142857,1399,133.571428571429
"8484","28370","2015",4,4,0,127002.5,1428.25,90.5
"8485","28371","2015",14,14,0,169514.285714286,2137.85714285714,81.9285714285714
"8486","28372","2015",8,7,1,189088.75,1985.75,99.75
"8487","28373","2015",44,44,0,110253.636363636,1252.47727272727,87.1136363636364
"8488","28374","2015",5,5,0,180040,1475,122.4
"8489","28375","2015",7,7,0,172561.428571429,2217,83.4285714285714
"8490","28377","2015",22,19,3,164700.136363636,1929.81818181818,91.8636363636364
"8491","28378","2015",5,5,0,87400,1063,84.4
"8492","28379","2015",4,4,0,184250,1683.5,110.5
"8493","28380","2015",12,12,0,140266.666666667,1610.25,90.75
"8494","28382","2015",6,6,0,105825,953.833333333333,113
"8495","28383","2015",7,7,0,143371.428571429,1421.28571428571,94.8571428571429
"8496","28385","2015",4,4,0,122275,1331,99
"8497","28386","2015",11,11,0,139359.090909091,1372.36363636364,101.818181818182
"8498","28387","2015",14,14,0,132678.571428571,1564.28571428571,86
"8499","28388","2015",11,11,0,173145.818181818,2032.36363636364,84.5454545454545
"8500","28389","2015",1,1,0,54000,831,65
"8501","28390","2015",6,6,0,128708.833333333,1061.66666666667,119.666666666667
"8502","28391","2015",27,27,0,129016.666666667,1521.92592592593,87.3333333333333
"8503","28392","2015",2,2,0,80250,818.5,116
"8504","28393","2015",37,37,0,156876.567567568,1623.94594594595,102
"8505","28394","2015",16,15,1,158343.75,1608.75,104.1875
"8506","28395","2015",4,4,0,174750,1501.25,97
"8507","28396","2015",4,4,0,161100,1320.5,124.5
"8508","28397","2015",7,7,0,161507.142857143,1866.85714285714,105
"8509","28398","2015",12,12,0,95018.3333333333,1094.91666666667,86.8333333333333
"8510","28400","2015",2,2,0,150950,1668.5,107.5
"8511","28401","2015",2,2,0,113000,1227.5,91.5
"8512","28403","2015",5,5,0,199420,1817.4,110.4
"8513","28404","2015",75,62,13,147110.386666667,1759.08,89.6133333333333
"8514","28405","2015",16,16,0,137196.875,1357,116.3125
"8515","28406","2015",17,17,0,118104.705882353,1127.11764705882,108.823529411765
"8516","28407","2015",7,7,0,112060,1335.57142857143,89.2857142857143
"8517","28408","2015",2,2,0,134500,1272.5,101.5
"8518","28409","2015",7,7,0,106714.285714286,1234.42857142857,94.7142857142857
"8519","28410","2015",2,2,0,185500,1360.5,129.5
"8520","28411","2015",2,2,0,82000,2147,44.5
"8521","28414","2015",1,1,0,103500,1310,79
"8522","28415","2015",17,16,1,137335.294117647,1780.11764705882,81.8235294117647
"8523","28417","2015",18,18,0,211856.111111111,1945.72222222222,108.833333333333
"8524","28418","2015",2,2,0,91621,1186,78.5
"8525","28419","2015",6,6,0,120891.666666667,1356.16666666667,92
"8526","28421","2015",3,3,0,170000,1315.33333333333,130.666666666667
"8527","28422","2015",44,42,2,118915,1376.88636363636,88.25
"8528","28423","2015",12,12,0,239084,2904.33333333333,120.333333333333
"8529","28424","2015",18,18,0,124030,1543.22222222222,88.2777777777778
"8530","28425","2015",9,9,0,149055.555555556,1913.33333333333,87.3333333333333
"8531","28426","2015",3,3,0,127000,1272,99.3333333333333
"8532","29001","2015",11,11,0,148909.090909091,2013.72727272727,76.9090909090909
"8533","29002","2015",14,14,0,139281.428571429,1275.57142857143,109.428571428571
"8534","29003","2015",79,63,16,144718.405063291,1677.62025316456,88.2278481012658
"8535","29004","2015",60,60,0,111000,1215.5,95.7666666666667
"8536","29005","2015",7,7,0,157713.857142857,1472.14285714286,110.857142857143
"8537","29006","2015",100,57,43,182814.39,2442.84,76.73
"8538","29007","2015",18,18,0,75802.7777777778,922.166666666667,82.1111111111111
"8539","29008","2015",3,3,0,133000,1342.33333333333,102.333333333333
"8540","29010","2015",9,9,0,108366.666666667,939.333333333333,117.444444444444
"8541","29011","2015",26,26,0,201277.192307692,1755.65384615385,116.884615384615
"8542","29012","2015",4,4,0,46500,857,55.5
"8543","29013","2015",4,4,0,75000,795.75,93.25
"8544","29014","2015",2,2,0,58000,580,100
"8545","29015","2015",27,23,4,146570.555555556,1359.11111111111,115.851851851852
"8546","29016","2015",7,7,0,56142.8571428571,702,80.4285714285714
"8547","29017","2015",10,10,0,134985,1380.7,96.7
"8548","29018","2015",5,5,0,69000,1054.2,69.8
"8549","29019","2015",2234,580,1654,105454.349597135,1439.02282900627,72.3272157564906
"8550","29020","2015",39,39,0,128142.794871795,1178.74358974359,112.435897435897
"8551","29021","2015",20,20,0,102141.15,1210.95,90.75
"8552","29022","2015",45,36,9,127435.4,1617.48888888889,86.0444444444445
"8553","29023","2015",45,36,9,205439.111111111,2150.42222222222,94.8
"8554","29024","2015",79,68,11,81935.4430379747,1024.88607594937,83.253164556962
"8555","29025","2015",15,15,0,108946.666666667,1244.4,91
"8556","29026","2015",46,39,7,124341.304347826,1537.4347826087,92.5434782608696
"8557","29027","2015",42,42,0,88223.8095238095,999.666666666667,95.6428571428571
"8558","29028","2015",12,12,0,121041.666666667,1338.16666666667,100
"8559","29029","2015",12,12,0,67795.8333333333,1078.83333333333,62.0833333333333
"8560","29030","2015",54,52,2,117948.888888889,1321.74074074074,94.9259259259259
"8561","29031","2015",104,88,16,158835.673076923,1977.75961538462,85.1923076923077
"8562","29032","2015",18,18,0,211422.5,1771.22222222222,125.222222222222
"8563","29033","2015",8,8,0,86181.25,817.5,101.125
"8564","29034","2015",11,11,0,92513.6363636364,1221.63636363636,79
"8565","29035","2015",13,12,1,137738.461538462,1428.23076923077,98.3846153846154
"8566","29036","2015",10,10,0,62260,866.1,83.5
"8567","29037","2015",53,52,1,222677.735849057,2149.54716981132,108.584905660377
"8568","29038","2015",20,19,1,67200,797.45,88.6
"8569","29039","2015",333,189,144,159461.876876877,1939.45045045045,86.3843843843844
"8570","29040","2015",47,43,4,195007.446808511,2058.29787234043,101.744680851064
"8571","29041","2015",23,23,0,109356.52173913,1060.17391304348,102.130434782609
"8572","29042","2015",105,90,15,161837.885714286,1853.77142857143,91.3333333333333
"8573","29043","2015",21,21,0,155684.285714286,1576.85714285714,100.571428571429
"8574","29044","2015",15,15,0,91466.6666666667,922.733333333333,99.1333333333333
"8575","29045","2015",12,12,0,168916.666666667,1497.75,118.416666666667
"8576","29046","2015",206,145,61,112781.398058252,1308.04854368932,87.4077669902913
"8577","29047","2015",10,10,0,129358,1153.5,113.7
"8578","29048","2015",18,18,0,110333.333333333,1171.61111111111,93.7777777777778
"8579","29049","2015",37,37,0,111048.648648649,1179.86486486486,94.8378378378378
"8580","29051","2015",49,48,1,144864.612244898,1451.44897959184,102.061224489796
"8581","29053","2015",26,26,0,113973.846153846,1159.42307692308,97.8846153846154
"8582","29054","2015",5,5,0,79520,1216,64.4
"8583","29055","2015",36,33,3,119514.444444444,1218.22222222222,102.888888888889
"8584","29056","2015",19,19,0,166433.157894737,1571.31578947368,106.842105263158
"8585","29057","2015",10,8,2,198825,2056.8,106.8
"8586","29058","2015",167,131,36,222671.790419162,2125.58083832335,103.688622754491
"8587","29059","2015",9,9,0,111500,1198.66666666667,90.8888888888889
"8588","29060","2015",24,23,1,217038.958333333,1996.79166666667,112.75
"8589","29061","2015",54,51,3,189168.833333333,1757.75925925926,110.777777777778
"8590","29062","2015",4,4,0,110250,1112,111
"8591","29063","2015",5,5,0,126690,997,114.4
"8592","29064","2015",6,6,0,144603.5,1534.16666666667,92.5
"8593","29065","2015",5,5,0,123840,1413.8,88.8
"8594","29066","2015",11,11,0,174145.454545455,1555.36363636364,112.090909090909
"8595","29067","2015",10,10,0,110950,1406.3,89.2
"8596","29068","2015",24,24,0,117993.333333333,1213.125,95.75
"8597","29069","2015",63,59,4,162724.428571429,1693.98412698413,97.8888888888889
"8598","29070","2015",8,8,0,107625,1389.125,87.25
"8599","29071","2015",7,7,0,104078.571428571,1002.42857142857,118.571428571429
"8600","29072","2015",74,66,8,135737.594594595,1659.41891891892,83.9594594594595
"8601","29073","2015",17,17,0,134220.588235294,1390.11764705882,97.7647058823529
"8602","29074","2015",9,9,0,118833.333333333,1280.11111111111,95.3333333333333
"8603","29075","2015",141,123,18,161271.524822695,1637.3829787234,99.4751773049645
"8604","29076","2015",40,40,0,171208.5,1599.75,109.825
"8605","29077","2015",22,22,0,145577.272727273,1388.59090909091,104.227272727273
"8606","29078","2015",20,20,0,125473.75,1201.4,102.5
"8607","29079","2015",9,8,1,106383.333333333,1281.44444444444,79.3333333333333
"8608","29080","2015",34,34,0,143480.705882353,1558.38235294118,93.6176470588235
"8609","29081","2015",48,46,2,82328.6875,905.4375,90.75
"8610","29082","2015",14,11,3,180557.857142857,2824.64285714286,68.3571428571429
"8611","29085","2015",30,14,16,156465.8,2523.53333333333,69.7
"8612","29086","2015",12,12,0,120500,1306.91666666667,93.5
"8613","29087","2015",5,5,0,145700,1108.6,132.4
"8614","29089","2015",7,7,0,120271.428571429,1294.14285714286,92
"8615","29090","2015",4,4,0,168137.5,1333.25,129.75
"8616","29091","2015",29,29,0,120257.586206897,1275.10344827586,104.103448275862
"8617","29093","2015",17,17,0,142047.058823529,1290.05882352941,107
"8618","29094","2015",3,3,0,123594.666666667,1099,113.666666666667
"8619","29095","2015",14,14,0,175822.857142857,1594,111.928571428571
"8620","29097","2015",11,11,0,115474.545454545,1090.45454545455,108.363636363636
"8621","29098","2015",29,28,1,145450.344827586,1581.58620689655,100.51724137931
"8622","29099","2015",5,5,0,127200,1336.2,102
"8623","29100","2015",3,3,0,245004,1454.66666666667,169.666666666667
"8624","29101","2015",18,15,3,199922.777777778,1837.94444444444,107.111111111111
"8625","29102","2015",18,18,0,68985.8333333333,776.5,86.7222222222222
"8626","29103","2015",185,132,53,130678.259459459,1463.32972972973,89.8216216216216
"8627","29104","2015",2,2,0,190000,1148,178
"8628","29105","2015",86,60,26,99696.4534883721,1215.67441860465,83.0813953488372
"8629","29106","2015",18,18,0,118737.888888889,1249.05555555556,103.222222222222
"8630","29107","2015",13,13,0,114615.384615385,1278.07692307692,87.8461538461538
"8631","29108","2015",16,16,0,142172.875,1265.625,118.125
"8632","29109","2015",16,16,0,163837.5,1538.5625,102.3125
"8633","29110","2015",6,6,0,102383.333333333,1079.16666666667,95.6666666666667
"8634","29111","2015",12,12,0,114012.5,1215.25,95.5
"8635","29112","2015",12,12,0,174679.416666667,1948.66666666667,91.1666666666667
"8636","29113","2015",29,29,0,102906.896551724,1140.86206896552,90.3103448275862
"8637","29114","2015",2,2,0,59500,685,87
"8638","29115","2015",4,4,0,97747,801,125.5
"8639","29116","2015",1,1,0,125000,1389,90
"8640","29117","2015",53,49,4,126542.528301887,1450.33962264151,87.1320754716981
"8641","29119","2015",11,11,0,161500,1529.81818181818,110.909090909091
"8642","29120","2015",22,16,6,100920.136363636,1231.72727272727,83.4090909090909
"8643","29122","2015",11,11,0,84163.6363636364,935.090909090909,93.8181818181818
"8644","29123","2015",6,6,0,93500,995.5,87.8333333333333
"8645","29124","2015",76,66,10,115530.934210526,1298.80263157895,90.1184210526316
"8646","29125","2015",11,11,0,79272.7272727273,795.909090909091,94
"8647","29126","2015",4,4,0,134994.75,1402.75,95.75
"8648","29128","2015",2,2,0,95500,1033.5,92.5
"8649","29130","2015",61,60,1,207546.229508197,1781.08196721311,116.426229508197
"8650","29131","2015",2,2,0,129750,1078.5,117
"8651","29132","2015",11,11,0,140904.545454545,1410.36363636364,104.454545454545
"8652","29133","2015",44,37,7,175350.068181818,2238.06818181818,82.2045454545455
"8653","29134","2015",7,7,0,118698.571428571,1263.42857142857,88.1428571428571
"8654","29135","2015",65,60,5,158682.692307692,1618.83076923077,101.184615384615
"8655","29136","2015",9,9,0,93166.6666666667,1041.77777777778,90.1111111111111
"8656","29137","2015",17,17,0,163156.117647059,1742.41176470588,104.823529411765
"8657","29139","2015",6,6,0,104876.833333333,1116,92.3333333333333
"8658","29140","2015",30,30,0,199985.2,1655.63333333333,122.5
"8659","29141","2015",4,4,0,56250,803.75,70.75
"8660","29142","2015",2,2,0,105000,989,108
"8661","29143","2015",5,5,0,130700,1388,97.2
"8662","29144","2015",4,4,0,160750,1385.5,116.25
"8663","29145","2015",7,7,0,127857.142857143,1436.42857142857,94.8571428571429
"8664","29146","2015",34,34,0,139111.352941176,1384.91176470588,104.323529411765
"8665","29147","2015",16,15,1,134393.75,1506.8125,94.0625
"8666","29148","2015",4,4,0,76750,685.75,121
"8667","29150","2015",121,104,17,161295.94214876,1759.09090909091,96.4297520661157
"8668","29151","2015",232,152,80,95957.974137931,1143.9224137931,85.7629310344828
"8669","29152","2015",9,9,0,127134.666666667,919.777777777778,112.888888888889
"8670","29153","2015",48,47,1,191531.229166667,1731.875,112.666666666667
"8671","29155","2015",9,8,1,170246.666666667,2492.44444444444,73.4444444444444
"8672","29156","2015",15,15,0,174306,1604.13333333333,109.6
"8673","29158","2015",97,89,8,130375.257731959,1409.09278350515,95.979381443299
"8674","29159","2015",8,8,0,114125,1207,96.875
"8675","29160","2015",87,83,4,151985.91954023,1640.47126436782,95.4942528735632
"8676","29161","2015",11,10,1,190582,1645.09090909091,113
"8677","29162","2015",42,42,0,100023.80952381,1026.42857142857,97.7857142857143
"8678","29163","2015",30,30,0,103451.666666667,987.366666666667,107.366666666667
"8679","29165","2015",61,59,2,144442.606557377,1533.7868852459,95.4262295081967
"8680","29166","2015",8,8,0,147937.5,1328.125,117.125
"8681","29167","2015",23,23,0,129763.043478261,1279.95652173913,105.217391304348
"8682","29168","2015",25,25,0,100956,1602.44,73.6
"8683","29169","2015",30,30,0,142248,1373.03333333333,108.4
"8684","29170","2015",31,29,2,164754.193548387,1426.29032258065,116.612903225806
"8685","29171","2015",26,26,0,160796.5,1809.23076923077,99.9615384615385
"8686","29172","2015",26,18,8,152523.461538462,1952.15384615385,94.6923076923077
"8687","29173","2015",14,14,0,154475.714285714,1570.14285714286,105.142857142857
"8688","29174","2015",60,60,0,127174.6,1263.03333333333,107.15
"8689","29175","2015",25,25,0,72766.4,841.4,88.04
"8690","29176","2015",15,15,0,131126.933333333,1298.33333333333,99.7333333333333
"8691","29177","2015",46,46,0,161272.043478261,1677.45652173913,99.4130434782609
"8692","29178","2015",79,75,4,145667.962025316,1612.15189873418,95.0253164556962
"8693","29179","2015",32,31,1,138781.5625,1408.8125,101.5
"8694","29180","2015",12,12,0,100916.666666667,1035.58333333333,108.333333333333
"8695","29181","2015",37,34,3,138397.297297297,1389.72972972973,100.108108108108
"8696","29182","2015",11,11,0,97254.5454545455,1044.18181818182,93.2727272727273
"8697","29183","2015",13,13,0,95741.5384615385,1011.92307692308,105.615384615385
"8698","29184","2015",17,17,0,97350,1212.64705882353,83
"8699","29185","2015",40,39,1,124066.25,1170.825,107.05
"8700","29186","2015",14,14,0,160257.142857143,1599.07142857143,101.214285714286
"8701","29187","2015",4,4,0,86875,911.5,103.25
"8702","29188","2015",63,59,4,143517.46031746,1600.31746031746,91.3333333333333
"8703","29189","2015",128,112,16,195412.328125,1910.7421875,104.09375
"8704","29190","2015",62,46,16,170723.919354839,1825.61290322581,92.5
"8705","29191","2015",36,35,1,110197.25,1132.66666666667,96.3611111111111
"8706","29192","2015",23,23,0,117576.304347826,1171.47826086957,99.7391304347826
"8707","29193","2015",11,11,0,111863.636363636,1091.09090909091,104.909090909091
"8708","29195","2015",86,83,3,128826.976744186,1519.51162790698,88.3139534883721
"8709","29196","2015",14,14,0,147207.857142857,1524.07142857143,98.0714285714286
"8710","29197","2015",60,60,0,163040,1694.21666666667,99.1
"8711","29198","2015",16,16,0,114873.875,1287,93.875
"8712","29199","2015",36,35,1,114441.666666667,1198.16666666667,98.5277777777778
"8713","29201","2015",22,22,0,161678.772727273,1605.18181818182,100.681818181818
"8714","29202","2015",10,10,0,84240,908,107.6
"8715","29204","2015",17,17,0,129033.823529412,1210.58823529412,105.176470588235
"8716","29205","2015",13,13,0,91307.6923076923,1141.15384615385,80.0769230769231
"8717","29206","2015",27,27,0,110837.037037037,1169.25925925926,99.7407407407407
"8718","29207","2015",52,49,3,120463.865384615,1333.51923076923,94.1923076923077
"8719","29208","2015",7,7,0,125917.142857143,1354,97.8571428571429
"8720","29209","2015",25,25,0,133778.32,1471.56,93.6
"8721","29210","2015",25,25,0,104154.88,1119.28,101.92
"8722","29211","2015",14,14,0,57714.2857142857,878.214285714286,65.5
"8723","29212","2015",107,99,8,169078.934579439,1666.75700934579,104.345794392523
"8724","29213","2015",17,17,0,119563.117647059,1204.94117647059,106.882352941176
"8725","29214","2015",9,9,0,158111.111111111,1611.77777777778,92.4444444444444
"8726","29215","2015",34,34,0,127263.470588235,1455.67647058824,92.5
"8727","29216","2015",28,28,0,167673.214285714,1639.57142857143,99.7857142857143
"8728","29217","2015",43,39,4,167046.511627907,1952.53488372093,92
"8729","29218","2015",29,27,2,99290.1724137931,1161.79310344828,94.3448275862069
"8730","29220","2015",137,106,31,135067.00729927,1504.76642335766,92.021897810219
"8731","29221","2015",20,20,0,139950,1591.8,91.35
"8732","29222","2015",4,3,1,68200,933,68.5
"8733","29224","2015",11,11,0,108414.545454545,1120,101.363636363636
"8734","29225","2015",16,16,0,124118.75,1310.375,95.5625
"8735","29226","2015",21,21,0,133780.761904762,1260.04761904762,109.428571428571
"8736","29227","2015",21,20,1,67797.6190476191,863.52380952381,81.9523809523809
"8737","29228","2015",7,7,0,140314.285714286,2110.28571428571,99.2857142857143
"8738","29229","2015",9,9,0,125527.777777778,1300.88888888889,103.222222222222
"8739","29230","2015",17,17,0,111940.705882353,1048.76470588235,106.823529411765
"8740","29232","2015",1069,505,564,114807.325537886,1430.75023386342,78.6099158091674
"8741","29233","2015",128,107,21,125568.8515625,1358.1796875,94.78125
"8742","29234","2015",23,23,0,157511.347826087,1477.4347826087,108.521739130435
"8743","29235","2015",147,114,33,171957.462585034,1885.52380952381,91.3605442176871
"8744","29236","2015",36,35,1,156448.916666667,1671.66666666667,100.194444444444
"8745","29237","2015",15,14,1,132200,1202,106.6
"8746","29238","2015",15,15,0,116433.333333333,1491.93333333333,81.1333333333333
"8747","29239","2015",65,32,33,138880,2051.55384615385,71.9692307692308
"8748","29240","2015",10,10,0,144642.5,1381.6,106.5
"8749","29241","2015",96,93,3,115411.0625,1245.15625,96.6875
"8750","29243","2015",3,3,0,86666.6666666667,1028,84
"8751","29244","2015",7,7,0,130611.428571429,1319.28571428571,103.571428571429
"8752","29245","2015",8,7,1,150500,1497.75,98.5
"8753","29246","2015",2,2,0,61100,640,95
"8754","29247","2015",37,37,0,205488.891891892,1747.91891891892,109.972972972973
"8755","29248","2015",6,6,0,143308.333333333,1381,101.666666666667
"8756","29249","2015",9,9,0,83365.8888888889,844.555555555556,93.2222222222222
"8757","29250","2015",9,9,0,90888.8888888889,921.888888888889,96.8888888888889
"8758","29251","2015",7,7,0,151514.285714286,1545.71428571429,103.571428571429
"8759","29252","2015",11,11,0,132636.363636364,1518.81818181818,89.0909090909091
"8760","29254","2015",59,54,5,123241.93220339,1396.47457627119,96.9322033898305
"8761","29255","2015",5,5,0,150726.8,1780.6,83.6
"8762","29256","2015",15,9,6,108086,1848,69.6666666666667
"8763","29257","2015",20,20,0,184752.75,1940.35,113.95
"8764","29259","2015",71,63,8,143800.690140845,1451.2676056338,96.8169014084507
"8765","29260","2015",71,62,9,156230.845070423,1587.56338028169,100.633802816901
"8766","29261","2015",2,2,0,89000,978,95
"8767","29262","2015",5,5,0,93000,986.2,96.6
"8768","29263","2015",6,6,0,126956.666666667,1173.16666666667,103
"8769","29264","2015",4,4,0,76839,680.75,109.75
"8770","29265","2015",9,9,0,138436.888888889,1257.33333333333,110.222222222222
"8771","29266","2015",33,32,1,116524.242424242,1093.66666666667,107.393939393939
"8772","29267","2015",10,10,0,71750,757.6,97.3
"8773","29268","2015",13,13,0,204847.307692308,1941.69230769231,115.076923076923
"8774","29269","2015",7,7,0,111071.428571429,1131.71428571429,106.857142857143
"8775","29270","2015",9,9,0,162211.111111111,1314.11111111111,124.888888888889
"8776","29271","2015",2,2,0,132500,1340,105.5
"8777","29272","2015",29,29,0,143221.034482759,1404.8275862069,107.068965517241
"8778","29273","2015",18,17,1,200122.222222222,1934.44444444444,116.055555555556
"8779","29274","2015",65,64,1,90518.4615384615,938.107692307692,96.9846153846154
"8780","29275","2015",13,13,0,78230.3846153846,865.923076923077,88.3846153846154
"8781","29276","2015",11,11,0,136954.545454545,1316.18181818182,113.363636363636
"8782","29277","2015",25,25,0,109529.44,1130.6,97.84
"8783","29278","2015",20,20,0,90650,927.9,95.5
"8784","29279","2015",20,20,0,113149.5,1186.1,102.4
"8785","29280","2015",24,24,0,139308.75,1512.08333333333,94.4166666666667
"8786","29281","2015",6,6,0,99166.6666666667,1249.66666666667,80.8333333333333
"8787","29282","2015",5,5,0,128760,1410.6,97.6
"8788","29284","2015",34,34,0,143770.588235294,1487.29411764706,102.205882352941
"8789","29285","2015",7,7,0,82000,1052.71428571429,79
"8790","29286","2015",1,1,0,121000,992,122
"8791","29287","2015",12,12,0,177708.333333333,1413.33333333333,121.333333333333
"8792","29288","2015",6,6,0,118850,1330.5,91.6666666666667
"8793","29290","2015",3,3,0,95950,1395.33333333333,72
"8794","29291","2015",11,11,0,83745.4545454545,867.636363636364,94.2727272727273
"8795","29292","2015",6,6,0,149833.333333333,2219.5,80.1666666666667
"8796","29293","2015",73,67,6,197769.452054795,1893.54794520548,105.890410958904
"8797","29294","2015",5,5,0,113360,1146.8,96.2
"8798","29295","2015",2,2,0,144876.5,2156,85.5
"8799","29296","2015",19,19,0,187673.684210526,1572.05263157895,121
"8800","29297","2015",20,20,0,118602.5,1408.7,86.85
"8801","29298","2015",1,1,0,77000,626,123
"8802","29299","2015",1,1,0,174000,1450,120
"8803","29300","2015",12,12,0,159297.083333333,1574.41666666667,99.25
"8804","29302","2015",45,45,0,106687.888888889,1100.42222222222,96.0444444444445
"8805","2A001","2015",17,12,5,312917.647058824,2807.58823529412,113.705882352941
"8806","2A004","2015",577,26,551,222955.667244367,3115.43847487002,71.2738301559792
"8807","2A006","2015",18,16,2,265813.888888889,2905.66666666667,96.5
"8808","2A008","2015",28,6,22,317779.535714286,4572.67857142857,71.8571428571429
"8809","2A017","2015",9,8,1,271455.555555556,2896.33333333333,107.111111111111
"8810","2A018","2015",2,2,0,237500,2616.5,92
"8811","2A019","2015",2,1,1,132500,1235.5,95
"8812","2A022","2015",1,1,0,313800,1382,227
"8813","2A024","2015",4,3,1,60750,819.5,81
"8814","2A026","2015",1,1,0,25000,417,60
"8815","2A028","2015",1,0,1,41000,456,90
"8816","2A031","2015",3,2,1,69333.3333333333,1140.33333333333,59.3333333333333
"8817","2A032","2015",19,12,7,290218.421052632,3510,87.8421052631579
"8818","2A035","2015",3,3,0,617666.666666667,4141.66666666667,153.666666666667
"8819","2A040","2015",2,1,1,37500,562.5,66
"8820","2A041","2015",27,8,19,382473.592592593,4370.59259259259,72.1851851851852
"8821","2A048","2015",12,6,6,177450,3370.25,54.3333333333333
"8822","2A056","2015",3,2,1,79000,983.333333333333,80
"8823","2A060","2015",1,1,0,40000,930,43
"8824","2A062","2015",2,2,0,95000,2912,30.5
"8825","2A065","2015",10,6,4,200972.5,3793.3,69.4
"8826","2A066","2015",1,1,0,178500,2006,89
"8827","2A070","2015",9,1,8,161888.888888889,3393.66666666667,53.3333333333333
"8828","2A085","2015",7,4,3,247428.571428571,3444.14285714286,68.4285714285714
"8829","2A090","2015",7,4,3,225464.285714286,2641.57142857143,79.5714285714286
"8830","2A091","2015",5,5,0,154008,1484.8,89.6
"8831","2A092","2015",9,3,6,243000,4507.66666666667,49.2222222222222
"8832","2A094","2015",1,1,0,30000,1000,30
"8833","2A098","2015",13,11,2,637670,4784.38461538462,128.384615384615
"8834","2A099","2015",1,1,0,75000,1154,65
"8835","2A103","2015",7,4,3,311710.285714286,3270.71428571429,88
"8836","2A104","2015",7,7,0,298278.571428571,2960.42857142857,115.428571428571
"8837","2A108","2015",2,2,0,58500,848.5,67
"8838","2A114","2015",7,7,0,238885.714285714,2406.71428571429,115.857142857143
"8839","2A118","2015",1,1,0,65468,1056,62
"8840","2A119","2015",1,0,1,55000,1100,50
"8841","2A128","2015",1,1,0,170000,3036,56
"8842","2A130","2015",62,23,39,285155.967741935,4883.38709677419,59.9193548387097
"8843","2A139","2015",37,28,9,557068.351351351,5235.10810810811,94.945945945946
"8844","2A142","2015",2,0,2,16500,550,30
"8845","2A154","2015",1,1,0,40000,500,80
"8846","2A158","2015",2,1,1,70000,1613.5,43.5
"8847","2A160","2015",1,1,0,45000,625,72
"8848","2A163","2015",3,2,1,263066.666666667,3014.66666666667,86.3333333333333
"8849","2A174","2015",1,0,1,30000,3000,10
"8850","2A181","2015",5,5,0,230000,2633.2,84.8
"8851","2A186","2015",2,1,1,106000,1551.5,66.5
"8852","2A189","2015",9,3,6,200166.666666667,2576,94.4444444444444
"8853","2A196","2015",2,2,0,64975,1181,51
"8854","2A197","2015",1,0,1,41000,1281,32
"8855","2A198","2015",3,0,3,110000,2231.33333333333,48.6666666666667
"8856","2A203","2015",1,0,1,35000,1346,26
"8857","2A209","2015",7,7,0,303678.571428571,3197.85714285714,97.8571428571429
"8858","2A211","2015",9,5,4,133450,1654.66666666667,77
"8859","2A212","2015",2,2,0,15000,1112.5,13.5
"8860","2A215","2015",4,2,2,745925,4779.25,112.75
"8861","2A228","2015",12,10,2,660752.5,4991.75,134.833333333333
"8862","2A232","2015",2,2,0,109500,1486,82
"8863","2A247","2015",121,63,58,428779.20661157,4332.12396694215,90.8181818181818
"8864","2A249","2015",41,5,36,180637.902439024,3095.39024390244,60.8048780487805
"8865","2A254","2015",6,5,1,103907.5,2702,55.1666666666667
"8866","2A258","2015",1,1,0,80000,1067,75
"8867","2A259","2015",1,0,1,130000,942,138
"8868","2A262","2015",1,1,0,75000,595,126
"8869","2A268","2015",1,1,0,120000,2000,60
"8870","2A269","2015",17,7,10,200382.823529412,2573.82352941176,81.5294117647059
"8871","2A271","2015",23,14,9,255249.217391304,3099.08695652174,83.695652173913
"8872","2A272","2015",24,6,18,184372.416666667,2323.5,71.0416666666667
"8873","2A276","2015",8,5,3,321845.75,4147,76
"8874","2A278","2015",2,2,0,76500,1299.5,48.5
"8875","2A279","2015",3,3,0,190000,3214.33333333333,57
"8876","2A282","2015",2,0,2,27500,530,51
"8877","2A284","2015",2,1,1,159000,2150,80
"8878","2A288","2015",7,5,2,142314.285714286,1531.28571428571,89.1428571428571
"8879","2A295","2015",1,1,0,210000,2211,95
"8880","2A300","2015",2,1,1,207500,2386.5,74
"8881","2A308","2015",7,3,4,148983.571428571,1762.42857142857,74.7142857142857
"8882","2A310","2015",2,2,0,120175,1559.5,88.5
"8883","2A312","2015",2,1,1,65000,1209,67.5
"8884","2A322","2015",3,1,2,57666.6666666667,1112.33333333333,52
"8885","2A323","2015",2,2,0,282500,2385,118.5
"8886","2A324","2015",3,2,1,114000,1525.66666666667,64.6666666666667
"8887","2A330","2015",5,5,0,124000,1364.2,79.8
"8888","2A331","2015",1,1,0,215000,1807,119
"8889","2A336","2015",1,0,1,30000,1000,30
"8890","2A345","2015",3,3,0,142281.333333333,1776.33333333333,77
"8891","2A348","2015",8,3,5,128958.75,1727.5,63.5
"8892","2A349","2015",4,3,1,345100,3261.25,100.75
"8893","2A351","2015",4,4,0,403750,3458.5,112.5
"8894","2A357","2015",1,1,0,62000,1107,56
"8895","2A359","2015",2,2,0,92500,1704,53.5
"8896","2A362","2015",28,20,8,413137.607142857,4471.57142857143,89.3214285714286
"8897","2B002","2015",1,1,0,140000,859,163
"8898","2B003","2015",2,2,0,57500,776.5,62
"8899","2B009","2015",15,12,3,177444.8,2528.06666666667,81.1333333333333
"8900","2B010","2015",7,1,6,268500,4605.71428571429,48.1428571428571
"8901","2B012","2015",1,0,1,58000,4833,12
"8902","2B016","2015",1,1,0,70000,1000,70
"8903","2B020","2015",6,4,2,201062.5,3084.16666666667,63.3333333333333
"8904","2B023","2015",1,1,0,115000,2556,45
"8905","2B025","2015",1,1,0,323000,2784,116
"8906","2B029","2015",1,0,1,175000,2574,68
"8907","2B030","2015",1,0,1,30000,833,36
"8908","2B033","2015",306,12,294,162620.506535948,2308.56209150327,70.3235294117647
"8909","2B034","2015",8,5,3,193500,3102.375,65.75
"8910","2B037","2015",61,24,37,191727.229508197,2331.95081967213,83.4098360655738
"8911","2B039","2015",2,2,0,1e+05,991,81.5
"8912","2B042","2015",68,37,31,195379.544117647,3033.20588235294,76.5
"8913","2B043","2015",19,7,12,228257.894736842,2677.15789473684,81.4210526315789
"8914","2B049","2015",22,15,7,229527.772727273,2527.95454545455,86.8636363636364
"8915","2B050","2015",72,10,62,235103.527777778,3839.05555555556,59.3055555555556
"8916","2B054","2015",1,1,0,110000,2391,46
"8917","2B055","2015",1,1,0,163627,1818,90
"8918","2B057","2015",3,2,1,114666.666666667,1306.33333333333,85
"8919","2B058","2015",4,3,1,155250,2033.25,75.5
"8920","2B059","2015",1,1,0,217500,2529,86
"8921","2B067","2015",2,1,1,37000,1130,34
"8922","2B072","2015",1,1,0,16000,444,36
"8923","2B073","2015",1,0,1,120000,2000,60
"8924","2B077","2015",8,8,0,145921.375,3476.25,58.125
"8925","2B079","2015",3,2,1,189864.666666667,1977.66666666667,96
"8926","2B080","2015",2,0,2,97500,1387.5,70.5
"8927","2B083","2015",1,0,1,23000,767,30
"8928","2B084","2015",2,0,2,112500,3937.5,32.5
"8929","2B086","2015",3,1,2,143333.333333333,2890.33333333333,50
"8930","2B087","2015",10,5,5,191418,2209.3,80.6
"8931","2B088","2015",1,1,0,73400,1707,43
"8932","2B093","2015",5,3,2,401000,4516.2,74.4
"8933","2B096","2015",44,5,39,143011.840909091,2221.79545454545,66.2272727272727
"8934","2B097","2015",1,0,1,25000,1087,23
"8935","2B102","2015",1,0,1,25000,568,44
"8936","2B107","2015",2,1,1,162500,2568,62
"8937","2B109","2015",1,1,0,135000,3214,42
"8938","2B112","2015",2,2,0,212500,3939.5,55
"8939","2B120","2015",19,13,6,238300,2731.52631578947,84.4736842105263
"8940","2B121","2015",2,2,0,2e+05,4500,48
"8941","2B123","2015",20,8,12,111444.5,1962.75,62.65
"8942","2B134","2015",50,5,45,164742.16,3297.62,56.7
"8943","2B135","2015",2,0,2,23500,752.5,32.5
"8944","2B143","2015",15,4,11,82500,1864.4,44.0666666666667
"8945","2B145","2015",2,1,1,62500,1500,42.5
"8946","2B147","2015",1,1,0,120148,1716,70
"8947","2B148","2015",38,23,15,180097.815789474,2409.73684210526,75.8947368421053
"8948","2B150","2015",28,4,24,185668.357142857,3670,53.25
"8949","2B152","2015",4,1,3,76175,1819.75,43.25
"8950","2B153","2015",2,2,0,115625,1605,80
"8951","2B159","2015",3,3,0,95500,1595.33333333333,64.6666666666667
"8952","2B162","2015",2,1,1,127500,1428,84.5
"8953","2B165","2015",4,3,1,299500,4876.75,62
"8954","2B167","2015",2,2,0,175000,1817.5,109
"8955","2B168","2015",13,10,3,475000,4083.23076923077,117.307692307692
"8956","2B169","2015",1,0,1,143000,2167,66
"8957","2B172","2015",2,2,0,118500,1213.5,76
"8958","2B173","2015",1,1,0,17000,850,20
"8959","2B175","2015",1,0,1,146000,1921,76
"8960","2B179","2015",1,1,0,69000,575,120
"8961","2B180","2015",1,1,0,80000,889,90
"8962","2B182","2015",1,1,0,30000,1500,20
"8963","2B184","2015",1,0,1,74500,931,80
"8964","2B185","2015",8,3,5,240187.5,3032,90.25
"8965","2B188","2015",3,2,1,183000,2095.66666666667,87.6666666666667
"8966","2B190","2015",2,2,0,73000,2568,35.5
"8967","2B192","2015",1,0,1,56500,1449,39
"8968","2B193","2015",5,2,3,54410,1123.8,57
"8969","2B195","2015",1,1,0,70000,1167,60
"8970","2B199","2015",1,1,0,25000,833,30
"8971","2B201","2015",1,1,0,116100,1416,82
"8972","2B205","2015",5,2,3,195395,2670.6,78.8
"8973","2B207","2015",18,6,12,141388.888888889,2107.77777777778,69.1111111111111
"8974","2B210","2015",1,0,1,58024,829,70
"8975","2B216","2015",1,1,0,230000,983,234
"8976","2B217","2015",1,1,0,1e+05,645,155
"8977","2B218","2015",1,1,0,40000,444,90
"8978","2B223","2015",2,1,1,88450,1672,56.5
"8979","2B224","2015",11,8,3,184581.818181818,2201.45454545455,81.9090909090909
"8980","2B225","2015",2,1,1,114035,1948.5,53.5
"8981","2B226","2015",2,0,2,41000,1085.5,40
"8982","2B229","2015",1,1,0,195000,2600,75
"8983","2B233","2015",3,2,1,257666.666666667,2075,115.333333333333
"8984","2B239","2015",5,4,1,200100,2100.2,87.6
"8985","2B242","2015",12,11,1,109491.666666667,2559.25,43.6666666666667
"8986","2B244","2015",1,1,0,140000,1707,82
"8987","2B246","2015",1,1,0,220000,2973,74
"8988","2B248","2015",1,1,0,205000,2158,95
"8989","2B250","2015",1,1,0,105000,955,110
"8990","2B251","2015",22,12,10,160893.818181818,1942.5,84.8636363636364
"8991","2B252","2015",1,0,1,45000,714,63
"8992","2B255","2015",1,1,0,71800,1795,40
"8993","2B261","2015",4,2,2,100500,2444,42.5
"8994","2B263","2015",1,1,0,85000,1441,59
"8995","2B264","2015",1,0,1,22000,786,28
"8996","2B265","2015",1,0,1,1e+05,3333,30
"8997","2B277","2015",3,3,0,244333.333333333,2535,100.666666666667
"8998","2B280","2015",2,2,0,113500,2535.5,51.5
"8999","2B281","2015",9,2,7,297100,3882.66666666667,60.2222222222222
"9000","2B283","2015",3,3,0,123666.666666667,1693,81.6666666666667
"9001","2B286","2015",3,1,2,158333.333333333,2570,54.3333333333333
"9002","2B287","2015",1,0,1,35000,636,55
"9003","2B289","2015",2,2,0,55000,1294.5,43
"9004","2B290","2015",3,2,1,125666.666666667,2388.66666666667,57.6666666666667
"9005","2B291","2015",1,1,0,30000,462,65
"9006","2B293","2015",2,2,0,90000,650,120
"9007","2B298","2015",27,8,19,325773.333333333,4246.92592592593,74.5925925925926
"9008","2B299","2015",4,1,3,28350,1206.5,23.5
"9009","2B303","2015",3,3,0,270666.666666667,2189.33333333333,129.333333333333
"9010","2B304","2015",1,1,0,50000,485,103
"9011","2B305","2015",19,5,14,164178.473684211,2002.15789473684,78.7368421052632
"9012","2B307","2015",15,2,13,124023.333333333,2633.86666666667,51.8
"9013","2B309","2015",8,2,6,242840,3360.75,65.375
"9014","2B311","2015",10,9,1,158235,2840.3,56.3
"9015","2B313","2015",21,3,18,112574.904761905,2586.80952380952,46.0952380952381
"9016","2B314","2015",4,3,1,145000,1827.25,72.5
"9017","2B315","2015",4,3,1,144271.75,1779.5,79.5
"9018","2B316","2015",6,3,3,203962.5,3260.16666666667,73
"9019","2B318","2015",2,1,1,190000,1786,111
"9020","2B319","2015",3,3,0,200883.333333333,1984,98.6666666666667
"9021","2B320","2015",1,1,0,42378,902,47
"9022","2B328","2015",1,0,1,50000,1042,48
"9023","2B332","2015",2,1,1,90000,1613,53.5
"9024","2B335","2015",2,2,0,370150,2825.5,143.5
"9025","2B337","2015",2,1,1,67500,902.5,78
"9026","2B340","2015",1,1,0,110000,2037,54
"9027","2B341","2015",3,2,1,58200,907.333333333333,63
"9028","2B342","2015",8,7,1,257857.5,2709.375,94.125
"9029","2B343","2015",12,6,6,118008,1734.91666666667,64.5
"9030","2B344","2015",3,3,0,75000,2410.66666666667,35.3333333333333
"9031","2B346","2015",12,9,3,183910.416666667,2171.16666666667,80.5
"9032","2B347","2015",3,1,2,49430,1073.33333333333,50
"9033","2B350","2015",3,3,0,223333.333333333,1720.33333333333,135.333333333333
"9034","2B352","2015",2,1,1,164250,2263,74
"9035","2B353","2015",32,4,28,258462.625,3027.59375,88.125
"9036","2B354","2015",2,2,0,91033,869,104
"9037","2B355","2015",1,1,0,175000,1750,100
"9038","2B356","2015",1,1,0,220000,2178,101
"9039","2B364","2015",1,0,1,45000,1071,42
"9040","2B366","2015",1,1,0,188000,1880,100
"9041","30001","2015",3,3,0,175000,1542.66666666667,118.666666666667
"9042","30002","2015",3,3,0,119250,1728.33333333333,69
"9043","30003","2015",122,98,24,233550.5,2918.3606557377,81.7540983606557
"9044","30004","2015",26,25,1,214239.423076923,2141,98.1153846153846
"9045","30005","2015",2,2,0,149998.5,2103,75
"9046","30006","2015",58,50,8,195496.534482759,2038.27586206897,96.1206896551724
"9047","30007","2015",327,146,181,113551.278287462,1476.01834862385,74.691131498471
"9048","30008","2015",7,7,0,258871.428571429,2369.57142857143,139.142857142857
"9049","30009","2015",6,5,1,80827.3333333333,1025.66666666667,75.1666666666667
"9050","30010","2015",29,20,9,181117.586206897,2086.55172413793,90.0689655172414
"9051","30011","2015",121,66,55,230168.644628099,2656.4132231405,85.3223140495868
"9052","30012","2015",15,15,0,156262.2,2320.8,79
"9053","30013","2015",2,2,0,264000,2300,113
"9054","30014","2015",17,17,0,286200.588235294,2570,105.882352941176
"9055","30015","2015",2,2,0,99500,1494,70
"9056","30016","2015",4,3,1,60750,798.25,73.5
"9057","30017","2015",4,3,1,128615,883,158.25
"9058","30018","2015",2,2,0,344260,1994,175.5
"9059","30019","2015",25,23,2,272465.4,2413,117.08
"9060","30020","2015",17,16,1,232594.117647059,2643.41176470588,104.411764705882
"9061","30021","2015",4,4,0,333175,3096.25,102.25
"9062","30023","2015",9,9,0,212152.222222222,2164.66666666667,96.7777777777778
"9063","30024","2015",7,7,0,120428.571428571,1132.85714285714,102.428571428571
"9064","30025","2015",2,1,1,132400,937,150
"9065","30026","2015",5,3,2,109300,1432.8,80.8
"9066","30027","2015",23,21,2,207235.217391304,2061.69565217391,99.6086956521739
"9067","30028","2015",155,81,74,136792.116129032,1672.90322580645,82.1354838709677
"9068","30029","2015",16,14,2,197070.75,2252.9375,91.875
"9069","30030","2015",3,3,0,181833.333333333,1315.66666666667,158.666666666667
"9070","30031","2015",3,3,0,235333.333333333,2186,99
"9071","30032","2015",108,75,33,145300.416666667,1704.40740740741,85.1759259259259
"9072","30033","2015",43,39,4,176995.790697674,1973.27906976744,92.953488372093
"9073","30034","2015",60,48,12,165270.75,2113.95,85.3333333333333
"9074","30035","2015",1,1,0,505000,3196,158
"9075","30036","2015",27,22,5,164197.037037037,2049.66666666667,87.7037037037037
"9076","30037","2015",20,12,8,110002.5,1363.65,79.75
"9077","30038","2015",5,3,2,104200,1795.6,67.6
"9078","30039","2015",13,11,2,162465.384615385,1775.46153846154,90.5384615384615
"9079","30040","2015",1,1,0,2e+05,1667,120
"9080","30041","2015",12,12,0,250127.083333333,2447.58333333333,105.583333333333
"9081","30042","2015",21,20,1,246426.666666667,2027.47619047619,123.809523809524
"9082","30043","2015",7,7,0,221080,1747.71428571429,127
"9083","30045","2015",2,2,0,177500,1818.5,97.5
"9084","30046","2015",4,3,1,128833.25,1482.25,91.5
"9085","30047","2015",55,46,9,199847.181818182,2218.32727272727,94.6909090909091
"9086","30049","2015",5,5,0,271240,2038.8,119.2
"9087","30051","2015",10,7,3,104467,1361,73.5
"9088","30052","2015",7,7,0,81928.5714285714,1598.85714285714,58.8571428571429
"9089","30053","2015",13,13,0,151520,1813.76923076923,81.0769230769231
"9090","30054","2015",5,5,0,184620,1716.2,111.4
"9091","30055","2015",4,4,0,189860,1581.5,129.75
"9092","30056","2015",6,6,0,236983.333333333,1875.83333333333,118.333333333333
"9093","30057","2015",19,19,0,228710.526315789,2389.36842105263,98.6315789473684
"9094","30058","2015",3,3,0,185000,1548.33333333333,117
"9095","30059","2015",18,16,2,198986.111111111,2156.94444444444,94.2777777777778
"9096","30060","2015",30,28,2,213522.166666667,2125.73333333333,102.266666666667
"9097","30061","2015",11,9,2,178905.272727273,1863.90909090909,95.0909090909091
"9098","30062","2015",64,53,11,200180.25,2400.28125,86.875
"9099","30064","2015",2,2,0,97633.5,1369,60
"9100","30065","2015",9,8,1,151406.666666667,1712,93.1111111111111
"9101","30066","2015",3,3,0,164000,1930,83.6666666666667
"9102","30067","2015",8,8,0,380853.25,3247.75,131.625
"9103","30068","2015",7,7,0,171607.142857143,1790.28571428571,104.571428571429
"9104","30069","2015",5,5,0,272100,2470.2,116.6
"9105","30070","2015",5,5,0,264300,2520.2,99.8
"9106","30071","2015",2,2,0,124350,1491.5,85
"9107","30072","2015",1,1,0,180000,1593,113
"9108","30073","2015",19,19,0,357568.421052632,3009.15789473684,117.052631578947
"9109","30075","2015",34,33,1,246085.264705882,2260.61764705882,107.323529411765
"9110","30076","2015",7,7,0,204778.571428571,2248.28571428571,93.5714285714286
"9111","30077","2015",10,9,1,139350,1648.2,87.4
"9112","30079","2015",5,5,0,196000,1875.6,103.6
"9113","30080","2015",12,9,3,72135.8333333333,1168.41666666667,65.1666666666667
"9114","30081","2015",5,5,0,169000,2079.2,86
"9115","30082","2015",52,42,10,215140.115384615,2194.67307692308,99.2884615384615
"9116","30083","2015",27,26,1,196295.555555556,2108.11111111111,98.962962962963
"9117","30084","2015",5,5,0,213190,2080,103.4
"9118","30085","2015",19,18,1,191183.684210526,2292.10526315789,88.1052631578947
"9119","30086","2015",3,3,0,265840.333333333,1661.33333333333,154
"9120","30087","2015",2,2,0,153525,1783,87.5
"9121","30088","2015",12,12,0,229693.333333333,1725.58333333333,136.166666666667
"9122","30089","2015",23,22,1,197614,2064.30434782609,95.3913043478261
"9123","30090","2015",4,4,0,118000,1596.5,75
"9124","30091","2015",16,16,0,208645.5,2277.625,97.9375
"9125","30095","2015",6,6,0,169333.333333333,2221.33333333333,79.8333333333333
"9126","30096","2015",9,9,0,240290.222222222,2807,86
"9127","30097","2015",4,4,0,192750,1858,109.75
"9128","30098","2015",7,7,0,156107.142857143,1725.71428571429,92.1428571428571
"9129","30099","2015",7,6,1,148808,1981.85714285714,75.8571428571429
"9130","30100","2015",10,10,0,155820,1689.2,91.4
"9131","30101","2015",4,4,0,239750,2113.75,113.5
"9132","30102","2015",9,9,0,137365,1452.55555555556,89.2222222222222
"9133","30103","2015",13,11,2,222046.153846154,1885.30769230769,117.153846153846
"9134","30104","2015",9,9,0,214284.444444444,1805.44444444444,120.777777777778
"9135","30105","2015",8,8,0,91735.375,1809.75,52.375
"9136","30106","2015",15,15,0,169673.333333333,1627.33333333333,98.5333333333333
"9137","30107","2015",3,3,0,210666.666666667,2020,104
"9138","30108","2015",3,3,0,150333.333333333,832.666666666667,182.666666666667
"9139","30109","2015",3,3,0,213076.666666667,1710.33333333333,123.333333333333
"9140","30110","2015",5,5,0,520680,2614.8,163
"9141","30111","2015",2,2,0,145000,1542,105
"9142","30112","2015",13,13,0,176428.692307692,1779.84615384615,100.461538461538
"9143","30114","2015",5,4,1,217748,2527.8,91.4
"9144","30115","2015",1,1,0,109000,1817,60
"9145","30116","2015",19,18,1,144297.894736842,1820.10526315789,78.5789473684211
"9146","30117","2015",27,18,9,165899.62962963,2117.77777777778,77.7777777777778
"9147","30119","2015",1,1,0,234985,1910,123
"9148","30120","2015",15,10,5,112422.666666667,1595.66666666667,68.0666666666667
"9149","30121","2015",2,2,0,117500,1646,74.5
"9150","30122","2015",2,2,0,122500,1764,75
"9151","30123","2015",34,29,5,196128.117647059,2072.29411764706,95.4411764705882
"9152","30124","2015",2,2,0,176000,1924,91
"9153","30125","2015",35,32,3,220129.657142857,2303.54285714286,98.0857142857143
"9154","30126","2015",5,5,0,337345,2572.2,123.4
"9155","30127","2015",10,9,1,232802,2253.7,104.3
"9156","30128","2015",42,36,6,152944.69047619,1834.2619047619,85.6190476190476
"9157","30129","2015",8,7,1,184313.75,1930.25,93.375
"9158","30130","2015",12,11,1,88708.3333333333,1298.41666666667,66.4166666666667
"9159","30131","2015",9,9,0,218498.888888889,2004.22222222222,110
"9160","30132","2015",22,13,9,74322.7272727273,947.954545454545,83.3181818181818
"9161","30133","2015",583,45,538,154890.933104631,3924.07890222985,39.6123499142367
"9162","30135","2015",34,28,6,168507.205882353,1837.5,91.3823529411765
"9163","30136","2015",11,10,1,219186.363636364,1859.90909090909,120.818181818182
"9164","30137","2015",1,1,0,150000,2206,68
"9165","30139","2015",4,4,0,47500,1202.25,59.5
"9166","30140","2015",13,10,3,119957.846153846,1182.15384615385,97.0769230769231
"9167","30141","2015",35,29,6,165610.342857143,2000.65714285714,84.2285714285714
"9168","30142","2015",3,3,0,203166.666666667,2264.33333333333,94.6666666666667
"9169","30143","2015",2,2,0,235500,1433.5,182
"9170","30144","2015",4,4,0,182905,2422.5,78.75
"9171","30145","2015",6,5,1,152750,2015,78.1666666666667
"9172","30146","2015",15,15,0,152516.666666667,1730.6,96.7333333333333
"9173","30147","2015",11,9,2,159181.818181818,1714.63636363636,87.4545454545455
"9174","30148","2015",3,3,0,250461.666666667,1986.33333333333,122.666666666667
"9175","30149","2015",7,6,1,152928.571428571,1981,74
"9176","30150","2015",3,3,0,171000,971.666666666667,173.666666666667
"9177","30151","2015",7,7,0,263857.142857143,1902.28571428571,148.857142857143
"9178","30152","2015",15,15,0,169310,1756,93.4666666666667
"9179","30153","2015",1,1,0,25000,333,75
"9180","30154","2015",2,2,0,130125,1890,65
"9181","30155","2015",38,37,1,210039.631578947,2283.63157894737,92.2368421052632
"9182","30156","2015",76,67,9,181182.894736842,2030.13157894737,91.3157894736842
"9183","30158","2015",1,1,0,213500,3094,69
"9184","30159","2015",4,2,2,129887.5,1600,76.75
"9185","30160","2015",2,2,0,225875,1976,115
"9186","30161","2015",4,4,0,147875,1604.25,92.5
"9187","30162","2015",5,5,0,238660.2,1979.4,107.4
"9188","30163","2015",1,1,0,73000,1352,54
"9189","30164","2015",14,14,0,153541.428571429,2077.64285714286,69.7857142857143
"9190","30165","2015",1,1,0,165000,1250,132
"9191","30166","2015",11,9,2,144434.727272727,1762,84.9090909090909
"9192","30167","2015",10,8,2,151340,1851.7,79.1
"9193","30168","2015",13,13,0,176423.076923077,2456.07692307692,76.5384615384615
"9194","30169","2015",48,38,10,163552.875,2287.83333333333,79.3958333333333
"9195","30170","2015",7,7,0,141605.714285714,1680.28571428571,85
"9196","30171","2015",5,2,3,84800,1357,65.8
"9197","30172","2015",4,4,0,224750,1944.75,117
"9198","30173","2015",8,8,0,138456.25,1467.875,91.375
"9199","30174","2015",22,22,0,344395.454545455,2580.95454545455,129.863636363636
"9200","30175","2015",1,1,0,395000,6371,62
"9201","30176","2015",2,2,0,167762.5,1703,109
"9202","30177","2015",5,5,0,153318,1410.8,103.6
"9203","30178","2015",11,10,1,175624.545454545,1765.18181818182,98.3636363636364
"9204","30179","2015",27,26,1,157610.777777778,1712.2962962963,90.4074074074074
"9205","30180","2015",3,3,0,178000,1824.66666666667,100
"9206","30181","2015",4,4,0,224825,2051.5,110.75
"9207","30182","2015",14,14,0,193510.714285714,1805.92857142857,101.857142857143
"9208","30183","2015",7,7,0,171220.714285714,1544.71428571429,115.857142857143
"9209","30184","2015",17,15,2,170047.058823529,1526.76470588235,107.411764705882
"9210","30185","2015",12,11,1,233575,2892.5,93.8333333333333
"9211","30186","2015",14,14,0,359695,2978.57142857143,120.857142857143
"9212","30188","2015",2,2,0,127500,1554.5,83.5
"9213","30189","2015",1700,526,1174,140791.43,1909.02705882353,72.0617647058824
"9214","30191","2015",11,11,0,158109.090909091,1873,89.4545454545455
"9215","30192","2015",3,3,0,237918.666666667,2079.33333333333,128.333333333333
"9216","30193","2015",2,1,1,126500,1629,78.5
"9217","30194","2015",4,4,0,111500,1512.25,79.25
"9218","30196","2015",6,6,0,217916.666666667,2059,100.833333333333
"9219","30198","2015",4,4,0,142125,1669.5,77.25
"9220","30200","2015",8,7,1,136916.25,1532.875,85.75
"9221","30201","2015",4,4,0,123700,1483.75,85.5
"9222","30202","2015",122,86,36,141242.827868852,1568.5,87.9672131147541
"9223","30203","2015",1,0,1,50000,1389,36
"9224","30204","2015",1,1,0,130000,1327,98
"9225","30205","2015",2,1,1,147900,2206.5,67.5
"9226","30206","2015",34,32,2,235657.558823529,2451.11764705882,99.2647058823529
"9227","30207","2015",9,9,0,262894.444444444,1678.44444444444,133.222222222222
"9228","30209","2015",30,26,4,291325.866666667,2699.03333333333,117.333333333333
"9229","30210","2015",32,26,6,165384.0625,1884.90625,90.40625
"9230","30211","2015",34,32,2,190218.470588235,1868.26470588235,103.882352941176
"9231","30212","2015",33,16,17,147468.96969697,2729.21212121212,63
"9232","30213","2015",1,1,0,60000,3000,20
"9233","30214","2015",13,10,3,151389.230769231,1673.46153846154,88.6923076923077
"9234","30215","2015",4,4,0,142850,2037.5,76
"9235","30216","2015",7,4,3,97285.7142857143,1358,70.1428571428571
"9236","30217","2015",78,74,4,305386.897435897,2686.38461538462,113
"9237","30218","2015",3,3,0,181460,1352.33333333333,131.666666666667
"9238","30219","2015",1,1,0,113000,1982,57
"9239","30220","2015",2,2,0,262500,1578.5,168.5
"9240","30221","2015",39,35,4,167920.923076923,1797.38461538462,91.2820512820513
"9241","30222","2015",1,1,0,150000,1000,150
"9242","30223","2015",33,31,2,158813.636363636,1717.42424242424,91.5151515151515
"9243","30224","2015",7,7,0,202289.428571429,2116.14285714286,101.142857142857
"9244","30225","2015",16,16,0,162878.125,1738.8125,99
"9245","30226","2015",4,4,0,176142.5,1201,155
"9246","30227","2015",32,26,6,106670.8125,1293.8125,80.4375
"9247","30228","2015",21,21,0,194623.80952381,2207.38095238095,97.9523809523809
"9248","30229","2015",5,5,0,89324,1228.6,74.4
"9249","30230","2015",6,6,0,158819.166666667,1978.5,77.1666666666667
"9250","30231","2015",8,7,1,82175,1133.25,74.375
"9251","30232","2015",3,3,0,194083.333333333,2391.33333333333,82
"9252","30233","2015",5,5,0,186800,1971.8,97
"9253","30235","2015",5,5,0,221960,1990.2,113.4
"9254","30237","2015",7,4,3,99714.2857142857,1716.42857142857,60.4285714285714
"9255","30239","2015",6,4,2,73650.8333333333,1132.5,61.5
"9256","30240","2015",2,2,0,194500,2226,89
"9257","30241","2015",13,13,0,221973.846153846,2031.61538461538,113.153846153846
"9258","30242","2015",2,2,0,114000,1887.5,60.5
"9259","30243","2015",52,47,5,181015.384615385,2049.48076923077,89.5192307692308
"9260","30244","2015",3,1,2,168733.333333333,1382.66666666667,123.666666666667
"9261","30245","2015",7,7,0,183900,2022,93.7142857142857
"9262","30247","2015",4,4,0,84500,1185,71.25
"9263","30248","2015",3,3,0,169666.666666667,1772.66666666667,96.6666666666667
"9264","30249","2015",9,7,2,275910,2438.77777777778,124.222222222222
"9265","30250","2015",4,4,0,215000,1649.25,120.5
"9266","30251","2015",5,5,0,107733.2,1332.4,86.6
"9267","30252","2015",1,1,0,247270,2778,89
"9268","30253","2015",6,5,1,134600,1666.66666666667,79.1666666666667
"9269","30254","2015",14,13,1,187615,2249.14285714286,83.2142857142857
"9270","30255","2015",19,15,4,155885.368421053,1779.47368421053,85.5263157894737
"9271","30256","2015",4,4,0,251603.5,2276.75,106.5
"9272","30257","2015",23,20,3,143665.739130435,1914.26086956522,78.9565217391304
"9273","30258","2015",113,96,17,141235.283185841,1649.69026548673,86.9823008849557
"9274","30259","2015",19,18,1,204825.789473684,2313.36842105263,91.9473684210526
"9275","30260","2015",11,11,0,193787.545454545,2590.18181818182,84.9090909090909
"9276","30262","2015",3,3,0,247036.666666667,2106.66666666667,117.333333333333
"9277","30263","2015",29,22,7,115148.275862069,1425.31034482759,82.5172413793103
"9278","30264","2015",1,1,0,131000,1795,73
"9279","30266","2015",5,5,0,175800,1794.6,102.6
"9280","30267","2015",7,7,0,143392,1545.14285714286,100.285714285714
"9281","30268","2015",8,6,2,86625,1156.125,72.875
"9282","30269","2015",16,11,5,157981.25,1698.625,103.5
"9283","30270","2015",10,9,1,226900,2013.4,116.4
"9284","30271","2015",6,4,2,158016.666666667,2744.83333333333,67.6666666666667
"9285","30272","2015",2,2,0,102000,2005.5,70
"9286","30273","2015",18,18,0,193058.333333333,2078.5,98.3888888888889
"9287","30274","2015",19,19,0,182280,1786.57894736842,101.052631578947
"9288","30275","2015",1,1,0,1e+05,833,120
"9289","30276","2015",40,37,3,177765.875,2296.15,84.3
"9290","30277","2015",3,3,0,171866.666666667,1953.33333333333,86
"9291","30278","2015",28,26,2,217202.642857143,1870,116.75
"9292","30279","2015",10,9,1,166199,1852.7,89.3
"9293","30280","2015",5,5,0,90133,1680.2,60.8
"9294","30281","2015",17,15,2,175332.352941176,1934.41176470588,91.4117647058823
"9295","30282","2015",6,6,0,182166.666666667,1970.66666666667,107.333333333333
"9296","30283","2015",1,1,0,45000,600,75
"9297","30284","2015",26,25,1,148646.923076923,1665.03846153846,97.3846153846154
"9298","30285","2015",7,7,0,151285.714285714,1826.42857142857,82.5714285714286
"9299","30286","2015",11,11,0,223267.272727273,2517.63636363636,88.2727272727273
"9300","30287","2015",6,5,1,89063.3333333333,971,91
"9301","30289","2015",3,2,1,291500,2765,137.666666666667
"9302","30290","2015",15,13,2,172130.666666667,1834.4,92.5333333333333
"9303","30291","2015",1,1,0,43500,473,92
"9304","30292","2015",6,6,0,131420,1361.33333333333,90.6666666666667
"9305","30293","2015",4,4,0,255000,3160,88
"9306","30294","2015",45,30,15,147146.888888889,1710.77777777778,88.8666666666667
"9307","30295","2015",32,26,6,236514.78125,2315.21875,103.15625
"9308","30296","2015",3,3,0,313166.666666667,2343,140
"9309","30297","2015",9,9,0,147496.333333333,2077.66666666667,80.3333333333333
"9310","30298","2015",3,2,1,182366.666666667,1824,99.3333333333333
"9311","30299","2015",4,4,0,286925,2480.5,112.75
"9312","30300","2015",6,5,1,215500,1849.83333333333,115.5
"9313","30301","2015",3,3,0,182916.666666667,2390.66666666667,78.6666666666667
"9314","30302","2015",13,13,0,262262.923076923,2739.84615384615,94.0769230769231
"9315","30303","2015",7,7,0,144928.571428571,2424.42857142857,64
"9316","30304","2015",1,1,0,82000,1171,70
"9317","30305","2015",21,20,1,150047.619047619,1634.14285714286,92.6190476190476
"9318","30306","2015",6,6,0,209662.5,1921.33333333333,102.166666666667
"9319","30307","2015",19,17,2,91781.8421052632,1157.26315789474,78.7894736842105
"9320","30308","2015",11,11,0,249677.272727273,2639.45454545455,98.0909090909091
"9321","30309","2015",3,3,0,301840,2108.33333333333,144
"9322","30310","2015",6,6,0,140166.666666667,1510.16666666667,94.6666666666667
"9323","30311","2015",15,12,3,163307.666666667,1922.26666666667,83.0666666666667
"9324","30312","2015",27,27,0,285616.296296296,2261.14814814815,127.37037037037
"9325","30313","2015",7,7,0,205746.857142857,2975.85714285714,94.8571428571429
"9326","30314","2015",3,3,0,122833.333333333,1533.33333333333,85
"9327","30315","2015",17,17,0,214299.058823529,2280,99
"9328","30316","2015",2,2,0,40000.5,666.5,70
"9329","30317","2015",19,16,3,142232.631578947,1574.36842105263,85.1052631578947
"9330","30319","2015",5,5,0,254820,1828,139.2
"9331","30320","2015",1,1,0,149600,2302,65
"9332","30321","2015",41,27,14,213695.243902439,2178.46341463415,98.8048780487805
"9333","30322","2015",4,4,0,90000,1338,66
"9334","30323","2015",2,2,0,66500,1268.5,49.5
"9335","30324","2015",6,6,0,280683.333333333,2597.33333333333,112.666666666667
"9336","30325","2015",10,8,2,153161,1756.5,77.7
"9337","30326","2015",21,21,0,205816.952380952,2282.71428571429,96.5238095238095
"9338","30327","2015",1,1,0,58000,1657,35
"9339","30328","2015",7,5,2,112059.857142857,1594.85714285714,75.1428571428571
"9340","30329","2015",4,4,0,280895,1797.75,170
"9341","30330","2015",7,6,1,221428.571428571,1416.28571428571,148.571428571429
"9342","30331","2015",9,8,1,173473.777777778,1990.22222222222,87.6666666666667
"9343","30332","2015",1,1,0,196000,2000,98
"9344","30333","2015",58,42,16,181692.137931034,2015.72413793103,92.6896551724138
"9345","30334","2015",135,64,71,247465.592592593,2654.6,88.2814814814815
"9346","30336","2015",11,11,0,163356.363636364,1758.54545454545,96
"9347","30337","2015",6,6,0,260095,2527.5,103.5
"9348","30338","2015",1,1,0,125500,1793,70
"9349","30339","2015",20,14,6,123564.95,1361.85,86.4
"9350","30340","2015",6,6,0,188500,2060.33333333333,84.3333333333333
"9351","30341","2015",117,87,30,160219.709401709,1842.35897435897,87.991452991453
"9352","30342","2015",11,8,3,178654.545454545,1730,100.727272727273
"9353","30343","2015",12,12,0,251519.166666667,1894.75,123.333333333333
"9354","30344","2015",49,46,3,217043.673469388,2357.67346938776,99.9387755102041
"9355","30345","2015",4,2,2,70505,1140.75,61
"9356","30346","2015",21,19,2,205155.333333333,2282.33333333333,94.7142857142857
"9357","30347","2015",16,15,1,201816.875,2193.125,89.9375
"9358","30348","2015",14,13,1,198785.714285714,2166.07142857143,95.3571428571429
"9359","30349","2015",2,2,0,238750,1938.5,125
"9360","30350","2015",36,23,13,114802.111111111,1378.33333333333,85.7222222222222
"9361","30351","2015",137,95,42,286706.218978102,2911.28467153285,97.2408759124088
"9362","30354","2015",3,3,0,182166.666666667,2028,84.3333333333333
"9363","30355","2015",5,5,0,212648.2,1965.4,109.4
"9364","30356","2015",18,17,1,181887.777777778,2023.5,92.4444444444444
"9365","31002","2015",3,3,0,211666.666666667,1432,149
"9366","31003","2015",13,10,3,294776.153846154,2740.84615384615,107.538461538462
"9367","31004","2015",30,27,3,234247.766666667,2239.9,103.7
"9368","31005","2015",4,4,0,122500,1325.5,105.25
"9369","31006","2015",3,3,0,239361.666666667,1765,130
"9370","31008","2015",5,5,0,275800,1411.4,188.8
"9371","31009","2015",2,2,0,104000,1265.5,85
"9372","31010","2015",1,1,0,140000,2154,65
"9373","31012","2015",3,3,0,65833.3333333333,998,75
"9374","31013","2015",4,4,0,109825,877.75,132.5
"9375","31014","2015",3,3,0,60926.6666666667,827.666666666667,78
"9376","31017","2015",1,1,0,1e+05,2000,50
"9377","31018","2015",2,2,0,230000,1547.5,142.5
"9378","31019","2015",1,1,0,186000,1958,95
"9379","31020","2015",5,5,0,66800,767.4,95.2
"9380","31021","2015",1,1,0,85000,1417,60
"9381","31022","2015",165,55,110,153022.666666667,2328.90909090909,65.9818181818182
"9382","31023","2015",6,6,0,118666.666666667,896.666666666667,139.333333333333
"9383","31024","2015",3,3,0,158560,1238.33333333333,140.333333333333
"9384","31025","2015",5,5,0,316934,2356.4,134
"9385","31026","2015",11,11,0,163726.818181818,1392.27272727273,118.363636363636
"9386","31027","2015",2,2,0,226000,1667.5,135
"9387","31028","2015",9,9,0,144000,1338.88888888889,115.333333333333
"9388","31029","2015",1,1,0,335340,2163,155
"9389","31030","2015",2,2,0,173000,1543.5,115
"9390","31032","2015",59,42,17,207872.372881356,2240.69491525424,92.1864406779661
"9391","31034","2015",1,1,0,348000,1513,230
"9392","31035","2015",36,14,22,219749.027777778,3036.22222222222,81.9444444444444
"9393","31036","2015",32,28,4,239146.5,2387.3125,102
"9394","31037","2015",8,8,0,177137.5,1776.125,98.25
"9395","31038","2015",5,5,0,209723,1514.6,140.6
"9396","31039","2015",1,1,0,113500,1720,66
"9397","31041","2015",1,1,0,65000,644,101
"9398","31042","2015",123,25,98,89066.9593495935,1761.16260162602,52.9756097560976
"9399","31043","2015",2,2,0,125000,791.5,156.5
"9400","31044","2015",174,74,100,245691.373563218,2839.71264367816,86.1551724137931
"9401","31045","2015",3,3,0,63666.6666666667,1162.66666666667,64.3333333333333
"9402","31048","2015",31,30,1,203511.193548387,2223.83870967742,92.8709677419355
"9403","31049","2015",1,1,0,270000,2455,110
"9404","31050","2015",5,5,0,113826,1044.6,115.2
"9405","31051","2015",6,6,0,242330.833333333,1701.16666666667,140.333333333333
"9406","31052","2015",6,6,0,194986.833333333,1865,106.166666666667
"9407","31053","2015",4,4,0,290500,2678,108.25
"9408","31054","2015",4,4,0,159625,1581,103.25
"9409","31055","2015",1,1,0,148350,2967,50
"9410","31056","2015",53,35,18,252888.716981132,2685.54716981132,91.6415094339623
"9411","31057","2015",7,5,2,228415.285714286,2423.57142857143,93.5714285714286
"9412","31059","2015",4,4,0,81625,748.5,108
"9413","31060","2015",1,1,0,210700,1741,121
"9414","31063","2015",4,4,0,114475,1254.5,95
"9415","31065","2015",18,18,0,184701.222222222,1854.88888888889,101
"9416","31066","2015",52,39,13,153534.423076923,1847.53846153846,83.6153846153846
"9417","31067","2015",1,1,0,40000,816,49
"9418","31069","2015",320,123,197,207760.175,2755.85,74.59375
"9419","31070","2015",6,6,0,87166.6666666667,876.166666666667,96.1666666666667
"9420","31071","2015",3,3,0,213983.333333333,1788.33333333333,122.666666666667
"9421","31073","2015",5,4,1,184310,1964.8,98.6
"9422","31074","2015",1,1,0,380000,1900,200
"9423","31075","2015",9,9,0,274891.777777778,2474.88888888889,114.555555555556
"9424","31076","2015",3,3,0,169433.333333333,1239.33333333333,135.666666666667
"9425","31077","2015",5,5,0,195499.2,1458.4,141.8
"9426","31078","2015",4,4,0,120375,1226.75,100.25
"9427","31079","2015",41,39,2,235138.951219512,2233.90243902439,110
"9428","31080","2015",12,11,1,111995.833333333,1114.25,114.333333333333
"9429","31082","2015",6,6,0,205016.666666667,1929.66666666667,103.833333333333
"9430","31083","2015",2,2,0,285000,2190,128.5
"9431","31084","2015",12,12,0,131300.833333333,1427.16666666667,93.1666666666667
"9432","31085","2015",9,7,2,68636.4444444444,986.333333333333,81.6666666666667
"9433","31086","2015",1,1,0,165000,1000,165
"9434","31087","2015",5,5,0,190960,1555.2,128.8
"9435","31088","2015",27,25,2,283348.407407407,2686.25925925926,104.962962962963
"9436","31089","2015",3,3,0,268000,2097.33333333333,131
"9437","31090","2015",3,3,0,160333.333333333,1765,92
"9438","31093","2015",12,12,0,194400,2079.58333333333,97.3333333333333
"9439","31094","2015",34,31,3,244403.441176471,2165.41176470588,110.852941176471
"9440","31095","2015",2,2,0,97500,1441.5,67.5
"9441","31096","2015",1,1,0,280000,1202,233
"9442","31097","2015",6,6,0,207750.833333333,1758,132.666666666667
"9443","31098","2015",15,15,0,161727.333333333,1600.13333333333,108.8
"9444","31099","2015",3,3,0,114333.333333333,1745.33333333333,66.3333333333333
"9445","31100","2015",26,26,0,137580.423076923,1568.38461538462,91.3461538461538
"9446","31101","2015",2,2,0,236080,2199.5,109
"9447","31102","2015",2,2,0,177500,1750,105
"9448","31103","2015",3,3,0,239733.333333333,2852.66666666667,86.3333333333333
"9449","31104","2015",9,9,0,203564.666666667,2131.77777777778,100.555555555556
"9450","31105","2015",1,1,0,253500,2613,97
"9451","31106","2015",19,19,0,198773.684210526,1657.42105263158,121.315789473684
"9452","31107","2015",50,48,2,200431.9,1942.96,108.06
"9453","31108","2015",2,2,0,161000,917,184
"9454","31109","2015",7,7,0,111703.571428571,1160.28571428571,102.428571428571
"9455","31110","2015",4,4,0,114300,961.75,116.5
"9456","31111","2015",4,4,0,261125,2235.5,135
"9457","31112","2015",2,2,0,120000,1439,87
"9458","31113","2015",149,55,94,223135.322147651,2710.40939597315,84.5906040268456
"9459","31114","2015",1,1,0,130000,1413,92
"9460","31116","2015",140,84,56,190205.921428571,2369.81428571429,82.5571428571429
"9461","31117","2015",36,35,1,285737.083333333,2674.86111111111,111.111111111111
"9462","31118","2015",67,46,21,174092.805970149,1963.58208955224,89.5671641791045
"9463","31119","2015",3,3,0,163333.333333333,1532.66666666667,111.333333333333
"9464","31120","2015",5,5,0,377131.2,2877.8,137
"9465","31121","2015",1,1,0,214125,1231,174
"9466","31124","2015",2,2,0,98250,836,118
"9467","31125","2015",3,3,0,129999.666666667,1646,139.666666666667
"9468","31126","2015",3,3,0,256553.333333333,1715.33333333333,152
"9469","31128","2015",11,11,0,185598.181818182,1881.27272727273,102.454545454545
"9470","31130","2015",1,1,0,189000,1750,108
"9471","31132","2015",1,1,0,69500,2106,33
"9472","31134","2015",2,2,0,107750,1070,105
"9473","31135","2015",53,42,11,127929.433962264,1460.84905660377,90.7735849056604
"9474","31136","2015",23,17,6,183386.086956522,1906.26086956522,98.8260869565217
"9475","31137","2015",1,1,0,328650,2858,115
"9476","31138","2015",1,1,0,165000,1587,104
"9477","31141","2015",2,2,0,142000,1127.5,125
"9478","31142","2015",3,3,0,201000,2343.33333333333,85
"9479","31143","2015",2,2,0,76500,857,87.5
"9480","31144","2015",11,11,0,75771.8181818182,842.545454545455,88
"9481","31145","2015",29,29,0,165789.448275862,1456.89655172414,113.793103448276
"9482","31146","2015",1,1,0,430000,2150,200
"9483","31147","2015",4,4,0,163250,1605.25,101.25
"9484","31148","2015",3,3,0,401400,2727.66666666667,144
"9485","31149","2015",392,223,169,208936.25,2330.5637755102,88.0357142857143
"9486","31150","2015",66,61,5,212609.318181818,2340.36363636364,92.6666666666667
"9487","31151","2015",2,2,0,355250,2642,135
"9488","31152","2015",1,1,0,170000,1518,112
"9489","31153","2015",10,10,0,150500,1276.8,121.4
"9490","31156","2015",3,3,0,136166.666666667,1047,139.333333333333
"9491","31157","2015",230,111,119,182639.047826087,2261.74782608696,78.9347826086957
"9492","31158","2015",1,1,0,115000,1173,98
"9493","31159","2015",3,3,0,166566.666666667,1261.66666666667,125.333333333333
"9494","31160","2015",18,17,1,230670,2341.88888888889,99.2777777777778
"9495","31161","2015",30,21,9,185836.333333333,2331.16666666667,82.0666666666667
"9496","31162","2015",8,8,0,232387.5,2033.25,116.25
"9497","31163","2015",22,21,1,299495,2565.45454545455,117.545454545455
"9498","31164","2015",1,1,0,155000,1722,90
"9499","31165","2015",2,2,0,186025,2438.5,79
"9500","31166","2015",2,2,0,221700,1686,125
"9501","31167","2015",5,5,0,96000,1024.8,93.6
"9502","31168","2015",1,1,0,114000,760,150
"9503","31169","2015",50,46,4,271384,2631.62,105.1
"9504","31170","2015",1,1,0,235000,1880,125
"9505","31171","2015",1,1,0,337800,2937,115
"9506","31172","2015",1,1,0,285701,1753,163
"9507","31174","2015",3,3,0,88533.3333333333,1211.66666666667,72.3333333333333
"9508","31175","2015",2,2,0,117500,1074.5,109.5
"9509","31176","2015",2,2,0,120000,1342,102
"9510","31177","2015",1,1,0,148000,1203,123
"9511","31178","2015",1,1,0,160000,1290,124
"9512","31179","2015",4,4,0,176401.25,1289.25,132.75
"9513","31181","2015",16,16,0,187859.375,1722.8125,120.4375
"9514","31182","2015",36,27,9,186749,2047.63888888889,93.0277777777778
"9515","31183","2015",5,5,0,73260,1177,72.4
"9516","31184","2015",3,3,0,242166.666666667,2091,121
"9517","31186","2015",41,14,27,152757.56097561,2138.43902439024,70.1951219512195
"9518","31187","2015",137,78,59,181433.408759124,2070.58394160584,84.4744525547445
"9519","31188","2015",35,34,1,263543.742857143,2193.34285714286,120.971428571429
"9520","31189","2015",2,2,0,169500,1621,104.5
"9521","31190","2015",9,9,0,65277.7777777778,734.555555555556,94
"9522","31192","2015",19,19,0,237348.421052632,2348.47368421053,102.842105263158
"9523","31193","2015",19,19,0,140512.105263158,1449.94736842105,103.947368421053
"9524","31194","2015",1,1,0,254910,1677,152
"9525","31196","2015",8,8,0,152812.5,1324.875,114.25
"9526","31197","2015",1,1,0,70000,417,168
"9527","31198","2015",2,2,0,130000,1387,92.5
"9528","31199","2015",6,6,0,101637.5,1332.33333333333,85.5
"9529","31200","2015",1,1,0,130000,1121,116
"9530","31201","2015",1,1,0,243820,1156,211
"9531","31202","2015",48,39,9,200289.041666667,1929.79166666667,109.458333333333
"9532","31203","2015",101,67,34,211217.940594059,2396.0198019802,89.2970297029703
"9533","31205","2015",37,17,20,167116.486486486,2215.94594594595,73.5135135135135
"9534","31206","2015",10,10,0,155825,1414.2,114.4
"9535","31207","2015",2,2,0,50000,800,70
"9536","31208","2015",1,1,0,228000,1520,150
"9537","31209","2015",1,1,0,125000,1389,90
"9538","31210","2015",15,13,2,151256.666666667,1512.66666666667,101.933333333333
"9539","31211","2015",5,5,0,241660,2040.6,122
"9540","31212","2015",18,15,3,196498.833333333,1929.55555555556,103.444444444444
"9541","31213","2015",3,2,1,103333.333333333,1655.33333333333,62.6666666666667
"9542","31215","2015",1,1,0,370000,3524,105
"9543","31216","2015",1,1,0,361140,2800,129
"9544","31217","2015",1,1,0,78000,867,90
"9545","31219","2015",4,4,0,117000,1442.5,81.25
"9546","31220","2015",2,2,0,57963.5,656,95
"9547","31221","2015",6,0,6,63904.1666666667,1694.5,37.3333333333333
"9548","31223","2015",1,1,0,75700,1183,64
"9549","31224","2015",18,16,2,79603.7222222222,890.722222222222,92.7777777777778
"9550","31227","2015",15,15,0,352293.933333333,2771.93333333333,129.533333333333
"9551","31228","2015",13,10,3,233841.538461538,2256.53846153846,103.461538461538
"9552","31229","2015",7,7,0,156095.714285714,1981.28571428571,102.571428571429
"9553","31230","2015",39,35,4,268709.923076923,2637.23076923077,103.205128205128
"9554","31231","2015",8,8,0,185631.25,1679.625,108.5
"9555","31232","2015",75,66,9,184316.133333333,2077.18666666667,93.24
"9556","31233","2015",6,6,0,2e+05,2010.33333333333,99.1666666666667
"9557","31234","2015",4,4,0,191325,1979.75,105
"9558","31236","2015",1,1,0,53000,414,128
"9559","31237","2015",3,3,0,69800,1334.33333333333,56.3333333333333
"9560","31239","2015",27,27,0,110648.703703704,1116.25925925926,101.555555555556
"9561","31240","2015",6,6,0,235602.5,2081,112.5
"9562","31241","2015",3,3,0,71000,795.666666666667,79
"9563","31244","2015",3,3,0,271910,2282,144.333333333333
"9564","31245","2015",1,1,0,140000,1014,138
"9565","31246","2015",12,12,0,122000,1185.91666666667,105.333333333333
"9566","31247","2015",10,10,0,161028.5,1204.1,147.2
"9567","31248","2015",48,40,8,199104.270833333,2018.41666666667,98.9375
"9568","31249","2015",12,12,0,200651.583333333,2258.33333333333,89.1666666666667
"9569","31250","2015",7,7,0,201814.285714286,1592.14285714286,125.285714285714
"9570","31251","2015",2,2,0,153000,1298,118
"9571","31252","2015",12,12,0,201644.75,2027.75,99.6666666666667
"9572","31253","2015",21,20,1,231793.80952381,2346.09523809524,100.761904761905
"9573","31254","2015",22,11,11,219887.090909091,2469.68181818182,90.8636363636364
"9574","31255","2015",6,6,0,82808.3333333333,1073,76.3333333333333
"9575","31256","2015",3,3,0,188333.333333333,1858.66666666667,101
"9576","31258","2015",2,2,0,241995,1430.5,175.5
"9577","31259","2015",19,16,3,274971.052631579,2626.52631578947,104.631578947368
"9578","31261","2015",8,8,0,171737.5,1657.125,103.75
"9579","31262","2015",3,3,0,134333.333333333,1732.66666666667,80.6666666666667
"9580","31263","2015",22,22,0,157997.727272727,1945.77272727273,82.3181818181818
"9581","31264","2015",5,5,0,168210,1824.2,93.6
"9582","31265","2015",2,2,0,143485,2856,48
"9583","31266","2015",2,2,0,127077,1114,112
"9584","31269","2015",7,7,0,198450,1848.57142857143,118.428571428571
"9585","31270","2015",10,10,0,184835,1445.8,133.4
"9586","31271","2015",24,23,1,277559.291666667,2182.54166666667,130.75
"9587","31273","2015",21,20,1,333022.380952381,2485.61904761905,137.809523809524
"9588","31276","2015",4,4,0,219886.75,1175.5,135.5
"9589","31277","2015",10,10,0,236713,1857.1,129.9
"9590","31278","2015",2,2,0,185750,987.5,173
"9591","31280","2015",7,7,0,146081.428571429,1221.28571428571,123.285714285714
"9592","31281","2015",14,13,1,182635.285714286,1710.85714285714,112.928571428571
"9593","31282","2015",71,45,26,187117.295774648,2230.22535211268,86.0985915492958
"9594","31283","2015",1,1,0,85000,924,92
"9595","31284","2015",11,11,0,354299.636363636,2892.27272727273,124.727272727273
"9596","31285","2015",1,1,0,387000,2932,132
"9597","31286","2015",4,4,0,157884.25,1208.5,126.75
"9598","31287","2015",12,12,0,261192.666666667,2183.5,134.416666666667
"9599","31288","2015",2,2,0,180000,1365.5,142
"9600","31289","2015",1,1,0,130000,1413,92
"9601","31290","2015",1,1,0,72000,742,97
"9602","31291","2015",87,65,22,218630.873563218,2314.96551724138,93.6436781609195
"9603","31293","2015",29,21,8,188182.75862069,2137.86206896552,89.3448275862069
"9604","31294","2015",1,1,0,106740,726,147
"9605","31296","2015",1,1,0,225000,1573,143
"9606","31297","2015",19,18,1,212791.842105263,2371.73684210526,91.7368421052632
"9607","31299","2015",45,38,7,191288.311111111,1932.26666666667,101.488888888889
"9608","31300","2015",2,2,0,96500,645,148.5
"9609","31301","2015",2,2,0,87750,911,95
"9610","31302","2015",4,4,0,203219,1325.75,161.5
"9611","31303","2015",27,25,2,181241.592592593,1866.85185185185,96.1111111111111
"9612","31304","2015",5,5,0,161360,1517.6,108
"9613","31306","2015",3,3,0,141166.666666667,1912,83.3333333333333
"9614","31309","2015",2,2,0,237660,1622,151.5
"9615","31310","2015",3,3,0,219500,1541.66666666667,158.333333333333
"9616","31311","2015",5,5,0,229770,1917.6,121.2
"9617","31313","2015",1,1,0,77000,875,88
"9618","31314","2015",4,4,0,122800,1417.5,85
"9619","31315","2015",5,5,0,79281.2,1038.6,75.2
"9620","31316","2015",6,6,0,100003.333333333,1369,78.5
"9621","31317","2015",3,3,0,215000,1712.33333333333,125.666666666667
"9622","31318","2015",2,2,0,150000,1486,100.5
"9623","31319","2015",2,2,0,195000,2117.5,91.5
"9624","31320","2015",5,5,0,232814,2209.6,108
"9625","31321","2015",1,1,0,50000,625,80
"9626","31323","2015",2,2,0,179500,1589.5,115.5
"9627","31324","2015",16,16,0,126750,1305.5625,98.8125
"9628","31325","2015",1,1,0,173480,1577,110
"9629","31326","2015",1,1,0,70000,438,160
"9630","31327","2015",2,2,0,162800,1682.5,107.5
"9631","31328","2015",2,2,0,215775,1778,121
"9632","31329","2015",3,3,0,190556.666666667,1537,120
"9633","31330","2015",2,2,0,125500,1652.5,73
"9634","31331","2015",2,2,0,197200,2093,94.5
"9635","31332","2015",3,3,0,186833.333333333,1660.66666666667,112
"9636","31333","2015",1,1,0,75250,717,105
"9637","31334","2015",15,15,0,197605.333333333,1788.6,105.733333333333
"9638","31336","2015",8,8,0,97953.75,904,106.375
"9639","31337","2015",2,2,0,56500,1502.5,44
"9640","31338","2015",9,9,0,193549.111111111,2323.44444444444,87.6666666666667
"9641","31339","2015",2,2,0,293595,3333.5,89
"9642","31340","2015",1,1,0,412200,2730,151
"9643","31341","2015",37,30,7,213324.540540541,2059.16216216216,104.945945945946
"9644","31342","2015",4,4,0,103625,1306.25,73.5
"9645","31343","2015",1,1,0,193970,1212,160
"9646","31344","2015",2,2,0,65000,820.5,80.5
"9647","31345","2015",24,23,1,193264.166666667,1991.625,95.9583333333333
"9648","31346","2015",7,7,0,206558.571428571,1906.57142857143,108.857142857143
"9649","31348","2015",1,1,0,130000,788,165
"9650","31349","2015",7,7,0,178372.857142857,1636.14285714286,108
"9651","31350","2015",1,1,0,90500,696,130
"9652","31351","2015",31,24,7,195770.161290323,2248.90322580645,89.3870967741936
"9653","31352","2015",3,3,0,377933.333333333,2377.66666666667,158
"9654","31354","2015",1,1,0,288000,2880,100
"9655","31355","2015",12,12,0,399303.833333333,2958.33333333333,137.916666666667
"9656","31356","2015",11,11,0,246387.636363636,2280.72727272727,117.909090909091
"9657","31357","2015",2,2,0,70000,671.5,92.5
"9658","31358","2015",27,26,1,245874.962962963,2302.7037037037,110.148148148148
"9659","31359","2015",1,1,0,150000,1271,118
"9660","31360","2015",6,4,2,162566.666666667,1883.5,88.5
"9661","31361","2015",5,5,0,230752,1885.6,123.6
"9662","31362","2015",2,2,0,80000,980.5,85
"9663","31363","2015",3,3,0,137666.666666667,1360.66666666667,109
"9664","31364","2015",2,2,0,271340,2467,110
"9665","31365","2015",5,5,0,310820,2098.2,140.8
"9666","31366","2015",4,4,0,228125,1768.75,124
"9667","31368","2015",3,3,0,242531.666666667,1814.33333333333,135.333333333333
"9668","31370","2015",3,3,0,129040,1468,86.3333333333333
"9669","31371","2015",2,2,0,145750,1444.5,101
"9670","31372","2015",3,3,0,128333.333333333,1124,115.666666666667
"9671","31373","2015",2,2,0,165300,1311.5,126
"9672","31374","2015",8,8,0,228305,2212.875,109.625
"9673","31375","2015",31,29,2,129392.838709677,1235.35483870968,107.225806451613
"9674","31377","2015",5,4,1,171160,2132.2,80.6
"9675","31380","2015",4,4,0,135603.5,1707.75,77.5
"9676","31381","2015",17,15,2,195255.176470588,2248.41176470588,90.7058823529412
"9677","31383","2015",9,9,0,230781.111111111,1986.77777777778,115.222222222222
"9678","31384","2015",10,10,0,234792,2806.8,88.4
"9679","31385","2015",3,3,0,115206.666666667,1523.66666666667,74.3333333333333
"9680","31386","2015",3,3,0,111466.666666667,908,129.666666666667
"9681","31387","2015",1,1,0,450000,5056,89
"9682","31388","2015",4,4,0,219471.25,2106.75,101.5
"9683","31389","2015",53,24,29,198270.867924528,2505.37735849057,78.6037735849057
"9684","31390","2015",25,23,2,102560.4,1181.24,83.72
"9685","31391","2015",3,3,0,108000,1260,85.6666666666667
"9686","31394","2015",2,2,0,188010,1923.5,99.5
"9687","31395","2015",243,143,100,160612.37037037,1976.33333333333,82.6090534979424
"9688","31396","2015",27,24,3,193529.037037037,1964.74074074074,104.592592592593
"9689","31398","2015",1,1,0,90000,1286,70
"9690","31399","2015",19,18,1,202146.578947368,2199.10526315789,91.2105263157895
"9691","31400","2015",2,2,0,201002.5,1245.5,161.5
"9692","31401","2015",1,1,0,309350,2475,125
"9693","31402","2015",7,7,0,350764.285714286,2779.14285714286,125.142857142857
"9694","31403","2015",2,2,0,220550,1496,165
"9695","31404","2015",1,1,0,1e+05,1299,77
"9696","31406","2015",5,5,0,114000,1113,98.4
"9697","31407","2015",8,8,0,240560,2061.25,125.25
"9698","31410","2015",36,33,3,232596.416666667,2332.63888888889,100.305555555556
"9699","31411","2015",5,5,0,439620,2977.8,149.4
"9700","31412","2015",3,3,0,95333.3333333333,697,145
"9701","31413","2015",5,5,0,165106,1651,104.8
"9702","31416","2015",6,6,0,123500,1277.33333333333,99.3333333333333
"9703","31417","2015",65,57,8,301424.092307692,2713.13846153846,113.123076923077
"9704","31418","2015",4,4,0,430620,2208,196
"9705","31420","2015",33,24,9,202864.848484848,2304.39393939394,88.8787878787879
"9706","31421","2015",41,32,9,211242.609756098,2226.78048780488,96.4634146341463
"9707","31422","2015",1,1,0,91000,1152,79
"9708","31423","2015",4,4,0,174675,1680.25,111.5
"9709","31424","2015",191,139,52,237132.654450262,2436.31937172775,95.565445026178
"9710","31425","2015",10,10,0,120274.5,1112.7,106.9
"9711","31426","2015",2,2,0,135000,1509.5,94.5
"9712","31427","2015",13,12,1,110480.769230769,1074.46153846154,108.615384615385
"9713","31428","2015",1,1,0,141000,820,172
"9714","31429","2015",27,14,13,198660,2338.7037037037,82.7407407407407
"9715","31430","2015",2,2,0,180000,1550,118.5
"9716","31431","2015",2,2,0,60000,949,61.5
"9717","31433","2015",83,59,24,208028.060240964,2177.0843373494,91.2168674698795
"9718","31435","2015",7,7,0,179659.714285714,1769.57142857143,104.714285714286
"9719","31436","2015",6,6,0,136500,1313.16666666667,105.666666666667
"9720","31437","2015",1,1,0,142400,1656,86
"9721","31439","2015",3,3,0,370740,2901.66666666667,132.666666666667
"9722","31440","2015",2,2,0,200750,1522.5,132
"9723","31442","2015",6,6,0,158490.833333333,1492.5,107.833333333333
"9724","31443","2015",2,2,0,215000,870.5,207
"9725","31445","2015",68,40,28,228389.382352941,2754.11764705882,83.2352941176471
"9726","31446","2015",196,50,146,172584.836734694,2449.65306122449,71.5
"9727","31447","2015",1,1,0,123000,1757,70
"9728","31448","2015",2,2,0,338927.5,3182.5,113
"9729","31449","2015",3,3,0,154000,1060,149
"9730","31450","2015",6,5,1,177616.666666667,1804.33333333333,97.6666666666667
"9731","31451","2015",94,74,20,146272.074468085,1611.77659574468,91.4255319148936
"9732","31452","2015",1,1,0,70000,667,105
"9733","31453","2015",1,1,0,2e+05,2041,98
"9734","31454","2015",46,35,11,132942.260869565,1460.4347826087,93.7608695652174
"9735","31455","2015",17,17,0,168617.117647059,1451.47058823529,118.764705882353
"9736","31456","2015",1,1,0,248000,1378,180
"9737","31457","2015",11,11,0,105310.090909091,916.545454545455,118.272727272727
"9738","31458","2015",36,32,4,228005.277777778,2460.33333333333,99.6388888888889
"9739","31459","2015",6,6,0,192500,1877.16666666667,105.333333333333
"9740","31460","2015",32,25,7,205170.15625,2213.5,95.28125
"9741","31461","2015",2,2,0,100125,1156.5,93.5
"9742","31462","2015",18,10,8,235769.444444444,2434.33333333333,86.7777777777778
"9743","31463","2015",2,2,0,209000,1525.5,137
"9744","31464","2015",1,1,0,250000,1220,205
"9745","31466","2015",7,7,0,233288.571428571,2514.28571428571,96.5714285714286
"9746","31467","2015",44,40,4,246532.5,2474.02272727273,99.5681818181818
"9747","31468","2015",3,3,0,119000,966,126.666666666667
"9748","31470","2015",8,2,6,69887.5,1508.375,46.375
"9749","31471","2015",5,4,1,106500,1092,103.2
"9750","31472","2015",1,1,0,1e+05,1250,80
"9751","31473","2015",3,2,1,196566.666666667,2055.66666666667,89.6666666666667
"9752","31475","2015",12,10,2,196644.166666667,1907.25,99.5833333333333
"9753","31476","2015",6,6,0,163380,1564.33333333333,106.666666666667
"9754","31477","2015",1,1,0,40000,500,80
"9755","31478","2015",13,13,0,168992.307692308,1464.69230769231,127.692307692308
"9756","31480","2015",18,15,3,285637.388888889,2402.55555555556,128.333333333333
"9757","31481","2015",16,14,2,207745,1760.9375,123
"9758","31482","2015",1,1,0,55200,547,101
"9759","31483","2015",91,55,36,104891.43956044,1171.06593406593,89.2527472527473
"9760","31484","2015",11,10,1,258528.090909091,2370.54545454545,117.818181818182
"9761","31485","2015",1,1,0,380550,2554,149
"9762","31486","2015",8,7,1,204350,1960.5,101.875
"9763","31487","2015",1,1,0,145000,806,180
"9764","31488","2015",159,86,73,213106.157232704,2660.31446540881,81.0691823899371
"9765","31489","2015",3,3,0,377026,2280,165.333333333333
"9766","31490","2015",3,3,0,183600,2190,85.3333333333333
"9767","31491","2015",4,4,0,141600,1544,89.5
"9768","31492","2015",7,7,0,152950,1540,105.142857142857
"9769","31494","2015",1,1,0,145000,1283,113
"9770","31495","2015",9,9,0,224472.777777778,2491.66666666667,103.333333333333
"9771","31496","2015",1,1,0,346000,5088,68
"9772","31497","2015",12,12,0,290355,2652.83333333333,109.333333333333
"9773","31499","2015",109,95,14,198949.71559633,2075.4128440367,98.0183486238532
"9774","31500","2015",13,5,8,114571.923076923,2023.15384615385,59.4615384615385
"9775","31501","2015",1,1,0,80000,1250,64
"9776","31502","2015",2,2,0,34600,505,68.5
"9777","31503","2015",11,11,0,121888.818181818,1244.09090909091,99
"9778","31504","2015",1,1,0,150000,1020,147
"9779","31505","2015",4,4,0,90000,1277.5,72.5
"9780","31506","2015",133,81,52,215660.007518797,2465.45864661654,88.6466165413534
"9781","31507","2015",14,11,3,205378.857142857,2212.35714285714,93.9285714285714
"9782","31511","2015",2,2,0,218500,2112.5,102.5
"9783","31512","2015",6,6,0,290350,2478,116.666666666667
"9784","31513","2015",2,2,0,98000,1033,99.5
"9785","31515","2015",5,5,0,235900,2282.2,102.8
"9786","31516","2015",15,15,0,208720,1959.46666666667,110
"9787","31517","2015",11,9,2,189397.272727273,1785.63636363636,109.545454545455
"9788","31518","2015",9,9,0,216288.888888889,1812.11111111111,118.888888888889
"9789","31519","2015",1,1,0,105000,656,160
"9790","31520","2015",1,1,0,163000,1455,112
"9791","31521","2015",2,2,0,45000,884,45.5
"9792","31523","2015",18,15,3,100469.833333333,1177.11111111111,95.3888888888889
"9793","31524","2015",1,0,1,46500,596,78
"9794","31525","2015",3,3,0,283333.333333333,1948,146.666666666667
"9795","31526","2015",88,59,29,207776.545454545,2473.02272727273,84.5
"9796","31527","2015",1,1,0,255000,2125,120
"9797","31528","2015",2,2,0,115000,1151.5,81
"9798","31529","2015",2,2,0,205276.5,728,231.5
"9799","31530","2015",1,1,0,140000,1687,83
"9800","31531","2015",1,1,0,62000,1051,59
"9801","31533","2015",20,19,1,272504.8,2425.9,122.95
"9802","31534","2015",1,1,0,230000,2396,96
"9803","31535","2015",6,6,0,63583.3333333333,931.333333333333,73.1666666666667
"9804","31536","2015",2,2,0,237350,1602.5,148
"9805","31537","2015",1,1,0,187700,1390,135
"9806","31538","2015",3,3,0,127520.333333333,2756.66666666667,49.6666666666667
"9807","31540","2015",2,2,0,282750,1803,166
"9808","31541","2015",69,20,49,188989.884057971,2462.10144927536,74.5797101449275
"9809","31542","2015",1,1,0,90000,1324,68
"9810","31545","2015",2,2,0,55000,514,101.5
"9811","31546","2015",1,1,0,390000,3000,130
"9812","31547","2015",70,63,7,220840.314285714,2121.25714285714,104.885714285714
"9813","31550","2015",2,2,0,106000,1495.5,69.5
"9814","31551","2015",5,5,0,233063,2207.8,107.2
"9815","31552","2015",1,1,0,95000,792,120
"9816","31553","2015",10,9,1,219725,2091.6,102.2
"9817","31554","2015",5,5,0,166240,1416.4,110.2
"9818","31555","2015",7115,1112,6003,172147.821925509,2759.1363316936,62.9628952916374
"9819","31556","2015",2,2,0,109000,1388.5,78.5
"9820","31557","2015",280,187,93,278894.575,2823.19642857143,97.1571428571429
"9821","31558","2015",1,1,0,150000,968,155
"9822","31560","2015",3,3,0,310666.666666667,2060,160
"9823","31561","2015",118,87,31,248661.669491525,2724.03389830508,92.9237288135593
"9824","31563","2015",7,7,0,187155.714285714,2287.14285714286,88.2857142857143
"9825","31564","2015",2,2,0,164960,1623.5,97
"9826","31565","2015",8,7,1,91127.5,950.125,95.125
"9827","31566","2015",3,3,0,192316.666666667,2115.33333333333,98.6666666666667
"9828","31567","2015",1,1,0,376160,2113,178
"9829","31568","2015",2,2,0,314387.5,2795.5,114
"9830","31569","2015",3,3,0,138000,1365.66666666667,102.666666666667
"9831","31570","2015",3,3,0,178600,2346.66666666667,79
"9832","31571","2015",3,3,0,241333.333333333,2050.33333333333,118.666666666667
"9833","31572","2015",22,20,2,189100.181818182,2176.5,86.3636363636364
"9834","31573","2015",35,29,6,209897.457142857,1836.11428571429,112.8
"9835","31574","2015",18,18,0,186419.666666667,2165.94444444444,94.1111111111111
"9836","31575","2015",15,15,0,458201.2,2755,173.333333333333
"9837","31576","2015",1,1,0,110000,1467,75
"9838","31577","2015",1,1,0,202000,2270,89
"9839","31578","2015",3,3,0,516966.666666667,3365.66666666667,152.333333333333
"9840","31579","2015",10,10,0,213769,2055.7,105.5
"9841","31580","2015",9,9,0,239883.333333333,2433.22222222222,100.333333333333
"9842","31581","2015",18,18,0,183793.055555556,1771.38888888889,102.944444444444
"9843","31582","2015",52,41,11,168084.230769231,2192.40384615385,85.7115384615385
"9844","31583","2015",7,7,0,183198.571428571,1732.57142857143,103.428571428571
"9845","31584","2015",74,64,10,135786.878378378,1530.62162162162,89.445945945946
"9846","31585","2015",10,9,1,132240,1246.3,115
"9847","31586","2015",3,3,0,102166.666666667,1233.66666666667,81
"9848","31587","2015",9,9,0,260005.555555556,2069.22222222222,128.111111111111
"9849","31588","2015",112,91,21,219618.151785714,2439.57142857143,90.5267857142857
"9850","31589","2015",11,10,1,194869.090909091,1650.90909090909,133.727272727273
"9851","31591","2015",1,1,0,61820,773,80
"9852","31592","2015",10,10,0,273009,2347.3,117.6
"9853","31593","2015",1,1,0,160000,1194,134
"9854","32001","2015",5,5,0,185134,1386.8,125.4
"9855","32002","2015",1,1,0,180000,1314,137
"9856","32004","2015",1,1,0,207550,1147,181
"9857","32005","2015",3,3,0,82900,1361.66666666667,62.6666666666667
"9858","32007","2015",2,2,0,175600,1989.5,89.5
"9859","32009","2015",2,2,0,92500,517,184
"9860","32010","2015",2,2,0,142660,1902,95
"9861","32012","2015",11,11,0,132633.363636364,1460.63636363636,107.454545454545
"9862","32013","2015",250,167,83,122652.604,1487.4,85.9
"9863","32014","2015",1,1,0,131000,771,170
"9864","32016","2015",5,5,0,215180,1824.6,119.8
"9865","32018","2015",1,1,0,229400,2085,110
"9866","32019","2015",4,4,0,184545,1862.5,97
"9867","32020","2015",4,4,0,100500,922.5,95
"9868","32021","2015",1,1,0,156970,1847,85
"9869","32022","2015",2,2,0,168000,1463,110.5
"9870","32024","2015",3,3,0,111500,679,177.333333333333
"9871","32025","2015",1,1,0,175000,983,178
"9872","32026","2015",1,1,0,138500,1669,83
"9873","32027","2015",11,10,1,96109.0909090909,1129.54545454545,84.3636363636364
"9874","32029","2015",9,9,0,130822.222222222,1104.44444444444,119.666666666667
"9875","32030","2015",2,2,0,239175,1694.5,140
"9876","32032","2015",1,1,0,61000,813,75
"9877","32033","2015",3,3,0,186666.666666667,1121.66666666667,158
"9878","32034","2015",1,1,0,120000,876,137
"9879","32036","2015",7,6,1,117687.285714286,1279.28571428571,93.1428571428571
"9880","32039","2015",1,1,0,115000,2091,55
"9881","32042","2015",1,1,0,75000,543,138
"9882","32043","2015",2,2,0,106000,1546.5,68.5
"9883","32044","2015",3,3,0,142333.333333333,2461,57
"9884","32045","2015",3,3,0,103666.666666667,1158,94
"9885","32046","2015",3,3,0,174233.333333333,1291.66666666667,138
"9886","32047","2015",1,1,0,475000,1621,293
"9887","32050","2015",1,1,0,75000,577,130
"9888","32051","2015",2,2,0,675487.5,3802.5,157.5
"9889","32054","2015",8,8,0,201712.5,1525.875,142.125
"9890","32057","2015",2,2,0,89000,834,108.5
"9891","32060","2015",3,3,0,210866.666666667,1459,140
"9892","32062","2015",1,1,0,40000,364,110
"9893","32063","2015",2,2,0,127500,1133.5,115.5
"9894","32064","2015",1,1,0,165000,1375,120
"9895","32066","2015",3,3,0,137333.333333333,1374.33333333333,99.3333333333333
"9896","32068","2015",2,2,0,147500,1488,102
"9897","32069","2015",4,4,0,217650,1714.75,119
"9898","32070","2015",3,3,0,95666.6666666667,1121,86
"9899","32071","2015",1,1,0,245000,1750,140
"9900","32073","2015",4,4,0,88442.5,709,119.75
"9901","32075","2015",2,2,0,130000,1924.5,74.5
"9902","32076","2015",3,3,0,185216.666666667,1390.66666666667,121.333333333333
"9903","32079","2015",16,16,0,132374.0625,1277.9375,111.75
"9904","32082","2015",5,5,0,147000,1344,110.6
"9905","32083","2015",7,7,0,146428.571428571,1505.42857142857,98.8571428571429
"9906","32084","2015",1,1,0,213000,2029,105
"9907","32085","2015",2,2,0,169600,1741.5,97.5
"9908","32086","2015",1,1,0,148000,1057,140
"9909","32088","2015",2,2,0,70000,819.5,83.5
"9910","32089","2015",3,3,0,117333.333333333,1069.33333333333,127.333333333333
"9911","32090","2015",3,3,0,191313.333333333,1512.33333333333,128.333333333333
"9912","32091","2015",3,3,0,191000,1962,97.3333333333333
"9913","32093","2015",1,1,0,170250,1431,119
"9914","32094","2015",3,3,0,212883.333333333,1609,140.666666666667
"9915","32095","2015",6,6,0,103350,1218.66666666667,94.6666666666667
"9916","32096","2015",47,15,32,68602.9787234043,1332,54.1063829787234
"9917","32097","2015",2,2,0,110000,916.5,125
"9918","32098","2015",1,1,0,155000,1033,150
"9919","32099","2015",2,2,0,231500,1101,213.5
"9920","32100","2015",2,2,0,120000,963,119
"9921","32102","2015",1,1,0,141000,1424,99
"9922","32103","2015",2,2,0,124000,941.5,133.5
"9923","32106","2015",10,10,0,153686.2,1440,115.3
"9924","32107","2015",59,51,8,138506.661016949,1164,105.762711864407
"9925","32108","2015",2,2,0,82250,1082,152.5
"9926","32109","2015",4,4,0,171125,1044.75,138
"9927","32110","2015",3,3,0,61166.6666666667,930.333333333333,65
"9928","32112","2015",1,1,0,223940,2488,90
"9929","32115","2015",2,2,0,124500,886,155.5
"9930","32116","2015",1,1,0,75000,882,85
"9931","32117","2015",6,6,0,231183.333333333,2041.66666666667,113.666666666667
"9932","32118","2015",1,1,0,280540,2953,95
"9933","32119","2015",32,30,2,109995,1174.9375,90.125
"9934","32120","2015",5,5,0,200860,1970,104
"9935","32121","2015",3,3,0,171000,1757,97
"9936","32123","2015",4,4,0,255350,1637.5,158.25
"9937","32124","2015",2,2,0,130750,1470.5,89
"9938","32125","2015",1,1,0,145000,1208,120
"9939","32126","2015",1,1,0,130000,793,164
"9940","32127","2015",6,6,0,134945,1379,94.8333333333333
"9941","32128","2015",1,1,0,80000,1404,57
"9942","32129","2015",2,1,1,84415,826,101
"9943","32132","2015",74,71,3,115188.621621622,1195.48648648649,102.162162162162
"9944","32134","2015",3,3,0,181800,1387,133.666666666667
"9945","32135","2015",1,1,0,123000,1367,90
"9946","32138","2015",1,1,0,249550,1540,162
"9947","32140","2015",2,2,0,160775,1820,88.5
"9948","32141","2015",1,1,0,260750,2103,124
"9949","32143","2015",1,1,0,195000,1625,120
"9950","32144","2015",2,2,0,177500,1133.5,138.5
"9951","32145","2015",1,1,0,86000,1194,72
"9952","32146","2015",2,2,0,199000,1261,153
"9953","32147","2015",26,23,3,139383.846153846,1355.34615384615,104.153846153846
"9954","32149","2015",12,12,0,117108.333333333,1222.41666666667,98.6666666666667
"9955","32150","2015",2,2,0,167317.5,1436.5,117
"9956","32152","2015",4,4,0,94492.5,895.25,100
"9957","32154","2015",4,4,0,144612.5,1490.75,88.5
"9958","32155","2015",7,7,0,86892.8571428571,1100.28571428571,77
"9959","32156","2015",1,1,0,155000,1550,100
"9960","32157","2015",2,2,0,157590,1529.5,103
"9961","32158","2015",1,1,0,210000,1180,178
"9962","32159","2015",4,4,0,79500,605.25,131.25
"9963","32160","2015",81,64,17,209515.271604938,2198.61728395062,98.1111111111111
"9964","32161","2015",1,1,0,155000,1490,104
"9965","32162","2015",9,8,1,102945.333333333,995.333333333333,114.444444444444
"9966","32163","2015",1,1,0,1e+05,971,103
"9967","32164","2015",1,1,0,277500,1632,170
"9968","32166","2015",1,1,0,144000,1000,144
"9969","32167","2015",1,1,0,111000,1850,60
"9970","32170","2015",2,2,0,187075,1387.5,143
"9971","32172","2015",1,1,0,70000,1667,42
"9972","32173","2015",3,3,0,150533.333333333,1711.33333333333,92
"9973","32174","2015",1,1,0,124000,1127,110
"9974","32175","2015",2,2,0,289425,1427.5,160
"9975","32177","2015",1,1,0,120000,1333,90
"9976","32180","2015",5,5,0,176753.2,1781.2,102.8
"9977","32181","2015",2,2,0,55000,464,112
"9978","32182","2015",2,2,0,122000,897.5,134
"9979","32183","2015",1,1,0,197800,1423,139
"9980","32184","2015",1,1,0,166250,978,170
"9981","32185","2015",1,1,0,70000,538,130
"9982","32188","2015",1,1,0,110000,1158,95
"9983","32189","2015",4,4,0,88875,802.75,92.25
"9984","32190","2015",5,3,2,74701.6,881,84
"9985","32191","2015",1,1,0,1e+05,1333,75
"9986","32192","2015",1,1,0,81000,853,95
"9987","32193","2015",4,4,0,122500,1055,113.5
"9988","32194","2015",3,3,0,118333.333333333,1409.66666666667,97.3333333333333
"9989","32195","2015",1,1,0,360000,1865,193
"9990","32196","2015",1,1,0,335000,1255,267
"9991","32197","2015",1,1,0,164700,1069,154
"9992","32198","2015",4,4,0,300678.75,2855,117.5
"9993","32200","2015",2,2,0,175000,1773,103.5
"9994","32201","2015",1,1,0,227140,1566,145
"9995","32202","2015",1,1,0,128000,1829,70
"9996","32203","2015",2,2,0,140000,907.5,155.5
"9997","32204","2015",3,3,0,183566.666666667,1419.33333333333,130
"9998","32205","2015",2,2,0,195250,1893,113
"9999","32206","2015",2,2,0,204265.5,1675.5,132
"10000","32207","2015",1,1,0,250400,2340,107
"10001","32208","2015",38,36,2,154233.157894737,1268.15789473684,113.631578947368
"10002","32209","2015",4,4,0,133162.5,1301.5,103.75
"10003","32210","2015",6,6,0,282150.833333333,2065.16666666667,137
"10004","32211","2015",1,1,0,120000,1200,100
"10005","32212","2015",1,1,0,70000,753,93
"10006","32213","2015",37,35,2,146052.27027027,1483.91891891892,100.756756756757
"10007","32214","2015",1,1,0,160000,696,230
"10008","32219","2015",5,5,0,133800,1003,131
"10009","32220","2015",1,1,0,25000,500,50
"10010","32221","2015",3,3,0,110960,1183,89.3333333333333
"10011","32222","2015",1,1,0,165000,1602,103
"10012","32223","2015",1,1,0,254680,2071,123
"10013","32224","2015",1,1,0,150000,1596,94
"10014","32225","2015",1,1,0,280000,2000,140
"10015","32226","2015",1,1,0,208000,1051,198
"10016","32227","2015",3,3,0,105083.333333333,1014,114.666666666667
"10017","32228","2015",1,1,0,70909,1418,50
"10018","32230","2015",1,1,0,56000,459,122
"10019","32231","2015",3,1,2,123616.666666667,1564.66666666667,76.6666666666667
"10020","32232","2015",1,1,0,36000,692,52
"10021","32233","2015",12,12,0,109755.833333333,1134.66666666667,96.9166666666667
"10022","32234","2015",5,5,0,202162,1379,150.4
"10023","32235","2015",2,2,0,171850,1263.5,136
"10024","32237","2015",5,5,0,155000,1620.4,96.2
"10025","32239","2015",2,2,0,251750,2627.5,107
"10026","32241","2015",1,1,0,350000,2800,125
"10027","32242","2015",16,16,0,153391.875,1596.5,108.3125
"10028","32243","2015",2,2,0,62750,717.5,96
"10029","32244","2015",4,4,0,112737.5,1212.75,110
"10030","32245","2015",1,1,0,123000,1464,84
"10031","32246","2015",1,1,0,52000,347,150
"10032","32248","2015",1,1,0,140000,1077,130
"10033","32249","2015",20,20,0,121310.05,1320.45,98.75
"10034","32251","2015",1,1,0,90000,1406,64
"10035","32252","2015",18,18,0,115678.555555556,1127.83333333333,101
"10036","32253","2015",4,3,1,48125,648.25,79.75
"10037","32254","2015",1,1,0,138000,1394,99
"10038","32256","2015",23,21,2,132534.956521739,1508.4347826087,108.130434782609
"10039","32257","2015",1,1,0,47520,625,76
"10040","32258","2015",1,1,0,48000,500,96
"10041","32261","2015",4,4,0,153790.25,1330.25,120
"10042","32262","2015",3,3,0,300933.333333333,1659,176.666666666667
"10043","32263","2015",2,2,0,156050,1270.5,122
"10044","32264","2015",1,1,0,106000,1325,80
"10045","32266","2015",2,2,0,205600,1652.5,124
"10046","32268","2015",5,5,0,226980,2116.6,105.8
"10047","32269","2015",2,2,0,180000,1707,94.5
"10048","32271","2015",1,1,0,94550,622,152
"10049","32272","2015",1,1,0,235000,1679,140
"10050","32273","2015",7,7,0,142130.285714286,1316,112
"10051","32274","2015",3,3,0,147166.666666667,959.333333333333,146
"10052","32276","2015",1,1,0,195250,1347,145
"10053","32277","2015",1,1,0,173250,1682,103
"10054","32279","2015",8,8,0,180871.875,1496.625,109.375
"10055","32282","2015",1,1,0,150200,1430,105
"10056","32283","2015",4,4,0,109250,1220.75,102
"10057","32284","2015",2,2,0,85000,870.5,100.5
"10058","32285","2015",5,5,0,137400,1218.2,121
"10059","32286","2015",8,8,0,133056.375,1813.5,96.5
"10060","32288","2015",2,2,0,169000,1748.5,94.5
"10061","32289","2015",4,4,0,136500,1334.75,105.5
"10062","32290","2015",16,16,0,169063.1875,1114.1875,152.5
"10063","32292","2015",4,4,0,91800,1106.75,77.25
"10064","32295","2015",1,1,0,170500,1421,120
"10065","32296","2015",18,18,0,134823.611111111,1213.16666666667,121.666666666667
"10066","32297","2015",1,1,0,209391,2033,103
"10067","32298","2015",2,2,0,115000,1130,98.5
"10068","32300","2015",1,1,0,53000,402,132
"10069","32301","2015",7,7,0,173571.428571429,1440.57142857143,139.571428571429
"10070","32302","2015",1,1,0,196850,1514,130
"10071","32303","2015",2,2,0,206250,1643.5,125
"10072","32304","2015",4,4,0,102405,982.25,123.25
"10073","32305","2015",3,3,0,96666.6666666667,1056.66666666667,89.6666666666667
"10074","32306","2015",2,2,0,92275,1020,95.5
"10075","32307","2015",7,7,0,158783.428571429,1623.14285714286,99.2857142857143
"10076","32308","2015",1,1,0,178000,1179,151
"10077","32310","2015",1,1,0,158000,1013,156
"10078","32311","2015",3,3,0,249796.666666667,1383.33333333333,182.666666666667
"10079","32312","2015",7,7,0,156652.142857143,1522.71428571429,98.7142857142857
"10080","32315","2015",2,2,0,140000,1370,102
"10081","32316","2015",1,1,0,214000,1585,135
"10082","32319","2015",20,20,0,88350,1031.85,88.25
"10083","32321","2015",5,5,0,141814,1402.6,95.2
"10084","32323","2015",2,2,0,181400,1042,186
"10085","32324","2015",2,2,0,107500,1021.5,126
"10086","32325","2015",2,2,0,167296.5,1046,153
"10087","32326","2015",3,3,0,377954,2335.66666666667,164.333333333333
"10088","32327","2015",1,1,0,214000,1427,150
"10089","32329","2015",4,4,0,157825,1359.5,130.25
"10090","32330","2015",1,1,0,90000,703,128
"10091","32331","2015",5,5,0,198840,1914.2,106
"10092","32332","2015",1,1,0,223450,1719,130
"10093","32333","2015",2,2,0,155442.5,1660,124.5
"10094","32334","2015",11,11,0,317942.909090909,2311.72727272727,143.636363636364
"10095","32335","2015",4,4,0,87250,1034.75,89
"10096","32336","2015",2,2,0,212310,1621.5,137
"10097","32338","2015",2,2,0,274500,2287,103.5
"10098","32339","2015",2,2,0,181820,1419.5,147.5
"10099","32340","2015",2,2,0,239500,1781,135
"10100","32341","2015",1,1,0,190000,1166,163
"10101","32343","2015",2,2,0,292500,1613.5,214
"10102","32344","2015",21,21,0,110153.80952381,1105.90476190476,106.238095238095
"10103","32345","2015",6,5,1,116000,1274.16666666667,101
"10104","32346","2015",1,1,0,107000,1574,68
"10105","32348","2015",5,5,0,142330,1513.8,102.6
"10106","32350","2015",1,1,0,20000,714,28
"10107","32351","2015",1,1,0,145000,1933,75
"10108","32352","2015",1,1,0,231000,4278,54
"10109","32353","2015",3,3,0,146433.333333333,1195,132.333333333333
"10110","32354","2015",3,3,0,62333.3333333333,526,114.666666666667
"10111","32356","2015",1,1,0,99220,1323,75
"10112","32357","2015",1,1,0,210000,1875,112
"10113","32358","2015",3,2,1,91500,1052.33333333333,91.6666666666667
"10114","32359","2015",1,1,0,161800,1703,95
"10115","32364","2015",1,1,0,176000,1544,114
"10116","32365","2015",2,2,0,155690,1207,129
"10117","32367","2015",1,1,0,151500,891,170
"10118","32368","2015",4,4,0,157112.5,1521,104.25
"10119","32369","2015",1,1,0,132000,1245,106
"10120","32370","2015",14,14,0,127922.857142857,1366.92857142857,97.7142857142857
"10121","32372","2015",4,4,0,222575,2311.25,98.5
"10122","32373","2015",1,1,0,243000,1227,198
"10123","32374","2015",2,2,0,179335,1369.5,133
"10124","32376","2015",2,2,0,114500,900.5,126
"10125","32377","2015",2,2,0,337450,2362.5,160
"10126","32378","2015",5,5,0,114676,1187.6,97.6
"10127","32379","2015",2,2,0,192500,1740,111
"10128","32380","2015",1,1,0,98900,733,135
"10129","32381","2015",2,2,0,115000,1187.5,93.5
"10130","32382","2015",2,2,0,84500,1193,66.5
"10131","32383","2015",1,1,0,50000,1250,40
"10132","32384","2015",1,1,0,287400,1369,210
"10133","32385","2015",1,1,0,185000,944,196
"10134","32386","2015",1,1,0,130000,602,216
"10135","32388","2015",1,1,0,300400,1581,190
"10136","32389","2015",4,4,0,187450,1628,117.75
"10137","32390","2015",2,2,0,366000,1879,227
"10138","32391","2015",1,1,0,36000,522,69
"10139","32392","2015",1,1,0,259000,3985,65
"10140","32394","2015",1,1,0,1e+05,588,170
"10141","32395","2015",2,2,0,89000,1125,80.5
"10142","32396","2015",1,1,0,75000,610,123
"10143","32397","2015",3,3,0,117666.666666667,1072.66666666667,103.666666666667
"10144","32398","2015",2,2,0,85915,941.5,89
"10145","32400","2015",3,3,0,171666.666666667,1162,109
"10146","32402","2015",1,1,0,617080,1916,322
"10147","32404","2015",12,12,0,117682.5,1275,96.5
"10148","32405","2015",1,1,0,195000,1134,172
"10149","32406","2015",3,3,0,142383.333333333,1255,115.666666666667
"10150","32407","2015",4,4,0,199615,1597.25,127.5
"10151","32408","2015",2,2,0,135000,1166.5,110
"10152","32409","2015",1,1,0,327900,1708,192
"10153","32410","2015",20,19,1,159160,1629.1,103.5
"10154","32411","2015",7,7,0,143671.428571429,1314.57142857143,118.142857142857
"10155","32412","2015",11,10,1,107552.454545455,1205.45454545455,79.1818181818182
"10156","32413","2015",1,1,0,56600,590,96
"10157","32414","2015",4,4,0,191250,1418.25,133.75
"10158","32415","2015",4,4,0,223750,1365.5,151.25
"10159","32416","2015",3,3,0,165000,1452,111.666666666667
"10160","32417","2015",4,4,0,90000,777.5,121.75
"10161","32419","2015",1,1,0,116000,1160,100
"10162","32424","2015",1,1,0,97900,1224,80
"10163","32425","2015",7,7,0,198565.714285714,2034.28571428571,97.2857142857143
"10164","32426","2015",16,15,1,150185.9375,1292.25,112.0625
"10165","32428","2015",1,1,0,187500,1603,117
"10166","32430","2015",2,2,0,1e+05,1136.5,87.5
"10167","32431","2015",1,1,0,130000,1140,114
"10168","32433","2015",4,4,0,106372.5,890,124
"10169","32436","2015",4,4,0,207375,2029.5,101.25
"10170","32439","2015",4,4,0,118369.5,775,162.25
"10171","32440","2015",2,2,0,181000,1067,166.5
"10172","32442","2015",5,5,0,217100,1129.6,166.2
"10173","32443","2015",5,5,0,96264.8,732.4,164.8
"10174","32446","2015",1,1,0,62000,1033,60
"10175","32448","2015",6,6,0,170823.5,1469.83333333333,117.166666666667
"10176","32450","2015",3,3,0,164100,1484.33333333333,107.666666666667
"10177","32451","2015",2,2,0,109000,1265.5,85
"10178","32452","2015",4,4,0,151250,2498,116.75
"10179","32453","2015",2,2,0,91000,836,109
"10180","32455","2015",1,1,0,83625,753,111
"10181","32456","2015",1,1,0,160000,2133,75
"10182","32457","2015",5,5,0,124520,1275.8,108.4
"10183","32458","2015",2,2,0,226200,1348.5,175.5
"10184","32459","2015",11,11,0,116493.272727273,1073.18181818182,106.272727272727
"10185","32460","2015",2,2,0,158745,1516,104.5
"10186","32462","2015",38,37,1,111118.421052632,1139.42105263158,99.6315789473684
"10187","32463","2015",7,7,0,89145.7142857143,1013.28571428571,90
"10188","32464","2015",9,8,1,141366.666666667,1082,127.555555555556
"10189","32465","2015",2,2,0,193731,2117,98.5
"10190","32467","2015",1,1,0,260000,1566,166
"10191","33001","2015",18,18,0,109611.111111111,1218.44444444444,91.2777777777778
"10192","33002","2015",6,6,0,163500,1675.33333333333,100.833333333333
"10193","33003","2015",150,138,12,188742.766666667,2073.42666666667,93.46
"10194","33004","2015",30,30,0,141961.666666667,1697.63333333333,86.7666666666667
"10195","33005","2015",243,190,53,278263.806584362,3496.15226337449,82.0617283950617
"10196","33006","2015",16,16,0,120693.75,1167.6875,106.375
"10197","33007","2015",8,8,0,233275,2656.875,88.625
"10198","33008","2015",6,6,0,170016.666666667,1632.33333333333,110.166666666667
"10199","33009","2015",448,128,320,329214.770089286,4996.07366071429,65.0267857142857
"10200","33010","2015",2,2,0,217500,2148,99
"10201","33011","2015",126,105,21,260698.285714286,3077.99206349206,87.3333333333333
"10202","33012","2015",33,33,0,221917.121212121,2093.81818181818,108.060606060606
"10203","33013","2015",91,79,12,233937.769230769,2528.06593406593,95.2747252747253
"10204","33014","2015",10,10,0,199145,1716.7,114.5
"10205","33015","2015",18,16,2,173712.777777778,1742.88888888889,100.333333333333
"10206","33016","2015",2,2,0,155906,1299,120
"10207","33017","2015",5,5,0,158400,1867.2,85.4
"10208","33018","2015",14,14,0,162405.714285714,1496.78571428571,114.714285714286
"10209","33019","2015",107,95,12,204729.355140187,2372.15887850467,89.0280373831776
"10210","33020","2015",1,1,0,34000,642,53
"10211","33021","2015",5,5,0,163820,953.6,171
"10212","33022","2015",31,30,1,188440.967741935,1930.87096774194,99.0322580645161
"10213","33023","2015",5,5,0,220640,2177.6,106.4
"10214","33025","2015",5,5,0,138016,1495.2,93.4
"10215","33026","2015",7,7,0,101902.285714286,1225.14285714286,86.2857142857143
"10216","33027","2015",3,3,0,161833.333333333,1082.66666666667,152
"10217","33028","2015",5,5,0,221300,1954.6,111.8
"10218","33029","2015",66,52,14,206870.909090909,2120.59090909091,98.2575757575758
"10219","33030","2015",20,20,0,132215,1387.15,99.2
"10220","33032","2015",44,41,3,198132.022727273,2392.79545454545,85.3636363636364
"10221","33033","2015",10,9,1,212292.3,2273.2,89.9
"10222","33034","2015",2,2,0,143736.5,1146,125
"10223","33035","2015",8,8,0,112631.25,1205.375,98.5
"10224","33036","2015",37,34,3,144134.459459459,1410.18918918919,105.162162162162
"10225","33037","2015",19,18,1,266023.157894737,2376.15789473684,118.315789473684
"10226","33038","2015",9,9,0,163672.222222222,1267.11111111111,124.222222222222
"10227","33039","2015",430,225,205,192739.286046512,2683.9488372093,72.846511627907
"10228","33040","2015",9,9,0,138388.888888889,1272,114.222222222222
"10229","33042","2015",63,59,4,177492.603174603,1861.26984126984,97.8888888888889
"10230","33043","2015",1,1,0,68250,1066,64
"10231","33044","2015",1,1,0,153000,956,160
"10232","33045","2015",1,1,0,140000,1167,120
"10233","33046","2015",4,4,0,126075,1326.25,116.75
"10234","33047","2015",21,21,0,145497.619047619,1276.33333333333,122.904761904762
"10235","33049","2015",19,19,0,206903.052631579,2007.78947368421,113.210526315789
"10236","33050","2015",10,10,0,193280,1324.7,148.2
"10237","33051","2015",126,112,14,208291.03968254,2331.75396825397,93.0793650793651
"10238","33052","2015",7,7,0,194470,1932.71428571429,102.428571428571
"10239","33053","2015",1,1,0,330200,2201,150
"10240","33054","2015",2,2,0,175000,1425,123.5
"10241","33055","2015",7,7,0,129154.285714286,1498.71428571429,80.7142857142857
"10242","33056","2015",135,76,59,209592.525925926,2510.66666666667,84.637037037037
"10243","33057","2015",10,10,0,155844.5,1348,122.8
"10244","33058","2015",60,50,10,107945.283333333,1121.63333333333,99.6333333333333
"10245","33059","2015",1,1,0,128000,1455,88
"10246","33060","2015",6,6,0,129691.666666667,1401.5,110.166666666667
"10247","33061","2015",10,10,0,244033,2081.3,113.5
"10248","33062","2015",6,6,0,129598.833333333,1309.33333333333,100.333333333333
"10249","33063","2015",4683,1183,3500,231662.304505659,3356.98505231689,69.7401238522315
"10250","33065","2015",18,17,1,387236.111111111,2848.05555555556,139.611111111111
"10251","33066","2015",1,1,0,45500,517,88
"10252","33067","2015",31,31,0,139748.129032258,1327.70967741935,103.709677419355
"10253","33069","2015",428,202,226,252763.261682243,2934.34345794393,84.2827102803738
"10254","33070","2015",7,7,0,237577.428571429,1999,120.142857142857
"10255","33071","2015",12,12,0,174029.166666667,1638.66666666667,111.666666666667
"10256","33073","2015",9,9,0,89905.5555555556,1193.33333333333,84.5555555555556
"10257","33075","2015",213,102,111,238862.971830986,2703.06103286385,86.9014084507042
"10258","33076","2015",5,5,0,134200,1371.6,97.8
"10259","33077","2015",14,14,0,203100.357142857,1935.21428571429,109.785714285714
"10260","33078","2015",2,2,0,340000,1518.5,203
"10261","33079","2015",4,4,0,235245,2163.25,111
"10262","33080","2015",62,48,14,188933.080645161,2223.06451612903,88
"10263","33081","2015",20,15,5,112211.35,1314.6,90.35
"10264","33082","2015",13,13,0,170919.615384615,1568.38461538462,110.461538461538
"10265","33083","2015",7,7,0,143560,1693.71428571429,87.1428571428571
"10266","33084","2015",14,13,1,221390.714285714,2045.71428571429,115.714285714286
"10267","33085","2015",29,29,0,330565.517241379,2511.8275862069,137.862068965517
"10268","33086","2015",2,2,0,215000,1566,111
"10269","33087","2015",3,3,0,233653.333333333,837.666666666667,213.333333333333
"10270","33088","2015",5,5,0,138100,1460.6,95.4
"10271","33089","2015",5,5,0,133370,1723.4,93.6
"10272","33090","2015",51,47,4,239648.764705882,2460.72549019608,97.8823529411765
"10273","33093","2015",6,6,0,154172.333333333,1545.16666666667,104.5
"10274","33094","2015",1,1,0,104500,1659,63
"10275","33095","2015",15,15,0,95460,1001.26666666667,95.2666666666667
"10276","33096","2015",102,77,25,187865.725490196,2478.52941176471,88.2647058823529
"10277","33097","2015",68,53,15,162139.514705882,2499.01470588235,72.1617647058823
"10278","33098","2015",4,4,0,129125,1435,91.5
"10279","33099","2015",23,19,4,313981.391304348,2624.13043478261,117.304347826087
"10280","33100","2015",15,14,1,231107.666666667,2337.46666666667,102.533333333333
"10281","33101","2015",13,13,0,106115.384615385,1000.69230769231,106.615384615385
"10282","33102","2015",2,2,0,108000,1073,101
"10283","33104","2015",49,45,4,178114.795918367,1964.85714285714,91.9183673469388
"10284","33105","2015",1,1,0,65000,500,130
"10285","33106","2015",16,16,0,176966.875,1535.5,117.25
"10286","33108","2015",29,28,1,94358.6206896552,1002.89655172414,103.344827586207
"10287","33109","2015",29,29,0,176905.862068966,1946.41379310345,91.3793103448276
"10288","33111","2015",12,12,0,169412.5,1533.83333333333,110.25
"10289","33112","2015",3,3,0,160666.666666667,1664,103.333333333333
"10290","33113","2015",3,3,0,93666.6666666667,921.333333333333,111
"10291","33114","2015",20,18,2,128392.95,1391.75,99.45
"10292","33115","2015",6,6,0,177333.333333333,1299.5,140.333333333333
"10293","33116","2015",4,4,0,166875,1756.75,96.75
"10294","33118","2015",20,20,0,266710.5,2550.4,112.15
"10295","33119","2015",264,129,135,161158.196969697,2198.92803030303,74.2992424242424
"10296","33120","2015",14,13,1,171653.571428571,1913.85714285714,94.7142857142857
"10297","33121","2015",1,1,0,299000,1834,163
"10298","33122","2015",133,124,9,287261.142857143,2809.45112781955,105.285714285714
"10299","33123","2015",25,25,0,160106,1433.52,116.8
"10300","33124","2015",8,8,0,102784.25,1155.75,89.625
"10301","33125","2015",26,26,0,136620.230769231,1365.03846153846,101.807692307692
"10302","33126","2015",8,8,0,161235,1533.625,110.5
"10303","33127","2015",1,1,0,108000,915,118
"10304","33128","2015",7,7,0,153168.571428571,1372.57142857143,121.857142857143
"10305","33129","2015",1,1,0,70000,972,72
"10306","33130","2015",14,14,0,193403.571428571,1658.85714285714,119.5
"10307","33132","2015",5,5,0,152200,1622.2,94.8
"10308","33133","2015",1,1,0,330000,2640,125
"10309","33134","2015",3,3,0,134333.333333333,1212.33333333333,103.666666666667
"10310","33135","2015",1,1,0,41000,506,81
"10311","33136","2015",2,2,0,307680,2451,117
"10312","33137","2015",4,4,0,122750,1384.25,84.75
"10313","33138","2015",87,85,2,137320.08045977,1484.93103448276,93.9310344827586
"10314","33140","2015",58,51,7,178986.689655172,1954.81034482759,92.9655172413793
"10315","33141","2015",8,8,0,192875,1957.125,100.875
"10316","33142","2015",11,11,0,152276.818181818,1564.54545454545,98.8181818181818
"10317","33143","2015",24,21,3,156495.333333333,1744.375,91.9583333333333
"10318","33144","2015",7,7,0,166828.571428571,1745.28571428571,97.5714285714286
"10319","33145","2015",13,13,0,204040.461538462,1729.76923076923,122.384615384615
"10320","33146","2015",24,24,0,141762.958333333,1453.33333333333,97.125
"10321","33147","2015",5,5,0,162656,1437.8,122.4
"10322","33148","2015",1,1,0,152000,1299,117
"10323","33150","2015",1,1,0,246745,2544,97
"10324","33151","2015",3,3,0,63333.3333333333,943.333333333333,75
"10325","33152","2015",2,2,0,447025,3156,140.5
"10326","33153","2015",1,1,0,198800,2723,73
"10327","33154","2015",18,16,2,88851.1111111111,1136.22222222222,86.6111111111111
"10328","33155","2015",4,4,0,122462.5,1344.75,90.25
"10329","33156","2015",4,4,0,199050,1089,178.25
"10330","33157","2015",3,3,0,206366.666666667,1736,115.666666666667
"10331","33159","2015",12,12,0,101296.666666667,1049.75,97.8333333333333
"10332","33160","2015",4,4,0,128625,1183.75,104.75
"10333","33161","2015",11,11,0,104787.272727273,1266.90909090909,96.6363636363636
"10334","33162","2015",241,161,80,219003.941908714,2598.75518672199,85.0290456431535
"10335","33163","2015",4,4,0,196475,1814,131.75
"10336","33164","2015",13,13,0,155538.461538462,1704,92.0769230769231
"10337","33165","2015",38,29,9,197810.263157895,2192.42105263158,93.4736842105263
"10338","33166","2015",5,5,0,154477,1247.8,123.6
"10339","33167","2015",147,93,54,174469.020408163,2272.89795918367,79.3197278911565
"10340","33168","2015",5,5,0,230900,1630.4,135
"10341","33170","2015",6,6,0,101750,974.666666666667,103
"10342","33171","2015",2,2,0,147975,1116,133
"10343","33172","2015",3,3,0,1e+05,1132,82.3333333333333
"10344","33173","2015",2,2,0,120000,1121,115
"10345","33174","2015",3,3,0,364900,1808.33333333333,191.333333333333
"10346","33175","2015",5,5,0,123124,1805.2,75.2
"10347","33177","2015",31,31,0,156498.483870968,1493.96774193548,106.322580645161
"10348","33178","2015",5,5,0,126080,1114.2,123
"10349","33179","2015",29,28,1,160729.517241379,1489.72413793103,111.655172413793
"10350","33181","2015",2,2,0,130250,1145.5,120
"10351","33182","2015",11,11,0,103022.727272727,938.909090909091,109.818181818182
"10352","33183","2015",17,17,0,157639.411764706,1714.23529411765,92.4117647058823
"10353","33184","2015",4,4,0,100625,1375,75.75
"10354","33185","2015",12,10,2,188912.5,1824.5,100
"10355","33186","2015",10,10,0,103730,1130.3,93.8
"10356","33187","2015",15,15,0,105436.666666667,1173.73333333333,98.5333333333333
"10357","33188","2015",2,2,0,132500,957,145
"10358","33189","2015",2,2,0,221700,1572.5,138.5
"10359","33190","2015",2,2,0,75500,1108.5,67.5
"10360","33191","2015",5,5,0,124400,1181.8,122.4
"10361","33192","2015",296,113,183,203449,2674.11148648649,77.4391891891892
"10362","33193","2015",16,16,0,156513.75,2048.625,90.8125
"10363","33194","2015",5,5,0,186418,1536,128.2
"10364","33195","2015",14,11,3,122301.142857143,1489.42857142857,89.3571428571429
"10365","33196","2015",3,3,0,324450,3474.33333333333,110.666666666667
"10366","33197","2015",7,7,0,169142.857142857,1583.14285714286,106.285714285714
"10367","33198","2015",15,15,0,124638.333333333,1238.26666666667,101.466666666667
"10368","33199","2015",351,292,59,239852.193732194,2859.69800569801,85.3361823361823
"10369","33200","2015",93,67,26,272641.462365591,2894.52688172043,93.8172043010753
"10370","33201","2015",10,10,0,160415,1671.9,101.7
"10371","33202","2015",16,15,1,160361.4375,1710.25,94.4375
"10372","33203","2015",110,90,20,145894.136363636,2153.06363636364,70.5727272727273
"10373","33204","2015",4,4,0,159913.25,1622,93.25
"10374","33205","2015",7,7,0,228285.714285714,3323.42857142857,102.142857142857
"10375","33206","2015",7,7,0,137922.857142857,1301,107.857142857143
"10376","33207","2015",73,73,0,204882.780821918,2054.72602739726,105.643835616438
"10377","33208","2015",18,18,0,103025.277777778,1243.05555555556,90.5
"10378","33209","2015",2,2,0,1e+05,1006,100.5
"10379","33210","2015",1,1,0,157698,1383,114
"10380","33211","2015",8,8,0,177284.5,1953.5,92.875
"10381","33213","2015",58,44,14,261703.327586207,2476.36206896552,108.568965517241
"10382","33214","2015",202,154,48,193085.014851485,3255.73267326733,63.2574257425743
"10383","33216","2015",1,1,0,270000,1459,185
"10384","33218","2015",16,15,1,117063.0625,1017.375,120.625
"10385","33219","2015",22,21,1,164463.590909091,1504.90909090909,107.909090909091
"10386","33220","2015",9,9,0,142984.444444444,1504.33333333333,93.4444444444444
"10387","33221","2015",4,4,0,95000,1248.75,78.5
"10388","33222","2015",5,5,0,236400,1703.4,130.8
"10389","33223","2015",5,5,0,112900,1019,114.8
"10390","33225","2015",24,24,0,163450.833333333,1486.875,117.625
"10391","33226","2015",22,20,2,150654.545454545,1672.45454545455,86.8636363636364
"10392","33227","2015",81,62,19,138645.827160494,1498.28395061728,97.358024691358
"10393","33228","2015",4,4,0,220300,2207.5,101.25
"10394","33229","2015",124,95,29,258395.032258065,3341.87903225806,81.3306451612903
"10395","33230","2015",3,3,0,157166.666666667,1724,98.3333333333333
"10396","33231","2015",6,6,0,239108.333333333,1732,133.666666666667
"10397","33233","2015",23,23,0,163185.130434783,1599.08695652174,112.739130434783
"10398","33234","2015",27,24,3,257569.518518519,2572.2962962963,102.481481481481
"10399","33235","2015",4,4,0,151000,1461.5,105.25
"10400","33236","2015",97,85,12,347047.773195876,3907.69072164948,94.4226804123711
"10401","33237","2015",10,10,0,193742.8,1644.3,113.7
"10402","33238","2015",74,70,4,287523.310810811,2957.67567567568,100.135135135135
"10403","33239","2015",1,1,0,152562,1010,151
"10404","33240","2015",55,48,7,116396.181818182,1324.61818181818,90
"10405","33241","2015",7,7,0,141780.714285714,1592.14285714286,89
"10406","33242","2015",4,4,0,126750,1231.25,104.75
"10407","33243","2015",332,235,97,137923.403614458,1774.93373493976,79.4487951807229
"10408","33244","2015",8,8,0,202950,1494.5,149.125
"10409","33245","2015",5,5,0,210119.8,1915.2,119.2
"10410","33246","2015",2,2,0,230000,1723.5,133
"10411","33248","2015",30,30,0,180541.9,1912.3,102.333333333333
"10412","33249","2015",193,82,111,161559.492227979,2212.77720207254,77.720207253886
"10413","33250","2015",2,2,0,171000,1406.5,129.5
"10414","33251","2015",6,6,0,157363.333333333,1560.33333333333,103.5
"10415","33252","2015",6,6,0,220500,1994.83333333333,118
"10416","33253","2015",5,5,0,169000,1912.2,86.6
"10417","33254","2015",4,4,0,241575,1371.25,174.25
"10418","33255","2015",1,1,0,285000,1213,235
"10419","33256","2015",48,41,7,200448.75,2176.04166666667,93.2916666666667
"10420","33257","2015",3,3,0,108666.666666667,1389.66666666667,79.6666666666667
"10421","33258","2015",3,3,0,167841.666666667,1543.66666666667,104.333333333333
"10422","33259","2015",10,10,0,156575,1496.7,107.8
"10423","33260","2015",10,10,0,202750,1923.6,106.8
"10424","33261","2015",10,10,0,134000,1469.3,91.8
"10425","33262","2015",56,50,6,171533.946428571,2002.21428571429,92.1428571428571
"10426","33263","2015",3,3,0,187333.333333333,1463.66666666667,120.333333333333
"10427","33264","2015",9,9,0,111429.555555556,1065.88888888889,109
"10428","33266","2015",7,7,0,155714.285714286,1362.57142857143,113.857142857143
"10429","33268","2015",33,33,0,210618,1856.9696969697,116.424242424242
"10430","33269","2015",5,5,0,148800,1130.4,127.4
"10431","33270","2015",2,2,0,109000,1401.5,76.5
"10432","33271","2015",3,3,0,177333.333333333,1147,144
"10433","33272","2015",15,15,0,172440,1412.53333333333,125.4
"10434","33273","2015",56,48,8,288149.857142857,2794.32142857143,106.267857142857
"10435","33274","2015",19,18,1,235532.105263158,2241.63157894737,105.473684210526
"10436","33275","2015",1,1,0,82000,550,149
"10437","33276","2015",1,1,0,85000,1000,85
"10438","33277","2015",6,6,0,229258.333333333,1395.5,161.833333333333
"10439","33278","2015",2,2,0,271981,1776.5,140
"10440","33279","2015",7,7,0,215500,1453.85714285714,153
"10441","33280","2015",7,7,0,123612.571428571,1211.85714285714,104.714285714286
"10442","33281","2015",1045,392,653,196968.390430622,2643.12727272727,74.7741626794258
"10443","33282","2015",3,3,0,208783.333333333,1461,145.333333333333
"10444","33283","2015",1,1,0,135000,1227,110
"10445","33284","2015",87,77,10,218275.91954023,2390.81609195402,93.3333333333333
"10446","33285","2015",3,3,0,150333.333333333,1244,115.666666666667
"10447","33287","2015",8,8,0,129187.5,1144.75,112.25
"10448","33288","2015",1,1,0,210000,1243,169
"10449","33289","2015",14,14,0,142257.142857143,1324.57142857143,112.928571428571
"10450","33290","2015",16,16,0,233948.4375,1730,136.5625
"10451","33291","2015",1,1,0,126000,1575,80
"10452","33293","2015",32,30,2,236233.4375,2078.21875,114.4375
"10453","33294","2015",6,6,0,99416.6666666667,745.166666666667,133.333333333333
"10454","33295","2015",1,1,0,230000,1769,130
"10455","33296","2015",12,12,0,171225,1420.66666666667,123.25
"10456","33297","2015",23,23,0,165618.695652174,1822.34782608696,93.7391304347826
"10457","33298","2015",8,8,0,244619.25,1809.875,138.125
"10458","33299","2015",2,2,0,156775,1299.5,138.5
"10459","33300","2015",16,16,0,149143.75,1578.125,103.625
"10460","33301","2015",1,1,0,92000,767,120
"10461","33302","2015",4,4,0,204250,1968.25,88
"10462","33303","2015",10,10,0,184747.3,1624.7,102.8
"10463","33304","2015",1,1,0,75000,1250,60
"10464","33305","2015",8,8,0,158508.75,1278.625,123.75
"10465","33306","2015",2,2,0,188700,1477,128
"10466","33307","2015",21,21,0,150614.285714286,1300.47619047619,121.190476190476
"10467","33308","2015",2,2,0,166500,1722.5,99.5
"10468","33309","2015",4,4,0,138750,1403.5,102
"10469","33310","2015",3,3,0,188810,1594,120.333333333333
"10470","33311","2015",12,9,3,120612.166666667,1661,73.4166666666667
"10471","33312","2015",90,76,14,241346.1,2603.57777777778,95.5333333333333
"10472","33314","2015",48,47,1,127074.270833333,1451.6875,90.1875
"10473","33315","2015",19,19,0,129265.789473684,1596.05263157895,92.7368421052632
"10474","33316","2015",3,3,0,190333.333333333,1352.33333333333,148.666666666667
"10475","33317","2015",9,9,0,160746.444444444,1220,132.444444444444
"10476","33318","2015",665,421,244,239020.562406015,2786.54736842105,85.5037593984962
"10477","33319","2015",8,8,0,209062.5,1872.75,121.875
"10478","33320","2015",2,2,0,110000,1126.5,95
"10479","33321","2015",16,16,0,189788.125,1850.9375,106.625
"10480","33322","2015",53,52,1,249228.679245283,2435.20754716981,106.849056603774
"10481","33323","2015",3,3,0,177266.666666667,1255.66666666667,141
"10482","33324","2015",38,37,1,115983.421052632,1121.89473684211,108.921052631579
"10483","33325","2015",15,15,0,134974,1122.66666666667,109.4
"10484","33327","2015",23,23,0,142664.130434783,1463.52173913043,104.695652173913
"10485","33328","2015",3,3,0,173166.666666667,1826.33333333333,103.333333333333
"10486","33329","2015",2,2,0,183500,2007.5,103.5
"10487","33330","2015",21,18,3,227453.19047619,2156.19047619048,111.047619047619
"10488","33331","2015",4,4,0,201500,1428.75,132.75
"10489","33332","2015",6,6,0,109016.666666667,1482.5,88
"10490","33333","2015",25,25,0,215008,2343.92,101.2
"10491","33334","2015",16,15,1,181150,1873.75,105.125
"10492","33335","2015",4,4,0,152010,1509,96.25
"10493","33336","2015",15,15,0,160750,1232.26666666667,139.333333333333
"10494","33337","2015",23,23,0,145330.652173913,1321.17391304348,119.260869565217
"10495","33339","2015",19,19,0,146886.842105263,1524.26315789474,98.1578947368421
"10496","33341","2015",18,18,0,158955.555555556,1350.33333333333,122.166666666667
"10497","33342","2015",10,10,0,163126.5,1588.9,104.5
"10498","33343","2015",7,7,0,155428.571428571,1480.14285714286,132.714285714286
"10499","33344","2015",7,7,0,139428.571428571,1527.71428571429,100
"10500","33345","2015",5,5,0,97200,856,112.4
"10501","33346","2015",3,3,0,227716.666666667,1638.66666666667,132.333333333333
"10502","33347","2015",3,3,0,64333.3333333333,852.666666666667,77
"10503","33348","2015",11,11,0,123000,1426.54545454545,96.9090909090909
"10504","33349","2015",24,24,0,266975.416666667,2211.04166666667,119.833333333333
"10505","33350","2015",17,14,3,148676.705882353,1992.70588235294,103.588235294118
"10506","33351","2015",13,12,1,121923.076923077,1270.92307692308,102
"10507","33352","2015",43,41,2,87589.8372093023,1025.60465116279,90.046511627907
"10508","33353","2015",3,3,0,237333.333333333,1587.66666666667,128.666666666667
"10509","33354","2015",3,3,0,167166.666666667,1214,155.333333333333
"10510","33355","2015",13,13,0,160311.538461538,1774.76923076923,89.5384615384615
"10511","33356","2015",2,2,0,181200,1707.5,107
"10512","33357","2015",14,14,0,189464.285714286,1580.64285714286,119.785714285714
"10513","33358","2015",6,6,0,201351.666666667,1413,144
"10514","33359","2015",3,3,0,95333.3333333333,993.666666666667,99
"10515","33360","2015",2,2,0,112650,1271,88
"10516","33361","2015",5,5,0,199345,2039.6,114.4
"10517","33362","2015",11,11,0,122076.727272727,1434.18181818182,90.5454545454545
"10518","33363","2015",31,29,2,216582.903225806,2118.74193548387,102.741935483871
"10519","33364","2015",2,2,0,234565,1932,122.5
"10520","33365","2015",1,1,0,80000,777,103
"10521","33366","2015",116,102,14,175797.051724138,1916.70689655172,97.2672413793103
"10522","33367","2015",4,4,0,214650,1348.75,146.5
"10523","33369","2015",9,9,0,152223.555555556,1700.33333333333,98.6666666666667
"10524","33370","2015",7,7,0,104421.428571429,1180.14285714286,88
"10525","33372","2015",1,1,0,420000,1448,290
"10526","33373","2015",6,6,0,152645,1171.16666666667,119.166666666667
"10527","33374","2015",9,9,0,110600,1087.22222222222,105.555555555556
"10528","33375","2015",4,4,0,205260,1867.25,111.75
"10529","33376","2015",56,54,2,351652.142857143,2829.5,125.696428571429
"10530","33377","2015",1,1,0,97211,1389,70
"10531","33378","2015",11,11,0,107800,1151.27272727273,102
"10532","33379","2015",1,1,0,80000,889,90
"10533","33380","2015",12,12,0,121375,1065.08333333333,115.5
"10534","33381","2015",23,22,1,252845.043478261,2341.17391304348,113.130434782609
"10535","33382","2015",10,10,0,102140,1064.8,106.7
"10536","33383","2015",4,4,0,119700,1359.25,93
"10537","33384","2015",2,2,0,111500,1052,100.5
"10538","33385","2015",7,7,0,152075.714285714,1218.14285714286,130.857142857143
"10539","33386","2015",1,1,0,158000,1317,120
"10540","33387","2015",14,14,0,145717.857142857,1308.21428571429,108.428571428571
"10541","33388","2015",5,5,0,200886,1998.8,111.8
"10542","33389","2015",21,21,0,102007.142857143,1123.42857142857,92.0952380952381
"10543","33390","2015",4,4,0,117500,1111.5,105.25
"10544","33391","2015",4,4,0,266619,1668.25,136.75
"10545","33392","2015",4,4,0,198212.5,1122,151.75
"10546","33393","2015",55,54,1,151470.381818182,1537.49090909091,100.527272727273
"10547","33394","2015",15,14,1,204662.2,2088.66666666667,104.533333333333
"10548","33395","2015",17,17,0,79446.4705882353,1059.64705882353,85.2941176470588
"10549","33397","2015",36,35,1,226711.5,2278.69444444444,107.833333333333
"10550","33399","2015",3,3,0,141826.666666667,1061,144.333333333333
"10551","33400","2015",2,2,0,443000,1555,254.5
"10552","33402","2015",28,16,12,95984.1071428571,978.535714285714,106.035714285714
"10553","33405","2015",4,4,0,113132,1050.5,113.25
"10554","33406","2015",3,3,0,182486,1599.66666666667,111
"10555","33407","2015",7,7,0,133891.428571429,1380.28571428571,95
"10556","33408","2015",1,1,0,212000,1767,120
"10557","33411","2015",1,1,0,219000,3650,60
"10558","33412","2015",8,8,0,135946.875,1332,97.625
"10559","33413","2015",15,15,0,187878,1685.8,110.133333333333
"10560","33414","2015",2,2,0,248025,1550,160
"10561","33415","2015",11,8,3,170807.272727273,1867.27272727273,99
"10562","33416","2015",7,7,0,91571.4285714286,868.571428571429,108
"10563","33417","2015",30,30,0,237361.666666667,2124.33333333333,115.266666666667
"10564","33418","2015",1,1,0,131000,1456,90
"10565","33419","2015",1,1,0,90060,901,100
"10566","33421","2015",10,10,0,132828.2,1321.5,102
"10567","33422","2015",67,47,20,241499.970149254,2778.29850746269,89.6865671641791
"10568","33423","2015",3,3,0,96500,1355,74.3333333333333
"10569","33424","2015",40,39,1,161337.65,1568.1,106.85
"10570","33425","2015",13,13,0,175658.461538462,1667.23076923077,101.769230769231
"10571","33427","2015",2,2,0,177500,1330,135.5
"10572","33428","2015",1,1,0,150000,1500,100
"10573","33431","2015",3,3,0,169783.333333333,1943,90
"10574","33432","2015",1,1,0,150000,1765,85
"10575","33433","2015",87,78,9,199086.310344828,2078.26436781609,100.804597701149
"10576","33434","2015",17,16,1,161999.411764706,1938.70588235294,88.7647058823529
"10577","33435","2015",15,13,2,157400,1535.53333333333,104.133333333333
"10578","33436","2015",14,14,0,221500,1952.85714285714,113.142857142857
"10579","33437","2015",16,16,0,110767.5,1403.625,87.8125
"10580","33438","2015",5,5,0,163230,1223,129.2
"10581","33439","2015",9,9,0,133088.888888889,1238.55555555556,108.222222222222
"10582","33440","2015",2,2,0,200250,1653.5,140.5
"10583","33441","2015",6,5,1,132379.333333333,1254.33333333333,107.333333333333
"10584","33442","2015",7,7,0,119428.571428571,1378.28571428571,92.1428571428571
"10585","33443","2015",3,3,0,83333.3333333333,1332,58
"10586","33445","2015",6,6,0,145000,1476.5,93.3333333333333
"10587","33446","2015",1,1,0,150000,993,151
"10588","33447","2015",31,31,0,82687.0967741935,1287.87096774194,74.5806451612903
"10589","33448","2015",30,30,0,237484.166666667,2460.86666666667,98.5666666666667
"10590","33449","2015",278,247,31,271875.956834532,2670.42446043165,104.625899280576
"10591","33450","2015",1,1,0,343000,2450,140
"10592","33451","2015",3,3,0,173666.666666667,1781,96.6666666666667
"10593","33452","2015",6,6,0,184166.666666667,1843.16666666667,103.5
"10594","33453","2015",1,1,0,60000,833,72
"10595","33454","2015",17,17,0,226679.411764706,1926.05882352941,117.647058823529
"10596","33456","2015",4,4,0,119250,959.75,123.75
"10597","33457","2015",8,8,0,178931.25,1700,105.25
"10598","33458","2015",11,11,0,139497.272727273,1360.36363636364,100.272727272727
"10599","33459","2015",1,1,0,75000,938,80
"10600","33460","2015",6,6,0,142416.666666667,1327,103.333333333333
"10601","33461","2015",1,0,1,50000,476,105
"10602","33462","2015",6,6,0,144933.333333333,1443.5,106.333333333333
"10603","33463","2015",19,18,1,134975.789473684,1356.94736842105,101.157894736842
"10604","33464","2015",1,1,0,23000,1095,21
"10605","33465","2015",7,7,0,160614.285714286,1387.71428571429,124.857142857143
"10606","33466","2015",15,15,0,153240,1648.46666666667,92.8
"10607","33467","2015",3,3,0,93500.3333333333,932.666666666667,92.6666666666667
"10608","33468","2015",2,2,0,136000,1320.5,103
"10609","33470","2015",11,11,0,240181.363636364,2064.54545454545,113.363636363636
"10610","33471","2015",7,7,0,130228.571428571,1300.28571428571,103.857142857143
"10611","33472","2015",2,2,0,74000,1533,54.5
"10612","33473","2015",19,19,0,121931.578947368,1283.84210526316,99.6842105263158
"10613","33474","2015",32,32,0,216385.625,2133.53125,102.15625
"10614","33475","2015",1,1,0,85000,944,90
"10615","33476","2015",8,8,0,95500,913.375,106.25
"10616","33477","2015",7,7,0,105611.428571429,1318.14285714286,79.4285714285714
"10617","33478","2015",30,30,0,117086.666666667,1204.66666666667,103.566666666667
"10618","33479","2015",7,7,0,220369.571428571,1842.28571428571,130
"10619","33480","2015",7,7,0,181107.142857143,1760.71428571429,102.857142857143
"10620","33481","2015",1,1,0,219000,1622,135
"10621","33482","2015",4,4,0,111795.75,1244.5,91.5
"10622","33483","2015",47,46,1,263665.617021277,2168.87234042553,120.617021276596
"10623","33484","2015",17,17,0,150308.470588235,1375.17647058824,114.823529411765
"10624","33485","2015",20,18,2,170948,1763.45,108.75
"10625","33486","2015",3,3,0,142914.333333333,1175.33333333333,120
"10626","33487","2015",12,12,0,175884.166666667,1547.5,117.833333333333
"10627","33488","2015",1,1,0,240500,2128,113
"10628","33489","2015",3,3,0,156016.666666667,1005.66666666667,156
"10629","33490","2015",18,18,0,112757.277777778,1490.38888888889,77.5555555555556
"10630","33491","2015",2,2,0,193000,2200.5,83.5
"10631","33492","2015",25,25,0,134238.8,1290.48,108
"10632","33493","2015",3,3,0,129000,1073.66666666667,120.333333333333
"10633","33494","2015",10,10,0,272880,2387,111.2
"10634","33496","2015",22,22,0,225294.818181818,2185.86363636364,105.863636363636
"10635","33498","2015",92,87,5,210480.141304348,1952.3152173913,110.358695652174
"10636","33499","2015",1,1,0,85000,1545,55
"10637","33500","2015",3,3,0,155536.666666667,1395,112
"10638","33501","2015",21,21,0,236853.047619048,2122.90476190476,116.761904761905
"10639","33502","2015",2,2,0,209200,1456,143.5
"10640","33503","2015",8,8,0,215006.25,2110.125,107.75
"10641","33504","2015",8,8,0,163438.75,1757.125,107.5
"10642","33505","2015",9,9,0,185245.888888889,1875.55555555556,101.777777777778
"10643","33506","2015",15,15,0,154855,1598.53333333333,110.866666666667
"10644","33507","2015",2,2,0,185900,1519.5,122.5
"10645","33508","2015",3,3,0,175333.333333333,1413.66666666667,133.333333333333
"10646","33509","2015",4,4,0,192625,1668.75,113.75
"10647","33511","2015",3,3,0,117933.333333333,1221.66666666667,94.6666666666667
"10648","33512","2015",1,1,0,550000,1746,315
"10649","33513","2015",1,1,0,120000,1579,76
"10650","33514","2015",87,65,22,170987.459770115,2522.33333333333,71.9770114942529
"10651","33515","2015",4,4,0,209425,1260.75,148
"10652","33516","2015",4,4,0,92125,972,95.25
"10653","33517","2015",15,15,0,134223.333333333,1558.4,84.4
"10654","33518","2015",12,12,0,351059.166666667,2455.16666666667,136
"10655","33519","2015",115,91,24,259262.530434783,2556.41739130435,104.660869565217
"10656","33520","2015",5,5,0,216300,1395.4,158.2
"10657","33521","2015",8,8,0,102478.75,1313,78.375
"10658","33522","2015",658,285,373,196901.582066869,2911.82066869301,69.0607902735562
"10659","33523","2015",9,9,0,162688.888888889,1693.88888888889,97.7777777777778
"10660","33524","2015",2,2,0,171975,1759.5,98.5
"10661","33525","2015",14,14,0,144875,1339,109.785714285714
"10662","33526","2015",3,3,0,194266.666666667,1492.33333333333,133
"10663","33527","2015",101,87,14,215412.198019802,2535.29702970297,85.950495049505
"10664","33528","2015",2,2,0,213500,2103,101.5
"10665","33529","2015",448,336,112,335505.301339286,3675.58482142857,87.0915178571429
"10666","33530","2015",11,11,0,176790.909090909,1365.09090909091,130.454545454545
"10667","33531","2015",3,3,0,197232.333333333,1853.33333333333,106.333333333333
"10668","33532","2015",5,5,0,189980,1458.6,135.6
"10669","33533","2015",16,16,0,165606.25,1885.25,88.75
"10670","33534","2015",8,8,0,182181.25,1856.75,94.75
"10671","33535","2015",35,35,0,248646.742857143,2623.94285714286,98.3142857142857
"10672","33536","2015",4,4,0,170462.5,2555.75,94.5
"10673","33537","2015",3,3,0,123086.666666667,1167.33333333333,122.333333333333
"10674","33538","2015",2,2,0,53000,659.5,77
"10675","33539","2015",52,42,10,179895.384615385,1961.15384615385,99.6346153846154
"10676","33540","2015",45,42,3,183677.422222222,2220.15555555556,92.9555555555555
"10677","33541","2015",13,13,0,155336,1817.07692307692,86.6153846153846
"10678","33542","2015",5,5,0,181040,1668.4,125
"10679","33543","2015",17,17,0,115270.588235294,1130.94117647059,109.941176470588
"10680","33544","2015",46,36,10,117464.347826087,1691.17391304348,71.8695652173913
"10681","33545","2015",11,11,0,142547.272727273,1171.81818181818,117.272727272727
"10682","33546","2015",2,2,0,197500,968,198
"10683","33547","2015",14,14,0,124157.142857143,1285.21428571429,100.928571428571
"10684","33548","2015",12,11,1,165458.333333333,1359.41666666667,128.5
"10685","33549","2015",1,1,0,162000,1800,90
"10686","33550","2015",345,254,91,213714.489855072,2576.68695652174,85.0376811594203
"10687","33551","2015",5,5,0,65230,1155.6,70.8
"10688","33552","2015",9,9,0,178435.777777778,1491.55555555556,112
"10689","33553","2015",12,12,0,225841.666666667,1873.08333333333,119.666666666667
"10690","33554","2015",30,29,1,236819.166666667,2403.43333333333,99.9
"10691","33555","2015",43,40,3,222941.76744186,2286.25581395349,98.9767441860465
"10692","34001","2015",27,27,0,160248.148148148,1814.18518518519,89.6296296296296
"10693","34002","2015",14,12,2,123195,1547.35714285714,72.5
"10694","34003","2015",1397,313,1084,120574.094488189,3104.06156048676,42.6048675733715
"10695","34004","2015",2,2,0,50365,816,64
"10696","34005","2015",2,2,0,319225,2426.5,119.5
"10697","34006","2015",2,2,0,227500,1569,145
"10698","34007","2015",10,10,0,137451,1454.7,93.4
"10699","34008","2015",8,8,0,103375,1270,88.875
"10700","34009","2015",21,21,0,179080.952380952,1724.85714285714,101.428571428571
"10701","34010","2015",21,19,2,169275.952380952,2255.2380952381,77.3809523809524
"10702","34011","2015",1,1,0,170000,1518,112
"10703","34012","2015",5,5,0,251014,2629.6,101.4
"10704","34013","2015",17,16,1,143970.588235294,1502.11764705882,99.8235294117647
"10705","34014","2015",14,14,0,454743.357142857,3682.5,132
"10706","34015","2015",2,2,0,242500,1902,131.5
"10707","34016","2015",6,6,0,243300,2359.66666666667,101
"10708","34017","2015",3,3,0,199500,1698.66666666667,113.666666666667
"10709","34018","2015",13,12,1,177730.769230769,1729.76923076923,107.538461538462
"10710","34019","2015",6,6,0,61916.6666666667,998,64
"10711","34020","2015",3,3,0,90833.3333333333,1169.66666666667,102.666666666667
"10712","34021","2015",3,3,0,107500,1065,93.3333333333333
"10713","34022","2015",76,59,17,286194.671052632,2839.13157894737,103.947368421053
"10714","34023","2015",212,51,161,144347.995283019,3510.50471698113,47.4245283018868
"10715","34024","2015",27,24,3,260038.814814815,2935.22222222222,90.7777777777778
"10716","34025","2015",22,22,0,163455,1720.18181818182,91.4090909090909
"10717","34026","2015",2,2,0,79000,1189.5,68.5
"10718","34027","2015",11,8,3,226366.818181818,2389.72727272727,99.1818181818182
"10719","34028","2015",59,39,20,87557.5254237288,1200.28813559322,74.9661016949153
"10720","34029","2015",5,5,0,222990,2372.2,94.6
"10721","34030","2015",1,1,0,79150,1466,54
"10722","34031","2015",40,36,4,176385.425,2085.95,84.325
"10723","34032","2015",919,404,515,118803.261153428,1541.43743199129,77.9989118607182
"10724","34033","2015",27,24,3,241791.740740741,2513.66666666667,103.62962962963
"10725","34035","2015",11,11,0,290115.090909091,3103.72727272727,96.5454545454545
"10726","34036","2015",6,6,0,199816.666666667,1727.83333333333,116.833333333333
"10727","34037","2015",29,17,12,167193.793103448,2260.34482758621,75.7931034482759
"10728","34038","2015",24,22,2,107533.333333333,1243.08333333333,91.5416666666667
"10729","34039","2015",23,15,8,259351.086956522,2797.95652173913,95.6521739130435
"10730","34040","2015",1,1,0,150000,1667,90
"10731","34041","2015",12,12,0,243201.416666667,2206,108.166666666667
"10732","34042","2015",1,1,0,47000,746,63
"10733","34043","2015",4,4,0,224887,1789.5,131
"10734","34044","2015",3,3,0,81241.6666666667,1909.66666666667,48.3333333333333
"10735","34045","2015",3,3,0,118750,1718.33333333333,63.6666666666667
"10736","34046","2015",1,1,0,18500,617,30
"10737","34047","2015",14,14,0,183697,1830.71428571429,96.9285714285714
"10738","34048","2015",1,1,0,415000,1751,237
"10739","34049","2015",5,4,1,60800,747.8,82.8
"10740","34050","2015",21,18,3,230151.380952381,2409.61904761905,96.6190476190476
"10741","34051","2015",37,33,4,185073.513513514,1851.35135135135,97.5675675675676
"10742","34052","2015",22,20,2,144605.727272727,1749.31818181818,87.0454545454545
"10743","34053","2015",1,1,0,61500,1708,36
"10744","34056","2015",17,16,1,141501.294117647,1650.29411764706,85.9411764705882
"10745","34057","2015",186,102,84,298535.193548387,3282.87634408602,89.4139784946236
"10746","34058","2015",65,60,5,299796.738461538,2961.32307692308,104.123076923077
"10747","34059","2015",1,1,0,185000,1321,140
"10748","34060","2015",2,2,0,122900,1530,82.5
"10749","34061","2015",6,6,0,243000,1634,148
"10750","34062","2015",2,1,1,36000,680.5,53
"10751","34063","2015",36,35,1,162585.138888889,1857.61111111111,88.0833333333333
"10752","34064","2015",6,5,1,74500,1074.33333333333,73.8333333333333
"10753","34065","2015",4,4,0,125000,1396.75,99.25
"10754","34066","2015",2,2,0,1070000,6932.5,207
"10755","34067","2015",15,13,2,185611.2,2033.6,93
"10756","34068","2015",2,2,0,97250,1188.5,87.5
"10757","34069","2015",48,44,4,146252.083333333,1475.39583333333,99.2708333333333
"10758","34070","2015",13,13,0,139729.846153846,1446.46153846154,93
"10759","34071","2015",4,3,1,99375,1248.25,79
"10760","34072","2015",1,1,0,215000,1955,110
"10761","34073","2015",28,28,0,189743.642857143,2075.60714285714,94.3928571428571
"10762","34074","2015",19,19,0,141301.578947368,1565.31578947368,91.1052631578947
"10763","34075","2015",7,7,0,183860,1697.85714285714,110.714285714286
"10764","34076","2015",19,16,3,190317.368421053,1976.05263157895,95.2631578947368
"10765","34077","2015",56,52,4,294043.625,2751.875,103.428571428571
"10766","34078","2015",7,7,0,203787.857142857,2672.57142857143,83.1428571428571
"10767","34079","2015",86,54,32,143438.61627907,1928.06976744186,73
"10768","34080","2015",7,7,0,147728.571428571,1430.85714285714,116.285714285714
"10769","34081","2015",30,27,3,190187.8,1789,106.066666666667
"10770","34082","2015",5,5,0,294160,2768.2,110
"10771","34083","2015",2,2,0,71000,780,102
"10772","34084","2015",16,16,0,158318.75,1760.4375,89
"10773","34085","2015",5,5,0,200100,1953.8,100.2
"10774","34086","2015",9,9,0,84573.3333333333,906.888888888889,96.6666666666667
"10775","34088","2015",55,47,8,217533.272727273,2336.85454545455,97.2363636363636
"10776","34089","2015",10,10,0,151370,1774.2,88.6
"10777","34090","2015",83,64,19,293490.614457831,3042.75903614458,99.710843373494
"10778","34091","2015",1,1,0,110000,1183,93
"10779","34092","2015",11,11,0,136667.727272727,1223.27272727273,112.545454545455
"10780","34093","2015",2,2,0,150000,1139,117.5
"10781","34094","2015",13,13,0,225046.153846154,2054.53846153846,110.384615384615
"10782","34095","2015",51,43,8,238052.156862745,2595.88235294118,93.7647058823529
"10783","34096","2015",9,9,0,168262.222222222,1722.33333333333,97.2222222222222
"10784","34097","2015",4,4,0,163200,1622.75,99.5
"10785","34098","2015",1,1,0,146000,2281,64
"10786","34101","2015",52,51,1,164087.596153846,1982.82692307692,81.6153846153846
"10787","34102","2015",3,3,0,383666.666666667,2555.66666666667,151.333333333333
"10788","34103","2015",12,12,0,174166.666666667,1818.16666666667,92.4166666666667
"10789","34104","2015",2,2,0,288025,2982.5,94
"10790","34105","2015",3,3,0,110166.666666667,1965,62.3333333333333
"10791","34106","2015",2,2,0,185000,1535,116
"10792","34107","2015",5,5,0,79600,1007.2,78.6
"10793","34108","2015",329,180,149,168830.306990881,2698.12765957447,66.5987841945289
"10794","34109","2015",8,8,0,129437.5,1445.75,77.375
"10795","34110","2015",5,5,0,191820,1665,120
"10796","34111","2015",34,14,20,99430.7058823529,1300.91176470588,75.2647058823529
"10797","34113","2015",72,60,12,209722.097222222,2409.11111111111,90.3611111111111
"10798","34114","2015",64,58,6,178630.890625,2034.140625,87.265625
"10799","34115","2015",1,1,0,94000,1343,70
"10800","34116","2015",109,38,71,182203.018348624,2634.04587155963,64.2110091743119
"10801","34117","2015",9,7,2,76750,681.444444444444,112.333333333333
"10802","34118","2015",4,4,0,341949.25,2718.5,125.5
"10803","34119","2015",16,15,1,91678.125,1133.5,82.4375
"10804","34120","2015",61,50,11,272904.540983607,2905.32786885246,94.9672131147541
"10805","34121","2015",2,2,0,69000,1150,60
"10806","34122","2015",1,1,0,384600,2360,163
"10807","34123","2015",108,75,33,256338.083333333,2870.96296296296,92.0462962962963
"10808","34124","2015",4,4,0,206750,2575,76.25
"10809","34126","2015",46,11,35,74994.5,1700.91304347826,45.304347826087
"10810","34127","2015",24,22,2,233006,2114.5,118.583333333333
"10811","34128","2015",8,7,1,172821.5,1935.25,84.5
"10812","34129","2015",216,95,121,262617.430555556,3315.47685185185,80.2222222222222
"10813","34130","2015",16,16,0,147965,1812.625,89.5
"10814","34131","2015",4,3,1,302600,2220,133.75
"10815","34132","2015",2,2,0,185000,2198,85.5
"10816","34133","2015",1,1,0,267000,1780,150
"10817","34134","2015",28,14,14,218861.428571429,2685,85.0357142857143
"10818","34135","2015",31,25,6,127953.548387097,1466.45161290323,92.7096774193548
"10819","34136","2015",19,17,2,148888.947368421,1496.15789473684,97.7368421052632
"10820","34138","2015",3,3,0,242333.333333333,2252.33333333333,108.666666666667
"10821","34139","2015",12,12,0,208324.25,2084.83333333333,113.083333333333
"10822","34140","2015",29,29,0,192747.24137931,1977.34482758621,93.9310344827586
"10823","34141","2015",10,10,0,147950,1409,106.9
"10824","34142","2015",70,47,23,117505.642857143,1462.61428571429,82.6
"10825","34143","2015",26,26,0,184418.461538462,2148.11538461538,88
"10826","34144","2015",8,7,1,84568.75,1407.375,74.25
"10827","34145","2015",297,182,115,160496.579124579,2035.78451178451,79.4511784511784
"10828","34146","2015",25,22,3,222930.8,2597.08,87.68
"10829","34147","2015",33,32,1,209834.545454545,1982.75757575758,103.969696969697
"10830","34148","2015",32,25,7,147155.25,1607.65625,88.90625
"10831","34149","2015",9,9,0,287508.888888889,2484.77777777778,117.333333333333
"10832","34150","2015",242,127,115,145662.318181818,2872.15289256198,57.1735537190083
"10833","34151","2015",76,61,15,182950.263157895,2439.67105263158,78.0789473684211
"10834","34152","2015",8,8,0,288799.5,3131.625,91.5
"10835","34153","2015",18,16,2,318870.888888889,3165.77777777778,102.555555555556
"10836","34154","2015",308,112,196,208717.522727273,3374.18506493506,63.211038961039
"10837","34155","2015",26,26,0,142642.115384615,1502.5,91.9230769230769
"10838","34156","2015",1,1,0,279259,3535,79
"10839","34157","2015",148,89,59,198974.27027027,2571.59459459459,78.972972972973
"10840","34158","2015",3,3,0,170716.666666667,2724.66666666667,61
"10841","34159","2015",40,35,5,191548.95,2257.8,85.9
"10842","34160","2015",6,6,0,77410,1308.5,60
"10843","34161","2015",43,42,1,179100.837209302,1931.13953488372,96.6744186046512
"10844","34162","2015",50,42,8,144556.48,1700.1,83.04
"10845","34164","2015",6,6,0,280826.666666667,2224.83333333333,122.833333333333
"10846","34165","2015",29,26,3,204343.965517241,2262,97.5862068965517
"10847","34166","2015",24,24,0,182467.166666667,1763.5,101.5
"10848","34168","2015",1,1,0,45000,750,60
"10849","34169","2015",28,22,6,333461.107142857,2997.46428571429,108.428571428571
"10850","34170","2015",2,2,0,52500,795.5,57
"10851","34171","2015",1,1,0,140000,1400,100
"10852","34172","2015",3976,500,3476,161221.373490946,2732.62399396378,60.4451710261569
"10853","34173","2015",12,11,1,193858.333333333,2298.16666666667,85.25
"10854","34174","2015",7,6,1,287000,2103.28571428571,124.428571428571
"10855","34176","2015",17,13,4,238620.764705882,2560.47058823529,99.2941176470588
"10856","34177","2015",1,1,0,160000,1553,103
"10857","34178","2015",35,34,1,163763.571428571,1548.37142857143,100.942857142857
"10858","34179","2015",18,17,1,310181.444444444,2428.11111111111,127.777777777778
"10859","34180","2015",15,15,0,150386.666666667,1633.86666666667,93.7333333333333
"10860","34181","2015",18,18,0,162965,1705.66666666667,95.4444444444444
"10861","34182","2015",19,18,1,152121.052631579,1865.21052631579,87.8947368421053
"10862","34183","2015",26,26,0,137240.461538462,1855.42307692308,84.8076923076923
"10863","34184","2015",8,8,0,290637.5,2644.875,97
"10864","34185","2015",9,9,0,148598.333333333,1558.66666666667,104.444444444444
"10865","34186","2015",4,4,0,605392.5,3276.75,139
"10866","34187","2015",14,13,1,137446.428571429,1732,85.7857142857143
"10867","34188","2015",4,4,0,241092.5,1942.5,108.75
"10868","34189","2015",19,19,0,122783.684210526,1159.63157894737,109.263157894737
"10869","34190","2015",2,2,0,115500,1440,89
"10870","34191","2015",4,4,0,204398.5,2344.25,89
"10871","34192","2015",234,32,202,183224.722222222,3957.30341880342,46.5384615384615
"10872","34193","2015",6,6,0,119045,1468.83333333333,83.3333333333333
"10873","34194","2015",28,25,3,126540.821428571,1658.5,77.0714285714286
"10874","34195","2015",1,1,0,60000,1875,32
"10875","34196","2015",2,2,0,152500,1595,107.5
"10876","34197","2015",7,7,0,117682.571428571,1441.57142857143,85.1428571428571
"10877","34198","2015",124,94,30,294761.862903226,3281.73387096774,92.6451612903226
"10878","34199","2015",82,46,36,145733.268292683,1859.07317073171,78.8048780487805
"10879","34200","2015",3,3,0,134476.666666667,1915.66666666667,77.6666666666667
"10880","34201","2015",3,3,0,235970,1585.66666666667,138
"10881","34202","2015",61,43,18,224127.508196721,2445.7868852459,92.983606557377
"10882","34203","2015",12,12,0,139041.666666667,1922.25,69.8333333333333
"10883","34204","2015",13,13,0,182600.769230769,1820.76923076923,112.615384615385
"10884","34205","2015",4,4,0,160967.25,2134.5,75.75
"10885","34206","2015",2,2,0,270000,1526,184
"10886","34207","2015",33,33,0,153178.545454545,1856.75757575758,81.8787878787879
"10887","34208","2015",4,4,0,143450,1713.75,77.5
"10888","34209","2015",99,85,14,155480.707070707,2745.10101010101,61.2020202020202
"10889","34210","2015",10,9,1,142000,1849.7,76.1
"10890","34211","2015",12,10,2,91405,1099.16666666667,85.8333333333333
"10891","34212","2015",1,1,0,52000,684,76
"10892","34213","2015",64,54,10,200826,2456.3125,85.34375
"10893","34214","2015",10,9,1,179175,1850.7,95.6
"10894","34215","2015",5,5,0,256900,2434.8,106
"10895","34216","2015",2,2,0,152500,1480.5,95
"10896","34217","2015",50,33,17,236313.94,2894.38,81.94
"10897","34218","2015",6,6,0,228545.833333333,1660,114.5
"10898","34219","2015",9,9,0,142889.444444444,1663.55555555556,84.1111111111111
"10899","34220","2015",2,2,0,135000,2048,64.5
"10900","34221","2015",4,4,0,107500,2011,49.25
"10901","34222","2015",9,9,0,229294.888888889,1794.55555555556,123.222222222222
"10902","34223","2015",9,9,0,222941.666666667,1931,111
"10903","34224","2015",16,16,0,222650,1826.625,117.3125
"10904","34225","2015",42,41,1,160021.571428571,1515.52380952381,108.97619047619
"10905","34226","2015",28,27,1,155693.214285714,1737.71428571429,94.1071428571429
"10906","34227","2015",19,18,1,334807.263157895,2718.42105263158,128.315789473684
"10907","34229","2015",9,9,0,83722.2222222222,1280.11111111111,103
"10908","34232","2015",11,11,0,175211.909090909,2009.54545454545,86.5454545454545
"10909","34235","2015",4,4,0,68325,1021.75,61.75
"10910","34237","2015",28,26,2,144759.357142857,1857.42857142857,82.1071428571429
"10911","34238","2015",1,1,0,230000,1917,120
"10912","34239","2015",17,15,2,196432.764705882,2344.94117647059,86.8235294117647
"10913","34240","2015",37,29,8,285822.972972973,3026.18918918919,96.8648648648649
"10914","34241","2015",8,8,0,247055,2862.375,98.125
"10915","34242","2015",9,9,0,292324.555555556,2546.33333333333,119.333333333333
"10916","34243","2015",17,13,4,162330,1785.76470588235,86.8235294117647
"10917","34244","2015",44,22,22,208755.954545455,2646.13636363636,80.3409090909091
"10918","34245","2015",19,14,5,144315.789473684,1998.31578947368,83.6842105263158
"10919","34246","2015",20,19,1,263825.85,2307.2,115.2
"10920","34247","2015",33,30,3,403839.151515151,3150.06060606061,131.242424242424
"10921","34248","2015",5,5,0,281646,2655.4,106.6
"10922","34249","2015",23,22,1,299122.782608696,2649.39130434783,122.739130434783
"10923","34250","2015",7,6,1,85857.1428571429,1429.42857142857,66
"10924","34251","2015",5,5,0,124200,1291.2,95.4
"10925","34252","2015",3,2,1,78333.3333333333,978.333333333333,79
"10926","34254","2015",3,3,0,275383.333333333,2276.33333333333,122.666666666667
"10927","34255","2015",81,65,16,371279.765432099,3172.45679012346,112.987654320988
"10928","34256","2015",32,32,0,300855.1875,2661.03125,112.71875
"10929","34257","2015",4,4,0,85750,1495,55.25
"10930","34258","2015",18,18,0,193071.111111111,1820.11111111111,102.944444444444
"10931","34259","2015",45,35,10,253690.844444444,2645.6,96.6888888888889
"10932","34260","2015",11,7,4,79904.5454545455,1156.72727272727,72.4545454545455
"10933","34261","2015",1,1,0,59040,1018,58
"10934","34262","2015",3,3,0,202846.666666667,1754.33333333333,112.333333333333
"10935","34263","2015",5,5,0,375760,3172.6,117.6
"10936","34264","2015",3,3,0,55500,618.333333333333,102.333333333333
"10937","34265","2015",4,4,0,497400,2598.75,174
"10938","34266","2015",3,3,0,404333.333333333,2878.66666666667,128.333333333333
"10939","34267","2015",15,14,1,159805,1951,81.3333333333333
"10940","34268","2015",3,3,0,172500,1827,102
"10941","34269","2015",2,2,0,56500,1171,50
"10942","34270","2015",91,67,24,295492.296703297,3131.96703296703,97.4725274725275
"10943","34271","2015",5,5,0,119400,1640.2,71.8
"10944","34272","2015",30,27,3,237160,2497.53333333333,95.0333333333333
"10945","34273","2015",2,2,0,86875,1613.5,56.5
"10946","34274","2015",16,15,1,282733.4375,2734.1875,101.3125
"10947","34276","2015",33,26,7,257095.060606061,2434.69696969697,109.393939393939
"10948","34277","2015",1,1,0,240000,2000,120
"10949","34279","2015",4,4,0,84000,1061,71
"10950","34280","2015",3,3,0,201500,2435.66666666667,96.3333333333333
"10951","34281","2015",25,24,1,132904.4,1807,74.28
"10952","34282","2015",8,7,1,285091.25,2488.5,110.5
"10953","34283","2015",1,1,0,305000,2061,148
"10954","34284","2015",11,9,2,65557.2727272727,802.818181818182,88.5454545454545
"10955","34285","2015",5,4,1,207000,2107.8,133.6
"10956","34286","2015",6,6,0,154091.666666667,2004.5,81
"10957","34287","2015",2,2,0,110950,1835,58.5
"10958","34288","2015",10,9,1,294432.3,2298.9,134.5
"10959","34289","2015",28,23,5,162064.285714286,1938.42857142857,84.7857142857143
"10960","34290","2015",4,4,0,371250,2982.75,116
"10961","34291","2015",3,3,0,93171.6666666667,1272.33333333333,70
"10962","34292","2015",2,2,0,179809.5,1701,101
"10963","34293","2015",14,13,1,155796.428571429,1600.92857142857,92.8571428571429
"10964","34294","2015",7,6,1,199642.857142857,2349.28571428571,85.4285714285714
"10965","34295","2015",12,12,0,260358.25,2451.91666666667,107.916666666667
"10966","34296","2015",5,5,0,272160.6,1953.2,144.6
"10967","34297","2015",3,3,0,114333.333333333,2312.33333333333,47.6666666666667
"10968","34298","2015",54,52,2,205571.555555556,2089,101.037037037037
"10969","34299","2015",89,74,15,196965.775280899,2449.16853932584,82.8089887640449
"10970","34300","2015",62,60,2,163343.241935484,1663.12903225806,96.6129032258064
"10971","34301","2015",766,123,643,160249.261096606,2524.65796344648,63.154046997389
"10972","34302","2015",19,18,1,117392.105263158,1526.21052631579,87.4736842105263
"10973","34304","2015",5,5,0,100796,1441.4,69.2
"10974","34305","2015",4,4,0,68317.5,1255.5,63.75
"10975","34306","2015",2,2,0,95000,1583.5,60
"10976","34307","2015",23,20,3,289737.782608696,2832,105.913043478261
"10977","34308","2015",4,4,0,108375,1252.25,102.25
"10978","34309","2015",27,23,4,379146.074074074,3305.77777777778,121.37037037037
"10979","34310","2015",34,33,1,199614.705882353,1720.91176470588,109.911764705882
"10980","34311","2015",19,19,0,212178.947368421,2134.42105263158,92.7894736842105
"10981","34312","2015",15,14,1,122016.333333333,1502.33333333333,83.1333333333333
"10982","34313","2015",9,9,0,192955.555555556,1564,119.111111111111
"10983","34314","2015",3,3,0,516666.666666667,3506.66666666667,167.666666666667
"10984","34315","2015",6,6,0,220568.333333333,1712.83333333333,122.666666666667
"10985","34316","2015",2,2,0,87500,1159,102.5
"10986","34317","2015",5,5,0,108860,1377.2,78.4
"10987","34318","2015",5,5,0,360407,2318.6,148.4
"10988","34319","2015",5,5,0,93600,1176.8,82
"10989","34320","2015",22,20,2,296563.954545455,2656,113.681818181818
"10990","34321","2015",11,11,0,260685,2618.45454545455,100.909090909091
"10991","34322","2015",7,7,0,248868.571428571,2206.14285714286,115.428571428571
"10992","34323","2015",2,2,0,146000,1367.5,91.5
"10993","34324","2015",209,98,111,128371.736842105,2868.54066985646,46.7846889952153
"10994","34325","2015",14,13,1,169375,1863.35714285714,94.0714285714286
"10995","34327","2015",58,42,16,246463.275862069,2917.60344827586,86.8275862068966
"10996","34328","2015",15,15,0,169723.333333333,2177.66666666667,79.6
"10997","34329","2015",59,44,15,148318.93220339,2810.49152542373,60.271186440678
"10998","34331","2015",5,5,0,89577,1382.8,67
"10999","34332","2015",108,97,11,144752.703703704,2164.23148148148,67.8888888888889
"11000","34333","2015",69,66,3,144916.811594203,4355.08695652174,38.6231884057971
"11001","34334","2015",4,4,0,96161.25,1893.5,53.75
"11002","34335","2015",6,6,0,105083.333333333,1356.83333333333,88.6666666666667
"11003","34336","2015",47,35,12,158734.255319149,1820.46808510638,84.8723404255319
"11004","34337","2015",68,52,16,231389.088235294,2778.52941176471,84.4264705882353
"11005","34338","2015",1,0,1,250000,2778,90
"11006","34339","2015",4,4,0,297575,2315.75,110.5
"11007","34340","2015",13,12,1,301839.615384615,2634.53846153846,114.538461538462
"11008","34341","2015",41,39,2,193362.634146341,2072.19512195122,92.6341463414634
"11009","34342","2015",1,1,0,327000,2515,130
"11010","34343","2015",6,6,0,275558.5,2659.66666666667,104.666666666667
"11011","34344","2015",631,42,589,164009.163232964,4003.80824088748,39.4738510301109
"11012","35001","2015",60,39,21,194606.066666667,2229.1,88.7833333333333
"11013","35002","2015",12,12,0,203451.666666667,1941.66666666667,111.833333333333
"11014","35003","2015",6,6,0,150083.333333333,1430,105.5
"11015","35004","2015",9,9,0,117769.444444444,1143.11111111111,104.222222222222
"11016","35005","2015",2,2,0,160000,1418.5,113.5
"11017","35006","2015",41,34,7,159081.170731707,1533.78048780488,110.121951219512
"11018","35008","2015",4,4,0,89750,1179.25,74.75
"11019","35009","2015",11,10,1,125263.636363636,1514.36363636364,86.4545454545455
"11020","35010","2015",14,14,0,112464.285714286,1311.21428571429,84.3571428571429
"11021","35012","2015",76,64,12,153494.934210526,1540.09210526316,98.3684210526316
"11022","35013","2015",34,34,0,118724.5,1168.79411764706,106.794117647059
"11023","35014","2015",28,28,0,133136.607142857,1233.28571428571,112.071428571429
"11024","35015","2015",20,20,0,153565,1404.45,108.7
"11025","35016","2015",18,18,0,138556.666666667,1532.11111111111,99.2777777777778
"11026","35017","2015",2,2,0,125000,1343,90.5
"11027","35018","2015",12,12,0,112958.333333333,965.25,111.083333333333
"11028","35019","2015",29,29,0,96893.1034482759,1035.31034482759,96.9655172413793
"11029","35021","2015",8,8,0,186930.625,1463.75,127.75
"11030","35022","2015",11,9,2,121863.636363636,1117,109.272727272727
"11031","35023","2015",37,31,6,187675.675675676,1851.97297297297,101.648648648649
"11032","35024","2015",157,115,42,221364.834394904,2237.17834394904,98.4777070063694
"11033","35025","2015",13,13,0,133715.384615385,1270.92307692308,108.769230769231
"11034","35026","2015",1,1,0,190000,500,380
"11035","35027","2015",24,24,0,109642.541666667,1220.29166666667,90
"11036","35028","2015",2,2,0,181950,1637,111
"11037","35029","2015",10,10,0,120340,1267.4,99.2
"11038","35030","2015",10,10,0,178620,1436.9,125
"11039","35031","2015",44,41,3,161292.75,1862.93181818182,88.4090909090909
"11040","35032","2015",34,28,6,165326.205882353,1765.44117647059,96.4117647058823
"11041","35033","2015",26,25,1,156493.653846154,1531.46153846154,106.576923076923
"11042","35034","2015",12,12,0,134947.916666667,1213.75,110.333333333333
"11043","35035","2015",5,5,0,85120,1161,80.2
"11044","35037","2015",63,48,15,174169.825396825,1940.96825396825,92.0634920634921
"11045","35038","2015",7,7,0,113902.285714286,1335.42857142857,86.2857142857143
"11046","35039","2015",22,20,2,181434.181818182,1846.5,97.1818181818182
"11047","35040","2015",34,29,5,176826.088235294,1924.85294117647,97.5588235294118
"11048","35041","2015",9,8,1,159438.888888889,1398.44444444444,119.555555555556
"11049","35042","2015",10,10,0,132700,1312.6,103.6
"11050","35045","2015",4,4,0,108961,984,110
"11051","35046","2015",5,5,0,77961.4,917.2,86.6
"11052","35047","2015",222,141,81,196038.333333333,2304.12612612613,87.4009009009009
"11053","35049","2015",98,76,22,257313.459183673,2693.04081632653,92.4387755102041
"11054","35050","2015",8,8,0,209000,1661.625,129.5
"11055","35051","2015",150,83,67,268750.86,2709.59333333333,100.886666666667
"11056","35052","2015",4,4,0,164250,1580.25,102.75
"11057","35054","2015",15,15,0,186642.333333333,1737.8,111.066666666667
"11058","35055","2015",97,37,60,195066.711340206,2435.77319587629,80.7319587628866
"11059","35056","2015",10,10,0,166231,1545.7,102.9
"11060","35057","2015",14,14,0,122650,1635.28571428571,81.0714285714286
"11061","35058","2015",9,9,0,170884.444444444,1624.55555555556,106.444444444444
"11062","35059","2015",39,32,7,213140.051282051,2175.53846153846,102.307692307692
"11063","35060","2015",17,17,0,128026.705882353,1376.70588235294,93.2352941176471
"11064","35061","2015",3,3,0,152166.666666667,1346.33333333333,110.666666666667
"11065","35062","2015",11,11,0,142709.090909091,1182.54545454545,120.727272727273
"11066","35063","2015",2,2,0,124000,1498,93.5
"11067","35064","2015",13,13,0,119662.307692308,1290.15384615385,91.1538461538462
"11068","35065","2015",18,16,2,177552.833333333,1873.88888888889,97.5555555555556
"11069","35066","2015",102,55,47,175168.892156863,2104.57843137255,84.578431372549
"11070","35067","2015",13,13,0,220467.692307692,1889,118.307692307692
"11071","35068","2015",74,61,13,162643.621621622,1794.54054054054,93.0675675675676
"11072","35069","2015",129,88,41,201300.891472868,2068.41085271318,96.4961240310078
"11073","35070","2015",17,15,2,132262.411764706,1896.58823529412,89.4117647058823
"11074","35071","2015",6,6,0,108683.333333333,1162,90.3333333333333
"11075","35072","2015",17,17,0,99822.4705882353,1193.94117647059,84.2352941176471
"11076","35075","2015",5,5,0,119080,1624.8,73
"11077","35076","2015",47,23,24,163397.404255319,1978.74468085106,83.8085106382979
"11078","35077","2015",6,6,0,82416.6666666667,807.833333333333,97.8333333333333
"11079","35078","2015",11,11,0,118636.363636364,1584.63636363636,74.8181818181818
"11080","35079","2015",13,12,1,224665.384615385,2196.84615384615,103.307692307692
"11081","35080","2015",17,17,0,183915.529411765,1732.11764705882,108.352941176471
"11082","35081","2015",4,4,0,254375,3054,118.5
"11083","35082","2015",9,9,0,126586.777777778,1132.88888888889,114.888888888889
"11084","35084","2015",7,7,0,131757.142857143,1262.57142857143,110.428571428571
"11085","35085","2015",52,44,8,148912.865384615,1522.36538461538,99.9423076923077
"11086","35086","2015",5,5,0,144700,1334,111.6
"11087","35087","2015",6,6,0,173666.666666667,1481.33333333333,119.833333333333
"11088","35088","2015",32,22,10,153575.46875,1744.125,92.15625
"11089","35089","2015",8,8,0,157687.5,1336.125,112.625
"11090","35090","2015",29,26,3,165927.482758621,1606.8275862069,103.310344827586
"11091","35091","2015",10,10,0,131400,1138.1,114.1
"11092","35092","2015",4,4,0,106250,1041.5,106.75
"11093","35093","2015",294,116,178,221248.693877551,3359.15306122449,68.6768707482993
"11094","35094","2015",18,18,0,117225.277777778,1469.66666666667,93.3888888888889
"11095","35095","2015",55,43,12,136952.327272727,1491.98181818182,97.1636363636364
"11096","35096","2015",21,20,1,151182.80952381,1457.7619047619,108.142857142857
"11097","35097","2015",16,16,0,151281.25,1412.5625,106.875
"11098","35098","2015",12,12,0,123832.5,1245.91666666667,107.25
"11099","35099","2015",31,20,11,170472.580645161,2009.29032258065,85.3870967741936
"11100","35101","2015",13,13,0,131423.076923077,1414.76923076923,89.6153846153846
"11101","35102","2015",7,7,0,96214.2857142857,1168.14285714286,95.7142857142857
"11102","35103","2015",2,2,0,109500,783.5,136.5
"11103","35104","2015",17,17,0,113956.470588235,1243.47058823529,96.4117647058823
"11104","35105","2015",10,10,0,157153.4,1695.5,102.6
"11105","35106","2015",19,19,0,105094.736842105,1173.84210526316,94.8947368421053
"11106","35107","2015",17,17,0,163000,1657.47058823529,96.5882352941177
"11107","35108","2015",4,4,0,169625,1287.75,132
"11108","35109","2015",11,11,0,135076.909090909,1185.09090909091,119.181818181818
"11109","35110","2015",12,12,0,124480,1121.25,123.083333333333
"11110","35111","2015",2,2,0,118125,751.5,149
"11111","35112","2015",5,5,0,119200,1232.6,102.6
"11112","35114","2015",4,4,0,72500,825,91.5
"11113","35115","2015",247,138,109,107577.153846154,1309.57489878543,83.0364372469636
"11114","35116","2015",22,22,0,138627.045454545,1498.09090909091,94.3636363636364
"11115","35117","2015",13,13,0,83035.3846153846,1170.30769230769,77.1538461538462
"11116","35118","2015",5,5,0,131800,1984,73.6
"11117","35119","2015",12,12,0,102816.666666667,976.25,103.666666666667
"11118","35120","2015",62,52,10,187352.774193548,1868.1935483871,101.548387096774
"11119","35121","2015",19,19,0,166141.052631579,1698.84210526316,97.4210526315789
"11120","35122","2015",23,21,2,157523.391304348,1818.04347826087,89.1739130434783
"11121","35123","2015",39,37,2,177742.769230769,1736.38461538462,105.897435897436
"11122","35124","2015",30,30,0,94549.4,1120.73333333333,84.5
"11123","35125","2015",46,42,4,110077.456521739,1198.54347826087,91.6086956521739
"11124","35126","2015",91,85,6,173682.813186813,1841.27472527473,98.3296703296703
"11125","35127","2015",39,35,4,149045.846153846,1596.82051282051,93.974358974359
"11126","35128","2015",9,9,0,162333.333333333,1622.55555555556,99.6666666666667
"11127","35130","2015",20,18,2,145198.8,1578.5,89.95
"11128","35131","2015",52,35,17,182618.923076923,2084.46153846154,88.75
"11129","35132","2015",15,15,0,152221.333333333,1447.2,103.6
"11130","35133","2015",32,29,3,164468.4375,1593.125,105.75
"11131","35134","2015",3,3,0,214333.333333333,1649,127.666666666667
"11132","35135","2015",21,18,3,143017.142857143,1529.7619047619,92.5238095238095
"11133","35136","2015",64,53,11,166999.765625,1619.3125,104.84375
"11134","35137","2015",16,16,0,127156.25,1290.625,100.75
"11135","35138","2015",9,9,0,145333.333333333,1552.66666666667,99.1111111111111
"11136","35139","2015",57,46,11,211219.578947368,1968.91228070175,107.771929824561
"11137","35140","2015",5,5,0,122231.6,962.8,122.4
"11138","35141","2015",3,3,0,151068.333333333,1199.33333333333,119.666666666667
"11139","35142","2015",16,13,3,102962.5,998.4375,103.25
"11140","35143","2015",6,6,0,130693.333333333,1287.66666666667,94.1666666666667
"11141","35144","2015",7,7,0,164642.857142857,1700.85714285714,97.4285714285714
"11142","35145","2015",23,23,0,81141.652173913,969.304347826087,93.2173913043478
"11143","35146","2015",2,2,0,292650,2130,134.5
"11144","35148","2015",2,2,0,186900,1493,129.5
"11145","35149","2015",13,13,0,185855.230769231,1733.23076923077,110.769230769231
"11146","35150","2015",22,22,0,152448.954545455,1368.63636363636,112.045454545455
"11147","35151","2015",3,3,0,59689.6666666667,990.333333333333,60.3333333333333
"11148","35152","2015",83,64,19,175437.951807229,1920.46987951807,93.0481927710843
"11149","35153","2015",5,5,0,153600,1397.6,110.8
"11150","35154","2015",13,13,0,125615.384615385,1329,94.5384615384615
"11151","35155","2015",4,4,0,82792,1354.25,64.75
"11152","35156","2015",4,4,0,126662.5,1722,84.75
"11153","35157","2015",6,6,0,85916.6666666667,983.666666666667,87.8333333333333
"11154","35159","2015",2,2,0,83750,1351,67
"11155","35160","2015",1,1,0,175000,1733,101
"11156","35161","2015",17,17,0,135257.411764706,1354.64705882353,101.882352941176
"11157","35162","2015",29,27,2,72089.0689655172,790.172413793103,90.3448275862069
"11158","35163","2015",13,13,0,104884.615384615,1123.84615384615,94.3846153846154
"11159","35164","2015",6,6,0,95916.6666666667,1008.16666666667,95.8333333333333
"11160","35165","2015",4,4,0,171775,1572.75,103
"11161","35166","2015",7,7,0,174699.285714286,1759.71428571429,103.428571428571
"11162","35167","2015",26,24,2,80476.9230769231,1023.84615384615,82.7307692307692
"11163","35168","2015",41,41,0,116322.219512195,1186.60975609756,98.5121951219512
"11164","35169","2015",11,11,0,108936.363636364,1247,93.7272727272727
"11165","35170","2015",5,5,0,104200,1147.6,86.4
"11166","35171","2015",14,14,0,109362.571428571,1089.42857142857,111.214285714286
"11167","35172","2015",17,17,0,103438.235294118,1407.47058823529,79.0588235294118
"11168","35173","2015",61,47,14,192395.737704918,2016.90163934426,100.885245901639
"11169","35174","2015",6,6,0,139742.5,1319.16666666667,106.833333333333
"11170","35175","2015",12,12,0,111659.583333333,1293.08333333333,86.75
"11171","35176","2015",60,58,2,121937.183333333,1313.1,95.1
"11172","35177","2015",56,46,10,205513.571428571,2116.51785714286,100.339285714286
"11173","35178","2015",14,14,0,188352.142857143,2538,101.857142857143
"11174","35179","2015",52,49,3,138248.461538462,1643.42307692308,90.4038461538462
"11175","35180","2015",4,4,0,99550,1323.25,90.5
"11176","35181","2015",16,16,0,227996.875,2195,102.0625
"11177","35183","2015",10,10,0,141753,1465,98.1
"11178","35184","2015",52,46,6,137727.711538462,1463.88461538462,99.7115384615385
"11179","35185","2015",2,2,0,118500,1312,94
"11180","35186","2015",15,15,0,126644.266666667,1682.93333333333,83.7333333333333
"11181","35187","2015",16,16,0,153043.25,1750,88.75
"11182","35188","2015",70,49,21,162854.4,1854.31428571429,89.5857142857143
"11183","35189","2015",36,27,9,221395.194444444,2357.97222222222,94.8611111111111
"11184","35190","2015",2,2,0,107500,906,129.5
"11185","35191","2015",24,24,0,92912.5,1166.66666666667,78.9583333333333
"11186","35193","2015",16,16,0,197353.5625,1826.625,116
"11187","35194","2015",8,8,0,212481.25,1703.25,128.75
"11188","35195","2015",25,22,3,136866.2,1450.96,96.16
"11189","35196","2015",105,55,50,179229.257142857,2120.97142857143,87.6571428571429
"11190","35197","2015",9,9,0,171066.666666667,1828.22222222222,93.4444444444444
"11191","35198","2015",6,6,0,201158.333333333,1750.83333333333,111.166666666667
"11192","35199","2015",2,2,0,116000,1091.5,99
"11193","35200","2015",4,4,0,150750,1162.75,139.75
"11194","35201","2015",5,5,0,115860,1271.2,95.8
"11195","35202","2015",8,8,0,88250,1345.5,62.75
"11196","35203","2015",3,3,0,164023.333333333,1442.33333333333,108.333333333333
"11197","35204","2015",30,27,3,167128.9,1757.4,98
"11198","35205","2015",4,4,0,96750,1041.75,98.25
"11199","35206","2015",86,52,34,179099.453488372,2086.6511627907,87.3023255813954
"11200","35207","2015",54,38,16,208078.611111111,2108.57407407407,98.7222222222222
"11201","35208","2015",40,27,13,178851.7,1960.65,90.925
"11202","35210","2015",129,91,38,259626.139534884,2486.37209302326,106.434108527132
"11203","35211","2015",27,27,0,138609.259259259,1282.55555555556,118.518518518519
"11204","35212","2015",10,10,0,162830,1408.2,114.3
"11205","35214","2015",5,5,0,97878,1213.6,79
"11206","35215","2015",18,18,0,137444.444444444,1134.72222222222,115.666666666667
"11207","35216","2015",17,13,4,171309.882352941,1766.29411764706,96.9411764705882
"11208","35217","2015",3,3,0,58683.3333333333,921.666666666667,70
"11209","35218","2015",6,6,0,133566.666666667,1426.33333333333,95.8333333333333
"11210","35219","2015",31,31,0,98976.5806451613,1232.64516129032,86.9354838709677
"11211","35220","2015",30,30,0,166731.666666667,1677.2,104.833333333333
"11212","35221","2015",33,33,0,134563.636363636,1386.9696969697,98.7878787878788
"11213","35222","2015",21,21,0,106822.714285714,1245.90476190476,89.1904761904762
"11214","35223","2015",48,43,5,129026.25,1458.75,89.5833333333333
"11215","35224","2015",32,31,1,143450,1542.8125,94.21875
"11216","35225","2015",10,10,0,120624.5,1047.7,120.6
"11217","35226","2015",25,23,2,108996.92,1116.68,101.92
"11218","35227","2015",21,15,6,154695.714285714,1723.61904761905,89.3809523809524
"11219","35228","2015",95,58,37,169053.621052632,1950.24210526316,85.3894736842105
"11220","35229","2015",8,8,0,162433.75,1441.5,110
"11221","35230","2015",2,2,0,133000,1438.5,104
"11222","35231","2015",13,13,0,186730.769230769,1579.23076923077,118.538461538462
"11223","35232","2015",4,4,0,99750,1109.75,99.5
"11224","35233","2015",14,14,0,108418.142857143,1067.71428571429,103.214285714286
"11225","35234","2015",10,10,0,82850,993.1,83
"11226","35235","2015",8,8,0,61425,782.625,85
"11227","35236","2015",75,45,30,97481.5733333333,1200.90666666667,80.76
"11228","35237","2015",11,11,0,112814.181818182,1062,102.545454545455
"11229","35238","2015",3166,469,2697,169302.617182565,2612.15192672141,64.9106127605812
"11230","35239","2015",51,49,2,122649.705882353,1335.33333333333,94.3529411764706
"11231","35240","2015",119,64,55,186884.504201681,2166.76470588235,88.0588235294118
"11232","35241","2015",27,23,4,167891.074074074,1920.59259259259,88.1111111111111
"11233","35242","2015",2,2,0,86500,1031.5,80
"11234","35243","2015",19,19,0,166696.842105263,1489.36842105263,114.052631578947
"11235","35244","2015",2,2,0,32000,659.5,53
"11236","35245","2015",35,29,6,165878.342857143,1671.48571428571,103.057142857143
"11237","35246","2015",10,10,0,142020,1356.1,113.7
"11238","35247","2015",13,12,1,96052.3076923077,1209.38461538462,88.9230769230769
"11239","35248","2015",5,5,0,116300,1113.2,102.6
"11240","35249","2015",13,13,0,78899.6923076923,954.076923076923,82.0769230769231
"11241","35250","2015",29,24,5,174201.724137931,1796.93103448276,100.448275862069
"11242","35251","2015",53,45,8,173125.735849057,1708.54716981132,104.962264150943
"11243","35252","2015",5,5,0,156074,1619,96.4
"11244","35253","2015",33,28,5,151832.939393939,1634.75757575758,92.6060606060606
"11245","35255","2015",11,11,0,156909.090909091,1611.72727272727,100.909090909091
"11246","35256","2015",55,42,13,311367.090909091,3099.90909090909,96.7272727272727
"11247","35257","2015",31,31,0,135354.806451613,1304.87096774194,104.387096774194
"11248","35258","2015",1,1,0,150000,2542,59
"11249","35259","2015",13,12,1,98576.9230769231,1228.30769230769,82.3846153846154
"11250","35260","2015",6,6,0,123231.166666667,1422.16666666667,85.1666666666667
"11251","35261","2015",8,8,0,116744.25,1113.875,115.375
"11252","35262","2015",1,1,0,126000,1518,83
"11253","35263","2015",30,28,2,200833,1981.9,99.9
"11254","35264","2015",13,13,0,181378.769230769,1853.15384615385,98.6153846153846
"11255","35265","2015",29,25,4,148179.448275862,1617.55172413793,95.5862068965517
"11256","35266","2015",27,16,11,188822.222222222,2075.37037037037,92
"11257","35268","2015",5,5,0,112700,1040.2,107
"11258","35270","2015",2,2,0,158000,1563,102.5
"11259","35271","2015",15,15,0,79962.6666666667,924.8,104.533333333333
"11260","35272","2015",7,7,0,136285.714285714,1368.57142857143,100.285714285714
"11261","35273","2015",13,13,0,114702.923076923,1345.84615384615,87
"11262","35274","2015",18,17,1,192316.111111111,1650.77777777778,118.722222222222
"11263","35275","2015",46,39,7,230379.369565217,2234.58695652174,103.173913043478
"11264","35276","2015",8,8,0,196181.625,1642.625,120.875
"11265","35277","2015",2,2,0,143475,1261,106
"11266","35278","2015",116,69,47,288426.586206897,2646.53448275862,108.543103448276
"11267","35279","2015",13,13,0,160653.846153846,1569.15384615385,104.769230769231
"11268","35280","2015",5,5,0,135000,1478,95.8
"11269","35281","2015",187,49,138,146088.64171123,2168.96256684492,68.6310160427807
"11270","35282","2015",28,28,0,139310.964285714,1368.39285714286,108.107142857143
"11271","35283","2015",7,6,1,171214.285714286,1769.14285714286,93.4285714285714
"11272","35284","2015",20,19,1,209557.5,2095.35,100.95
"11273","35285","2015",10,10,0,80798,1128.7,70.4
"11274","35286","2015",2,2,0,67500,1195.5,75.5
"11275","35287","2015",39,30,9,333872.58974359,3805.15384615385,93.5128205128205
"11276","35288","2015",808,327,481,205521.304455446,2800.42574257426,75.1695544554455
"11277","35289","2015",13,13,0,94376.6153846154,1136,76.5384615384615
"11278","35290","2015",11,11,0,102952.727272727,1028.54545454545,99.8181818181818
"11279","35291","2015",5,5,0,107800,937.4,109.4
"11280","35292","2015",14,14,0,92073.2857142857,932.928571428571,95.0714285714286
"11281","35294","2015",24,24,0,119955.541666667,1230.95833333333,97
"11282","35295","2015",5,5,0,97360,967,103.4
"11283","35296","2015",9,9,0,165634.666666667,1653,102.111111111111
"11284","35297","2015",46,34,12,101488.434782609,1220.69565217391,85.1086956521739
"11285","35299","2015",55,49,6,214062.163636364,1954.87272727273,103.072727272727
"11286","35300","2015",6,6,0,127239.5,1473.5,87.5
"11287","35302","2015",8,8,0,158959.75,1686,93.875
"11288","35304","2015",14,14,0,132350,1391.78571428571,94.9285714285714
"11289","35305","2015",4,4,0,106350,1351.5,81
"11290","35306","2015",27,27,0,191762.962962963,1941.85185185185,101.925925925926
"11291","35307","2015",4,4,0,128000,1218.5,105.5
"11292","35308","2015",60,57,3,115475.5,1249.81666666667,96.3833333333333
"11293","35309","2015",3,3,0,139333.333333333,1147.66666666667,120.333333333333
"11294","35310","2015",9,9,0,168466.666666667,1641.88888888889,103.222222222222
"11295","35311","2015",3,3,0,86330,1059,86.3333333333333
"11296","35312","2015",14,14,0,134169.785714286,1674.78571428571,78.1428571428571
"11297","35314","2015",10,10,0,245700,2024.6,137.8
"11298","35315","2015",21,21,0,193347.619047619,1752.2380952381,114.142857142857
"11299","35316","2015",11,11,0,83674.2727272727,973.454545454545,85.6363636363636
"11300","35317","2015",3,3,0,281885.333333333,2239.33333333333,124.333333333333
"11301","35318","2015",9,9,0,172031.333333333,1505.33333333333,118.555555555556
"11302","35319","2015",23,18,5,154850,1679.82608695652,92
"11303","35320","2015",3,3,0,176516.666666667,1538,116
"11304","35321","2015",7,7,0,114428.571428571,1160.42857142857,99.1428571428571
"11305","35322","2015",7,7,0,124071.428571429,912.285714285714,134
"11306","35324","2015",4,4,0,119250,1149.75,105
"11307","35325","2015",3,3,0,91333.3333333333,1215,80.6666666666667
"11308","35326","2015",13,13,0,141449.230769231,1279.46153846154,109.076923076923
"11309","35327","2015",36,30,6,186661.5,1877.77777777778,103.944444444444
"11310","35328","2015",21,21,0,72870.9523809524,888.714285714286,83.7619047619048
"11311","35329","2015",4,4,0,128000,1102.75,116.5
"11312","35330","2015",11,11,0,160963.636363636,1417.90909090909,112.727272727273
"11313","35331","2015",20,18,2,166747.5,1835.25,98
"11314","35332","2015",16,16,0,115825,1096.125,110.25
"11315","35333","2015",13,13,0,122384.615384615,1184.76923076923,106.307692307692
"11316","35334","2015",122,60,62,205562.786885246,2199.29508196721,93.5
"11317","35335","2015",7,7,0,85527.2857142857,1528.71428571429,58
"11318","35336","2015",2,2,0,86500,776.5,98
"11319","35337","2015",25,23,2,156696,1613.08,106.24
"11320","35338","2015",4,4,0,103052.5,1274.5,85.25
"11321","35339","2015",9,9,0,115555.555555556,1141.33333333333,95
"11322","35340","2015",6,6,0,133350,1638.83333333333,88
"11323","35342","2015",2,2,0,143500,1966.5,75.5
"11324","35343","2015",10,10,0,114595,1137.1,99.2
"11325","35345","2015",7,7,0,107368.428571429,1153.14285714286,99.5714285714286
"11326","35346","2015",1,1,0,191600,1916,100
"11327","35347","2015",15,14,1,139077,1292.93333333333,112.266666666667
"11328","35350","2015",4,4,0,105394.5,1091,94
"11329","35351","2015",14,14,0,152564.285714286,1612.14285714286,97.7857142857143
"11330","35352","2015",84,63,21,216422.738095238,2122.13095238095,101.869047619048
"11331","35353","2015",38,22,16,192850.394736842,2316.21052631579,85.8421052631579
"11332","35354","2015",4,4,0,145000,1204.5,127.25
"11333","35355","2015",15,15,0,178256.666666667,1837.2,97.2
"11334","35356","2015",20,17,3,179230,1720.05,105.2
"11335","35357","2015",4,4,0,112500,1094.75,103.75
"11336","35358","2015",12,12,0,175483.333333333,1835.58333333333,99.1666666666667
"11337","35359","2015",6,6,0,107900,1256,88
"11338","35360","2015",193,119,74,167026.430051813,1902.74093264249,88.699481865285
"11339","35361","2015",18,18,0,121132.222222222,1595.27777777778,81.0555555555556
"11340","35362","2015",13,13,0,106076.923076923,1278,84.6153846153846
"11341","35363","2015",34,23,11,199557.176470588,1931.05882352941,102.617647058824
"11342","36001","2015",13,13,0,78153.8461538462,869.923076923077,93.8461538461538
"11343","36002","2015",1,1,0,38150,370,103
"11344","36003","2015",10,10,0,88360,917.5,95.2
"11345","36004","2015",5,5,0,86400,818.8,104.8
"11346","36005","2015",44,43,1,122848.931818182,1324.97727272727,92.8863636363636
"11347","36006","2015",53,48,5,99727.7924528302,1136.92452830189,89.3018867924528
"11348","36007","2015",6,6,0,70566.6666666667,771.5,93.5
"11349","36008","2015",2,2,0,74500,703.5,105.5
"11350","36009","2015",10,10,0,121500,1314.7,91.6
"11351","36010","2015",9,9,0,82762.6666666667,881.666666666667,95.1111111111111
"11352","36011","2015",1,1,0,150000,1304,115
"11353","36012","2015",1,1,0,135000,1378,98
"11354","36013","2015",4,4,0,72250,700.75,106
"11355","36014","2015",2,2,0,85250,990.5,89.5
"11356","36015","2015",1,1,0,1e+05,1282,78
"11357","36016","2015",7,7,0,103757.142857143,1087.42857142857,91.4285714285714
"11358","36017","2015",3,3,0,77333.3333333333,948.333333333333,76
"11359","36018","2015",56,51,5,98125,1136.80357142857,89.9464285714286
"11360","36019","2015",6,6,0,78096.8333333333,1022.33333333333,91
"11361","36021","2015",4,4,0,113500,1065,109.25
"11362","36022","2015",7,7,0,118000,1023.28571428571,120
"11363","36023","2015",2,2,0,62000,736.5,86
"11364","36024","2015",1,1,0,7e+05,4730,148
"11365","36025","2015",4,4,0,139250,1205.25,127.75
"11366","36026","2015",3,3,0,64916.6666666667,777.333333333333,94
"11367","36027","2015",2,2,0,110225,1224.5,93.5
"11368","36029","2015",5,5,0,71600,881.4,84.2
"11369","36030","2015",1,1,0,128800,1415,91
"11370","36031","2015",36,36,0,87315.8333333333,1150.61111111111,84.5555555555556
"11371","36032","2015",10,10,0,64925,902.4,68.6
"11372","36033","2015",7,7,0,109214.285714286,914,117.714285714286
"11373","36034","2015",25,25,0,92049.08,1117.8,81.72
"11374","36035","2015",11,11,0,54636.3636363636,735.090909090909,77.2727272727273
"11375","36036","2015",4,4,0,63000,1038.25,55.5
"11376","36038","2015",2,2,0,122500,949,122
"11377","36040","2015",2,2,0,81000,1096,76.5
"11378","36042","2015",4,4,0,79795,1040,83.5
"11379","36043","2015",2,2,0,77500,809,90.5
"11380","36044","2015",406,290,116,104338.118226601,1198.87438423645,87.807881773399
"11381","36045","2015",15,15,0,96323.3333333333,1035.6,96.4666666666667
"11382","36046","2015",34,28,6,104146.147058824,1349.79411764706,85.7058823529412
"11383","36047","2015",6,6,0,62166.6666666667,709,108.666666666667
"11384","36048","2015",4,4,0,74250,775.25,107.5
"11385","36050","2015",3,3,0,77333.3333333333,907.333333333333,84
"11386","36051","2015",1,1,0,30000,500,60
"11387","36052","2015",1,1,0,60000,480,125
"11388","36053","2015",3,3,0,70800,828,86
"11389","36054","2015",1,1,0,37000,685,54
"11390","36055","2015",11,11,0,87443.6363636364,899.818181818182,102
"11391","36056","2015",14,14,0,63462.1428571429,927.571428571429,71.5714285714286
"11392","36057","2015",9,9,0,132877.777777778,1368.55555555556,98.4444444444444
"11393","36058","2015",11,11,0,106972.727272727,1117.81818181818,90.8181818181818
"11394","36060","2015",6,6,0,65250,913,76.6666666666667
"11395","36061","2015",2,2,0,46000,693,114
"11396","36062","2015",9,9,0,70186.6666666667,1025.33333333333,74.6666666666667
"11397","36063","2015",82,81,1,110291.219512195,1226.43902439024,90.4756097560976
"11398","36064","2015",3,3,0,143600,1363.66666666667,108.666666666667
"11399","36065","2015",4,4,0,90000,1110.75,81.25
"11400","36066","2015",2,2,0,117500,1179.5,95
"11401","36067","2015",1,1,0,50000,833,60
"11402","36068","2015",7,7,0,68996.4285714286,687.714285714286,100
"11403","36069","2015",16,16,0,90931.25,1193.8125,78.875
"11404","36070","2015",19,19,0,94097.3684210526,991.526315789474,94.3157894736842
"11405","36071","2015",7,7,0,138535.714285714,1395.28571428571,100.857142857143
"11406","36073","2015",3,3,0,70441.6666666667,780.333333333333,93.3333333333333
"11407","36074","2015",2,2,0,75500,1016,74
"11408","36076","2015",5,5,0,116177,1248.4,102.2
"11409","36077","2015",3,3,0,70216.6666666667,964.333333333333,83
"11410","36078","2015",3,3,0,113566.666666667,1336,85
"11411","36079","2015",1,1,0,156000,975,160
"11412","36080","2015",1,1,0,56571,1489,38
"11413","36081","2015",5,5,0,103450,790,123
"11414","36082","2015",6,6,0,78200,1000.33333333333,92.1666666666667
"11415","36084","2015",2,2,0,86000,875,90
"11416","36085","2015",4,4,0,65000,720.25,78.5
"11417","36086","2015",3,3,0,54833.3333333333,880.333333333333,62
"11418","36087","2015",3,3,0,53666.6666666667,742.333333333333,73.3333333333333
"11419","36088","2015",101,96,5,88036.8811881188,1056.86138613861,84.0792079207921
"11420","36089","2015",4,4,0,184625,1111,166
"11421","36090","2015",1,1,0,145000,1000,145
"11422","36091","2015",5,5,0,99004,1059.8,89.2
"11423","36092","2015",2,2,0,65000,957,68.5
"11424","36093","2015",31,29,2,84304.8387096774,939.258064516129,89.6129032258064
"11425","36094","2015",7,7,0,96142.8571428571,1032,83.1428571428571
"11426","36095","2015",3,3,0,78500,823,104.333333333333
"11427","36096","2015",2,2,0,121000,847,149
"11428","36097","2015",1,1,0,58000,674,86
"11429","36098","2015",1,1,0,5e+05,2347,213
"11430","36099","2015",5,5,0,59872.8,646.4,101.4
"11431","36100","2015",4,4,0,114000,1149.75,93.5
"11432","36101","2015",11,11,0,152137.727272727,1348.72727272727,106.090909090909
"11433","36102","2015",3,3,0,65000,704.666666666667,93.3333333333333
"11434","36103","2015",11,10,1,64766.8181818182,711.818181818182,93
"11435","36104","2015",2,2,0,32500,680,46
"11436","36105","2015",1,1,0,94900,871,109
"11437","36106","2015",1,1,0,53050,632,84
"11438","36107","2015",2,2,0,53150,853.5,62.5
"11439","36108","2015",2,2,0,132000,1392,93.5
"11440","36109","2015",6,6,0,86666.6666666667,1127,80.6666666666667
"11441","36110","2015",2,2,0,60000,1124.5,65
"11442","36111","2015",1,1,0,105000,644,163
"11443","36112","2015",7,7,0,118357.428571429,1226,101.714285714286
"11444","36113","2015",15,15,0,68452.6666666667,916.333333333333,76
"11445","36114","2015",1,1,0,50000,633,79
"11446","36115","2015",2,2,0,82500,1055,87
"11447","36116","2015",1,1,0,45000,625,72
"11448","36117","2015",6,6,0,97333.3333333333,954,99.5
"11449","36118","2015",2,2,0,81500,778.5,94.5
"11450","36119","2015",5,5,0,73730,759,91.4
"11451","36120","2015",10,10,0,91190,912.4,98.4
"11452","36122","2015",2,2,0,49500,653.5,65.5
"11453","36123","2015",14,14,0,73107.1428571429,880.285714285714,82.4285714285714
"11454","36124","2015",5,5,0,159700,1289.8,125.6
"11455","36125","2015",1,1,0,48000,762,63
"11456","36126","2015",3,3,0,152820.666666667,1620,81.6666666666667
"11457","36127","2015",10,10,0,73540,942,86.5
"11458","36128","2015",9,9,0,105744.444444444,979.222222222222,107.222222222222
"11459","36129","2015",8,8,0,76125,851.875,77.75
"11460","36130","2015",2,2,0,227750,1148,170.5
"11461","36131","2015",5,5,0,111000,1461,102
"11462","36133","2015",2,2,0,43750,1264.5,41
"11463","36134","2015",8,8,0,70030.875,795.5,93.125
"11464","36135","2015",2,2,0,35000,574,61
"11465","36136","2015",2,2,0,136000,1197.5,117.5
"11466","36137","2015",3,3,0,77500,995.333333333333,79.3333333333333
"11467","36138","2015",1,1,0,110000,759,145
"11468","36139","2015",8,8,0,115600,1017.75,114.125
"11469","36140","2015",14,14,0,101035.714285714,1141,90.7857142857143
"11470","36141","2015",12,12,0,76193,988.666666666667,80.3333333333333
"11471","36142","2015",18,18,0,120966.666666667,1271.11111111111,95.5
"11472","36143","2015",3,3,0,82166.6666666667,616.666666666667,129.666666666667
"11473","36144","2015",1,1,0,58000,921,63
"11474","36145","2015",3,3,0,73970,1068.33333333333,73.6666666666667
"11475","36146","2015",8,8,0,53625,818.5,70.625
"11476","36148","2015",5,5,0,62260,715.6,84.4
"11477","36149","2015",13,13,0,79392.3076923077,778,98.7692307692308
"11478","36150","2015",7,7,0,72334.2857142857,803.428571428571,88.8571428571429
"11479","36152","2015",6,6,0,80383.3333333333,871.5,89
"11480","36153","2015",4,4,0,63000,995.5,65.5
"11481","36154","2015",16,16,0,87843.75,958.875,97
"11482","36155","2015",10,10,0,81630,933.6,85.2
"11483","36156","2015",5,5,0,98850,718,121.2
"11484","36157","2015",4,4,0,114375,1316.75,82.75
"11485","36158","2015",8,7,1,60087.5,859.125,69.625
"11486","36159","2015",37,36,1,159454.054054054,1456.91891891892,116.756756756757
"11487","36160","2015",1,1,0,17500,547,32
"11488","36161","2015",5,5,0,67900,733,91.6
"11489","36162","2015",10,10,0,83292,923.8,93.5
"11490","36163","2015",8,8,0,89875,1105.875,82
"11491","36164","2015",3,3,0,101956.333333333,1030.33333333333,95
"11492","36165","2015",11,11,0,112109.090909091,1119.09090909091,101.636363636364
"11493","36166","2015",2,2,0,251100,4765.5,51
"11494","36167","2015",3,3,0,71000,868,74.6666666666667
"11495","36168","2015",7,7,0,110416.428571429,1087.71428571429,107
"11496","36169","2015",7,7,0,67785.7142857143,889.285714285714,74.5714285714286
"11497","36170","2015",1,1,0,60000,1091,55
"11498","36171","2015",20,20,0,81455,875.8,92.55
"11499","36172","2015",6,6,0,82808.3333333333,773.5,116.333333333333
"11500","36173","2015",7,7,0,76514.2857142857,716.857142857143,105.428571428571
"11501","36174","2015",3,3,0,46000,718.333333333333,64
"11502","36175","2015",2,2,0,54000,1188,64
"11503","36176","2015",2,2,0,163200,1650,98
"11504","36177","2015",4,4,0,55250,762.75,71.75
"11505","36178","2015",1,1,0,170000,1466,116
"11506","36179","2015",2,2,0,127500,1886.5,75.5
"11507","36180","2015",5,5,0,80200,931.8,82.6
"11508","36181","2015",2,2,0,77000,795,95.5
"11509","36182","2015",9,9,0,56876,765.777777777778,76.8888888888889
"11510","36184","2015",4,4,0,108125,865,117.25
"11511","36185","2015",3,3,0,59000,629,92.3333333333333
"11512","36186","2015",4,4,0,89000,993.25,86.5
"11513","36187","2015",1,1,0,33000,589,56
"11514","36189","2015",6,6,0,65333.3333333333,931.333333333333,77.8333333333333
"11515","36191","2015",4,4,0,84325,975.75,93
"11516","36192","2015",15,15,0,73026.6666666667,933.666666666667,81.7333333333333
"11517","36193","2015",2,2,0,86250,969.5,87.5
"11518","36194","2015",8,8,0,112062.5,990.375,117
"11519","36195","2015",6,6,0,110416.666666667,1327.83333333333,90.1666666666667
"11520","36196","2015",1,1,0,24000,490,49
"11521","36197","2015",1,1,0,63000,636,99
"11522","36198","2015",1,1,0,70000,700,100
"11523","36199","2015",2,2,0,106500,1253.5,82
"11524","36200","2015",21,20,1,73190.4761904762,1026.19047619048,69.6190476190476
"11525","36202","2015",24,24,0,134114.583333333,1210.91666666667,114
"11526","36204","2015",1,1,0,89300,835,107
"11527","36205","2015",1,1,0,224500,1871,120
"11528","36207","2015",17,17,0,66168.2941176471,903.823529411765,84.4705882352941
"11529","36208","2015",3,3,0,84666.6666666667,1141,70.3333333333333
"11530","36209","2015",3,3,0,88333.3333333333,921.333333333333,106.666666666667
"11531","36211","2015",2,2,0,102540,1026.5,104
"11532","36212","2015",1,1,0,75000,500,150
"11533","36213","2015",5,5,0,118655,1024.6,114.8
"11534","36214","2015",2,2,0,83040,898.5,95
"11535","36215","2015",4,4,0,97375,1141.25,85.25
"11536","36218","2015",4,4,0,82661.25,982.25,84
"11537","36219","2015",7,7,0,119285.714285714,1121.42857142857,106.714285714286
"11538","36220","2015",10,10,0,84520,938.6,90.5
"11539","36221","2015",1,1,0,95000,754,126
"11540","36223","2015",1,1,0,35000,500,70
"11541","36224","2015",12,12,0,64925,738.25,85.75
"11542","36225","2015",1,1,0,91000,1083,84
"11543","36226","2015",3,3,0,49333.3333333333,775.333333333333,67
"11544","36227","2015",4,4,0,74000,686.75,122.5
"11545","36228","2015",20,19,1,84040,1064.55,77.35
"11546","36229","2015",18,17,1,73023.3333333333,915.166666666667,75.1666666666667
"11547","36230","2015",22,22,0,78361.3636363636,862.409090909091,90.8181818181818
"11548","36231","2015",9,9,0,125156.222222222,1414.44444444444,89.5555555555556
"11549","36232","2015",11,11,0,79418.1818181818,1062.81818181818,76.7272727272727
"11550","36233","2015",10,10,0,91850,837.2,121.7
"11551","36234","2015",3,3,0,84333.3333333333,1039.66666666667,79.6666666666667
"11552","36235","2015",1,1,0,91500,654,140
"11553","36236","2015",2,2,0,54500,899.5,62.5
"11554","36237","2015",10,10,0,67660,794.8,84.3
"11555","36238","2015",3,3,0,89000.6666666667,941.666666666667,87.3333333333333
"11556","36239","2015",7,7,0,76857.1428571429,1007.57142857143,76.8571428571429
"11557","36240","2015",3,3,0,73666.6666666667,786.666666666667,99.6666666666667
"11558","36241","2015",20,20,0,88118.3,994.95,90.25
"11559","36242","2015",1,1,0,130000,1300,100
"11560","36243","2015",7,7,0,60300,761.285714285714,76.4285714285714
"11561","36244","2015",5,5,0,61400,1566.4,67.8
"11562","36247","2015",7,7,0,93071.4285714286,948.571428571429,102
"11563","36248","2015",4,4,0,86500,1051.5,86.5
"11564","37001","2015",9,9,0,140044.444444444,1349,100.111111111111
"11565","37002","2015",18,18,0,137246.055555556,1461.22222222222,96.7777777777778
"11566","37003","2015",142,117,25,174095.26056338,1998.49295774648,89.2957746478873
"11567","37004","2015",4,4,0,109975,1084.75,125.75
"11568","37005","2015",4,4,0,103750,1257.75,79.5
"11569","37006","2015",38,37,1,194279.473684211,1919.44736842105,104.315789473684
"11570","37007","2015",1,1,0,197500,737,268
"11571","37008","2015",23,23,0,179675.173913043,2175.04347826087,91.4782608695652
"11572","37009","2015",4,4,0,125750,1275.75,97.75
"11573","37010","2015",17,17,0,150639.823529412,1523.47058823529,108.764705882353
"11574","37011","2015",9,7,2,150888.888888889,1547.88888888889,101.111111111111
"11575","37012","2015",6,6,0,115716.666666667,1336.83333333333,90.8333333333333
"11576","37013","2015",1,1,0,50000,781,64
"11577","37014","2015",34,32,2,139698.352941176,1569.38235294118,90.2941176470588
"11578","37015","2015",27,27,0,187680.740740741,1979.37037037037,101
"11579","37016","2015",3,3,0,86166.6666666667,875,106
"11580","37018","2015",79,66,13,222172.556962025,2228.25316455696,101.708860759494
"11581","37019","2015",7,7,0,89340.2857142857,862.285714285714,106.142857142857
"11582","37020","2015",11,11,0,110480.909090909,1438.90909090909,76.9090909090909
"11583","37021","2015",16,16,0,158903.125,1695.9375,98.9375
"11584","37022","2015",17,17,0,140866.352941176,1771.47058823529,79.7058823529412
"11585","37023","2015",2,2,0,111500,1492,73.5
"11586","37024","2015",14,14,0,119642.857142857,1383.92857142857,92.1428571428571
"11587","37025","2015",8,8,0,197832.5,1946.5,104.625
"11588","37026","2015",5,5,0,73100,874.2,84.8
"11589","37027","2015",50,48,2,178630,1786.22,101.78
"11590","37028","2015",10,10,0,90500,1033.4,89.6
"11591","37029","2015",5,5,0,103400,1081.4,103.8
"11592","37030","2015",8,8,0,120375,1270.625,96.625
"11593","37031","2015",34,34,0,151802.058823529,1602.14705882353,98.4117647058823
"11594","37032","2015",3,3,0,107333.333333333,1091.33333333333,104.333333333333
"11595","37033","2015",2,2,0,138500,1269.5,103
"11596","37034","2015",2,2,0,132500,1509,78.5
"11597","37035","2015",3,3,0,85000,842.666666666667,91
"11598","37036","2015",1,1,0,65000,730,89
"11599","37037","2015",3,2,1,92666.6666666667,1520,72.6666666666667
"11600","37038","2015",10,10,0,118780,1128.9,103.9
"11601","37039","2015",7,7,0,94500,1158.57142857143,81.4285714285714
"11602","37040","2015",2,2,0,100500,1056.5,93
"11603","37041","2015",3,3,0,117666.666666667,1167.33333333333,101
"11604","37042","2015",3,3,0,139333.333333333,1186.66666666667,113
"11605","37043","2015",7,7,0,128857.142857143,1555.57142857143,85.4285714285714
"11606","37044","2015",5,5,0,91800,848.6,106.4
"11607","37045","2015",4,4,0,120000,1033.25,109.5
"11608","37046","2015",2,2,0,62700,769.5,83.5
"11609","37047","2015",14,14,0,200710,1873.85714285714,119.785714285714
"11610","37048","2015",3,3,0,120000,2190.66666666667,56.3333333333333
"11611","37049","2015",7,7,0,173651.428571429,1559.71428571429,112.142857142857
"11612","37050","2015",154,65,89,155713.681818182,2049.34415584416,77.3116883116883
"11613","37051","2015",8,8,0,77000,1084.25,70.875
"11614","37052","2015",11,11,0,159596.818181818,1725.81818181818,92.5454545454545
"11615","37053","2015",1,1,0,123200,1232,100
"11616","37054","2015",32,32,0,205023.4375,2013.09375,104.65625
"11617","37055","2015",10,10,0,93850,1254.4,73.5
"11618","37056","2015",6,6,0,149833.333333333,1454.33333333333,122.833333333333
"11619","37057","2015",5,5,0,145000,1356.2,113.6
"11620","37058","2015",12,12,0,129250,1522.25,86.3333333333333
"11621","37059","2015",10,9,1,174270,1410.3,119.6
"11622","37060","2015",15,15,0,180733.333333333,1982.2,93.8
"11623","37061","2015",4,4,0,69750,743,94.75
"11624","37062","2015",26,26,0,106403.269230769,1251.19230769231,88.7307692307692
"11625","37063","2015",38,36,2,114587.631578947,1426.23684210526,85.3947368421053
"11626","37064","2015",5,5,0,88330,914,113.6
"11627","37065","2015",3,3,0,83333.3333333333,1033.33333333333,88.6666666666667
"11628","37066","2015",5,5,0,82700,1263,75.4
"11629","37067","2015",11,11,0,148913.636363636,1537.72727272727,101.363636363636
"11630","37068","2015",1,1,0,60000,896,67
"11631","37069","2015",2,2,0,312500,2246,135
"11632","37070","2015",5,5,0,182000,1635,119.8
"11633","37071","2015",1,1,0,2e+05,1042,192
"11634","37072","2015",70,60,10,139865.085714286,1677.28571428571,90.7714285714286
"11635","37073","2015",7,7,0,135428.571428571,1289.14285714286,103.571428571429
"11636","37074","2015",26,26,0,124119.423076923,1366.69230769231,92.3076923076923
"11637","37075","2015",4,4,0,105500,1294.25,78.25
"11638","37076","2015",1,1,0,180000,2647,68
"11639","37077","2015",44,44,0,164036.363636364,1692.29545454545,99.5681818181818
"11640","37078","2015",1,1,0,60000,652,92
"11641","37079","2015",26,26,0,174957.692307692,1850.11538461538,103.153846153846
"11642","37080","2015",2,2,0,72050,1235.5,59
"11643","37081","2015",17,17,0,156147.058823529,1494.41176470588,105.705882352941
"11644","37082","2015",4,4,0,115665.75,1116,105.75
"11645","37083","2015",24,24,0,135139.041666667,1429.29166666667,98.5416666666667
"11646","37084","2015",4,4,0,114500,2100.75,83
"11647","37085","2015",11,11,0,123527.272727273,1556.45454545455,75.7272727272727
"11648","37086","2015",6,6,0,124666.666666667,1618.33333333333,81.3333333333333
"11649","37087","2015",2,2,0,126000,1289,98
"11650","37088","2015",1,1,0,146000,1217,120
"11651","37089","2015",3,3,0,131000,1524.33333333333,86
"11652","37091","2015",27,27,0,146416.296296296,1560.55555555556,97.1851851851852
"11653","37092","2015",4,4,0,163625,1735.75,95.25
"11654","37093","2015",2,2,0,155000,1079.5,145.5
"11655","37094","2015",6,6,0,93166.6666666667,1272.66666666667,72
"11656","37095","2015",4,4,0,84125,1122.5,79.75
"11657","37096","2015",12,12,0,169666.666666667,1550.66666666667,113.166666666667
"11658","37097","2015",8,8,0,151072.5,1459.25,103
"11659","37098","2015",6,6,0,98000,1210.5,85.6666666666667
"11660","37099","2015",9,9,0,171568.555555556,1855.44444444444,100.444444444444
"11661","37100","2015",5,5,0,116400,1141.8,98.4
"11662","37101","2015",2,2,0,80500,1058,75.5
"11663","37104","2015",50,50,0,204711.4,2190.18,99.5
"11664","37105","2015",3,3,0,119000,1268,99
"11665","37106","2015",1,1,0,139931,1572,89
"11666","37107","2015",6,6,0,83541.6666666667,676.5,119.666666666667
"11667","37108","2015",4,4,0,143750,1434,109
"11668","37109","2015",83,83,0,263896.168674699,2245.78313253012,121.072289156627
"11669","37110","2015",21,21,0,164161.904761905,1462.85714285714,112.761904761905
"11670","37111","2015",21,21,0,129791.952380952,1205.28571428571,106.809523809524
"11671","37112","2015",5,5,0,142600,1031.4,130.8
"11672","37113","2015",2,2,0,50000,631,81.5
"11673","37114","2015",1,1,0,108000,3857,28
"11674","37115","2015",37,32,5,75798.6486486487,913,80.4594594594595
"11675","37116","2015",8,8,0,79000,1212.125,65
"11676","37117","2015",10,10,0,134700,1228.1,114.6
"11677","37118","2015",17,17,0,134800,1257.58823529412,115
"11678","37119","2015",20,17,3,91623.05,1053.35,88.6
"11679","37121","2015",3,3,0,101151.666666667,1461,80.3333333333333
"11680","37122","2015",347,177,170,142723.971181556,1885.06916426513,75.3919308357349
"11681","37123","2015",42,42,0,151303.80952381,1560.54761904762,101.380952380952
"11682","37124","2015",18,16,2,223135.555555556,2199.61111111111,110.055555555556
"11683","37125","2015",4,4,0,111750,1385,88.25
"11684","37126","2015",4,4,0,67500,1302,77.75
"11685","37127","2015",1,1,0,120000,1765,68
"11686","37128","2015",7,7,0,143435.714285714,1475.57142857143,103.857142857143
"11687","37129","2015",12,12,0,101126.083333333,1421.41666666667,88.0833333333333
"11688","37130","2015",15,14,1,127256.666666667,1222.6,97.2
"11689","37131","2015",20,20,0,146673.15,1840.2,84.45
"11690","37132","2015",63,58,5,108011.111111111,1395.77777777778,78.0952380952381
"11691","37133","2015",8,8,0,151225,1300.75,120.75
"11692","37134","2015",9,9,0,155777.777777778,1411.88888888889,132.888888888889
"11693","37136","2015",8,8,0,143000,1891,98.875
"11694","37137","2015",2,2,0,108500,1016,108.5
"11695","37138","2015",10,10,0,143720,1730.2,83.4
"11696","37139","2015",32,29,3,213949.0625,2055.09375,106.625
"11697","37140","2015",2,2,0,61250,1025,62.5
"11698","37141","2015",9,9,0,186355.555555556,1470.77777777778,127
"11699","37142","2015",2,2,0,114000,1233.5,87
"11700","37143","2015",10,10,0,121450,1041,115.8
"11701","37144","2015",5,5,0,104400,1075.8,94.4
"11702","37146","2015",2,2,0,80000,883.5,101.5
"11703","37147","2015",4,3,1,80500,871.5,91
"11704","37148","2015",3,3,0,46333.3333333333,597.333333333333,71.3333333333333
"11705","37149","2015",4,4,0,132000,1306.5,100.5
"11706","37150","2015",14,14,0,157518.571428571,1465.21428571429,113
"11707","37151","2015",29,26,3,208059.172413793,2175,101.275862068966
"11708","37152","2015",12,12,0,179583.333333333,1878.83333333333,95.5
"11709","37153","2015",36,34,2,176231.027777778,1726.27777777778,106.444444444444
"11710","37154","2015",47,43,4,186107.85106383,1988.10638297872,96.3617021276596
"11711","37155","2015",8,8,0,140812.5,1414.75,105.75
"11712","37156","2015",109,99,10,187905.669724771,1996.36697247706,97.302752293578
"11713","37157","2015",2,2,0,158377,1396,110.5
"11714","37158","2015",8,8,0,197433.125,1422.5,146.375
"11715","37159","2015",76,69,7,175125.776315789,1862.94736842105,99.9210526315789
"11716","37160","2015",1,1,0,1e+05,1370,73
"11717","37161","2015",4,4,0,150750,1794.75,82
"11718","37162","2015",3,3,0,116333.333333333,1845.33333333333,72
"11719","37163","2015",36,36,0,161817.777777778,1806.38888888889,95.0833333333333
"11720","37165","2015",11,11,0,120651.363636364,1213.36363636364,109.272727272727
"11721","37166","2015",3,3,0,113000,976.333333333333,122
"11722","37167","2015",15,15,0,143886.666666667,1587.33333333333,98.4666666666667
"11723","37168","2015",1,1,0,70000,795,88
"11724","37169","2015",12,12,0,143600,1550.83333333333,92
"11725","37170","2015",11,11,0,133369.090909091,1110,119.636363636364
"11726","37171","2015",14,14,0,122757.142857143,1888.5,76.8571428571429
"11727","37172","2015",23,23,0,212473.739130435,1975.47826086957,108.695652173913
"11728","37173","2015",8,8,0,77977.25,885.75,85.625
"11729","37174","2015",11,11,0,106818.181818182,1291.09090909091,84.8181818181818
"11730","37175","2015",9,9,0,166583.333333333,1353.88888888889,124.333333333333
"11731","37176","2015",9,9,0,163062,1748.22222222222,97.4444444444444
"11732","37177","2015",6,6,0,118583.333333333,1138.5,100.5
"11733","37178","2015",7,7,0,127857.142857143,1279.14285714286,103.285714285714
"11734","37179","2015",12,12,0,220283.333333333,2033.5,108.833333333333
"11735","37180","2015",4,4,0,43500,816,61.5
"11736","37181","2015",2,2,0,125000,1371.5,105
"11737","37182","2015",14,14,0,204085.714285714,1914.78571428571,110.785714285714
"11738","37183","2015",10,8,2,136438,1463.3,89.5
"11739","37184","2015",4,4,0,99950,1134,95.25
"11740","37185","2015",9,9,0,172649.888888889,1661,107.222222222222
"11741","37186","2015",14,14,0,195274.714285714,1820.64285714286,109.428571428571
"11742","37187","2015",1,1,0,50000,833,60
"11743","37188","2015",9,9,0,102153.333333333,1065.66666666667,95.7777777777778
"11744","37189","2015",14,13,1,74623.9285714286,802.571428571429,93.9285714285714
"11745","37190","2015",1,1,0,20000,333,60
"11746","37191","2015",2,2,0,65000,847,87
"11747","37192","2015",11,10,1,148818.181818182,1664.90909090909,95.4545454545455
"11748","37193","2015",7,7,0,147428.571428571,1369,115.142857142857
"11749","37194","2015",17,17,0,182619.411764706,1563.94117647059,119.352941176471
"11750","37195","2015",158,41,117,132874.53164557,2031.89873417722,66.620253164557
"11751","37196","2015",17,13,4,109095.882352941,1111.76470588235,95.1764705882353
"11752","37197","2015",5,5,0,84500,1275.2,68
"11753","37198","2015",3,3,0,90000,1645,52.6666666666667
"11754","37199","2015",6,6,0,107750,1056.5,91.1666666666667
"11755","37200","2015",10,9,1,151440,1256.4,126.2
"11756","37201","2015",3,3,0,135500,1606.33333333333,93
"11757","37202","2015",3,3,0,113536.666666667,1941.33333333333,61.3333333333333
"11758","37203","2015",29,25,4,212510.206896552,2353.31034482759,91.6206896551724
"11759","37204","2015",12,12,0,146415.166666667,1801.58333333333,79.3333333333333
"11760","37205","2015",6,6,0,156083.333333333,1685.66666666667,92.5
"11761","37206","2015",12,12,0,194218.333333333,1743.25,114.333333333333
"11762","37207","2015",5,5,0,107800,934.4,119.6
"11763","37208","2015",163,126,37,221618.564417178,2272.40490797546,99.7361963190184
"11764","37210","2015",3,3,0,176700,1785.33333333333,98.6666666666667
"11765","37211","2015",26,26,0,210974.961538462,1801.07692307692,121.192307692308
"11766","37212","2015",4,4,0,89906.25,794,107
"11767","37213","2015",8,8,0,99125,1129.875,89.375
"11768","37214","2015",227,131,96,210618.894273128,2367.19383259912,88.2599118942731
"11769","37216","2015",13,13,0,143599.230769231,1269.53846153846,116.307692307692
"11770","37217","2015",18,18,0,174714.666666667,1984.5,93.7777777777778
"11771","37218","2015",10,10,0,75850,878.8,85.3
"11772","37219","2015",8,8,0,224950,2054.625,109.375
"11773","37220","2015",7,7,0,112429.714285714,1113.85714285714,102.714285714286
"11774","37221","2015",10,10,0,97920,1067.8,86.7
"11775","37222","2015",8,8,0,96850,1227.75,77
"11776","37223","2015",1,1,0,76000,1188,64
"11777","37224","2015",7,7,0,138071.428571429,1289.85714285714,114.571428571429
"11778","37225","2015",36,36,0,159562.5,1834.80555555556,98.0833333333333
"11779","37226","2015",52,50,2,131185.576923077,1431.44230769231,91.7692307692308
"11780","37228","2015",6,6,0,147501.166666667,1173.83333333333,130.666666666667
"11781","37229","2015",1,1,0,140000,2333,60
"11782","37230","2015",9,9,0,261238.888888889,2275.44444444444,128.111111111111
"11783","37231","2015",25,24,1,109144.96,1168.16,102.2
"11784","37232","2015",26,26,0,134784.615384615,1323.26923076923,106.769230769231
"11785","37233","2015",140,96,44,138419.278571429,1813.85714285714,78.7571428571429
"11786","37234","2015",4,4,0,96500,1294,87.75
"11787","37236","2015",3,3,0,234333.333333333,2297.33333333333,104.333333333333
"11788","37237","2015",13,13,0,272900,2167.30769230769,125.384615384615
"11789","37238","2015",4,4,0,1e+05,1066.5,99.5
"11790","37240","2015",2,2,0,156000,1374.5,113.5
"11791","37241","2015",10,10,0,130700,1419.2,96.9
"11792","37242","2015",11,11,0,93711.9090909091,1373.54545454545,67.3636363636364
"11793","37243","2015",29,29,0,212476.413793103,1826.27586206897,118.965517241379
"11794","37244","2015",2,2,0,122500,1596,76.5
"11795","37245","2015",19,19,0,188813.157894737,1927.26315789474,100.052631578947
"11796","37246","2015",4,4,0,107200,1013.25,110.5
"11797","37247","2015",4,4,0,88250,1238.75,65.75
"11798","37248","2015",7,7,0,163957.142857143,1240.85714285714,134.285714285714
"11799","37249","2015",7,7,0,137285.714285714,1724.28571428571,82
"11800","37250","2015",23,22,1,226805,2007.30434782609,118.04347826087
"11801","37251","2015",8,7,1,115437.5,1770,73.75
"11802","37252","2015",7,7,0,122142.857142857,1266.28571428571,93
"11803","37253","2015",3,3,0,181133.333333333,2334,82
"11804","37254","2015",10,10,0,125730,1471.3,90.5
"11805","37255","2015",3,3,0,75933.3333333333,1025.66666666667,77.6666666666667
"11806","37256","2015",3,3,0,141333.333333333,1206.33333333333,118.333333333333
"11807","37257","2015",13,13,0,199371.538461538,1855.84615384615,110.538461538462
"11808","37258","2015",2,2,0,205000,1453,145
"11809","37259","2015",2,2,0,74500,1090,68
"11810","37260","2015",3,3,0,133000,1269.33333333333,118.666666666667
"11811","37261","2015",1759,473,1286,154313.971006254,2315.4525298465,67.2791358726549
"11812","37262","2015",1,1,0,40000,488,82
"11813","37263","2015",30,30,0,183455.833333333,1903.1,98.7333333333333
"11814","37264","2015",12,12,0,147615.833333333,1500.16666666667,103.583333333333
"11815","37265","2015",3,3,0,102333.333333333,1046.33333333333,85.3333333333333
"11816","37266","2015",63,62,1,171992.317460317,1915,91.5396825396825
"11817","37267","2015",37,37,0,212486.081081081,1928.08108108108,116.162162162162
"11818","37269","2015",1,1,0,55000,519,106
"11819","37270","2015",14,13,1,188788.428571429,1633.64285714286,122.285714285714
"11820","37271","2015",5,5,0,84800,1170.8,68.8
"11821","37272","2015",12,12,0,166409.666666667,1611.16666666667,106.916666666667
"11822","37273","2015",45,39,6,181563.088888889,2009.6,92.8666666666667
"11823","37274","2015",5,5,0,75560,1407,54.2
"11824","37275","2015",1,1,0,149999,1079,139
"11825","37276","2015",11,11,0,145889.090909091,1512.90909090909,95.1818181818182
"11826","37277","2015",9,9,0,97888.8888888889,871.777777777778,104.111111111111
"11827","37278","2015",7,7,0,152362.857142857,1967.85714285714,79.7142857142857
"11828","37279","2015",8,8,0,113737.5,1341.5,87.125
"11829","37280","2015",5,5,0,99000,984.6,114.2
"11830","37281","2015",34,28,6,187504.029411765,2147.73529411765,93.7941176470588
"11831","37282","2015",6,6,0,79500,897.666666666667,85.6666666666667
"11832","38001","2015",72,52,20,144550.444444444,1546.875,94.4444444444444
"11833","38002","2015",41,4,37,104428.463414634,2490.70731707317,37.7560975609756
"11834","38003","2015",9,9,0,207111.111111111,1851.77777777778,118.666666666667
"11835","38004","2015",15,11,4,123916.666666667,1424.06666666667,89.8
"11836","38005","2015",15,7,8,140326.666666667,2203.26666666667,57.4666666666667
"11837","38006","2015",83,24,59,93490.2289156627,1496.30120481928,60.710843373494
"11838","38009","2015",5,5,0,172550,1883.2,92.8
"11839","38010","2015",3,3,0,180666.666666667,2195.66666666667,84.6666666666667
"11840","38011","2015",9,5,4,247306.666666667,2560.44444444444,97.7777777777778
"11841","38012","2015",31,30,1,175836.129032258,1897.25806451613,95.7096774193548
"11842","38013","2015",37,33,4,197129.594594595,1979.91891891892,101.810810810811
"11843","38015","2015",18,18,0,190180.277777778,1734.38888888889,113.388888888889
"11844","38017","2015",12,12,0,191158.333333333,2153.58333333333,91.9166666666667
"11845","38018","2015",3,3,0,138866.666666667,1507.33333333333,90
"11846","38019","2015",16,14,2,168860.3125,1728.625,97.5625
"11847","38020","2015",19,2,17,80069.3684210526,2250.36842105263,34.4210526315789
"11848","38022","2015",84,66,18,138784.714285714,1547.77380952381,91.3095238095238
"11849","38023","2015",1,1,0,125000,1190,105
"11850","38026","2015",9,7,2,176993.333333333,1507.88888888889,116.666666666667
"11851","38027","2015",19,18,1,227940.736842105,2308,102.052631578947
"11852","38029","2015",14,13,1,158815,1825.07142857143,97.7857142857143
"11853","38030","2015",7,6,1,186642.857142857,2336.71428571429,92.4285714285714
"11854","38032","2015",5,5,0,129800,1476.2,95
"11855","38033","2015",5,5,0,223504.2,1783,127
"11856","38034","2015",44,37,7,136128.295454545,1473.97727272727,93.4318181818182
"11857","38035","2015",6,6,0,191050,1767.16666666667,107.5
"11858","38036","2015",2,2,0,130000,1048,126
"11859","38037","2015",4,4,0,163812.5,1806.5,101.5
"11860","38038","2015",5,5,0,180934,1899.4,95.4
"11861","38039","2015",25,23,2,369480,3493.2,106.8
"11862","38042","2015",11,11,0,185525.454545455,1673.09090909091,114.090909090909
"11863","38043","2015",12,10,2,217928.083333333,2697.16666666667,89
"11864","38044","2015",9,9,0,159688.888888889,1517.66666666667,106.555555555556
"11865","38045","2015",15,13,2,438787.333333333,3570.13333333333,123.333333333333
"11866","38046","2015",8,8,0,161612.5,1563,106
"11867","38048","2015",7,6,1,191721.428571429,2455,78.5714285714286
"11868","38049","2015",3,3,0,128561.666666667,1843,80.6666666666667
"11869","38050","2015",11,11,0,168484.090909091,1564.63636363636,108.727272727273
"11870","38051","2015",7,5,2,138142.857142857,1729.42857142857,77.4285714285714
"11871","38052","2015",40,27,13,150039.525,1984.75,77.4
"11872","38053","2015",332,113,219,147029.746987952,1878.81626506024,78.9487951807229
"11873","38054","2015",11,11,0,164169.090909091,1700.54545454545,90.4545454545455
"11874","38055","2015",6,6,0,139166.666666667,1440.5,128.833333333333
"11875","38057","2015",8,5,3,292562.5,3059.375,93
"11876","38058","2015",17,15,2,148721.235294118,1524.88235294118,100
"11877","38059","2015",19,13,6,339436.578947368,3111.68421052632,109.526315789474
"11878","38061","2015",33,15,18,235038.03030303,2575.36363636364,91.6363636363636
"11879","38062","2015",5,4,1,187465.8,2026.4,94.2
"11880","38063","2015",2,2,0,160105,1806,88.5
"11881","38064","2015",28,28,0,208575.178571429,1937.5,111.642857142857
"11882","38065","2015",16,14,2,148705.625,1621.25,105
"11883","38066","2015",1,1,0,241400,2367,102
"11884","38067","2015",16,11,5,218036.5625,1921.25,116.75
"11885","38068","2015",7,6,1,335651.428571429,3125.42857142857,107.285714285714
"11886","38069","2015",17,15,2,138238.235294118,1509.82352941176,106
"11887","38070","2015",17,11,6,192837.058823529,2239.88235294118,85.4705882352941
"11888","38071","2015",33,27,6,219075.636363636,2540.87878787879,86.9393939393939
"11889","38072","2015",20,19,1,185420,1923.05,103.15
"11890","38073","2015",4,4,0,89600,1377.75,65.5
"11891","38074","2015",1,1,0,263000,2248,117
"11892","38075","2015",18,15,3,224894.722222222,2208,102.277777777778
"11893","38076","2015",19,18,1,160773.157894737,1621.05263157895,98.8421052631579
"11894","38077","2015",4,4,0,210000,1696,121.75
"11895","38078","2015",1,1,0,124000,2067,60
"11896","38080","2015",5,5,0,181530,1566,112.6
"11897","38081","2015",19,16,3,200495.263157895,2074.68421052632,98.6842105263158
"11898","38082","2015",27,21,6,158872.592592593,1587.66666666667,106.296296296296
"11899","38083","2015",2,2,0,125500,897.5,135
"11900","38084","2015",11,11,0,261927.272727273,2123.09090909091,127.090909090909
"11901","38085","2015",87,74,13,201572.643678161,2075.71264367816,98.3218390804598
"11902","38086","2015",5,5,0,195950,1800.4,115.4
"11903","38087","2015",37,30,7,208773.675675676,2544.7027027027,85.1081081081081
"11904","38090","2015",3,3,0,106166.666666667,2496.66666666667,47.3333333333333
"11905","38091","2015",3,3,0,210500,1862,119.666666666667
"11906","38093","2015",6,6,0,190050,1424,144.666666666667
"11907","38094","2015",23,22,1,149402.52173913,1737.47826086957,89.3478260869565
"11908","38095","2015",25,23,2,219987.76,1790.6,120.48
"11909","38097","2015",35,30,5,200132.428571429,2356.05714285714,87.2
"11910","38098","2015",5,5,0,178520,1593.8,112
"11911","38099","2015",8,8,0,202009.75,1906.875,108.875
"11912","38100","2015",20,17,3,221576.75,2517.8,97.55
"11913","38101","2015",10,9,1,160260,1863,89.5
"11914","38102","2015",4,4,0,200759,1936,110.5
"11915","38103","2015",1,1,0,127450,850,150
"11916","38104","2015",14,14,0,148655,1503.5,101.571428571429
"11917","38105","2015",15,14,1,214440,1852,116
"11918","38106","2015",3,3,0,266983.333333333,2188.33333333333,123.666666666667
"11919","38107","2015",10,6,4,176850,2041.7,87.6
"11920","38109","2015",11,11,0,213068.181818182,1897.63636363636,117.545454545455
"11921","38110","2015",37,34,3,255555.405405405,2565.83783783784,102.027027027027
"11922","38111","2015",66,43,23,278324.848484849,2805.21212121212,98.8484848484848
"11923","38113","2015",4,4,0,189295.5,1342,146.5
"11924","38114","2015",14,13,1,202456.428571429,2058.28571428571,99.2142857142857
"11925","38115","2015",6,5,1,169500,1923.16666666667,82.5
"11926","38117","2015",5,5,0,151250,1699.4,87.8
"11927","38118","2015",17,17,0,193802.117647059,1865.64705882353,105.411764705882
"11928","38120","2015",5,5,0,267735.2,2319.6,121.2
"11929","38124","2015",17,15,2,145225,1292.05882352941,118.882352941176
"11930","38126","2015",39,28,11,430786.384615385,3292.53846153846,133.487179487179
"11931","38127","2015",2,2,0,140675,1523,92
"11932","38128","2015",7,3,4,66600,1116.28571428571,66.2857142857143
"11933","38129","2015",22,5,17,147328.863636364,2684.90909090909,50.6818181818182
"11934","38130","2015",45,27,18,145140.711111111,1567.4,94.0444444444445
"11935","38131","2015",13,12,1,263413.076923077,2424.69230769231,106.307692307692
"11936","38132","2015",2,2,0,175000,1771,100
"11937","38133","2015",37,27,10,241341.945945946,2492.72972972973,98.5945945945946
"11938","38134","2015",6,6,0,165183.333333333,1651,99
"11939","38135","2015",9,9,0,160633.333333333,1555.44444444444,108.555555555556
"11940","38136","2015",5,5,0,148750,1289,111.4
"11941","38137","2015",3,3,0,286878.333333333,2117,156.666666666667
"11942","38138","2015",45,22,23,162550.111111111,2048.71111111111,76.8
"11943","38139","2015",26,26,0,166272.230769231,1744.26923076923,97.2307692307692
"11944","38140","2015",63,48,15,308596.920634921,3042.2380952381,103.222222222222
"11945","38141","2015",5,5,0,217298,1939.4,115.4
"11946","38144","2015",22,19,3,209785.045454545,2453.59090909091,98.5454545454545
"11947","38146","2015",18,18,0,213349.111111111,2248.83333333333,95.1666666666667
"11948","38147","2015",6,6,0,156608.333333333,1578.5,98.3333333333333
"11949","38148","2015",32,31,1,162607.84375,1684.25,103.78125
"11950","38149","2015",15,13,2,186197.333333333,1906.46666666667,104
"11951","38150","2015",67,18,49,179947.298507463,2491.34328358209,70.955223880597
"11952","38151","2015",312,33,279,151487.217948718,2090.33012820513,73.2852564102564
"11953","38152","2015",7,7,0,150209.285714286,1522.14285714286,97.2857142857143
"11954","38153","2015",2,2,0,371730,2467,152.5
"11955","38154","2015",2,2,0,202500,1275,165
"11956","38155","2015",12,11,1,155220.833333333,1723.16666666667,89.4166666666667
"11957","38156","2015",9,9,0,135317.666666667,1404.66666666667,103.333333333333
"11958","38157","2015",30,27,3,226005.266666667,2511.36666666667,89.0666666666667
"11959","38158","2015",105,20,85,187249.533333333,2612.78095238095,73.6952380952381
"11960","38159","2015",3,3,0,180916.666666667,1908.66666666667,102.333333333333
"11961","38160","2015",22,20,2,185571.363636364,1889.31818181818,99.8181818181818
"11962","38161","2015",4,3,1,161250,1388,105.5
"11963","38162","2015",14,14,0,161433.571428571,1772.35714285714,94.7142857142857
"11964","38163","2015",4,3,1,143453.75,1782.75,80.75
"11965","38166","2015",6,6,0,186020,1937.5,97.3333333333333
"11966","38167","2015",4,4,0,129554.5,1505,90.75
"11967","38169","2015",235,35,200,129909.434042553,1960.00425531915,65.8510638297872
"11968","38170","2015",29,8,21,231555.275862069,2706.75862068966,88.5862068965517
"11969","38171","2015",5,5,0,147630,1408.6,101.4
"11970","38172","2015",16,7,9,164963.5,1982.5,90.25
"11971","38173","2015",6,4,2,153545,1795.5,79.8333333333333
"11972","38174","2015",9,9,0,143809.444444444,1763.77777777778,83.7777777777778
"11973","38175","2015",23,11,12,214523.130434783,2417.08695652174,94.6521739130435
"11974","38176","2015",11,11,0,244240.909090909,2068,124.090909090909
"11975","38177","2015",4,3,1,96325,2169,43.75
"11976","38179","2015",74,20,54,203071.864864865,2810.60810810811,72.5135135135135
"11977","38180","2015",6,6,0,164191.666666667,1922,88.5
"11978","38181","2015",26,16,10,178473.846153846,2072.03846153846,88
"11979","38182","2015",27,21,6,167001.259259259,1575.77777777778,110.666666666667
"11980","38183","2015",3,3,0,144666.666666667,1508.66666666667,109.333333333333
"11981","38184","2015",23,18,5,231482.391304348,2385.21739130435,102.434782608696
"11982","38185","2015",2449,66,2383,145165.518170682,2340.06574111882,63.6598611678236
"11983","38186","2015",24,7,17,88816.25,1979.75,42.1666666666667
"11984","38187","2015",23,21,2,194154.652173913,2188.08695652174,87.2173913043478
"11985","38188","2015",9,7,2,396598.666666667,2986.55555555556,137.444444444444
"11986","38189","2015",45,34,11,206742.044444444,2375.66666666667,88.9333333333333
"11987","38190","2015",13,12,1,156853.846153846,1806,92.3846153846154
"11988","38191","2015",182,9,173,152840.005494505,3975.91758241758,37.0549450549451
"11989","38192","2015",2,2,0,252500,2485.5,101
"11990","38193","2015",144,100,44,170393.208333333,2210.1875,84.8333333333333
"11991","38194","2015",19,15,4,145361.894736842,1585.15789473684,96.7368421052632
"11992","38195","2015",4,4,0,105875,836.25,131.5
"11993","38197","2015",17,10,7,213921.117647059,2479.11764705882,85.8235294117647
"11994","38198","2015",6,6,0,113666.666666667,1222.16666666667,92.3333333333333
"11995","38199","2015",20,19,1,261389,2284.35,110.75
"11996","38200","2015",32,16,16,251732.96875,2632.6875,96.6875
"11997","38203","2015",8,5,3,106506.25,1598.625,72.75
"11998","38204","2015",2,2,0,51215,709.5,72
"11999","38205","2015",34,18,16,197061.764705882,3324.91176470588,64.0882352941177
"12000","38206","2015",8,8,0,295666.25,2680.5,113
"12001","38207","2015",3,3,0,91333.3333333333,2314.33333333333,56.3333333333333
"12002","38209","2015",4,4,0,157700,1421,118.25
"12003","38210","2015",13,13,0,205710.307692308,1994.61538461538,106.692307692308
"12004","38211","2015",8,8,0,190781.25,1575,125
"12005","38212","2015",8,8,0,75125,1092,73.5
"12006","38213","2015",7,7,0,134828.571428571,1225.85714285714,105.857142857143
"12007","38215","2015",21,20,1,272912.380952381,2630.90476190476,107.761904761905
"12008","38217","2015",1,1,0,60000,545,110
"12009","38218","2015",5,5,0,185110,1477.8,141.2
"12010","38219","2015",5,5,0,163423,1660,97.8
"12011","38221","2015",1,1,0,199500,1446,138
"12012","38222","2015",6,6,0,197938.333333333,1726.66666666667,123.666666666667
"12013","38223","2015",15,14,1,202974.666666667,2119.26666666667,96.6
"12014","38224","2015",2,2,0,126500,1545.5,79
"12015","38225","2015",41,18,23,153791.951219512,2311.63414634146,68.3170731707317
"12016","38226","2015",9,9,0,159961.111111111,1468.33333333333,107.555555555556
"12017","38228","2015",7,7,0,187075.714285714,1916.71428571429,105.857142857143
"12018","38229","2015",183,45,138,300764.459016393,3152.97267759563,92.1748633879781
"12019","38230","2015",4,4,0,239731.25,1815,136
"12020","38231","2015",15,15,0,165796.666666667,1639.8,100.133333333333
"12021","38232","2015",7,7,0,178914.285714286,1294.71428571429,140.285714285714
"12022","38236","2015",11,10,1,174941.818181818,1845.36363636364,95.8181818181818
"12023","38237","2015",3,1,2,154133.333333333,1807.33333333333,87.3333333333333
"12024","38238","2015",24,23,1,199409.583333333,1835.45833333333,110.833333333333
"12025","38239","2015",55,39,16,201992.254545455,2175.89090909091,92.0727272727273
"12026","38240","2015",3,3,0,158766.666666667,1712,93
"12027","38242","2015",11,9,2,176422.727272727,1578.18181818182,113.272727272727
"12028","38243","2015",2,1,1,131250,2846,45
"12029","38244","2015",9,9,0,177686.222222222,1703.66666666667,103.888888888889
"12030","38245","2015",2,2,0,153500,1716,85.5
"12031","38246","2015",10,10,0,167371.9,1599.2,103.5
"12032","38247","2015",45,36,9,140974.866666667,1591.2,90.2222222222222
"12033","38248","2015",3,3,0,246333.333333333,2072.33333333333,111.666666666667
"12034","38249","2015",53,25,28,318022.264150943,3358.43396226415,93.4716981132076
"12035","38250","2015",4,4,0,174250,1972.25,105.25
"12036","38253","2015",259,7,252,125620.563706564,3195.50193050193,37.9420849420849
"12037","38254","2015",7,7,0,123857.142857143,1588.71428571429,81
"12038","38255","2015",1,1,0,92000,1353,68
"12039","38256","2015",18,16,2,180549.944444444,2176.27777777778,93.7777777777778
"12040","38257","2015",3,3,0,145800,1339.33333333333,108.666666666667
"12041","38259","2015",5,5,0,162200,1558.4,110.6
"12042","38260","2015",1,1,0,135000,2143,63
"12043","38261","2015",43,27,16,150292.720930233,1669.23255813953,91.4186046511628
"12044","38263","2015",6,6,0,205491.666666667,1898.5,112.166666666667
"12045","38264","2015",13,2,11,67730.7692307692,1941.53846153846,32.2307692307692
"12046","38265","2015",24,20,4,125210.291666667,1568.20833333333,79.7083333333333
"12047","38266","2015",10,9,1,110600,1376.4,86
"12048","38267","2015",8,7,1,187181.25,1746.125,114.375
"12049","38268","2015",3,3,0,160761.666666667,1718.33333333333,91
"12050","38269","2015",48,26,22,108596.25,1484.14583333333,72.4375
"12051","38270","2015",13,12,1,244995.384615385,2104.30769230769,113.769230769231
"12052","38271","2015",5,5,0,289400,3318.2,86.4
"12053","38272","2015",2,1,1,166660,1877,88.5
"12054","38273","2015",6,6,0,150216.666666667,1663.16666666667,89.1666666666667
"12055","38275","2015",2,2,0,268950,1940.5,138.5
"12056","38276","2015",24,19,5,197109.166666667,2016.66666666667,104.291666666667
"12057","38277","2015",13,13,0,212282.153846154,2025.46153846154,109.923076923077
"12058","38278","2015",3,3,0,190166.666666667,1917.66666666667,98.3333333333333
"12059","38279","2015",10,9,1,267084,2356.8,113.7
"12060","38280","2015",7,7,0,124300,1492.14285714286,84.5714285714286
"12061","38281","2015",21,12,9,192420.476190476,2161.38095238095,87.4285714285714
"12062","38282","2015",7,7,0,142342.857142857,1539.14285714286,95.4285714285714
"12063","38284","2015",6,6,0,165570.833333333,1606.5,101.5
"12064","38285","2015",1,1,0,135000,1688,80
"12065","38287","2015",9,8,1,174611.666666667,1612.77777777778,109.555555555556
"12066","38288","2015",15,12,3,195254.133333333,2107.53333333333,100
"12067","38289","2015",15,4,11,178050.666666667,3608.13333333333,51.6666666666667
"12068","38290","2015",8,8,0,152962.5,1785.625,95.75
"12069","38291","2015",8,8,0,159546.25,1271.875,135.5
"12070","38292","2015",20,19,1,183563.5,1730.25,116.5
"12071","38294","2015",4,3,1,229485,1540,137.5
"12072","38295","2015",13,13,0,183071.923076923,1629,111.846153846154
"12073","38296","2015",7,7,0,178025.714285714,1712.71428571429,105.714285714286
"12074","38297","2015",20,16,4,132375.8,1592.1,83.85
"12075","38298","2015",54,29,25,113561.851851852,1456.31481481481,84.0740740740741
"12076","38299","2015",1,1,0,150000,2143,70
"12077","38300","2015",2,2,0,186650,818.5,233.5
"12078","38301","2015",1,1,0,162500,1890,86
"12079","38303","2015",4,4,0,328725,2309.5,125.5
"12080","38304","2015",17,15,2,166185.294117647,1756.11764705882,95.7647058823529
"12081","38307","2015",3,3,0,128333.333333333,1153.66666666667,110.666666666667
"12082","38308","2015",1,1,0,217000,1736,125
"12083","38309","2015",20,10,10,238228.85,2995.55,84.65
"12084","38310","2015",7,7,0,255371.428571429,2331.71428571429,117.428571428571
"12085","38311","2015",8,7,1,133043.75,1388.25,94.5
"12086","38313","2015",1,1,0,2e+05,1299,154
"12087","38314","2015",69,45,24,196962.623188406,2309.69565217391,87.7971014492754
"12088","38315","2015",35,12,23,129102.857142857,1433.05714285714,95.0857142857143
"12089","38316","2015",72,23,49,130882,1882.01388888889,69.0277777777778
"12090","38317","2015",103,14,89,118939.59223301,1775.72815533981,66.368932038835
"12091","38318","2015",41,18,23,139813.073170732,1695.78048780488,81.219512195122
"12092","38319","2015",3,3,0,124273.333333333,2099.33333333333,64
"12093","38320","2015",21,20,1,154201.666666667,1599.71428571429,97.5238095238095
"12094","38322","2015",1,1,0,114000,726,157
"12095","38323","2015",7,7,0,151939.285714286,1463.42857142857,103.571428571429
"12096","38324","2015",7,6,1,163246.571428571,1792.71428571429,92
"12097","38325","2015",3,3,0,165766.666666667,2535.33333333333,63.3333333333333
"12098","38326","2015",1,1,0,160000,1250,128
"12099","38328","2015",3,3,0,398678.333333333,2642,151
"12100","38329","2015",1,1,0,80000,1067,75
"12101","38330","2015",1,1,0,236400,1847,128
"12102","38331","2015",10,8,2,202217,1882.6,108.1
"12103","38332","2015",24,16,8,159514.791666667,1838.33333333333,88.125
"12104","38333","2015",5,4,1,151600,1471.8,111
"12105","38334","2015",11,10,1,278315.454545455,2108,135.636363636364
"12106","38335","2015",5,5,0,100202,1332.4,71.8
"12107","38336","2015",19,16,3,213761.578947368,1875.68421052632,120.157894736842
"12108","38337","2015",76,35,41,163042.539473684,2042.07894736842,84.3421052631579
"12109","38338","2015",8,8,0,170225,1997.25,88.375
"12110","38339","2015",12,10,2,213325.416666667,1862.33333333333,114.166666666667
"12111","38340","2015",22,14,8,143925.909090909,2123.77272727273,73.9545454545455
"12112","38341","2015",10,10,0,203716.2,1879.5,109.7
"12113","38342","2015",4,4,0,188250,1894.75,105.25
"12114","38343","2015",16,16,0,139912.5,1650.125,85.625
"12115","38344","2015",64,39,25,141137.578125,1637.109375,89.21875
"12116","38345","2015",8,8,0,183931.25,1888.625,97.75
"12117","38346","2015",4,4,0,228162.5,2120.5,111
"12118","38347","2015",5,5,0,164260,1625.6,104.2
"12119","38348","2015",39,36,3,210016.794871795,2049.74358974359,106.897435897436
"12120","38349","2015",16,16,0,185347.5,2015.1875,96.9375
"12121","38350","2015",2,2,0,208675,1693.5,124
"12122","38351","2015",7,7,0,152714.285714286,1417,105.571428571429
"12123","38352","2015",22,19,3,194656.363636364,2098.59090909091,100.545454545455
"12124","38353","2015",9,9,0,188603.333333333,1995.11111111111,94.5555555555556
"12125","38354","2015",6,6,0,168741.666666667,1489,119.666666666667
"12126","38355","2015",2,2,0,172000,1604.5,116.5
"12127","38356","2015",1,1,0,85000,1133,75
"12128","38357","2015",24,23,1,153031.25,1598.33333333333,100.125
"12129","38358","2015",9,8,1,181200,1873.44444444444,102.444444444444
"12130","38359","2015",7,5,2,131657.142857143,1326.85714285714,107
"12131","38360","2015",3,3,0,177261.666666667,1705,119.666666666667
"12132","38361","2015",1,1,0,167500,1196,140
"12133","38362","2015",6,6,0,183645.833333333,2010.66666666667,96.5
"12134","38363","2015",8,8,0,152118.75,1523.625,102.5
"12135","38364","2015",4,4,0,181250,2037.25,89.5
"12136","38365","2015",9,9,0,159465,1353.55555555556,119
"12137","38366","2015",4,4,0,158800,1695.25,101.25
"12138","38368","2015",2,2,0,232030,2448.5,94.5
"12139","38369","2015",11,11,0,187159.636363636,1942.18181818182,98.3636363636364
"12140","38370","2015",12,11,1,182108.75,1769.5,106.833333333333
"12141","38372","2015",9,8,1,142922.222222222,1460,100.888888888889
"12142","38373","2015",10,10,0,332817.9,2655,132
"12143","38374","2015",34,28,6,178716.588235294,2025.44117647059,89.2941176470588
"12144","38375","2015",1,0,1,50000,1852,27
"12145","38376","2015",10,9,1,171382,1559.3,108.7
"12146","38377","2015",47,36,11,151840.85106383,1779.23404255319,90.5744680851064
"12147","38378","2015",44,39,5,187644.363636364,1991.45454545455,95.9090909090909
"12148","38379","2015",3,3,0,159433.333333333,1791,84.6666666666667
"12149","38380","2015",3,3,0,114666.666666667,1433,84.6666666666667
"12150","38381","2015",12,11,1,201736.25,1871.58333333333,109.5
"12151","38382","2015",185,53,132,219396.594594595,2623.14594594595,81.9081081081081
"12152","38383","2015",23,20,3,219891.826086957,2202.39130434783,104.173913043478
"12153","38384","2015",34,22,12,173848.382352941,1993.85294117647,95.4411764705882
"12154","38386","2015",20,19,1,195802,1890.75,111.65
"12155","38387","2015",4,0,4,151750,1509.75,104.5
"12156","38388","2015",18,17,1,260233.888888889,2503.66666666667,105.055555555556
"12157","38389","2015",27,25,2,208291.888888889,1917.18518518519,109.962962962963
"12158","38390","2015",4,4,0,259673.75,2333,114
"12159","38391","2015",2,2,0,227375,1897.5,127
"12160","38392","2015",5,5,0,184964,3238.4,57.2
"12161","38393","2015",9,8,1,174883.333333333,1477.44444444444,119.555555555556
"12162","38394","2015",18,15,3,135357.222222222,1452.33333333333,96.8888888888889
"12163","38395","2015",29,28,1,245213.793103448,2667.89655172414,97.8965517241379
"12164","38396","2015",8,5,3,108426.25,1490.5,69.875
"12165","38397","2015",63,46,17,409024,3585.1746031746,116.333333333333
"12166","38398","2015",12,11,1,201780,1824.16666666667,107.916666666667
"12167","38399","2015",53,37,16,161296.79245283,1834.60377358491,97.9622641509434
"12168","38400","2015",20,16,4,199573.25,2138.75,96.85
"12169","38401","2015",16,16,0,178067.375,1635.9375,110.75
"12170","38402","2015",4,4,0,167250,1701.25,101.25
"12171","38403","2015",1,1,0,148000,1410,105
"12172","38404","2015",2,1,1,237500,2474.5,98.5
"12173","38405","2015",16,14,2,173240,1969.9375,91.9375
"12174","38406","2015",2,2,0,172000,1520,114.5
"12175","38407","2015",5,5,0,184320,1808.4,92.4
"12176","38408","2015",17,16,1,228097.058823529,2227.23529411765,111
"12177","38409","2015",11,11,0,167268.181818182,1734.81818181818,106.636363636364
"12178","38410","2015",8,7,1,187746.25,1685,115.5
"12179","38412","2015",36,28,8,160818.888888889,1840.52777777778,90.6388888888889
"12180","38413","2015",3,3,0,105033.333333333,1780.33333333333,58.3333333333333
"12181","38415","2015",5,5,0,250982,2421,115
"12182","38416","2015",110,32,78,128356.827272727,1627.09090909091,79.2090909090909
"12183","38417","2015",1,1,0,396210,1415,280
"12184","38418","2015",4,4,0,152425,2187.5,69.5
"12185","38420","2015",1,1,0,234000,2340,100
"12186","38421","2015",382,34,348,139946.657068063,2225.31937172775,64.3246073298429
"12187","38422","2015",72,41,31,277007.166666667,2838.65277777778,100.527777777778
"12188","38423","2015",67,15,52,185734.910447761,2272.0447761194,79.0597014925373
"12189","38425","2015",45,42,3,163056.911111111,1776.48888888889,93.2
"12190","38426","2015",5,5,0,247528,2447.6,96.4
"12191","38427","2015",1,1,0,105000,700,150
"12192","38429","2015",4,4,0,199397.5,2477,105.5
"12193","38430","2015",3,3,0,193123.333333333,2082,94.3333333333333
"12194","38431","2015",25,18,7,365336.8,3255.4,115
"12195","38432","2015",5,5,0,283083,2291.8,123.6
"12196","38433","2015",13,8,5,251235.769230769,2347.30769230769,104.923076923077
"12197","38434","2015",5,4,1,99130,926.6,113.6
"12198","38436","2015",11,11,0,286249.545454545,2690.72727272727,108.363636363636
"12199","38437","2015",2,2,0,175500,2046,86.5
"12200","38438","2015",1,1,0,95000,1056,90
"12201","38439","2015",25,24,1,182651,2074.08,90.04
"12202","38440","2015",6,6,0,158483.333333333,1432.16666666667,111
"12203","38442","2015",27,13,14,147136.851851852,2221.85185185185,66.2592592592593
"12204","38443","2015",1,1,0,197500,1646,120
"12205","38444","2015",1,1,0,19000,396,48
"12206","38445","2015",4,4,0,203750,2194.75,94
"12207","38446","2015",5,5,0,142138,1412.8,102.4
"12208","38448","2015",6,5,1,203358.333333333,2165,95
"12209","38449","2015",48,42,6,208367.9375,2249.60416666667,93.125
"12210","38450","2015",10,9,1,211298,2305.4,104.8
"12211","38451","2015",30,29,1,190975.5,1962.03333333333,98.3666666666667
"12212","38452","2015",3,3,0,214666.666666667,1795,122
"12213","38453","2015",8,6,2,186815,1997,94.875
"12214","38454","2015",18,17,1,180001.944444444,1923.22222222222,93.7222222222222
"12215","38455","2015",29,28,1,237287.931034483,2425,104.689655172414
"12216","38456","2015",5,5,0,118760,1186.4,104.8
"12217","38457","2015",30,25,5,152113.433333333,1611.2,95.6
"12218","38458","2015",5,5,0,186272.4,2211.4,89.8
"12219","38459","2015",9,9,0,246422.222222222,2155.88888888889,115.333333333333
"12220","38462","2015",6,6,0,180325.833333333,2222.5,91.1666666666667
"12221","38463","2015",13,11,2,173627.538461538,1778.15384615385,94.5384615384615
"12222","38464","2015",20,18,2,157983.25,1736.85,92.2
"12223","38465","2015",21,19,2,169629.523809524,1518.52380952381,114.52380952381
"12224","38466","2015",17,10,7,228106.176470588,2914.05882352941,80.1176470588235
"12225","38467","2015",11,11,0,197966,1960.63636363636,103.363636363636
"12226","38468","2015",29,23,6,198142.75862069,2018.79310344828,101.275862068966
"12227","38469","2015",2,2,0,86500,1774.5,50.5
"12228","38470","2015",5,5,0,114303,1822.2,76.6
"12229","38471","2015",11,8,3,251195.454545455,2755.81818181818,94.0909090909091
"12230","38472","2015",3,3,0,303966.666666667,2732.33333333333,114
"12231","38473","2015",10,9,1,148649,1613.5,97.3
"12232","38474","2015",139,36,103,190269.28057554,2502.73381294964,76.0791366906475
"12233","38475","2015",23,20,3,258860.869565217,2309.30434782609,111.173913043478
"12234","38476","2015",5,5,0,189000,2089.4,90.6
"12235","38478","2015",5,5,0,88860,1656.6,55.8
"12236","38479","2015",14,11,3,159577.142857143,1405.07142857143,109.285714285714
"12237","38480","2015",33,21,12,193668.787878788,2271.18181818182,86.6363636363636
"12238","38481","2015",10,10,0,257220,1966.9,134.1
"12239","38483","2015",15,14,1,175539,1885.4,95.3333333333333
"12240","38484","2015",18,17,1,210424.222222222,2109.11111111111,100.611111111111
"12241","38485","2015",188,29,159,174511.510638298,2276.8829787234,73.5212765957447
"12242","38486","2015",79,31,48,276388.683544304,2915.67088607595,97.873417721519
"12243","38487","2015",13,11,2,276446.923076923,2769.76923076923,108.769230769231
"12244","38488","2015",11,11,0,188972.727272727,2003.90909090909,92.4545454545455
"12245","38489","2015",1,1,0,205200,2306,89
"12246","38490","2015",21,21,0,182543.761904762,1756.71428571429,103.666666666667
"12247","38492","2015",4,4,0,230000,1768.5,124
"12248","38494","2015",8,7,1,242100,3063.625,121.375
"12249","38495","2015",4,3,1,151343.75,1554,98
"12250","38496","2015",6,6,0,161561.666666667,1576,95.3333333333333
"12251","38498","2015",6,6,0,199833.333333333,1984.5,101.5
"12252","38499","2015",5,5,0,131560,1392,100.4
"12253","38500","2015",6,6,0,186826.666666667,2078.5,92.6666666666667
"12254","38501","2015",36,14,22,189559.083333333,2559.52777777778,76.9444444444444
"12255","38503","2015",3,3,0,220881.666666667,2764.33333333333,87.3333333333333
"12256","38504","2015",16,15,1,227390.125,2247.625,100.125
"12257","38505","2015",8,8,0,182478.5,1595.75,115.25
"12258","38507","2015",70,53,17,207951.7,2380.68571428571,91.4428571428571
"12259","38508","2015",7,7,0,181760,1693,118.428571428571
"12260","38509","2015",94,47,47,130022.319148936,1639.32978723404,81.436170212766
"12261","38511","2015",27,11,16,204416.111111111,2378.77777777778,91.0740740740741
"12262","38512","2015",4,4,0,181204.75,2051.25,88.5
"12263","38513","2015",3,3,0,282308.333333333,2651,103
"12264","38514","2015",5,5,0,128226.4,1214.8,121.8
"12265","38515","2015",27,25,2,157271.296296296,1976.33333333333,85.5925925925926
"12266","38516","2015",71,26,45,262211.169014085,3159.38028169014,84.9859154929577
"12267","38517","2015",70,46,24,168285.114285714,1845.75714285714,92.9714285714286
"12268","38518","2015",3,3,0,102000,1167,84
"12269","38519","2015",35,22,13,240709.2,2518.45714285714,96.9714285714286
"12270","38520","2015",6,6,0,138000,1380.66666666667,101.5
"12271","38522","2015",2,2,0,117500,1147,105
"12272","38523","2015",2,2,0,131050,1545.5,84
"12273","38524","2015",65,39,26,258013.4,2875.86153846154,90.4153846153846
"12274","38525","2015",8,8,0,159173.75,1612.75,105.25
"12275","38526","2015",1,1,0,171000,1315,130
"12276","38528","2015",16,16,0,285394.0625,2687.75,111.375
"12277","38529","2015",53,31,22,256797.943396226,2847.11320754717,90.3396226415094
"12278","38530","2015",17,9,8,205002.882352941,2318.88235294118,93.1764705882353
"12279","38531","2015",7,7,0,164672.857142857,1616.71428571429,104.142857142857
"12280","38532","2015",3,3,0,219700,2177.33333333333,102.333333333333
"12281","38533","2015",3,3,0,440333.333333333,3561.33333333333,124.666666666667
"12282","38535","2015",2,2,0,293000,2079.5,141.5
"12283","38536","2015",7,7,0,216144.285714286,1992.85714285714,111.428571428571
"12284","38537","2015",67,50,17,181885.910447761,2104.53731343284,86.7910447761194
"12285","38538","2015",49,24,25,219596.734693878,2695.24489795918,80.8979591836735
"12286","38539","2015",8,8,0,160551.25,1428.125,122
"12287","38540","2015",6,6,0,277500,2781.16666666667,96.1666666666667
"12288","38542","2015",2,2,0,285925,2290,128
"12289","38543","2015",23,22,1,177266.565217391,1620.82608695652,112.826086956522
"12290","38544","2015",349,78,271,149709.521489971,1964.67621776504,75.8968481375358
"12291","38545","2015",68,38,30,254226.573529412,2856.30882352941,89.4117647058823
"12292","38546","2015",7,7,0,158922.857142857,1607.71428571429,101.857142857143
"12293","38547","2015",78,31,47,174501.692307692,2277.32051282051,76.1538461538462
"12294","38548","2015",231,25,206,122271.701298701,2579.25974025974,46.3246753246753
"12295","38550","2015",6,1,5,68435.8333333333,2518.16666666667,27.8333333333333
"12296","38551","2015",5,4,1,142082,2409.4,58.6
"12297","38552","2015",2,2,0,55000,1085,51.5
"12298","38553","2015",139,100,39,179372.553956835,1929.48201438849,92.8057553956834
"12299","38554","2015",17,17,0,210357.058823529,1875.23529411765,111.823529411765
"12300","38555","2015",11,11,0,172116.363636364,1822.36363636364,100.090909090909
"12301","38556","2015",3,3,0,192000,1714.33333333333,112.333333333333
"12302","38557","2015",44,37,7,284521.818181818,2841.5,113.477272727273
"12303","38558","2015",15,7,8,279198.333333333,2769.8,106.666666666667
"12304","38559","2015",1,1,0,366000,2011,182
"12305","38560","2015",13,12,1,141931,1497.46153846154,95.2307692307692
"12306","38561","2015",11,10,1,136860,1384.72727272727,99.2727272727273
"12307","38562","2015",87,35,52,149469.781609195,2126.10344827586,70.6551724137931
"12308","38563","2015",245,65,180,175002.836734694,2118.95102040816,82.5755102040816
"12309","38564","2015",4,4,0,186375,1940,96.75
"12310","38565","2015",78,42,36,202593.141025641,2377.74358974359,84
"12311","38566","2015",11,8,3,253023.636363636,2448.45454545455,106.454545454545
"12312","38567","2015",81,5,76,76770.0617283951,2106.60493827161,36.6049382716049
"12313","39001","2015",4,4,0,101625,1175,86
"12314","39002","2015",1,1,0,150000,3571,42
"12315","39006","2015",4,4,0,97250,1272.25,75.5
"12316","39007","2015",1,1,0,64800,864,75
"12317","39008","2015",1,0,1,30000,857,35
"12318","39009","2015",8,7,1,135450,1083.625,125.375
"12319","39010","2015",1,1,0,150000,1071,140
"12320","39011","2015",5,5,0,95830,908.2,108
"12321","39013","2015",34,26,8,108922.441176471,1232.67647058824,86.9117647058823
"12322","39014","2015",3,2,1,158900,1503,109.333333333333
"12323","39015","2015",1,0,1,60000,968,62
"12324","39016","2015",6,6,0,77709,928.166666666667,84.5
"12325","39017","2015",6,6,0,141658.333333333,1215.16666666667,119.166666666667
"12326","39018","2015",5,5,0,148200,1048.4,123.8
"12327","39019","2015",2,1,1,120000,1666.5,85.5
"12328","39020","2015",2,2,0,90000,1090,122.5
"12329","39021","2015",2,2,0,103740,1692.5,65
"12330","39022","2015",7,7,0,87534.2857142857,1005.85714285714,86.8571428571429
"12331","39024","2015",2,1,1,109500,1061.5,100
"12332","39025","2015",1,1,0,80000,1143,70
"12333","39026","2015",2,0,2,76500,1302,60.5
"12334","39027","2015",3,3,0,62666.6666666667,878.333333333333,69.6666666666667
"12335","39028","2015",3,2,1,75000,822.666666666667,94
"12336","39029","2015",2,2,0,99000,980,102.5
"12337","39030","2015",5,5,0,131800,1192,104.6
"12338","39031","2015",2,2,0,118875,1126,92.5
"12339","39034","2015",2,2,0,98000,2306,64.5
"12340","39038","2015",3,3,0,76566.6666666667,991.333333333333,71.3333333333333
"12341","39039","2015",1,1,0,23000,852,27
"12342","39041","2015",3,3,0,86866.6666666667,961.333333333333,88.3333333333333
"12343","39042","2015",2,2,0,198250,1707.5,115.5
"12344","39043","2015",9,9,0,117137.333333333,1082.66666666667,114.555555555556
"12345","39045","2015",1,1,0,54300,603,90
"12346","39046","2015",1,1,0,242400,2424,100
"12347","39047","2015",4,3,1,153575,1918.25,80.75
"12348","39048","2015",3,3,0,153166.666666667,1238.33333333333,109.666666666667
"12349","39049","2015",1,1,0,95000,742,128
"12350","39051","2015",3,3,0,148766.666666667,1222,124
"12351","39053","2015",2,2,0,165500,1753,93
"12352","39056","2015",15,12,3,118860,1450.13333333333,94.2666666666667
"12353","39057","2015",1,1,0,35000,583,60
"12354","39058","2015",1,1,0,64000,1280,50
"12355","39059","2015",12,6,6,185948.5,2080.08333333333,93.5833333333333
"12356","39060","2015",5,4,1,74400,862.8,80.8
"12357","39062","2015",2,2,0,126000,1430,88
"12358","39063","2015",3,2,1,58333.3333333333,958.333333333333,65.3333333333333
"12359","39065","2015",1,1,0,79990,1403,57
"12360","39066","2015",2,2,0,170000,1602.5,106
"12361","39068","2015",1,1,0,63000,426,148
"12362","39070","2015",1,1,0,156800,1465,107
"12363","39072","2015",3,3,0,63057,755,85.3333333333333
"12364","39073","2015",1,1,0,95000,1092,87
"12365","39074","2015",1,1,0,75000,670,112
"12366","39076","2015",3,3,0,148256.666666667,1380.33333333333,108.666666666667
"12367","39078","2015",6,5,1,119523.333333333,1241.83333333333,100
"12368","39079","2015",3,3,0,52000,651,76
"12369","39081","2015",2,2,0,66500,1025,62
"12370","39083","2015",1,1,0,221400,1785,124
"12371","39086","2015",2,2,0,95000,1548.5,79
"12372","39088","2015",6,6,0,119733.333333333,1124.5,101.5
"12373","39090","2015",1,1,0,266050,1593,167
"12374","39092","2015",2,2,0,72500,1328.5,65
"12375","39093","2015",4,4,0,125000,1497.25,86.75
"12376","39094","2015",2,2,0,147500,1609.5,95.5
"12377","39095","2015",1,1,0,25000,893,28
"12378","39096","2015",4,4,0,126950,1291.25,96.5
"12379","39097","2015",79,29,50,107878.329113924,1306.16455696203,82.379746835443
"12380","39100","2015",2,2,0,122000,1049.5,117
"12381","39101","2015",17,16,1,105039.705882353,1061.76470588235,98.8823529411765
"12382","39102","2015",3,3,0,187280,1558,119.666666666667
"12383","39103","2015",3,3,0,134833.333333333,1834,93.3333333333333
"12384","39104","2015",7,7,0,102857.142857143,1208.57142857143,94
"12385","39105","2015",1,1,0,118180,1055,112
"12386","39107","2015",2,2,0,105500,1105.5,92
"12387","39109","2015",2,2,0,130750,1472,90
"12388","39114","2015",3,3,0,146666.666666667,1390,102.666666666667
"12389","39116","2015",3,3,0,47850,1463.33333333333,38
"12390","39119","2015",1,1,0,132300,1310,101
"12391","39120","2015",1,1,0,85000,988,86
"12392","39121","2015",2,2,0,140750,1445,98
"12393","39122","2015",2,1,1,95000,1388.5,64.5
"12394","39124","2015",4,4,0,138381.25,1247,111.25
"12395","39126","2015",3,3,0,146500,1479,90.6666666666667
"12396","39127","2015",3,3,0,214400,1412,156.666666666667
"12397","39128","2015",26,25,1,106033.961538462,1074.76923076923,103.653846153846
"12398","39129","2015",4,4,0,110108.75,1033,116.5
"12399","39130","2015",5,5,0,127190,1317.2,115.4
"12400","39131","2015",4,4,0,93750,847,110.5
"12401","39134","2015",4,4,0,165437.5,1323,136
"12402","39137","2015",5,5,0,154780,1066.6,147.8
"12403","39138","2015",8,8,0,93897.5,978.75,103.375
"12404","39139","2015",2,2,0,157500,1924,79.5
"12405","39140","2015",1,1,0,1e+05,1370,73
"12406","39141","2015",1,1,0,123000,932,132
"12407","39142","2015",1,1,0,100600,1273,79
"12408","39143","2015",1,1,0,80000,976,82
"12409","39145","2015",2,2,0,68654,901,83
"12410","39146","2015",4,4,0,116175,1167,99
"12411","39147","2015",1,0,1,130000,1444,90
"12412","39149","2015",6,6,0,112416.666666667,1443.33333333333,83.8333333333333
"12413","39150","2015",10,8,2,156410,1575.6,94.2
"12414","39151","2015",2,2,0,128897.5,1094.5,140
"12415","39153","2015",7,7,0,148528.571428571,1324.28571428571,116.857142857143
"12416","39154","2015",18,16,2,137069.444444444,1436.94444444444,112.444444444444
"12417","39155","2015",1,1,0,60000,400,150
"12418","39156","2015",3,3,0,113666.666666667,1519.33333333333,79
"12419","39159","2015",2,2,0,135500,1406.5,97
"12420","39160","2015",8,8,0,122000,1380.375,85
"12421","39162","2015",3,3,0,126000,1540.66666666667,85.3333333333333
"12422","39163","2015",1,1,0,55000,948,58
"12423","39164","2015",12,9,3,111958.333333333,1135.5,103.916666666667
"12424","39166","2015",2,2,0,56000,844,79
"12425","39167","2015",2,2,0,152500,1446,105
"12426","39169","2015",2,2,0,163750,1160.5,135
"12427","39170","2015",9,9,0,131900,1249.44444444444,106.111111111111
"12428","39171","2015",10,9,1,138681.2,1424.3,102.4
"12429","39172","2015",5,4,1,132398,1868.2,76.8
"12430","39173","2015",15,14,1,87133.3333333333,1056.8,83
"12431","39175","2015",1,1,0,112500,2163,52
"12432","39176","2015",4,4,0,98890.25,1170.25,85.75
"12433","39177","2015",8,6,2,128875,1098.875,127.875
"12434","39179","2015",1,1,0,185000,1267,146
"12435","39180","2015",1,1,0,55000,505,109
"12436","39182","2015",8,8,0,165900,1555.25,111.625
"12437","39185","2015",4,4,0,69625,767,87.25
"12438","39187","2015",1,1,0,284000,2254,126
"12439","39188","2015",3,3,0,104833.333333333,1059,96.6666666666667
"12440","39189","2015",32,30,2,105239.0625,1213.03125,86.71875
"12441","39190","2015",9,8,1,187820,1728.11111111111,115.222222222222
"12442","39192","2015",2,2,0,89000,947,88.5
"12443","39193","2015",9,9,0,160055.555555556,1248.33333333333,138.888888888889
"12444","39194","2015",2,2,0,158500,1239.5,136
"12445","39196","2015",1,1,0,70000,560,125
"12446","39197","2015",5,5,0,156600,1608.4,98.2
"12447","39198","2015",269,131,138,115326.141263941,1374.10037174721,84.4312267657993
"12448","39199","2015",11,10,1,128635.454545455,1381.09090909091,91.4545454545455
"12449","39200","2015",3,3,0,83000,878.333333333333,88.6666666666667
"12450","39201","2015",5,5,0,106200,1888,70.8
"12451","39202","2015",1,1,0,160000,1538,104
"12452","39205","2015",6,6,0,140816.666666667,1143.5,121
"12453","39207","2015",1,1,0,142500,1096,130
"12454","39208","2015",5,4,1,119200,1145.8,102
"12455","39209","2015",5,5,0,174014,1117.6,164.8
"12456","39210","2015",4,4,0,174220,1478.25,120
"12457","39211","2015",4,4,0,117875,999.5,121.25
"12458","39214","2015",2,2,0,202900,1908,113.5
"12459","39216","2015",6,6,0,114064.166666667,1316.16666666667,94
"12460","39217","2015",2,2,0,175500,1672.5,103.5
"12461","39218","2015",4,4,0,100162.5,1753.75,70.75
"12462","39219","2015",8,5,3,159990,1541.375,102.625
"12463","39220","2015",3,3,0,157200,1263,130
"12464","39223","2015",1,1,0,90000,1011,89
"12465","39225","2015",3,3,0,202435,2388.66666666667,82.6666666666667
"12466","39227","2015",2,1,1,72000,980.5,95.5
"12467","39228","2015",11,9,2,153335.909090909,1507.54545454545,103.272727272727
"12468","39229","2015",2,2,0,61000,905,68
"12469","39232","2015",2,2,0,131500,1366,121
"12470","39233","2015",23,14,9,131830.434782609,1401.91304347826,93.304347826087
"12471","39234","2015",2,2,0,85875,862.5,99
"12472","39235","2015",8,5,3,146565,1368.875,102
"12473","39236","2015",2,2,0,145850,1284,92.5
"12474","39238","2015",3,3,0,109166.666666667,939.333333333333,105
"12475","39239","2015",1,1,0,115000,1917,60
"12476","39240","2015",3,3,0,183600,1258.33333333333,146
"12477","39241","2015",3,3,0,105666.666666667,1495,78.6666666666667
"12478","39244","2015",1,1,0,140000,1273,110
"12479","39245","2015",7,7,0,128635.714285714,1124.85714285714,113.857142857143
"12480","39246","2015",2,1,1,108750,999,109
"12481","39249","2015",1,1,0,96200,1336,72
"12482","39250","2015",3,3,0,183836.666666667,1456.33333333333,127.666666666667
"12483","39251","2015",5,5,0,138700,1209.4,107.2
"12484","39252","2015",7,7,0,130969.857142857,1285.28571428571,109.428571428571
"12485","39253","2015",5,5,0,96277.2,920.4,96.8
"12486","39254","2015",3,3,0,126706.666666667,1057.66666666667,119
"12487","39255","2015",3,3,0,90666.6666666667,773.333333333333,117.333333333333
"12488","39258","2015",4,4,0,193959.75,1463.75,136.5
"12489","39261","2015",1,1,0,72900,361,202
"12490","39263","2015",2,2,0,134823,1467,92
"12491","39265","2015",1,1,0,198800,1390,143
"12492","39266","2015",5,5,0,136171,1104.2,123.6
"12493","39270","2015",5,5,0,101740,1059.6,97.8
"12494","39271","2015",2,2,0,158775,1355.5,110
"12495","39272","2015",1,1,0,79000,669,118
"12496","39273","2015",1,1,0,60000,741,81
"12497","39274","2015",4,4,0,238312.5,2708.25,98
"12498","39275","2015",15,9,6,172881.333333333,2330.06666666667,81.7333333333333
"12499","39277","2015",1,1,0,94800,988,96
"12500","39278","2015",1,1,0,152000,1169,130
"12501","39279","2015",5,5,0,157460,1294.4,120
"12502","39281","2015",1,1,0,70000,519,135
"12503","39283","2015",7,6,1,159000,1518.85714285714,110
"12504","39284","2015",2,2,0,81750,822.5,99.5
"12505","39285","2015",11,11,0,141600.909090909,1252.18181818182,113
"12506","39286","2015",16,12,4,117601.875,1171.125,105.25
"12507","39288","2015",5,4,1,110378,1052.8,110.4
"12508","39289","2015",5,5,0,87900,1129.2,82
"12509","39290","2015",4,4,0,72934.25,776,96.75
"12510","39291","2015",5,5,0,96200,890.2,103.8
"12511","39293","2015",1,1,0,179000,1845,97
"12512","39296","2015",4,4,0,87750,896,102.75
"12513","39297","2015",15,14,1,158884,1703.6,111.333333333333
"12514","39299","2015",9,9,0,91786.7777777778,972.666666666667,96
"12515","39300","2015",203,54,149,110799.113300493,1349.99014778325,86.5073891625616
"12516","39302","2015",1,1,0,120000,1644,73
"12517","39304","2015",2,2,0,95600,964,112.5
"12518","39305","2015",1,1,0,165100,1529,108
"12519","39306","2015",9,9,0,136077.777777778,1291.77777777778,103.555555555556
"12520","39307","2015",6,6,0,162569.166666667,2375.16666666667,81
"12521","39308","2015",2,2,0,151880,1294.5,116
"12522","39310","2015",7,7,0,141314.285714286,1088.85714285714,136.428571428571
"12523","39313","2015",1,1,0,92500,526,176
"12524","39314","2015",2,2,0,219500,1429.5,155
"12525","39315","2015",6,6,0,156208.333333333,1489.16666666667,103.833333333333
"12526","39317","2015",4,4,0,115000,965.5,123.25
"12527","39318","2015",1,1,0,50000,424,118
"12528","39319","2015",1,1,0,50000,625,80
"12529","39320","2015",5,5,0,137480,1080.6,139.2
"12530","39321","2015",2,2,0,197500,1484,137
"12531","39322","2015",2,2,0,260000,1605.5,165.5
"12532","39323","2015",5,5,0,122800,943.6,134.8
"12533","39325","2015",6,6,0,127066.666666667,1137.33333333333,106.5
"12534","39326","2015",2,2,0,163480,1734,95
"12535","39327","2015",6,6,0,136020,1554.83333333333,89.1666666666667
"12536","39328","2015",4,3,1,120375,915,125.75
"12537","39331","2015",2,2,0,147000,1516,90.5
"12538","39333","2015",11,9,2,107631.363636364,1137.54545454545,96.3636363636364
"12539","39335","2015",6,5,1,129050,834,166.666666666667
"12540","39336","2015",1,1,0,160000,1032,155
"12541","39337","2015",2,2,0,135000,1155,124
"12542","39338","2015",4,4,0,101500,1188.5,90.75
"12543","39339","2015",9,8,1,164013.333333333,1221.44444444444,129.555555555556
"12544","39344","2015",4,4,0,166950,1520.25,124.25
"12545","39345","2015",5,4,1,153760,1869.8,93.2
"12546","39346","2015",2,2,0,184622.5,1227.5,179.5
"12547","39348","2015",2,2,0,227500,1333.5,168.5
"12548","39350","2015",4,4,0,106500,1114.25,91.25
"12549","39352","2015",1,1,0,205100,1508,136
"12550","39353","2015",6,6,0,96635,1181.5,84.6666666666667
"12551","39354","2015",5,5,0,128300,1372.2,92.4
"12552","39355","2015",3,3,0,139850,1065.33333333333,119.666666666667
"12553","39356","2015",2,2,0,143300,1223.5,120
"12554","39360","2015",2,2,0,129800,919,144.5
"12555","39361","2015",3,3,0,96666.6666666667,805.666666666667,130.333333333333
"12556","39362","2015",38,15,23,96394.7368421053,1284.63157894737,73.6842105263158
"12557","39363","2015",1,1,0,103000,1471,70
"12558","39364","2015",5,5,0,147640,1283.6,124
"12559","39365","2015",9,9,0,163444.444444444,1487.22222222222,106.666666666667
"12560","39366","2015",2,2,0,110000,1361.5,81
"12561","39367","2015",18,15,3,217272.777777778,2170.22222222222,104.166666666667
"12562","39368","2015",47,9,38,99419.1063829787,1301.55319148936,75.1489361702128
"12563","39370","2015",7,6,1,72885.7142857143,930.142857142857,70.7142857142857
"12564","39372","2015",2,2,0,221115,1230,180
"12565","39373","2015",1,1,0,60000,500,120
"12566","39375","2015",1,1,0,40000,421,95
"12567","39377","2015",2,2,0,141500,1270.5,112
"12568","39378","2015",8,8,0,119881.25,1459.75,94.125
"12569","39379","2015",5,5,0,136212,1471.2,95.6
"12570","39381","2015",1,1,0,70000,795,88
"12571","39385","2015",6,6,0,106833.333333333,1552.83333333333,71.8333333333333
"12572","39387","2015",2,2,0,124000,1277,103.5
"12573","39388","2015",2,2,0,2e+05,1229,152.5
"12574","39389","2015",3,3,0,160666.666666667,1591,102
"12575","39390","2015",2,2,0,110000,1562.5,72
"12576","39391","2015",1,1,0,121000,1008,120
"12577","39394","2015",1,1,0,235925,1685,140
"12578","39396","2015",16,10,6,127118.75,1393.875,90.8125
"12579","39397","2015",16,15,1,72875,953.5625,79.75
"12580","39398","2015",4,4,0,144625,1091.5,129
"12581","39399","2015",4,4,0,82500,992.5,83.5
"12582","39401","2015",2,2,0,69750,1125.5,66.5
"12583","39402","2015",5,1,4,84485.6,960.2,82
"12584","39403","2015",6,6,0,134583.333333333,1345.83333333333,104
"12585","39404","2015",3,2,1,96838.3333333333,963.666666666667,94
"12586","39405","2015",10,10,0,173850,1409.1,120.6
"12587","39406","2015",2,2,0,159100,1547,103.5
"12588","39407","2015",2,2,0,131500,833,141.5
"12589","39408","2015",2,2,0,110000,999.5,118.5
"12590","39411","2015",16,10,6,100129.6875,1082.875,92.9375
"12591","39412","2015",6,6,0,130258.333333333,1164.16666666667,108.5
"12592","39413","2015",6,3,3,173666.666666667,2333.33333333333,67.5
"12593","39415","2015",13,13,0,107576.923076923,1097.30769230769,99.5384615384615
"12594","39418","2015",2,2,0,99500,952,102
"12595","39419","2015",1,1,0,35000,361,97
"12596","39420","2015",4,4,0,110425,1454,104.5
"12597","39421","2015",2,2,0,225500,1995,112
"12598","39422","2015",4,4,0,129670,1291,92.5
"12599","39423","2015",2,2,0,109000,892,124
"12600","39427","2015",1,1,0,214990,1194,180
"12601","39429","2015",1,1,0,85000,1214,70
"12602","39432","2015",1,1,0,174500,959,182
"12603","39434","2015",32,25,7,125010.9375,1364.875,108.1875
"12604","39435","2015",5,4,1,98300,1111.8,90
"12605","39436","2015",2,2,0,118750,1139.5,108.5
"12606","39437","2015",4,4,0,131350,1490.5,93.75
"12607","39439","2015",10,10,0,158895,1314.6,119.9
"12608","39441","2015",29,10,19,145695.517241379,2546.65517241379,58.448275862069
"12609","39443","2015",1,1,0,110000,1196,92
"12610","39445","2015",4,4,0,70000,695.25,97.75
"12611","39446","2015",1,1,0,220000,1302,169
"12612","39447","2015",1,1,0,152000,1369,111
"12613","39448","2015",3,3,0,133166.666666667,1281.33333333333,105.666666666667
"12614","39449","2015",2,2,0,175300,860.5,186.5
"12615","39451","2015",5,5,0,154780,1356.6,115.2
"12616","39452","2015",8,8,0,158837.625,1577.25,105
"12617","39453","2015",5,3,2,104600,1371.6,81.4
"12618","39454","2015",1,1,0,2e+05,1562,128
"12619","39456","2015",3,3,0,124883.333333333,1271.66666666667,99
"12620","39458","2015",5,5,0,84600,963,92.2
"12621","39460","2015",1,1,0,37500,625,60
"12622","39462","2015",2,2,0,119000,1490,79.5
"12623","39463","2015",2,2,0,245000,2447.5,99
"12624","39464","2015",1,1,0,127000,1671,76
"12625","39465","2015",1,1,0,138900,1310,106
"12626","39467","2015",2,2,0,129400,1369.5,95.5
"12627","39468","2015",1,1,0,135000,1286,105
"12628","39469","2015",2,2,0,88325,749.5,126
"12629","39470","2015",76,19,57,164599.565789474,2859.81578947368,56.8289473684211
"12630","39471","2015",10,10,0,104720,1097.1,100.7
"12631","39472","2015",1,1,0,182000,2022,90
"12632","39474","2015",2,1,1,149000,1220,125.5
"12633","39475","2015",23,20,3,117808.739130435,1098.73913043478,111.04347826087
"12634","39476","2015",11,11,0,104654.545454545,1018.45454545455,112.181818181818
"12635","39477","2015",2,2,0,141000,1287.5,109.5
"12636","39478","2015",48,18,30,90835.1875,1075.6875,82.4791666666667
"12637","39479","2015",3,3,0,155966.666666667,1282.33333333333,116.333333333333
"12638","39481","2015",3,3,0,94066.6666666667,945.333333333333,105.666666666667
"12639","39485","2015",4,4,0,118750,945,132.75
"12640","39486","2015",1,1,0,264800,2817,94
"12641","39487","2015",9,6,3,165646.222222222,1952.66666666667,95.3333333333333
"12642","39489","2015",2,2,0,102500,1352.5,78
"12643","39490","2015",1,1,0,175000,1458,120
"12644","39491","2015",15,10,5,109833.333333333,1289.06666666667,83.4
"12645","39492","2015",1,1,0,60000,750,80
"12646","39494","2015",3,3,0,147000,1117.33333333333,145.666666666667
"12647","39495","2015",1,1,0,112000,1867,60
"12648","39498","2015",2,2,0,260225,2104.5,123
"12649","39499","2015",6,6,0,135933.333333333,1240.33333333333,111.333333333333
"12650","39500","2015",19,6,13,111963.157894737,1598.15789473684,64.7368421052632
"12651","39501","2015",9,9,0,183944.444444444,1483.77777777778,125.666666666667
"12652","39502","2015",6,6,0,122498.666666667,860.666666666667,136.666666666667
"12653","39504","2015",4,4,0,142412.5,1140,120.25
"12654","39505","2015",1,1,0,45000,1500,30
"12655","39508","2015",5,4,1,73466,879.4,81.4
"12656","39510","2015",9,9,0,169377.777777778,2172,89.2222222222222
"12657","39512","2015",1,1,0,365000,1357,269
"12658","39513","2015",2,2,0,197500,1240,159.5
"12659","39514","2015",2,2,0,181125,2468,119.5
"12660","39517","2015",1,1,0,228000,1267,180
"12661","39518","2015",2,2,0,169500,1286,154.5
"12662","39519","2015",2,2,0,99000,796.5,124
"12663","39520","2015",7,7,0,152570.428571429,1018.71428571429,148.285714285714
"12664","39522","2015",1,1,0,50000,435,115
"12665","39523","2015",2,2,0,125282.5,905.5,137.5
"12666","39525","2015",5,5,0,130500,1359,95.4
"12667","39526","2015",41,33,8,106713.414634146,1284.46341463415,83.7073170731707
"12668","39527","2015",1,1,0,156570,1253,125
"12669","39528","2015",2,2,0,112400,1285,87.5
"12670","39530","2015",11,11,0,124265.909090909,1291.54545454545,97.3636363636364
"12671","39531","2015",2,2,0,113855,1296.5,84.5
"12672","39532","2015",1,1,0,85000,386,220
"12673","39533","2015",4,4,0,90925,1020.75,89.5
"12674","39534","2015",2,2,0,153225,1522,100
"12675","39535","2015",7,7,0,137564.285714286,1223.28571428571,111.714285714286
"12676","39537","2015",5,5,0,138300,1769,87.8
"12677","39539","2015",2,2,0,141250,1343,105
"12678","39540","2015",1,1,0,129000,679,190
"12679","39546","2015",4,4,0,154250,1304,124.25
"12680","39547","2015",6,6,0,94294.1666666667,1143.83333333333,83.1666666666667
"12681","39550","2015",2,2,0,77000,1014,67.5
"12682","39551","2015",2,2,0,83000,770.5,99.5
"12683","39552","2015",3,2,1,116333.333333333,1267,82
"12684","39553","2015",2,2,0,199500,1811.5,115
"12685","39555","2015",3,3,0,87333.3333333333,864.333333333333,107.666666666667
"12686","39556","2015",1,1,0,1e+05,1389,72
"12687","39557","2015",1,1,0,37500,493,76
"12688","39558","2015",3,3,0,153333.333333333,1603.33333333333,99.3333333333333
"12689","39559","2015",3,3,0,145979.333333333,1155.33333333333,132
"12690","39560","2015",12,10,2,125632.75,1390.25,89.5
"12691","39561","2015",3,3,0,93333.3333333333,829,110.666666666667
"12692","39565","2015",1,1,0,147000,1081,136
"12693","39567","2015",3,3,0,124500,995,108.333333333333
"12694","39568","2015",1,1,0,280000,3500,80
"12695","39569","2015",6,6,0,119233.333333333,1420.66666666667,91.8333333333333
"12696","39570","2015",4,4,0,91600,803.75,114.5
"12697","39571","2015",2,2,0,121500,1535.5,110
"12698","39572","2015",7,7,0,120552.857142857,1076.28571428571,115.428571428571
"12699","39573","2015",3,3,0,157333.333333333,1588.33333333333,105.666666666667
"12700","39574","2015",5,5,0,132000,1260.4,107.6
"12701","39576","2015",4,4,0,98000,936.5,114.75
"12702","39577","2015",5,5,0,146380,1456.6,99.2
"12703","39579","2015",8,8,0,136812.5,1302.75,102.625
"12704","39581","2015",3,3,0,129816.666666667,982,135.666666666667
"12705","39582","2015",6,6,0,111000,1116,106.833333333333
"12706","39583","2015",4,4,0,100500,1349.25,89
"12707","39584","2015",3,3,0,82733.3333333333,1028.66666666667,80.6666666666667
"12708","40001","2015",62,52,10,123576.14516129,1294.77419354839,98.2096774193548
"12709","40002","2015",8,8,0,118560,1239.875,95.5
"12710","40005","2015",3,3,0,111166.666666667,989.333333333333,117.666666666667
"12711","40006","2015",5,4,1,85920,1122.8,79.6
"12712","40007","2015",1,1,0,70000,778,90
"12713","40008","2015",3,3,0,177236.333333333,1730,138.666666666667
"12714","40011","2015",2,2,0,127300,1043.5,127
"12715","40012","2015",3,3,0,91666.6666666667,750.333333333333,119.666666666667
"12716","40014","2015",7,7,0,137142.857142857,1447.14285714286,95
"12717","40015","2015",2,2,0,132500,732.5,137
"12718","40016","2015",7,7,0,137438.571428571,1195,118.714285714286
"12719","40017","2015",3,3,0,94333.3333333333,1250,73.6666666666667
"12720","40018","2015",4,4,0,100250,1296.5,90.25
"12721","40019","2015",15,15,0,153598,1878.06666666667,91.8666666666667
"12722","40020","2015",6,6,0,115458.333333333,1137.83333333333,102
"12723","40021","2015",6,5,1,200836.333333333,2903.83333333333,83.1666666666667
"12724","40023","2015",2,2,0,128500,726,176.5
"12725","40024","2015",2,2,0,145000,1739.5,85
"12726","40025","2015",4,4,0,168750,1549.25,114.75
"12727","40028","2015",2,2,0,141000,1185,115
"12728","40029","2015",3,3,0,118125,1125.33333333333,110.333333333333
"12729","40030","2015",1,1,0,80000,640,125
"12730","40031","2015",4,4,0,126797.5,1849.5,67.75
"12731","40032","2015",3,3,0,93333.3333333333,1626,62
"12732","40033","2015",1,1,0,40000,571,70
"12733","40034","2015",5,4,1,160000,1502.8,110.6
"12734","40035","2015",1,1,0,301280,2511,120
"12735","40036","2015",36,27,9,232882.666666667,2503.69444444444,96.0833333333333
"12736","40037","2015",5,5,0,200800,1484,130.2
"12737","40040","2015",4,4,0,107000,1586.75,72.75
"12738","40041","2015",2,2,0,186500,1638.5,113
"12739","40042","2015",1,1,0,247000,1462,169
"12740","40043","2015",17,14,3,126420.588235294,1891.17647058824,69.2941176470588
"12741","40044","2015",3,3,0,363666.666666667,2700.66666666667,131.333333333333
"12742","40046","2015",324,185,139,186161.75,2461.69444444444,79.2777777777778
"12743","40047","2015",4,4,0,136750,1164.5,120.75
"12744","40049","2015",2,2,0,117550,1403.5,81
"12745","40050","2015",3,3,0,141950,1278.33333333333,113.333333333333
"12746","40051","2015",5,5,0,169600,1724.6,99.4
"12747","40052","2015",3,3,0,120333.333333333,1336.33333333333,87
"12748","40053","2015",3,3,0,265450,2365.33333333333,140
"12749","40054","2015",1,1,0,149500,1680,89
"12750","40055","2015",6,6,0,158333.333333333,1745.16666666667,96.8333333333333
"12751","40056","2015",7,6,1,147035.714285714,1529.14285714286,96.7142857142857
"12752","40057","2015",6,6,0,106230,1273.66666666667,83.1666666666667
"12753","40058","2015",6,6,0,139816.666666667,1392,99.8333333333333
"12754","40059","2015",5,5,0,175880,1406.8,125
"12755","40060","2015",5,5,0,126546,1241.2,119
"12756","40061","2015",4,4,0,218000,1591.75,132
"12757","40062","2015",6,6,0,197510.166666667,1692,115.166666666667
"12758","40063","2015",5,5,0,145095,1611.4,93.8
"12759","40064","2015",2,2,0,110000,1219.5,88
"12760","40065","2015",282,134,148,235467.680851064,3990.66312056738,62.7234042553191
"12761","40066","2015",4,4,0,118750,1406.5,81.25
"12762","40067","2015",3,3,0,120366.666666667,1260,103.666666666667
"12763","40068","2015",5,4,1,127880,1366,107.8
"12764","40069","2015",4,4,0,157000,1364.75,115
"12765","40070","2015",3,3,0,78962.6666666667,690.666666666667,115.333333333333
"12766","40071","2015",1,1,0,90000,1000,90
"12767","40072","2015",1,1,0,83000,741,112
"12768","40073","2015",1,1,0,215000,1405,153
"12769","40074","2015",3,3,0,145533.333333333,1637.33333333333,90.6666666666667
"12770","40075","2015",13,12,1,204500,2008.84615384615,96.3846153846154
"12771","40076","2015",1,1,0,130000,2000,65
"12772","40077","2015",3,3,0,161366.666666667,1553.66666666667,112.666666666667
"12773","40078","2015",1,1,0,125000,1157,108
"12774","40079","2015",2,2,0,146500,1173,174.5
"12775","40080","2015",21,21,0,130183.80952381,1315.52380952381,101.761904761905
"12776","40081","2015",7,7,0,141285.714285714,1545.42857142857,94.5714285714286
"12777","40082","2015",2,2,0,105000,1500,67.5
"12778","40083","2015",1,1,0,303000,1188,255
"12779","40084","2015",5,5,0,214060,1472.2,144.4
"12780","40085","2015",7,7,0,136857.142857143,1368.85714285714,108.428571428571
"12781","40086","2015",5,5,0,104543,869.4,111.2
"12782","40087","2015",2,2,0,140585,1572.5,89
"12783","40088","2015",325,108,217,114054.923076923,1827.88923076923,65.4584615384615
"12784","40089","2015",4,4,0,120517.5,1392,93.5
"12785","40090","2015",7,7,0,127542.857142857,995,131.857142857143
"12786","40091","2015",5,5,0,149060,1197.8,132.4
"12787","40092","2015",3,3,0,163533.333333333,1543.66666666667,107.333333333333
"12788","40093","2015",2,2,0,142500,1574,86
"12789","40094","2015",7,7,0,124672.714285714,1160,110.142857142857
"12790","40095","2015",5,4,1,163180,1197.2,148.8
"12791","40096","2015",1,1,0,2e+05,1550,129
"12792","40097","2015",2,1,1,119250,1748,75
"12793","40098","2015",3,3,0,137206.666666667,948.333333333333,144.666666666667
"12794","40099","2015",1,1,0,101000,1262,80
"12795","40100","2015",4,4,0,98162.5,938.75,120.75
"12796","40101","2015",2,2,0,170000,1082,177.5
"12797","40102","2015",17,17,0,92029.4117647059,1116.76470588235,90.3529411764706
"12798","40103","2015",9,9,0,166500,1389.77777777778,127.888888888889
"12799","40104","2015",10,10,0,130775,1506.8,87.9
"12800","40105","2015",2,2,0,160500,1472.5,114
"12801","40106","2015",1,1,0,153000,1264,121
"12802","40108","2015",8,8,0,166043.75,2009.25,84.25
"12803","40109","2015",4,4,0,151245,1427.25,106.25
"12804","40110","2015",6,6,0,136018.333333333,1109.33333333333,118
"12805","40111","2015",7,7,0,136547.714285714,1373.42857142857,101
"12806","40113","2015",4,4,0,131000,1269,107.5
"12807","40114","2015",1,1,0,164000,1577,104
"12808","40115","2015",4,4,0,132866,1239.25,113
"12809","40116","2015",2,2,0,160500,1511,106
"12810","40117","2015",25,21,4,121450.8,1212.72,99.08
"12811","40118","2015",7,6,1,97857.1428571429,926.428571428571,107.714285714286
"12812","40119","2015",42,41,1,129056.166666667,1292.33333333333,107.333333333333
"12813","40120","2015",3,3,0,179720,1772.33333333333,101.333333333333
"12814","40121","2015",2,2,0,135000,1547,79
"12815","40122","2015",12,12,0,168916.666666667,1599.5,109.333333333333
"12816","40123","2015",12,12,0,216419.75,2063.58333333333,117.833333333333
"12817","40124","2015",3,3,0,139666.666666667,1025.66666666667,145.333333333333
"12818","40125","2015",10,10,0,142241.9,1423.7,100.2
"12819","40126","2015",19,19,0,178744.368421053,2069.63157894737,90.1052631578947
"12820","40127","2015",4,4,0,88000,767.25,110.5
"12821","40128","2015",7,7,0,106092.857142857,1417.14285714286,84.2857142857143
"12822","40129","2015",11,11,0,214301.363636364,2108,102
"12823","40131","2015",12,12,0,113725,1112.66666666667,115.083333333333
"12824","40132","2015",9,9,0,139510.222222222,1294.22222222222,114.777777777778
"12825","40133","2015",117,87,30,228334.547008547,2855.66666666667,84.9316239316239
"12826","40134","2015",14,14,0,112785.714285714,1275.14285714286,91.6428571428571
"12827","40135","2015",6,5,1,121200,1411.16666666667,89
"12828","40136","2015",2,2,0,98650,1227,81.5
"12829","40137","2015",2,2,0,138500,1397,101
"12830","40139","2015",2,2,0,105000,897,116.5
"12831","40141","2015",3,3,0,181573.333333333,1583.66666666667,115.666666666667
"12832","40142","2015",6,6,0,164069.666666667,1528.66666666667,107.5
"12833","40143","2015",1,1,0,113000,1430,79
"12834","40144","2015",1,1,0,297040,2496,119
"12835","40145","2015",2,2,0,120500,1330.5,89.5
"12836","40146","2015",1,1,0,140000,979,143
"12837","40147","2015",5,5,0,90700,933.2,114
"12838","40149","2015",3,3,0,116333.333333333,1147,99.6666666666667
"12839","40150","2015",25,20,5,191409.32,2214.64,88.88
"12840","40151","2015",3,3,0,175000,1190,149.333333333333
"12841","40152","2015",3,3,0,108614,1463.33333333333,74
"12842","40153","2015",5,5,0,146300,1312.6,114.8
"12843","40154","2015",1,1,0,135000,1588,85
"12844","40155","2015",12,12,0,219986.25,2031.83333333333,104.583333333333
"12845","40156","2015",5,5,0,197020,1538,128
"12846","40157","2015",38,25,13,161104.342105263,2124,77.4736842105263
"12847","40158","2015",1,1,0,190000,2500,76
"12848","40159","2015",2,1,1,129000,1522.5,82.5
"12849","40160","2015",2,2,0,130000,1000.5,136
"12850","40161","2015",1,1,0,95000,1267,75
"12851","40162","2015",14,14,0,197357.142857143,1531.5,126.571428571429
"12852","40163","2015",12,12,0,151416.666666667,1407.58333333333,109.583333333333
"12853","40164","2015",4,4,0,158372.5,1324.25,116.75
"12854","40165","2015",4,4,0,143000,1269.25,110.75
"12855","40166","2015",2,2,0,54000,777,67
"12856","40167","2015",9,9,0,175107.777777778,1589.88888888889,106.777777777778
"12857","40168","2015",15,14,1,163682,1823.6,94.9333333333333
"12858","40169","2015",1,1,0,83999,1292,65
"12859","40170","2015",1,1,0,177000,1654,107
"12860","40171","2015",1,1,0,170000,1214,140
"12861","40172","2015",1,1,0,98970,678,146
"12862","40173","2015",1,1,0,95000,960,99
"12863","40175","2015",2,2,0,155625,1267,121
"12864","40176","2015",2,2,0,184340,1282.5,142.5
"12865","40177","2015",3,3,0,136051.666666667,899,154.333333333333
"12866","40178","2015",5,5,0,216400,1888.4,119.4
"12867","40179","2015",11,11,0,168726.545454545,1672.18181818182,105.727272727273
"12868","40180","2015",9,9,0,139222.222222222,1303.77777777778,105.777777777778
"12869","40181","2015",19,17,2,260996.315789474,2668.68421052632,99.3157894736842
"12870","40182","2015",13,13,0,214050.769230769,1842.15384615385,113.384615384615
"12871","40183","2015",1,1,0,144000,1565,92
"12872","40184","2015",148,92,56,156401.871621622,2416.27027027027,71.777027027027
"12873","40185","2015",1,1,0,181159,1575,115
"12874","40186","2015",8,8,0,146250,1409.875,101.25
"12875","40187","2015",76,46,30,179838.802631579,3265.42105263158,59.4605263157895
"12876","40188","2015",1,1,0,133805,1262,106
"12877","40190","2015",1,1,0,118500,1173,101
"12878","40191","2015",9,9,0,111155.555555556,1049.22222222222,111.222222222222
"12879","40192","2015",369,212,157,121668.192411924,1622.89159891599,76.3848238482385
"12880","40194","2015",8,8,0,117312.5,1130.25,109.875
"12881","40195","2015",3,3,0,202166.666666667,1404,160.666666666667
"12882","40196","2015",6,6,0,145742.5,1207,129.666666666667
"12883","40197","2015",20,18,2,125291.5,1481.95,86.9
"12884","40199","2015",3,3,0,147000,1755.33333333333,86.3333333333333
"12885","40200","2015",8,8,0,166734.75,1531.75,115
"12886","40201","2015",5,5,0,140700,1284.8,126.8
"12887","40202","2015",24,22,2,175261.666666667,1617.41666666667,110
"12888","40205","2015",1,1,0,163000,1772,92
"12889","40206","2015",7,7,0,171142.857142857,1567.71428571429,118
"12890","40207","2015",9,9,0,159966.666666667,1858.88888888889,86.8888888888889
"12891","40208","2015",2,2,0,143000,994,140
"12892","40209","2015",96,51,45,204323.135416667,2736.48958333333,79.5
"12893","40210","2015",9,9,0,168000,1448.55555555556,111.777777777778
"12894","40211","2015",5,4,1,169254,1481.4,113.8
"12895","40212","2015",5,5,0,171600,1884,91.8
"12896","40213","2015",6,5,1,256808.666666667,2056.33333333333,121.333333333333
"12897","40214","2015",7,7,0,199957.142857143,1436.71428571429,138.142857142857
"12898","40215","2015",3,3,0,116416.666666667,871.666666666667,126.333333333333
"12899","40216","2015",4,4,0,150350,1272,125.75
"12900","40217","2015",68,58,10,182001.367647059,1904.67647058824,98.1323529411765
"12901","40218","2015",7,7,0,116785.714285714,1330.28571428571,92.2857142857143
"12902","40220","2015",1,1,0,130000,1182,110
"12903","40221","2015",2,2,0,173300,1218,130.5
"12904","40222","2015",1,1,0,240000,1412,170
"12905","40223","2015",2,2,0,123750,1058,121.5
"12906","40224","2015",33,27,6,146373.636363636,1426.75757575758,103.242424242424
"12907","40225","2015",2,2,0,107290,1045.5,132
"12908","40227","2015",11,11,0,184727.272727273,2184.90909090909,99.9090909090909
"12909","40228","2015",14,12,2,129335.714285714,1460.28571428571,90.2142857142857
"12910","40229","2015",36,35,1,156395.555555556,1669.77777777778,96.8611111111111
"12911","40230","2015",26,25,1,162557.692307692,1697.03846153846,99.5
"12912","40231","2015",8,8,0,166904.75,1801.25,95.125
"12913","40232","2015",1,1,0,170000,1700,100
"12914","40233","2015",16,16,0,161131.25,1496.6875,113.6875
"12915","40234","2015",7,7,0,143314.285714286,1395.57142857143,103.571428571429
"12916","40235","2015",6,6,0,156166.666666667,1115,148.833333333333
"12917","40236","2015",5,5,0,201600,1536,134.2
"12918","40237","2015",6,6,0,160666.666666667,1281.66666666667,124.5
"12919","40238","2015",8,8,0,159900,1336.875,116.25
"12920","40239","2015",1,1,0,123000,1281,96
"12921","40240","2015",6,6,0,124061.666666667,1243,100.666666666667
"12922","40243","2015",28,28,0,141787.142857143,1514,96.5714285714286
"12923","40244","2015",6,6,0,234122.666666667,1792.66666666667,132.833333333333
"12924","40245","2015",27,25,2,111911.111111111,1139.18518518519,101.925925925926
"12925","40246","2015",11,11,0,121770.363636364,1317.27272727273,92.8181818181818
"12926","40248","2015",12,12,0,242154.166666667,2302.5,106.416666666667
"12927","40249","2015",5,5,0,109070,1141.2,93.8
"12928","40250","2015",6,6,0,145433.333333333,2104.66666666667,77.5
"12929","40251","2015",1,1,0,93600,620,151
"12930","40252","2015",5,5,0,148040,1280,116
"12931","40253","2015",3,3,0,107666.666666667,1071.66666666667,100.666666666667
"12932","40254","2015",1,1,0,181500,1306,139
"12933","40255","2015",5,5,0,144000,1350,107.6
"12934","40256","2015",10,10,0,158240,1424.7,117.5
"12935","40257","2015",18,17,1,169263.333333333,2104.72222222222,87.1666666666667
"12936","40258","2015",2,2,0,145000,1194.5,120.5
"12937","40259","2015",2,2,0,140000,1349,101.5
"12938","40260","2015",3,3,0,160966.666666667,1416.33333333333,117.333333333333
"12939","40261","2015",25,22,3,191643,1960.04,101.08
"12940","40262","2015",2,2,0,62500,879.5,70
"12941","40263","2015",3,3,0,132666.666666667,1383.66666666667,98.6666666666667
"12942","40264","2015",11,11,0,214177.272727273,2047,117.818181818182
"12943","40266","2015",30,18,12,141593.666666667,2377.66666666667,65.4333333333333
"12944","40267","2015",9,9,0,159378.888888889,1551.77777777778,118
"12945","40268","2015",5,5,0,169831.4,1989.2,85.8
"12946","40269","2015",8,8,0,221612.5,1717.375,129.375
"12947","40270","2015",4,4,0,140212.5,1194,125.25
"12948","40271","2015",8,8,0,184073.75,1436.875,121.5
"12949","40272","2015",17,12,5,215113.352941176,2053.47058823529,108.764705882353
"12950","40273","2015",59,42,17,242455.915254237,2375.61016949153,104.35593220339
"12951","40274","2015",10,10,0,152079,1496.3,101.2
"12952","40275","2015",4,4,0,141780,1270.5,110.5
"12953","40276","2015",6,6,0,167716.666666667,2370.83333333333,78.6666666666667
"12954","40277","2015",3,3,0,203633.333333333,1725,138
"12955","40278","2015",9,9,0,186888.888888889,1945.55555555556,101.222222222222
"12956","40279","2015",200,129,71,154838.54,1862.875,84.965
"12957","40280","2015",20,19,1,163470,1694.6,97.5
"12958","40281","2015",101,86,15,146898.316831683,1667.44554455446,89.6435643564356
"12959","40282","2015",34,26,8,124610.294117647,1425.85294117647,91.4705882352941
"12960","40283","2015",20,17,3,195730,1902.3,105.7
"12961","40284","2015",126,85,41,179291.087301587,2110.99206349206,88.515873015873
"12962","40285","2015",5,5,0,123200,1426,101.4
"12963","40286","2015",7,6,1,101878.571428571,770.714285714286,129.571428571429
"12964","40287","2015",49,41,8,224340.693877551,2364.85714285714,99.2448979591837
"12965","40288","2015",7,7,0,132850,1547.57142857143,93
"12966","40289","2015",3,3,0,101666.666666667,1101.33333333333,118.333333333333
"12967","40290","2015",1,1,0,130000,1429,91
"12968","40291","2015",9,8,1,214904.444444444,2306.55555555556,111.111111111111
"12969","40292","2015",10,10,0,275080,2106,141.8
"12970","40293","2015",8,8,0,199187.5,2248.25,90.25
"12971","40294","2015",11,11,0,168339.454545455,1879.09090909091,92.1818181818182
"12972","40295","2015",13,13,0,145540.153846154,1644.53846153846,96
"12973","40296","2015",176,65,111,208519.857954545,3131.5625,66.6306818181818
"12974","40298","2015",1,1,0,173000,1418,122
"12975","40299","2015",3,3,0,111666.666666667,1431,78
"12976","40300","2015",9,8,1,159844.444444444,1666.55555555556,99.3333333333333
"12977","40301","2015",1,1,0,70000,897,78
"12978","40303","2015",4,4,0,104975,1128.75,92.5
"12979","40304","2015",126,72,54,381761.30952381,4502.19047619048,85.984126984127
"12980","40305","2015",3,3,0,106666.666666667,1169,93
"12981","40306","2015",5,5,0,118900,1194,102.4
"12982","40307","2015",15,15,0,155396.733333333,1432.6,119.8
"12983","40308","2015",2,2,0,187500,1240,166
"12984","40309","2015",7,7,0,129000,1568.28571428571,79.2857142857143
"12985","40310","2015",133,79,54,190687.436090226,2572.81954887218,77.9097744360902
"12986","40311","2015",7,7,0,187867.142857143,1593.42857142857,120.142857142857
"12987","40312","2015",131,70,61,204530.152671756,2559.91603053435,82.5725190839695
"12988","40313","2015",38,34,4,121878.947368421,1307.55263157895,97.2894736842105
"12989","40314","2015",5,5,0,158800,1692.4,93.4
"12990","40315","2015",9,9,0,161468.111111111,1505.22222222222,109.333333333333
"12991","40316","2015",9,8,1,132237.777777778,1386.33333333333,97.6666666666667
"12992","40317","2015",45,38,7,243404.088888889,2469.75555555556,98.2222222222222
"12993","40318","2015",5,5,0,164285,1338.6,123.4
"12994","40319","2015",5,5,0,123300,1209.8,99.8
"12995","40320","2015",8,8,0,147250,1310.5,120.5
"12996","40322","2015",2,2,0,279500,1977.5,141.5
"12997","40323","2015",1,1,0,162000,1350,120
"12998","40324","2015",1,1,0,2e+05,1709,117
"12999","40325","2015",5,5,0,163876,1489.6,116
"13000","40326","2015",25,22,3,181098.8,1965.68,96.88
"13001","40328","2015",87,22,65,155170,3296.839,49.58621
"13002","40329","2015",2,2,0,130000,1496,87
"13003","40330","2015",7,7,0,188814.3,1233.143,174.1429
"13004","40331","2015",37,36,1,122505.4,1336.541,96.10811
"13005","40332","2015",26,26,0,173047.7,1797.654,100.5385
"13006","40333","2015",12,10,2,113296.7,1263.167,90
"13007","40334","2015",4,4,0,130250,1364.5,103.75
"13008","41001","2015",2,2,0,126250,1262.5,106
"13009","41002","2015",6,6,0,119833.3,1415.333,97
"13010","41003","2015",1,1,0,90000,744,121
"13011","41004","2015",2,2,0,62500,1056,64.5
"13012","41006","2015",7,7,0,118728.6,1404,91.71429
"13013","41007","2015",9,9,0,110405.6,1242,97
"13014","41008","2015",5,5,0,120000,1154.4,100.8
"13015","41009","2015",8,8,0,177459.2,1802,88.75
"13016","41010","2015",11,11,0,121747.2,1736.545,93
"13017","41012","2015",3,3,0,191400,1571.333,124.3333
"13018","41013","2015",3,3,0,264333.3,1775.333,141.3333
"13019","41014","2015",4,4,0,102750,934.75,120
"13020","41016","2015",4,4,0,75252.5,1161,67
"13021","41017","2015",6,6,0,140050,1439.167,101.6667
"13022","41018","2015",520,211,309,112431.4,1516.575,73.75
"13023","41019","2015",1,1,0,150000,1000,150
"13024","41020","2015",4,4,0,107750,888.75,124.75
"13025","41022","2015",3,3,0,160800,1227,133
"13026","41024","2015",3,3,0,86409.33,1084.667,77.33333
"13027","41025","2015",21,20,1,131212,1622.667,85.38095
"13028","41026","2015",2,2,0,92500,1127.5,96.5
"13029","41027","2015",1,1,0,105000,1117,94
"13030","41028","2015",2,2,0,81000,1330,62
"13031","41029","2015",17,17,0,131602.9,1172.824,114.5882
"13032","41030","2015",3,3,0,81666.67,1029,75
"13033","41031","2015",18,18,0,199129.4,1871.889,103.6111
"13034","41032","2015",20,20,0,131909.2,1308.9,101.65
"13035","41035","2015",7,7,0,120285.7,1188.571,111.4286
"13036","41036","2015",6,6,0,109000,1335.667,81.5
"13037","41037","2015",1,1,0,160000,1221,131
"13038","41038","2015",4,4,0,97125,1040,93.75
"13039","41039","2015",8,8,0,123263.8,969.25,127.125
"13040","41040","2015",8,8,0,121686.4,1359.375,94
"13041","41042","2015",3,3,0,126333.3,1119,89.66667
"13042","41043","2015",22,22,0,101418.2,1095.318,96.40909
"13043","41044","2015",8,8,0,52095,947.375,55.25
"13044","41045","2015",7,6,1,93614.29,2228.571,63.57143
"13045","41046","2015",18,17,1,170394.4,1611.278,107.0556
"13046","41047","2015",55,35,20,140854.9,1613.673,89.61818
"13047","41048","2015",1,1,0,68500,2210,31
"13048","41049","2015",8,8,0,143630,1409.875,93.75
"13049","41050","2015",10,10,0,162427,1827.6,88.7
"13050","41051","2015",8,8,0,105750,1266,81.5
"13051","41052","2015",9,9,0,193971.1,1735.111,115.1111
"13052","41053","2015",1,1,0,1e+05,943,106
"13053","41054","2015",3,3,0,97000,959.3333,96
"13054","41055","2015",23,23,0,149750,1559.522,96.56522
"13055","41057","2015",1,1,0,150000,1304,115
"13056","41058","2015",1,1,0,86000,1246,69
"13057","41059","2015",77,76,1,114758.6,1418.74,86.01299
"13058","41060","2015",7,7,0,90571.43,1130,81.57143
"13059","41061","2015",3,3,0,191000,1826.667,109.3333
"13060","41062","2015",6,6,0,145491,1230,114.6667
"13061","41063","2015",7,7,0,154465.7,1282.571,122.2857
"13062","41065","2015",5,5,0,168200,1301.8,125.2
"13063","41066","2015",9,8,1,131444.4,1444,90.33333
"13064","41067","2015",26,25,1,159227.3,1802.538,91.80769
"13065","41068","2015",4,4,0,81550,910.5,85
"13066","41069","2015",3,3,0,187333.3,1847,99.33333
"13067","41070","2015",5,5,0,101600,1114.4,80.8
"13068","41071","2015",6,6,0,117210,1373.667,93.5
"13069","41072","2015",2,2,0,107500,803.5,149.5
"13070","41073","2015",6,6,0,102466.7,953.8333,109.3333
"13071","41074","2015",17,17,0,106801.2,1355,79.58824
"13072","41075","2015",14,14,0,90069.86,869.7857,105.5714
"13073","41077","2015",4,4,0,135305,983.25,149.5
"13074","41078","2015",2,2,0,67000,830,80.5
"13075","41079","2015",1,1,0,45000,750,60
"13076","41080","2015",16,16,0,121490.3,1244.188,96.125
"13077","41081","2015",2,2,0,214100,1426,142.5
"13078","41083","2015",7,7,0,89892.86,1423,63.28571
"13079","41084","2015",16,16,0,101843.8,1078.812,93.4375
"13080","41085","2015",8,8,0,152062.5,1423,101.375
"13081","41086","2015",8,8,0,112312.5,1176,94
"13082","41087","2015",7,7,0,95928.57,1353.714,75.85714
"13083","41088","2015",5,5,0,94520,1040.6,88.4
"13084","41089","2015",2,2,0,108250,1251,79.5
"13085","41090","2015",5,5,0,68120,694.4,115.8
"13086","41091","2015",8,8,0,157362.5,1509.875,102.25
"13087","41093","2015",2,2,0,105000,1180,82.5
"13088","41094","2015",12,12,0,158523.4,1553.083,99.58333
"13089","41095","2015",13,13,0,76500,1070.308,75.76923
"13090","41096","2015",7,7,0,63342.86,1202.714,62.85714
"13091","41097","2015",33,33,0,89068.36,1158.485,78.30303
"13092","41098","2015",2,2,0,142715,1444,100
"13093","41099","2015",6,6,0,173416.7,1220.5,111.1667
"13094","41101","2015",12,12,0,129775,1510.833,89
"13095","41102","2015",8,8,0,100250,1365.625,75
"13096","41103","2015",5,5,0,109800,1062.2,107
"13097","41104","2015",23,22,1,118450,1554.391,85
"13098","41105","2015",13,13,0,128721.9,1312.769,104.1538
"13099","41106","2015",46,46,0,125638,1419.109,89.54348
"13100","41107","2015",5,5,0,108731,1093.4,105.6
"13101","41108","2015",3,3,0,113000,986.6667,119.3333
"13102","41109","2015",3,3,0,130110.7,1748.333,76
"13103","41110","2015",7,7,0,123007.1,1329.429,90
"13104","41112","2015",2,2,0,145000,1031.5,140
"13105","41113","2015",4,4,0,221500,1922.75,139.25
"13106","41114","2015",5,5,0,137220,1212,114.2
"13107","41115","2015",6,6,0,99500,972.6667,104.5
"13108","41116","2015",1,1,0,180000,1084,166
"13109","41119","2015",4,4,0,138250,1361.75,104.25
"13110","41120","2015",18,18,0,104294.8,1203.556,98.55556
"13111","41121","2015",1,1,0,115000,913,126
"13112","41122","2015",1,1,0,90000,714,126
"13113","41123","2015",5,5,0,78248,959.8,76.2
"13114","41124","2015",2,2,0,201950,2257,90.5
"13115","41125","2015",12,12,0,152175,1572.583,97.41667
"13116","41126","2015",9,9,0,123407.3,1313.444,98.88889
"13117","41127","2015",4,4,0,179875,2667.25,72.25
"13118","41128","2015",2,2,0,267250,1301,209.5
"13119","41129","2015",5,5,0,204600,1522.6,134
"13120","41130","2015",6,6,0,151877.5,1398.667,113.3333
"13121","41131","2015",9,9,0,110833.3,1229.889,87.33333
"13122","41134","2015",10,9,1,150758,1679.5,92.7
"13123","41135","2015",8,7,1,67812.5,969.625,83.75
"13124","41136","2015",64,59,5,121559.7,1299.578,95.70312
"13125","41137","2015",4,4,0,162000,1694.75,100.75
"13126","41139","2015",13,13,0,83346.15,1002.769,77.69231
"13127","41140","2015",5,5,0,99200,743.2,142
"13128","41141","2015",2,2,0,110730,1277.5,88.5
"13129","41142","2015",18,18,0,165332.8,1564.778,107.9444
"13130","41143","2015",15,14,1,95986.67,942.3333,98.6
"13131","41144","2015",7,7,0,140822.9,1462.857,98.28571
"13132","41145","2015",2,2,0,105000,1656,62.5
"13133","41146","2015",9,9,0,99516.67,1042.444,96.55556
"13134","41147","2015",24,24,0,152054.6,1585.25,97.41667
"13135","41148","2015",10,9,1,120551.1,1356.6,90.6
"13136","41149","2015",40,39,1,104895,1351.225,84.25
"13137","41150","2015",26,26,0,153154.2,1665.885,95.61538
"13138","41151","2015",43,40,3,110943.1,1261.791,89.34884
"13139","41152","2015",6,6,0,131500,1487.333,86.66667
"13140","41153","2015",3,3,0,89266.67,1595,58.66667
"13141","41154","2015",17,17,0,75235.29,903,82.70588
"13142","41155","2015",13,13,0,125307.7,1305.231,109.2308
"13143","41156","2015",5,5,0,140600,1600.4,102.8
"13144","41157","2015",8,8,0,117070.4,1165,96.75
"13145","41158","2015",24,24,0,171190.9,1557.583,114.6667
"13146","41159","2015",10,10,0,167060,1703.2,91.1
"13147","41160","2015",3,3,0,108166.7,1225,84
"13148","41161","2015",25,25,0,120829.6,1246.28,100.76
"13149","41163","2015",3,3,0,133354.3,1194.667,128.3333
"13150","41164","2015",25,25,0,97597.4,1067.28,93.16
"13151","41166","2015",2,2,0,235250,1351.5,185
"13152","41167","2015",34,34,0,119683.1,1319.235,91.55882
"13153","41168","2015",2,2,0,244100,2004,176.5
"13154","41171","2015",12,12,0,93208.33,1120,88.16667
"13155","41172","2015",4,4,0,123500,1022.5,120.25
"13156","41173","2015",45,45,0,110195,1138.222,97.4
"13157","41174","2015",2,2,0,104000,1039,101
"13158","41175","2015",9,9,0,112738.9,1256,94.88889
"13159","41176","2015",8,8,0,132041.2,1345.25,88.75
"13160","41177","2015",7,7,0,88857.14,1088.857,85.42857
"13161","41178","2015",1,1,0,1e+05,1250,80
"13162","41179","2015",3,3,0,115244.3,1255.333,98.33333
"13163","41180","2015",18,18,0,147396.7,1402.889,108.2778
"13164","41181","2015",3,3,0,128000,1467.333,90
"13165","41182","2015",6,6,0,105166.7,972,109.5
"13166","41184","2015",5,5,0,93200,1198.2,79.4
"13167","41185","2015",16,16,0,131140.2,1238,106.6875
"13168","41186","2015",5,5,0,143440,1442.8,117.8
"13169","41187","2015",6,6,0,125166.7,1122.333,111.3333
"13170","41188","2015",1,1,0,132500,974,136
"13171","41189","2015",5,5,0,111408.6,1057.4,107.4
"13172","41190","2015",2,2,0,156500,1220,130.5
"13173","41191","2015",1,1,0,100340,836,120
"13174","41192","2015",5,5,0,85000,1465,75.8
"13175","41193","2015",2,2,0,47500,544.5,84.5
"13176","41194","2015",200,183,17,108952.9,1274.875,88.995
"13177","41195","2015",1,1,0,60900,1353,45
"13178","41196","2015",1,1,0,40000,615,65
"13179","41198","2015",33,32,1,95478.79,1113,83.12121
"13180","41199","2015",6,5,1,147105,1752.833,84.66667
"13181","41200","2015",3,3,0,154566.7,1661.667,91.66667
"13182","41201","2015",4,4,0,96125,1031.25,115.75
"13183","41203","2015",3,3,0,165961.3,1687.667,98.66667
"13184","41204","2015",15,15,0,214010.7,1677.133,131.2667
"13185","41205","2015",1,1,0,50000,847,59
"13186","41206","2015",8,8,0,169000,1722,107.625
"13187","41207","2015",13,13,0,138706.9,1476.538,95.61538
"13188","41209","2015",7,7,0,145814.3,1540.857,95
"13189","41211","2015",29,29,0,138475.9,1416.276,95.93103
"13190","41212","2015",33,32,1,188290.9,1808.515,106.6667
"13191","41213","2015",2,2,0,85000,1113,77.5
"13192","41214","2015",4,4,0,93515,1282.5,74.75
"13193","41215","2015",2,2,0,130000,1179.5,111.5
"13194","41216","2015",9,9,0,111646.7,1385.778,85.22222
"13195","41217","2015",16,16,0,167176.9,1651.625,98.8125
"13196","41218","2015",7,7,0,70242.86,1144,58.42857
"13197","41219","2015",4,4,0,89280,1167.25,79
"13198","41220","2015",40,40,0,133229.4,1476.65,92.975
"13199","41221","2015",9,9,0,101272.2,1131.556,88.88889
"13200","41222","2015",1,1,0,119400,1388,86
"13201","41223","2015",8,8,0,149081.2,1298.25,117.875
"13202","41224","2015",2,2,0,95500,1235.5,80
"13203","41225","2015",2,2,0,176800,1276,132
"13204","41226","2015",22,22,0,149061.5,1523.136,97.54545
"13205","41229","2015",16,16,0,96625,1149.188,82.0625
"13206","41230","2015",13,13,0,156328.5,1471.077,107.5385
"13207","41231","2015",9,9,0,174207.8,1434.778,114.5556
"13208","41232","2015",51,44,7,115298,1243.373,88.45098
"13209","41233","2015",6,6,0,125466.7,1506.833,89.83333
"13210","41234","2015",3,3,0,93833.33,990.6667,84.33333
"13211","41235","2015",14,14,0,117000,1208.714,108.2143
"13212","41236","2015",1,1,0,1e+05,1053,95
"13213","41237","2015",10,10,0,151850,1909.2,93.1
"13214","41238","2015",22,17,5,104960.8,2071.318,77.54545
"13215","41239","2015",10,10,0,107724,1222.7,89.2
"13216","41241","2015",13,13,0,112856.9,1207.231,97.61538
"13217","41242","2015",38,36,2,100338.4,1130.289,93.36842
"13218","41243","2015",9,9,0,139764.3,1214.556,113.4444
"13219","41245","2015",5,5,0,129980,1525.2,116
"13220","41246","2015",4,4,0,243750,1555.5,156.5
"13221","41247","2015",14,14,0,140264.3,1165.786,122.1429
"13222","41248","2015",17,17,0,88396.59,972.7647,92.17647
"13223","41249","2015",16,16,0,102708.6,1132.75,93.1875
"13224","41250","2015",7,7,0,76414.29,833.5714,90.71429
"13225","41251","2015",3,3,0,171666.7,1873,92.66667
"13226","41252","2015",14,14,0,143741.4,1527.786,99.35714
"13227","41253","2015",7,7,0,124367.1,1513.143,83.57143
"13228","41254","2015",1,1,0,260000,1106,235
"13229","41255","2015",8,8,0,101187.5,1018.125,90.625
"13230","41256","2015",9,9,0,121331.1,1188.222,97
"13231","41258","2015",8,8,0,81125,1181.375,68.75
"13232","41259","2015",7,7,0,107003.1,1281.429,90.14286
"13233","41260","2015",10,10,0,168545,1518.1,102.7
"13234","41261","2015",1,1,0,145000,1208,120
"13235","41262","2015",11,11,0,209521.5,1972,109.6364
"13236","41265","2015",3,3,0,73000,1211.667,63
"13237","41267","2015",8,8,0,140937.5,1341.125,107.625
"13238","41269","2015",168,104,64,139468.9,1614.815,87.41667
"13239","41271","2015",6,6,0,99342.5,1080.167,96.33333
"13240","41273","2015",8,8,0,87600,1007,78.375
"13241","41274","2015",1,1,0,350054,3646,96
"13242","41275","2015",9,9,0,106448.7,1175.556,90.88889
"13243","41276","2015",14,11,3,117321.4,1629.857,71.5
"13244","41277","2015",3,3,0,141056.7,918.3333,153
"13245","41278","2015",3,3,0,88666.67,967.3333,92.66667
"13246","41279","2015",6,6,0,70500,886.6667,81.66667
"13247","41280","2015",27,27,0,83793.44,1456.037,79.88889
"13248","41281","2015",5,5,0,123680,1437.2,84.8
"13249","41282","2015",3,3,0,191666.7,3500,113.6667
"13250","41283","2015",3,3,0,108666.7,1300,83.66667
"13251","41284","2015",1,1,0,50000,781,64
"13252","41285","2015",6,6,0,166991.7,1667,116.5
"13253","41286","2015",1,1,0,55000,833,66
"13254","41287","2015",2,2,0,171000,1647.5,109.5
"13255","41288","2015",8,8,0,145507.5,1492.125,98.875
"13256","41289","2015",2,2,0,105250,1762.5,59.5
"13257","41290","2015",2,2,0,82500,882.5,85
"13258","41291","2015",5,5,0,135200,1368,98
"13259","41293","2015",2,2,0,135000,930.5,142.5
"13260","41294","2015",13,13,0,135564.6,1415.692,98.38462
"13261","41295","2015",69,65,4,172168.4,1812.797,96.37681
"13262","41296","2015",13,13,0,174530.8,1647.692,102
"13263","41297","2015",10,10,0,158270,1658.5,93.1
"13264","42001","2015",7,7,0,130955.7,1255.429,113.8571
"13265","42002","2015",5,5,0,103450,1205.2,92.4
"13266","42003","2015",13,13,0,172961.2,1394,118.6923
"13267","42005","2015",74,38,36,160684.7,1747.351,90.97297
"13268","42006","2015",6,6,0,86583.33,880.6667,104.5
"13269","42007","2015",2,2,0,75000,776,107.5
"13270","42008","2015",2,1,1,73500,1054.5,69.5
"13271","42009","2015",5,5,0,193520,1408.8,153.2
"13272","42010","2015",17,16,1,177718.2,1844.118,97.17647
"13273","42011","2015",34,32,2,122357.4,1393.853,93.11765
"13274","42012","2015",6,6,0,191753.3,1515.167,123.8333
"13275","42013","2015",13,12,1,165709.2,1766,95.76923
"13276","42014","2015",7,7,0,119635.7,1013.143,122.1429
"13277","42015","2015",11,11,0,98658.45,1059.364,90.54545
"13278","42016","2015",2,2,0,106000,819.5,127
"13279","42017","2015",8,7,1,171965,1924.75,94
"13280","42018","2015",4,4,0,190325,1779.75,110.25
"13281","42019","2015",20,18,2,110037.5,1227.05,83.95
"13282","42020","2015",14,14,0,207215.5,1873.571,112.5714
"13283","42021","2015",12,12,0,145262.9,1388.5,106.0833
"13284","42022","2015",25,22,3,163908.8,1884.48,87.76
"13285","42023","2015",10,5,5,87105,1119.3,77.3
"13286","42026","2015",18,16,2,147144.4,1289.111,123.1111
"13287","42027","2015",4,4,0,82500,894,93
"13288","42028","2015",2,2,0,95000,1128.5,87.5
"13289","42029","2015",16,16,0,100063.5,1117.688,89.5625
"13290","42030","2015",4,4,0,108351.2,1162,97
"13291","42031","2015",3,3,0,194000,1351.667,145
"13292","42032","2015",11,11,0,263715.8,2308.182,124.2727
"13293","42033","2015",5,4,1,154320,1904,92.6
"13294","42034","2015",1,1,0,60000,750,80
"13295","42036","2015",3,3,0,226463.3,2197.667,102
"13296","42037","2015",4,4,0,194718.8,1680,120.25
"13297","42038","2015",7,7,0,172385.7,1653.429,106.8571
"13298","42039","2015",3,3,0,110600,1201.667,82
"13299","42040","2015",2,2,0,41120,409.5,104
"13300","42041","2015",4,4,0,374400,3279.5,109.5
"13301","42042","2015",11,11,0,236531.8,1906.636,122.1818
"13302","42043","2015",15,14,1,228179.9,2131.933,106
"13303","42044","2015",89,47,42,116057,1337.944,88.14607
"13304","42046","2015",14,13,1,152798.6,1527.429,102.5
"13305","42047","2015",4,4,0,59250,971,60
"13306","42048","2015",20,19,1,131611.7,1216.6,107.7
"13307","42049","2015",9,9,0,107230,1247.889,90.77778
"13308","42050","2015",2,2,0,107000,1256,90
"13309","42051","2015",4,4,0,214712.5,2287.5,98
"13310","42052","2015",25,12,13,115588,1142.56,99.64
"13311","42053","2015",1,1,0,223000,1487,150
"13312","42054","2015",2,2,0,122415,927,130
"13313","42055","2015",5,5,0,133272,1181.2,122
"13314","42056","2015",17,14,3,140661.8,1543,89.11765
"13315","42058","2015",6,6,0,66921.67,982.1667,72
"13316","42059","2015",50,30,20,130905.2,1451.7,100
"13317","42060","2015",3,3,0,143333.3,2218,65.33333
"13318","42061","2015",3,3,0,59333.33,1083.667,49.33333
"13319","42062","2015",5,5,0,196380,1749.8,114.2
"13320","42063","2015",4,4,0,83366.25,1011.5,83.25
"13321","42064","2015",3,3,0,145333.3,2578.667,83
"13322","42065","2015",10,10,0,159275,1524.7,104.8
"13323","42066","2015",3,3,0,133333.3,1513.667,100
"13324","42067","2015",3,2,1,125666.7,1587.333,77
"13325","42068","2015",1,1,0,179000,1845,97
"13326","42069","2015",29,29,0,143707.3,1459.966,102.0345
"13327","42070","2015",6,6,0,130916.7,1159.833,109.8333
"13328","42071","2015",84,33,51,96047.74,1193.345,76.69048
"13329","42073","2015",9,9,0,108966.7,1162.111,97.11111
"13330","42074","2015",5,5,0,64700,849.2,73.8
"13331","42075","2015",12,12,0,190493.3,1945.75,107.75
"13332","42076","2015",3,3,0,119000,1209,95
"13333","42077","2015",2,2,0,117675,1428,80
"13334","42078","2015",1,1,0,122000,2542,48
"13335","42079","2015",5,5,0,106400,794.8,139.8
"13336","42081","2015",18,18,0,177414.7,1752,108.5556
"13337","42083","2015",2,1,1,215525,2384.5,90.5
"13338","42084","2015",2,2,0,129500,1175,89
"13339","42085","2015",5,5,0,140980,2044.4,70.4
"13340","42086","2015",6,6,0,113733.3,1001.667,115.1667
"13341","42087","2015",8,8,0,210483.8,1621.125,131.75
"13342","42088","2015",9,9,0,132087.8,1491.556,92.66667
"13343","42089","2015",5,5,0,202491,1544.6,134.6
"13344","42090","2015",4,4,0,180662.5,2008.75,91
"13345","42091","2015",7,7,0,101090.7,1265.429,78.28571
"13346","42092","2015",24,12,12,198618.8,2116.958,98.54167
"13347","42093","2015",8,4,4,200259.5,1943.125,105.375
"13348","42094","2015",93,51,42,125063.9,1435.527,87.12903
"13349","42095","2015",118,38,80,104862.2,1185.178,88.30508
"13350","42096","2015",2,2,0,225310,2100,107
"13351","42097","2015",55,40,15,205384.6,1875.164,110.4
"13352","42098","2015",2,2,0,155000,1228.5,131.5
"13353","42099","2015",28,16,12,132082.9,1472.536,90.71429
"13354","42100","2015",1,1,0,175000,1535,114
"13355","42101","2015",1,1,0,152000,1267,120
"13356","42102","2015",2,2,0,209250,1783.5,118
"13357","42103","2015",38,19,19,138950.7,1613.579,86.89474
"13358","42104","2015",10,10,0,89410,870.8,104.2
"13359","42106","2015",2,2,0,1e+05,1583.5,62.5
"13360","42108","2015",14,14,0,180757.9,2013,92.35714
"13361","42109","2015",1,1,0,30000,375,80
"13362","42110","2015",22,13,9,167908.6,1758.455,98.22727
"13363","42112","2015",7,7,0,74888.57,662.7143,106.5714
"13364","42113","2015",2,2,0,125050,1095.5,114
"13365","42115","2015",10,6,4,152000,1458.1,102.9
"13366","42116","2015",2,2,0,50750,861.5,58.5
"13367","42117","2015",2,2,0,97000,1232,80.5
"13368","42118","2015",2,2,0,285500,1409.5,201.5
"13369","42119","2015",3,2,1,115333.3,933.6667,128.6667
"13370","42120","2015",19,19,0,136966.6,1423.421,95.42105
"13371","42121","2015",2,2,0,40000,681,67
"13372","42122","2015",10,10,0,200956,1592.7,116.7
"13373","42123","2015",39,17,22,135756.4,1581.462,87.33333
"13374","42124","2015",1,1,0,72000,1125,64
"13375","42126","2015",12,12,0,115063.3,1410,81.16667
"13376","42127","2015",62,56,6,131039.1,1369.79,96.41935
"13377","42128","2015",3,3,0,114233.3,1030.667,111.6667
"13378","42129","2015",11,11,0,160243.6,1700.091,92.54545
"13379","42130","2015",2,2,0,200175,1942,103
"13380","42131","2015",3,3,0,105733.3,958,114.3333
"13381","42132","2015",4,4,0,169525,1766,99
"13382","42133","2015",10,10,0,116370,1400.5,84.5
"13383","42134","2015",11,11,0,156676.4,1596.636,100.8182
"13384","42135","2015",2,2,0,156900,1644,95.5
"13385","42136","2015",4,4,0,104625,1844.5,64.5
"13386","42137","2015",8,8,0,143862.5,1339.5,109.125
"13387","42138","2015",3,3,0,143483.3,1546,90
"13388","42139","2015",9,7,2,111811.1,1304.222,89.44444
"13389","42140","2015",1,1,0,135000,1688,80
"13390","42141","2015",7,7,0,89428.57,1012.857,88.28571
"13391","42142","2015",6,6,0,128766.7,1567.667,82.83333
"13392","42143","2015",6,6,0,200658.3,1331,158.5
"13393","42145","2015",10,9,1,91150,882.5,101.4
"13394","42146","2015",1,1,0,117470,653,180
"13395","42147","2015",192,97,95,133864.6,1668.182,83.25
"13396","42148","2015",5,5,0,110500,1101.6,98.4
"13397","42149","2015",75,46,29,158999.1,1919.947,85.13333
"13398","42150","2015",13,13,0,140900,1515.231,92.30769
"13399","42151","2015",5,5,0,199510,1476,139.8
"13400","42152","2015",4,4,0,88607.5,913.25,100.25
"13401","42153","2015",7,7,0,102375.7,1192.143,88.57143
"13402","42154","2015",3,3,0,57333.33,1366.333,47.33333
"13403","42155","2015",17,17,0,108658.4,1200.118,89.47059
"13404","42156","2015",8,7,1,132370.8,1391.125,96.375
"13405","42157","2015",4,4,0,156825,1299.5,124.5
"13406","42158","2015",3,3,0,71370,1130.333,60.66667
"13407","42159","2015",6,6,0,139219.2,1477,93
"13408","42160","2015",1,1,0,148000,1345,110
"13409","42161","2015",2,2,0,263060,2138.5,123
"13410","42162","2015",5,5,0,194400,1623.8,128.2
"13411","42163","2015",6,6,0,104433.3,963.6667,111
"13412","42165","2015",22,21,1,124221.9,1253.318,101.2273
"13413","42166","2015",6,6,0,155925,1664.667,94.83333
"13414","42167","2015",4,4,0,131295,1396.25,89.75
"13415","42168","2015",35,22,13,150524,1641.343,92.85714
"13416","42169","2015",7,7,0,166925,1971.857,88.28571
"13417","42170","2015",16,15,1,177021.9,1529.25,116.125
"13418","42171","2015",3,3,0,122666.7,1339.333,92
"13419","42172","2015",11,11,0,151517.4,1504.545,111.3636
"13420","42173","2015",1,1,0,1e+05,833,120
"13421","42174","2015",6,6,0,120125,1269,94
"13422","42175","2015",10,10,0,94930,1034.8,95.7
"13423","42176","2015",15,14,1,143273.3,1522.6,93.06667
"13424","42177","2015",27,25,2,103103.7,1084.037,99.51852
"13425","42178","2015",9,8,1,173133.3,1265,141
"13426","42179","2015",4,3,1,133750,1911,70
"13427","42180","2015",5,5,0,177000,1719,102.6
"13428","42181","2015",7,5,2,108772.9,1074.429,98.85714
"13429","42182","2015",20,18,2,127267.2,1262.25,100.85
"13430","42183","2015",37,18,19,93003.89,1171.541,78.16216
"13431","42184","2015",114,72,42,116247.9,1427.588,80.64035
"13432","42185","2015",5,5,0,214688,2195.8,103.2
"13433","42186","2015",93,53,40,142946.2,1629.925,89.48387
"13434","42187","2015",414,104,310,85302.48,1107.797,76.07488
"13435","42188","2015",1,1,0,58000,384,151
"13436","42189","2015",67,30,37,135553,1597.851,85.35821
"13437","42191","2015",11,11,0,189914.5,2015.818,104.6364
"13438","42192","2015",9,9,0,114547.8,1118.889,98.44444
"13439","42193","2015",11,9,2,118200.9,1086.636,103.1818
"13440","42194","2015",2,2,0,237250,3145,105
"13441","42195","2015",13,10,3,74923.08,853.1538,94.30769
"13442","42197","2015",9,9,0,160760,1646.889,97
"13443","42198","2015",8,8,0,147555,1414.75,104.625
"13444","42199","2015",15,14,1,116993.3,1392.2,88.73333
"13445","42200","2015",11,11,0,169932.7,2017.273,89.27273
"13446","42201","2015",4,4,0,154348.8,1640.25,102
"13447","42202","2015",6,6,0,101639.7,1083.833,101.5
"13448","42203","2015",5,5,0,89550,1244.8,82.6
"13449","42204","2015",11,9,2,95768.18,956.4545,101.8182
"13450","42205","2015",3,3,0,87340,1972,73.33333
"13451","42206","2015",9,9,0,252288.3,2277.222,112.6667
"13452","42207","2015",240,86,154,132818.9,1526.737,86.94583
"13453","42208","2015",9,8,1,155370,1718.667,90.66667
"13454","42209","2015",5,5,0,75680,1005.6,70.6
"13455","42210","2015",4,4,0,262324,1930.25,140
"13456","42211","2015",21,10,11,156522.4,1772.762,88
"13457","42212","2015",7,7,0,154121.4,1721.143,102.2857
"13458","42213","2015",4,4,0,137425,1132.25,115.75
"13459","42214","2015",7,7,0,170128.6,1559.857,107.1429
"13460","42215","2015",14,14,0,89754.64,870.5,104.1429
"13461","42216","2015",1,1,0,163600,1636,100
"13462","42217","2015",4,4,0,60500,612.25,104.5
"13463","42218","2015",1846,205,1641,86084.57,1131.21,74.69231
"13464","42219","2015",12,12,0,141023.3,1311.333,110.9167
"13465","42220","2015",1,1,0,128870,1401,92
"13466","42221","2015",6,6,0,154261.7,1555.5,102.3333
"13467","42222","2015",38,29,9,232745.3,2136.263,111.3158
"13468","42223","2015",42,22,20,165726.4,1784.357,95.45238
"13469","42224","2015",28,19,9,157586.4,1581.714,97.85714
"13470","42225","2015",35,32,3,175104.8,2022.2,86.74286
"13471","42226","2015",3,3,0,169125,1107.333,143
"13472","42227","2015",2,2,0,120505,1257,93
"13473","42228","2015",11,11,0,208368.2,1813.818,115.0909
"13474","42229","2015",4,4,0,81250,1172,73
"13475","42230","2015",9,9,0,106466.7,1074.222,94
"13476","42231","2015",8,8,0,130962.5,1201.875,105
"13477","42232","2015",3,3,0,58833.33,715.3333,81.66667
"13478","42233","2015",10,10,0,143960,1362.3,106.1
"13479","42234","2015",21,17,4,201483.3,2007.333,98.38095
"13480","42235","2015",7,7,0,104502.9,1195.571,89.57143
"13481","42237","2015",40,31,9,163346.3,1777.825,90.975
"13482","42238","2015",1,1,0,20000,339,59
"13483","42239","2015",13,13,0,130565.8,1766.308,81.69231
"13484","42240","2015",6,6,0,94000,1047.167,96
"13485","42241","2015",3,3,0,122666.7,1092.667,128
"13486","42242","2015",16,16,0,204719.8,2054.5,100.6875
"13487","42243","2015",1,1,0,61000,871,70
"13488","42245","2015",3,3,0,91633.33,961.6667,93
"13489","42246","2015",12,12,0,96170.42,1154.167,80.66667
"13490","42247","2015",1,1,0,56000,933,60
"13491","42248","2015",5,5,0,66800,656.2,94.4
"13492","42249","2015",10,10,0,101763.9,1007.8,105.5
"13493","42251","2015",2,2,0,181500,1877.5,97
"13494","42253","2015",8,8,0,127671.2,1413.125,89.25
"13495","42254","2015",8,8,0,114962.5,1202.75,84.625
"13496","42255","2015",2,2,0,104000,714.5,164
"13497","42256","2015",47,45,2,159908.9,1692.638,98.6383
"13498","42257","2015",5,5,0,66694,898.4,73.6
"13499","42259","2015",32,27,5,208892.2,2069.406,98.96875
"13500","42260","2015",4,4,0,141304.5,1674.75,100.25
"13501","42261","2015",8,8,0,94546.88,1156.375,92.5
"13502","42262","2015",10,8,2,119590,1307.9,92.7
"13503","42264","2015",5,5,0,187334,1909,101.6
"13504","42265","2015",8,8,0,181118.8,1944.25,93.125
"13505","42266","2015",7,7,0,168485.7,1280.429,134.2857
"13506","42267","2015",15,15,0,129602.6,1300.467,105.1333
"13507","42268","2015",2,2,0,113250,1465.5,79
"13508","42269","2015",2,2,0,205525,1885.5,106
"13509","42270","2015",11,7,4,127550,1516.364,83.72727
"13510","42271","2015",26,24,2,182108.5,1719.5,107.3462
"13511","42272","2015",14,12,2,159900.4,1726.286,93.5
"13512","42273","2015",5,5,0,115250,1175.4,96.4
"13513","42274","2015",4,4,0,115125,1322.25,92.25
"13514","42275","2015",65,25,40,193552.9,2189.154,87.47692
"13515","42276","2015",5,5,0,90160,1144,101.4
"13516","42277","2015",4,4,0,76252.5,867,104.5
"13517","42279","2015",173,122,51,177154.9,2020.289,91.79769
"13518","42280","2015",1,1,0,1e+05,730,137
"13519","42282","2015",3,3,0,50833.33,760.3333,67.66667
"13520","42283","2015",3,3,0,96666.67,1574,59
"13521","42284","2015",14,14,0,128403.6,1292.5,99.92857
"13522","42285","2015",33,25,8,157686.4,1799.576,86.33333
"13523","42286","2015",5,5,0,149980,1705.8,90.2
"13524","42287","2015",9,9,0,96083.33,1611.667,75.66667
"13525","42288","2015",3,3,0,70333.33,629,88.66667
"13526","42289","2015",9,8,1,119833.3,1092.667,106.6667
"13527","42290","2015",3,3,0,198856.7,1751.333,116
"13528","42293","2015",5,4,1,104000,1530,77.4
"13529","42294","2015",12,12,0,248391.7,1666.167,135.8333
"13530","42295","2015",2,2,0,60000,633.5,95
"13531","42296","2015",1,1,0,165000,1833,90
"13532","42297","2015",6,6,0,176350,1623.5,112.5
"13533","42299","2015",33,19,14,147178.5,1644.909,88.27273
"13534","42300","2015",2,2,0,208750,1714.5,120.5
"13535","42301","2015",14,13,1,99237.86,1223,78.57143
"13536","42302","2015",66,42,24,203071.5,2106.5,96.42424
"13537","42303","2015",2,2,0,23750,528,45
"13538","42304","2015",74,67,7,150907.8,1651.743,91.85135
"13539","42305","2015",59,32,27,167146.2,2057.136,84.81356
"13540","42306","2015",8,6,2,159331.2,1565.5,100
"13541","42307","2015",8,8,0,174007.2,2073.125,85.125
"13542","42308","2015",10,8,2,137576,1746.6,88.9
"13543","42311","2015",8,8,0,285553.1,1957.875,146.25
"13544","42312","2015",4,4,0,151392.5,1397.25,113.25
"13545","42313","2015",5,4,1,91600,1050.2,91.6
"13546","42314","2015",1,1,0,56000,1167,48
"13547","42315","2015",1,1,0,148000,1762,84
"13548","42316","2015",47,35,12,148181.1,1524.745,96.68085
"13549","42318","2015",9,9,0,110411.1,1263.333,89.22222
"13550","42319","2015",3,3,0,90900,1301.667,77.66667
"13551","42320","2015",6,6,0,106607.7,908.8333,118.5
"13552","42322","2015",8,8,0,144855.2,1555,97.125
"13553","42323","2015",74,54,20,178221.4,2023.608,88.21622
"13554","42324","2015",8,8,0,169993.8,1955.5,88.125
"13555","42325","2015",2,2,0,160500,1198,139.5
"13556","42326","2015",7,7,0,119592.4,1718,74.71429
"13557","42327","2015",8,7,1,164454.8,1602,106.625
"13558","42328","2015",7,7,0,147364.3,1464,105.4286
"13559","42329","2015",3,3,0,150166.7,1334.333,110
"13560","42330","2015",89,25,64,130632.8,1447.393,87.30337
"13561","42331","2015",8,8,0,111823.8,1493.5,77.625
"13562","42332","2015",35,34,1,170547.1,1610.029,108.0857
"13563","42333","2015",3,3,0,101666.7,921,140
"13564","42334","2015",20,19,1,104971.2,1229.1,88.2
"13565","42335","2015",4,3,1,169550,2037.25,91
"13566","42336","2015",5,5,0,173300,1819.4,94.6
"13567","42337","2015",6,6,0,57083.33,715,79.5
"13568","42338","2015",11,11,0,149008.2,1295.091,118.9091
"13569","42339","2015",1,1,0,97000,1386,70
"13570","43001","2015",3,3,0,61500,676.3333,89
"13571","43002","2015",23,12,11,127634,1457.13,88.17391
"13572","43003","2015",8,8,0,82609.38,796.875,102.875
"13573","43004","2015",2,2,0,92178,1252.5,75
"13574","43005","2015",4,4,0,32625,770.75,46
"13575","43007","2015",2,2,0,129050,1281.5,115.5
"13576","43008","2015",1,1,0,154000,2053,75
"13577","43010","2015",5,5,0,151162,1375.8,107.6
"13578","43011","2015",3,3,0,68833.33,846,90.33333
"13579","43012","2015",66,50,16,139262.3,1610.152,88.57576
"13580","43013","2015",2,2,0,51500,881,59
"13581","43015","2015",1,1,0,60000,476,126
"13582","43016","2015",10,10,0,57610,777.9,70.1
"13583","43017","2015",3,3,0,146666.7,1217,125
"13584","43018","2015",12,11,1,135370.9,1592.917,109.75
"13585","43019","2015",1,1,0,60000,909,66
"13586","43020","2015",52,50,2,138385.7,1465.846,96.84615
"13587","43021","2015",5,5,0,95601.6,1058.6,106
"13588","43022","2015",3,3,0,95783.33,1146,83
"13589","43023","2015",3,3,0,113333.3,939,119.6667
"13590","43024","2015",11,11,0,101106.4,1302.273,77.54545
"13591","43025","2015",25,24,1,127636.2,1694.32,93.8
"13592","43026","2015",3,3,0,135166.7,898.6667,148.3333
"13593","43028","2015",7,7,0,133139.6,1467,89.71429
"13594","43030","2015",1,1,0,193650,1490,130
"13595","43031","2015",1,1,0,43200,424,102
"13596","43032","2015",13,11,2,112030.8,1076.231,108.4615
"13597","43033","2015",12,12,0,84625,807.3333,104
"13598","43034","2015",2,2,0,57000,725,84.5
"13599","43035","2015",1,1,0,151025,2221,68
"13600","43036","2015",2,2,0,126715,1273,102
"13601","43037","2015",1,1,0,3e+05,1562,192
"13602","43038","2015",10,8,2,80982.5,1093.9,74.1
"13603","43039","2015",2,2,0,77500,931,76.5
"13604","43040","2015",59,47,12,106544.1,1114.593,93.35593
"13605","43041","2015",59,30,29,117122,1413.78,82.05085
"13606","43042","2015",3,3,0,92000,1158.333,77
"13607","43043","2015",3,3,0,82333.33,958.6667,105
"13608","43044","2015",2,2,0,89000,1033,101
"13609","43045","2015",1,1,0,50000,1111,45
"13610","43046","2015",33,18,15,145984.3,1710.818,89.18182
"13611","43047","2015",2,2,0,181500,1463.5,126.5
"13612","43048","2015",11,11,0,72418.18,722.4545,91.27273
"13613","43049","2015",8,8,0,70312.5,918.25,75.125
"13614","43051","2015",35,28,7,142020.3,1383.857,106.9429
"13615","43052","2015",2,2,0,49700,569.5,100.5
"13616","43053","2015",2,2,0,87500,1277,81
"13617","43056","2015",3,3,0,65393.33,535.3333,113
"13618","43058","2015",5,5,0,226900,2134.2,113.4
"13619","43059","2015",5,5,0,93860,1016.4,86.2
"13620","43060","2015",1,1,0,35000,486,72
"13621","43061","2015",3,3,0,181973.3,1548.667,115.3333
"13622","43062","2015",5,5,0,125880,1297.8,96
"13623","43063","2015",4,4,0,49825,753.25,66.75
"13624","43064","2015",1,1,0,34000,773,44
"13625","43066","2015",3,3,0,82166.67,1349.667,92.66667
"13626","43067","2015",4,4,0,70975,985.75,67.75
"13627","43069","2015",4,4,0,75500,1154,63.75
"13628","43070","2015",2,2,0,64250,765,84
"13629","43071","2015",7,7,0,131000,1316.429,101.5714
"13630","43072","2015",1,1,0,115145,822,140
"13631","43073","2015",2,2,0,80000,586,126
"13632","43074","2015",8,8,0,161606.2,1719.5,98.5
"13633","43075","2015",1,1,0,74000,587,126
"13634","43076","2015",2,2,0,146000,852.5,164
"13635","43077","2015",1,1,0,75000,564,133
"13636","43078","2015",21,18,3,156984.8,1506,105
"13637","43080","2015",15,14,1,112600,883.2,131.0667
"13638","43082","2015",1,1,0,90815,1020,89
"13639","43083","2015",2,2,0,54000,771.5,87
"13640","43084","2015",6,6,0,154833.3,1517.667,98.33333
"13641","43085","2015",1,1,0,80000,1778,45
"13642","43086","2015",2,2,0,91726,954,116
"13643","43087","2015",17,15,2,153688.2,1627.765,98.76471
"13644","43088","2015",2,2,0,130000,1465.5,90
"13645","43089","2015",36,27,9,133178.8,1445.417,96.55556
"13646","43090","2015",3,3,0,68500,774.6667,87.33333
"13647","43091","2015",8,4,4,108407.5,1633.375,84.5
"13648","43092","2015",5,5,0,99400,1350.4,76.4
"13649","43093","2015",2,2,0,66295,744.5,97
"13650","43095","2015",3,3,0,51000,776.6667,68.33333
"13651","43096","2015",4,4,0,80200,877.75,86.75
"13652","43099","2015",5,5,0,80770,1254.4,60.2
"13653","43100","2015",1,1,0,67400,674,100
"13654","43101","2015",1,1,0,30000,500,60
"13655","43102","2015",5,5,0,94200,952.8,106
"13656","43103","2015",1,1,0,133000,1317,101
"13657","43104","2015",1,1,0,40000,500,80
"13658","43106","2015",3,3,0,41533.33,540.6667,74
"13659","43107","2015",2,2,0,77500,968.5,80
"13660","43108","2015",2,2,0,61500,724,84
"13661","43109","2015",2,2,0,161000,2279,75
"13662","43110","2015",6,6,0,89750,919.1667,94
"13663","43111","2015",9,9,0,87833.33,1081.111,83.77778
"13664","43112","2015",34,28,6,78259.12,875.0294,86.5
"13665","43113","2015",9,9,0,108922.2,1278.667,82.22222
"13666","43114","2015",9,8,1,138366.7,1616.444,87.55556
"13667","43115","2015",10,10,0,83000,1096.9,94.3
"13668","43116","2015",1,1,0,46000,438,105
"13669","43117","2015",3,3,0,102145,733.6667,143.3333
"13670","43118","2015",5,5,0,59800,741.6,83
"13671","43119","2015",4,4,0,89250,1612.25,55.75
"13672","43120","2015",16,16,0,70593.75,913.6875,82.9375
"13673","43121","2015",2,2,0,147500,1280,112
"13674","43122","2015",4,4,0,82945,956.5,82
"13675","43123","2015",5,5,0,70888,935.4,82
"13676","43124","2015",5,5,0,87300,834.4,98.4
"13677","43125","2015",2,2,0,45250,766.5,64.5
"13678","43126","2015",3,3,0,199166.7,1452,136.3333
"13679","43127","2015",8,8,0,138393.8,1461.25,93.75
"13680","43129","2015",2,2,0,93675,833.5,102.5
"13681","43130","2015",16,16,0,114110.6,1074.5,101.1875
"13682","43131","2015",2,2,0,126350,631.5,170
"13683","43132","2015",12,12,0,121395.8,1511.083,81.25
"13684","43133","2015",2,2,0,81500,869.5,96.5
"13685","43134","2015",1,1,0,74000,1423,52
"13686","43135","2015",10,10,0,107420,995.4,101
"13687","43136","2015",3,3,0,110833.3,951,105
"13688","43137","2015",74,59,15,156148.6,1668.473,95.5
"13689","43138","2015",3,3,0,112356.7,841.6667,133
"13690","43140","2015",4,4,0,146775,1475.5,96.5
"13691","43141","2015",2,1,1,105750,1274.5,78.5
"13692","43142","2015",5,5,0,101816,1206.6,84.4
"13693","43144","2015",2,2,0,128500,1201.5,110
"13694","43145","2015",2,2,0,50060,712.5,78
"13695","43147","2015",7,6,1,104350,1204.429,90.14286
"13696","43148","2015",4,4,0,110837.5,937.25,120.75
"13697","43149","2015",2,2,0,65250,733.5,89
"13698","43150","2015",7,7,0,123611.4,1299.286,95.85714
"13699","43151","2015",1,1,0,60000,682,88
"13700","43152","2015",16,15,1,131575,1342.875,101.1875
"13701","43153","2015",21,16,5,122964.3,1393,87.7619
"13702","43154","2015",9,8,1,61294.44,806.3333,77.33333
"13703","43156","2015",5,5,0,71498,801.2,94.2
"13704","43157","2015",271,49,222,98229.03,1336.601,75.10332
"13705","43158","2015",5,5,0,122460,1250.4,95.2
"13706","43159","2015",3,3,0,106100,1592.333,68.66667
"13707","43160","2015",1,1,0,60000,667,90
"13708","43162","2015",30,30,0,98860,1196.433,85.83333
"13709","43163","2015",6,6,0,114250,1132.167,85.83333
"13710","43164","2015",3,3,0,77333.33,1112,72
"13711","43165","2015",11,11,0,89081.82,1286.273,77.27273
"13712","43166","2015",3,3,0,120333.3,1135.667,101.3333
"13713","43167","2015",1,1,0,17100,684,25
"13714","43168","2015",2,2,0,52500,447.5,122
"13715","43170","2015",4,4,0,123219.8,1248,95
"13716","43171","2015",1,1,0,50000,385,130
"13717","43174","2015",4,3,1,165905,1275.25,131.5
"13718","43177","2015",32,25,7,115885.6,1251.469,95.53125
"13719","43178","2015",3,3,0,82133.33,1989.667,61.66667
"13720","43181","2015",7,7,0,158719.6,1242.857,125.4286
"13721","43183","2015",3,3,0,59166.67,639,90.66667
"13722","43184","2015",20,15,5,134735,1422.45,89.8
"13723","43185","2015",33,33,0,89872.88,1062.848,87.60606
"13724","43186","2015",4,4,0,74225,1372.5,62.75
"13725","43188","2015",4,4,0,95937.5,1198,93.5
"13726","43189","2015",2,2,0,128525,1208,104
"13727","43190","2015",24,23,1,150665,1522.875,97.04167
"13728","43191","2015",1,1,0,150692,1159,130
"13729","43192","2015",3,3,0,98333.33,1069.667,90
"13730","43193","2015",1,1,0,50000,685,73
"13731","43194","2015",4,4,0,108625,1387,85.25
"13732","43195","2015",3,3,0,71333.33,765.3333,77
"13733","43196","2015",1,1,0,26000,520,50
"13734","43197","2015",2,2,0,112050,994.5,110.5
"13735","43198","2015",3,3,0,91116.67,1132.333,110.3333
"13736","43199","2015",5,5,0,94860,1301.4,74.6
"13737","43200","2015",16,13,3,115669.1,1242.75,89.75
"13738","43201","2015",3,3,0,96666.67,1430.333,69.66667
"13739","43203","2015",2,2,0,190400,1771.5,108
"13740","43204","2015",1,1,0,51500,644,80
"13741","43205","2015",33,29,4,144550.6,1591.394,93.75758
"13742","43206","2015",1,1,0,29900,388,77
"13743","43207","2015",2,2,0,145000,1788,84
"13744","43210","2015",4,4,0,76750,682.25,137.5
"13745","43211","2015",19,15,4,122284.2,1232.316,92.84211
"13746","43212","2015",6,5,1,83741.67,1017.667,84
"13747","43213","2015",18,17,1,115510.6,1323.556,94.77778
"13748","43214","2015",1,1,0,57000,712,80
"13749","43215","2015",2,2,0,47500,974.5,50
"13750","43216","2015",16,16,0,126224.4,1198.875,113.0625
"13751","43217","2015",4,4,0,106375,845,123.25
"13752","43218","2015",7,7,0,128892.9,1263.714,107.7143
"13753","43220","2015",1,1,0,71000,798,89
"13754","43221","2015",10,9,1,96710,985.2,109.1
"13755","43223","2015",3,3,0,181933.3,1456,123.6667
"13756","43224","2015",42,37,5,133021,1397.881,98.45238
"13757","43226","2015",3,3,0,29833.33,464,70
"13758","43227","2015",3,2,1,145750,1395.333,108
"13759","43228","2015",1,1,0,54250,1391,39
"13760","43229","2015",2,2,0,181500,1460.5,124
"13761","43230","2015",10,10,0,110500,1315,85.7
"13762","43231","2015",2,2,0,61500,982,96
"13763","43232","2015",6,6,0,49416.67,748.8333,63.16667
"13764","43233","2015",9,9,0,154681.1,1306,110.3333
"13765","43234","2015",10,8,2,72300,1143.2,74.2
"13766","43236","2015",9,7,2,125277.8,1259.222,95.44444
"13767","43237","2015",5,5,0,74100,715.4,101
"13768","43238","2015",2,2,0,116500,926,121.5
"13769","43239","2015",8,8,0,88475,813.25,107.375
"13770","43240","2015",4,3,1,116250,1412,81.5
"13771","43241","2015",6,6,0,141675,1370.5,108.5
"13772","43242","2015",4,4,0,45500,759.5,62.5
"13773","43244","2015",26,22,4,127145.7,1107.231,118.5385
"13774","43245","2015",1,1,0,125342,979,128
"13775","43246","2015",4,4,0,112100,1298.75,89.25
"13776","43247","2015",1,1,0,30010,455,66
"13777","43249","2015",3,3,0,202666.3,2488.333,81.66667
"13778","43251","2015",46,18,28,109879.9,1295.261,84.78261
"13779","43252","2015",1,1,0,128500,1428,90
"13780","43256","2015",2,2,0,55000,752,72.5
"13781","43257","2015",1,0,1,15000,341,44
"13782","43258","2015",11,11,0,108470.9,1155.909,91.09091
"13783","43259","2015",1,1,0,38000,380,100
"13784","43261","2015",4,4,0,86648.75,881.5,96.25
"13785","43262","2015",24,13,11,109117.1,1143.167,83.5
"13786","43263","2015",1,1,0,160000,1684,95
"13787","43264","2015",1,1,0,172200,1722,100
"13788","43265","2015",10,10,0,197844,1555.1,128.4
"13789","43267","2015",14,13,1,69125,926.5,74.5
"13790","43268","2015",56,48,8,148608.6,1533.107,98.10714
"13791","44001","2015",14,14,0,102142.9,1291.929,84.78571
"13792","44002","2015",29,29,0,186730.3,1763.103,108.931
"13793","44003","2015",56,41,15,190387.4,1912.071,100.8393
"13794","44005","2015",61,61,0,169447.1,1858.443,93.01639
"13795","44006","2015",21,21,0,158105.7,1836.19,87.7619
"13796","44007","2015",22,22,0,104249.3,1102.227,98
"13797","44009","2015",74,66,8,295418.9,2638.392,115.2973
"13798","44010","2015",65,53,12,211471.6,3130.815,73.98462
"13799","44012","2015",86,76,10,171379.8,2527.628,72.06977
"13800","44013","2015",32,32,0,169201.6,1686.375,103.7188
"13801","44014","2015",40,36,4,189282.8,2162.775,91.5
"13802","44015","2015",85,78,7,157576.4,1715.247,95.89412
"13803","44016","2015",9,9,0,165661.1,1741.667,96.33333
"13804","44018","2015",95,83,12,229590.8,2328.895,101
"13805","44019","2015",7,7,0,160857.1,1478.429,104
"13806","44020","2015",186,167,19,209978,2426.151,89.17742
"13807","44021","2015",59,59,0,158860,1672.678,100.0508
"13808","44022","2015",12,12,0,118525,1401.5,85.08333
"13809","44023","2015",28,28,0,147353.9,1563.75,98.07143
"13810","44025","2015",35,35,0,149094.3,1596.6,96.14286
"13811","44026","2015",200,131,69,243017.4,2621.74,95.17
"13812","44027","2015",20,19,1,205922.5,1965.1,105.55
"13813","44028","2015",32,32,0,178943.8,1703.625,106.5938
"13814","44029","2015",64,64,0,163811.5,1910.516,88.79688
"13815","44030","2015",37,37,0,155736.6,1725.865,94.27027
"13816","44031","2015",10,10,0,114600,1006.5,116.2
"13817","44032","2015",32,31,1,192392.2,2064.406,95.4375
"13818","44033","2015",26,26,0,165226.7,1656.577,105.7692
"13819","44035","2015",190,136,54,246731.3,2627.363,94.95263
"13820","44036","2015",110,90,20,109628.9,1370.382,83.4
"13821","44037","2015",17,17,0,189247.9,1826.882,106.6471
"13822","44038","2015",24,24,0,186137.5,1755.458,105.9583
"13823","44039","2015",7,7,0,184014.3,1895.429,103.1429
"13824","44041","2015",5,5,0,185420,1990.8,96
"13825","44043","2015",86,69,17,189664.4,2118.105,88.9186
"13826","44044","2015",9,9,0,116051.9,1220.778,103.5556
"13827","44045","2015",21,21,0,180109.5,2032.81,92.28571
"13828","44046","2015",20,20,0,179253.3,1893.5,97.2
"13829","44047","2015",256,222,34,202194.3,2444.805,86.04688
"13830","44048","2015",18,18,0,136340.1,1473.944,98
"13831","44049","2015",109,61,48,212564.5,3076.945,73.57798
"13832","44050","2015",22,22,0,158186.8,1520.636,109.1364
"13833","44051","2015",26,26,0,142080.8,1252.846,114.2308
"13834","44052","2015",74,72,2,130924.8,1543.824,87.10811
"13835","44053","2015",19,19,0,164444.7,1602.895,105.9474
"13836","44054","2015",35,35,0,115714.3,1210.714,94.22857
"13837","44055","2015",544,211,333,320439.6,4316.722,75.74081
"13838","44056","2015",49,48,1,158128.2,1735.939,95.42857
"13839","44057","2015",19,19,0,94494.74,1062.684,84.94737
"13840","44058","2015",3,3,0,86333.33,1144.667,70.33333
"13841","44061","2015",25,25,0,159340,1627.84,98.84
"13842","44062","2015",25,25,0,113017.8,1330.56,88.28
"13843","44063","2015",31,31,0,153508.2,1691.032,91.80645
"13844","44064","2015",40,34,6,176321.9,1965.9,90.325
"13845","44065","2015",7,7,0,98300,1027.571,95.42857
"13846","44066","2015",24,24,0,245113.9,2110.875,116.6667
"13847","44067","2015",69,69,0,110278.3,1207.377,89.69565
"13848","44068","2015",29,29,0,123674.1,1332.69,95.82759
"13849","44069","2015",168,128,40,270742.3,2818.137,100.744
"13850","44070","2015",43,42,1,195251.4,2113.628,93.74419
"13851","44071","2015",45,44,1,218474.4,2427.2,96.53333
"13852","44072","2015",62,60,2,169093,1798.806,97.95161
"13853","44073","2015",40,39,1,191479,1917.875,102.1
"13854","44074","2015",51,46,5,170046.6,2151.02,80.62745
"13855","44075","2015",11,11,0,116636.4,1228.727,97.45455
"13856","44076","2015",12,12,0,115708.3,1255.417,93.58333
"13857","44077","2015",31,31,0,130721.3,1314.355,102.7742
"13858","44078","2015",2,2,0,79000,712,103.5
"13859","44079","2015",23,23,0,163798.3,1764.739,93.21739
"13860","44080","2015",2,2,0,282500,1839.5,158.5
"13861","44081","2015",52,52,0,128855.7,1297.096,104.7885
"13862","44082","2015",12,12,0,214708.3,1943.917,114.5833
"13863","44083","2015",22,22,0,156541.4,1469.227,107.0455
"13864","44084","2015",68,61,7,183427.9,1856.926,100.8235
"13865","44085","2015",6,6,0,105000,1057.167,95.83333
"13866","44086","2015",12,12,0,101333.3,1062.25,93.41667
"13867","44087","2015",90,84,6,143950.8,1632.022,90.14444
"13868","44088","2015",28,28,0,157467.9,1751.571,90.82143
"13869","44089","2015",35,35,0,183439.4,1815.286,103.8571
"13870","44090","2015",4,4,0,141875,1611.75,87.5
"13871","44091","2015",18,18,0,119666.7,1171.722,104.5556
"13872","44092","2015",11,11,0,105289.8,1062.273,105.5455
"13873","44094","2015",32,31,1,193068.9,2044.406,97.09375
"13874","44095","2015",17,17,0,86636.24,1027.412,81.88235
"13875","44096","2015",34,34,0,176429.7,1796.5,101.5588
"13876","44097","2015",52,44,8,268952.7,3013.788,90.34615
"13877","44098","2015",40,40,0,155666.6,1698.95,99.375
"13878","44099","2015",21,21,0,89071.43,1130.81,80.2381
"13879","44100","2015",19,19,0,169437.3,1934.947,89.84211
"13880","44101","2015",84,75,9,189894.9,2385.94,82.78571
"13881","44102","2015",35,35,0,173135.7,1934.8,95.85714
"13882","44103","2015",71,55,16,149873.2,1789.563,85.94366
"13883","44104","2015",12,12,0,137916.7,1413.333,98.58333
"13884","44105","2015",7,7,0,97381.43,1145.714,81.42857
"13885","44106","2015",41,39,2,162656.1,2558.78,66.90244
"13886","44107","2015",11,11,0,155627.3,1454.818,109
"13887","44108","2015",16,16,0,220956.9,1883.938,106.3125
"13888","44109","2015",4608,1063,3545,187384.1,2731.019,68.00022
"13889","44110","2015",64,59,5,197148.2,2154.188,99.375
"13890","44111","2015",13,12,1,190123.1,1460.077,141.1538
"13891","44112","2015",2,2,0,114000,1350.5,93.5
"13892","44113","2015",31,29,2,133654.8,1416.452,105.6774
"13893","44114","2015",324,196,128,236896.2,2573.173,91.53704
"13894","44115","2015",34,33,1,193071.5,1891.794,104.8529
"13895","44116","2015",45,34,11,132262.2,1532.933,88.6
"13896","44117","2015",28,27,1,159633,1998.357,87.71429
"13897","44118","2015",11,11,0,113998.6,1200,105.9091
"13898","44119","2015",6,6,0,118050,1466,86.66667
"13899","44120","2015",55,49,6,181092.7,2190.582,84.98182
"13900","44121","2015",6,6,0,127477.3,1363,91.83333
"13901","44122","2015",33,33,0,185986.4,1728.97,108.7273
"13902","44123","2015",15,15,0,117533.3,1122.267,107.2
"13903","44124","2015",6,6,0,91166.67,881.3333,109.5
"13904","44125","2015",47,44,3,245949.8,3414.702,77.51064
"13905","44126","2015",94,92,2,170076.2,2474.936,73.01064
"13906","44127","2015",17,17,0,146905.9,1677.882,89.76471
"13907","44128","2015",39,39,0,109038.5,1287.282,88.28205
"13908","44129","2015",95,85,10,143552.7,1576.621,94.58947
"13909","44130","2015",54,54,0,193431.3,2152.241,94.05556
"13910","44131","2015",261,223,38,233183.2,3005.333,81.33333
"13911","44132","2015",261,104,157,245687.3,3836.169,66.44061
"13912","44133","2015",16,16,0,196381,1943.625,105.4375
"13913","44134","2015",11,11,0,138590.9,1423.909,100.2727
"13914","44135","2015",137,71,66,232505.8,3331.577,73.83942
"13915","44137","2015",29,29,0,177973.5,1940.897,98.34483
"13916","44138","2015",13,13,0,147930.8,1662.692,94.92308
"13917","44139","2015",20,20,0,111835.5,1255.65,92.5
"13918","44140","2015",18,18,0,164527.8,1567.944,106
"13919","44141","2015",9,9,0,140743.1,1551.222,89.55556
"13920","44142","2015",18,18,0,148211.1,1586.5,92.5
"13921","44143","2015",595,328,267,180388.1,2338.884,78.15798
"13922","44144","2015",31,31,0,123454.8,1271.419,101.0645
"13923","44145","2015",28,27,1,204774.8,2015.286,103.6071
"13924","44146","2015",16,16,0,115874.4,1105.5,106.9375
"13925","44148","2015",4,4,0,61675,704,86
"13926","44149","2015",18,18,0,140205.6,1568,94.11111
"13927","44150","2015",29,29,0,230215.1,2072.276,112.7931
"13928","44151","2015",56,52,4,238009.6,2202.482,109.5
"13929","44152","2015",26,26,0,142847.9,1642.462,88.53846
"13930","44153","2015",13,13,0,97760.77,990.3077,99.53846
"13931","44154","2015",253,177,76,184984.7,2753,70.90514
"13932","44155","2015",27,27,0,156203.7,1744.037,92.44444
"13933","44156","2015",21,21,0,118095.2,1520.286,79.7619
"13934","44157","2015",13,13,0,151515.4,1434,111.3846
"13935","44158","2015",57,53,4,229865.1,2215.86,106.5439
"13936","44159","2015",15,15,0,192627.3,1834.867,99.86667
"13937","44161","2015",36,36,0,115027.8,1268.306,91.69444
"13938","44162","2015",535,216,319,169348.3,2178.568,77.55327
"13939","44163","2015",30,30,0,140443.9,1456.233,105.3333
"13940","44164","2015",24,24,0,169479.2,1744.708,100.4167
"13941","44165","2015",16,16,0,171093.8,1627.75,102.125
"13942","44166","2015",45,43,2,193568,2257.822,90.06667
"13943","44168","2015",34,33,1,116646.2,1394.471,85.64706
"13944","44169","2015",47,46,1,180281.5,2053.404,92.21277
"13945","44170","2015",7,7,0,89142.86,1037.571,89.14286
"13946","44171","2015",19,19,0,215778.9,2052.474,109.5789
"13947","44172","2015",136,108,28,238320.8,2556.515,96.72794
"13948","44173","2015",17,17,0,178567.6,1850.588,94.64706
"13949","44174","2015",10,10,0,139550,1577.8,90.6
"13950","44175","2015",49,49,0,206239.8,1934.551,109.2653
"13951","44176","2015",25,24,1,138910,1427.56,100.48
"13952","44178","2015",9,9,0,192722.2,1898.556,102.7778
"13953","44179","2015",42,42,0,178458.5,2003.619,93.02381
"13954","44180","2015",43,43,0,100928.8,1092.512,95.18605
"13955","44182","2015",114,86,28,192900.8,2723.895,75.48246
"13956","44183","2015",30,30,0,222656.7,2105.567,111.2
"13957","44184","2015",882,458,424,148722,1938.548,77.51247
"13958","44185","2015",27,25,2,94570.67,1228.741,81.33333
"13959","44186","2015",46,44,2,176964,1917.87,93.86957
"13960","44187","2015",33,30,3,150090.9,1629.879,94.30303
"13961","44188","2015",89,87,2,175015.2,1843.742,97.91011
"13962","44189","2015",25,25,0,118892,1594.64,81.76
"13963","44190","2015",361,234,127,198639,2442.972,82.48476
"13964","44192","2015",17,17,0,183735.3,2201.235,88.70588
"13965","44193","2015",13,13,0,132923.1,1350.923,101
"13966","44194","2015",64,53,11,312107.3,2586.031,120.75
"13967","44195","2015",77,71,6,193572.1,1897.39,108.013
"13968","44196","2015",18,18,0,93511,1200.444,79
"13969","44197","2015",16,16,0,81856.25,943.5,84.9375
"13970","44198","2015",86,58,28,209165.5,2384.465,89.06977
"13971","44199","2015",20,20,0,112315,1135.7,106.75
"13972","44200","2015",5,5,0,91420,1044.8,89.2
"13973","44201","2015",60,50,10,246031.1,2363.867,106.4
"13974","44202","2015",13,13,0,112584.6,1446.923,85.76923
"13975","44203","2015",18,17,1,186111.1,1871.889,104.5
"13976","44204","2015",87,80,7,250409.9,2307.172,114.9425
"13977","44205","2015",13,13,0,158223.1,1567.692,103.9231
"13978","44206","2015",14,14,0,113064.3,1355.214,84.42857
"13979","44207","2015",8,8,0,155875,1363.25,116.5
"13980","44208","2015",12,12,0,124283.3,1191.5,107.4167
"13981","44209","2015",56,50,6,258617.1,2418.804,108.1964
"13982","44210","2015",68,63,5,135062.3,1533.765,90.11765
"13983","44211","2015",111,70,41,191066,2786.73,76.27027
"13984","44212","2015",81,79,2,173707.5,1860.296,97.19753
"13985","44213","2015",65,64,1,124918.2,1249.6,98.83077
"13986","44214","2015",25,25,0,144447.2,1467.52,99.56
"13987","44215","2015",281,239,42,238138.5,2532.922,97.71886
"13988","44216","2015",32,32,0,167139.2,1629.875,102.625
"13989","44217","2015",49,48,1,249333.1,2376.143,111.7143
"13990","44218","2015",9,9,0,86666.67,846.7778,101.6667
"13991","44220","2015",14,14,0,154785.7,1775.857,88.21429
"13992","44221","2015",13,13,0,203161.5,1761.538,120.8462
"13993","44222","2015",10,10,0,132288.2,1341.7,100
"13994","44223","2015",40,33,7,167710,1773.075,92.45
"13995","44224","2015",15,15,0,168746.7,1623.867,106.2
"13996","45001","2015",1,1,0,70000,972,72
"13997","45002","2015",2,2,0,77250,1196,64
"13998","45004","2015",140,134,6,127751.6,1541.557,87.23571
"13999","45005","2015",1,1,0,205000,3060,67
"14000","45006","2015",11,11,0,297547.7,2050.636,141.8182
"14001","45008","2015",21,15,6,119382.4,1414,83.47619
"14002","45009","2015",13,13,0,144096.2,1401.462,109.3846
"14003","45010","2015",7,7,0,155642.9,1388.714,114.2857
"14004","45011","2015",2,2,0,118944.5,1554.5,75
"14005","45012","2015",3,3,0,149666.7,1764.333,87.66667
"14006","45013","2015",6,6,0,137083.3,1924.833,67
"14007","45014","2015",6,6,0,105836.3,1434.333,80.5
"14008","45015","2015",9,9,0,127434.4,2080.556,67.44444
"14009","45016","2015",13,13,0,116384.6,1484.462,81.92308
"14010","45017","2015",7,7,0,92714.29,1166.286,83
"14011","45018","2015",13,13,0,110630.8,1334.077,92.38462
"14012","45019","2015",5,5,0,170100,1259.4,140
"14013","45020","2015",9,9,0,125982.2,1436.778,88.88889
"14014","45021","2015",5,5,0,135130,1281.2,107.4
"14015","45022","2015",5,5,0,111580,1237.4,89.8
"14016","45023","2015",1,1,0,158000,1317,120
"14017","45024","2015",27,27,0,153448.1,1596.296,101.6667
"14018","45025","2015",19,19,0,145006.2,1296.842,108.9474
"14019","45026","2015",7,7,0,115357.1,1459.857,85
"14020","45027","2015",8,8,0,103000,1386.25,77.375
"14021","45028","2015",94,66,28,131458,1544.84,85.55319
"14022","45029","2015",29,29,0,90517.24,1082.69,88.41379
"14023","45030","2015",15,14,1,107563.3,1413.2,77.8
"14024","45031","2015",12,11,1,83325,985.0833,92.25
"14025","45032","2015",7,7,0,201714.3,1610.286,122.8571
"14026","45033","2015",5,5,0,132000,1586.8,79
"14027","45034","2015",21,21,0,183987.1,1796.524,109.619
"14028","45035","2015",5,5,0,105100,1120.8,101
"14029","45036","2015",9,9,0,172950,1605.667,112.2222
"14030","45037","2015",8,8,0,135250,1463.375,94.875
"14031","45038","2015",2,2,0,157045,1687,92.5
"14032","45039","2015",5,5,0,169000,1913.6,89.2
"14033","45040","2015",22,21,1,94333.18,1210.227,79.04545
"14034","45041","2015",2,2,0,75000,1576,47
"14035","45042","2015",16,16,0,120952.8,1377,91.125
"14036","45043","2015",13,13,0,165336.2,1659,106.4615
"14037","45044","2015",1,1,0,165000,1618,102
"14038","45045","2015",1,1,0,67000,779,86
"14039","45046","2015",4,4,0,168500,1887.25,91.75
"14040","45047","2015",6,6,0,135108.3,1156.5,117.1667
"14041","45049","2015",16,16,0,122062.5,1326.75,97.6875
"14042","45050","2015",12,12,0,96367.5,1082.25,96.58333
"14043","45051","2015",15,15,0,132433.3,1451.733,95.06667
"14044","45053","2015",47,44,3,132300.9,1511.681,90.12766
"14045","45054","2015",12,12,0,148725,1584.917,95.33333
"14046","45055","2015",2,2,0,168000,1541.5,108
"14047","45058","2015",1,1,0,153900,1494,103
"14048","45059","2015",2,2,0,246500,1619.5,147.5
"14049","45060","2015",4,4,0,112625,888.5,118.5
"14050","45061","2015",30,28,2,109165.5,1358.1,81.86667
"14051","45062","2015",14,13,1,202157.1,1712.429,124.8571
"14052","45063","2015",16,16,0,193875,1777,81.5625
"14053","45064","2015",11,11,0,99024.55,978.2727,103.8182
"14054","45065","2015",6,3,3,105833.3,1324.167,73.16667
"14055","45066","2015",7,7,0,141300,1460.857,94.28571
"14056","45067","2015",35,35,0,188543.1,1778.2,108.8857
"14057","45068","2015",113,103,10,119937.8,1531.894,80.35398
"14058","45069","2015",8,8,0,130750,1450.75,94.25
"14059","45070","2015",1,1,0,57300,716,80
"14060","45072","2015",1,1,0,290700,2271,128
"14061","45073","2015",7,6,1,92080,1249.571,75
"14062","45074","2015",1,1,0,170000,2656,64
"14063","45075","2015",104,72,32,153677.8,1779.923,86.84615
"14064","45076","2015",3,3,0,130000,1470.667,87.66667
"14065","45077","2015",8,8,0,116275,1305,89.625
"14066","45078","2015",1,1,0,178000,1187,150
"14067","45080","2015",3,3,0,180283.3,1237.333,154.6667
"14068","45081","2015",6,6,0,108951.7,1111.167,98.66667
"14069","45082","2015",96,78,18,154003.8,1608.771,96.91667
"14070","45083","2015",26,24,2,116526.9,1237.154,94.57692
"14071","45084","2015",3,3,0,99000,1718.667,68.33333
"14072","45085","2015",26,25,1,86455.77,994.5385,87
"14073","45086","2015",2,2,0,144000,1150,139.5
"14074","45087","2015",28,27,1,99923.21,1126.143,89.5
"14075","45088","2015",4,4,0,134000,1047,136.5
"14076","45089","2015",76,69,7,176423.1,1811.618,101.6184
"14077","45091","2015",5,5,0,125621,1335.2,101.6
"14078","45092","2015",8,8,0,164110.9,1670.625,110
"14079","45093","2015",26,26,0,179601.9,2013.231,91.19231
"14080","45094","2015",1,1,0,260000,2222,117
"14081","45095","2015",20,19,1,145332.2,1732.85,87.05
"14082","45096","2015",7,7,0,82985.71,911.4286,88.42857
"14083","45097","2015",14,14,0,126065.7,1486.071,90.35714
"14084","45098","2015",34,34,0,168361.6,1603.294,110.2059
"14085","45099","2015",5,5,0,126615.8,1372.8,90.2
"14086","45100","2015",5,5,0,243220,2129.2,120.4
"14087","45101","2015",1,1,0,166373,1733,96
"14088","45102","2015",1,1,0,42000,913,46
"14089","45103","2015",13,13,0,123184.6,1356.538,96.38462
"14090","45104","2015",32,32,0,122812,1421.5,90.5625
"14091","45105","2015",1,1,0,165800,2126,78
"14092","45107","2015",1,1,0,130000,1429,91
"14093","45108","2015",31,31,0,122270.7,1420.71,88.16129
"14094","45109","2015",4,4,0,128846.5,1461.5,92
"14095","45110","2015",3,3,0,115333.3,1157.667,113
"14096","45111","2015",3,3,0,85566.67,1282.667,79
"14097","45112","2015",3,3,0,120000,1151,121.3333
"14098","45113","2015",6,6,0,126602.8,1219.167,124.6667
"14099","45115","2015",40,40,0,121961.2,1297.6,94.45
"14100","45116","2015",4,4,0,122550,918.25,138
"14101","45118","2015",3,3,0,116333.3,1503.333,73
"14102","45119","2015",23,23,0,131047.8,1555.913,87.34783
"14103","45120","2015",2,2,0,62500,826,75.5
"14104","45121","2015",10,10,0,71262.5,1047.8,70
"14105","45122","2015",9,9,0,116805.6,1448.111,88
"14106","45123","2015",17,17,0,186552.9,1707.765,112.1176
"14107","45124","2015",5,5,0,155900,1669.4,94
"14108","45125","2015",2,2,0,142075,1726.5,83
"14109","45126","2015",28,28,0,186374.5,1778.643,106.7143
"14110","45127","2015",41,41,0,137043.5,1643.902,86.26829
"14111","45129","2015",24,24,0,95437.5,1052.292,92.375
"14112","45130","2015",14,14,0,169220.7,1770.5,99.92857
"14113","45131","2015",5,5,0,128800,1664.4,83.8
"14114","45132","2015",2,2,0,124000,1366,94.5
"14115","45133","2015",7,7,0,147242.9,1341.286,109.5714
"14116","45134","2015",10,10,0,112944,1318.6,88.8
"14117","45135","2015",1,1,0,57000,950,60
"14118","45136","2015",12,12,0,118166.7,1409.5,84.25
"14119","45137","2015",1,1,0,55000,859,64
"14120","45139","2015",5,5,0,155400,1271.2,124.4
"14121","45141","2015",4,4,0,64500,725,89.75
"14122","45142","2015",46,44,2,171252.8,1730.152,103.1522
"14123","45143","2015",1,1,0,135100,1876,72
"14124","45144","2015",14,14,0,156989.5,1564,107.1429
"14125","45145","2015",45,45,0,150320,1482,103.7333
"14126","45146","2015",90,87,3,145312.8,1628.267,91.7
"14127","45147","2015",214,135,79,145507.4,1790.178,83.14953
"14128","45148","2015",18,17,1,123163.9,1519.833,92.72222
"14129","45149","2015",6,6,0,86500,1028.167,83.16667
"14130","45150","2015",2,2,0,178500,2058,98
"14131","45152","2015",3,3,0,145000,1596.667,92.33333
"14132","45153","2015",7,7,0,130285.7,1476.857,90.71429
"14133","45154","2015",18,18,0,156086.7,1601.222,96.88889
"14134","45155","2015",125,99,26,112122.4,1365.352,87.592
"14135","45156","2015",7,7,0,130285.7,1057.571,122.2857
"14136","45157","2015",1,1,0,125000,1562,80
"14137","45158","2015",6,6,0,120500,1209.333,94.5
"14138","45159","2015",2,2,0,180000,1939.5,93.5
"14139","45160","2015",7,7,0,161064.3,1797.571,91.14286
"14140","45161","2015",9,9,0,137861.7,1420.333,98.22222
"14141","45162","2015",5,5,0,191600,1615,123.6
"14142","45164","2015",6,6,0,135500,1463.5,102.3333
"14143","45165","2015",8,8,0,92375,1275.625,70.25
"14144","45166","2015",6,6,0,191353.3,1538.667,131.1667
"14145","45167","2015",20,19,1,153598.9,1724.5,91.15
"14146","45168","2015",10,10,0,131500,1315,107.1
"14147","45169","2015",52,49,3,194817.1,2141.212,96.51923
"14148","45170","2015",2,2,0,178750,5300.5,46
"14149","45171","2015",10,10,0,76880,1080.6,76.9
"14150","45173","2015",56,51,5,155210,1592.357,101.8929
"14151","45174","2015",1,1,0,130000,1444,90
"14152","45175","2015",7,7,0,253862.9,2572.857,112.1429
"14153","45176","2015",2,2,0,167500,1906.5,88.5
"14154","45177","2015",2,2,0,73250,807.5,105.5
"14155","45178","2015",21,21,0,103469,1208.619,87.71429
"14156","45179","2015",24,23,1,151646.2,1604.125,98.45833
"14157","45180","2015",1,1,0,128000,1524,84
"14158","45181","2015",2,2,0,135000,1236.5,126.5
"14159","45182","2015",10,10,0,195743.5,1672.9,118.2
"14160","45183","2015",5,5,0,133300,1015,139.8
"14161","45184","2015",5,5,0,107800,1234.2,89
"14162","45185","2015",4,4,0,172570,1752.25,109.75
"14163","45186","2015",5,5,0,90000,1061.2,82.8
"14164","45187","2015",39,39,0,112832.5,1384.026,88.15385
"14165","45188","2015",18,18,0,159833.1,1671.444,101.5556
"14166","45191","2015",100,76,24,136550,1604.67,87.58
"14167","45193","2015",25,24,1,164902,1690.92,104
"14168","45194","2015",12,10,2,179775,1722.417,110.5
"14169","45195","2015",11,11,0,177227.3,1639.545,109.6364
"14170","45196","2015",10,10,0,195315,2090.6,98.4
"14171","45197","2015",11,11,0,176109.1,1766.273,99.72727
"14172","45198","2015",3,3,0,142100,1639.333,94
"14173","45199","2015",11,10,1,94223.27,1202.273,79.54545
"14174","45200","2015",9,9,0,184645.6,1930.889,99.66667
"14175","45201","2015",2,2,0,123000,1388.5,89
"14176","45202","2015",16,16,0,158777.5,1518.125,104.0625
"14177","45203","2015",83,70,13,145339.8,1564.386,95.0241
"14178","45204","2015",8,8,0,182210.6,1724,114.125
"14179","45205","2015",4,4,0,121000,951,124.25
"14180","45206","2015",2,2,0,96000,1179.5,81
"14181","45207","2015",2,2,0,69650,1186,53
"14182","45208","2015",180,52,128,91751.78,1257.739,73.4
"14183","45209","2015",2,2,0,203500,1321,158
"14184","45210","2015",6,6,0,90500,1211,81
"14185","45212","2015",20,20,0,130675,1338.8,103.85
"14186","45213","2015",7,7,0,113071.4,1296.286,86.14286
"14187","45214","2015",3,3,0,107600,1212.667,87.33333
"14188","45215","2015",3,3,0,76666.67,1064.667,73.66667
"14189","45217","2015",2,2,0,61250,820,85.5
"14190","45218","2015",3,3,0,99333.33,975,100.6667
"14191","45219","2015",1,1,0,110000,1089,101
"14192","45220","2015",8,8,0,125500,1337,105.125
"14193","45222","2015",14,14,0,128321.4,1384.5,102.0714
"14194","45223","2015",5,5,0,155500,1538.2,114.2
"14195","45224","2015",30,25,5,157623.5,1662,99.33333
"14196","45225","2015",7,7,0,151063.6,1883.857,88
"14197","45226","2015",11,11,0,136363.6,1232,115.8182
"14198","45227","2015",12,12,0,143563.3,1392.083,102.0833
"14199","45228","2015",10,10,0,106240,1273.2,80
"14200","45229","2015",28,28,0,120921.4,1297.679,93.25
"14201","45230","2015",6,6,0,108666.7,1351,80
"14202","45232","2015",245,137,108,168781.5,1993.567,84.71837
"14203","45233","2015",2,2,0,103500,1222.5,85
"14204","45234","2015",1550,399,1151,138992.5,2004.32,70.67742
"14205","45235","2015",17,17,0,202195.3,1993.235,101.8235
"14206","45237","2015",2,2,0,206500,1771,120
"14207","45238","2015",8,8,0,124760.2,1275.375,94
"14208","45239","2015",8,8,0,110125,1218.875,92.625
"14209","45240","2015",25,25,0,130699.8,1502.08,90.36
"14210","45241","2015",8,8,0,161304.1,1439.625,130
"14211","45242","2015",2,2,0,160000,2129,87.5
"14212","45243","2015",1,1,0,255000,1594,160
"14213","45244","2015",13,13,0,119450.8,1531.231,94.23077
"14214","45245","2015",11,11,0,157477.3,1960.182,79.45455
"14215","45246","2015",1,1,0,210000,1909,110
"14216","45247","2015",21,21,0,131751.2,1430.429,93.71429
"14217","45248","2015",21,19,2,127028.6,1315.667,100
"14218","45249","2015",7,7,0,149975.4,1346,111.7143
"14219","45250","2015",5,5,0,109400,1442,75
"14220","45251","2015",1,1,0,70000,673,104
"14221","45252","2015",63,38,25,119327.8,1484.238,85.22222
"14222","45253","2015",8,8,0,170162.5,1698.125,103.375
"14223","45254","2015",19,19,0,119960.5,1335.789,94.31579
"14224","45255","2015",1,1,0,160000,1379,116
"14225","45256","2015",1,1,0,105000,1544,68
"14226","45257","2015",7,7,0,93357.14,1580.857,70.71429
"14227","45258","2015",38,35,3,135802.6,1556.316,95.44737
"14228","45259","2015",12,12,0,135544.2,1199.917,116.4167
"14229","45261","2015",9,9,0,174825,1667.333,109
"14230","45262","2015",1,1,0,123000,1218,101
"14231","45263","2015",3,2,1,149666.7,2136.667,82
"14232","45264","2015",2,2,0,142500,1293,111.5
"14233","45265","2015",8,8,0,137250,1479.75,101
"14234","45266","2015",3,3,0,169753.3,1645,128
"14235","45268","2015",10,9,1,126050,1533.6,94.6
"14236","45269","2015",28,26,2,159666.7,1598.143,99.5
"14237","45270","2015",23,23,0,119284.3,1369.391,91.78261
"14238","45271","2015",7,7,0,109771.4,1000.429,110.5714
"14239","45272","2015",22,21,1,207974.1,2155.318,101.2273
"14240","45273","2015",26,21,5,148627.7,1755.346,87.65385
"14241","45274","2015",58,57,1,228216.8,2200.966,109.6552
"14242","45275","2015",4,4,0,96337.5,1290.75,82
"14243","45276","2015",6,6,0,117535,1220.833,97.5
"14244","45277","2015",4,4,0,105350,1593.25,67.75
"14245","45278","2015",17,17,0,81032.94,1165.824,73.11765
"14246","45279","2015",27,27,0,112880.6,1178.704,96.96296
"14247","45280","2015",11,11,0,110866.8,1374.091,84.27273
"14248","45281","2015",23,23,0,118843.5,1282.478,104.7391
"14249","45282","2015",28,25,3,230019.1,2079.321,117.5
"14250","45283","2015",2,2,0,122500,1272,98
"14251","45284","2015",233,126,107,147796,1816.644,81.63948
"14252","45285","2015",161,102,59,142386.5,1792.484,80.34161
"14253","45286","2015",115,57,58,159107.8,1907.67,83.58261
"14254","45288","2015",5,5,0,121400,1394.8,90.4
"14255","45289","2015",10,10,0,172060,1574.1,112.7
"14256","45290","2015",15,15,0,179408.9,1766.867,104.5333
"14257","45291","2015",10,10,0,137000,1470.4,94.2
"14258","45292","2015",16,16,0,140168.8,1257.5,113.5
"14259","45293","2015",11,11,0,119400,1428.455,79.36364
"14260","45294","2015",1,1,0,144000,2028,71
"14261","45296","2015",14,14,0,162973.4,1551.786,106.2143
"14262","45297","2015",12,12,0,139904.2,1752,88
"14263","45298","2015",48,42,6,191154.2,1849.062,109.0417
"14264","45299","2015",2,2,0,114000,1486,73.5
"14265","45300","2015",2,2,0,228000,1457,152.5
"14266","45301","2015",7,7,0,93992,1030.571,94.85714
"14267","45302","2015",136,110,26,161368.9,1836.801,91.33824
"14268","45303","2015",6,6,0,139500,1756.667,84.16667
"14269","45305","2015",3,3,0,171410,1746.667,103.3333
"14270","45306","2015",9,9,0,115782.8,1400.444,86.11111
"14271","45307","2015",18,18,0,116134.6,1239.278,104.0556
"14272","45308","2015",15,14,1,214025,2156.067,100.2
"14273","45309","2015",10,10,0,153776,1841.3,88.6
"14274","45310","2015",13,12,1,152175.8,1734.769,96.76923
"14275","45311","2015",6,6,0,137666.7,1528.667,87.33333
"14276","45312","2015",4,4,0,144375,1294,115.75
"14277","45313","2015",15,15,0,132356.3,1388.467,94.33333
"14278","45314","2015",5,5,0,195840,1719.2,104.8
"14279","45315","2015",35,26,9,140601,1584.514,88.25714
"14280","45316","2015",12,12,0,120075,1450.667,87.25
"14281","45317","2015",11,11,0,171063.6,1631.182,110
"14282","45320","2015",2,2,0,150250,1932.5,77.5
"14283","45321","2015",7,7,0,140222.9,1153,128.2857
"14284","45322","2015",2,2,0,141500,1182,130.5
"14285","45323","2015",3,3,0,70000,986.3333,73.66667
"14286","45324","2015",10,10,0,174215,1780.9,103.1
"14287","45325","2015",4,4,0,172100,1260.25,147
"14288","45326","2015",3,3,0,105500,955,107
"14289","45327","2015",28,28,0,177435,1707.107,107.6071
"14290","45328","2015",4,4,0,102750,871.5,118.25
"14291","45329","2015",25,25,0,85602.52,1111.32,81.52
"14292","45330","2015",1,1,0,95000,1583,60
"14293","45331","2015",6,6,0,139083.3,1437.167,96.33333
"14294","45332","2015",20,20,0,135845,1550.65,90.2
"14295","45333","2015",21,20,1,190960.5,1929.619,105.7619
"14296","45334","2015",4,4,0,127000,1454.5,100
"14297","45335","2015",11,11,0,152227.3,1649.091,102.6364
"14298","45336","2015",6,6,0,107257,1226.833,91
"14299","45337","2015",3,3,0,80606.67,1037,80.66667
"14300","45338","2015",54,49,5,130059.4,1614.722,83.46296
"14301","45339","2015",5,5,0,150300,1430.2,125.6
"14302","45340","2015",2,2,0,129972.5,1309,99
"14303","45341","2015",3,3,0,161500,2006.333,117.3333
"14304","45342","2015",7,7,0,145828.6,1475.714,105.4286
"14305","45344","2015",9,9,0,141144.4,1545.667,91.55556
"14306","45345","2015",11,11,0,140122.7,1496.636,96.90909
"14307","45346","2015",21,21,0,147376.2,1659.286,92.57143
"14308","45347","2015",5,5,0,138180,1326.8,110.8
"14309","45348","2015",8,8,0,134625,1754,91.25
"14310","46001","2015",5,5,0,166270,1475.8,114.6
"14311","46002","2015",2,2,0,81500,926,88
"14312","46003","2015",4,4,0,133000,1374,98.75
"14313","46004","2015",1,1,0,155750,1731,90
"14314","46005","2015",4,4,0,221845.8,1704.25,121.75
"14315","46006","2015",1,1,0,223250,1717,130
"14316","46007","2015",5,5,0,146460,1364.6,106.6
"14317","46009","2015",3,3,0,150666.7,1358.667,125.6667
"14318","46010","2015",1,1,0,148000,1526,97
"14319","46011","2015",5,5,0,133540,1147.8,114.4
"14320","46012","2015",5,5,0,105100,1729.4,60.8
"14321","46013","2015",4,4,0,128417.5,1241.5,101.75
"14322","46015","2015",5,5,0,119380,1212.4,102.4
"14323","46016","2015",4,4,0,90500,1050.75,92.5
"14324","46020","2015",5,5,0,97800,1520,53.4
"14325","46021","2015",8,8,0,148831.4,1405.625,107.125
"14326","46022","2015",2,2,0,267250,2454.5,108
"14327","46023","2015",5,5,0,183146,1501,120
"14328","46026","2015",1,1,0,220000,1410,156
"14329","46028","2015",8,8,0,117343.8,1289.625,93.375
"14330","46029","2015",12,12,0,93116.67,1254.167,73
"14331","46030","2015",3,3,0,90000,881.3333,101.6667
"14332","46031","2015",1,1,0,1e+05,1031,97
"14333","46032","2015",4,4,0,195450,1666.5,116
"14334","46033","2015",5,5,0,240000,2581,95.6
"14335","46034","2015",3,2,1,129500,1683.667,77
"14336","46035","2015",2,2,0,164500,1392,119
"14337","46036","2015",1,1,0,418130,2630,159
"14338","46037","2015",2,2,0,109500,1499.5,73
"14339","46038","2015",14,13,1,110767.9,1264.214,89.92857
"14340","46039","2015",1,1,0,340000,2345,145
"14341","46040","2015",5,4,1,107700,1119,108.8
"14342","46042","2015",235,107,128,116398.5,1399.979,81.80851
"14343","46043","2015",1,1,0,105000,955,110
"14344","46044","2015",4,4,0,132850,1389.5,95
"14345","46045","2015",14,14,0,144325.7,1152.929,123.7143
"14346","46046","2015",2,2,0,170000,1430.5,129
"14347","46047","2015",4,4,0,132000,1007,126.5
"14348","46049","2015",3,3,0,91000,1467.333,57
"14349","46051","2015",2,2,0,130000,1489.5,87
"14350","46053","2015",3,3,0,221666.7,2009.667,112.6667
"14351","46054","2015",5,5,0,72900,1054.2,73.6
"14352","46055","2015",14,14,0,132190.7,1344.5,93.92857
"14353","46056","2015",1,1,0,110000,2075,53
"14354","46057","2015",10,10,0,100015.4,1137.4,91.1
"14355","46058","2015",10,10,0,109185,1484.3,75
"14356","46059","2015",3,3,0,106400,1170.333,91
"14357","46061","2015",1,1,0,128850,1171,110
"14358","46062","2015",3,3,0,136300,803.3333,144
"14359","46063","2015",23,23,0,148173.9,1773.783,100.6087
"14360","46064","2015",9,9,0,124137.2,1143.333,103.1111
"14361","46065","2015",7,7,0,186357.1,1342.143,133.7143
"14362","46066","2015",9,9,0,128510.7,1143.889,129.8889
"14363","46068","2015",3,3,0,69966.67,1177,61
"14364","46069","2015",1,1,0,178200,1764,101
"14365","46070","2015",7,7,0,185278,1334.286,134.7143
"14366","46072","2015",2,2,0,106250,1457,80
"14367","46073","2015",3,3,0,123000,2042.333,68.66667
"14368","46074","2015",3,3,0,78866.67,1290.667,61.66667
"14369","46075","2015",4,4,0,131775,2551.75,50
"14370","46076","2015",2,2,0,97500,731,128.5
"14371","46078","2015",3,3,0,101666.7,1189.333,87.33333
"14372","46079","2015",1,1,0,177500,1557,114
"14373","46080","2015",4,4,0,140900,1579.75,92.5
"14374","46081","2015",1,1,0,95800,1198,80
"14375","46082","2015",2,2,0,179975,1753,102
"14376","46083","2015",2,2,0,135000,2638,60
"14377","46084","2015",6,6,0,148661.7,1457.667,113.6667
"14378","46085","2015",1,1,0,1e+05,971,103
"14379","46086","2015",6,6,0,173533.3,1838,100
"14380","46087","2015",10,10,0,108370,1224.6,89.4
"14381","46088","2015",8,8,0,130496.9,1439.125,90.75
"14382","46089","2015",13,13,0,173111.9,1627.077,111
"14383","46090","2015",1,1,0,2e+05,1835,109
"14384","46091","2015",7,7,0,203987.9,1985.429,100.4286
"14385","46092","2015",1,1,0,145675,2174,67
"14386","46093","2015",2,2,0,149750,991.5,146.5
"14387","46094","2015",1,1,0,60000,667,90
"14388","46095","2015",10,10,0,163620,1559.2,117.2
"14389","46098","2015",5,5,0,161690,1535.4,107.8
"14390","46100","2015",11,11,0,129935.3,1420.727,92.54545
"14391","46101","2015",4,4,0,158500,1378.5,124.25
"14392","46102","2015",116,76,40,104235.8,1297.336,80.36207
"14393","46103","2015",7,7,0,122142.9,1248.857,89.85714
"14394","46105","2015",4,4,0,195323.8,1214.5,160
"14395","46106","2015",3,3,0,156000,1762,95.66667
"14396","46107","2015",2,2,0,106000,1071.5,100
"14397","46108","2015",5,5,0,126801.4,1518.2,85.2
"14398","46109","2015",5,5,0,113085,1137,97.4
"14399","46111","2015",5,5,0,147190,1797.8,93.6
"14400","46112","2015",1,1,0,60000,682,88
"14401","46113","2015",3,3,0,175813.3,1783.333,112.3333
"14402","46114","2015",5,5,0,92482,1520.2,80.2
"14403","46116","2015",1,1,0,75000,765,98
"14404","46117","2015",4,4,0,75712.5,900.25,76.5
"14405","46118","2015",4,4,0,137957.5,978.25,143
"14406","46119","2015",2,2,0,90000,1237,75
"14407","46120","2015",2,2,0,92500,1283,70.5
"14408","46121","2015",2,2,0,532000,5394,91.5
"14409","46124","2015",1,1,0,141000,1567,90
"14410","46125","2015",3,3,0,62000,955,68.66667
"14411","46126","2015",1,1,0,170000,1318,129
"14412","46127","2015",40,36,4,129648.2,1356.1,97.875
"14413","46128","2015",31,29,2,96495.16,1193.742,87.29032
"14414","46129","2015",3,3,0,104842.3,1989,52.66667
"14415","46130","2015",5,5,0,162486,1134.8,123.2
"14416","46131","2015",2,2,0,87500,1583.5,55
"14417","46132","2015",2,2,0,388250,1805.5,197
"14418","46133","2015",4,4,0,170712.5,1366.25,119
"14419","46134","2015",1,1,0,122750,3069,40
"14420","46136","2015",4,4,0,96250,1051.75,92.75
"14421","46137","2015",8,8,0,268152.1,1897.875,130.25
"14422","46138","2015",6,6,0,164566.7,1448.167,117.8333
"14423","46142","2015",1,1,0,193450,1466,132
"14424","46143","2015",10,9,1,106611.5,1175.1,90.8
"14425","46144","2015",1,1,0,130000,1111,117
"14426","46145","2015",15,15,0,145391.4,1337.2,103.4
"14427","46147","2015",1,1,0,255000,1875,136
"14428","46148","2015",9,9,0,164226.4,1467.667,114.2222
"14429","46149","2015",6,6,0,133666.7,1307.333,117.5
"14430","46151","2015",1,1,0,204990,1306,157
"14431","46152","2015",2,2,0,188630,1998.5,105
"14432","46153","2015",6,6,0,128166.7,1436.5,92.83333
"14433","46154","2015",4,4,0,112851.2,1570.75,78
"14434","46155","2015",2,2,0,127500,1064.5,122
"14435","46156","2015",9,9,0,122177.8,1191.556,94.88889
"14436","46157","2015",3,3,0,85700,1592.333,48.33333
"14437","46159","2015",2,2,0,118300,1120.5,101
"14438","46160","2015",4,4,0,94945,890.25,103.75
"14439","46161","2015",3,3,0,90400,1208.667,76.66667
"14440","46162","2015",3,3,0,56533.33,950.3333,65
"14441","46163","2015",1,1,0,32000,421,76
"14442","46165","2015",3,3,0,82750,537,148.3333
"14443","46167","2015",1,1,0,130000,1083,120
"14444","46168","2015",1,1,0,47500,864,55
"14445","46169","2015",1,1,0,118000,1242,95
"14446","46170","2015",4,4,0,110807.5,1259.25,83
"14447","46171","2015",4,4,0,152562.5,1389.25,108
"14448","46172","2015",8,8,0,173062.5,1373.25,128.75
"14449","46173","2015",11,10,1,110363.6,1414.636,84.54545
"14450","46174","2015",3,3,0,103233.3,1405.667,70.66667
"14451","46175","2015",11,11,0,166006.6,1764.636,104.6364
"14452","46176","2015",2,2,0,80680.5,1396,64
"14453","46177","2015",3,3,0,93560.67,1132.333,91.33333
"14454","46178","2015",4,4,0,132175,1141.25,120
"14455","46179","2015",2,2,0,141700,1667,85
"14456","46180","2015",4,4,0,187200,1751.5,102.25
"14457","46182","2015",17,15,2,241497.1,2153.941,115.4118
"14458","46183","2015",3,3,0,96666.67,1505.333,59
"14459","46184","2015",2,2,0,221500,2930.5,81
"14460","46185","2015",22,22,0,166681.8,1578.545,107.0455
"14461","46186","2015",3,3,0,203140,1911.667,109
"14462","46187","2015",6,6,0,117666.7,1242.667,94.83333
"14463","46188","2015",2,2,0,174075,1645,105.5
"14464","46189","2015",2,2,0,76250,858.5,89
"14465","46190","2015",2,2,0,145000,2413.5,62
"14466","46191","2015",8,8,0,77437.5,945.375,82.625
"14467","46192","2015",1,1,0,120000,1791,67
"14468","46193","2015",1,1,0,65000,1275,51
"14469","46194","2015",2,2,0,124150,1071.5,117
"14470","46195","2015",1,1,0,46000,613,75
"14471","46197","2015",3,3,0,233983.3,1565.333,159.6667
"14472","46198","2015",1,1,0,195000,2600,75
"14473","46199","2015",3,3,0,266903.3,3039,88.33333
"14474","46200","2015",3,3,0,53333.33,600.6667,89
"14475","46201","2015",27,25,2,153848.5,1646.741,93.11111
"14476","46202","2015",4,4,0,162500,1350.5,122.5
"14477","46204","2015",2,2,0,68000,977.5,74.5
"14478","46205","2015",6,6,0,111158.3,1315,89.83333
"14479","46208","2015",7,7,0,154142.9,1363.429,122.2857
"14480","46209","2015",2,2,0,153600,1343,121.5
"14481","46210","2015",2,2,0,140250,1218,119
"14482","46211","2015",3,3,0,190036.7,1876.333,101
"14483","46212","2015",2,2,0,75500,1187.5,65
"14484","46213","2015",2,2,0,53250,632,84.5
"14485","46214","2015",2,2,0,110000,894,106.5
"14486","46215","2015",12,12,0,192000,1249.833,137.5
"14487","46216","2015",3,3,0,188328.3,1635.333,125
"14488","46217","2015",2,2,0,92500,1039.5,85.5
"14489","46218","2015",2,2,0,64000,1254,52
"14490","46219","2015",6,6,0,113050,1498.833,69.16667
"14491","46220","2015",8,7,1,154499.1,1524.75,96.375
"14492","46221","2015",3,3,0,199000,1667,123
"14493","46222","2015",1,1,0,230000,3833,60
"14494","46223","2015",5,5,0,205208,1790.4,106.8
"14495","46224","2015",33,30,3,159124.5,1579.576,103.2727
"14496","46225","2015",32,32,0,183991.2,1738.781,109.0938
"14497","46226","2015",1,1,0,23100,513,45
"14498","46227","2015",3,3,0,167000,1719.667,113.3333
"14499","46228","2015",5,5,0,120298,1116.2,90.4
"14500","46229","2015",15,15,0,104854,1119.067,95.26667
"14501","46231","2015",24,24,0,162233.4,1499.583,110.5833
"14502","46232","2015",13,13,0,120123.1,1385.538,89.38462
"14503","46236","2015",3,3,0,112313.3,1307.667,93.66667
"14504","46237","2015",1,1,0,147000,1387,106
"14505","46239","2015",2,2,0,146800,1783,80.5
"14506","46240","2015",7,7,0,129708.6,1568.571,102.7143
"14507","46242","2015",2,2,0,119000,1358,88.5
"14508","46245","2015",2,2,0,131000,1913,66.5
"14509","46246","2015",1,1,0,198000,2020,98
"14510","46247","2015",2,2,0,48500,559,91.5
"14511","46250","2015",1,1,0,87520,761,115
"14512","46251","2015",37,32,5,123105.5,1219.378,95.75676
"14513","46252","2015",3,3,0,122833.3,1224,95
"14514","46253","2015",4,4,0,285505,4327,75.5
"14515","46255","2015",3,3,0,150733.3,1428.667,114
"14516","46256","2015",10,8,2,158846.2,2709.1,59.5
"14517","46257","2015",2,2,0,142000,1696.5,86
"14518","46258","2015",2,2,0,190000,2247.5,82.5
"14519","46259","2015",1,1,0,402205,2106,191
"14520","46260","2015",3,3,0,103666.7,1072.333,100
"14521","46262","2015",8,8,0,248986.2,1999.625,122.5
"14522","46263","2015",2,2,0,102450,988.5,107.5
"14523","46264","2015",5,5,0,125904.4,1483,92.8
"14524","46265","2015",9,9,0,115111.1,1019,109.3333
"14525","46266","2015",2,2,0,113000,1234,96.5
"14526","46267","2015",6,6,0,129833.3,1555.667,83.33333
"14527","46268","2015",11,11,0,131763.6,1421.182,98.90909
"14528","46269","2015",1,1,0,76000,1013,75
"14529","46270","2015",4,4,0,79150,1797.75,50.75
"14530","46271","2015",2,2,0,101000,1231.5,81.5
"14531","46272","2015",2,2,0,51300,596.5,87.5
"14532","46273","2015",7,7,0,159032.9,1545.571,103.2857
"14533","46276","2015",3,3,0,152500,1355,125.6667
"14534","46277","2015",3,3,0,217216.7,1542,139
"14535","46279","2015",2,2,0,101500,1609,62.5
"14536","46280","2015",4,4,0,118825,1513,79
"14537","46281","2015",1,1,0,48000,1067,45
"14538","46283","2015",2,2,0,155920,1012.5,145
"14539","46284","2015",1,1,0,167429,2119,79
"14540","46288","2015",3,3,0,72833.33,1014.667,67
"14541","46289","2015",3,3,0,238000,3284,70
"14542","46290","2015",5,5,0,174224,1408.8,121.8
"14543","46292","2015",3,3,0,102500,1123.667,93.33333
"14544","46293","2015",6,6,0,174833.3,1631.667,108.6667
"14545","46294","2015",1,1,0,1e+05,794,126
"14546","46296","2015",4,4,0,97750,1153,84.5
"14547","46297","2015",7,7,0,152990,1194.714,125.7143
"14548","46299","2015",4,4,0,107000,1162,94.75
"14549","46301","2015",7,7,0,115657.1,1324.714,84.85714
"14550","46302","2015",3,3,0,79166.67,866.6667,92.33333
"14551","46303","2015",2,2,0,90500,996.5,74
"14552","46305","2015",3,3,0,165000,1444.667,103
"14553","46306","2015",1,1,0,115000,1533,75
"14554","46307","2015",4,4,0,106625,1191.5,90.75
"14555","46308","2015",1,1,0,106000,1359,78
"14556","46309","2015",26,21,5,109605,1157.962,95.65385
"14557","46310","2015",2,2,0,137500,1111,127
"14558","46311","2015",8,8,0,80193.25,949.375,77.25
"14559","46312","2015",5,2,3,114500,1076.6,106.6
"14560","46313","2015",2,2,0,199130,1715,116.5
"14561","46314","2015",2,2,0,59970,683,88
"14562","46315","2015",2,2,0,59600,1091.5,54
"14563","46316","2015",4,4,0,99125,1512.25,84.5
"14564","46317","2015",2,2,0,139000,1396,116
"14565","46318","2015",2,2,0,123800,1034.5,146.5
"14566","46320","2015",2,2,0,137500,1217,96.5
"14567","46321","2015",1,1,0,91000,758,120
"14568","46322","2015",6,6,0,185452,1388.5,135
"14569","46323","2015",2,2,0,129950,1618.5,81.5
"14570","46324","2015",2,2,0,135000,1709,91.5
"14571","46328","2015",3,3,0,236666.7,2047.333,116.6667
"14572","46329","2015",5,5,0,200737,1759.8,159.4
"14573","46330","2015",21,20,1,128427.8,1332.857,97.95238
"14574","46334","2015",15,15,0,168731.3,1802.667,95.33333
"14575","46335","2015",1,1,0,259600,2200,118
"14576","46336","2015",6,6,0,137440,1108.167,143.1667
"14577","46337","2015",1,1,0,205000,2050,100
"14578","46339","2015",1,1,0,82000,1171,70
"14579","46340","2015",2,2,0,149500,1915.5,78.5
"14580","47001","2015",514,205,309,98980.9,1320.903,77.51751
"14581","47002","2015",1,1,0,87300,1164,75
"14582","47003","2015",5,5,0,174800,1682.8,105.4
"14583","47004","2015",44,37,7,96441.14,1027.023,97.95455
"14584","47005","2015",7,7,0,139288.7,1363,103.4286
"14585","47006","2015",4,4,0,182985.8,1439.75,130.25
"14586","47007","2015",3,3,0,174400,1159,142.6667
"14587","47009","2015",1,1,0,117000,1045,112
"14588","47010","2015",1,1,0,420000,2154,195
"14589","47011","2015",2,2,0,184500,1644.5,110
"14590","47012","2015",1,1,0,157000,1246,126
"14591","47013","2015",2,2,0,208575,1352.5,152.5
"14592","47014","2015",2,2,0,78965,732.5,115.5
"14593","47015","2015",7,7,0,144144,1460.571,121.7143
"14594","47016","2015",11,10,1,154481.8,1299.909,119.1818
"14595","47018","2015",1,1,0,138020,1624,85
"14596","47019","2015",9,9,0,179050,1597.222,116.4444
"14597","47020","2015",5,5,0,193600,1082.4,171.6
"14598","47021","2015",12,11,1,137737.5,1400.083,101.9167
"14599","47022","2015",4,4,0,141307.5,1845.75,84
"14600","47023","2015",2,2,0,157500,1533.5,108
"14601","47024","2015",14,14,0,173357.1,1500.571,113.7857
"14602","47025","2015",9,9,0,148996.8,1155.222,126.2222
"14603","47027","2015",30,30,0,141427.4,1511.233,93.06667
"14604","47028","2015",5,5,0,334796.2,3074.4,126
"14605","47029","2015",4,4,0,93125,1667.75,64.75
"14606","47030","2015",2,2,0,118400,806,150.5
"14607","47031","2015",57,53,4,164985.6,1780.544,92.01754
"14608","47032","2015",66,63,3,160462.5,1602.636,101.4242
"14609","47033","2015",1,1,0,155300,1538,101
"14610","47034","2015",8,8,0,140147.5,1435.625,94.625
"14611","47035","2015",1,1,0,70000,538,130
"14612","47036","2015",4,4,0,137500,1334.5,108.25
"14613","47037","2015",4,4,0,156862.5,1075.75,154.5
"14614","47038","2015",6,6,0,98833.33,1219.5,96.5
"14615","47040","2015",25,23,2,262912.4,2170.84,99.52
"14616","47041","2015",9,9,0,123411.1,1187.111,108.6667
"14617","47042","2015",1,1,0,125000,1344,93
"14618","47043","2015",5,5,0,101600,959.8,98.6
"14619","47044","2015",2,2,0,174300,1681.5,101
"14620","47045","2015",3,3,0,164443.3,1332.333,122.6667
"14621","47046","2015",6,6,0,121666.7,1339.667,91.66667
"14622","47047","2015",3,3,0,245000,1065.667,214
"14623","47048","2015",12,12,0,83078.33,957.1667,88.5
"14624","47049","2015",21,20,1,120890.5,1289.286,94.14286
"14625","47050","2015",1,1,0,42000,525,80
"14626","47051","2015",19,19,0,174739.5,1892.053,100.5263
"14627","47052","2015",43,39,4,122001.2,1422.605,87.88372
"14628","47053","2015",3,3,0,162593.3,1893.333,85.66667
"14629","47054","2015",15,13,2,88209.6,1069.667,96.33333
"14630","47055","2015",10,8,2,90945,963.5,95.8
"14631","47056","2015",8,8,0,173412.5,1396.5,125.125
"14632","47057","2015",17,17,0,87970.59,965.9412,95.94118
"14633","47058","2015",2,2,0,117500,1364,86.5
"14634","47059","2015",4,4,0,138025,971.5,115
"14635","47060","2015",6,6,0,122708.3,1208.167,101.8333
"14636","47061","2015",6,6,0,111916.7,1159.5,93.83333
"14637","47062","2015",4,4,0,147500,1522.75,95
"14638","47063","2015",2,2,0,112500,1451,77
"14639","47064","2015",2,2,0,71500,764,95
"14640","47065","2015",39,39,0,101701,976.8205,103.4615
"14641","47066","2015",5,5,0,149900,1380,116.4
"14642","47067","2015",2,2,0,135500,1516,89.5
"14643","47068","2015",2,2,0,138900,1165.5,141
"14644","47069","2015",20,20,0,150873.5,1590,96.45
"14645","47070","2015",6,6,0,107825,1707.667,78.83333
"14646","47071","2015",1,1,0,109050,1136,96
"14647","47073","2015",4,4,0,157000,1236.25,129.75
"14648","47074","2015",6,6,0,124116.7,880.5,127.5
"14649","47075","2015",14,14,0,145151.4,1363.143,108.6429
"14650","47076","2015",1,1,0,150000,1339,112
"14651","47077","2015",8,8,0,122550.8,1354.5,89.875
"14652","47078","2015",7,7,0,141429.1,1078.143,130.1429
"14653","47079","2015",3,3,0,175666.7,1472,128
"14654","47080","2015",3,3,0,148333.3,1227,106.3333
"14655","47081","2015",5,5,0,156410,1614.6,100.4
"14656","47082","2015",1,1,0,206000,1471,140
"14657","47083","2015",4,4,0,119150,1124.5,103
"14658","47084","2015",4,4,0,132250,1386,94.75
"14659","47085","2015",3,3,0,132666.7,1270.667,105.3333
"14660","47086","2015",21,19,2,128110.1,1737.714,91.2381
"14661","47088","2015",10,8,2,103935,1118.4,95.1
"14662","47089","2015",1,1,0,168302,1530,110
"14663","47090","2015",4,4,0,201487.5,1401.25,144.25
"14664","47091","2015",13,12,1,191071.2,1726.231,110.8462
"14665","47092","2015",2,2,0,214000,2761,96.5
"14666","47093","2015",5,5,0,125500,1149.6,105.6
"14667","47094","2015",6,6,0,97450,986.8333,104.6667
"14668","47095","2015",7,7,0,166000,1330.429,118.4286
"14669","47096","2015",4,4,0,194427.5,1387.75,135.25
"14670","47097","2015",8,7,1,106212.5,1148,108.875
"14671","47098","2015",1,1,0,155000,1047,148
"14672","47099","2015",4,4,0,155350,1912,86
"14673","47100","2015",45,44,1,167171.5,1586.911,109.1556
"14674","47101","2015",11,11,0,100090.9,1258.545,92.18182
"14675","47102","2015",2,1,1,45000,1263.5,57
"14676","47103","2015",3,3,0,626100,2940.333,154.6667
"14677","47104","2015",2,2,0,247700,1556.5,157
"14678","47105","2015",3,3,0,2e+05,1512.333,144.6667
"14679","47106","2015",32,29,3,116934.4,1043.875,107.1875
"14680","47107","2015",4,4,0,62750,968.5,69.25
"14681","47108","2015",1,1,0,80000,808,99
"14682","47109","2015",1,1,0,105000,1312,80
"14683","47110","2015",16,15,1,143891.9,1287.438,113.1875
"14684","47111","2015",10,10,0,111305,1067.4,103.5
"14685","47112","2015",4,4,0,113076,989,111.75
"14686","47114","2015",5,5,0,140100,1281.8,112.8
"14687","47115","2015",1,1,0,241500,1118,216
"14688","47117","2015",10,10,0,174098.4,1475.5,112.7
"14689","47118","2015",1,1,0,156000,1677,93
"14690","47119","2015",6,6,0,131500,1298.667,102
"14691","47120","2015",1,1,0,108660,849,128
"14692","47122","2015",2,2,0,213949,1299.5,158.5
"14693","47123","2015",4,4,0,125700,1257,102
"14694","47124","2015",2,2,0,181900,1151.5,162
"14695","47125","2015",1,1,0,245000,2188,112
"14696","47127","2015",10,10,0,147235,1869.8,108.8
"14697","47128","2015",18,15,3,122248.6,1436.056,82.33333
"14698","47129","2015",2,2,0,143000,1548.5,98
"14699","47130","2015",4,4,0,134500,1200.75,119
"14700","47131","2015",6,6,0,146250,1241.5,118.8333
"14701","47132","2015",3,3,0,102333.3,986.3333,102
"14702","47133","2015",6,6,0,145950,1127.833,135.3333
"14703","47134","2015",4,4,0,80705,748,99
"14704","47135","2015",8,8,0,145962.5,1206.625,115.375
"14705","47136","2015",1,1,0,148000,846,175
"14706","47137","2015",14,13,1,196884.7,1799.143,109.7143
"14707","47138","2015",22,22,0,167248.6,1528.682,112.0909
"14708","47140","2015",6,6,0,86533.33,1195.833,72.66667
"14709","47141","2015",4,4,0,160000,1468,114.75
"14710","47142","2015",11,11,0,105500,974.3636,108.5455
"14711","47143","2015",22,21,1,116550,1140.591,104.2727
"14712","47144","2015",4,4,0,125250,1191.75,111
"14713","47145","2015",42,39,3,135656.2,1331.762,104.619
"14714","47146","2015",10,10,0,164050,1494.2,122
"14715","47147","2015",6,6,0,147500,1121.833,133.5
"14716","47150","2015",2,2,0,122500,869,150
"14717","47151","2015",7,7,0,233351.6,1366.429,162.1429
"14718","47152","2015",4,4,0,107500,1578.5,81.25
"14719","47154","2015",4,4,0,114750,1157,93.25
"14720","47155","2015",3,3,0,152666.7,1703,91
"14721","47156","2015",2,2,0,174500,1249,121.5
"14722","47157","2015",247,203,44,106688.9,1199.866,89.59919
"14723","47159","2015",13,13,0,117192.3,1093.769,107.3077
"14724","47160","2015",1,1,0,153000,1319,116
"14725","47162","2015",3,3,0,120666.7,1171,110
"14726","47163","2015",5,5,0,242180.8,1796.8,122.8
"14727","47164","2015",1,1,0,2e+05,1667,120
"14728","47165","2015",11,11,0,121804.5,1214.182,108.5455
"14729","47167","2015",11,11,0,98454.55,1022.364,91.54545
"14730","47168","2015",43,40,3,83819.77,994.6512,84.60465
"14731","47169","2015",9,9,0,202597.8,1567.333,134.7778
"14732","47170","2015",10,10,0,105033,978.2,122.4
"14733","47171","2015",2,2,0,162500,1746,97.5
"14734","47172","2015",7,7,0,193723.1,1873.143,108.1429
"14735","47173","2015",11,11,0,105563.6,1048.182,110.0909
"14736","47174","2015",7,7,0,203555.6,1583.857,113.5714
"14737","47175","2015",26,26,0,106888.1,1123.462,99.46154
"14738","47177","2015",1,1,0,50000,758,66
"14739","47178","2015",4,4,0,106655,1113.25,96.75
"14740","47179","2015",25,23,2,78220,955.2,83.92
"14741","47180","2015",5,5,0,145000,1375.8,107.8
"14742","47181","2015",2,2,0,246000,1632,170
"14743","47183","2015",2,2,0,85475,759.5,113
"14744","47184","2015",8,8,0,178250,1721.375,103.25
"14745","47185","2015",40,40,0,115049.4,1129.375,104.2
"14746","47186","2015",2,2,0,114750,1116.5,119.5
"14747","47187","2015",1,1,0,140000,1818,77
"14748","47188","2015",5,5,0,118910,939.6,125.8
"14749","47190","2015",6,6,0,117050,1041.167,111.5
"14750","47191","2015",8,8,0,98475,925.125,106.75
"14751","47192","2015",2,2,0,187300,1032.5,159
"14752","47194","2015",1,1,0,160000,1333,120
"14753","47195","2015",61,59,2,136770.5,1313.164,105.0328
"14754","47196","2015",2,2,0,87500,1287,66
"14755","47197","2015",3,3,0,312333.3,1698.667,178
"14756","47198","2015",3,3,0,132064.3,1153.333,134
"14757","47199","2015",6,6,0,251063.7,1666.333,152.8333
"14758","47201","2015",125,115,10,126963.1,1531.096,82.952
"14759","47202","2015",2,2,0,149500,1293,124.5
"14760","47203","2015",27,27,0,152916.7,1460.556,99.77778
"14761","47204","2015",1,1,0,110000,1048,105
"14762","47205","2015",3,3,0,163833.3,1362.333,136.6667
"14763","47206","2015",7,7,0,137571.4,1211.143,121.4286
"14764","47207","2015",3,3,0,131666.7,1090,121.6667
"14765","47208","2015",1,1,0,92000,1484,62
"14766","47209","2015",35,34,1,164766.9,1636.771,101.7143
"14767","47210","2015",15,14,1,91103.33,894,100.3333
"14768","47211","2015",3,3,0,109666.7,980.6667,113.3333
"14769","47212","2015",3,3,0,183333.3,1783,104
"14770","47213","2015",10,10,0,159100,1580.7,108.5
"14771","47214","2015",8,8,0,166141.8,1344.625,124
"14772","47215","2015",38,37,1,116620.9,1260.526,95.68421
"14773","47216","2015",6,6,0,315544.8,3465.5,92.83333
"14774","47217","2015",5,5,0,119940,1407,88.6
"14775","47218","2015",3,3,0,181333.3,1474.333,118.3333
"14776","47219","2015",3,3,0,215666.7,1669.667,132
"14777","47220","2015",2,2,0,95000,1155,82.5
"14778","47221","2015",7,7,0,145528.6,1780.143,90.71429
"14779","47222","2015",7,7,0,198428.6,1468.857,142
"14780","47223","2015",3,3,0,154333.3,1709,91.33333
"14781","47224","2015",3,3,0,175200,1248,139.3333
"14782","47225","2015",18,18,0,182756.4,1724.722,109.1667
"14783","47226","2015",10,10,0,162585.9,1135.2,143.7
"14784","47227","2015",2,2,0,170000,929.5,182
"14785","47228","2015",6,6,0,151116.7,1328.5,111
"14786","47229","2015",2,2,0,86250,1747.5,57.5
"14787","47230","2015",2,2,0,134600,1275,102
"14788","47231","2015",2,2,0,271250,1628,167
"14789","47232","2015",3,3,0,33666.67,525.3333,64.33333
"14790","47233","2015",21,21,0,123412.9,1170.952,111.6667
"14791","47234","2015",4,4,0,166650,1450.75,113
"14792","47235","2015",5,5,0,170680,1276,123.8
"14793","47237","2015",4,4,0,260985.2,1873,128
"14794","47238","2015",10,10,0,214493.5,1655.6,132.2
"14795","47239","2015",9,9,0,129255,1235.556,108.7778
"14796","47240","2015",2,2,0,180000,1667,104.5
"14797","47241","2015",14,14,0,183178.6,1540.857,128.9286
"14798","47242","2015",7,7,0,115692.9,1109.857,113
"14799","47244","2015",2,2,0,304000,1578.5,181
"14800","47246","2015",16,16,0,170258.7,1450.625,118.375
"14801","47247","2015",3,3,0,159333.3,1260.333,129
"14802","47248","2015",2,2,0,250475,1918,130.5
"14803","47249","2015",4,4,0,91375,1100,81.25
"14804","47250","2015",1,1,0,65000,637,102
"14805","47251","2015",5,5,0,138624,1272,117.2
"14806","47252","2015",60,57,3,108329.1,1166,93.03333
"14807","47253","2015",8,8,0,177775,1551.25,114
"14808","47254","2015",2,2,0,122500,796.5,134
"14809","47255","2015",1,1,0,110000,759,145
"14810","47256","2015",1,1,0,113000,1119,101
"14811","47257","2015",8,8,0,132537.5,1412.25,100.875
"14812","47258","2015",2,2,0,132700,1456,101.5
"14813","47259","2015",2,2,0,94225,643.5,146
"14814","47260","2015",3,3,0,205966.7,1098,181.6667
"14815","47262","2015",3,3,0,143316.7,940.6667,155.6667
"14816","47263","2015",7,7,0,190171.4,1628.286,120.8571
"14817","47264","2015",13,13,0,124207.7,1315.538,98.30769
"14818","47265","2015",2,2,0,123400,1116.5,101
"14819","47266","2015",3,3,0,96620.67,1305.667,74.66667
"14820","47267","2015",1,1,0,95500,1592,60
"14821","47269","2015",8,8,0,134712.5,1388.125,96.75
"14822","47271","2015",3,3,0,164333.3,964.6667,181.3333
"14823","47272","2015",3,3,0,98000,1088,103.3333
"14824","47273","2015",1,1,0,117000,2127,55
"14825","47274","2015",4,4,0,121445,1026.75,120
"14826","47275","2015",2,2,0,153850,1008.5,137
"14827","47276","2015",3,2,1,182666.7,1790.667,117
"14828","47277","2015",4,4,0,185750,1909.25,97
"14829","47278","2015",7,7,0,166942.9,1224.571,140.8571
"14830","47279","2015",2,2,0,70500,733.5,112.5
"14831","47280","2015",27,25,2,124542.6,1201.63,103.8148
"14832","47281","2015",3,3,0,201466.7,1445.333,132
"14833","47283","2015",10,10,0,100440,1014,98.2
"14834","47284","2015",2,2,0,213500,2686,94
"14835","47285","2015",11,11,0,101443.9,1044.727,98.54545
"14836","47286","2015",2,2,0,120000,907.5,123.5
"14837","47288","2015",3,3,0,198136.7,2039.333,95.66667
"14838","47289","2015",7,7,0,163471.4,1330.571,124.4286
"14839","47290","2015",10,10,0,213464.9,1517.5,140.2
"14840","47291","2015",8,8,0,133068.8,1349.625,101.25
"14841","47292","2015",7,7,0,79020.71,980.7143,79.85714
"14842","47295","2015",2,2,0,97500,1145.5,80.5
"14843","47296","2015",2,2,0,194500,1717,118.5
"14844","47297","2015",2,2,0,232500,1359.5,170
"14845","47298","2015",2,2,0,111000,1579.5,74
"14846","47299","2015",2,2,0,186630,1476.5,130
"14847","47300","2015",9,9,0,196155.6,1308.444,148
"14848","47301","2015",12,12,0,105433.3,1229.667,95.75
"14849","47302","2015",6,6,0,150750,1129,125.3333
"14850","47303","2015",3,3,0,283666.7,1690.333,165.6667
"14851","47305","2015",4,4,0,141287.5,1699.75,80.75
"14852","47306","2015",11,11,0,257911.6,2736.182,114.4545
"14853","47307","2015",1,1,0,250000,1866,134
"14854","47308","2015",1,1,0,77000,1283,60
"14855","47309","2015",6,6,0,90233.33,1125.167,82
"14856","47310","2015",125,109,16,97305.4,1119.784,88.576
"14857","47311","2015",1,1,0,178000,1483,120
"14858","47312","2015",11,11,0,115345.5,995.3636,119.1818
"14859","47314","2015",4,4,0,184400,1524.5,118.75
"14860","47315","2015",7,7,0,118571.4,1112,111.1429
"14861","47316","2015",2,2,0,97000,1324.5,73
"14862","47317","2015",4,4,0,105750,1193.5,85.25
"14863","47318","2015",7,6,1,90571.43,1222.143,71.85714
"14864","47319","2015",3,3,0,145666.7,1235.667,125
"14865","47320","2015",8,8,0,110311,1345.125,85.25
"14866","47321","2015",3,3,0,140000,1267.667,113.3333
"14867","47323","2015",288,251,37,112054.9,1245.694,91.76389
"14868","47324","2015",19,19,0,115221.1,1327.368,87.42105
"14869","47325","2015",6,6,0,99333.33,1043,97.16667
"14870","47326","2015",10,10,0,164879.1,1438.2,114.8
"14871","47327","2015",5,5,0,119400,1268.2,94.2
"14872","47328","2015",3,3,0,99500,763.3333,134
"14873","48001","2015",2,2,0,147940,1419.5,107
"14874","48002","2015",2,2,0,94367.5,979.5,110
"14875","48003","2015",1,1,0,110000,1310,84
"14876","48005","2015",3,3,0,64000,852.3333,69
"14877","48008","2015",2,2,0,67875,875,77
"14878","48009","2015",18,18,0,117250.6,1341.667,87.61111
"14879","48010","2015",2,2,0,86000,820,102.5
"14880","48012","2015",4,4,0,151583.5,1206.75,123
"14881","48013","2015",5,5,0,132860,1365,96
"14882","48015","2015",2,2,0,65600,1114.5,114
"14883","48016","2015",4,4,0,103000,1174.5,75.5
"14884","48017","2015",10,7,3,105890,1330.2,88.3
"14885","48018","2015",4,4,0,148950,1412.75,103.75
"14886","48019","2015",4,3,1,63562.5,1212,54.25
"14887","48025","2015",1,1,0,255700,1866,137
"14888","48027","2015",17,12,5,59717.65,1091.647,61.58824
"14889","48028","2015",1,1,0,40000,1000,40
"14890","48029","2015",1,1,0,90000,900,100
"14891","48030","2015",1,1,0,67500,1350,50
"14892","48031","2015",1,1,0,40000,833,48
"14893","48032","2015",1,1,0,1e+05,1538,65
"14894","48034","2015",11,10,1,100418.2,1047.727,93.27273
"14895","48036","2015",4,3,1,105067.5,1347.25,68.5
"14896","48037","2015",1,1,0,55000,1000,55
"14897","48038","2015",3,3,0,93650,719.6667,132
"14898","48039","2015",9,9,0,144457.9,1527.667,89.88889
"14899","48042","2015",4,4,0,193500,1506,129.5
"14900","48043","2015",2,2,0,154898.5,1541,100.5
"14901","48045","2015",2,2,0,77500,1067.5,71.5
"14902","48046","2015",2,2,0,38000,796.5,47.5
"14903","48050","2015",4,3,1,107311.2,2005.5,51.25
"14904","48051","2015",9,8,1,128136.4,1583.667,79.11111
"14905","48053","2015",2,1,1,54000,1036,61
"14906","48054","2015",1,1,0,70200,702,100
"14907","48055","2015",1,1,0,229000,1527,150
"14908","48056","2015",6,6,0,120000,1204.5,102
"14909","48058","2015",1,1,0,70000,636,110
"14910","48059","2015",2,2,0,117000,908.5,117
"14911","48061","2015",11,8,3,93650,1335.909,71.72727
"14912","48063","2015",5,5,0,102215,1034.4,89.4
"14913","48064","2015",2,2,0,122500,779.5,168
"14914","48067","2015",1,1,0,295000,2107,140
"14915","48068","2015",2,2,0,97850,1093,84.5
"14916","48070","2015",6,6,0,114368.5,1149.333,93
"14917","48071","2015",1,1,0,149900,1199,125
"14918","48075","2015",9,8,1,76555.56,1081,72.44444
"14919","48079","2015",2,2,0,76000,769,90
"14920","48080","2015",20,15,5,97973.2,1218.6,85
"14921","48081","2015",2,2,0,155650,1367.5,129.5
"14922","48082","2015",2,2,0,80000,967,83
"14923","48085","2015",3,3,0,110666.7,981.6667,118.3333
"14924","48086","2015",1,0,1,19000,452,42
"14925","48087","2015",3,3,0,56670.33,738.6667,76.66667
"14926","48088","2015",3,3,0,140533.3,1640,90
"14927","48089","2015",4,4,0,120600,1386,82.75
"14928","48090","2015",10,8,2,104650.2,1173.8,85.3
"14929","48092","2015",30,18,12,123666.7,1436.767,91.3
"14930","48094","2015",8,8,0,121243.8,1431.375,93.75
"14931","48095","2015",74,32,42,161134.2,1918.459,85.55405
"14932","48096","2015",8,8,0,157550,1371.375,116.75
"14933","48097","2015",1,1,0,195000,3421,57
"14934","48099","2015",12,12,0,126741.7,1346.833,96.5
"14935","48100","2015",1,1,0,20000,1000,20
"14936","48103","2015",6,6,0,185733.3,1597.333,116.6667
"14937","48104","2015",5,5,0,156600,2406.2,89.2
"14938","48105","2015",1,1,0,171715,1752,98
"14939","48106","2015",1,1,0,32880,391,84
"14940","48108","2015",1,1,0,74400,1063,70
"14941","48111","2015",4,3,1,70500,1159.25,59
"14942","48112","2015",2,2,0,89500,844,124
"14943","48115","2015",2,2,0,111000,3160.5,34
"14944","48116","2015",8,8,0,86750,1203.625,77.75
"14945","48117","2015",3,3,0,197000,1573,118
"14946","48119","2015",1,1,0,38000,679,56
"14947","48121","2015",1,1,0,90000,1364,66
"14948","48124","2015",1,1,0,1e+05,1000,100
"14949","48126","2015",1,1,0,245000,2579,95
"14950","48127","2015",10,9,1,76600,1349.5,61.1
"14951","48128","2015",5,4,1,79000,845.2,102.2
"14952","48129","2015",4,4,0,123927.5,1506.25,89
"14953","48130","2015",1,1,0,38000,809,47
"14954","48131","2015",1,1,0,108100,1201,90
"14955","48132","2015",10,10,0,111350,1370,84.4
"14956","48135","2015",1,1,0,77000,1540,50
"14957","48136","2015",1,1,0,260000,6842,38
"14958","48137","2015",2,2,0,200250,3636,83
"14959","48138","2015",1,1,0,234000,1828,128
"14960","48139","2015",2,2,0,23250,694,32.5
"14961","48140","2015",19,16,3,117581.6,1456.105,84.21053
"14962","48141","2015",2,2,0,140500,1274.5,107.5
"14963","48144","2015",2,2,0,236300,2732.5,88
"14964","48145","2015",2,2,0,60250,621.5,109.5
"14965","48146","2015",10,8,2,99485,1674.2,70.5
"14966","48147","2015",3,3,0,153067.7,1425,97.33333
"14967","48148","2015",3,3,0,201803.3,2479,84.33333
"14968","48149","2015",1,1,0,85000,1214,70
"14969","48152","2015",3,3,0,113333.3,1502,75.33333
"14970","48155","2015",2,2,0,259497.5,4036.5,66.5
"14971","48156","2015",4,4,0,113000,1417,81
"14972","48157","2015",1,1,0,95500,1137,84
"14973","48158","2015",1,1,0,85000,817,104
"14974","48160","2015",3,3,0,76133,878.3333,78.66667
"14975","48163","2015",1,1,0,115000,2091,55
"14976","48165","2015",1,1,0,110000,2200,50
"14977","48166","2015",1,1,0,199000,1658,120
"14978","48170","2015",3,3,0,81666.67,2098.333,41.66667
"14979","48171","2015",2,2,0,60250,725.5,82
"14980","48173","2015",1,1,0,115000,1494,77
"14981","48174","2015",1,1,0,64650,2020,32
"14982","48175","2015",1,1,0,165000,1964,84
"14983","48176","2015",2,2,0,67000,958.5,75
"14984","48177","2015",1,1,0,25000,357,70
"14985","48178","2015",3,3,0,96333.33,1148.333,81
"14986","48181","2015",1,1,0,20000,500,40
"14987","48185","2015",2,2,0,110000,1380,94
"14988","48188","2015",3,3,0,40000,841,49.33333
"14989","48190","2015",2,2,0,85000,879.5,89
"14990","48191","2015",1,1,0,1e+06,7692,130
"14991","48192","2015",2,2,0,90000,1158.5,77.5
"14992","48193","2015",5,5,0,59354,1149.8,55.6
"14993","48194","2015",4,4,0,96812.5,1124.75,82.5
"14994","48198","2015",6,6,0,137250,1286,95.5
"14995","49002","2015",34,33,1,125986.8,1308.676,93.91176
"14996","49003","2015",19,19,0,129684.2,1328.684,95.10526
"14997","49007","2015",2064,612,1452,145080.7,1963.256,73.50291
"14998","49008","2015",8,8,0,148243.8,1428.25,101.25
"14999","49009","2015",6,6,0,127200,1149.667,115.1667
"15000","49010","2015",4,4,0,150547.5,940.75,178.75
"15001","49011","2015",3,3,0,134833.3,1189,115
"15002","49012","2015",3,3,0,134333.3,1301,103.3333
"15003","49015","2015",161,110,51,210040.2,2085.516,102.882
"15004","49017","2015",7,7,0,137428.6,1224.571,111.1429
"15005","49018","2015",116,113,3,116517.4,1110.388,104.1724
"15006","49020","2015",67,65,2,203010.6,2140.896,98.68657
"15007","49021","2015",57,56,1,132648.2,1346.404,104.1404
"15008","49022","2015",14,14,0,154335.7,1429.5,111
"15009","49023","2015",172,165,7,122635.3,1231.581,100.25
"15010","49026","2015",25,25,0,149428,1457.64,104.32
"15011","49027","2015",15,15,0,125733.3,1258.733,103.6667
"15012","49028","2015",1,1,0,42000,1680,25
"15013","49029","2015",15,15,0,146293.3,1508,96.66667
"15014","49030","2015",7,7,0,137142.9,1322.571,105.4286
"15015","49035","2015",58,56,2,260025.3,2192.276,116.9828
"15016","49036","2015",5,5,0,85842.8,976.4,88
"15017","49038","2015",3,3,0,87393,864,114
"15018","49041","2015",6,6,0,109166.7,1189,97.33333
"15019","49045","2015",5,5,0,146300,1677.4,117.6
"15020","49048","2015",38,38,0,161468.4,1609.605,99.60526
"15021","49050","2015",87,83,4,183313.2,1731.586,111.1954
"15022","49053","2015",2,2,0,107000,1413,78
"15023","49054","2015",24,23,1,123115.1,1055.333,118.0833
"15024","49055","2015",21,20,1,195746.2,1927.476,103.4762
"15025","49056","2015",2,2,0,96250,888,103
"15026","49058","2015",8,8,0,108750,1210,89.875
"15027","49060","2015",13,12,1,131923.1,1447.462,93.61538
"15028","49061","2015",11,11,0,134136.4,1042.636,124.7273
"15029","49063","2015",60,54,6,152090.3,1604.517,96
"15030","49064","2015",10,10,0,153700,1378.1,109.5
"15031","49067","2015",6,6,0,82833.33,993.8333,91.5
"15032","49068","2015",16,16,0,126750,1313.188,95.6875
"15033","49069","2015",98,96,2,138149.9,1626.878,88.15306
"15034","49070","2015",8,8,0,106562.5,1012,105.75
"15035","49076","2015",9,9,0,143500,1473.667,102.4444
"15036","49080","2015",42,39,3,128131.2,1453.333,97.09524
"15037","49082","2015",7,7,0,124928.6,1398,91.14286
"15038","49086","2015",45,44,1,145683.4,1573.6,99.77778
"15039","49089","2015",7,7,0,161642.9,1390.143,119.5714
"15040","49090","2015",16,15,1,161006.2,1574.375,107.5625
"15041","49092","2015",138,136,2,137010.4,1332.507,105.3841
"15042","49099","2015",603,435,168,133545.9,1501.917,87.83748
"15043","49100","2015",7,7,0,135285.7,1226.857,111
"15044","49102","2015",1,1,0,161500,1794,90
"15045","49107","2015",4,4,0,183500,1219.25,162.75
"15046","49109","2015",12,12,0,119261.7,1253.5,97.41667
"15047","49110","2015",11,11,0,166761.8,1382.545,126.9091
"15048","49112","2015",12,12,0,143316.7,1251.417,108.3333
"15049","49113","2015",2,2,0,95000,1075.5,88.5
"15050","49114","2015",1,1,0,57500,1438,40
"15051","49120","2015",17,17,0,171999.1,1563.941,110.8824
"15052","49121","2015",3,3,0,116000,1662.667,79.33333
"15053","49123","2015",16,16,0,230406.2,2038.875,116.75
"15054","49125","2015",97,94,3,132920.7,1288.918,102.2165
"15055","49127","2015",36,35,1,125231.2,1170.917,106.9722
"15056","49129","2015",43,29,14,173086.9,2118.791,84.74419
"15057","49130","2015",3,3,0,176000,2013.667,90
"15058","49131","2015",6,6,0,151983.3,1296.5,116.1667
"15059","49132","2015",14,14,0,131089.3,1279.857,99.14286
"15060","49135","2015",21,20,1,148873.8,1544.048,96.85714
"15061","49138","2015",26,26,0,146769.2,1394.5,103.7692
"15062","49140","2015",7,7,0,104714.3,1116.571,100.1429
"15063","49155","2015",9,9,0,207555.6,1941.222,108.4444
"15064","49160","2015",25,25,0,130700,1347.44,97.92
"15065","49161","2015",6,6,0,150166.7,1855.667,94.66667
"15066","49163","2015",28,28,0,131518.9,1341.821,100.5
"15067","49167","2015",39,38,1,244199.2,2066.974,120.6667
"15068","49170","2015",14,14,0,105026.4,1322.571,86.07143
"15069","49171","2015",1,1,0,80000,1026,78
"15070","49174","2015",13,13,0,114653.8,1186.615,99.30769
"15071","49176","2015",7,6,1,135428.6,1043.143,121.8571
"15072","49178","2015",9,9,0,112166.7,983,115.8889
"15073","49180","2015",55,54,1,113990.5,1188.236,98.10909
"15074","49182","2015",7,7,0,76828.57,1073,77
"15075","49183","2015",56,54,2,131068.2,1334.286,101.2857
"15076","49188","2015",10,10,0,119300,1322.3,94.7
"15077","49192","2015",25,25,0,134440,1268.6,106.88
"15078","49193","2015",24,24,0,103041.7,1240.125,84.83333
"15079","49194","2015",57,57,0,139936.4,1382.07,102.7544
"15080","49195","2015",8,8,0,166625,1596.5,105.5
"15081","49200","2015",39,37,2,193005.1,1796.487,107.8974
"15082","49201","2015",18,18,0,142523.3,1291.556,116.2222
"15083","49205","2015",8,8,0,128977.4,1173.375,110.125
"15084","49209","2015",4,4,0,115000,974.5,121.75
"15085","49211","2015",12,12,0,90041.67,964.25,94.25
"15086","49214","2015",78,67,11,203934.7,1924.09,104.4615
"15087","49215","2015",18,18,0,97888.89,1094.833,94
"15088","49216","2015",3,3,0,127333.3,1274.333,91
"15089","49217","2015",6,6,0,87750,1174.833,79.66667
"15090","49218","2015",108,107,1,108166.3,1210.546,93.41667
"15091","49219","2015",8,8,0,128463.8,1599.375,76.25
"15092","49220","2015",36,36,0,98294.44,1059.417,98.83333
"15093","49221","2015",11,11,0,96309.09,971.5455,101.0909
"15094","49222","2015",14,14,0,189022.3,1570.643,123.5
"15095","49223","2015",55,43,12,199724.2,1830.182,110.0909
"15096","49224","2015",1,1,0,140000,1750,80
"15097","49228","2015",63,63,0,93558.9,959.2381,100.4286
"15098","49231","2015",9,9,0,125666.7,1221.889,101.7778
"15099","49235","2015",7,7,0,117142.9,1358.571,93.71429
"15100","49236","2015",2,2,0,102000,783.5,178.5
"15101","49237","2015",2,2,0,56000,725,74.5
"15102","49240","2015",7,7,0,119683.1,1307.571,89.57143
"15103","49241","2015",13,13,0,194753.8,1528.154,133.6154
"15104","49244","2015",147,145,2,122339.5,1301.925,96.27211
"15105","49246","2015",120,103,17,172734,1841.467,95.95833
"15106","49247","2015",18,17,1,165000,1515.611,105.9444
"15107","49248","2015",73,73,0,96283.55,1006.849,93.10959
"15108","49253","2015",22,22,0,103242.3,1050.182,101.9091
"15109","49257","2015",7,7,0,120321.4,868.5714,134
"15110","49259","2015",15,15,0,143146.7,1336.467,123
"15111","49260","2015",14,14,0,147392.9,1506.714,98.64286
"15112","49261","2015",86,86,0,132372.7,1434.628,96.36047
"15113","49262","2015",3,3,0,101336.7,1378.333,75.33333
"15114","49266","2015",14,14,0,150950,1648.571,93.14286
"15115","49267","2015",74,52,22,187470.3,1844.378,103.3243
"15116","49269","2015",12,12,0,151837.4,1457.833,105.6667
"15117","49271","2015",32,32,0,171282.5,1754.281,99.53125
"15118","49272","2015",8,8,0,101250,1264,86.25
"15119","49278","2015",32,28,4,215070.3,2030.938,110.4062
"15120","49283","2015",28,27,1,158060.5,1445.929,113.8929
"15121","49284","2015",8,8,0,167489.9,1646,107
"15122","49288","2015",3,3,0,117900,1689,72
"15123","49291","2015",4,4,0,115875,1239.5,94.25
"15124","49292","2015",31,31,0,156980.5,1859.581,95.41935
"15125","49294","2015",20,20,0,215982.5,1687.9,132.05
"15126","49298","2015",17,17,0,180660.4,1749.647,105.8824
"15127","49299","2015",28,27,1,166293.2,1566.75,107.1786
"15128","49301","2015",200,199,1,130113.7,1403.185,95.425
"15129","49302","2015",2,2,0,98100,854,114
"15130","49306","2015",13,13,0,193541.3,1792.077,107.7692
"15131","49307","2015",108,107,1,174350,1666.481,107.4074
"15132","49308","2015",11,11,0,238136.4,1988.727,118.0909
"15133","49310","2015",5,5,0,65168.8,945.4,75.2
"15134","49311","2015",14,14,0,134175,1264.286,110
"15135","49321","2015",3,3,0,141333.3,1375,102.3333
"15136","49323","2015",53,50,3,173809.4,1679.094,106.2453
"15137","49326","2015",7,7,0,155629.7,1621.429,91.57143
"15138","49328","2015",304,179,125,125210.6,1378.885,90.30592
"15139","49329","2015",9,9,0,222660.2,1873.556,110
"15140","49330","2015",11,11,0,159909.1,1596,97.63636
"15141","49331","2015",170,154,16,111266.6,1127.476,99.12941
"15142","49332","2015",33,33,0,150029.3,1407.788,105
"15143","49333","2015",26,25,1,135380.8,1412.731,102.8846
"15144","49334","2015",1,1,0,111200,1080,103
"15145","49336","2015",8,8,0,105312.5,1024.5,97
"15146","49338","2015",15,15,0,207900,1839.267,114.7333
"15147","49339","2015",11,11,0,182618.4,1539.636,121.9091
"15148","49341","2015",4,4,0,167500,1382.25,113
"15149","49343","2015",26,22,4,148729.5,2509.308,80.61538
"15150","49344","2015",10,10,0,168500,1840.2,100.1
"15151","49345","2015",54,54,0,134385.2,1263.019,109.0556
"15152","49347","2015",45,44,1,165005.3,1620.911,103.0222
"15153","49352","2015",12,12,0,132234.6,1496.5,90.25
"15154","49353","2015",137,123,14,162929.4,1774.876,93.16058
"15155","49355","2015",20,19,1,119690,1231.1,97.35
"15156","49358","2015",5,5,0,170200,1689.4,99.2
"15157","49359","2015",4,4,0,128750,1461.75,86.75
"15158","49361","2015",13,13,0,120269.2,1307.308,90.46154
"15159","49362","2015",12,12,0,180583.3,1600.417,116
"15160","49364","2015",14,14,0,109890.7,1095.214,98.64286
"15161","49367","2015",49,48,1,137932.2,1331.633,109.0408
"15162","49368","2015",16,16,0,94375,1092.625,84.1875
"15163","49369","2015",11,11,0,104772.7,1086.545,103.2727
"15164","49370","2015",3,3,0,167663.3,1177.667,151.6667
"15165","49371","2015",7,7,0,125214.3,1350.429,98.28571
"15166","49373","2015",74,74,0,110196,1077.068,103.9054
"15167","49374","2015",11,11,0,143900,1337.636,111.6364
"15168","49377","2015",42,42,0,178264.5,1510.762,118.0952
"15169","49378","2015",10,10,0,144380.5,1367,109.3
"15170","49381","2015",4,4,0,143675,1428,100.75
"15171","50002","2015",54,50,4,134801.9,1274.037,109.9444
"15172","50003","2015",72,66,6,206925.2,2488.125,90.31944
"15173","50004","2015",4,4,0,127500,1314,96
"15174","50006","2015",1,1,0,155000,1165,133
"15175","50008","2015",2,2,0,195650,1527,128
"15176","50013","2015",5,5,0,107400,1130.2,101.2
"15177","50015","2015",9,9,0,170100,1505.778,129.5556
"15178","50016","2015",3,3,0,125000,1473.333,105
"15179","50019","2015",2,2,0,60750,691.5,79.5
"15180","50022","2015",1,1,0,95000,856,111
"15181","50023","2015",12,12,0,100083.3,879.1667,111.5
"15182","50025","2015",109,53,56,123064.9,2608.541,71.23853
"15183","50026","2015",1,1,0,182000,1282,142
"15184","50027","2015",9,9,0,134944.4,1285.556,108
"15185","50028","2015",1,1,0,153300,1136,135
"15186","50029","2015",10,10,0,83338,973.4,79.3
"15187","50030","2015",7,5,2,176842.9,2459.429,73.57143
"15188","50031","2015",58,50,8,158857.1,2026.724,81.67241
"15189","50032","2015",5,5,0,146400,1290,114.2
"15190","50033","2015",4,4,0,202875,1457,137.25
"15191","50034","2015",6,6,0,199007.2,1628.5,123.5
"15192","50036","2015",3,3,0,116666.7,1177.667,97
"15193","50038","2015",4,4,0,103875,886,118.5
"15194","50040","2015",1,1,0,160000,1000,160
"15195","50041","2015",86,85,1,147110.2,1664.674,95.88372
"15196","50042","2015",4,4,0,237794.2,1996,112.5
"15197","50044","2015",2,2,0,90550,1480,60.5
"15198","50045","2015",7,7,0,161571.4,1462.429,102
"15199","50046","2015",4,4,0,162526.8,1366.5,120.5
"15200","50048","2015",7,7,0,105064.3,1021.143,102.7143
"15201","50049","2015",3,3,0,63333.33,970.6667,71.66667
"15202","50050","2015",2,2,0,75250,1041.5,64
"15203","50052","2015",2,2,0,186750,1627.5,122.5
"15204","50054","2015",1,1,0,160000,970,165
"15205","50058","2015",23,22,1,171826.1,2007.174,92.82609
"15206","50059","2015",2,2,0,87800,625.5,140.5
"15207","50060","2015",3,3,0,104166.7,787,116.6667
"15208","50066","2015",59,52,7,216053.2,2452.61,93.01695
"15209","50069","2015",2,2,0,104630,1341,77.5
"15210","50072","2015",1,1,0,152000,1462,104
"15211","50074","2015",23,23,0,106203,1019.043,104.8261
"15212","50076","2015",50,46,4,147727,1740.54,86.84
"15213","50077","2015",11,11,0,172454.5,1724,104.8182
"15214","50078","2015",11,11,0,102654.5,1285.091,91.81818
"15215","50079","2015",2,2,0,181000,1292,136
"15216","50081","2015",11,11,0,273663.6,2034.909,140.4545
"15217","50082","2015",53,53,0,128719.2,1474.868,91.32075
"15218","50083","2015",6,6,0,141166.7,1625.333,86.16667
"15219","50084","2015",3,3,0,113166.7,915,131
"15220","50085","2015",15,15,0,146760,1503.333,99.53333
"15221","50086","2015",1,1,0,102000,1342,76
"15222","50087","2015",17,17,0,165541.2,1509.294,114.1765
"15223","50088","2015",1,1,0,55000,917,60
"15224","50090","2015",5,5,0,43188,720.6,59.8
"15225","50092","2015",4,4,0,110436.2,951,123.5
"15226","50093","2015",10,10,0,70225,915.9,76.3
"15227","50094","2015",3,3,0,103166.7,722,136.3333
"15228","50095","2015",14,14,0,138667.9,1227.857,115.7857
"15229","50096","2015",1,1,0,75000,750,100
"15230","50097","2015",1,1,0,440000,3385,130
"15231","50098","2015",4,4,0,80250,994,83.75
"15232","50099","2015",109,97,12,114220.9,1243.303,95.82569
"15233","50102","2015",26,24,2,162535.7,1855.885,99.11538
"15234","50106","2015",3,3,0,115333.3,1249.667,88.33333
"15235","50108","2015",5,5,0,103600,1605,71.4
"15236","50109","2015",16,16,0,97750,996.5,98.25
"15237","50110","2015",10,10,0,96285,1003.6,102.6
"15238","50111","2015",11,11,0,127548.4,1106.909,116.4545
"15239","50112","2015",2,2,0,141750,1473.5,101.5
"15240","50115","2015",2,2,0,115500,1138,98
"15241","50117","2015",8,8,0,230125,2294.5,101.25
"15242","50118","2015",7,7,0,113650,912.4286,125.2857
"15243","50120","2015",2,2,0,162750,1636.5,99.5
"15244","50121","2015",4,4,0,139750,1661.75,94
"15245","50126","2015",2,2,0,247250,1468,171
"15246","50129","2015",747,587,160,134842.6,1588.814,86.85542
"15247","50130","2015",6,6,0,84333.33,1170.5,67
"15248","50137","2015",3,3,0,82333.33,991,87
"15249","50138","2015",10,10,0,142950,1467.2,101.7
"15250","50139","2015",31,31,0,131195.2,1218.097,111.129
"15251","50142","2015",8,8,0,116000,1421.75,76.125
"15252","50143","2015",7,7,0,99365.71,1168.571,90.42857
"15253","50144","2015",5,5,0,67520,886.6,86.2
"15254","50145","2015",6,6,0,119583.3,1174.167,100.8333
"15255","50146","2015",3,3,0,71266.67,1069.667,63.33333
"15256","50147","2015",89,59,30,110747.2,1266.112,89.95506
"15257","50148","2015",4,4,0,100300,1285.75,78.25
"15258","50149","2015",3,3,0,161666.7,1434.333,113
"15259","50150","2015",7,7,0,121678.6,1339.429,87.85714
"15260","50151","2015",13,12,1,95630.77,1142.462,91.69231
"15261","50152","2015",3,3,0,70333.33,859.6667,77
"15262","50156","2015",1,1,0,57000,722,79
"15263","50158","2015",2,2,0,65880.5,783.5,72
"15264","50159","2015",6,6,0,93333.33,913.1667,99.66667
"15265","50161","2015",8,8,0,118875,1255.25,104.75
"15266","50162","2015",18,18,0,214842.2,1906.611,121.7222
"15267","50164","2015",7,7,0,100357.1,978.4286,102
"15268","50165","2015",78,52,26,172577.7,2316.385,78.33333
"15269","50167","2015",11,11,0,163454.5,1582.636,104.8182
"15270","50168","2015",20,19,1,110741.4,1309.15,88.2
"15271","50172","2015",1,1,0,180000,1250,144
"15272","50174","2015",2,2,0,186000,1464.5,130
"15273","50176","2015",5,5,0,104900,1675.6,63.6
"15274","50177","2015",3,3,0,155680,1639.667,94.33333
"15275","50178","2015",13,13,0,137423.1,1447.923,94.76923
"15276","50181","2015",3,3,0,83166.67,904,85.66667
"15277","50182","2015",5,5,0,92800,963.2,90.8
"15278","50183","2015",4,4,0,147000,1960.5,110
"15279","50184","2015",12,12,0,110250,1342.5,83.25
"15280","50185","2015",7,7,0,116700,1423.286,83.42857
"15281","50186","2015",1,1,0,45000,625,72
"15282","50188","2015",6,6,0,104833.3,1188.667,86.33333
"15283","50190","2015",3,3,0,148000,1831.667,86.66667
"15284","50192","2015",2,2,0,83500,1104.5,87.5
"15285","50193","2015",5,5,0,132276,1281.2,98.8
"15286","50194","2015",5,5,0,132340,1287.2,97.6
"15287","50195","2015",10,10,0,95200,1258,94.6
"15288","50196","2015",4,4,0,151250,2550.5,63.25
"15289","50197","2015",30,30,0,120778.7,1206.1,102.4667
"15290","50198","2015",3,3,0,145000,1541.667,94
"15291","50199","2015",4,4,0,114500,1467,74.75
"15292","50200","2015",11,11,0,84564.27,893.8182,101.0909
"15293","50205","2015",3,3,0,91606.33,1242,69.33333
"15294","50207","2015",3,3,0,98333.33,1339,87.33333
"15295","50208","2015",1,1,0,157000,604,260
"15296","50209","2015",13,13,0,154369.2,1700.231,97.38462
"15297","50210","2015",4,4,0,78062.5,1033.5,74
"15298","50214","2015",4,4,0,70875,810.75,106.75
"15299","50215","2015",33,33,0,130950,1547.576,92.18182
"15300","50216","2015",5,5,0,105040,1007.4,103.6
"15301","50217","2015",6,6,0,61537.17,843.3333,74.16667
"15302","50218","2015",249,91,158,145638.3,2212.454,67.55422
"15303","50219","2015",4,4,0,166742.5,1616.5,99.75
"15304","50221","2015",1,1,0,90000,1023,88
"15305","50222","2015",13,13,0,129964.2,1664.385,78.69231
"15306","50227","2015",1,1,0,109000,1298,84
"15307","50228","2015",16,16,0,88225,1020.562,87.375
"15308","50229","2015",1,1,0,83900,1199,70
"15309","50230","2015",6,6,0,158000,1428.667,109.3333
"15310","50231","2015",18,18,0,119655.6,2237.222,65.11111
"15311","50232","2015",4,4,0,91750,824,117.5
"15312","50233","2015",2,2,0,97500,1109,82.5
"15313","50234","2015",1,1,0,85000,525,162
"15314","50235","2015",1,1,0,110000,1375,80
"15315","50236","2015",39,39,0,117913.9,1303.692,96.10256
"15316","50237","2015",8,8,0,71375,769.625,97.125
"15317","50239","2015",11,11,0,130816.8,1284.727,113.5455
"15318","50240","2015",7,7,0,161142.9,1408.571,119.2857
"15319","50241","2015",4,4,0,120750,1679.75,89.5
"15320","50243","2015",2,2,0,141500,1372,102.5
"15321","50246","2015",2,2,0,146500,1395.5,114.5
"15322","50251","2015",3,3,0,107766.7,1082,113.6667
"15323","50252","2015",14,14,0,117314.3,1396.071,79.28571
"15324","50253","2015",3,3,0,91166.67,994,115
"15325","50256","2015",39,39,0,131933.2,1400.128,103.3846
"15326","50259","2015",5,5,0,121000,1054.4,113.4
"15327","50260","2015",21,21,0,79904.76,1045.952,75.19048
"15328","50262","2015",5,5,0,100600,1167.4,89
"15329","50263","2015",7,7,0,80285.71,822.2857,99.57143
"15330","50265","2015",4,4,0,83765.5,853.25,97.75
"15331","50266","2015",6,6,0,109833.3,1020.5,113.8333
"15332","50267","2015",21,20,1,98688.48,1305.048,78.57143
"15333","50268","2015",3,3,0,120333.3,1310.333,97.33333
"15334","50269","2015",5,5,0,130400,1230.8,110.2
"15335","50270","2015",3,3,0,125000,1265.333,99
"15336","50272","2015",21,21,0,120728,1633.857,75.14286
"15337","50273","2015",16,16,0,88781.25,1008.75,97.3125
"15338","50274","2015",9,9,0,114992,1152.444,98.44444
"15339","50275","2015",1,1,0,44300,492,90
"15340","50276","2015",5,5,0,159588,1238.6,133.4
"15341","50277","2015",7,7,0,180428.6,1764.286,95.42857
"15342","50278","2015",6,6,0,85616.67,838.6667,95
"15343","50279","2015",8,8,0,92762.5,951.375,99.375
"15344","50281","2015",12,12,0,134020.8,1430.75,96.08333
"15345","50282","2015",1,1,0,120000,1519,79
"15346","50283","2015",1,1,0,238000,1266,188
"15347","50285","2015",5,5,0,125400,1625.8,76.8
"15348","50288","2015",15,15,0,136200,1441.333,92.73333
"15349","50289","2015",8,8,0,89837.5,956.625,96
"15350","50290","2015",5,5,0,106976,1211.2,85.6
"15351","50291","2015",2,2,0,142750,1320,129.5
"15352","50292","2015",21,21,0,134895.2,1199.619,109.5238
"15353","50294","2015",7,7,0,114600,1408.857,81.85714
"15354","50295","2015",2,2,0,79500,763,104
"15355","50296","2015",1,1,0,156000,2836,55
"15356","50297","2015",13,13,0,124280.8,1102.615,114.6154
"15357","50298","2015",3,3,0,164333.3,969.3333,171
"15358","50299","2015",2,2,0,147750,1191.5,121.5
"15359","50300","2015",1,1,0,71500,1233,58
"15360","50302","2015",4,4,0,157500,1417.25,112.25
"15361","50304","2015",2,2,0,88500,748,111
"15362","50305","2015",6,6,0,157600,2094,89.5
"15363","50310","2015",2,2,0,96500,729.5,142
"15364","50311","2015",1,1,0,50000,649,77
"15365","50315","2015",2,2,0,103500,1425,80
"15366","50317","2015",1,1,0,140000,1429,98
"15367","50321","2015",5,5,0,165980,1322.4,128.6
"15368","50324","2015",1,1,0,140000,1167,120
"15369","50326","2015",9,9,0,106346.1,1330.333,79.55556
"15370","50327","2015",2,2,0,126190.5,923,134
"15371","50328","2015",8,8,0,82729.12,934.875,86.625
"15372","50332","2015",11,11,0,115136.4,1371.182,86
"15373","50334","2015",2,2,0,119000,1077.5,119.5
"15374","50335","2015",4,4,0,119625,1451.25,83
"15375","50336","2015",3,3,0,143666.7,1324.333,109.6667
"15376","50338","2015",10,10,0,72540,776.7,92.5
"15377","50340","2015",4,4,0,87750,1272.25,78.5
"15378","50341","2015",16,16,0,108450,1502.812,82.75
"15379","50342","2015",15,15,0,119600,2095.4,74.2
"15380","50345","2015",5,5,0,123000,1028.8,120.2
"15381","50347","2015",1,1,0,148000,1480,100
"15382","50349","2015",19,19,0,128786.8,1834.263,83.21053
"15383","50350","2015",6,6,0,152624.2,1589.333,98.5
"15384","50351","2015",2,2,0,123000,1020.5,120
"15385","50352","2015",7,7,0,90142.86,656.1429,128
"15386","50356","2015",12,12,0,130358.3,1266.75,103.5
"15387","50359","2015",34,31,3,78073.24,1025.5,84.35294
"15388","50360","2015",1,1,0,195500,1700,115
"15389","50361","2015",4,4,0,117250,1102,98.5
"15390","50362","2015",3,3,0,93071.33,977.3333,92
"15391","50363","2015",13,13,0,134023.1,1081.923,122.8462
"15392","50364","2015",10,10,0,98620,1244,82.6
"15393","50365","2015",1,1,0,180000,1593,113
"15394","50369","2015",5,5,0,175100,1367,126.8
"15395","50370","2015",2,2,0,115000,1207,97
"15396","50371","2015",4,4,0,88750,833.25,101.5
"15397","50372","2015",1,1,0,48000,889,54
"15398","50373","2015",2,2,0,91500,1110.5,82.5
"15399","50376","2015",1,1,0,130000,1354,96
"15400","50378","2015",4,4,0,63000,795,83.5
"15401","50379","2015",2,2,0,80000,1607,57
"15402","50382","2015",5,5,0,171400,1817.6,95.2
"15403","50387","2015",1,1,0,160000,1212,132
"15404","50388","2015",11,11,0,120739.1,1243.818,94.09091
"15405","50389","2015",7,7,0,85142.86,837.4286,100.4286
"15406","50390","2015",1,1,0,17000,405,42
"15407","50391","2015",17,16,1,90792.35,1181,77.94118
"15408","50393","2015",26,26,0,105676.2,1112,97.23077
"15409","50394","2015",16,16,0,87406.25,874.8125,104.1875
"15410","50395","2015",3,3,0,113400,1346,85.33333
"15411","50397","2015",2,2,0,149000,2500,56
"15412","50400","2015",38,38,0,99011.18,1141,91.55263
"15413","50401","2015",5,5,0,153500,1668.4,103.4
"15414","50402","2015",31,31,0,175170,1814.484,104.2903
"15415","50403","2015",27,27,0,106109.7,1499.37,76.59259
"15416","50405","2015",4,4,0,94266.25,1157,108.5
"15417","50407","2015",6,6,0,94641.67,1187.167,76.83333
"15418","50408","2015",4,4,0,72700,775.25,95.75
"15419","50409","2015",24,21,3,90791.67,1032.75,89.95833
"15420","50410","2015",50,42,8,107953.2,1276.1,87.04
"15421","50411","2015",6,6,0,170666.7,1597.167,109.1667
"15422","50412","2015",48,48,0,157365.6,1961.854,89.08333
"15423","50413","2015",7,7,0,113214.3,1400,80.42857
"15424","50417","2015",21,21,0,131494.9,1537.905,94.85714
"15425","50419","2015",23,23,0,122000,1321.913,90.78261
"15426","50420","2015",6,6,0,93166.67,864.1667,97.33333
"15427","50421","2015",6,6,0,148100,2117.833,76
"15428","50422","2015",3,3,0,96666.67,707.3333,138.3333
"15429","50423","2015",2,2,0,159100,1271,124.5
"15430","50425","2015",5,5,0,115340,1050.4,107
"15431","50426","2015",4,4,0,68125,1090.25,71
"15432","50428","2015",9,9,0,55311.11,939,63.22222
"15433","50429","2015",15,15,0,154908.7,1979.267,81.13333
"15434","50431","2015",13,13,0,102069.2,940.6154,108.2308
"15435","50433","2015",17,17,0,163470.6,1659.529,95.88235
"15436","50435","2015",5,5,0,111600,1194,91.2
"15437","50436","2015",13,13,0,120083.2,1422.769,83.61538
"15438","50437","2015",5,5,0,132680,1184.6,117
"15439","50442","2015",2,2,0,148500,1315.5,119.5
"15440","50443","2015",4,4,0,75025,973.5,75.25
"15441","50444","2015",19,19,0,112023.7,1109.842,103.5789
"15442","50445","2015",7,7,0,113500,973.4286,117.7143
"15443","50446","2015",3,3,0,172333.3,1543.667,112.3333
"15444","50447","2015",2,2,0,270000,1854.5,146
"15445","50448","2015",6,6,0,97300,1019.667,96.5
"15446","50450","2015",3,3,0,100133.3,896,113.3333
"15447","50451","2015",1,1,0,41500,629,66
"15448","50452","2015",8,8,0,108043.8,1039.125,106.75
"15449","50453","2015",8,8,0,124513.5,1185.25,113.25
"15450","50454","2015",4,4,0,232500,1730.75,138
"15451","50455","2015",8,8,0,148875,1487.75,104.25
"15452","50456","2015",9,9,0,128429.3,1332.444,94.66667
"15453","50457","2015",5,5,0,84220.8,1098.6,92.8
"15454","50461","2015",1,1,0,170000,1308,130
"15455","50462","2015",9,8,1,56427.89,633.6667,85.55556
"15456","50463","2015",10,10,0,116406.5,1442.1,87.3
"15457","50464","2015",3,3,0,107666.7,1331,80.66667
"15458","50467","2015",4,4,0,146550,1426,103
"15459","50468","2015",4,4,0,81250,905.25,97
"15460","50469","2015",3,3,0,120000,1448.667,83
"15461","50471","2015",6,6,0,179500,1630.667,96.33333
"15462","50472","2015",3,3,0,139000,1368.667,97.33333
"15463","50473","2015",3,3,0,142666.7,1275.667,100
"15464","50474","2015",3,3,0,122733.3,1194.333,101.6667
"15465","50475","2015",6,6,0,144858.3,1339.667,107.6667
"15466","50476","2015",2,2,0,100500,915,100
"15467","50478","2015",4,4,0,146750,1262.25,109.25
"15468","50479","2015",3,3,0,77666.67,741.6667,94.66667
"15469","50480","2015",4,4,0,88500,879.25,95
"15470","50481","2015",30,30,0,137619.2,1897.5,78.1
"15471","50482","2015",1,1,0,120000,1000,120
"15472","50483","2015",10,10,0,142540,1390.3,101.3
"15473","50484","2015",40,37,3,101614.2,1178.675,87.125
"15474","50486","2015",2,2,0,182500,1800.5,101.5
"15475","50487","2015",38,37,1,104225.6,1140.447,95.89474
"15476","50488","2015",6,6,0,139905.7,982.3333,141.1667
"15477","50489","2015",6,6,0,131750,1346.5,98.16667
"15478","50490","2015",6,5,1,126916.7,1947.667,65.5
"15479","50491","2015",3,3,0,78333.33,845.6667,94.66667
"15480","50492","2015",17,17,0,135568.6,1086.647,126.7059
"15481","50493","2015",10,10,0,169711,1602.2,106.1
"15482","50495","2015",1,1,0,62200,565,110
"15483","50496","2015",4,4,0,103500,1615.75,75.25
"15484","50498","2015",7,7,0,162642.9,1534.857,107.5714
"15485","50499","2015",8,8,0,80296.88,908,86.625
"15486","50500","2015",8,8,0,101953.8,1239.625,80
"15487","50502","2015",191,121,70,114055.5,1270.257,92.23037
"15488","50505","2015",3,3,0,165333.3,1547,105.3333
"15489","50506","2015",4,4,0,127550,1350,91.75
"15490","50507","2015",4,4,0,192250,1797.75,115.25
"15491","50509","2015",12,12,0,140491.7,1304.417,108.25
"15492","50510","2015",7,7,0,116364.3,1305.286,94.42857
"15493","50511","2015",1,1,0,170000,2267,75
"15494","50512","2015",6,6,0,112866.7,1114,98.33333
"15495","50513","2015",4,4,0,120125,1006.5,119.5
"15496","50514","2015",6,6,0,71369.33,1013.833,73.66667
"15497","50517","2015",2,2,0,140000,1438,90
"15498","50518","2015",3,3,0,66666.67,661,83.66667
"15499","50519","2015",8,8,0,206875,1962,112.875
"15500","50522","2015",4,4,0,106125,973.75,116.25
"15501","50523","2015",35,34,1,119187.3,1423.657,90.57143
"15502","50525","2015",10,10,0,93270,1211.6,88.9
"15503","50528","2015",6,6,0,81833.33,898,93.16667
"15504","50529","2015",1,1,0,30000,526,57
"15505","50531","2015",5,5,0,106850,1221.8,87.6
"15506","50532","2015",76,54,22,205570.9,2315.934,91.06579
"15507","50533","2015",4,4,0,200400,1870.5,109.5
"15508","50535","2015",8,8,0,104612.5,1193.625,97.375
"15509","50537","2015",4,4,0,171425,1446.5,110
"15510","50538","2015",1,1,0,40000,533,75
"15511","50539","2015",18,18,0,123607.2,1459.778,90.88889
"15512","50540","2015",9,9,0,165777.8,1487.444,109.5556
"15513","50541","2015",17,17,0,158993.5,1775,93.47059
"15514","50542","2015",3,3,0,96833.33,1062,90.33333
"15515","50543","2015",9,9,0,130722.2,1508,89.66667
"15516","50546","2015",31,31,0,134071,1331.903,103.0323
"15517","50549","2015",4,4,0,104800,1110.75,102.25
"15518","50550","2015",22,22,0,109948.2,973.6818,113.3636
"15519","50551","2015",14,13,1,107107.1,1097.214,101.6429
"15520","50552","2015",4,4,0,121125,1006.75,119.5
"15521","50553","2015",1,1,0,75000,765,98
"15522","50554","2015",12,12,0,146983.3,1555.417,96.58333
"15523","50556","2015",7,7,0,134717.1,1251.571,115.4286
"15524","50562","2015",33,28,5,162408.1,2004.091,85.90909
"15525","50563","2015",8,8,0,148312.5,1277.625,118
"15526","50564","2015",5,5,0,108300,912.6,122.2
"15527","50565","2015",33,30,3,130431.7,1359.485,95.27273
"15528","50567","2015",9,9,0,131866.7,1657.889,87.11111
"15529","50568","2015",2,2,0,90500,1106.5,83
"15530","50569","2015",6,6,0,129488.3,1288.667,99.33333
"15531","50570","2015",2,2,0,47500,905.5,45.5
"15532","50572","2015",1,1,0,50000,758,66
"15533","50574","2015",3,3,0,75000,859.3333,82
"15534","50575","2015",9,9,0,180711.1,1837.444,100.7778
"15535","50576","2015",7,7,0,162031.4,2227.429,80.71429
"15536","50577","2015",1,1,0,105000,2100,50
"15537","50578","2015",1,1,0,170000,1241,137
"15538","50579","2015",9,9,0,134733.3,1545,88.77778
"15539","50580","2015",2,2,0,162000,1573.5,102.5
"15540","50582","2015",33,32,1,82959.09,1028.848,87.21212
"15541","50584","2015",2,2,0,56250,809,73.5
"15542","50585","2015",20,20,0,121950,1493.75,83.95
"15543","50588","2015",6,6,0,134122.7,1344.5,96.83333
"15544","50589","2015",2,2,0,136500,1194,104.5
"15545","50590","2015",4,4,0,137375,1135,120.25
"15546","50591","2015",14,14,0,69150,759.5714,91.28571
"15547","50592","2015",18,18,0,136911.1,1554.833,105.5556
"15548","50593","2015",11,11,0,101668.2,1125.909,92.18182
"15549","50594","2015",6,6,0,187443.3,1913.667,99.83333
"15550","50596","2015",3,3,0,155300,1465,105.6667
"15551","50597","2015",8,8,0,119875,1383.5,94.75
"15552","50598","2015",2,2,0,181800,1555,115
"15553","50599","2015",11,11,0,180990.3,1762.909,105.1818
"15554","50601","2015",33,33,0,95973.76,1099.273,90
"15555","50603","2015",12,12,0,138166.7,1609.167,92
"15556","50604","2015",10,10,0,133750,1345,109.2
"15557","50606","2015",1,1,0,70000,1148,61
"15558","50607","2015",3,3,0,61833.33,840.3333,60.66667
"15559","50609","2015",1,1,0,87000,967,90
"15560","50610","2015",2,2,0,102500,1529.5,80
"15561","50612","2015",6,6,0,151666.7,1574.333,98.83333
"15562","50613","2015",4,4,0,230750,1796,131.25
"15563","50615","2015",62,53,9,128814.7,1389.435,96.95161
"15564","50616","2015",10,10,0,149900.2,1470.6,106.3
"15565","50617","2015",4,4,0,57000,843,78
"15566","50618","2015",3,3,0,87666.67,1240.333,72.33333
"15567","50619","2015",3,3,0,105666.7,1411.667,82.33333
"15568","50624","2015",6,6,0,99166.67,829,120.3333
"15569","50626","2015",5,5,0,177250,1424.8,140.4
"15570","50628","2015",1,1,0,60000,1034,58
"15571","50629","2015",12,12,0,95437.08,1148.167,91.41667
"15572","50633","2015",1,1,0,106000,1514,70
"15573","50637","2015",6,6,0,95350,853.1667,105
"15574","50639","2015",36,31,5,110611.1,1280.194,92.22222
"15575","50641","2015",10,10,0,130825,1281.6,101.6
"15576","50643","2015",2,2,0,148500,1492.5,81
"15577","50647","2015",13,13,0,152051.5,1826.923,85.23077
"15578","50648","2015",3,3,0,171333.3,2015.667,90.66667
"15579","51001","2015",3,3,0,122333.3,1121.333,113.6667
"15580","51003","2015",3,3,0,158666.7,1237.667,134.6667
"15581","51006","2015",1,1,0,72000,900,80
"15582","51007","2015",10,10,0,168250,1756.9,101
"15583","51008","2015",1,1,0,70000,1250,56
"15584","51012","2015",1,1,0,113350,1259,90
"15585","51013","2015",1,1,0,158400,984,161
"15586","51014","2015",3,3,0,127666.7,1075.667,123
"15587","51017","2015",2,2,0,140500,1397,101
"15588","51018","2015",4,4,0,170500,1465.75,109
"15589","51019","2015",1,1,0,157000,1427,110
"15590","51022","2015",2,2,0,129425,1275,104.5
"15591","51023","2015",3,3,0,207008.3,1345,173.3333
"15592","51025","2015",6,6,0,172333.3,1850.333,99
"15593","51027","2015",1,1,0,127000,1351,94
"15594","51029","2015",16,16,0,148893.8,1494.812,97.125
"15595","51030","2015",55,38,17,137786.3,1627.491,87.61818
"15596","51031","2015",5,5,0,192660,1575.6,122.4
"15597","51036","2015",11,10,1,75480.45,1050.091,74.54545
"15598","51037","2015",4,4,0,149903.5,1528.25,101.75
"15599","51038","2015",1,1,0,175000,1750,100
"15600","51040","2015",2,2,0,132500,1027.5,124.5
"15601","51042","2015",2,2,0,95000,1208.5,79
"15602","51043","2015",17,17,0,151817.6,1484.118,104.2353
"15603","51044","2015",4,4,0,226458.2,2211.5,104.25
"15604","51046","2015",9,9,0,199641.7,1903.778,106.3333
"15605","51048","2015",3,3,0,468060.7,3519,147.3333
"15606","51049","2015",1,1,0,150000,1111,135
"15607","51050","2015",2,2,0,145000,2133.5,73
"15608","51051","2015",1,1,0,280000,2435,115
"15609","51052","2015",3,3,0,164966.7,1362.333,116.3333
"15610","51054","2015",20,20,0,141235.5,1461.5,102.15
"15611","51055","2015",58,45,13,199293.6,2042.621,99.18966
"15612","51058","2015",8,7,1,246687.5,2244.875,116.25
"15613","51059","2015",6,6,0,132341.7,1332.5,101
"15614","51065","2015",6,6,0,108500,1143.833,94.66667
"15615","51066","2015",5,5,0,46200,701.2,66
"15616","51069","2015",1,1,0,110000,1746,63
"15617","51070","2015",3,3,0,140500,1686.333,99
"15618","51073","2015",3,3,0,184366.7,1590,116.6667
"15619","51074","2015",22,21,1,161857.8,1687.091,101.8182
"15620","51075","2015",17,16,1,236211.8,2085.647,114.5294
"15621","51077","2015",2,2,0,207500,1351,180
"15622","51078","2015",2,2,0,189600,1478.5,127.5
"15623","51079","2015",9,9,0,236467.8,1936.889,125.2222
"15624","51081","2015",3,3,0,272283.3,2484.333,125
"15625","51086","2015",4,4,0,168275,1782.75,94.75
"15626","51093","2015",7,7,0,243371.4,1470.857,162.1429
"15627","51094","2015",1,1,0,120000,1500,80
"15628","51095","2015",1,1,0,146500,964,152
"15629","51097","2015",1,1,0,119000,1545,77
"15630","51098","2015",2,2,0,110200,1142,90
"15631","51099","2015",2,2,0,90500,1152,79
"15632","51101","2015",6,6,0,220550,1999.5,111.3333
"15633","51102","2015",3,3,0,190666.7,1819,107.3333
"15634","51105","2015",11,11,0,233415.3,2238.909,111.7273
"15635","51108","2015",338,155,183,114385.4,1374.873,82.06213
"15636","51109","2015",1,1,0,650000,2083,312
"15637","51110","2015",1,1,0,170000,1214,140
"15638","51112","2015",3,3,0,195533.3,1400,132.3333
"15639","51115","2015",7,7,0,290771.4,2506,120.2857
"15640","51117","2015",1,1,0,165000,1435,115
"15641","51118","2015",10,10,0,391345,2446.3,166.3
"15642","51129","2015",2,2,0,153500,1329,115.5
"15643","51134","2015",1,1,0,150000,1163,129
"15644","51136","2015",6,6,0,142916.7,1232.167,110.3333
"15645","51139","2015",4,4,0,152375,994,145.75
"15646","51140","2015",3,3,0,160333.3,1506,111
"15647","51141","2015",8,8,0,133773.5,1139.625,115.5
"15648","51142","2015",2,2,0,186750,2096,88.5
"15649","51145","2015",1,1,0,746000,6217,120
"15650","51146","2015",1,1,0,104500,1357,77
"15651","51147","2015",5,5,0,139140,1327.8,105
"15652","51150","2015",1,1,0,28000,364,77
"15653","51152","2015",2,2,0,335750,1988.5,169.5
"15654","51153","2015",11,11,0,139289.5,1482.909,97.18182
"15655","51154","2015",2,2,0,125800,1261.5,116
"15656","51158","2015",2,2,0,123755,1154,106.5
"15657","51160","2015",16,16,0,141816.9,1365.688,102.0625
"15658","51161","2015",7,7,0,141114.3,1384.429,108.8571
"15659","51163","2015",4,4,0,106125,1088.75,100
"15660","51167","2015",2,2,0,93500,1028.5,92.5
"15661","51171","2015",16,16,0,181437.5,1857,98.4375
"15662","51172","2015",56,42,14,232644.2,2440.964,97.98214
"15663","51175","2015",3,3,0,192333.3,1307,140.6667
"15664","51177","2015",1,1,0,3e+05,2308,130
"15665","51181","2015",5,5,0,233000,1817.2,119.6
"15666","51182","2015",1,1,0,135000,1364,99
"15667","51183","2015",8,7,1,203300,2102.75,100.875
"15668","51187","2015",4,4,0,145950,1540,94.5
"15669","51188","2015",1,1,0,230000,3151,73
"15670","51191","2015",2,2,0,96000,976.5,100.5
"15671","51193","2015",15,15,0,170065.6,1539.267,115.5333
"15672","51194","2015",6,6,0,158583.3,1382.167,115.6667
"15673","51195","2015",5,5,0,136200,1246.8,122.4
"15674","51196","2015",5,5,0,194084,1550.8,125.2
"15675","51197","2015",2,2,0,131000,1461.5,90.5
"15676","51198","2015",2,2,0,228000,2289,101.5
"15677","51199","2015",3,3,0,117600,863.3333,122
"15678","51200","2015",2,2,0,192500,2568,78.5
"15679","51202","2015",9,9,0,184263.3,1583.222,122.3333
"15680","51205","2015",2,2,0,162500,1660.5,98.5
"15681","51206","2015",1,1,0,60000,400,150
"15682","51208","2015",1,1,0,220800,1502,147
"15683","51212","2015",2,2,0,156400,972.5,162.5
"15684","51213","2015",1,1,0,50000,1000,50
"15685","51214","2015",1,1,0,130000,765,170
"15686","51216","2015",2,2,0,110000,1467,89
"15687","51218","2015",2,2,0,123380,1127.5,104.5
"15688","51220","2015",1,1,0,79000,963,82
"15689","51225","2015",3,3,0,112000,1033.667,105.3333
"15690","51227","2015",2,2,0,134050,1581.5,85
"15691","51228","2015",2,2,0,106150,966.5,111
"15692","51229","2015",2,2,0,80750,489,173.5
"15693","51230","2015",219,122,97,133046.6,1680.274,78.40183
"15694","51231","2015",4,3,1,203043.8,2075,100.25
"15695","51238","2015",6,6,0,136083.3,1446.667,95.5
"15696","51239","2015",3,3,0,119500,1024.333,132.6667
"15697","51242","2015",44,37,7,140927.5,1494.5,95.22727
"15698","51244","2015",1,1,0,135000,1421,95
"15699","51245","2015",3,3,0,202566.7,1732.333,120
"15700","51248","2015",21,20,1,96223.81,1346.476,89.85714
"15701","51250","2015",46,41,5,141667.8,1517.978,98.21739
"15702","51251","2015",1,1,0,150000,508,295
"15703","51253","2015",3,3,0,82000,591,138
"15704","51262","2015",19,19,0,126692.4,1313.737,98.89474
"15705","51263","2015",5,5,0,104350,1145.8,93.6
"15706","51264","2015",8,8,0,136882.5,1569.375,94.125
"15707","51266","2015",10,10,0,233895,2084.6,122.4
"15708","51267","2015",3,3,0,272800,2189.333,124
"15709","51272","2015",6,5,1,94616.67,1025,92.66667
"15710","51275","2015",1,1,0,130000,2407,54
"15711","51278","2015",1,1,0,198700,795,250
"15712","51281","2015",3,3,0,139666.7,1341,115.6667
"15713","51282","2015",21,20,1,283094.3,2193.81,133.1905
"15714","51286","2015",1,1,0,147000,817,180
"15715","51289","2015",2,2,0,106000,1017.5,104
"15716","51290","2015",1,1,0,65000,1413,46
"15717","51291","2015",9,9,0,226523.9,1924.667,119.6667
"15718","51292","2015",1,1,0,150000,1596,94
"15719","51293","2015",7,7,0,128557.1,1276.143,108.4286
"15720","51294","2015",1,1,0,189320,1352,140
"15721","51295","2015",2,2,0,115500,927.5,124
"15722","51299","2015",10,10,0,191940,1715.9,117
"15723","51302","2015",1,1,0,123000,2278,54
"15724","51303","2015",4,4,0,124975,1299.25,104
"15725","51304","2015",2,2,0,134560,954.5,142
"15726","51305","2015",2,2,0,327000,1856,196.5
"15727","51308","2015",29,27,2,222405.9,2012.586,119.7931
"15728","51309","2015",2,2,0,170000,1583,105
"15729","51310","2015",1,1,0,250000,1572,159
"15730","51311","2015",1,1,0,208500,1256,166
"15731","51312","2015",11,11,0,174518.2,1405,123.1818
"15732","51315","2015",1,1,0,55000,618,89
"15733","51317","2015",1,1,0,138500,1539,90
"15734","51318","2015",3,3,0,362166.7,2588.667,141
"15735","51325","2015",3,3,0,135550,1341.667,99.33333
"15736","51326","2015",14,14,0,187606.1,1628.714,123.3571
"15737","51327","2015",1,1,0,70000,1014,69
"15738","51328","2015",10,10,0,119799.6,1197,96.5
"15739","51329","2015",12,12,0,218306.7,2402.25,96.58333
"15740","51333","2015",8,8,0,263437.5,1945.875,129.125
"15741","51334","2015",2,2,0,116750,1195,97.5
"15742","51336","2015",1,1,0,63500,552,115
"15743","51337","2015",2,2,0,159550,1293,129
"15744","51338","2015",7,7,0,176500,1667.143,105.5714
"15745","51340","2015",4,4,0,139750,1247,117
"15746","51342","2015",2,2,0,172500,1442,119.5
"15747","51344","2015",16,16,0,232912.5,2121.375,97.6875
"15748","51348","2015",1,1,0,205800,1400,147
"15749","51352","2015",6,6,0,73916.67,724,101.3333
"15750","51354","2015",2,2,0,196925,1486.5,131.5
"15751","51355","2015",1,1,0,46000,730,63
"15752","51357","2015",6,6,0,156641.7,1595.833,103
"15753","51362","2015",6,6,0,310885,2168.167,139.8333
"15754","51363","2015",5,5,0,122000,1253,99.8
"15755","51364","2015",1,1,0,94100,1325,71
"15756","51365","2015",7,7,0,286000,2055.286,135.1429
"15757","51367","2015",12,12,0,138458.3,1505,93
"15758","51370","2015",1,1,0,21000,382,55
"15759","51372","2015",5,5,0,214160,1540.8,152.6
"15760","51378","2015",2,2,0,221500,1890.5,116.5
"15761","51379","2015",5,5,0,170000,1497.8,117
"15762","51380","2015",27,26,1,95705.56,1054.741,91.62963
"15763","51382","2015",1,1,0,75000,833,90
"15764","51384","2015",6,4,2,149960,1537.833,102.6667
"15765","51387","2015",1,1,0,192000,2000,96
"15766","51388","2015",33,31,2,160572.3,1399.667,119.0303
"15767","51389","2015",6,6,0,157500,1480.333,111.6667
"15768","51390","2015",9,9,0,206555.6,1611.333,129.6667
"15769","51391","2015",12,12,0,216800,2265.167,102.1667
"15770","51393","2015",2,2,0,264000,1875.5,137.5
"15771","51397","2015",1,1,0,95000,1011,94
"15772","51398","2015",1,1,0,130000,2000,65
"15773","51399","2015",5,5,0,68000,615.8,128.8
"15774","51403","2015",5,5,0,208740,1726,120.2
"15775","51413","2015",2,2,0,191000,1497.5,129.5
"15776","51418","2015",3,3,0,300483.3,2232,135
"15777","51422","2015",1,1,0,308750,2782,111
"15778","51425","2015",2,2,0,199750,2266,92
"15779","51428","2015",4,4,0,160069.5,1523,104
"15780","51429","2015",1,1,0,260000,1469,177
"15781","51430","2015",1,1,0,190000,1462,130
"15782","51431","2015",17,17,0,146541.2,1765.941,82.94118
"15783","51433","2015",3,3,0,106133.3,909.6667,113.3333
"15784","51434","2015",5,5,0,174113,1470.4,124.4
"15785","51439","2015",6,5,1,171615,1844.333,94
"15786","51440","2015",27,26,1,155957,1531.037,106.5926
"15787","51442","2015",1,1,0,124000,827,150
"15788","51444","2015",6,6,0,182283.3,1729.833,107
"15789","51445","2015",4,4,0,279905.2,1813,160.25
"15790","51446","2015",6,6,0,105308.3,1134.167,93.33333
"15791","51447","2015",2,2,0,206215,1358.5,152
"15792","51448","2015",6,6,0,81466.67,1329.833,51.16667
"15793","51449","2015",6,6,0,155533.3,1956.833,84.33333
"15794","51450","2015",6,6,0,218559.2,1912.833,117.6667
"15795","51453","2015",5,5,0,228933.6,1676.2,139.8
"15796","51454","2015",1900,524,1376,153007.6,2116.344,72.63737
"15797","51455","2015",2,2,0,107000,1026.5,105
"15798","51460","2015",1,1,0,170000,708,240
"15799","51461","2015",6,6,0,326037.5,2926.333,130.1667
"15800","51463","2015",1,1,0,80000,833,96
"15801","51464","2015",6,6,0,185946.7,1706,111.3333
"15802","51466","2015",1,1,0,125000,625,200
"15803","51468","2015",3,3,0,304166.7,1851,166.6667
"15804","51469","2015",2,2,0,141400,1310,100
"15805","51471","2015",2,2,0,117500,1019,110.5
"15806","51472","2015",14,13,1,127593.6,1272,103.2143
"15807","51474","2015",25,20,5,190550.2,1960.36,96.6
"15808","51476","2015",7,7,0,175157.1,1714.714,105.1429
"15809","51477","2015",1,1,0,181050,1847,98
"15810","51479","2015",2,2,0,222750,1976,114.5
"15811","51483","2015",5,5,0,184860,1199.2,159.6
"15812","51484","2015",1,1,0,114600,1451,79
"15813","51486","2015",2,2,0,200200,1402,147.5
"15814","51487","2015",3,3,0,146666.7,1215.333,127.6667
"15815","51489","2015",1,1,0,95000,1056,90
"15816","51490","2015",1,1,0,187300,2497,75
"15817","51491","2015",3,3,0,75701.33,874.6667,97.66667
"15818","51493","2015",2,2,0,211225,1606,95
"15819","51496","2015",3,3,0,137666.7,844.6667,170.3333
"15820","51499","2015",2,2,0,91000,945,100
"15821","51501","2015",2,2,0,110250,871.5,125
"15822","51503","2015",2,2,0,203950,1561.5,129.5
"15823","51504","2015",8,8,0,303947.5,2893.625,98.75
"15824","51505","2015",4,4,0,214700,1919.75,117.25
"15825","51506","2015",36,22,14,117220.9,1335.056,84.27778
"15826","51507","2015",26,23,3,89276.19,1056.462,81.73077
"15827","51515","2015",1,1,0,217700,1893,115
"15828","51518","2015",7,7,0,306142.9,1744.571,183.1429
"15829","51521","2015",2,2,0,109250,1255,86.5
"15830","51523","2015",2,2,0,105950,1562,66
"15831","51525","2015",20,19,1,177166.5,1676.5,107.95
"15832","51526","2015",6,6,0,154023.3,1541.833,104.1667
"15833","51527","2015",4,3,1,162375,1686.5,109.75
"15834","51529","2015",6,6,0,187700,1680,114
"15835","51530","2015",6,6,0,154706.7,1430.167,101.5
"15836","51532","2015",5,5,0,220330,2434.8,100.8
"15837","51534","2015",1,0,1,45000,750,60
"15838","51536","2015",15,14,1,195155.3,2019.8,98.73333
"15839","51542","2015",1,1,0,20000,400,50
"15840","51544","2015",4,4,0,96250,1058.5,93.5
"15841","51545","2015",4,4,0,122975.2,1197,107.75
"15842","51546","2015",5,5,0,161074,1561.2,103.6
"15843","51547","2015",2,2,0,113500,812,142.5
"15844","51548","2015",4,4,0,155575,1495.25,104.75
"15845","51552","2015",4,4,0,97500,1517.5,69.75
"15846","51553","2015",7,7,0,158971.4,1374.429,127.7143
"15847","51555","2015",1,1,0,99500,1228,81
"15848","51556","2015",3,3,0,204513.3,1631.667,128.3333
"15849","51557","2015",6,6,0,121450,1049.167,112.1667
"15850","51559","2015",20,20,0,124885,1321,99.05
"15851","51560","2015",1,1,0,65000,565,115
"15852","51562","2015",14,11,3,252928.6,2131.714,117.6429
"15853","51566","2015",1,1,0,92150,1138,81
"15854","51569","2015",3,3,0,304000,2208.333,140
"15855","51571","2015",9,9,0,154955.6,1585.222,92.88889
"15856","51573","2015",92,57,35,177197,2055.641,86.68478
"15857","51576","2015",16,16,0,171022.5,1726.562,97.3125
"15858","51577","2015",3,3,0,176666.7,2428.667,76.33333
"15859","51579","2015",2,2,0,192500,1127,186.5
"15860","51580","2015",3,3,0,108666.7,1371.333,82.66667
"15861","51581","2015",3,3,0,112000,1373,81.66667
"15862","51582","2015",7,7,0,197671.4,1534.429,141.4286
"15863","51583","2015",4,4,0,102250,883.5,118.25
"15864","51584","2015",2,2,0,345500,2781,126.5
"15865","51586","2015",5,5,0,171120,1724,102
"15866","51587","2015",1,1,0,231000,1167,198
"15867","51590","2015",2,2,0,113100,824.5,131.5
"15868","51591","2015",6,6,0,269133.3,2111.833,122
"15869","51592","2015",2,2,0,101940,1472,70
"15870","51596","2015",6,6,0,85833.33,1234.5,66.33333
"15871","51598","2015",4,4,0,122250,1264.25,95
"15872","51600","2015",1,1,0,73000,936,78
"15873","51601","2015",2,2,0,1e+05,1023.5,95.5
"15874","51603","2015",1,1,0,78000,821,95
"15875","51604","2015",2,2,0,163700,1012.5,195.5
"15876","51610","2015",1,1,0,97000,836,116
"15877","51611","2015",4,4,0,115000,1168.5,93.5
"15878","51612","2015",25,25,0,150217.2,1488.4,105.56
"15879","51613","2015",10,10,0,137505,1807.1,76.3
"15880","51614","2015",8,8,0,173337.5,1515.875,119.875
"15881","51617","2015",2,2,0,132500,1440.5,95
"15882","51619","2015",1,1,0,157590,1970,80
"15883","51622","2015",1,1,0,242800,1974,123
"15884","51623","2015",4,4,0,239755,2266,104.75
"15885","51624","2015",6,6,0,144666.7,1489.333,96.83333
"15886","51626","2015",1,1,0,117000,900,130
"15887","51627","2015",2,2,0,104350,1513.5,73.5
"15888","51629","2015",16,12,4,208006.9,2642.312,93.75
"15889","51630","2015",2,2,0,130000,1497,85.5
"15890","51631","2015",1,1,0,195000,1773,110
"15891","51633","2015",3,3,0,280333.3,2053.667,135
"15892","51634","2015",3,3,0,185900,1546.667,118
"15893","51636","2015",2,2,0,172000,2240,77.5
"15894","51638","2015",3,3,0,155466.7,1229.333,132.6667
"15895","51640","2015",2,2,0,72750,966,81
"15896","51643","2015",5,3,2,87300,1194.6,64.6
"15897","51646","2015",1,1,0,50000,610,82
"15898","51647","2015",9,9,0,107712.8,1240.222,96.77778
"15899","51649","2015",94,73,21,92465.38,1149.457,86.61702
"15900","51654","2015",2,2,0,123550,1686.5,72.5
"15901","51655","2015",1,1,0,155000,2095,74
"15902","51656","2015",5,5,0,213010.8,1402.6,167.4
"15903","51657","2015",3,3,0,289595,1733.667,167.3333
"15904","51659","2015",1,1,0,120000,800,150
"15905","51660","2015",26,26,0,175404,1726.769,103.3077
"15906","51662","2015",39,32,7,219351.4,2014.231,108.5641
"15907","51663","2015",13,11,2,133338.5,2061.923,73.76923
"15908","52006","2015",1,1,0,117500,1224,96
"15909","52021","2015",3,3,0,97033.33,1017.667,98.66667
"15910","52045","2015",17,17,0,120864.7,1296.294,98.11765
"15911","52060","2015",9,9,0,82888.89,722.5556,118.7778
"15912","52061","2015",3,3,0,60189,640.6667,88.66667
"15913","52072","2015",3,3,0,101666.7,1186,88.33333
"15914","52079","2015",1,1,0,95500,565,169
"15915","52088","2015",3,3,0,138333.3,1287,108.3333
"15916","52093","2015",17,14,3,73882.35,762.9412,96.47059
"15917","52104","2015",9,9,0,165459.3,1656.556,101
"15918","52114","2015",9,9,0,92589,683.3333,132.1111
"15919","52121","2015",209,136,73,111890.9,1276.569,87.8134
"15920","52125","2015",7,7,0,185032.9,1449.286,128.8571
"15921","52140","2015",3,3,0,152800,2183,70
"15922","52141","2015",3,3,0,129200,1338.333,95
"15923","52151","2015",1,1,0,140000,1239,113
"15924","52158","2015",3,3,0,47333.33,476.3333,97.33333
"15925","52169","2015",2,2,0,68600,735,94
"15926","52171","2015",3,3,0,62666.67,530.6667,107.6667
"15927","52175","2015",3,3,0,86666.67,983.6667,85.66667
"15928","52182","2015",21,20,1,123233.3,1213.238,103.1429
"15929","52193","2015",6,6,0,139500,1427.5,99
"15930","52206","2015",2,2,0,80975,935,75.5
"15931","52235","2015",2,2,0,126250,857.5,147.5
"15932","52244","2015",6,6,0,131125,1195,110.1667
"15933","52250","2015",27,25,2,83281.48,1009.259,94.44444
"15934","52251","2015",6,6,0,156666.7,1308.667,122.1667
"15935","52253","2015",1,1,0,124000,685,181
"15936","52267","2015",1,1,0,82000,854,96
"15937","52269","2015",53,39,14,113302.6,1202.283,105
"15938","52294","2015",5,5,0,94800,991.8,95.4
"15939","52327","2015",11,11,0,134182.9,1257.091,112.6364
"15940","52331","2015",14,14,0,123921.4,1195.286,104.2143
"15941","52341","2015",2,2,0,76602.5,794,114
"15942","52411","2015",7,7,0,80428.57,841,92.14286
"15943","52421","2015",3,3,0,103213.3,1135.333,88
"15944","52448","2015",179,135,44,88569.01,1088.849,82.56425
"15945","52469","2015",2,2,0,77500,871.5,90
"15946","52475","2015",1,1,0,40000,400,100
"15947","52479","2015",5,5,0,76400,768.4,97.8
"15948","52487","2015",1,1,0,134800,1037,130
"15949","52494","2015",4,4,0,169207.5,1594.25,105.75
"15950","52497","2015",2,2,0,130500,1226,105.5
"15951","52500","2015",11,11,0,124850,1338.818,96.09091
"15952","52510","2015",2,2,0,97500,1063.5,90
"15953","52520","2015",5,5,0,62313,791.6,78.8
"15954","52522","2015",2,2,0,131504.5,977.5,137
"15955","52528","2015",2,2,0,81500,843.5,105
"15956","52534","2015",14,14,0,110083.6,1218.429,91.71429
"15957","52535","2015",6,6,0,146833.3,1240.333,122.3333
"15958","52543","2015",2,2,0,130500,1112,125.5
"15959","52550","2015",9,9,0,81500,895.5556,90.44444
"15960","53001","2015",11,10,1,150909.1,1613.364,93.45455
"15961","53002","2015",8,8,0,105125,1115.5,101.75
"15962","53003","2015",40,40,0,91792.25,929.275,94.275
"15963","53005","2015",23,23,0,125069.6,1079.565,113.087
"15964","53007","2015",27,26,1,130791.4,1435.111,96.22222
"15965","53008","2015",19,19,0,119970.3,1249.895,95.42105
"15966","53009","2015",9,9,0,144722.2,1267,116.4444
"15967","53010","2015",1,1,0,105000,1544,68
"15968","53011","2015",5,5,0,87240,997.4,90
"15969","53012","2015",4,4,0,103000,1284.75,87.25
"15970","53013","2015",6,6,0,85250,914,88.5
"15971","53015","2015",18,18,0,119250,1159.056,104.6111
"15972","53016","2015",12,12,0,92875,1113.917,84.33333
"15973","53017","2015",11,11,0,91662.73,941.5455,98.63636
"15974","53018","2015",9,9,0,101222.2,1139.667,88.11111
"15975","53019","2015",1,1,0,105000,1105,95
"15976","53021","2015",8,8,0,148793.8,1407.25,105.375
"15977","53022","2015",3,3,0,130833.3,823.3333,160
"15978","53023","2015",2,2,0,189000,1769,149
"15979","53025","2015",11,11,0,103233.6,966.6364,106.0909
"15980","53026","2015",11,11,0,110027.3,1201.545,93
"15981","53029","2015",13,13,0,99638.46,970.7692,108.3846
"15982","53030","2015",2,2,0,168700,1111,154.5
"15983","53031","2015",6,6,0,112833.3,1155.833,94.16667
"15984","53034","2015",59,59,0,192730.5,1766.492,112.322
"15985","53035","2015",1,1,0,44000,830,53
"15986","53036","2015",10,10,0,141604.3,1286.3,100.9
"15987","53037","2015",6,6,0,105800,1114.333,101.5
"15988","53038","2015",1,1,0,50000,1316,38
"15989","53039","2015",20,19,1,103400,1105,95.65
"15990","53040","2015",7,7,0,114142.9,1709.857,76
"15991","53041","2015",3,3,0,135333.3,1011.667,135
"15992","53042","2015",11,11,0,102963.6,884.9091,129.9091
"15993","53043","2015",5,5,0,116099.2,882.6,155.6
"15994","53045","2015",4,4,0,164750,1517,108.25
"15995","53046","2015",4,4,0,123750,1280.5,100.75
"15996","53047","2015",4,4,0,75750,909.5,84.5
"15997","53048","2015",13,13,0,97900,945.1538,99.53846
"15998","53049","2015",5,5,0,145040,1260.2,110.4
"15999","53051","2015",8,8,0,84625,1034.5,82.25
"16000","53052","2015",3,3,0,73333.33,1259.667,60
"16001","53053","2015",9,9,0,75222.22,934.8889,82
"16002","53054","2015",48,46,2,172025,1866.021,92.9375
"16003","53055","2015",7,7,0,91714.29,738.4286,125.7143
"16004","53056","2015",11,11,0,134609.1,1306.364,103.8182
"16005","53057","2015",6,6,0,84831.67,1111,77.33333
"16006","53058","2015",2,2,0,91500,787,116.5
"16007","53059","2015",3,3,0,71166.67,892.6667,81.33333
"16008","53061","2015",6,6,0,99693.17,1034.667,92.83333
"16009","53062","2015",194,173,21,132474.2,1355.619,98.23711
"16010","53063","2015",3,3,0,158333.3,1594.333,100
"16011","53064","2015",14,14,0,75833.21,1247.714,87.78571
"16012","53066","2015",16,16,0,104446.6,1149.062,93.3125
"16013","53067","2015",1,1,0,119000,1035,115
"16014","53068","2015",2,2,0,99000,1089,90.5
"16015","53069","2015",4,4,0,62750,696.75,105.25
"16016","53071","2015",7,7,0,97857.14,901.7143,110.4286
"16017","53072","2015",11,11,0,120909.1,1072.909,111.9091
"16018","53073","2015",5,5,0,99620,1068.2,87.6
"16019","53074","2015",4,4,0,45250,803.25,63.25
"16020","53075","2015",4,4,0,126750,1152.5,134.25
"16021","53076","2015",2,2,0,97000,801,104
"16022","53077","2015",28,28,0,122062.1,1299.393,96.46429
"16023","53078","2015",5,5,0,88000,1024.6,86.6
"16024","53079","2015",3,3,0,101543.3,836,125.6667
"16025","53080","2015",4,4,0,97775,598,162
"16026","53082","2015",7,7,0,132168,1211.429,105.7143
"16027","53083","2015",13,13,0,67951.54,746,95.30769
"16028","53084","2015",50,50,0,103030.8,1098.44,91.46
"16029","53085","2015",1,1,0,169500,942,180
"16030","53086","2015",6,6,0,138240,1404.167,110.5
"16031","53088","2015",12,12,0,96729.17,1021.167,99.16667
"16032","53089","2015",6,6,0,110500,1053.167,103
"16033","53090","2015",4,4,0,180000,1310.5,128.75
"16034","53091","2015",6,6,0,69790.17,803.8333,88.5
"16035","53093","2015",5,5,0,85500,880,93
"16036","53094","2015",4,4,0,147125,1595.25,92
"16037","53096","2015",41,41,0,95141.93,989.5122,96.41463
"16038","53097","2015",64,57,7,101738.5,1250.516,87.39062
"16039","53098","2015",3,3,0,122000,1520,82.66667
"16040","53099","2015",9,9,0,149000,1622.889,98.88889
"16041","53100","2015",13,13,0,121448,1232.462,87.92308
"16042","53101","2015",3,3,0,111300,1128.667,97.33333
"16043","53102","2015",3,3,0,90000,1132.333,77.33333
"16044","53103","2015",12,12,0,120467.2,1372.833,98.66667
"16045","53104","2015",10,10,0,119000,1137.4,110.3
"16046","53105","2015",2,2,0,126750,1210.5,107
"16047","53106","2015",5,5,0,51400,890.4,59.8
"16048","53107","2015",27,27,0,93642.59,943.9259,104.2963
"16049","53108","2015",6,6,0,105883.3,1126.833,96.83333
"16050","53109","2015",7,7,0,93703.71,1377,73.85714
"16051","53110","2015",8,8,0,67250,797.875,86.25
"16052","53111","2015",1,1,0,68325,962,71
"16053","53112","2015",6,6,0,96621.67,916.3333,104.1667
"16054","53113","2015",7,7,0,113571.4,1263.714,92.28571
"16055","53114","2015",3,3,0,55666.67,699,80.33333
"16056","53115","2015",4,4,0,172500,1137.5,169.5
"16057","53116","2015",6,6,0,56841.67,752.6667,77.16667
"16058","53117","2015",5,5,0,143339.2,1041.8,130.4
"16059","53118","2015",2,2,0,117500,1362.5,86
"16060","53119","2015",47,46,1,179872.1,1728.319,105.5532
"16061","53120","2015",7,7,0,48285.71,636,76.85714
"16062","53121","2015",9,9,0,63500,840.3333,80.22222
"16063","53122","2015",9,9,0,89055.56,935.8889,95.77778
"16064","53123","2015",12,12,0,82750,891.1667,98.41667
"16065","53124","2015",9,9,0,118318.7,1138.333,102.6667
"16066","53125","2015",8,8,0,115062.5,1019.375,113.375
"16067","53126","2015",9,9,0,79455.56,1042.778,79
"16068","53127","2015",35,33,2,72499.69,890.2857,82.91429
"16069","53128","2015",10,10,0,95350,890.6,101.1
"16070","53129","2015",3,3,0,117333.3,1059.333,105.6667
"16071","53130","2015",727,359,368,117435.2,1484.711,77.04402
"16072","53131","2015",5,5,0,81440,795.6,101.4
"16073","53132","2015",3,3,0,44133.33,681.3333,67
"16074","53133","2015",7,7,0,73657.14,880.5714,83.42857
"16075","53134","2015",1,1,0,120000,1111,108
"16076","53135","2015",7,7,0,102305.1,935.1429,112.7143
"16077","53136","2015",4,4,0,102875,973.5,108
"16078","53137","2015",18,18,0,134293.9,1250.667,104.6111
"16079","53139","2015",2,2,0,71750,765.5,86.5
"16080","53140","2015",34,34,0,208686.7,2041.059,104.0882
"16081","53141","2015",13,13,0,128808.2,1456.308,92.23077
"16082","53142","2015",9,9,0,81555.56,945.2222,99.66667
"16083","53143","2015",8,8,0,140850,1222.875,121.625
"16084","53144","2015",3,3,0,92333.33,1036,96.66667
"16085","53145","2015",5,5,0,102280,1170.8,83
"16086","53146","2015",13,13,0,125361.5,1291.692,97.76923
"16087","53147","2015",113,88,25,119469.3,1288.761,93.09735
"16088","53148","2015",2,2,0,82390,792,140.5
"16089","53150","2015",12,12,0,164020.8,1436.667,116
"16090","53151","2015",11,11,0,120995.5,1051.455,113.8182
"16091","53152","2015",20,20,0,116050,1106.85,109.3
"16092","53153","2015",5,5,0,151982,1557,96.4
"16093","53154","2015",12,12,0,101209.2,915.3333,112.4167
"16094","53155","2015",13,13,0,121553.8,1192.846,95.76923
"16095","53156","2015",4,4,0,162500,1311.75,147
"16096","53157","2015",8,8,0,159875,1305.5,121.125
"16097","53158","2015",11,11,0,113000,1159.364,99.18182
"16098","53160","2015",3,3,0,83333.33,987.6667,78.66667
"16099","53161","2015",45,45,0,82386.27,967.6222,88.57778
"16100","53162","2015",7,7,0,102571.4,1199.714,83.28571
"16101","53163","2015",6,6,0,83833.33,852.8333,93.16667
"16102","53164","2015",7,7,0,69105.71,937,73.85714
"16103","53165","2015",2,2,0,155000,1501,103.5
"16104","53168","2015",10,9,1,119700,1075.8,105.4
"16105","53169","2015",9,9,0,120877.8,1170.556,103.1111
"16106","53170","2015",17,17,0,117024.5,1305.235,94
"16107","53172","2015",4,4,0,93575,869.25,105.75
"16108","53173","2015",6,6,0,56133.33,705.5,72
"16109","53174","2015",10,10,0,150400,1373.2,120.1
"16110","53175","2015",23,23,0,127024.8,1231.957,104.6087
"16111","53176","2015",9,9,0,83268.89,1129.556,85.33333
"16112","53177","2015",2,2,0,81660,925.5,96
"16113","53178","2015",1,1,0,80000,1143,70
"16114","53179","2015",5,5,0,108500,634.6,145.2
"16115","53180","2015",4,4,0,86000,917.25,92
"16116","53181","2015",7,7,0,98104.29,1021.143,96
"16117","53182","2015",26,25,1,99630.77,1128.769,83.38462
"16118","53185","2015",21,21,0,95602.38,1019.81,89
"16119","53186","2015",19,19,0,113526.3,1100.842,103.8421
"16120","53187","2015",1,1,0,155000,912,170
"16121","53188","2015",34,34,0,84893.53,969.7941,88.26471
"16122","53189","2015",4,4,0,70237.5,777.5,81.25
"16123","53190","2015",8,8,0,67869.25,951.125,84.625
"16124","53191","2015",5,5,0,74200,552.6,123.2
"16125","53192","2015",4,4,0,121750,1457.5,95.5
"16126","53193","2015",4,4,0,149425,1302.75,117.25
"16127","53195","2015",5,4,1,157200,1373.2,113.6
"16128","53196","2015",8,8,0,73937.5,878.75,86.625
"16129","53197","2015",10,10,0,84050,918.7,90.4
"16130","53198","2015",2,2,0,56000,510.5,108.5
"16131","53199","2015",8,8,0,60115.62,737.5,94
"16132","53200","2015",6,6,0,143863.3,1282.667,115.5
"16133","53201","2015",69,58,11,142437.6,1606.493,89.11594
"16134","53202","2015",3,3,0,120419.7,988.3333,126
"16135","53203","2015",8,8,0,92087.5,890.375,100
"16136","53204","2015",5,5,0,93750,950.6,99.6
"16137","53206","2015",1,1,0,1e+05,1205,83
"16138","53208","2015",6,6,0,70986.67,871.6667,78.16667
"16139","53209","2015",2,2,0,145000,1523.5,95.5
"16140","53210","2015",21,21,0,109547.6,1070.857,102.619
"16141","53211","2015",15,15,0,62575.27,783.0667,79.06667
"16142","53212","2015",2,2,0,76000,817,94.5
"16143","53213","2015",4,3,1,61183.75,971.5,70.5
"16144","53214","2015",1,1,0,69000,841,82
"16145","53216","2015",8,8,0,72125,1088.625,64.75
"16146","53218","2015",13,13,0,142868.5,1204.231,113.5385
"16147","53219","2015",17,14,3,107253.4,1136.059,98.94118
"16148","53220","2015",7,7,0,161000,1249.857,134.4286
"16149","53221","2015",5,5,0,105800,1075.6,95.4
"16150","53222","2015",5,5,0,142539.4,1242.8,109.6
"16151","53223","2015",5,5,0,90800,1046.4,83.2
"16152","53224","2015",13,12,1,146984.6,1422.462,100.2308
"16153","53225","2015",4,4,0,113000,1207.75,94.5
"16154","53226","2015",10,10,0,109541.5,1194.7,91.1
"16155","53228","2015",7,7,0,95714.29,1341.286,75.42857
"16156","53229","2015",11,11,0,106000,1229.091,85.27273
"16157","53230","2015",6,6,0,82000,999.6667,80.16667
"16158","53232","2015",3,3,0,117356.7,1017,109
"16159","53233","2015",3,3,0,126333.3,1235.333,106.6667
"16160","53234","2015",3,3,0,131000,1166,112.3333
"16161","53235","2015",4,4,0,58212.5,586.25,97.25
"16162","53236","2015",2,2,0,50000,1085,50
"16163","53237","2015",2,2,0,33000,559.5,63.5
"16164","53238","2015",4,4,0,65150.5,740.75,105.75
"16165","53240","2015",7,7,0,110696.3,1194,96
"16166","53242","2015",1,1,0,49000,710,69
"16167","53243","2015",26,25,1,118850,1389.231,98.80769
"16168","53245","2015",15,15,0,97782.07,1481.2,74.6
"16169","53246","2015",12,12,0,100266.7,1060.083,90.58333
"16170","53247","2015",23,23,0,107011.9,1218.87,90.26087
"16171","53248","2015",4,4,0,59125,853.25,71.75
"16172","53249","2015",14,14,0,72785.71,743.9286,101.3571
"16173","53250","2015",6,6,0,117433.3,1249.167,107.1667
"16174","53251","2015",6,6,0,94583.33,855.1667,112.5
"16175","53253","2015",3,3,0,97533.33,954.6667,110.6667
"16176","53255","2015",14,14,0,106646.4,1129.929,95.64286
"16177","53256","2015",3,3,0,23500,388.6667,59.66667
"16178","53257","2015",1,1,0,150000,1163,129
"16179","53258","2015",1,1,0,132500,1035,128
"16180","53259","2015",2,2,0,89000,798,101.5
"16181","53260","2015",5,5,0,144200,1534.4,102.2
"16182","53261","2015",4,4,0,76050,697.5,109.5
"16183","53262","2015",9,8,1,135888.9,1232.889,114.6667
"16184","53263","2015",5,5,0,73260,870.2,86.2
"16185","53264","2015",3,3,0,103000,1052.667,103
"16186","53265","2015",10,10,0,90750,1115.4,82.6
"16187","53266","2015",2,2,0,128750,2350.5,66
"16188","53267","2015",7,7,0,121285.7,1065.286,112.7143
"16189","53269","2015",5,5,0,113400,1143.6,101.4
"16190","53270","2015",2,2,0,72000,1000,80
"16191","53271","2015",35,32,3,86462.86,953.8,90.17143
"16192","53272","2015",3,3,0,115666.7,1849.333,61.66667
"16193","53273","2015",11,11,0,138090.9,1251.455,113.7273
"16194","53276","2015",14,14,0,80178.57,928.8571,86.78571
"16195","54001","2015",4,4,0,141610.8,1433.5,108.75
"16196","54003","2015",1,1,0,93000,930,100
"16197","54004","2015",1,1,0,56000,509,110
"16198","54005","2015",1,1,0,156000,1458,107
"16199","54006","2015",5,5,0,242964.4,1650.2,142
"16200","54007","2015",3,3,0,83200,1096.667,69.66667
"16201","54008","2015",8,8,0,129529.2,1240,104.375
"16202","54010","2015",1,1,0,116100,1262,92
"16203","54011","2015",2,2,0,110500,764,134
"16204","54012","2015",2,2,0,255750,2098,138.5
"16205","54013","2015",1,1,0,1e+05,870,115
"16206","54014","2015",2,2,0,139750,1889,75.5
"16207","54015","2015",4,4,0,166625,1255.75,140.25
"16208","54016","2015",1,1,0,115000,1211,95
"16209","54018","2015",1,1,0,30000,333,90
"16210","54019","2015",1,1,0,107000,1507,71
"16211","54020","2015",1,1,0,248000,1503,165
"16212","54021","2015",2,2,0,150850,1588,97
"16213","54022","2015",3,3,0,127600,852,153.6667
"16214","54023","2015",2,2,0,84000,693.5,121.5
"16215","54024","2015",1,1,0,143900,1635,88
"16216","54025","2015",20,14,6,181129.8,2044.85,92.35
"16217","54026","2015",3,3,0,104400,639.6667,145.3333
"16218","54027","2015",5,5,0,167000,1779.6,93.2
"16219","54028","2015",33,23,10,97513.03,1293.242,80.57576
"16220","54029","2015",20,18,2,153630.2,1594.85,98
"16221","54030","2015",2,2,0,80250,605.5,133
"16222","54031","2015",3,3,0,138333.3,1216.667,127.6667
"16223","54034","2015",1,1,0,85000,1024,83
"16224","54035","2015",4,4,0,97000,1058,89
"16225","54036","2015",4,4,0,199180,1439.5,139.25
"16226","54037","2015",3,3,0,233389.7,1938.667,126.6667
"16227","54038","2015",7,6,1,130428.6,1022.571,129.1429
"16228","54039","2015",40,32,8,89970.62,971.475,94.45
"16229","54040","2015",13,13,0,68219.62,887.3846,86.76923
"16230","54042","2015",3,3,0,126816.7,1096,120
"16231","54043","2015",13,8,5,153311.9,1509.846,107.4615
"16232","54045","2015",6,6,0,150833.3,1479,106.8333
"16233","54046","2015",6,5,1,138583.3,1158.333,125.6667
"16234","54047","2015",2,2,0,157900,1304.5,130.5
"16235","54048","2015",2,2,0,90000,961,92.5
"16236","54049","2015",2,2,0,134300,1938.5,69
"16237","54051","2015",13,13,0,165334.6,1512.692,113.2308
"16238","54052","2015",1,1,0,148240,723,205
"16239","54053","2015",1,1,0,144520,892,162
"16240","54054","2015",14,12,2,156197.4,1355.857,118.8571
"16241","54055","2015",2,2,0,182125,1703,131
"16242","54056","2015",2,2,0,158250,1732,92
"16243","54057","2015",2,2,0,91660,790.5,151
"16244","54059","2015",7,7,0,132550.7,1401.143,102.5714
"16245","54060","2015",13,13,0,139015.4,1664.923,85
"16246","54062","2015",3,3,0,178000,1213,171
"16247","54063","2015",1,1,0,147000,948,155
"16248","54064","2015",4,4,0,80750,911.75,88.25
"16249","54065","2015",11,11,0,82250.27,988.4545,83.45455
"16250","54066","2015",2,2,0,162000,1508.5,106
"16251","54067","2015",11,11,0,149918.2,1283.636,115.6364
"16252","54068","2015",2,2,0,69000,1034,66.5
"16253","54070","2015",1,1,0,161500,1970,82
"16254","54072","2015",2,2,0,113000,1579.5,72
"16255","54073","2015",6,6,0,116658.3,966.1667,126.1667
"16256","54074","2015",1,1,0,225000,1619,139
"16257","54075","2015",3,3,0,165333.3,1732.667,96
"16258","54076","2015",30,26,4,116391.7,1343.633,88.86667
"16259","54077","2015",6,6,0,69166.67,672.8333,108.5
"16260","54079","2015",40,34,6,119272.5,1317.9,94.625
"16261","54080","2015",14,13,1,109228.6,1068.5,106.2857
"16262","54081","2015",5,5,0,139282,1345.8,102.2
"16263","54082","2015",3,3,0,140000,1044.333,128.6667
"16264","54083","2015",1,1,0,102000,1020,100
"16265","54084","2015",8,8,0,74750,1000,78.25
"16266","54086","2015",5,5,0,103100,997,102
"16267","54089","2015",10,10,0,199215,1880.4,107.6
"16268","54090","2015",45,37,8,165593.7,1699.067,100.6889
"16269","54091","2015",3,3,0,137616.7,1307.667,106.3333
"16270","54093","2015",1,1,0,274500,1484,185
"16271","54096","2015",2,2,0,300060,1532,183.5
"16272","54097","2015",3,3,0,48926.67,489,100.6667
"16273","54098","2015",1,1,0,80000,816,98
"16274","54099","2015",87,46,41,107382.9,1276.046,83.03448
"16275","54100","2015",6,6,0,145949.2,1345.333,110
"16276","54102","2015",6,5,1,162250,1101.667,144.8333
"16277","54103","2015",1,1,0,49500,521,95
"16278","54105","2015",7,7,0,294350,1886.857,117.2857
"16279","54108","2015",1,1,0,145000,1629,89
"16280","54109","2015",9,8,1,169841.1,1545.889,110.8889
"16281","54110","2015",6,6,0,175283.3,1965.167,90
"16282","54111","2015",35,32,3,135703.7,1704.686,89.74286
"16283","54112","2015",13,13,0,126642.9,1104.615,116.2308
"16284","54113","2015",13,13,0,166707.7,1612.846,105.9231
"16285","54114","2015",3,3,0,160781.7,1448,121.6667
"16286","54115","2015",64,32,32,132620.2,1621.891,85.64062
"16287","54116","2015",23,22,1,154926.1,1558.261,102.4783
"16288","54117","2015",2,2,0,107000,677,157.5
"16289","54118","2015",6,6,0,116966.7,989.8333,124.6667
"16290","54119","2015",1,1,0,239250,1650,145
"16291","54120","2015",6,6,0,136704.2,1065.667,125
"16292","54121","2015",3,3,0,114000,979.6667,120.6667
"16293","54122","2015",8,7,1,167975,1278.875,139
"16294","54123","2015",22,21,1,142052,1410.864,103.2727
"16295","54125","2015",5,5,0,149900,1320.6,119.8
"16296","54126","2015",1,1,0,191846,799,240
"16297","54127","2015",6,6,0,136433.3,1438.5,98.66667
"16298","54128","2015",8,8,0,103350,1022.5,96.25
"16299","54129","2015",8,8,0,96862.5,1022.25,101.625
"16300","54131","2015",3,3,0,125000,1059,121.6667
"16301","54133","2015",4,4,0,82750,939.5,85
"16302","54134","2015",1,1,0,62000,390,159
"16303","54135","2015",8,7,1,101162.5,909.5,111.625
"16304","54136","2015",27,26,1,115420.4,1197.63,97.92593
"16305","54137","2015",5,4,1,104500,1245.6,92
"16306","54138","2015",22,17,5,161461.1,1774.182,89.72727
"16307","54139","2015",1,1,0,235500,1670,141
"16308","54140","2015",2,2,0,90000,980.5,91.5
"16309","54141","2015",2,2,0,212800,1199,177
"16310","54143","2015",4,4,0,107237.5,834.5,130.5
"16311","54144","2015",6,6,0,196601.7,1539.5,134
"16312","54145","2015",16,14,2,127678.1,1230.188,103.75
"16313","54146","2015",2,2,0,111500,859.5,128.5
"16314","54147","2015",1,1,0,188000,1649,114
"16315","54148","2015",10,10,0,118180,963.1,126.1
"16316","54149","2015",22,22,0,129119.3,1458.409,86.81818
"16317","54150","2015",35,31,4,141899.2,1572.6,93.65714
"16318","54151","2015",13,11,2,126761.5,1437.462,86.30769
"16319","54152","2015",32,27,5,132785.9,1334.094,99.21875
"16320","54153","2015",2,2,0,113750,1143,116
"16321","54154","2015",4,4,0,88782.5,778,113.75
"16322","54155","2015",4,4,0,133000,1082.5,128.5
"16323","54156","2015",4,4,0,52700,513.75,101
"16324","54157","2015",34,31,3,130919.8,1342.706,100.6176
"16325","54158","2015",1,1,0,1e+05,826,121
"16326","54159","2015",118,109,9,136042.3,1491.042,96.66949
"16327","54160","2015",8,8,0,145383.6,1309.5,115.25
"16328","54161","2015",3,3,0,92333.33,823.3333,116.6667
"16329","54162","2015",14,12,2,115448.2,1329.857,90.64286
"16330","54163","2015",7,7,0,106142.9,721.7143,149.5714
"16331","54165","2015",4,4,0,473050,2618,191.25
"16332","54167","2015",20,19,1,152725,1503.5,101.65
"16333","54169","2015",1,1,0,1143600,14295,80
"16334","54171","2015",11,11,0,160032.7,1559.182,102.1818
"16335","54172","2015",3,3,0,48889,551,87.66667
"16336","54173","2015",3,3,0,94333.33,735.3333,125.3333
"16337","54174","2015",32,28,4,143936.5,1503.312,97.40625
"16338","54175","2015",2,2,0,69375,775,85
"16339","54176","2015",11,9,2,100400,972.7273,105.1818
"16340","54177","2015",6,6,0,120445.8,1177.667,105.6667
"16341","54178","2015",2,2,0,231400,1184,224
"16342","54179","2015",5,5,0,167178,1201.2,143.8
"16343","54181","2015",6,6,0,166936.7,1743.167,94.5
"16344","54182","2015",4,3,1,119875,870.75,130
"16345","54184","2015",82,28,54,146858.1,1914.427,78.23171
"16346","54186","2015",11,10,1,170360.9,1454.273,105.3636
"16347","54187","2015",4,4,0,84775,679.5,130
"16348","54188","2015",9,8,1,170322.2,1696,100.7778
"16349","54189","2015",5,5,0,121120,1265,96.6
"16350","54191","2015",3,3,0,78531.67,581.6667,131
"16351","54192","2015",3,3,0,168666.7,1656,101.6667
"16352","54194","2015",3,3,0,210666.7,1485.333,144.3333
"16353","54195","2015",1,1,0,169000,1837,92
"16354","54196","2015",14,12,2,144857.1,1356.571,107.4286
"16355","54197","2015",17,17,0,193046.5,1898,106.8235
"16356","54198","2015",1,1,0,50000,352,142
"16357","54199","2015",3,3,0,78333.33,691.6667,134
"16358","54201","2015",3,3,0,107333.3,998,110.6667
"16359","54202","2015",10,10,0,139093,1393.2,96
"16360","54203","2015",2,2,0,195000,1323.5,146.5
"16361","54205","2015",16,15,1,133573.8,1093.125,127.625
"16362","54206","2015",2,2,0,61250,761.5,106.5
"16363","54207","2015",1,1,0,66000,347,190
"16364","54208","2015",3,3,0,115833.3,2031,77.33333
"16365","54210","2015",1,1,0,158000,988,160
"16366","54212","2015",9,9,0,193088.9,1295.889,151.1111
"16367","54213","2015",5,5,0,153772,1327.8,114.6
"16368","54214","2015",7,7,0,147168.6,1228.429,133
"16369","54215","2015",72,52,20,132238.9,1536.903,86.90278
"16370","54216","2015",3,3,0,105333.3,912,115.3333
"16371","54217","2015",3,3,0,172466.7,1112.667,151
"16372","54218","2015",1,1,0,73200,938,78
"16373","54221","2015",3,3,0,196000,1362.667,178
"16374","54222","2015",13,13,0,120115.4,1288.154,95.84615
"16375","54223","2015",4,4,0,98425,1035.5,85.75
"16376","54226","2015",1,1,0,40000,476,84
"16377","54227","2015",8,8,0,89013.75,1099.5,85.125
"16378","54229","2015",6,6,0,88033.33,761.5,111.8333
"16379","54231","2015",2,2,0,117908,745,160.5
"16380","54232","2015",24,19,5,160617.3,1521.792,107.2083
"16381","54234","2015",28,22,6,135771.4,1478.607,94.32143
"16382","54235","2015",4,4,0,121650,1006.5,125.75
"16383","54236","2015",2,2,0,95500,1658.5,77.5
"16384","54238","2015",1,1,0,110600,1843,60
"16385","54239","2015",1,1,0,190000,1520,125
"16386","54243","2015",2,2,0,126252,701.5,180
"16387","54246","2015",1,1,0,50000,365,137
"16388","54247","2015",2,2,0,135000,1011,123
"16389","54249","2015",2,2,0,83000,969,82.5
"16390","54250","2015",8,8,0,173762.5,1445.75,124
"16391","54252","2015",7,7,0,137857.1,882.4286,172.5714
"16392","54253","2015",6,6,0,124833.3,1356.167,89.66667
"16393","54254","2015",21,20,1,137835.7,1532.19,89.33333
"16394","54255","2015",1,1,0,90000,947,95
"16395","54256","2015",2,2,0,167750,1590,107.5
"16396","54257","2015",61,44,17,202757.3,2326.213,93.7541
"16397","54258","2015",2,2,0,119200,710,166.5
"16398","54259","2015",1,1,0,166450,1849,90
"16399","54260","2015",6,5,1,121333.3,1162.333,118.1667
"16400","54261","2015",30,23,7,94463.33,1224.433,78.6
"16401","54262","2015",1,1,0,88000,1143,77
"16402","54263","2015",82,60,22,80767.01,989.9024,83.19512
"16403","54265","2015",18,16,2,168630,1763.222,94.27778
"16404","54266","2015",5,5,0,109800,932.8,124.8
"16405","54269","2015",2,2,0,105500,1015.5,96.5
"16406","54270","2015",35,29,6,142068.6,1462.457,100.6571
"16407","54271","2015",4,4,0,137500,789.25,175.5
"16408","54272","2015",5,5,0,180550,1531.2,122
"16409","54273","2015",58,44,14,107728.5,1269.414,86.55172
"16410","54274","2015",74,27,47,122608.7,1573.014,76.68919
"16411","54275","2015",3,3,0,169316.7,1355,122.6667
"16412","54276","2015",4,4,0,112275,1482.25,84.5
"16413","54277","2015",4,4,0,121750,1426.25,85.5
"16414","54278","2015",1,1,0,77000,700,110
"16415","54279","2015",4,4,0,178500,1792.25,100.5
"16416","54280","2015",84,61,23,72770.06,874.0833,82.89286
"16417","54281","2015",4,4,0,143625,1287,103.75
"16418","54282","2015",1,1,0,60000,769,78
"16419","54283","2015",1,1,0,228271,1631,140
"16420","54284","2015",15,15,0,65566.67,911.6,72
"16421","54286","2015",13,13,0,113423.1,1224.385,93.30769
"16422","54287","2015",1,1,0,65500,862,76
"16423","54288","2015",7,7,0,135628.6,1227.286,112.4286
"16424","54289","2015",6,5,1,189550,1617.667,129.5
"16425","54290","2015",4,4,0,163475,1529.5,106.5
"16426","54291","2015",1,1,0,145530,1427,102
"16427","54292","2015",1,1,0,63250,536,118
"16428","54295","2015",13,10,3,84702.85,843.6923,98.61538
"16429","54296","2015",2,2,0,157500,2026.5,87.5
"16430","54297","2015",7,7,0,110928.6,970.7143,117.4286
"16431","54300","2015",68,51,17,184184.1,1723.941,107.2206
"16432","54302","2015",7,7,0,162914.3,1573.143,100.1429
"16433","54303","2015",2,2,0,126000,824,150.5
"16434","54304","2015",184,55,129,140440.3,1739.049,80.52174
"16435","54305","2015",21,19,2,251907.8,2083.095,116.7619
"16436","54306","2015",2,2,0,71000,835.5,86
"16437","54308","2015",3,3,0,140333.3,1022,138.6667
"16438","54309","2015",2,2,0,160000,1812,101.5
"16439","54311","2015",5,5,0,153900,1402.8,111.2
"16440","54312","2015",3,3,0,189610,1164.667,162.3333
"16441","54313","2015",1,1,0,175000,1250,140
"16442","54314","2015",37,33,4,174413.2,1812.811,99.51351
"16443","54315","2015",7,6,1,146385.7,1116,129.5714
"16444","54317","2015",2,2,0,95000,907,105
"16445","54318","2015",52,49,3,145987.5,1464.385,101.3462
"16446","54320","2015",2,2,0,202500,1526,132
"16447","54321","2015",14,9,5,144696.4,1798.714,80
"16448","54322","2015",47,34,13,92401.06,1050.851,88.53191
"16449","54323","2015",104,58,46,117844.7,1296.173,91.79808
"16450","54326","2015",3,3,0,169324,1328.667,127
"16451","54327","2015",9,9,0,175476.7,1282.222,145
"16452","54328","2015",58,48,10,201647,2014.31,101.3103
"16453","54329","2015",165,95,70,106233.7,1127.842,94.50909
"16454","54330","2015",3,3,0,206442.3,1652.667,120.3333
"16455","54331","2015",2,2,0,58450,649.5,90
"16456","54332","2015",21,14,7,151456.8,1549.333,98.7619
"16457","54333","2015",1,1,0,109600,2740,40
"16458","54334","2015",7,7,0,116697.6,1013.857,113.8571
"16459","54335","2015",2,2,0,75250,1163.5,73.5
"16460","54336","2015",4,4,0,104750,1099.75,92.5
"16461","54338","2015",7,7,0,172314.3,1517.857,104.5714
"16462","54339","2015",95,54,41,152320.5,1723.084,87.21053
"16463","54340","2015",1,1,0,170000,1062,160
"16464","54343","2015",2,2,0,137500,1196.5,121.5
"16465","54344","2015",2,2,0,136500,1273,108.5
"16466","54345","2015",3,3,0,154000,1518.667,109.3333
"16467","54346","2015",3,3,0,121000,925.6667,132.6667
"16468","54348","2015",5,5,0,109200,1053.2,99.8
"16469","54349","2015",2,2,0,82250,953,74.5
"16470","54350","2015",10,9,1,125502,1110.4,120.1
"16471","54351","2015",21,20,1,150948.6,1706.905,91.71429
"16472","54352","2015",14,13,1,176757.3,1451.357,122.7143
"16473","54353","2015",7,7,0,143242.9,1219,120.1429
"16474","54354","2015",1,1,0,25000,714,35
"16475","54357","2015",60,27,33,107957.1,1513.217,71.08333
"16476","54358","2015",2,2,0,205350,1648.5,155
"16477","54359","2015",3,3,0,128666.7,1262.333,103.3333
"16478","54360","2015",4,3,1,171250,1338.75,128.25
"16479","54362","2015",16,15,1,107594.2,1279.938,87.0625
"16480","54364","2015",11,10,1,165509.1,2331.182,93.45455
"16481","54365","2015",3,3,0,97600,979.3333,99.66667
"16482","54366","2015",20,19,1,146769.6,1587.65,93.3
"16483","54367","2015",22,17,5,166360.8,1762.318,92.45455
"16484","54369","2015",2,2,0,126500,1549,78.5
"16485","54370","2015",2,2,0,118500,833.5,148.5
"16486","54371","2015",10,10,0,168953,1580.4,107.7
"16487","54372","2015",5,5,0,167595,1513.2,111.2
"16488","54373","2015",4,4,0,178625,1381.75,131
"16489","54374","2015",1,1,0,147000,1531,96
"16490","54375","2015",9,9,0,172316.7,1603.222,114.6667
"16491","54376","2015",6,6,0,173341.7,1595,110.8333
"16492","54377","2015",1,1,0,46826,397,118
"16493","54379","2015",1,1,0,159500,1491,107
"16494","54380","2015",4,4,0,107250,931.5,120
"16495","54382","2015",51,40,11,124096.4,1362.392,89.58824
"16496","54383","2015",12,12,0,132275,1241.083,104.0833
"16497","54385","2015",11,11,0,120163.6,1265.545,92.45455
"16498","54387","2015",1,1,0,25000,347,72
"16499","54389","2015",1,1,0,162000,1209,134
"16500","54390","2015",2,2,0,178000,1511.5,108
"16501","54391","2015",14,14,0,78244.29,1017.857,72.35714
"16502","54393","2015",1,1,0,115000,804,143
"16503","54395","2015",1605,211,1394,131232.3,1892.136,70.38442
"16504","54396","2015",2,2,0,65250,581.5,112.5
"16505","54397","2015",68,61,7,127446.7,1474.838,91
"16506","54399","2015",5,5,0,147438,1327.6,111.8
"16507","54400","2015",3,2,1,92333.33,1478.667,66.33333
"16508","54401","2015",1,1,0,114000,712,160
"16509","54402","2015",4,4,0,97225,1017.75,100.5
"16510","54403","2015",6,4,2,154750,1376.5,115.1667
"16511","54404","2015",1,1,0,45000,409,110
"16512","54405","2015",3,3,0,128950,1166.667,105.6667
"16513","54406","2015",4,4,0,135750,1093,142
"16514","54407","2015",2,2,0,91000,799,110
"16515","54408","2015",2,2,0,84050,889.5,101.5
"16516","54409","2015",1,1,0,162900,1139,143
"16517","54410","2015",6,6,0,148483.3,1434,108
"16518","54411","2015",3,3,0,195333.3,1249,150.3333
"16519","54412","2015",1,1,0,217000,1550,140
"16520","54414","2015",2,2,0,176500,1630.5,107
"16521","54415","2015",17,12,5,146444.1,1423.235,100.5294
"16522","54416","2015",3,3,0,153150,1249,127.3333
"16523","54417","2015",3,3,0,209766.7,1550.667,133
"16524","54418","2015",3,3,0,66333.33,1099,71
"16525","54419","2015",2,2,0,90500,740,131
"16526","54421","2015",3,3,0,58266.67,620.6667,89.33333
"16527","54423","2015",4,4,0,66362.5,618,94.5
"16528","54425","2015",15,15,0,109163.3,996.7333,111.4667
"16529","54426","2015",10,9,1,89825,1054.7,84.4
"16530","54428","2015",9,7,2,78666.67,954.3333,88.44444
"16531","54430","2015",35,25,10,109492.6,1283.286,86.37143
"16532","54431","2015",169,89,80,126119.2,1325.562,95.40828
"16533","54432","2015",25,19,6,111082,1245.6,90.68
"16534","54433","2015",1,1,0,236000,2565,92
"16535","54434","2015",3,3,0,151666.7,1093,144
"16536","54435","2015",6,5,1,147973.3,1444.167,103
"16537","54437","2015",6,6,0,102041.7,1360.5,85.16667
"16538","54438","2015",1,1,0,203500,1219,167
"16539","54439","2015",39,33,6,180448.3,1960.821,92.02564
"16540","54440","2015",1,1,0,130000,1398,93
"16541","54441","2015",1,1,0,231200,1217,190
"16542","54443","2015",1,1,0,17000,1417,12
"16543","54444","2015",4,4,0,120375,1144.75,102.5
"16544","54445","2015",1,1,0,125000,1471,85
"16545","54447","2015",1,1,0,80000,571,140
"16546","54449","2015",16,16,0,136343.8,1350.375,102.25
"16547","54451","2015",22,19,3,139861.4,1419.045,98.86364
"16548","54453","2015",4,4,0,92370,856.25,112.5
"16549","54455","2015",2,2,0,136675,1604.5,84.5
"16550","54456","2015",6,6,0,153183.3,1194.167,137.1667
"16551","54457","2015",1,1,0,95000,605,157
"16552","54459","2015",24,24,0,197322.5,1775.75,116.5417
"16553","54460","2015",2,2,0,252000,1147,178.5
"16554","54462","2015",36,28,8,121914.3,1393.111,88.52778
"16555","54463","2015",2,2,0,47500,682,74
"16556","54464","2015",2,2,0,120000,1023,122.5
"16557","54465","2015",12,11,1,144714.2,1240.667,116
"16558","54466","2015",3,3,0,134333.3,1050.667,124.6667
"16559","54467","2015",2,2,0,80000,820,91
"16560","54469","2015",3,3,0,129666.7,1004,128
"16561","54472","2015",5,5,0,89300,742.4,132.8
"16562","54473","2015",3,3,0,135000,1051.667,144
"16563","54474","2015",1,1,0,160000,1739,92
"16564","54475","2015",1,1,0,136000,1700,80
"16565","54476","2015",2,2,0,99000,1022.5,103.5
"16566","54477","2015",1,1,0,50000,476,105
"16567","54478","2015",1,0,1,85000,766,111
"16568","54479","2015",2,2,0,130875,1343.5,118
"16569","54481","2015",2,2,0,123875,1155.5,111
"16570","54482","2015",133,41,92,131988,1624.925,80.52632
"16571","54483","2015",74,51,23,128120.7,1395.986,94.7973
"16572","54484","2015",2,2,0,89000,514.5,169
"16573","54485","2015",1,1,0,165000,1352,122
"16574","54486","2015",2,2,0,102250,730,122.5
"16575","54487","2015",1,1,0,1e+05,690,145
"16576","54488","2015",2,2,0,60750,565,101
"16577","54489","2015",1,1,0,32000,410,78
"16578","54490","2015",8,8,0,153518.8,1387.375,118
"16579","54491","2015",4,4,0,119961.5,1124,98
"16580","54493","2015",24,18,6,94392.71,1066.292,88.125
"16581","54494","2015",1,1,0,50000,373,134
"16582","54495","2015",36,35,1,182526,1769,104.8611
"16583","54496","2015",4,4,0,128943,938.25,141.75
"16584","54497","2015",2,2,0,145000,706.5,156
"16585","54498","2015",51,49,2,180595,1860.412,97.13725
"16586","54500","2015",2,2,0,137500,897.5,157.5
"16587","54501","2015",2,2,0,62500,739,88
"16588","54502","2015",4,2,2,104475,987.5,114.5
"16589","54504","2015",6,5,1,140291.7,1657.5,90.66667
"16590","54505","2015",2,2,0,204500,1492.5,136.5
"16591","54508","2015",2,2,0,152775,1603,95
"16592","54509","2015",9,7,2,88797.78,1181,77.88889
"16593","54511","2015",2,2,0,57000,454,124
"16594","54513","2015",7,7,0,135178.6,1155.857,122.7143
"16595","54514","2015",3,2,1,198700,1636.667,130
"16596","54515","2015",2,2,0,116405.5,968,100.5
"16597","54516","2015",1,1,0,202000,2126,95
"16598","54517","2015",1,1,0,85000,1214,70
"16599","54518","2015",6,6,0,151166.7,1366,114.5
"16600","54519","2015",9,9,0,128444.4,1146.778,123.6667
"16601","54520","2015",3,3,0,85833.33,1012.667,83.66667
"16602","54521","2015",15,11,4,110775.7,1747.8,70.4
"16603","54522","2015",3,3,0,120333.3,826.6667,142
"16604","54523","2015",1,1,0,111820,932,120
"16605","54525","2015",5,3,2,171920,1688.2,101.4
"16606","54526","2015",94,51,43,149251.8,1777.17,85.1383
"16607","54527","2015",8,8,0,179025,1451,124.125
"16608","54528","2015",142,84,58,120584,1263.141,97.06338
"16609","54530","2015",1,1,0,143000,1474,97
"16610","54533","2015",28,28,0,106883.6,1272.786,82.03571
"16611","54534","2015",4,4,0,106477.5,893.25,116.75
"16612","54535","2015",4,4,0,175350,1321.5,133.5
"16613","54536","2015",16,16,0,81093.75,1089.188,73.5
"16614","54537","2015",8,8,0,199585.1,1578.125,119.5
"16615","54538","2015",3,3,0,126333.3,1114,111
"16616","54539","2015",2,2,0,188800,1294.5,166
"16617","54540","2015",4,4,0,43250,570.5,78
"16618","54542","2015",33,28,5,99391.21,1218.091,85.06061
"16619","54544","2015",2,1,1,104000,1484.5,66.5
"16620","54545","2015",1,1,0,53000,358,148
"16621","54546","2015",8,7,1,133863.8,1349,104.375
"16622","54547","2015",304,83,221,102825.8,1604.566,65.81908
"16623","54548","2015",5,5,0,84000,559.8,145.4
"16624","54549","2015",27,22,5,137085.1,1431.037,99.22222
"16625","54550","2015",5,4,1,136520,1261.6,109.4
"16626","54551","2015",1,1,0,85000,654,130
"16627","54552","2015",1,1,0,65000,812,80
"16628","54555","2015",1,1,0,25400,385,66
"16629","54556","2015",2,2,0,123250,746.5,164
"16630","54557","2015",24,24,0,238381.2,1764.917,137.75
"16631","54558","2015",5,5,0,133400,1361.8,103.6
"16632","54559","2015",4,4,0,120150,1407,93.5
"16633","54563","2015",15,13,2,111700.3,1076.8,107.2667
"16634","54564","2015",1,1,0,164000,965,170
"16635","54565","2015",1,1,0,130000,855,152
"16636","54566","2015",1,1,0,174210,1037,168
"16637","54567","2015",7,7,0,97228.57,965.2857,107.7143
"16638","54568","2015",2,2,0,91500,676,153
"16639","54569","2015",1,1,0,186000,1722,108
"16640","54570","2015",3,3,0,198345,1543.667,135
"16641","54571","2015",3,2,1,149700,1241.667,114.6667
"16642","54572","2015",12,12,0,161041.7,1394.083,110.75
"16643","54573","2015",2,2,0,141925.5,1901,87.5
"16644","54574","2015",1,1,0,293000,2035,144
"16645","54575","2015",19,13,6,169841.6,1855,91.78947
"16646","54577","2015",1,1,0,1e+05,794,126
"16647","54578","2015",189,96,93,154701.7,1843.54,84.74074
"16648","54579","2015",3,3,0,126000,908.3333,141.6667
"16649","54580","2015",114,85,29,110443.8,1411.035,77.69298
"16650","54581","2015",1,1,0,214600,1394,154
"16651","54582","2015",2,2,0,97500,841,117.5
"16652","54583","2015",2,2,0,40000,961.5,41
"16653","54584","2015",7,7,0,147714.3,1528.143,101.4286
"16654","54585","2015",5,5,0,154125.2,1195.2,125.2
"16655","54586","2015",11,11,0,130272.7,1201.818,105.0909
"16656","54587","2015",1,1,0,150000,1200,125
"16657","54588","2015",3,3,0,159000,1106.667,153.3333
"16658","54590","2015",7,7,0,136357.1,1269.143,109.5714
"16659","54591","2015",1,1,0,177650,1161,153
"16660","54592","2015",3,3,0,157750,1485.333,108
"16661","54593","2015",3,3,0,122500,1514,79
"16662","54595","2015",3,3,0,121500,1064,135.6667
"16663","54596","2015",8,7,1,177198,1504.625,117.25
"16664","54597","2015",3,3,0,142210.3,985,163
"16665","54598","2015",3,3,0,121700,1340,90.33333
"16666","54600","2015",1,1,0,48000,1200,40
"16667","54601","2015",2,2,0,158750,953,164
"16668","55001","2015",4,4,0,75750,765.5,96.75
"16669","55004","2015",1,1,0,120000,642,187
"16670","55009","2015",2,2,0,100800,964.5,103.5
"16671","55010","2015",18,17,1,88000,1077.333,80.61111
"16672","55011","2015",1,1,0,78000,629,124
"16673","55012","2015",5,5,0,111720,1147.6,108.6
"16674","55013","2015",7,7,0,126307.1,1466.429,88.85714
"16675","55014","2015",4,4,0,93775,628.5,160.25
"16676","55015","2015",4,4,0,98750,1266,76.75
"16677","55021","2015",1,1,0,39000,411,95
"16678","55024","2015",1,1,0,114500,902,127
"16679","55027","2015",2,2,0,82500,576.5,127
"16680","55028","2015",2,2,0,110000,725.5,147
"16681","55029","2015",138,95,43,104696.2,1117.783,96.27536
"16682","55036","2015",1,1,0,98000,524,187
"16683","55038","2015",3,3,0,155493.3,1456,117.3333
"16684","55040","2015",5,5,0,87000,801,105.8
"16685","55041","2015",6,6,0,129500,1333,92.33333
"16686","55042","2015",3,3,0,111700,1236.333,89.66667
"16687","55043","2015",37,30,7,125504.1,1285.622,95.97297
"16688","55044","2015",2,2,0,87750,777.5,107
"16689","55047","2015",3,3,0,80666.67,876,95.33333
"16690","55048","2015",1,1,0,50000,1042,48
"16691","55049","2015",1,1,0,75400,1109,68
"16692","55051","2015",1,1,0,91500,984,93
"16693","55053","2015",3,3,0,33333.33,415,80
"16694","55057","2015",1,1,0,1e+05,962,104
"16695","55058","2015",4,4,0,110155,1035.75,108.5
"16696","55060","2015",4,4,0,107250,1143.75,96.25
"16697","55061","2015",1,1,0,96000,565,170
"16698","55063","2015",24,20,4,61497.71,785.75,78.95833
"16699","55065","2015",1,1,0,59000,738,80
"16700","55068","2015",1,1,0,140000,690,203
"16701","55069","2015",2,2,0,47500,453.5,106
"16702","55071","2015",5,5,0,94780,704,145.2
"16703","55072","2015",3,3,0,93666.67,1191,76.66667
"16704","55073","2015",4,4,0,180000,1771.25,100.75
"16705","55075","2015",1,1,0,75000,441,170
"16706","55076","2015",2,2,0,90000,744,123.5
"16707","55077","2015",3,3,0,148333.7,965,183.3333
"16708","55078","2015",3,3,0,69666.67,733,91.66667
"16709","55079","2015",4,4,0,104500,1245,83
"16710","55081","2015",1,1,0,48000,696,69
"16711","55083","2015",2,2,0,120000,827,155
"16712","55085","2015",4,4,0,125875,1060,128.75
"16713","55088","2015",1,1,0,88100,678,130
"16714","55093","2015",2,2,0,177500,1648,104
"16715","55094","2015",1,1,0,70000,824,85
"16716","55095","2015",3,2,1,50142.67,484.6667,106.3333
"16717","55096","2015",1,1,0,117000,688,170
"16718","55099","2015",4,4,0,161250,1144.5,140.75
"16719","55101","2015",2,2,0,63500,591,95.5
"16720","55102","2015",3,3,0,113333.3,1160,119.6667
"16721","55105","2015",5,5,0,115050,809,149.6
"16722","55108","2015",1,1,0,90000,789,114
"16723","55109","2015",1,1,0,20000,333,60
"16724","55111","2015",4,4,0,56000,681.75,88.25
"16725","55113","2015",2,2,0,87361,502,175
"16726","55116","2015",2,2,0,88077,1322.5,66.5
"16727","55117","2015",6,6,0,109200,777.1667,141.5
"16728","55119","2015",1,1,0,80000,1053,76
"16729","55120","2015",9,9,0,116100,1241.222,92.44444
"16730","55121","2015",1,1,0,128500,1382,93
"16731","55122","2015",41,30,11,89805.37,901.3415,98.2439
"16732","55123","2015",3,3,0,123633.3,1238,108.6667
"16733","55124","2015",1,1,0,78000,743,105
"16734","55125","2015",8,7,1,98625,1160.75,90.625
"16735","55138","2015",2,2,0,183750,2210.5,133
"16736","55140","2015",1,1,0,130000,861,151
"16737","55142","2015",2,2,0,85000,582,141.5
"16738","55143","2015",1,1,0,120000,632,190
"16739","55144","2015",2,2,0,65550,971,64.5
"16740","55145","2015",3,3,0,76666.67,678.3333,110.3333
"16741","55146","2015",1,1,0,50000,476,105
"16742","55153","2015",1,1,0,189500,1298,146
"16743","55154","2015",15,15,0,88760,980.0667,93.4
"16744","55155","2015",1,1,0,49000,510,96
"16745","55156","2015",3,3,0,94833.33,899,105.3333
"16746","55159","2015",3,3,0,74000,800,89
"16747","55165","2015",5,5,0,93000,991.6,97.2
"16748","55166","2015",9,8,1,144422.2,1540.222,99.11111
"16749","55167","2015",5,5,0,93100,1398.6,82.2
"16750","55169","2015",5,4,1,135800,1482,94.8
"16751","55170","2015",2,2,0,60900,632,114.5
"16752","55171","2015",1,1,0,112000,1258,89
"16753","55175","2015",2,2,0,59500,644.5,95
"16754","55177","2015",1,1,0,99705,688,145
"16755","55178","2015",2,2,0,85000,938,92.5
"16756","55183","2015",1,1,0,72000,818,88
"16757","55184","2015",27,27,0,97053.7,1076.037,93
"16758","55186","2015",20,20,0,133419.3,1201.85,111.15
"16759","55192","2015",1,1,0,50000,532,94
"16760","55196","2015",1,1,0,110500,614,180
"16761","55198","2015",6,6,0,123116.7,1276,95.33333
"16762","55199","2015",3,3,0,95833.33,1008,91.66667
"16763","55202","2015",1,1,0,125000,735,170
"16764","55204","2015",1,1,0,90000,714,126
"16765","55206","2015",2,2,0,80500,775.5,118.5
"16766","55214","2015",2,2,0,63913.5,678.5,85
"16767","55217","2015",1,1,0,66300,597,111
"16768","55222","2015",1,1,0,75000,333,225
"16769","55224","2015",10,10,0,90592.6,841.7,116.4
"16770","55226","2015",1,1,0,90000,682,132
"16771","55228","2015",7,7,0,112026.3,971.5714,126.7143
"16772","55229","2015",4,4,0,70500,636.25,116.5
"16773","55236","2015",9,9,0,131968.9,1093.778,121.4444
"16774","55237","2015",2,2,0,110500,1447.5,102
"16775","55241","2015",2,2,0,72500,725,100
"16776","55243","2015",1,1,0,70000,722,97
"16777","55245","2015",1,1,0,74396,1860,40
"16778","55246","2015",2,2,0,56500,534.5,102.5
"16779","55250","2015",1,1,0,80000,1481,54
"16780","55251","2015",1,1,0,50000,476,105
"16781","55252","2015",1,1,0,104000,754,138
"16782","55253","2015",6,6,0,67500,784.3333,86.16667
"16783","55254","2015",1,1,0,76000,844,90
"16784","55255","2015",1,1,0,94000,543,173
"16785","55256","2015",1,1,0,149500,1661,90
"16786","55258","2015",9,9,0,99188.89,1303.667,84
"16787","55261","2015",2,2,0,81500,953.5,80
"16788","55263","2015",3,3,0,126270,889.3333,149.3333
"16789","55267","2015",1,1,0,177500,997,178
"16790","55268","2015",3,3,0,64000,619,107.6667
"16791","55270","2015",1,1,0,80000,449,178
"16792","55272","2015",3,3,0,128000,1297.667,101
"16793","55274","2015",4,4,0,57750,959.75,61
"16794","55275","2015",1,1,0,50000,410,122
"16795","55279","2015",3,3,0,65000,675.3333,92
"16796","55281","2015",1,1,0,142000,1183,120
"16797","55285","2015",1,1,0,125950,1499,84
"16798","55286","2015",3,3,0,157650,1228,128.3333
"16799","55288","2015",14,13,1,92912.5,1071.857,87.21429
"16800","55289","2015",1,1,0,116500,1641,71
"16801","55291","2015",18,18,0,103394.4,1034.167,96
"16802","55292","2015",3,3,0,80233.33,943,79.66667
"16803","55293","2015",2,2,0,104000,741.5,142.5
"16804","55296","2015",8,8,0,94426.25,836.875,121.875
"16805","55298","2015",3,3,0,88000,777.6667,113.6667
"16806","55300","2015",1,1,0,132000,1467,90
"16807","55302","2015",9,9,0,92888.89,1045.444,87.88889
"16808","55306","2015",2,2,0,142500,1348.5,118.5
"16809","55310","2015",3,3,0,64166.67,776,79.33333
"16810","55312","2015",1,1,0,32300,394,82
"16811","55313","2015",1,1,0,59000,369,160
"16812","55321","2015",2,2,0,77187.5,733,102.5
"16813","55323","2015",2,2,0,54000,430.5,126.5
"16814","55324","2015",1,1,0,105000,1154,91
"16815","55326","2015",3,3,0,68866.67,609.6667,104
"16816","55328","2015",2,2,0,76000,534,137
"16817","55329","2015",2,2,0,35750,413,86
"16818","55332","2015",3,3,0,123666.7,1033.667,116.6667
"16819","55335","2015",3,3,0,68333.33,805.3333,88.33333
"16820","55344","2015",1,1,0,110000,550,200
"16821","55345","2015",2,2,0,75345,1047,96.5
"16822","55346","2015",1,1,0,35000,368,95
"16823","55349","2015",3,3,0,132500,1465.667,98.33333
"16824","55351","2015",13,13,0,142423.1,1493.385,104.3077
"16825","55353","2015",2,2,0,172500,1928,78.5
"16826","55355","2015",2,2,0,24500,414.5,58.5
"16827","55357","2015",1,1,0,33000,471,70
"16828","55358","2015",2,2,0,63250,598.5,97.5
"16829","55360","2015",2,2,0,55000,724,76
"16830","55362","2015",4,4,0,109450,990.5,113.25
"16831","55363","2015",1,1,0,60000,732,82
"16832","55364","2015",3,3,0,123000,1098,118.3333
"16833","55365","2015",1,1,0,60000,600,100
"16834","55366","2015",3,3,0,104333.3,903.6667,118
"16835","55369","2015",6,6,0,108250,926.3333,110.8333
"16836","55370","2015",1,1,0,65000,481,135
"16837","55372","2015",3,3,0,96233.33,1118.667,86.66667
"16838","55375","2015",1,1,0,52000,1444,36
"16839","55376","2015",1,1,0,129400,911,142
"16840","55377","2015",1,1,0,88000,978,90
"16841","55378","2015",6,5,1,66583.33,643,109.1667
"16842","55382","2015",9,9,0,89800,909.7778,96.77778
"16843","55386","2015",5,5,0,105176,970.4,105
"16844","55388","2015",5,5,0,124900,568.2,215
"16845","55389","2015",2,2,0,145000,846,172.5
"16846","55391","2015",2,2,0,51250,676,77.5
"16847","55399","2015",1,1,0,127000,1309,97
"16848","55404","2015",2,2,0,126902.5,966.5,121
"16849","55406","2015",1,1,0,68000,861,79
"16850","55423","2015",1,1,0,65000,508,128
"16851","55424","2015",1,1,0,33000,330,100
"16852","55426","2015",3,3,0,134866.7,1056,131
"16853","55427","2015",19,19,0,83476.32,900.8947,95.73684
"16854","55429","2015",1,1,0,180000,1161,155
"16855","55435","2015",9,9,0,120122.2,1110.667,110.4444
"16856","55439","2015",3,3,0,106666.7,990.6667,104
"16857","55442","2015",1,1,0,41000,414,99
"16858","55444","2015",1,1,0,107800,787,137
"16859","55446","2015",3,3,0,87166.67,788.6667,103.6667
"16860","55449","2015",1,1,0,80000,516,155
"16861","55457","2015",2,2,0,99450,821,124.5
"16862","55458","2015",10,10,0,110690,994.5,109.1
"16863","55460","2015",2,2,0,136000,1031,156
"16864","55463","2015",18,18,0,82535.78,843.6111,101.9444
"16865","55466","2015",1,1,0,30000,429,70
"16866","55467","2015",5,4,1,86200,759.8,113.4
"16867","55469","2015",2,2,0,40750,625.5,68.5
"16868","55476","2015",3,2,1,121333.3,1451.333,77
"16869","55477","2015",3,3,0,103750,637.6667,178.3333
"16870","55488","2015",2,2,0,112500,1173.5,100.5
"16871","55489","2015",3,3,0,108333.3,829,128.6667
"16872","55490","2015",2,2,0,62000,903,62
"16873","55492","2015",6,6,0,112333.3,1099.5,105.6667
"16874","55498","2015",4,4,0,120000,1005,119.25
"16875","55502","2015",14,12,2,103357.1,984.9286,104.7857
"16876","55504","2015",5,5,0,112780,1202.2,100.6
"16877","55505","2015",12,11,1,148916.7,1556.25,96.66667
"16878","55507","2015",2,2,0,95750,1162.5,83
"16879","55508","2015",3,3,0,109666.7,1117,93.66667
"16880","55514","2015",6,4,2,140883.3,1477.5,118.6667
"16881","55517","2015",3,3,0,84666.67,959.3333,95.66667
"16882","55519","2015",8,8,0,99812.5,1008.125,100
"16883","55520","2015",5,5,0,87220,961.4,104.4
"16884","55523","2015",1,1,0,95000,1080,88
"16885","55526","2015",1,1,0,115000,1250,92
"16886","55527","2015",3,3,0,57500,680.3333,98.66667
"16887","55531","2015",3,3,0,76666.67,657,123.3333
"16888","55533","2015",9,9,0,61894.67,790.2222,79.11111
"16889","55541","2015",4,4,0,149978.2,1144,121.75
"16890","55543","2015",9,9,0,127944.4,1154,107.6667
"16891","55545","2015",173,114,59,113511.4,1369.711,87.4104
"16892","55551","2015",18,18,0,112667.5,984.8333,112.3889
"16893","55553","2015",8,8,0,80187.5,884,97.5
"16894","55556","2015",1,1,0,130000,1368,95
"16895","55557","2015",1,1,0,45000,352,128
"16896","55560","2015",1,1,0,65000,1300,50
"16897","55568","2015",1,1,0,155000,1422,109
"16898","55571","2015",2,2,0,85000,629,135
"16899","55578","2015",2,2,0,65500,657.5,98.5
"16900","55582","2015",1,1,0,21000,389,54
"16901","55584","2015",2,2,0,61500,670,95
"16902","55586","2015",2,2,0,114000,839,136
"16903","56001","2015",26,25,1,136261.3,1257.962,108.8846
"16904","56002","2015",8,8,0,174446.2,2005.625,88.875
"16905","56003","2015",59,48,11,340361,2950.559,113.3559
"16906","56004","2015",31,29,2,127412.7,2054.129,69.80645
"16907","56005","2015",98,47,51,235691.5,3501.857,69.78571
"16908","56006","2015",9,9,0,102655.6,1245.111,79.33333
"16909","56007","2015",181,79,102,168021.1,2049.271,84.03315
"16910","56008","2015",64,57,7,333481.1,2834.859,116.1719
"16911","56009","2015",20,20,0,298882.2,3448.7,89
"16912","56010","2015",65,60,5,111645.4,1337.8,84.66154
"16913","56011","2015",16,16,0,88912.5,1125.25,75.625
"16914","56012","2015",18,18,0,150441.4,1373.444,106
"16915","56013","2015",39,30,9,189412.4,2306.128,82.4359
"16916","56014","2015",21,20,1,89758.05,1197.762,81.09524
"16917","56015","2015",13,13,0,164043.8,1629,101.4615
"16918","56017","2015",19,19,0,101157.9,1307,89.57895
"16919","56018","2015",17,17,0,154788.2,1843.647,91.23529
"16920","56019","2015",6,6,0,82416.67,1032.833,79.66667
"16921","56020","2015",5,5,0,150700,1308,120.2
"16922","56021","2015",11,11,0,152636.4,1560.364,99.36364
"16923","56022","2015",16,16,0,145690.9,1483.5,99.6875
"16924","56023","2015",48,44,4,207161.6,2087.75,105.3333
"16925","56024","2015",18,18,0,97267.78,933.5556,105.6667
"16926","56025","2015",1,1,0,40000,769,52
"16927","56026","2015",19,19,0,105297.9,1169,92.73684
"16928","56027","2015",6,6,0,88166.67,1051,75.83333
"16929","56028","2015",20,20,0,108160,1190.25,99.8
"16930","56029","2015",14,14,0,149330.7,1603.857,93.78571
"16931","56030","2015",11,11,0,176118.2,2003.091,97.81818
"16932","56031","2015",42,42,0,117702.1,1315.167,90.92857
"16933","56032","2015",16,16,0,104375,1122.625,92.25
"16934","56033","2015",37,34,3,77445.73,1059,75.43243
"16935","56034","2015",158,81,77,251729.3,3365.152,79.46835
"16936","56035","2015",4,4,0,99582.5,1248,82.5
"16937","56036","2015",52,48,4,178693.3,1697.173,108.4231
"16938","56039","2015",11,11,0,121536.4,1254.727,103.1818
"16939","56040","2015",35,34,1,146573.9,1461.686,101.5143
"16940","56041","2015",27,27,0,92855.48,990.7037,93.59259
"16941","56042","2015",16,16,0,121731.2,1598.812,79.5625
"16942","56043","2015",11,11,0,73178.09,955.9091,84
"16943","56044","2015",10,10,0,99090,1076.8,96.2
"16944","56045","2015",11,11,0,127481.8,1356.727,99.36364
"16945","56046","2015",25,25,0,301684,2591.24,128.4
"16946","56047","2015",12,12,0,82425,1070.5,94.66667
"16947","56048","2015",5,5,0,144554,1693.2,109.8
"16948","56050","2015",7,7,0,73225.14,803.7143,93.57143
"16949","56051","2015",5,5,0,68600,907.2,84.4
"16950","56052","2015",50,41,9,231226.6,3024.44,81.24
"16951","56053","2015",55,49,6,143998.2,1582.527,91.41818
"16952","56054","2015",49,42,7,194283.1,2484.327,86.04082
"16953","56055","2015",43,28,15,176225.6,2491.628,76.86047
"16954","56056","2015",3,3,0,40166.67,528,71
"16955","56057","2015",28,28,0,80017.86,1060.857,77.75
"16956","56058","2015",23,23,0,144445.7,1818.043,84.04348
"16957","56060","2015",6,6,0,67996.67,1109.333,78
"16958","56061","2015",36,36,0,115937,1154.639,98.05556
"16959","56062","2015",12,12,0,279584.1,2675.333,108.25
"16960","56063","2015",21,21,0,191438.6,1847.19,105.7143
"16961","56065","2015",5,5,0,176100,1752.2,101
"16962","56066","2015",47,46,1,76698.94,851.8085,90.59574
"16963","56067","2015",46,45,1,182119.7,1610.087,118.4565
"16964","56068","2015",4,4,0,62000,765.25,83
"16965","56069","2015",38,37,1,215815.3,2577.342,90.26316
"16966","56070","2015",24,23,1,94532.5,1021.083,96.625
"16967","56071","2015",9,9,0,129310.1,1522.111,88.66667
"16968","56072","2015",3,3,0,102083.3,1071,92.33333
"16969","56073","2015",17,17,0,54796.76,796.8824,81.29412
"16970","56074","2015",25,25,0,139034.3,1431.72,100.64
"16971","56075","2015",51,48,3,130306.4,1316.275,100.8431
"16972","56076","2015",17,17,0,108061.8,1044.765,104.2941
"16973","56077","2015",8,8,0,144648.8,1497,94.75
"16974","56078","2015",147,82,65,165851.3,2186.714,77.97959
"16975","56079","2015",16,16,0,91281.25,959.9375,93.25
"16976","56080","2015",17,17,0,78901.29,798.4118,97.64706
"16977","56081","2015",17,17,0,93500,931.1765,100.8235
"16978","56082","2015",8,8,0,77587.5,926.25,81.625
"16979","56083","2015",188,127,61,133915.9,1506.862,88.98936
"16980","56084","2015",3,3,0,264666.7,2307.667,119.6667
"16981","56085","2015",3,3,0,361666.7,4719,77.33333
"16982","56086","2015",5,5,0,230200,6289.8,41.4
"16983","56087","2015",10,10,0,539000,4803.2,109.3
"16984","56088","2015",8,8,0,263812.5,3409.875,81.875
"16985","56089","2015",21,21,0,121176.2,1361.905,97.2381
"16986","56090","2015",72,70,2,124731.1,1523.069,86.125
"16987","56091","2015",33,32,1,101275.8,1068.333,90.21212
"16988","56092","2015",3,3,0,97266.67,969.6667,102.3333
"16989","56093","2015",2,2,0,57500,742,69.5
"16990","56094","2015",40,37,3,199010.8,1841.7,111.025
"16991","56096","2015",20,20,0,183027.5,1893.15,102.1
"16992","56097","2015",21,21,0,157639.3,1753.476,92.33333
"16993","56098","2015",194,149,45,143039.8,1613.072,89.76289
"16994","56099","2015",6,6,0,157909,999.5,115.3333
"16995","56100","2015",19,19,0,91463.84,935,94.73684
"16996","56101","2015",58,55,3,154494.4,1642.19,98.51724
"16997","56102","2015",29,29,0,95362.07,1017.448,96.34483
"16998","56103","2015",4,4,0,98175,948,99.25
"16999","56104","2015",9,9,0,119488.9,1360.444,97.55556
"17000","56105","2015",14,14,0,83857.14,981.2143,90.78571
"17001","56106","2015",17,15,2,477216.9,3787.529,105.6471
"17002","56107","2015",121,86,35,283117.1,3030.017,98.39669
"17003","56108","2015",16,16,0,127137.5,1460.25,89.5625
"17004","56109","2015",12,12,0,174275,1596.083,107.5833
"17005","56110","2015",9,9,0,77783.22,1309.333,85.88889
"17006","56111","2015",15,15,0,119356.7,1181.333,99.6
"17007","56112","2015",6,6,0,89248.33,952.8333,89.83333
"17008","56113","2015",12,12,0,110958.3,1216.417,84.66667
"17009","56114","2015",18,17,1,284338.3,3542.889,77.72222
"17010","56115","2015",18,18,0,153261.1,1536.278,108.8333
"17011","56116","2015",25,19,6,263658.9,3442.88,83.36
"17012","56117","2015",32,27,5,132543.4,1453.594,92.40625
"17013","56118","2015",56,51,5,151511.8,1836.571,84.73214
"17014","56119","2015",25,24,1,244036,2319.76,113.12
"17015","56120","2015",17,17,0,156680.3,1385.824,111.8824
"17016","56121","2015",747,259,488,131305.1,1698.668,78.1178
"17017","56122","2015",23,23,0,79963.3,1024.087,81.52174
"17018","56123","2015",28,28,0,109898.9,1140.964,99.14286
"17019","56124","2015",39,35,4,113888.6,1288.256,85.48718
"17020","56125","2015",16,16,0,115015.6,1243.812,96.25
"17021","56126","2015",31,31,0,133684,1621.226,86.03226
"17022","56127","2015",39,36,3,99700,1055.128,98.17949
"17023","56128","2015",22,22,0,93552.27,993.1364,96.04545
"17024","56129","2015",17,17,0,84041.18,845.4706,94.52941
"17025","56130","2015",33,33,0,173468.8,1811.606,99.60606
"17026","56131","2015",12,12,0,126625,1298.167,98.66667
"17027","56132","2015",1,1,0,180000,1607,112
"17028","56133","2015",8,8,0,113775,1122.25,100.875
"17029","56134","2015",10,10,0,71440,790.1,86.4
"17030","56135","2015",19,19,0,115529.1,1174.789,95.31579
"17031","56136","2015",10,10,0,82535,904.5,91.9
"17032","56137","2015",15,14,1,189892,1504.8,126.0667
"17033","56139","2015",2,2,0,175425,1415,122
"17034","56140","2015",24,24,0,129149.2,1245.875,111.2917
"17035","56141","2015",10,10,0,128927.6,1533.1,86.4
"17036","56143","2015",44,36,8,157504.3,1750.909,92.63636
"17037","56144","2015",18,18,0,85250,1101.556,77.61111
"17038","56145","2015",8,8,0,52047.5,772.25,68.5
"17039","56146","2015",7,7,0,105257.1,1084.286,95.71429
"17040","56147","2015",39,37,2,154433.8,1541.564,99.69231
"17041","56148","2015",11,11,0,213863.6,1708.455,123.1818
"17042","56149","2015",26,26,0,170317.3,1898.962,91.38462
"17043","56151","2015",29,29,0,128273.3,1354.897,94.34483
"17044","56152","2015",50,34,16,290756.6,3121.1,86.68
"17045","56153","2015",32,31,1,136239.6,1418.781,94.75
"17046","56154","2015",17,17,0,89105.88,1010,93.58824
"17047","56155","2015",65,60,5,167419.6,2478.169,74.63077
"17048","56156","2015",7,7,0,65814.29,895.8571,79.42857
"17049","56157","2015",17,17,0,136970.6,1476.529,94.52941
"17050","56158","2015",63,34,29,182489.1,2058.714,88.65079
"17051","56159","2015",21,21,0,107669.9,1081.429,101.4762
"17052","56160","2015",6,6,0,89831.33,789.8333,102.6667
"17053","56161","2015",31,22,9,186133.5,2033.29,91.64516
"17054","56162","2015",188,149,39,230509.5,2490.186,97.84043
"17055","56163","2015",18,18,0,81748.89,1016.389,77.5
"17056","56164","2015",54,46,8,252453.4,2210.426,113.7963
"17057","56165","2015",89,72,17,124764.8,1425.899,88.86517
"17058","56166","2015",51,50,1,132647.1,1371.686,102.9608
"17059","56167","2015",18,15,3,241597.9,2317.056,113.3333
"17060","56168","2015",21,18,3,238678.6,2374.19,100.2381
"17061","56169","2015",52,49,3,182843,2032.865,92.80769
"17062","56170","2015",7,7,0,98714.29,780.4286,129
"17063","56171","2015",16,16,0,113640.6,1332.812,84.0625
"17064","56172","2015",25,25,0,122242.4,1248.76,108.08
"17065","56173","2015",59,59,0,98279.29,1139.542,87.61017
"17066","56174","2015",24,24,0,133433.8,1325.167,99.25
"17067","56175","2015",37,28,9,163738.1,1669.351,102.2162
"17068","56176","2015",50,44,6,203422.5,1947.64,105.8
"17069","56177","2015",102,98,4,150467.1,1651.01,97.66667
"17070","56178","2015",130,92,38,105361.9,1334.6,83.87692
"17071","56179","2015",31,30,1,182728.8,1721.452,109.2581
"17072","56180","2015",9,9,0,146346.9,1403.222,101.6667
"17073","56181","2015",54,42,12,169818.5,2001.722,92.90741
"17074","56182","2015",4,4,0,123050,1485,97.25
"17075","56184","2015",69,60,9,124397.9,1490.623,84.2029
"17076","56185","2015",65,62,3,200490.5,1881.862,106.8923
"17077","56186","2015",171,85,86,232319.3,3403.468,73.50292
"17078","56188","2015",27,27,0,105451.9,1269.259,85
"17079","56189","2015",13,13,0,112026.9,1268.154,90.23077
"17080","56190","2015",20,20,0,106716.9,1147.65,94
"17081","56191","2015",3,3,0,102656.7,1005,102
"17082","56193","2015",66,66,0,155912.9,1697.909,94.19697
"17083","56194","2015",25,25,0,122050.4,1119.96,110.36
"17084","56195","2015",16,8,8,149512.5,1727,93.4375
"17085","56196","2015",12,12,0,146058.3,1481.333,102.0833
"17086","56197","2015",29,29,0,105194.1,1135.31,92.96552
"17087","56198","2015",22,22,0,59397.73,768.5455,78
"17088","56199","2015",4,4,0,82500,930,98.5
"17089","56200","2015",9,9,0,84504.44,1253.889,86.55556
"17090","56201","2015",12,12,0,78083.33,857.4167,95
"17091","56202","2015",6,6,0,135675,1249.333,108
"17092","56203","2015",11,11,0,90844.55,1009.636,93.90909
"17093","56204","2015",9,9,0,116155.6,1096.111,98.88889
"17094","56205","2015",8,8,0,284037.5,2584.5,113.75
"17095","56206","2015",100,82,18,213578.2,2053.61,104.72
"17096","56207","2015",15,15,0,108297.9,1140.4,96.13333
"17097","56208","2015",2,2,0,43000,594,72
"17098","56209","2015",6,6,0,87243,1047.167,90.16667
"17099","56210","2015",4,4,0,109512.5,837.25,126.75
"17100","56211","2015",12,12,0,83941.25,901.5833,94.33333
"17101","56212","2015",25,25,0,127924,1307.64,97.64
"17102","56213","2015",8,8,0,82250,1035.625,81.875
"17103","56214","2015",61,59,2,298964.2,3005.197,100.1311
"17104","56215","2015",9,9,0,123086.4,1163.556,107.7778
"17105","56216","2015",8,8,0,100468.8,1040.375,92.625
"17106","56218","2015",17,17,0,84405.76,1038.471,82.23529
"17107","56219","2015",6,6,0,186566.7,1669,115.1667
"17108","56220","2015",10,10,0,204700,1943.6,102.9
"17109","56221","2015",13,13,0,100567.4,1046.308,95.30769
"17110","56222","2015",24,24,0,125395.9,1240,99.70833
"17111","56223","2015",10,10,0,105449,1237,80.2
"17112","56224","2015",5,5,0,121871.8,1342.2,91.8
"17113","56225","2015",1,1,0,140100,726,193
"17114","56226","2015",3,3,0,129000,1134.667,118.3333
"17115","56227","2015",5,5,0,105600,1043.6,94.4
"17116","56228","2015",6,6,0,94592.67,991.5,89.33333
"17117","56229","2015",18,18,0,83464.78,928.9444,89.05556
"17118","56230","2015",11,11,0,92460.82,983.1818,94.63636
"17119","56231","2015",38,37,1,183930.7,1716.342,108.9474
"17120","56232","2015",10,10,0,107119.1,1313.6,79.4
"17121","56233","2015",29,25,4,364198.3,3408.655,108.4138
"17122","56234","2015",59,52,7,237209,3167.254,80.32203
"17123","56236","2015",14,14,0,115544.6,1127.857,93.71429
"17124","56237","2015",13,13,0,114153.8,1231,92.69231
"17125","56238","2015",4,4,0,88890,1214.25,73.25
"17126","56239","2015",14,14,0,96161.43,1057.286,89.07143
"17127","56240","2015",183,148,35,238440.3,2850.459,91.22951
"17128","56241","2015",21,18,3,324738.1,3262.81,101.0476
"17129","56242","2015",9,9,0,118638.9,1162.778,100.7778
"17130","56243","2015",118,92,26,217973.8,2370.746,90.13559
"17131","56244","2015",26,26,0,119232.3,1335.769,91.92308
"17132","56245","2015",7,7,0,70714.29,780.2857,91.57143
"17133","56246","2015",13,13,0,99385,1040.308,95.15385
"17134","56247","2015",36,36,0,181900,1866.833,102.25
"17135","56248","2015",41,39,2,199976.2,1810.707,114.2927
"17136","56249","2015",18,17,1,91060.28,1019.833,92.83333
"17137","56250","2015",6,6,0,116966.7,1021,106.8333
"17138","56251","2015",64,60,4,209326,1992.906,105.8125
"17139","56252","2015",29,28,1,225996,2199.138,106.8966
"17140","56253","2015",6,6,0,90498.33,1163.333,72.66667
"17141","56254","2015",12,12,0,171540.8,1604.25,111.1667
"17142","56255","2015",22,21,1,179409.1,1684.818,109.3182
"17143","56257","2015",8,8,0,52161.62,647.75,83.5
"17144","56258","2015",35,20,15,290739.7,3703.514,84.48571
"17145","56259","2015",1,0,1,90000,2647,34
"17146","56260","2015",899,270,629,166030.9,2252.189,72.31591
"17147","56261","2015",14,14,0,143961.1,1380.214,104.7857
"17148","56262","2015",25,24,1,223027,2135.56,107.76
"17149","56263","2015",32,27,5,182948.8,1825.656,98.125
"17150","56264","2015",2,2,0,153250,1985.5,69
"17151","58001","2015",4,4,0,124500,1281.25,80.5
"17152","58002","2015",16,16,0,92664.19,1020.188,90.875
"17153","58003","2015",7,7,0,105497.1,1505.714,74.71429
"17154","58004","2015",4,4,0,70750,795.25,90.25
"17155","58005","2015",3,3,0,57333.33,577,104
"17156","58006","2015",3,3,0,181666.7,1058,168.6667
"17157","58007","2015",6,6,0,101195,1194,118.6667
"17158","58008","2015",6,6,0,53166.67,657.6667,80.16667
"17159","58009","2015",1,1,0,56700,691,82
"17160","58010","2015",6,5,1,67966.67,1135.833,68.83333
"17161","58011","2015",3,3,0,49333.33,824,61
"17162","58012","2015",8,8,0,97875,1231.875,81.375
"17163","58013","2015",3,3,0,58000,530.3333,116.3333
"17164","58014","2015",1,1,0,23000,489,47
"17165","58015","2015",2,2,0,49500,532,92
"17166","58020","2015",4,4,0,133000,1205.5,111.25
"17167","58021","2015",1,1,0,68000,1659,41
"17168","58023","2015",1,1,0,65000,774,84
"17169","58024","2015",3,3,0,83500,1102.333,83.33333
"17170","58025","2015",1,1,0,80000,920,87
"17171","58026","2015",1,1,0,72500,967,75
"17172","58030","2015",3,3,0,65333.33,645.6667,100.3333
"17173","58031","2015",5,5,0,90900,1048,81
"17174","58032","2015",7,7,0,65142.86,920.7143,73.85714
"17175","58033","2015",6,6,0,127000,1181.833,108.6667
"17176","58034","2015",2,2,0,99450,1070,92.5
"17177","58035","2015",5,5,0,103300,1101.8,101.6
"17178","58036","2015",7,7,0,84714.29,634.2857,119.8571
"17179","58037","2015",14,14,0,68110.71,969.8571,78.78571
"17180","58038","2015",3,3,0,81333.33,806.3333,96
"17181","58039","2015",2,2,0,42000,1018.5,39.5
"17182","58040","2015",1,1,0,30114,502,60
"17183","58041","2015",4,4,0,77250,705.25,108
"17184","58042","2015",4,4,0,90000,905.75,113.25
"17185","58043","2015",1,1,0,38000,487,78
"17186","58044","2015",6,6,0,135833.3,1249.333,114.1667
"17187","58045","2015",2,2,0,80285,893,85.5
"17188","58046","2015",20,19,1,67450,843.1,80.45
"17189","58047","2015",11,11,0,88709.09,852.7273,103.0909
"17190","58048","2015",3,3,0,57666.67,666.6667,79
"17191","58049","2015",2,2,0,159900,1452.5,113.5
"17192","58051","2015",15,15,0,130084.4,1512.333,86.33333
"17193","58053","2015",7,7,0,73214.29,725.7143,100.4286
"17194","58054","2015",1,1,0,84000,1400,60
"17195","58055","2015",11,11,0,81954.55,1085,73.45455
"17196","58056","2015",4,4,0,85500,1098,79.5
"17197","58057","2015",16,16,0,80806.25,968.625,85.25
"17198","58058","2015",8,8,0,51437.5,870.125,65.375
"17199","58059","2015",57,48,9,94701,1080.088,88.63158
"17200","58060","2015",8,8,0,65125,814,78.625
"17201","58061","2015",5,5,0,60800,664.2,86.4
"17202","58062","2015",11,10,1,79325.73,833.7273,98.45455
"17203","58063","2015",6,6,0,89500,1117.833,82.66667
"17204","58064","2015",11,11,0,57388.55,573.6364,93.90909
"17205","58065","2015",10,9,1,74275,823.7,94
"17206","58067","2015",16,16,0,161431.9,1271.625,121.6875
"17207","58068","2015",5,5,0,107143,1344.2,76.4
"17208","58069","2015",2,2,0,75500,810,86.5
"17209","58071","2015",2,2,0,27500,450,61
"17210","58072","2015",5,5,0,123800,1136.8,106
"17211","58073","2015",1,1,0,150000,1071,140
"17212","58074","2015",4,4,0,112500,1086.25,109.5
"17213","58075","2015",3,3,0,67000,1250,56.66667
"17214","58077","2015",3,3,0,75000,945,83.66667
"17215","58079","2015",33,31,2,66015.15,778.5152,91.18182
"17216","58080","2015",4,4,0,67752.5,1056.25,80
"17217","58081","2015",4,4,0,61000,860,70.5
"17218","58082","2015",5,5,0,103404.2,1328.8,91.8
"17219","58083","2015",12,12,0,89750,888.1667,102.4167
"17220","58084","2015",3,3,0,35333.33,591,57.66667
"17221","58085","2015",6,6,0,69166.67,748,103.5
"17222","58086","2015",124,107,17,93592.02,1114.323,84.31452
"17223","58087","2015",7,7,0,140057.1,1349.286,95.28571
"17224","58088","2015",44,40,4,109288.1,1198.25,94.25
"17225","58089","2015",3,3,0,60166.67,830,69.66667
"17226","58090","2015",2,2,0,99000,728,157.5
"17227","58092","2015",4,4,0,82250,1133.25,74.5
"17228","58093","2015",3,3,0,146883.3,1560.667,87
"17229","58094","2015",7,7,0,86642.86,1212.429,69.14286
"17230","58095","2015",52,40,12,74597.63,1008.519,73.38462
"17231","58096","2015",4,4,0,117250,1038.75,111
"17232","58098","2015",2,2,0,81000,887.5,88.5
"17233","58099","2015",1,1,0,24000,545,44
"17234","58101","2015",2,2,0,45720,909,51.5
"17235","58102","2015",11,11,0,85727.27,1051.818,81.90909
"17236","58103","2015",7,7,0,80142.86,789.2857,100.2857
"17237","58104","2015",19,19,0,92000,871.8421,110.8421
"17238","58105","2015",5,5,0,92555.6,1063.2,93.4
"17239","58106","2015",8,8,0,86875,806.5,112.5
"17240","58107","2015",1,1,0,155000,1566,99
"17241","58108","2015",5,5,0,63540,701,90.4
"17242","58109","2015",11,9,2,73909.09,565.6364,116.9091
"17243","58111","2015",1,1,0,90000,1000,90
"17244","58112","2015",6,6,0,112583.3,1314.167,82.83333
"17245","58114","2015",1,1,0,145000,853,170
"17246","58115","2015",2,2,0,120000,879,135
"17247","58116","2015",1,1,0,45000,2812,16
"17248","58117","2015",27,20,7,94228.04,1083.667,88.07407
"17249","58118","2015",7,7,0,75285.71,1058.429,79.14286
"17250","58120","2015",7,7,0,63214.29,739.5714,91.85714
"17251","58121","2015",27,25,2,94953.15,1179.926,76.81481
"17252","58122","2015",6,6,0,53833.33,752.6667,81.33333
"17253","58123","2015",1,1,0,170000,1000,170
"17254","58124","2015",13,12,1,98923.08,1080.846,88.53846
"17255","58125","2015",1,1,0,54000,964,56
"17256","58126","2015",1,1,0,143600,957,150
"17257","58127","2015",4,4,0,70500,751.75,95
"17258","58128","2015",2,2,0,39000,1193,32.5
"17259","58129","2015",3,3,0,90333.33,723.3333,127.6667
"17260","58130","2015",4,4,0,61750,814.75,85.75
"17261","58131","2015",20,20,0,89330,1039.2,89.35
"17262","58132","2015",4,4,0,56400,586.5,98.25
"17263","58133","2015",2,2,0,190500,1183,140
"17264","58134","2015",33,22,11,66043.94,897.6364,72.09091
"17265","58135","2015",3,3,0,106000,965,116.3333
"17266","58136","2015",1,1,0,23000,460,50
"17267","58138","2015",6,6,0,62716.67,705,87
"17268","58139","2015",3,3,0,82666.67,1344.333,66
"17269","58140","2015",6,6,0,82416.67,1326.833,77.5
"17270","58141","2015",3,3,0,77600,1249.667,56
"17271","58142","2015",3,3,0,203833.3,1840.333,100.3333
"17272","58144","2015",4,4,0,95000,997,90
"17273","58145","2015",14,13,1,84585.71,1089.286,74.92857
"17274","58146","2015",11,11,0,66659.09,887.3636,70.45455
"17275","58147","2015",2,2,0,87000,921.5,97
"17276","58148","2015",7,7,0,95500,1255.857,86.57143
"17277","58149","2015",17,16,1,72211.76,892,73.29412
"17278","58150","2015",1,1,0,164200,1263,130
"17279","58151","2015",37,36,1,65358.95,903.8919,70.62162
"17280","58152","2015",9,8,1,156555.6,1315.556,122.4444
"17281","58154","2015",4,4,0,99500,1485.25,71
"17282","58155","2015",4,4,0,106575,1531.75,78
"17283","58156","2015",3,3,0,144166.7,1667.333,94.66667
"17284","58157","2015",1,1,0,217500,809,269
"17285","58158","2015",3,3,0,104000,1273,89.33333
"17286","58159","2015",4,4,0,84687.5,803.75,107.5
"17287","58160","2015",30,29,1,140083,1469.9,97.7
"17288","58161","2015",5,5,0,140800,1154.6,116.8
"17289","58162","2015",1,1,0,34000,400,85
"17290","58163","2015",2,2,0,50000,693,73
"17291","58164","2015",10,10,0,91790,1064.5,86.7
"17292","58166","2015",4,4,0,42000,755,64.75
"17293","58168","2015",5,5,0,36414,671.4,61.4
"17294","58170","2015",1,1,0,70000,875,80
"17295","58171","2015",2,2,0,39000,571,68
"17296","58173","2015",4,3,1,67500,874.5,79
"17297","58174","2015",1,1,0,80000,625,128
"17298","58175","2015",2,2,0,117000,893,125.5
"17299","58176","2015",6,6,0,159833.3,2949.667,121.5
"17300","58177","2015",5,5,0,71273,948.2,70
"17301","58178","2015",3,3,0,68000,703.6667,88
"17302","58179","2015",3,3,0,47833.33,528.3333,88.66667
"17303","58180","2015",11,11,0,85681.82,1561.909,58.90909
"17304","58181","2015",4,4,0,157087.5,1434,134.5
"17305","58182","2015",14,14,0,76117.64,798.4286,90.85714
"17306","58183","2015",2,2,0,37600,606,73
"17307","58184","2015",4,4,0,85000,1893.5,77
"17308","58185","2015",7,7,0,71000,1271.857,63
"17309","58186","2015",1,1,0,72000,774,93
"17310","58187","2015",5,5,0,85800,1197.4,73
"17311","58188","2015",1,1,0,50000,1000,50
"17312","58189","2015",4,4,0,89500,883.5,97.75
"17313","58192","2015",2,2,0,34500,550.5,61
"17314","58193","2015",21,19,2,98288.67,914.0952,110.1905
"17315","58194","2015",338,169,169,88298.3,1038.55,84.01479
"17316","58195","2015",8,8,0,84470,1024.25,92
"17317","58196","2015",6,6,0,76750,748.3333,99.33333
"17318","58197","2015",1,1,0,80000,696,115
"17319","58198","2015",1,1,0,57000,648,88
"17320","58199","2015",5,5,0,80300,816.2,94.8
"17321","58200","2015",2,2,0,61500,674,91.5
"17322","58201","2015",4,4,0,42000,513.25,83.5
"17323","58202","2015",1,1,0,148000,1007,147
"17324","58204","2015",7,7,0,102431.6,1089.714,95.42857
"17325","58205","2015",13,13,0,85497.69,933.1538,91
"17326","58207","2015",12,12,0,107583.3,1148,102.5
"17327","58208","2015",3,3,0,126580,548.3333,208.6667
"17328","58209","2015",2,2,0,84000,639,127.5
"17329","58210","2015",7,7,0,49821.43,1096.429,48.28571
"17330","58211","2015",7,7,0,59142.86,819,79.28571
"17331","58212","2015",7,7,0,79571.43,963.4286,77.85714
"17332","58213","2015",7,7,0,96142.86,1122,90.42857
"17333","58214","2015",28,26,2,121907.1,1218.929,99.71429
"17334","58215","2015",21,19,2,70046.43,764.3333,89.14286
"17335","58216","2015",3,3,0,52666.67,1025,45.33333
"17336","58217","2015",2,2,0,54500,648.5,77
"17337","58218","2015",18,18,0,76155.56,870.5,83.33333
"17338","58219","2015",2,2,0,135000,1077,124
"17339","58220","2015",11,11,0,95039.82,1069.818,90.36364
"17340","58221","2015",1,1,0,50000,347,144
"17341","58222","2015",5,5,0,90600,1018.4,92.8
"17342","58223","2015",5,5,0,94600,928.4,116
"17343","58225","2015",2,1,1,105000,850,120
"17344","58226","2015",1,1,0,90000,938,96
"17345","58227","2015",17,17,0,52794.12,773.6471,70.05882
"17346","58228","2015",10,10,0,83550,1058.2,80.8
"17347","58229","2015",6,6,0,89000,973,91.16667
"17348","58230","2015",3,3,0,41666.67,755.3333,59.66667
"17349","58231","2015",3,3,0,52000,888.6667,59
"17350","58232","2015",11,11,0,119000,866.2727,130
"17351","58233","2015",1,1,0,59000,808,73
"17352","58235","2015",7,7,0,78285.71,1121.571,73.14286
"17353","58236","2015",1,1,0,60000,732,82
"17354","58237","2015",1,1,0,110000,640,172
"17355","58238","2015",17,17,0,152984.1,1344.588,116.0588
"17356","58240","2015",1,1,0,45000,577,78
"17357","58242","2015",1,1,0,45000,900,50
"17358","58243","2015",1,1,0,94000,979,96
"17359","58244","2015",1,1,0,63000,955,66
"17360","58245","2015",3,3,0,52900,780.3333,68.33333
"17361","58246","2015",13,13,0,56038.46,863.0769,67.53846
"17362","58247","2015",4,4,0,121750,1160,109.5
"17363","58248","2015",3,3,0,102333.3,1377.333,87
"17364","58249","2015",5,5,0,122200,1911.6,69
"17365","58250","2015",16,16,0,82250,1006.562,79.375
"17366","58251","2015",2,2,0,71000,1134.5,66.5
"17367","58252","2015",1,1,0,32000,492,65
"17368","58254","2015",6,6,0,118375,1139.667,102.8333
"17369","58255","2015",4,4,0,95500,893.5,101.25
"17370","58256","2015",9,9,0,98085.56,956.1111,101.5556
"17371","58258","2015",3,3,0,112666.7,1154,89.33333
"17372","58259","2015",1,1,0,90000,1071,84
"17373","58260","2015",10,10,0,84500,831.5,111.9
"17374","58261","2015",11,11,0,118090.9,1533.636,87.45455
"17375","58262","2015",4,4,0,50000,697.25,77.5
"17376","58263","2015",3,3,0,87666.67,607.6667,133.6667
"17377","58264","2015",15,15,0,81405.93,1055.667,78.13333
"17378","58266","2015",4,4,0,43300,781.75,67.5
"17379","58267","2015",12,12,0,63416.67,735.75,84.58333
"17380","58268","2015",1,1,0,38000,667,57
"17381","58269","2015",4,4,0,107992.5,1056.25,99.25
"17382","58270","2015",6,6,0,68400,833.6667,83.33333
"17383","58272","2015",1,1,0,250000,1786,140
"17384","58273","2015",13,13,0,121445.3,1212.923,109.4615
"17385","58274","2015",3,3,0,51938.67,661.3333,79
"17386","58275","2015",4,4,0,74750,670.25,109.5
"17387","58276","2015",1,1,0,85000,1133,75
"17388","58277","2015",7,7,0,87928.57,707.5714,117.8571
"17389","58278","2015",14,13,1,120170.4,1429.143,91.71429
"17390","58279","2015",1,1,0,166000,810,205
"17391","58280","2015",2,2,0,63000,911.5,60
"17392","58281","2015",6,6,0,90666.67,944.8333,98.66667
"17393","58282","2015",4,4,0,33750,532.5,67.75
"17394","58284","2015",1,1,0,97500,460,212
"17395","58285","2015",1,1,0,1e+05,901,111
"17396","58286","2015",9,9,0,42550.89,651.4444,66
"17397","58287","2015",3,3,0,83500,1162,80
"17398","58288","2015",1,1,0,30000,556,54
"17399","58289","2015",4,4,0,46837.5,571.5,80.25
"17400","58291","2015",3,3,0,42666.67,835,51
"17401","58292","2015",1,1,0,20000,435,46
"17402","58293","2015",8,8,0,96687.5,1047.875,86.5
"17403","58294","2015",2,2,0,29000,614,49.5
"17404","58295","2015",6,6,0,87500,1088.167,82.16667
"17405","58297","2015",1,1,0,53100,571,93
"17406","58298","2015",3,3,0,125833.3,1095,113.6667
"17407","58299","2015",2,2,0,67500,746,92.5
"17408","58300","2015",13,13,0,114499.2,1184.615,95.53846
"17409","58301","2015",2,2,0,71000,931,72.5
"17410","58302","2015",7,7,0,63500,860.7143,70.85714
"17411","58303","2015",77,68,9,110001.9,1225.584,91.54545
"17412","58304","2015",13,13,0,82398.77,811.5385,98.61538
"17413","58306","2015",2,2,0,92500,954.5,88
"17414","58307","2015",2,2,0,57500,676,75.5
"17415","58308","2015",1,1,0,35000,432,81
"17416","58309","2015",6,6,0,62000,872.6667,68.16667
"17417","58311","2015",5,5,0,69120,760.6,93
"17418","58312","2015",1,1,0,120000,750,160
"17419","58313","2015",2,2,0,138000,1063.5,154
"17420","59001","2015",4,4,0,148500,936,150.25
"17421","59002","2015",51,50,1,121152.2,1319.373,98.31373
"17422","59003","2015",2,2,0,117500,1056,119.5
"17423","59004","2015",6,6,0,284566.7,2170.5,135.3333
"17424","59005","2015",30,30,0,187581,1815.033,103.9667
"17425","59006","2015",2,2,0,257275,1589,183.5
"17426","59007","2015",2,2,0,103500,1556,64.5
"17427","59008","2015",76,76,0,97381.84,1044.25,95.57895
"17428","59009","2015",624,394,230,209974.5,3135.242,81.04006
"17429","59010","2015",5,5,0,112000,1098.4,123.2
"17430","59011","2015",97,90,7,177349.8,1818.66,100.5258
"17431","59012","2015",30,30,0,116832.2,1023.567,117.4667
"17432","59013","2015",9,9,0,245454.4,2105.333,111.8889
"17433","59014","2015",123,112,11,88010.28,1007.715,89.49593
"17434","59015","2015",26,25,1,128206.9,1494.731,90.26923
"17435","59016","2015",19,19,0,155630,1795.474,87.21053
"17436","59017","2015",339,273,66,127023,1586.994,82.51327
"17437","59018","2015",20,18,2,159296.5,1778.85,101.05
"17438","59019","2015",13,13,0,158829.5,2033,87.46154
"17439","59021","2015",11,11,0,129909.1,1378.091,96.18182
"17440","59022","2015",19,19,0,262010.5,2165.579,123.4211
"17441","59023","2015",3,3,0,140370,1230.333,110
"17442","59024","2015",47,47,0,112724.5,1316.489,86.74468
"17443","59025","2015",17,15,2,213505.9,1987.176,111.2941
"17444","59026","2015",13,13,0,149069.2,1356,110.2308
"17445","59027","2015",13,13,0,164473.1,1691.923,100.3846
"17446","59028","2015",58,58,0,116215.5,1259.207,92.84483
"17447","59029","2015",18,18,0,270647.3,2051.722,130.1111
"17448","59031","2015",3,3,0,215666.7,1625.333,128.6667
"17449","59032","2015",55,53,2,119143.1,1390.382,85.61818
"17450","59033","2015",58,58,0,98074.31,1141.586,84.5
"17451","59034","2015",34,31,3,228509.1,2314.824,103.6765
"17452","59035","2015",27,27,0,107651.9,983.7407,110.6667
"17453","59036","2015",25,24,1,101320,1242.32,96.76
"17454","59037","2015",44,44,0,82981.82,1007.591,83.45455
"17455","59038","2015",16,16,0,119152.8,1205.625,98.4375
"17456","59039","2015",11,11,0,223990.9,2199.091,126.3636
"17457","59041","2015",12,12,0,112333.3,1194.083,97.08333
"17458","59042","2015",16,16,0,250406.2,2076.312,124.0625
"17459","59043","2015",136,116,20,177765.5,1910.669,96.33824
"17460","59044","2015",49,49,0,225260.3,2316.98,99.22449
"17461","59045","2015",4,4,0,104375,1042.5,98.25
"17462","59046","2015",6,6,0,203404.2,1844.667,109
"17463","59047","2015",2,2,0,57500,797.5,76.5
"17464","59048","2015",3,3,0,139750,1022,128.6667
"17465","59049","2015",6,6,0,108500,1082.167,103.1667
"17466","59050","2015",4,4,0,185562.5,1288.5,142.5
"17467","59051","2015",57,54,3,137287.9,1623.491,86.87719
"17468","59052","2015",50,50,0,146419.5,1624.44,92
"17469","59053","2015",26,25,1,113871.8,1385.5,90.5
"17470","59054","2015",12,12,0,118525,1418.167,88.16667
"17471","59055","2015",4,4,0,84500,901.5,103.75
"17472","59056","2015",5,5,0,221100,2275.4,97.4
"17473","59057","2015",10,10,0,127120,1722.5,81
"17474","59058","2015",8,8,0,130446.1,1382.5,97.5
"17475","59059","2015",2,2,0,65500,701,92.5
"17476","59060","2015",1,1,0,135000,1421,95
"17477","59061","2015",3,3,0,183150,1377.333,137.3333
"17478","59062","2015",5,5,0,99600,1217.2,88.8
"17479","59063","2015",19,19,0,81655.26,788.7895,104.7895
"17480","59064","2015",6,6,0,109000,1286.333,84.16667
"17481","59065","2015",6,6,0,105416.7,934,111.6667
"17482","59066","2015",2,2,0,95000,834.5,134.5
"17483","59067","2015",36,25,11,167926.4,1849.139,92.27778
"17484","59068","2015",32,31,1,111970.2,1147.969,94.3125
"17485","59069","2015",9,9,0,165273.3,1585.667,108.4444
"17486","59070","2015",2,2,0,101500,914.5,101.5
"17487","59071","2015",23,23,0,253277.9,2294.217,112.4783
"17488","59072","2015",2,2,0,120000,1331,90
"17489","59073","2015",6,6,0,175316.7,1871.5,96.66667
"17490","59074","2015",25,25,0,116852,992.48,109.08
"17491","59075","2015",10,10,0,66800,744.2,89
"17492","59076","2015",1,1,0,90000,938,96
"17493","59077","2015",1,1,0,45000,450,100
"17494","59078","2015",8,8,0,115896.6,924.25,125.5
"17495","59079","2015",41,38,3,98145.12,1105.415,90
"17496","59080","2015",23,23,0,198702.2,2040,97.30435
"17497","59081","2015",3,3,0,130000,974,132.3333
"17498","59082","2015",15,15,0,196006,1980.933,99.13333
"17499","59083","2015",1,1,0,305000,2179,140
"17500","59084","2015",15,15,0,144353.3,1526.4,92.06667
"17501","59085","2015",3,3,0,178333.3,1326,132.3333
"17502","59086","2015",29,28,1,162962.1,1957.552,86.58621
"17503","59087","2015",10,10,0,155661,1525.1,104.8
"17504","59088","2015",14,14,0,277142.9,2149.929,126.9286
"17505","59089","2015",8,8,0,137825,1689,87.625
"17506","59090","2015",160,150,10,411188.5,3180.162,127.0938
"17507","59091","2015",5,5,0,218600,1960.2,112.4
"17508","59092","2015",35,35,0,124643.4,1366.943,92.08571
"17509","59094","2015",46,44,2,125309.6,1330.413,96.82609
"17510","59096","2015",8,8,0,318837.5,2505.625,141.375
"17511","59097","2015",1,1,0,132000,1100,120
"17512","59098","2015",56,53,3,208788.4,2036.179,103.9821
"17513","59099","2015",18,18,0,103540.6,924.4444,113.2778
"17514","59100","2015",5,5,0,261060,2449.6,108.4
"17515","59101","2015",2,2,0,157500,2064.5,77.5
"17516","59102","2015",4,4,0,86750,771.75,120.75
"17517","59103","2015",4,4,0,140125,1408,90.75
"17518","59104","2015",28,28,0,97911.43,1046.179,93.07143
"17519","59105","2015",19,15,4,169074.6,1736.211,94.84211
"17520","59106","2015",3,2,1,285196.7,2232,115.6667
"17521","59107","2015",115,60,55,149219.1,2428.052,70.36522
"17522","59108","2015",2,2,0,96750,822.5,117.5
"17523","59109","2015",9,9,0,224833.3,2058.111,118.1111
"17524","59110","2015",10,10,0,161490,1529.4,106.5
"17525","59111","2015",4,4,0,159375,1304.25,120.25
"17526","59112","2015",70,70,0,105359.8,1187.914,90.78571
"17527","59113","2015",11,11,0,131927.5,1343.455,103.2727
"17528","59114","2015",18,17,1,190091.7,1939.889,106.8889
"17529","59115","2015",5,5,0,160070,1795,94.4
"17530","59116","2015",1,1,0,350000,2134,164
"17531","59117","2015",8,8,0,85468.5,1044.5,92.5
"17532","59118","2015",25,24,1,100668.3,970.56,104.88
"17533","59119","2015",7,7,0,157442.9,1504.286,105.4286
"17534","59120","2015",21,21,0,173323.8,1502.619,119.8095
"17535","59121","2015",6,6,0,136090.5,1177.833,109.5
"17536","59122","2015",364,269,95,116095.2,1307.852,93.23352
"17537","59123","2015",19,18,1,163073.7,1833.474,95.84211
"17538","59124","2015",17,17,0,296418.4,2437.471,121.2941
"17539","59126","2015",6,6,0,192666.7,1415.833,136.3333
"17540","59128","2015",18,15,3,236669.2,2368.5,97.44444
"17541","59129","2015",28,28,0,238048.2,1989.107,119.7857
"17542","59130","2015",14,14,0,183271.4,1418.643,132
"17543","59131","2015",72,72,0,147110.6,1574.375,96.22222
"17544","59132","2015",8,8,0,122225,1177.125,108.875
"17545","59133","2015",6,6,0,268683.3,1839.167,145
"17546","59134","2015",5,5,0,103980,1206.2,83.2
"17547","59135","2015",22,22,0,135675.9,1407.455,102.8182
"17548","59136","2015",73,73,0,78341.78,877.4384,91.15068
"17549","59137","2015",6,6,0,103000,1085.833,92.5
"17550","59138","2015",7,7,0,107700,1114.429,104.1429
"17551","59139","2015",134,124,10,80388.58,960.4701,85.54478
"17552","59140","2015",3,3,0,97333.33,825.6667,118.6667
"17553","59141","2015",8,8,0,130834,1278.75,102.125
"17554","59142","2015",6,6,0,119413.3,1302.5,98.83333
"17555","59143","2015",85,84,1,194956.2,1995.494,97.68235
"17556","59144","2015",8,8,0,217186.2,1639.875,147.875
"17557","59145","2015",3,3,0,181666.7,2175.667,83.33333
"17558","59146","2015",39,35,4,266878.7,2552.59,104.0256
"17559","59147","2015",1,1,0,50000,1000,50
"17560","59148","2015",5,5,0,146773.2,962.2,148
"17561","59149","2015",14,14,0,105392.9,1131.214,97.5
"17562","59150","2015",3,3,0,400666.7,2505,160.3333
"17563","59151","2015",16,16,0,91499.94,1016.812,87.0625
"17564","59152","2015",134,129,5,184751.3,1929.328,99.10448
"17565","59153","2015",40,37,3,97031,1087.1,91.925
"17566","59155","2015",198,185,13,133905,1517.712,90.06566
"17567","59156","2015",45,28,17,128506.4,1662.267,81.66667
"17568","59157","2015",15,15,0,101164,1094.4,81.33333
"17569","59158","2015",31,31,0,219168.1,1951.032,117.0645
"17570","59159","2015",3,2,1,176666.7,3144,74.66667
"17571","59160","2015",30,30,0,86383.8,1132.7,80.53333
"17572","59161","2015",6,6,0,155583.3,1536.833,102.8333
"17573","59162","2015",4,4,0,200587.5,1866.75,111
"17574","59163","2015",310,235,75,186461.1,2092.958,86.6129
"17575","59164","2015",2,2,0,133000,1405,93.5
"17576","59165","2015",61,61,0,160940.5,1700.689,93.77049
"17577","59166","2015",12,12,0,127591.7,1197.417,110.8333
"17578","59167","2015",4,4,0,86425,1103.25,84
"17579","59170","2015",40,40,0,103993.5,1358.45,82.65
"17580","59171","2015",1,1,0,106680,773,138
"17581","59172","2015",168,164,4,71789.26,896.494,82.17262
"17582","59173","2015",24,23,1,222362.5,2032.25,103.875
"17583","59174","2015",2,2,0,146250,1278.5,122
"17584","59175","2015",3,3,0,169644.3,1330.667,128
"17585","59176","2015",3,3,0,72133.33,851.6667,85
"17586","59177","2015",5,5,0,126040,1098,139.2
"17587","59178","2015",342,197,145,125186.4,1570.193,84.07602
"17588","59179","2015",64,64,0,110384.9,1207.562,92.73438
"17589","59180","2015",19,19,0,235536.8,1976.895,120.5789
"17590","59181","2015",5,5,0,107786,1144.6,94.4
"17591","59182","2015",1,1,0,80500,2368,34
"17592","59183","2015",839,555,284,138429.2,1615.881,88.1907
"17593","59184","2015",4,4,0,119617.5,857,141
"17594","59185","2015",8,8,0,126812.5,1332.375,95.625
"17595","59187","2015",5,5,0,153820,1470,111.6
"17596","59188","2015",5,5,0,157600,1504.6,103.2
"17597","59189","2015",15,15,0,172453.3,1458.6,122.4
"17598","59190","2015",11,11,0,155727.3,1538.273,101.2727
"17599","59191","2015",7,7,0,70785.71,801,86.71429
"17600","59192","2015",8,7,1,128500,1276.25,99.5
"17601","59193","2015",35,34,1,203936.7,2156.743,98.54286
"17602","59194","2015",12,12,0,119550,1171.417,105
"17603","59195","2015",5,5,0,420780,2931.6,132.8
"17604","59196","2015",10,10,0,359480,2794.7,125.9
"17605","59197","2015",21,21,0,229347.9,2280.19,103.9048
"17606","59198","2015",3,3,0,107833.3,1023.667,140.3333
"17607","59199","2015",5,5,0,121400,1313.6,92.8
"17608","59200","2015",9,9,0,122977.9,1107.444,111.7778
"17609","59201","2015",6,6,0,283150,2081.667,122.3333
"17610","59202","2015",56,51,5,174388.9,1974.857,90.32143
"17611","59203","2015",16,16,0,136562.5,1373.75,106.5
"17612","59204","2015",4,4,0,134500,1314.5,109.75
"17613","59205","2015",60,58,2,93088.83,1163.233,82.46667
"17614","59206","2015",31,31,0,113996.8,1125.774,100.871
"17615","59207","2015",16,16,0,115309.4,1345.062,86.125
"17616","59208","2015",1,1,0,410000,2455,167
"17617","59209","2015",7,7,0,130485.7,1074.571,119.8571
"17618","59210","2015",16,16,0,132461.9,1378.812,102.75
"17619","59211","2015",12,12,0,156795.8,1677.917,91.33333
"17620","59212","2015",76,71,5,140626.3,1507.697,95.46053
"17621","59213","2015",3,3,0,106000,1227,87
"17622","59214","2015",10,10,0,122990,1435.9,88.2
"17623","59215","2015",7,7,0,234962.9,1870.714,125.5714
"17624","59216","2015",1,1,0,204000,1489,137
"17625","59217","2015",3,3,0,264000,1957.333,136
"17626","59218","2015",11,11,0,93272.73,956.9091,102.9091
"17627","59219","2015",7,7,0,156378.7,1270,123.8571
"17628","59220","2015",237,205,32,167492.3,2024.468,82.78481
"17629","59221","2015",19,13,6,149580,1734.263,88.26316
"17630","59222","2015",26,26,0,203341.9,1828.538,111.8462
"17631","59223","2015",7,7,0,137560,1713.286,79.71429
"17632","59224","2015",18,18,0,150528.3,1459.778,115.5
"17633","59225","2015",49,49,0,113097.7,1213.49,91.4898
"17634","59226","2015",8,8,0,122768.8,1387.375,89.875
"17635","59227","2015",66,66,0,118667.4,1389.53,88.42424
"17636","59228","2015",12,12,0,170387,1506.583,111.8333
"17637","59229","2015",3,3,0,173043,1262,139.3333
"17638","59230","2015",49,46,3,117029.8,1230.429,105.7143
"17639","59231","2015",8,8,0,115485,1230,100.75
"17640","59232","2015",4,4,0,95675,1065.5,84
"17641","59233","2015",2,2,0,75000,678.5,106.5
"17642","59234","2015",45,45,0,121118.3,1478.356,87.37778
"17643","59237","2015",10,10,0,218405,1718.2,114.8
"17644","59238","2015",19,19,0,127424.2,1485.632,88.21053
"17645","59239","2015",59,59,0,164265.9,1643,102.0847
"17646","59240","2015",3,3,0,165166.7,1325.667,136.6667
"17647","59241","2015",5,5,0,98800,899.6,111.2
"17648","59242","2015",6,5,1,106166.7,1166.167,90.66667
"17649","59243","2015",13,13,0,87908.46,1036.077,95.23077
"17650","59244","2015",13,13,0,150175.4,1486.231,105.8462
"17651","59246","2015",5,5,0,78000,779.6,100
"17652","59247","2015",17,16,1,183640.7,2061.706,88.35294
"17653","59249","2015",77,71,6,75314.45,846.4935,90.02597
"17654","59250","2015",23,22,1,215626.4,2100,103.5217
"17655","59251","2015",1,1,0,223000,1991,112
"17656","59252","2015",31,31,0,232993.6,2285.226,106.1935
"17657","59253","2015",60,60,0,93728.17,1121.767,85.75
"17658","59254","2015",5,5,0,158130,1549.4,103
"17659","59255","2015",5,5,0,126196,1233.8,101.4
"17660","59256","2015",46,44,2,215337.1,2366.543,95.45652
"17661","59257","2015",14,14,0,236003.6,2130.357,116.5
"17662","59258","2015",26,26,0,235334.6,2166.615,109.0385
"17663","59259","2015",7,7,0,158928.6,1368,116.8571
"17664","59260","2015",37,37,0,195773.5,1923.649,104.7838
"17665","59261","2015",12,12,0,87541.67,888.9167,97.33333
"17666","59262","2015",17,17,0,174351.4,1575.176,114.2353
"17667","59263","2015",7,7,0,111271.4,1084.143,103.8571
"17668","59264","2015",6,6,0,147565.2,1053.333,151.5
"17669","59265","2015",26,26,0,175832,1338.808,133.1538
"17670","59266","2015",47,46,1,199496.6,2047.298,101.1064
"17671","59267","2015",5,5,0,71200,872,83.4
"17672","59268","2015",59,58,1,145194.3,1535.78,98.28814
"17673","59269","2015",12,12,0,121958.3,1270,95.58333
"17674","59270","2015",3,3,0,76666.67,799.3333,100.6667
"17675","59271","2015",97,91,6,124389.9,1330.608,95.02062
"17676","59272","2015",43,42,1,117889,1571.186,78.27907
"17677","59273","2015",80,76,4,144667.9,1541.037,95.6625
"17678","59274","2015",8,8,0,110887.5,988.25,115.875
"17679","59275","2015",14,14,0,339256.4,2693.714,119.5714
"17680","59276","2015",24,23,1,147148.1,1337.125,109
"17681","59277","2015",2,2,0,123500,1560.5,84
"17682","59278","2015",50,48,2,192086.5,2072.1,97.22
"17683","59279","2015",267,245,22,167071.2,1858.094,92.42322
"17684","59280","2015",9,9,0,181105.6,1503.667,114.1111
"17685","59281","2015",16,16,0,195886.9,1832.438,108.6875
"17686","59282","2015",3,3,0,310400,2076.667,150
"17687","59283","2015",4,4,0,171010,1792.5,94.5
"17688","59284","2015",44,44,0,166881.4,1635.977,108.8409
"17689","59285","2015",25,25,0,93825.76,1082.88,87.48
"17690","59286","2015",181,146,35,153404.3,1893.503,83.20994
"17691","59287","2015",2,2,0,145000,776,190.5
"17692","59288","2015",25,25,0,116302.4,1164.56,100.2
"17693","59289","2015",9,9,0,105166.7,1042,103.6667
"17694","59290","2015",3,3,0,126783.3,1198.667,105
"17695","59291","2015",112,110,2,90693.08,953.4018,95.58036
"17696","59292","2015",17,17,0,106620,1292.118,87.05882
"17697","59293","2015",20,20,0,134925,1352.55,98.95
"17698","59294","2015",3,3,0,129000,1317,106.3333
"17699","59295","2015",191,163,28,142861.3,1671.429,89.94241
"17700","59296","2015",1,1,0,166500,1914,87
"17701","59297","2015",8,8,0,123000,1532.75,76.5
"17702","59299","2015",180,173,7,228981,2202.5,101.4278
"17703","59300","2015",7,7,0,128114.3,1290,101.1429
"17704","59301","2015",47,47,0,138461.3,1444.553,97.40426
"17705","59302","2015",28,28,0,118857.7,1330.357,87.5
"17706","59303","2015",28,28,0,225627.5,2209.036,102.7857
"17707","59304","2015",3,3,0,203666.7,2101.667,91.33333
"17708","59305","2015",19,19,0,158891.2,1566.211,104.2105
"17709","59306","2015",2,2,0,114265,947,120.5
"17710","59307","2015",8,8,0,131062.5,1371.5,97.5
"17711","59308","2015",12,12,0,180745,1655.5,108.3333
"17712","59309","2015",37,37,0,166458.1,1485.514,115.973
"17713","59310","2015",5,5,0,202120,1564.6,128.6
"17714","59311","2015",4,4,0,135250,1106.5,125.75
"17715","59312","2015",8,8,0,128000,1174.625,109.75
"17716","59313","2015",12,12,0,100162.5,1271.583,80.75
"17717","59314","2015",23,23,0,154255.7,1500.348,104.7391
"17718","59315","2015",6,6,0,110283.3,1255,87.16667
"17719","59316","2015",36,36,0,236181.9,2060.889,113.25
"17720","59317","2015",97,97,0,141428.1,1785.505,78.79381
"17721","59318","2015",11,11,0,150659.1,1487.364,102.2727
"17722","59319","2015",28,28,0,191747.9,1751.75,110.5357
"17723","59320","2015",12,12,0,194394.2,1839.667,110
"17724","59321","2015",5,5,0,48160,479.8,97.6
"17725","59322","2015",31,28,3,108920.4,1242.452,89.29032
"17726","59323","2015",11,11,0,155936.4,1358.727,109.7273
"17727","59324","2015",100,97,3,89277.51,1047.59,86.31
"17728","59325","2015",7,7,0,132714.3,1189,112.4286
"17729","59326","2015",9,9,0,162055.6,1364.222,128.1111
"17730","59327","2015",44,44,0,132428.4,1385.023,95.29545
"17731","59328","2015",489,323,166,226441.4,2597.344,86.63599
"17732","59329","2015",39,36,3,129762.7,1535.385,85.35897
"17733","59330","2015",20,20,0,228803.5,2122.75,110.95
"17734","59331","2015",31,30,1,100345.2,1061.968,95.19355
"17735","59332","2015",32,17,15,147564.7,1618.781,88.46875
"17736","59334","2015",14,13,1,141057.1,1465.786,97.14286
"17737","59335","2015",34,32,2,207051.4,1800.882,116.7059
"17738","59336","2015",15,15,0,108495.3,1263.133,84.66667
"17739","59337","2015",6,6,0,148266.7,1456.667,112.5
"17740","59338","2015",4,4,0,143525,2368,61.5
"17741","59339","2015",92,91,1,193620.2,2081.989,94.53261
"17742","59340","2015",43,40,3,171887.1,1780.628,94.93023
"17743","59341","2015",2,2,0,107000,1444,74.5
"17744","59342","2015",2,2,0,99000,1199,78.5
"17745","59343","2015",83,76,7,217395.7,2349.663,94.08434
"17746","59344","2015",26,26,0,93792.31,1070.923,86.92308
"17747","59345","2015",19,19,0,125085.9,1310.263,96.36842
"17748","59346","2015",42,42,0,192221,2229.238,86.40476
"17749","59347","2015",7,7,0,84690,1099.143,75
"17750","59348","2015",16,16,0,139806.2,1534.375,91.3125
"17751","59349","2015",13,13,0,118115.4,1139.154,102.6923
"17752","59350","2015",3538,1039,2499,167649.6,2729.545,65.67524
"17753","59351","2015",5,5,0,126400,1454.8,87
"17754","59352","2015",117,94,23,223092.3,2337.906,93.73504
"17755","59353","2015",4,4,0,103114.2,982.25,105
"17756","59354","2015",9,9,0,179665.7,1930.889,103.2222
"17757","59356","2015",26,26,0,324133,2717.269,118.6154
"17758","59357","2015",20,20,0,136909.5,1260.2,119.15
"17759","59358","2015",6,6,0,114368.3,1495,78.5
"17760","59359","2015",41,40,1,168428.4,1746.683,98.82927
"17761","59360","2015",280,190,90,140642.4,1973.064,74.53214
"17762","59361","2015",15,15,0,106298.7,1121.933,97.2
"17763","59363","2015",12,12,0,143514.7,1401.667,99.5
"17764","59364","2015",8,8,0,226262.5,2467.125,91
"17765","59365","2015",48,47,1,70633.88,908.8958,80.20833
"17766","59366","2015",6,6,0,123758.3,1230.333,96.66667
"17767","59367","2015",158,140,18,178783.7,2071.563,87.38608
"17768","59368","2015",410,153,257,182704.2,2396.785,76.80244
"17769","59369","2015",41,37,4,124346.6,1233.634,105.3415
"17770","59370","2015",6,6,0,151333.3,1288,114
"17771","59371","2015",4,4,0,275250,2288.25,120.75
"17772","59372","2015",7,7,0,98350,850.4286,118.8571
"17773","59374","2015",5,5,0,114600,1110.4,101.6
"17774","59375","2015",70,69,1,146563.5,1599.171,93.87143
"17775","59377","2015",15,15,0,144437.3,1220.2,115.3333
"17776","59378","2015",615,373,242,277806.2,2842.676,94.72358
"17777","59379","2015",8,8,0,126461.5,1410.125,94
"17778","59381","2015",7,7,0,182184,1773.714,115.5714
"17779","59382","2015",19,19,0,96773.68,892.4211,113.1053
"17780","59383","2015",122,116,6,116447.7,1378.164,86.13115
"17781","59384","2015",10,9,1,137235,1541.7,99.4
"17782","59385","2015",27,27,0,91826.81,1018.037,89.66667
"17783","59386","2015",125,120,5,205039.4,2424.648,85.384
"17784","59387","2015",8,8,0,121336.6,1130.875,97.375
"17785","59388","2015",21,21,0,212819,1938.476,110.9048
"17786","59389","2015",29,29,0,109234.7,1121.448,95.48276
"17787","59390","2015",20,20,0,110705,1265.7,88.55
"17788","59391","2015",4,4,0,133431.2,1474.75,93.25
"17789","59392","2015",248,193,55,93048.85,1057.548,90.4879
"17790","59393","2015",10,10,0,195800,1756.8,109.1
"17791","59394","2015",6,6,0,119333.3,1020,126.8333
"17792","59395","2015",8,8,0,139437.5,1324.375,107.25
"17793","59396","2015",6,6,0,138500,1252,111.1667
"17794","59397","2015",4,4,0,131875,1695,79.25
"17795","59398","2015",33,32,1,343416.5,3006.121,127.8485
"17796","59399","2015",5,5,0,197200,1569.8,125.4
"17797","59400","2015",104,103,1,134032.5,1469.731,94.36538
"17798","59401","2015",21,21,0,167159.7,1753.238,97.09524
"17799","59402","2015",13,13,0,142192.3,1402.077,104.5385
"17800","59403","2015",8,8,0,177217.4,1658.625,110.375
"17801","59405","2015",2,2,0,115500,1582.5,76
"17802","59406","2015",3,3,0,57666.67,656,85.66667
"17803","59407","2015",2,2,0,151500,1378,111
"17804","59408","2015",19,19,0,232541.2,2073.211,113.2632
"17805","59409","2015",17,17,0,110991.2,1134.412,100.4118
"17806","59410","2015",207,127,80,160874.3,1966.401,79.57971
"17807","59411","2015",24,24,0,203163.5,1903.583,112.0833
"17808","59412","2015",3,3,0,94000,792.6667,114.6667
"17809","59413","2015",8,8,0,99874.5,1189.75,83.75
"17810","59414","2015",27,26,1,142205.6,1712.481,86.2963
"17811","59415","2015",5,5,0,188700,1435,130
"17812","59416","2015",20,20,0,156052,1599.05,101
"17813","59418","2015",14,14,0,156863.9,1435.357,122.1429
"17814","59419","2015",7,7,0,209993.3,1601.571,131.8571
"17815","59420","2015",1,1,0,170000,1269,134
"17816","59421","2015",210,169,41,264844.1,2594.881,98.88571
"17817","59422","2015",4,4,0,138813.5,1522.75,90.25
"17818","59423","2015",9,9,0,141344.4,1726.556,85.55556
"17819","59424","2015",8,6,2,99043.75,850.125,116.625
"17820","59425","2015",3,3,0,145266.7,1208,127
"17821","59426","2015",118,114,4,213489.1,2165.093,100.6441
"17822","59427","2015",6,6,0,322916.7,2769.5,130.8333
"17823","59428","2015",35,35,0,109455.4,1166.8,94.65714
"17824","59429","2015",30,30,0,96950.83,1117.767,86.8
"17825","59430","2015",10,10,0,87700,901.2,94.8
"17826","59431","2015",86,84,2,195043.7,1893.756,104.0465
"17827","59432","2015",7,5,2,80285.71,1050,86.28571
"17828","59433","2015",4,4,0,141375,1310.25,109
"17829","59434","2015",15,15,0,178830,1661.2,98.66667
"17830","59435","2015",27,27,0,224178.9,2134.556,109.963
"17831","59436","2015",11,11,0,145653.3,1347.091,108.5455
"17832","59437","2015",9,9,0,266944.6,1946.444,134.4444
"17833","59438","2015",5,5,0,133400,1306.6,95
"17834","59440","2015",6,6,0,138100,1218.333,109.1667
"17835","59441","2015",4,4,0,183750,1200.5,151.25
"17836","59442","2015",1,1,0,45000,1500,30
"17837","59443","2015",5,5,0,169210,1584.6,113.8
"17838","59444","2015",8,8,0,148787.5,1208.75,120.25
"17839","59445","2015",14,13,1,117646.4,1175.5,102.3571
"17840","59446","2015",9,8,1,145629,1523.222,101.8889
"17841","59447","2015",64,64,0,127500.8,1428.406,91.95312
"17842","59448","2015",4,4,0,175275,1220.5,155.5
"17843","59449","2015",82,74,8,165083.8,1941.61,89.35366
"17844","59450","2015",2,2,0,102500,806,126
"17845","59451","2015",5,5,0,202591,1654.6,124.4
"17846","59452","2015",33,31,2,137527.6,1363.303,103.2424
"17847","59453","2015",9,9,0,167867.8,1767.889,98.88889
"17848","59454","2015",3,3,0,162666.7,1394.667,118
"17849","59455","2015",9,9,0,107633.3,1168.556,99.11111
"17850","59456","2015",29,29,0,150106.9,1483.69,103.069
"17851","59457","2015",111,94,17,169696.9,2016.757,86.51351
"17852","59458","2015",7,7,0,309842.9,2915.857,109.5714
"17853","59459","2015",34,33,1,135567.1,1410.118,97.11765
"17854","59461","2015",1,1,0,141000,1567,90
"17855","59462","2015",59,50,9,201249.7,2055.305,100.661
"17856","59463","2015",8,8,0,185812.5,1625.875,109.5
"17857","59464","2015",12,12,0,111083.3,1156,92.66667
"17858","59465","2015",6,6,0,114500,1230.5,94.5
"17859","59466","2015",30,27,3,199112,2210.733,92.3
"17860","59467","2015",33,32,1,101148.5,1172.364,88.39394
"17861","59468","2015",3,3,0,199543.3,1377,155.3333
"17862","59469","2015",3,3,0,235500,2167,109.6667
"17863","59470","2015",26,26,0,266333.7,2444.885,106.3846
"17864","59471","2015",22,21,1,162470.9,1595,102.5
"17865","59472","2015",11,11,0,124187.5,1102.455,107.5455
"17866","59473","2015",2,2,0,228819,1774,126.5
"17867","59474","2015",6,6,0,115166.7,1066.833,109.8333
"17868","59475","2015",16,16,0,102787.5,1259.062,81.0625
"17869","59476","2015",26,25,1,140042.3,1441.269,99.5
"17870","59477","2015",36,36,0,155258.1,1727.306,90
"17871","59478","2015",10,10,0,163710,1592.6,106.4
"17872","59479","2015",21,21,0,118615,1368.476,87.90476
"17873","59480","2015",7,6,1,210128.6,2354.429,104.8571
"17874","59481","2015",55,54,1,126572.6,1395.073,92.29091
"17875","59482","2015",69,66,3,226560.5,2196.435,101.4783
"17876","59483","2015",2,2,0,152500,1069.5,150
"17877","59484","2015",26,26,0,96503.85,1154.769,89.15385
"17878","59485","2015",18,18,0,96038.89,884.8333,108
"17879","59486","2015",33,33,0,129224.8,1430.939,91.54545
"17880","59487","2015",10,9,1,256180,2459.8,118.3
"17881","59488","2015",14,14,0,115139.1,1410.214,82.21429
"17882","59489","2015",50,50,0,160404.7,1576.5,107.84
"17883","59490","2015",3,3,0,89333.33,1096,73
"17884","59491","2015",90,89,1,107141.8,1266.6,84.61111
"17885","59492","2015",6,6,0,70966.67,840.1667,80.16667
"17886","59493","2015",2,2,0,92500,978.5,93.5
"17887","59494","2015",4,4,0,132875,1274,104.75
"17888","59495","2015",26,26,0,95489.23,1085.577,86.73077
"17889","59496","2015",2,2,0,140879,1271,116.5
"17890","59497","2015",19,19,0,114296.1,1340.211,91.26316
"17891","59498","2015",5,5,0,89800,1066.2,82.6
"17892","59499","2015",19,19,0,177629,1777.158,103.6316
"17893","59500","2015",1,1,0,110000,1222,90
"17894","59501","2015",11,11,0,159618.2,1433.182,111
"17895","59502","2015",8,8,0,98131.25,1290.625,78.375
"17896","59504","2015",23,23,0,101784.8,1184.957,89.13043
"17897","59505","2015",6,6,0,187866.7,1422.833,135.6667
"17898","59506","2015",2,2,0,120000,821.5,150
"17899","59507","2015",224,177,47,171464.5,2002.33,86.26786
"17900","59508","2015",180,169,11,216669.6,2236.406,95.66111
"17901","59509","2015",35,34,1,157637.7,1606.486,102
"17902","59511","2015",21,21,0,217969.9,1865.619,117.3333
"17903","59512","2015",652,500,152,126396.4,1424.655,90.34356
"17904","59513","2015",2,2,0,213000,1719,122.5
"17905","59514","2015",57,54,3,113922,1266.544,91.01754
"17906","59515","2015",6,6,0,117166.7,1109.667,106.5
"17907","59516","2015",11,11,0,157331.8,1554.455,109.6364
"17908","59517","2015",9,9,0,141133.3,1308.889,109
"17909","59518","2015",8,8,0,135125,1508.25,99.375
"17910","59519","2015",20,20,0,252639.5,1905.85,136.25
"17911","59520","2015",8,8,0,153287.5,1176.5,120.375
"17912","59521","2015",1,1,0,88000,1011,87
"17913","59522","2015",18,18,0,310503.3,2542.222,124.5
"17914","59523","2015",24,24,0,260495.8,2764.875,94.25
"17915","59524","2015",56,55,1,190034.6,2113.393,91.53571
"17916","59525","2015",19,19,0,88394.74,997.1579,90.42105
"17917","59526","2015",172,167,5,134848.8,1420.936,96.64535
"17918","59527","2015",151,113,38,199315,2394.636,82.29139
"17919","59528","2015",19,19,0,78994.74,874,92.42105
"17920","59530","2015",2,2,0,132500,1622,87
"17921","59531","2015",2,2,0,83750,943,88
"17922","59533","2015",23,23,0,91026.09,1025.609,93.04348
"17923","59534","2015",4,4,0,185500,3307.5,90
"17924","59535","2015",16,16,0,194540.6,2053.125,94.5625
"17925","59536","2015",5,5,0,148140,1905,72.6
"17926","59537","2015",4,4,0,60000,1133.25,60.5
"17927","59538","2015",7,7,0,111065.7,1382.571,81
"17928","59539","2015",12,12,0,172041.7,1380.167,135.4167
"17929","59541","2015",10,10,0,95350,1003.2,94.1
"17930","59542","2015",5,5,0,123600,1018.8,112.8
"17931","59543","2015",11,11,0,98181.82,1139.636,92
"17932","59544","2015",81,64,17,153969.3,1787.284,87.02469
"17933","59545","2015",11,11,0,71966.36,906.2727,82.27273
"17934","59546","2015",13,13,0,154006.5,1431.538,110.3077
"17935","59547","2015",8,8,0,78375,923.25,86.375
"17936","59548","2015",7,7,0,116628.6,1098.857,110.4286
"17937","59549","2015",5,5,0,116667.2,1093.4,104.2
"17938","59550","2015",24,23,1,152042.1,1675.792,90
"17939","59551","2015",13,13,0,251760.7,2028.231,127.5385
"17940","59552","2015",2,2,0,107500,818.5,119.5
"17941","59553","2015",64,62,2,235761.8,2092.188,114.7031
"17942","59554","2015",11,11,0,244840.7,1838.818,130.2727
"17943","59555","2015",9,9,0,98660.67,1002.889,95.44444
"17944","59556","2015",1,1,0,118000,843,140
"17945","59557","2015",22,20,2,167745.2,1709.682,101.1818
"17946","59558","2015",21,21,0,99722.86,1113.905,92.2381
"17947","59559","2015",18,17,1,199347.8,1707.778,115.8889
"17948","59560","2015",124,107,17,166944.3,2017.371,86.20161
"17949","59562","2015",4,4,0,203762.5,1501.25,143.5
"17950","59563","2015",6,6,0,163374.2,1607.167,100.1667
"17951","59564","2015",28,22,6,104666.1,1384.357,75.42857
"17952","59565","2015",5,5,0,139722.8,1322,122.8
"17953","59566","2015",47,46,1,193591.5,2098.979,94.29787
"17954","59567","2015",5,5,0,151033.2,1262.2,123
"17955","59568","2015",2,2,0,258000,2396,105
"17956","59569","2015",142,117,25,104362.7,1143.049,89.23239
"17957","59570","2015",13,13,0,231710,1579,155.3077
"17958","59571","2015",39,36,3,104818.5,1142.769,105.5897
"17959","59572","2015",14,13,1,85250,873.2857,98.07143
"17960","59573","2015",1,1,0,222000,1370,162
"17961","59574","2015",103,100,3,130071.3,1416.175,91.7767
"17962","59575","2015",4,4,0,123250,1457.75,86
"17963","59576","2015",13,13,0,186563.1,1685.308,120.1538
"17964","59577","2015",10,10,0,121300,1427.4,86.5
"17965","59578","2015",14,13,1,155000.2,1454.143,113.7143
"17966","59579","2015",13,13,0,178773.8,1474.846,127.5385
"17967","59580","2015",44,43,1,130807.3,1583.841,90.38636
"17968","59581","2015",46,44,2,180645.3,1777.652,106.5652
"17969","59582","2015",10,10,0,195730,1884,101.9
"17970","59583","2015",3,3,0,115000,1100.667,102.3333
"17971","59584","2015",14,14,0,152052.9,1353.5,109.3571
"17972","59585","2015",24,24,0,197781,2090.458,95.16667
"17973","59586","2015",6,6,0,268500,2308,115.8333
"17974","59587","2015",5,5,0,197300,1866.8,104
"17975","59588","2015",70,66,4,226071.1,2022.771,114.6143
"17976","59589","2015",24,24,0,125189.6,1404.958,91.125
"17977","59590","2015",14,14,0,138375,1457.786,98.5
"17978","59591","2015",2,2,0,127200,1704.5,74.5
"17979","59592","2015",45,43,2,178240.7,1777.867,105.1556
"17980","59593","2015",6,6,0,127000,1408.333,96.16667
"17981","59594","2015",12,12,0,140454.7,1918.417,76.58333
"17982","59595","2015",3,3,0,201333.3,1553,167.6667
"17983","59596","2015",3,3,0,185666.7,1454.667,119
"17984","59597","2015",9,9,0,124555.6,1242.889,96.33333
"17985","59598","2015",44,43,1,191165.2,2262.341,89.43182
"17986","59599","2015",1170,851,319,126517.5,1524.733,84.73846
"17987","59600","2015",15,15,0,254086,2396.267,109.4667
"17988","59601","2015",17,17,0,85332.35,922.3529,89.11765
"17989","59602","2015",12,12,0,352372.5,2665.5,132.3333
"17990","59603","2015",52,50,2,115604.4,1282.596,90.13462
"17991","59604","2015",16,16,0,89625,873.4375,102.875
"17992","59605","2015",14,14,0,190781.4,1789.857,104.6429
"17993","59606","2015",482,274,208,125337.6,1624.502,79.37137
"17994","59607","2015",10,10,0,123715,1302.3,94.7
"17995","59608","2015",9,9,0,199483.3,1586.667,120.1111
"17996","59609","2015",15,15,0,254134.7,2545.8,102.1333
"17997","59610","2015",16,16,0,141187.5,1376.312,104.375
"17998","59611","2015",27,27,0,288599.2,2627.407,109.5185
"17999","59612","2015",1,1,0,46000,821,56
"18000","59613","2015",6,6,0,126583.3,1220.833,106.8333
"18001","59614","2015",16,16,0,97551.31,1128.812,88.875
"18002","59615","2015",24,24,0,177638.6,1501.792,125.7083
"18003","59616","2015",96,95,1,120870.4,1321.281,94.29167
"18004","59617","2015",7,7,0,150853.6,1297.286,112.4286
"18005","59618","2015",8,8,0,112186.8,920.75,122.5
"18006","59619","2015",11,11,0,168599.3,1543.273,114.7273
"18007","59620","2015",4,4,0,160000,1283.25,127.75
"18008","59622","2015",13,12,1,106862.3,1433.385,94.15385
"18009","59623","2015",5,5,0,92800,1011.4,114.6
"18010","59624","2015",14,14,0,89155.86,902.4286,103.2857
"18011","59625","2015",8,8,0,133437.5,1246.25,109.375
"18012","59626","2015",15,15,0,149008.3,1572.933,104.2
"18013","59627","2015",8,8,0,87959,1076.25,82.25
"18014","59628","2015",6,6,0,141250,1557.333,98.66667
"18015","59629","2015",14,14,0,180560.7,2030.857,92.14286
"18016","59630","2015",37,37,0,157466.4,1865.216,89.24324
"18017","59631","2015",20,20,0,89290.5,858.25,107.35
"18018","59632","2015",41,41,0,121077.3,1308.39,91.46341
"18019","59633","2015",1,1,0,152500,1338,114
"18020","59634","2015",11,11,0,158556,1534.364,104.5455
"18021","59635","2015",5,5,0,197300,1621,114.2
"18022","59636","2015",123,99,24,240334.8,2420.057,99.31707
"18023","59637","2015",15,15,0,173353.3,1556.667,117.8
"18024","59638","2015",12,12,0,216593.8,2338.583,94.33333
"18025","59639","2015",8,8,0,149653.6,1330,111
"18026","59640","2015",7,7,0,257042.9,1578.571,164.5714
"18027","59641","2015",24,24,0,171983.3,1850.625,96.79167
"18028","59642","2015",6,6,0,211633.3,1650.167,142
"18029","59643","2015",7,7,0,156007,2157.714,72.28571
"18030","59645","2015",6,6,0,121500,1270.667,93
"18031","59646","2015",244,214,30,231745.6,2415.443,95.5
"18032","59647","2015",21,20,1,91888.1,1145.048,88.47619
"18033","59648","2015",190,122,68,178195.1,2090.947,84.13158
"18034","59649","2015",2,2,0,174500,1495.5,117.5
"18035","59650","2015",394,369,25,138183.4,1705.746,83.47716
"18036","59651","2015",13,13,0,99107.31,1028.615,90.84615
"18037","59652","2015",9,9,0,113711.1,1334.778,82.33333
"18038","59653","2015",38,36,2,155421.4,1832.579,87.63158
"18039","59654","2015",46,46,0,103201.8,1103.957,93.91304
"18040","59655","2015",4,4,0,164908.2,1536.75,115
"18041","59656","2015",66,56,10,240321.2,2387.803,99.81818
"18042","59657","2015",7,7,0,127157.1,1610.429,82.28571
"18043","59658","2015",5,5,0,253201.8,2244.6,129.4
"18044","59659","2015",17,16,1,82288.24,814.1765,102.4118
"18045","59660","2015",26,25,1,208880.8,2594.731,91.96154
"18046","59661","2015",1,1,0,146650,1397,105
"18047","59662","2015",18,18,0,190071.4,1624.778,121.0556
"18048","59663","2015",64,55,9,157636.2,1780.969,92.375
"18049","59664","2015",4,4,0,114250,1104.75,94.5
"18050","59665","2015",4,4,0,149965,1454.5,110.25
"18051","59666","2015",13,13,0,153745.7,1718.385,93.61538
"18052","59667","2015",2,2,0,145000,1377,104
"18053","59668","2015",17,17,0,171397.1,1673.941,100.7647
"18054","59669","2015",6,6,0,146066.7,1521.667,99.5
"18055","59670","2015",11,11,0,163618.2,1766.455,89.63636
"18056","60001","2015",7,7,0,137285.7,1251.714,101.5714
"18057","60002","2015",8,8,0,144375,1570.75,98.375
"18058","60003","2015",5,5,0,179876,1839.8,97.6
"18059","60004","2015",2,2,0,112500,1865,64
"18060","60005","2015",22,19,3,154200,1636.591,99.86364
"18061","60006","2015",14,12,2,171428.6,1859.857,94.14286
"18062","60007","2015",31,31,0,209595.6,1930,110.0323
"18063","60008","2015",5,5,0,155200,1530.2,107.8
"18064","60009","2015",9,9,0,171666.7,1778.222,98.66667
"18065","60010","2015",27,25,2,226863,2423.556,96.7037
"18066","60011","2015",2,2,0,102000,1227,91
"18067","60012","2015",32,31,1,190335.9,2263.344,90.34375
"18068","60013","2015",11,11,0,187090.9,1882.364,101.8182
"18069","60014","2015",2,2,0,195000,2187.5,90
"18070","60015","2015",14,13,1,148255.7,1992.714,78.42857
"18071","60016","2015",1,1,0,126000,2333,54
"18072","60017","2015",13,13,0,131846.2,1323.154,104.8462
"18073","60019","2015",3,3,0,165000,1837.333,96.33333
"18074","60021","2015",5,5,0,109920,1090.8,102.4
"18075","60022","2015",7,7,0,318857.1,2808.571,119
"18076","60023","2015",4,4,0,226125,2139.5,106.25
"18077","60024","2015",5,5,0,184600,1595.4,117.8
"18078","60025","2015",16,15,1,157406.2,1673.125,97.3125
"18079","60026","2015",5,5,0,128651.2,1359,93
"18080","60027","2015",5,5,0,232200,2598.4,118.8
"18081","60028","2015",12,9,3,311150,2835.5,113.8333
"18082","60029","2015",24,23,1,143984.4,1590.333,95.91667
"18083","60030","2015",7,7,0,184285.7,2412.714,86.85714
"18084","60031","2015",3,3,0,171666.7,1622.667,110.3333
"18085","60032","2015",3,3,0,102666.7,1542,64.66667
"18086","60033","2015",13,13,0,249957.8,2652.692,102
"18087","60034","2015",15,15,0,185826.7,1778.8,112
"18088","60035","2015",5,5,0,119407,1508,86.2
"18089","60036","2015",4,4,0,122750,1828,67.25
"18090","60037","2015",12,12,0,124092.1,1167.667,105.9167
"18091","60039","2015",11,11,0,114954.5,1419.364,79.81818
"18092","60040","2015",10,10,0,185220,1650.2,120.4
"18093","60041","2015",15,14,1,183390,2121.067,100.1333
"18094","60042","2015",11,10,1,171495.5,1701.636,107.8182
"18095","60043","2015",5,5,0,164000,1913.6,90.6
"18096","60044","2015",20,20,0,166325,1789.9,94.5
"18097","60045","2015",5,4,1,298840,3304.4,98.6
"18098","60046","2015",3,3,0,216333.3,1343.667,171
"18099","60047","2015",9,9,0,204777.8,2310.444,88.22222
"18100","60048","2015",1,1,0,186400,1071,174
"18101","60049","2015",1,1,0,164300,1595,103
"18102","60050","2015",5,5,0,182100,2122.6,92
"18103","60051","2015",2,2,0,112500,1886.5,68
"18104","60052","2015",1,1,0,42600,926,46
"18105","60053","2015",6,6,0,99650,959.5,103
"18106","60054","2015",4,4,0,166875,2011.25,82.5
"18107","60055","2015",2,2,0,124850,1497.5,83.5
"18108","60056","2015",3,3,0,160000,1966.667,83
"18109","60057","2015",452,205,247,131559.5,1874.878,72.2146
"18110","60058","2015",2,2,0,122000,980.5,123.5
"18111","60059","2015",3,3,0,138333.3,1396.667,99.66667
"18112","60060","2015",6,6,0,198250,2206.333,87.16667
"18113","60062","2015",2,2,0,149000,1135,127.5
"18114","60063","2015",10,10,0,228281.3,2685.2,107.3
"18115","60064","2015",14,14,0,150392.9,1434.786,111.2143
"18116","60065","2015",11,11,0,159940.9,1721.182,98.54545
"18117","60066","2015",1,1,0,210000,1750,120
"18118","60067","2015",11,11,0,161454.5,1982.909,84.18182
"18119","60068","2015",37,33,4,153171.2,1853.649,84.37838
"18120","60069","2015",14,10,4,163807.9,2083.214,83.07143
"18121","60070","2015",4,4,0,336750,2760.75,115
"18122","60071","2015",2,2,0,147500,1219,125
"18123","60072","2015",3,3,0,84000,1164.333,74
"18124","60073","2015",8,8,0,198300,1725.125,122
"18125","60074","2015",19,19,0,236728.9,2266.895,109.7368
"18126","60075","2015",2,2,0,175000,1365.5,129
"18127","60076","2015",4,4,0,140250,1641,88.25
"18128","60077","2015",5,5,0,187400,1906,115
"18129","60078","2015",1,0,1,1e+05,1429,70
"18130","60079","2015",12,12,0,214391.7,2453.417,91.66667
"18131","60081","2015",2,2,0,190175,1585,120
"18132","60082","2015",7,7,0,112714.3,1472.571,79
"18133","60083","2015",19,19,0,158402.7,1705.421,95.42105
"18134","60084","2015",2,2,0,78500,1216.5,78
"18135","60085","2015",4,4,0,114000,1500.75,80
"18136","60086","2015",16,14,2,256830,2617.375,105.125
"18137","60088","2015",64,55,9,202352.6,2502.359,83.46875
"18138","60089","2015",9,9,0,206944.4,2481.111,92.11111
"18139","60090","2015",4,4,0,228025,2202.75,103
"18140","60091","2015",4,3,1,168500,2077,89.25
"18141","60092","2015",2,2,0,141500,1538,90.5
"18142","60093","2015",8,8,0,132000,1388.875,104.75
"18143","60094","2015",2,2,0,213500,1455.5,146.5
"18144","60095","2015",9,9,0,208944.4,2428.333,92
"18145","60097","2015",3,3,0,175000,2567.667,73.33333
"18146","60098","2015",2,2,0,247875,1169.5,230
"18147","60099","2015",6,6,0,225416.7,1778.667,125.8333
"18148","60100","2015",1,1,0,255000,3400,75
"18149","60101","2015",7,7,0,184519,1549.857,122.4286
"18150","60102","2015",28,24,4,168477.6,1862.857,92.03571
"18151","60103","2015",24,21,3,149041.7,1810.333,84.875
"18152","60104","2015",34,33,1,121883.8,1464.324,85.79412
"18153","60105","2015",5,5,0,122020,1300.4,89
"18154","60106","2015",22,21,1,189850,1850,103.3636
"18155","60107","2015",1,1,0,230500,2195,105
"18156","60108","2015",5,5,0,123000,1526.2,85.4
"18157","60109","2015",4,4,0,120000,1012.5,117.75
"18158","60110","2015",4,4,0,94359.5,956.25,109.75
"18159","60111","2015",3,3,0,103666.7,1095.333,98.66667
"18160","60112","2015",5,5,0,133200,1458.8,90.4
"18161","60113","2015",1,1,0,1e+05,1250,80
"18162","60115","2015",9,9,0,156111.1,1674,95.44444
"18163","60116","2015",45,45,0,152215.6,1835.356,87.4
"18164","60117","2015",2,2,0,130500,1637,80
"18165","60118","2015",6,6,0,141033.3,1378,103.3333
"18166","60119","2015",16,16,0,168787.5,1802.438,95.125
"18167","60120","2015",8,8,0,225500,2394.75,99.75
"18168","60121","2015",1,1,0,110000,973,113
"18169","60122","2015",3,3,0,72466.67,1219.667,63
"18170","60123","2015",5,5,0,87200,1053,82.4
"18171","60124","2015",7,7,0,114493.9,1681.429,82.71429
"18172","60125","2015",6,6,0,206333.3,1998,107.1667
"18173","60126","2015",3,3,0,125666.7,1711.667,77
"18174","60127","2015",1,1,0,133800,1379,97
"18175","60128","2015",2,2,0,159020,1003,158
"18176","60129","2015",14,14,0,142357.1,1377.714,109.9286
"18177","60130","2015",10,10,0,189334.7,1585.5,136.8
"18178","60132","2015",2,2,0,130125,1014.5,129
"18179","60133","2015",6,6,0,171666.7,1545.833,108.6667
"18180","60134","2015",18,18,0,183802.8,1998.444,94.44444
"18181","60135","2015",16,16,0,183875,1972.188,95.5625
"18182","60136","2015",3,3,0,156666.7,1503.333,103.6667
"18183","60137","2015",9,9,0,153550,1482.889,109.6667
"18184","60138","2015",10,10,0,242505,2731.2,92.7
"18185","60139","2015",117,62,55,180230.3,2695.197,71.37607
"18186","60140","2015",8,8,0,272000,2218.625,128.625
"18187","60141","2015",153,25,128,242567.4,3508.81,69.98039
"18188","60142","2015",63,35,28,218630.1,2830.889,82.74603
"18189","60143","2015",25,21,4,180640,2094.92,87.44
"18190","60144","2015",1,1,0,277000,2978,93
"18191","60145","2015",7,7,0,195142.9,1942.143,102.4286
"18192","60146","2015",6,6,0,144750,1178.667,126
"18193","60147","2015",8,8,0,155787.5,1971.125,83.25
"18194","60148","2015",5,5,0,229680,2089.2,120.8
"18195","60149","2015",13,13,0,193076.9,2139.692,91.15385
"18196","60150","2015",11,11,0,126418.2,1508.455,92.45455
"18197","60151","2015",31,30,1,206535.2,1963.871,109.7742
"18198","60152","2015",2,2,0,173500,1557,113
"18199","60154","2015",24,24,0,214781.2,2109.75,108.9583
"18200","60155","2015",41,36,5,164581.8,1852.122,95.29268
"18201","60156","2015",22,22,0,201885,2350.182,87.68182
"18202","60157","2015",145,91,54,140360.7,1822.766,79.88966
"18203","60158","2015",4,4,0,112000,1342,84.25
"18204","60159","2015",444,139,305,182517,2251.336,81.01351
"18205","60160","2015",10,10,0,134458.6,1310.1,105.8
"18206","60162","2015",5,5,0,205300,2067,103.6
"18207","60163","2015",2,2,0,181000,2269,84
"18208","60164","2015",11,11,0,122567.2,1526.727,85.27273
"18209","60165","2015",9,9,0,186000,2085.667,90.66667
"18210","60166","2015",7,6,1,157392.9,1921.714,85.42857
"18211","60167","2015",5,5,0,146600,1551.8,97.6
"18212","60168","2015",3,3,0,143000,1493,108.3333
"18213","60169","2015",9,9,0,164777.8,1849.111,95.55556
"18214","60170","2015",8,8,0,214825,2714.5,82
"18215","60171","2015",4,4,0,217956.5,2541.75,101.75
"18216","60172","2015",76,47,29,284371.8,3239.355,91.36842
"18217","60173","2015",7,7,0,171857.1,2175,79
"18218","60174","2015",6,6,0,94743.33,1022.833,109.3333
"18219","60175","2015",160,47,113,110902.1,1777.812,65.91875
"18220","60176","2015",186,107,79,177537.5,2413.699,76.88172
"18221","60177","2015",5,5,0,213000,1900.4,122.2
"18222","60178","2015",35,32,3,117934.3,1522.657,86.51429
"18223","60179","2015",2,2,0,150000,1173,131
"18224","60180","2015",8,8,0,125611.6,1297.625,101.125
"18225","60181","2015",10,10,0,115340,1256.6,93.6
"18226","60182","2015",2,2,0,90000,1169,77
"18227","60184","2015",1,1,0,255000,2040,125
"18228","60185","2015",15,15,0,241210.7,2194.6,110.8
"18229","60186","2015",1,1,0,166000,1677,99
"18230","60187","2015",13,13,0,130484.6,1540.615,81.69231
"18231","60188","2015",28,28,0,161684.6,1843,98.96429
"18232","60189","2015",8,8,0,143962.5,1167.75,127.125
"18233","60190","2015",2,2,0,171000,1781.5,99.5
"18234","60191","2015",6,6,0,161050,1638.833,114.1667
"18235","60192","2015",2,2,0,163550,1079,150.5
"18236","60193","2015",2,2,0,133500,1462,101
"18237","60194","2015",2,2,0,107500,1764,94
"18238","60195","2015",7,7,0,184891.6,2576,87.57143
"18239","60196","2015",9,9,0,213316.7,2088.667,113
"18240","60197","2015",6,6,0,231333.3,2194.667,103
"18241","60198","2015",2,2,0,125000,1565.5,96
"18242","60199","2015",1,1,0,162000,2314,70
"18243","60200","2015",2,2,0,119168.5,948,114.5
"18244","60201","2015",5,5,0,112200,1302.2,104
"18245","60203","2015",3,3,0,278666.7,1977.667,135.6667
"18246","60204","2015",5,5,0,111353.4,1508.2,76
"18247","60206","2015",16,16,0,154368.5,1770.375,93
"18248","60207","2015",4,4,0,166175,1613.25,104.25
"18249","60208","2015",1,1,0,2e+05,1282,156
"18250","60209","2015",2,2,0,172500,2070.5,83.5
"18251","60210","2015",3,3,0,241500,2127.333,113.3333
"18252","60211","2015",8,8,0,149551.2,1838.125,83.375
"18253","60212","2015",13,13,0,177153.8,2227.231,84.15385
"18254","60213","2015",11,10,1,226967.3,2440,96.18182
"18255","60214","2015",1,1,0,238000,1488,160
"18256","60215","2015",3,3,0,168333.3,1926.333,88.66667
"18257","60216","2015",3,3,0,178333.3,1622,125.6667
"18258","60217","2015",3,3,0,144333.3,1894.667,82.66667
"18259","60218","2015",19,19,0,209563.2,2117.263,103.4211
"18260","60219","2015",1,1,0,70000,909,77
"18261","60220","2015",2,2,0,205000,2433.5,89
"18262","60221","2015",4,4,0,98750,1423.75,81.75
"18263","60222","2015",9,9,0,144000,1813.556,81
"18264","60223","2015",34,32,2,170941.2,1730.324,105.4412
"18265","60224","2015",1,1,0,207000,2494,83
"18266","60225","2015",11,11,0,180181.8,2021.182,91.54545
"18267","60226","2015",1,1,0,5e+05,3333,150
"18268","60227","2015",2,2,0,135000,1156.5,116.5
"18269","60228","2015",10,10,0,191710,1897.6,107.4
"18270","60229","2015",1,1,0,125000,1667,75
"18271","60230","2015",4,4,0,159000,1427,107.75
"18272","60231","2015",6,6,0,221553.3,2227.333,104.6667
"18273","60232","2015",6,6,0,155000,1826.667,91.16667
"18274","60233","2015",8,8,0,124525,1328.25,118.875
"18275","60234","2015",28,23,5,179875,2125.786,88.39286
"18276","60235","2015",9,9,0,174162,1777.444,102.6667
"18277","60236","2015",1,1,0,118000,1967,60
"18278","60237","2015",1,1,0,96000,1920,50
"18279","60238","2015",21,18,3,230279,2353.048,96.80952
"18280","60239","2015",8,8,0,163625,1788.625,94.5
"18281","60240","2015",2,2,0,144000,1496.5,96.5
"18282","60241","2015",6,6,0,311000,2449.667,133.5
"18283","60243","2015",5,5,0,208680,1890.6,122
"18284","60244","2015",2,2,0,59150,801,79
"18285","60245","2015",18,18,0,112361.1,1399,82.38889
"18286","60249","2015",2,2,0,309800,2929,109.5
"18287","60250","2015",3,3,0,103333.3,1451.333,64
"18288","60251","2015",4,4,0,171250,1731.25,100.25
"18289","60252","2015",8,7,1,129187.5,1338,109.875
"18290","60253","2015",5,5,0,145400,1211.2,123
"18291","60254","2015",5,5,0,158780,1816.2,92.8
"18292","60255","2015",6,6,0,87775,1584.333,58.83333
"18293","60256","2015",16,16,0,190184.4,1792.562,115.5
"18294","60257","2015",12,12,0,180666.7,2223.167,90.25
"18295","60258","2015",1,1,0,130000,867,150
"18296","60259","2015",13,13,0,214687.7,2145.077,102.4615
"18297","60260","2015",6,6,0,204983.3,1923.5,110.5
"18298","60261","2015",9,9,0,246691.7,2112.111,127.4444
"18299","60262","2015",1,1,0,119000,700,170
"18300","60263","2015",2,2,0,89250,1266,69
"18301","60264","2015",4,4,0,167500,1713.25,97.5
"18302","60265","2015",14,14,0,112428.6,1166.714,101.5
"18303","60267","2015",1,1,0,132500,1541,86
"18304","60268","2015",8,8,0,129750,1679.75,82.75
"18305","60269","2015",4,4,0,65500,1213.75,54.75
"18306","60270","2015",4,4,0,145625,1896,78.25
"18307","60271","2015",1,1,0,3e+05,2857,105
"18308","60272","2015",11,11,0,194681.8,2216.545,92.18182
"18309","60273","2015",2,2,0,208050,2305.5,91
"18310","60274","2015",5,5,0,152287.4,1520.6,115.2
"18311","60275","2015",2,2,0,194000,2456.5,78
"18312","60276","2015",3,3,0,176033.3,1489,127.3333
"18313","60277","2015",9,9,0,181400,2054.889,89.22222
"18314","60278","2015",2,2,0,131000,1474,92.5
"18315","60279","2015",2,2,0,182250,3039.5,66
"18316","60281","2015",4,4,0,173500,2575,68.5
"18317","60282","2015",148,97,51,271548.6,3036.203,92.41216
"18318","60284","2015",20,20,0,214036.5,2091.65,107.95
"18319","60285","2015",6,6,0,174583.3,1954,90.5
"18320","60286","2015",23,23,0,133818.4,1451.522,91.04348
"18321","60287","2015",1,1,0,202500,1368,148
"18322","60288","2015",4,4,0,127750,2275.5,60.75
"18323","60289","2015",1,1,0,188000,1880,100
"18324","60290","2015",6,6,0,189166.7,1648,126
"18325","60291","2015",7,7,0,136264.3,1332,106.4286
"18326","60292","2015",3,3,0,124166.7,1592.667,78.33333
"18327","60293","2015",6,6,0,266333.3,2305.833,113.5
"18328","60294","2015",1,1,0,120000,909,132
"18329","60295","2015",4,4,0,81375,1200.25,71
"18330","60296","2015",2,2,0,121562.5,1165,104
"18331","60297","2015",1,1,0,75000,714,105
"18332","60298","2015",6,6,0,157200,1639.5,97.33333
"18333","60299","2015",11,11,0,122954.5,1328.545,91.63636
"18334","60301","2015",4,4,0,107500,1478,70.5
"18335","60302","2015",5,5,0,181960,1653.8,121.4
"18336","60304","2015",3,3,0,109000,1260,81.33333
"18337","60305","2015",6,6,0,125641.7,1352.167,100.1667
"18338","60307","2015",6,6,0,157000,2223,73
"18339","60308","2015",3,3,0,137666.7,2478,61
"18340","60309","2015",12,12,0,196604.2,2009.917,96.66667
"18341","60311","2015",2,2,0,104000,1458.5,78
"18342","60312","2015",3,3,0,117333.3,1788.667,66.66667
"18343","60313","2015",1,1,0,80000,1194,67
"18344","60314","2015",2,2,0,110000,1517.5,70
"18345","60315","2015",5,5,0,138200,1634.6,88.4
"18346","60316","2015",2,2,0,165000,1833,90
"18347","60317","2015",10,10,0,154644.6,1687.5,92.6
"18348","60318","2015",8,8,0,193375,1862.375,107.875
"18349","60319","2015",10,10,0,198100,1716.3,117.2
"18350","60320","2015",7,7,0,177428.6,1557.857,124.4286
"18351","60321","2015",5,5,0,185320,1719.8,121.2
"18352","60322","2015",1,1,0,211000,4907,43
"18353","60323","2015",4,4,0,161500,1933,90.25
"18354","60324","2015",11,11,0,112820.9,1412.273,82.90909
"18355","60325","2015",18,16,2,215166.7,2091.556,108.5
"18356","60326","2015",5,5,0,197000,1832.6,125.6
"18357","60327","2015",16,16,0,168369.9,2193.5,85.1875
"18358","60328","2015",2,2,0,310000,1956,152
"18359","60329","2015",3,3,0,146333.3,1440.333,103.6667
"18360","60330","2015",10,9,1,202975,1911.3,116.4
"18361","60331","2015",10,10,0,185034,1940,105.9
"18362","60332","2015",7,7,0,181000,2209.571,91.28571
"18363","60333","2015",11,11,0,143185.8,1568.091,95.27273
"18364","60334","2015",9,9,0,181311.1,1956.778,95.55556
"18365","60335","2015",1,1,0,99000,1100,90
"18366","60336","2015",1,1,0,63000,1312,48
"18367","60337","2015",5,4,1,229649.6,2397.8,98.4
"18368","60338","2015",59,48,11,190071.1,2211.102,88.67797
"18369","60339","2015",2,2,0,187500,2400.5,80
"18370","60340","2015",4,4,0,122750,1350,90.25
"18371","60341","2015",33,33,0,277305.5,2564.242,111.1818
"18372","60342","2015",63,57,6,167531.6,2041.905,85.5873
"18373","60343","2015",6,6,0,147666.7,1746,88.33333
"18374","60344","2015",2,2,0,223000,2528,98.5
"18375","60345","2015",2,2,0,175000,2288.5,79.5
"18376","60346","2015",122,84,38,344711.7,3299.336,108.8033
"18377","60347","2015",2,2,0,82000,862,92.5
"18378","60348","2015",9,9,0,161733.3,1422.889,116.2222
"18379","60350","2015",6,6,0,139833.3,1825,77.33333
"18380","60351","2015",3,3,0,115956.7,1104,110.3333
"18381","60352","2015",2,2,0,177500,2258.5,95.5
"18382","60353","2015",3,3,0,113500,1122.667,104
"18383","60355","2015",12,12,0,172041.7,1721.167,102.6667
"18384","60356","2015",3,3,0,252300,2753.667,107
"18385","60357","2015",3,3,0,142666.7,1846.667,77.33333
"18386","60358","2015",12,8,4,161866.3,1908.583,84.83333
"18387","60360","2015",66,55,11,140363.6,1865.379,80.39394
"18388","60361","2015",10,10,0,206600.5,1962.4,105.6
"18389","60362","2015",2,2,0,121500,1299,94.5
"18390","60363","2015",5,5,0,228900,2014,122.2
"18391","60364","2015",10,9,1,154000,1942.8,80
"18392","60365","2015",4,3,1,99750,1059,92.5
"18393","60366","2015",1,1,0,110075,840,131
"18394","60367","2015",3,3,0,151500,1453,88.66667
"18395","60368","2015",23,22,1,149493.5,1746.087,88.34783
"18396","60369","2015",17,17,0,214458.3,1952.118,113.7647
"18397","60370","2015",17,17,0,211311.8,2090.824,102.1765
"18398","60372","2015",8,8,0,179980,1586.125,117.25
"18399","60373","2015",4,4,0,147875,1707.75,86.5
"18400","60374","2015",18,17,1,128927.8,1450.389,91.05556
"18401","60375","2015",2,2,0,185000,2606.5,79
"18402","60376","2015",2,2,0,120000,1756,70.5
"18403","60377","2015",2,2,0,103650,961.5,105
"18404","60378","2015",5,5,0,184700,1637.6,122.8
"18405","60379","2015",6,6,0,181600,1530.667,129
"18406","60380","2015",18,18,0,173888.9,1911.167,95.05556
"18407","60381","2015",4,4,0,155625,1223.5,138
"18408","60382","2015",115,71,44,172887.5,2207.113,81.46087
"18409","60383","2015",3,3,0,171666.7,1581.333,109.3333
"18410","60385","2015",6,6,0,166166.7,1968,88.83333
"18411","60386","2015",5,5,0,209700,1470.8,152.4
"18412","60387","2015",5,5,0,139900,1230.2,122
"18413","60388","2015",1,1,0,249600,1965,127
"18414","60389","2015",3,3,0,114800,1134,103
"18415","60390","2015",4,4,0,151400,1697.5,90.25
"18416","60391","2015",5,5,0,200900,2398,93.6
"18417","60392","2015",5,5,0,166300,2078.4,81.6
"18418","60393","2015",8,8,0,147625,2016.375,76.125
"18419","60395","2015",113,84,29,156087.7,2036.221,79.39823
"18420","60396","2015",5,5,0,131825,1285.2,101.2
"18421","60398","2015",27,22,5,203316.7,2439.704,86.44444
"18422","60399","2015",2,2,0,77500,939.5,84
"18423","60401","2015",12,12,0,157254.2,2186.75,74.58333
"18424","60402","2015",14,12,2,210118.4,2156.571,118.5714
"18425","60403","2015",12,12,0,139460.5,2225.583,65.5
"18426","60404","2015",16,16,0,179052.2,2085.5,90.6875
"18427","60405","2015",6,6,0,115731,1386.5,85.33333
"18428","60406","2015",7,7,0,191285.7,2002.286,103
"18429","60408","2015",11,6,5,177745.5,1920.182,102.9091
"18430","60409","2015",16,16,0,171134.4,1908.438,92.625
"18431","60410","2015",2,2,0,113600,1153,99.5
"18432","60411","2015",9,9,0,208872.2,2409.889,88.77778
"18433","60412","2015",6,6,0,212333.3,2533.167,84
"18434","60413","2015",3,3,0,221000,1933.333,117
"18435","60414","2015",71,49,22,133251.5,1829.437,74.8169
"18436","60415","2015",4,4,0,392675,3153.25,144.75
"18437","60416","2015",3,3,0,104666.7,1087.667,97
"18438","60418","2015",10,10,0,141500,1570.4,93.2
"18439","60420","2015",5,5,0,152785,2333.4,79
"18440","60421","2015",3,3,0,303333.3,2959,100
"18441","60422","2015",3,3,0,528083.3,2885,195.6667
"18442","60423","2015",12,12,0,161725,1795.667,92.66667
"18443","60424","2015",2,2,0,224500,2675,84.5
"18444","60425","2015",5,5,0,105600,1467.2,68.8
"18445","60426","2015",8,8,0,210000,2078.375,102
"18446","60427","2015",2,2,0,172000,2868.5,69.5
"18447","60428","2015",4,4,0,196035.2,1723.5,117.25
"18448","60429","2015",5,5,0,206331.4,2627.6,82.2
"18449","60430","2015",11,11,0,224945.5,1779.455,137.3636
"18450","60431","2015",8,8,0,142175,1686.125,88.5
"18451","60432","2015",12,11,1,287739.1,2909.5,105.25
"18452","60433","2015",7,7,0,154550,1894.714,96.28571
"18453","60435","2015",2,2,0,103275,1529.5,67.5
"18454","60436","2015",2,2,0,106000,1429,70.5
"18455","60437","2015",1,1,0,155000,1148,135
"18456","60438","2015",3,3,0,157166.7,1249.333,122
"18457","60439","2015",53,47,6,137131.1,1675.283,92.03774
"18458","60440","2015",8,8,0,172013.6,1833,96.25
"18459","60441","2015",4,4,0,177750,1737.5,102.5
"18460","60442","2015",2,2,0,146500,1756.5,84.5
"18461","60443","2015",5,5,0,89700,1371,67.6
"18462","60444","2015",3,3,0,98333.33,1250,80.33333
"18463","60445","2015",3,3,0,108333.3,1273,84
"18464","60446","2015",46,32,14,188945.3,2362.391,87.17391
"18465","60447","2015",5,5,0,175274.4,2039,87
"18466","60448","2015",1,1,0,145000,2788,52
"18467","60449","2015",1,1,0,150000,1456,103
"18468","60450","2015",59,47,12,183949.2,2450.475,86.62712
"18469","60451","2015",18,18,0,211388.9,2118.111,105
"18470","60452","2015",4,4,0,205062.5,1943.5,104.75
"18471","60456","2015",13,13,0,139525.8,1726.231,82.61538
"18472","60457","2015",1,1,0,170000,1771,96
"18473","60458","2015",2,2,0,112500,2202,51
"18474","60459","2015",4,4,0,169300,1757.25,101.75
"18475","60460","2015",2,2,0,152500,1435,104.5
"18476","60461","2015",2,2,0,187500,1481,140
"18477","60462","2015",30,29,1,167178.1,1954.7,89.16667
"18478","60463","2015",122,86,36,152819.7,2013.754,78.36885
"18479","60464","2015",12,12,0,178250,1847.083,101.4167
"18480","60465","2015",1,1,0,180000,1200,150
"18481","60466","2015",1,1,0,143000,1589,90
"18482","60468","2015",6,6,0,137368.8,1397.5,107.6667
"18483","60469","2015",4,4,0,200750,1904.75,114.25
"18484","60470","2015",4,4,0,177000,1756.5,101
"18485","60471","2015",92,69,23,106823.6,1355.457,84.3913
"18486","60472","2015",1,1,0,142000,2367,60
"18487","60473","2015",3,3,0,244333.3,2461,103.6667
"18488","60474","2015",2,2,0,141500,1142.5,126
"18489","60477","2015",12,12,0,156975.8,1501.333,103.75
"18490","60478","2015",2,1,1,272600,1943,140.5
"18491","60479","2015",6,6,0,186000,1907.333,106.3333
"18492","60480","2015",7,7,0,229142.9,2176.143,108.4286
"18493","60481","2015",7,7,0,188600,1820.571,117.5714
"18494","60482","2015",37,34,3,293705.9,3043.162,102.4054
"18495","60483","2015",2,2,0,187500,1607,117
"18496","60486","2015",2,2,0,64500,991.5,61.5
"18497","60487","2015",5,5,0,400372,2926.6,122.4
"18498","60488","2015",1,1,0,78000,975,80
"18499","60489","2015",13,13,0,246461.5,2526.615,102.1538
"18500","60490","2015",2,2,0,144500,2102.5,68
"18501","60491","2015",32,27,5,172345.9,1983.375,87.0625
"18502","60492","2015",10,10,0,167030,1737.8,96.4
"18503","60493","2015",3,3,0,181500,1767.667,105.6667
"18504","60494","2015",18,11,7,234102.8,2747.722,91.44444
"18505","60495","2015",1,1,0,170000,2537,67
"18506","60496","2015",2,2,0,152500,1252.5,129
"18507","60497","2015",4,4,0,122750,1919,67.25
"18508","60498","2015",6,6,0,126666.7,1616,79
"18509","60500","2015",44,26,18,190542.7,2713.364,73.79545
"18510","60501","2015",17,17,0,151191.2,1759,93.05882
"18511","60503","2015",2,2,0,158950,1536.5,106.5
"18512","60504","2015",11,11,0,164818.2,2083.091,85
"18513","60505","2015",8,8,0,276875,2716.25,101
"18514","60506","2015",7,7,0,104000,1231.429,83.42857
"18515","60507","2015",6,6,0,96583.33,1228.667,84.83333
"18516","60508","2015",40,32,8,193903.5,2227.7,91.25
"18517","60509","2015",108,72,36,149639.7,2103.685,74.92593
"18518","60510","2015",9,9,0,188283.3,1986,96.11111
"18519","60511","2015",1,1,0,122000,1419,86
"18520","60512","2015",2,2,0,207000,2368.5,89.5
"18521","60513","2015",48,43,5,215501.9,2467.021,90.20833
"18522","60514","2015",1,1,0,110000,803,137
"18523","60515","2015",3,3,0,176000,1941,99.33333
"18524","60516","2015",4,4,0,120000,1306.25,94
"18525","60517","2015",8,8,0,192125,2363.75,88.125
"18526","60518","2015",1,1,0,150000,1103,136
"18527","60519","2015",1,1,0,250000,1852,135
"18528","60520","2015",3,3,0,163333.3,1657,105.3333
"18529","60521","2015",3,3,0,100333.3,1232,81.33333
"18530","60522","2015",4,4,0,124250,2191.5,62
"18531","60523","2015",11,11,0,214131.2,1968,115.8182
"18532","60524","2015",38,23,15,145893.4,1877.895,81.23684
"18533","60526","2015",9,9,0,104944.4,1439.667,72.33333
"18534","60527","2015",2,2,0,259600,2687.5,100.5
"18535","60530","2015",5,5,0,160343.4,1796.6,93.4
"18536","60531","2015",15,15,0,192486.7,1711.533,126.4667
"18537","60533","2015",16,16,0,141246.9,1664.312,89.75
"18538","60534","2015",13,13,0,167600,1640.615,103.2308
"18539","60535","2015",4,4,0,133582.2,1021.25,117.25
"18540","60536","2015",1,1,0,217000,2047,106
"18541","60537","2015",36,36,0,137225.8,1544.111,89.80556
"18542","60538","2015",5,5,0,169000,1838.2,93.4
"18543","60539","2015",18,17,1,176088.9,2107.111,84.66667
"18544","60540","2015",6,6,0,162166.7,1951.333,87.33333
"18545","60541","2015",3,3,0,227000,2316.333,106.6667
"18546","60542","2015",7,7,0,160857.1,1863.714,87
"18547","60543","2015",4,4,0,308118.8,2415.75,129.5
"18548","60544","2015",3,3,0,100833.3,1503.333,66.33333
"18549","60545","2015",6,6,0,125416.7,1265.167,98.66667
"18550","60546","2015",2,2,0,226500,2470,89
"18551","60547","2015",6,6,0,233816.7,2041.5,116.6667
"18552","60548","2015",11,11,0,179000,1611.818,111.2727
"18553","60549","2015",3,3,0,156500,1476,105
"18554","60550","2015",3,3,0,171833.3,1201,141.3333
"18555","60551","2015",3,3,0,202500,1908.667,111.3333
"18556","60553","2015",3,3,0,122666.7,1655.333,72
"18557","60554","2015",8,8,0,202125,1925.5,110.875
"18558","60555","2015",1,1,0,155000,1281,121
"18559","60556","2015",3,3,0,118607.3,1129,105.3333
"18560","60557","2015",3,3,0,129666.7,1259,111
"18561","60558","2015",3,3,0,209333.3,1889.667,107
"18562","60559","2015",7,7,0,196274.7,1756,130.5714
"18563","60560","2015",7,7,0,246055.7,2787.857,92.85714
"18564","60561","2015",3,3,0,197500,1595,128.3333
"18565","60562","2015",17,16,1,189210.5,1918.765,101.3529
"18566","60563","2015",9,9,0,132000,1635.778,86.77778
"18567","60564","2015",6,6,0,123064.7,1215.667,100.5
"18568","60565","2015",6,6,0,118283.3,1455.333,82
"18569","60566","2015",1,1,0,110000,570,193
"18570","60567","2015",12,12,0,153920.8,1606.167,102
"18571","60568","2015",7,7,0,172394.3,1763.714,101.8571
"18572","60570","2015",17,17,0,182560.2,1760.294,104.3529
"18573","60572","2015",5,5,0,178200,1560.4,132.8
"18574","60573","2015",4,4,0,161060.8,1206.5,140.5
"18575","60574","2015",4,4,0,177875,1822.25,108
"18576","60575","2015",43,40,3,200139.5,2218.395,102.8372
"18577","60576","2015",5,5,0,146225,1712.4,89
"18578","60577","2015",12,12,0,138875,1800.25,80.41667
"18579","60578","2015",12,12,0,136115.7,1745.5,81.58333
"18580","60579","2015",7,7,0,270285.7,2515.857,113.7143
"18581","60581","2015",65,48,17,116516.2,1542.631,78.46154
"18582","60582","2015",13,13,0,165615.4,1655.231,105.9231
"18583","60583","2015",1,1,0,235000,1808,130
"18584","60584","2015",32,28,4,205923.4,2427.531,89.34375
"18585","60585","2015",2,2,0,90000,1277,61.5
"18586","60586","2015",10,10,0,210900,1819.8,118.4
"18587","60587","2015",16,16,0,184531.2,2100.125,89.1875
"18588","60588","2015",2,2,0,111100,1193.5,96.5
"18589","60589","2015",28,25,3,207446.4,2424.286,87.32143
"18590","60590","2015",10,10,0,130780.3,1505.1,88
"18591","60591","2015",16,16,0,193686.2,1862.562,106.25
"18592","60592","2015",4,4,0,163750,2144.75,95.25
"18593","60593","2015",1,1,0,140000,1591,88
"18594","60594","2015",2,2,0,141500,1790,104.5
"18595","60595","2015",5,5,0,156400,1361.6,124.4
"18596","60597","2015",18,18,0,170916.7,1963.056,91.16667
"18597","60598","2015",4,4,0,152750,1631.25,94.25
"18598","60599","2015",1,1,0,58500,562,104
"18599","60600","2015",8,8,0,205062.5,2158.875,97.125
"18600","60601","2015",9,5,4,129444.4,1734.222,72.55556
"18601","60603","2015",8,8,0,153950.2,1451.5,107.375
"18602","60604","2015",1,1,0,285000,1239,230
"18603","60605","2015",5,5,0,106200,1250.8,87.2
"18604","60609","2015",8,8,0,199358.8,2099.25,96.25
"18605","60610","2015",9,9,0,166133.3,1638.111,111.5556
"18606","60611","2015",7,7,0,155035.7,1364.571,122
"18607","60612","2015",163,73,90,268954.5,3080.589,86.32515
"18608","60613","2015",2,2,0,165000,2643.5,70
"18609","60614","2015",2,2,0,192000,2325,90
"18610","60615","2015",1,1,0,87000,935,93
"18611","60616","2015",26,25,1,149288.5,1662.077,93.23077
"18612","60617","2015",3,3,0,83333.33,994.3333,81.66667
"18613","60618","2015",4,4,0,192837.5,2177.5,98.5
"18614","60619","2015",18,17,1,230115,2480.778,98.38889
"18615","60620","2015",10,10,0,195200,2215.3,105.3
"18616","60622","2015",2,2,0,1e+05,981,113
"18617","60623","2015",3,3,0,119666.7,1349.667,81.33333
"18618","60625","2015",4,4,0,138732.5,1663.25,85.25
"18619","60626","2015",5,5,0,140670,1581.4,103.8
"18620","60627","2015",2,2,0,74000,1150,64
"18621","60628","2015",7,7,0,143571.4,1713.571,84.28571
"18622","60629","2015",1,1,0,70000,753,93
"18623","60630","2015",7,7,0,238000,2077.429,119.1429
"18624","60631","2015",8,8,0,275812.5,2883.875,94.25
"18625","60632","2015",5,5,0,148100,1629.4,98.4
"18626","60633","2015",2,2,0,124000,1218,100
"18627","60634","2015",2,2,0,127500,1521,81
"18628","60635","2015",7,4,3,128142.9,2358,54.85714
"18629","60636","2015",34,30,4,136645.6,1771.118,80.61765
"18630","60637","2015",2,2,0,170000,2300.5,74.5
"18631","60638","2015",6,6,0,196758.3,3155.333,79.16667
"18632","60639","2015",9,9,0,182189.4,2023.222,92.66667
"18633","60640","2015",2,2,0,176000,1748,102.5
"18634","60641","2015",23,22,1,159442.1,1580.696,110.9565
"18635","60642","2015",12,12,0,166416.7,1913.167,87.75
"18636","60643","2015",6,6,0,93333.33,1282,76
"18637","60644","2015",14,13,1,191100,1714.071,119.4286
"18638","60645","2015",3,3,0,172666.7,2339.333,75
"18639","60646","2015",12,12,0,177000,1775.917,104.6667
"18640","60647","2015",18,17,1,154869.4,1773.333,91.72222
"18641","60648","2015",2,2,0,65000,1136,62.5
"18642","60650","2015",4,4,0,230625,2401.25,94.5
"18643","60651","2015",30,29,1,188938.4,2053.633,95.53333
"18644","60652","2015",10,10,0,173135,2193.9,92.2
"18645","60653","2015",2,2,0,154000,2140,72
"18646","60654","2015",5,5,0,147107.8,1768.4,83.6
"18647","60655","2015",3,3,0,73666.67,1314,60.66667
"18648","60656","2015",2,2,0,180000,1940.5,95.5
"18649","60657","2015",3,3,0,99000,1183.333,86.66667
"18650","60658","2015",9,9,0,184245.1,2085.556,88
"18651","60659","2015",1,1,0,149000,1490,100
"18652","60660","2015",4,4,0,212500,2322.5,87.75
"18653","60661","2015",9,9,0,168666.7,2111.333,85.66667
"18654","60662","2015",10,10,0,173880,2185.4,101.1
"18655","60663","2015",1,1,0,170000,1298,131
"18656","60664","2015",4,4,0,125750,1020.75,132.75
"18657","60665","2015",32,25,7,178042.2,2109.375,84.9375
"18658","60666","2015",17,16,1,194521.6,2413,87.76471
"18659","60667","2015",50,42,8,167598.9,2101.24,83.32
"18660","60668","2015",8,8,0,192093.8,1811.125,110.875
"18661","60669","2015",8,8,0,192812.5,2023.75,96.875
"18662","60670","2015",46,39,7,204886.7,2384.522,89.45652
"18663","60671","2015",2,2,0,245050,2523.5,97
"18664","60672","2015",2,2,0,165250,2126,77.5
"18665","60673","2015",4,4,0,153025,1879.75,81.5
"18666","60674","2015",13,13,0,284680.8,2360.154,124.7692
"18667","60675","2015",5,5,0,177742.4,1692.4,110.2
"18668","60676","2015",6,6,0,127316.7,1450.333,89.66667
"18669","60677","2015",4,4,0,142500,2021.75,79.5
"18670","60678","2015",11,10,1,181890.9,2027,93
"18671","60679","2015",1,1,0,232000,2442,95
"18672","60680","2015",11,11,0,177904.5,2202.455,77.81818
"18673","60681","2015",3,3,0,158333.3,1566.667,108.3333
"18674","60682","2015",8,8,0,307700,3116.375,100.75
"18675","60683","2015",6,6,0,205500,2503.5,90
"18676","60684","2015",45,29,16,163327.8,2025.711,82.84444
"18677","60686","2015",26,25,1,236011.5,2592.385,92.53846
"18678","60687","2015",4,4,0,206812.5,1605.75,129.25
"18679","60688","2015",3,3,0,130666.7,1495.333,137
"18680","60689","2015",25,25,0,232552,1712.36,142.76
"18681","60691","2015",4,4,0,92231.25,1007,95.75
"18682","60692","2015",3,3,0,156066.7,1245,117.3333
"18683","60693","2015",3,3,0,116700,1354.667,103
"18684","60695","2015",14,8,6,288346.4,3029.357,104.9286
"18685","60698","2015",2,2,0,112500,2012.5,53.5
"18686","60699","2015",2,2,0,142500,1591.5,87.5
"18687","60700","2015",10,10,0,160330,2016.2,83.2
"18688","60701","2015",7,7,0,146007.1,1667.143,87.71429
"18689","60702","2015",4,4,0,96250,1174.75,80
"18690","60703","2015",3,3,0,198233.3,1894.667,110
"18691","61001","2015",199,113,86,93844.89,1214.588,77.35176
"18692","61002","2015",6,6,0,97166.67,983.1667,96.33333
"18693","61005","2015",3,3,0,123635.3,1416.667,90
"18694","61006","2015",97,76,21,102323.9,1268.278,82.29897
"18695","61007","2015",41,40,1,98151.05,1072.951,91.56098
"18696","61008","2015",9,9,0,112088.9,1171.778,93.11111
"18697","61011","2015",3,3,0,134500,850.3333,147.3333
"18698","61012","2015",4,4,0,70500,1033.5,66.5
"18699","61013","2015",2,2,0,120000,851.5,153
"18700","61014","2015",1,1,0,250000,1786,140
"18701","61015","2015",2,2,0,104000,1642,65
"18702","61018","2015",1,1,0,255000,1386,184
"18703","61020","2015",2,2,0,116950,921.5,118
"18704","61023","2015",6,6,0,102856.7,1055.833,98
"18705","61024","2015",7,7,0,82200,979.7143,80.42857
"18706","61026","2015",3,3,0,152666.7,1786,89.66667
"18707","61028","2015",7,7,0,103000,1013.571,111.2857
"18708","61029","2015",13,12,1,108973.1,1239.923,91.53846
"18709","61030","2015",1,1,0,116500,1294,90
"18710","61032","2015",6,6,0,109333.3,1169.167,90.5
"18711","61034","2015",3,3,0,155333.3,1300.667,119
"18712","61035","2015",1,1,0,151000,1819,83
"18713","61036","2015",4,4,0,69212.5,1005.5,68
"18714","61037","2015",1,1,0,108750,906,120
"18715","61038","2015",16,15,1,89456.25,1084.5,86.6875
"18716","61039","2015",1,1,0,80000,1067,75
"18717","61040","2015",6,6,0,70000,935.8333,71.66667
"18718","61041","2015",4,4,0,117250,1430.5,86.5
"18719","61043","2015",9,9,0,140444.4,1420.111,99.22222
"18720","61044","2015",5,5,0,104905,1053.8,92.6
"18721","61048","2015",3,3,0,88858.33,982.6667,92.66667
"18722","61050","2015",13,13,0,108891.5,1110.462,98.92308
"18723","61051","2015",4,4,0,105625,1290,91.75
"18724","61052","2015",1,1,0,73000,716,102
"18725","61053","2015",2,2,0,47500,581,84
"18726","61054","2015",5,5,0,127295,1605.2,87.6
"18727","61055","2015",4,4,0,137250,765.5,177
"18728","61056","2015",3,3,0,77333.33,1010.333,81.33333
"18729","61060","2015",1,1,0,189000,1322,143
"18730","61061","2015",24,23,1,105854.6,1322.833,88.54167
"18731","61062","2015",1,1,0,81000,786,103
"18732","61063","2015",11,11,0,87986.36,1048.364,83.18182
"18733","61064","2015",1,1,0,155000,3444,45
"18734","61066","2015",3,3,0,286666.7,2271.667,118
"18735","61067","2015",1,1,0,170000,1789,95
"18736","61068","2015",5,5,0,217600,1752,106.6
"18737","61069","2015",1,1,0,46000,1022,45
"18738","61070","2015",9,9,0,112633.3,1114.778,101.3333
"18739","61071","2015",2,2,0,110000,952,92.5
"18740","61072","2015",1,1,0,127358,1168,109
"18741","61074","2015",7,7,0,133571.4,1007.429,123.4286
"18742","61075","2015",21,21,0,81500,915.0952,86.42857
"18743","61077","2015",5,5,0,142180,1412.2,103.4
"18744","61078","2015",2,2,0,55250,736,75.5
"18745","61079","2015",16,15,1,68750,952.375,72.5
"18746","61081","2015",4,4,0,85000,887.25,95.75
"18747","61084","2015",3,3,0,120000,1170.333,106.3333
"18748","61086","2015",1,1,0,45000,450,100
"18749","61087","2015",2,2,0,72825,944.5,77.5
"18750","61089","2015",2,2,0,149850,1159.5,125.5
"18751","61091","2015",16,16,0,63177.19,899.125,79.875
"18752","61092","2015",9,9,0,112744.4,1067.444,113
"18753","61093","2015",11,11,0,78995.45,855,101
"18754","61094","2015",4,4,0,91250,1008.25,82
"18755","61095","2015",1,1,0,167800,2179,77
"18756","61096","2015",21,21,0,83171.24,867.9048,94.7619
"18757","61097","2015",9,9,0,72055.56,822.3333,88.33333
"18758","61098","2015",2,2,0,110450,1324,88.5
"18759","61099","2015",3,3,0,78333.33,740,107.6667
"18760","61100","2015",1,1,0,149000,1733,86
"18761","61102","2015",2,2,0,44250,629,68
"18762","61103","2015",2,2,0,105000,866,124
"18763","61107","2015",4,4,0,94750,1068.75,90
"18764","61108","2015",2,2,0,128750,1685.5,79
"18765","61111","2015",5,5,0,93800,1119.2,85.2
"18766","61114","2015",2,2,0,116750,1357.5,86
"18767","61116","2015",22,22,0,123429.5,1163.545,105.1364
"18768","61117","2015",24,21,3,135264.6,1396.333,98.625
"18769","61118","2015",1,1,0,139000,1738,80
"18770","61121","2015",7,7,0,102428.6,1303.857,79.14286
"18771","61123","2015",5,5,0,94000,1101.8,88
"18772","61124","2015",5,5,0,118690,1243.4,100
"18773","61126","2015",2,2,0,120500,1035,119.5
"18774","61129","2015",4,4,0,119250,1217.5,100.5
"18775","61130","2015",3,3,0,124000,1363.333,90.66667
"18776","61133","2015",11,11,0,74004.82,800.8182,93.72727
"18777","61137","2015",3,3,0,133333.3,1404.333,95.33333
"18778","61138","2015",2,2,0,1e+05,1443.5,68.5
"18779","61139","2015",6,6,0,159713.8,1266.333,127.6667
"18780","61140","2015",9,9,0,104833.3,1407.111,82.11111
"18781","61141","2015",2,2,0,92000,1080,84.5
"18782","61142","2015",3,3,0,55000,1141.667,62.66667
"18783","61143","2015",20,19,1,113105.8,1401,80.05
"18784","61145","2015",33,26,7,94643,1024.576,99.39394
"18785","61146","2015",1,1,0,82973,1238,67
"18786","61148","2015",2,2,0,90000,1202.5,72
"18787","61150","2015",7,7,0,110285.7,1671.286,77.42857
"18788","61151","2015",2,2,0,90000,1572,56.5
"18789","61152","2015",2,2,0,198962,3686,49.5
"18790","61153","2015",25,25,0,95814,1052.44,90.96
"18791","61156","2015",3,3,0,236000,2297.333,110
"18792","61158","2015",1,1,0,123200,893,138
"18793","61159","2015",4,4,0,145134,1452,96.25
"18794","61162","2015",2,2,0,92500,1035.5,83
"18795","61163","2015",12,12,0,109664.8,1014.667,106.5
"18796","61164","2015",2,2,0,342500,2533,115.5
"18797","61165","2015",8,8,0,127587.5,1229.5,111
"18798","61166","2015",3,3,0,163000,1694.667,94.66667
"18799","61167","2015",33,33,0,100481.4,966.8182,102.2424
"18800","61168","2015",40,40,0,74150,949.225,80.7
"18801","61169","2015",122,85,37,83763.18,955.7787,87.39344
"18802","61180","2015",3,3,0,121666.7,1034.333,110.6667
"18803","61181","2015",21,21,0,78928.57,980.0952,81.47619
"18804","61182","2015",3,3,0,84000,1497.667,65.66667
"18805","61183","2015",2,2,0,69000,1248.5,57.5
"18806","61187","2015",4,4,0,64875,1101.25,61.25
"18807","61188","2015",1,1,0,108500,1669,65
"18808","61189","2015",2,2,0,143500,1421.5,102
"18809","61190","2015",1,1,0,106000,1247,85
"18810","61192","2015",1,1,0,75500,1258,60
"18811","61193","2015",1,1,0,2e+05,1212,165
"18812","61194","2015",5,5,0,120000,975.8,105.2
"18813","61195","2015",1,1,0,106000,1029,103
"18814","61196","2015",19,18,1,149152.6,1494.789,103.4211
"18815","61197","2015",1,1,0,148300,939,158
"18816","61198","2015",2,2,0,86150,1589,52.5
"18817","61202","2015",7,7,0,141289.1,1666.857,92.14286
"18818","61203","2015",6,6,0,137275,1480.167,90.33333
"18819","61206","2015",1,1,0,120000,1043,115
"18820","61207","2015",3,3,0,207633.3,1358,133
"18821","61208","2015",4,4,0,116250,1186.75,104.75
"18822","61209","2015",2,2,0,164450,2111,70
"18823","61210","2015",4,4,0,104000,1245.75,73.25
"18824","61211","2015",26,25,1,71410.77,908.6923,81.96154
"18825","61213","2015",1,1,0,20000,385,52
"18826","61214","2015",65,60,5,116046.2,1283.292,92.90769
"18827","61215","2015",2,2,0,80500,1356,74
"18828","61216","2015",2,2,0,170200,3314,106.5
"18829","61217","2015",1,1,0,110000,1447,76
"18830","61218","2015",15,15,0,103347.8,1107.667,93.8
"18831","61221","2015",2,2,0,109459,1212,90.5
"18832","61222","2015",7,7,0,86487.57,839.4286,105.4286
"18833","61224","2015",2,2,0,66850,466,145
"18834","61225","2015",1,1,0,255000,2318,110
"18835","61228","2015",1,1,0,36000,1029,35
"18836","61229","2015",1,1,0,192000,1670,115
"18837","61230","2015",44,44,0,109077,1329.318,88.70455
"18838","61232","2015",5,5,0,115300,1662,62.8
"18839","61233","2015",2,2,0,81500,978,105
"18840","61234","2015",7,7,0,150557.1,1562.571,92.57143
"18841","61237","2015",3,3,0,110666.7,1257.333,93.66667
"18842","61238","2015",3,3,0,81666.67,926,79
"18843","61240","2015",6,6,0,313448.3,2358.667,140
"18844","61241","2015",7,7,0,100857.1,1074.429,93
"18845","61242","2015",8,8,0,104687.5,1147.875,93.875
"18846","61243","2015",11,11,0,98484.55,1268,83.54545
"18847","61244","2015",5,5,0,186890.6,1634.2,85.6
"18848","61248","2015",7,7,0,77460,829.8571,92.14286
"18849","61251","2015",1,1,0,78000,1114,70
"18850","61252","2015",2,2,0,93900,1867.5,50
"18851","61255","2015",9,9,0,161785.6,1093.889,136.4444
"18852","61256","2015",3,3,0,72791.67,808,92
"18853","61257","2015",6,6,0,79508.33,875.5,87.83333
"18854","61258","2015",11,11,0,95654.55,1125.818,87.72727
"18855","61259","2015",2,2,0,157500,1316,126.5
"18856","61260","2015",8,8,0,85398.12,868.75,102.375
"18857","61261","2015",3,3,0,106666.7,604,177.6667
"18858","61262","2015",2,2,0,91000,1314,66.5
"18859","61263","2015",2,2,0,208750,2342.5,92
"18860","61266","2015",1,1,0,116300,1530,76
"18861","61267","2015",2,2,0,121000,820.5,148.5
"18862","61268","2015",2,2,0,176500,1375.5,123
"18863","61269","2015",12,12,0,70973.33,754.3333,92.25
"18864","61271","2015",1,1,0,63000,955,66
"18865","61272","2015",1,1,0,230000,5111,45
"18866","61273","2015",2,2,0,116000,809,144
"18867","61274","2015",2,2,0,143500,1017.5,141.5
"18868","61275","2015",14,14,0,71023.43,873.7857,79.92857
"18869","61276","2015",1,1,0,96500,902,107
"18870","61277","2015",2,2,0,102750,1347,76
"18871","61278","2015",7,7,0,97973.43,1170.714,89
"18872","61279","2015",6,6,0,154859,1882.833,95
"18873","61281","2015",2,2,0,47000,1069,43
"18874","61283","2015",6,6,0,114360,1086,111.1667
"18875","61284","2015",2,2,0,84750,1165.5,86
"18876","61286","2015",2,2,0,135000,1234.5,115
"18877","61287","2015",7,7,0,85975.14,1018.429,82
"18878","61288","2015",4,4,0,103500,1189.25,87
"18879","61289","2015",2,2,0,42712.5,683,65.5
"18880","61290","2015",2,2,0,84000,590.5,131
"18881","61291","2015",2,2,0,115250,1091,104.5
"18882","61292","2015",4,4,0,74125,842.25,85.75
"18883","61293","2015",36,35,1,123486.6,1133.25,116.1389
"18884","61294","2015",8,8,0,106406.2,1132.375,96.375
"18885","61297","2015",5,5,0,50900,658.4,73
"18886","61298","2015",4,4,0,165750,1463.25,117.75
"18887","61300","2015",13,13,0,194615.4,2211.538,100.4615
"18888","61301","2015",1,1,0,2e+05,1471,136
"18889","61302","2015",2,2,0,120875,1135.5,110.5
"18890","61303","2015",6,6,0,86666.67,1082.5,80.16667
"18891","61304","2015",4,4,0,87500,1024.5,81.75
"18892","61307","2015",2,2,0,63000,730,75.5
"18893","61308","2015",3,3,0,247930,1375.333,156
"18894","61309","2015",21,21,0,167537.6,1761.333,95.80952
"18895","61310","2015",11,11,0,81577.27,929.6364,92.18182
"18896","61314","2015",3,3,0,105000,1142.667,81.33333
"18897","61316","2015",2,2,0,228500,1477.5,141.5
"18898","61317","2015",6,6,0,162208.3,1508,107.1667
"18899","61319","2015",3,3,0,137683.3,1152.667,119
"18900","61321","2015",3,3,0,164000,1301.667,128.6667
"18901","61322","2015",3,3,0,85000,1076.333,78.66667
"18902","61323","2015",2,2,0,81000,1945.5,41
"18903","61324","2015",18,17,1,75405.56,1040.722,83.38889
"18904","61326","2015",2,2,0,84500,973.5,90
"18905","61327","2015",5,5,0,183362,1613.4,105.8
"18906","61328","2015",2,2,0,207500,2206,92
"18907","61329","2015",3,3,0,131666.7,980.3333,102
"18908","61330","2015",4,4,0,132375,1379.25,100.75
"18909","61331","2015",1,1,0,227509,910,250
"18910","61333","2015",1,1,0,79000,1179,67
"18911","61339","2015",30,30,0,106144,1296.167,85
"18912","61341","2015",13,13,0,122461.5,1173.385,102.6154
"18913","61342","2015",10,10,0,97127.2,1466.8,81
"18914","61344","2015",14,14,0,88664.29,1064.643,83.71429
"18915","61345","2015",25,23,2,125192,1301.64,94.6
"18916","61346","2015",4,4,0,220806.5,2488.5,103.5
"18917","61347","2015",6,6,0,92666.67,787.5,111
"18918","61348","2015",6,6,0,87950,916.6667,86.33333
"18919","61350","2015",1,1,0,1e+05,1111,90
"18920","61351","2015",4,4,0,109625,1470.25,80
"18921","61357","2015",3,3,0,219000,1910.667,100
"18922","61358","2015",3,3,0,131166.7,1003.333,126.3333
"18923","61361","2015",2,2,0,110000,1078,103
"18924","61362","2015",2,1,1,96250,1409,68
"18925","61363","2015",1,1,0,110000,909,121
"18926","61365","2015",1,1,0,105000,1750,60
"18927","61366","2015",1,1,0,55000,1833,30
"18928","61367","2015",2,2,0,109750,961.5,119
"18929","61369","2015",8,8,0,150250,1086,123.875
"18930","61371","2015",3,3,0,85723.33,853.3333,100.6667
"18931","61372","2015",2,2,0,138000,1796.5,90
"18932","61373","2015",1,1,0,70000,761,92
"18933","61374","2015",1,1,0,35600,456,78
"18934","61375","2015",15,15,0,109253.3,1395.733,82.46667
"18935","61376","2015",10,9,1,53917.1,773.8,69.9
"18936","61379","2015",4,4,0,152250,1719.5,113.75
"18937","61382","2015",11,11,0,119049.1,1338.273,94.63636
"18938","61384","2015",1,1,0,42000,1400,30
"18939","61385","2015",3,3,0,59240,1108.333,56
"18940","61386","2015",6,6,0,175761.8,1528,124
"18941","61387","2015",5,5,0,75800,780.2,112.4
"18942","61388","2015",2,2,0,215500,1511,121
"18943","61389","2015",6,6,0,51400,811.3333,61
"18944","61390","2015",3,3,0,82666.67,882.3333,93.66667
"18945","61391","2015",34,31,3,112077.5,1097.176,101.7941
"18946","61394","2015",10,9,1,76560,1115.6,74.5
"18947","61395","2015",4,4,0,177500,1632,109.5
"18948","61397","2015",42,42,0,131989.8,1319.071,101.8095
"18949","61399","2015",2,2,0,192500,2460.5,76
"18950","61400","2015",4,4,0,104950,949.25,131
"18951","61401","2015",1,1,0,168000,2211,76
"18952","61402","2015",3,3,0,68033.33,1102,66.33333
"18953","61404","2015",3,3,0,126666.7,1766.667,73.33333
"18954","61405","2015",6,6,0,125900,874.8333,137.3333
"18955","61406","2015",1,1,0,120000,1500,80
"18956","61407","2015",6,6,0,163491.8,1958.5,79.16667
"18957","61411","2015",3,3,0,159333.3,1890.667,88.33333
"18958","61412","2015",5,5,0,98980,1278.4,89.4
"18959","61413","2015",1,1,0,80000,930,86
"18960","61414","2015",5,5,0,131000,1705.2,82.6
"18961","61415","2015",3,3,0,115733.3,1164,94
"18962","61418","2015",2,2,0,202000,1700,120
"18963","61419","2015",3,3,0,81833.33,770,105.6667
"18964","61420","2015",1,1,0,68000,1545,44
"18965","61421","2015",10,9,1,52340.1,650.4,79.4
"18966","61422","2015",10,10,0,71900,1025.1,70.6
"18967","61423","2015",3,3,0,170666.7,1303,133.3333
"18968","61424","2015",2,2,0,100100,1437,80.5
"18969","61425","2015",1,1,0,112000,1474,76
"18970","61426","2015",10,10,0,102477,1377.8,79.8
"18971","61427","2015",1,1,0,150000,3125,48
"18972","61429","2015",11,11,0,94363.64,1395.364,81.72727
"18973","61432","2015",1,1,0,170000,1977,86
"18974","61433","2015",3,3,0,313000,4200.333,116.3333
"18975","61435","2015",4,4,0,101760,1940.5,51.75
"18976","61436","2015",3,3,0,82240,959,77.33333
"18977","61438","2015",5,5,0,140120,1203.6,119.2
"18978","61439","2015",2,2,0,145825,1244.5,117
"18979","61440","2015",7,7,0,140928.6,1482.857,96.14286
"18980","61442","2015",1,1,0,110000,1294,85
"18981","61443","2015",5,5,0,124880,1110.2,114.2
"18982","61444","2015",5,5,0,99400,1068.6,88.8
"18983","61445","2015",3,3,0,107666.7,856,132.6667
"18984","61446","2015",2,2,0,405000,2503.5,146.5
"18985","61447","2015",15,15,0,93866.67,1074.6,89.8
"18986","61448","2015",3,3,0,172450,1254.333,133
"18987","61451","2015",2,2,0,87500,1124.5,76
"18988","61453","2015",3,3,0,141000,1136.333,136
"18989","61454","2015",6,6,0,137916.7,1216.167,113.8333
"18990","61456","2015",18,18,0,149416.7,1302.778,102.2222
"18991","61457","2015",3,3,0,59800,790.3333,75.66667
"18992","61459","2015",2,2,0,38250,431.5,88.5
"18993","61460","2015",6,6,0,99876,1043.667,101.3333
"18994","61461","2015",3,3,0,111000,1173,91.66667
"18995","61462","2015",12,12,0,132134.1,1379.5,100.25
"18996","61463","2015",6,6,0,87656.67,1048.167,77.5
"18997","61464","2015",29,28,1,104957.2,1130.207,94.72414
"18998","61466","2015",11,11,0,113355,1136.364,104.6364
"18999","61467","2015",2,2,0,145288.5,1468.5,104
"19000","61472","2015",1,1,0,82000,1171,70
"19001","61473","2015",2,2,0,93725,1036,89
"19002","61474","2015",35,35,0,120635.7,1235.943,100.2571
"19003","61475","2015",7,7,0,96928.57,1186.571,86.71429
"19004","61476","2015",3,3,0,98333.33,1112.667,103.3333
"19005","61482","2015",2,2,0,94225,1726,61
"19006","61483","2015",87,20,67,67224.02,1327.264,56.63218
"19007","61484","2015",29,29,0,113202.8,1185.138,96.51724
"19008","61485","2015",2,2,0,109000,1138.5,94.5
"19009","61486","2015",42,41,1,86902.86,922.3571,96
"19010","61487","2015",1,1,0,160000,1060,151
"19011","61490","2015",3,3,0,93666.67,1096,88.66667
"19012","61491","2015",46,46,0,109998,1335.478,87.26087
"19013","61494","2015",9,6,3,102333.3,999.1111,113
"19014","61497","2015",9,9,0,121377.8,1334.333,91
"19015","61498","2015",1,1,0,91090,1752,52
"19016","61499","2015",2,2,0,135700,1129.5,120
"19017","61500","2015",4,4,0,77500,989.5,76.25
"19018","61501","2015",6,6,0,162275,1603,92.66667
"19019","61502","2015",1,1,0,90000,1200,75
"19020","61503","2015",2,2,0,197435,1455,139
"19021","61505","2015",2,2,0,132500,1184.5,112
"19022","61507","2015",1,1,0,150000,1724,87
"19023","61508","2015",19,19,0,122134.4,1443.158,91.36842
"19024","61510","2015",2,2,0,103500,1305,79
"19025","62001","2015",21,21,0,195457.1,1822.667,107.381
"19026","62003","2015",6,5,1,104250,1475.667,79.33333
"19027","62004","2015",80,78,2,143184.4,1556.338,91.825
"19028","62005","2015",9,9,0,107444.4,1154,94.44444
"19029","62006","2015",6,6,0,69962.5,889,81.66667
"19030","62007","2015",7,7,0,183638.6,1687.571,109
"19031","62008","2015",8,8,0,120190,1303.125,103.375
"19032","62009","2015",1,1,0,123500,950,130
"19033","62010","2015",6,6,0,149557.3,1574.833,96
"19034","62011","2015",8,8,0,175250,1628.5,107.75
"19035","62012","2015",1,1,0,125000,1471,85
"19036","62013","2015",15,15,0,183910,1797.4,102
"19037","62014","2015",90,86,4,124674.8,1331.967,97.63333
"19038","62015","2015",3,3,0,164333.3,1141.333,119
"19039","62016","2015",2,2,0,145000,1230,126
"19040","62017","2015",1,1,0,131300,1412,93
"19041","62018","2015",6,6,0,142466.7,1266.833,116.1667
"19042","62019","2015",21,21,0,143031,1459.286,98.33333
"19043","62020","2015",11,11,0,125335.9,1375.818,93.63636
"19044","62021","2015",6,6,0,117666.7,1420,84.83333
"19045","62022","2015",3,3,0,111666.7,1172.667,89
"19046","62023","2015",34,34,0,113257.4,1220.794,92.58824
"19047","62024","2015",6,6,0,114000,1168.333,107.1667
"19048","62025","2015",20,16,4,185107.5,2558.8,81.6
"19049","62026","2015",1,1,0,75000,577,130
"19050","62027","2015",3,3,0,90000,758.6667,111.6667
"19051","62028","2015",5,5,0,73400,681.2,102.8
"19052","62029","2015",4,4,0,78420,860.5,87
"19053","62030","2015",3,3,0,106666.7,984.3333,106.6667
"19054","62031","2015",8,8,0,164750,1620,106.125
"19055","62032","2015",31,31,0,176941.9,1732.484,102.7742
"19056","62033","2015",45,45,0,136325.8,1526.711,91.6
"19057","62034","2015",21,21,0,141123.6,1403.238,101.4762
"19058","62035","2015",62,62,0,118611.1,1300.339,94.16129
"19059","62036","2015",5,4,1,95000,1117.6,84
"19060","62037","2015",33,32,1,212676.7,1948.212,111.5758
"19061","62038","2015",30,30,0,137212.6,1487.833,95.53333
"19062","62039","2015",14,14,0,194770.7,1699.214,115.2143
"19063","62040","2015",92,83,9,124424,1423.576,88.76087
"19064","62041","2015",470,254,216,133711,1725.815,82.16596
"19065","62042","2015",10,10,0,147720,1573.4,97.3
"19066","62043","2015",16,16,0,186281.2,1836.062,105.8125
"19067","62044","2015",5,5,0,117011.2,1328.4,90.2
"19068","62045","2015",10,9,1,136680,1558.8,94.3
"19069","62046","2015",3,3,0,89666.67,2294.333,74
"19070","62047","2015",2,2,0,65500,1085.5,71
"19071","62048","2015",85,83,2,86871.54,900.6941,97.70588
"19072","62049","2015",5,5,0,79479,999.4,77.6
"19073","62050","2015",9,9,0,98055.56,850.6667,110.6667
"19074","62051","2015",37,37,0,144400.9,1495.324,98.62162
"19075","62052","2015",5,5,0,189600,1589,137.6
"19076","62053","2015",2,2,0,120500,1027,111
"19077","62054","2015",15,15,0,184491.4,2104.067,90.13333
"19078","62055","2015",4,4,0,128037.5,1511.75,89
"19079","62056","2015",5,4,1,151460,2941,56.8
"19080","62057","2015",42,42,0,140736.6,1440.619,99.02381
"19081","62059","2015",2,2,0,72500,1506,47.5
"19082","62060","2015",19,18,1,117239.5,1083.789,112.3684
"19083","62061","2015",2,2,0,170000,1351,131
"19084","62063","2015",20,20,0,115655,1238.35,94.25
"19085","62064","2015",4,4,0,65320.5,932.75,69.75
"19086","62065","2015",108,104,4,124429.5,1434.306,88.7037
"19087","62067","2015",3,3,0,142833.3,1498.333,95.66667
"19088","62068","2015",3,3,0,163433.3,1563.333,111.3333
"19089","62069","2015",2,2,0,125000,732,169.5
"19090","62071","2015",5,5,0,95900,1168.8,85.2
"19091","62072","2015",1,1,0,170000,1417,120
"19092","62073","2015",11,11,0,165390.9,1611,104.0909
"19093","62074","2015",1,1,0,151500,881,172
"19094","62075","2015",15,15,0,214380.7,1807.467,119.8667
"19095","62077","2015",8,8,0,145687.5,1391.75,101.75
"19096","62078","2015",11,11,0,153136.4,1506.455,103.6364
"19097","62079","2015",1,1,0,90000,776,116
"19098","62080","2015",25,22,3,100832,1069.68,96.88
"19099","62081","2015",1,1,0,195000,1773,110
"19100","62082","2015",3,3,0,96140,688,138.6667
"19101","62083","2015",33,33,0,126880.9,1425.273,92.72727
"19102","62084","2015",1,1,0,75000,595,126
"19103","62085","2015",1,1,0,152000,1634,93
"19104","62086","2015",2,2,0,81100,977,83
"19105","62087","2015",9,9,0,178455.6,1347.333,129
"19106","62088","2015",2,2,0,72000,963,74.5
"19107","62089","2015",8,8,0,190712.5,1871,100.25
"19108","62090","2015",1,1,0,2e+05,1036,193
"19109","62092","2015",9,9,0,127777.8,1296.556,101
"19110","62093","2015",2,2,0,52900,1056,50
"19111","62094","2015",5,5,0,138560,1261,117.6
"19112","62095","2015",2,2,0,125000,1183.5,104
"19113","62096","2015",5,5,0,81386.4,766.6,113.2
"19114","62097","2015",3,3,0,156333.3,1561,107.6667
"19115","62099","2015",44,39,5,147864.8,1640.386,91.31818
"19116","62100","2015",13,13,0,140692.3,1571.385,86.76923
"19117","62101","2015",1,1,0,116000,734,158
"19118","62102","2015",1,1,0,150000,1364,110
"19119","62103","2015",1,1,0,2e+05,1026,195
"19120","62104","2015",7,7,0,183357.1,1686,108.4286
"19121","62105","2015",6,6,0,184000,1650.333,109.8333
"19122","62106","2015",3,3,0,140833.3,1532.667,94.66667
"19123","62107","2015",3,3,0,143333.3,1082.667,130.3333
"19124","62108","2015",245,124,121,127033,2145.531,65.09388
"19125","62111","2015",2,2,0,101000,1203.5,93.5
"19126","62112","2015",2,2,0,63000,788,80
"19127","62113","2015",6,6,0,137391.7,1092.833,136.5
"19128","62114","2015",2,2,0,108500,1101.5,102.5
"19129","62115","2015",3,3,0,206706.7,2029,96.66667
"19130","62116","2015",2,2,0,109650,1350,88.5
"19131","62117","2015",8,8,0,109875,1095.125,105.5
"19132","62118","2015",2,2,0,176000,1540.5,115
"19133","62119","2015",261,195,66,111535.7,1375.609,81.83142
"19134","62120","2015",2,2,0,85000,863,96.5
"19135","62122","2015",5,5,0,87900,994.6,87.6
"19136","62123","2015",3,3,0,170000,1823.333,98.66667
"19137","62124","2015",3,3,0,192666.7,1740.333,118.3333
"19138","62126","2015",76,70,6,108491.2,1323.382,85.69737
"19139","62127","2015",2,2,0,156500,1735.5,91.5
"19140","62128","2015",32,32,0,125909.7,1418.531,90.78125
"19141","62130","2015",5,5,0,121500,998.8,124
"19142","62131","2015",2,2,0,119000,1029.5,116
"19143","62132","2015",47,47,0,154906.3,1679.787,93.40426
"19144","62133","2015",45,43,2,109326.7,1238.244,91.35556
"19145","62134","2015",3,3,0,73000,819.3333,84
"19146","62135","2015",2,2,0,128000,1195.5,104.5
"19147","62138","2015",4,4,0,70250,798.25,104.5
"19148","62139","2015",44,44,0,114081.9,1240,93.52273
"19149","62140","2015",3,3,0,156333.3,1005,172.3333
"19150","62141","2015",4,4,0,114500,1045,107
"19151","62142","2015",2,2,0,118500,1462.5,86.5
"19152","62144","2015",4,4,0,183437.5,1534.25,118.75
"19153","62145","2015",2,2,0,157500,1203,122
"19154","62146","2015",2,2,0,132000,1699.5,79.5
"19155","62147","2015",3,3,0,140166.7,1632.333,83
"19156","62148","2015",6,6,0,161666.7,1622,97.5
"19157","62149","2015",2,2,0,151500,1600,95
"19158","62150","2015",9,9,0,127111.1,1563,86.77778
"19159","62151","2015",2,2,0,110000,1462.5,80.5
"19160","62152","2015",1,1,0,150000,1562,96
"19161","62153","2015",5,5,0,131800,1361.4,94
"19162","62154","2015",8,8,0,105125,920.25,119.875
"19163","62155","2015",3,3,0,132666.7,1159.667,105.6667
"19164","62156","2015",2,2,0,282300,2130,132.5
"19165","62158","2015",11,11,0,98636.36,1137.364,86.63636
"19166","62160","2015",367,201,166,110746.5,1426.24,82.42234
"19167","62161","2015",18,18,0,119083.3,1387.222,81.61111
"19168","62162","2015",6,6,0,97666.67,1155.167,95.83333
"19169","62163","2015",1,1,0,60000,833,72
"19170","62164","2015",9,9,0,100444.4,1052.556,99.11111
"19171","62165","2015",2,2,0,160000,1546,106.5
"19172","62166","2015",3,3,0,88666.67,1085,81
"19173","62167","2015",1,1,0,165000,2230,74
"19174","62168","2015",3,3,0,145000,1400,108
"19175","62169","2015",2,2,0,75750,678.5,109
"19176","62170","2015",23,23,0,145332,1527.261,94.21739
"19177","62171","2015",1,1,0,30000,600,50
"19178","62172","2015",6,6,0,171910.7,1835.833,94
"19179","62173","2015",35,35,0,112442.9,1407.943,79.94286
"19180","62174","2015",17,17,0,129649,1454.235,87.11765
"19181","62175","2015",2,2,0,165500,1580.5,107.5
"19182","62176","2015",2,2,0,105800,1430.5,83
"19183","62177","2015",7,7,0,175928.6,1575.286,113.4286
"19184","62178","2015",131,119,12,106392,1240.298,87.9771
"19185","62179","2015",2,2,0,136000,1220,108.5
"19186","62180","2015",4,4,0,139808.8,1191.5,116.25
"19187","62181","2015",12,12,0,105949.2,1015.75,112
"19188","62182","2015",3,3,0,99333.33,848.3333,126.3333
"19189","62183","2015",8,8,0,110275,1335.5,80.375
"19190","62184","2015",5,5,0,192000,1239.6,168
"19191","62185","2015",3,3,0,222583.3,1572.333,151
"19192","62186","2015",81,78,3,132511.8,1476.222,91.82716
"19193","62187","2015",1,1,0,218600,2043,107
"19194","62188","2015",20,20,0,81992.5,1008.25,81.75
"19195","62190","2015",11,11,0,134636.4,1331.636,100.0909
"19196","62191","2015",4,4,0,163250,1315,123.5
"19197","62192","2015",4,4,0,91750,1231.5,69
"19198","62193","2015",722,599,123,113013,1371.072,85.0277
"19199","62194","2015",29,29,0,101125.9,1068.172,100.7931
"19200","62195","2015",9,9,0,163411.1,1506,108.7778
"19201","62196","2015",5,5,0,151500,1442.4,108.2
"19202","62197","2015",15,15,0,125494.1,1101.333,110.5333
"19203","62198","2015",3,3,0,2e+05,1630,120
"19204","62199","2015",7,7,0,226357.1,1585,143.4286
"19205","62200","2015",8,8,0,177075,1320.25,146.25
"19206","62201","2015",83,53,30,139298.4,2439.663,60.03614
"19207","62202","2015",6,6,0,118000,937,133.3333
"19208","62203","2015",6,6,0,161000,1952,86.5
"19209","62204","2015",16,16,0,139181.2,1312.188,110.0625
"19210","62205","2015",7,7,0,221185.7,1691.571,127.7143
"19211","62206","2015",4,4,0,169750,1346.25,128
"19212","62207","2015",7,7,0,175928.6,1781.571,99.71429
"19213","62208","2015",1,1,0,175000,931,188
"19214","62209","2015",3,3,0,119666.7,1239.667,96.33333
"19215","62211","2015",2,2,0,217500,1606,148
"19216","62212","2015",3,3,0,113766.7,1147.333,99.66667
"19217","62214","2015",2,2,0,247000,1566,149
"19218","62215","2015",169,153,16,139117.6,1547.686,93.08284
"19219","62216","2015",1,1,0,125000,893,140
"19220","62217","2015",22,22,0,107631.8,1213.773,88.63636
"19221","62218","2015",2,2,0,135500,1175.5,116
"19222","62219","2015",2,2,0,64500,880.5,73
"19223","62220","2015",10,10,0,95033,1095.6,86.9
"19224","62221","2015",3,3,0,188933.3,1649.667,120
"19225","62222","2015",3,3,0,119833.3,1365.333,92
"19226","62223","2015",6,6,0,167583.3,1434.667,122.1667
"19227","62224","2015",23,23,0,120003.3,1409.609,87.3913
"19228","62225","2015",6,6,0,197400,2041.167,109.5
"19229","62227","2015",3,3,0,67333.33,919.6667,72.33333
"19230","62228","2015",4,4,0,156750,1617,97.5
"19231","62229","2015",7,7,0,163651.4,1600,105.1429
"19232","62230","2015",11,11,0,169445.5,1690.818,103.9091
"19233","62232","2015",11,11,0,128959.1,1205.818,114.4545
"19234","62233","2015",15,15,0,152086.7,1533.2,101
"19235","62234","2015",4,4,0,68225,704.5,100.75
"19236","62235","2015",24,24,0,258658.9,2079.875,125.7917
"19237","62236","2015",3,3,0,69666.67,746.3333,93
"19238","62237","2015",2,2,0,231500,1628,142.5
"19239","62238","2015",1,1,0,130000,1215,107
"19240","62239","2015",26,22,4,180549.7,2045.192,90.15385
"19241","62240","2015",20,20,0,116928.2,1360.6,86
"19242","62241","2015",3,3,0,188366.7,1572.333,121.6667
"19243","62242","2015",2,2,0,139500,1671,92
"19244","62244","2015",68,68,0,134508.1,1538.25,90.33824
"19245","62245","2015",6,6,0,136441.7,1591.167,79.66667
"19246","62246","2015",2,2,0,91187,927,98.5
"19247","62247","2015",7,7,0,85428.57,833.2857,100.4286
"19248","62248","2015",6,6,0,130826,1345.167,101
"19249","62249","2015",55,55,0,149786.2,1474,90.10909
"19250","62250","2015",85,84,1,146197.9,1506,97.34118
"19251","62251","2015",4,4,0,166500,1404.75,125.25
"19252","62252","2015",22,22,0,233365.9,1883.091,131.9545
"19253","62253","2015",1,1,0,60000,632,95
"19254","62254","2015",3,3,0,105000,1379,74.33333
"19255","62255","2015",6,6,0,139750,1461.167,96.66667
"19256","62256","2015",1,1,0,105000,955,110
"19257","62257","2015",1,1,0,77500,799,97
"19258","62258","2015",4,4,0,148750,1581.25,93.75
"19259","62259","2015",12,12,0,149045.8,1635.167,94.75
"19260","62260","2015",1,1,0,180000,1104,163
"19261","62261","2015",171,92,79,157653,2608.772,63.78363
"19262","62262","2015",9,9,0,126166.7,1308.556,94.33333
"19263","62263","2015",56,56,0,171282.8,1738.732,98.39286
"19264","62264","2015",7,7,0,117314.3,1208.571,96.42857
"19265","62265","2015",1,1,0,154000,1149,134
"19266","62266","2015",1,1,0,135000,1467,92
"19267","62267","2015",5,5,0,120800,1571.2,79
"19268","62268","2015",46,46,0,101436.6,1167.457,88.71739
"19269","62269","2015",6,6,0,79333.33,1039.333,78.66667
"19270","62270","2015",31,31,0,108451.7,1207.097,92.16129
"19271","62271","2015",7,7,0,155000,1450.571,108.2857
"19272","62272","2015",5,5,0,123300,1067.2,109.8
"19273","62273","2015",5,5,0,142175,1797.8,78.4
"19274","62274","2015",47,47,0,129371.4,1431.17,91.51064
"19275","62275","2015",4,4,0,105000,1203.25,79.75
"19276","62276","2015",52,52,0,151139.6,1516.596,103.3077
"19277","62277","2015",19,19,0,115757.9,1246,92.26316
"19278","62278","2015",6,6,0,149575,1680.167,88.16667
"19279","62279","2015",6,6,0,274575,2141.333,129.5
"19280","62280","2015",1,1,0,50000,562,89
"19281","62281","2015",4,4,0,166525,1487.25,110.5
"19282","62282","2015",1,1,0,73000,760,96
"19283","62284","2015",9,9,0,116082.2,1167.667,100.8889
"19284","62285","2015",5,5,0,138916,1304,99.6
"19285","62286","2015",4,4,0,136350,1279,100.75
"19286","62288","2015",18,18,0,148827.8,1512.056,101.6111
"19287","62289","2015",3,3,0,230000,2107.667,113.3333
"19288","62290","2015",3,3,0,262666.7,1882.333,137
"19289","62291","2015",21,20,1,134500,1627.81,90.57143
"19290","62292","2015",9,9,0,132816.7,1227.444,111
"19291","62293","2015",3,3,0,89000,983.6667,100
"19292","62295","2015",14,14,0,119857.1,1428.071,82.42857
"19293","62296","2015",2,2,0,139500,1711.5,80.5
"19294","62297","2015",33,33,0,152154,1478.909,104.4545
"19295","62298","2015",5,5,0,142000,1340.2,114.4
"19296","62299","2015",3,3,0,115666.7,1340.667,89
"19297","62300","2015",25,23,2,171008,2031.96,88.68
"19298","62301","2015",2,2,0,94500,1310.5,72
"19299","62302","2015",4,4,0,112125,946,127.25
"19300","62303","2015",2,2,0,97500,954,101
"19301","62304","2015",1,1,0,90000,1216,74
"19302","62306","2015",4,4,0,137750,1133.75,114.75
"19303","62307","2015",4,4,0,146500,2098.75,69
"19304","62308","2015",2,2,0,70000,976,70.5
"19305","62309","2015",16,16,0,104234.4,1158.062,91.1875
"19306","62310","2015",18,18,0,130816.3,1400.222,93.22222
"19307","62311","2015",20,20,0,177304.5,1758.3,101.9
"19308","62312","2015",2,2,0,93125,1135.5,68
"19309","62313","2015",4,4,0,93825,1142.25,87
"19310","62314","2015",5,5,0,145500,1501.2,95.6
"19311","62315","2015",7,7,0,188175.4,1844.857,102.1429
"19312","62316","2015",2,2,0,56500,460,122.5
"19313","62317","2015",5,5,0,149800,1211.2,120.2
"19314","62318","2015",85,82,3,139972.7,1625.859,86.71765
"19315","62319","2015",1,1,0,225380,1621,139
"19316","62320","2015",4,4,0,383500,1907.25,165.5
"19317","62321","2015",40,40,0,127006.5,1376.25,96.325
"19318","62323","2015",15,15,0,161900,1513.067,108.1333
"19319","62324","2015",5,5,0,123400,1395.4,87.6
"19320","62325","2015",7,6,1,98171.43,994.7143,95.42857
"19321","62326","2015",1,1,0,85000,966,88
"19322","62327","2015",1,1,0,156000,1200,130
"19323","62328","2015",8,8,0,102971.2,1162.125,93.25
"19324","62329","2015",4,4,0,150350,1358.5,110.5
"19325","62330","2015",21,21,0,200131.2,1869.048,114.7619
"19326","62331","2015",13,13,0,124569.2,1323.692,94.15385
"19327","62332","2015",4,4,0,169187.5,1385.25,131.75
"19328","62333","2015",2,2,0,100550,1227.5,91
"19329","62334","2015",6,6,0,146833.3,1274.5,112.1667
"19330","62335","2015",1,1,0,255000,1821,140
"19331","62336","2015",4,4,0,98400,1152.25,92.75
"19332","62337","2015",4,4,0,109000,1333.25,90.25
"19333","62338","2015",24,24,0,252791.7,2137.458,120.1667
"19334","62340","2015",10,10,0,88063.5,906,99.2
"19335","62341","2015",6,6,0,100500,1146.833,94.83333
"19336","62342","2015",1,1,0,80000,833,96
"19337","62343","2015",3,3,0,176830,1199,133.3333
"19338","62344","2015",1,1,0,78000,830,94
"19339","62345","2015",1,1,0,90000,789,114
"19340","62346","2015",5,5,0,101200,1254,80.6
"19341","62347","2015",1,1,0,131500,1384,95
"19342","62348","2015",2,2,0,142500,1298,109.5
"19343","62349","2015",13,13,0,144151.3,1459.692,96.61538
"19344","62350","2015",16,16,0,127080,1359.062,92.75
"19345","62351","2015",44,44,0,119914.7,1278.341,97.22727
"19346","62352","2015",1,1,0,130000,1857,70
"19347","62353","2015",6,6,0,107916.7,1001,132
"19348","62354","2015",4,4,0,145250,1836.75,84
"19349","62355","2015",5,5,0,241600,1619.6,157.4
"19350","62356","2015",5,5,0,67660,1088.6,59.8
"19351","62357","2015",1,1,0,97500,609,160
"19352","62358","2015",1,1,0,180500,1703,106
"19353","62359","2015",5,5,0,109996,1339.2,86.2
"19354","62360","2015",10,10,0,180000,1683.3,105.9
"19355","62361","2015",29,29,0,69258.62,829.5517,84.31034
"19356","62362","2015",1,1,0,103800,1081,96
"19357","62363","2015",4,4,0,209450,1762.25,122.5
"19358","62364","2015",15,14,1,97664.67,822.4,116.4
"19359","62365","2015",2,2,0,77325,1002,76.5
"19360","62366","2015",4,4,0,94065,877,101.25
"19361","62367","2015",5,5,0,172650,1657,103.2
"19362","62368","2015",1,1,0,45000,1125,40
"19363","62369","2015",4,4,0,151000,1578,98
"19364","62370","2015",1,1,0,129000,768,168
"19365","62371","2015",24,24,0,150679.2,1401.708,110.0417
"19366","62373","2015",8,8,0,151157.4,1523.75,99.625
"19367","62376","2015",22,22,0,154519,1494.091,103.2727
"19368","62377","2015",6,6,0,131241.7,1398.5,92
"19369","62378","2015",1,1,0,140000,1443,97
"19370","62379","2015",2,2,0,111250,850,112.5
"19371","62380","2015",3,3,0,167100,1523,123
"19372","62381","2015",3,3,0,136666.7,1137,124.3333
"19373","62382","2015",4,3,1,202500,1537.25,127.25
"19374","62383","2015",11,11,0,188877.7,1688.636,112.7273
"19375","62384","2015",7,7,0,116000,943.2857,123.7143
"19376","62385","2015",1,1,0,183500,1952,94
"19377","62386","2015",24,24,0,153360.2,1840.417,89.41667
"19378","62387","2015",2,2,0,68170,776.5,87
"19379","62388","2015",5,5,0,73762,977.2,83.4
"19380","62390","2015",13,13,0,191269.2,1851.385,104.6923
"19381","62391","2015",8,8,0,114662.5,1276,94.875
"19382","62392","2015",3,3,0,166000,1934.333,91
"19383","62393","2015",16,16,0,154125,1679.562,93.25
"19384","62395","2015",3,3,0,151666.7,1235.333,129.3333
"19385","62396","2015",1,1,0,117000,1073,109
"19386","62397","2015",59,58,1,131292.7,1425.492,92.23729
"19387","62398","2015",9,9,0,124777.8,1160.556,111.1111
"19388","62399","2015",3,3,0,158333.3,1591,99.66667
"19389","62400","2015",28,28,0,131621.6,1381.286,95.32143
"19390","62401","2015",45,45,0,141378.8,1484.911,95.68889
"19391","62402","2015",2,2,0,160500,2239,75.5
"19392","62403","2015",10,10,0,110886,1349.1,89.1
"19393","62404","2015",2,2,0,135750,1348,100.5
"19394","62405","2015",5,5,0,95200,958.6,105
"19395","62406","2015",3,3,0,73500,957.3333,83.66667
"19396","62407","2015",4,4,0,180250,1653.5,107.75
"19397","62408","2015",8,8,0,141800,1449.625,99.375
"19398","62409","2015",1,1,0,150000,1613,93
"19399","62410","2015",3,3,0,124666.7,1174,100.3333
"19400","62411","2015",1,1,0,1e+05,1053,95
"19401","62412","2015",9,9,0,156688.9,1729.111,90.88889
"19402","62413","2015",71,71,0,112844,1216.901,95.09859
"19403","62414","2015",1,1,0,135000,1378,98
"19404","62415","2015",2,2,0,174175,1852,106
"19405","62418","2015",3,3,0,187333.3,1481,127
"19406","62419","2015",2,2,0,187250,1583,119.5
"19407","62421","2015",4,4,0,70868,714,109.75
"19408","62422","2015",4,4,0,89695,963.25,96
"19409","62423","2015",13,13,0,121269.2,1320.538,90.61538
"19410","62424","2015",3,3,0,131000,2230,58.66667
"19411","62425","2015",1,1,0,192000,1297,148
"19412","62426","2015",2,2,0,95000,1243,76
"19413","62427","2015",228,217,11,118106.1,1315.171,91.9693
"19414","62428","2015",3,3,0,154216.7,1368.333,113.3333
"19415","62429","2015",3,3,0,109000,1194.333,98
"19416","62430","2015",1,1,0,142800,1428,100
"19417","62432","2015",2,2,0,68000,873,78
"19418","62435","2015",1,1,0,130000,1548,84
"19419","62437","2015",3,3,0,78333.33,984.6667,83.66667
"19420","62438","2015",4,4,0,163500,1538.75,108.5
"19421","62439","2015",2,2,0,132500,1170,112.5
"19422","62440","2015",8,8,0,110625,1322.75,85.875
"19423","62441","2015",2,2,0,146055,1208.5,112
"19424","62442","2015",3,3,0,121433.3,1129.667,115
"19425","62443","2015",42,42,0,128728.8,1334.69,98.09524
"19426","62444","2015",4,4,0,261000,2011,124.5
"19427","62445","2015",6,6,0,114725,1273.167,90.66667
"19428","62446","2015",7,7,0,154852.1,1309,119.7143
"19429","62447","2015",26,23,3,69886.92,796.7692,88.84615
"19430","62448","2015",19,19,0,180198.1,1686.368,109.9474
"19431","62449","2015",3,3,0,126666.7,1024.333,133
"19432","62450","2015",3,3,0,117666.7,1008,119.3333
"19433","62451","2015",2,2,0,145000,1395,102
"19434","62452","2015",9,9,0,144611.1,1446.667,100.8889
"19435","62453","2015",1,1,0,115000,1150,100
"19436","62454","2015",15,15,0,204128,1686.867,122.1333
"19437","62456","2015",8,8,0,172506.2,1622.125,111.5
"19438","62457","2015",53,51,2,108724.5,1230.774,87.81132
"19439","62458","2015",14,14,0,112165.4,1607,74.14286
"19440","62460","2015",1,1,0,126000,2520,50
"19441","62461","2015",15,15,0,106166.7,1114.067,100.1333
"19442","62463","2015",6,6,0,134583.3,1296.667,101.8333
"19443","62464","2015",25,25,0,161060,1615.52,105.24
"19444","62466","2015",3,3,0,119666.7,1018,108.6667
"19445","62467","2015",3,3,0,112000,1038.333,108.3333
"19446","62468","2015",2,2,0,50000,579,85.5
"19447","62469","2015",7,7,0,112021.4,1162,98
"19448","62470","2015",2,2,0,124289,1117,118
"19449","62471","2015",4,4,0,133525,1347,97.5
"19450","62472","2015",1,1,0,148000,1609,92
"19451","62473","2015",71,69,2,101921.3,1168.394,88.74648
"19452","62474","2015",17,15,2,134053.5,1441.941,95.41176
"19453","62475","2015",2,2,0,99500,1373.5,73
"19454","62477","2015",4,4,0,108250,992,107.75
"19455","62478","2015",1,1,0,129500,1619,80
"19456","62479","2015",15,15,0,112220,1281.267,90.86667
"19457","62480","2015",16,16,0,136322.8,1377.125,93.4375
"19458","62481","2015",2,2,0,101000,1159.5,83.5
"19459","62483","2015",4,4,0,149750,1851.25,86.25
"19460","62484","2015",3,3,0,147600,1138.333,123
"19461","62485","2015",3,3,0,93333.33,1051,90.66667
"19462","62486","2015",10,10,0,116300,1198.6,105.2
"19463","62487","2015",13,13,0,148620.8,1707.846,87.92308
"19464","62488","2015",7,7,0,164692.9,1748.429,96.28571
"19465","62489","2015",41,41,0,129729.5,1264.537,98.2439
"19466","62490","2015",1,1,0,218500,1572,139
"19467","62491","2015",57,56,1,212050,1891.14,113.4386
"19468","62492","2015",1,1,0,40000,563,71
"19469","62493","2015",1,1,0,136000,971,140
"19470","62494","2015",1,1,0,58000,967,60
"19471","62495","2015",4,4,0,128187.5,1080,121.75
"19472","62497","2015",60,60,0,158315.6,1658,98.28333
"19473","62498","2015",186,134,52,115948.3,1449.349,84.3871
"19474","62499","2015",3,3,0,200216.7,1616.667,123.3333
"19475","62500","2015",2,2,0,70000,1182.5,61
"19476","62501","2015",1,1,0,92300,1099,84
"19477","62502","2015",42,42,0,193255.5,1700.143,114.9524
"19478","62503","2015",1,1,0,160000,1860,86
"19479","62504","2015",1,1,0,172000,1147,150
"19480","62505","2015",1,1,0,205500,1885,109
"19481","62506","2015",12,12,0,186750,1735.667,125.0833
"19482","62507","2015",6,6,0,139466.7,2174.167,83.16667
"19483","62508","2015",1,1,0,58000,716,81
"19484","62509","2015",1,1,0,187000,1438,130
"19485","62510","2015",177,163,14,113876.5,1309.497,87.9887
"19486","62511","2015",4,4,0,109225,1178.75,91.25
"19487","62512","2015",10,10,0,116860,1257.4,100.6
"19488","62513","2015",1,1,0,210000,1019,206
"19489","62515","2015",10,10,0,119850,1340.7,96.5
"19490","62516","2015",86,84,2,96003.12,1083.488,88.56977
"19491","62518","2015",2,2,0,81750,953,88
"19492","62519","2015",2,2,0,49500,684,73.5
"19493","62520","2015",25,25,0,176498.5,1567.64,114.56
"19494","62521","2015",2,2,0,90000,822.5,109.5
"19495","62522","2015",2,2,0,52500,641,80
"19496","62523","2015",57,57,0,119231.6,1435.754,83.59649
"19497","62524","2015",13,13,0,144694.5,1422.692,108.3077
"19498","62525","2015",80,73,7,145282.2,1539.562,95.95
"19499","62526","2015",1,1,0,60000,1111,54
"19500","62528","2015",39,38,1,128171.8,1342.231,95
"19501","62529","2015",22,22,0,262033.4,1856.455,142.4545
"19502","62530","2015",2,2,0,130250,1252,104
"19503","62531","2015",12,12,0,138483.3,1605.5,91.75
"19504","62532","2015",10,10,0,109452,1334.8,90.6
"19505","62533","2015",2,2,0,130814.5,1071,121.5
"19506","62534","2015",24,24,0,99081.04,1209.708,81.91667
"19507","62535","2015",2,2,0,462500,2400.5,186
"19508","62536","2015",6,6,0,136033.3,1412.5,89
"19509","62537","2015",3,3,0,132000,1095.667,118
"19510","62538","2015",2,2,0,110000,1500,72.5
"19511","62539","2015",2,2,0,87500,1324,67.5
"19512","62540","2015",6,6,0,178797,1749.5,109.3333
"19513","62541","2015",1,1,0,60000,462,130
"19514","62542","2015",3,3,0,139000,1126.333,118.6667
"19515","62543","2015",13,13,0,137703.5,1538.692,91.61538
"19516","62544","2015",1,1,0,211800,2229,95
"19517","62546","2015",3,3,0,287630,2019.667,145.3333
"19518","62547","2015",1,1,0,183000,1366,134
"19519","62548","2015",91,86,5,159455.7,1585.549,103.3736
"19520","62549","2015",8,8,0,121750,1070.75,117.5
"19521","62550","2015",11,11,0,114245.5,989.0909,119.0909
"19522","62551","2015",3,3,0,145000,1202,124
"19523","62552","2015",1,1,0,50000,1562,32
"19524","62555","2015",33,33,0,143150.2,1555.636,97.57576
"19525","62557","2015",30,30,0,171504.3,1579.1,113.5667
"19526","62559","2015",10,9,1,146893.7,1349.8,112.6
"19527","62560","2015",51,46,5,128057.3,1488.549,87.76471
"19528","62561","2015",1,1,0,40000,1000,40
"19529","62562","2015",3,3,0,59333.33,781.3333,102.3333
"19530","62563","2015",51,50,1,140769.8,1489.725,95.23529
"19531","62564","2015",3,3,0,181333.3,1725.667,106.3333
"19532","62566","2015",4,4,0,150775,1358.75,114
"19533","62567","2015",7,7,0,123448.6,1396,92.85714
"19534","62568","2015",8,8,0,146331.2,1377.375,107.25
"19535","62569","2015",6,6,0,97483.33,1023.667,99.83333
"19536","62570","2015",62,61,1,122543.1,1470.129,84.75806
"19537","62571","2015",114,70,44,156307.5,2601.316,64.01754
"19538","62572","2015",4,4,0,112375,1289.75,89
"19539","62573","2015",41,41,0,145933.7,1496.22,98.29268
"19540","62574","2015",1,1,0,130000,1548,84
"19541","62576","2015",1,1,0,147000,865,170
"19542","62577","2015",1,1,0,50000,909,55
"19543","62578","2015",1,1,0,180000,1440,125
"19544","62579","2015",4,4,0,161225,1237.25,124.5
"19545","62580","2015",7,7,0,156357.1,1434.429,97.57143
"19546","62582","2015",6,6,0,134875,1182.167,115.8333
"19547","62583","2015",5,5,0,101420,1106,93.6
"19548","62584","2015",9,9,0,179305.6,1622.556,128.4444
"19549","62585","2015",5,5,0,152500,2462.4,75.6
"19550","62586","2015",9,9,0,232500,1809.889,133.5556
"19551","62587","2015",57,53,4,122589,1346.333,92.10526
"19552","62588","2015",24,19,5,158280.5,1907.875,90.5
"19553","62589","2015",12,11,1,143845.8,1583.417,92.83333
"19554","62591","2015",1,1,0,110000,1375,80
"19555","62592","2015",6,6,0,120466.7,1274,100.3333
"19556","62593","2015",1,1,0,66000,485,136
"19557","62594","2015",5,5,0,111840,1049.4,114.6
"19558","62595","2015",11,11,0,150068.2,1702.091,85.72727
"19559","62596","2015",2,2,0,210000,1247.5,181
"19560","62597","2015",3,3,0,155666.7,1340.333,121.3333
"19561","62598","2015",12,12,0,133922.5,1340.417,105.8333
"19562","62599","2015",1,1,0,150000,2206,68
"19563","62600","2015",2,2,0,102810,707,144
"19564","62601","2015",4,4,0,101750,1062.25,97.5
"19565","62602","2015",2,2,0,180000,1596,115.5
"19566","62603","2015",12,12,0,118626.7,1332,90
"19567","62604","2015",144,62,82,240614.7,3221.722,81.625
"19568","62606","2015",13,13,0,210746.2,1781.846,120.3846
"19569","62608","2015",1,1,0,68000,1333,51
"19570","62609","2015",15,15,0,217916.7,1709.667,136.8667
"19571","62610","2015",7,7,0,111714.3,1256,89.42857
"19572","62612","2015",9,9,0,164994.4,1614.333,104
"19573","62613","2015",7,7,0,118269.4,1205.286,99.14286
"19574","62614","2015",3,3,0,195333.3,1859.333,106
"19575","62615","2015",1,1,0,150000,1531,98
"19576","62616","2015",1,1,0,136000,2267,60
"19577","62617","2015",88,80,8,118788.3,1394.523,88.23864
"19578","62618","2015",10,10,0,147200,1649.1,96.4
"19579","62619","2015",1,1,0,1e+05,1190,84
"19580","62620","2015",8,8,0,111525,1148.125,95.625
"19581","62621","2015",10,10,0,184306,1629.9,114.6
"19582","62622","2015",3,3,0,153333.3,1164,143.3333
"19583","62623","2015",4,4,0,160900,1471.25,103
"19584","62624","2015",34,34,0,139085.6,1504.559,94.29412
"19585","62626","2015",20,20,0,162938,1649.15,99.1
"19586","62627","2015",4,4,0,198325,1476.5,132.5
"19587","62628","2015",44,40,4,106679.6,1312.409,83.29545
"19588","62629","2015",1,1,0,178000,1219,146
"19589","62630","2015",2,2,0,117500,1921.5,112.5
"19590","62631","2015",3,3,0,111666.7,1479.333,81.33333
"19591","62633","2015",2,2,0,120000,1290,95
"19592","62634","2015",9,9,0,175922.2,1545.778,114.8889
"19593","62636","2015",3,3,0,212666.7,1653,129.3333
"19594","62637","2015",51,50,1,142096.5,1520.804,99.15686
"19595","62638","2015",9,9,0,106277.8,1001,110.4444
"19596","62639","2015",4,4,0,175200,1618.75,110.75
"19597","62640","2015",2,2,0,135000,1027.5,132
"19598","62641","2015",1,1,0,142500,1532,93
"19599","62642","2015",1,1,0,87000,1776,49
"19600","62643","2015",121,109,12,115193.4,1278.223,91.22314
"19601","62644","2015",4,4,0,103875,1519.75,79.5
"19602","62645","2015",56,56,0,177986.4,1790.893,96.35714
"19603","62646","2015",7,7,0,114985.7,1350.429,83.85714
"19604","62647","2015",3,3,0,160000,1265.333,124
"19605","62648","2015",5,5,0,146400,1347,120.2
"19606","62649","2015",5,5,0,93800,978,98.6
"19607","62650","2015",8,8,0,136187.5,1255.125,111.375
"19608","62651","2015",5,5,0,125040,1286,101.8
"19609","62652","2015",25,25,0,97664,1191.88,86.96
"19610","62653","2015",8,8,0,230385,1649.125,138.125
"19611","62654","2015",6,6,0,184716.7,2104.667,101.5
"19612","62655","2015",7,7,0,102428.6,959.2857,110.2857
"19613","62656","2015",5,5,0,169908,1690.4,102.8
"19614","62657","2015",2,2,0,85000,749.5,112.5
"19615","62659","2015",1,1,0,136000,1015,134
"19616","62660","2015",4,4,0,121250,1362.75,92.5
"19617","62661","2015",7,7,0,96428.57,1301.857,75.85714
"19618","62662","2015",9,9,0,115316.7,1322.333,86.77778
"19619","62663","2015",3,3,0,93540,962,90.66667
"19620","62665","2015",2,2,0,86000,1154,75.5
"19621","62666","2015",45,45,0,126906.8,1502.6,86.75556
"19622","62667","2015",74,60,14,114935.1,1501.392,82.54054
"19623","62668","2015",3,3,0,134903.3,1406.333,98.66667
"19624","62669","2015",1,1,0,125200,1391,90
"19625","62670","2015",2,2,0,176860,1861,97.5
"19626","62671","2015",4,4,0,135750,1316.25,105
"19627","62672","2015",7,7,0,101542.9,981,105.1429
"19628","62673","2015",9,9,0,117663.3,1331.667,89.88889
"19629","62674","2015",2,2,0,140000,1640.5,85.5
"19630","62675","2015",3,3,0,88666.67,1107,83.66667
"19631","62677","2015",3,3,0,118333.3,1238,95
"19632","62678","2015",9,9,0,135405.6,1380.556,97.33333
"19633","62679","2015",5,5,0,152200,1655.2,86.6
"19634","62680","2015",4,4,0,118750,1156,102.25
"19635","62681","2015",2,2,0,143960,1264,114
"19636","62683","2015",1,1,0,21500,358,60
"19637","62684","2015",20,20,0,131580,1483.35,88.95
"19638","62685","2015",3,3,0,160833.3,1707.333,94
"19639","62686","2015",3,3,0,116716.7,1099.667,109.6667
"19640","62688","2015",52,52,0,166455.8,1891.904,84.53846
"19641","62690","2015",4,4,0,91750,1014.75,85
"19642","62691","2015",8,8,0,144718.8,1286.125,130.625
"19643","62692","2015",2,2,0,173270.5,1969,88
"19644","62693","2015",8,8,0,155712.5,1338.5,111.5
"19645","62694","2015",1,1,0,78000,951,82
"19646","62695","2015",2,2,0,52000,909.5,66
"19647","62696","2015",1,1,0,210000,1522,138
"19648","62697","2015",2,2,0,143200,1435,100.5
"19649","62698","2015",1,1,0,127000,1058,120
"19650","62699","2015",3,3,0,102500,1836,63
"19651","62700","2015",4,4,0,182750,1089.25,190
"19652","62701","2015",5,5,0,155440,1362.2,127
"19653","62702","2015",2,2,0,162800,1262,128.5
"19654","62703","2015",3,3,0,211200,1759,124.6667
"19655","62704","2015",2,2,0,145000,1374.5,105.5
"19656","62705","2015",21,21,0,157398.6,1573.429,100.4762
"19657","62706","2015",25,25,0,177657.2,1643.48,111.96
"19658","62708","2015",1,1,0,105000,1094,96
"19659","62709","2015",3,3,0,116666.7,1093.667,105.6667
"19660","62710","2015",2,2,0,107500,1029.5,138
"19661","62711","2015",26,26,0,141214.9,1581.577,92.61538
"19662","62712","2015",11,11,0,176290.9,1413,129.1818
"19663","62713","2015",5,5,0,171350,1324.6,134.2
"19664","62714","2015",7,7,0,236142.9,1965.714,120
"19665","62715","2015",3,3,0,122066.7,1204.667,109.6667
"19666","62716","2015",5,5,0,142540,1422.2,102.8
"19667","62717","2015",3,3,0,151333.3,1389.333,117.3333
"19668","62718","2015",13,13,0,139073.1,1438.308,98.69231
"19669","62719","2015",5,5,0,157200,1446.6,115.2
"19670","62720","2015",1,1,0,159400,1147,139
"19671","62721","2015",11,11,0,155266.4,1665,98.09091
"19672","62722","2015",1,1,0,1e+05,1042,96
"19673","62723","2015",1,1,0,95000,1462,65
"19674","62724","2015",45,45,0,135497.8,1469.067,93.88889
"19675","62725","2015",1,1,0,75000,750,100
"19676","62727","2015",9,9,0,175233.3,1401.222,132
"19677","62728","2015",5,5,0,165900,1336,122
"19678","62729","2015",3,3,0,112666.7,1171.667,97.66667
"19679","62730","2015",15,15,0,158283.3,1563,104.1333
"19680","62731","2015",1,1,0,45000,577,78
"19681","62733","2015",4,4,0,87125,1117,74.5
"19682","62734","2015",3,3,0,223666.7,1851.333,121
"19683","62735","2015",19,19,0,153959.6,1574.737,99.26316
"19684","62736","2015",47,46,1,191133.6,1810.34,106.3617
"19685","62737","2015",44,44,0,117302.3,1364.114,88.81818
"19686","62738","2015",1,1,0,175500,836,210
"19687","62739","2015",3,3,0,117333.3,1097.333,102.3333
"19688","62740","2015",5,5,0,108400,969.4,113.8
"19689","62741","2015",1,1,0,170000,1250,136
"19690","62742","2015",4,4,0,304331,4663.5,95
"19691","62743","2015",5,5,0,107600,1258.4,84.4
"19692","62744","2015",55,45,10,175178.6,1728.636,102.9455
"19693","62745","2015",3,3,0,101000,1453,69.33333
"19694","62746","2015",33,33,0,155114,1528.364,100.8485
"19695","62747","2015",5,5,0,160700,1746,89.8
"19696","62748","2015",33,33,0,169206.1,1632.364,103.697
"19697","62749","2015",7,7,0,112114.3,1132.857,95.14286
"19698","62750","2015",3,3,0,216900,1517.667,153.6667
"19699","62751","2015",6,6,0,219650,1773.833,125.5
"19700","62752","2015",16,16,0,202815.6,1967.688,106.25
"19701","62753","2015",92,74,18,158077.7,1769.598,89.59783
"19702","62754","2015",4,4,0,135625,1137,120
"19703","62755","2015",32,32,0,155794.8,1701.438,92.9375
"19704","62756","2015",9,9,0,108966.7,1262.222,85.22222
"19705","62757","2015",47,46,1,151403.6,1533.128,102.3617
"19706","62758","2015",119,94,25,152248,1672.277,97.57983
"19707","62759","2015",3,3,0,118000,1265.667,99.66667
"19708","62760","2015",2,2,0,72500,631.5,109
"19709","62762","2015",1,1,0,87000,916,95
"19710","62763","2015",8,8,0,106562.5,1208.375,88
"19711","62764","2015",37,35,2,169037.9,1706.649,100
"19712","62765","2015",158,117,41,119606,1466.968,88.34177
"19713","62766","2015",4,4,0,144850,1391.25,105
"19714","62767","2015",40,32,8,97962.5,1235.35,83.4
"19715","62769","2015",11,11,0,176000,1559.818,123.0909
"19716","62770","2015",14,14,0,139471.4,1291.786,110
"19717","62771","2015",34,34,0,113162.1,1304.765,90.32353
"19718","62772","2015",6,6,0,133746.7,1471.167,99.66667
"19719","62773","2015",34,34,0,136460.4,1531.618,105.4118
"19720","62774","2015",44,40,4,172134.3,1936.364,95
"19721","62776","2015",1,1,0,125800,758,166
"19722","62777","2015",5,5,0,89200,989,93.8
"19723","62778","2015",1,1,0,132500,1183,112
"19724","62780","2015",3,3,0,116333.3,931.3333,124
"19725","62781","2015",8,7,1,122625.5,1240.75,106
"19726","62782","2015",1,1,0,120000,1034,116
"19727","62783","2015",5,5,0,103980,1391.2,81.4
"19728","62784","2015",4,4,0,109000,1117.5,100.5
"19729","62785","2015",9,7,2,129624.9,2825.667,83.11111
"19730","62786","2015",1,1,0,25000,521,48
"19731","62787","2015",4,4,0,117375,1344.75,89.25
"19732","62788","2015",5,5,0,100600,1079,95.6
"19733","62791","2015",1,1,0,85000,594,143
"19734","62792","2015",13,13,0,123053.8,1745.846,71.23077
"19735","62793","2015",7,7,0,184892.9,1419.857,132
"19736","62794","2015",10,10,0,150747.3,1540.1,102.6
"19737","62795","2015",2,2,0,105000,985.5,106
"19738","62796","2015",7,7,0,192222.7,1771,116
"19739","62797","2015",2,2,0,119400,1041.5,116
"19740","62798","2015",1,1,0,162700,1085,150
"19741","62799","2015",10,10,0,193470,1476.2,132
"19742","62800","2015",4,4,0,89250,945.25,95.25
"19743","62801","2015",34,34,0,173825.6,1735,101.0588
"19744","62802","2015",1,1,0,39000,500,78
"19745","62803","2015",4,4,0,186725,1530.25,131
"19746","62804","2015",6,6,0,121666.7,977,123
"19747","62805","2015",1,1,0,4e+05,3200,125
"19748","62808","2015",2,2,0,80500,994,82.5
"19749","62809","2015",1,1,0,201385,2238,90
"19750","62810","2015",8,8,0,152481.2,1460.5,102.125
"19751","62811","2015",12,12,0,142208.3,1481.083,99.91667
"19752","62812","2015",9,9,0,113588.9,1340.889,87.55556
"19753","62813","2015",6,6,0,131400,1295.167,104.6667
"19754","62816","2015",1,1,0,153000,1800,85
"19755","62817","2015",15,13,2,163946.7,1658.133,100.4667
"19756","62818","2015",2,2,0,55000,769,80
"19757","62819","2015",8,8,0,161016.8,1666.25,104.5
"19758","62820","2015",4,4,0,90214.75,1122,83
"19759","62821","2015",4,4,0,172250,1432,140.5
"19760","62823","2015",3,3,0,153666.7,1193.333,128.3333
"19761","62824","2015",2,2,0,119250,1170,104
"19762","62825","2015",7,7,0,192585.7,1793.714,107.1429
"19763","62826","2015",437,106,331,265774.7,4201.117,64.14188
"19764","62827","2015",9,9,0,122777.8,1256.889,104.4444
"19765","62829","2015",6,6,0,96505.83,1087.667,93
"19766","62830","2015",2,2,0,37500,466.5,82
"19767","62831","2015",1,1,0,198000,1356,146
"19768","62832","2015",1,1,0,276000,1957,141
"19769","62835","2015",1,1,0,130000,1250,104
"19770","62836","2015",15,15,0,226206.7,1684,134.5333
"19771","62837","2015",2,2,0,96500,1409.5,69
"19772","62838","2015",1,1,0,44000,367,120
"19773","62839","2015",5,5,0,108270,1049.4,101.4
"19774","62840","2015",1,1,0,75500,1238,61
"19775","62841","2015",29,29,0,151225.3,1418.621,108.4138
"19776","62842","2015",42,41,1,159969,1597.738,104.4762
"19777","62843","2015",4,4,0,105500,1309,101
"19778","62844","2015",3,3,0,79500,1275.333,64.66667
"19779","62845","2015",3,3,0,139833.3,1526.333,90
"19780","62846","2015",29,29,0,147189.7,1405.828,106.8276
"19781","62847","2015",13,13,0,140346.2,1434.462,99.23077
"19782","62848","2015",34,34,0,124253,1432.647,86.88235
"19783","62849","2015",19,19,0,170421.1,1802.579,96.42105
"19784","62851","2015",9,9,0,190444.4,1562,120.1111
"19785","62852","2015",18,18,0,168581.9,1663.333,103.5556
"19786","62853","2015",3,3,0,136000,1065,139
"19787","62854","2015",5,5,0,213700,1610.2,132.6
"19788","62855","2015",1,1,0,125500,951,132
"19789","62856","2015",2,2,0,93000,902,113.5
"19790","62857","2015",1,1,0,180000,1169,154
"19791","62858","2015",1,1,0,53000,662,80
"19792","62859","2015",4,4,0,72000,726.25,100.25
"19793","62861","2015",33,33,0,149904.5,1628.182,99.60606
"19794","62863","2015",50,50,0,171557.4,1789.34,100.8
"19795","62864","2015",9,9,0,150516.7,1406.889,109.4444
"19796","62865","2015",46,46,0,135079.9,1466.13,93.71739
"19797","62866","2015",4,4,0,131500,1538.75,90.75
"19798","62867","2015",3,3,0,202333.3,1911.333,109.3333
"19799","62868","2015",5,5,0,171100,1573.8,115.4
"19800","62869","2015",7,7,0,151714.3,1356.286,116
"19801","62870","2015",7,7,0,140889.7,1734,81.71429
"19802","62871","2015",7,7,0,128642.9,1271.143,96.85714
"19803","62872","2015",2,2,0,91000,933.5,100
"19804","62873","2015",6,6,0,158166.7,1510.5,102.1667
"19805","62874","2015",10,10,0,126750,1261.4,100.1
"19806","62875","2015",6,6,0,184866.7,1615.833,114
"19807","62876","2015",1,1,0,136900,1556,88
"19808","62878","2015",5,5,0,220900,1812,122.6
"19809","62880","2015",5,5,0,176660,1614.6,116.6
"19810","62881","2015",4,4,0,166125,1223.75,168.25
"19811","62882","2015",13,13,0,137926.9,1326.615,105
"19812","62883","2015",4,4,0,114562.5,1062,113.5
"19813","62885","2015",2,2,0,101500,1266,83
"19814","62886","2015",4,4,0,83750,938.25,80.5
"19815","62887","2015",1,1,0,110000,902,122
"19816","62888","2015",2,2,0,275000,2480,147.5
"19817","62889","2015",9,9,0,205472.8,1656,124.4444
"19818","62890","2015",7,7,0,113417.9,1289.571,99.85714
"19819","62891","2015",1,1,0,245000,1094,224
"19820","62892","2015",8,8,0,189250,1648.25,115.625
"19821","62893","2015",140,70,70,208292,2764,78.92143
"19822","62894","2015",52,49,3,172044.5,1799.808,91.5
"19823","62895","2015",42,42,0,130970.6,1463.952,93.90476
"19824","62896","2015",5,5,0,188600,1419.2,138.6
"19825","62897","2015",4,4,0,113280,1295.75,90.5
"19826","62898","2015",2,2,0,203050,2277,97.5
"19827","62899","2015",27,20,7,215981.5,3387.741,68.85185
"19828","62900","2015",10,10,0,128490,1465.1,92.7
"19829","62901","2015",10,10,0,157900,1554.7,100.6
"19830","62902","2015",28,28,0,126677.5,1366.607,94.67857
"19831","62903","2015",7,7,0,168900,1676.714,125.7143
"19832","62904","2015",4,4,0,148750,1484.75,102
"19833","62905","2015",5,5,0,135602.4,1112.2,116.6
"19834","62906","2015",17,17,0,144723.5,1456.706,98.70588
"19835","62907","2015",46,44,2,135876.6,1549.696,88.26087
"19836","62908","2015",9,9,0,217421.1,1850.778,117.3333
"19837","62909","2015",5,5,0,87400,833.4,109.2
"19838","63001","2015",28,27,1,131291.8,1310.5,101.6429
"19839","63003","2015",45,42,3,113597.6,1222.378,100.2444
"19840","63004","2015",11,11,0,108273.6,1161.909,91.54545
"19841","63005","2015",7,7,0,159993.6,1642.143,100.4286
"19842","63006","2015",1,1,0,30000,429,70
"19843","63007","2015",4,4,0,69425,881.75,75.25
"19844","63008","2015",3,3,0,111500,905,127
"19845","63009","2015",8,8,0,66459.38,760,84.5
"19846","63010","2015",6,5,1,67750,968.8333,63.66667
"19847","63011","2015",5,5,0,114800,805.4,130.4
"19848","63012","2015",9,9,0,123804.9,1584.889,83.33333
"19849","63013","2015",8,8,0,152455.6,1440.375,100.75
"19850","63014","2015",126,68,58,146371.9,2087.667,70.4127
"19851","63015","2015",3,3,0,99533.33,899.3333,106
"19852","63016","2015",4,4,0,96285,1054.25,89.5
"19853","63017","2015",2,2,0,64525,877.5,69
"19854","63019","2015",27,27,0,140668.4,1669.778,83.66667
"19855","63020","2015",2,2,0,204350,1707,129.5
"19856","63021","2015",5,5,0,188058,1919.6,96.4
"19857","63022","2015",33,33,0,91667.58,1227.242,79.45455
"19858","63023","2015",4,3,1,122457.5,1368,85.75
"19859","63024","2015",1,1,0,125000,1276,98
"19860","63025","2015",1,1,0,90000,1552,58
"19861","63026","2015",30,30,0,169667.2,1969.8,88.76667
"19862","63027","2015",1,1,0,73000,912,80
"19863","63028","2015",1,1,0,55000,688,80
"19864","63029","2015",3,3,0,92500,1397.667,65.66667
"19865","63030","2015",6,6,0,155533.3,1181.667,143.8333
"19866","63031","2015",5,5,0,109400,1186.2,91
"19867","63032","2015",155,66,89,163391,2136.516,76.70323
"19868","63033","2015",3,3,0,71333.33,867,64.66667
"19869","63034","2015",10,10,0,151162,1606.3,95.1
"19870","63035","2015",14,14,0,202163.6,1806.429,111.7857
"19871","63036","2015",2,2,0,271900,1506,175.5
"19872","63037","2015",5,5,0,86300,750.8,119.6
"19873","63038","2015",55,17,38,118230.1,2555.327,49.01818
"19874","63039","2015",1,1,0,30000,375,80
"19875","63040","2015",58,52,6,148719.9,1391.517,104.2931
"19876","63041","2015",1,1,0,90000,372,242
"19877","63042","2015",31,28,3,189657.4,1880.806,99.6129
"19878","63043","2015",6,6,0,104183.8,1127,88.5
"19879","63044","2015",5,5,0,133060,1333,106.4
"19880","63045","2015",2,2,0,173325,1277.5,136
"19881","63046","2015",1,1,0,60000,1034,58
"19882","63047","2015",73,23,50,78684.32,1356.986,61.94521
"19883","63048","2015",7,7,0,67300,725.5714,90.28571
"19884","63049","2015",9,9,0,196134.4,2028.778,97.33333
"19885","63050","2015",24,24,0,85430.54,1103.333,82.625
"19886","63051","2015",4,4,0,194125,1868.75,102.75
"19887","63052","2015",8,8,0,118617.5,1126.625,100.75
"19888","63053","2015",3,3,0,102966.7,802,123
"19889","63054","2015",5,5,0,149680,1335.4,108
"19890","63055","2015",7,7,0,151696.4,1310.714,119.2857
"19891","63056","2015",5,5,0,70600,797,86.4
"19892","63057","2015",1,1,0,65000,867,75
"19893","63058","2015",5,5,0,133686,1241.8,105.8
"19894","63059","2015",2,2,0,155800,1592,95
"19895","63061","2015",6,6,0,129491.7,1028.667,124.5
"19896","63062","2015",1,1,0,142500,1004,142
"19897","63063","2015",73,60,13,171015.2,1938.781,89.47945
"19898","63064","2015",1,1,0,35000,389,90
"19899","63066","2015",10,10,0,90625,800.2,114.8
"19900","63067","2015",1,1,0,160000,1481,108
"19901","63069","2015",58,49,9,169766.5,1911.155,90.06897
"19902","63070","2015",74,60,14,221269.3,2347.811,96.2027
"19903","63071","2015",5,5,0,168500,1582.6,100
"19904","63072","2015",5,5,0,112260,1235.8,91.2
"19905","63073","2015",3,3,0,68833.33,1343.667,52.33333
"19906","63074","2015",3,3,0,166626.7,1227.333,144.6667
"19907","63075","2015",325,51,274,159166.3,2019.628,75.46769
"19908","63076","2015",1,1,0,16800,622,27
"19909","63077","2015",12,12,0,105337.1,1988.75,67.83333
"19910","63079","2015",4,4,0,92587.5,1028.25,89.75
"19911","63080","2015",15,15,0,150701,1425.133,104.7333
"19912","63081","2015",5,5,0,51400,783.6,65
"19913","63082","2015",7,7,0,117250,1309.429,87.42857
"19914","63083","2015",2,2,0,226600,1995,116
"19915","63084","2015",18,18,0,210489.4,1981.222,107.1111
"19916","63085","2015",10,10,0,116684,1205.1,101.5
"19917","63086","2015",6,6,0,74566.67,760,94.66667
"19918","63087","2015",1,1,0,50740,564,90
"19919","63089","2015",12,12,0,183651.7,1715.25,107.4167
"19920","63090","2015",2,2,0,76412.5,1473,51.5
"19921","63091","2015",9,9,0,87910.89,1055.111,80.88889
"19922","63092","2015",13,13,0,157963.8,1521.308,96.92308
"19923","63093","2015",12,12,0,142154.2,1372.167,116.3333
"19924","63094","2015",6,6,0,55416.67,651.6667,87
"19925","63095","2015",2,2,0,58500,843.5,64
"19926","63096","2015",5,5,0,144380,1496.2,96.4
"19927","63097","2015",2,2,0,97600,1117.5,91
"19928","63098","2015",5,5,0,128800,1947.6,68.8
"19929","63099","2015",21,19,2,203630.3,2131.762,100.8095
"19930","63100","2015",2,2,0,52750,534.5,100
"19931","63101","2015",1,1,0,38500,713,54
"19932","63102","2015",8,8,0,56700,822,67.75
"19933","63103","2015",90,57,33,149318.6,1671.667,87.22222
"19934","63104","2015",2,2,0,101995,907,105
"19935","63105","2015",2,2,0,78875,932,75
"19936","63106","2015",15,15,0,144796,1660.267,89.26667
"19937","63107","2015",6,6,0,186856.7,1907.333,99.83333
"19938","63108","2015",5,5,0,161950,1592.6,108.2
"19939","63109","2015",1,1,0,165000,1854,89
"19940","63110","2015",2,2,0,149853,1679.5,89
"19941","63111","2015",1,1,0,116900,1113,105
"19942","63112","2015",3,3,0,130866.7,1150,131
"19943","63113","2015",1857,310,1547,121370.3,1848.138,66.2154
"19944","63114","2015",1,1,0,70000,530,132
"19945","63115","2015",2,2,0,134500,1297.5,107.5
"19946","63116","2015",34,33,1,124987.9,1505.324,87.17647
"19947","63117","2015",3,3,0,70000,1321,90
"19948","63118","2015",1,1,0,48000,393,122
"19949","63119","2015",5,5,0,130023.2,1318.8,108.6
"19950","63120","2015",9,9,0,175550,1732.444,101.6667
"19951","63121","2015",16,15,1,129219.4,1550.375,82.0625
"19952","63122","2015",1,1,0,59500,1082,55
"19953","63123","2015",1,1,0,67000,744,90
"19954","63124","2015",192,135,57,174510.5,1899.161,92.46354
"19955","63125","2015",37,36,1,93019.19,1018.595,88.37838
"19956","63126","2015",4,4,0,304512.5,2166,142.25
"19957","63128","2015",4,4,0,132712.5,1011.25,133.5
"19958","63129","2015",5,5,0,75260,955.8,81.2
"19959","63130","2015",5,5,0,81780,948.8,84.4
"19960","63131","2015",10,10,0,131195,1487.9,89.3
"19961","63132","2015",15,14,1,69500.2,891.2667,81.53333
"19962","63134","2015",2,2,0,98025,779.5,120
"19963","63135","2015",8,8,0,178006.2,1888.25,95
"19964","63136","2015",5,5,0,109849.2,1454.6,79.6
"19965","63137","2015",2,2,0,53250,1053,55.5
"19966","63138","2015",2,2,0,158000,1545,105.5
"19967","63139","2015",6,6,0,84547,1011.333,93.5
"19968","63140","2015",1,1,0,96500,1038,93
"19969","63141","2015",9,9,0,286650,2271.111,123.3333
"19970","63142","2015",3,2,1,101000,2913.333,51
"19971","63143","2015",4,3,1,94135,1196.5,81
"19972","63144","2015",4,4,0,52750,754.25,75.75
"19973","63145","2015",3,3,0,75028.33,783.6667,94.66667
"19974","63146","2015",9,9,0,143461.1,1542.222,95.88889
"19975","63147","2015",1,1,0,77000,1100,70
"19976","63148","2015",17,17,0,167433.5,1951.471,85.52941
"19977","63149","2015",6,6,0,126905,1671.833,72.66667
"19978","63150","2015",11,10,1,178947.3,1827.182,95.90909
"19979","63151","2015",7,7,0,89767.14,1049.857,85.71429
"19980","63152","2015",2,2,0,42750,584.5,72.5
"19981","63153","2015",3,3,0,74333.33,1137.667,70.66667
"19982","63154","2015",4,4,0,120287.5,1432.75,88
"19983","63155","2015",7,7,0,120984.3,1362.143,93.71429
"19984","63156","2015",2,2,0,80285,648,122.5
"19985","63157","2015",1,1,0,138000,2300,60
"19986","63158","2015",1,1,0,50000,521,96
"19987","63160","2015",6,6,0,170191.7,1678.5,102.1667
"19988","63161","2015",3,3,0,96666.67,1129,86.33333
"19989","63163","2015",4,3,1,96750,875,114.5
"19990","63164","2015",105,73,32,146536.4,1767.629,83.82857
"19991","63165","2015",9,9,0,96811.11,964.4444,96.33333
"19992","63166","2015",3,3,0,116966.7,1062.333,105
"19993","63167","2015",4,4,0,171125,1718.25,98.5
"19994","63168","2015",4,4,0,214475,1582.5,136
"19995","63170","2015",2,2,0,166347.5,1351,123.5
"19996","63171","2015",4,4,0,62817.5,1061,71
"19997","63173","2015",5,4,1,60800,980.4,66.8
"19998","63175","2015",2,2,0,54500,482.5,119
"19999","63177","2015",5,5,0,144550,1368.2,100.4
"20000","63178","2015",159,97,62,122803.5,1505.956,82.23899
"20001","63179","2015",11,10,1,92018.18,866.3636,96.27273
"20002","63180","2015",7,7,0,121864.3,1102.571,113.7143
"20003","63181","2015",4,4,0,89022.5,1639.5,54.75
"20004","63182","2015",4,4,0,65960,678.25,93.5
"20005","63184","2015",5,5,0,111700,1003,128
"20006","63185","2015",11,11,0,105846.4,1087.273,102.7273
"20007","63186","2015",2,2,0,130500,2039.5,68.5
"20008","63187","2015",6,6,0,84500,782.1667,110.1667
"20009","63188","2015",3,3,0,139500,1120.667,115
"20010","63189","2015",5,5,0,76212,980.8,78.8
"20011","63190","2015",4,4,0,64837.5,944.75,78.25
"20012","63191","2015",1,1,0,42600,426,100
"20013","63192","2015",12,12,0,93791.67,954.6667,102.9167
"20014","63193","2015",54,44,10,162743.1,1865.037,87.77778
"20015","63194","2015",6,6,0,150141.7,1457.833,104.5
"20016","63195","2015",49,48,1,169384.8,1763.653,96.87755
"20017","63196","2015",8,8,0,90875,1102.125,82.125
"20018","63197","2015",2,2,0,106000,1146.5,93
"20019","63198","2015",12,12,0,158400,1475.5,114.8333
"20020","63199","2015",4,4,0,133542.5,1280,100.25
"20021","63200","2015",9,9,0,176833.7,1464,115.1111
"20022","63201","2015",5,5,0,118480,1203.6,90
"20023","63202","2015",1,1,0,189000,1235,153
"20024","63203","2015",9,9,0,220800,1771.889,121.8889
"20025","63204","2015",10,10,0,130708,1756,77.5
"20026","63205","2015",2,2,0,129175,1271.5,141
"20027","63206","2015",17,17,0,134286.5,1237.294,109.0588
"20028","63207","2015",8,8,0,81744.38,1053.75,90.125
"20029","63208","2015",4,4,0,57500,781.75,75.5
"20030","63209","2015",1,1,0,57200,733,78
"20031","63210","2015",20,20,0,126360.2,1247.25,107.25
"20032","63211","2015",13,13,0,84107.69,856.3077,102.3077
"20033","63212","2015",15,15,0,224272.7,1788.2,121.8
"20034","63213","2015",22,22,0,181016,1852.227,100.3636
"20035","63214","2015",37,37,0,180749.2,1785.432,98.27027
"20036","63215","2015",6,6,0,229218.3,2051.667,115.8333
"20037","63218","2015",2,2,0,73025,904.5,83.5
"20038","63219","2015",7,7,0,136586.4,1344.714,104.8571
"20039","63220","2015",1,1,0,39200,754,52
"20040","63221","2015",3,3,0,102500,1175,95.33333
"20041","63222","2015",6,6,0,140250,1467.167,95.16667
"20042","63223","2015",12,12,0,68133.33,871.3333,82.83333
"20043","63224","2015",9,9,0,170244.4,1797.556,98.33333
"20044","63225","2015",16,16,0,62595.69,760,88.375
"20045","63226","2015",28,28,0,161922.2,1640.143,98.10714
"20046","63228","2015",3,3,0,93233.33,1393.333,64.66667
"20047","63229","2015",13,13,0,173854.4,1478.308,118.6154
"20048","63230","2015",2,2,0,208925,1193,149.5
"20049","63231","2015",12,11,1,76041.67,918.1667,88.08333
"20050","63232","2015",6,6,0,107600,942.5,108.6667
"20051","63233","2015",6,6,0,72166.67,787.3333,88.33333
"20052","63234","2015",15,15,0,98886.67,1117.733,92.13333
"20053","63235","2015",8,8,0,149513.8,1574,94.875
"20054","63236","2015",97,13,84,82825.07,1953.649,46.27835
"20055","63237","2015",2,2,0,57100,543.5,92.5
"20056","63238","2015",1,1,0,102000,850,120
"20057","63239","2015",6,6,0,122430.2,1235.667,102.8333
"20058","63240","2015",8,7,1,162368.8,1613.375,96.75
"20059","63241","2015",6,6,0,174458.3,2344.333,88.5
"20060","63242","2015",5,5,0,86000,832.4,95.6
"20061","63243","2015",5,5,0,91487,1033.8,112.8
"20062","63244","2015",12,12,0,157973.8,1441.167,106.25
"20063","63245","2015",37,35,2,198719.6,1792.973,112.0811
"20064","63246","2015",13,9,4,118795.2,1700.462,88.23077
"20065","63247","2015",14,13,1,99040.71,1369.5,77.64286
"20066","63248","2015",3,3,0,225333.3,2057.667,109
"20067","63249","2015",8,8,0,103312.5,1167.75,100
"20068","63250","2015",10,10,0,165014,1536.9,109
"20069","63251","2015",3,3,0,73333.33,912,108
"20070","63252","2015",6,6,0,178400,1504.667,122.6667
"20071","63253","2015",4,4,0,150237.5,1257,125.75
"20072","63254","2015",14,14,0,263149.3,2126,122.7857
"20073","63255","2015",3,3,0,290531.7,1777.333,161.6667
"20074","63256","2015",1,1,0,50000,694,72
"20075","63257","2015",4,4,0,141648,1373.25,102.75
"20076","63258","2015",5,5,0,67466,1166,82.2
"20077","63259","2015",5,5,0,126734,1520.2,85.4
"20078","63260","2015",4,4,0,75070,818.25,91.5
"20079","63261","2015",7,7,0,179628.6,1600.571,119
"20080","63262","2015",17,17,0,154330,1731.941,87.29412
"20081","63263","2015",10,10,0,219670,2021.8,116.2
"20082","63265","2015",19,18,1,151254.1,1464.947,106.1579
"20083","63267","2015",3,3,0,54666.67,685,83.66667
"20084","63269","2015",5,4,1,97730,1421.6,69.2
"20085","63270","2015",4,4,0,133025,1351.5,101.75
"20086","63271","2015",8,8,0,113155,1071.625,102.5
"20087","63272","2015",16,16,0,227625,1888.875,120.1875
"20088","63274","2015",2,2,0,97000,1070,89
"20089","63275","2015",6,6,0,153600,1112.667,133.5
"20090","63276","2015",14,14,0,143668.6,1350.786,112.5714
"20091","63278","2015",6,6,0,227387.5,1975.167,114.3333
"20092","63279","2015",8,8,0,132316.2,1642.375,81.125
"20093","63280","2015",2,2,0,126100,1631,80.5
"20094","63281","2015",11,11,0,73456.36,829.5455,95.09091
"20095","63282","2015",15,15,0,140873.3,1450.667,96.46667
"20096","63283","2015",4,4,0,108150,886.5,122.75
"20097","63284","2015",61,60,1,197011.8,1921.459,102.2459
"20098","63285","2015",8,7,1,82076.25,998,88.375
"20099","63286","2015",1,1,0,70000,795,88
"20100","63287","2015",1,1,0,120000,800,150
"20101","63288","2015",6,6,0,108083.3,1602.833,68.33333
"20102","63289","2015",2,2,0,117610,646,173.5
"20103","63290","2015",1,1,0,65000,833,78
"20104","63291","2015",26,26,0,104569.8,1136.038,89.76923
"20105","63293","2015",8,8,0,83093.75,687.625,112.875
"20106","63294","2015",3,3,0,105666.7,1369,77.33333
"20107","63295","2015",16,16,0,123512.5,1204,108.3125
"20108","63296","2015",3,3,0,94266.67,1537.667,57.66667
"20109","63297","2015",6,6,0,122300,1184,100
"20110","63298","2015",5,5,0,108200,1405.4,92.2
"20111","63299","2015",1,1,0,50000,595,84
"20112","63300","2015",216,124,92,140786.5,1651.597,84.93519
"20113","63301","2015",9,9,0,94911.11,924.3333,112.4444
"20114","63302","2015",32,32,0,187355.6,1787.031,106.2188
"20115","63303","2015",1,1,0,25000,357,70
"20116","63304","2015",1,1,0,50000,625,80
"20117","63305","2015",3,3,0,130300,958.6667,132.6667
"20118","63306","2015",4,4,0,246250,1934,117.25
"20119","63307","2015",70,58,12,188817.5,2099.486,90.27143
"20120","63308","2015",69,25,44,151741.8,1931.928,76.18841
"20121","63309","2015",5,5,0,112952,861.4,132.8
"20122","63310","2015",1,1,0,235000,1567,150
"20123","63311","2015",8,8,0,155668.8,1310,124.125
"20124","63312","2015",3,3,0,62460,622.3333,101.3333
"20125","63314","2015",7,7,0,118342.9,935.5714,116
"20126","63315","2015",22,21,1,185433.9,1846.545,98.31818
"20127","63317","2015",5,5,0,151600,1270.8,124
"20128","63318","2015",6,6,0,128516.7,1266.667,100.3333
"20129","63319","2015",11,9,2,66880,810.8182,83.72727
"20130","63321","2015",6,6,0,174200,1655,105.5
"20131","63322","2015",16,16,0,181407.1,1756.875,107.4375
"20132","63323","2015",1,1,0,45000,511,88
"20133","63324","2015",3,3,0,39000,661.6667,58.33333
"20134","63326","2015",4,4,0,105137.5,1408.75,90.75
"20135","63327","2015",31,31,0,170275.6,1673.29,102.1613
"20136","63329","2015",3,3,0,87666.67,999,89.66667
"20137","63330","2015",5,5,0,186200,1439.8,131.6
"20138","63331","2015",3,3,0,58666.67,945,62.33333
"20139","63332","2015",6,6,0,168466.7,1914.667,95
"20140","63333","2015",3,3,0,141500,1120,118.6667
"20141","63334","2015",1,1,0,50000,667,75
"20142","63335","2015",2,2,0,105600,1464,70.5
"20143","63336","2015",4,4,0,80647.5,1107,73.5
"20144","63337","2015",3,3,0,75666.67,866.6667,86.66667
"20145","63338","2015",26,26,0,58888.73,800.4615,77.80769
"20146","63339","2015",2,2,0,30000,503,61
"20147","63340","2015",5,5,0,92940,979.6,80
"20148","63341","2015",5,5,0,92360,973.2,94.2
"20149","63342","2015",1,1,0,50000,769,65
"20150","63343","2015",6,6,0,94027.17,827.3333,119
"20151","63344","2015",2,2,0,147500,2126.5,67.5
"20152","63345","2015",24,24,0,198242.5,1792.167,114.1667
"20153","63346","2015",3,3,0,92565,1486,77.66667
"20154","63347","2015",5,5,0,106600,1347.2,86.4
"20155","63348","2015",4,4,0,141750,1677.5,82.5
"20156","63349","2015",17,17,0,91637.24,1114.412,81.82353
"20157","63350","2015",13,13,0,181104.6,1755.154,106.2308
"20158","63351","2015",1,1,0,35000,467,75
"20159","63352","2015",14,14,0,94850,1235.286,79.5
"20160","63353","2015",5,5,0,76088,714.8,103.4
"20161","63354","2015",11,11,0,85118.18,1071.636,94.18182
"20162","63355","2015",3,3,0,53000,706,72.33333
"20163","63356","2015",2,2,0,150550,1514.5,105
"20164","63357","2015",1,1,0,90000,909,99
"20165","63358","2015",5,5,0,130593.6,1266.8,102.4
"20166","63359","2015",2,2,0,29000,538.5,52.5
"20167","63360","2015",1,1,0,55000,1038,53
"20168","63362","2015",8,8,0,179812.5,1494.75,122.75
"20169","63363","2015",2,2,0,90000,1103.5,86.5
"20170","63364","2015",8,8,0,171500,1666.375,102.125
"20171","63365","2015",8,8,0,116079.4,1117.625,105
"20172","63366","2015",4,4,0,162457.8,1405,112.75
"20173","63367","2015",2,2,0,145500,907,160.5
"20174","63368","2015",18,18,0,156202.8,1490,104.6667
"20175","63370","2015",2,2,0,62500,911,68.5
"20176","63371","2015",4,4,0,73850,939.75,75.25
"20177","63372","2015",9,9,0,174805.6,1623.222,110.1111
"20178","63374","2015",1,1,0,134000,1340,100
"20179","63375","2015",3,3,0,117750,955,121
"20180","63376","2015",6,6,0,66916.67,799.5,86
"20181","63377","2015",3,3,0,30933.33,395.6667,80.66667
"20182","63378","2015",10,10,0,170360,1769.2,98.9
"20183","63379","2015",2,2,0,156900,1857.5,89.5
"20184","63380","2015",6,4,2,103285.8,2359.333,68
"20185","63381","2015",19,16,3,107183.7,1448.737,77.68421
"20186","63383","2015",5,5,0,103100,1240,84.2
"20187","63384","2015",4,4,0,47875,899.5,52.25
"20188","63385","2015",1,1,0,179500,1743,103
"20189","63386","2015",10,10,0,110964,1162,92.9
"20190","63387","2015",7,7,0,119321.4,1294.714,94
"20191","63388","2015",1,1,0,22000,338,65
"20192","63389","2015",1,1,0,118000,2269,52
"20193","63390","2015",3,3,0,110000,1114.667,97.33333
"20194","63391","2015",3,3,0,99000,878,113
"20195","63392","2015",3,3,0,119566.7,1615.333,67.66667
"20196","63393","2015",23,23,0,92989.78,1175.957,81.78261
"20197","63394","2015",2,2,0,63500,869.5,85
"20198","63395","2015",12,12,0,129791.1,1302.417,100.8333
"20199","63396","2015",6,6,0,115466.7,1481,79.66667
"20200","63397","2015",12,12,0,99525.83,1225.083,84.5
"20201","63398","2015",1,1,0,65000,677,96
"20202","63399","2015",1,1,0,93175,1758,53
"20203","63400","2015",4,4,0,112805.5,1011.5,114.25
"20204","63401","2015",1,1,0,130600,1187,110
"20205","63402","2015",5,5,0,49800,784.6,63.6
"20206","63403","2015",6,6,0,187255,1480.333,141.3333
"20207","63404","2015",4,4,0,171587.5,1876,93.75
"20208","63405","2015",8,8,0,137043.8,1670.25,83.375
"20209","63406","2015",3,3,0,90666.67,746,128.6667
"20210","63407","2015",1,1,0,25000,500,50
"20211","63408","2015",2,2,0,103250,911,112.5
"20212","63409","2015",3,3,0,123810,1830.667,69.33333
"20213","63410","2015",1,0,1,34750,695,50
"20214","63411","2015",9,9,0,161627.4,1504,122.4444
"20215","63412","2015",4,4,0,87434.25,947.75,98.25
"20216","63413","2015",9,9,0,178124.4,1857.667,94.77778
"20217","63414","2015",5,5,0,131920,1286.2,108.6
"20218","63415","2015",21,20,1,96648.81,1176.381,85.95238
"20219","63416","2015",2,2,0,80000,725,118
"20220","63417","2015",22,21,1,150904.1,1719.955,87.45455
"20221","63418","2015",4,4,0,157450,1366,117.25
"20222","63419","2015",11,11,0,99542.73,1150.091,94.81818
"20223","63420","2015",1,1,0,214300,1674,128
"20224","63421","2015",6,6,0,71291.67,898.1667,80.66667
"20225","63422","2015",5,5,0,141700,1287.6,112.6
"20226","63423","2015",7,7,0,123785.7,1158.143,105.8571
"20227","63424","2015",3,3,0,103436.7,1200.333,84
"20228","63425","2015",14,14,0,194801.4,2079.857,95.42857
"20229","63426","2015",5,5,0,84820,1050,83.8
"20230","63427","2015",1,1,0,166000,1953,85
"20231","63428","2015",2,2,0,99575,1209,87.5
"20232","63429","2015",1,1,0,105000,784,134
"20233","63430","2015",90,71,19,85706.01,1006.578,84.67778
"20234","63431","2015",3,3,0,100616.7,1045,110
"20235","63432","2015",8,8,0,121700,1398.25,88.125
"20236","63433","2015",1,1,0,75000,556,135
"20237","63434","2015",6,6,0,88916.67,826,108.5
"20238","63435","2015",2,2,0,105300,1511.5,72.5
"20239","63437","2015",1,1,0,69000,1769,39
"20240","63438","2015",4,4,0,94550,876,104.5
"20241","63439","2015",6,6,0,101266.7,1159.667,90.5
"20242","63440","2015",2,2,0,82750,835.5,97
"20243","63441","2015",6,6,0,78416.67,1098.167,71.66667
"20244","63443","2015",6,6,0,169081.5,1769.5,95.83333
"20245","63444","2015",1,1,0,184500,1883,98
"20246","63445","2015",1,1,0,136000,1813,75
"20247","63446","2015",7,7,0,123043.4,1240.143,98.71429
"20248","63447","2015",1,1,0,55000,357,154
"20249","63448","2015",12,12,0,99729.17,1172.25,95.75
"20250","63449","2015",5,5,0,103048,1414,73.6
"20251","63450","2015",4,4,0,45500,744,63.25
"20252","63451","2015",7,7,0,84907.14,1527.571,56.71429
"20253","63452","2015",2,2,0,106000,1250.5,85
"20254","63453","2015",36,34,2,155716.8,1563.417,99.36111
"20255","63454","2015",4,4,0,79025,850.5,86.25
"20256","63455","2015",30,26,4,186741.3,1790,104.6667
"20257","63456","2015",3,3,0,124766.7,1119.333,112
"20258","63457","2015",51,49,2,147078.8,1672.549,86.52941
"20259","63458","2015",4,4,0,128600,1158.75,118.75
"20260","63459","2015",5,5,0,145180,1086.2,135.4
"20261","63460","2015",3,3,0,86971.67,914,102
"20262","63461","2015",2,2,0,72000,1142.5,69
"20263","63462","2015",2,2,0,75000,736.5,100.5
"20264","63463","2015",3,3,0,46000,508.3333,91.33333
"20265","63464","2015",3,3,0,133833.3,1118.667,117
"20266","63465","2015",2,2,0,121000,1583,75
"20267","63467","2015",1,1,0,119700,855,140
"20268","63468","2015",6,6,0,89583.33,964.1667,95.83333
"20269","63469","2015",4,4,0,47136.25,490.25,94.75
"20270","63470","2015",54,53,1,147273.7,1613.648,94.87037
"20271","63471","2015",7,7,0,74642.86,910.1429,79.28571
"20272","63472","2015",8,8,0,130968.8,1336.25,92.25
"20273","63473","2015",6,6,0,117816.7,1387.167,86.83333
"20274","64001","2015",3,3,0,134242,1259.333,108.6667
"20275","64003","2015",2,2,0,135500,1654.5,83.5
"20276","64004","2015",3,3,0,102616.7,917,120
"20277","64005","2015",3,3,0,147666.7,1614.667,89.33333
"20278","64006","2015",5,5,0,131460,1129.6,118
"20279","64009","2015",23,12,11,343825.9,3124.304,104
"20280","64010","2015",7,7,0,163428.6,1277,142.2857
"20281","64011","2015",1,1,0,2e+05,2105,95
"20282","64014","2015",2,2,0,223524,1832.5,119.5
"20283","64015","2015",1,1,0,53943,457,118
"20284","64016","2015",1,1,0,17500,515,34
"20285","64017","2015",1,1,0,50000,435,115
"20286","64021","2015",6,6,0,224900,1671.833,142
"20287","64023","2015",10,10,0,173559.7,1378.2,138
"20288","64024","2015",615,190,425,276893.6,3597.911,74.87642
"20289","64027","2015",2,2,0,217000,1569.5,146
"20290","64028","2015",3,3,0,112333.3,1007.667,111.6667
"20291","64029","2015",8,8,0,113571.2,956.75,118.125
"20292","64031","2015",1,1,0,155000,1742,89
"20293","64032","2015",2,2,0,77750,1171.5,60.5
"20294","64033","2015",2,2,0,125000,1123,121
"20295","64034","2015",1,1,0,194810,1838,106
"20296","64035","2015",19,10,9,468572.1,3556.947,130.6842
"20297","64036","2015",3,3,0,189663.3,1739.333,107.6667
"20298","64037","2015",11,11,0,200099.1,1736.364,116.2727
"20299","64038","2015",30,17,13,365076.3,3047.5,121.2667
"20300","64039","2015",1,1,0,144450,1553,93
"20301","64040","2015",31,11,20,76921.77,1634.065,54.03226
"20302","64041","2015",4,4,0,184675,1518.5,124.25
"20303","64042","2015",5,5,0,136800,1650.2,81.8
"20304","64043","2015",2,2,0,182000,1888,98
"20305","64046","2015",2,2,0,147800,1639.5,93
"20306","64047","2015",1,1,0,213000,1919,111
"20307","64049","2015",3,3,0,172600,1404.333,113.3333
"20308","64050","2015",2,2,0,110000,1126,106.5
"20309","64051","2015",7,3,4,104714.3,1288.857,87.71429
"20310","64053","2015",2,2,0,228017,2234.5,102
"20311","64054","2015",5,5,0,131540,1561.6,83.4
"20312","64057","2015",18,17,1,141947.2,1359.833,107.1667
"20313","64058","2015",1,1,0,45800,1579,29
"20314","64059","2015",8,8,0,268037.5,2153.75,126.375
"20315","64060","2015",10,8,2,199836.6,2146.6,95.1
"20316","64061","2015",21,19,2,170037.2,1598.762,109.2381
"20317","64062","2015",18,17,1,131297.2,1386.111,103.2222
"20318","64063","2015",7,6,1,129662.1,1257.571,103.2857
"20319","64064","2015",3,3,0,119980,1258.333,94
"20320","64065","2015",44,28,16,346060.9,3099,109.7045
"20321","64066","2015",2,2,0,189500,1450,147
"20322","64067","2015",12,12,0,228951.6,1839.583,128.0833
"20323","64068","2015",19,18,1,153371.4,1636.368,97.26316
"20324","64069","2015",4,4,0,73375,809.5,83
"20325","64070","2015",1,1,0,213400,1721,124
"20326","64071","2015",2,2,0,150300,1359.5,107.5
"20327","64072","2015",3,3,0,329690,2489.333,161.3333
"20328","64073","2015",4,4,0,195312.5,1697.75,117.75
"20329","64077","2015",3,3,0,131233.3,1282.667,105.3333
"20330","64078","2015",1,1,0,152200,2272,67
"20331","64080","2015",8,8,0,237473.8,1959.625,126.25
"20332","64081","2015",1,1,0,60000,429,140
"20333","64083","2015",2,2,0,119980,1671.5,67
"20334","64084","2015",2,2,0,111500,948.5,120
"20335","64085","2015",2,2,0,166805,1784.5,94
"20336","64086","2015",5,2,3,230916,2615,85.4
"20337","64087","2015",8,8,0,156343.6,1449.25,111.875
"20338","64088","2015",1,1,0,208472,1913,109
"20339","64090","2015",1,1,0,355000,2101,169
"20340","64091","2015",5,5,0,157320,1480.6,117.2
"20341","64093","2015",6,6,0,122525,1154.333,111.3333
"20342","64094","2015",11,8,3,208522.7,2246.273,93.18182
"20343","64095","2015",4,4,0,148250,1546.5,109.75
"20344","64096","2015",3,3,0,182000,1773,110.6667
"20345","64097","2015",5,5,0,180840,1415.8,129.8
"20346","64098","2015",1,1,0,83000,532,156
"20347","64099","2015",1,1,0,80000,941,85
"20348","64100","2015",39,20,19,316682.2,3070.026,103.5897
"20349","64101","2015",2,2,0,181900,1929.5,93
"20350","64102","2015",772,63,709,170844.8,2580.367,67.25259
"20351","64103","2015",2,2,0,136780,1012,137.5
"20352","64104","2015",7,6,1,101285.7,1498.857,69.14286
"20353","64105","2015",2,2,0,1e+05,625.5,155.5
"20354","64106","2015",4,4,0,120155,1614,77.25
"20355","64108","2015",7,7,0,118423.6,1107.857,112.8571
"20356","64109","2015",22,22,0,188041.6,1533.364,127
"20357","64110","2015",2,2,0,65500,1324.5,49.5
"20358","64111","2015",1,1,0,30500,871,35
"20359","64112","2015",6,6,0,155008.3,1160.333,136.3333
"20360","64114","2015",9,9,0,172416.7,1374.778,130.6667
"20361","64116","2015",2,2,0,143500,1118,124
"20362","64117","2015",1,1,0,117000,854,137
"20363","64118","2015",1,1,0,36000,818,44
"20364","64120","2015",1,1,0,170000,1478,115
"20365","64121","2015",1,1,0,115000,1162,99
"20366","64122","2015",652,113,539,316402.4,4607.718,68.98466
"20367","64123","2015",13,10,3,193003.8,1655,132.6923
"20368","64125","2015",107,43,64,320746.9,4073.85,77.15888
"20369","64126","2015",4,4,0,140250,1578.25,89.75
"20370","64128","2015",1,1,0,35000,350,100
"20371","64129","2015",204,45,159,117090.2,1720.951,68.19118
"20372","64130","2015",9,1,8,133440,2174.667,63.88889
"20373","64131","2015",4,4,0,154734.5,1626,100.5
"20374","64132","2015",50,36,14,185841.8,1816.74,107.26
"20375","64133","2015",9,7,2,168611.1,1364.667,132.8889
"20376","64134","2015",1,1,0,210000,1981,106
"20377","64135","2015",3,3,0,121666.7,1162.667,109.6667
"20378","64136","2015",1,1,0,30000,429,70
"20379","64137","2015",3,3,0,161470,1195.667,133.3333
"20380","64138","2015",16,16,0,174821.9,1614,110.9375
"20381","64139","2015",4,4,0,228250,2175.75,118
"20382","64140","2015",103,47,56,205353.5,2588.301,80.04854
"20383","64141","2015",2,2,0,120800,981,123
"20384","64142","2015",6,6,0,214341.7,1805.333,118
"20385","64143","2015",1,1,0,167000,1876,89
"20386","64145","2015",2,2,0,214975,1621.5,134.5
"20387","64147","2015",15,8,7,221682.1,2151.2,101.2
"20388","64148","2015",3,2,1,142666.7,1331.667,108.3333
"20389","64149","2015",1,1,0,365000,2074,176
"20390","64151","2015",1,1,0,127850,1421,90
"20391","64152","2015",9,8,1,244760,2115.778,127.1111
"20392","64154","2015",1,1,0,145000,1169,124
"20393","64156","2015",7,6,1,164300,1229.857,133.4286
"20394","64157","2015",6,6,0,132666.7,1434.5,100.1667
"20395","64158","2015",3,3,0,112400,807,139.3333
"20396","64159","2015",1,1,0,94000,1044,90
"20397","64160","2015",82,24,58,169606.7,2394.146,72.58537
"20398","64161","2015",10,10,0,162868,1406.1,118.1
"20399","64162","2015",1,1,0,95000,586,162
"20400","64165","2015",2,2,0,169100,1014,166
"20401","64166","2015",1,1,0,155000,1582,98
"20402","64168","2015",4,4,0,137000,1372,99.75
"20403","64171","2015",1,1,0,204200,1908,107
"20404","64172","2015",3,3,0,165669.7,1818.667,94
"20405","64173","2015",1,1,0,125000,2315,54
"20406","64175","2015",1,1,0,70620,565,125
"20407","64177","2015",4,4,0,117837.5,1112.5,110.25
"20408","64178","2015",1,1,0,144000,960,150
"20409","64180","2015",2,2,0,163000,1097.5,137
"20410","64181","2015",2,2,0,129250,1279.5,105
"20411","64183","2015",4,4,0,236825,1636,136.5
"20412","64184","2015",5,5,0,196266,1868.2,110.4
"20413","64187","2015",1,1,0,80000,762,105
"20414","64188","2015",5,5,0,110220,1044.2,103.8
"20415","64189","2015",171,31,140,276260.8,3659.626,79.67836
"20416","64190","2015",1,1,0,167000,1380,121
"20417","64191","2015",6,5,1,144833.3,1742,84.66667
"20418","64194","2015",3,3,0,251883.3,1649.333,152.3333
"20419","64197","2015",1,1,0,227000,1816,125
"20420","64198","2015",13,13,0,203814.6,1879.769,114.6154
"20421","64199","2015",1,1,0,228600,762,300
"20422","64200","2015",1,1,0,188000,1270,148
"20423","64201","2015",2,2,0,127125,729.5,197
"20424","64202","2015",2,1,1,108350,1450.5,105
"20425","64203","2015",3,3,0,203333.3,2081.333,103
"20426","64204","2015",34,4,30,59909.68,1522.824,42.47059
"20427","64205","2015",3,3,0,176316.7,1448,141.6667
"20428","64206","2015",3,3,0,94666.67,873,112
"20429","64207","2015",1,1,0,2e+05,2062,97
"20430","64208","2015",3,3,0,130400,1128,113.6667
"20431","64209","2015",3,3,0,140666.7,1463.667,94.66667
"20432","64210","2015",2,2,0,191420,1480.5,135
"20433","64211","2015",6,6,0,178494.7,1509.333,116.3333
"20434","64212","2015",1,1,0,224550,1871,120
"20435","64213","2015",5,4,1,269000,2365,117.6
"20436","64214","2015",4,4,0,188802.5,1161,161
"20437","64216","2015",11,8,3,219518.2,1915.545,121.5455
"20438","64217","2015",2,2,0,162500,1352,132.5
"20439","64219","2015",1,1,0,132000,1404,94
"20440","64220","2015",2,2,0,141000,1281,99
"20441","64221","2015",1,1,0,442000,1768,250
"20442","64223","2015",2,1,1,71000,625,118
"20443","64224","2015",2,2,0,166000,1768,96
"20444","64225","2015",5,5,0,188000,1950.4,102.8
"20445","64226","2015",3,3,0,156966.7,1295.333,127.3333
"20446","64227","2015",6,6,0,130475,1739.5,85.16667
"20447","64228","2015",1,1,0,160000,1143,140
"20448","64230","2015",46,41,5,193341.1,1711.283,116.8043
"20449","64231","2015",4,4,0,124750,969.25,127
"20450","64232","2015",1,1,0,208000,2364,88
"20451","64233","2015",10,10,0,140694,1324.5,105.1
"20452","64234","2015",5,5,0,125284,941,140.6
"20453","64235","2015",1,1,0,230000,1966,117
"20454","64237","2015",46,27,19,177845.4,1801.391,102.087
"20455","64238","2015",13,13,0,165603.1,1309.462,121.3846
"20456","64239","2015",2,2,0,93000,1041.5,89
"20457","64240","2015",1,1,0,69000,945,73
"20458","64241","2015",2,2,0,78000,854.5,98.5
"20459","64242","2015",1,1,0,205330,1416,145
"20460","64243","2015",3,3,0,192300,1531.333,126
"20461","64244","2015",1,1,0,60000,750,80
"20462","64245","2015",3,3,0,136233.3,1707.333,79.33333
"20463","64246","2015",2,2,0,186950,1844,101
"20464","64247","2015",4,4,0,150250,1197,135.25
"20465","64249","2015",27,11,16,552699.4,4955.481,105.9259
"20466","64250","2015",2,2,0,144386,1259.5,114.5
"20467","64252","2015",6,6,0,173621.7,1548.167,116.1667
"20468","64253","2015",3,3,0,213550,1006,175
"20469","64254","2015",4,4,0,171862.5,1767.25,98.25
"20470","64255","2015",1,1,0,150000,1667,90
"20471","64256","2015",59,35,24,202742.5,2053.153,100.661
"20472","64257","2015",1,1,0,176857,2211,80
"20473","64258","2015",5,5,0,101500,937.8,118.4
"20474","64259","2015",7,3,4,118000,1310.429,86.14286
"20475","64260","2015",351,39,312,167312.7,2927.872,60.16239
"20476","64261","2015",4,4,0,189812.5,1694,112
"20477","64262","2015",1,1,0,71800,598,120
"20478","64265","2015",1,1,0,115000,1150,100
"20479","64268","2015",1,1,0,123000,1352,91
"20480","64269","2015",39,33,6,282429.8,2307.026,123.641
"20481","64270","2015",10,7,3,231431.9,2629.3,84.9
"20482","64271","2015",3,3,0,161755,1228,130.3333
"20483","64273","2015",4,4,0,163000,1669,98.5
"20484","64274","2015",4,4,0,166825,1235.75,141
"20485","64275","2015",2,2,0,121250,1537,72
"20486","64276","2015",4,4,0,123541,1087.5,130
"20487","64277","2015",4,4,0,240981.8,2082.5,122.5
"20488","64279","2015",5,3,2,197780.4,2144.4,91
"20489","64280","2015",4,3,1,98175,916.75,108
"20490","64281","2015",2,2,0,118000,1218.5,96.5
"20491","64282","2015",3,3,0,358333.3,2555.667,148.6667
"20492","64284","2015",74,40,34,142418.2,1622.095,89.74324
"20493","64286","2015",8,8,0,173000,1488.375,115.875
"20494","64287","2015",3,3,0,175700,1646.667,107.3333
"20495","64288","2015",2,2,0,168024,1729,95.5
"20496","64289","2015",6,4,2,128030,1106.5,104.3333
"20497","64290","2015",3,3,0,201756.7,1544.667,134.3333
"20498","64291","2015",3,3,0,138736,1290.333,124.6667
"20499","64293","2015",2,2,0,97500,792.5,125
"20500","64296","2015",3,3,0,171000,1614.667,110.3333
"20501","64298","2015",2,2,0,91250,762.5,122
"20502","64299","2015",2,2,0,197925,1885,105
"20503","64301","2015",5,5,0,103800,1378.4,77.4
"20504","64302","2015",5,5,0,166762,1506.6,112.2
"20505","64304","2015",17,12,5,209255.9,2366.118,93.35294
"20506","64305","2015",11,11,0,100551.3,807.1818,127.3636
"20507","64306","2015",4,4,0,247662.5,2219,114.75
"20508","64307","2015",3,3,0,108866.7,1139.667,107.3333
"20509","64308","2015",3,3,0,178108.3,1524.667,110.6667
"20510","64309","2015",1,1,0,279000,2325,120
"20511","64310","2015",3,3,0,107566.7,1401,76.66667
"20512","64312","2015",1,1,0,122000,1196,102
"20513","64313","2015",1,1,0,128000,1882,68
"20514","64314","2015",1,1,0,120000,789,152
"20515","64315","2015",4,4,0,243625,1775,143.5
"20516","64317","2015",12,10,2,257248.7,2656,102
"20517","64318","2015",1,1,0,147000,2014,73
"20518","64319","2015",2,2,0,171100,1791,98
"20519","64320","2015",16,6,10,87305,1281.25,79.1875
"20520","64321","2015",4,4,0,165512.5,1664.5,99
"20521","64322","2015",1,1,0,220300,1836,120
"20522","64324","2015",11,11,0,211518.2,1594.727,135
"20523","64325","2015",1,1,0,153300,1015,151
"20524","64326","2015",2,2,0,130000,806,174
"20525","64327","2015",1,1,0,210000,2917,72
"20526","64328","2015",5,5,0,210590,1527.4,134
"20527","64329","2015",8,8,0,300261.2,2012.125,152.125
"20528","64330","2015",4,4,0,93000,1269.75,76
"20529","64331","2015",11,11,0,147309.1,1070,129.3636
"20530","64332","2015",1,1,0,301600,1571,192
"20531","64334","2015",3,3,0,157333.3,1521.667,105
"20532","64335","2015",67,52,15,200002.1,1951.164,103.403
"20533","64336","2015",1,1,0,210000,2165,97
"20534","64337","2015",1,1,0,147500,829,178
"20535","64339","2015",8,6,2,101966,923.75,112.625
"20536","64341","2015",1,1,0,167000,1704,98
"20537","64342","2015",2,2,0,92500,697,121
"20538","64343","2015",10,7,3,184965.5,1988.5,95.1
"20539","64344","2015",2,2,0,237425,1527,157
"20540","64345","2015",2,2,0,119426.5,1021,117
"20541","64346","2015",2,2,0,264500,1901.5,138.5
"20542","64347","2015",3,3,0,150120,1596.667,98.33333
"20543","64348","2015",143,78,65,186152.5,2137.343,88.65035
"20544","64349","2015",6,6,0,179741.7,1589.667,117.3333
"20545","64350","2015",5,3,2,196955,3046.2,70.8
"20546","64351","2015",1,1,0,115000,1369,84
"20547","64352","2015",2,2,0,208225,1651,125.5
"20548","64353","2015",11,9,2,141829.4,1590,96.54545
"20549","64354","2015",4,4,0,96250,1218.25,100
"20550","64355","2015",2,2,0,85750,734.5,137.5
"20551","64356","2015",1,1,0,175000,2273,77
"20552","64357","2015",1,1,0,2e+05,1299,154
"20553","64358","2015",1,1,0,220200,2393,92
"20554","64359","2015",4,4,0,234847.5,1624.25,133.25
"20555","64360","2015",3,2,1,121000,1312.667,122.6667
"20556","64362","2015",1,1,0,120000,1043,115
"20557","64363","2015",1,1,0,234135,1561,150
"20558","64364","2015",1,1,0,90000,909,99
"20559","64365","2015",2,2,0,28500,584.5,57
"20560","64367","2015",6,6,0,188166.7,1282,149.3333
"20561","64368","2015",1,1,0,154000,1232,125
"20562","64369","2015",2,2,0,137500,1074,129
"20563","64370","2015",7,7,0,146430,1342.714,117
"20564","64371","2015",20,12,8,104630,1105,100.8
"20565","64372","2015",1,1,0,110000,1100,100
"20566","64373","2015",14,14,0,207953.6,2036.286,106.2857
"20567","64374","2015",8,8,0,192871.2,1673.25,115.625
"20568","64375","2015",2,2,0,190000,1054.5,180.5
"20569","64376","2015",1,1,0,357100,2976,120
"20570","64377","2015",1,1,0,105000,861,122
"20571","64378","2015",1,1,0,57000,543,105
"20572","64379","2015",1,1,0,145300,1529,95
"20573","64380","2015",1,1,0,226000,1337,169
"20574","64381","2015",1,1,0,1e+05,1149,87
"20575","64385","2015",2,2,0,162129,1371.5,118
"20576","64386","2015",13,11,2,155546.2,1530.846,105.6154
"20577","64387","2015",3,3,0,176333.3,1778.667,99.33333
"20578","64389","2015",4,4,0,201182.5,1856.75,107.5
"20579","64390","2015",2,2,0,115000,2014.5,84.5
"20580","64391","2015",1,1,0,165000,1289,128
"20581","64393","2015",32,27,5,154497.2,1554.188,106.8438
"20582","64394","2015",1,1,0,25000,500,50
"20583","64395","2015",3,3,0,117983.3,755,146
"20584","64396","2015",9,9,0,169667,1532.444,111.3333
"20585","64397","2015",2,2,0,133075,1233,117
"20586","64399","2015",10,10,0,265641.4,1783.4,144.6
"20587","64400","2015",8,8,0,178375,1511.625,123
"20588","64401","2015",1,1,0,148000,925,160
"20589","64403","2015",2,2,0,181375,920.5,216
"20590","64404","2015",5,5,0,125400,1436.8,82.4
"20591","64405","2015",28,24,4,211575,1659.464,129.0357
"20592","64406","2015",5,5,0,217230,1622.6,137
"20593","64407","2015",34,22,12,245012.2,2476.618,102.5
"20594","64408","2015",3,3,0,134283.3,1207,112.6667
"20595","64409","2015",6,6,0,91998.33,997.8333,97.83333
"20596","64410","2015",33,18,15,104068.2,1188.909,88.48485
"20597","64413","2015",4,4,0,201057.5,1533.5,121.25
"20598","64415","2015",7,7,0,168671.4,1781.571,98.42857
"20599","64416","2015",9,6,3,122946.7,1218.444,109.3333
"20600","64417","2015",38,22,16,116693.8,1330.605,91.92105
"20601","64418","2015",3,3,0,113683.3,1314.333,87.66667
"20602","64419","2015",11,11,0,241224.5,1782.455,134.3636
"20603","64420","2015",1,1,0,174585,1084,161
"20604","64421","2015",9,9,0,176305.6,1427.667,126.2222
"20605","64422","2015",103,61,42,112202.6,1230.01,96.6699
"20606","64423","2015",2,2,0,279500,2034,127.5
"20607","64424","2015",3,1,2,51500,670.6667,72
"20608","64425","2015",3,3,0,149250,1479.667,98.66667
"20609","64426","2015",3,3,0,98533.33,1168,100.3333
"20610","64427","2015",1,1,0,134665,1036,130
"20611","64428","2015",4,4,0,161250,1346,141
"20612","64430","2015",100,70,30,125192.4,1365.7,94.05
"20613","64431","2015",3,3,0,110333.3,1351,82
"20614","64432","2015",1,1,0,125000,1543,81
"20615","64433","2015",2,2,0,47500,852.5,52.5
"20616","64436","2015",6,4,2,169571.7,1638.833,101.6667
"20617","64438","2015",4,4,0,205325.2,1615.25,125
"20618","64439","2015",10,9,1,263009.2,2756.8,124.7
"20619","64440","2015",2,2,0,238375,1815.5,122.5
"20620","64442","2015",4,4,0,186865,1716.25,108.75
"20621","64443","2015",2,2,0,174400,1596.5,114.5
"20622","64444","2015",2,2,0,145000,1518.5,99
"20623","64445","2015",1461,246,1215,120956.8,1694.055,71.63929
"20624","64446","2015",1,1,0,290000,2214,131
"20625","64448","2015",14,13,1,202697.6,1784.929,116
"20626","64450","2015",4,4,0,157225,1570.75,100.75
"20627","64452","2015",2,2,0,177350,1759,108
"20628","64453","2015",23,23,0,147067.4,1490.957,107.1739
"20629","64454","2015",1,1,0,168950,1508,112
"20630","64457","2015",1,1,0,83000,1064,78
"20631","64458","2015",2,2,0,128500,1029.5,133
"20632","64460","2015",1,1,0,108000,1317,82
"20633","64461","2015",13,13,0,125069.2,1430.846,88.76923
"20634","64462","2015",3,3,0,243666.7,1789.333,155
"20635","64463","2015",6,6,0,158666.7,1193.333,139
"20636","64465","2015",1,1,0,133000,1415,94
"20637","64467","2015",11,10,1,201794.5,1652.818,122
"20638","64469","2015",2,2,0,156775,1406.5,110.5
"20639","64470","2015",1,1,0,195000,1990,98
"20640","64471","2015",5,5,0,189400,1138,160
"20641","64472","2015",5,5,0,239120,1665.8,147.2
"20642","64473","2015",1,1,0,68500,797,86
"20643","64474","2015",1,1,0,63000,649,97
"20644","64475","2015",1,1,0,130000,977,133
"20645","64476","2015",2,2,0,144000,1845,88
"20646","64477","2015",16,15,1,135615.6,1361.938,102.375
"20647","64478","2015",3,3,0,344650,2068,168.3333
"20648","64479","2015",3,3,0,142666.7,1194.667,118.3333
"20649","64482","2015",3,3,0,230333.3,1756.667,131.3333
"20650","64483","2015",298,48,250,274758.5,4172.322,66.86242
"20651","64484","2015",5,4,1,172750,1466.8,112.2
"20652","64485","2015",11,2,9,135027.3,1769.455,80.90909
"20653","64486","2015",1,1,0,219000,1386,158
"20654","64487","2015",1,1,0,99900,602,166
"20655","64488","2015",2,2,0,224400,1445.5,153.5
"20656","64489","2015",1,1,0,190000,1462,130
"20657","64490","2015",8,7,1,163625,1463.375,121.75
"20658","64492","2015",2,2,0,82000,722,113.5
"20659","64493","2015",19,13,6,139253.4,1268.053,119.8947
"20660","64495","2015",63,37,26,253156.3,2554.381,96.52381
"20661","64496","2015",42,16,26,228193.6,2618.976,88.16667
"20662","64498","2015",3,3,0,241486.7,1648.333,154.3333
"20663","64499","2015",56,48,8,156418.3,1427.679,107.3214
"20664","64500","2015",3,3,0,158450,1440.333,110
"20665","64501","2015",3,3,0,140666.7,1503.333,92
"20666","64502","2015",8,8,0,108857.5,1475.875,72
"20667","64503","2015",2,2,0,162700,890.5,194.5
"20668","64504","2015",8,5,3,217788.1,2491.875,99.125
"20669","64505","2015",3,2,1,142833.3,1479.667,95.33333
"20670","64506","2015",3,2,1,84666.67,1185.667,81.66667
"20671","64507","2015",1,1,0,199500,2267,88
"20672","64509","2015",4,4,0,132250,1104,119
"20673","64510","2015",7,7,0,139928.6,1139.429,117.4286
"20674","64511","2015",33,33,0,212903.5,1860.182,118.3636
"20675","64512","2015",2,2,0,166000,1124,172
"20676","64513","2015",17,15,2,142574.4,1276.059,111.6471
"20677","64514","2015",3,3,0,174900,1745.333,116.6667
"20678","64515","2015",4,4,0,163161.2,1332.5,126.5
"20679","64516","2015",2,2,0,93000,952.5,87
"20680","64517","2015",2,2,0,125150,1241.5,101.5
"20681","64518","2015",3,3,0,233500,2528.667,93.33333
"20682","64519","2015",32,30,2,212949.5,1988.344,109.0938
"20683","64520","2015",5,5,0,258200,1527.2,173.8
"20684","64522","2015",4,3,1,123637.5,1481,88.25
"20685","64523","2015",5,5,0,150942.4,1321.4,112
"20686","64524","2015",5,5,0,123900,1020.8,117.8
"20687","64525","2015",4,4,0,179105,2070.5,87.5
"20688","64526","2015",10,7,3,167165,1493.7,119.9
"20689","64527","2015",4,4,0,279000,2432.25,130.75
"20690","64529","2015",4,4,0,153007.5,1648.75,94.75
"20691","64530","2015",6,6,0,147958.3,1386.833,109.3333
"20692","64533","2015",4,4,0,110150,942,120
"20693","64534","2015",1,1,0,173000,1227,141
"20694","64535","2015",2,2,0,243000,1519,160
"20695","64536","2015",6,6,0,223910,1768.5,127.6667
"20696","64537","2015",3,3,0,113500,1490.333,80
"20697","64538","2015",7,3,4,118771.4,1685.714,69.28571
"20698","64539","2015",2,2,0,173852,1410,153.5
"20699","64540","2015",21,18,3,255790,2263.048,119.1429
"20700","64541","2015",2,2,0,167870,1284,129.5
"20701","64542","2015",3,2,1,88000,1000.333,94.66667
"20702","64543","2015",2,2,0,81000,962.5,90
"20703","64544","2015",1,1,0,110000,917,120
"20704","64545","2015",109,50,59,276144.3,3176.128,86.43119
"20705","64546","2015",23,17,6,224980.9,2374,99.34783
"20706","64547","2015",71,30,41,217425.5,2482.873,87.97183
"20707","64548","2015",1,1,0,105100,964,109
"20708","64549","2015",5,5,0,222234,2128.8,102.2
"20709","64550","2015",4,3,1,240325,2231,123.75
"20710","64551","2015",3,3,0,144000,1469.333,100.6667
"20711","64555","2015",4,4,0,129721.2,1179.5,115.5
"20712","64556","2015",2,2,0,199640,1251.5,174
"20713","64557","2015",5,5,0,123215,1166.4,107.4
"20714","64558","2015",18,15,3,244354.6,2566.944,93.44444
"20715","64559","2015",3,3,0,91124.67,916,94
"20716","64560","2015",1,1,0,130000,915,142
"20717","65001","2015",3,3,0,141000,1846.333,75.33333
"20718","65002","2015",3,3,0,116316.7,1124.667,102.6667
"20719","65003","2015",3,2,1,216960,2512,88.66667
"20720","65004","2015",1,1,0,351500,2253,156
"20721","65005","2015",3,3,0,162391.7,1421.333,129
"20722","65006","2015",3,1,2,230833.3,2041,99.33333
"20723","65007","2015",1,1,0,102800,647,159
"20724","65009","2015",2,2,0,81500,636.5,120
"20725","65011","2015",2,2,0,147500,1043,142.5
"20726","65015","2015",2,2,0,98500,665.5,146.5
"20727","65016","2015",1,1,0,110890,1499,74
"20728","65017","2015",20,3,17,59086,1700.1,35.2
"20729","65019","2015",5,5,0,222000.8,1303.2,174
"20730","65020","2015",4,4,0,128100,1256.75,103
"20731","65021","2015",4,4,0,154075,1540.5,103.75
"20732","65023","2015",1,1,0,1e+05,813,123
"20733","65024","2015",1,1,0,169200,1209,140
"20734","65025","2015",46,15,31,126291.5,2044.696,71.5
"20735","65026","2015",1,1,0,107400,1074,100
"20736","65028","2015",1,1,0,155000,1026,151
"20737","65029","2015",3,3,0,177500,1765.333,109.3333
"20738","65031","2015",12,6,6,113327.5,1735.417,71.08333
"20739","65032","2015",8,7,1,176484,2008.625,105.375
"20740","65034","2015",1,1,0,140000,1000,140
"20741","65035","2015",2,2,0,83000,740.5,116
"20742","65036","2015",2,2,0,123200,929.5,129
"20743","65039","2015",1,1,0,99000,990,100
"20744","65040","2015",2,2,0,172500,1955,87
"20745","65041","2015",2,2,0,108557.5,1114.5,97
"20746","65042","2015",3,2,1,154416.7,1533.667,103.3333
"20747","65044","2015",1,1,0,181900,1516,120
"20748","65045","2015",4,4,0,219507.8,1994.5,113.5
"20749","65046","2015",2,2,0,127500,1483,83.5
"20750","65047","2015",87,70,17,124179.2,1376.276,91.74713
"20751","65048","2015",3,3,0,219000,1931.667,111.6667
"20752","65049","2015",3,3,0,128483.3,1246.333,104.3333
"20753","65050","2015",1,1,0,167000,3036,55
"20754","65051","2015",4,4,0,82525,985.75,86.5
"20755","65052","2015",1,1,0,94600,985,96
"20756","65054","2015",3,3,0,131078,1495.333,87.33333
"20757","65056","2015",1,1,0,127800,1420,90
"20758","65057","2015",5,5,0,146800,1335.8,118.8
"20759","65059","2015",180,54,126,96356.35,1626.278,62.72778
"20760","65062","2015",31,31,0,136998.9,1453.226,95.67742
"20761","65065","2015",2,2,0,178500,1365.5,130
"20762","65067","2015",1,1,0,170000,1133,150
"20763","65069","2015",9,9,0,116880,1339.222,89.33333
"20764","65071","2015",1,1,0,205000,2050,100
"20765","65072","2015",11,11,0,122002.7,1575.818,77.18182
"20766","65075","2015",2,2,0,130000,1590.5,110
"20767","65077","2015",4,3,1,148625,1580.5,92.5
"20768","65078","2015",2,2,0,150350,1983.5,77.5
"20769","65079","2015",1,1,0,130000,903,144
"20770","65080","2015",2,2,0,149000,1949.5,79
"20771","65081","2015",1,1,0,118000,1475,80
"20772","65082","2015",1,1,0,53000,1472,36
"20773","65083","2015",7,7,0,176331.4,1450.143,125.7143
"20774","65084","2015",3,3,0,153513,1524,98.33333
"20775","65085","2015",1,1,0,112000,1087,103
"20776","65087","2015",2,2,0,77500,892,85
"20777","65089","2015",2,1,1,99200,2836.5,42.5
"20778","65095","2015",2,2,0,131000,934.5,139.5
"20779","65097","2015",3,3,0,67500,800.6667,102.3333
"20780","65098","2015",6,6,0,137516.7,1640.5,91.33333
"20781","65099","2015",2,1,1,87500,1274.5,78
"20782","65100","2015",40,37,3,151289,1634.375,94.6
"20783","65101","2015",11,11,0,154920.9,1366,134.5455
"20784","65103","2015",2,2,0,166500,1713.5,98.5
"20785","65104","2015",5,5,0,185924,1431.2,129.4
"20786","65105","2015",4,4,0,95113.75,1476.5,68.75
"20787","65106","2015",3,2,1,65068.67,1618.333,52.33333
"20788","65108","2015",7,7,0,133538.6,1542.571,86.28571
"20789","65110","2015",2,2,0,61500,684,95
"20790","65111","2015",1,1,0,110000,1833,60
"20791","65113","2015",1,1,0,117500,851,138
"20792","65115","2015",3,3,0,122366.7,788.6667,130.3333
"20793","65116","2015",4,4,0,103750,1265.75,78.75
"20794","65117","2015",1,1,0,90000,1452,62
"20795","65119","2015",3,3,0,171516.7,1229,143.3333
"20796","65121","2015",2,2,0,118950,1719.5,77
"20797","65123","2015",24,20,4,101960,1544.75,73.79167
"20798","65124","2015",1,1,0,189000,3500,54
"20799","65125","2015",2,2,0,112500,1125,100
"20800","65127","2015",13,11,2,128450.3,1382.538,94.38462
"20801","65129","2015",6,6,0,71320,706.8333,105.5
"20802","65130","2015",6,6,0,116433.3,1038.5,116.5
"20803","65131","2015",1,1,0,187000,1816,103
"20804","65137","2015",2,2,0,136000,1156.5,117.5
"20805","65138","2015",134,13,121,95406.49,2488.597,39.70896
"20806","65141","2015",1,1,0,155000,1962,79
"20807","65142","2015",4,4,0,101875,1053,102.75
"20808","65144","2015",2,2,0,83850,1023.5,82
"20809","65146","2015",2,2,0,132170.5,1200.5,108.5
"20810","65147","2015",4,4,0,175125,1624.5,125
"20811","65149","2015",1,1,0,220000,1833,120
"20812","65150","2015",4,4,0,143825,1254.5,116
"20813","65153","2015",1,1,0,173860,1425,122
"20814","65154","2015",1,1,0,42000,575,73
"20815","65156","2015",3,3,0,172396.3,1471,117.3333
"20816","65158","2015",3,3,0,73966.67,869.6667,93
"20817","65159","2015",1,1,0,83847,902,93
"20818","65161","2015",1,1,0,191650,1452,132
"20819","65165","2015",2,2,0,62500,1950,30.5
"20820","65168","2015",17,4,13,101424.1,2205.412,49.41176
"20821","65169","2015",3,3,0,149216.7,1311,116.3333
"20822","65170","2015",1,1,0,155000,731,212
"20823","65171","2015",2,2,0,198000,2816.5,80
"20824","65173","2015",4,4,0,129205,2550.75,60.75
"20825","65174","2015",2,2,0,156500,1281.5,122
"20826","65175","2015",2,2,0,106500,958.5,105
"20827","65176","2015",4,4,0,95792.5,1162.75,75.75
"20828","65177","2015",2,2,0,189000,1507.5,125.5
"20829","65180","2015",1,1,0,168055,4001,42
"20830","65182","2015",5,3,2,135177.2,2215,77.4
"20831","65183","2015",7,6,1,135998.6,1139.571,130.8571
"20832","65184","2015",2,2,0,99800,1119.5,96.5
"20833","65185","2015",1,1,0,160000,1684,95
"20834","65191","2015",1,1,0,105000,1591,66
"20835","65192","2015",7,4,3,65328.57,1364.714,58.57143
"20836","65193","2015",1,1,0,94000,989,95
"20837","65194","2015",2,2,0,158500,1305,122
"20838","65195","2015",7,4,3,196826.4,2792.286,78.71429
"20839","65197","2015",1,1,0,225000,1923,117
"20840","65198","2015",17,16,1,129185.9,1415,91.64706
"20841","65199","2015",12,1,11,159191.7,2580.083,61.5
"20842","65200","2015",2,2,0,134000,1427.5,91
"20843","65201","2015",1,1,0,48000,738,65
"20844","65202","2015",4,3,1,175653.5,1942.75,89.25
"20845","65207","2015",1,1,0,1e+05,725,138
"20846","65208","2015",1,1,0,241000,2078,116
"20847","65209","2015",2,1,1,127500,2261.5,57.5
"20848","65210","2015",1,1,0,124200,887,140
"20849","65211","2015",1,1,0,2e+05,1333,150
"20850","65212","2015",4,3,1,181400,2079.75,86.5
"20851","65213","2015",4,4,0,157500,1368,114.25
"20852","65217","2015",1,1,0,70000,569,123
"20853","65218","2015",4,4,0,77550,751.25,103.5
"20854","65219","2015",1,1,0,308000,1034,298
"20855","65221","2015",2,2,0,200414,1291,164.5
"20856","65223","2015",13,13,0,207203.8,1895.923,119.6923
"20857","65224","2015",3,3,0,117450,1108.667,107.3333
"20858","65225","2015",1,1,0,95000,896,106
"20859","65226","2015",17,16,1,168714.9,1815.765,94.47059
"20860","65228","2015",1,1,0,82000,1171,70
"20861","65230","2015",4,3,1,123817.5,1301,97.75
"20862","65231","2015",1,1,0,33000,579,57
"20863","65232","2015",1,1,0,197000,1359,145
"20864","65233","2015",2,2,0,149500,991.5,150
"20865","65234","2015",1,1,0,145000,1593,91
"20866","65235","2015",36,35,1,139170.6,1508.806,96.25
"20867","65236","2015",3,3,0,179333.3,1650.333,109.6667
"20868","65237","2015",1,1,0,145000,1859,78
"20869","65238","2015",2,2,0,1e+05,1667,60
"20870","65240","2015",2,2,0,89000,1056,92
"20871","65242","2015",2,2,0,201775,1383.5,145.5
"20872","65243","2015",3,3,0,149100,1793.667,107.3333
"20873","65244","2015",1,1,0,219100,1470,149
"20874","65245","2015",4,4,0,134487.5,1265.25,121
"20875","65248","2015",1,1,0,190000,633,300
"20876","65249","2015",1,1,0,327650,1412,232
"20877","65250","2015",1,1,0,130500,1186,110
"20878","65251","2015",20,20,0,152936,1569.35,97.15
"20879","65252","2015",10,9,1,136470,1482.5,101.6
"20880","65254","2015",1,1,0,143000,1300,110
"20881","65257","2015",3,3,0,182406.7,1387.333,133
"20882","65258","2015",60,33,27,85357.77,1126.217,76.6
"20883","65259","2015",1,1,0,145000,1082,134
"20884","65260","2015",2,2,0,122350,1073.5,122
"20885","65262","2015",5,5,0,122000,1162.2,129.2
"20886","65263","2015",1,1,0,20000,435,46
"20887","65264","2015",1,1,0,80000,602,133
"20888","65265","2015",3,3,0,215505,1715.333,121.6667
"20889","65267","2015",3,3,0,194983.3,1639,118.6667
"20890","65269","2015",3,3,0,159333.3,1417.667,109
"20891","65270","2015",1,1,0,120000,938,128
"20892","65271","2015",4,4,0,166095,1568.25,112
"20893","65272","2015",1,1,0,130000,1398,93
"20894","65273","2015",2,2,0,65000,885.5,80
"20895","65274","2015",1,1,0,182800,3656,50
"20896","65279","2015",1,1,0,221845,1946,114
"20897","65280","2015",2,2,0,114000,1055,137.5
"20898","65281","2015",3,3,0,188655,1256.333,148
"20899","65282","2015",12,4,8,142739.2,2642.417,60.83333
"20900","65283","2015",2,2,0,171750,1547.5,122.5
"20901","65284","2015",8,8,0,178268.1,1531.125,128.625
"20902","65286","2015",143,59,84,103749,1326.867,84.27273
"20903","65287","2015",7,7,0,113214.3,1230.286,94.71429
"20904","65289","2015",1,1,0,91000,827,110
"20905","65290","2015",1,1,0,80000,952,84
"20906","65292","2015",2,2,0,80000,575,140
"20907","65295","2015",32,13,19,100280.7,2003.125,58.6875
"20908","65296","2015",3,3,0,90273.33,958.6667,93
"20909","65298","2015",1,1,0,108000,850,127
"20910","65299","2015",1,1,0,66000,880,75
"20911","65301","2015",1,1,0,135000,1588,85
"20912","65303","2015",3,3,0,255466.7,1866,145.3333
"20913","65304","2015",20,20,0,113015,1118.85,102.05
"20914","65305","2015",4,4,0,54392.5,728,79
"20915","65306","2015",2,2,0,130810,1375.5,109.5
"20916","65307","2015",2,2,0,180000,1068.5,192.5
"20917","65309","2015",1,1,0,75000,962,78
"20918","65310","2015",1,1,0,77000,1027,75
"20919","65313","2015",1,1,0,110000,1447,76
"20920","65314","2015",4,4,0,239318.8,1303.25,171.25
"20921","65315","2015",2,2,0,117030,1139.5,101.5
"20922","65316","2015",2,2,0,204713.5,1125,190.5
"20923","65318","2015",3,3,0,188633.3,1207.667,162.3333
"20924","65319","2015",4,4,0,108750,856,128.25
"20925","65320","2015",3,3,0,120983.3,1242,113.3333
"20926","65322","2015",3,3,0,50666.67,768.6667,66.33333
"20927","65324","2015",2,2,0,140000,1208,116.5
"20928","65327","2015",2,2,0,140000,1128,125
"20929","65329","2015",3,3,0,80333.33,727.6667,100.3333
"20930","65330","2015",1,1,0,80000,1096,73
"20931","65331","2015",32,32,0,169948.6,1540.781,108.875
"20932","65333","2015",1,1,0,178000,1471,121
"20933","65334","2015",2,2,0,151500,1419,107
"20934","65335","2015",7,7,0,149742.9,1433.714,107.5714
"20935","65338","2015",1,1,0,75000,1210,62
"20936","65339","2015",2,2,0,82500,1055.5,78.5
"20937","65340","2015",17,17,0,157738.6,1451.647,110
"20938","65342","2015",1,1,0,158000,1026,154
"20939","65343","2015",1,1,0,180000,1406,128
"20940","65344","2015",15,15,0,147292.3,1485.133,100.1333
"20941","65345","2015",1,1,0,190000,1293,147
"20942","65346","2015",1,1,0,164800,2140,77
"20943","65350","2015",6,6,0,136408.3,1264.667,105.8333
"20944","65351","2015",1,1,0,160000,1758,91
"20945","65353","2015",2,2,0,37750,559,66.5
"20946","65356","2015",1,1,0,245250,1271,193
"20947","65360","2015",3,3,0,182000,1163.667,162
"20948","65361","2015",2,2,0,66410,773,87.5
"20949","65362","2015",12,10,2,128031.6,1582.5,84.5
"20950","65363","2015",4,4,0,122012.5,1258.75,110
"20951","65366","2015",9,9,0,147427.8,1439.222,102
"20952","65367","2015",1,1,0,106000,991,107
"20953","65369","2015",1,1,0,130000,1250,104
"20954","65370","2015",5,5,0,154380,1902.8,89
"20955","65371","2015",2,2,0,193630,2075,95
"20956","65372","2015",4,4,0,138437.5,1262.75,110.25
"20957","65373","2015",2,2,0,125000,917.5,185
"20958","65375","2015",8,7,1,80875,1086.5,80.125
"20959","65376","2015",1,1,0,84000,933,90
"20960","65380","2015",2,2,0,196750,1147.5,170
"20961","65381","2015",1,1,0,145800,1458,100
"20962","65382","2015",2,2,0,51500,577.5,90
"20963","65384","2015",1,0,1,95000,1462,65
"20964","65386","2015",1,1,0,120000,816,147
"20965","65388","2015",152,10,142,94006.84,2311.092,39.42105
"20966","65389","2015",11,11,0,101544.7,1072.545,96.09091
"20967","65390","2015",3,3,0,138700,1609.667,94.33333
"20968","65392","2015",3,3,0,214000,1698.333,127.3333
"20969","65393","2015",3,3,0,119400,1231.333,118.6667
"20970","65394","2015",2,2,0,154000,1602.5,96
"20971","65395","2015",12,10,2,122083.3,1251,102.5833
"20972","65396","2015",5,4,1,160910,1637.8,116.8
"20973","65397","2015",1,1,0,78600,786,100
"20974","65398","2015",1,1,0,54000,491,110
"20975","65399","2015",1,1,0,190000,2111,90
"20976","65400","2015",1,1,0,143900,1919,75
"20977","65401","2015",4,4,0,143052.5,1168.75,119.5
"20978","65404","2015",2,2,0,176250,1514.5,109.5
"20979","65406","2015",1,1,0,248700,1815,137
"20980","65407","2015",1,1,0,90000,857,105
"20981","65408","2015",4,3,1,131625,1395.25,81.75
"20982","65410","2015",4,2,2,109000,1449.5,76.25
"20983","65411","2015",2,2,0,156250,1765.5,90
"20984","65412","2015",1,1,0,140625,1290,109
"20985","65413","2015",3,2,1,119316.7,1568,67.66667
"20986","65415","2015",8,8,0,121025,1308.25,94.5
"20987","65417","2015",44,35,9,131084.7,1478.364,89.84091
"20988","65418","2015",3,3,0,72433.33,841.6667,88
"20989","65420","2015",1,1,0,242400,1616,150
"20990","65422","2015",1,1,0,168500,1381,122
"20991","65424","2015",3,1,2,102033.3,2519.667,50
"20992","65425","2015",2,2,0,129526,1501.5,85.5
"20993","65427","2015",3,3,0,94000,995,93.66667
"20994","65428","2015",2,2,0,137500,1196,111.5
"20995","65429","2015",1,1,0,230000,1299,177
"20996","65431","2015",2,2,0,55000,577.5,114.5
"20997","65432","2015",1,1,0,162000,1373,118
"20998","65433","2015",32,24,8,133154.4,1456.781,90.5
"20999","65435","2015",4,3,1,78000,1185.5,73.25
"21000","65436","2015",5,5,0,136384,1344,100.8
"21001","65439","2015",1,1,0,177000,1106,160
"21002","65440","2015",554,177,377,97629.95,1331.816,75.48917
"21003","65441","2015",1,1,0,69000,986,70
"21004","65445","2015",1,1,0,126000,741,170
"21005","65446","2015",2,2,0,92500,863,108
"21006","65447","2015",10,9,1,104141,1230.6,92.5
"21007","65448","2015",2,2,0,43500,584,75
"21008","65450","2015",1,1,0,152000,2375,64
"21009","65451","2015",6,6,0,107675,1335.5,81.5
"21010","65452","2015",6,6,0,120333.3,971.3333,121.6667
"21011","65455","2015",5,5,0,80132,874,80
"21012","65456","2015",1,1,0,171070,855,200
"21013","65457","2015",1,1,0,225000,1389,162
"21014","65459","2015",1,1,0,145000,1355,107
"21015","65460","2015",52,46,6,106076.3,1193.212,90.92308
"21016","65461","2015",1,1,0,270000,1800,150
"21017","65462","2015",2,2,0,93250,1490.5,59
"21018","65463","2015",1,1,0,115000,2805,41
"21019","65464","2015",4,4,0,152550,1480.5,105.5
"21020","65465","2015",17,5,12,105117.6,2602.882,41.88235
"21021","65467","2015",2,2,0,200500,1637.5,116
"21022","65470","2015",2,2,0,106881,1421,88.5
"21023","65471","2015",9,3,6,165754.4,2412.444,75.11111
"21024","65473","2015",8,7,1,94908.75,1647.125,60.875
"21025","65474","2015",1,1,0,24000,533,45
"21026","65476","2015",1,1,0,150000,1829,82
"21027","65478","2015",1,1,0,98500,657,150
"21028","65481","2015",28,1,27,71012.14,2112.036,33.35714
"21029","65482","2015",1,1,0,145000,1648,88
"21030","66002","2015",39,33,6,208751.4,2087.949,98.51282
"21031","66003","2015",112,20,92,74362.16,1354.795,55.03571
"21032","66004","2015",100,25,75,95633.9,2273.58,40.4
"21033","66005","2015",4,3,1,143500,1920.75,76.25
"21034","66006","2015",1,1,0,123000,2510,49
"21035","66007","2015",2,2,0,130000,1657.5,80
"21036","66008","2015",287,117,170,153210.3,3075.3,54.9547
"21037","66010","2015",2,2,0,75000,1214.5,60
"21038","66011","2015",56,54,2,171274.3,1858.232,92.21429
"21039","66012","2015",32,29,3,182589.1,1820.781,102.5938
"21040","66014","2015",21,20,1,141285.7,1589.905,87.14286
"21041","66015","2015",12,12,0,176841.7,1670.75,102.3333
"21042","66016","2015",85,29,56,168545.4,2615.106,65.03529
"21043","66017","2015",367,98,269,96318.3,2554,38.52044
"21044","66018","2015",1,1,0,30000,375,80
"21045","66019","2015",2,2,0,204500,2738.5,95
"21046","66020","2015",75,24,51,107236.2,2330.813,47.61333
"21047","66021","2015",72,68,4,178409.4,2027.819,90.125
"21048","66022","2015",3,3,0,147166.7,1709.333,88.33333
"21049","66023","2015",15,14,1,108682.1,1424.333,83.53333
"21050","66024","2015",64,46,18,167065.7,2069.156,80.40625
"21051","66025","2015",18,8,10,126500,1976.5,62.44444
"21052","66026","2015",11,10,1,197509.1,1897.273,107.3636
"21053","66027","2015",8,8,0,153375,1948.625,84.875
"21054","66028","2015",97,84,13,232546.5,2273.392,103.7216
"21055","66029","2015",2,2,0,241266.5,2600.5,127
"21056","66030","2015",1,1,0,211000,2542,83
"21057","66033","2015",4,4,0,330820,2284,126.75
"21058","66034","2015",1,1,0,160000,2222,72
"21059","66035","2015",2,2,0,39500,880,45
"21060","66036","2015",2,2,0,79190,1195,75
"21061","66037","2015",432,140,292,155437.8,2832.479,56.11806
"21062","66038","2015",61,55,6,189199.4,2007.033,93.55738
"21063","66041","2015",6,6,0,172416.7,1821.167,98.33333
"21064","66042","2015",2,2,0,175400,1645,101
"21065","66043","2015",2,2,0,108000,1189,91.5
"21066","66044","2015",3,3,0,226766.7,2210.667,100
"21067","66045","2015",5,5,0,146748.4,1276.8,114
"21068","66046","2015",7,7,0,85000,803.2857,97.28571
"21069","66048","2015",21,9,12,206953.6,2846.81,71.52381
"21070","66049","2015",88,61,27,190609.7,2081.523,92.85227
"21071","66050","2015",36,35,1,203386,2096.222,96.27778
"21072","66051","2015",4,4,0,125750,1369,98.5
"21073","66052","2015",4,4,0,166875,1450.5,122.75
"21074","66053","2015",74,17,57,240403.3,3945.473,63.90541
"21075","66054","2015",1,1,0,44500,873,51
"21076","66055","2015",11,11,0,159727.3,1707,95.36364
"21077","66056","2015",9,9,0,130988.9,1400.778,93.77778
"21078","66057","2015",9,9,0,121888.9,1211.556,99.77778
"21079","66058","2015",27,27,0,136492.6,1759.556,87.51852
"21080","66059","2015",22,20,2,203616.4,1914.727,101.7727
"21081","66060","2015",4,4,0,86032.75,1164.75,73.75
"21082","66061","2015",3,2,1,178333.3,1950.667,89.66667
"21083","66063","2015",3,3,0,231666.7,1856,133
"21084","66064","2015",7,5,2,142028.6,2143.714,69.14286
"21085","66065","2015",90,68,22,145821.6,1874.6,79.46667
"21086","66066","2015",8,6,2,159713,1608.25,92.375
"21087","66067","2015",8,3,5,118875,2112.625,59.75
"21088","66068","2015",3,3,0,160000,2199.667,73.33333
"21089","66069","2015",29,28,1,162846.2,1736.724,93.58621
"21090","66070","2015",3,3,0,109800,1411.667,83.33333
"21091","66071","2015",4,4,0,70500,1123.75,63.75
"21092","66072","2015",20,11,9,153219,2059.7,77.1
"21093","66073","2015",1,1,0,83420,1813,46
"21094","66074","2015",8,7,1,199500.6,1883,100.5
"21095","66075","2015",12,7,5,102176.7,2136.417,48.33333
"21096","66076","2015",1,0,1,60000,1000,60
"21097","66077","2015",1,1,0,185000,2056,90
"21098","66078","2015",4,4,0,73000,1167.5,53.25
"21099","66079","2015",4,4,0,118625.2,1203.5,85.75
"21100","66080","2015",6,6,0,69466.67,1451.5,50.33333
"21101","66081","2015",2,2,0,195000,2100,93
"21102","66082","2015",16,12,4,133760.1,1846.625,85.875
"21103","66083","2015",1,1,0,25200,1200,21
"21104","66084","2015",14,14,0,149175,1799.286,86.92857
"21105","66085","2015",6,6,0,216510,2046,99.83333
"21106","66088","2015",53,47,6,126800,1577.755,84.24528
"21107","66089","2015",2,0,2,22500,555.5,46
"21108","66090","2015",3,3,0,86924.67,1612.667,54.33333
"21109","66091","2015",1,0,1,25000,1087,23
"21110","66092","2015",1,1,0,140000,1186,118
"21111","66093","2015",35,34,1,216998.6,2400.114,91.05714
"21112","66094","2015",28,25,3,168672.4,1860,92.71429
"21113","66095","2015",4,3,1,109875,1735,60.5
"21114","66096","2015",21,21,0,92714.05,1299.381,74.28571
"21115","66098","2015",5,4,1,129960,2350,57.6
"21116","66099","2015",5,4,1,134240,1513.8,95
"21117","66100","2015",6,6,0,159833.3,2365.667,82.33333
"21118","66101","2015",26,26,0,177507.7,2004.346,88.61538
"21119","66103","2015",8,8,0,106426.9,1621.875,73
"21120","66104","2015",7,7,0,164028.6,1685.571,93.28571
"21121","66105","2015",13,11,2,103341.5,2237.692,51.61538
"21122","66106","2015",37,37,0,168686.2,1874.216,89.83784
"21123","66107","2015",9,9,0,112722.2,1357.111,82.44444
"21124","66108","2015",34,33,1,178086,1766.529,101.8529
"21125","66109","2015",6,6,0,112000,1686.5,64
"21126","66111","2015",1,1,0,136980,1957,70
"21127","66112","2015",3,3,0,147666.7,1912.333,74.66667
"21128","66113","2015",1,0,1,72000,1286,56
"21129","66114","2015",15,15,0,176083.3,2099.867,82.26667
"21130","66115","2015",18,17,1,219812.8,2304.556,98.72222
"21131","66116","2015",2,2,0,80500,1281,64.5
"21132","66117","2015",2,1,1,104000,1351,68
"21133","66118","2015",9,9,0,143326.1,1527.222,91.66667
"21134","66119","2015",4,3,1,176500,2159.5,84.75
"21135","66121","2015",13,13,0,177605.4,2088.462,84.92308
"21136","66122","2015",1,1,0,57000,891,64
"21137","66123","2015",2,2,0,77500,1027,75
"21138","66124","2015",117,22,95,94251.26,1941.915,48.37607
"21139","66125","2015",6,5,1,63583.33,1081.167,67.16667
"21140","66126","2015",4,4,0,196750,1636.25,119.25
"21141","66127","2015",10,10,0,169258,1566.9,100.9
"21142","66129","2015",21,21,0,190278.5,1882.81,96.47619
"21143","66130","2015",22,5,17,120680.9,2105.182,62.13636
"21144","66132","2015",5,4,1,150400,1975,78.8
"21145","66133","2015",33,32,1,200457.4,1946.333,101.2121
"21146","66134","2015",9,7,2,164677.8,1760.889,88.66667
"21147","66136","2015",1535,402,1133,110785.9,1529.941,73.08078
"21148","66137","2015",4,4,0,54300,904.75,68.25
"21149","66138","2015",13,13,0,150475.4,1589.308,93.84615
"21150","66139","2015",1,1,0,54000,491,110
"21151","66140","2015",34,33,1,148730.7,1775.588,86.23529
"21152","66141","2015",74,63,11,175334.9,1815.581,97.41892
"21153","66144","2015",57,53,4,179887.3,1927.123,93.47368
"21154","66145","2015",30,30,0,167747.9,1856.233,88.2
"21155","66146","2015",2,2,0,32500,904.5,36
"21156","66147","2015",6,3,3,62250,1445.5,47.5
"21157","66148","2015",63,16,47,148364.7,2739.286,56.31746
"21158","66149","2015",61,39,22,132763.9,1502.082,87.04918
"21159","66150","2015",14,10,4,93321.43,1147.429,86.35714
"21160","66151","2015",2,2,0,60500.5,1208,59
"21161","66152","2015",2,2,0,113000,1120,103
"21162","66154","2015",8,7,1,89600,2316.375,44.375
"21163","66155","2015",1,1,0,105000,1105,95
"21164","66156","2015",1,1,0,30135,355,85
"21165","66158","2015",1,1,0,64000,557,115
"21166","66159","2015",4,3,1,108262.5,2024.25,53
"21167","66160","2015",15,13,2,201766.7,2279,90.73333
"21168","66161","2015",10,10,0,161900,1584.2,97.1
"21169","66162","2015",7,7,0,154361.4,1730,87.42857
"21170","66164","2015",74,63,11,150817.4,1618.608,94.87838
"21171","66165","2015",7,7,0,152984.3,1488.714,101.4286
"21172","66166","2015",7,5,2,78714.29,1329.857,57.42857
"21173","66167","2015",16,9,7,123187.5,1899.125,63.5625
"21174","66168","2015",48,44,4,187591.5,2266.167,84.22917
"21175","66169","2015",1,1,0,82323,1193,69
"21176","66171","2015",400,191,209,150896.7,3051.903,53.4
"21177","66172","2015",126,94,32,173889.6,1914.603,89.95238
"21178","66173","2015",15,14,1,213316.7,1958.867,99.66667
"21179","66174","2015",17,16,1,179117.6,1725.529,112.2353
"21180","66175","2015",44,42,2,229101.6,2318.364,102.1818
"21181","66176","2015",44,42,2,179577.3,1910.977,93.97727
"21182","66177","2015",13,11,2,181115.4,2002.615,93.61538
"21183","66178","2015",30,28,2,176846.7,2050.233,93.2
"21184","66179","2015",11,7,4,95116.36,1389.909,77.54545
"21185","66180","2015",130,121,9,170787.1,1946.462,87.73846
"21186","66181","2015",8,1,7,111025,1955.75,52
"21187","66182","2015",113,88,25,155986,2774.257,63.55752
"21188","66183","2015",2,1,1,145500,1899.5,74
"21189","66185","2015",2,2,0,146500,1798.5,71.5
"21190","66186","2015",26,24,2,171677.4,1932.385,91.88462
"21191","66187","2015",16,15,1,76712.5,1008.312,75.875
"21192","66188","2015",13,11,2,134814.3,2492,59.46154
"21193","66189","2015",39,30,9,184987.7,2218.256,90.46154
"21194","66190","2015",24,24,0,145661.5,1933.208,81.16667
"21195","66192","2015",2,1,1,99000,1191,95
"21196","66193","2015",3,3,0,79666.67,1232.667,70.33333
"21197","66194","2015",2,2,0,76500,1031,84
"21198","66195","2015",77,71,6,178136.7,1956.87,89.80519
"21199","66196","2015",45,42,3,239523.4,2493.556,96.8
"21200","66198","2015",7,7,0,55424.29,856.2857,69.85714
"21201","66199","2015",4,4,0,258500,2531,98
"21202","66202","2015",6,3,3,150484.3,2057.5,74
"21203","66203","2015",3,3,0,167836.3,1523,109
"21204","66204","2015",8,8,0,143460,1462.125,95.5
"21205","66205","2015",3,3,0,153333.3,1632,103.6667
"21206","66206","2015",3,3,0,131666.7,1121.333,115.3333
"21207","66207","2015",7,7,0,195857.1,1935.429,103
"21208","66208","2015",18,16,2,184263.9,1711.389,108.5556
"21209","66209","2015",3,3,0,40000,732.3333,54.33333
"21210","66210","2015",65,55,10,151033.2,1600.446,90.56923
"21211","66212","2015",97,88,9,135927.7,2182.897,64.3299
"21212","66213","2015",71,68,3,177725.9,1824.014,97.77465
"21213","66214","2015",10,9,1,183480,1974.4,96.5
"21214","66215","2015",4,4,0,101665,1191.75,93
"21215","66217","2015",24,23,1,145497.1,1705.583,85.54167
"21216","66218","2015",7,4,3,126357.1,1427.143,90.71429
"21217","66219","2015",4,4,0,46625,751.5,61.75
"21218","66220","2015",1,0,1,40000,889,45
"21219","66221","2015",2,1,1,66000,902,76
"21220","66222","2015",42,20,22,94191.79,1366,63.7619
"21221","66223","2015",3,1,2,161666.7,1798.333,100
"21222","66224","2015",36,33,3,182486.4,2509,92.61111
"21223","66225","2015",17,16,1,212923.5,2337,96.47059
"21224","66226","2015",15,15,0,154066.7,1815.467,87.53333
"21225","66227","2015",56,52,4,215255,2126.304,105.5179
"21226","66230","2015",19,15,4,122289.5,1296.421,91.52632
"21227","66231","2015",11,11,0,158190.9,1520.455,100.2727
"21228","66233","2015",4,4,0,262650,2077.5,128.25
"21229","66234","2015",1,1,0,92000,1070,86
"21230","69001","2015",6,6,0,139050,1764.667,77.33333
"21231","69002","2015",1,1,0,200900,1196,168
"21232","69003","2015",18,10,8,277118.2,2778.333,99.77778
"21233","69004","2015",10,5,5,200998.5,2051.8,96.6
"21234","69005","2015",5,3,2,183830,2258.2,86.6
"21235","69006","2015",40,32,8,121145,1391.95,88.35
"21236","69007","2015",17,10,7,211998.1,2186.176,100.2353
"21237","69008","2015",10,10,0,170251,1686.7,107.3
"21238","69009","2015",87,63,24,214183.7,2429.402,93.05747
"21239","69010","2015",75,36,39,180545,2250.947,80.4
"21240","69012","2015",4,4,0,151750,1262,118.75
"21241","69013","2015",30,16,14,183807.8,2042.867,91.6
"21242","69014","2015",5,5,0,178078,2158.4,84.2
"21243","69016","2015",1,1,0,78000,600,130
"21244","69017","2015",6,6,0,215108.3,1964.5,109.6667
"21245","69018","2015",19,14,5,95562.63,1066.316,91.47368
"21246","69019","2015",114,69,45,168205,1861.728,94.15789
"21247","69020","2015",3,3,0,351833.3,2799,128.3333
"21248","69021","2015",21,16,5,173951,1813.143,98.95238
"21249","69022","2015",5,5,0,231624,2051.4,111.8
"21250","69023","2015",15,12,3,235821.5,1983.667,113.6667
"21251","69024","2015",38,29,9,203561.9,2133.868,95.86842
"21252","69026","2015",2,2,0,297500,2320,130.5
"21253","69027","2015",112,66,46,287550.6,2877.268,97.57143
"21254","69028","2015",74,53,21,301201.6,2790.149,109.1351
"21255","69029","2015",419,59,360,178379.7,2505.444,71.06683
"21256","69030","2015",6,6,0,158546.7,1485.667,109.5
"21257","69031","2015",13,10,3,171856.2,1561.769,109.6923
"21258","69032","2015",19,14,5,221643.7,2028.895,109.7895
"21259","69033","2015",25,21,4,314550.1,2880.56,111.84
"21260","69034","2015",600,74,526,256787.3,3118.502,80.44
"21261","69035","2015",3,3,0,155933.3,1586,107
"21262","69036","2015",10,6,4,130865.4,1854.5,68.3
"21263","69037","2015",9,9,0,136103.2,1141.778,121.6667
"21264","69038","2015",9,9,0,142883.3,1468,96.55556
"21265","69039","2015",9,8,1,147460.6,1754.889,85.44444
"21266","69040","2015",68,21,47,271258.8,3133.868,85.22059
"21267","69042","2015",3,3,0,183816.7,1750,104.3333
"21268","69043","2015",76,48,28,302439.6,3140.947,96.73684
"21269","69044","2015",28,17,11,372573,3686.964,102.1786
"21270","69045","2015",5,5,0,231044,2335.8,122.4
"21271","69046","2015",48,37,11,358665.9,2910.271,125.4375
"21272","69047","2015",15,14,1,330576.1,2592.8,119.4667
"21273","69049","2015",37,26,11,321942.1,2869.27,117.4595
"21274","69050","2015",31,26,5,245801.4,2323.484,106.0645
"21275","69051","2015",5,3,2,253882,2518.6,100.8
"21276","69052","2015",42,38,4,308650.5,2886.238,107.1905
"21277","69053","2015",3,3,0,220951.7,1733.333,121
"21278","69054","2015",4,4,0,104892.8,1184.75,83.5
"21279","69055","2015",7,7,0,271785.7,2678,98.42857
"21280","69056","2015",18,13,5,212953.3,2273.222,92.16667
"21281","69057","2015",3,3,0,307800,2260.333,135
"21282","69058","2015",3,3,0,113733.3,1351.667,77
"21283","69059","2015",22,15,7,299225.5,2825.182,102.2727
"21284","69060","2015",1,1,0,155780,1039,150
"21285","69061","2015",7,7,0,264882.9,2513.286,108.8571
"21286","69062","2015",7,7,0,207471.4,1751.286,123.8571
"21287","69063","2015",50,32,18,429269.6,3625.46,118.42
"21288","69064","2015",43,29,14,173741.5,1960.326,87.88372
"21289","69065","2015",7,5,2,211483.9,1816.571,118.8571
"21290","69066","2015",27,26,1,102317.7,1116.444,92.22222
"21291","69067","2015",10,10,0,150324,1408.1,109.1
"21292","69068","2015",32,25,7,316447.3,3180.562,102.625
"21293","69069","2015",144,59,85,252443,2892.243,88.60417
"21294","69070","2015",11,11,0,131667.3,1220.727,103.8182
"21295","69071","2015",13,9,4,278428.5,2633.769,111.3846
"21296","69072","2015",67,50,17,385822.3,3320.552,113.7761
"21297","69074","2015",9,8,1,260092.1,2064.333,129.8889
"21298","69075","2015",1,1,0,190000,559,340
"21299","69076","2015",23,20,3,468676.7,3190.435,149.2174
"21300","69077","2015",6,6,0,240525,1763.333,128.3333
"21301","69078","2015",10,10,0,208721,1636.4,132.2
"21302","69080","2015",12,11,1,204180,2131.667,94.66667
"21303","69081","2015",182,43,139,303301.4,3231.423,93.97253
"21304","69082","2015",1,1,0,314000,1308,240
"21305","69083","2015",13,11,2,269564.6,2813.462,97.46154
"21306","69084","2015",11,9,2,169330,1648,102.2727
"21307","69085","2015",10,7,3,216802.6,2448.6,89.1
"21308","69086","2015",22,17,5,287994.9,2790.682,102.6818
"21309","69087","2015",32,20,12,333907.9,3030.969,112.8438
"21310","69088","2015",116,15,101,207199,2556.422,79.64655
"21311","69089","2015",164,67,97,278556.7,3108.47,89.7561
"21312","69090","2015",6,6,0,243125,2121.333,115.6667
"21313","69091","2015",119,65,54,147006.3,1879.21,78.53782
"21314","69092","2015",71,47,24,215746.5,2207.07,95.60563
"21315","69093","2015",11,11,0,97227.27,1143.273,83
"21316","69094","2015",56,32,24,309387.2,3071.179,96.46429
"21317","69095","2015",8,8,0,168125,1650,112.875
"21318","69096","2015",93,46,47,172699.5,2192.581,78.77419
"21319","69097","2015",1,0,1,228500,1222,187
"21320","69098","2015",2,2,0,251086.5,2479.5,105
"21321","69099","2015",13,12,1,138657.7,1119.077,123.1538
"21322","69100","2015",65,22,43,205885.1,2486.585,82.73846
"21323","69102","2015",8,8,0,143043.8,1373.5,104.125
"21324","69103","2015",7,7,0,146985.7,1747.571,99.42857
"21325","69104","2015",6,6,0,191633.3,1533.333,136.3333
"21326","69105","2015",10,8,2,293434,2620.5,116.4
"21327","69106","2015",13,9,4,336496.5,2403.769,147.8462
"21328","69107","2015",18,15,3,127202.6,1720.444,83.16667
"21329","69108","2015",13,12,1,156467.3,1709.692,94.07692
"21330","69109","2015",4,4,0,132532.5,1574.75,77
"21331","69110","2015",25,25,0,168060.8,1636.72,105.2
"21332","69111","2015",9,7,2,252021.7,2067.889,124.8889
"21333","69112","2015",51,35,16,306709.9,2871.373,107.4706
"21334","69113","2015",8,7,1,138807.5,1720.125,78.125
"21335","69115","2015",53,35,18,225397,2327.245,97.30189
"21336","69116","2015",42,23,19,365538,4042.976,97.7381
"21337","69117","2015",28,23,5,327649.6,2865.964,114.6071
"21338","69118","2015",17,9,8,184923.4,2316.529,82.76471
"21339","69119","2015",4,3,1,217462.5,2371,91.5
"21340","69120","2015",1,1,0,73000,1327,55
"21341","69121","2015",19,13,6,282842.2,2749.263,107.1053
"21342","69122","2015",10,10,0,318069.7,2836.6,113.6
"21343","69123","2015",6997,183,6814,226343.6,3316.898,68.43104
"21344","69124","2015",3,3,0,71000,1001.333,69
"21345","69125","2015",12,5,7,199777.1,2291.75,90.41667
"21346","69126","2015",3,3,0,278333.3,2324,117
"21347","69127","2015",24,19,5,363382.1,3305.333,110.7083
"21348","69130","2015",1,1,0,145000,1179,123
"21349","69131","2015",30,21,9,270933.8,2787.267,105.2
"21350","69132","2015",6,6,0,165066.7,1699,105.5
"21351","69133","2015",42,32,10,295534.7,2825.238,105.1429
"21352","69134","2015",3,3,0,196316.7,1909.667,93.33333
"21353","69135","2015",21,20,1,93210.14,1002.619,95.19048
"21354","69136","2015",28,22,6,259015.7,2349.536,110.25
"21355","69137","2015",2,1,1,184075,1772.5,103
"21356","69138","2015",6,6,0,164100,1546.833,102.6667
"21357","69139","2015",24,21,3,164721.2,1777.083,96.45833
"21358","69140","2015",35,24,11,292768.3,2720.257,109.6
"21359","69141","2015",67,31,36,203804.7,2383.269,84.73134
"21360","69142","2015",100,4,96,165782.8,2326.74,69.35
"21361","69143","2015",62,21,41,217870,2662.097,85
"21362","69145","2015",5,5,0,228101,2258.6,106
"21363","69148","2015",23,17,6,273138,2777.478,99.95652
"21364","69149","2015",370,49,321,172203.2,2422.403,70.37297
"21365","69151","2015",12,12,0,195572.5,1975.917,104
"21366","69152","2015",81,24,57,160295.5,2256.716,69.76543
"21367","69153","2015",12,12,0,450075.3,3815.333,120.9167
"21368","69154","2015",21,18,3,318553.8,2972.238,110.7619
"21369","69155","2015",4,4,0,168750,1645.5,113.75
"21370","69157","2015",50,41,9,207212.5,2025.74,104.56
"21371","69159","2015",12,12,0,247450.8,2296.5,116.1667
"21372","69160","2015",11,11,0,110009.1,963,117.9091
"21373","69161","2015",5,5,0,82720,782.2,106.4
"21374","69162","2015",13,13,0,127566.2,1415.692,90.53846
"21375","69163","2015",32,28,4,275456.3,2536.906,108.0938
"21376","69164","2015",5,4,1,96180,691,130.4
"21377","69165","2015",8,8,0,161582.1,1722.125,94.75
"21378","69166","2015",2,2,0,298100,2303,129
"21379","69167","2015",7,7,0,218750,1562.286,145
"21380","69168","2015",24,14,10,275988.8,2941,92.66667
"21381","69169","2015",5,5,0,139300,1546.6,89
"21382","69170","2015",7,6,1,189965.7,2332.429,78.71429
"21383","69171","2015",31,23,8,207020.8,2165.677,98.67742
"21384","69172","2015",10,7,3,177995,1822.4,98.7
"21385","69173","2015",6,5,1,218443.3,1750.5,126.3333
"21386","69174","2015",4,4,0,160220,1731.25,106.5
"21387","69175","2015",14,14,0,201960.7,2144.857,99.14286
"21388","69176","2015",54,41,13,280306,2654.593,105.2222
"21389","69177","2015",22,21,1,263273.4,2321.955,114.4545
"21390","69178","2015",8,8,0,173925,1581.625,106.625
"21391","69179","2015",38,34,4,230470.7,2394.605,97.02632
"21392","69180","2015",1,1,0,265000,1656,160
"21393","69181","2015",1,1,0,132100,2097,63
"21394","69182","2015",4,4,0,88750,1009.75,88.75
"21395","69183","2015",3,3,0,97333.33,1399.333,76.33333
"21396","69184","2015",12,10,2,224425,2012.667,115.0833
"21397","69186","2015",1,1,0,117300,1805,65
"21398","69187","2015",3,3,0,192066.7,1530,130
"21399","69188","2015",12,11,1,120612.5,1439,82.75
"21400","69189","2015",24,5,19,170372.9,1938.875,90.04167
"21401","69190","2015",18,15,3,328565.7,2689.778,123.2778
"21402","69191","2015",69,57,12,551047.8,4398.855,128.1739
"21403","69193","2015",7,7,0,246668.6,2475.429,102.4286
"21404","69194","2015",68,47,21,484948.2,4115.132,119.5735
"21405","69196","2015",5,5,0,141298,1335.4,109.8
"21406","69197","2015",14,14,0,218507.1,2099,102.2857
"21407","69198","2015",7,7,0,172534.3,1818.143,95.42857
"21408","69199","2015",105,32,73,154220.5,2122.21,73.00952
"21409","69200","2015",12,10,2,161257.2,2009.417,85.91667
"21410","69201","2015",16,12,4,106775,1330.062,81.8125
"21411","69202","2015",271,54,217,257369.5,2863.007,86.32472
"21412","69203","2015",15,15,0,172142,1822.733,98.73333
"21413","69204","2015",215,94,121,252482.5,2787.619,89.06047
"21414","69205","2015",55,38,17,293903.3,3016.564,98.10909
"21415","69206","2015",43,32,11,198072.9,1975.558,99.76744
"21416","69207","2015",32,22,10,342836.6,3037.625,112.5938
"21417","69208","2015",8,8,0,270018.8,2257.875,124.5
"21418","69209","2015",2,2,0,91000,1400,65
"21419","69212","2015",2,2,0,526150,3013.5,171.5
"21420","69214","2015",14,12,2,120776.2,1283.429,92.85714
"21421","69215","2015",11,7,4,196593.2,1781.727,106.5455
"21422","69216","2015",5,5,0,143750,1340.2,116.2
"21423","69217","2015",11,11,0,107940,1201.636,92.81818
"21424","69218","2015",4,4,0,202875,2699.75,74.5
"21425","69219","2015",31,25,6,249553.2,2441.71,107.2581
"21426","69220","2015",11,8,3,126972.7,1655,78.54545
"21427","69225","2015",3,3,0,303757.3,2240,141.6667
"21428","69227","2015",17,11,6,230200,2560.706,94.29412
"21429","69228","2015",32,31,1,254333.1,2144.688,119.7188
"21430","69229","2015",4,4,0,103187.5,1022,97
"21431","69230","2015",2,2,0,211950,1350.5,157
"21432","69231","2015",24,22,2,266097.9,2422.583,110.75
"21433","69233","2015",17,14,3,372499.9,3727.647,99.94118
"21434","69234","2015",13,13,0,245306.2,2308.154,109.1538
"21435","69235","2015",23,13,10,190098.7,2024.261,94.26087
"21436","69236","2015",4,4,0,140462.5,1483.75,92.75
"21437","69238","2015",48,30,18,153367.4,1688.312,91.3125
"21438","69239","2015",13,12,1,167663.5,1470.769,114.5385
"21439","69240","2015",12,12,0,77916.17,882.5833,87.08333
"21440","69241","2015",32,22,10,263430.6,2823.469,98.125
"21441","69242","2015",10,9,1,192747.5,1946.7,106.6
"21442","69243","2015",87,39,48,125707.1,1501.31,86.44828
"21443","69244","2015",355,39,316,236146.3,2933.634,79.66197
"21444","69245","2015",5,5,0,174762.4,1781.2,98
"21445","69246","2015",18,17,1,203430.7,2233.389,107
"21446","69248","2015",39,33,6,107675.3,1116.897,99.4359
"21447","69249","2015",29,21,8,242182.8,2425.862,103.069
"21448","69250","2015",46,29,17,334464.6,3097.457,110.1522
"21449","69252","2015",5,5,0,183400,1898,95.2
"21450","69253","2015",5,5,0,226438.6,2209.8,100
"21451","69254","2015",7,6,1,151144.3,1635.143,83.57143
"21452","69255","2015",57,47,10,275120.1,2609.316,105.9649
"21453","69256","2015",228,64,164,159043.6,2213.61,72.86842
"21454","69257","2015",14,13,1,167526.1,1669.643,104.5
"21455","69258","2015",3,3,0,94666.67,1164.667,87.66667
"21456","69259","2015",286,56,230,145556.6,2130.594,69.47552
"21457","69260","2015",40,24,16,277565.9,2814.85,99.75
"21458","69261","2015",1,1,0,145000,1543,94
"21459","69263","2015",11,11,0,113896.4,1359.273,84.09091
"21460","69264","2015",435,86,349,146142.7,1938.333,76.30345
"21461","69265","2015",9,9,0,270122.2,2334.778,112.8889
"21462","69266","2015",1873,112,1761,171022,2731.859,63.8441
"21463","69267","2015",18,18,0,207861.1,1770.889,118.8333
"21464","69268","2015",36,14,22,271955.6,3332.833,83.25
"21465","69269","2015",14,13,1,202610.4,2170.357,96.71429
"21466","69270","2015",26,25,1,349173.5,3084.423,119.7308
"21467","69271","2015",78,64,14,330285.2,3212.808,105.7051
"21468","69272","2015",36,29,7,279556.4,2811.194,100.0278
"21469","69273","2015",106,52,54,216739.4,2626.16,82.4434
"21470","69275","2015",273,87,186,198452.6,2654.26,74.63004
"21471","69276","2015",101,62,39,199616.9,2352.881,85.22772
"21472","69277","2015",123,89,34,328026.8,3230.504,103.6098
"21473","69278","2015",48,28,20,238175.3,2623.479,90.75
"21474","69279","2015",61,58,3,280430.2,2791.115,102.0164
"21475","69280","2015",18,15,3,229131.2,2532.056,90.5
"21476","69281","2015",11,9,2,301951.8,2713.364,111.5455
"21477","69282","2015",295,190,105,243954.2,2793.566,87.67458
"21478","69283","2015",113,87,26,260259.8,2937,90.89381
"21479","69284","2015",22,21,1,327505,3231.045,108.8182
"21480","69285","2015",33,29,4,254738.9,2710.727,98.24242
"21481","69286","2015",195,92,103,250080.4,2572.292,95.09231
"21482","69287","2015",63,37,26,252829.1,2885.254,88.42857
"21483","69288","2015",51,37,14,251689.8,2699.843,97.90196
"21484","69289","2015",44,33,11,272835.2,3230.432,89.18182
"21485","69290","2015",394,114,280,195025.1,2431.665,80.03553
"21486","69291","2015",79,37,42,207852.4,2737.684,81.50633
"21487","69292","2015",48,11,37,218844.9,2649.521,83.83333
"21488","69293","2015",32,20,12,354941,3572.781,100.0938
"21489","69294","2015",29,18,11,231266.6,2665.655,86.62069
"21490","69295","2015",18,13,5,297988.9,2761.722,113.5
"21491","69296","2015",29,23,6,262934.1,2596.31,101.8966
"21492","69297","2015",35,25,10,243994.3,2703.971,92.91429
"21493","69299","2015",18,18,0,240798.7,2385,102.8889
"21494","70004","2015",2,2,0,109000,1219.5,99
"21495","70005","2015",2,2,0,84500,811,102
"21496","70006","2015",8,8,0,94656.25,933.625,110.25
"21497","70011","2015",1,1,0,120000,759,158
"21498","70014","2015",3,3,0,152133.3,1221.667,124.6667
"21499","70016","2015",3,3,0,123326.7,1492.667,83.33333
"21500","70017","2015",4,4,0,103062.5,825.25,121
"21501","70018","2015",5,5,0,131700,1341.6,101.6
"21502","70019","2015",1,1,0,75000,938,80
"21503","70020","2015",2,2,0,99000,1097.5,90
"21504","70024","2015",3,3,0,85833.33,1692.667,48.66667
"21505","70026","2015",13,12,1,92953.85,916.2308,101.0769
"21506","70029","2015",3,3,0,111658.3,815.6667,136
"21507","70030","2015",1,1,0,137270,1508,91
"21508","70031","2015",8,8,0,105387.5,1111,96.75
"21509","70036","2015",2,2,0,184250,2401.5,76.5
"21510","70037","2015",2,2,0,232000,1019.5,230.5
"21511","70039","2015",2,2,0,136750,1147.5,120
"21512","70041","2015",5,5,0,66300,715.8,88.4
"21513","70043","2015",2,2,0,110000,1338.5,80.5
"21514","70044","2015",5,5,0,122310,1202,101.8
"21515","70046","2015",1,1,0,95000,1044,91
"21516","70047","2015",2,2,0,148900,1265.5,115.5
"21517","70052","2015",1,1,0,130000,1413,92
"21518","70053","2015",1,1,0,154000,1027,150
"21519","70054","2015",2,2,0,179000,1411.5,126.5
"21520","70061","2015",3,3,0,78553.33,1958.333,42.66667
"21521","70062","2015",2,2,0,79000,1399.5,66.5
"21522","70063","2015",1,1,0,105000,607,173
"21523","70064","2015",1,1,0,2e+05,1000,200
"21524","70065","2015",2,2,0,80975,880,94
"21525","70066","2015",3,3,0,52833.33,476,108.6667
"21526","70071","2015",6,6,0,111391.7,2148.333,65.33333
"21527","70076","2015",4,4,0,174075,1600.5,107.75
"21528","70079","2015",3,3,0,241750,1947.333,124.6667
"21529","70080","2015",1,1,0,20000,364,55
"21530","70083","2015",3,3,0,69301.67,675,96.66667
"21531","70085","2015",3,3,0,85750,964.3333,85.33333
"21532","70088","2015",1,1,0,145000,967,150
"21533","70090","2015",2,0,2,111300,1001.5,112.5
"21534","70094","2015",5,5,0,84000,891.2,98.8
"21535","70096","2015",7,7,0,111214.3,1176.857,97.14286
"21536","70101","2015",6,6,0,92917.5,1155.167,86.5
"21537","70103","2015",1,1,0,122000,1326,92
"21538","70104","2015",9,9,0,104522.2,1165,111.2222
"21539","70105","2015",2,2,0,50050,2037,51
"21540","70107","2015",1,1,0,235100,1837,128
"21541","70109","2015",2,2,0,120500,885.5,132
"21542","70111","2015",3,3,0,120266.7,867.6667,138.3333
"21543","70116","2015",7,4,3,134385.7,1564.286,80.57143
"21544","70117","2015",11,10,1,211750,1449.727,149.3636
"21545","70118","2015",2,2,0,131500,1146,114
"21546","70120","2015",36,34,2,90531.81,1163.083,77.94444
"21547","70121","2015",8,8,0,118912.5,1211.625,102.125
"21548","70125","2015",2,2,0,98850,1008.5,98.5
"21549","70128","2015",4,4,0,82500,942.25,88
"21550","70129","2015",2,2,0,195500,1992.5,100.5
"21551","70130","2015",2,2,0,96500,1008.5,107.5
"21552","70132","2015",4,3,1,96625,913.75,102
"21553","70134","2015",2,2,0,38175,763.5,50
"21554","70136","2015",5,2,3,119000,1128.2,106.2
"21555","70138","2015",2,2,0,150600,1037.5,196.5
"21556","70145","2015",2,2,0,266825,1816.5,148.5
"21557","70147","2015",4,4,0,102109.8,1110,118.75
"21558","70148","2015",2,2,0,132500,1811,77.5
"21559","70149","2015",4,4,0,211762.5,1765.75,132.75
"21560","70152","2015",3,3,0,92300,858.3333,105.6667
"21561","70154","2015",2,2,0,70922,811.5,88
"21562","70157","2015",6,6,0,109283.3,958.1667,122.3333
"21563","70158","2015",1,0,1,198000,1737,114
"21564","70159","2015",1,1,0,81000,540,150
"21565","70162","2015",3,3,0,189516.7,1599,117.6667
"21566","70163","2015",4,4,0,133862.5,1187.5,114
"21567","70166","2015",1,1,0,63000,636,99
"21568","70168","2015",5,5,0,38213.2,523.8,73.4
"21569","70169","2015",1,1,0,83000,830,100
"21570","70171","2015",8,8,0,148687.5,1262.375,119.125
"21571","70172","2015",1,1,0,155000,1148,135
"21572","70174","2015",3,3,0,206333.3,2055.333,158.6667
"21573","70178","2015",3,3,0,126500,1207,104
"21574","70179","2015",3,3,0,99383.33,1096.333,94
"21575","70182","2015",2,2,0,306560,1717,177.5
"21576","70184","2015",6,4,2,91266.67,1230.5,69.33333
"21577","70185","2015",4,4,0,92095,808,115.5
"21578","70186","2015",1,1,0,103000,963,107
"21579","70187","2015",2,2,0,126000,1283,98.5
"21580","70189","2015",2,2,0,110500,1010.5,110.5
"21581","70190","2015",4,4,0,179375,1013.25,189.75
"21582","70194","2015",2,2,0,77500,800.5,94
"21583","70196","2015",2,2,0,67850,633.5,111.5
"21584","70199","2015",2,2,0,150456.5,1120.5,138.5
"21585","70202","2015",1,1,0,70000,886,79
"21586","70205","2015",1,1,0,311000,1798,173
"21587","70206","2015",6,6,0,127879.5,1220.333,104
"21588","70207","2015",33,30,3,115957.6,1147.909,99.63636
"21589","70211","2015",2,1,1,49000,729,72.5
"21590","70215","2015",2,2,0,98000,1703,57.5
"21591","70216","2015",4,4,0,97200,1295,77.5
"21592","70217","2015",3,3,0,69700,904.6667,72.66667
"21593","70218","2015",1,1,0,110000,542,203
"21594","70219","2015",4,4,0,50250,544.25,103.5
"21595","70220","2015",2,2,0,100500,1146,87.5
"21596","70221","2015",2,2,0,157600,1349.5,118.5
"21597","70222","2015",1,1,0,115000,1106,104
"21598","70224","2015",4,4,0,227625,1328.25,151.75
"21599","70225","2015",1,1,0,75000,938,80
"21600","70226","2015",2,2,0,62500,950,62.5
"21601","70227","2015",3,3,0,103333.3,1095.333,95.66667
"21602","70228","2015",6,6,0,73083.33,949.8333,85.16667
"21603","70229","2015",1,1,0,30000,508,59
"21604","70239","2015",1,1,0,80000,1026,78
"21605","70240","2015",9,8,1,122811.1,1070.111,119.8889
"21606","70242","2015",1,1,0,64000,444,144
"21607","70243","2015",4,4,0,109100,1051.75,104
"21608","70244","2015",2,2,0,77000,728,106
"21609","70245","2015",19,19,0,105226.3,1174.947,93.78947
"21610","70248","2015",8,7,1,215900,1728.75,139.5
"21611","70249","2015",1,1,0,55000,433,127
"21612","70253","2015",3,3,0,111666.7,705,144.3333
"21613","70254","2015",4,4,0,153113.5,1586.75,98.25
"21614","70255","2015",5,5,0,94264.8,1057.4,91.2
"21615","70256","2015",10,10,0,121305,991.1,126.4
"21616","70257","2015",7,6,1,112428.6,1096.143,105.7143
"21617","70259","2015",2,2,0,97134.5,747,129
"21618","70260","2015",6,6,0,130096.7,1183.167,118.6667
"21619","70261","2015",12,12,0,157958.2,1483.25,109.25
"21620","70263","2015",2,2,0,132250,1412.5,94.5
"21621","70265","2015",1,1,0,62500,548,114
"21622","70271","2015",7,7,0,97142.86,781.2857,122
"21623","70275","2015",4,4,0,92500,658.25,137.5
"21624","70276","2015",3,3,0,121800,967.3333,125.3333
"21625","70277","2015",2,2,0,130000,1523.5,85.5
"21626","70279","2015",43,22,21,81216.28,922.2791,93.97674
"21627","70280","2015",16,16,0,124093.8,1247,106.1875
"21628","70282","2015",8,6,2,73725,933.125,86
"21629","70283","2015",5,4,1,105120,2424.6,57
"21630","70285","2015",80,48,32,106352.5,1332.225,80.125
"21631","70287","2015",1,1,0,46000,523,88
"21632","70289","2015",2,2,0,140750,1327.5,107.5
"21633","70290","2015",2,2,0,63750,385.5,165
"21634","70292","2015",12,8,4,69083.33,815.6667,85
"21635","70294","2015",3,3,0,133333.3,987.6667,133.6667
"21636","70295","2015",4,4,0,152200,1148.25,127.25
"21637","70305","2015",1,1,0,80000,1333,60
"21638","70306","2015",6,6,0,174538.3,1470,138
"21639","70307","2015",2,2,0,112500,1025.5,119.5
"21640","70308","2015",2,1,1,63500,849.5,68.5
"21641","70310","2015",55,40,15,90264.91,1093.818,86.45455
"21642","70312","2015",6,6,0,128345,1196,106.8333
"21643","70314","2015",1,1,0,60000,857,70
"21644","70315","2015",4,4,0,69538.75,816,88.5
"21645","70319","2015",3,3,0,112366.7,855.6667,125.6667
"21646","70321","2015",7,7,0,106050,1155,91.71429
"21647","70323","2015",1,1,0,23000,885,26
"21648","70324","2015",8,7,1,108050,1088,102.125
"21649","70325","2015",1,1,0,197000,1515,130
"21650","70328","2015",3,3,0,93100,997.6667,96.33333
"21651","70330","2015",1,1,0,239000,1959,122
"21652","70331","2015",7,7,0,96671.43,974,97
"21653","70336","2015",3,3,0,110666.7,1445.667,79.66667
"21654","70339","2015",16,14,2,84703.31,1091.438,86.4375
"21655","70341","2015",1,1,0,50000,714,70
"21656","70343","2015",5,5,0,97546.2,859.4,119.4
"21657","70347","2015",5,5,0,96200,944.2,100.8
"21658","70348","2015",7,7,0,99325,1202.714,82.57143
"21659","70349","2015",2,2,0,77500,765,103.5
"21660","70352","2015",2,2,0,192500,2030.5,99
"21661","70355","2015",3,3,0,194333.3,1240,156
"21662","70356","2015",2,2,0,1e+05,1000,97.5
"21663","70357","2015",3,2,1,118440.7,1010,110.6667
"21664","70358","2015",3,3,0,107283.3,1061,106
"21665","70360","2015",1,1,0,113000,904,125
"21666","70361","2015",1,1,0,130000,1193,109
"21667","70363","2015",3,2,1,112816.7,1208.333,92.33333
"21668","70366","2015",1,1,0,220570,1103,200
"21669","70367","2015",1,1,0,59500,850,70
"21670","70376","2015",2,2,0,131500,1326,99
"21671","70378","2015",16,14,2,121689.9,1187.188,103.125
"21672","70383","2015",2,2,0,210000,1544,145.5
"21673","70384","2015",2,2,0,155950,1012.5,155
"21674","70385","2015",1,1,0,219500,1247,176
"21675","70387","2015",10,10,0,109322,1119.8,106.8
"21676","70388","2015",16,16,0,126624.1,1394.938,92
"21677","70393","2015",5,5,0,93420,796.4,114
"21678","70397","2015",2,2,0,84250,1084.5,77
"21679","70401","2015",1,1,0,1e+05,952,105
"21680","70402","2015",3,2,1,77000,762,101
"21681","70403","2015",2,2,0,124500,1508,79.5
"21682","70404","2015",4,4,0,39000,525.25,76.5
"21683","70405","2015",1,1,0,42400,1413,30
"21684","70407","2015",1,1,0,110000,1803,61
"21685","70408","2015",14,13,1,112925.7,1140.571,113.4286
"21686","70413","2015",22,21,1,120978.2,1391,93.09091
"21687","70414","2015",8,8,0,93568.75,1109.75,92.75
"21688","70415","2015",3,3,0,93500,830.6667,107.6667
"21689","70417","2015",2,2,0,141000,1558.5,94
"21690","70418","2015",5,5,0,90300,955.4,87
"21691","70419","2015",1,1,0,62850,786,80
"21692","70420","2015",1,1,0,228000,1267,180
"21693","70421","2015",30,25,5,116607.3,1189.933,95.53333
"21694","70425","2015",2,2,0,67500,690,96.5
"21695","70427","2015",1,1,0,38000,432,88
"21696","70428","2015",11,10,1,173209.1,1598.273,108.4545
"21697","70429","2015",5,4,1,120200,1221.6,100.8
"21698","70431","2015",1,1,0,95000,679,140
"21699","70433","2015",12,11,1,169383.3,1576.917,106.3333
"21700","70435","2015",6,6,0,117291.7,1016.5,125.3333
"21701","70437","2015",1,1,0,175000,1029,170
"21702","70439","2015",1,1,0,148000,1147,129
"21703","70441","2015",4,4,0,205150,1272,166
"21704","70444","2015",2,2,0,131620,864,165
"21705","70445","2015",1,1,0,270000,1862,145
"21706","70446","2015",1,1,0,110000,1122,98
"21707","70447","2015",14,11,3,142678.6,1515.714,95.07143
"21708","70451","2015",28,26,2,105726.8,1164.5,92.35714
"21709","70452","2015",5,5,0,97900,854.4,114.8
"21710","70453","2015",2,2,0,88675,1290,68
"21711","70455","2015",12,12,0,132281.7,1296.5,104.6667
"21712","70457","2015",1,1,0,55000,550,100
"21713","70459","2015",8,8,0,122525,1276.375,98.75
"21714","70460","2015",5,5,0,74180,611.4,127.4
"21715","70462","2015",1,1,0,101800,1227,83
"21716","70463","2015",2,2,0,133000,1408,94.5
"21717","70464","2015",20,20,0,131416.5,1227.9,109.8
"21718","70466","2015",1,1,0,70000,778,90
"21719","70467","2015",28,26,2,63245.36,803.7143,81.17857
"21720","70469","2015",1,1,0,160000,1584,101
"21721","70472","2015",3,3,0,70333.33,819.3333,85.33333
"21722","70474","2015",1,1,0,81000,900,90
"21723","70477","2015",8,8,0,100637.5,1374.875,104
"21724","70478","2015",3,3,0,153900,1410.333,108.6667
"21725","70482","2015",18,17,1,91897.22,904.9444,106.5
"21726","70484","2015",1,1,0,68000,861,79
"21727","70485","2015",3,3,0,64500,596.6667,120
"21728","70487","2015",2,2,0,67500,855,73
"21729","70489","2015",6,6,0,113016.7,727.1667,158
"21730","70490","2015",3,3,0,74433.33,706.3333,99.33333
"21731","70492","2015",5,5,0,74970,787.2,95.2
"21732","70493","2015",3,3,0,139000,1628.333,86.33333
"21733","70498","2015",3,3,0,137000,1873,83.33333
"21734","70504","2015",3,3,0,49166.67,884.3333,65
"21735","70505","2015",1,1,0,135000,1500,90
"21736","70506","2015",1,1,0,168200,1502,112
"21737","70507","2015",3,3,0,164166.7,1320,124.3333
"21738","70512","2015",1,1,0,62000,912,68
"21739","70513","2015",19,19,0,153370,1532.368,103.0526
"21740","70514","2015",4,4,0,156675,1232.25,128
"21741","70515","2015",1,1,0,95000,1583,60
"21742","70517","2015",6,6,0,222533.3,1455.667,147.5
"21743","70519","2015",1,1,0,202843,1276,159
"21744","70521","2015",2,2,0,82500,775.5,113
"21745","70522","2015",1,1,0,84870,772,110
"21746","70523","2015",2,2,0,74000,533.5,152
"21747","70524","2015",3,3,0,61000,535,97.33333
"21748","70526","2015",5,4,1,99000,838.8,121.6
"21749","70527","2015",1,1,0,153000,1055,145
"21750","70529","2015",3,3,0,101916.7,1452.333,80.66667
"21751","70530","2015",1,1,0,146000,1587,92
"21752","70531","2015",1,1,0,80500,629,128
"21753","70532","2015",4,4,0,134750,1204.5,115
"21754","70533","2015",1,1,0,71500,894,80
"21755","70534","2015",1,1,0,150000,1087,138
"21756","70535","2015",4,4,0,110950,995.5,102
"21757","70536","2015",2,2,0,106500,990.5,109
"21758","70537","2015",5,5,0,81140,1078,89.8
"21759","70538","2015",1,1,0,55000,917,60
"21760","70540","2015",1,1,0,134000,793,169
"21761","70542","2015",2,2,0,120000,917,132
"21762","70544","2015",1,1,0,255350,1323,193
"21763","70549","2015",3,3,0,81333.33,1313.667,65.66667
"21764","70550","2015",138,35,103,82092.5,1085.942,75.92029
"21765","70558","2015",1,1,0,63000,1050,60
"21766","70559","2015",1,1,0,173300,1456,119
"21767","70561","2015",9,7,2,97500,1175.333,83.66667
"21768","70562","2015",2,2,0,49750,472.5,105
"21769","70563","2015",3,3,0,178666.7,1943.667,92.66667
"21770","70573","2015",1,1,0,45000,2250,20
"21771","70575","2015",7,5,2,145936.4,1697.857,88.57143
"21772","70577","2015",2,2,0,87500,732,122.5
"21773","70579","2015",5,5,0,169700,1649.8,105
"21774","70580","2015",4,4,0,88075,926.75,91.75
"21775","70581","2015",8,8,0,98775,851.25,118.375
"21776","71001","2015",7,7,0,148985.7,1512.143,96.42857
"21777","71002","2015",10,10,0,181400,1570.6,126.9
"21778","71003","2015",8,8,0,196278.1,1674.75,117.5
"21779","71004","2015",13,13,0,184540.8,1539.615,121.6154
"21780","71005","2015",2,2,0,167000,1753.5,95.5
"21781","71006","2015",1,1,0,72714,404,180
"21782","71007","2015",1,1,0,142000,947,150
"21783","71008","2015",3,3,0,75963.33,920,84
"21784","71009","2015",11,11,0,85250.36,907,89.54545
"21785","71010","2015",8,8,0,78037.5,1015.125,80
"21786","71011","2015",5,5,0,152500,1252.6,122.2
"21787","71012","2015",5,5,0,103500,868.2,117.2
"21788","71013","2015",5,5,0,96800,876.6,121
"21789","71014","2015",104,59,45,103361.2,1154.558,89.07692
"21790","71015","2015",10,10,0,103220,923.6,102.4
"21791","71016","2015",11,11,0,216055,1682,123.7273
"21792","71017","2015",1,1,0,210000,2386,88
"21793","71018","2015",6,6,0,91695.83,707.5,128.6667
"21794","71019","2015",2,2,0,135000,1732.5,85.5
"21795","71020","2015",1,1,0,58000,1289,45
"21796","71021","2015",2,2,0,107285,1178.5,96
"21797","71022","2015",6,6,0,118103.3,1363.167,85.5
"21798","71023","2015",9,8,1,116033.3,1154.333,97.55556
"21799","71024","2015",4,4,0,112500,1122.25,103
"21800","71025","2015",4,4,0,126475,1293.25,98.75
"21801","71027","2015",8,8,0,165125,1346.25,129.25
"21802","71028","2015",1,1,0,191000,1504,127
"21803","71029","2015",3,3,0,55333.33,821.6667,67.33333
"21804","71030","2015",2,2,0,190414,1036.5,191.5
"21805","71032","2015",7,7,0,183304.3,1768,99
"21806","71033","2015",6,6,0,106083.3,1047.667,107.3333
"21807","71034","2015",1,1,0,1e+05,833,120
"21808","71035","2015",2,2,0,69000,1055.5,60
"21809","71036","2015",1,1,0,50000,714,70
"21810","71037","2015",1,1,0,160000,1684,95
"21811","71038","2015",2,2,0,273250,1879,139
"21812","71039","2015",1,1,0,110000,1358,81
"21813","71040","2015",52,52,0,105045.7,1215.173,91.23077
"21814","71042","2015",3,2,1,120166.7,1937.667,59.66667
"21815","71043","2015",1,1,0,78000,780,100
"21816","71044","2015",5,5,0,125100,1345.6,97
"21817","71046","2015",3,3,0,60416.67,2416,31
"21818","71047","2015",43,40,3,93450,1108.209,83.30233
"21819","71048","2015",1,1,0,53000,662,80
"21820","71050","2015",4,3,1,102575,1283.25,81
"21821","71051","2015",1,1,0,74000,705,105
"21822","71052","2015",2,2,0,246500,1258,195
"21823","71054","2015",8,8,0,121821.2,1483.75,86.625
"21824","71056","2015",19,19,0,87984.21,1017.579,90.31579
"21825","71057","2015",1,1,0,90000,750,120
"21826","71058","2015",4,4,0,103375,1131.5,92.75
"21827","71059","2015",26,26,0,134044.2,1322.769,104.8462
"21828","71060","2015",5,5,0,105000,1213,90.4
"21829","71061","2015",6,6,0,154500,1402.667,104.8333
"21830","71063","2015",8,7,1,84837.5,1120.5,76.5
"21831","71064","2015",9,9,0,98333.33,1035.556,95.55556
"21832","71065","2015",5,5,0,126971.8,1073,115.6
"21833","71066","2015",1,1,0,68000,944,72
"21834","71067","2015",2,2,0,97000,1236,78.5
"21835","71068","2015",1,1,0,121300,933,130
"21836","71069","2015",3,3,0,182833.3,1702.333,110
"21837","71070","2015",15,13,2,160988.1,1580.467,103.1333
"21838","71071","2015",1,1,0,49500,1207,41
"21839","71072","2015",2,2,0,117250,1176.5,101
"21840","71073","2015",51,43,8,133892.4,1510.667,90.7451
"21841","71075","2015",9,7,2,71788.89,849.2222,88.88889
"21842","71076","2015",541,108,433,93330.97,1211.739,75.80961
"21843","71077","2015",4,4,0,64250,870,81.25
"21844","71079","2015",3,3,0,98333.33,1046.333,91.66667
"21845","71081","2015",19,15,4,121503.7,1295.105,95.05263
"21846","71084","2015",1,1,0,80000,1067,75
"21847","71085","2015",1,1,0,166200,2158,77
"21848","71086","2015",5,5,0,112900,1177.6,91.2
"21849","71087","2015",1,1,0,1e+05,901,111
"21850","71088","2015",3,3,0,93166.67,960.3333,95.66667
"21851","71089","2015",1,1,0,190000,960,198
"21852","71090","2015",32,30,2,175659.3,1698.344,105.1875
"21853","71091","2015",2,2,0,62500,1014,62.5
"21854","71092","2015",8,8,0,160762.5,1350.25,152.75
"21855","71093","2015",10,10,0,135460,1006.1,131.7
"21856","71094","2015",2,2,0,91000,1128,80.5
"21857","71095","2015",5,5,0,150480,1083,142.4
"21858","71096","2015",3,3,0,40383.33,724,51.66667
"21859","71097","2015",7,7,0,128819.3,1201.143,110.7143
"21860","71098","2015",4,4,0,82500,1011.25,80.75
"21861","71099","2015",3,3,0,184416.7,1463.667,119.6667
"21862","71100","2015",2,2,0,97500,1023.5,95.5
"21863","71101","2015",8,8,0,115500,1180.625,97.25
"21864","71102","2015",5,5,0,156863.6,1647.8,92.6
"21865","71104","2015",1,1,0,158800,992,160
"21866","71105","2015",98,54,44,167141.7,1853.01,92.19388
"21867","71106","2015",27,21,6,117433.3,1134.333,107.1481
"21868","71107","2015",3,3,0,110333.3,1054.333,103.3333
"21869","71108","2015",3,3,0,132300,1175.667,115
"21870","71109","2015",7,7,0,132641,1647.571,84.28571
"21871","71110","2015",3,3,0,89333.33,1072,87
"21872","71111","2015",1,1,0,88000,800,110
"21873","71112","2015",6,6,0,164666.7,1692.333,103.5
"21874","71115","2015",2,2,0,2e+05,1382.5,145.5
"21875","71116","2015",2,2,0,251500,1337.5,179
"21876","71117","2015",12,11,1,140738,1545.833,91.16667
"21877","71118","2015",66,52,14,134644.2,1873.333,81.89394
"21878","71119","2015",13,13,0,156703.8,1637.231,100.6154
"21879","71120","2015",31,28,3,110691.9,1153.387,97.70968
"21880","71121","2015",4,4,0,97125,1022.25,90
"21881","71122","2015",7,7,0,126357.1,1399.143,89.42857
"21882","71123","2015",3,3,0,76670,861.3333,84.33333
"21883","71124","2015",2,2,0,86000,1128.5,77
"21884","71126","2015",6,6,0,287816.7,1709,158.6667
"21885","71127","2015",2,2,0,51699.5,869,69
"21886","71128","2015",1,1,0,32500,722,45
"21887","71129","2015",3,3,0,52666.67,1259.333,49
"21888","71130","2015",3,3,0,94666.67,1843.667,67.33333
"21889","71131","2015",4,4,0,155252.5,1331.5,117.25
"21890","71132","2015",16,14,2,79478.12,866.6875,90.6875
"21891","71133","2015",20,14,6,76250,871.4,85.95
"21892","71134","2015",4,4,0,69787.5,666.5,113
"21893","71135","2015",4,4,0,153165,1707,95
"21894","71136","2015",1,1,0,59900,689,87
"21895","71137","2015",32,23,9,175877.7,1859.625,97.375
"21896","71139","2015",4,4,0,191250,4375.25,69.5
"21897","71141","2015",4,4,0,117362,1300.25,89
"21898","71142","2015",4,4,0,68125,1080,58
"21899","71143","2015",5,5,0,138683,955.8,115.2
"21900","71144","2015",1,1,0,150000,882,170
"21901","71145","2015",7,7,0,127492.9,1395.429,88.57143
"21902","71146","2015",2,2,0,95000,1226,75
"21903","71147","2015",1,1,0,84600,1128,75
"21904","71148","2015",6,6,0,135250,1150.5,122
"21905","71149","2015",20,18,2,97950,1189.7,83.85
"21906","71150","2015",17,16,1,182789.4,1581.353,118.7059
"21907","71151","2015",1,1,0,99200,1359,73
"21908","71153","2015",151,87,64,93324.14,1170.477,83.01987
"21909","71154","2015",18,17,1,160151.1,1520.056,107.9444
"21910","71155","2015",2,2,0,93500,995.5,90.5
"21911","71156","2015",2,2,0,60000,1238,43.5
"21912","71157","2015",16,16,0,125445.5,1149.062,112.375
"21913","71158","2015",20,18,2,112750.5,1058.35,107.1
"21914","71159","2015",1,1,0,128200,1308,98
"21915","71160","2015",2,2,0,114000,1051.5,126
"21916","71161","2015",3,3,0,165000,1144,139
"21917","71162","2015",5,5,0,111200,905.6,129
"21918","71163","2015",2,2,0,33000,510.5,64
"21919","71164","2015",1,1,0,1e+05,1333,75
"21920","71165","2015",3,3,0,67571.67,973,79
"21921","71167","2015",4,4,0,105250,887,127.75
"21922","71168","2015",2,2,0,120000,1128,107
"21923","71169","2015",10,10,0,234957,1789,123.5
"21924","71170","2015",12,11,1,152808.3,1480.667,104.1667
"21925","71171","2015",3,3,0,124530,1107,115
"21926","71173","2015",6,6,0,106333.3,1284.167,85.33333
"21927","71174","2015",2,2,0,59925,1100.5,54
"21928","71175","2015",3,3,0,116000,1050,113.3333
"21929","71176","2015",59,41,18,86430.59,1069.085,83.40678
"21930","71177","2015",9,9,0,117777.8,1681.778,85.44444
"21931","71178","2015",14,14,0,114168.9,1166.857,103.1429
"21932","71179","2015",1,1,0,73000,1014,72
"21933","71181","2015",1,1,0,182000,1300,140
"21934","71182","2015",10,10,0,288880,1903.3,157.7
"21935","71183","2015",3,3,0,164535,2587.333,66.66667
"21936","71184","2015",6,6,0,72233.33,851.5,79.83333
"21937","71185","2015",3,3,0,188666.7,1373,139.6667
"21938","71186","2015",4,4,0,103625,1170.25,104.75
"21939","71187","2015",22,22,0,106115,990.7727,100.5
"21940","71188","2015",1,1,0,86050,1721,50
"21941","71189","2015",1,1,0,219700,1581,139
"21942","71190","2015",14,13,1,64464.29,784.7857,81.57143
"21943","71191","2015",6,6,0,127333.3,1225.333,94.83333
"21944","71192","2015",13,12,1,104442.3,1050.538,109.1538
"21945","71193","2015",10,10,0,178535,1600,104.5
"21946","71194","2015",7,7,0,172497.1,1483.143,120.2857
"21947","71195","2015",2,2,0,87500,956.5,91
"21948","71196","2015",6,6,0,118900,1285.5,90.66667
"21949","71198","2015",7,7,0,87950,1102.857,78.28571
"21950","71199","2015",2,2,0,151800,1590,101
"21951","71200","2015",6,6,0,150183.3,1193.5,129.5
"21952","71201","2015",3,3,0,445333.3,2232,203.3333
"21953","71202","2015",13,12,1,144088.5,1362.231,106.6154
"21954","71203","2015",1,1,0,96000,1391,69
"21955","71204","2015",14,14,0,165246.4,1423.143,116.7143
"21956","71205","2015",6,6,0,141186.7,1379.5,107.5
"21957","71206","2015",5,5,0,137600,1407,100.2
"21958","71207","2015",3,3,0,60000,863.3333,69.33333
"21959","71208","2015",3,3,0,82000,917.3333,84.66667
"21960","71209","2015",9,9,0,90033.33,1183.111,83.11111
"21961","71210","2015",2,2,0,261900,2674,89.5
"21962","71212","2015",10,7,3,86733.3,930.1,96.2
"21963","71213","2015",6,6,0,129204.2,1408.833,93.83333
"21964","71214","2015",4,4,0,79000,1066.25,79.75
"21965","71215","2015",20,20,0,146496,1457,105.7
"21966","71216","2015",2,2,0,177975,1314,132.5
"21967","71217","2015",3,3,0,135430,1231,109
"21968","71218","2015",7,7,0,79785.71,1022.714,94.57143
"21969","71219","2015",5,5,0,89100,905.4,100
"21970","71221","2015",38,31,7,167906.3,1612.316,99.05263
"21971","71222","2015",8,8,0,151938.1,1412.375,107.875
"21972","71223","2015",5,5,0,112664,858.4,119.2
"21973","71224","2015",1,1,0,150000,1364,110
"21974","71225","2015",3,3,0,200873.3,1571.667,130.6667
"21975","71227","2015",3,3,0,81037.33,903,89.33333
"21976","71228","2015",2,2,0,182350,1507,122.5
"21977","71229","2015",1,1,0,47500,792,60
"21978","71230","2015",46,43,3,96321.3,1002.522,95.34783
"21979","71231","2015",5,5,0,128800,751.4,134
"21980","71232","2015",1,1,0,203000,1781,114
"21981","71233","2015",1,1,0,89000,947,94
"21982","71234","2015",7,7,0,113764.3,1116.714,96.85714
"21983","71235","2015",18,16,2,218136.2,1986,113.2778
"21984","71236","2015",5,5,0,148090,1775,85.6
"21985","71237","2015",5,5,0,78854.4,901.6,96
"21986","71238","2015",14,14,0,145252.1,1235.429,113.8571
"21987","71239","2015",6,6,0,75083.33,906.6667,83.83333
"21988","71240","2015",7,7,0,165721.6,1738.286,96.28571
"21989","71241","2015",4,4,0,174265.2,1795.5,105.5
"21990","71242","2015",10,9,1,100840,1285.5,98.6
"21991","71243","2015",4,4,0,112825,1218.5,100.5
"21992","71244","2015",6,6,0,96918.33,1184.667,81.5
"21993","71245","2015",3,3,0,98333.33,1199.667,92.66667
"21994","71246","2015",2,2,0,77500,968.5,80
"21995","71247","2015",3,3,0,147333.3,1560.667,92
"21996","71248","2015",5,5,0,139440,1767.4,81.8
"21997","71249","2015",11,11,0,157225.5,1493.545,105.5455
"21998","71250","2015",8,8,0,143341.2,1308.375,107.875
"21999","71251","2015",8,8,0,121443.8,1151,99.125
"22000","71252","2015",3,3,0,137625,1231.333,102
"22001","71253","2015",5,5,0,179465.2,1763.4,104.2
"22002","71255","2015",5,5,0,128000,1159,96.8
"22003","71256","2015",3,3,0,292900,2471,118.6667
"22004","71257","2015",6,6,0,156236.7,1330.167,129.3333
"22005","71258","2015",5,5,0,173123,1682.2,102.8
"22006","71259","2015",3,3,0,146166.7,1123.333,128
"22007","71261","2015",6,6,0,126933.3,1175.667,96.83333
"22008","71262","2015",3,3,0,68352.67,905,76.66667
"22009","71263","2015",68,48,20,101721.8,1132.397,91.29412
"22010","71264","2015",2,2,0,131500,1394.5,89
"22011","71267","2015",5,5,0,264637.6,2191.6,117.2
"22012","71269","2015",13,11,2,122915.4,1465.154,85.30769
"22013","71270","2015",330,99,231,119887,1488.776,80.2
"22014","71271","2015",3,3,0,117920,839.3333,132
"22015","71272","2015",4,4,0,151500,3115,86
"22016","71273","2015",8,8,0,69887.5,815.875,94.5
"22017","71274","2015",2,2,0,64900,953,69
"22018","71275","2015",15,15,0,113532,1006.4,116.2
"22019","71276","2015",4,4,0,61925.5,912,68.75
"22020","71277","2015",6,6,0,162000,1477.5,110.3333
"22021","71278","2015",1,1,0,65000,436,149
"22022","71279","2015",6,6,0,123883.3,1438.5,87.5
"22023","71280","2015",4,4,0,174250,1918.25,79.75
"22024","71281","2015",2,2,0,92000,1272,65
"22025","71282","2015",12,11,1,146149.2,1464.917,98.66667
"22026","71283","2015",1,1,0,1e+05,1667,60
"22027","71284","2015",3,3,0,63166.67,840.3333,76
"22028","71285","2015",4,4,0,103201.2,1047.75,99
"22029","71286","2015",7,7,0,203007.1,1488.143,144.1429
"22030","71287","2015",1,1,0,147050,1730,85
"22031","71289","2015",9,8,1,104766.7,980.5556,115.1111
"22032","71290","2015",1,1,0,159000,1710,93
"22033","71291","2015",10,10,0,80141.3,1054.3,75.7
"22034","71292","2015",7,7,0,170785.7,1859.857,87.85714
"22035","71293","2015",8,8,0,94000,897,109
"22036","71294","2015",14,12,2,163973.1,1490.357,105.8571
"22037","71295","2015",14,14,0,103825,1102.571,97
"22038","71296","2015",16,16,0,143472.5,1501.688,98.9375
"22039","71297","2015",7,7,0,123285.7,1361.571,83.85714
"22040","71299","2015",3,3,0,204393.3,1742,109.3333
"22041","71300","2015",8,8,0,153016,1615.875,95.375
"22042","71301","2015",1,1,0,45000,459,98
"22043","71303","2015",7,7,0,157000,1355,124.5714
"22044","71305","2015",9,9,0,185341.1,2013.556,109
"22045","71306","2015",122,90,32,79451.22,1018.123,80.32787
"22046","71308","2015",1,1,0,30000,1429,21
"22047","71309","2015",13,13,0,121034.6,1245.154,98.38462
"22048","71310","2015",37,26,11,125049.5,1388,90.64865
"22049","71311","2015",4,4,0,142750,1317.5,107
"22050","71312","2015",1,1,0,128000,1580,81
"22051","71313","2015",2,2,0,115000,1250,94.5
"22052","71314","2015",4,4,0,56250,810.5,72
"22053","71315","2015",1,1,0,145318,1530,95
"22054","71316","2015",4,4,0,103000,1241.75,85.5
"22055","71318","2015",14,14,0,103645.1,1169.357,93.21429
"22056","71319","2015",7,7,0,106928.6,1171.286,87
"22057","71320","2015",4,4,0,83500,953.5,94.5
"22058","71321","2015",1,1,0,37000,860,43
"22059","71322","2015",1,1,0,85000,914,93
"22060","71323","2015",2,2,0,63750,1083.5,59
"22061","71324","2015",3,3,0,173716.7,1506.333,118.6667
"22062","71325","2015",7,7,0,118054.3,1053.857,110.7143
"22063","71326","2015",13,13,0,92846.15,1015.462,101.2308
"22064","71327","2015",1,1,0,105000,1235,85
"22065","71328","2015",3,3,0,192000,1417.333,135.6667
"22066","71329","2015",3,3,0,152333.3,1034,131
"22067","71330","2015",3,3,0,77333.33,869,96
"22068","71332","2015",3,3,0,145666.7,1644.333,88.33333
"22069","71333","2015",6,6,0,162516.7,1737.667,95.16667
"22070","71334","2015",2,2,0,116030,1185.5,96
"22071","71335","2015",2,2,0,62500,721.5,86.5
"22072","71336","2015",21,20,1,123612.1,1366.81,94.61905
"22073","71337","2015",5,5,0,206950,1070.4,163.8
"22074","71338","2015",5,5,0,317718.2,3393.8,106.4
"22075","71339","2015",6,6,0,128133.3,1175.833,104.8333
"22076","71340","2015",18,18,0,114400,1242.722,89.44444
"22077","71341","2015",2,2,0,167500,1390.5,120
"22078","71342","2015",98,61,37,113000,1604.347,81.08163
"22079","71343","2015",2,2,0,200225,2081.5,101.5
"22080","71344","2015",2,2,0,1e+05,1658,60.5
"22081","71345","2015",4,4,0,176347,1859,97.5
"22082","71346","2015",13,12,1,62792.31,690.8462,93.69231
"22083","71347","2015",4,4,0,132625,1351.5,96
"22084","71348","2015",1,1,0,74845,1040,72
"22085","71349","2015",2,2,0,114687.5,927,120
"22086","71350","2015",5,5,0,121520,1345.6,89
"22087","71351","2015",18,18,0,110186.1,1037.389,110.3889
"22088","71352","2015",4,4,0,194742.5,1470.5,133
"22089","71353","2015",4,3,1,83750,968.25,82.25
"22090","71354","2015",8,8,0,100781.1,1007,114.5
"22091","71355","2015",2,2,0,129000,1100,114
"22092","71356","2015",7,7,0,84992.86,1048.857,78.14286
"22093","71357","2015",3,3,0,1e+05,1287.333,83.66667
"22094","71358","2015",2,2,0,154045,1763.5,84
"22095","71359","2015",6,6,0,115850,945.1667,122.5
"22096","71360","2015",14,14,0,204141.8,1780.286,116.2143
"22097","71362","2015",2,2,0,68500,978,74
"22098","71363","2015",1,1,0,180000,1034,174
"22099","71364","2015",2,2,0,135500,804.5,168.5
"22100","71365","2015",10,10,0,84955.8,912.6,90.4
"22101","71366","2015",4,4,0,88025,751,109.5
"22102","71367","2015",3,3,0,99166.67,1176.667,85.33333
"22103","71368","2015",1,1,0,158000,1215,130
"22104","71369","2015",7,7,0,138928.6,1409.286,97.57143
"22105","71370","2015",8,7,1,138450,1657.625,91.625
"22106","71371","2015",14,14,0,162259.3,1466.143,114.5
"22107","71372","2015",12,12,0,150358.3,1704.25,94.5
"22108","71373","2015",21,20,1,118039.5,1234,110.381
"22109","71376","2015",4,4,0,111900,1172.75,97
"22110","71377","2015",1,1,0,51500,402,128
"22111","71378","2015",21,19,2,174952.4,1597.81,105.9048
"22112","71379","2015",16,16,0,108281.2,1291.812,92.125
"22113","71380","2015",8,8,0,141125,1018.375,136
"22114","71381","2015",1,1,0,92000,929,99
"22115","71382","2015",6,6,0,83067.17,845.5,100.6667
"22116","71383","2015",4,4,0,119335,1173.5,94.75
"22117","71384","2015",3,3,0,159066.7,1142,144.6667
"22118","71385","2015",2,2,0,145500,1450,97.5
"22119","71386","2015",1,1,0,250000,1471,170
"22120","71387","2015",1,1,0,52700,753,70
"22121","71388","2015",6,6,0,223233.3,2744.5,72.16667
"22122","71389","2015",1,1,0,140000,1414,99
"22123","71390","2015",7,7,0,94191.43,1159.714,84.42857
"22124","71391","2015",3,3,0,85766.67,1344.333,64.33333
"22125","71392","2015",7,7,0,78285.71,1216.429,67.42857
"22126","71393","2015",5,5,0,95930,1123.8,78
"22127","71394","2015",9,8,1,100944.4,1055.333,89.44444
"22128","71395","2015",2,2,0,168500,1747.5,97.5
"22129","71396","2015",8,8,0,83750,1146.75,77.75
"22130","71397","2015",2,2,0,178750,1936,99
"22131","71398","2015",9,9,0,149725.6,1420.222,108.2222
"22132","71399","2015",6,6,0,102755,1049.667,101.8333
"22133","71401","2015",9,8,1,110673.3,1194.111,97.88889
"22134","71402","2015",5,5,0,189934,1644.6,117.8
"22135","71403","2015",1,1,0,55000,1375,40
"22136","71404","2015",9,7,2,139202.6,1468.333,106.6667
"22137","71405","2015",1,1,0,210000,1750,120
"22138","71407","2015",2,2,0,86250,1347.5,66
"22139","71408","2015",3,3,0,195966.7,1019.667,182
"22140","71409","2015",3,3,0,40000,514,78
"22141","71410","2015",6,6,0,112500,1332.167,95.83333
"22142","71411","2015",4,4,0,122375,1535.25,77.75
"22143","71412","2015",12,11,1,119703.5,1329.25,93
"22144","71413","2015",3,3,0,150400,1738.333,87.66667
"22145","71414","2015",2,2,0,87500,1071,69.5
"22146","71415","2015",1,1,0,50000,472,106
"22147","71416","2015",6,6,0,145376.2,1705.833,88
"22148","71417","2015",12,12,0,88086.67,967.1667,89.66667
"22149","71419","2015",26,24,2,124598.9,1343.269,97.11538
"22150","71420","2015",16,16,0,133806.2,1282.75,108.4375
"22151","71422","2015",3,3,0,182833.3,1231,166.3333
"22152","71423","2015",5,5,0,131560,1370.4,97.4
"22153","71424","2015",3,3,0,118533.3,1160.667,103.3333
"22154","71425","2015",5,5,0,79700,1101,72.6
"22155","71426","2015",6,6,0,105450,1339,90
"22156","71428","2015",6,6,0,119383.3,948.8333,127.5
"22157","71430","2015",2,2,0,144500,1410.5,105.5
"22158","71431","2015",5,5,0,78620,836.8,87.8
"22159","71433","2015",5,5,0,105140,862,119.2
"22160","71434","2015",5,5,0,116478,1251.6,92
"22161","71435","2015",1,1,0,78600,1228,64
"22162","71436","2015",7,6,1,130771.4,1474.429,82.42857
"22163","71437","2015",2,2,0,161250,1417.5,120
"22164","71438","2015",4,4,0,133000,1115.25,120.5
"22165","71439","2015",3,3,0,184573.3,1519.667,122.3333
"22166","71440","2015",4,4,0,135375,881.5,176.5
"22167","71441","2015",3,3,0,74000,967.3333,79.66667
"22168","71442","2015",15,15,0,103066.7,1347.333,76.93333
"22169","71443","2015",14,14,0,179587.3,1510.929,120.7857
"22170","71444","2015",12,12,0,158313.8,1502.833,113.0833
"22171","71445","2015",49,42,7,139462.6,1423.327,99.67347
"22172","71446","2015",4,4,0,120262.5,1006.25,113.75
"22173","71447","2015",4,4,0,116375,1148.5,101.5
"22174","71448","2015",9,9,0,169324.1,1689.778,99.33333
"22175","71449","2015",1,1,0,112000,1333,84
"22176","71450","2015",1,1,0,15000,385,39
"22177","71451","2015",1,1,0,176000,1364,129
"22178","71452","2015",8,8,0,134692.5,1418.375,87.75
"22179","71453","2015",2,2,0,117000,1179,101.5
"22180","71454","2015",2,2,0,95500,1022,95
"22181","71455","2015",1,1,0,345200,2301,150
"22182","71456","2015",15,15,0,165272,1357.8,122.3333
"22183","71457","2015",2,2,0,202500,1773.5,121.5
"22184","71459","2015",3,3,0,291343.3,2008.667,146.3333
"22185","71460","2015",2,2,0,169250,1464,121.5
"22186","71461","2015",2,2,0,85650,833,100.5
"22187","71462","2015",5,5,0,112000,1156.8,94.4
"22188","71463","2015",8,8,0,102562.5,1081.75,96
"22189","71464","2015",3,3,0,116666.7,1286.667,94.33333
"22190","71465","2015",1,1,0,50000,435,115
"22191","71466","2015",2,2,0,96000,845,119
"22192","71468","2015",11,10,1,154009.1,1332.091,114.4545
"22193","71469","2015",1,0,1,70000,1186,59
"22194","71470","2015",6,6,0,119791.7,1176.667,110.6667
"22195","71471","2015",3,3,0,147470,1402,104.6667
"22196","71472","2015",4,4,0,70000,1034.75,63.75
"22197","71474","2015",1,1,0,65000,730,89
"22198","71475","2015",50,45,5,154104.4,1588.5,96.16
"22199","71477","2015",2,2,0,165000,1194.5,137
"22200","71479","2015",10,10,0,131817,1295.6,101.7
"22201","71480","2015",10,10,0,131900,1184.1,118
"22202","71481","2015",15,13,2,146606.7,1288.533,119.8
"22203","71482","2015",5,5,0,126241.4,1183.4,113.2
"22204","71483","2015",1,1,0,180500,1280,141
"22205","71484","2015",17,16,1,107557.6,1073.588,93.76471
"22206","71485","2015",4,4,0,201775,2259.75,107.75
"22207","71486","2015",89,87,2,94860.84,1015.663,96.8427
"22208","71487","2015",1,1,0,226650,1743,130
"22209","71488","2015",1,1,0,92000,657,140
"22210","71489","2015",7,7,0,117108.6,1143.571,105.4286
"22211","71490","2015",4,4,0,125500,1190.25,104.25
"22212","71491","2015",10,10,0,108400.1,1087,109.1
"22213","71492","2015",3,3,0,82250,1165,68.33333
"22214","71493","2015",7,7,0,84507.14,1432.143,67.85714
"22215","71494","2015",5,5,0,162368,1695.8,92.2
"22216","71495","2015",7,7,0,138058.6,1448.857,92
"22217","71496","2015",1,1,0,1e+05,2083,48
"22218","71497","2015",12,8,4,164475,1799.833,89.91667
"22219","71499","2015",36,35,1,88742.56,962.0833,91.97222
"22220","71500","2015",1,1,0,170400,1385,123
"22221","71502","2015",8,8,0,139055,1392.625,106.125
"22222","71503","2015",1,1,0,201830,1565,129
"22223","71506","2015",15,14,1,111400,1014.067,116.9333
"22224","71507","2015",6,6,0,92750,1447.333,63.83333
"22225","71508","2015",4,4,0,136800,1264,109
"22226","71509","2015",3,3,0,104166.7,1258.667,80
"22227","71510","2015",2,2,0,245575,1425,172.5
"22228","71512","2015",22,22,0,149045.7,1428.909,108.2727
"22229","71513","2015",8,8,0,163992.5,1725,96.375
"22230","71514","2015",9,9,0,94500,969,98.44444
"22231","71515","2015",1,1,0,43500,343,127
"22232","71516","2015",9,9,0,128786.7,1114.556,117.5556
"22233","71517","2015",5,5,0,131524,1043.6,126.4
"22234","71518","2015",2,2,0,133069.5,1796.5,64.5
"22235","71519","2015",1,1,0,144000,1385,104
"22236","71520","2015",4,4,0,151075,1600,96
"22237","71521","2015",2,2,0,79000,757,104.5
"22238","71522","2015",16,16,0,132408.1,1375.562,98.0625
"22239","71523","2015",16,16,0,111312.5,1184.875,93.8125
"22240","71524","2015",4,4,0,170875,1122,133
"22241","71525","2015",6,6,0,189508.3,1805.5,111.6667
"22242","71526","2015",3,3,0,164616.7,1631.667,105.3333
"22243","71527","2015",2,2,0,32500,623,63
"22244","71528","2015",21,21,0,105358.7,1147.238,91.09524
"22245","71529","2015",2,2,0,157500,2007,76
"22246","71530","2015",2,2,0,94000,1695.5,61.5
"22247","71531","2015",2,2,0,92250,1137.5,76
"22248","71533","2015",2,2,0,94250,977,95
"22249","71535","2015",1,1,0,80000,748,107
"22250","71538","2015",4,4,0,133000,1393.75,103.5
"22251","71540","2015",15,14,1,134145.3,1331.8,104.9333
"22252","71541","2015",12,12,0,90566.67,1058.083,86.75
"22253","71542","2015",15,15,0,83133.33,982.3333,90.8
"22254","71543","2015",52,40,12,114051.3,1245.481,94.15385
"22255","71544","2015",1,1,0,27000,750,36
"22256","71545","2015",11,11,0,135629.1,1358.636,100.7273
"22257","71546","2015",6,6,0,114716.7,1280.333,88.66667
"22258","71547","2015",3,3,0,104066.7,1112,91.66667
"22259","71548","2015",7,7,0,111747.1,1167.571,92.57143
"22260","71549","2015",7,7,0,117242.9,1386.857,87.71429
"22261","71550","2015",10,9,1,80931.2,1239.8,74.6
"22262","71551","2015",7,7,0,158032.3,1526.714,119.5714
"22263","71552","2015",1,1,0,45000,511,88
"22264","71553","2015",3,3,0,169000,1379,115
"22265","71554","2015",2,2,0,226750,2732,90.5
"22266","71555","2015",10,10,0,175546,1658.9,108.4
"22267","71556","2015",6,3,3,160966.7,2038.167,81.83333
"22268","71557","2015",1,1,0,80000,1053,76
"22269","71558","2015",11,10,1,91081.82,1120.818,82.63636
"22270","71561","2015",3,3,0,175000,1235.667,145
"22271","71562","2015",1,1,0,84000,832,101
"22272","71563","2015",1,1,0,37000,673,55
"22273","71564","2015",9,9,0,76748.89,1030.222,79
"22274","71565","2015",2,2,0,69800,863.5,81.5
"22275","71566","2015",11,10,1,92745.45,1211,80.81818
"22276","71567","2015",4,4,0,163435,1862.25,86.75
"22277","71568","2015",1,1,0,122000,1061,115
"22278","71570","2015",4,4,0,164000,1341.25,131.75
"22279","71571","2015",3,3,0,103483.3,1012,104.3333
"22280","71572","2015",2,2,0,140300,1016,127.5
"22281","71573","2015",3,3,0,76166.67,706,105.6667
"22282","71574","2015",5,5,0,165060,1693.6,99
"22283","71577","2015",1,1,0,82000,845,97
"22284","71578","2015",4,4,0,114000,1267.75,95.75
"22285","71580","2015",5,5,0,160968,1418,113.4
"22286","71581","2015",3,3,0,108333.3,824.6667,132
"22287","71582","2015",13,13,0,123492.3,1635.692,81.92308
"22288","71583","2015",7,7,0,192207.1,1921,100
"22289","71584","2015",13,13,0,162629.2,1563.692,115.1538
"22290","71585","2015",14,11,3,127649.3,1379.429,91.92857
"22291","71586","2015",7,7,0,187198.6,1215.857,155.4286
"22292","71588","2015",12,12,0,104491.3,1025.25,104.5833
"22293","71589","2015",3,3,0,123466.7,1341,90.66667
"22294","71590","2015",5,5,0,196772,1744.4,122.2
"22295","71591","2015",5,5,0,108960,1034.8,114.8
"22296","72001","2015",6,6,0,142666.7,1360.333,103.1667
"22297","72002","2015",3,3,0,59833.33,855.3333,81.66667
"22298","72003","2015",56,36,20,104360.3,1345.161,77.60714
"22299","72004","2015",4,4,0,90363,946.25,99.75
"22300","72005","2015",9,9,0,140609.4,1343.333,106.1111
"22301","72006","2015",24,24,0,131229.2,1431.875,91.91667
"22302","72007","2015",6,6,0,164500,1785.5,94
"22303","72008","2015",51,51,0,139650.7,1399.098,99.94118
"22304","72009","2015",6,6,0,126500,1136.5,113.1667
"22305","72010","2015",3,3,0,61850,931.6667,64.66667
"22306","72011","2015",9,9,0,70377.78,983.8889,75.55556
"22307","72012","2015",7,7,0,105514.3,1311.286,99.28571
"22308","72013","2015",22,22,0,93500,956.5909,99.04545
"22309","72015","2015",2,2,0,79500,881,87
"22310","72016","2015",10,10,0,151360,1397.1,127
"22311","72017","2015",2,2,0,84950,1273.5,65.5
"22312","72019","2015",5,5,0,84700,1066,88.2
"22313","72020","2015",7,7,0,112992.9,1106.857,102.5714
"22314","72021","2015",8,8,0,96750,1203.25,90.375
"22315","72022","2015",10,10,0,108100,1104.3,96.4
"22316","72023","2015",22,22,0,111834.5,1370,83.86364
"22317","72024","2015",29,29,0,159131,1484.414,107.4138
"22318","72025","2015",24,24,0,114737.5,1194.292,103.1667
"22319","72026","2015",21,21,0,118683.5,1354.571,88.14286
"22320","72027","2015",5,5,0,109200,1173.6,103.2
"22321","72028","2015",1,1,0,97380,1014,96
"22322","72029","2015",20,20,0,88285,1132.3,78.7
"22323","72031","2015",12,12,0,101291.7,1134.917,89.41667
"22324","72032","2015",4,4,0,71350,1029.5,68
"22325","72034","2015",4,4,0,148512.5,1359.25,103.25
"22326","72035","2015",12,12,0,96366.67,915.4167,107.3333
"22327","72036","2015",5,5,0,153740,1506.4,103
"22328","72037","2015",1,1,0,45000,523,86
"22329","72038","2015",11,11,0,93860.91,901.2727,100.5455
"22330","72039","2015",40,40,0,94636.45,1096.325,86.25
"22331","72041","2015",2,2,0,104000,1067,104.5
"22332","72042","2015",22,22,0,99771.59,1197.909,83.54545
"22333","72043","2015",5,5,0,97640,1038.4,93.6
"22334","72044","2015",1,1,0,80000,870,92
"22335","72045","2015",4,4,0,108557.5,1547.25,91.75
"22336","72046","2015",19,19,0,98696.53,1193,88.52632
"22337","72047","2015",4,4,0,80375,1389.75,63.75
"22338","72048","2015",4,4,0,82250,1026,77
"22339","72050","2015",11,11,0,107758.1,984.3636,98.54545
"22340","72051","2015",34,34,0,130365.6,1257.824,101.8529
"22341","72052","2015",8,8,0,59787.5,735,81.25
"22342","72053","2015",9,9,0,119074.4,1456.667,81.77778
"22343","72054","2015",31,30,1,144317.3,1378.355,108.2903
"22344","72056","2015",12,9,3,85460,1072.917,84
"22345","72057","2015",2,2,0,176500,1585.5,111
"22346","72058","2015",45,44,1,180794.9,1695.644,108.7556
"22347","72059","2015",5,5,0,124000,1122.8,116.2
"22348","72060","2015",3,3,0,77166.67,1139.333,84
"22349","72061","2015",22,22,0,126696,1343.909,97.13636
"22350","72062","2015",6,6,0,131866.7,1230.5,91.16667
"22351","72064","2015",5,5,0,124700,1081.4,117.4
"22352","72065","2015",14,14,0,206439.6,1906.5,106.1429
"22353","72066","2015",3,3,0,154000,1923,80.33333
"22354","72067","2015",15,15,0,117573.3,1180.933,109
"22355","72068","2015",20,19,1,122042.5,1235.45,104
"22356","72070","2015",1,1,0,140000,1186,118
"22357","72071","2015",64,64,0,95896.09,1000.906,96.25
"22358","72072","2015",4,4,0,131987.5,1230.5,110
"22359","72073","2015",5,5,0,98240,1290.4,73
"22360","72074","2015",4,4,0,105000,1262.25,84.75
"22361","72075","2015",7,7,0,116161.4,1306.429,94.42857
"22362","72076","2015",3,3,0,169101,1133,156
"22363","72077","2015",4,4,0,67000,740.5,98
"22364","72078","2015",3,3,0,122333.3,1179,108
"22365","72079","2015",2,2,0,133100,1068,117
"22366","72080","2015",23,23,0,155673,1618.826,99.34783
"22367","72083","2015",3,3,0,228166.7,1273.333,171
"22368","72084","2015",12,12,0,105333.3,953.0833,118.8333
"22369","72085","2015",3,3,0,137333.3,1348,101.3333
"22370","72087","2015",4,4,0,103000,1128.25,93.25
"22371","72088","2015",3,3,0,112333.3,989,97.66667
"22372","72089","2015",17,17,0,114970.6,1295.353,92.35294
"22373","72090","2015",33,33,0,106642.7,1279.424,83.63636
"22374","72093","2015",5,5,0,137890,1370.2,98.8
"22375","72094","2015",10,10,0,97620,1098.1,86.5
"22376","72095","2015",49,33,16,145880.1,1497.02,96.22449
"22377","72096","2015",1,1,0,47000,887,53
"22378","72098","2015",4,4,0,71000,889.5,77.75
"22379","72099","2015",3,3,0,111918.7,1091.667,99.33333
"22380","72100","2015",3,3,0,82333.33,931,101.6667
"22381","72101","2015",10,10,0,133867,1224.7,119
"22382","72103","2015",7,7,0,134642.9,1190.429,131.5714
"22383","72104","2015",3,3,0,93333.33,996.6667,98.33333
"22384","72105","2015",6,6,0,105166.7,1247.5,88.16667
"22385","72106","2015",3,3,0,149333.3,1821.667,104.6667
"22386","72107","2015",2,2,0,100412.5,1380,70
"22387","72109","2015",5,5,0,73392,1121.8,72
"22388","72110","2015",2,2,0,183500,1325.5,143
"22389","72111","2015",8,8,0,99887.5,1245.25,84.125
"22390","72112","2015",3,3,0,101333.3,915,114
"22391","72113","2015",2,2,0,120000,1188.5,119.5
"22392","72114","2015",1,1,0,99000,1414,70
"22393","72115","2015",7,7,0,74628.57,874.2857,84.42857
"22394","72118","2015",15,15,0,84073.33,1020.533,83.2
"22395","72119","2015",10,10,0,126680,1322.7,99.9
"22396","72120","2015",3,3,0,86000,944.3333,86.66667
"22397","72121","2015",4,4,0,124875,1426.5,93.5
"22398","72122","2015",10,10,0,116600,1254.8,96.7
"22399","72123","2015",1,1,0,120000,1395,86
"22400","72124","2015",37,33,4,114909.5,1250.054,94.91892
"22401","72125","2015",2,2,0,157500,876.5,207.5
"22402","72126","2015",8,8,0,117200,1177.375,107.125
"22403","72127","2015",16,16,0,148112.5,1546.375,98.75
"22404","72128","2015",5,5,0,101600,901.4,110
"22405","72129","2015",4,4,0,168250,1632,108
"22406","72130","2015",1,1,0,165000,2200,75
"22407","72131","2015",11,11,0,140000,1223.545,105.8182
"22408","72132","2015",101,78,23,119710.3,1378.149,85.08911
"22409","72133","2015",16,16,0,154841.9,1548.312,103.625
"22410","72134","2015",7,7,0,73142.86,935.4286,73
"22411","72135","2015",6,6,0,143068.3,1468.333,97.66667
"22412","72136","2015",2,2,0,51666.5,627,84.5
"22413","72137","2015",18,18,0,105094.4,1162.556,95.66667
"22414","72138","2015",31,31,0,88653.23,1078.452,82.41935
"22415","72139","2015",5,5,0,257650,3083.8,105
"22416","72141","2015",13,13,0,93403.85,1143.308,79.92308
"22417","72142","2015",2,2,0,67500,1027.5,60
"22418","72143","2015",23,22,1,107521.7,1206.913,90.52174
"22419","72144","2015",5,5,0,60480,890.8,68.2
"22420","72145","2015",2,2,0,147500,1106,135
"22421","72146","2015",16,16,0,160875,1580.312,109.75
"22422","72147","2015",17,17,0,135403.2,1334.706,99.29412
"22423","72149","2015",8,8,0,127703.8,1521.125,94.875
"22424","72150","2015",15,15,0,149100.9,1394.6,105.6
"22425","72151","2015",14,14,0,125821.4,1205.643,109.0714
"22426","72152","2015",2,2,0,91000,1104,101
"22427","72153","2015",8,8,0,104562.5,923.5,117.125
"22428","72154","2015",140,126,14,121471.9,1279.386,96.12857
"22429","72155","2015",24,24,0,149809.6,1528.583,102.875
"22430","72156","2015",10,10,0,85140,1004,81.8
"22431","72157","2015",12,12,0,174030,1363.25,125.6667
"22432","72158","2015",8,8,0,80125,1056.625,76
"22433","72160","2015",3,3,0,130000,1433.333,93
"22434","72161","2015",11,11,0,131363.6,1257.364,91.27273
"22435","72163","2015",4,4,0,80625,903.25,87.75
"22436","72164","2015",1,1,0,120000,1667,72
"22437","72165","2015",18,18,0,117072.2,1210.111,99.11111
"22438","72166","2015",3,3,0,104333.3,1304,74.33333
"22439","72167","2015",4,4,0,135000,1418.75,98
"22440","72168","2015",19,19,0,103411.6,1020.105,96.15789
"22441","72169","2015",17,17,0,164230.8,1608.765,104.5882
"22442","72170","2015",3,3,0,72666.67,713.3333,103
"22443","72171","2015",2,2,0,90000,1017.5,90.5
"22444","72172","2015",18,18,0,116617.8,1176.278,101.1667
"22445","72173","2015",8,8,0,138875,1533.625,87
"22446","72174","2015",5,5,0,102400,1049.8,95.8
"22447","72175","2015",20,20,0,88055,1128.1,80.1
"22448","72176","2015",17,17,0,98388.24,1040.412,95.05882
"22449","72177","2015",4,4,0,81250,743.75,115.5
"22450","72179","2015",31,30,1,105938.7,1119.968,98.06452
"22451","72180","2015",46,39,7,81131.52,951.5652,86.1087
"22452","72181","2015",1981,1073,908,122005.5,1588.869,76.10348
"22453","72182","2015",19,19,0,90512.37,1176.421,79.47368
"22454","72183","2015",4,4,0,153150,1686,104
"22455","72184","2015",5,5,0,110340,1026,105.4
"22456","72185","2015",6,6,0,97183.33,1091,92
"22457","72186","2015",6,6,0,116450,1392.667,88
"22458","72187","2015",9,9,0,112555.6,1397.444,90
"22459","72188","2015",3,3,0,130716.7,1220.667,106.6667
"22460","72189","2015",20,20,0,102620,1121.4,91.15
"22461","72190","2015",2,2,0,111200,1166.5,98.5
"22462","72191","2015",33,33,0,98313.64,1155.212,85.87879
"22463","72192","2015",1,1,0,76000,844,90
"22464","72193","2015",4,4,0,61250,825.75,75.25
"22465","72194","2015",1,1,0,97000,1329,73
"22466","72195","2015",17,17,0,122329.4,1198.353,104.5882
"22467","72196","2015",9,9,0,68111.11,891.1111,75.22222
"22468","72197","2015",7,7,0,136600,1417.286,97.85714
"22469","72198","2015",24,23,1,161612.1,1620.917,98.75
"22470","72199","2015",4,4,0,67625,1114.5,64
"22471","72200","2015",21,21,0,136540.4,1438.905,95.57143
"22472","72201","2015",1,1,0,33000,550,60
"22473","72202","2015",2,2,0,55500,722,75
"22474","72204","2015",7,7,0,72142.86,940,88.57143
"22475","72205","2015",24,24,0,118716.5,1336.708,91.33333
"22476","72208","2015",6,6,0,76333.33,673.3333,125
"22477","72209","2015",6,6,0,79416.67,1077.167,71.66667
"22478","72210","2015",1,1,0,50000,1471,34
"22479","72211","2015",7,7,0,97049,1423.143,74.57143
"22480","72212","2015",6,6,0,129719,1266.167,103.3333
"22481","72213","2015",41,41,0,158651.7,1533.293,104.5122
"22482","72215","2015",11,11,0,102681.8,1133.545,89.45455
"22483","72216","2015",6,6,0,151083.3,1295,112
"22484","72217","2015",35,35,0,166270.4,1687.743,107.5143
"22485","72218","2015",5,5,0,88846,1142,81.4
"22486","72219","2015",4,4,0,135750,1260.25,105
"22487","72220","2015",10,10,0,85590,1035.8,81.6
"22488","72221","2015",4,4,0,88750,765.25,105.75
"22489","72222","2015",5,5,0,87800,729.8,121
"22490","72223","2015",21,21,0,124837.1,1490.095,89.33333
"22491","72224","2015",6,6,0,111000,1181.833,91
"22492","72225","2015",2,2,0,102000,970.5,105
"22493","72226","2015",14,14,0,110965.5,1221.071,91.28571
"22494","72227","2015",1,1,0,106700,1111,96
"22495","72228","2015",17,17,0,114000,1147.941,103.2941
"22496","72229","2015",5,5,0,94086,935.6,99.4
"22497","72230","2015",8,8,0,117687.5,1149.625,99.75
"22498","72231","2015",37,37,0,170673,1583,111.3243
"22499","72232","2015",5,5,0,109340,1289.8,87.8
"22500","72234","2015",2,2,0,62900,1135,55
"22501","72235","2015",6,6,0,87983.33,1088.833,80.83333
"22502","72236","2015",2,2,0,204000,1381.5,146
"22503","72237","2015",6,6,0,126833.3,1217.833,103.5
"22504","72238","2015",1,1,0,130000,707,184
"22505","72239","2015",6,6,0,84383.33,1038,79.83333
"22506","72241","2015",40,40,0,119342.5,1398.5,89.475
"22507","72243","2015",11,11,0,106185.5,955.0909,110.1818
"22508","72244","2015",11,11,0,132564.5,1163.545,129.1818
"22509","72245","2015",3,3,0,129833.3,1269,101.6667
"22510","72246","2015",6,6,0,111083.3,1185.333,94
"22511","72247","2015",6,6,0,172235,1626.833,106.3333
"22512","72248","2015",14,14,0,111760.7,1215.857,99.85714
"22513","72249","2015",8,8,0,118712.5,1255.25,99.875
"22514","72250","2015",2,2,0,157000,1902.5,133.5
"22515","72251","2015",4,4,0,128750,1236,103.75
"22516","72252","2015",13,13,0,97915.38,1089.462,90.61538
"22517","72253","2015",22,22,0,124520.7,1210.955,97.90909
"22518","72254","2015",1,1,0,68000,895,76
"22519","72255","2015",3,3,0,88833.33,1190,81.66667
"22520","72256","2015",4,4,0,74500,921.75,84.25
"22521","72257","2015",13,11,2,185345.2,2255.846,94.84615
"22522","72259","2015",5,5,0,54440,650.6,82.8
"22523","72260","2015",31,28,3,158669,1569.129,101.1935
"22524","72261","2015",4,4,0,135375,1096.75,125
"22525","72262","2015",18,18,0,85928,1001.944,86.22222
"22526","72264","2015",101,91,10,118842.8,1320.109,94.20792
"22527","72265","2015",4,4,0,86525,885,88.25
"22528","72266","2015",4,4,0,146247.5,1278.25,116.75
"22529","72267","2015",9,9,0,75050,1079.444,72.55556
"22530","72268","2015",4,3,1,168000,1644.75,113.25
"22531","72269","2015",26,25,1,83812.15,1064.923,77.26923
"22532","72270","2015",4,4,0,89750,980,76.25
"22533","72271","2015",21,21,0,112727.6,1293.381,88.7619
"22534","72272","2015",4,4,0,110165.2,1488,79
"22535","72274","2015",2,2,0,131650,1059,128
"22536","72275","2015",8,8,0,145237.5,1400.875,104.75
"22537","72276","2015",29,29,0,84637.93,1039.414,88.37931
"22538","72277","2015",1,1,0,95500,1345,71
"22539","72278","2015",8,8,0,65875,893.25,85.75
"22540","72279","2015",4,4,0,40375,666.75,61
"22541","72280","2015",14,14,0,161162.1,1587.786,98.57143
"22542","72281","2015",6,6,0,164184.2,1263.833,136.8333
"22543","72283","2015",4,4,0,143375,2115.25,92.5
"22544","72286","2015",2,2,0,79750,1104,66.5
"22545","72287","2015",15,15,0,153647.1,1630.067,93.4
"22546","72289","2015",21,21,0,115025.7,1342.143,87.04762
"22547","72290","2015",11,11,0,142409.1,1393,111.8182
"22548","72291","2015",6,6,0,90916.67,939.3333,96.5
"22549","72292","2015",4,4,0,102625,1127.75,99
"22550","72293","2015",2,2,0,137250,1536,92
"22551","72294","2015",9,9,0,93333.33,1236.889,80.55556
"22552","72295","2015",7,7,0,97885.71,1064.143,96.85714
"22553","72296","2015",10,10,0,102200,1224.4,82.4
"22554","72297","2015",6,6,0,97380.83,1228.833,69.5
"22555","72298","2015",5,5,0,109270,1144,95.8
"22556","72299","2015",31,31,0,136812,1318.71,105.4516
"22557","72300","2015",23,23,0,156735.8,1626.522,103.9565
"22558","72303","2015",8,8,0,80587.5,878.5,95.25
"22559","72305","2015",4,4,0,96325,1290.5,77.5
"22560","72306","2015",6,6,0,146916.7,1485.833,94.83333
"22561","72307","2015",6,6,0,133025,1076.667,121
"22562","72308","2015",19,18,1,131833.5,1488.263,93.57895
"22563","72309","2015",4,4,0,56800,681.5,93.75
"22564","72310","2015",11,11,0,209754.5,1644.273,130.0909
"22565","72311","2015",2,2,0,46000,764.5,57.5
"22566","72312","2015",1,1,0,89000,881,101
"22567","72313","2015",2,2,0,85000,670,117
"22568","72314","2015",4,4,0,89500,647.75,132.5
"22569","72315","2015",9,9,0,83938,1052.222,84.44444
"22570","72316","2015",7,7,0,93557.14,1027.857,90.42857
"22571","72317","2015",4,4,0,95375,1046.75,95
"22572","72319","2015",11,11,0,97715.09,1122,85.72727
"22573","72320","2015",25,25,0,221344.8,1917.52,114.84
"22574","72321","2015",2,2,0,131750,1620,84.5
"22575","72322","2015",6,6,0,123500,1545.5,78
"22576","72323","2015",5,5,0,118000,1088.6,110.4
"22577","72324","2015",4,4,0,122712.5,1288.25,97.5
"22578","72325","2015",9,9,0,70944.44,1093.778,65.55556
"22579","72326","2015",1,1,0,133500,1335,100
"22580","72327","2015",3,3,0,66666.67,617.6667,100
"22581","72328","2015",21,21,0,204819.5,1846.381,111.1429
"22582","72329","2015",33,33,0,161084.8,1578.152,103.5152
"22583","72330","2015",3,3,0,81333.33,1875.333,62.33333
"22584","72331","2015",4,4,0,88078.5,1283.5,72.5
"22585","72332","2015",6,6,0,100922.5,1264.667,88.16667
"22586","72333","2015",8,8,0,91785,1175.625,81.875
"22587","72334","2015",22,20,2,94476.36,1139.5,87.72727
"22588","72335","2015",17,17,0,119129.4,1404.529,88.70588
"22589","72336","2015",13,13,0,187361.9,1396.077,139.3077
"22590","72337","2015",10,10,0,79410,1031.3,79.1
"22591","72338","2015",6,6,0,153425,1622.333,93.83333
"22592","72339","2015",4,4,0,152000,1546.75,111
"22593","72340","2015",13,13,0,125330.8,1154.231,111.1538
"22594","72341","2015",7,7,0,110857.1,1313.143,90.28571
"22595","72342","2015",2,2,0,189250,1231.5,154
"22596","72343","2015",7,7,0,122428.6,1217.571,100.2857
"22597","72344","2015",21,21,0,172188,1566.81,112
"22598","72345","2015",4,4,0,217665.2,1556.5,126.75
"22599","72346","2015",47,47,0,112954.8,1398.489,80.34043
"22600","72347","2015",3,3,0,42333.33,543.6667,78.66667
"22601","72348","2015",4,4,0,100750,1243.25,82
"22602","72349","2015",6,6,0,102858.3,1300.333,84.83333
"22603","72350","2015",21,21,0,149488.1,1288.19,116.381
"22604","72351","2015",10,10,0,84800,952.8,89.3
"22605","72352","2015",1,1,0,163500,985,166
"22606","72353","2015",2,2,0,92500,1490,69.5
"22607","72355","2015",3,3,0,62333.33,646.6667,95
"22608","72356","2015",3,3,0,106016.7,1185.333,92.33333
"22609","72357","2015",10,10,0,111600,939,123.1
"22610","72358","2015",13,13,0,105707.7,1318.769,82.84615
"22611","72359","2015",26,26,0,134836.5,1390.115,103.2308
"22612","72361","2015",3,3,0,82666.67,889,88.66667
"22613","72362","2015",1,1,0,104000,1300,80
"22614","72363","2015",21,21,0,104997.6,1161.762,91.95238
"22615","72364","2015",21,21,0,87838.1,1035.381,84.42857
"22616","72366","2015",4,4,0,91250,1076.75,90.25
"22617","72367","2015",6,6,0,80666.67,1160,72.83333
"22618","72368","2015",6,6,0,108733.3,1128.333,101
"22619","72369","2015",2,2,0,68750,758,96
"22620","72370","2015",5,5,0,134460,1120.2,135.4
"22621","72372","2015",2,2,0,98000,981,101.5
"22622","72373","2015",30,29,1,91945.6,1064.033,82.6
"22623","72374","2015",1,1,0,73500,1413,52
"22624","72375","2015",5,5,0,92110,1372.8,83.8
"22625","72376","2015",1,1,0,128500,1168,110
"22626","72377","2015",10,10,0,104482.6,1183.7,89.8
"22627","72378","2015",10,10,0,148127.4,1300.5,114
"22628","72379","2015",2,2,0,59000,814.5,65.5
"22629","72380","2015",13,13,0,89171.15,1035.692,86.30769
"22630","72381","2015",16,16,0,152684.6,1514.688,101.1875
"22631","72382","2015",11,11,0,123195.5,1266,105.3636
"22632","72385","2015",18,18,0,123827.8,1379.778,94.27778
"22633","72386","2015",48,48,0,187065.8,1678.104,113.4375
"22634","73001","2015",2,0,2,72465,1740,43.5
"22635","73003","2015",37,15,22,148389.8,2023.973,72.54054
"22636","73004","2015",15,4,11,70433.33,1883.6,34.6
"22637","73005","2015",2,2,0,91500,1321,70
"22638","73006","2015",114,17,97,127712.7,2751.868,48.21053
"22639","73007","2015",12,11,1,147896.2,1698.417,86.33333
"22640","73008","2015",511,98,413,182658.1,2826.879,66.47358
"22641","73010","2015",44,36,8,211099.5,2411.523,92.40909
"22642","73011","2015",199,45,154,130160.1,1831.236,72.49749
"22643","73012","2015",1,1,0,185000,1128,164
"22644","73013","2015",10,3,7,111659.8,2327.3,59.7
"22645","73015","2015",130,12,118,369430.7,6936.877,49.43846
"22646","73017","2015",2,2,0,137150,2352,49
"22647","73018","2015",13,9,4,181088.1,2022.231,94.38462
"22648","73019","2015",12,12,0,114259.2,1564,78.25
"22649","73020","2015",3,3,0,225488.3,2009.333,119.6667
"22650","73021","2015",9,9,0,137936.4,1267.889,100.4444
"22651","73022","2015",3,3,0,167986.7,1778.667,108.6667
"22652","73023","2015",14,1,13,124353.6,3002.571,42.57143
"22653","73024","2015",52,6,46,134521.3,3369.808,44.26923
"22654","73025","2015",1,1,0,179500,1496,120
"22655","73027","2015",4,4,0,229950,1476.5,158.75
"22656","73028","2015",4,4,0,108000,1053.5,99.75
"22657","73029","2015",73,19,54,204700.4,2613.123,81.16438
"22658","73030","2015",27,11,16,207885.6,2610.37,78.92593
"22659","73031","2015",52,11,41,197487.1,2567.308,77.73077
"22660","73032","2015",24,17,7,131726.2,1708,77.95833
"22661","73033","2015",5,5,0,192600,1559.8,125.2
"22662","73034","2015",44,18,26,206894.2,3702.477,59.77273
"22663","73036","2015",8,7,1,139688.2,1875.25,85.25
"22664","73039","2015",3,3,0,311766.7,2313,126.6667
"22665","73040","2015",8,2,6,156961.6,3373.25,45.625
"22666","73041","2015",1,1,0,201475,1651,122
"22667","73043","2015",9,9,0,241911.1,2376,99.66667
"22668","73047","2015",4,0,4,179500,4509.5,37.5
"22669","73048","2015",3,3,0,127333.3,1787,88
"22670","73049","2015",1,1,0,205000,2356,87
"22671","73050","2015",3,1,2,242358.3,2479.667,97
"22672","73051","2015",47,15,32,199630.4,3140.277,66.55319
"22673","73052","2015",2,2,0,153150,2548,63.5
"22674","73053","2015",6,6,0,307741.2,3287.5,114.5
"22675","73054","2015",301,22,279,149770.9,3549.405,43.33887
"22676","73055","2015",27,11,16,230486,3263.704,74.14815
"22677","73057","2015",29,1,28,99388.66,3094.138,31.17241
"22678","73058","2015",13,9,4,155500,1878.923,85
"22679","73059","2015",22,18,4,280503.4,3009.409,98.90909
"22680","73061","2015",3,3,0,153800,1364,118
"22681","73063","2015",4,4,0,192975,2104.5,83.5
"22682","73064","2015",70,14,56,203092.2,2854.886,74.57143
"22683","73065","2015",711,100,611,165877.3,2311.557,73.61181
"22684","73067","2015",11,5,6,172509.1,1909.909,97.27273
"22685","73068","2015",7,7,0,199775.1,2016.286,100.2857
"22686","73069","2015",10,8,2,125138.3,1451.4,77.9
"22687","73070","2015",9,8,1,179070.3,2008,94.66667
"22688","73071","2015",26,8,18,279853.9,4426.962,62.53846
"22689","73072","2015",1,1,0,102000,2914,35
"22690","73073","2015",8,8,0,221231.2,2572.25,86.75
"22691","73074","2015",2,2,0,104200,1896.5,51
"22692","73075","2015",2,2,0,249800,1786,141.5
"22693","73077","2015",4,4,0,381000,2464.75,156.75
"22694","73078","2015",1,1,0,228500,1565,146
"22695","73079","2015",7,7,0,219361.7,1958.714,115.7143
"22696","73081","2015",5,3,2,167230,2266.2,86
"22697","73082","2015",7,7,0,267857.1,2140.714,130
"22698","73083","2015",3,3,0,239596.7,2142,114
"22699","73084","2015",5,5,0,235000,2857,97.8
"22700","73085","2015",18,14,4,156991.7,2341.5,80.88889
"22701","73086","2015",1,0,1,110000,1222,90
"22702","73087","2015",60,19,41,205622.9,2606.283,80.56667
"22703","73088","2015",11,2,9,202816.8,3777.364,54.36364
"22704","73089","2015",10,10,0,185039.6,2067.5,96.5
"22705","73090","2015",6,6,0,132341.7,1115.5,116
"22706","73091","2015",6,5,1,345282.5,4095,99.66667
"22707","73092","2015",3,3,0,216512,1867,121
"22708","73094","2015",14,5,9,341295,4479.857,75.57143
"22709","73096","2015",12,12,0,271069.5,2216.083,123.6667
"22710","73097","2015",7,7,0,259364.3,2548.429,105.1429
"22711","73098","2015",11,9,2,278868.2,3295.273,95.18182
"22712","73099","2015",4,4,0,159375,1399,113.75
"22713","73100","2015",14,14,0,173707.1,1723.5,103
"22714","73101","2015",1,1,0,53000,646,82
"22715","73103","2015",20,10,10,241969,2787.8,87
"22716","73104","2015",4,4,0,241800,2304.5,103
"22717","73105","2015",8,3,5,111468.8,1571.125,67
"22718","73106","2015",4,4,0,146200,1674.5,95.5
"22719","73107","2015",5,4,1,120300,1474.6,75.4
"22720","73109","2015",2,2,0,110000,1338,83
"22721","73110","2015",9,8,1,233169.3,2354,86.11111
"22722","73113","2015",4,4,0,176933.5,1727,97.25
"22723","73114","2015",14,4,10,194833.6,3026.786,61.85714
"22724","73116","2015",37,5,32,146726.8,3063.432,42.89189
"22725","73117","2015",5,0,5,68800,1117,61.8
"22726","73119","2015",2,2,0,195250,1931.5,101.5
"22727","73120","2015",1,1,0,65000,1444,45
"22728","73121","2015",14,7,7,219815.2,2160.857,97.85714
"22729","73122","2015",3,3,0,181500,1716.667,114
"22730","73123","2015",8,4,4,133576.2,2353.25,59.625
"22731","73124","2015",24,15,9,234481.2,2486.75,101.3333
"22732","73128","2015",51,25,26,295963.3,3158.431,92.5098
"22733","73129","2015",14,9,5,141046.4,1683.857,90.78571
"22734","73130","2015",17,14,3,204744.7,2190.941,94.76471
"22735","73131","2015",3,3,0,235698.7,1403.667,161.3333
"22736","73132","2015",54,6,48,236145,5102.852,46.83333
"22737","73133","2015",5,4,1,184287.2,1619.8,116
"22738","73135","2015",11,11,0,125840,1827.818,71.72727
"22739","73137","2015",46,7,39,187408.9,2648.848,72.23913
"22740","73138","2015",5,4,1,124080,2168.4,55.8
"22741","73139","2015",4,4,0,116312.5,1146.75,95.25
"22742","73140","2015",1,1,0,59190,1644,36
"22743","73141","2015",14,13,1,149389.3,1717.071,90.35714
"22744","73142","2015",26,5,21,224208.4,4227.231,55.42308
"22745","73145","2015",6,6,0,214200,2090.333,109.1667
"22746","73146","2015",6,3,3,136866.7,1684.667,84.5
"22747","73147","2015",2,2,0,129500,1230,105.5
"22748","73149","2015",3,3,0,117433.3,1690,62.33333
"22749","73150","2015",245,27,218,123299.7,3234.127,38.32653
"22750","73151","2015",19,14,5,205769.7,2371.632,85.89474
"22751","73152","2015",3,3,0,146666.7,1285,113
"22752","73153","2015",7,6,1,184847.1,1817.571,102.4286
"22753","73154","2015",26,18,8,183077.2,1827,99.42308
"22754","73155","2015",12,10,2,247694.6,2706.083,92.66667
"22755","73156","2015",2,2,0,214890,1849.5,116.5
"22756","73157","2015",69,3,66,59071.86,1562.42,43.18841
"22757","73159","2015",10,8,2,186649,2129.8,89.7
"22758","73160","2015",6,5,1,422179.7,2760.667,150.3333
"22759","73161","2015",2,2,0,98522.5,2088,60
"22760","73162","2015",7,7,0,181600,1792.571,99.71429
"22761","73164","2015",15,15,0,216507.7,2246.933,96.66667
"22762","73166","2015",3,3,0,62566.67,1048,62.66667
"22763","73170","2015",6,6,0,211701.7,2024.667,104.5
"22764","73171","2015",31,7,24,157166.1,1978.806,78.35484
"22765","73173","2015",3,3,0,178506.7,2429,77.66667
"22766","73175","2015",3,3,0,100166.7,1829,52.33333
"22767","73176","2015",36,4,32,195231.9,3613.917,54.61111
"22768","73177","2015",3,3,0,144866,1871.667,83.66667
"22769","73178","2015",4,4,0,250027.5,2368.5,120.5
"22770","73179","2015",101,30,71,195634.5,2525.416,76.72277
"22771","73180","2015",8,8,0,178266.2,2377.625,84.125
"22772","73181","2015",20,6,14,121451.4,1568.45,84.9
"22773","73182","2015",22,18,4,260405.7,2835.682,93.86364
"22774","73183","2015",10,7,3,285520,2952.9,104.2
"22775","73184","2015",3,2,1,230716.7,2257.667,103.3333
"22776","73186","2015",24,3,21,189235,3824.583,49.375
"22777","73187","2015",22,12,10,155763.5,2401.227,70.5
"22778","73188","2015",5,5,0,250238,2237,95.2
"22779","73189","2015",3,3,0,193233.3,2022,97.66667
"22780","73190","2015",2,2,0,153465,1705.5,90
"22781","73191","2015",16,14,2,222663.5,2265.062,103.375
"22782","73192","2015",3,3,0,250866.7,1851.333,131
"22783","73193","2015",2,2,0,192887.5,2154.5,89.5
"22784","73194","2015",19,8,11,113096.9,2036.211,59.36842
"22785","73196","2015",3,2,1,216650,2473.667,89.33333
"22786","73197","2015",24,7,17,170131.4,3118.167,61.54167
"22787","73200","2015",3,1,2,193883.3,2220,88.66667
"22788","73201","2015",10,5,5,166555.5,1948.5,97.8
"22789","73202","2015",6,6,0,253191.7,2514.833,97.83333
"22790","73204","2015",32,13,19,109633.1,1450.688,79.46875
"22791","73205","2015",1,1,0,59000,808,73
"22792","73206","2015",23,4,19,196857,4233.652,48
"22793","73207","2015",5,5,0,98109,1334.6,67.8
"22794","73208","2015",8,8,0,438790,2927.125,149.25
"22795","73210","2015",2,2,0,236725,2560.5,120
"22796","73211","2015",7,7,0,202266.4,3374.857,64.14286
"22797","73212","2015",14,11,3,118839.3,1472.071,78.28571
"22798","73213","2015",86,27,59,210739.7,2619.744,80.97674
"22799","73214","2015",1,1,0,170000,1589,107
"22800","73215","2015",2,2,0,183500,1922,101
"22801","73216","2015",5,5,0,170956.2,3078.4,71.2
"22802","73217","2015",2,2,0,152767,1214.5,125
"22803","73218","2015",12,12,0,210835,2383.667,89.5
"22804","73219","2015",7,6,1,245947.1,2293.429,111.1429
"22805","73220","2015",3,3,0,116666.7,1592,72.66667
"22806","73221","2015",2,2,0,84250,1821.5,47
"22807","73222","2015",61,23,38,233142.6,2953.377,79.18033
"22808","73223","2015",3,2,1,168333.3,1857,95.33333
"22809","73224","2015",7,7,0,147900,1768.429,81.85714
"22810","73225","2015",13,7,6,289982.7,2845.538,101.2308
"22811","73226","2015",9,8,1,225972.2,1489,153.2222
"22812","73227","2015",126,18,108,340129.6,6415.357,54.42063
"22813","73228","2015",2,2,0,287900,2311,121
"22814","73229","2015",1,1,0,55000,688,80
"22815","73230","2015",2,2,0,169750,1565,112.5
"22816","73231","2015",13,12,1,130011.5,1636.462,82.46154
"22817","73232","2015",31,12,19,371827.3,4309.903,82.93548
"22818","73234","2015",3,3,0,142000,2237,71.33333
"22819","73235","2015",65,9,56,108001.7,2840.123,37.18462
"22820","73236","2015",42,34,8,144461.9,1562.881,102.7143
"22821","73237","2015",5,5,0,179812.2,2198.6,94
"22822","73240","2015",8,7,1,231011.6,2021.25,115.625
"22823","73241","2015",11,11,0,150517.1,1460.273,107.1818
"22824","73242","2015",7,2,5,169007.1,2367.143,86.85714
"22825","73243","2015",20,10,10,196087.9,2558.8,80
"22826","73245","2015",5,4,1,199890,1448.4,123.8
"22827","73246","2015",3,3,0,199500,1879,101.3333
"22828","73247","2015",8,7,1,193092.5,2475.125,84.375
"22829","73248","2015",63,13,50,132847.2,1708.587,78.12698
"22830","73249","2015",16,5,11,244259.8,2714.75,87.9375
"22831","73250","2015",15,14,1,145629.7,2120.733,72.46667
"22832","73252","2015",1,1,0,1e+05,1429,70
"22833","73253","2015",4,4,0,135020.5,1368.75,139.25
"22834","73255","2015",4,4,0,95267.5,1212.75,81
"22835","73256","2015",5,4,1,166200,1453.8,99
"22836","73257","2015",331,17,314,144999.1,4128.773,33.45317
"22837","73258","2015",7,7,0,149785.7,1644.429,91.85714
"22838","73259","2015",4,4,0,199307.5,1286.25,145.75
"22839","73261","2015",20,14,6,108222,1338.55,85.45
"22840","73262","2015",10,2,8,85805,2381.5,32.2
"22841","73263","2015",11,10,1,275998.6,2667.909,105.7273
"22842","73265","2015",3,3,0,281066.7,3059.667,92
"22843","73267","2015",10,7,3,200286,2128.8,91.3
"22844","73268","2015",5,4,1,110900,1683.4,69
"22845","73269","2015",10,10,0,200897,2187.8,96.1
"22846","73270","2015",36,34,2,158305.1,2122.806,81.02778
"22847","73271","2015",3,3,0,268732.3,2173,124.6667
"22848","73272","2015",1,1,0,171200,1630,105
"22849","73273","2015",3,3,0,96333.33,1617.667,66.33333
"22850","73274","2015",7,7,0,202935.7,2090.571,99.71429
"22851","73275","2015",1,1,0,223900,2153,104
"22852","73276","2015",1,1,0,180000,1565,115
"22853","73278","2015",8,7,1,140038.1,1832.625,77.5
"22854","73280","2015",12,0,12,123704,3693.167,33.41667
"22855","73281","2015",3,3,0,291600,1585,182.6667
"22856","73282","2015",5,5,0,173180,1799.4,98.6
"22857","73283","2015",5,4,1,187634,2432.4,80.2
"22858","73284","2015",11,2,9,110645.4,1736.818,64.81818
"22859","73285","2015",26,5,21,193375.9,2371.769,89.42308
"22860","73286","2015",15,15,0,139182,1536.733,90.4
"22861","73288","2015",11,8,3,271143.5,2669.727,98
"22862","73289","2015",3,3,0,118933.7,1563,72.66667
"22863","73290","2015",37,5,32,118872.8,2838.919,45.02703
"22864","73292","2015",2,1,1,136100,1230.5,123
"22865","73293","2015",4,4,0,176962.5,2779.75,64.25
"22866","73294","2015",1,1,0,175000,1944,90
"22867","73296","2015",156,3,153,167338.7,4056.59,39
"22868","73297","2015",4,4,0,284075,2297.5,126.5
"22869","73298","2015",3,2,1,190183.3,2549.667,75.66667
"22870","73299","2015",2,2,0,209000,2613,80
"22871","73300","2015",43,21,22,322904.8,3251.814,96.44186
"22872","73301","2015",7,6,1,263263.1,2419.714,119.1429
"22873","73302","2015",2,2,0,118500,2421.5,46
"22874","73303","2015",34,19,15,138452.8,1982.088,71.05882
"22875","73304","2015",115,0,115,298660.3,6918.643,38.09565
"22876","73306","2015",49,1,48,165191.8,3901.367,43.10204
"22877","73307","2015",42,0,42,97589.69,2765.762,34.78571
"22878","73308","2015",8,7,1,167400,1936.5,89.625
"22879","73309","2015",2,2,0,120206.5,1307,101
"22880","73310","2015",3,3,0,236333.3,1968.333,110.6667
"22881","73311","2015",1,1,0,39345,984,40
"22882","73312","2015",5,5,0,173136,1763.4,99
"22883","73313","2015",3,3,0,78833.33,1185.333,67.66667
"22884","73314","2015",2,2,0,206100,2366,87
"22885","73315","2015",4,3,1,132765,1662,77.75
"22886","73316","2015",2,2,0,200350,1745.5,113.5
"22887","73317","2015",32,2,30,216016.6,3845.875,58.9375
"22888","73318","2015",68,2,66,55697.29,1924.088,27.17647
"22889","73320","2015",9,6,3,128111.1,1349.556,99.66667
"22890","73322","2015",35,2,33,99383.71,2475.657,43.85714
"22891","73323","2015",2,0,2,182250,1663,109.5
"22892","73326","2015",10,7,3,305366.6,2739.1,113.5
"22893","73327","2015",6,6,0,130142.5,1451.833,85.83333
"22894","73328","2015",27,19,8,407054,3260,124.8519
"22895","73329","2015",12,8,4,302632.9,2903.083,104.75
"22896","73330","2015",23,16,7,148573.9,1793.565,85.52174
"22897","74001","2015",36,10,26,147160.2,2862.389,54.97222
"22898","74002","2015",25,13,12,230181.6,2726.24,86.32
"22899","74003","2015",11,7,4,323188.2,3081.818,108.1818
"22900","74004","2015",5,5,0,252410,3654.2,73
"22901","74005","2015",36,31,5,341544.7,3306.722,106.6111
"22902","74006","2015",24,6,18,255743.5,3193.375,91
"22903","74007","2015",11,5,6,271375.4,3231.545,87.18182
"22904","74008","2015",63,16,47,258928.2,3558.556,72.77778
"22905","74009","2015",9,8,1,327059.7,3474,95.77778
"22906","74010","2015",1466,119,1347,249476.3,3625.148,69.26467
"22907","74012","2015",361,17,344,188858.2,2935.997,64.61219
"22908","74013","2015",18,10,8,593954.4,4718.167,122.7222
"22909","74014","2015",202,20,182,169458.7,3647.98,44.14851
"22910","74015","2015",8,8,0,292886.8,2336.5,127.5
"22911","74016","2015",32,16,16,408612.4,4395.938,95.03125
"22912","74018","2015",12,9,3,331404.2,3261,109.4167
"22913","74019","2015",32,10,22,341019.6,4187.094,84.84375
"22914","74020","2015",16,13,3,293361.9,2731.938,110.875
"22915","74021","2015",8,7,1,375125,2966.75,137
"22916","74024","2015",11,10,1,289415.5,2759.909,104.9091
"22917","74025","2015",13,12,1,334559.2,2877.308,123.4615
"22918","74026","2015",45,17,28,256585.2,3280.333,81.02222
"22919","74027","2015",2,1,1,108500,2056.5,69
"22920","74029","2015",2,2,0,216500,2892,76.5
"22921","74030","2015",3,3,0,180000,3106.333,57.66667
"22922","74031","2015",36,15,21,359549.9,3580,100.8056
"22923","74032","2015",20,6,14,112619.8,2122.4,58.65
"22924","74033","2015",32,11,21,169384.6,3002.156,57.90625
"22925","74034","2015",15,8,7,183031,2482.2,71.66667
"22926","74035","2015",7,7,0,233039.3,2523.143,92.42857
"22927","74036","2015",2,2,0,440000,6049,73
"22928","74037","2015",20,15,5,306459,2358.95,132.35
"22929","74038","2015",15,8,7,160860,2131.6,74.33333
"22930","74040","2015",33,14,19,273818.6,3438.727,84.42424
"22931","74041","2015",2,2,0,264500,2984.5,88
"22932","74042","2015",90,35,55,214653.1,2649.156,83.36667
"22933","74043","2015",59,34,25,285235.4,3346.424,86.44068
"22934","74044","2015",9,6,3,686752.8,4838.111,138.7778
"22935","74045","2015",4,4,0,254862.5,3710,76.5
"22936","74046","2015",2,2,0,191250,1621,144.5
"22937","74048","2015",5,5,0,297000,3072,99.8
"22938","74049","2015",7,7,0,136374.4,3076.857,43.14286
"22939","74050","2015",2,2,0,238750,2795.5,85
"22940","74051","2015",6,5,1,305455,2415.667,139
"22941","74052","2015",16,16,0,428631.2,3614.938,122.5
"22942","74053","2015",8,8,0,307100,2667,121.875
"22943","74054","2015",3,3,0,223366.7,1850.333,114
"22944","74055","2015",5,5,0,240120,2825.4,126.6
"22945","74056","2015",367,49,318,354214.3,6136.845,54.3951
"22946","74057","2015",8,7,1,353177.5,3061.5,119.5
"22947","74058","2015",34,9,25,257681.8,3596.765,67.14706
"22948","74059","2015",2,0,2,272000,2226,122.5
"22949","74061","2015",8,4,4,303392.2,3089,95.125
"22950","74062","2015",15,4,11,229402.7,2504.733,97.73333
"22951","74063","2015",93,15,78,221758.6,4250.645,48.86022
"22952","74064","2015",8,8,0,289150,3461.875,91
"22953","74065","2015",4,4,0,216737.5,1761.75,127.75
"22954","74066","2015",1,1,0,340630,3373,101
"22955","74068","2015",2,2,0,470000,2973.5,163.5
"22956","74069","2015",7,3,4,343467.1,3773.714,101.5714
"22957","74070","2015",33,21,12,556873.3,4379.455,115.6364
"22958","74072","2015",3,1,2,155205.7,1550.333,124.3333
"22959","74073","2015",10,10,0,205658.5,2317.1,88.1
"22960","74074","2015",4,3,1,312450,3014.5,102.5
"22961","74075","2015",12,12,0,249408.3,2561.917,103.1667
"22962","74076","2015",11,10,1,310431.8,3378.909,95.27273
"22963","74077","2015",7,6,1,311688.9,3204.429,105.1429
"22964","74078","2015",2,2,0,199950,3362.5,58
"22965","74079","2015",8,7,1,277597.5,2913.75,99.375
"22966","74080","2015",66,7,59,327403.5,6425.439,49.24242
"22967","74081","2015",165,18,147,139978.4,2005.788,70.1697
"22968","74082","2015",55,17,38,343139.2,3986.382,84.49091
"22969","74083","2015",66,21,45,453203.5,5163.833,73.57576
"22970","74085","2015",76,13,63,211863.3,3906.513,53.85526
"22971","74086","2015",2,2,0,487500,3949,125
"22972","74087","2015",18,14,4,300922.1,3252.167,92.72222
"22973","74088","2015",6,2,4,258666.7,3632.333,76.66667
"22974","74089","2015",13,4,9,376980.7,4003.462,91.07692
"22975","74090","2015",8,2,6,284319.1,3550.125,81.75
"22976","74091","2015",6,4,2,312039.7,3168.167,107.3333
"22977","74094","2015",56,48,8,379532.7,3743.607,109.5357
"22978","74095","2015",8,8,0,219336.2,2169.125,104.5
"22979","74096","2015",44,21,23,254315.9,3195.068,80.09091
"22980","74097","2015",12,11,1,253645,2451.833,105
"22981","74098","2015",23,16,7,382315.7,3872.696,102.8261
"22982","74099","2015",21,2,19,259307.6,5345.762,39.66667
"22983","74100","2015",7,7,0,364981,2474.429,158.8571
"22984","74101","2015",2,2,0,450000,3223.5,139
"22985","74102","2015",12,8,4,344197.9,3608.25,94.5
"22986","74103","2015",18,11,7,276158.3,3204.389,88.94444
"22987","74104","2015",35,20,15,298532.6,3260.714,93.94286
"22988","74105","2015",82,32,50,264779.6,3295.049,82.06098
"22989","74106","2015",5,5,0,326678,3196.2,105
"22990","74108","2015",12,4,8,436493.8,4147.25,99.41667
"22991","74109","2015",7,7,0,281214.3,2691.857,111.5714
"22992","74111","2015",4,4,0,171250,2163.5,75.25
"22993","74112","2015",99,24,75,282743.3,3636.859,77.62626
"22994","74114","2015",7,3,4,342755.7,4791.714,71.85714
"22995","74116","2015",19,15,4,380323.4,3166,124.0526
"22996","74118","2015",31,11,20,327974.6,4287.065,77.19355
"22997","74119","2015",152,25,127,257152.2,3442.145,72.05921
"22998","74121","2015",16,13,3,458773.4,3604.812,122.5625
"22999","74122","2015",7,7,0,320907.7,3257.429,109.4286
"23000","74123","2015",85,35,50,172417.5,2187.329,82.4
"23001","74124","2015",10,8,2,468600,3849.1,133.6
"23002","74126","2015",4,3,1,299700,3245.25,105.5
"23003","74127","2015",6,5,1,231273.8,2744.667,85
"23004","74128","2015",21,16,5,285153.3,2932.524,99.85714
"23005","74129","2015",1,1,0,288000,2400,120
"23006","74130","2015",3,3,0,162166.7,1477.667,99
"23007","74131","2015",15,12,3,220800.7,2906.6,76.6
"23008","74133","2015",148,14,134,163746.2,3037.52,53.25676
"23009","74134","2015",87,18,69,320621.6,5581.92,57.25287
"23010","74135","2015",5,3,2,196008,2684.4,73.2
"23011","74136","2015",114,10,104,214598.6,4660.456,46.05263
"23012","74137","2015",27,16,11,303197.6,3283.63,98.14815
"23013","74138","2015",18,9,9,277339.9,3432.111,82.27778
"23014","74139","2015",6,5,1,292591.7,2905,99.33333
"23015","74140","2015",46,16,30,156955,2713.348,58.69565
"23016","74141","2015",12,10,2,253037.5,2435.25,109.9167
"23017","74142","2015",12,11,1,252858.3,2422.417,102.5833
"23018","74143","2015",120,37,83,328074.2,5026.517,61.325
"23019","74144","2015",4,2,2,355430,3550.5,101.25
"23020","74145","2015",7,5,2,346505.7,3336.714,114.4286
"23021","74146","2015",5,5,0,343800,2982.8,126.2
"23022","74147","2015",14,9,5,288672.1,3244,93.71429
"23023","74148","2015",4,1,3,82007,1717.25,47.75
"23024","74150","2015",7,7,0,385235.7,3339,119.5714
"23025","74151","2015",6,6,0,187693.2,2017.667,101.3333
"23026","74152","2015",7,3,4,320908.6,3843.714,93.57143
"23027","74153","2015",16,9,7,294981.2,3448.125,89.6875
"23028","74154","2015",30,20,10,302474.8,3082.8,98.23333
"23029","74155","2015",6,2,4,177833.3,2408.667,74.33333
"23030","74156","2015",4,4,0,247234,2255.5,110.75
"23031","74157","2015",18,16,2,350770.6,3235.722,122.9444
"23032","74158","2015",11,6,5,253890.9,3351.455,75.63636
"23033","74159","2015",33,21,12,193578.7,2664.697,79
"23034","74160","2015",51,11,40,216503.3,4401.706,47.21569
"23035","74161","2015",13,13,0,234065.4,2493.538,103.7692
"23036","74162","2015",6,4,2,252650,2376,99.5
"23037","74163","2015",13,9,4,271587.1,3902.692,78.46154
"23038","74164","2015",46,27,19,222949,2631.891,86.19565
"23039","74165","2015",4,3,1,325664,3154.5,98
"23040","74166","2015",16,13,3,284356.4,2795.938,98.4375
"23041","74167","2015",7,6,1,177874.1,2309.571,84.57143
"23042","74168","2015",12,7,5,296566.7,2789.667,108.1667
"23043","74169","2015",36,16,20,185777.8,2052.417,97.61111
"23044","74170","2015",8,8,0,227353.8,2453.5,102.25
"23045","74171","2015",14,13,1,386736.3,4213.286,114.2857
"23046","74172","2015",20,17,3,305685,2938.85,102.45
"23047","74173","2015",145,23,122,558604.8,7593.572,69.5931
"23048","74174","2015",7,7,0,231311.4,2545,99.42857
"23049","74175","2015",9,3,6,120468.9,1732,70.88889
"23050","74176","2015",31,15,16,499131,4667.516,103
"23051","74177","2015",8,8,0,316627.5,3053.375,112.5
"23052","74178","2015",9,8,1,187416.7,1399.111,140.5556
"23053","74179","2015",6,4,2,256829.2,2232.333,127
"23054","74180","2015",20,15,5,517754.2,3915,129.9
"23055","74183","2015",24,17,7,234535.6,2808.083,86.29167
"23056","74184","2015",7,3,4,265057.1,2779.286,97.28571
"23057","74185","2015",13,10,3,346051.5,3197.769,110.6923
"23058","74186","2015",3,2,1,393023.3,3277,115.6667
"23059","74188","2015",21,11,10,385715.5,5044.476,69.57143
"23060","74189","2015",43,14,29,128927.1,2329.488,57.67442
"23061","74190","2015",67,10,57,155503.8,3341.134,47.37313
"23062","74191","2015",230,23,207,269926.6,5180.991,50.26522
"23063","74192","2015",14,13,1,239272.1,2435.143,107.0714
"23064","74193","2015",7,4,3,249764.3,2773.286,105.4286
"23065","74194","2015",4,3,1,341736.2,3078,111.5
"23066","74195","2015",2,2,0,337500,2303,149
"23067","74196","2015",6,6,0,159683.3,1775.167,95.66667
"23068","74197","2015",8,6,2,315019.1,3452.875,92.75
"23069","74198","2015",5,4,1,264360,2404,107.2
"23070","74199","2015",5,4,1,621130,5700.6,121
"23071","74200","2015",39,28,11,439505.5,3919.282,109.8974
"23072","74201","2015",13,8,5,435142.7,4312.462,107.7692
"23073","74202","2015",10,6,4,227640,2542.9,92.3
"23074","74205","2015",21,9,12,170564.3,2356.429,65.95238
"23075","74206","2015",11,9,2,278367.1,2845.091,97.27273
"23076","74208","2015",97,42,55,222585,2796.959,81.62887
"23077","74209","2015",11,11,0,318750,3188.455,99.81818
"23078","74210","2015",13,7,6,223240.8,2551.231,93.23077
"23079","74211","2015",25,22,3,351969.2,3285.32,116
"23080","74212","2015",15,13,2,156125.1,2151.133,76.33333
"23081","74213","2015",74,24,50,300784.9,3859.932,78.7973
"23082","74215","2015",64,5,59,202272.1,4176.891,43.1875
"23083","74216","2015",16,3,13,298762,4024.688,77.625
"23084","74218","2015",78,43,35,315880.9,3583.436,88.85897
"23085","74219","2015",8,5,3,395102,3582.625,120.375
"23086","74220","2015",76,26,50,277519.4,3227.895,86
"23087","74221","2015",2,1,1,258750,2024,125.5
"23088","74222","2015",3,1,2,241984.3,2436.333,107.3333
"23089","74223","2015",9,7,2,221978.9,2738.222,81.88889
"23090","74224","2015",136,37,99,228856.8,2864.779,79.39706
"23091","74225","2015",202,64,138,170836,2275.842,76.27723
"23092","74226","2015",5,5,0,268660,3048.2,89.8
"23093","74228","2015",4,3,1,423575,4288.5,98
"23094","74229","2015",35,19,16,263079.1,3477.971,79.05714
"23095","74231","2015",2,2,0,440450,3545,126
"23096","74232","2015",8,4,4,187587.5,2142.625,86
"23097","74233","2015",49,19,30,206669.4,2662.265,80.69388
"23098","74234","2015",7,5,2,106952.9,1718.714,67
"23099","74235","2015",3,3,0,355213.7,2957.667,120.3333
"23100","74236","2015",234,47,187,215414.8,3529.286,59.76923
"23101","74237","2015",18,7,11,179650,2550.833,70.44444
"23102","74238","2015",87,21,66,166649.3,3020.333,55.72414
"23103","74239","2015",35,12,23,243554.8,4007.171,58.45714
"23104","74240","2015",12,10,2,200177.4,2356.583,88.41667
"23105","74241","2015",41,14,27,158117.6,2342,67.04878
"23106","74242","2015",66,33,33,363465.2,3871.758,93.5
"23107","74243","2015",114,20,94,309518.9,3729.368,79.4386
"23108","74244","2015",4,3,1,235725,2464,92.25
"23109","74249","2015",30,22,8,268232.4,2812.933,95.46667
"23110","74250","2015",65,34,31,263582.9,3002.154,90.61538
"23111","74252","2015",4,4,0,267217.5,2991,90
"23112","74253","2015",10,10,0,252258.3,2935.6,91.1
"23113","74254","2015",7,6,1,315685,2758.857,122.2857
"23114","74255","2015",18,14,4,261847.2,2517.333,105.6111
"23115","74256","2015",226,35,191,198057.3,2803.602,71.29646
"23116","74257","2015",11,9,2,207522.8,2355.273,88
"23117","74258","2015",134,24,110,208349,3816.694,52.55224
"23118","74259","2015",2,2,0,287995,2259,121
"23119","74260","2015",4,3,1,211650,1979.5,110.25
"23120","74261","2015",6,6,0,270000,3130.167,91.83333
"23121","74262","2015",7,2,5,257907.1,2783.857,93.42857
"23122","74263","2015",76,49,27,354688.7,3532.105,95.92105
"23123","74264","2015",69,23,46,172884.8,2276.71,78.82609
"23124","74265","2015",5,5,0,258962,2524.8,100.8
"23125","74266","2015",16,9,7,336180.4,3924.188,92.1875
"23126","74267","2015",44,22,22,422291.9,4345.273,98.43182
"23127","74269","2015",27,17,10,158050.8,1994.111,86.88889
"23128","74271","2015",9,5,4,310333.3,2549.333,121.7778
"23129","74272","2015",38,19,19,253354.1,3158.105,82.23684
"23130","74273","2015",10,7,3,218418.3,2984.8,83.1
"23131","74275","2015",27,14,13,414608.4,4047.778,96.03704
"23132","74276","2015",82,17,65,151158.2,2733.537,57.5122
"23133","74278","2015",44,18,26,217698.8,2637.545,86.13636
"23134","74279","2015",54,13,41,122201.2,2608.5,45.64815
"23135","74280","2015",59,15,44,236491.2,3100.949,81.79661
"23136","74281","2015",445,76,369,203190.4,2909.384,69.54831
"23137","74282","2015",72,54,18,337199.1,3446.542,99.69444
"23138","74283","2015",15,14,1,283896.9,2291.333,126.4667
"23139","74284","2015",9,3,6,164916.7,2648.444,62.11111
"23140","74285","2015",3,2,1,85453.33,1320.667,68
"23141","74286","2015",10,7,3,290437.1,2537,103.3
"23142","74287","2015",6,3,3,192116.7,2137,97.16667
"23143","74288","2015",48,18,30,309006.6,3640.812,86.20833
"23144","74289","2015",15,12,3,235809.3,2499.133,97.73333
"23145","74290","2015",5,3,2,416202,4096.4,93.2
"23146","74291","2015",3,3,0,209333.3,1646,124.3333
"23147","74292","2015",4,4,0,305100,2711.75,115
"23148","74293","2015",47,37,10,501220.3,4466.128,117.4468
"23149","74294","2015",13,9,4,292150.7,3963.615,72.30769
"23150","74295","2015",2,2,0,217500,2829,80
"23151","74296","2015",8,4,4,313600,3732.875,88.25
"23152","74297","2015",3,1,2,207300,1981,106.3333
"23153","74298","2015",94,35,59,308934,3748.489,81.18085
"23154","74299","2015",30,15,15,575145.7,5957.4,97.43333
"23155","74301","2015",3,2,1,222000,4320,52
"23156","74302","2015",11,6,5,308424.4,3511.636,82.09091
"23157","74303","2015",41,19,22,300737.3,3622.732,82.97561
"23158","74304","2015",6,4,2,296210,4792.667,83.83333
"23159","74305","2015",76,30,46,274851,3608.803,75.38158
"23160","74306","2015",2,2,0,375700,2524.5,160.5
"23161","74307","2015",5,4,1,508380,4657.4,120.8
"23162","74308","2015",10,10,0,254076,3290.7,86.9
"23163","74309","2015",29,16,13,338177.4,3600.828,100.3793
"23164","74310","2015",11,9,2,323304.6,2790.091,115.4545
"23165","74311","2015",51,22,29,217179.7,2949.961,71.96078
"23166","74312","2015",8,6,2,214515,2177.75,95.875
"23167","74313","2015",9,9,0,237050,2363.111,104.3333
"23168","74314","2015",8,6,2,293227.5,3261.875,88.875
"23169","74315","2015",7,6,1,360914.3,3208.714,125
"23170","75056","2015",29553,121,29432,436988.9,8042.958,53.67739
"23171","76001","2015",8,8,0,113087.5,1286.875,88.875
"23172","76002","2015",5,5,0,147880,1711,88.6
"23173","76004","2015",3,3,0,172000,1640.667,105.3333
"23174","76005","2015",34,32,2,158702.9,1803,88.14706
"23175","76006","2015",1,1,0,195000,2600,75
"23176","76007","2015",9,9,0,182766.7,2026.667,94.66667
"23177","76008","2015",4,4,0,109000,1564.75,69.25
"23178","76009","2015",3,3,0,188200,1028.333,196.3333
"23179","76010","2015",4,4,0,98875,1359.75,71.5
"23180","76012","2015",3,3,0,157666.7,1325,112.3333
"23181","76013","2015",9,9,0,128500,1303.889,100.4444
"23182","76014","2015",16,15,1,160531.2,2053.75,84.3125
"23183","76016","2015",1,1,0,110000,2292,48
"23184","76017","2015",9,9,0,205388.9,1850.444,112.3333
"23185","76018","2015",11,11,0,126602,1326.364,99.45455
"23186","76019","2015",4,4,0,153900,1536.5,100.75
"23187","76020","2015",10,10,0,147903.5,1591.7,96.1
"23188","76021","2015",6,6,0,178275,1959,96
"23189","76022","2015",3,3,0,190943.3,1953.333,105.6667
"23190","76023","2015",1,1,0,36000,424,85
"23191","76024","2015",2,2,0,163750,1673.5,107
"23192","76025","2015",7,7,0,106714.3,2372.143,66.14286
"23193","76026","2015",21,18,3,108614.7,1409.333,83.04762
"23194","76028","2015",2,2,0,80750,1137.5,80
"23195","76029","2015",2,2,0,91000,1098.5,77
"23196","76030","2015",3,3,0,153500,1413.333,104.6667
"23197","76032","2015",3,3,0,145833.3,2204.667,65.66667
"23198","76033","2015",3,3,0,251523.3,1753,169.6667
"23199","76034","2015",14,14,0,121492.9,1447.143,84.57143
"23200","76035","2015",21,20,1,97766.67,1166.524,87.19048
"23201","76036","2015",7,7,0,166988.9,1834.714,90.71429
"23202","76038","2015",2,2,0,132025,1593.5,90
"23203","76039","2015",6,6,0,230225,1804,128.3333
"23204","76040","2015",1,1,0,138500,1399,99
"23205","76041","2015",8,8,0,162162.5,1602.375,105.125
"23206","76043","2015",3,3,0,211372.3,1835.333,122.3333
"23207","76045","2015",5,5,0,147800,1641.8,92.2
"23208","76046","2015",4,4,0,168500,1873,88
"23209","76047","2015",1,1,0,109950,1195,92
"23210","76048","2015",4,4,0,216577.5,1231.75,164.5
"23211","76049","2015",4,4,0,112731.2,1403.5,81.25
"23212","76050","2015",9,8,1,142494.8,1430,100.2222
"23213","76051","2015",11,11,0,133019.1,1329.455,101.0909
"23214","76054","2015",6,6,0,84945,1333.5,61.33333
"23215","76055","2015",2,2,0,99000,1385,76
"23216","76056","2015",6,6,0,152333.3,1557.667,99.16667
"23217","76057","2015",104,99,5,158351,1683.769,94.89423
"23218","76058","2015",2,2,0,81500,1385.5,61
"23219","76059","2015",1,1,0,130000,1161,112
"23220","76062","2015",3,3,0,133166.7,1665.333,77.66667
"23221","76063","2015",4,4,0,183437.5,1679.5,110.5
"23222","76064","2015",5,5,0,180400,1471.2,132.2
"23223","76065","2015",4,4,0,121250,1331.5,88.75
"23224","76066","2015",4,4,0,180997.5,1508.5,131.5
"23225","76067","2015",9,9,0,115333.3,1532.333,93.11111
"23226","76068","2015",9,9,0,134622.2,1409.222,99.55556
"23227","76069","2015",21,21,0,242776.7,2283.571,112.9524
"23228","76070","2015",3,3,0,107833.3,1042,113.3333
"23229","76071","2015",2,2,0,100850,1246.5,82.5
"23230","76072","2015",7,7,0,150247.9,1669.571,96.14286
"23231","76075","2015",7,7,0,140264.3,1448.571,111.2857
"23232","76076","2015",2,2,0,138500,1340,106.5
"23233","76079","2015",4,4,0,159000,1779.75,95
"23234","76082","2015",7,7,0,158342.9,1562.143,109.2857
"23235","76083","2015",1,1,0,140000,1573,89
"23236","76084","2015",2,2,0,73500,888,81
"23237","76085","2015",5,5,0,122400,1672.6,80.4
"23238","76087","2015",5,5,0,158300,1489.8,122.2
"23239","76088","2015",7,7,0,149750,1422.143,109.7143
"23240","76090","2015",9,9,0,153911.1,1589.667,94.55556
"23241","76091","2015",2,2,0,181750,1105,155
"23242","76092","2015",2,2,0,142500,1847,77.5
"23243","76093","2015",7,7,0,120714.3,1502.429,80.42857
"23244","76094","2015",5,5,0,157600,1679.2,106.8
"23245","76095","2015",105,75,30,214079.8,2198.781,97.5619
"23246","76096","2015",8,8,0,137175,1749.375,83.75
"23247","76099","2015",9,9,0,180766.7,1603,113.3333
"23248","76100","2015",11,11,0,186818.2,1777.818,106.6364
"23249","76101","2015",15,15,0,115831,1358.533,87.86667
"23250","76103","2015",99,45,54,167971.6,2036.101,83.71717
"23251","76104","2015",3,3,0,244916.7,2350,109
"23252","76105","2015",3,3,0,171133.3,1753.333,100.6667
"23253","76106","2015",5,5,0,299400,1898.4,160.4
"23254","76107","2015",3,3,0,173500,2394.667,83.33333
"23255","76108","2015",204,135,69,269132.3,2550.412,103.9804
"23256","76110","2015",3,3,0,153000,1551.667,97.33333
"23257","76111","2015",8,8,0,182303.8,1635.625,117.375
"23258","76112","2015",3,3,0,243000,1416,163.6667
"23259","76113","2015",3,3,0,162800,1685.333,98
"23260","76114","2015",119,95,24,97183.93,1342.824,74.41176
"23261","76115","2015",3,3,0,136000,1264.667,115
"23262","76116","2015",29,29,0,215093.8,1998.379,110.2759
"23263","76117","2015",4,4,0,154750,1718.25,103.5
"23264","76118","2015",2,2,0,155950,2251.5,65.5
"23265","76119","2015",2,2,0,67500,1026.5,66
"23266","76120","2015",4,4,0,189600,1604.75,120.75
"23267","76121","2015",4,4,0,112350,1276,96.25
"23268","76122","2015",1,1,0,110000,1146,96
"23269","76123","2015",10,10,0,243840,1757.3,135.9
"23270","76124","2015",2,2,0,116500,1112.5,114.5
"23271","76125","2015",9,9,0,128300,1654.333,82.66667
"23272","76126","2015",3,3,0,120000,1392.333,78.33333
"23273","76128","2015",4,4,0,134750,1185.25,115.25
"23274","76129","2015",1,1,0,131000,1472,89
"23275","76130","2015",2,2,0,82500,1213.5,73
"23276","76131","2015",9,7,2,205005.1,2421.111,104
"23277","76132","2015",1,1,0,169000,1470,115
"23278","76133","2015",3,3,0,161666.7,1217.333,127
"23279","76134","2015",4,4,0,168875,1748.5,107
"23280","76135","2015",7,7,0,186357.1,1955.429,98.57143
"23281","76136","2015",4,4,0,127769.5,1271,102.25
"23282","76138","2015",3,3,0,85333.33,925.6667,109
"23283","76139","2015",2,2,0,171375,1367.5,126.5
"23284","76141","2015",8,8,0,165146.2,2025.25,94
"23285","76142","2015",3,3,0,115828.7,1326,88.66667
"23286","76143","2015",16,16,0,150321.9,1621.5,96.0625
"23287","76144","2015",3,3,0,133500,1310.333,102
"23288","76146","2015",24,22,2,147020.8,1640.792,94.41667
"23289","76147","2015",6,6,0,141000,1497.667,102.3333
"23290","76148","2015",2,2,0,132807.5,1628,82
"23291","76149","2015",4,4,0,166025,1608.25,106.5
"23292","76151","2015",3,3,0,139666.7,1396.333,106.6667
"23293","76152","2015",5,5,0,168400,1732.4,96.2
"23294","76153","2015",5,5,0,114600,1050.2,104.6
"23295","76154","2015",4,4,0,77800,999,74.25
"23296","76155","2015",1,1,0,81000,711,114
"23297","76156","2015",5,5,0,151940,1812.6,88.2
"23298","76157","2015",59,41,18,162486.4,1873.034,89.49153
"23299","76158","2015",1,1,0,175000,1048,167
"23300","76159","2015",19,18,1,109592.8,1278.158,83.84211
"23301","76160","2015",2,2,0,243500,2019.5,123
"23302","76162","2015",2,2,0,148000,1306.5,114.5
"23303","76163","2015",6,6,0,136516.7,1366.333,104.8333
"23304","76164","2015",38,32,6,143412.6,1619.211,91.73684
"23305","76165","2015",67,56,11,125087.3,1560.284,84.13433
"23306","76166","2015",5,5,0,99200,1055.2,98.6
"23307","76167","2015",14,14,0,240825.7,2118.429,115.9286
"23308","76169","2015",8,8,0,214812.5,1906,110.75
"23309","76170","2015",1,1,0,123000,1519,81
"23310","76171","2015",1,1,0,158650,1220,130
"23311","76172","2015",2,2,0,204600,1537.5,132.5
"23312","76173","2015",3,3,0,105833.3,1583.333,68.33333
"23313","76174","2015",2,2,0,268500,1712,167.5
"23314","76175","2015",3,3,0,1e+05,1391,70.66667
"23315","76176","2015",2,2,0,120000,1727.5,70.5
"23316","76177","2015",2,2,0,212500,1774.5,124
"23317","76178","2015",29,28,1,149342.9,1893.448,84.24138
"23318","76179","2015",11,10,1,144745.5,1673.091,89.18182
"23319","76181","2015",1,1,0,150000,1786,84
"23320","76182","2015",3,3,0,145113.3,1768.667,112.6667
"23321","76183","2015",6,6,0,162583.3,1613.333,96.33333
"23322","76184","2015",2,2,0,62500,940.5,66.5
"23323","76185","2015",1,1,0,180000,1800,100
"23324","76186","2015",5,5,0,118200,1562.2,76.8
"23325","76188","2015",6,6,0,150351.3,1945,79.83333
"23326","76189","2015",3,3,0,61333.33,1181.667,54.33333
"23327","76190","2015",1,1,0,247900,3099,80
"23328","76192","2015",70,60,10,130690.1,1960.843,73.71429
"23329","76193","2015",4,4,0,160500,1737.5,101.25
"23330","76194","2015",1,1,0,275000,1950,141
"23331","76196","2015",28,27,1,181692.9,2156.393,88.07143
"23332","76197","2015",2,2,0,115000,1394,83
"23333","76198","2015",9,9,0,140777.8,1457.556,96.33333
"23334","76199","2015",9,9,0,109833.3,1372.333,87.55556
"23335","76200","2015",3,3,0,154833.3,1781.667,87.66667
"23336","76201","2015",6,6,0,142649.2,2005.333,80.33333
"23337","76202","2015",3,3,0,100516.7,1291.667,76.33333
"23338","76203","2015",7,7,0,163475.4,1474.286,111.2857
"23339","76205","2015",2,2,0,121500,1078,112
"23340","76206","2015",3,3,0,184500,1808.333,103.6667
"23341","76207","2015",1,1,0,155000,1157,134
"23342","76208","2015",7,7,0,193274.3,1939.571,98
"23343","76209","2015",4,4,0,160652.5,1782.5,89.25
"23344","76210","2015",2,2,0,129500,920,136.5
"23345","76211","2015",4,4,0,100700,1158.25,102.25
"23346","76212","2015",88,67,21,123909.2,1728.443,73.69318
"23347","76213","2015",2,2,0,120000,1845.5,69.5
"23348","76214","2015",2,2,0,152650,1258,121
"23349","76216","2015",125,83,42,125605.2,1687.704,75.8
"23350","76217","2015",337,152,185,125160.7,1831.647,69.46884
"23351","76218","2015",1,1,0,1e+05,735,136
"23352","76219","2015",22,20,2,144438,1585.227,92.22727
"23353","76220","2015",6,6,0,122483.3,1274,98.5
"23354","76221","2015",3,3,0,138106.7,1352.333,108
"23355","76222","2015",48,46,2,148238.5,1666.083,91.75
"23356","76223","2015",2,2,0,159600,2029,78.5
"23357","76224","2015",10,10,0,164000,1667.1,106.9
"23358","76225","2015",2,2,0,167500,3108.5,55
"23359","76226","2015",2,2,0,139500,2295.5,63.5
"23360","76227","2015",9,9,0,154433.3,1447.556,105.3333
"23361","76228","2015",5,5,0,109300,1376.8,80.2
"23362","76229","2015",6,6,0,175750,1883.5,100.5
"23363","76230","2015",5,5,0,152020,1599,100.8
"23364","76231","2015",101,50,51,114932.5,1387.347,84.94059
"23365","76232","2015",10,10,0,142900,1559.8,96.4
"23366","76233","2015",1,1,0,210000,2000,105
"23367","76234","2015",3,3,0,124300,1465,84
"23368","76235","2015",12,12,0,116354.2,1555.417,77.41667
"23369","76236","2015",2,2,0,164100,1198.5,131.5
"23370","76237","2015",3,3,0,157333.3,1296.667,130
"23371","76238","2015",20,20,0,202992.5,1913.95,108.7
"23372","76239","2015",6,6,0,230718.8,1819.333,126.1667
"23373","76240","2015",9,8,1,162051.3,1575.222,105.1111
"23374","76242","2015",2,2,0,210500,2684.5,89.5
"23375","76243","2015",1,1,0,112000,1898,59
"23376","76244","2015",7,7,0,114914.3,1505.714,73.42857
"23377","76245","2015",12,12,0,185416.7,1797.5,106.5
"23378","76247","2015",6,6,0,180741.7,1691.167,112.8333
"23379","76249","2015",8,8,0,174600,1409.125,122.125
"23380","76250","2015",7,7,0,203728.6,1943.143,106.7143
"23381","76251","2015",4,4,0,118000,1210.25,101
"23382","76252","2015",8,8,0,157737.5,1337.375,116.25
"23383","76253","2015",13,13,0,168747.7,1644.846,106.4615
"23384","76254","2015",36,23,13,197278.3,2329.75,88
"23385","76255","2015",92,69,23,125186,1462.043,83.41304
"23386","76257","2015",1,1,0,95000,812,117
"23387","76258","2015",40,35,5,140587.5,1535.325,99.15
"23388","76259","2015",191,143,48,125970,1624.613,79.00524
"23389","76260","2015",10,10,0,117051.7,1695.2,70.5
"23390","76261","2015",1,1,0,83000,1277,65
"23391","76262","2015",1,1,0,115000,1223,94
"23392","76263","2015",7,7,0,154201.4,1415.286,128.8571
"23393","76264","2015",3,3,0,171366.7,1731.667,101.3333
"23394","76265","2015",1,1,0,40000,435,92
"23395","76266","2015",9,9,0,128922.2,1461.222,95.44444
"23396","76269","2015",3,3,0,90333.33,1284.667,65
"23397","76270","2015",31,31,0,265621,2242.419,121.0645
"23398","76271","2015",15,15,0,171212,1567.2,113.3333
"23399","76272","2015",13,12,1,116769.2,1366.923,85.53846
"23400","76273","2015",3,3,0,188000,1818.333,109.3333
"23401","76274","2015",1,1,0,181107,1617,112
"23402","76275","2015",11,11,0,207200,1782.818,120.5455
"23403","76276","2015",41,38,3,108043.9,1336.902,85.04878
"23404","76278","2015",4,4,0,104375,1042,109.25
"23405","76279","2015",1,1,0,157790,1052,150
"23406","76280","2015",3,3,0,175533.3,1918.333,85.66667
"23407","76281","2015",14,14,0,171728.6,1786,97.92857
"23408","76282","2015",10,10,0,149452,1702.3,89.9
"23409","76283","2015",2,2,0,164800,1656.5,107
"23410","76284","2015",1,1,0,106000,1536,69
"23411","76285","2015",4,4,0,179800,1926.5,93.5
"23412","76286","2015",13,13,0,105002.3,1216,94.38462
"23413","76287","2015",13,13,0,214241.9,1748.615,127.3077
"23414","76288","2015",11,11,0,132375,1465.455,88.27273
"23415","76289","2015",12,11,1,173633.3,1624.25,110.4167
"23416","76290","2015",2,2,0,144700,1491.5,96.5
"23417","76291","2015",14,14,0,146632.1,1535.571,102.3571
"23418","76292","2015",2,2,0,119500,1968.5,84.5
"23419","76293","2015",3,3,0,143000,1658.667,93.33333
"23420","76295","2015",12,12,0,121450,1330.25,94.25
"23421","76296","2015",26,25,1,189151.9,1832.923,106.8846
"23422","76297","2015",3,3,0,198666.7,2098,94.66667
"23423","76298","2015",5,5,0,174340,2194.6,86
"23424","76299","2015",4,4,0,125587.5,1541.25,76
"23425","76300","2015",2,2,0,137500,1325.5,104
"23426","76302","2015",20,17,3,157284.1,1998.1,83.75
"23427","76303","2015",6,6,0,182420,1933.833,96.83333
"23428","76304","2015",3,3,0,156500,1692,95.33333
"23429","76305","2015",49,46,3,141011,1841.122,83.28571
"23430","76306","2015",5,5,0,189870,1758,111.6
"23431","76307","2015",7,6,1,165742.9,2045.429,83.85714
"23432","76308","2015",3,3,0,185366.7,1790,103.3333
"23433","76309","2015",1,1,0,220000,1202,183
"23434","76311","2015",5,5,0,141400,1369.4,107.6
"23435","76312","2015",53,47,6,126590.8,1383.792,93.49057
"23436","76313","2015",8,7,1,166075,2099,84.125
"23437","76314","2015",5,5,0,131500,1543,87.4
"23438","76315","2015",12,12,0,180308.3,1460.667,125.0833
"23439","76316","2015",3,3,0,167466.7,1481.667,117.3333
"23440","76317","2015",3,3,0,429800,5728,91
"23441","76318","2015",3,3,0,218333.3,2046.333,108.3333
"23442","76319","2015",72,72,0,157861.8,1830.889,88.94444
"23443","76320","2015",5,5,0,91200,1395.8,63.6
"23444","76321","2015",9,9,0,148833.3,1844,89
"23445","76322","2015",154,109,45,167185.7,2036.909,82.57143
"23446","76324","2015",3,3,0,152000,1628.333,99.33333
"23447","76327","2015",5,5,0,166300,1444.8,121.8
"23448","76328","2015",3,3,0,158000,1770.333,92.33333
"23449","76329","2015",26,23,3,145674.8,1692.846,87.46154
"23450","76330","2015",8,8,0,166237.5,1629,122.25
"23451","76331","2015",1,1,0,206000,1304,158
"23452","76332","2015",6,6,0,145850,1913.333,90.33333
"23453","76333","2015",2,2,0,150000,2143,70
"23454","76334","2015",7,7,0,138735.7,1370.286,96.57143
"23455","76335","2015",1,1,0,95000,1583,60
"23456","76336","2015",7,7,0,154857.1,1720.429,94.14286
"23457","76339","2015",2,2,0,175913,1343,131
"23458","76340","2015",3,3,0,131966.7,1467.333,91.66667
"23459","76341","2015",54,45,9,136050.6,1827.722,76.46296
"23460","76342","2015",7,7,0,126428.6,1471.429,92.71429
"23461","76343","2015",3,3,0,105333.3,1288,94.33333
"23462","76344","2015",4,4,0,65926.5,991,65.5
"23463","76345","2015",1,1,0,98000,1101,89
"23464","76346","2015",3,3,0,171233.3,1226.333,140
"23465","76347","2015",3,3,0,156000,2275.667,73.66667
"23466","76348","2015",4,4,0,150925,1294,118
"23467","76349","2015",19,18,1,156668.4,1906.789,80.31579
"23468","76350","2015",2,2,0,131375,1539.5,87
"23469","76351","2015",1900,802,1098,137538.1,1898.295,72.5
"23470","76352","2015",3,3,0,164000,1561,105
"23471","76353","2015",1,1,0,58000,1611,36
"23472","76354","2015",9,9,0,218848.9,1845.222,124.6667
"23473","76355","2015",4,4,0,122250,1193.5,112.75
"23474","76357","2015",3,3,0,188333.3,1876,98.66667
"23475","76358","2015",2,2,0,107500,2687.5,40
"23476","76359","2015",1,1,0,275000,2434,113
"23477","76360","2015",4,3,1,119350,1977.5,63.25
"23478","76361","2015",8,8,0,186125,1906.125,103.125
"23479","76362","2015",1,1,0,2e+05,1429,140
"23480","76363","2015",5,5,0,112700,1436.2,88.2
"23481","76364","2015",4,4,0,143500,1727,104.25
"23482","76366","2015",34,34,0,133400,1723.735,84.08824
"23483","76367","2015",23,23,0,214657.3,2095.913,107.1304
"23484","76368","2015",3,3,0,216500,2392.333,93.66667
"23485","76369","2015",2,2,0,105750,1525.5,69
"23486","76370","2015",6,6,0,173154.2,1448.5,122
"23487","76371","2015",1,1,0,90000,1059,85
"23488","76372","2015",1,1,0,73500,735,100
"23489","76373","2015",4,4,0,100775,1035.5,94.5
"23490","76374","2015",11,11,0,91618.18,1360.909,67.81818
"23491","76375","2015",2,2,0,138750,1389.5,99.5
"23492","76377","2015",32,31,1,261022.9,2159.156,119.75
"23493","76378","2015",14,14,0,161392.9,1633.786,101.5714
"23494","76379","2015",3,3,0,96333.33,1074.333,90.66667
"23495","76380","2015",3,3,0,115033.3,1325,97.33333
"23496","76381","2015",1,1,0,119626,1595,75
"23497","76382","2015",13,13,0,149869.2,1728.077,88.23077
"23498","76383","2015",1,1,0,216910,1808,120
"23499","76384","2015",78,69,9,116745,1512,78.14103
"23500","76385","2015",7,7,0,160857.1,1574.429,104.7143
"23501","76386","2015",6,6,0,129833.3,1445.167,92
"23502","76387","2015",2,2,0,184500,1369.5,135
"23503","76388","2015",2,2,0,104750,2028,53.5
"23504","76389","2015",1,1,0,120000,1765,68
"23505","76390","2015",10,10,0,129530,1409.4,90.2
"23506","76391","2015",20,20,0,206810,1859.75,111.75
"23507","76392","2015",13,12,1,94261.54,1114.308,87.38462
"23508","76393","2015",1,1,0,294500,1280,230
"23509","76394","2015",6,6,0,146933.3,1609.833,91.33333
"23510","76395","2015",7,7,0,141264.3,1426.286,99.14286
"23511","76396","2015",3,3,0,101000,985,108.6667
"23512","76397","2015",5,4,1,177360,1444.2,127.2
"23513","76398","2015",7,7,0,150857.1,1427.143,106.1429
"23514","76399","2015",2,2,0,1e+05,1362,75
"23515","76400","2015",15,15,0,136796.7,1864.8,80.33333
"23516","76401","2015",30,30,0,133773.3,1437.4,94.3
"23517","76402","2015",53,51,2,161160,1757.943,93.15094
"23518","76403","2015",5,5,0,163480,1224.8,151.2
"23519","76404","2015",9,9,0,193055.6,1802.111,107.7778
"23520","76405","2015",2,2,0,114150,2113.5,58.5
"23521","76406","2015",3,3,0,161666.7,1384,120.6667
"23522","76407","2015",3,3,0,140733.3,1254,110.3333
"23523","76408","2015",12,12,0,161945.8,1756.25,103.8333
"23524","76409","2015",13,13,0,180972.1,2073.769,90.07692
"23525","76410","2015",99,56,43,118523.6,1614.778,75.53535
"23526","76411","2015",4,4,0,175500,1908.75,106.75
"23527","76412","2015",3,3,0,154466.7,1164.667,136.6667
"23528","76413","2015",4,4,0,141362.5,1502.25,98.25
"23529","76414","2015",12,12,0,176283.3,1764.667,102
"23530","76415","2015",4,4,0,191500,1222.75,142.25
"23531","76416","2015",2,2,0,175850,1483,126.5
"23532","76417","2015",2,2,0,149500,1222,122
"23533","76418","2015",7,7,0,121671.4,1735.714,74.42857
"23534","76419","2015",3,3,0,132288.7,1498.667,93
"23535","76420","2015",11,11,0,146045.5,1403.909,105.4545
"23536","76421","2015",11,11,0,168809.1,1477.545,118.5455
"23537","76422","2015",3,3,0,172366.7,1417.667,140.3333
"23538","76424","2015",4,4,0,132125,1306.25,95
"23539","76426","2015",1,1,0,120000,1667,72
"23540","76427","2015",4,4,0,88100,1141,75
"23541","76428","2015",4,4,0,149325,1485.5,105.75
"23542","76429","2015",88,77,11,230621.8,2226.102,105.875
"23543","76430","2015",1,1,0,96000,1231,78
"23544","76432","2015",2,2,0,160000,1260.5,125.5
"23545","76433","2015",12,12,0,167504.2,1288.333,137
"23546","76434","2015",7,7,0,198680,1423.857,139.2857
"23547","76435","2015",6,6,0,105696.5,1393.667,73
"23548","76437","2015",8,8,0,120950,1199,99.25
"23549","76438","2015",1,1,0,110000,909,121
"23550","76439","2015",3,3,0,178266.7,1828.333,96.33333
"23551","76440","2015",1,1,0,115000,2347,49
"23552","76441","2015",3,3,0,73341.33,1033,67.66667
"23553","76443","2015",10,10,0,154800,1790.5,95.5
"23554","76445","2015",4,4,0,115250,1283.25,89.75
"23555","76446","2015",14,14,0,236525,2226.071,112.9286
"23556","76447","2015",178,137,41,181275.2,2033.253,91.24719
"23557","76448","2015",11,11,0,193954.5,2018.182,96.54545
"23558","76449","2015",6,6,0,152333.3,1521.667,98.33333
"23559","76450","2015",7,7,0,134221.4,1898.286,78.28571
"23560","76451","2015",273,110,163,213797.3,2207.183,94.14652
"23561","76452","2015",53,50,3,155854.3,1696.151,90.39623
"23562","76453","2015",6,6,0,168383.3,1646.5,104.8333
"23563","76455","2015",4,4,0,109575,1578.25,69.5
"23564","76456","2015",7,7,0,107142.9,1373.286,79.71429
"23565","76457","2015",9,7,2,118144.4,1431,85.33333
"23566","76458","2015",1,1,0,305930,2970,103
"23567","76459","2015",4,4,0,155964,1211.5,144.25
"23568","76460","2015",6,6,0,58000,884.8333,73.16667
"23569","76461","2015",5,5,0,117940,1344,82.8
"23570","76462","2015",37,34,3,129551.4,1562.703,88.75676
"23571","76463","2015",6,6,0,133241.7,2630.333,79.83333
"23572","76464","2015",25,25,0,198646.1,1854.36,108.84
"23573","76465","2015",6,6,0,131650,1558.167,83.66667
"23574","76467","2015",10,10,0,157834.7,1618.9,94.2
"23575","76468","2015",10,10,0,116750,1414.8,81.7
"23576","76469","2015",5,5,0,97100,1204.4,84.4
"23577","76470","2015",7,7,0,201307.1,1757.143,113.1429
"23578","76471","2015",10,10,0,136150,1571.5,89.7
"23579","76472","2015",5,5,0,107500,1535,67
"23580","76473","2015",9,9,0,138066.7,1635.111,86.33333
"23581","76474","2015",56,50,6,159941.7,1858.107,89.76786
"23582","76475","2015",60,51,9,220737.1,2181.35,106.25
"23583","76476","2015",91,85,6,132416.9,1458.231,92.57143
"23584","76477","2015",7,7,0,213357.1,1944.571,117.1429
"23585","76478","2015",2,2,0,132750,2157,70
"23586","76480","2015",2,2,0,98000,1314,80
"23587","76481","2015",62,58,4,297436.5,2335.548,129.4677
"23588","76482","2015",20,20,0,170172.5,1617.55,101.45
"23589","76483","2015",3,3,0,105666.7,1295,69
"23590","76484","2015",88,88,0,138354.5,1709.386,83.29545
"23591","76485","2015",3,3,0,138966.7,1182.667,119.3333
"23592","76486","2015",8,8,0,87562.5,1012.875,84.375
"23593","76487","2015",5,5,0,127768,1465.6,90.8
"23594","76488","2015",4,4,0,115750,1276.75,90.75
"23595","76489","2015",4,4,0,164360,1561.25,104.75
"23596","76490","2015",13,13,0,153136.5,1391.615,112.3077
"23597","76491","2015",1,1,0,115000,1769,65
"23598","76492","2015",7,7,0,118714.3,1620.571,79.14286
"23599","76494","2015",8,8,0,190887.5,1869.625,115.125
"23600","76495","2015",55,51,4,147025.9,1667.182,89.78182
"23601","76497","2015",52,42,10,156789.2,1757.212,89.71154
"23602","76498","2015",226,166,60,123473.9,1708.531,72.81858
"23603","76499","2015",11,11,0,168665.5,1876.636,91.45455
"23604","76500","2015",5,5,0,99520,1250.6,83
"23605","76501","2015",2,2,0,117500,1261.5,92.5
"23606","76502","2015",6,6,0,170360.7,1238.5,141.6667
"23607","76503","2015",10,10,0,221065.1,1770,127.7
"23608","76506","2015",2,2,0,70000,807,88
"23609","76507","2015",5,5,0,84200,1513.2,56.4
"23610","76508","2015",10,10,0,179800,2513.3,77.6
"23611","76509","2015",19,19,0,181100,1862.842,98.52632
"23612","76510","2015",2,2,0,126500,1499.5,81.5
"23613","76511","2015",2,2,0,82500,1010.5,82.5
"23614","76513","2015",9,9,0,289277.8,1931.111,152.1111
"23615","76514","2015",9,8,1,176666.7,1920.778,94.11111
"23616","76515","2015",14,14,0,193392.9,2251.857,87.78571
"23617","76516","2015",2,2,0,255500,1463,170.5
"23618","76517","2015",16,16,0,266734.4,1986.688,136.875
"23619","76518","2015",3,3,0,170000,1168.667,147
"23620","76519","2015",2,2,0,210000,1870.5,112.5
"23621","76520","2015",4,4,0,107950,1193.5,104
"23622","76521","2015",2,2,0,136750,1834,75
"23623","76522","2015",15,15,0,166080.4,1655.133,101.8667
"23624","76523","2015",2,2,0,58500,662.5,105
"23625","76526","2015",4,4,0,107750,1325.5,79.5
"23626","76527","2015",5,5,0,98400,1247.6,80.4
"23627","76528","2015",3,3,0,107666.7,1474.333,73.33333
"23628","76529","2015",2,2,0,119500,2346,50
"23629","76530","2015",1,1,0,146000,1521,96
"23630","76531","2015",4,4,0,117625,1153.25,110.25
"23631","76532","2015",9,9,0,139666.7,1528.333,96.88889
"23632","76533","2015",12,12,0,201525,2032,103.1667
"23633","76534","2015",12,11,1,176708.3,2164.75,92.25
"23634","76535","2015",2,2,0,138500,3576.5,44.5
"23635","76536","2015",14,14,0,208698.6,1705.786,122.0714
"23636","76537","2015",1,1,0,57000,1140,50
"23637","76538","2015",4,4,0,168250,2079.25,82.5
"23638","76540","2015",1802,331,1471,130090.5,2206.223,61.14484
"23639","76541","2015",11,11,0,212136.4,1738.636,129.0909
"23640","76542","2015",2,2,0,112750,1400,79.5
"23641","76543","2015",5,5,0,157100,1579.2,102.8
"23642","76544","2015",3,3,0,118886.7,1497.667,78.66667
"23643","76545","2015",16,15,1,149348.1,1696.188,90.125
"23644","76546","2015",1,1,0,156000,1209,129
"23645","76547","2015",8,8,0,233925,2002.375,124.875
"23646","76548","2015",4,4,0,174050,1538.5,112.25
"23647","76549","2015",3,3,0,216616.7,1560.333,138
"23648","76550","2015",6,6,0,145500,1750,86.66667
"23649","76551","2015",8,8,0,176912.5,1866.5,91.5
"23650","76552","2015",125,76,49,260128.1,2691.896,96.8
"23651","76554","2015",3,3,0,144000,1488.667,96
"23652","76555","2015",8,8,0,168187.5,1482.25,117.625
"23653","76556","2015",15,15,0,181008,1687.4,107.4
"23654","76557","2015",15,15,0,161890,1717.8,98.8
"23655","76558","2015",11,11,0,208044.1,1974.636,106.8182
"23656","76559","2015",5,5,0,157200,1619.8,97.4
"23657","76560","2015",9,9,0,168277.8,1753.667,95.22222
"23658","76561","2015",87,65,22,117413.2,1509.494,81.95402
"23659","76562","2015",11,11,0,149818.2,1595.364,99.27273
"23660","76563","2015",9,9,0,178986.4,1715.667,107.1111
"23661","76564","2015",3,3,0,183660,2146.667,96
"23662","76565","2015",14,14,0,179989.3,1790.5,98.35714
"23663","76566","2015",2,2,0,200500,1916.5,105.5
"23664","76567","2015",3,3,0,124633.3,1224,104.3333
"23665","76568","2015",6,6,0,210155,1816.333,115.3333
"23666","76570","2015",1,1,0,120000,1395,86
"23667","76571","2015",8,8,0,192499.4,1488.875,125.875
"23668","76572","2015",2,2,0,82700,1568.5,60.5
"23669","76573","2015",11,11,0,189668.2,1677.909,123.0909
"23670","76574","2015",7,7,0,182714.3,1483.857,124.8571
"23671","76575","2015",238,200,38,141752.3,1718.256,82.41176
"23672","76576","2015",9,9,0,116044.4,1731,67
"23673","76577","2015",5,5,0,92460,1080,84.8
"23674","76578","2015",2,2,0,88000,869.5,104
"23675","76580","2015",7,7,0,181142.9,1500,122.5714
"23676","76581","2015",4,4,0,179000,1305.5,141.75
"23677","76582","2015",2,2,0,113700,1594.5,71.5
"23678","76583","2015",3,3,0,176000,1844,95.66667
"23679","76584","2015",2,2,0,105000,1220.5,87
"23680","76585","2015",5,5,0,191800,1863.2,105
"23681","76586","2015",5,5,0,188600,2036.6,93
"23682","76587","2015",5,5,0,152960,1437.8,107.8
"23683","76588","2015",4,4,0,112850,1642.75,70.5
"23684","76590","2015",3,3,0,122166.7,1260.667,97.66667
"23685","76591","2015",24,24,0,230531.8,1907.125,123.3333
"23686","76592","2015",8,8,0,159000,1902,94.625
"23687","76593","2015",3,3,0,258666.7,2288.667,116.6667
"23688","76594","2015",6,6,0,169333.3,1635.667,109.3333
"23689","76595","2015",22,22,0,215720.5,1936,117.1364
"23690","76596","2015",19,19,0,191573.7,1890.158,111.6842
"23691","76597","2015",10,10,0,112545.4,1024.6,110.3
"23692","76598","2015",5,5,0,105500,1265.4,79.2
"23693","76599","2015",28,28,0,163197.9,2044.857,80.5
"23694","76600","2015",22,22,0,161545.5,1828.455,92.72727
"23695","76602","2015",5,5,0,127400,1106.4,108.6
"23696","76603","2015",2,2,0,156500,1551.5,103
"23697","76604","2015",2,2,0,106325,1367,73
"23698","76605","2015",9,9,0,218900,2976.778,78.55556
"23699","76606","2015",1,1,0,139000,1695,82
"23700","76608","2015",18,18,0,137211.1,1511.944,93.66667
"23701","76609","2015",4,4,0,243740,1519,167
"23702","76610","2015",9,9,0,159298.1,1768.333,92.22222
"23703","76611","2015",1,1,0,149000,1862,80
"23704","76612","2015",3,3,0,143333.3,1318,107.6667
"23705","76613","2015",14,13,1,133400,1549,86.64286
"23706","76614","2015",10,10,0,326570,2587.8,128.4
"23707","76615","2015",6,6,0,185833.3,1719,114.5
"23708","76616","2015",17,17,0,214570.6,2086,104.8235
"23709","76617","2015",13,13,0,338010.8,2395.692,142.6154
"23710","76618","2015",76,76,0,141336.6,1635.684,92.72368
"23711","76619","2015",3,3,0,116307,764.6667,143.3333
"23712","76620","2015",2,2,0,150235,1385,115
"23713","76621","2015",8,8,0,143500,1331.25,108.75
"23714","76622","2015",1,1,0,1e+05,1333,75
"23715","76623","2015",1,1,0,138000,1971,70
"23716","76624","2015",28,27,1,127787.1,1573.929,86.67857
"23717","76626","2015",4,4,0,154625,1842.75,83.25
"23718","76627","2015",16,16,0,162095.9,1568.438,110.5625
"23719","76628","2015",11,11,0,151320.5,1412.909,116.4545
"23720","76631","2015",16,16,0,142325.4,1435.125,100.5
"23721","76632","2015",5,5,0,117800,1427.2,88.8
"23722","76634","2015",3,3,0,168483,1673.667,97
"23723","76636","2015",17,17,0,158339.9,1737.706,90.41176
"23724","76637","2015",13,10,3,87950.77,1283.923,77.69231
"23725","76638","2015",13,13,0,125615.2,1888.769,72.38462
"23726","76640","2015",77,66,11,143938.2,1682.545,87.36364
"23727","76644","2015",4,4,0,115875,1448.75,79.5
"23728","76646","2015",6,6,0,190041.7,1614.5,120.5
"23729","76647","2015",43,37,6,176350,1901.953,95.88372
"23730","76648","2015",22,22,0,133681.8,1397,97.36364
"23731","76649","2015",7,7,0,135642.9,1265.571,112.1429
"23732","76650","2015",13,13,0,188576.9,1753.231,111.6923
"23733","76651","2015",1,1,0,90000,1059,85
"23734","76652","2015",10,10,0,116300,1126.6,105.5
"23735","76653","2015",8,8,0,129012.5,1012.5,130.5
"23736","76654","2015",5,5,0,133400,1346.6,119.2
"23737","76655","2015",38,29,9,115921.3,1730.526,70.94737
"23738","76656","2015",2,2,0,117910,1241.5,103.5
"23739","76657","2015",9,9,0,197964.4,1941,104.3333
"23740","76658","2015",8,8,0,208750,1941,110.125
"23741","76660","2015",16,16,0,203893.3,2232.5,92.5625
"23742","76662","2015",2,2,0,111587.5,1130,97
"23743","76663","2015",12,12,0,172762.5,1912.167,100.5
"23744","76664","2015",2,2,0,168500,1883.5,89.5
"23745","76665","2015",6,6,0,141146.7,1464.5,120.5
"23746","76666","2015",6,6,0,110933.3,1055.167,106
"23747","76667","2015",7,7,0,150142.9,1538.143,97.14286
"23748","76668","2015",6,6,0,169083.3,1908.833,95.33333
"23749","76669","2015",2,2,0,160000,1742,92
"23750","76670","2015",8,8,0,146775,1763.625,86.375
"23751","76672","2015",11,11,0,104725.5,1450.545,89.63636
"23752","76673","2015",10,10,0,183700,1668.2,112.6
"23753","76675","2015",8,8,0,179062.5,1679.75,109.75
"23754","76676","2015",13,13,0,114253.8,1353.154,83.46154
"23755","76677","2015",5,5,0,137500,1209.2,117
"23756","76678","2015",9,9,0,109563.3,1392.667,80.66667
"23757","76680","2015",1,1,0,78000,1950,40
"23758","76681","2015",316,251,65,139746.4,1881.361,74.83228
"23759","76682","2015",12,12,0,162533.3,1792.167,96.16667
"23760","76683","2015",3,3,0,191666.7,1539.333,117.6667
"23761","76684","2015",12,12,0,151993.6,1793.833,86.25
"23762","76685","2015",5,5,0,110740,1353.8,79
"23763","76686","2015",2,2,0,132500,1994.5,66.5
"23764","76688","2015",3,3,0,118333.3,1236,99.33333
"23765","76689","2015",5,5,0,127328,1346.2,96.8
"23766","76690","2015",3,3,0,130600,1455.667,87.33333
"23767","76691","2015",2,2,0,106850,1495.5,66
"23768","76692","2015",3,3,0,118500,1384.333,84.33333
"23769","76693","2015",5,5,0,134500,1694.4,88.6
"23770","76694","2015",1,1,0,170800,1220,140
"23771","76695","2015",2,2,0,117250,1631,74.5
"23772","76697","2015",8,8,0,117325,1454.25,78.875
"23773","76698","2015",7,7,0,125957.1,1235.714,100.2857
"23774","76700","2015",7,7,0,133142.9,1445.857,91.71429
"23775","76702","2015",5,5,0,219000,1792.8,136
"23776","76703","2015",1,1,0,90000,1343,67
"23777","76705","2015",20,17,3,173779,1733.65,104.5
"23778","76706","2015",6,6,0,124000,1429.5,89.66667
"23779","76707","2015",13,13,0,158408.5,1624.846,102.7692
"23780","76708","2015",4,4,0,114625,1297.75,92.5
"23781","76709","2015",52,51,1,142054.2,1645.481,86.46154
"23782","76710","2015",3,3,0,132666.7,1079.667,122
"23783","76711","2015",102,57,45,70448.73,1457.49,53.87255
"23784","76712","2015",8,8,0,160187.5,1788.625,92
"23785","76714","2015",7,7,0,182464.3,1847,105.2857
"23786","76715","2015",12,12,0,160575,1854.333,90.83333
"23787","76716","2015",9,9,0,163688.9,1717,100.6667
"23788","76717","2015",7,7,0,172000,1648.429,109.7143
"23789","76718","2015",9,9,0,182933.3,1701.778,112
"23790","76719","2015",3,3,0,101712.7,1443.667,72.66667
"23791","76720","2015",9,8,1,278388.9,2496.778,111.1111
"23792","76721","2015",4,4,0,134650,1512.5,93.25
"23793","76723","2015",3,3,0,146366.7,1909.667,81.33333
"23794","76724","2015",2,2,0,190000,1451,136
"23795","76725","2015",3,3,0,157106.7,1962.333,80
"23796","76726","2015",2,2,0,182500,1744.5,105
"23797","76727","2015",8,8,0,131587.5,1526.5,95.25
"23798","76728","2015",13,13,0,195392.3,1758.308,113.5385
"23799","76730","2015",3,3,0,130833.3,1330,100
"23800","76731","2015",2,2,0,150000,1717,87.5
"23801","76732","2015",6,6,0,127216.7,1392.167,101.1667
"23802","76733","2015",4,4,0,137575,1246.25,157
"23803","76734","2015",9,9,0,208577.8,2064.444,107.5556
"23804","76735","2015",22,14,8,133963.6,1815.409,81.40909
"23805","76736","2015",6,6,0,147083.3,2758.167,81.33333
"23806","76737","2015",4,4,0,169300,1665.25,131
"23807","76738","2015",7,7,0,172514.3,1671,103
"23808","76739","2015",5,5,0,106510,1130,91.4
"23809","76740","2015",3,3,0,165550,1630.667,96.66667
"23810","76741","2015",5,5,0,217600,2157.2,101.8
"23811","76743","2015",16,16,0,143012.5,1462.25,102.25
"23812","76745","2015",1,1,0,42000,700,60
"23813","76747","2015",3,3,0,162000,1902.667,94.33333
"23814","76748","2015",4,4,0,145875,1749,85
"23815","76749","2015",3,3,0,87500,1440.333,65
"23816","76750","2015",12,12,0,129708.3,1566.5,87.33333
"23817","76751","2015",10,10,0,157540,1902.3,90.2
"23818","76752","2015",37,28,9,150526.3,1764.676,91.54054
"23819","76754","2015",20,20,0,151216.5,2033.2,82.3
"23820","76755","2015",3,3,0,165833.3,1877.333,88.33333
"23821","76756","2015",1,1,0,195000,1500,130
"23822","76757","2015",5,5,0,145600,1277.4,115.6
"23823","76758","2015",106,78,28,144622.2,1690.264,86.84906
"23824","76759","2015",8,8,0,169075,1400.75,129.5
"23825","77001","2015",11,11,0,299672.7,2329.909,130.5455
"23826","77002","2015",13,13,0,168630.8,1609.385,113
"23827","77003","2015",2,2,0,166000,1308.5,125.5
"23828","77004","2015",5,5,0,203600,2241.4,91.4
"23829","77005","2015",42,29,13,240384.5,2694.238,93.92857
"23830","77006","2015",11,10,1,180000,3295.636,69.18182
"23831","77007","2015",3,3,0,268333.3,2571,105.6667
"23832","77008","2015",14,14,0,220571.4,1961,117.1429
"23833","77009","2015",2,2,0,147500,1833,80.5
"23834","77010","2015",13,13,0,190476.9,2588.692,96.07692
"23835","77011","2015",4,4,0,186000,1857.75,104.75
"23836","77012","2015",3,3,0,183383.3,1561.667,134.3333
"23837","77013","2015",5,5,0,237500,2504.4,98.8
"23838","77014","2015",187,37,150,174720,2528.754,70.8984
"23839","77016","2015",11,11,0,145269.4,1584.909,97.27273
"23840","77018","2015",96,51,45,262068.9,3238.781,81.89583
"23841","77019","2015",8,8,0,156000,1665.25,109.125
"23842","77020","2015",14,14,0,206917.9,1783.071,121.5
"23843","77022","2015",24,23,1,475472.1,3236.458,157.125
"23844","77023","2015",3,3,0,156666.7,1845,90
"23845","77024","2015",1,1,0,150000,1875,80
"23846","77025","2015",6,6,0,108833.3,1748.167,62.16667
"23847","77026","2015",6,6,0,141916.7,1320.333,114.6667
"23848","77027","2015",11,11,0,122381.8,1196.091,102.1818
"23849","77029","2015",2,2,0,246550,2307,110.5
"23850","77030","2015",11,11,0,194786.4,1327.909,160.6364
"23851","77031","2015",9,9,0,252222.2,1928.778,128.8889
"23852","77032","2015",6,6,0,151000,1286.167,117.1667
"23853","77033","2015",2,2,0,250000,1822,138
"23854","77034","2015",6,6,0,184016.7,2660.167,75.5
"23855","77035","2015",13,13,0,168846.2,1923.308,94.15385
"23856","77036","2015",1,1,0,213000,1532,139
"23857","77037","2015",72,62,10,321021.5,3267.75,102.4861
"23858","77038","2015",3,3,0,344500,2857,125.6667
"23859","77039","2015",11,10,1,304627.3,3004.818,100.5455
"23860","77040","2015",32,31,1,280328.1,2489.469,118.7188
"23861","77041","2015",8,8,0,234775,1919.375,124.625
"23862","77042","2015",30,30,0,203192.8,1961.267,105.6
"23863","77043","2015",3,3,0,256000,2079.333,117.6667
"23864","77044","2015",13,10,3,179044.6,1817.538,98.15385
"23865","77045","2015",5,5,0,210481.8,1942.4,106.8
"23866","77046","2015",5,5,0,155600,1805.6,91.6
"23867","77047","2015",15,14,1,240470.7,2379.4,109.4667
"23868","77048","2015",33,30,3,307168.2,2646.97,117.7576
"23869","77049","2015",9,9,0,247105.6,2354.111,112.7778
"23870","77050","2015",5,5,0,162880,1563,110.8
"23871","77051","2015",23,19,4,118873.3,1637.522,78.04348
"23872","77052","2015",1,1,0,242000,2051,118
"23873","77053","2015",249,127,122,215896,3021.157,74.83534
"23874","77054","2015",6,6,0,188166.7,2128.167,96
"23875","77055","2015",46,14,32,214238.3,3000.13,72.80435
"23876","77056","2015",1,1,0,272700,2050,133
"23877","77057","2015",5,5,0,125200,1398,111.6
"23878","77058","2015",360,92,268,235106.6,3305.817,73.68333
"23879","77059","2015",5,4,1,266490,3259.6,90.2
"23880","77060","2015",8,7,1,134528.4,1488.375,89.75
"23881","77061","2015",14,14,0,161308.1,2190.143,82.78571
"23882","77062","2015",6,4,2,290913.7,3264.667,89.66667
"23883","77063","2015",24,24,0,209252.9,2347.125,95.20833
"23884","77065","2015",9,7,2,282375.7,3183.444,98.33333
"23885","77066","2015",4,4,0,130500,1362.5,104
"23886","77067","2015",95,90,5,238385.4,2467.432,100.4105
"23887","77068","2015",1,1,0,162700,2169,75
"23888","77069","2015",22,22,0,350195.4,2979.682,115.2727
"23889","77070","2015",14,14,0,197728.6,2164.5,99.21429
"23890","77071","2015",10,10,0,145710,1447.8,97.5
"23891","77072","2015",8,8,0,116635,1059.375,118.625
"23892","77073","2015",1,1,0,159000,2092,76
"23893","77075","2015",12,11,1,329702.5,3271.5,120.4167
"23894","77076","2015",10,10,0,153575,1561.3,101.9
"23895","77077","2015",5,5,0,168860,2491,68
"23896","77078","2015",10,10,0,152300,1847,88.3
"23897","77079","2015",46,29,17,147197.1,2238.913,71.73913
"23898","77080","2015",5,5,0,159630,1530.8,104.6
"23899","77081","2015",8,8,0,241375,2326.5,109.125
"23900","77082","2015",8,6,2,241112.5,2697,95
"23901","77083","2015",222,74,148,223849.4,2858.815,81.54505
"23902","77084","2015",16,15,1,219093.8,2140.062,107.0625
"23903","77085","2015",30,26,4,319387.3,3217.7,102.3667
"23904","77086","2015",6,6,0,160833.3,2043,81.33333
"23905","77087","2015",5,3,2,143000,2176.4,66.4
"23906","77088","2015",24,23,1,198945,2051.542,101.4167
"23907","77089","2015",15,15,0,204538.3,1902.867,109.9333
"23908","77090","2015",1,1,0,175000,1357,129
"23909","77091","2015",4,4,0,290500,2504.75,121.5
"23910","77093","2015",4,4,0,127000,1526.25,85.75
"23911","77094","2015",5,2,3,183200,3017,61.8
"23912","77095","2015",15,13,2,246776.7,2769.133,94.66667
"23913","77096","2015",25,25,0,262009.9,2681.84,96.72
"23914","77097","2015",4,4,0,163250,1609.25,104
"23915","77098","2015",5,5,0,171300,1520.6,121.6
"23916","77099","2015",41,39,2,129965,1713.463,87.73171
"23917","77100","2015",50,44,6,192002.4,2356.5,81.16
"23918","77101","2015",14,14,0,148934.5,1798.357,92.92857
"23919","77102","2015",5,5,0,168600,1491,119.2
"23920","77103","2015",2,2,0,197500,2655,82.5
"23921","77104","2015",5,5,0,246800,2684.4,91.6
"23922","77106","2015",14,14,0,175714.3,1603.357,120.2143
"23923","77107","2015",47,34,13,204181.1,2503.553,86.06383
"23924","77108","2015",650,306,344,213397.1,2983.265,74.37538
"23925","77109","2015",14,13,1,193635.7,1856.714,110.2857
"23926","77110","2015",1,1,0,175000,1509,116
"23927","77111","2015",93,41,52,256030.6,3536.161,76.06452
"23928","77112","2015",4,4,0,124250,1372.25,108.25
"23929","77113","2015",16,16,0,169075.6,1870.812,97.375
"23930","77114","2015",46,38,8,276053.1,3148.087,93.36957
"23931","77115","2015",7,7,0,142642.9,1351.286,107.8571
"23932","77116","2015",14,11,3,156350.7,1733.643,100.5714
"23933","77117","2015",11,10,1,143536.4,1749.727,85.81818
"23934","77118","2015",151,92,59,261689.6,3234.623,85.19205
"23935","77119","2015",4,4,0,222575,2121.5,105
"23936","77120","2015",3,2,1,213000,2729.667,79
"23937","77121","2015",29,20,9,255741.4,3026,85.37931
"23938","77122","2015",233,133,100,203892.6,2630.455,80.08155
"23939","77123","2015",3,3,0,241333.3,2456,98.66667
"23940","77124","2015",20,19,1,305750,2942.6,107.95
"23941","77125","2015",18,17,1,251138.9,2793.611,92.05556
"23942","77126","2015",20,20,0,189576.8,1950.5,102.9
"23943","77127","2015",15,8,7,196160,3065.333,66.86667
"23944","77128","2015",22,18,4,261056.3,2699.955,97.81818
"23945","77129","2015",5,5,0,177400,1662.4,117
"23946","77130","2015",9,9,0,178555.6,2325.333,87.55556
"23947","77131","2015",147,91,56,174353.3,2340.925,79.41497
"23948","77132","2015",34,32,2,276195.3,3188.029,93.35294
"23949","77134","2015",1,1,0,182500,1342,136
"23950","77135","2015",27,27,0,232285.2,2122.222,113.963
"23951","77137","2015",2,2,0,136000,1329.5,98
"23952","77138","2015",12,12,0,203581.7,2692.583,84.91667
"23953","77139","2015",65,60,5,260466.9,2795,97.36923
"23954","77140","2015",1,1,0,252000,1924,131
"23955","77141","2015",13,10,3,292434.6,2577.077,121.3846
"23956","77142","2015",44,33,11,238470.7,2826.205,92.22727
"23957","77143","2015",43,33,10,185527.5,2515.651,78.37209
"23958","77144","2015",3,3,0,245833.3,2737.333,90.33333
"23959","77145","2015",7,7,0,207292.9,1939,113.1429
"23960","77146","2015",22,22,0,305794.1,3137.273,99.68182
"23961","77147","2015",3,2,1,172666.7,2343.333,71.66667
"23962","77148","2015",18,15,3,148861.1,1722.611,88.5
"23963","77150","2015",5,5,0,209600,2586.2,82.8
"23964","77151","2015",3,3,0,196660,1855.667,120.3333
"23965","77152","2015",170,80,90,177966.7,2503.871,74.78235
"23966","77153","2015",143,88,55,210353.3,2858.238,78.37063
"23967","77154","2015",15,14,1,274357.3,2423.467,119.3333
"23968","77155","2015",43,32,11,227926.5,2812.535,84.93023
"23969","77156","2015",12,12,0,188858.3,1799.917,106.9167
"23970","77157","2015",3,3,0,165666.7,1736.667,104
"23971","77158","2015",4,4,0,168500,1350.5,130.75
"23972","77159","2015",32,30,2,134570.5,1680.25,86.90625
"23973","77161","2015",19,19,0,202113.2,1852.474,117.0526
"23974","77162","2015",16,15,1,150031.2,1526.062,111.375
"23975","77163","2015",4,4,0,274000,2110.75,133
"23976","77164","2015",6,6,0,158833.3,1736.5,96.33333
"23977","77165","2015",5,5,0,207000,2081.6,105.6
"23978","77167","2015",5,5,0,132900,1388.8,97.4
"23979","77168","2015",23,23,0,133227.8,1216.565,113.6957
"23980","77169","2015",102,45,57,249202.1,3063.765,84.03922
"23981","77171","2015",104,67,37,220057.3,3068.067,77.32692
"23982","77172","2015",10,10,0,134150,1586.1,87.3
"23983","77173","2015",13,12,1,202696.2,1991.692,105.7692
"23984","77174","2015",7,7,0,109848.6,1252.714,87.57143
"23985","77175","2015",46,44,2,254828.7,2705.217,98.6087
"23986","77176","2015",35,32,3,195194.1,1992.143,107.4
"23987","77177","2015",12,12,0,324075,2309.167,138.8333
"23988","77178","2015",2,2,0,155000,1496,113.5
"23989","77179","2015",8,8,0,234012.5,2494.25,92.5
"23990","77180","2015",6,6,0,346605.8,3291.833,105.5
"23991","77181","2015",21,12,9,228023.8,3219.762,71.33333
"23992","77182","2015",36,28,8,133955.7,1632.111,88.72222
"23993","77183","2015",103,76,27,178062.5,2096.34,88.37864
"23994","77184","2015",5,5,0,148076,1888.4,80
"23995","77185","2015",5,5,0,392000,2923.8,132
"23996","77186","2015",254,71,183,264710.2,3458.976,75.96063
"23997","77187","2015",11,11,0,120500,1293.182,97.45455
"23998","77188","2015",14,14,0,260592.9,2899.143,96.92857
"23999","77190","2015",2,2,0,232500,1641,142
"24000","77191","2015",9,9,0,168566.7,1961.778,85.55556
"24001","77192","2015",52,38,14,209003.4,2705.731,81.30769
"24002","77193","2015",2,2,0,181750,2308.5,79
"24003","77194","2015",3,3,0,156666.7,1884,91.33333
"24004","77195","2015",7,7,0,257357.1,3124.286,93.28571
"24005","77196","2015",9,7,2,252927.8,3369.444,74.55556
"24006","77197","2015",2,2,0,240000,1656,155
"24007","77198","2015",5,5,0,169600,1658.2,115.6
"24008","77199","2015",12,12,0,235583.3,2801.167,87.33333
"24009","77200","2015",3,3,0,207333.3,1704,122.3333
"24010","77201","2015",14,12,2,186250,1945,104.0714
"24011","77202","2015",10,10,0,189490,1868.9,109.2
"24012","77203","2015",26,26,0,260390.4,2367.538,117.0385
"24013","77204","2015",1,1,0,60000,600,100
"24014","77205","2015",2,2,0,227500,2838.5,82.5
"24015","77206","2015",2,2,0,231000,1579,141
"24016","77208","2015",13,12,1,115923.1,1396.538,87.53846
"24017","77209","2015",10,8,2,318690,2974.5,109.9
"24018","77210","2015",19,19,0,166215.8,1795.789,97.68421
"24019","77211","2015",8,8,0,236900,2392.125,97.5
"24020","77212","2015",1,1,0,80000,1250,64
"24021","77214","2015",12,12,0,358345.9,2905.417,126.8333
"24022","77215","2015",88,64,24,227126.1,2895.67,85.09091
"24023","77216","2015",13,13,0,263567.3,2002.154,122.9231
"24024","77217","2015",35,24,11,244742.9,2739.029,95.14286
"24025","77218","2015",3,3,0,1e+05,1416,65.33333
"24026","77219","2015",31,31,0,247204.8,2404.516,107.129
"24027","77220","2015",4,4,0,121975,1273.5,98.5
"24028","77221","2015",19,19,0,398277.9,3087.368,133.2105
"24029","77222","2015",67,40,27,189926.4,2566.119,76.9403
"24030","77223","2015",5,5,0,205690,1659.4,123
"24031","77224","2015",1,1,0,248000,2480,100
"24032","77225","2015",1,1,0,190000,1508,126
"24033","77226","2015",25,24,1,269046,2690.2,104.36
"24034","77227","2015",3,3,0,171333.3,988.6667,175.3333
"24035","77228","2015",2,2,0,161000,1660,99.5
"24036","77229","2015",15,15,0,271266.7,2347.133,123.0667
"24037","77230","2015",1,1,0,118000,1229,96
"24038","77231","2015",5,5,0,218300,2086.2,112.2
"24039","77232","2015",32,13,19,186246.9,2427.438,77.34375
"24040","77233","2015",6,6,0,276575,2292.333,122.1667
"24041","77234","2015",5,5,0,212800,3413.2,90.6
"24042","77235","2015",3,3,0,163333.3,1784,86.66667
"24043","77236","2015",6,6,0,140306.5,1901.167,72.5
"24044","77237","2015",8,8,0,324414.6,3077.875,106.375
"24045","77238","2015",37,34,3,185367.6,2054.324,94.94595
"24046","77239","2015",21,21,0,189804.8,1934.429,112.1905
"24047","77240","2015",29,29,0,160890.8,1738.897,95.58621
"24048","77241","2015",18,15,3,228300,2504.056,95
"24049","77242","2015",8,8,0,152500,1519,112.75
"24050","77243","2015",249,116,133,241456.2,3158.137,78.88755
"24051","77244","2015",11,11,0,206599.8,2257.455,98.27273
"24052","77245","2015",7,7,0,172692.9,1979.857,92.28571
"24053","77246","2015",4,4,0,144912.5,1594.75,105.25
"24054","77247","2015",7,7,0,149271.4,1479.429,99.71429
"24055","77248","2015",9,9,0,265724.4,3151.667,96.55556
"24056","77249","2015",106,100,6,317998.6,2903.84,111.9151
"24057","77250","2015",1,1,0,210000,1148,183
"24058","77251","2015",151,77,74,200588.6,2736.503,75.23841
"24059","77252","2015",1,1,0,281000,4930,57
"24060","77253","2015",1,1,0,86000,741,116
"24061","77254","2015",14,13,1,276178.6,3047.857,105.1429
"24062","77255","2015",21,21,0,263788.1,2769,101.2381
"24063","77256","2015",3,3,0,187333.3,1972,94.33333
"24064","77257","2015",20,15,5,150270,2068.95,77.2
"24065","77258","2015",149,30,119,186795.2,2876.134,67.62416
"24066","77259","2015",28,17,11,199053.6,2911.429,75.5
"24067","77260","2015",12,12,0,151491.7,1654.25,96.08333
"24068","77261","2015",6,4,2,127666.7,1582.333,79.16667
"24069","77262","2015",7,7,0,122642.9,1538.143,80.57143
"24070","77263","2015",3,3,0,175000,1513,130.3333
"24071","77264","2015",14,14,0,264226.4,2237.571,128.7143
"24072","77265","2015",14,14,0,173571.4,1778.857,97.35714
"24073","77266","2015",8,7,1,196700,1892,112.75
"24074","77267","2015",3,3,0,129131.7,1390.333,97.33333
"24075","77268","2015",337,49,288,208352.9,6511.582,41.61128
"24076","77269","2015",23,12,11,189056.5,2365.304,80.65217
"24077","77270","2015",9,9,0,291111.1,2448.333,122.7778
"24078","77271","2015",1,1,0,230000,1917,120
"24079","77272","2015",9,8,1,158400,1633.667,100.8889
"24080","77273","2015",5,5,0,231870,2203,110.2
"24081","77274","2015",9,9,0,227188.9,2186.556,110.5556
"24082","77275","2015",1,1,0,129000,1743,74
"24083","77276","2015",33,30,3,284934.8,2505.424,115.4848
"24084","77277","2015",17,15,2,224555.3,2533.824,95.88235
"24085","77278","2015",5,5,0,157600,1790,99.4
"24086","77279","2015",8,8,0,149106.2,1732.375,97.75
"24087","77280","2015",17,16,1,191094.1,2178.235,89.17647
"24088","77281","2015",6,6,0,189666.7,2103.833,108
"24089","77282","2015",2,2,0,180000,2282,79.5
"24090","77283","2015",6,6,0,139600,1768.167,80.5
"24091","77284","2015",486,148,338,171610.7,2561.66,70.80041
"24092","77285","2015",148,65,83,158932.2,1929.149,81.52703
"24093","77286","2015",1,1,0,120000,632,190
"24094","77287","2015",4,4,0,142000,1451.5,101
"24095","77288","2015",369,75,294,155209.2,2565.61,65.1355
"24096","77289","2015",7,7,0,134000,1394.429,121.1429
"24097","77290","2015",14,14,0,159775.7,2227.357,87.71429
"24098","77291","2015",5,5,0,140600,1937.6,71.4
"24099","77292","2015",17,14,3,234714.7,3004.882,83.47059
"24100","77293","2015",18,18,0,171368.3,2189.056,83.66667
"24101","77294","2015",159,132,27,218579.1,2948.786,78.77358
"24102","77295","2015",16,16,0,240892.5,2486.812,99.0625
"24103","77296","2015",181,103,78,199380.2,2680.343,76.89503
"24104","77297","2015",5,5,0,188640,1610,116.8
"24105","77298","2015",7,7,0,174787.1,1360.143,148
"24106","77300","2015",5,4,1,192600,2233.4,87.8
"24107","77301","2015",6,6,0,84333.33,953.5,95.66667
"24108","77302","2015",22,21,1,195931.4,1840.182,104.2273
"24109","77303","2015",4,4,0,113000,1746.75,65
"24110","77304","2015",1,1,0,47000,443,106
"24111","77305","2015",142,44,98,115112.6,1813.444,70.5493
"24112","77306","2015",4,4,0,224625,1795.5,138.5
"24113","77307","2015",162,48,114,240650.3,3502.71,71.25926
"24114","77308","2015",22,21,1,180659.1,2124.591,87.36364
"24115","77309","2015",21,20,1,199617.1,2671.19,81.19048
"24116","77310","2015",5,5,0,165498,1511.4,123
"24117","77311","2015",11,11,0,146909.1,1528.818,101.6364
"24118","77312","2015",37,35,2,264011.4,2534.027,111.6486
"24119","77313","2015",2,2,0,205400,2088.5,98.5
"24120","77314","2015",2,2,0,117000,1092,115
"24121","77315","2015",45,40,5,227926.2,3128.444,78.06667
"24122","77316","2015",154,119,35,202068.9,2502.364,85.2987
"24123","77317","2015",43,40,3,196167.9,2229.814,90.44186
"24124","77318","2015",9,8,1,252458.9,2443.222,102
"24125","77319","2015",2,2,0,163000,1728.5,93.5
"24126","77320","2015",78,73,5,190390.9,2363.128,87.67949
"24127","77321","2015",9,8,1,142100,1687.889,85.66667
"24128","77322","2015",34,28,6,248779.5,3083.382,84.29412
"24129","77323","2015",14,10,4,219885.7,2948.357,75.92857
"24130","77325","2015",5,5,0,146400,1795,92
"24131","77326","2015",59,46,13,234846.1,2375.881,100.5763
"24132","77327","2015",49,37,12,167506.6,2133.388,83.34694
"24133","77328","2015",4,4,0,205841.8,2095,99.5
"24134","77329","2015",2,2,0,197500,2101.5,100
"24135","77330","2015",72,63,9,212440.2,2623.625,92.69444
"24136","77331","2015",5,5,0,162200,1938.6,91.2
"24137","77332","2015",3,3,0,236566.7,2715.333,90
"24138","77333","2015",110,78,32,163466.9,2093.409,81.50909
"24139","77335","2015",23,21,2,212882.6,2510.478,88
"24140","77336","2015",2,1,1,206200,2343.5,97.5
"24141","77337","2015",93,22,71,198494.6,2607.849,77.70968
"24142","77338","2015",4,4,0,167062.5,1690.5,106
"24143","77339","2015",32,27,5,293245.7,2346.188,124.9062
"24144","77340","2015",6,6,0,198333.3,1680.5,121.8333
"24145","77341","2015",8,8,0,109745,1028,113.875
"24146","77342","2015",1,1,0,130000,1444,90
"24147","77343","2015",1,1,0,175300,2504,70
"24148","77344","2015",14,14,0,252717.9,2497.714,104
"24149","77345","2015",9,9,0,162925.3,1620.556,105.4444
"24150","77347","2015",8,8,0,164468.8,1832.625,89.875
"24151","77348","2015",6,6,0,159166.7,1604.667,99.5
"24152","77349","2015",88,74,14,235444.3,2635.25,95.01136
"24153","77350","2015",218,167,51,270177.6,3249.789,90.16972
"24154","77352","2015",25,25,0,233972.6,2472.36,99.88
"24155","77353","2015",4,4,0,196750,1824,101.5
"24156","77354","2015",10,10,0,203570,2261.3,94.1
"24157","77355","2015",4,4,0,181500,1852.75,97.25
"24158","77357","2015",7,7,0,217710,2361.429,104.2857
"24159","77358","2015",7,6,1,195674.3,2303.571,85.71429
"24160","77359","2015",17,17,0,261023.5,2646.588,104.1176
"24161","77360","2015",3,3,0,210000,2576.333,113.3333
"24162","77361","2015",6,6,0,2e+05,1817,109.1667
"24163","77363","2015",14,10,4,271349.1,3227.857,83.92857
"24164","77364","2015",6,6,0,259291.7,2284.167,119.8333
"24165","77365","2015",5,5,0,199600,1831.4,110.2
"24166","77366","2015",1,1,0,238000,2800,85
"24167","77367","2015",4,4,0,247250,1909.25,147.5
"24168","77368","2015",3,3,0,155634.7,1706.667,93
"24169","77369","2015",1,1,0,118000,2269,52
"24170","77370","2015",14,14,0,182248.5,1720.857,105.2857
"24171","77371","2015",35,33,2,208013.1,2261.857,99.91429
"24172","77372","2015",43,25,18,294151,3330.488,93.25581
"24173","77373","2015",419,238,181,247526,3322.556,78.1599
"24174","77374","2015",35,27,8,268350.7,2979.343,94.34286
"24175","77376","2015",13,12,1,208115.4,2659.077,84
"24176","77377","2015",28,28,0,291754.6,2692.821,110.7143
"24177","77378","2015",35,16,19,199254.3,2752.514,78.11429
"24178","77379","2015",76,45,31,153016.1,1861.684,86.82895
"24179","77380","2015",3,3,0,210000,2243.333,96.33333
"24180","77381","2015",7,7,0,218855.7,1889,118.8571
"24181","77382","2015",61,53,8,256014.3,2664.918,100.6557
"24182","77383","2015",14,14,0,179957.1,1682,106.8571
"24183","77384","2015",21,21,0,217347.6,3386.524,71.04762
"24184","77385","2015",18,15,3,171555.6,1829.722,101.5556
"24185","77386","2015",7,7,0,235149.6,2306.571,109
"24186","77387","2015",5,5,0,128690,1389.6,90.6
"24187","77388","2015",12,12,0,177016.7,1931.833,98.41667
"24188","77389","2015",49,16,33,200998.4,2379.551,87.71429
"24189","77390","2015",237,156,81,229897.1,2862.591,82.74262
"24190","77392","2015",4,4,0,243750,2541.25,101.75
"24191","77393","2015",40,33,7,205408.1,2326.925,98.45
"24192","77394","2015",19,19,0,301226.3,2562.895,119.1579
"24193","77395","2015",2,2,0,136000,1780.5,87.5
"24194","77397","2015",19,18,1,155863.2,1935.211,84.47368
"24195","77398","2015",10,10,0,179730,1583.7,116.1
"24196","77400","2015",24,23,1,208154.4,2434.083,93.83333
"24197","77401","2015",8,8,0,180125,1775.5,100.375
"24198","77403","2015",5,5,0,189000,2337.6,81.8
"24199","77404","2015",16,16,0,133487.5,1811.125,75.6875
"24200","77405","2015",20,20,0,179775,1671.4,109.65
"24201","77406","2015",14,14,0,179350,1770,112.5714
"24202","77407","2015",171,111,60,224581.5,2609.556,88.69591
"24203","77408","2015",6,6,0,185027,1899.5,99.66667
"24204","77409","2015",18,18,0,157222.2,1792.944,89.05556
"24205","77410","2015",3,2,1,195000,2716.667,68.33333
"24206","77411","2015",7,7,0,174714.3,1512.429,114.4286
"24207","77412","2015",3,3,0,256633.3,1995,131.6667
"24208","77413","2015",49,40,9,222845.4,2729.918,85.26531
"24209","77414","2015",6,6,0,136666.7,1429.167,95.83333
"24210","77415","2015",16,16,0,227506.2,2127.062,108.125
"24211","77416","2015",3,3,0,266610,1532,190.6667
"24212","77417","2015",3,3,0,124000,1536.333,82.33333
"24213","77418","2015",11,11,0,138640.9,1489.818,100.2727
"24214","77419","2015",35,29,6,179961.4,2531.143,78.94286
"24215","77420","2015",51,42,9,200459.8,2562.569,83.13725
"24216","77421","2015",5,5,0,182200,1803,101
"24217","77423","2015",5,5,0,166800,1737.8,97
"24218","77424","2015",4,4,0,201575,1535.5,135.5
"24219","77425","2015",16,16,0,373593.8,2661.5,147.5625
"24220","77426","2015",5,5,0,194396,2464.2,92.4
"24221","77427","2015",2,1,1,90000,1482.5,60
"24222","77428","2015",5,5,0,181680,2225.8,82.2
"24223","77429","2015",10,10,0,214277.6,1801.8,120.5
"24224","77430","2015",54,54,0,250284.3,2504.796,101.2593
"24225","77431","2015",64,56,8,180921.1,1948.641,100.25
"24226","77432","2015",14,12,2,133128.6,1197.643,119.4286
"24227","77433","2015",18,17,1,194044.4,2045.889,98.83333
"24228","77434","2015",3,3,0,135666.7,2873,48
"24229","77435","2015",12,12,0,310313.9,2723.917,115.4167
"24230","77436","2015",6,6,0,180666.7,1715.667,104.3333
"24231","77437","2015",37,32,5,224499.2,2470.135,92.86486
"24232","77438","2015",72,41,31,264401.8,3127.778,86.98611
"24233","77439","2015",7,7,0,192428.6,1937.571,111.5714
"24234","77440","2015",11,11,0,207409.1,2224.091,96.18182
"24235","77441","2015",19,17,2,228419.7,3277.368,72.84211
"24236","77442","2015",17,17,0,235948.1,2253.882,109.7647
"24237","77443","2015",4,4,0,241547.5,2634.5,91.75
"24238","77444","2015",6,6,0,142650,1224.333,124.8333
"24239","77445","2015",280,180,100,199856.7,2391.171,85.65714
"24240","77446","2015",10,10,0,170000,1488.6,120.4
"24241","77447","2015",18,16,2,343694.4,2851.944,122.7778
"24242","77448","2015",6,4,2,180825,2106,85.16667
"24243","77449","2015",90,17,73,238367.3,3521.356,68.95556
"24244","77450","2015",46,34,12,282282.2,2824.717,106.9783
"24245","77451","2015",5,5,0,226500,2002,114.2
"24246","77453","2015",11,11,0,227200,2414.909,117.8182
"24247","77454","2015",7,7,0,188642.9,2035.143,125.5714
"24248","77455","2015",26,16,10,183030.8,2449.077,80.96154
"24249","77456","2015",10,10,0,174308.5,1561.5,114.2
"24250","77457","2015",24,18,6,203750,2592.667,83.20833
"24251","77458","2015",44,39,5,138455.2,1726.045,86.11364
"24252","77459","2015",14,14,0,151494.3,1623.571,98.07143
"24253","77460","2015",3,3,0,158000,1914,82.33333
"24254","77461","2015",5,5,0,194775,1518.8,135.2
"24255","77462","2015",11,7,4,181472.7,2154.364,101.3636
"24256","77463","2015",38,37,1,288457.4,2774.237,108.7368
"24257","77464","2015",106,60,46,212712.8,3145.472,71.27358
"24258","77465","2015",11,11,0,121548.6,1621.091,79.36364
"24259","77466","2015",6,6,0,148083.3,3008.667,58.5
"24260","77467","2015",2,2,0,201500,1008.5,197.5
"24261","77468","2015",207,49,158,207292.4,2931.372,73.12077
"24262","77469","2015",11,10,1,233625.5,2176.091,119.1818
"24263","77470","2015",95,55,40,237213.4,3024.768,81.26316
"24264","77471","2015",3,3,0,255000,1619,176.6667
"24265","77472","2015",8,8,0,188437.5,1523.125,134.375
"24266","77473","2015",7,7,0,221957.1,1564.143,148.8571
"24267","77474","2015",13,12,1,227176.9,2839.923,81.23077
"24268","77475","2015",72,65,7,199692.6,2460.264,83.48611
"24269","77476","2015",4,4,0,164750,1852.75,95.25
"24270","77477","2015",11,10,1,236109.1,2085.636,116.5455
"24271","77478","2015",7,7,0,212507.1,1931.714,112
"24272","77479","2015",144,74,70,260597.5,3359.882,80.31944
"24273","77480","2015",7,7,0,181428.6,1648.286,112.4286
"24274","77481","2015",1,1,0,118000,356,331
"24275","77482","2015",40,39,1,169416.3,2029.225,91.475
"24276","77483","2015",26,23,3,187313.5,2587.731,76.69231
"24277","77484","2015",4,4,0,236750,2016.25,118.25
"24278","77485","2015",13,13,0,336830.8,3052.462,114.2308
"24279","77486","2015",9,9,0,227036.7,2251.111,107.4444
"24280","77487","2015",117,72,45,227150.9,2595,90.90598
"24281","77489","2015",2,2,0,149500,1411,106.5
"24282","77490","2015",5,5,0,164790,1934.6,85.8
"24283","77492","2015",10,10,0,185669.6,1392,136.3
"24284","77493","2015",21,21,0,223341.4,2427.286,95.14286
"24285","77494","2015",31,31,0,206084.5,2158.742,101.129
"24286","77495","2015",81,78,3,229404.9,2534.494,92.49383
"24287","77496","2015",1,1,0,143000,1788,80
"24288","77498","2015",3,3,0,191100,2845,70.66667
"24289","77500","2015",5,5,0,154308.6,1710.8,96.4
"24290","77501","2015",6,6,0,224516.7,1714.5,123.3333
"24291","77504","2015",14,14,0,169464.3,1752.143,100.2857
"24292","77505","2015",3,3,0,134500,1783.333,63
"24293","77506","2015",9,9,0,177680.6,1841.556,104.4444
"24294","77507","2015",3,3,0,184125,1043,189.6667
"24295","77508","2015",20,19,1,257447.5,2704.3,98.15
"24296","77509","2015",12,12,0,165592.1,1887.333,93.5
"24297","77510","2015",10,8,2,284860,3174.7,92.2
"24298","77511","2015",5,5,0,255300,4057.8,116
"24299","77512","2015",21,21,0,135871.4,1629.19,87.80952
"24300","77513","2015",51,26,25,195921.5,2774.745,74.94118
"24301","77514","2015",288,149,139,197955.5,2949.611,71.16319
"24302","77515","2015",8,8,0,269250,2705,109.5
"24303","77516","2015",8,8,0,205425,1904.25,128.125
"24304","77517","2015",24,20,4,258562,2868.917,99.83333
"24305","77518","2015",1,1,0,390000,3514,111
"24306","77519","2015",13,13,0,137538.5,1337.615,110.7692
"24307","77520","2015",13,13,0,249967.3,1715.615,145.0769
"24308","77521","2015",21,19,2,195735,2480.762,82.85714
"24309","77522","2015",5,5,0,164200,1284,131.2
"24310","77523","2015",2,2,0,307500,1216,258.5
"24311","77524","2015",10,10,0,164700,1648.6,100.8
"24312","77525","2015",4,4,0,228772.8,2519,97.75
"24313","77526","2015",1,1,0,186000,2325,80
"24314","77527","2015",7,7,0,192000,2199.714,96.42857
"24315","77528","2015",11,11,0,262661.4,2256.909,119.3636
"24316","77529","2015",12,12,0,184500,1800.583,120.5833
"24317","77531","2015",25,25,0,130532,1860.44,75.52
"24318","77533","2015",22,22,0,257960.2,2381.045,113.1818
"24319","77534","2015",8,8,0,235900,2340.75,105.125
"24320","78003","2015",33,30,3,199008.9,2119.061,97.66667
"24321","78005","2015",165,76,89,244596.5,3335.976,74.90303
"24322","78006","2015",4,4,0,365000,2485.5,152.5
"24323","78007","2015",9,9,0,660174.4,4359.556,156.8889
"24324","78009","2015",2,2,0,156000,1804.5,82
"24325","78010","2015",12,12,0,524175,3180.167,167.25
"24326","78013","2015",6,6,0,234083.3,2295.5,102
"24327","78015","2015",167,76,91,252770.4,3122.419,83.02994
"24328","78020","2015",9,8,1,252377.8,2321.222,121.7778
"24329","78029","2015",124,52,72,171964.4,2346.258,74.87097
"24330","78030","2015",15,12,3,308520,3227.4,100.6667
"24331","78031","2015",6,6,0,189331.7,1766,107
"24332","78033","2015",12,10,2,218293.8,2449.917,96.16667
"24333","78034","2015",10,10,0,329080,2975.8,113.5
"24334","78036","2015",5,5,0,263857.8,2405,118.8
"24335","78043","2015",45,24,21,418714.7,4334.356,100.5111
"24336","78048","2015",21,16,5,220640.3,2695.286,90.38095
"24337","78049","2015",20,19,1,353090,2931.9,132.25
"24338","78050","2015",8,8,0,436888.8,3212.25,153.75
"24339","78053","2015",5,5,0,342454,2384.2,141.6
"24340","78057","2015",24,24,0,193066.7,1988.792,101.7917
"24341","78062","2015",94,63,31,243314,2913.223,85.8617
"24342","78068","2015",10,10,0,274700,2151.5,157.9
"24343","78070","2015",3,3,0,205000,2371,94.66667
"24344","78071","2015",6,6,0,203333.3,2161.667,107.3333
"24345","78072","2015",5,5,0,217160,1942.6,106.8
"24346","78073","2015",189,48,141,225298.6,3196.19,70.30688
"24347","78076","2015",3,3,0,195286.7,1586.667,132.6667
"24348","78077","2015",12,12,0,254320.8,2299.833,116.1667
"24349","78082","2015",6,6,0,221416.7,2154.333,106.5
"24350","78084","2015",6,5,1,329525,3120,119.1667
"24351","78087","2015",16,16,0,256109.4,2422.75,106.8125
"24352","78089","2015",29,23,6,166019,2126.862,78.68966
"24353","78092","2015",103,26,77,366606.5,4311.534,81.56311
"24354","78096","2015",5,4,1,303800,2193.6,149.4
"24355","78104","2015",2,2,0,236500,3034,77
"24356","78107","2015",15,14,1,228910,2464.733,104.1333
"24357","78108","2015",14,8,6,270571.4,2683.929,110.5
"24358","78113","2015",6,6,0,235166.7,2173.5,106.8333
"24359","78117","2015",54,34,20,461728.1,4494.944,103.5926
"24360","78118","2015",24,23,1,237941.7,2799.667,99.125
"24361","78120","2015",17,17,0,308517.6,3195.353,105.7647
"24362","78123","2015",145,68,77,217603.1,3180.276,72.24138
"24363","78124","2015",168,66,102,330247.4,4687.167,72.10714
"24364","78125","2015",11,11,0,311792.7,2748.091,117.3636
"24365","78126","2015",189,63,126,416665.6,4342.757,91.80423
"24366","78128","2015",12,12,0,379275,3146.667,121
"24367","78133","2015",46,15,31,395364.5,3738.87,105.2826
"24368","78138","2015",59,48,11,221120.7,2846.525,83.55932
"24369","78140","2015",21,21,0,290967.1,3537.81,94.19048
"24370","78143","2015",21,20,1,520938.1,4086.667,131.0476
"24371","78146","2015",384,117,267,384677.6,4651.747,80.65885
"24372","78147","2015",3,3,0,197666.7,1963.667,100.6667
"24373","78152","2015",18,16,2,470543.3,3525.111,144.6111
"24374","78158","2015",211,45,166,429420.7,4929.858,86.20853
"24375","78160","2015",57,37,20,340592.1,3784.737,92.82456
"24376","78162","2015",4,4,0,475950,3609,133.25
"24377","78163","2015",5,5,0,288904,2519.6,119
"24378","78164","2015",5,3,2,352114,3023.4,128
"24379","78165","2015",194,71,123,225014.6,3043.216,75.40722
"24380","78168","2015",25,15,10,234253.7,3067.64,79.32
"24381","78171","2015",13,12,1,333588.5,2654.692,128.9231
"24382","78172","2015",397,233,164,252149.8,3502.476,74.19647
"24383","78185","2015",7,7,0,297073.7,2539.857,121.8571
"24384","78188","2015",4,2,2,152250,1899.5,84
"24385","78189","2015",21,19,2,441954.8,4074.762,118.4286
"24386","78190","2015",117,53,64,573966.4,5336.692,102.0256
"24387","78192","2015",15,13,2,223513.3,2214.067,106.8667
"24388","78193","2015",8,5,3,348142.5,3697.5,101.625
"24389","78196","2015",6,5,1,430666.7,2824.833,147.5
"24390","78202","2015",1,1,0,162000,1906,85
"24391","78208","2015",372,111,261,205874.9,2765.755,77.29839
"24392","78209","2015",10,10,0,342253,2611.9,138.6
"24393","78217","2015",59,48,11,229355.9,2895.932,85.25424
"24394","78220","2015",67,39,28,235240.3,2882.552,87.59701
"24395","78224","2015",56,33,23,471400.6,4667.446,107.4286
"24396","78227","2015",11,9,2,235054.3,2592.364,91.18182
"24397","78230","2015",4,4,0,230750,2313.75,99.25
"24398","78231","2015",2,2,0,264500,1819,147.5
"24399","78233","2015",19,18,1,490685.5,3796.737,137.1053
"24400","78234","2015",2,2,0,236500,1800.5,143
"24401","78236","2015",6,5,1,299000,3330.5,95.66667
"24402","78237","2015",2,2,0,234500,2191.5,107.5
"24403","78239","2015",9,9,0,233722.2,2434.889,105.4444
"24404","78242","2015",82,14,68,198809.1,3100.61,66.53659
"24405","78245","2015",4,4,0,202775,1268.25,154.25
"24406","78246","2015",11,10,1,216300.9,1983.091,106.6364
"24407","78255","2015",33,33,0,181492.4,2102.485,89.36364
"24408","78261","2015",4,4,0,201250,2192.5,91
"24409","78262","2015",8,6,2,253656.2,3820.875,77
"24410","78263","2015",29,28,1,316402.1,2669.724,124.8966
"24411","78264","2015",1,1,0,679000,3072,221
"24412","78265","2015",16,11,5,225581.2,3055,78.25
"24413","78267","2015",64,55,9,214643.3,2652.609,87.04688
"24414","78269","2015",9,8,1,400500,2962.222,138.3333
"24415","78276","2015",8,8,0,188375,1936.5,103.75
"24416","78278","2015",1,1,0,509401,3014,169
"24417","78281","2015",12,11,1,286670.8,2652,114.3333
"24418","78283","2015",3,3,0,235533.3,2526,96
"24419","78285","2015",5,4,1,243630,2455.6,118.2
"24420","78289","2015",5,5,0,768320,3669.6,197
"24421","78290","2015",9,9,0,177655.6,2062.444,85.44444
"24422","78291","2015",17,15,2,206680.9,2621.706,81.23529
"24423","78296","2015",2,2,0,180000,1997.5,91
"24424","78297","2015",209,44,165,260874.7,3543.426,75.55981
"24425","78299","2015",29,23,6,212672.4,3029,75.62069
"24426","78300","2015",7,5,2,207242.9,2505.286,85.14286
"24427","78302","2015",2,2,0,255000,2237,189
"24428","78305","2015",1,1,0,370000,4625,80
"24429","78307","2015",11,11,0,292640.9,3434.091,94.63636
"24430","78310","2015",46,23,23,199570.7,2864.5,71.91304
"24431","78311","2015",459,218,241,308905.4,4444.769,71.27015
"24432","78314","2015",35,30,5,192730,2512.2,80.6
"24433","78317","2015",11,11,0,266114.3,2328.091,115.1818
"24434","78320","2015",3,3,0,458333.3,2226,201.6667
"24435","78321","2015",56,49,7,326248.5,3222.946,106.7143
"24436","78322","2015",63,31,32,433968.9,4427.571,100.0159
"24437","78324","2015",9,9,0,248850,2844.667,89.77778
"24438","78325","2015",7,7,0,194100,2623,87.42857
"24439","78327","2015",45,38,7,231367.6,2712.622,89.51111
"24440","78329","2015",9,9,0,281622.2,2269.556,130.2222
"24441","78334","2015",14,14,0,296571.9,3157.214,97.78571
"24442","78335","2015",97,76,21,186004.4,2346.835,84.19588
"24443","78337","2015",12,11,1,232695.8,2003.5,115.4167
"24444","78343","2015",9,9,0,639600,4591.333,142.4444
"24445","78344","2015",5,5,0,197540,2058.2,97
"24446","78346","2015",25,22,3,225688.8,2273.48,103.56
"24447","78349","2015",5,5,0,348969.8,2678.8,127.4
"24448","78350","2015",62,20,42,423162.4,4288.516,99.08065
"24449","78354","2015",50,48,2,221473.5,2298.02,99.26
"24450","78356","2015",97,59,38,296606.9,3336.34,89.20619
"24451","78358","2015",370,112,258,415871.4,4916.476,84.18649
"24452","78361","2015",263,75,188,162972.9,2452.422,68.78327
"24453","78362","2015",161,100,61,178415.8,2456.876,75.68323
"24454","78364","2015",6,6,0,260583.3,2479.667,105.8333
"24455","78366","2015",4,4,0,341625,2941.25,121
"24456","78367","2015",42,29,13,514561.9,4379.452,116.3571
"24457","78368","2015",15,15,0,351699.1,3299.333,114.2667
"24458","78372","2015",245,39,206,297585.3,3821.486,77.66939
"24459","78380","2015",49,42,7,286766.3,3117.49,101.1429
"24460","78381","2015",7,6,1,260664.3,2818.429,101.1429
"24461","78382","2015",40,30,10,291661.5,3444.575,87.775
"24462","78383","2015",204,88,116,223521.4,2828.123,81.66176
"24463","78384","2015",15,15,0,417076.7,3479.933,114.6667
"24464","78385","2015",4,4,0,162025,1685.25,98
"24465","78389","2015",17,15,2,381236.5,3614,114.1765
"24466","78391","2015",3,3,0,161700,2342.333,70
"24467","78396","2015",59,34,25,432081.3,4360.051,99.59322
"24468","78397","2015",96,77,19,316368.7,2994.698,108.0312
"24469","78398","2015",7,7,0,564640,3334.429,177
"24470","78401","2015",105,38,67,154478.4,2535.371,62.6381
"24471","78402","2015",54,30,24,207538.3,2517.926,87.61111
"24472","78403","2015",25,21,4,231890,2518,96.28
"24473","78404","2015",2,2,0,380250,2789,139
"24474","78406","2015",3,3,0,418666.7,3444,121
"24475","78407","2015",1,1,0,267000,2207,121
"24476","78410","2015",18,18,0,163927.8,2010.667,89.72222
"24477","78413","2015",8,8,0,234735,1719.125,143.5
"24478","78415","2015",5,4,1,327300,2293.6,148
"24479","78416","2015",6,6,0,227500,2553.667,91.33333
"24480","78417","2015",3,3,0,354500,2402.333,159
"24481","78418","2015",177,90,87,355494,4221.695,86.16949
"24482","78420","2015",30,20,10,423300.5,3611.133,112.6333
"24483","78423","2015",408,136,272,284730.5,3562.667,81.68137
"24484","78431","2015",33,32,1,407364.2,3071.152,133.8182
"24485","78437","2015",7,7,0,247357.1,2308.571,111.5714
"24486","78439","2015",2,2,0,247500,1849,137
"24487","78440","2015",162,86,76,161288.3,2246.864,73.83333
"24488","78442","2015",64,22,42,241911.8,3366.5,76.15625
"24489","78444","2015",8,8,0,258675,2394.625,108.875
"24490","78451","2015",7,6,1,221700,2706.714,85.71429
"24491","78455","2015",63,47,16,511130.7,4138.937,124.5397
"24492","78460","2015",5,5,0,289664,2852.8,103
"24493","78464","2015",9,9,0,290047.8,2679.556,107.4444
"24494","78465","2015",18,18,0,247933.3,2468.278,110.2778
"24495","78466","2015",88,69,19,439034,3828.42,117.4205
"24496","78470","2015",14,12,2,222913.6,2313.786,109.2143
"24497","78472","2015",5,4,1,161400,1960.6,97.8
"24498","78474","2015",16,14,2,236000.6,2437.625,99.8125
"24499","78475","2015",5,5,0,228856,2183.2,119
"24500","78478","2015",2,2,0,178750,1792,96.5
"24501","78481","2015",180,38,142,323925.1,4182.278,77.40556
"24502","78484","2015",8,8,0,217572.1,2541.25,88
"24503","78486","2015",21,11,10,223211.9,3153,77.04762
"24504","78490","2015",336,126,210,224940.4,2891.03,80.14881
"24505","78497","2015",11,11,0,336782.3,2581.182,139.0909
"24506","78498","2015",331,64,267,234072,3515.166,67.02719
"24507","78499","2015",8,8,0,292000,2539.375,125
"24508","78501","2015",25,23,2,208456.1,2220.96,94.8
"24509","78502","2015",59,11,48,258148.6,3655.78,68.94915
"24510","78505","2015",4,4,0,202850,2328,89
"24511","78506","2015",12,12,0,235483.3,2143.833,116.3333
"24512","78513","2015",18,14,4,305155.6,3382.778,99.11111
"24513","78516","2015",17,17,0,320311.8,2494.176,132.2353
"24514","78517","2015",362,127,235,232705.7,3200.044,75.56354
"24515","78518","2015",1,1,0,250000,3571,70
"24516","78520","2015",6,6,0,294585,2944.667,103.6667
"24517","78522","2015",16,13,3,269656.2,2411.062,121.75
"24518","78530","2015",4,4,0,262375,2492.75,105.75
"24519","78531","2015",56,43,13,194743.2,2433,84.80357
"24520","78536","2015",4,4,0,191508,1820.5,105.25
"24521","78537","2015",67,50,17,241709.1,2850.731,89.52239
"24522","78545","2015",207,35,172,228441.4,3677.754,63.36715
"24523","78548","2015",3,3,0,429931.7,4122,105.6667
"24524","78550","2015",19,18,1,333262,3372,103.2105
"24525","78551","2015",505,101,404,427594.4,5225.198,81.71287
"24526","78557","2015",10,10,0,240854.1,2522.3,101
"24527","78558","2015",4,4,0,324450,1954.5,165
"24528","78559","2015",1,1,0,2e+05,2247,89
"24529","78561","2015",3,3,0,623666.7,3737,160
"24530","78562","2015",16,15,1,388350,2777.938,147.875
"24531","78564","2015",5,5,0,204740,2032.2,114.8
"24532","78565","2015",3,3,0,233333.3,2136,109.3333
"24533","78567","2015",12,11,1,259431,2455.167,108.5833
"24534","78569","2015",21,15,6,228498.9,2398.857,96.85714
"24535","78571","2015",61,52,9,649378.8,4413.77,151.1148
"24536","78575","2015",72,60,12,387098.2,3901.889,103.2222
"24537","78576","2015",17,12,5,324538.8,3344.941,103.7059
"24538","78586","2015",550,237,313,262111.9,3740.831,73.33273
"24539","78588","2015",10,10,0,307137,2540,125.4
"24540","78590","2015",4,3,1,289481.5,2869.75,102.75
"24541","78591","2015",21,18,3,211864.3,2239.333,104.8571
"24542","78597","2015",4,4,0,271875,2750,101.75
"24543","78601","2015",25,20,5,239358.2,2422.44,106.36
"24544","78605","2015",8,8,0,276666.6,3166,95
"24545","78608","2015",1,1,0,244000,2122,115
"24546","78609","2015",11,11,0,226422.7,2306.364,103.8182
"24547","78615","2015",6,4,2,182432.5,2483.667,76.66667
"24548","78616","2015",14,11,3,284978.6,3046.571,104.3571
"24549","78618","2015",3,3,0,281000,1987.333,148.3333
"24550","78620","2015",6,4,2,435992.2,3506.5,124.1667
"24551","78621","2015",146,29,117,173420.8,2599.027,70.61644
"24552","78624","2015",161,112,49,259042.6,3094.342,88.8882
"24553","78638","2015",46,36,10,255787,3020,89.52174
"24554","78640","2015",163,32,131,316926.2,4061.239,78.41718
"24555","78642","2015",166,91,75,275019,3143.801,90.40361
"24556","78643","2015",102,77,25,313103.5,3251.892,99.80392
"24557","78644","2015",25,19,6,235970.8,3310.92,73.2
"24558","78646","2015",903,92,811,430288.5,5546.859,77.10853
"24559","78647","2015",10,10,0,232210,2593.9,94.6
"24560","78650","2015",265,104,161,533952.4,5563.555,91.81887
"24561","78655","2015",3,3,0,336000,4122,88
"24562","78668","2015",5,4,1,180600,2615.4,69.4
"24563","78672","2015",52,39,13,489549.9,4047.442,120.5385
"24564","78674","2015",103,81,22,263849.6,3315.301,81.54369
"24565","78677","2015",3,3,0,242000,2511.667,100.3333
"24566","78681","2015",6,6,0,268825,2943.333,96.16667
"24567","78686","2015",206,72,134,416970,5195.714,77.16019
"24568","78688","2015",131,88,43,390954.2,3939.511,100.8473
"24569","79001","2015",10,10,0,63200,722.3,96.6
"24570","79002","2015",3,3,0,170166.7,945.6667,150.3333
"24571","79003","2015",46,45,1,164601.5,1591.913,110.3696
"24572","79005","2015",30,30,0,105418.1,1007.467,107.8333
"24573","79007","2015",3,3,0,95466.67,972,101.3333
"24574","79008","2015",7,7,0,105870.7,969.1429,116
"24575","79009","2015",2,2,0,149000,1155,133
"24576","79010","2015",10,10,0,103500,1127.3,90.1
"24577","79012","2015",17,17,0,122415.6,1125.471,112.1176
"24578","79013","2015",23,23,0,84500,877.3478,94.3913
"24579","79014","2015",7,7,0,93992.43,1006,95.85714
"24580","79015","2015",1,1,0,75000,721,104
"24581","79016","2015",6,6,0,57563.33,692.6667,82.5
"24582","79018","2015",2,2,0,35500,444.5,80.5
"24583","79019","2015",1,1,0,20000,556,36
"24584","79020","2015",7,7,0,76000,739.1429,109.4286
"24585","79022","2015",1,1,0,50000,758,66
"24586","79023","2015",1,1,0,55000,550,100
"24587","79024","2015",17,17,0,142441.2,1254.765,112.8235
"24588","79025","2015",8,8,0,90800,962,90.25
"24589","79029","2015",6,6,0,79568.17,953.1667,83
"24590","79030","2015",10,10,0,116100,1024.9,122.4
"24591","79031","2015",24,23,1,139974.6,1164.042,120.375
"24592","79032","2015",3,3,0,156333.3,932.6667,167.6667
"24593","79034","2015",13,13,0,177553.8,1572.769,110.7692
"24594","79038","2015",13,12,1,85576.92,844,105
"24595","79040","2015",1,1,0,57000,1583,36
"24596","79042","2015",2,2,0,81500,587,127.5
"24597","79046","2015",6,6,0,100500,1201.667,83
"24598","79047","2015",6,6,0,77750,754.1667,110.8333
"24599","79048","2015",62,61,1,144237.4,1371.581,108.4677
"24600","79049","2015",152,142,10,108624.5,1149.888,95.02632
"24601","79050","2015",5,4,1,104400,977,107.2
"24602","79056","2015",5,5,0,109924,997.6,115.2
"24603","79057","2015",9,9,0,106093.2,1129.333,95.11111
"24604","79058","2015",8,8,0,92125,1001,87
"24605","79059","2015",7,7,0,72571.43,761.7143,97.28571
"24606","79060","2015",1,1,0,132700,1382,96
"24607","79061","2015",33,33,0,132984.8,1170.212,116.2424
"24608","79062","2015",36,34,2,98094.44,1008.083,95.58333
"24609","79063","2015",22,22,0,103272.7,963.5909,114.1818
"24610","79064","2015",1,1,0,47500,500,95
"24611","79066","2015",21,21,0,97623.33,914.1429,111.2381
"24612","79069","2015",10,10,0,81154,762.6,106.4
"24613","79070","2015",4,4,0,107500,1180.25,91
"24614","79071","2015",6,6,0,113833.3,966.1667,110.5
"24615","79074","2015",1,1,0,60000,435,138
"24616","79076","2015",17,17,0,107594.1,992,113.6471
"24617","79077","2015",14,14,0,95839.29,951.7143,105.1429
"24618","79078","2015",7,7,0,137428.6,980.7143,142.8571
"24619","79079","2015",61,61,0,112037.7,1107.787,98.63934
"24620","79080","2015",18,18,0,128138.9,1232.056,103.2222
"24621","79081","2015",44,44,0,162775.9,1613.523,102.4318
"24622","79083","2015",16,16,0,95962.5,979,103.5
"24623","79084","2015",6,6,0,87500,719.3333,124.3333
"24624","79085","2015",1,1,0,120000,1121,107
"24625","79086","2015",15,15,0,153673.1,1203.933,126.6
"24626","79087","2015",5,5,0,74100,834,90
"24627","79088","2015",13,13,0,111765.4,1122.308,100.7692
"24628","79090","2015",12,12,0,104625,831.3333,124.3333
"24629","79091","2015",4,4,0,118580,840,135
"24630","79092","2015",4,4,0,86250,1259,76
"24631","79094","2015",11,11,0,92363.64,877,102.4545
"24632","79095","2015",10,10,0,91346,975.4,105.5
"24633","79096","2015",4,4,0,105390,1005.5,115.5
"24634","79100","2015",29,29,0,161386.9,1573.241,108.3448
"24635","79101","2015",30,30,0,122916.7,1035.067,115.4
"24636","79102","2015",1,1,0,125000,625,200
"24637","79103","2015",21,21,0,76809.29,803.9048,96.52381
"24638","79104","2015",1,1,0,260000,1300,200
"24639","79105","2015",4,4,0,111625,1034,108.75
"24640","79106","2015",4,4,0,71518.75,782,97.25
"24641","79108","2015",3,3,0,69620,714,95.66667
"24642","79109","2015",16,16,0,131211.9,1380.562,93.1875
"24643","79111","2015",7,7,0,78214.29,638.4286,122.5714
"24644","79112","2015",10,10,0,151791.2,1180.7,128.3
"24645","79114","2015",14,14,0,135527.9,1196.929,118.5714
"24646","79115","2015",6,6,0,87583.33,738,114.6667
"24647","79116","2015",7,7,0,87085.71,955.4286,90.71429
"24648","79117","2015",4,4,0,117250,1259,91.75
"24649","79118","2015",3,3,0,83666.67,1126.667,85
"24650","79119","2015",9,9,0,89222.22,876.1111,100.7778
"24651","79120","2015",10,10,0,68020,725,91.9
"24652","79121","2015",2,2,0,104000,988,110
"24653","79122","2015",8,8,0,85550,931.625,91.375
"24654","79123","2015",22,22,0,90982.95,946.3182,95.45455
"24655","79124","2015",4,3,1,118000,1143,105.25
"24656","79125","2015",20,20,0,130948,1211.65,107.45
"24657","79126","2015",3,3,0,101500,1194.667,86.33333
"24658","79127","2015",4,4,0,186100,1208.25,157.75
"24659","79128","2015",6,6,0,163250,1450,114
"24660","79129","2015",21,21,0,137300.9,1347.762,103.381
"24661","79130","2015",35,35,0,156635.7,1334.8,114.6857
"24662","79131","2015",5,5,0,97550,1040.2,98.6
"24663","79132","2015",2,2,0,53750,485,112.5
"24664","79133","2015",12,12,0,148699.6,1285.75,114
"24665","79134","2015",5,5,0,111876,1122.2,101.2
"24666","79135","2015",9,9,0,93207.89,824.1111,115.3333
"24667","79136","2015",12,12,0,113479.2,850.5833,142.1667
"24668","79137","2015",4,4,0,110625,1165,97.25
"24669","79140","2015",3,3,0,234700,1237.333,142.3333
"24670","79141","2015",4,4,0,92000,954.25,91.5
"24671","79142","2015",1,1,0,45000,333,135
"24672","79144","2015",2,2,0,119000,783,158.5
"24673","79145","2015",3,3,0,104333.3,1042,102.3333
"24674","79147","2015",8,8,0,82562.5,735,111.625
"24675","79148","2015",19,19,0,99010.53,1023.842,101.1579
"24676","79149","2015",2,2,0,79250,629,126.5
"24677","79150","2015",7,7,0,82928.57,964,98.28571
"24678","79152","2015",10,10,0,98195,840.6,109.1
"24679","79153","2015",2,2,0,94000,707,127.5
"24680","79154","2015",8,8,0,78025,895.625,99.125
"24681","79156","2015",4,4,0,93500,947.5,95.25
"24682","79157","2015",13,13,0,94615.38,1007.923,94.76923
"24683","79158","2015",2,2,0,65000,629.5,102
"24684","79159","2015",2,2,0,105000,1153.5,91
"24685","79160","2015",4,4,0,71000,1093.25,63.75
"24686","79161","2015",8,8,0,90000,859,99
"24687","79162","2015",20,20,0,145530,1511.45,100.8
"24688","79163","2015",7,7,0,76903.57,833.4286,98.57143
"24689","79164","2015",3,3,0,121628.3,1154,106
"24690","79165","2015",1,1,0,33000,611,54
"24691","79166","2015",6,6,0,115333.3,1160.167,93.66667
"24692","79167","2015",2,2,0,99000,964,94
"24693","79170","2015",25,25,0,148884,1581.84,93.92
"24694","79172","2015",6,6,0,100058.3,1026,100.8333
"24695","79174","2015",36,35,1,105012.5,986.25,104.0833
"24696","79175","2015",9,9,0,104088.9,886.1111,116.1111
"24697","79176","2015",16,16,0,125763.1,984.125,117.375
"24698","79177","2015",1,1,0,40000,460,87
"24699","79179","2015",37,37,0,84482.11,836.6486,100
"24700","79180","2015",1,1,0,193100,1822,106
"24701","79183","2015",4,4,0,98300,1280.25,76.75
"24702","79184","2015",19,19,0,89638.21,814.1579,113.5789
"24703","79185","2015",45,45,0,149288.2,1320.689,115.2222
"24704","79189","2015",20,20,0,109870.8,1148.85,96.4
"24705","79190","2015",6,6,0,65166.67,710.3333,88.16667
"24706","79191","2015",824,601,223,122291.4,1465.633,83.83738
"24707","79195","2015",40,40,0,97396.75,981.275,101.475
"24708","79196","2015",27,27,0,92808.67,895.1852,103.8889
"24709","79198","2015",2,2,0,77500,811.5,105
"24710","79200","2015",2,2,0,91745,855,108.5
"24711","79201","2015",23,23,0,99421.52,872.5217,115.1304
"24712","79202","2015",123,106,17,95457.73,1053.756,89.7561
"24713","79203","2015",1,1,0,31700,391,81
"24714","79204","2015",12,12,0,105166.7,1040.833,104.8333
"24715","79205","2015",2,2,0,46755,487,91.5
"24716","79207","2015",4,4,0,95125,1004,94.5
"24717","79208","2015",13,13,0,82070.77,910.9231,93.53846
"24718","79209","2015",3,3,0,48500,689,68.66667
"24719","79210","2015",7,7,0,115900,1138.857,105.4286
"24720","79212","2015",3,3,0,75666.67,800.3333,89
"24721","79213","2015",18,18,0,111850,1087.389,105.5
"24722","79215","2015",1,1,0,20000,741,27
"24723","79216","2015",13,13,0,136440.8,1331.538,103
"24724","79217","2015",9,9,0,104609.7,939.3333,115.3333
"24725","79218","2015",4,4,0,100528.8,875.25,129.25
"24726","79220","2015",4,4,0,134787.5,1065.25,119.75
"24727","79225","2015",2,2,0,52500,511.5,108.5
"24728","79226","2015",3,3,0,138166.7,1036,132.6667
"24729","79229","2015",10,10,0,171660.5,1232.2,136.2
"24730","79230","2015",15,15,0,119508.7,1023.867,115.0667
"24731","79231","2015",7,7,0,138439.3,1178.286,117.1429
"24732","79235","2015",6,6,0,134500,1097.667,113
"24733","79236","2015",6,6,0,91833.33,967.5,103
"24734","79238","2015",2,2,0,74500,845,87
"24735","79239","2015",17,17,0,127131.8,1172.294,103.6471
"24736","79241","2015",7,7,0,147625.7,1198.857,147.4286
"24737","79242","2015",7,7,0,98000,940.5714,106
"24738","79243","2015",1,1,0,201000,1026,196
"24739","79244","2015",5,5,0,97800,1149.4,114.4
"24740","79246","2015",3,3,0,89833.33,1124.333,79
"24741","79249","2015",24,24,0,169445.2,1619.167,104.125
"24742","79250","2015",3,3,0,95361.67,759.3333,134
"24743","79251","2015",5,5,0,95950,1152,98
"24744","79252","2015",4,4,0,104500,945.75,104
"24745","79253","2015",3,3,0,129166.7,1388,92.66667
"24746","79254","2015",5,5,0,107000,1153.6,95.2
"24747","79255","2015",2,2,0,110500,992.5,111.5
"24748","79256","2015",2,2,0,79920,843,93.5
"24749","79257","2015",17,17,0,121334.4,1179.941,106.6471
"24750","79258","2015",5,5,0,79200,882,86.2
"24751","79259","2015",9,9,0,115282.2,1317.556,85.77778
"24752","79263","2015",7,7,0,101214.3,945,113.2857
"24753","79265","2015",5,5,0,115700,951.4,122.8
"24754","79267","2015",5,5,0,66480.2,557.4,118
"24755","79268","2015",11,11,0,96127.27,924.0909,108.8182
"24756","79269","2015",5,5,0,76360,731.8,106
"24757","79270","2015",60,58,2,109827.9,1066.183,104.1167
"24758","79273","2015",9,9,0,149944.4,1391.889,108.7778
"24759","79274","2015",3,3,0,98166.67,906,102
"24760","79276","2015",15,15,0,145268.7,1354.067,114.2
"24761","79277","2015",13,13,0,106892.3,1130.846,96.15385
"24762","79278","2015",3,3,0,104000,712.3333,140.3333
"24763","79280","2015",9,9,0,86722.22,897.1111,96
"24764","79281","2015",8,8,0,134094.4,1210.125,107.125
"24765","79283","2015",14,14,0,148728.6,1476.429,106.5714
"24766","79284","2015",11,11,0,127754.1,1236.364,105.3636
"24767","79285","2015",16,16,0,108406.2,1009.375,115.5625
"24768","79286","2015",2,2,0,119700,752.5,164
"24769","79289","2015",17,17,0,102117.6,1107.235,92.76471
"24770","79290","2015",12,12,0,94716.67,956.4167,108
"24771","79293","2015",5,4,1,98800,964,107.6
"24772","79294","2015",1,1,0,69500,732,95
"24773","79295","2015",8,8,0,98187.5,969.625,115.125
"24774","79297","2015",4,4,0,65750,872.5,66.75
"24775","79298","2015",17,17,0,146329.4,1325.706,110.3529
"24776","79299","2015",16,16,0,100087.5,999.875,101.5625
"24777","79300","2015",14,14,0,111357.1,1131.714,96.71429
"24778","79301","2015",7,7,0,130989.3,1184,99.85714
"24779","79302","2015",13,13,0,137666.2,1329.769,103
"24780","79303","2015",2,2,0,114800,921,129.5
"24781","79304","2015",6,6,0,119500,1077.833,107
"24782","79307","2015",12,12,0,84166.67,890.6667,93.91667
"24783","79308","2015",5,5,0,188160,1422.8,128.4
"24784","79309","2015",6,6,0,90537.83,1193.667,76.16667
"24785","79310","2015",4,4,0,73312.5,867.75,86.75
"24786","79311","2015",13,13,0,80403.46,838.6923,90.15385
"24787","79312","2015",1,1,0,73000,608,120
"24788","79313","2015",7,7,0,118357.1,1009.857,125.8571
"24789","79316","2015",2,2,0,45750,403,114
"24790","79319","2015",3,3,0,93800,860,111.3333
"24791","79320","2015",5,5,0,65800,802,81.6
"24792","79322","2015",13,12,1,125762.3,1077.231,116.6923
"24793","79326","2015",14,14,0,76107.14,702.0714,106.0714
"24794","79329","2015",134,124,10,89595.78,965.4104,91.64925
"24795","79331","2015",2,2,0,53250,434,115.5
"24796","79332","2015",2,2,0,144250,1298,113
"24797","79334","2015",7,7,0,119714.3,1265.857,97.85714
"24798","79335","2015",3,3,0,75000,1076.333,72.66667
"24799","79336","2015",2,2,0,105000,1272,86
"24800","79337","2015",9,9,0,106284.7,1159.333,95.11111
"24801","79338","2015",1,1,0,94000,671,140
"24802","79339","2015",18,18,0,76554,849.7778,94.83333
"24803","79340","2015",4,4,0,90500,641,134.75
"24804","79341","2015",1,1,0,265000,1472,180
"24805","79342","2015",8,8,0,79284.62,970.75,82.375
"24806","79343","2015",2,2,0,42500,458.5,91
"24807","79345","2015",11,11,0,96858.18,1052.818,102.1818
"24808","79346","2015",1,1,0,107000,982,109
"24809","79347","2015",1,1,0,154000,1400,110
"24810","79348","2015",4,4,0,84562.5,1076.5,82.5
"24811","79349","2015",2,2,0,61225,688.5,96
"24812","79350","2015",2,2,0,127500,1058,121
"24813","79351","2015",15,15,0,131560,1316.467,99.33333
"24814","79352","2015",2,2,0,121600,1035,123
"24815","79354","2015",6,6,0,90666.67,1226.167,84
"24816","79355","2015",40,30,10,147093.8,2251.225,89.4
"24817","79357","2015",1,1,0,60000,513,117
"24818","80001","2015",197,163,34,124042.4,1465.873,85.7868
"24819","80002","2015",3,3,0,90666.67,763.3333,122.3333
"24820","80003","2015",8,8,0,158125,1286.875,131.625
"24821","80006","2015",5,5,0,138400,1193.4,125
"24822","80008","2015",4,4,0,115975,1146,112
"24823","80009","2015",4,4,0,145500,1349.25,115.5
"24824","80010","2015",21,21,0,146584.8,1527.095,102.0952
"24825","80011","2015",25,25,0,108042.4,1301.2,82.12
"24826","80013","2015",14,14,0,115032.6,1120.643,106
"24827","80016","2015",109,96,13,106639.8,1329.523,82.81651
"24828","80017","2015",4,4,0,61250,1043.75,62
"24829","80019","2015",4,4,0,70750,779.5,92.75
"24830","80020","2015",4,4,0,249750,2005.5,135
"24831","80021","2015",1328,796,532,148935.1,2107.837,73.36521
"24832","80023","2015",5,5,0,107600,1247.4,92.8
"24833","80024","2015",5,5,0,168720,1611,105
"24834","80025","2015",4,4,0,127125,1844,75.25
"24835","80028","2015",3,3,0,146666.7,1263,114.3333
"24836","80029","2015",5,5,0,108460,1166,92.8
"24837","80030","2015",5,5,0,131100,1649,75.6
"24838","80031","2015",5,5,0,124870,1218.2,97.8
"24839","80032","2015",3,3,0,95666.67,1288,70.66667
"24840","80033","2015",4,4,0,141272.5,1038.25,124.75
"24841","80034","2015",6,6,0,103333.3,923.8333,112.8333
"24842","80036","2015",10,10,0,153985.3,1459.4,105.6
"24843","80038","2015",3,3,0,151900,1124.333,131
"24844","80039","2015",49,35,14,102537.7,1388.184,78.26531
"24845","80040","2015",2,2,0,171000,1223,140
"24846","80042","2015",1,1,0,1e+05,794,126
"24847","80043","2015",2,2,0,146000,971.5,147
"24848","80044","2015",1,1,0,20000,400,50
"24849","80045","2015",1,1,0,80000,2353,34
"24850","80046","2015",1,1,0,115000,1438,80
"24851","80047","2015",5,5,0,76460,1238.6,64
"24852","80048","2015",2,2,0,103000,1827.5,84
"24853","80050","2015",4,4,0,218625,2254.5,102.25
"24854","80052","2015",1,1,0,110000,1183,93
"24855","80053","2015",1,1,0,119000,1092,109
"24856","80054","2015",1,1,0,56000,615,91
"24857","80055","2015",2,2,0,69000,877,78.5
"24858","80057","2015",1,1,0,95000,1067,89
"24859","80058","2015",4,4,0,83250,1191.25,79.75
"24860","80059","2015",1,1,0,140000,1573,89
"24861","80060","2015",2,2,0,42500,785,53.5
"24862","80061","2015",2,2,0,111500,1095,98.5
"24863","80062","2015",13,13,0,79321.69,872,89.38462
"24864","80063","2015",8,8,0,107125,1098.625,100.375
"24865","80064","2015",2,2,0,125000,1034,119
"24866","80065","2015",1,1,0,132000,1517,87
"24867","80066","2015",2,2,0,185700,1803,108.5
"24868","80067","2015",1,1,0,54000,551,98
"24869","80068","2015",5,5,0,85600,1059.4,87.8
"24870","80069","2015",4,4,0,190217.5,2122,104.25
"24871","80070","2015",10,10,0,127520,1249,114.7
"24872","80071","2015",13,13,0,101500,1042.385,99.76923
"24873","80074","2015",1,1,0,130000,1066,122
"24874","80076","2015",7,7,0,126785.7,1265.571,103
"24875","80078","2015",1,1,0,200500,1874,107
"24876","80079","2015",2,2,0,55000,893,60.5
"24877","80080","2015",4,4,0,65125,823.75,80.5
"24878","80081","2015",3,3,0,75000,736,105.3333
"24879","80082","2015",8,8,0,140018.8,1295.875,108.375
"24880","80084","2015",6,6,0,106250,1381.167,76.16667
"24881","80085","2015",1,1,0,144000,1007,143
"24882","80086","2015",6,6,0,113666.7,1223.5,92.5
"24883","80088","2015",7,7,0,88360.71,1050.571,83.57143
"24884","80092","2015",4,4,0,181375,1974.5,94.25
"24885","80093","2015",11,11,0,102272.7,1308.091,80.45455
"24886","80094","2015",1,1,0,48000,960,50
"24887","80095","2015",3,3,0,71333.33,997.3333,68
"24888","80096","2015",2,2,0,106250,1102.5,97.5
"24889","80097","2015",1,1,0,110000,786,140
"24890","80098","2015",1,1,0,140000,1414,99
"24891","80099","2015",3,3,0,156000,1322,113
"24892","80100","2015",6,6,0,168000,1615.667,110.6667
"24893","80101","2015",12,12,0,116675,1248.5,98.91667
"24894","80102","2015",5,5,0,59600,959.8,63.4
"24895","80103","2015",2,2,0,122000,1188,105.5
"24896","80105","2015",4,4,0,146875,1610,116
"24897","80106","2015",1,0,1,51000,1275,40
"24898","80107","2015",11,11,0,189045.5,1741.545,111.5455
"24899","80109","2015",3,3,0,95900,1390,68.66667
"24900","80110","2015",9,9,0,124935.8,1683.667,73.55556
"24901","80112","2015",3,3,0,105000,1358,74.66667
"24902","80113","2015",2,2,0,75000,857,85
"24903","80114","2015",2,2,0,95000,833.5,112.5
"24904","80115","2015",4,4,0,111950.2,1105,107
"24905","80116","2015",2,2,0,87780,793,121.5
"24906","80118","2015",1,1,0,90000,978,92
"24907","80119","2015",4,4,0,95000,1031.75,95.75
"24908","80120","2015",5,5,0,130700,1081,117.6
"24909","80121","2015",2,2,0,162275,2330,74.5
"24910","80122","2015",3,3,0,120666.7,1321.667,86
"24911","80123","2015",2,2,0,160000,978.5,169.5
"24912","80124","2015",7,7,0,169725.4,1265.286,132.7143
"24913","80127","2015",8,8,0,126800,1292.875,101.125
"24914","80128","2015",1,1,0,156000,1418,110
"24915","80129","2015",6,6,0,104444.5,1389.5,89.33333
"24916","80130","2015",6,6,0,194833.3,1475.167,130.5
"24917","80131","2015",36,36,0,215486.1,2375.194,102.5556
"24918","80132","2015",2,2,0,134750,1479.5,92
"24919","80133","2015",2,2,0,75000,662,123
"24920","80135","2015",2,2,0,89000,1407.5,68.5
"24921","80136","2015",14,14,0,149792.9,2088.786,71.14286
"24922","80137","2015",4,4,0,106000,1154.75,92.75
"24923","80140","2015",3,3,0,105000,1002.667,103.3333
"24924","80141","2015",4,4,0,84675,1082.5,79.5
"24925","80143","2015",1,1,0,135300,1340,101
"24926","80144","2015",4,4,0,107637.5,1307.5,82.5
"24927","80145","2015",1,1,0,65000,1066,61
"24928","80146","2015",3,3,0,65000,1114,61.33333
"24929","80147","2015",3,3,0,132433.3,1271.667,108.6667
"24930","80148","2015",1,1,0,220000,1833,120
"24931","80149","2015",4,4,0,155062.5,1537,103
"24932","80150","2015",2,2,0,130000,1221,108.5
"24933","80151","2015",3,3,0,104666.7,941.3333,112.3333
"24934","80152","2015",5,5,0,121600,1810.2,69.8
"24935","80153","2015",2,2,0,110050,994,110.5
"24936","80154","2015",2,2,0,120000,1291,90.5
"24937","80155","2015",4,4,0,127125,952.75,126.75
"24938","80156","2015",3,3,0,241816.7,2068,118.6667
"24939","80157","2015",2,2,0,141875,1688.5,84.5
"24940","80159","2015",1,1,0,231250,1086,213
"24941","80160","2015",15,15,0,217522.7,2062.067,105.2667
"24942","80161","2015",1,1,0,170000,1889,90
"24943","80162","2015",14,14,0,112071.4,1333.571,95.28571
"24944","80163","2015",5,5,0,106181,1521.8,70.8
"24945","80164","2015",38,37,1,214812.5,2396.342,91.92105
"24946","80166","2015",5,5,0,138800,1677.6,82.6
"24947","80167","2015",4,4,0,150050,1713.25,95.25
"24948","80168","2015",3,3,0,105666.7,1592.333,71.33333
"24949","80169","2015",2,2,0,58500,869,67.5
"24950","80171","2015",3,3,0,120000,1241,94.66667
"24951","80172","2015",10,10,0,75900,829.2,90.6
"24952","80173","2015",5,5,0,191080,1910.2,106.4
"24953","80176","2015",1,1,0,129000,1433,90
"24954","80177","2015",9,9,0,122361.1,993.5556,126.2222
"24955","80179","2015",1,1,0,134000,1634,82
"24956","80181","2015",3,3,0,118333.3,1363,97.66667
"24957","80182","2015",79,69,10,103646.8,1664.228,66.22785
"24958","80183","2015",3,3,0,163333.3,1460.667,121
"24959","80184","2015",6,6,0,104716.7,1568.333,70.33333
"24960","80185","2015",2,2,0,154750,1768.5,120
"24961","80186","2015",7,7,0,77633.57,705.7143,108
"24962","80187","2015",7,7,0,122392.9,1157.857,111.4286
"24963","80188","2015",4,4,0,161592.5,1843.5,89
"24964","80189","2015",1,1,0,160000,879,182
"24965","80190","2015",8,8,0,97750,1302.75,78.25
"24966","80191","2015",1,1,0,110000,1375,80
"24967","80192","2015",2,2,0,214175,2017,110
"24968","80193","2015",4,4,0,150750,951.25,160.25
"24969","80194","2015",1,1,0,45000,405,111
"24970","80197","2015",1,1,0,56500,819,69
"24971","80198","2015",2,2,0,229000,2296.5,102
"24972","80199","2015",8,8,0,84705.75,1023,84.5
"24973","80200","2015",2,2,0,183500,1351,117
"24974","80201","2015",1,1,0,115000,1045,110
"24975","80202","2015",2,2,0,218097,1834.5,119
"24976","80204","2015",5,5,0,99480,1042.2,97.6
"24977","80205","2015",7,7,0,125714.3,1939.714,71.57143
"24978","80206","2015",1,1,0,40000,615,65
"24979","80207","2015",2,2,0,149000,1188.5,125.5
"24980","80210","2015",2,2,0,212500,2039,104.5
"24981","80211","2015",7,7,0,112871.4,1217.714,93.85714
"24982","80212","2015",64,58,6,120540.7,1397.578,85.73438
"24983","80213","2015",6,6,0,171000,1848.333,103.1667
"24984","80214","2015",4,4,0,91750,1028.5,86.5
"24985","80215","2015",2,2,0,112000,1320.5,89.5
"24986","80216","2015",1,1,0,45000,750,60
"24987","80217","2015",1,1,0,165000,1650,100
"24988","80221","2015",3,3,0,60166.67,997.3333,55
"24989","80222","2015",9,9,0,123266.7,1692,79.33333
"24990","80224","2015",3,3,0,118833.3,1137.667,105.3333
"24991","80225","2015",2,2,0,215000,1735,124
"24992","80226","2015",2,2,0,78400,1116,75
"24993","80227","2015",5,5,0,100100.2,1107.4,90
"24994","80228","2015",80,62,18,160223.9,2796.325,62.4125
"24995","80229","2015",7,3,4,117907.1,1240,99.57143
"24996","80230","2015",4,4,0,140125,1189.5,135
"24997","80231","2015",1,1,0,80000,792,101
"24998","80232","2015",1,1,0,71500,841,85
"24999","80233","2015",2,2,0,107000,916.5,121
"25000","80234","2015",3,3,0,116000,1702,68
"25001","80235","2015",14,13,1,94478.57,1053,92.78571
"25002","80236","2015",10,10,0,96800,1198.9,77.5
"25003","80237","2015",7,7,0,132250,1337.143,100.1429
"25004","80238","2015",7,7,0,140900,1637.857,88
"25005","80240","2015",19,19,0,111343.7,1169.421,92.47368
"25006","80241","2015",7,7,0,93000,1091.286,89.28571
"25007","80242","2015",3,3,0,173756.7,1765,99.66667
"25008","80244","2015",5,5,0,78920,1390.2,64.4
"25009","80245","2015",4,4,0,150000,1393.25,107
"25010","80246","2015",1,1,0,174680,1747,100
"25011","80247","2015",5,5,0,96000,1302,95.6
"25012","80248","2015",6,6,0,131966.7,1298.333,103
"25013","80249","2015",5,5,0,81364,998,87.2
"25014","80250","2015",5,5,0,167560,1542.6,106.8
"25015","80251","2015",3,3,0,120000,1198,104
"25016","80252","2015",1,1,0,70000,761,92
"25017","80253","2015",39,34,5,100285.9,1145.179,88.64103
"25018","80256","2015",16,14,2,149378.1,1862.188,82.875
"25019","80259","2015",1,1,0,48000,727,66
"25020","80260","2015",6,6,0,192666.7,1725.333,113
"25021","80261","2015",13,13,0,251507.7,2199.385,116.2308
"25022","80262","2015",2,2,0,185305,1894.5,102
"25023","80264","2015",2,2,0,46500,1115,45.5
"25024","80265","2015",6,6,0,129616.7,1471.833,83.5
"25025","80266","2015",3,3,0,113100,1022.333,123.3333
"25026","80267","2015",2,2,0,76950,1251,58
"25027","80268","2015",6,6,0,156958.3,1394.5,109
"25028","80269","2015",2,2,0,62812.5,913.5,69
"25029","80271","2015",11,11,0,96527.27,1028.182,96.45455
"25030","80272","2015",2,2,0,105750,977,108.5
"25031","80273","2015",2,2,0,178500,1672,111
"25032","80274","2015",11,11,0,83000,983.1818,88.18182
"25033","80275","2015",1,1,0,65000,929,70
"25034","80278","2015",2,2,0,135162,1872.5,73
"25035","80279","2015",4,4,0,63500,1218.5,72
"25036","80280","2015",2,2,0,148100,1342.5,107.5
"25037","80282","2015",4,4,0,109250,1348,90
"25038","80284","2015",10,10,0,92200,962.8,97.1
"25039","80285","2015",1,1,0,150000,1087,138
"25040","80287","2015",2,2,0,60000,1301.5,64.5
"25041","80290","2015",3,3,0,190666.7,1755,96
"25042","80291","2015",2,2,0,237500,2180,108.5
"25043","80293","2015",1,1,0,20000,667,30
"25044","80294","2015",1,1,0,48000,828,58
"25045","80295","2015",6,6,0,112709.2,1180.333,98.5
"25046","80296","2015",7,7,0,88285.71,1081,83.71429
"25047","80297","2015",1,1,0,167000,1084,154
"25048","80298","2015",3,3,0,106000,1971.667,77.66667
"25049","80299","2015",3,3,0,107666.7,1149.333,88.66667
"25050","80300","2015",1,1,0,80000,842,95
"25051","80301","2015",3,3,0,173666.7,1080.667,154.3333
"25052","80302","2015",1,1,0,75000,987,76
"25053","80303","2015",1,1,0,220000,2588,85
"25054","80305","2015",5,5,0,247586,1761,128
"25055","80306","2015",1,1,0,40000,976,41
"25056","80307","2015",3,3,0,191333.3,1981.667,104.6667
"25057","80308","2015",14,14,0,128142.9,1484.429,89.21429
"25058","80310","2015",6,6,0,81166.67,994,82.5
"25059","80311","2015",1,1,0,35000,449,78
"25060","80312","2015",3,3,0,111666.7,733.3333,154
"25061","80314","2015",3,3,0,98666.67,875.3333,110.3333
"25062","80315","2015",6,6,0,207116.7,1749.833,120.3333
"25063","80316","2015",14,14,0,149274.3,1574.357,97.14286
"25064","80318","2015",21,21,0,111714.3,1177.381,90.71429
"25065","80320","2015",1,1,0,164000,2278,72
"25066","80321","2015",1,1,0,75000,1705,44
"25067","80322","2015",1,1,0,130000,1940,67
"25068","80324","2015",1,1,0,1e+05,1818,55
"25069","80326","2015",1,1,0,140000,1085,129
"25070","80328","2015",8,8,0,75937.5,1105.75,70.125
"25071","80329","2015",2,2,0,1e+05,1224.5,78.5
"25072","80330","2015",1,1,0,113500,1419,80
"25073","80331","2015",2,2,0,130000,1140,125
"25074","80332","2015",1,1,0,117000,1393,84
"25075","80333","2015",99,29,70,142234.2,3228.354,48
"25076","80334","2015",1,1,0,248000,1699,146
"25077","80335","2015",1,1,0,250000,1116,224
"25078","80337","2015",3,3,0,157333.3,2088.667,86.33333
"25079","80338","2015",20,18,2,135091,1499.35,92.75
"25080","80339","2015",2,2,0,103000,816.5,111.5
"25081","80340","2015",4,4,0,121726.5,1246.75,97.75
"25082","80342","2015",5,5,0,141600,1632.6,88.2
"25083","80344","2015",3,3,0,105833.3,925.3333,109.6667
"25084","80345","2015",5,5,0,109260,1410.6,78.4
"25085","80347","2015",2,2,0,167500,1114.5,152
"25086","80348","2015",4,4,0,140000,1565,95.25
"25087","80349","2015",3,3,0,168166.7,1473,113.6667
"25088","80350","2015",4,4,0,127300,1572.75,79
"25089","80352","2015",3,3,0,94933.33,1253.333,88.33333
"25090","80353","2015",2,2,0,128500,1086.5,123
"25091","80354","2015",2,2,0,124000,1630,81.5
"25092","80358","2015",1,1,0,35000,467,75
"25093","80359","2015",3,3,0,102666.7,877.3333,106.3333
"25094","80360","2015",12,12,0,87770.83,1164.25,78.08333
"25095","80362","2015",5,5,0,105000,1233,90.8
"25096","80364","2015",2,2,0,172431,1725.5,100
"25097","80365","2015",2,2,0,68750,896,76
"25098","80366","2015",7,7,0,110714.3,1335.571,83.71429
"25099","80367","2015",5,5,0,113098.2,1303.2,95.4
"25100","80368","2015",36,35,1,91672.94,1245.639,76.08333
"25101","80369","2015",2,2,0,112500,1204,103.5
"25102","80372","2015",1,1,0,105000,890,118
"25103","80373","2015",23,23,0,98680.43,1129.522,87.56522
"25104","80374","2015",2,2,0,130000,1315.5,103.5
"25105","80375","2015",3,3,0,161666.7,1115,135.6667
"25106","80376","2015",7,7,0,155464.3,1544.143,106.8571
"25107","80377","2015",4,4,0,167460,1116.25,148
"25108","80378","2015",1,1,0,1e+05,935,107
"25109","80379","2015",7,7,0,201985.7,2187.857,96.14286
"25110","80380","2015",2,2,0,118000,1660,70.5
"25111","80384","2015",2,2,0,33000,1022.5,33
"25112","80385","2015",2,2,0,82500,1644.5,49.5
"25113","80386","2015",9,9,0,93222.22,1007.667,99.33333
"25114","80387","2015",6,6,0,133805.7,1445.833,87
"25115","80388","2015",1,1,0,117000,1206,97
"25116","80390","2015",1,1,0,98900,1336,74
"25117","80391","2015",2,2,0,136000,1481.5,91
"25118","80392","2015",4,4,0,98375,1437,70.25
"25119","80393","2015",7,7,0,114153.6,1296.143,94.28571
"25120","80395","2015",4,4,0,92500,1122.75,82.75
"25121","80396","2015",5,5,0,130000,1235,105.2
"25122","80399","2015",2,2,0,186500,1436.5,120
"25123","80400","2015",5,5,0,115000,1229.6,93.6
"25124","80401","2015",2,2,0,105000,1025.5,98.5
"25125","80403","2015",2,2,0,132500,1026.5,124.5
"25126","80404","2015",1,1,0,60000,857,70
"25127","80405","2015",4,4,0,152625,1687.75,89.75
"25128","80406","2015",9,9,0,122845.6,1223.333,98.44444
"25129","80407","2015",2,2,0,161500,1554.5,104.5
"25130","80409","2015",2,2,0,112150,1183.5,95
"25131","80410","2015",26,26,0,77365.38,939.6154,82.53846
"25132","80411","2015",5,5,0,120209.8,1674.2,75.6
"25133","80413","2015",4,4,0,61750,885.5,75
"25134","80414","2015",1,1,0,136000,1600,85
"25135","80415","2015",11,11,0,112518.2,1161.455,98.45455
"25136","80416","2015",6,6,0,87666.67,1254,69.83333
"25137","80417","2015",14,14,0,119286.4,1404.286,83.71429
"25138","80420","2015",1,1,0,143500,957,150
"25139","80421","2015",4,4,0,84250,1060,75.5
"25140","80422","2015",4,4,0,179250,1304,139
"25141","80424","2015",6,6,0,200006.7,1957.5,113.5
"25142","80426","2015",7,7,0,98857.14,1154.571,89.71429
"25143","80427","2015",5,5,0,145000,1284,113
"25144","80428","2015",1,1,0,1e+05,1429,70
"25145","80429","2015",1,1,0,235000,1469,160
"25146","80432","2015",1,1,0,165000,1650,100
"25147","80433","2015",1,1,0,85000,1012,84
"25148","80435","2015",2,2,0,73000,895,83
"25149","80436","2015",5,5,0,138300,1327.6,118.4
"25150","80437","2015",1,1,0,256012,1280,200
"25151","80438","2015",7,7,0,83949.14,733.2857,114.1429
"25152","80439","2015",1,1,0,138000,2029,68
"25153","80440","2015",1,1,0,85000,1024,83
"25154","80442","2015",11,11,0,96645.45,987.5455,98.81818
"25155","80443","2015",16,16,0,102921.9,1066,98.6875
"25156","80444","2015",5,5,0,76000,1168.4,72.6
"25157","80445","2015",1,1,0,30000,400,75
"25158","80446","2015",4,4,0,159125,1251.25,129.25
"25159","80452","2015",5,5,0,159400,1643.6,98
"25160","80453","2015",2,2,0,72500,627.5,116.5
"25161","80455","2015",1,1,0,133600,1452,92
"25162","80456","2015",4,4,0,109042,1276.75,89.5
"25163","80459","2015",1,1,0,90000,947,95
"25164","80461","2015",1,1,0,65000,956,68
"25165","80463","2015",16,16,0,153143.2,1587.625,97.875
"25166","80464","2015",10,10,0,100720,1292.6,79.2
"25167","80465","2015",4,4,0,101750,942.75,120.5
"25168","80466","2015",2,2,0,101000,1193,83.5
"25169","80467","2015",2,2,0,120600,1340,90
"25170","80468","2015",1,1,0,70000,875,80
"25171","80472","2015",1,1,0,80000,1194,67
"25172","80473","2015",2,2,0,103250,1112,120.5
"25173","80474","2015",5,5,0,142500,1256.4,112
"25174","80475","2015",4,4,0,109750,1202,89.5
"25175","80476","2015",1,1,0,173000,1696,102
"25176","80477","2015",2,2,0,90000,1148.5,70
"25177","80478","2015",1,1,0,165000,1737,95
"25178","80479","2015",2,2,0,130450,2153.5,63.5
"25179","80481","2015",3,3,0,65533.33,1298,49
"25180","80482","2015",1,1,0,113000,1018,111
"25181","80484","2015",1,1,0,50000,538,93
"25182","80485","2015",13,13,0,148538.5,1673.077,94.69231
"25183","80486","2015",5,5,0,95600,1149.6,94.2
"25184","80487","2015",1,1,0,162600,2085,78
"25185","80488","2015",20,20,0,124565,1644.3,78.3
"25186","80489","2015",23,22,1,147212.8,1760.13,85.43478
"25187","80490","2015",2,2,0,126500,1267,100
"25188","80493","2015",3,3,0,112240,1289,97.66667
"25189","80494","2015",3,3,0,129000,1430.667,90.33333
"25190","80495","2015",10,10,0,249250,3216.8,110.9
"25191","80496","2015",2,2,0,95000,1256,75.5
"25192","80497","2015",3,3,0,135166.7,1983.333,67.33333
"25193","80498","2015",10,10,0,91733.5,1031.5,95.6
"25194","80499","2015",3,3,0,161000,1221,127
"25195","80500","2015",2,2,0,181000,1199.5,148.5
"25196","80501","2015",1,1,0,181000,1534,118
"25197","80502","2015",1,1,0,160000,1000,160
"25198","80504","2015",1,1,0,169000,2347,72
"25199","80505","2015",2,2,0,73480,1392,57
"25200","80507","2015",17,17,0,128259.4,1584.353,83.82353
"25201","80509","2015",4,4,0,105562.5,942,100.5
"25202","80511","2015",3,3,0,115000,1342.667,88.33333
"25203","80512","2015",8,8,0,94844.38,1216.875,86.5
"25204","80513","2015",2,2,0,209615,1533,137.5
"25205","80514","2015",1,1,0,120000,750,160
"25206","80515","2015",2,2,0,125000,1409.5,95.5
"25207","80516","2015",1,1,0,70000,986,71
"25208","80517","2015",2,2,0,103250,1170.5,87.5
"25209","80518","2015",2,2,0,129750,1488.5,86.5
"25210","80519","2015",1,1,0,87000,1088,80
"25211","80520","2015",1,1,0,1e+05,1429,70
"25212","80521","2015",1,1,0,142000,899,158
"25213","80523","2015",12,12,0,113307.5,1206.583,96.91667
"25214","80524","2015",7,7,0,110357.1,1324.571,84.71429
"25215","80526","2015",1,1,0,35000,660,53
"25216","80528","2015",1,1,0,22000,611,36
"25217","80529","2015",3,3,0,112333.3,1204.667,92
"25218","80530","2015",2,2,0,106500,1564.5,75.5
"25219","80533","2015",94,44,50,88140.48,1623.84,57.78723
"25220","80536","2015",3,3,0,87666.67,854.6667,102
"25221","80538","2015",1,1,0,50000,357,140
"25222","80541","2015",5,5,0,742674,4654.8,126.8
"25223","80542","2015",7,7,0,98000,1130.429,90.42857
"25224","80545","2015",4,4,0,133025,1524.25,90.25
"25225","80546","2015",5,5,0,136600,1416.2,95
"25226","80547","2015",1,1,0,155000,2013,77
"25227","80548","2015",2,2,0,141500,1770.5,81.5
"25228","80549","2015",5,5,0,143060,1437.4,105.6
"25229","80552","2015",19,19,0,78331.21,936.5263,85.57895
"25230","80554","2015",10,10,0,128213.3,1369.3,90.8
"25231","80555","2015",8,8,0,116125,959.125,125.5
"25232","80556","2015",6,6,0,132950,1415.167,93.5
"25233","80557","2015",6,6,0,115360.2,1312,92.5
"25234","80558","2015",1,1,0,149000,1568,95
"25235","80559","2015",1,1,0,144000,1143,126
"25236","80560","2015",2,2,0,75000,1144.5,59
"25237","80561","2015",54,53,1,112066.9,1292.722,85.62963
"25238","80563","2015",1,1,0,180000,1607,112
"25239","80566","2015",1,1,0,51000,810,63
"25240","80568","2015",2,2,0,80000,1148,68
"25241","80569","2015",9,9,0,165986.1,1408.556,113.7778
"25242","80570","2015",37,37,0,135827,1386.946,103.0541
"25243","80571","2015",7,7,0,123185.7,1740.857,71.42857
"25244","80572","2015",4,4,0,96375,1271,75.25
"25245","80573","2015",4,4,0,120335.8,1261.25,106.5
"25246","80575","2015",1,1,0,168000,1120,150
"25247","80576","2015",5,5,0,141000,1690.8,90.6
"25248","80577","2015",2,2,0,97500,1096.5,88.5
"25249","80578","2015",6,6,0,142500,1662,87.16667
"25250","80579","2015",7,7,0,156853.1,1354.714,118.5714
"25251","80580","2015",5,5,0,143100,1456.4,112
"25252","80582","2015",8,8,0,145375,1554.25,99.625
"25253","80583","2015",1,1,0,106200,1475,72
"25254","80584","2015",6,6,0,121500,1299.667,90
"25255","80585","2015",22,22,0,88122.73,1045.5,82.72727
"25256","80586","2015",1,1,0,218500,2185,100
"25257","80587","2015",1,1,0,83500,1575,53
"25258","80588","2015",4,4,0,108000,1414,85.25
"25259","80589","2015",2,2,0,139000,1369,112
"25260","80590","2015",2,2,0,183500,2010,91.5
"25261","80591","2015",1,1,0,45000,865,52
"25262","80592","2015",5,5,0,83400,869.2,96.2
"25263","80593","2015",5,5,0,98300,1076,96.6
"25264","80595","2015",5,5,0,119298,1520,79.2
"25265","80596","2015",1,1,0,143000,2383,60
"25266","80598","2015",14,14,0,146141.4,1827.286,89.92857
"25267","80599","2015",1,1,0,75000,750,100
"25268","80600","2015",10,10,0,148820,1566.6,102.9
"25269","80601","2015",3,3,0,112400,1294.333,87
"25270","80602","2015",1,1,0,132585,1597,83
"25271","80604","2015",2,2,0,85000,981.5,88.5
"25272","80605","2015",1,1,0,50000,649,77
"25273","80606","2015",6,6,0,113041.3,1018,111
"25274","80609","2015",2,2,0,112000,1440,88.5
"25275","80611","2015",10,7,3,150150,1569,97.3
"25276","80613","2015",5,5,0,77560,1195.8,66
"25277","80614","2015",4,4,0,96700,1134.5,88.25
"25278","80615","2015",2,2,0,85000,990,111
"25279","80617","2015",1,1,0,80000,1509,53
"25280","80618","2015",14,14,0,127627.9,1433,99.42857
"25281","80619","2015",4,4,0,156050,1203.75,130.75
"25282","80620","2015",75,69,6,114633.1,1218.96,96.25333
"25283","80621","2015",10,10,0,116933.5,1155.8,100.4
"25284","80622","2015",17,17,0,109111.8,1239.588,87.88235
"25285","80623","2015",1,1,0,150000,1304,115
"25286","80624","2015",1,1,0,222900,2083,107
"25287","80625","2015",14,14,0,126857.1,1425,94.57143
"25288","80627","2015",9,9,0,212422.2,1797.444,113.5556
"25289","80628","2015",9,9,0,107593.3,1043,111.2222
"25290","80629","2015",1,1,0,125000,1374,91
"25291","80630","2015",21,21,0,145744.8,1553.667,96.95238
"25292","80631","2015",6,6,0,116333.3,1236.167,96.5
"25293","80632","2015",29,28,1,202356.8,2170.483,93.41379
"25294","80633","2015",7,7,0,127339.3,1930.714,65
"25295","80634","2015",9,9,0,152855.6,1536.778,99.77778
"25296","80635","2015",11,11,0,124036.4,1420.909,90.27273
"25297","80637","2015",4,4,0,127000,1624.5,76
"25298","80639","2015",7,7,0,219821.4,2152.429,95.71429
"25299","80640","2015",2,2,0,124500,1527.5,86
"25300","80642","2015",7,7,0,89242.86,971.8571,87.42857
"25301","80643","2015",6,6,0,142500,2093.167,73.16667
"25302","80644","2015",12,12,0,105006.7,1066.833,101.0833
"25303","80645","2015",6,6,0,113066.7,1042.5,105.3333
"25304","80646","2015",2,2,0,83000,1424.5,58.5
"25305","80647","2015",4,4,0,97350,1073,87.75
"25306","80649","2015",51,30,21,126686.5,2328.569,58.80392
"25307","80650","2015",7,7,0,232937.1,2029.286,118.1429
"25308","80651","2015",5,5,0,64900,768.6,84
"25309","80652","2015",12,12,0,147449.2,1541.333,99.91667
"25310","80654","2015",10,10,0,96910,1102.4,92.6
"25311","80655","2015",4,4,0,126625,1109.25,119.5
"25312","80656","2015",9,7,2,142222.2,1574.889,99
"25313","80657","2015",3,3,0,117333.3,1126.667,107
"25314","80658","2015",1,1,0,190000,888,214
"25315","80659","2015",1,1,0,150000,1613,93
"25316","80661","2015",6,6,0,188257.8,1707.667,110.5
"25317","80663","2015",2,2,0,110500,956.5,114
"25318","80665","2015",2,2,0,127500,1985,66.5
"25319","80667","2015",4,4,0,111250,1033.25,120
"25320","80669","2015",1,1,0,25000,500,50
"25321","80670","2015",1,1,0,56000,452,124
"25322","80671","2015",3,3,0,132433.3,1489.333,98
"25323","80672","2015",7,7,0,120985.7,1386.143,86.57143
"25324","80673","2015",3,3,0,108000,1390.333,82.66667
"25325","80674","2015",55,42,13,141716,1869.127,77
"25326","80675","2015",1,1,0,130000,1000,130
"25327","80677","2015",19,18,1,96757.89,988.8947,96.42105
"25328","80678","2015",7,7,0,122857.1,1133.143,114.2857
"25329","80679","2015",3,3,0,98666.67,1042.667,103.3333
"25330","80680","2015",27,26,1,118993.4,1299.185,98.18519
"25331","80682","2015",2,2,0,82500,894.5,90.5
"25332","80683","2015",3,3,0,105829.3,1105.333,117
"25333","80684","2015",2,2,0,85000,3103,52.5
"25334","80685","2015",45,43,2,103827.8,1300.444,83.17778
"25335","80686","2015",6,6,0,172716.7,1772.833,108.5
"25336","80687","2015",1,1,0,132000,1941,68
"25337","80688","2015",31,31,0,135243.5,1909.516,72.74194
"25338","80690","2015",9,9,0,188500,1696.333,115.4444
"25339","80691","2015",9,9,0,168666.7,1608.778,95.77778
"25340","80692","2015",10,10,0,110172,1440.5,83.3
"25341","80693","2015",4,4,0,85475,1835.75,55.75
"25342","80694","2015",4,4,0,103000,850.5,116.75
"25343","80695","2015",3,3,0,110833.3,1146.333,103
"25344","80696","2015",10,10,0,222736,1884.3,122.9
"25345","80700","2015",4,4,0,107000,1261.25,85.75
"25346","80701","2015",2,2,0,75000,1017,73
"25347","80702","2015",10,10,0,338479,2353.6,145.9
"25348","80703","2015",1,1,0,20000,769,26
"25349","80706","2015",14,14,0,106928.6,1240.429,89.71429
"25350","80708","2015",2,2,0,174250,1279,138
"25351","80709","2015",4,4,0,145937.5,1203.5,138.5
"25352","80710","2015",3,3,0,85833.33,968.6667,100.6667
"25353","80711","2015",11,11,0,85318.18,1021.455,85.36364
"25354","80713","2015",2,2,0,285000,2561,112
"25355","80714","2015",8,8,0,86696.25,1030.25,82.625
"25356","80716","2015",9,9,0,123222.2,1261.444,101.1111
"25357","80717","2015",13,13,0,145892.3,1727.538,81.84615
"25358","80718","2015",15,15,0,166726.7,1569.333,107.3333
"25359","80721","2015",61,56,5,187606.3,2533.197,80.72131
"25360","80722","2015",5,5,0,186400,1632.8,114.8
"25361","80724","2015",21,21,0,227628.6,2074.762,107.2381
"25362","80725","2015",29,28,1,200694.8,1982.897,99.48276
"25363","80726","2015",1,1,0,85000,1349,63
"25364","80729","2015",4,4,0,141261.8,1388.75,117
"25365","80730","2015",8,7,1,186620,1832.75,100.5
"25366","80732","2015",6,6,0,112058.3,1012.333,103.3333
"25367","80733","2015",4,4,0,105000,1077.25,96.5
"25368","80734","2015",1,1,0,120000,1791,67
"25369","80736","2015",2,2,0,257500,7123,49.5
"25370","80737","2015",4,4,0,54250,484.25,111.25
"25371","80740","2015",1,1,0,74000,740,100
"25372","80741","2015",2,2,0,90000,1227.5,74
"25373","80743","2015",2,2,0,123025,1201,103.5
"25374","80746","2015",5,5,0,202103.2,2146.6,92.8
"25375","80748","2015",1,1,0,60000,779,77
"25376","80749","2015",3,3,0,115000,721.3333,147
"25377","80750","2015",2,2,0,42500,673.5,64
"25378","80751","2015",6,6,0,201404,2275.167,94
"25379","80752","2015",5,5,0,150500,1531.2,96.6
"25380","80753","2015",1,1,0,330000,1435,230
"25381","80755","2015",2,2,0,122500,1075,114
"25382","80757","2015",1,1,0,126950,1144,111
"25383","80759","2015",1,1,0,114000,1727,66
"25384","80760","2015",2,2,0,226000,1552.5,128.5
"25385","80762","2015",2,2,0,55000,1040.5,63
"25386","80763","2015",4,4,0,108750,1473,82.25
"25387","80764","2015",3,3,0,136666.7,1825.667,71.33333
"25388","80765","2015",4,4,0,104840,1184,88
"25389","80766","2015",2,2,0,143150,1303,107
"25390","80767","2015",2,2,0,90000,976,93
"25391","80769","2015",2,2,0,1e+05,711.5,135.5
"25392","80770","2015",1,1,0,41000,911,45
"25393","80774","2015",2,2,0,205350,1658,124
"25394","80775","2015",2,2,0,82500,1029.5,77.5
"25395","80776","2015",5,5,0,134400,1055.2,120
"25396","80779","2015",3,3,0,147333.3,1429,102
"25397","80780","2015",4,4,0,73940.75,1056.25,82.25
"25398","80781","2015",1,1,0,1e+05,1250,80
"25399","80782","2015",6,6,0,175666.7,1633.833,105.1667
"25400","80783","2015",1,1,0,111000,1306,85
"25401","80784","2015",1,1,0,126880,1627,78
"25402","80785","2015",5,5,0,118050,1599.4,78.6
"25403","80786","2015",2,2,0,158750,1521,103
"25404","80787","2015",2,2,0,98350,1093.5,83
"25405","80788","2015",2,2,0,82250,1069,76.5
"25406","80789","2015",2,2,0,135000,1163.5,117
"25407","80791","2015",7,7,0,169571.4,1913.571,90.14286
"25408","80792","2015",2,2,0,188382,1788.5,105
"25409","80793","2015",18,18,0,122000,1304.556,93.66667
"25410","80795","2015",4,4,0,88000,1259.25,76.5
"25411","80796","2015",1,1,0,160000,1633,98
"25412","80798","2015",10,10,0,189540,1524.4,131.1
"25413","80799","2015",56,56,0,159126.1,1785.429,93.44643
"25414","80800","2015",2,2,0,120000,950.5,108.5
"25415","80801","2015",3,3,0,77666.67,680.3333,108.6667
"25416","80802","2015",5,5,0,74400,807.4,89.4
"25417","80803","2015",1,1,0,153000,5100,30
"25418","80805","2015",5,5,0,128762,1017.6,137.2
"25419","80806","2015",3,3,0,153333.3,1292.667,119.6667
"25420","80807","2015",3,3,0,142900,1709.667,88.66667
"25421","80808","2015",2,2,0,96500,1294,79
"25422","80809","2015",4,4,0,73000,871.75,91.75
"25423","80810","2015",2,2,0,69000,1179.5,66.5
"25424","80811","2015",7,7,0,107014.3,1359.143,80.28571
"25425","80813","2015",1,1,0,134000,1836,73
"25426","80814","2015",7,7,0,131957.1,1350.143,101.5714
"25427","80815","2015",8,8,0,106875,1276.5,85.875
"25428","80820","2015",5,5,0,149920,1915.6,93.8
"25429","80821","2015",2,2,0,105650,1122.5,104.5
"25430","80822","2015",2,2,0,62500,765,89.5
"25431","80823","2015",2,2,0,171000,976,177
"25432","80824","2015",4,4,0,100250,1323.25,79
"25433","80825","2015",1,1,0,45000,643,70
"25434","80826","2015",9,6,3,104061.1,1529.333,67.11111
"25435","80827","2015",10,10,0,86460,1009.3,82.5
"25436","80830","2015",2,2,0,195250,1315,143.5
"25437","80832","2015",2,2,0,152500,1874.5,83.5
"25438","80833","2015",1,1,0,144000,1412,102
"25439","80835","2015",3,3,0,106666.7,1048.333,98.66667
"25440","80836","2015",2,2,0,217500,1896.5,113
"25441","81001","2015",2,2,0,362800,1964,174
"25442","81002","2015",15,15,0,99018.27,1090.733,90.46667
"25443","81003","2015",7,7,0,84142.86,794.4286,113.8571
"25444","81004","2015",623,352,271,141506.9,1776.681,83.98234
"25445","81005","2015",4,4,0,66725,948.75,81.25
"25446","81006","2015",1,1,0,516950,2127,243
"25447","81008","2015",7,7,0,125285.7,1017.429,118.7143
"25448","81010","2015",4,4,0,96300,1002.25,92
"25449","81011","2015",10,10,0,228682,1950.2,127.6
"25450","81012","2015",1,1,0,140000,875,160
"25451","81013","2015",1,1,0,71000,888,80
"25452","81014","2015",11,11,0,62931.82,1112.818,65
"25453","81015","2015",1,1,0,334500,1890,177
"25454","81016","2015",3,3,0,81666.67,1334,63.33333
"25455","81017","2015",2,2,0,83250,1690.5,52
"25456","81018","2015",14,14,0,130830.7,1508.429,89.35714
"25457","81019","2015",1,1,0,60000,645,93
"25458","81020","2015",2,2,0,300500,2423.5,124
"25459","81021","2015",42,42,0,113691.1,1145.69,100.0952
"25460","81022","2015",3,3,0,243600,2002,123.6667
"25461","81023","2015",4,4,0,60500,798,81.75
"25462","81024","2015",2,2,0,207645,1568.5,134.5
"25463","81025","2015",3,3,0,319766.7,2036.333,168.3333
"25464","81026","2015",4,4,0,140875,1100.25,132.25
"25465","81027","2015",1,1,0,95000,725,131
"25466","81028","2015",1,1,0,60000,750,80
"25467","81029","2015",2,2,0,246685,1775.5,140
"25468","81030","2015",1,1,0,135000,1500,90
"25469","81031","2015",6,6,0,61000,1217.833,64.33333
"25470","81032","2015",8,8,0,136111.2,1317.375,104.25
"25471","81033","2015",25,25,0,86520.6,1031.76,82.2
"25472","81034","2015",3,3,0,87500,838.6667,102.3333
"25473","81035","2015",1,1,0,184400,2459,75
"25474","81036","2015",10,10,0,130488,1399.8,94.7
"25475","81037","2015",13,13,0,76294.23,803.6923,91
"25476","81038","2015",23,23,0,178306.7,1633.826,109.7826
"25477","81039","2015",14,14,0,106106.4,1160.571,89.35714
"25478","81040","2015",3,3,0,89650,1248.667,74.66667
"25479","81041","2015",2,2,0,189000,1446.5,130.5
"25480","81042","2015",20,20,0,149545,1504.65,102
"25481","81043","2015",3,3,0,152416.7,1230.667,123.6667
"25482","81044","2015",3,3,0,172230,1592.333,109
"25483","81045","2015",4,4,0,125088.5,2727.25,71.75
"25484","81046","2015",12,12,0,185691.2,1808.5,105.9167
"25485","81047","2015",2,2,0,170000,2958,51
"25486","81048","2015",35,35,0,109031.5,1310.4,79.88571
"25487","81050","2015",1,1,0,280600,1568,179
"25488","81051","2015",13,13,0,129392.3,1339.308,98.84615
"25489","81052","2015",18,18,0,177765.6,1690.667,108.3333
"25490","81053","2015",7,7,0,81714.29,941.5714,94.14286
"25491","81054","2015",4,4,0,115250,1280.5,83.5
"25492","81055","2015",2,2,0,152500,1906.5,80
"25493","81056","2015",2,2,0,302000,1621.5,135
"25494","81059","2015",2,2,0,210900,1646.5,128
"25495","81060","2015",65,61,4,102538.9,1106.938,100.8769
"25496","81061","2015",1,1,0,130000,1300,100
"25497","81062","2015",11,11,0,73682.73,874.9091,91.09091
"25498","81063","2015",7,7,0,174035.3,1916.429,90.71429
"25499","81064","2015",9,9,0,117746.9,1261,101.7778
"25500","81065","2015",449,328,121,119659.7,1325.013,92.88864
"25501","81066","2015",1,1,0,74000,902,82
"25502","81067","2015",3,3,0,222188.3,1754.333,127
"25503","81068","2015",1,1,0,245500,1395,176
"25504","81069","2015",13,11,2,222464.6,1778.385,120.1538
"25505","81070","2015",32,31,1,224145.5,1828,125.5
"25506","81072","2015",1,1,0,85000,680,125
"25507","81074","2015",8,8,0,176812.5,1779.75,100
"25508","81075","2015",2,2,0,156625,1382,117.5
"25509","81076","2015",5,5,0,123280,1382.4,100
"25510","81077","2015",8,8,0,140693.8,1137.875,128.25
"25511","81078","2015",7,7,0,158201.4,1244.714,132.2857
"25512","81079","2015",2,2,0,197175,1688,118.5
"25513","81081","2015",11,11,0,102500,1097.273,97.54545
"25514","81082","2015",1,1,0,32000,582,55
"25515","81083","2015",4,4,0,124500,1162.75,112.5
"25516","81084","2015",5,5,0,101930,1404.8,101.8
"25517","81086","2015",2,2,0,88960,722.5,112
"25518","81087","2015",3,3,0,256666.7,1521.333,175.3333
"25519","81088","2015",6,6,0,129666.7,1228,99.5
"25520","81090","2015",4,4,0,279418.8,2040.75,134
"25521","81092","2015",5,5,0,152510,1667,92.6
"25522","81093","2015",7,7,0,160050.7,1309.286,111.4286
"25523","81095","2015",1,1,0,220000,2200,100
"25524","81096","2015",5,5,0,155957.4,1032.2,147.8
"25525","81097","2015",3,3,0,201666.7,1561.667,125
"25526","81098","2015",2,2,0,182500,1858.5,97
"25527","81099","2015",154,122,32,143933.6,1515.468,93.80519
"25528","81101","2015",11,11,0,147906.4,1299.727,113.1818
"25529","81102","2015",2,2,0,185175,1883.5,98.5
"25530","81103","2015",1,1,0,210000,1429,147
"25531","81104","2015",5,5,0,213392,1761.2,118.4
"25532","81105","2015",126,120,6,105244.7,1098.897,98.03968
"25533","81106","2015",3,3,0,261666.7,1574.333,168
"25534","81110","2015",1,1,0,140000,2188,64
"25535","81111","2015",2,2,0,82500,1015.5,85
"25536","81112","2015",8,8,0,217918.8,1788,123.625
"25537","81114","2015",5,5,0,147800,1550.2,98
"25538","81115","2015",19,19,0,87797.37,888.1579,93.84211
"25539","81116","2015",11,11,0,208845.5,1732.909,119.4545
"25540","81117","2015",3,3,0,176433.3,1734.333,101.3333
"25541","81119","2015",7,7,0,104371.4,1003,113.4286
"25542","81120","2015",65,62,3,115362.4,1213.523,94.47692
"25543","81121","2015",3,3,0,58333.33,680.3333,90
"25544","81122","2015",1,1,0,58000,690,84
"25545","81124","2015",23,17,6,81015.22,842.6522,99.69565
"25546","81125","2015",5,5,0,65200,921,83.8
"25547","81128","2015",9,9,0,82077.78,968.7778,85.11111
"25548","81129","2015",1,1,0,88000,880,100
"25549","81130","2015",28,17,11,119632.1,1410.357,82.60714
"25550","81131","2015",20,19,1,181448.5,1722.4,105.6
"25551","81132","2015",16,16,0,128531.2,1379.75,98.5625
"25552","81133","2015",2,2,0,99500,1326.5,76
"25553","81135","2015",2,2,0,225000,1596,151.5
"25554","81136","2015",2,2,0,167915,1223.5,131
"25555","81138","2015",1,1,0,160000,1882,85
"25556","81139","2015",14,14,0,168805.7,1390.714,132.4286
"25557","81140","2015",135,102,33,144159.5,1571.533,88.68148
"25558","81141","2015",3,3,0,45333.33,559,90
"25559","81142","2015",11,11,0,232546.1,2038.182,127.4545
"25560","81143","2015",8,8,0,149012.5,1479.75,102.5
"25561","81144","2015",28,28,0,190727.1,1956.679,101.8214
"25562","81145","2015",47,46,1,169001.5,1481.638,114.3191
"25563","81146","2015",3,3,0,238333.3,1721.667,136.3333
"25564","81147","2015",6,6,0,184216.7,1509.167,122.6667
"25565","81148","2015",3,3,0,106681.7,1035,104.3333
"25566","81149","2015",4,4,0,212500,1896.5,122.25
"25567","81150","2015",3,3,0,305333.3,2051.333,144.6667
"25568","81151","2015",1,1,0,110000,1158,95
"25569","81152","2015",3,3,0,180500,1577,118.3333
"25570","81156","2015",42,42,0,171974.1,1930.905,92.66667
"25571","81157","2015",1,1,0,91500,1408,65
"25572","81159","2015",1,1,0,258700,1875,138
"25573","81161","2015",1,1,0,50000,575,87
"25574","81163","2015",75,68,7,87688,872.4667,105.1867
"25575","81164","2015",6,6,0,148833.3,1442.833,117.6667
"25576","81165","2015",4,4,0,113625,1029.75,105.25
"25577","81168","2015",12,12,0,140660.4,1303.667,108.3333
"25578","81170","2015",12,11,1,114166.6,1119.167,105.25
"25579","81171","2015",8,8,0,150437.5,1515.75,106
"25580","81173","2015",2,2,0,241000,2100,115.5
"25581","81174","2015",6,6,0,121275,1259.333,98.66667
"25582","81175","2015",3,3,0,187833.3,1591,117.6667
"25583","81177","2015",5,5,0,144607,1078.8,132
"25584","81178","2015",5,5,0,141420,1165.6,126.4
"25585","81179","2015",3,3,0,158333.3,1378,119.6667
"25586","81180","2015",3,2,1,168466.7,1959.667,87.66667
"25587","81182","2015",21,21,0,85219.52,1121.81,82.47619
"25588","81183","2015",1,1,0,160000,1240,129
"25589","81184","2015",1,1,0,230000,2054,112
"25590","81185","2015",3,3,0,215216.7,1177.333,210
"25591","81186","2015",1,1,0,112500,1114,101
"25592","81187","2015",3,3,0,113733.3,1431.667,79.66667
"25593","81188","2015",2,2,0,126000,1450,85
"25594","81190","2015",4,4,0,139000,1226.5,111.5
"25595","81191","2015",1,1,0,111000,1057,105
"25596","81192","2015",7,7,0,119964.3,1414.571,91.42857
"25597","81193","2015",8,8,0,85072.25,1230,72.375
"25598","81195","2015",2,2,0,210600,1967.5,107
"25599","81196","2015",4,4,0,134375,1558.75,98.75
"25600","81197","2015",2,2,0,181000,1484,122.5
"25601","81198","2015",1,1,0,123807,2476,50
"25602","81199","2015",3,3,0,162600,1159.667,129
"25603","81200","2015",1,1,0,152220,1312,116
"25604","81201","2015",8,8,0,106865,915.25,129.375
"25605","81202","2015",9,9,0,188933.3,1783.667,106
"25606","81203","2015",2,2,0,183800,1425.5,127.5
"25607","81204","2015",14,14,0,124122.1,1220.571,102.4286
"25608","81205","2015",2,2,0,203750,1926.5,111
"25609","81206","2015",5,4,1,87880,1158.2,83.8
"25610","81208","2015",4,4,0,174513.8,1922.25,96.75
"25611","81209","2015",17,17,0,126347.1,1389.941,92.05882
"25612","81210","2015",2,2,0,139265,1058,119.5
"25613","81211","2015",7,7,0,186300,1339.143,151.5714
"25614","81212","2015",1,1,0,45000,346,130
"25615","81213","2015",1,1,0,340000,2394,142
"25616","81214","2015",2,2,0,197500,1534,126.5
"25617","81215","2015",2,2,0,103000,1087.5,97.5
"25618","81216","2015",1,1,0,141000,1007,140
"25619","81217","2015",6,5,1,138211.2,1531.833,89
"25620","81218","2015",14,14,0,227564.2,1775.071,121.2857
"25621","81219","2015",27,27,0,170125.9,1789.963,107.4815
"25622","81220","2015",76,73,3,161606.1,1694.013,97.06579
"25623","81221","2015",2,2,0,117500,1028.5,107.5
"25624","81222","2015",20,19,1,150274.5,1399.8,110.95
"25625","81224","2015",2,2,0,175000,1843.5,98.5
"25626","81225","2015",12,12,0,172382.5,1778.083,97.16667
"25627","81227","2015",20,20,0,104446.5,1083.05,97.35
"25628","81228","2015",3,3,0,244600,3032.667,118
"25629","81229","2015",1,1,0,222800,1066,209
"25630","81230","2015",7,7,0,93522.14,885.7143,107.1429
"25631","81231","2015",2,2,0,68000,948.5,75
"25632","81232","2015",5,5,0,227420,1707.6,128.8
"25633","81233","2015",16,16,0,126215.5,1125.812,112.6875
"25634","81234","2015",3,3,0,116333.3,1354.333,77
"25635","81235","2015",4,4,0,163625,1767.25,93.25
"25636","81236","2015",4,4,0,263256.2,2445.25,111.75
"25637","81237","2015",2,2,0,69000,1016,67.5
"25638","81238","2015",6,6,0,77133.33,1192.833,77.83333
"25639","81239","2015",4,4,0,132250,1191,109.75
"25640","81242","2015",1,1,0,74000,822,90
"25641","81243","2015",2,2,0,327850,1905.5,170
"25642","81244","2015",21,21,0,85712.38,959.0476,94.42857
"25643","81245","2015",1,1,0,377010,1813,208
"25644","81247","2015",2,2,0,59000,743,90.5
"25645","81248","2015",6,6,0,148000,1393,105.5
"25646","81249","2015",8,8,0,129125,1392.5,115.25
"25647","81250","2015",1,1,0,225000,1607,140
"25648","81251","2015",6,6,0,169650,1665.167,101.5
"25649","81253","2015",1,1,0,64000,1882,34
"25650","81254","2015",5,5,0,89732,1071.4,88.2
"25651","81255","2015",4,4,0,214895,1615,129.75
"25652","81256","2015",1,1,0,143000,1490,96
"25653","81257","2015",51,43,8,137625.9,1493.078,94.09804
"25654","81258","2015",5,5,0,118384.8,1398.6,84.8
"25655","81259","2015",2,2,0,80000,741.5,114
"25656","81261","2015",9,9,0,236583.3,1859.222,128.7778
"25657","81262","2015",3,3,0,204618.3,2388.667,84
"25658","81263","2015",1,1,0,113000,942,120
"25659","81265","2015",2,2,0,92500,943.5,98
"25660","81266","2015",7,7,0,120892.9,1124.429,109.5714
"25661","81267","2015",4,3,1,83250,973.25,84
"25662","81269","2015",2,2,0,162500,1366,140
"25663","81271","2015",109,86,23,160319,1808.138,89.55963
"25664","81273","2015",27,24,3,140455,1369.704,103.4074
"25665","81274","2015",4,4,0,169000,1544.75,110.25
"25666","81275","2015",3,2,1,131666.7,1431.333,87.33333
"25667","81276","2015",16,16,0,137828.1,1360.688,104
"25668","81277","2015",2,2,0,192000,1554.5,123.5
"25669","81278","2015",2,2,0,170325,1791.5,94
"25670","81279","2015",1,1,0,137810,1584,87
"25671","81280","2015",1,1,0,140000,933,150
"25672","81281","2015",17,16,1,135064.7,1549.471,101.6471
"25673","81282","2015",1,1,0,77000,856,90
"25674","81283","2015",9,9,0,165444.4,1438.333,119
"25675","81284","2015",17,15,2,146823.6,1859.824,83.58824
"25676","81285","2015",3,3,0,127666.7,1085,105.3333
"25677","81286","2015",3,3,0,129000,1124.667,113.6667
"25678","81287","2015",1,1,0,122000,1140,107
"25679","81288","2015",19,19,0,127605.3,1213,118.8947
"25680","81289","2015",17,17,0,138941.2,1216.765,114.4118
"25681","81290","2015",1,1,0,160000,1333,120
"25682","81291","2015",3,3,0,158333.3,1092,157
"25683","81292","2015",3,3,0,130000,1173,123
"25684","81293","2015",2,2,0,142750,1358.5,109
"25685","81294","2015",9,9,0,208561.1,1397.778,162.6667
"25686","81295","2015",3,2,1,110566.7,1126,107.6667
"25687","81297","2015",11,11,0,192522.7,1692.182,117.3636
"25688","81298","2015",5,5,0,303990,1732.8,200.4
"25689","81299","2015",2,2,0,213975,1578.5,140
"25690","81303","2015",5,5,0,81700,1099.6,76
"25691","81304","2015",4,4,0,117500,1309.5,96
"25692","81305","2015",9,9,0,90855.56,857.4444,112
"25693","81306","2015",3,3,0,108666.7,919.6667,136.6667
"25694","81307","2015",7,7,0,120512.9,1141.143,100.1429
"25695","81308","2015",5,5,0,147200,1367.6,115
"25696","81309","2015",2,1,1,193800,1228,156
"25697","81310","2015",2,2,0,194680,1275,155.5
"25698","81311","2015",4,4,0,84153.25,863.75,98.25
"25699","81312","2015",11,11,0,87581.82,900.1818,104.1818
"25700","81313","2015",6,6,0,215910,1578.833,131
"25701","81314","2015",5,4,1,86670,1669,67.2
"25702","81315","2015",12,12,0,140833.3,1348.167,102.8333
"25703","81316","2015",1,1,0,150000,1316,114
"25704","81317","2015",7,7,0,125871.4,1127.714,117.2857
"25705","81318","2015",2,2,0,207500,2070,123.5
"25706","81319","2015",5,5,0,188100,1482.4,126.4
"25707","81320","2015",2,2,0,346375,3143,110
"25708","81321","2015",1,1,0,130000,1121,116
"25709","81323","2015",2,2,0,167500,1594,105.5
"25710","81324","2015",1,1,0,234550,1396,168
"25711","81325","2015",12,12,0,151666.7,1365.75,110.25
"25712","81326","2015",1,1,0,185580,1213,153
"25713","82001","2015",3,3,0,129900,1341,97.33333
"25714","82002","2015",35,32,3,148728.9,1614.714,97.94286
"25715","82003","2015",1,1,0,85870,550,156
"25716","82005","2015",18,18,0,154825.9,1635.111,103.0556
"25717","82006","2015",1,1,0,117500,470,250
"25718","82007","2015",1,1,0,160000,1600,100
"25719","82008","2015",3,3,0,65158.67,864.6667,94
"25720","82009","2015",1,1,0,164500,1567,105
"25721","82010","2015",5,5,0,115700,1163,104.2
"25722","82011","2015",10,10,0,160880,1436.4,113.1
"25723","82012","2015",5,5,0,111600,1146,113
"25724","82013","2015",41,41,0,99364.49,1010.585,103.2927
"25725","82014","2015",3,3,0,151333.3,1393.667,105
"25726","82015","2015",3,3,0,147633.3,1203.333,120.3333
"25727","82016","2015",4,4,0,205308.8,1569.25,127.5
"25728","82017","2015",9,8,1,177744.4,1787.667,99.22222
"25729","82018","2015",7,7,0,155578.6,1493.857,103.4286
"25730","82019","2015",10,10,0,139915,1442.1,106
"25731","82020","2015",7,7,0,215980,1818.143,121.7143
"25732","82021","2015",1,1,0,327166,2337,140
"25733","82022","2015",2,2,0,229021,2393,85
"25734","82023","2015",6,6,0,119076.7,1304.5,91.16667
"25735","82024","2015",1,1,0,145000,806,180
"25736","82025","2015",29,28,1,173552.4,1699.759,100.5862
"25737","82026","2015",9,9,0,110494.4,1241.556,92.11111
"25738","82027","2015",12,12,0,182047.6,1713.75,111.3333
"25739","82028","2015",5,5,0,190380,1862.2,103.6
"25740","82029","2015",1,1,0,185836,1575,118
"25741","82030","2015",4,4,0,116217.5,1090.75,119
"25742","82031","2015",12,12,0,138702.1,1291.5,110.3333
"25743","82032","2015",4,4,0,129500,914.5,146.75
"25744","82033","2015",124,101,23,119619.4,1324.823,92.48387
"25745","82034","2015",1,1,0,145000,967,150
"25746","82035","2015",1,1,0,149000,1620,92
"25747","82037","2015",65,57,8,121610.5,1351,89.87692
"25748","82038","2015",20,20,0,126956.7,1272.3,94.55
"25749","82039","2015",4,4,0,165837.5,1439.25,115.25
"25750","82040","2015",6,6,0,190583.3,1620.833,119.3333
"25751","82041","2015",4,4,0,84083,1200.25,65.75
"25752","82042","2015",13,13,0,172558.8,1365.231,126.6154
"25753","82043","2015",2,2,0,360750,2498.5,137
"25754","82044","2015",20,20,0,168356.2,1627.7,104.85
"25755","82045","2015",4,4,0,146637.5,1321.5,110.75
"25756","82046","2015",1,1,0,250000,3125,80
"25757","82048","2015",19,18,1,187738.6,1797.526,104.7895
"25758","82049","2015",9,9,0,79133.33,916.7778,88.11111
"25759","82050","2015",14,14,0,177577.5,1434.286,137.0714
"25760","82051","2015",12,12,0,116951.1,1029.667,117.1667
"25761","82052","2015",11,11,0,152579.1,1450.091,108.2727
"25762","82053","2015",2,2,0,117250,2114.5,50.5
"25763","82054","2015",3,2,1,65000,731.6667,90.66667
"25764","82055","2015",2,2,0,102000,1077,97.5
"25765","82056","2015",1,1,0,385000,1540,250
"25766","82057","2015",10,10,0,191461.6,1562.1,137.6
"25767","82058","2015",1,1,0,92000,902,102
"25768","82059","2015",3,3,0,155893.3,1134.667,147.3333
"25769","82060","2015",1,1,0,275970,1160,238
"25770","82061","2015",5,5,0,110797,1280.6,88.4
"25771","82062","2015",11,11,0,146072.7,1525.273,94.18182
"25772","82063","2015",6,6,0,150083.3,1127.5,137.3333
"25773","82064","2015",2,2,0,131500,1271.5,100.5
"25774","82065","2015",1,1,0,1e+05,990,101
"25775","82066","2015",3,3,0,145066.7,1436.667,101.3333
"25776","82069","2015",4,4,0,193750,2039.75,114.75
"25777","82072","2015",13,13,0,154615.4,1192.462,121.4615
"25778","82073","2015",8,7,1,123325,1030.125,122.125
"25779","82074","2015",1,1,0,190000,1357,140
"25780","82075","2015",2,2,0,142500,1367,102
"25781","82076","2015",10,10,0,170800,1570.3,111.4
"25782","82077","2015",2,2,0,117000,1834.5,62.5
"25783","82079","2015",32,30,2,180188.3,1691.781,106.625
"25784","82080","2015",4,4,0,142291.2,1349.75,116
"25785","82082","2015",3,3,0,82000,1167.333,67
"25786","82084","2015",3,3,0,207976.7,1696.333,115
"25787","82085","2015",5,5,0,174300,1748,101.6
"25788","82086","2015",3,3,0,141166.7,1324.667,106
"25789","82087","2015",20,19,1,147960,1581,96.1
"25790","82088","2015",10,10,0,130593.6,1941.7,68.6
"25791","82089","2015",10,10,0,110025,702.7,145.1
"25792","82090","2015",7,7,0,147057.1,1468.857,100.5714
"25793","82091","2015",1,1,0,437500,2188,200
"25794","82092","2015",3,3,0,96595.67,1099.667,90.33333
"25795","82093","2015",9,9,0,159528.9,1382.889,114.3333
"25796","82094","2015",20,20,0,126742.1,1507.1,88.7
"25797","82095","2015",2,2,0,168000,1522.5,117
"25798","82096","2015",27,26,1,149903.7,1439.074,106.5926
"25799","82097","2015",8,8,0,92812.5,1043.375,98.75
"25800","82098","2015",10,10,0,170625,1645.3,103.1
"25801","82099","2015",3,3,0,104833.3,1399.667,89.33333
"25802","82100","2015",3,3,0,184163.3,1617.333,104.3333
"25803","82101","2015",4,4,0,109225,1213,88.75
"25804","82102","2015",3,3,0,123725,856.3333,164.3333
"25805","82104","2015",2,2,0,92130,976,91
"25806","82105","2015",12,12,0,174846.2,1560.167,111.3333
"25807","82106","2015",1,1,0,160000,1702,94
"25808","82107","2015",2,2,0,80500,847.5,95
"25809","82108","2015",10,9,1,139690.2,1385.5,99.8
"25810","82109","2015",2,2,0,170500,1090,161.5
"25811","82110","2015",10,10,0,130640,1353.1,98.8
"25812","82111","2015",2,2,0,172500,1474,118.5
"25813","82112","2015",115,89,26,113438.5,1249.757,94.26957
"25814","82113","2015",13,13,0,144700,1782,80.92308
"25815","82114","2015",5,5,0,194580,1542.8,127.6
"25816","82115","2015",19,19,0,124067.1,1241.684,104.4737
"25817","82116","2015",5,5,0,143500,1631.8,86.6
"25818","82117","2015",18,18,0,170734.3,1547.889,115.1667
"25819","82118","2015",1,1,0,110000,957,115
"25820","82119","2015",4,4,0,123612.5,1160.5,95.5
"25821","82120","2015",2,2,0,71750,1161.5,63
"25822","82121","2015",790,445,345,137413.5,1559.847,87.13924
"25823","82123","2015",8,8,0,149831.2,1516.875,97.875
"25824","82124","2015",28,19,9,124105.4,1376.714,88.25
"25825","82125","2015",63,57,6,170844.3,1654.524,102.9365
"25826","82126","2015",5,5,0,139844,1220.4,116.6
"25827","82127","2015",7,7,0,107200,1157.571,92.14286
"25828","82129","2015",4,4,0,80119.25,916.75,87.75
"25829","82130","2015",2,2,0,220500,1161,183
"25830","82131","2015",12,12,0,154166.7,1483.667,96.08333
"25831","82132","2015",11,11,0,149781.8,1498.818,100.0909
"25832","82133","2015",1,1,0,65000,722,90
"25833","82134","2015",46,45,1,144517.5,1378.478,104.6304
"25834","82135","2015",11,11,0,171995.5,1629.727,110.1818
"25835","82136","2015",12,12,0,189333.3,1718.25,112.0833
"25836","82137","2015",4,4,0,112287.5,1507.5,77
"25837","82138","2015",1,1,0,178000,1935,92
"25838","82140","2015",7,7,0,205771.4,1627.571,124.1429
"25839","82141","2015",4,3,1,90000,972.25,93.25
"25840","82142","2015",14,13,1,174292.9,1847.214,95.57143
"25841","82143","2015",2,2,0,118806,1089,107.5
"25842","82144","2015",7,7,0,161621.4,1571.429,103.1429
"25843","82145","2015",4,4,0,125750,1394,92.25
"25844","82147","2015",3,3,0,83500,1296,65
"25845","82148","2015",7,7,0,125452.1,1081.857,121.8571
"25846","82149","2015",11,11,0,150045.5,1144.273,132.8182
"25847","82150","2015",10,8,2,128770,1239.8,107
"25848","82151","2015",9,9,0,118101.8,1387.333,85.66667
"25849","82152","2015",6,5,1,142366.7,1371.833,101.1667
"25850","82153","2015",5,5,0,160220,1077.4,159
"25851","82154","2015",2,2,0,207875,891,194
"25852","82155","2015",44,41,3,150504.3,1652.023,93.20455
"25853","82156","2015",2,2,0,1e+05,1278.5,77.5
"25854","82158","2015",2,2,0,155000,1147.5,158
"25855","82159","2015",6,6,0,181892,1930.667,100.1667
"25856","82161","2015",31,31,0,167356.4,1584,107.5484
"25857","82162","2015",1,1,0,54000,2250,24
"25858","82164","2015",3,3,0,130060,1066.333,122
"25859","82165","2015",8,8,0,95265.62,1210.625,81.75
"25860","82166","2015",3,3,0,96897.67,1146.667,84.66667
"25861","82167","2015",15,15,0,149262.3,1578.733,96.8
"25862","82168","2015",2,2,0,170392.5,884,190
"25863","82169","2015",21,21,0,127373.8,1104.857,119.4286
"25864","82170","2015",2,2,0,124500,1103,107.5
"25865","82171","2015",7,7,0,137571.4,1188.714,141.1429
"25866","82172","2015",6,6,0,108498.3,1567.833,78.16667
"25867","82173","2015",5,5,0,195564,1835.2,106
"25868","82174","2015",1,1,0,105000,1909,55
"25869","82176","2015",8,8,0,151166.9,1362.5,112
"25870","82178","2015",1,1,0,120000,1000,120
"25871","82179","2015",32,31,1,123803.1,1340.969,92.9375
"25872","82180","2015",3,3,0,124386.7,1237.667,96.33333
"25873","82181","2015",2,2,0,193500,1063.5,237.5
"25874","82182","2015",4,4,0,190500,1786,105.5
"25875","82183","2015",1,1,0,85000,1889,45
"25876","82184","2015",9,9,0,154389.1,1425.778,108.3333
"25877","82185","2015",2,2,0,95000,1226.5,77
"25878","82186","2015",50,41,9,109304.3,1351.58,85.84
"25879","82187","2015",12,12,0,137046.2,1309.583,104.4167
"25880","82188","2015",4,4,0,157250,1982.75,110.75
"25881","82189","2015",9,9,0,109000,1276.778,92.11111
"25882","82190","2015",66,55,11,139886.4,1555.515,96.98485
"25883","82191","2015",6,6,0,195225,1358.833,133.5
"25884","82192","2015",7,7,0,151421.1,1490.857,101.4286
"25885","82193","2015",1,1,0,190000,1429,133
"25886","82194","2015",8,8,0,162325,1567.625,102.75
"25887","82195","2015",6,6,0,153833.3,1686.167,87.5
"25888","83001","2015",28,25,3,494890.1,4025.393,122.5357
"25889","83002","2015",1,1,0,107000,1274,84
"25890","83003","2015",8,8,0,291087.5,3014.875,95.25
"25891","83004","2015",78,48,30,235761.2,2744.282,80.57692
"25892","83005","2015",8,7,1,88633.12,1314.5,71
"25893","83006","2015",7,7,0,261368.6,2452.571,108.2857
"25894","83007","2015",15,11,4,170800,2103.867,72.26667
"25895","83008","2015",58,47,11,292366.2,3237.655,95.5
"25896","83009","2015",283,43,240,268458.3,4970.424,55.38163
"25897","83011","2015",11,8,3,213874.1,2229.273,97.72727
"25898","83012","2015",39,21,18,142205.6,2166,69.87179
"25899","83013","2015",5,5,0,164000,1855.2,93.4
"25900","83014","2015",3,3,0,160936,1497,110.6667
"25901","83015","2015",6,4,2,293517.5,3739.833,85.83333
"25902","83016","2015",129,73,56,275339.2,3319.558,83.75194
"25903","83017","2015",18,12,6,215376.1,2957.444,80.5
"25904","83018","2015",35,34,1,245828.7,2704.771,96.4
"25905","83019","2015",201,63,138,316218.9,4843.667,60.1791
"25906","83021","2015",38,30,8,172729.6,2328.132,76.47368
"25907","83022","2015",1,1,0,78000,918,85
"25908","83023","2015",143,84,59,188532.2,2158.965,87.04196
"25909","83025","2015",22,16,6,190744.8,2386.364,79.63636
"25910","83026","2015",24,21,3,154250.8,2077.458,78.20833
"25911","83027","2015",48,44,4,513393.1,4598.646,113.3542
"25912","83028","2015",24,18,6,226820.8,2689.292,86.625
"25913","83029","2015",59,40,19,267585.6,3098.576,91.81356
"25914","83030","2015",21,17,4,211550,2288.476,92.09524
"25915","83031","2015",34,24,10,261038.2,2761.559,91.70588
"25916","83032","2015",45,33,12,202329.1,2341.511,87.44444
"25917","83033","2015",37,25,12,184720.2,2390.811,77.24324
"25918","83034","2015",155,60,95,374920.5,4556.658,80.84516
"25919","83035","2015",40,35,5,344646.2,3847.975,94.7
"25920","83036","2015",4,1,3,481250,5416.25,90.25
"25921","83037","2015",23,19,4,218866.1,2519.478,92.13043
"25922","83038","2015",2,2,0,197700,1950.5,100.5
"25923","83040","2015",1,1,0,95000,1397,68
"25924","83041","2015",19,15,4,189368.4,2084.947,94.84211
"25925","83042","2015",124,45,79,226815.9,3733.161,64.25
"25926","83043","2015",27,16,11,157133.3,2436.63,68.7037
"25927","83044","2015",2,2,0,55500,722,93
"25928","83045","2015",8,7,1,205503.1,1895.625,106
"25929","83046","2015",35,26,9,279072.1,2734.343,97.54286
"25930","83047","2015",149,109,40,290265.1,3312.617,89.08725
"25931","83048","2015",109,54,55,484173,6077.22,75.23853
"25932","83049","2015",25,24,1,278219.1,2866.4,98.48
"25933","83050","2015",415,157,258,175183.1,2209.92,78.13735
"25934","83051","2015",17,13,4,144143.5,1702.941,83.35294
"25935","83052","2015",6,6,0,119601.3,1801.5,70.16667
"25936","83053","2015",20,15,5,339163.5,3254.25,107.6
"25937","83054","2015",78,47,31,238914.8,3055.679,78.38462
"25938","83055","2015",74,56,18,338995.1,3227.541,108.1486
"25939","83056","2015",35,32,3,252786.7,2357.543,111.4857
"25940","83057","2015",32,24,8,191151.2,2148.344,88.875
"25941","83058","2015",55,46,9,306199.1,2693.236,113.3273
"25942","83059","2015",46,31,15,204551.1,2871.457,80.54348
"25943","83060","2015",7,7,0,219831.4,2044.143,110.2857
"25944","83061","2015",923,215,708,218448.7,3611.055,63.27411
"25945","83062","2015",271,86,185,217408.1,2897.93,75.13653
"25946","83063","2015",21,12,9,248410.9,3602.095,78.90476
"25947","83064","2015",60,57,3,275226,2782.1,99.91667
"25948","83065","2015",52,30,22,578112.1,6389.692,78.63462
"25949","83066","2015",12,11,1,197782.5,2210.333,86.75
"25950","83067","2015",43,35,8,154721,2359.419,69.65116
"25951","83068","2015",144,82,62,608172.2,6794.875,87.36806
"25952","83069","2015",783,192,591,233306.6,3617.441,65.43423
"25953","83070","2015",236,53,183,297895.7,5111.326,57.47458
"25954","83071","2015",148,67,81,264308.1,4624.358,58.85811
"25955","83072","2015",123,96,27,284833.9,2844.772,99.12195
"25956","83073","2015",94,70,24,189212.8,2234.734,83.37234
"25957","83075","2015",5,4,1,238400,3182.4,66.8
"25958","83076","2015",13,13,0,224864,2118.154,101.3846
"25959","83077","2015",17,15,2,271690,2435.471,109.0588
"25960","83078","2015",8,7,1,219934.1,2328.875,89.125
"25961","83079","2015",10,6,4,304325,4638.6,69.7
"25962","83080","2015",8,8,0,258150,1968.625,110.375
"25963","83081","2015",73,55,18,286975.8,3266.123,90.12329
"25964","83082","2015",3,2,1,202766.7,2138,83.33333
"25965","83083","2015",15,13,2,179040,2274.467,92.06667
"25966","83084","2015",13,13,0,187192.3,2345.769,84.07692
"25967","83085","2015",47,34,13,299155.8,3712.553,85.14894
"25968","83086","2015",108,74,34,225568.1,2573.241,88.72222
"25969","83087","2015",56,47,9,288007,2852.143,106.5179
"25970","83088","2015",35,32,3,237810.4,2521.914,94.91429
"25971","83089","2015",3,3,0,237000,3296,72.33333
"25972","83090","2015",107,71,36,308142.5,3244.234,97.40187
"25973","83091","2015",45,32,13,274884.5,3044.156,86.91111
"25974","83092","2015",52,43,9,198443.1,2259.5,89.53846
"25975","83093","2015",26,21,5,244774.8,2644.269,99.73077
"25976","83094","2015",58,40,18,402973.3,4072.862,93.39655
"25977","83095","2015",8,7,1,159081.2,2124.5,70
"25978","83096","2015",25,20,5,200094.8,2932.12,74.2
"25979","83097","2015",61,51,10,269540.7,2941.672,92.77049
"25980","83098","2015",141,52,89,260537.4,3409.518,76.73759
"25981","83099","2015",77,40,37,238863.8,3005.299,79.44156
"25982","83100","2015",40,31,9,197034.3,2422.35,80.175
"25983","83101","2015",18,14,4,1154633,8448.278,134.7778
"25984","83102","2015",41,41,0,226779.5,2329.756,100.5122
"25985","83103","2015",34,31,3,316780.8,3096.529,106.6176
"25986","83104","2015",49,45,4,211215.5,2392.143,90.87755
"25987","83106","2015",55,52,3,256985,2597.818,101.1273
"25988","83107","2015",312,189,123,361132.5,4006.41,88.05449
"25989","83108","2015",25,21,4,233908.8,2410.8,95.4
"25990","83109","2015",1,1,0,219000,3174,69
"25991","83110","2015",14,9,5,169007.1,2406.143,74.71429
"25992","83111","2015",28,25,3,234998.6,2848.464,93.21429
"25993","83112","2015",216,64,152,281214,4572.074,62.27315
"25994","83113","2015",30,28,2,184963.2,2150.9,88.36667
"25995","83114","2015",4,4,0,207737.5,2222.5,95.5
"25996","83115","2015",335,108,227,374288.2,4804.49,73.25672
"25997","83116","2015",209,164,45,254866.4,2759.813,93.20096
"25998","83117","2015",27,23,4,286289.3,2924.704,96
"25999","83118","2015",912,230,682,315597.2,4226.157,72.99561
"26000","83119","2015",87,10,77,544594.9,7816.494,64.28736
"26001","83120","2015",64,39,25,274263,3392.078,83.73438
"26002","83121","2015",46,35,11,235985.9,2388.587,94.45652
"26003","83122","2015",8,2,6,179437.5,2451.5,66.875
"26004","83123","2015",371,114,257,307555.3,4472.501,68.62534
"26005","83124","2015",34,26,8,316491.2,3312.794,100.6176
"26006","83125","2015",39,28,11,225493.9,2848.641,81.58974
"26007","83126","2015",793,218,575,188250.6,2892.533,67.08323
"26008","83127","2015",23,21,2,218418.3,2417.087,89.86957
"26009","83128","2015",5,5,0,231930,2018.4,119.8
"26010","83129","2015",625,220,405,240694,3859.139,64.6704
"26011","83130","2015",108,65,43,241771.7,2894.009,84.12037
"26012","83131","2015",55,47,8,268600.9,2973.473,93.2
"26013","83132","2015",22,16,6,275224,2876.545,96.45455
"26014","83133","2015",16,16,0,296643.1,3060,101.75
"26015","83134","2015",31,25,6,276662.9,2763.258,98.80645
"26016","83135","2015",28,26,2,127478.2,1807.607,74.57143
"26017","83136","2015",36,33,3,230734.4,2544.278,95.08333
"26018","83137","2015",2226,407,1819,167496.5,2466.821,66.74618
"26019","83138","2015",46,40,6,311703.6,3620,80.41304
"26020","83139","2015",13,13,0,278166.9,2490.923,116.3077
"26021","83140","2015",76,71,5,211172.5,2641.237,85.84211
"26022","83141","2015",60,47,13,249006.5,2583.483,99.78333
"26023","83142","2015",4,2,2,127000,2260.25,53.75
"26024","83143","2015",104,45,59,171330,5217.673,54.25
"26025","83144","2015",307,91,216,211069.5,2862.453,75.32248
"26026","83145","2015",21,14,7,136547.3,2194.238,67.14286
"26027","83146","2015",24,24,0,210337.7,1988.208,106.25
"26028","83148","2015",149,124,25,214827.1,2667.242,82.10067
"26029","83149","2015",21,16,5,252436.2,2908.476,90.47619
"26030","83150","2015",38,34,4,190029.3,2238.026,83.26316
"26031","83151","2015",12,11,1,171916.7,2247,76.66667
"26032","83152","2015",22,10,12,445628.6,5884.5,87.40909
"26033","83154","2015",8,8,0,268512.5,2471.625,104.125
"26034","84001","2015",20,16,4,283914.8,2925.95,102.4
"26035","84002","2015",10,10,0,364546,3602.5,108.4
"26036","84003","2015",97,51,46,160278.9,1842.588,87.35052
"26037","84004","2015",35,30,5,240872.1,2406.2,103.9714
"26038","84005","2015",3,3,0,110000,1850.333,60.66667
"26039","84006","2015",1,1,0,170000,1574,108
"26040","84007","2015",1193,324,869,140244.4,2238.448,65.83655
"26041","84008","2015",4,4,0,227000,2317.5,102.75
"26042","84009","2015",11,10,1,213766.1,2379.818,95.63636
"26043","84010","2015",9,9,0,328138.9,3105.444,113.4444
"26044","84011","2015",4,4,0,506676.8,4815.5,117.5
"26045","84012","2015",19,17,2,229973.7,2554.053,90.15789
"26046","84013","2015",4,4,0,221375,2311,93.75
"26047","84014","2015",13,10,3,164658.8,2031.769,85.23077
"26048","84015","2015",2,2,0,135000,1432,95
"26049","84016","2015",27,25,2,235761.4,2588.333,92.55556
"26050","84017","2015",45,40,5,264419.3,2681.511,104.4444
"26051","84018","2015",6,6,0,282700,2734,108
"26052","84019","2015",102,78,24,155857.3,1849.667,87.38235
"26053","84020","2015",18,16,2,533129.3,4008.944,122.7778
"26054","84021","2015",1,1,0,85000,1181,72
"26055","84022","2015",4,4,0,385905,2326.5,167
"26056","84024","2015",6,6,0,210133.3,2287.667,102.3333
"26057","84025","2015",19,18,1,555092.1,4209,136.4211
"26058","84026","2015",42,32,10,171237.5,2253.714,81.2619
"26059","84027","2015",20,19,1,212287.5,2177.4,97.35
"26060","84028","2015",7,7,0,303685.7,2575.714,118
"26061","84029","2015",47,44,3,196227.2,2080.34,95.40426
"26062","84030","2015",32,28,4,259501.7,2361.281,113.125
"26063","84031","2015",230,151,79,176050.7,2113.913,83.48696
"26064","84032","2015",3,3,0,545583.3,3914.333,141.6667
"26065","84033","2015",4,4,0,140887.5,1720.75,81.5
"26066","84034","2015",35,25,10,242294.6,2387.971,103.1143
"26067","84035","2015",266,136,130,159878.7,1966.741,80.90226
"26068","84036","2015",40,34,6,270984.6,2778.925,104.875
"26069","84037","2015",12,11,1,227708.3,2311.667,106.3333
"26070","84038","2015",29,27,2,289687,2787.31,105.6207
"26071","84039","2015",32,26,6,171637.5,2087.312,85.0625
"26072","84040","2015",3,3,0,1054000,3757,219.6667
"26073","84041","2015",7,7,0,401972,3310,118.2857
"26074","84042","2015",22,19,3,369463.6,3238.773,112.5
"26075","84043","2015",63,46,17,206254,2263.016,92.28571
"26076","84044","2015",14,14,0,366035.7,2677.143,141.6429
"26077","84045","2015",6,6,0,297988.3,2597.5,117.6667
"26078","84046","2015",6,6,0,153000,1565.333,107.6667
"26079","84047","2015",21,21,0,211347.6,2193.429,98.71429
"26080","84049","2015",2,2,0,252500,2940.5,79
"26081","84050","2015",28,26,2,878072.3,5162.929,157.7143
"26082","84051","2015",17,16,1,746161.9,4269.412,152.1176
"26083","84052","2015",11,11,0,315168.2,2455.091,123.0909
"26084","84053","2015",14,12,2,240437.2,2238,100.0714
"26085","84054","2015",233,144,89,234244.3,2856.202,82.81116
"26086","84055","2015",18,18,0,225595.1,2253.222,103
"26087","84056","2015",37,27,10,180051.2,2001.27,87.7027
"26088","84057","2015",3,3,0,416000,3395.667,115.6667
"26089","84058","2015",6,6,0,607333.3,4208.167,164.3333
"26090","84061","2015",2,2,0,229500,2007,113
"26091","84062","2015",13,12,1,311949.2,3535.462,94.46154
"26092","84063","2015",1,1,0,590232,3577,165
"26093","84064","2015",36,30,6,144190.2,1495.083,95.36111
"26094","84065","2015",58,49,9,258867.6,2913.483,92.32759
"26095","84066","2015",3,3,0,483742,3066,136.3333
"26096","84067","2015",17,15,2,273031.6,2996.235,112.2941
"26097","84068","2015",16,11,5,493471.7,5392.688,90.6875
"26098","84069","2015",23,22,1,285201.7,2341.435,109.4783
"26099","84070","2015",15,13,2,202968.7,2084.067,93.06667
"26100","84071","2015",12,12,0,326721.3,3060.917,111.3333
"26101","84072","2015",11,11,0,222627.3,1960.091,106.7273
"26102","84073","2015",19,18,1,475400,3850.263,127.9474
"26103","84074","2015",23,20,3,269013.9,2593.565,101.1304
"26104","84075","2015",3,2,1,217333.3,2692.333,77.33333
"26105","84076","2015",17,15,2,270140.9,2602.294,100
"26106","84077","2015",2,2,0,762500,2750,250
"26107","84078","2015",33,21,12,162429.7,1566,98.33333
"26108","84079","2015",8,8,0,202875,2670.125,85.5
"26109","84080","2015",84,67,17,185805.4,2060.607,91.4881
"26110","84081","2015",107,84,23,196249,2311.664,86.86916
"26111","84082","2015",15,15,0,190095.3,2174.667,85.2
"26112","84083","2015",21,20,1,197938.1,2119.238,98.28571
"26113","84084","2015",10,9,1,217500,3277.5,82
"26114","84085","2015",9,9,0,348318.9,3404.444,95.88889
"26115","84086","2015",15,10,5,318790.7,3701.467,85.93333
"26116","84087","2015",240,142,98,153720.6,1780.792,85.2
"26117","84088","2015",107,92,15,290368.2,2875.449,102.5234
"26118","84089","2015",206,107,99,197672.4,2565.85,78.36893
"26119","84090","2015",6,6,0,225752.5,3642.667,69.66667
"26120","84091","2015",33,28,5,192993.3,1853,104.6364
"26121","84092","2015",168,95,73,145793.9,1845.274,81.47024
"26122","84093","2015",10,10,0,271857,3742.2,82.7
"26123","84094","2015",6,6,0,244850,2919.333,93.16667
"26124","84095","2015",11,10,1,329772.7,2890.273,109.0909
"26125","84096","2015",5,5,0,194279,1806,123.4
"26126","84097","2015",8,8,0,198475,2202.625,91.25
"26127","84098","2015",3,3,0,274233.3,2221,125.6667
"26128","84099","2015",40,32,8,248307.5,2808.65,87.65
"26129","84100","2015",3,3,0,313796.7,2590,123.6667
"26130","84101","2015",7,7,0,513147.1,3351,159.5714
"26131","84102","2015",16,16,0,414637.5,3543.188,136.875
"26132","84103","2015",7,6,1,191291.4,2654.429,77.85714
"26133","84104","2015",11,9,2,316409.1,2784.091,105.2727
"26134","84105","2015",10,10,0,277090.3,2466,115
"26135","84106","2015",13,11,2,233598.5,2250.846,101.3077
"26136","84107","2015",9,9,0,131915.6,1529.778,91.33333
"26137","84108","2015",19,16,3,314717.4,2929.421,105.2105
"26138","84109","2015",2,2,0,240000,2540.5,95.5
"26139","84110","2015",1,1,0,250000,1866,134
"26140","84111","2015",4,4,0,315500,2432.25,135
"26141","84112","2015",12,10,2,284580.8,3363.833,90.25
"26142","84113","2015",11,10,1,256667.7,2843.727,89.36364
"26143","84115","2015",2,2,0,172500,2102.5,84.5
"26144","84116","2015",9,9,0,362046.7,3169.556,108.7778
"26145","84117","2015",5,5,0,183200,2041.6,90.2
"26146","84118","2015",33,32,1,272070.1,2790.212,100.9394
"26147","84119","2015",41,29,12,232094,2434.829,93.68293
"26148","84120","2015",1,1,0,46300,643,72
"26149","84121","2015",1,1,0,237000,2663,89
"26150","84122","2015",34,33,1,219889.4,2047.382,109.3824
"26151","84123","2015",20,16,4,155200,1901.95,85.2
"26152","84124","2015",6,3,3,215825,2961.333,73.66667
"26153","84125","2015",3,3,0,182000,2147,84.33333
"26154","84126","2015",6,6,0,375761.2,3206,120.3333
"26155","84127","2015",25,24,1,182226,1902.72,96.76
"26156","84129","2015",156,99,57,148614,1773.821,84.05128
"26157","84130","2015",3,3,0,286666.7,2930,108.3333
"26158","84131","2015",20,19,1,286096.3,2688.75,110.85
"26159","84132","2015",85,67,18,253071.1,2505.235,97.01176
"26160","84133","2015",28,20,8,214708.6,2185,92.85714
"26161","84134","2015",5,5,0,452680,4770.8,87.2
"26162","84135","2015",15,14,1,284636.7,2562.867,118.8667
"26163","84136","2015",4,4,0,261375,2096.25,130
"26164","84137","2015",75,43,32,200119.7,2581.613,79.41333
"26165","84138","2015",96,77,19,133255.9,1581.729,86.5
"26166","84139","2015",5,3,2,230520,2509.2,84.8
"26167","84140","2015",4,3,1,322162.5,3040.5,111
"26168","84141","2015",93,84,9,212808.6,2320.441,92.16129
"26169","84142","2015",25,22,3,290264,2728.84,110.2
"26170","84143","2015",14,10,4,274549.8,2744.357,102.0714
"26171","84144","2015",5,4,1,191668,2100,88.2
"26172","84145","2015",7,7,0,186891.1,3003.857,77.42857
"26173","84146","2015",2,2,0,295000,3337.5,96
"26174","84147","2015",31,23,8,234012.4,2688.29,88.64516
"26175","84148","2015",11,11,0,172672.7,2361.273,83
"26176","84149","2015",10,8,2,271877.6,2359.4,103.4
"26177","84150","2015",13,13,0,195002.3,2158.231,92
"26178","84151","2015",3,3,0,179333.3,1577.333,110.6667
"26179","85001","2015",99,95,4,134704.9,2201.576,67.87879
"26180","85002","2015",26,26,0,149088.9,1728,90.03846
"26181","85003","2015",114,111,3,148283.5,1576.86,96.19298
"26182","85004","2015",55,54,1,142963.9,1886.691,79.18182
"26183","85005","2015",10,10,0,111400,970.4,114.5
"26184","85006","2015",25,25,0,122643.2,1546.4,82.52
"26185","85008","2015",60,59,1,149151.6,1558.017,96.76667
"26186","85009","2015",8,8,0,129875,1218,113.25
"26187","85010","2015",6,6,0,219500,1746.5,129.1667
"26188","85011","2015",55,50,5,195221.8,2709.091,78.12727
"26189","85012","2015",61,43,18,126924.2,2117.918,65.04918
"26190","85013","2015",11,11,0,113518.2,1147.455,99.36364
"26191","85014","2015",8,8,0,86000,965.125,90.75
"26192","85015","2015",15,15,0,155766.5,1446.867,108.2667
"26193","85016","2015",14,14,0,164515.4,1566.429,107.2143
"26194","85017","2015",15,15,0,127986.7,1432.533,90.06667
"26195","85018","2015",44,44,0,137934.1,1616.182,89.04545
"26196","85019","2015",60,60,0,154269.6,1561.617,100.3333
"26197","85020","2015",32,32,0,119355.6,1257,98.34375
"26198","85021","2015",16,16,0,185812.5,1680.125,113.125
"26199","85022","2015",23,23,0,135187,1479.826,93.17391
"26200","85023","2015",2,2,0,96000,1148.5,93
"26201","85024","2015",12,12,0,146874.5,1469,101.5833
"26202","85025","2015",30,30,0,148982.3,1460.133,101.6667
"26203","85026","2015",15,15,0,151733.3,1649.067,90.66667
"26204","85028","2015",7,7,0,117528.6,990.8571,119.1429
"26205","85029","2015",29,29,0,107186.2,1347.138,84.2069
"26206","85031","2015",33,33,0,115561.2,1090.455,106.9091
"26207","85033","2015",9,9,0,98600,983.7778,94.66667
"26208","85034","2015",32,32,0,105451.6,1130.844,93.59375
"26209","85035","2015",150,128,22,174648.9,2741.22,70.02667
"26210","85036","2015",6,6,0,159750,1204,136.1667
"26211","85037","2015",5,5,0,107400,902,125
"26212","85038","2015",27,27,0,156201.9,1461.556,108.2963
"26213","85039","2015",45,44,1,123753.6,1365.089,93.53333
"26214","85040","2015",12,12,0,114672.2,1028.667,108.4167
"26215","85041","2015",2,2,0,55000,461.5,119.5
"26216","85042","2015",30,30,0,108475.4,1092.067,101.1333
"26217","85045","2015",12,12,0,110481.2,1585.167,70
"26218","85046","2015",39,39,0,127118.5,1369,92.17949
"26219","85047","2015",251,191,60,165569.8,1986.845,85.39841
"26220","85049","2015",21,21,0,111016.9,1376.762,84.33333
"26221","85050","2015",31,31,0,123428.1,1235.387,99.96774
"26222","85051","2015",81,80,1,119261.3,1303.63,95.85185
"26223","85054","2015",6,6,0,115500,1517.333,77.5
"26224","85055","2015",1,1,0,70000,1273,55
"26225","85056","2015",7,7,0,127857.1,1161.286,110.7143
"26226","85058","2015",2,2,0,143900,2061,69.5
"26227","85059","2015",18,17,1,92800,996.1667,95
"26228","85062","2015",14,14,0,176293.6,1724.286,103
"26229","85064","2015",23,23,0,124360.9,1186.609,109.6957
"26230","85065","2015",26,26,0,125630.2,1300.769,97.46154
"26231","85066","2015",9,9,0,88917.78,1004.778,88.55556
"26232","85067","2015",12,11,1,118091.7,1119.833,101.4167
"26233","85070","2015",29,29,0,136740.3,1459.414,92.41379
"26234","85071","2015",34,34,0,133975,1628,84.70588
"26235","85072","2015",11,11,0,130562.7,1098.818,127.8182
"26236","85073","2015",8,8,0,133875,1253.375,102.25
"26237","85074","2015",4,4,0,96750,1129.25,88.75
"26238","85076","2015",35,34,1,185200.6,2045.743,103.6
"26239","85077","2015",6,6,0,136816.7,1052.167,129.1667
"26240","85078","2015",14,14,0,84787.86,977.8571,86.78571
"26241","85080","2015",27,27,0,102331.1,1036.815,100.5556
"26242","85081","2015",45,44,1,161971.5,1435.733,115.8667
"26243","85082","2015",25,24,1,108004,1203.64,91.24
"26244","85083","2015",44,44,0,221897.7,3022.909,80.29545
"26245","85084","2015",67,67,0,133844.2,1365.612,98.46269
"26246","85086","2015",7,7,0,98214.29,1211.143,81.42857
"26247","85087","2015",2,2,0,38500,499.5,79.5
"26248","85088","2015",47,46,1,195115.7,2073.255,96.53191
"26249","85089","2015",52,51,1,146430.6,1526.212,97.05769
"26250","85090","2015",39,39,0,117069,1126.59,107.6154
"26251","85092","2015",131,114,17,102728.4,1068.771,95.48092
"26252","85093","2015",14,14,0,122093.6,1155.143,106
"26253","85094","2015",17,16,1,104231.7,1043,102.0588
"26254","85095","2015",19,19,0,136152.6,1409.158,98.15789
"26255","85096","2015",46,46,0,177181,1683.609,105.3478
"26256","85097","2015",12,12,0,137312.5,1455.25,106.4167
"26257","85098","2015",20,20,0,148809.5,1591.55,95.95
"26258","85099","2015",9,8,1,135444.4,1308.111,103
"26259","85100","2015",29,29,0,211610.6,2231,97.37931
"26260","85101","2015",5,5,0,145680,1442,98.4
"26261","85102","2015",11,11,0,103656.7,1223.818,95
"26262","85103","2015",32,32,0,158903.7,1558.344,102.3125
"26263","85104","2015",29,29,0,136853.2,1592.207,89.17241
"26264","85105","2015",3,3,0,151366.7,1355,101.6667
"26265","85106","2015",50,49,1,207732.9,2790.12,79.32
"26266","85108","2015",21,21,0,156969.1,1523.619,102.619
"26267","85109","2015",150,136,14,156033.8,1666.993,95.25333
"26268","85110","2015",8,8,0,104406.2,978,101.125
"26269","85111","2015",20,20,0,73961,950.65,79.85
"26270","85112","2015",38,38,0,176236.8,2067.421,86.23684
"26271","85113","2015",83,78,5,277719.3,3575.012,78.62651
"26272","85114","2015",92,75,17,182347.1,2635.707,72.86957
"26273","85115","2015",7,7,0,100285.7,1051.286,102.5714
"26274","85116","2015",8,8,0,135362.5,1202.25,115.625
"26275","85117","2015",6,6,0,97833.33,1085,92.16667
"26276","85118","2015",34,34,0,171649.9,1631.029,105.3529
"26277","85119","2015",20,19,1,120295,1213.05,103.05
"26278","85120","2015",19,19,0,141860.5,1859.421,80.31579
"26279","85121","2015",7,7,0,119214.3,1038.571,115.8571
"26280","85123","2015",6,6,0,122500,1151.167,115
"26281","85125","2015",1,1,0,149000,1602,93
"26282","85126","2015",18,18,0,131894.4,1261.722,102.7222
"26283","85127","2015",75,69,6,132396.7,1864.693,74.10667
"26284","85128","2015",125,119,6,128968.2,1487.72,88.944
"26285","85129","2015",22,22,0,133536.4,1389.727,100.0455
"26286","85130","2015",15,14,1,135322.4,1292.267,104.8
"26287","85131","2015",14,13,1,112500,1273.714,91.64286
"26288","85132","2015",10,10,0,110825,1012.1,116.3
"26289","85133","2015",10,10,0,98650,1065.4,97.2
"26290","85134","2015",5,5,0,154700,1470.4,106.2
"26291","85135","2015",30,30,0,119412,1303.967,89.53333
"26292","85137","2015",7,7,0,96914.29,960.7143,102.1429
"26293","85138","2015",9,9,0,125533.3,1206.222,105.1111
"26294","85139","2015",4,4,0,90500,1011.75,88.25
"26295","85140","2015",8,8,0,114187.5,1375.5,80.25
"26296","85141","2015",1,1,0,69000,561,123
"26297","85142","2015",10,10,0,132630,1286.2,104
"26298","85143","2015",13,13,0,93569.38,1068.846,94.23077
"26299","85144","2015",12,12,0,110068.2,1239.25,87.75
"26300","85145","2015",9,9,0,94888.89,1028.556,94.55556
"26301","85146","2015",55,46,9,149917.5,1796.491,89.74545
"26302","85147","2015",18,18,0,91966.67,906.6667,102.6667
"26303","85148","2015",5,5,0,65790,684.8,100.6
"26304","85149","2015",4,4,0,140875,998.25,133.25
"26305","85151","2015",56,56,0,141256.3,1424.143,99.21429
"26306","85152","2015",65,65,0,153297.8,1606.338,96.23077
"26307","85153","2015",29,29,0,126575.6,1339.621,93.27586
"26308","85154","2015",12,12,0,100625,1127,97.25
"26309","85155","2015",55,55,0,177725.2,1708.255,103.6727
"26310","85156","2015",21,21,0,149825.2,1530.81,97.2381
"26311","85157","2015",7,7,0,143000,1140.143,118.7143
"26312","85158","2015",14,14,0,144650,1142.143,126.1429
"26313","85159","2015",30,30,0,107361,1113.767,104
"26314","85160","2015",24,24,0,164487.6,1665.875,102.2083
"26315","85161","2015",22,22,0,130227.3,1344.182,97.90909
"26316","85162","2015",20,20,0,122925,1147.2,109.45
"26317","85163","2015",101,88,13,289683.4,3706.99,79.42574
"26318","85164","2015",64,35,29,137660.6,2653.281,55.46875
"26319","85167","2015",12,12,0,99545.83,933.6667,108.25
"26320","85169","2015",20,20,0,137840,1355,102.85
"26321","85171","2015",8,8,0,138737.5,1244.375,111.625
"26322","85172","2015",26,26,0,149603.8,1728.577,90.42308
"26323","85174","2015",3,3,0,122500,1122.333,112
"26324","85175","2015",3,3,0,141933.3,1155.333,122.3333
"26325","85176","2015",9,9,0,135061.7,1152.111,108.7778
"26326","85177","2015",6,6,0,97050,881.5,113.1667
"26327","85178","2015",79,79,0,145417.8,1493.747,98.58228
"26328","85179","2015",10,10,0,105900,1405.6,75.2
"26329","85181","2015",4,4,0,108355,1013.25,110.75
"26330","85182","2015",49,49,0,104100.2,1160.735,94.5102
"26331","85184","2015",11,11,0,101163.6,835.6364,118.7273
"26332","85185","2015",4,4,0,103000,1065.5,110.5
"26333","85186","2015",8,8,0,108267.5,1305.25,87.125
"26334","85187","2015",4,4,0,98500,989.5,109.75
"26335","85188","2015",9,9,0,125083.3,1097.444,117.3333
"26336","85189","2015",32,32,0,155244.4,1900.688,85.78125
"26337","85190","2015",35,27,8,96541.29,1165.143,84.48571
"26338","85191","2015",717,440,277,134757.3,1595.72,85.01116
"26339","85192","2015",3,3,0,85747,921,107
"26340","85193","2015",2,2,0,51340,687,68.5
"26341","85194","2015",574,246,328,202042.6,3181.979,65.33275
"26342","85196","2015",14,14,0,126785.7,1396.571,94.64286
"26343","85197","2015",32,32,0,139987.8,1273.594,111.7188
"26344","85198","2015",9,9,0,164611.1,1417.556,114.6667
"26345","85199","2015",1,1,0,139350,1639,85
"26346","85200","2015",13,13,0,186338.5,2020.692,98.46154
"26347","85201","2015",6,6,0,157216.5,1488,105.6667
"26348","85202","2015",19,19,0,101550.5,1192.737,85.57895
"26349","85204","2015",24,24,0,128960.5,1413.625,96.125
"26350","85205","2015",6,6,0,96423.17,928.6667,104.1667
"26351","85206","2015",17,17,0,65354.71,1111.529,62.76471
"26352","85207","2015",11,11,0,118190.9,1136.818,106.0909
"26353","85208","2015",13,13,0,127592.3,1294,97.07692
"26354","85209","2015",8,8,0,118112.5,1058,114.625
"26355","85210","2015",26,26,0,107528.8,1186.731,93.88462
"26356","85211","2015",19,19,0,141452.6,1390.263,103.8947
"26357","85213","2015",29,29,0,132036.7,1331.586,98.86207
"26358","85214","2015",25,25,0,206592.6,1967.04,103.76
"26359","85215","2015",32,32,0,105188.6,1346.656,86.15625
"26360","85216","2015",17,17,0,139775.3,1359.294,100.7059
"26361","85218","2015",17,17,0,151723.5,1578.235,95.82353
"26362","85220","2015",16,16,0,149763.8,1408.125,110.125
"26363","85221","2015",42,42,0,151289.8,1678.738,91.38095
"26364","85222","2015",229,146,83,205374.1,3004.148,72.13974
"26365","85223","2015",24,22,2,115814.7,1062.333,111
"26366","85226","2015",434,227,207,134315.3,2294.247,59.97005
"26367","85227","2015",26,26,0,108090.7,1054.692,102.9231
"26368","85229","2015",8,8,0,74687.5,826,95
"26369","85232","2015",11,11,0,107970.2,1082.636,96.81818
"26370","85233","2015",9,9,0,128944.4,1014.444,133.1111
"26371","85234","2015",350,162,188,139842.3,2413.017,60.31143
"26372","85235","2015",8,7,1,106562.5,1011,111.375
"26373","85236","2015",20,20,0,197670,2018.65,98.15
"26374","85237","2015",2,2,0,53106.5,722,95.5
"26375","85238","2015",28,26,2,114183.9,1562.679,75.28571
"26376","85239","2015",18,18,0,165788.9,1607.278,103.1111
"26377","85240","2015",16,16,0,110367.2,1337.312,94.0625
"26378","85242","2015",7,7,0,152637.1,1358.429,120.2857
"26379","85243","2015",54,52,2,152643.5,2040.222,79.33333
"26380","85244","2015",2,2,0,117000,1520,77.5
"26381","85246","2015",19,19,0,108815.8,1224.105,99.05263
"26382","85247","2015",14,14,0,109964.3,1131.214,98.07143
"26383","85248","2015",4,4,0,124500,1758,82.5
"26384","85250","2015",23,23,0,177742,1771.304,102.1739
"26385","85251","2015",6,6,0,93866.67,843.1667,108.5
"26386","85252","2015",3,3,0,73666.67,913.3333,79
"26387","85254","2015",11,11,0,109759.1,1102,102.9091
"26388","85255","2015",48,48,0,130533.8,1462.25,90.25
"26389","85256","2015",12,12,0,112241.7,1147.667,97.75
"26390","85259","2015",8,8,0,141200,1379.25,103.25
"26391","85260","2015",11,11,0,113645.5,1285.727,88.27273
"26392","85261","2015",2,2,0,133750,1391.5,95
"26393","85262","2015",27,27,0,139673.3,1643.519,90.14815
"26394","85264","2015",13,13,0,96269.23,1013,95.84615
"26395","85265","2015",8,8,0,121606.2,1058.75,107.75
"26396","85266","2015",12,11,1,99173.33,1150.667,83.66667
"26397","85267","2015",12,12,0,129633.4,1300,98.16667
"26398","85268","2015",11,11,0,133403.6,1485.364,91.81818
"26399","85271","2015",5,5,0,113840,946,115
"26400","85273","2015",27,27,0,138274.1,1533.852,90.92593
"26401","85274","2015",9,9,0,154388.9,1120,138.5556
"26402","85276","2015",8,8,0,115275,934.75,130.125
"26403","85277","2015",16,15,1,111712.5,1315.938,85.375
"26404","85278","2015",49,41,8,162901.8,2633.694,67.36735
"26405","85280","2015",36,36,0,161568.9,1583.806,101.8889
"26406","85281","2015",12,12,0,112064.9,1061.167,108.9167
"26407","85282","2015",3,3,0,116333.3,1816,64.33333
"26408","85284","2015",41,40,1,171392.6,1766.415,97.36585
"26409","85285","2015",11,11,0,157454.5,1624.364,100.4545
"26410","85286","2015",8,8,0,120936.9,1125.25,105.375
"26411","85287","2015",4,4,0,110500,973.75,109.25
"26412","85288","2015",152,125,27,174104.1,2112.309,87.22368
"26413","85289","2015",9,9,0,85861.11,965.3333,92.22222
"26414","85290","2015",6,6,0,111600,840.1667,136.5
"26415","85291","2015",23,20,3,116322.3,1227.565,97.6087
"26416","85292","2015",9,9,0,85333.33,796.8889,111.2222
"26417","85293","2015",9,7,2,80000,801.8889,93.44444
"26418","85294","2015",119,107,12,167028.5,2750.924,65.67227
"26419","85295","2015",20,20,0,141260.3,1312,108.75
"26420","85296","2015",10,10,0,142240,1289.4,111
"26421","85297","2015",11,11,0,99210.91,1010.909,108.2727
"26422","85298","2015",22,22,0,163000,1834.864,89.90909
"26423","85300","2015",47,47,0,160772.1,1535.638,107.2766
"26424","85301","2015",5,5,0,140200,1478.2,102
"26425","85302","2015",39,39,0,115448.7,1280.462,90.82051
"26426","85303","2015",16,16,0,125095.3,990.3125,130.25
"26427","85304","2015",8,8,0,97212.5,1238.375,88
"26428","85305","2015",12,12,0,146496.2,1146,129.1667
"26429","85306","2015",5,5,0,101482.2,1086,95.6
"26430","86001","2015",3,3,0,64333.33,972,68.33333
"26431","86002","2015",4,4,0,88250,1066.75,81.75
"26432","86003","2015",3,3,0,124333.3,1046,122.3333
"26433","86004","2015",9,9,0,110108.9,1351.444,89.55556
"26434","86005","2015",4,4,0,68000,706,108.75
"26435","86006","2015",8,8,0,89555.62,1003.875,89
"26436","86007","2015",7,7,0,131492.9,1216.571,107.1429
"26437","86008","2015",4,4,0,77500,648.5,121.5
"26438","86009","2015",8,8,0,117957.5,1007,115.5
"26439","86010","2015",15,15,0,145613.3,1363.2,109.4
"26440","86011","2015",3,3,0,68166.67,762.6667,90
"26441","86012","2015",2,2,0,215000,1281,161
"26442","86013","2015",1,1,0,115000,958,120
"26443","86014","2015",15,15,0,134586.7,1297.933,103.6
"26444","86015","2015",24,24,0,100515.9,940.0833,101.0833
"26445","86016","2015",17,17,0,125461.2,1488.706,86.41176
"26446","86017","2015",10,10,0,111512,1152.4,95.4
"26447","86018","2015",4,4,0,71250,730,103
"26448","86019","2015",34,34,0,123005.3,1256.618,99.67647
"26449","86020","2015",2,2,0,105500,1144,92
"26450","86022","2015",1,1,0,30000,417,72
"26451","86023","2015",4,4,0,109000,945.5,128.5
"26452","86024","2015",9,9,0,162030.9,1419.667,116
"26453","86025","2015",6,6,0,71833.33,783.5,93.5
"26454","86026","2015",4,4,0,82870,890.25,93
"26455","86027","2015",12,11,1,179676.7,1762.083,102.75
"26456","86028","2015",10,10,0,174200,1737,101
"26457","86029","2015",9,9,0,88507.56,843.4444,108.5556
"26458","86031","2015",5,5,0,144382,1612.4,90.2
"26459","86032","2015",16,16,0,121410.3,1274.438,96.75
"26460","86034","2015",6,6,0,93500,1143,82.5
"26461","86036","2015",4,4,0,133538.5,1223.75,111.75
"26462","86037","2015",5,5,0,98934.8,1011,95.6
"26463","86038","2015",3,3,0,163883.3,1853,94.33333
"26464","86039","2015",5,5,0,139600,980.6,139.8
"26465","86041","2015",121,86,35,132324.3,1616.099,80.61157
"26466","86042","2015",12,12,0,87912.5,1030.75,89.91667
"26467","86044","2015",6,6,0,122358.3,1575,88.33333
"26468","86045","2015",7,7,0,107296,1188.143,105.4286
"26469","86046","2015",16,16,0,98765.62,1245.688,79
"26470","86047","2015",7,7,0,97571.43,969.8571,100.1429
"26471","86048","2015",9,9,0,155777.8,1551.889,103.2222
"26472","86049","2015",4,4,0,97450,1257.75,78
"26473","86050","2015",6,6,0,134943.3,914.6667,144.1667
"26474","86051","2015",1,1,0,24000,480,50
"26475","86052","2015",7,7,0,75928.57,1197.143,73.14286
"26476","86053","2015",3,3,0,109400,1112.333,93.33333
"26477","86054","2015",4,4,0,87000,1042.5,90.25
"26478","86055","2015",6,6,0,82833.33,964.5,88
"26479","86058","2015",7,7,0,112175.7,1717.286,72.57143
"26480","86059","2015",3,3,0,83666.67,1145.333,72.66667
"26481","86061","2015",10,10,0,120991,1057.2,112
"26482","86062","2015",41,35,6,137191.2,1685.878,87.80488
"26483","86063","2015",4,4,0,61002.5,691.25,88.25
"26484","86064","2015",8,8,0,100968.8,1255.375,85.25
"26485","86065","2015",6,6,0,115666.7,1221,107.8333
"26486","86066","2015",320,276,44,105629.1,1183.513,88.54063
"26487","86068","2015",6,6,0,93206.67,739,124.5
"26488","86069","2015",2,2,0,63750,706.5,91
"26489","86070","2015",66,63,3,121973,1257.03,96.89394
"26490","86072","2015",1,1,0,81000,587,138
"26491","86073","2015",3,3,0,87500,916.6667,94
"26492","86074","2015",2,2,0,71500,955,77.5
"26493","86075","2015",8,8,0,75875,826.375,89.5
"26494","86076","2015",23,23,0,165569.6,1540.957,109.4783
"26495","86077","2015",7,7,0,101028.6,1124.571,86.28571
"26496","86078","2015",26,26,0,112191.9,1138.885,100.6538
"26497","86079","2015",5,5,0,97000,1012.8,90.2
"26498","86080","2015",4,4,0,107000,1139.25,95
"26499","86081","2015",3,3,0,111666.7,893.6667,128
"26500","86082","2015",47,46,1,106011.5,1146.362,100.9787
"26501","86083","2015",7,7,0,125928.6,1317.429,101.2857
"26502","86084","2015",5,5,0,39200,622,61.4
"26503","86085","2015",7,7,0,79642.86,821,93.85714
"26504","86086","2015",11,11,0,102210,1169.091,85.45455
"26505","86087","2015",1,1,0,60000,373,161
"26506","86088","2015",7,6,1,207500,1680.143,124.7143
"26507","86089","2015",4,4,0,80125,1024,82.5
"26508","86091","2015",4,4,0,52500,635.5,84.25
"26509","86092","2015",27,27,0,111624.1,1185.593,96.22222
"26510","86093","2015",4,4,0,64000,839,100.5
"26511","86094","2015",8,8,0,213953.8,1711.625,121.5
"26512","86095","2015",29,29,0,145485.9,1414,105
"26513","86096","2015",12,12,0,87916.67,884.5833,97.08333
"26514","86097","2015",2,2,0,127500,815,159.5
"26515","86098","2015",1,1,0,80000,889,90
"26516","86099","2015",7,7,0,139165,1358.143,103.5714
"26517","86100","2015",37,34,3,176269.9,1750.514,104
"26518","86102","2015",7,7,0,165418.6,1354.857,125.2857
"26519","86103","2015",18,18,0,117411.1,1142.611,104
"26520","86104","2015",9,9,0,119939.4,1163.778,97.44444
"26521","86105","2015",2,2,0,191650,1716,128.5
"26522","86106","2015",1,1,0,245000,965,254
"26523","86107","2015",7,7,0,69321.43,910.1429,80.57143
"26524","86108","2015",1,1,0,50500,351,144
"26525","86109","2015",2,2,0,104000,993,109
"26526","86110","2015",3,3,0,112833.3,1142.667,105.6667
"26527","86111","2015",15,15,0,112174.7,1216.6,88.33333
"26528","86112","2015",19,14,5,63510.89,883.4211,77.73684
"26529","86113","2015",23,23,0,141338.5,1430.391,101.5217
"26530","86114","2015",14,14,0,136832.1,1493.786,93.35714
"26531","86115","2015",57,51,6,121989,1416.386,89
"26532","86116","2015",6,6,0,91433.33,992.1667,99.16667
"26533","86117","2015",4,4,0,83500,819.25,110.25
"26534","86118","2015",2,2,0,35000,1048,40.5
"26535","86119","2015",4,4,0,77000,640.25,114
"26536","86120","2015",13,13,0,61596.15,775.6923,85.53846
"26537","86121","2015",1,1,0,30000,750,40
"26538","86122","2015",1,1,0,68000,680,100
"26539","86123","2015",6,6,0,100808.3,1112.667,96.16667
"26540","86124","2015",11,11,0,160590.9,1374,112.7273
"26541","86125","2015",6,6,0,97464.17,1098.667,93.66667
"26542","86126","2015",9,9,0,95723.33,996.4444,96.33333
"26543","86127","2015",3,3,0,120000,1253.667,89
"26544","86128","2015",28,26,2,101305.1,1024.607,103.8214
"26545","86129","2015",6,6,0,115760,1190.667,108
"26546","86130","2015",6,6,0,108083.3,1362,83
"26547","86131","2015",6,6,0,114200,1132.5,103
"26548","86132","2015",5,5,0,108218.8,1035,88.2
"26549","86133","2015",31,31,0,162404.7,1631.613,101.2581
"26550","86134","2015",1,1,0,172412,817,211
"26551","86135","2015",7,7,0,128257.1,1227.857,105.1429
"26552","86136","2015",5,5,0,151050,1119,135
"26553","86137","2015",52,45,7,88687.79,1021.558,89.25
"26554","86138","2015",4,4,0,105937.5,1256.75,83
"26555","86139","2015",29,29,0,97343.93,1106.69,92.58621
"26556","86140","2015",23,22,1,114480.4,1239.043,95.43478
"26557","86141","2015",5,5,0,89500,983.6,91.6
"26558","86142","2015",6,6,0,152666.7,1345.5,125
"26559","86143","2015",3,3,0,120000,1420.667,76.66667
"26560","86144","2015",1,1,0,160000,1250,128
"26561","86145","2015",6,6,0,193666.7,1412.667,127.5
"26562","86147","2015",6,6,0,121333.3,1360,89
"26563","86148","2015",4,4,0,116250,1089.5,113.75
"26564","86149","2015",2,2,0,101500,824,123.5
"26565","86150","2015",1,1,0,199500,1108,180
"26566","86151","2015",1,1,0,119500,664,180
"26567","86152","2015",7,7,0,94457.14,888.1429,96.28571
"26568","86153","2015",9,9,0,91852.22,917.3333,99.11111
"26569","86154","2015",1,1,0,63000,840,75
"26570","86156","2015",3,3,0,68601.67,725,97.66667
"26571","86157","2015",35,26,9,173229.1,1957.286,89.31429
"26572","86158","2015",66,64,2,169536.2,1663.197,102.7879
"26573","86159","2015",7,7,0,99523.57,896.7143,102
"26574","86160","2015",17,17,0,82705.88,760.8824,114.1765
"26575","86161","2015",9,8,1,110408.6,954,101.2222
"26576","86162","2015",1,1,0,120000,667,180
"26577","86163","2015",22,22,0,228438.1,1686.545,141.4091
"26578","86164","2015",5,5,0,198140,1303.2,132.8
"26579","86165","2015",67,60,7,80321.9,1133.642,73.8806
"26580","86167","2015",3,3,0,122366.7,1302,83.33333
"26581","86169","2015",7,7,0,92542.86,974.8571,97
"26582","86170","2015",4,4,0,72250,639,116.5
"26583","86171","2015",7,7,0,100137.1,1077,95.85714
"26584","86172","2015",3,3,0,120683.3,965,102
"26585","86173","2015",2,2,0,135000,926.5,131.5
"26586","86174","2015",44,43,1,135080,1390.659,99.56818
"26587","86175","2015",4,4,0,134750,1003.25,124.5
"26588","86176","2015",3,3,0,60566.67,566.6667,124.6667
"26589","86177","2015",44,43,1,144053.2,1520.568,100.6364
"26590","86178","2015",17,17,0,167880.9,1424.118,119.6471
"26591","86180","2015",35,35,0,165385.5,1573.086,106.3143
"26592","86181","2015",4,4,0,1e+05,1119,97.25
"26593","86182","2015",5,5,0,99600,1118,93
"26594","86183","2015",12,12,0,114333.3,1239.583,92
"26595","86184","2015",6,6,0,104666.7,1121.667,97.83333
"26596","86186","2015",3,3,0,168333.3,1316.667,129
"26597","86187","2015",6,6,0,75083.33,883.3333,84
"26598","86189","2015",3,3,0,51333.33,444.6667,123.3333
"26599","86190","2015",10,10,0,99900,982.3,103.8
"26600","86191","2015",6,6,0,95203.33,829.3333,123.6667
"26601","86192","2015",2,2,0,85000,910,98
"26602","86193","2015",8,8,0,112850.2,864.625,116.5
"26603","86194","2015",1132,467,665,114186.1,1702.83,68.77915
"26604","86195","2015",9,9,0,70888.89,974.5556,76.55556
"26605","86196","2015",3,3,0,93800,969.6667,99.33333
"26606","86197","2015",3,3,0,92166.67,1127.333,81.66667
"26607","86198","2015",1,1,0,153000,1681,91
"26608","86200","2015",7,7,0,76817.29,1261.571,86.42857
"26609","86201","2015",2,2,0,67500,456,148
"26610","86202","2015",6,6,0,103916.7,1189.833,107
"26611","86203","2015",7,7,0,44714.29,646.1429,77.28571
"26612","86204","2015",19,19,0,206958.4,1745.053,123.4737
"26613","86206","2015",1,1,0,226050,1884,120
"26614","86207","2015",21,19,2,101165.5,1425.048,83.33333
"26615","86209","2015",8,8,0,129887.5,1520.125,89.125
"26616","86210","2015",9,9,0,130455.6,1218,113.1111
"26617","86211","2015",6,6,0,104250,902.1667,120
"26618","86213","2015",22,22,0,130477.3,1366.909,103.2273
"26619","86214","2015",69,49,20,150670.8,1738.319,88.36232
"26620","86217","2015",3,3,0,132033.3,1042,116.6667
"26621","86218","2015",4,4,0,56731.25,605.5,79.25
"26622","86220","2015",3,3,0,78966.67,814.6667,96
"26623","86221","2015",4,4,0,68987.5,924.25,76
"26624","86222","2015",42,40,2,168136.2,1651.857,103.3333
"26625","86223","2015",9,9,0,106833.3,1042.111,97.77778
"26626","86224","2015",9,9,0,112233.3,979.7778,122.7778
"26627","86225","2015",19,19,0,65357.89,726.5263,91.63158
"26628","86226","2015",15,15,0,161100,1590.067,101.6667
"26629","86228","2015",3,3,0,73100,651.3333,118.6667
"26630","86229","2015",3,3,0,88333.33,1169.333,76
"26631","86230","2015",2,2,0,125000,1305,101
"26632","86231","2015",7,7,0,73959.29,829.2857,96.28571
"26633","86233","2015",26,26,0,109831.5,1171.615,93.23077
"26634","86234","2015",4,4,0,93500,768,119
"26635","86235","2015",16,16,0,96156.25,1083.062,90.625
"26636","86236","2015",7,7,0,74816.43,899.2857,84.28571
"26637","86237","2015",7,7,0,85001.43,762.7143,126.4286
"26638","86239","2015",3,3,0,137833.3,1103,121.6667
"26639","86241","2015",6,6,0,84333.33,1139.833,88.33333
"26640","86242","2015",6,6,0,74000,671.3333,108.3333
"26641","86244","2015",16,16,0,86253.12,1229.688,78.5625
"26642","86245","2015",12,12,0,122805,1294.583,97.41667
"26643","86246","2015",8,8,0,69719.38,799.875,79.125
"26644","86247","2015",7,7,0,118131.4,1393.714,88.42857
"26645","86248","2015",4,4,0,89500,813,109
"26646","86249","2015",2,2,0,95000,891.5,100.5
"26647","86252","2015",3,3,0,76200,985.3333,76.33333
"26648","86253","2015",9,9,0,57692.89,697.5556,83.44444
"26649","86254","2015",10,10,0,94300,908.9,102.4
"26650","86255","2015",8,8,0,107437.5,876.125,119.25
"26651","86256","2015",7,7,0,180249.9,1702.857,113.1429
"26652","86257","2015",7,7,0,101642.9,898.2857,128.7143
"26653","86258","2015",13,13,0,114038.5,1123.769,106.6923
"26654","86260","2015",3,3,0,92666.67,902.6667,104.3333
"26655","86261","2015",17,16,1,172042.1,1523.059,115.1765
"26656","86262","2015",4,4,0,168750,848.5,175.5
"26657","86263","2015",24,24,0,133336.3,1537.792,90.79167
"26658","86264","2015",6,6,0,101666.7,721.3333,143
"26659","86265","2015",3,3,0,110666.7,1355,146
"26660","86266","2015",3,3,0,101666.7,974.3333,111.3333
"26661","86268","2015",7,7,0,121857.1,1224.429,104
"26662","86269","2015",4,4,0,87250,639,131
"26663","86271","2015",10,10,0,102300,1031.6,101.9
"26664","86272","2015",18,18,0,98781.61,948.6111,99.22222
"26665","86273","2015",13,13,0,63946.15,787.3077,75.46154
"26666","86274","2015",6,6,0,112829.2,1082.5,101.6667
"26667","86275","2015",8,8,0,131193.8,1150.25,109.25
"26668","86276","2015",10,10,0,70350,747.1,91
"26669","86279","2015",7,7,0,104678.6,1261.571,88.28571
"26670","86280","2015",7,7,0,89228.57,1180.429,81
"26671","86281","2015",54,54,0,151481.9,1298.389,119.2963
"26672","86284","2015",3,3,0,101833.3,1170.667,86.33333
"26673","86285","2015",10,10,0,84794.6,996.5,82.2
"26674","86286","2015",7,7,0,80000,954.4286,81.28571
"26675","86287","2015",4,4,0,106534.5,1297.25,77.25
"26676","86288","2015",10,10,0,71342,827.7,92
"26677","86289","2015",7,6,1,156985.7,1973.857,87.57143
"26678","86290","2015",13,13,0,146381.8,1406.385,106.6923
"26679","86292","2015",10,10,0,139397,1462.8,97.6
"26680","86293","2015",28,28,0,132377.3,1453.536,95.78571
"26681","86294","2015",29,29,0,161175.9,1558.897,104.3448
"26682","86295","2015",7,7,0,67385.71,937.4286,71.85714
"26683","86296","2015",2,2,0,137500,1500,92.5
"26684","86297","2015",45,45,0,180549.1,1764.867,102.6
"26685","86298","2015",18,18,0,123038.9,1239.278,102.9444
"26686","86299","2015",4,4,0,145450,1364.5,119.75
"26687","86300","2015",2,2,0,72000,548.5,131
"26688","87001","2015",39,34,5,132880,1476.385,94.25641
"26689","87002","2015",56,56,0,140780,1356.518,104.8929
"26690","87003","2015",9,9,0,108780.3,1174.556,103.2222
"26691","87004","2015",3,3,0,92166.67,924.3333,113.3333
"26692","87005","2015",4,4,0,128450,1133.25,117
"26693","87006","2015",6,6,0,109545.8,1232.833,91.83333
"26694","87007","2015",1,1,0,30000,750,40
"26695","87008","2015",2,2,0,82500,743,105
"26696","87009","2015",10,10,0,120240,1313.5,97.2
"26697","87011","2015",29,23,6,96711.31,1176.483,97.58621
"26698","87012","2015",5,5,0,70600,918.2,70.6
"26699","87013","2015",9,9,0,68900,836.5556,84.11111
"26700","87014","2015",23,20,3,84480.43,1056.043,79.78261
"26701","87015","2015",3,3,0,238981.3,1369.667,170.3333
"26702","87016","2015",2,2,0,101665,826.5,115.5
"26703","87017","2015",3,3,0,138000,1486.333,85.33333
"26704","87018","2015",14,14,0,78296.43,767.5714,102.9286
"26705","87019","2015",30,30,0,180589.7,1482.767,126.4667
"26706","87020","2015",8,8,0,140420,1509.75,100.375
"26707","87021","2015",26,26,0,143800,1519.308,96.38462
"26708","87022","2015",1,1,0,95000,841,113
"26709","87023","2015",2,2,0,80500,1182,77.5
"26710","87024","2015",12,12,0,74750,949,90.16667
"26711","87025","2015",12,12,0,155079.2,1475.5,105.6667
"26712","87027","2015",21,20,1,92541.43,1046.048,87.47619
"26713","87028","2015",22,22,0,83059.14,881.2727,98.27273
"26714","87029","2015",5,5,0,114920,924.2,116.8
"26715","87030","2015",9,9,0,123354.4,1206,101.3333
"26716","87031","2015",5,5,0,82300,1059.2,85.2
"26717","87032","2015",21,20,1,83118.1,1027.381,84.33333
"26718","87033","2015",9,9,0,103616.7,1072.667,103.6667
"26719","87034","2015",16,16,0,89108.44,1029.125,89.4375
"26720","87035","2015",6,6,0,109666.7,1489.667,85.66667
"26721","87036","2015",10,10,0,92401.8,1020.7,88.8
"26722","87037","2015",2,2,0,94665,667,139.5
"26723","87038","2015",15,15,0,150746.7,1596.933,95.13333
"26724","87039","2015",12,12,0,92409.17,1385.667,70.91667
"26725","87040","2015",17,17,0,88048.24,868.8824,106
"26726","87041","2015",23,23,0,78392.17,1025.87,82.6087
"26727","87042","2015",9,8,1,93222.22,1043.333,98.55556
"26728","87043","2015",4,4,0,39500,758.75,52.5
"26729","87044","2015",5,5,0,134630,1582.4,107
"26730","87045","2015",13,13,0,100015.4,974.0769,101.0769
"26731","87046","2015",18,17,1,71948.89,951.9444,75.66667
"26732","87047","2015",18,18,0,116169.9,1067.333,107.2778
"26733","87048","2015",46,46,0,138977.8,1469.565,98.80435
"26734","87049","2015",16,16,0,116957.5,1464.562,80.6875
"26735","87050","2015",80,72,8,168291.4,1616.05,108.6125
"26736","87051","2015",7,7,0,44285.71,561.7143,82
"26737","87052","2015",1,1,0,73000,635,115
"26738","87053","2015",1,1,0,66500,1511,44
"26739","87054","2015",15,15,0,85450,1073.533,80.53333
"26740","87056","2015",3,3,0,66426.67,869.3333,79
"26741","87057","2015",1,1,0,30000,333,90
"26742","87058","2015",1,1,0,53720,597,90
"26743","87059","2015",18,17,1,89379.72,954.9444,93.11111
"26744","87060","2015",9,9,0,129427.8,1376.778,96.33333
"26745","87061","2015",4,4,0,106500,866.25,114.25
"26746","87063","2015",8,8,0,152300,1607.25,95.625
"26747","87064","2015",20,18,2,73857.5,817.85,94.3
"26748","87065","2015",44,44,0,174006,1685.727,105.5909
"26749","87066","2015",5,5,0,149590,1329.6,119.6
"26750","87067","2015",2,2,0,40000,572.5,71
"26751","87068","2015",3,3,0,70033.33,529.3333,124.6667
"26752","87069","2015",3,3,0,117285,1104.333,97
"26753","87070","2015",11,10,1,123109.1,1193.909,102.9091
"26754","87071","2015",3,3,0,137666.7,965,154
"26755","87072","2015",9,9,0,100666.7,1151.333,87.44444
"26756","87073","2015",4,4,0,83875,1020,84.5
"26757","87074","2015",3,3,0,90666.67,700.6667,130
"26758","87075","2015",64,59,5,165672.5,1497.406,111.125
"26759","87076","2015",4,4,0,81250,998,81.5
"26760","87077","2015",4,4,0,130800,1280,105
"26761","87078","2015",9,9,0,70911.11,997,67.66667
"26762","87079","2015",9,9,0,96742.22,957.4444,101.5556
"26763","87080","2015",2,2,0,97500,1303.5,87.5
"26764","87081","2015",7,7,0,120814.3,1087.571,116
"26765","87082","2015",16,16,0,77981.25,961.9375,77.375
"26766","87083","2015",5,5,0,81442.6,859.8,92.8
"26767","87085","2015",1526,532,994,101164.1,1365.82,73.16055
"26768","87086","2015",10,9,1,82530,946.8,89.7
"26769","87087","2015",1,1,0,49226,895,55
"26770","87088","2015",17,16,1,102200,1150.882,85.88235
"26771","87089","2015",18,18,0,101680.6,1045.722,99.44444
"26772","87090","2015",5,5,0,101944,857,120.6
"26773","87091","2015",4,4,0,55108.75,814.25,72.5
"26774","87092","2015",8,8,0,111377.5,1094.375,95.375
"26775","87093","2015",3,3,0,37791.67,560.6667,67.66667
"26776","87094","2015",3,3,0,94000,1019,86
"26777","87095","2015",7,7,0,101992.9,1342.429,81.28571
"26778","87096","2015",11,11,0,98363.64,1318.545,90.27273
"26779","87097","2015",11,11,0,100295.5,1045.636,100.6364
"26780","87099","2015",5,5,0,134100,1108.8,121.6
"26781","87100","2015",3,3,0,60000,796.6667,68.33333
"26782","87101","2015",4,4,0,60887.5,669,100.75
"26783","87103","2015",16,16,0,87714.44,962.625,87.9375
"26784","87104","2015",5,5,0,50469.6,708,70.8
"26785","87105","2015",10,10,0,94980,1127.1,92.1
"26786","87106","2015",20,20,0,154699.6,1674.55,103.7
"26787","87107","2015",15,15,0,136473.3,1450.733,97.13333
"26788","87108","2015",13,13,0,113349.2,1322,111.4615
"26789","87109","2015",8,8,0,80127.5,844.875,103.375
"26790","87110","2015",17,17,0,114744.1,1152.882,109.4706
"26791","87111","2015",24,24,0,86887.67,754.0833,115.7083
"26792","87112","2015",2,2,0,77500,894.5,88.5
"26793","87113","2015",39,39,0,148433,1466.077,102.7949
"26794","87114","2015",85,80,5,152888.3,1575.376,100.0471
"26795","87115","2015",2,2,0,131000,1425,95
"26796","87116","2015",9,9,0,114220.9,1272.667,88.44444
"26797","87117","2015",22,22,0,59146.91,846.5455,70.81818
"26798","87118","2015",17,17,0,111965.6,1115.647,102.2353
"26799","87119","2015",14,14,0,106314.3,1423,75.35714
"26800","87120","2015",11,11,0,89073.64,1023.455,96.90909
"26801","87121","2015",5,5,0,71518.6,745.6,97.4
"26802","87122","2015",14,14,0,154400,1235.071,119.1429
"26803","87123","2015",3,3,0,130000,1188,109.3333
"26804","87124","2015",4,4,0,78525,1032,72.75
"26805","87125","2015",29,29,0,159720.7,1569.621,101.6552
"26806","87126","2015",48,48,0,107471.4,1123.333,100.8333
"26807","87127","2015",5,5,0,46400,909,53.6
"26808","87128","2015",18,18,0,85633.33,987.7778,88.5
"26809","87129","2015",8,8,0,134623.8,1433.875,97.75
"26810","87130","2015",6,6,0,136900,1412.5,110.1667
"26811","87131","2015",12,12,0,65747.92,923.75,71.08333
"26812","87132","2015",1,1,0,58000,784,74
"26813","87133","2015",5,4,1,57760,787.4,76.6
"26814","87134","2015",4,4,0,61000,1191.5,75.5
"26815","87135","2015",10,10,0,73525,806.1,88.7
"26816","87137","2015",1,1,0,292075,1460,200
"26817","87138","2015",6,6,0,123666.7,1394.333,89.83333
"26818","87139","2015",9,9,0,82747.78,1384.333,66
"26819","87140","2015",17,17,0,99794.12,1097.353,88.82353
"26820","87141","2015",9,9,0,79789.56,1147.667,68.44444
"26821","87142","2015",8,8,0,95150,1342.625,80.75
"26822","87143","2015",16,16,0,117497,1114.812,101.4375
"26823","87144","2015",4,4,0,150305,1145,136
"26824","87145","2015",3,3,0,64833.33,661,100
"26825","87146","2015",6,6,0,130085,1293.5,105.3333
"26826","87147","2015",1,1,0,59000,1439,41
"26827","87148","2015",6,6,0,131393.3,1111.833,113.5
"26828","87149","2015",1,1,0,160000,1333,120
"26829","87150","2015",15,15,0,111933.3,1470.867,76.86667
"26830","87151","2015",6,6,0,197858,1682.333,109
"26831","87152","2015",9,9,0,131722.2,1351.222,101.7778
"26832","87153","2015",6,6,0,77721.67,841.6667,93.5
"26833","87154","2015",94,90,4,119872.9,1232.755,99.2234
"26834","87155","2015",4,4,0,59875,733,78.25
"26835","87156","2015",9,9,0,121977.8,1136.333,111.4444
"26836","87157","2015",14,14,0,106142.9,1219.5,88.85714
"26837","87158","2015",16,16,0,111507,1068.812,105.6875
"26838","87159","2015",2,2,0,71000,728.5,110
"26839","87160","2015",12,12,0,138059.2,1294.167,110.75
"26840","87161","2015",43,41,2,108707.4,1149.651,96.09302
"26841","87162","2015",1,1,0,60000,833,72
"26842","87163","2015",3,3,0,45000,697.6667,67.66667
"26843","87164","2015",4,4,0,98500,1027,95.75
"26844","87165","2015",7,7,0,109714.3,1094.429,104.2857
"26845","87166","2015",7,7,0,135665.7,1414.143,96.28571
"26846","87167","2015",7,7,0,84777.14,1242.286,74.14286
"26847","87168","2015",7,7,0,141542.9,845,177.4286
"26848","87170","2015",8,8,0,64250,738.25,88.875
"26849","87172","2015",2,2,0,205000,936.5,167.5
"26850","87174","2015",12,12,0,125337.5,1060.083,115.5833
"26851","87176","2015",10,10,0,104587.7,1180.9,93.4
"26852","87177","2015",19,18,1,126957.4,1221.842,105.9474
"26853","87178","2015",32,31,1,115431.7,1306.781,88.75
"26854","87179","2015",4,4,0,209500,2664.25,88.5
"26855","87180","2015",7,7,0,65142.86,663.1429,100.7143
"26856","87181","2015",8,8,0,67037.5,786,81.25
"26857","87182","2015",16,16,0,69883.75,941.0625,84.5625
"26858","87183","2015",10,10,0,95110,930.2,109.3
"26859","87185","2015",20,20,0,120175,1272,92.2
"26860","87186","2015",3,3,0,65666.67,890,71.66667
"26861","87187","2015",66,63,3,98763.64,1147.909,87
"26862","87188","2015",5,5,0,112260,1128.4,99
"26863","87189","2015",4,4,0,86071.25,873.5,109.25
"26864","87190","2015",13,13,0,108730.8,1291.538,84.07692
"26865","87191","2015",14,14,0,108315.5,1235.286,95.78571
"26866","87192","2015",8,8,0,141731.2,1482.125,92.125
"26867","87193","2015",1,1,0,85000,1371,62
"26868","87194","2015",6,6,0,60333.33,643.8333,104.6667
"26869","87195","2015",1,1,0,41000,539,76
"26870","87197","2015",8,8,0,137613.1,1580.375,97.5
"26871","87198","2015",14,14,0,67321.43,757,92.42857
"26872","87199","2015",13,13,0,87557.69,1002.923,101.6154
"26873","87200","2015",2,2,0,110000,1273.5,88
"26874","87201","2015",35,35,0,160361.1,1473.714,110.4571
"26875","87202","2015",23,23,0,131007.8,1316.652,99.52174
"26876","87203","2015",12,12,0,104141.7,1296.25,80.08333
"26877","87204","2015",5,5,0,74240,1118,65.8
"26878","87205","2015",17,16,1,144594.1,1373.882,106.6471
"26879","87206","2015",5,5,0,47400,508.6,94.2
"26880","88002","2015",2,2,0,105000,745.5,143.5
"26881","88005","2015",3,3,0,148220,1102,163.3333
"26882","88006","2015",3,1,2,81000,742.3333,113.6667
"26883","88008","2015",3,2,1,80500,895.3333,110
"26884","88009","2015",39,36,3,127423.5,1361.949,94.28205
"26885","88011","2015",14,13,1,133078.6,1117.357,123.1429
"26886","88012","2015",7,6,1,84557.14,1055.571,77.57143
"26887","88014","2015",1,1,0,168000,1273,132
"26888","88015","2015",1,1,0,240000,1600,150
"26889","88016","2015",1,1,0,45000,500,90
"26890","88017","2015",1,1,0,98500,1082,91
"26891","88019","2015",3,3,0,63666.67,715,82.66667
"26892","88020","2015",1,1,0,104000,1891,55
"26893","88026","2015",5,5,0,162970,1250.6,129.8
"26894","88027","2015",3,3,0,161500,1350.333,113.3333
"26895","88028","2015",3,3,0,141800,868,140.6667
"26896","88029","2015",13,13,0,110847.7,946.7692,123.5385
"26897","88030","2015",2,2,0,142125,1854.5,113
"26898","88031","2015",2,2,0,81500,922,89
"26899","88032","2015",15,13,2,103900,1157.533,90.26667
"26900","88033","2015",1,1,0,60000,504,119
"26901","88035","2015",4,4,0,110692.5,1246,94.25
"26902","88036","2015",3,3,0,86666.67,740.6667,104
"26903","88037","2015",9,9,0,135337.2,1381.556,98.44444
"26904","88039","2015",1,1,0,45000,346,130
"26905","88040","2015",1,1,0,150000,1145,131
"26906","88041","2015",1,1,0,247200,651,380
"26907","88043","2015",1,1,0,37500,399,94
"26908","88044","2015",4,4,0,113562.5,940.5,123
"26909","88046","2015",1,1,0,133000,1157,115
"26910","88047","2015",3,3,0,81400,842.6667,94.66667
"26911","88048","2015",11,11,0,131619.2,1700.818,101.9091
"26912","88050","2015",2,2,0,45000,739,63.5
"26913","88052","2015",1,1,0,80000,860,93
"26914","88053","2015",6,6,0,116028.8,938.8333,111
"26915","88054","2015",5,5,0,165200,1217.8,147.2
"26916","88055","2015",3,3,0,127500,1050.333,138.6667
"26917","88056","2015",1,1,0,114000,814,140
"26918","88057","2015",1,1,0,80000,432,185
"26919","88058","2015",1,1,0,85000,810,105
"26920","88059","2015",6,4,2,92750,834.3333,101.5
"26921","88061","2015",1,1,0,85000,612,139
"26922","88062","2015",1,1,0,37000,356,104
"26923","88063","2015",3,3,0,145383.3,1077.333,137
"26924","88064","2015",2,2,0,80000,781.5,102
"26925","88065","2015",3,3,0,78000,828.3333,95.33333
"26926","88068","2015",11,11,0,100086.4,1233,84.72727
"26927","88069","2015",1,1,0,190000,1131,168
"26928","88070","2015",2,2,0,119000,979.5,123
"26929","88073","2015",1,1,0,208000,1261,165
"26930","88075","2015",72,28,44,114045.4,1735.625,69.76389
"26931","88076","2015",1,1,0,178000,913,195
"26932","88077","2015",4,4,0,117875,1050.75,105.25
"26933","88078","2015",22,15,7,93920.45,1002.455,96.59091
"26934","88079","2015",12,12,0,145299.2,1243.333,117.5
"26935","88081","2015",9,8,1,66000,1057.889,74.11111
"26936","88082","2015",10,9,1,69350,702.6,95.4
"26937","88083","2015",2,2,0,109500,1040,104.5
"26938","88084","2015",8,8,0,105000,1063.125,107.75
"26939","88085","2015",2,2,0,88075,1407,68.5
"26940","88086","2015",7,7,0,128380.4,1115.857,112
"26941","88087","2015",28,20,8,137995,1405.286,92.96429
"26942","88088","2015",10,10,0,105138.3,1102.6,93.3
"26943","88089","2015",4,4,0,115075,1044.75,106.5
"26944","88090","2015",40,33,7,133117.6,1312.85,102.875
"26945","88091","2015",2,2,0,145990,1400,129
"26946","88092","2015",6,6,0,90926.67,1419.667,91
"26947","88094","2015",8,6,2,114701.9,1135.625,97.875
"26948","88095","2015",6,6,0,122050,1033.833,118.1667
"26949","88098","2015",10,10,0,136115.1,1492.9,98
"26950","88099","2015",10,8,2,113035,1329.9,91.6
"26951","88101","2015",19,17,2,120284.2,1198.053,105
"26952","88104","2015",2,2,0,64000,1372,45
"26953","88106","2015",17,15,2,130390,1382.235,93.52941
"26954","88108","2015",7,6,1,78242.86,961.1429,87.57143
"26955","88109","2015",2,2,0,178500,1884.5,98
"26956","88110","2015",2,2,0,87500,974,95.5
"26957","88111","2015",4,4,0,143250,1053,137
"26958","88113","2015",2,2,0,57500,538.5,106
"26959","88114","2015",20,16,4,91950.85,994.95,93.4
"26960","88115","2015",7,7,0,103485.7,1067.429,105.1429
"26961","88116","2015",29,18,11,95358.62,1076.345,92.27586
"26962","88118","2015",2,2,0,79750,764.5,98.5
"26963","88119","2015",2,2,0,46250,493,94
"26964","88120","2015",12,12,0,111250,1135.667,100.1667
"26965","88121","2015",2,2,0,54250,514.5,107
"26966","88122","2015",3,3,0,101100,778.6667,133
"26967","88123","2015",3,3,0,46500,499,90.66667
"26968","88124","2015",6,5,1,73851.67,813.5,87.66667
"26969","88126","2015",17,12,5,120611.2,1252.471,95.05882
"26970","88127","2015",1,1,0,153000,1404,109
"26971","88129","2015",1,1,0,70000,1000,70
"26972","88132","2015",6,5,1,92516.67,995.3333,95.5
"26973","88134","2015",4,4,0,165200,1410,118.5
"26974","88135","2015",4,3,1,104875,992,121.25
"26975","88136","2015",9,9,0,131455.6,942.1111,139
"26976","88137","2015",1,1,0,54100,644,84
"26977","88138","2015",1,1,0,90000,450,200
"26978","88139","2015",1,1,0,2e+05,1176,170
"26979","88140","2015",3,3,0,50008.33,452.6667,109
"26980","88147","2015",2,2,0,162775,1592,101
"26981","88148","2015",11,10,1,138818.2,1220.636,118.3636
"26982","88151","2015",8,7,1,131555.1,1284,103.125
"26983","88153","2015",5,5,0,118780,1184.6,112
"26984","88154","2015",1,1,0,55000,505,109
"26985","88155","2015",1,1,0,72000,791,91
"26986","88156","2015",1,1,0,116100,1222,95
"26987","88157","2015",7,7,0,171705.7,1292.286,130
"26988","88158","2015",20,11,9,113669.7,1259.05,91.35
"26989","88159","2015",4,4,0,117500,1090.5,107
"26990","88160","2015",346,140,206,99718.07,1202.197,82.30636
"26991","88161","2015",5,5,0,87920,781.2,108.6
"26992","88162","2015",1,1,0,131450,1195,110
"26993","88163","2015",6,6,0,135483.3,1188.833,113.6667
"26994","88164","2015",1,1,0,22000,550,40
"26995","88165","2015",19,18,1,108091.6,1146.526,98.52632
"26996","88166","2015",4,4,0,120327.5,920.5,136
"26997","88167","2015",2,2,0,163250,1737.5,94
"26998","88168","2015",1,1,0,82000,854,96
"26999","88169","2015",3,3,0,134433.3,1274.667,103
"27000","88170","2015",7,7,0,101342.9,1153.714,90.71429
"27001","88172","2015",3,3,0,160000,1525,104.6667
"27002","88173","2015",3,3,0,154816.7,1740.333,91
"27003","88175","2015",7,7,0,125900,1278.714,99
"27004","88176","2015",6,6,0,65700,914.5,70.5
"27005","88177","2015",8,8,0,146375,1634.25,96.5
"27006","88178","2015",14,14,0,138735.7,1507.643,92.92857
"27007","88179","2015",1,1,0,115000,833,138
"27008","88181","2015",22,19,3,104129.5,1213.273,93
"27009","88182","2015",1,1,0,212000,2494,85
"27010","88183","2015",1,1,0,28000,560,50
"27011","88184","2015",5,5,0,90600,834.6,105.6
"27012","88185","2015",1,1,0,30000,400,75
"27013","88188","2015",20,17,3,93581.2,1001.5,96.4
"27014","88192","2015",1,1,0,25000,373,67
"27015","88193","2015",1,1,0,135000,1552,87
"27016","88195","2015",2,2,0,37500,583.5,62.5
"27017","88196","2015",165,41,124,120573.8,1817.527,70.25455
"27018","88197","2015",3,3,0,155000,1252.667,132.6667
"27019","88198","2015",10,10,0,129527.2,1143.3,124.1
"27020","88200","2015",2,2,0,66150,781,82
"27021","88201","2015",10,10,0,111770,1205.2,100.2
"27022","88205","2015",2,2,0,94500,1132,84
"27023","88206","2015",5,5,0,60520,690.6,90.4
"27024","88208","2015",1,1,0,22000,400,55
"27025","88209","2015",82,51,31,110802.4,1256.317,88.02439
"27026","88210","2015",1,1,0,50000,500,100
"27027","88213","2015",1,1,0,64000,1049,61
"27028","88215","2015",2,2,0,93050,1011,92.5
"27029","88216","2015",3,3,0,164383.3,1547,110.6667
"27030","88218","2015",23,22,1,87356.96,1137.609,79.47826
"27031","88219","2015",1,1,0,43000,478,90
"27032","88220","2015",1,1,0,90200,949,95
"27033","88222","2015",2,2,0,154000,982.5,150.5
"27034","88223","2015",1,1,0,123000,946,130
"27035","88224","2015",2,2,0,134000,1549.5,86.5
"27036","88225","2015",13,12,1,106051.9,1083.538,103.7692
"27037","88227","2015",2,2,0,54100,494.5,114
"27038","88228","2015",1,1,0,43000,544,79
"27039","88229","2015",2,2,0,86250,705.5,121.5
"27040","88230","2015",2,2,0,107050,1162.5,88
"27041","88231","2015",2,2,0,145000,1041,139.5
"27042","88232","2015",1,1,0,1e+05,671,149
"27043","88233","2015",3,3,0,90000,753.6667,119.3333
"27044","88236","2015",1,1,0,75000,452,166
"27045","88237","2015",3,3,0,130666.7,1184.333,107
"27046","88238","2015",3,3,0,101750,865.6667,104.3333
"27047","88239","2015",2,2,0,116000,1414,80.5
"27048","88240","2015",3,2,1,73666.67,775.3333,98.66667
"27049","88241","2015",2,2,0,119850,1091,111.5
"27050","88243","2015",3,3,0,140166.7,918,155.6667
"27051","88244","2015",5,4,1,94000,947,100
"27052","88245","2015",1,1,0,110000,759,145
"27053","88246","2015",5,5,0,89240,843.8,113.2
"27054","88247","2015",10,9,1,98950,1148.8,85.3
"27055","88250","2015",5,4,1,118800,1161.6,105.4
"27056","88251","2015",11,11,0,118145.5,1061.182,110.3636
"27057","88253","2015",8,7,1,165587.5,1522.875,114.875
"27058","88256","2015",2,2,0,60950,1453,48.5
"27059","88257","2015",1,1,0,65000,793,82
"27060","88258","2015",8,8,0,59856.25,549.5,107.25
"27061","88259","2015",2,1,1,28000,1447,39
"27062","88260","2015",1,1,0,188000,1635,115
"27063","88261","2015",6,6,0,145833.3,1142.333,129.6667
"27064","88262","2015",7,4,3,61642.86,769.4286,77
"27065","88263","2015",2,2,0,154827.5,1476.5,105
"27066","88264","2015",1,1,0,39900,798,50
"27067","88266","2015",6,4,2,101066.7,894.1667,110.3333
"27068","88267","2015",1,1,0,1e+05,345,290
"27069","88269","2015",4,4,0,143212.5,1597,95
"27070","88270","2015",10,10,0,102022.5,892.6,116.5
"27071","88271","2015",2,2,0,65000,861,65
"27072","88273","2015",4,4,0,149637.5,1374,120.5
"27073","88274","2015",1,1,0,46200,428,108
"27074","88275","2015",5,4,1,129040,1089.2,120
"27075","88276","2015",6,6,0,79333.33,692.3333,112
"27076","88278","2015",1,1,0,51500,844,61
"27077","88280","2015",1,1,0,163500,1062,154
"27078","88281","2015",1,1,0,70000,1400,50
"27079","88284","2015",5,5,0,104150,1022.2,101
"27080","88285","2015",1,1,0,60000,556,108
"27081","88286","2015",1,1,0,110000,576,191
"27082","88289","2015",4,4,0,65750,687.75,98.5
"27083","88291","2015",1,1,0,108500,1096,99
"27084","88292","2015",5,5,0,85375,915,92.4
"27085","88293","2015",2,2,0,61782.5,941,62.5
"27086","88294","2015",1,1,0,132000,985,134
"27087","88295","2015",4,4,0,102500,1090.5,95.25
"27088","88296","2015",2,2,0,75000,874.5,87
"27089","88297","2015",2,2,0,92000,1012.5,103
"27090","88299","2015",1,1,0,133000,917,145
"27091","88301","2015",3,3,0,76666.67,770.3333,98
"27092","88302","2015",9,9,0,105577.8,1106,93.77778
"27093","88303","2015",1,1,0,97000,822,118
"27094","88304","2015",29,20,9,89556.93,881.4483,101.3793
"27095","88306","2015",1,1,0,70000,579,121
"27096","88310","2015",2,2,0,60000,397,153
"27097","88312","2015",1,1,0,87500,1182,74
"27098","88313","2015",4,4,0,97122.5,818.5,121.75
"27099","88315","2015",5,5,0,112324,945.4,126
"27100","88317","2015",7,6,1,101513.6,1113.286,94.85714
"27101","88319","2015",26,22,4,90163.46,939.2692,93.42308
"27102","88320","2015",9,9,0,139288.9,1138.556,127.4444
"27103","88321","2015",41,37,4,98729.15,993.6341,103.1951
"27104","88322","2015",3,3,0,114951.7,964,123
"27105","88324","2015",5,4,1,75960,697,106.6
"27106","88325","2015",2,2,0,104125,805,123.5
"27107","88326","2015",4,4,0,108250,1232.5,90
"27108","88327","2015",15,14,1,97938.13,1118.067,90.2
"27109","88328","2015",2,2,0,165250,1272,132.5
"27110","88330","2015",1,1,0,127000,1067,119
"27111","88331","2015",1,1,0,90000,643,140
"27112","88334","2015",4,3,1,78500,729.75,110
"27113","88335","2015",3,3,0,137550,1681.333,104.3333
"27114","88340","2015",4,3,1,142750,1238.25,118.25
"27115","88341","2015",3,3,0,91666.67,1219,75.33333
"27116","88342","2015",2,2,0,87250,855,107
"27117","88343","2015",4,4,0,53568.25,548.75,97.25
"27118","88344","2015",2,2,0,99250,1305,79
"27119","88346","2015",1,1,0,40000,364,110
"27120","88348","2015",1,1,0,95600,1328,72
"27121","88349","2015",20,14,6,94280,1095.6,86.75
"27122","88350","2015",1,1,0,248000,1355,183
"27123","88351","2015",10,8,2,68850,956.6,75.7
"27124","88352","2015",1,0,1,55000,585,94
"27125","88355","2015",12,12,0,83316.67,873.5833,103.25
"27126","88356","2015",1,1,0,106000,707,150
"27127","88357","2015",1,1,0,120000,1600,75
"27128","88358","2015",20,19,1,138339,1193.1,113.55
"27129","88361","2015",8,8,0,118680.6,974.25,120
"27130","88362","2015",2,2,0,112500,1554.5,74.5
"27131","88364","2015",1,1,0,165000,1122,147
"27132","88365","2015",2,2,0,87500,685.5,131.5
"27133","88367","2015",35,32,3,80921.57,874.8,93.42857
"27134","88368","2015",2,2,0,94500,746,128
"27135","88369","2015",7,7,0,111750,1018.143,115.8571
"27136","88371","2015",4,3,1,112875,896.5,117.5
"27137","88372","2015",52,42,10,91861,1060.827,94.65385
"27138","88373","2015",2,2,0,106750,1504.5,81
"27139","88375","2015",1,1,0,88711,1044,85
"27140","88376","2015",1,1,0,80000,920,87
"27141","88377","2015",1,1,0,70000,609,115
"27142","88380","2015",3,3,0,113733.3,1248.333,117.6667
"27143","88381","2015",3,3,0,76666.67,969.3333,76.33333
"27144","88383","2015",115,35,80,93786.07,1095.026,85.2
"27145","88385","2015",3,3,0,53383.33,677.6667,79.33333
"27146","88386","2015",9,9,0,114988.9,1012.222,129.1111
"27147","88387","2015",1,1,0,85000,1349,63
"27148","88388","2015",1,1,0,195000,1393,140
"27149","88391","2015",10,7,3,143552.5,1243.8,124.9
"27150","88393","2015",3,3,0,80656.67,721.3333,107
"27151","88394","2015",1,1,0,30000,750,40
"27152","88395","2015",4,4,0,156250,1079.75,145.5
"27153","88398","2015",1,1,0,73930,569,130
"27154","88400","2015",1,1,0,74001,578,128
"27155","88401","2015",2,2,0,134272.5,1010.5,132.5
"27156","88406","2015",1,1,0,155000,1250,124
"27157","88408","2015",36,33,3,99497.78,984.9722,102.3333
"27158","88409","2015",18,13,5,117828.1,1181.5,95.55556
"27159","88410","2015",3,3,0,87333.33,913.6667,95
"27160","88412","2015",8,8,0,97550,815.875,128.875
"27161","88413","2015",177,102,75,100810.7,1046.921,96.33333
"27162","88415","2015",32,23,9,124108.6,1355.844,91.5
"27163","88416","2015",1,1,0,60000,400,150
"27164","88417","2015",3,3,0,88000,906,98.33333
"27165","88423","2015",11,11,0,125736.4,1312.909,99.90909
"27166","88424","2015",20,18,2,133107.5,1375.6,97.5
"27167","88426","2015",6,4,2,64962.5,893.5,82.66667
"27168","88428","2015",11,9,2,120259.5,1077.727,109.4545
"27169","88429","2015",23,20,3,153915.7,1652.522,98.78261
"27170","88430","2015",5,5,0,77942.4,804.2,85.8
"27171","88432","2015",1,1,0,38000,418,91
"27172","88433","2015",1,1,0,53000,662,80
"27173","88435","2015",2,2,0,113750,936.5,138.5
"27174","88436","2015",1,1,0,50000,833,60
"27175","88437","2015",1,1,0,40000,392,102
"27176","88438","2015",5,5,0,102000,1020.2,100
"27177","88439","2015",5,5,0,153160,1648,100.6
"27178","88442","2015",2,2,0,122200,1018,120
"27179","88444","2015",1,1,0,30000,375,80
"27180","88445","2015",24,20,4,142495.8,1328.125,106.7083
"27181","88446","2015",4,4,0,55250,670.25,82.25
"27182","88447","2015",20,17,3,114510,1251,98.65
"27183","88448","2015",2,2,0,93150,667,139.5
"27184","88449","2015",3,3,0,79333.33,840.3333,93
"27185","88450","2015",2,2,0,60000,508,115
"27186","88451","2015",23,18,5,77397.83,852.3478,93.3913
"27187","88452","2015",1,1,0,80000,667,120
"27188","88454","2015",1,1,0,50000,549,91
"27189","88457","2015",1,1,0,75000,938,80
"27190","88458","2015",5,5,0,139700,1147.8,132.8
"27191","88459","2015",1,1,0,90050,948,95
"27192","88460","2015",6,5,1,132000,1258.167,118.6667
"27193","88461","2015",2,2,0,108500,617.5,170
"27194","88462","2015",12,10,2,103791.7,1200.167,91.08333
"27195","88463","2015",17,16,1,114872.9,999.4706,111.5882
"27196","88464","2015",5,5,0,111200,1460.4,115
"27197","88465","2015",95,66,29,96958.42,1193.232,85.83158
"27198","88466","2015",1,1,0,99000,1165,85
"27199","88467","2015",2,2,0,76250,579,135
"27200","88468","2015",22,17,5,97609.55,955.1818,101.5909
"27201","88469","2015",2,2,0,105640,715,144.5
"27202","88470","2015",21,15,6,121150.1,1585.81,88
"27203","88471","2015",1,1,0,40100,501,80
"27204","88472","2015",2,2,0,209525,1146,196.5
"27205","88473","2015",1,1,0,57000,877,65
"27206","88476","2015",1,1,0,96900,1275,76
"27207","88477","2015",2,2,0,52500,438,115
"27208","88478","2015",1,1,0,70000,700,100
"27209","88479","2015",6,6,0,98166.67,827.8333,127.8333
"27210","88480","2015",1,1,0,135000,1164,116
"27211","88481","2015",13,10,3,136030.8,1229.308,106.1538
"27212","88482","2015",1,1,0,68000,618,110
"27213","88483","2015",22,21,1,165900.7,1563.955,106
"27214","88484","2015",6,6,0,142084.7,1271.667,111.8333
"27215","88485","2015",2,2,0,61500,575,108
"27216","88486","2015",32,28,4,116476.6,1212.25,100.4375
"27217","88487","2015",29,26,3,100629.3,1037.931,96.89655
"27218","88488","2015",3,3,0,101433.3,890,129.3333
"27219","88490","2015",1,1,0,150000,1293,116
"27220","88492","2015",1,1,0,185000,2534,73
"27221","88495","2015",2,2,0,118250,848,136.5
"27222","88497","2015",5,5,0,101097.4,989.6,106.6
"27223","88498","2015",3,2,1,120856.7,1066.333,123
"27224","88500","2015",18,13,5,138480.6,1659.167,90.72222
"27225","88503","2015",3,3,0,102033.3,974.3333,116
"27226","88504","2015",1,1,0,123740,952,130
"27227","88506","2015",2,2,0,89000,758.5,109
"27228","88508","2015",2,2,0,119750,1722.5,68.5
"27229","88509","2015",1,1,0,70000,625,112
"27230","88511","2015",1,1,0,80000,1000,80
"27231","88512","2015",3,3,0,106666.7,1089,115
"27232","88513","2015",12,12,0,91602.08,1192.417,79.75
"27233","88515","2015",2,2,0,87500,649.5,139.5
"27234","88516","2015",54,36,18,119412.5,1162.037,100.3704
"27235","88517","2015",3,3,0,104500,882,111.3333
"27236","88519","2015",3,2,1,116866.7,990.6667,110.6667
"27237","88521","2015",1,1,0,185500,1484,125
"27238","88522","2015",3,3,0,126000,1030.333,123.3333
"27239","88524","2015",6,6,0,97183.33,895,110.6667
"27240","88525","2015",2,2,0,115000,978,131
"27241","88526","2015",3,3,0,136333.3,1304.667,97
"27242","88527","2015",1,1,0,50365,607,83
"27243","88528","2015",3,3,0,138800,1013.667,139
"27244","88529","2015",1,1,0,95000,931,102
"27245","88530","2015",18,18,0,108763.9,1079.167,108.2778
"27246","88531","2015",42,14,28,105573.8,1595.381,71.47619
"27247","89003","2015",37,36,1,119031.5,1356.649,91.62162
"27248","89004","2015",2,2,0,73375,966,82.5
"27249","89005","2015",7,6,1,63821.43,651,97.14286
"27250","89006","2015",2,2,0,53750,1000,50
"27251","89007","2015",7,7,0,65257.14,767.2857,84.14286
"27252","89008","2015",2,2,0,108500,1399,78
"27253","89009","2015",4,4,0,94250,908.75,105.5
"27254","89010","2015",6,6,0,120936.7,1221.5,102.1667
"27255","89012","2015",1,1,0,126000,1086,116
"27256","89013","2015",40,39,1,133529.6,1433.275,92.85
"27257","89014","2015",8,8,0,88312.5,1030.875,87.625
"27258","89015","2015",10,10,0,93800,927.7,100
"27259","89016","2015",1,1,0,65000,756,86
"27260","89017","2015",5,5,0,59200,840.8,71.8
"27261","89018","2015",7,7,0,83000,1139.286,78.57143
"27262","89019","2015",2,2,0,68025,983,69
"27263","89020","2015",3,3,0,51000,711.6667,72.66667
"27264","89021","2015",7,7,0,100778.6,1045.143,87.42857
"27265","89022","2015",2,2,0,135850,1363.5,99.5
"27266","89023","2015",9,8,1,109823.3,1363.667,78.33333
"27267","89024","2015",406,183,223,118709.6,1607.002,75.73399
"27268","89025","2015",57,44,13,109566.9,1354.825,83.89474
"27269","89027","2015",4,4,0,112000,892.75,125.75
"27270","89029","2015",13,13,0,103884.6,1174.769,85.53846
"27271","89030","2015",6,6,0,126766.7,1404.667,88.66667
"27272","89031","2015",6,6,0,171850,1308.833,138.1667
"27273","89033","2015",10,10,0,129091,1099.8,122.8
"27274","89034","2015",5,5,0,117845,1303,102
"27275","89035","2015",3,3,0,139000,1276,110.3333
"27276","89036","2015",5,5,0,173920,1193.8,152.2
"27277","89037","2015",3,3,0,81666.67,1005,82.66667
"27278","89039","2015",1,1,0,120000,732,164
"27279","89040","2015",2,2,0,85500,991.5,96
"27280","89041","2015",2,2,0,104500,1095.5,101.5
"27281","89042","2015",4,4,0,74640,1039.5,61.5
"27282","89043","2015",1,1,0,150000,1304,115
"27283","89045","2015",2,2,0,105450,842.5,121.5
"27284","89046","2015",17,17,0,71676.47,803.5294,97.05882
"27285","89048","2015",10,10,0,119505,1014.3,114.3
"27286","89050","2015",17,17,0,127386.5,1454.353,90.82353
"27287","89051","2015",11,11,0,108727.3,1134,105.3636
"27288","89053","2015",7,7,0,117571.4,1384.429,88.57143
"27289","89054","2015",11,11,0,115345.5,1430.909,82.81818
"27290","89055","2015",30,30,0,87200,1035.4,87.4
"27291","89056","2015",6,6,0,102366.7,1359.667,73.16667
"27292","89057","2015",2,2,0,86340,1245.5,70
"27293","89058","2015",2,2,0,102300,968,101.5
"27294","89059","2015",4,4,0,150255.5,2036.75,73.25
"27295","89060","2015",4,4,0,106825,890.25,116.75
"27296","89061","2015",1,1,0,147000,1301,113
"27297","89062","2015",3,3,0,105333.3,871,131.6667
"27298","89063","2015",15,15,0,102230.7,1250.333,80.66667
"27299","89065","2015",3,3,0,110260,1342.333,82
"27300","89066","2015",10,10,0,105600,924.6,112.8
"27301","89067","2015",12,12,0,100375,1386.25,73.41667
"27302","89068","2015",22,22,0,176021.5,1509.273,102.1818
"27303","89069","2015",7,7,0,117637.1,1394,88
"27304","89071","2015",2,2,0,67500,895,83.5
"27305","89072","2015",3,3,0,52500,1132.333,51.33333
"27306","89073","2015",16,16,0,121484.4,1316.125,80.9375
"27307","89074","2015",24,24,0,126331.2,1599.833,80.08333
"27308","89075","2015",5,5,0,179800,1520.4,119.4
"27309","89076","2015",7,7,0,136785.7,1085,130.7143
"27310","89077","2015",17,16,1,132153.9,1512.529,90.58824
"27311","89079","2015",2,2,0,79000,1416,57.5
"27312","89080","2015",6,6,0,118333.3,1440,87.83333
"27313","89083","2015",14,14,0,168550,1537.786,112.4286
"27314","89084","2015",1,1,0,115000,2091,55
"27315","89085","2015",10,10,0,106750,1566.5,69.9
"27316","89086","2015",74,74,0,93421.08,1087.919,89.74324
"27317","89087","2015",4,4,0,86250,1111.25,72
"27318","89088","2015",7,7,0,153601.4,1604.143,100.2857
"27319","89089","2015",2,2,0,38225,978.5,42.5
"27320","89091","2015",10,10,0,76650,1097.4,64.4
"27321","89092","2015",3,3,0,44333.33,752.6667,56.33333
"27322","89093","2015",8,7,1,128500,1591.875,86.125
"27323","89094","2015",10,10,0,130000,1623,88.1
"27324","89095","2015",3,3,0,69500,663.6667,90
"27325","89096","2015",17,17,0,123085.3,1407.529,89.05882
"27326","89098","2015",2,2,0,125500,1193.5,114
"27327","89099","2015",22,22,0,93722.27,1246.727,75.77273
"27328","89100","2015",32,28,4,125619.8,1450.938,91.75
"27329","89102","2015",22,22,0,156904.8,1475.409,105.5
"27330","89104","2015",2,2,0,136950,1827.5,74.5
"27331","89105","2015",4,4,0,123375,963,123.5
"27332","89108","2015",3,3,0,108166.7,1208.333,89.66667
"27333","89111","2015",2,2,0,150875,1701.5,89
"27334","89113","2015",7,7,0,142697.1,1091.143,133
"27335","89115","2015",3,3,0,99000,1367.667,76.33333
"27336","89116","2015",4,4,0,121380,1142.75,108.25
"27337","89117","2015",4,4,0,96500,1183,84.5
"27338","89118","2015",3,3,0,77333.33,762,109.3333
"27339","89119","2015",2,2,0,73500,684.5,111.5
"27340","89120","2015",2,2,0,96000,1229,77.5
"27341","89122","2015",14,14,0,81585.71,924.7143,97
"27342","89123","2015",2,2,0,74500,961.5,80
"27343","89124","2015",9,9,0,145306,1343.222,107.1111
"27344","89125","2015",9,9,0,67934.22,888.2222,83.22222
"27345","89127","2015",8,8,0,153500,1477,105
"27346","89128","2015",1,1,0,50000,806,62
"27347","89129","2015",5,5,0,120860,862.6,132.4
"27348","89130","2015",16,16,0,87562.5,997.0625,89.25
"27349","89131","2015",3,3,0,45333.33,575.6667,83.66667
"27350","89132","2015",2,2,0,93500,841,112
"27351","89133","2015",7,7,0,107834.3,1028,107.7143
"27352","89134","2015",5,5,0,109338,1114.8,106
"27353","89136","2015",4,4,0,87000,1205.5,76.25
"27354","89137","2015",5,5,0,89500,1013.2,105.4
"27355","89139","2015",16,16,0,79255.25,1005.062,78.6875
"27356","89141","2015",1,1,0,115000,1307,88
"27357","89142","2015",13,13,0,105407.7,1294.462,88.38462
"27358","89143","2015",5,5,0,131300,1493,95
"27359","89144","2015",10,10,0,125750,1271.9,107.2
"27360","89145","2015",1,1,0,79000,832,95
"27361","89147","2015",6,6,0,93333.33,1293.167,71.5
"27362","89148","2015",4,4,0,92370,873.75,119.25
"27363","89149","2015",3,3,0,61666.67,663.3333,82.66667
"27364","89150","2015",6,6,0,97033.33,943.3333,108.3333
"27365","89151","2015",8,8,0,112912.5,1221.25,94.25
"27366","89152","2015",8,8,0,91875,1264,78
"27367","89153","2015",3,3,0,114333.3,1262,87.66667
"27368","89154","2015",10,10,0,162480,1365.3,122.6
"27369","89155","2015",5,5,0,250890,1524.6,150.8
"27370","89156","2015",2,2,0,90500,1123,81
"27371","89158","2015",7,7,0,87285.71,958.4286,93.85714
"27372","89159","2015",5,5,0,146728,1588.6,90.8
"27373","89160","2015",9,9,0,129826.7,1427.222,91.55556
"27374","89161","2015",5,5,0,60425.6,587.2,90.2
"27375","89162","2015",3,3,0,159666.7,1625,99.33333
"27376","89163","2015",6,6,0,133800,957.1667,140.5
"27377","89164","2015",1,1,0,88000,1100,80
"27378","89165","2015",2,2,0,124500,883.5,140.5
"27379","89167","2015",11,11,0,131527.3,1242.182,110.7273
"27380","89168","2015",1,1,0,21000,429,49
"27381","89169","2015",7,7,0,111857.1,1205.143,96
"27382","89170","2015",3,3,0,51983.33,760.6667,62.66667
"27383","89171","2015",5,5,0,98000,1021,94.4
"27384","89172","2015",6,6,0,180833.3,1519.833,118.8333
"27385","89173","2015",2,2,0,65000,1071.5,50
"27386","89175","2015",2,2,0,229200,1521,151.5
"27387","89176","2015",1,1,0,134000,1117,120
"27388","89177","2015",3,3,0,69500,817,79.66667
"27389","89179","2015",2,2,0,126000,1543,81.5
"27390","89180","2015",4,4,0,105625,1265.5,89
"27391","89181","2015",1,1,0,130000,594,219
"27392","89182","2015",2,2,0,100875,799,125.5
"27393","89183","2015",1,1,0,45000,500,90
"27394","89186","2015",2,2,0,186000,1296,143.5
"27395","89188","2015",2,2,0,75000,1303.5,51
"27396","89189","2015",6,6,0,132183.8,1459.833,96
"27397","89190","2015",2,2,0,85000,726,108.5
"27398","89191","2015",2,2,0,82000,906.5,90
"27399","89194","2015",3,3,0,137833.3,1125.667,138.6667
"27400","89195","2015",19,19,0,148654.1,1468.947,103
"27401","89196","2015",13,13,0,134624.4,1134.538,122.0769
"27402","89197","2015",10,10,0,93900,904.4,103.5
"27403","89198","2015",14,14,0,119265.4,1372.714,87.14286
"27404","89199","2015",11,11,0,120200,1120.182,125.1818
"27405","89200","2015",10,10,0,130650,1295.6,106.9
"27406","89201","2015",15,15,0,157914.7,1285.4,132.8
"27407","89202","2015",8,8,0,131411.4,1430.125,91.25
"27408","89204","2015",6,6,0,109683.3,1051.333,110.5
"27409","89205","2015",1,1,0,144000,1152,125
"27410","89206","2015",77,59,18,87351.94,1116.442,81.93506
"27411","89208","2015",3,3,0,115716.7,1840.667,73.33333
"27412","89209","2015",2,2,0,136000,1914,71
"27413","89211","2015",1,1,0,33000,611,54
"27414","89212","2015",2,2,0,57500,687.5,92
"27415","89214","2015",4,4,0,86250,806,106.75
"27416","89215","2015",3,3,0,65166.67,535,124
"27417","89216","2015",6,6,0,104250,1382.833,83.83333
"27418","89217","2015",3,3,0,115500,887.6667,141.6667
"27419","89218","2015",12,12,0,107083.3,1328.667,78
"27420","89220","2015",3,3,0,73666.67,825.6667,88.66667
"27421","89221","2015",1,1,0,129072,1698,76
"27422","89222","2015",2,2,0,78000,1083.5,69.5
"27423","89223","2015",4,4,0,140000,1007,139
"27424","89225","2015",1,1,0,120000,1200,100
"27425","89227","2015",13,13,0,94830.77,1003.692,88.76923
"27426","89228","2015",10,9,1,127105,1759.1,77
"27427","89229","2015",3,3,0,117900,1382,86.66667
"27428","89230","2015",7,7,0,107428.6,1202.714,83.14286
"27429","89232","2015",3,3,0,115833.3,1056.667,124
"27430","89233","2015",1,1,0,22000,957,23
"27431","89234","2015",4,4,0,98750,725.5,127.5
"27432","89235","2015",11,11,0,107863.6,1251.364,85.45455
"27433","89236","2015",8,8,0,135262.5,1311.125,107.875
"27434","89237","2015",6,6,0,90916.67,904.6667,106.8333
"27435","89238","2015",7,7,0,97857.14,823.4286,115.4286
"27436","89239","2015",17,16,1,133708.8,1447.882,95.29412
"27437","89240","2015",2,2,0,179950,1521,116
"27438","89242","2015",7,7,0,95957.14,1009.143,100
"27439","89244","2015",1,1,0,28000,1556,18
"27440","89245","2015",7,7,0,144557.9,1403.857,107.1429
"27441","89246","2015",2,2,0,140000,778,179
"27442","89247","2015",5,5,0,88253,838.6,102.2
"27443","89249","2015",1,1,0,90000,1200,75
"27444","89250","2015",1,1,0,45000,672,67
"27445","89251","2015",5,5,0,129800,1687.6,76
"27446","89252","2015",1,1,0,75000,1027,73
"27447","89253","2015",4,4,0,48250,811.75,65.25
"27448","89254","2015",6,6,0,137000,1182.833,108.3333
"27449","89255","2015",12,12,0,110631.7,1422.667,79.25
"27450","89256","2015",5,5,0,112600,1039.2,116.8
"27451","89257","2015",64,52,12,92967.28,1239.188,79.26562
"27452","89259","2015",4,4,0,106500,911.75,123.25
"27453","89261","2015",3,2,1,84000,1047.667,82.66667
"27454","89262","2015",5,5,0,97646.2,1077,87.2
"27455","89263","2015",43,43,0,133859.6,1623.651,86.44186
"27456","89264","2015",10,10,0,375132.7,3190.4,100.8
"27457","89265","2015",5,4,1,116400,1377.4,87
"27458","89266","2015",3,3,0,87000,1009.333,92
"27459","89267","2015",3,3,0,132500,1098.667,111.3333
"27460","89268","2015",5,5,0,100600,1008.6,102.6
"27461","89270","2015",2,2,0,121150.5,670,153.5
"27462","89272","2015",5,5,0,95600,926.4,113.6
"27463","89273","2015",8,8,0,104875,1097.5,101.625
"27464","89274","2015",11,11,0,123909.1,1447.727,83.72727
"27465","89276","2015",18,18,0,110722.2,1097.778,107.9444
"27466","89277","2015",1,1,0,118000,1192,99
"27467","89278","2015",6,6,0,149656.7,985.8333,146.8333
"27468","89279","2015",8,8,0,124826.6,1185.5,103
"27469","89280","2015",4,4,0,123750,1259.75,101.25
"27470","89281","2015",5,5,0,183980,1097.2,157
"27471","89282","2015",6,6,0,127493.2,1166.833,114
"27472","89283","2015",7,6,1,87571.43,957.4286,110.5714
"27473","89284","2015",1,1,0,72000,661,109
"27474","89285","2015",5,5,0,171544,1501.2,120.6
"27475","89286","2015",6,6,0,127933.3,1108.167,120.3333
"27476","89287","2015",60,49,11,128610.8,1659.25,87.8
"27477","89289","2015",2,2,0,87500,998.5,82
"27478","89291","2015",2,2,0,90000,1045.5,88
"27479","89292","2015",3,3,0,110516.7,1154.333,104.3333
"27480","89295","2015",7,7,0,149770,1692.286,94
"27481","89296","2015",1,1,0,74800,890,84
"27482","89297","2015",3,3,0,171333.3,1293,117.6667
"27483","89298","2015",10,10,0,103265.2,1147.9,101.8
"27484","89299","2015",2,2,0,44000,653,76.5
"27485","89300","2015",1,1,0,130000,1477,88
"27486","89302","2015",6,6,0,113833.3,1271.167,90.66667
"27487","89303","2015",2,2,0,120092,1323,94
"27488","89304","2015",11,11,0,108636.4,1063.273,98.54545
"27489","89306","2015",3,3,0,146733.3,1308.667,113
"27490","89307","2015",6,6,0,107950,1302.5,92.5
"27491","89308","2015",1,1,0,138000,1179,117
"27492","89309","2015",29,27,2,114470.3,1519.069,77.31034
"27493","89310","2015",2,2,0,121000,1355,97
"27494","89311","2015",10,10,0,117787.4,1300,112.3
"27495","89312","2015",6,6,0,81320,805.5,104.8333
"27496","89313","2015",6,6,0,84000,952.1667,83.16667
"27497","89314","2015",1,1,0,171500,1191,144
"27498","89316","2015",5,4,1,98907.8,1073.6,86.6
"27499","89318","2015",5,5,0,72200,794.6,84
"27500","89319","2015",5,5,0,159020,1548.8,105.6
"27501","89321","2015",5,5,0,56000,617.4,85
"27502","89323","2015",5,5,0,92000,841.2,107.6
"27503","89324","2015",12,12,0,88908.33,1054.5,95.91667
"27504","89326","2015",11,11,0,177401.8,1457.273,125.4545
"27505","89327","2015",6,6,0,129333.3,989.1667,125.1667
"27506","89328","2015",2,2,0,111450,1224.5,92.5
"27507","89329","2015",3,3,0,101666.7,1236.333,83.66667
"27508","89332","2015",5,5,0,139840,1519.8,92.2
"27509","89334","2015",7,7,0,138704.3,1018.714,151.4286
"27510","89335","2015",10,10,0,78350,1081.2,79.1
"27511","89336","2015",3,3,0,102500,1157.667,87.66667
"27512","89337","2015",13,13,0,130160.8,2357.769,77.07692
"27513","89338","2015",26,18,8,135834.6,1717.346,83
"27514","89339","2015",5,5,0,78872.2,902.8,88.8
"27515","89341","2015",6,6,0,102671.8,1131.167,91.83333
"27516","89342","2015",5,4,1,164940,1613.4,102.2
"27517","89344","2015",24,24,0,94958.33,929.4167,103.7917
"27518","89345","2015",31,25,6,88298.71,1002.032,91.74194
"27519","89346","2015",37,32,5,155719.2,1748.892,91.78378
"27520","89347","2015",4,4,0,95200,1009.25,81.25
"27521","89348","2015",34,32,2,109277.9,1304.588,87
"27522","89349","2015",8,8,0,128455,921.125,139.875
"27523","89350","2015",4,4,0,94375,1078.25,86.75
"27524","89351","2015",1,1,0,162250,1545,105
"27525","89352","2015",2,2,0,144500,1219.5,128
"27526","89353","2015",2,2,0,115500,740.5,171.5
"27527","89354","2015",13,12,1,114618.5,1439.615,81
"27528","89359","2015",3,3,0,82400,937.6667,99.66667
"27529","89360","2015",6,6,0,160386.7,1364.5,124.1667
"27530","89361","2015",3,3,0,106666.7,1026.667,104.3333
"27531","89362","2015",1,1,0,79000,1646,48
"27532","89364","2015",6,6,0,69041.67,1072,68.66667
"27533","89365","2015",8,8,0,127162.5,1466.75,82
"27534","89367","2015",8,8,0,95601.25,943.125,112.875
"27535","89368","2015",8,6,2,76250,909.375,94
"27536","89369","2015",8,8,0,124375,1526.875,85.125
"27537","89370","2015",12,12,0,94417.5,1152,90.41667
"27538","89371","2015",1,1,0,120000,5000,24
"27539","89373","2015",6,6,0,157516.7,1461,117.3333
"27540","89374","2015",1,1,0,106000,981,108
"27541","89376","2015",2,2,0,163000,1828,89
"27542","89377","2015",1,1,0,99000,1253,79
"27543","89378","2015",5,5,0,127980,1345.6,96.4
"27544","89379","2015",2,2,0,90000,935.5,93.5
"27545","89380","2015",13,7,6,155520.9,2761.154,59.53846
"27546","89382","2015",14,14,0,91178.57,1126.357,87.21429
"27547","89384","2015",5,5,0,110600,1327.8,89.2
"27548","89385","2015",1,1,0,60000,545,110
"27549","89386","2015",1,1,0,40000,800,50
"27550","89387","2015",273,128,145,114449.9,1537.993,76.95604
"27551","89388","2015",3,2,1,89244.67,1126.667,86.66667
"27552","89390","2015",12,12,0,143415.8,1487.667,104.0833
"27553","89391","2015",19,19,0,123394.7,1439.474,89.73684
"27554","89392","2015",4,4,0,106575,1421,73.5
"27555","89393","2015",4,4,0,131500,1050,116.5
"27556","89394","2015",3,3,0,58666.67,582.6667,101.3333
"27557","89395","2015",5,5,0,100600,1084,96.2
"27558","89397","2015",9,9,0,106701.9,1182.556,85.22222
"27559","89398","2015",3,3,0,80333.33,1305.667,60
"27560","89399","2015",16,16,0,157425,1543.938,108.4375
"27561","89400","2015",2,2,0,90000,1024,98
"27562","89402","2015",4,4,0,100750,934.75,106
"27563","89403","2015",2,2,0,72000,930.5,80.5
"27564","89404","2015",7,7,0,148857.1,1522,106.2857
"27565","89405","2015",5,5,0,84870,886.2,94.2
"27566","89406","2015",1,1,0,90000,1154,78
"27567","89407","2015",12,12,0,83666.67,945.3333,90.66667
"27568","89408","2015",5,5,0,64400,758.8,82.8
"27569","89409","2015",1,1,0,78000,975,80
"27570","89410","2015",1,1,0,175900,1599,110
"27571","89411","2015",15,15,0,141831,1407.333,119.3333
"27572","89412","2015",3,3,0,358000,3570.333,88
"27573","89413","2015",1,1,0,38500,740,52
"27574","89414","2015",26,26,0,119521.9,1413.269,94.84615
"27575","89415","2015",1,1,0,116621,1405,83
"27576","89416","2015",2,2,0,79500,790.5,109
"27577","89418","2015",22,17,5,87657.27,1151.182,77.54545
"27578","89419","2015",22,21,1,112146.7,1154.136,98.40909
"27579","89420","2015",14,14,0,73007.14,851.4286,94.57143
"27580","89422","2015",1,1,0,84000,1200,70
"27581","89423","2015",1,1,0,50000,532,94
"27582","89424","2015",4,4,0,123575,1351.75,94.5
"27583","89425","2015",8,8,0,82437.5,1024.25,83.375
"27584","89426","2015",1,1,0,82000,1025,80
"27585","89427","2015",3,3,0,84527.67,1096.667,77.33333
"27586","89428","2015",8,8,0,163137.5,1537,111.125
"27587","89430","2015",2,2,0,68500,717.5,115
"27588","89432","2015",3,3,0,90666.67,895,103.6667
"27589","89433","2015",3,3,0,94600,914.6667,98
"27590","89434","2015",2,2,0,123000,1569.5,81
"27591","89436","2015",10,10,0,103058.6,1179.4,87.4
"27592","89437","2015",3,3,0,127000,979.6667,136.3333
"27593","89438","2015",20,20,0,153555,1477.05,106.85
"27594","89439","2015",13,11,2,97897.69,963.7692,101.1538
"27595","89440","2015",5,5,0,156360,1652.2,102
"27596","89441","2015",22,22,0,95188.64,1027.818,95.77273
"27597","89442","2015",1,1,0,153000,956,160
"27598","89443","2015",25,25,0,135698.8,1615.4,89.92
"27599","89445","2015",1,1,0,85000,966,88
"27600","89446","2015",6,6,0,221503.3,1570.333,160.8333
"27601","89447","2015",1,1,0,47000,810,58
"27602","89449","2015",19,19,0,162693.4,1607.105,109.3158
"27603","89450","2015",5,5,0,70700,1296.6,62.8
"27604","89451","2015",2,2,0,138000,1626,85
"27605","89452","2015",6,6,0,72516.67,938.5,89.5
"27606","89453","2015",4,4,0,200862.5,1949.5,113.5
"27607","89456","2015",9,9,0,127444.4,1657,82.66667
"27608","89459","2015",4,3,1,78720,1040.75,76.5
"27609","89460","2015",33,32,1,144357,1594.424,93.72727
"27610","89461","2015",10,10,0,83450,813.7,98.2
"27611","89462","2015",6,6,0,76333.33,1090.167,70.5
"27612","89463","2015",2,2,0,202300,1636,124
"27613","89464","2015",61,55,6,102704.7,1281.82,80.16393
"27614","89465","2015",2,2,0,106000,1334,80.5
"27615","89466","2015",6,6,0,160333.3,1612.333,100.5
"27616","89467","2015",9,9,0,132333.3,1299.556,100.7778
"27617","89468","2015",3,3,0,59333.33,825.3333,80.33333
"27618","89469","2015",17,17,0,110686.8,1312.529,94.64706
"27619","89470","2015",2,2,0,77750,1069.5,73
"27620","89471","2015",8,8,0,90106.12,1251,76.75
"27621","89472","2015",7,7,0,109437.6,1001.714,104.4286
"27622","89474","2015",3,3,0,74000,1052.667,76
"27623","89475","2015",3,3,0,52166.67,665,81.66667
"27624","89478","2015",12,11,1,120527.1,1230.417,97.41667
"27625","89479","2015",6,6,0,94500,1147.667,91.5
"27626","89480","2015",20,20,0,136850,1553.5,95.75
"27627","89481","2015",1,1,0,35000,583,60
"27628","89482","2015",1,1,0,49000,576,85
"27629","89483","2015",6,6,0,129833.3,1480.833,92.33333
"27630","89485","2015",3,3,0,141666.7,971.6667,134.3333
"27631","89486","2015",2,2,0,142648.5,1187,120
"27632","90001","2015",12,10,2,190379.4,1846.5,100.0833
"27633","90002","2015",4,4,0,132050,1430,95
"27634","90003","2015",2,2,0,236875,1703,136
"27635","90004","2015",6,4,2,122216.7,1322.333,99.16667
"27636","90005","2015",6,5,1,105100,973.6667,107
"27637","90006","2015",2,2,0,140000,1145,122.5
"27638","90007","2015",2,2,0,202010,1822.5,113.5
"27639","90008","2015",30,16,14,126893.2,1534.7,82.96667
"27640","90009","2015",49,29,20,104764.8,1188.408,87.12245
"27641","90010","2015",484,86,398,102003.5,1306.523,77.77479
"27642","90011","2015",1,1,0,265100,2039,130
"27643","90012","2015",12,12,0,228770.8,1753.167,136.5833
"27644","90013","2015",1,1,0,262000,2278,115
"27645","90014","2015",2,2,0,197000,1720,114.5
"27646","90015","2015",1,0,1,137500,1375,100
"27647","90017","2015",12,10,2,178955.6,1650.833,110.0833
"27648","90018","2015",1,1,0,163000,1538,106
"27649","90019","2015",1,1,0,277000,1993,139
"27650","90020","2015",1,1,0,90000,978,92
"27651","90021","2015",4,4,0,173695.8,1429.75,122
"27652","90022","2015",21,16,5,129465.8,1368.857,96.52381
"27653","90023","2015",10,9,1,169770,1435.7,125.3
"27654","90025","2015",3,3,0,231233.3,1495,167
"27655","90026","2015",7,5,2,172650,1856.429,95.14286
"27656","90027","2015",1,1,0,120000,1000,120
"27657","90028","2015",4,4,0,207025,1636.5,131.5
"27658","90029","2015",13,10,3,193801.5,1670.154,116.7692
"27659","90031","2015",1,1,0,178000,2000,89
"27660","90032","2015",31,20,11,146022.3,1533.613,95.77419
"27661","90033","2015",52,28,24,121427,1384.519,87.03846
"27662","90035","2015",4,3,1,172337.5,1681.75,101
"27663","90037","2015",14,13,1,159264.3,1691.571,96.92857
"27664","90039","2015",33,25,8,151743.6,1543.212,103.1212
"27665","90041","2015",8,5,3,119187.5,1162.125,107
"27666","90042","2015",19,18,1,193094.2,1775.368,114.6842
"27667","90043","2015",3,3,0,159833.3,1468.333,110.3333
"27668","90044","2015",3,3,0,186000,1569,117
"27669","90045","2015",4,4,0,175250,1445.75,122.25
"27670","90046","2015",4,4,0,138695,1197.75,117.75
"27671","90047","2015",8,8,0,159125,1385,116
"27672","90048","2015",4,4,0,204892.5,1523.5,134.5
"27673","90049","2015",11,8,3,143276.4,1446.273,101.8182
"27674","90051","2015",2,2,0,128750,1270,101
"27675","90052","2015",21,8,13,108117.1,1143.19,101.619
"27676","90053","2015",20,14,6,129197.5,1226.85,109.3
"27677","90054","2015",6,6,0,218750,1813.333,123
"27678","90055","2015",5,5,0,170650,1454.2,117.8
"27679","90056","2015",16,16,0,183123.1,1583.5,115.5
"27680","90057","2015",6,6,0,182246,1751.333,103.6667
"27681","90058","2015",8,7,1,161125,1631.125,96.875
"27682","90060","2015",1,1,0,169900,1752,97
"27683","90062","2015",5,5,0,179740,1431.2,122.4
"27684","90063","2015",1,1,0,175000,1944,90
"27685","90064","2015",1,1,0,60000,1000,60
"27686","90065","2015",7,6,1,98142.86,1263.857,87
"27687","90066","2015",3,3,0,107333.3,1296.333,97.66667
"27688","90067","2015",3,3,0,145000,1393.667,105.3333
"27689","90068","2015",6,4,2,174116.7,1873.5,90.16667
"27690","90069","2015",11,7,4,147140.9,1382.545,105.3636
"27691","90070","2015",5,5,0,196268,1497.6,125.8
"27692","90071","2015",7,6,1,162975.7,1657.286,100.5714
"27693","90072","2015",6,4,2,112591.7,1196,89.5
"27694","90074","2015",1,1,0,355000,2152,165
"27695","90075","2015",30,21,9,157344.6,1491.833,103.9667
"27696","90076","2015",14,11,3,182567.9,1625.857,117.2857
"27697","90077","2015",2,2,0,154000,1438.5,105
"27698","90079","2015",3,3,0,123000,1161.333,105
"27699","90080","2015",2,2,0,117450,1241.5,107.5
"27700","90081","2015",4,4,0,159950,1207.75,134
"27701","90084","2015",2,2,0,190500,1825,103.5
"27702","90086","2015",2,2,0,200500,1344,148.5
"27703","90087","2015",3,3,0,211000,2222.667,96.66667
"27704","90088","2015",4,3,1,151670,1370.5,111.75
"27705","90089","2015",14,6,8,121700,1298.714,90.85714
"27706","90090","2015",1,1,0,129300,1724,75
"27707","90091","2015",7,7,0,214300,1496.571,143.8571
"27708","90093","2015",7,5,2,195390,1551,112.8571
"27709","90094","2015",4,1,3,85853,1494.75,57
"27710","90095","2015",2,2,0,106500,1203,95
"27711","90097","2015",9,7,2,131735.6,1564.222,82.33333
"27712","90099","2015",40,12,28,98753.7,1310.925,73.85
"27713","90102","2015",6,6,0,148450,1289.833,119.8333
"27714","90103","2015",6,5,1,238158.3,1892,123.1667
"27715","90104","2015",7,6,1,218049.3,1590.714,143
"27716","90105","2015",1,1,0,223000,1604,139
"27717","91001","2015",1,1,0,291000,1617,180
"27718","91016","2015",1,1,0,180000,3673,49
"27719","91017","2015",18,16,2,204837.2,2379.889,94.05556
"27720","91021","2015",119,40,79,181460.8,2977.613,62.81513
"27721","91022","2015",2,2,0,364615,2229.5,174.5
"27722","91027","2015",298,121,177,214076.4,3307.826,67.85906
"27723","91035","2015",5,5,0,220494.8,1947.4,116.6
"27724","91037","2015",5,5,0,259300,2116,117
"27725","91038","2015",9,8,1,229048.9,2595.556,90.11111
"27726","91041","2015",1,1,0,155000,2627,59
"27727","91044","2015",1,1,0,299500,2748,109
"27728","91045","2015",84,68,16,221783.9,2697.94,88.29762
"27729","91047","2015",17,14,3,217323.5,2560.824,92.70588
"27730","91064","2015",32,22,10,470749.3,4544.25,107.7188
"27731","91067","2015",4,4,0,158825,2040.25,80.5
"27732","91069","2015",9,9,0,216288.9,2322.444,103.8889
"27733","91079","2015",4,4,0,323300,2258,141.5
"27734","91080","2015",12,10,2,206383.3,2319,91.41667
"27735","91081","2015",5,4,1,235950,2073,123.4
"27736","91085","2015",57,48,9,228093.9,2948.018,81.54386
"27737","91086","2015",102,87,15,255646.8,2634.637,99.97059
"27738","91093","2015",10,10,0,381270,2689.2,137.4
"27739","91095","2015",28,27,1,231785.7,2694.143,88.75
"27740","91097","2015",78,32,46,184106.5,2393.141,77.75641
"27741","91098","2015",2,2,0,209027.5,2496,84
"27742","91099","2015",41,38,3,228081.3,2588.073,93.36585
"27743","91100","2015",8,8,0,212862.5,2737.5,88.875
"27744","91103","2015",269,128,141,209387,2863.688,76.65428
"27745","91105","2015",63,57,6,237037.4,2582.238,93.84127
"27746","91106","2015",10,10,0,238951,3109,79.5
"27747","91109","2015",9,7,2,219811.1,2520.778,93.44444
"27748","91111","2015",43,37,6,273765.3,2903.07,99.11628
"27749","91112","2015",1,1,0,314193,1122,280
"27750","91114","2015",304,153,151,240922.9,3127.697,80.02303
"27751","91115","2015",29,21,8,232838.8,2781.931,90.31034
"27752","91121","2015",10,10,0,242030,2233,120
"27753","91122","2015",95,68,27,350633.3,4038.611,94.81053
"27754","91129","2015",54,44,10,218029.6,2693.556,86
"27755","91130","2015",22,19,3,203030.9,2296.773,89.36364
"27756","91131","2015",4,4,0,127500,2194.25,60.75
"27757","91132","2015",8,8,0,274347.5,2511.625,111.625
"27758","91135","2015",22,20,2,258081.8,2535.5,106.6818
"27759","91137","2015",2,2,0,135250,2032.5,79.5
"27760","91145","2015",1,1,0,187000,2149,87
"27761","91148","2015",4,4,0,273250,2402,115.5
"27762","91156","2015",18,10,8,231114.3,2873.278,87
"27763","91159","2015",14,12,2,253954.9,2785.143,94.85714
"27764","91161","2015",250,30,220,167713.5,2581.012,68.624
"27765","91174","2015",468,148,320,151820,2460.261,63.43803
"27766","91175","2015",20,17,3,227665,2620.55,95.1
"27767","91179","2015",76,46,30,212856,2519.776,86.02632
"27768","91180","2015",3,3,0,190333.3,2137.333,80.33333
"27769","91184","2015",2,2,0,291000,5179,52.5
"27770","91186","2015",16,14,2,255182.2,2479.562,105.8125
"27771","91191","2015",131,63,68,217584,2898.42,78.29008
"27772","91195","2015",15,13,2,219049.4,2458.667,98
"27773","91198","2015",18,15,3,211675,2356.889,94.22222
"27774","91200","2015",88,46,42,198368,2809.386,73.76136
"27775","91201","2015",308,206,102,239779.5,3033.143,83.37013
"27776","91207","2015",38,27,11,233490.3,2887.947,86.76316
"27777","91215","2015",74,24,50,162343.9,2207.486,74.01351
"27778","91216","2015",120,81,39,254810.3,3386.658,77.80833
"27779","91223","2015",281,102,179,139261.5,2135.427,68.16014
"27780","91225","2015",18,9,9,287130.6,2535.889,111.7778
"27781","91226","2015",80,60,20,226267.8,3002.425,80.55
"27782","91228","2015",507,113,394,152920.9,2126.006,73.36292
"27783","91232","2015",68,53,15,221808.2,2504.5,93.47059
"27784","91235","2015",14,12,2,247593.1,2820.929,89.14286
"27785","91243","2015",24,23,1,297649,2911.375,110.0417
"27786","91244","2015",11,7,4,206939.4,2584.909,87.90909
"27787","91247","2015",2,2,0,193987.5,2407.5,80.5
"27788","91248","2015",7,6,1,198850,1726.571,118.5714
"27789","91249","2015",50,35,15,269419.9,2709.08,102
"27790","91272","2015",216,127,89,357697.4,3578.361,103.5324
"27791","91273","2015",17,16,1,189744.7,2191.353,92.17647
"27792","91274","2015",6,6,0,376045,2994.833,132.5
"27793","91275","2015",18,17,1,339780.6,3427,104.7778
"27794","91284","2015",11,10,1,228663.6,2016.091,115.6364
"27795","91286","2015",35,23,12,186035.7,2594.857,74.8
"27796","91292","2015",8,8,0,252833.8,2720.5,93.5
"27797","91293","2015",11,10,1,238385.1,2710.182,93.36364
"27798","91294","2015",14,14,0,210076.6,1934.071,118.4286
"27799","91312","2015",101,66,35,319083.2,3999.307,84.16832
"27800","91315","2015",105,100,5,229484.6,2741.419,88.37143
"27801","91318","2015",26,23,3,248738.5,2635.038,97.5
"27802","91319","2015",7,7,0,363135.7,2729.857,149.1429
"27803","91326","2015",157,50,107,205237.5,3355.293,62.97452
"27804","91330","2015",65,56,9,238248.9,3106.415,82.53846
"27805","91332","2015",19,17,2,267007.9,2841.421,104.4211
"27806","91333","2015",59,48,11,226524.6,2638.203,89.61017
"27807","91338","2015",77,69,8,284250.8,2717.636,107.2987
"27808","91339","2015",98,66,32,234244.9,3058.184,83.53061
"27809","91340","2015",82,67,15,246581.5,2701.402,92.45122
"27810","91345","2015",264,104,160,207068.5,2715.527,77.55303
"27811","91347","2015",72,58,14,267582.6,2843.347,97.58333
"27812","91359","2015",36,32,4,196116.7,2650.111,82.69444
"27813","91363","2015",92,62,30,252930.2,2913.033,90.67391
"27814","91376","2015",49,39,10,250858.2,2875.714,94.26531
"27815","91377","2015",410,65,345,232132.6,3386.068,70.15366
"27816","91378","2015",4,4,0,327550,1435,239
"27817","91386","2015",233,150,83,230567.5,2732.828,89.96567
"27818","91390","2015",36,33,3,161266.7,2011.556,86.05556
"27819","91393","2015",8,8,0,194828.1,2048,98.625
"27820","91405","2015",52,44,8,242182.1,2766.519,97.80769
"27821","91408","2015",8,8,0,254896.2,2318,109
"27822","91411","2015",19,18,1,350212.1,3289.474,111.1053
"27823","91412","2015",10,10,0,250960,2487.7,108.2
"27824","91414","2015",7,7,0,155857.1,1691.429,94.28571
"27825","91421","2015",267,160,107,242612.3,3464.213,74.54682
"27826","91425","2015",94,44,50,200366.8,3024.245,69.96809
"27827","91432","2015",139,94,45,255306.8,3473.799,77.28777
"27828","91433","2015",54,40,14,215059.9,2340.074,96.2037
"27829","91434","2015",218,127,91,227267.7,2971.115,79.11468
"27830","91435","2015",6,6,0,522833.3,3538,163.5
"27831","91441","2015",3,3,0,250828.3,2250.333,111.6667
"27832","91457","2015",38,34,4,274127.1,2868.895,98.15789
"27833","91458","2015",32,15,17,226190.8,2952.344,77.34375
"27834","91461","2015",38,35,3,264846.7,2815.158,98
"27835","91463","2015",2,2,0,239000,2401,99
"27836","91468","2015",27,26,1,268794.4,2731.037,102.1481
"27837","91469","2015",11,11,0,203006.8,2422.545,90.09091
"27838","91471","2015",172,94,78,309370,3929.634,82.36628
"27839","91473","2015",2,1,1,197000,1407,140
"27840","91477","2015",338,120,218,258686.1,3377.843,78.59172
"27841","91479","2015",68,59,9,266645.9,3961.985,73.97059
"27842","91482","2015",12,10,2,294208.3,2740.75,114.9167
"27843","91494","2015",50,39,11,259942.7,3099.02,87.16
"27844","91495","2015",3,3,0,170333.3,1722.333,107
"27845","91507","2015",2,2,0,225000,2324.5,95
"27846","91508","2015",4,4,0,189125,1970,111.5
"27847","91511","2015",22,14,8,143827.3,1841.909,79.45455
"27848","91514","2015",85,59,26,220906.9,2967.541,77.75294
"27849","91519","2015",6,6,0,198333.3,2576.333,78.83333
"27850","91521","2015",286,94,192,159315.2,2212.038,72.51399
"27851","91525","2015",14,14,0,298446.8,2614.929,117.5714
"27852","91533","2015",17,13,4,185602.9,2098.294,91.47059
"27853","91534","2015",37,17,20,310782.3,4032.622,78.43243
"27854","91538","2015",6,5,1,321166.7,3309.167,96.66667
"27855","91540","2015",64,46,18,217675.4,2681.188,86.15625
"27856","91544","2015",12,10,2,216668.8,1744.75,135.4167
"27857","91546","2015",11,11,0,324433.6,2815.545,125.8182
"27858","91547","2015",5,5,0,193200,1943.8,100.8
"27859","91549","2015",347,180,167,217662.4,3128.081,72.54467
"27860","91552","2015",101,68,33,216601,2822.327,78.75248
"27861","91553","2015",93,62,31,263036.6,2945.731,92.02151
"27862","91556","2015",5,5,0,223440,2327.6,102
"27863","91560","2015",7,6,1,292584.1,3078.286,106.5714
"27864","91568","2015",15,15,0,307662.3,2901.267,110.8
"27865","91570","2015",206,78,128,186932.2,2549.583,76.45631
"27866","91573","2015",113,82,31,235025.2,2676.124,90.15044
"27867","91577","2015",62,45,17,240001.5,2685.113,93.90323
"27868","91578","2015",4,4,0,352288.8,2952.75,131.25
"27869","91579","2015",54,35,19,218686.1,2808.333,81.57407
"27870","91581","2015",8,8,0,275250,2703.125,103.625
"27871","91587","2015",54,33,21,278099.4,3165.333,91.59259
"27872","91589","2015",384,222,162,221249,3233.453,72.4974
"27873","91593","2015",19,18,1,245120,2383.737,106.4737
"27874","91599","2015",18,18,0,235294.9,2763,92.72222
"27875","91600","2015",93,65,28,294257.8,3151.215,97.55914
"27876","91602","2015",4,2,2,154672.5,2758.25,65.25
"27877","91613","2015",1,1,0,151000,2013,75
"27878","91617","2015",39,26,13,259699.1,3128.821,86.53846
"27879","91619","2015",1,1,0,286000,3109,92
"27880","91629","2015",8,8,0,176250,1922.75,96.75
"27881","91630","2015",17,11,6,260340.3,2845.706,108.5882
"27882","91631","2015",23,21,2,341530.6,3192.043,112.1739
"27883","91634","2015",16,13,3,244046.2,2397.688,108.75
"27884","91635","2015",28,26,2,406230.3,4166.286,103.1071
"27885","91639","2015",15,14,1,211640,2191.733,104.0667
"27886","91645","2015",169,89,80,403643,4197.32,97.26036
"27887","91648","2015",36,25,11,269013.9,2881.222,103.0833
"27888","91649","2015",38,32,6,230109.1,2723,86.76316
"27889","91654","2015",4,4,0,218012.5,2019.75,109.75
"27890","91657","2015",202,124,78,216739.8,3199.025,70.82673
"27891","91659","2015",43,32,11,229422.1,2487.628,94.13953
"27892","91661","2015",84,42,42,278085.1,3295.94,86.80952
"27893","91662","2015",2,2,0,430500,3266.5,140.5
"27894","91665","2015",62,55,7,256380,2940.645,88.16129
"27895","91666","2015",18,14,4,213304.1,3174.556,74.66667
"27896","91667","2015",83,61,22,264615.1,3294.518,83.55422
"27897","91671","2015",4,4,0,260625,2149,124.75
"27898","91679","2015",12,5,7,290698.5,3562.25,82.16667
"27899","91685","2015",52,29,23,231283.9,2988.481,79.53846
"27900","91687","2015",249,104,145,191846.2,2819.992,71.02008
"27901","91689","2015",98,36,62,290630.5,3876.01,78.71429
"27902","91691","2015",331,173,158,251717.7,3133.707,83.76133
"27903","91692","2015",197,12,185,155757.9,2217.538,71.95939
"27904","92002","2015",620,200,420,340050.3,4570.861,74.75484
"27905","92004","2015",1185,121,1064,321505.2,5169.464,60.95696
"27906","92007","2015",242,42,200,245526.6,4145.169,61.16942
"27907","92009","2015",463,101,362,348780.2,5251.797,64.72138
"27908","92012","2015",1813,37,1776,432263.6,6969.244,60.66906
"27909","92014","2015",276,56,220,345837.3,4944.123,71.25725
"27910","92019","2015",302,43,259,318456.3,4324.848,72.28477
"27911","92020","2015",386,61,325,318514.4,5108.163,63.15026
"27912","92022","2015",255,68,187,368696.3,5326.176,68.81569
"27913","92023","2015",569,184,385,357265,5120.392,70.07206
"27914","92024","2015",571,13,558,228996.2,5034.974,45.72154
"27915","92025","2015",997,341,656,305479.2,4517.851,66.41926
"27916","92026","2015",1107,37,1070,331344.6,5577.046,59.53388
"27917","92032","2015",215,45,170,313376.3,4286.074,73.1814
"27918","92033","2015",244,42,202,438554,5193.545,81.69672
"27919","92035","2015",413,42,371,351276.9,5404.867,63.75303
"27920","92036","2015",167,21,146,223479.7,3621.952,61.53293
"27921","92040","2015",742,51,691,392563.9,6357.818,60.36388
"27922","92044","2015",902,5,897,414630.3,7451.462,55.04878
"27923","92046","2015",240,40,200,263591,5410.887,48.1125
"27924","92047","2015",17,14,3,719428.2,6196,121.0588
"27925","92048","2015",556,57,499,366315.6,4985.944,70.07374
"27926","92049","2015",595,17,578,319494.7,5821.38,55.10924
"27927","92050","2015",484,129,355,311904.1,4701.64,67.62397
"27928","92051","2015",957,10,947,720460,8554.217,83.03762
"27929","92060","2015",302,35,267,351249.7,4925.811,71.83775
"27930","92062","2015",509,16,493,313024.3,5665.153,55.26719
"27931","92063","2015",887,209,678,416394.5,5438.344,74.55355
"27932","92064","2015",378,57,321,535090.7,6127.847,84.28307
"27933","92071","2015",197,38,159,461480.8,5578.995,81.63452
"27934","92072","2015",278,53,225,416920.2,5199.504,77.65468
"27935","92073","2015",563,76,487,402141.2,5752.075,68.90764
"27936","92075","2015",303,18,285,326002.3,5559.142,58.17162
"27937","92076","2015",99,31,68,520576.7,5197.909,98.0202
"27938","92077","2015",83,15,68,479633,5206.277,90.08434
"27939","92078","2015",108,22,86,222942,3113.231,71.38889
"27940","93001","2015",442,38,404,155313.9,3063.511,52.64027
"27941","93005","2015",517,317,200,209351.3,3081.46,72.08124
"27942","93006","2015",222,45,177,252782.8,4198.631,60.55405
"27943","93007","2015",310,201,109,216358.2,3112.129,72.56452
"27944","93008","2015",200,90,110,201465.2,3116.245,67.765
"27945","93010","2015",384,201,183,196083.8,3018.875,67.34115
"27946","93013","2015",149,29,120,174127.6,3166.611,57.14765
"27947","93014","2015",88,39,49,155478.8,2147.295,74.17045
"27948","93015","2015",41,26,15,193797.6,2590.317,77.56098
"27949","93027","2015",114,33,81,152222.9,2918.088,57.76316
"27950","93029","2015",474,247,227,191480.2,3067.082,65.28481
"27951","93030","2015",30,8,22,175489.2,2626.8,67.5
"27952","93031","2015",331,71,260,162597.8,2567.819,64.81873
"27953","93032","2015",388,212,176,221173.4,3074.041,74.64691
"27954","93033","2015",97,61,36,290455.8,3912.856,80.37113
"27955","93039","2015",51,7,44,193022.8,2887.51,67.4902
"27956","93045","2015",232,32,200,274052.2,5463.353,50.00862
"27957","93046","2015",507,205,302,191662.6,2888.653,69.10256
"27958","93047","2015",193,147,46,221775.2,2931.114,79.59585
"27959","93048","2015",1035,222,813,267898.9,4656.547,58.70242
"27960","93049","2015",234,98,136,244028.7,3605.389,69.32479
"27961","93050","2015",258,67,191,197622.4,2900.725,70.14729
"27962","93051","2015",644,182,462,220859.6,3430.017,67.22516
"27963","93053","2015",301,106,195,197824.1,3233.329,63.42525
"27964","93055","2015",519,28,491,218092.4,4339.114,49.95183
"27965","93057","2015",276,123,153,196961.3,3072.011,66.81159
"27966","93059","2015",139,79,60,185570.7,2833.719,68.06475
"27967","93061","2015",177,13,164,221301.6,4535.593,48.77966
"27968","93062","2015",192,72,120,286711.2,3833.276,75.27604
"27969","93063","2015",151,60,91,264031.4,4340.093,61.33775
"27970","93064","2015",446,99,347,199725.2,3263.049,63.49552
"27971","93066","2015",686,51,635,168578.8,3142.859,54.22595
"27972","93070","2015",393,26,367,201726.5,4333.288,46.62341
"27973","93071","2015",272,155,117,177900,2556.658,73.20588
"27974","93072","2015",150,72,78,162139.8,2528.927,66.54667
"27975","93073","2015",245,178,67,213544.9,2788.657,81.15918
"27976","93074","2015",74,32,42,202585.4,2784.892,75.64865
"27977","93077","2015",351,179,172,234012.1,3536.601,67.63248
"27978","93078","2015",216,141,75,203224.2,2799.75,77.10648
"27979","93079","2015",26,16,10,173207.7,2630.615,67.92308
"27980","94001","2015",70,21,49,189251.5,2873.329,67.5
"27981","94002","2015",453,56,397,235466.7,4125.943,57.47241
"27982","94003","2015",158,39,119,263411.9,4636.006,57.78481
"27983","94004","2015",132,51,81,207245.1,2971.856,73.82576
"27984","94011","2015",86,35,51,237788.2,3479.302,71.33721
"27985","94015","2015",213,63,150,320659,4328.606,73.97653
"27986","94016","2015",249,74,175,310970,4522.225,70.18876
"27987","94017","2015",700,289,411,236996.2,3450.089,71.66143
"27988","94018","2015",361,9,352,367984.6,6055.687,60.82548
"27989","94019","2015",215,71,144,239103.1,3314.623,73.50698
"27990","94021","2015",160,33,127,228915.1,3242.6,70.9125
"27991","94022","2015",445,91,354,202445.5,3292.62,63.21798
"27992","94028","2015",575,67,508,228141.9,3541.544,66.64174
"27993","94033","2015",561,171,390,329922.3,4935.321,68.52585
"27994","94034","2015",313,35,278,206201,3120.399,67.50479
"27995","94037","2015",122,26,96,250643.6,4821.598,52.59016
"27996","94038","2015",259,79,180,267054.6,3737.174,71.93822
"27997","94041","2015",473,37,436,219208.3,4307.803,52.28118
"27998","94042","2015",241,69,172,315981.1,5004.539,64.15768
"27999","94043","2015",214,12,202,258516.8,4871.724,54.01402
"28000","94044","2015",323,104,219,199270.9,2969.3,69.34056
"28001","94046","2015",604,103,501,281419.4,4714.098,59.59934
"28002","94047","2015",50,34,16,247439.1,3098.12,84.78
"28003","94048","2015",64,59,5,344449.3,2863.922,123.5781
"28004","94052","2015",473,53,420,350185.6,5292.97,65.97252
"28005","94053","2015",56,27,29,252375.4,3315.804,78.23214
"28006","94054","2015",130,57,73,224981.7,3351.931,68.19231
"28007","94055","2015",118,111,7,324624.5,3549.864,98.02542
"28008","94056","2015",29,25,4,280510.3,2968.69,101.6207
"28009","94058","2015",528,161,367,322752,4818.818,66.875
"28010","94059","2015",254,59,195,236666.4,3263.311,74
"28011","94060","2015",118,103,15,266334.9,2858.619,96.9322
"28012","94065","2015",47,19,28,337708.9,4077.681,81.17021
"28013","94067","2015",356,7,349,448061.3,6890.379,64.40449
"28014","94068","2015",1131,351,780,360325.8,4842.504,74.67286
"28015","94069","2015",197,3,194,286449.7,5153.827,55.32487
"28016","94070","2015",41,32,9,323317.1,2865.927,120.6585
"28017","94071","2015",274,139,135,265504.7,3369.599,81.16423
"28018","94073","2015",337,78,259,222828.5,3325.926,68.8724
"28019","94074","2015",62,33,29,232601.5,3319.548,73.04839
"28020","94075","2015",117,77,40,263939.7,2938.88,95.42735
"28021","94076","2015",484,99,385,245054.8,4089.475,61.06818
"28022","94077","2015",162,107,55,210140.9,3393.012,66.2284
"28023","94078","2015",201,89,112,162358.2,2796.876,61.53234
"28024","94079","2015",287,118,169,253569,3482.275,75.17073
"28025","94080","2015",799,32,767,396429.8,6894.854,56.50688
"28026","94081","2015",542,141,401,223154.5,3646.994,62.97232
"28027","95002","2015",12,12,0,257729.2,2091.083,125.0833
"28028","95008","2015",9,9,0,175144.4,1911.333,95.55556
"28029","95011","2015",5,5,0,194200,2498,79.8
"28030","95012","2015",1,1,0,95000,1979,48
"28031","95014","2015",17,15,2,313141.2,3560.294,99.64706
"28032","95018","2015",822,399,423,201559,3178.128,67.01217
"28033","95019","2015",142,97,45,201511.9,2736.606,76.47183
"28034","95023","2015",6,6,0,260750,2557.333,105.1667
"28035","95024","2015",3,3,0,233500,2486,109.6667
"28036","95026","2015",42,35,7,216072.2,2474.571,91.95238
"28037","95028","2015",20,18,2,241292.5,3057.05,83.9
"28038","95039","2015",76,67,9,259974.8,3234.224,84.30263
"28039","95040","2015",11,11,0,298628.6,2502,121.8182
"28040","95042","2015",21,20,1,285360,2954.429,98.57143
"28041","95046","2015",2,2,0,134375,1648,105
"28042","95051","2015",113,83,30,259720.3,3596.805,78.0531
"28043","95052","2015",124,58,66,168677.7,2696.516,65.6371
"28044","95054","2015",3,3,0,229666.7,2202.333,105.6667
"28045","95055","2015",3,2,1,156000,3496,50.66667
"28046","95056","2015",25,21,4,219523.2,2927.8,76.76
"28047","95058","2015",30,30,0,226994.3,2572.467,90.16667
"28048","95059","2015",3,3,0,206433,1876.333,115
"28049","95060","2015",74,55,19,259167.6,3321.703,79.82432
"28050","95061","2015",4,4,0,364875,2598.25,144
"28051","95063","2015",221,111,110,240222.3,3879.729,65.71493
"28052","95074","2015",6,5,1,264250,2623.5,108.6667
"28053","95078","2015",13,8,5,203706.9,2412.231,86.23077
"28054","95088","2015",8,6,2,174125.1,2763.75,77
"28055","95091","2015",49,43,6,250175.3,2725.224,95.79592
"28056","95094","2015",3,2,1,166000,2611.333,65.66667
"28057","95101","2015",4,4,0,203350,2096.25,98.25
"28058","95102","2015",5,5,0,270947.2,2263,127
"28059","95110","2015",4,4,0,379357.5,3280.75,149.25
"28060","95116","2015",28,28,0,210159.6,2196.893,98.89286
"28061","95119","2015",7,7,0,194371.4,2326.143,89.28571
"28062","95120","2015",27,26,1,291053.7,3249.963,95.2963
"28063","95127","2015",535,129,406,179523.5,2885.179,66.30093
"28064","95134","2015",49,39,10,263163.7,2786.796,102.1429
"28065","95139","2015",4,4,0,234250,2095.75,114.25
"28066","95142","2015",25,20,5,188831.7,2373.56,87.04
"28067","95149","2015",56,54,2,242491,2685.982,94.92857
"28068","95150","2015",8,8,0,164087.5,2407.75,69
"28069","95151","2015",4,4,0,215000,3126.25,73.5
"28070","95154","2015",2,2,0,186750,2116,99
"28071","95157","2015",1,1,0,435230,1860,234
"28072","95166","2015",3,3,0,228841.7,2435,93.66667
"28073","95169","2015",5,5,0,225494.8,2352.4,117
"28074","95170","2015",5,5,0,286320,2635.8,115.2
"28075","95176","2015",259,144,115,271898,3676.915,76.58301
"28076","95177","2015",11,10,1,239090.9,2192.273,113.8182
"28077","95181","2015",3,3,0,295766.7,2775.667,108.3333
"28078","95183","2015",72,42,30,239503.9,2940.944,84.91667
"28079","95197","2015",297,99,198,216727.6,3201.327,69.51852
"28080","95199","2015",204,103,101,227814.1,2903.368,80.70098
"28081","95203","2015",283,120,163,254190.8,3342.364,77.30389
"28082","95205","2015",68,32,36,216454.6,2750.265,80.73529
"28083","95210","2015",195,56,139,330306,4124.513,80.04103
"28084","95211","2015",23,22,1,304831.3,2989.261,102.1304
"28085","95213","2015",12,12,0,268238,2563.333,106.9167
"28086","95218","2015",171,106,65,245867.5,2970.865,86.97661
"28087","95219","2015",325,137,188,259177.5,3497.185,76.53231
"28088","95229","2015",90,33,57,202612.6,2813.878,74.13333
"28089","95241","2015",15,14,1,239733.3,2573.933,98.4
"28090","95250","2015",117,109,8,204309.9,2410.12,89.08547
"28091","95252","2015",508,136,372,194148.8,2820.014,69.76181
"28092","95253","2015",8,8,0,294787.5,2461,121.625
"28093","95254","2015",6,5,1,270105,3125.667,88.16667
"28094","95256","2015",41,33,8,266968,3020.024,92.21951
"28095","95257","2015",58,45,13,290603.4,3568.259,83.25862
"28096","95258","2015",7,7,0,382157.1,3505.571,126.2857
"28097","95268","2015",139,58,81,157531.9,2421.065,68.04317
"28098","95270","2015",2,2,0,215000,3501.5,65
"28099","95271","2015",4,4,0,290500,3198.5,102.75
"28100","95277","2015",173,95,78,185652.8,2731.861,70.68786
"28101","95280","2015",216,183,33,200056.7,3040.954,72.71759
"28102","95287","2015",5,5,0,247410,2319.6,117
"28103","95288","2015",91,43,48,240104.1,3255.769,75.73626
"28104","95295","2015",1,1,0,167000,1590,105
"28105","95298","2015",5,5,0,286740,2074.8,141.4
"28106","95301","2015",6,6,0,181333.3,1370.5,126.6667
"28107","95303","2015",5,5,0,293460,2793.6,112.8
"28108","95304","2015",4,4,0,274375,2100,130.75
"28109","95306","2015",325,207,118,270746,3438.732,80.86462
"28110","95308","2015",9,9,0,343566.7,3119.889,127.3333
"28111","95309","2015",4,4,0,252500,2132.5,123.25
"28112","95313","2015",168,84,84,280167.5,3257.732,89.30357
"28113","95323","2015",147,120,27,232110.4,2639.245,90.22449
"28114","95328","2015",3,2,1,192033.3,2474,78
"28115","95331","2015",3,3,0,251000,3213,78.66667
"28116","95341","2015",2,2,0,199500,2235,89.5
"28117","95348","2015",7,6,1,246116.3,2222.714,118.1429
"28118","95351","2015",103,69,34,179567,2657.524,70.84466
"28119","95352","2015",44,34,10,270990.2,2893.568,103.0227
"28120","95353","2015",25,20,5,233862,2584.68,93.48
"28121","95355","2015",58,47,11,197411.2,2374.776,89.25862
"28122","95365","2015",4,3,1,243225,2235.75,108.75
"28123","95369","2015",31,19,12,332806.8,3613.194,93.77419
"28124","95370","2015",41,36,5,245836.1,2840.732,96.73171
"28125","95371","2015",70,67,3,240044.4,2753.871,92.07143
"28126","95379","2015",3,3,0,225933.3,2205.667,102.3333
"28127","95388","2015",51,48,3,236487.7,2566.118,93.66667
"28128","95392","2015",54,49,5,261969.8,3110.333,88.40741
"28129","95394","2015",92,62,30,241175.6,2908.859,86.69565
"28130","95395","2015",7,5,2,201321.4,2756,74
"28131","95409","2015",14,9,5,221735,2860.929,82.92857
"28132","95422","2015",5,5,0,241218,2311.6,107
"28133","95424","2015",175,94,81,210702.3,2853.869,76.06286
"28134","95426","2015",25,19,6,285843.6,3263.48,93.32
"28135","95427","2015",142,60,82,191730.9,2817.077,72.87324
"28136","95428","2015",305,110,195,296441.8,3497.8,88.08525
"28137","95429","2015",11,11,0,192911.4,2077.091,93.45455
"28138","95430","2015",43,28,15,238263.3,2933.558,88.5814
"28139","95436","2015",16,15,1,234090.6,2798.75,92.5
"28140","95445","2015",9,9,0,272955.6,3421.556,83.77778
"28141","95446","2015",26,26,0,304080.8,3254.962,100.8462
"28142","95447","2015",5,5,0,295450,3193.8,93.4
"28143","95450","2015",9,9,0,273478.9,3537.444,79.33333
"28144","95452","2015",12,9,3,233612.5,2716.75,89.91667
"28145","95456","2015",7,6,1,174385.7,2468.714,74
"28146","95459","2015",8,8,0,246152.5,2160.125,115.625
"28147","95462","2015",2,2,0,275250,2941.5,92.5
"28148","95476","2015",155,112,43,248587.8,2930.31,89.47097
"28149","95480","2015",85,75,10,268142.2,2995.882,92.97647
"28150","95483","2015",6,6,0,246316.7,2374.5,109.3333
"28151","95487","2015",93,47,46,171201.1,2619.473,69.43011
"28152","95488","2015",61,47,14,243598.4,3393.689,80.63934
"28153","95489","2015",2,2,0,234500,4654,64
"28154","95491","2015",121,52,69,229715.2,3047.603,77.78512
"28155","95500","2015",315,93,222,188597.1,2912.714,68.90159
"28156","95504","2015",53,43,10,254453.6,2959.906,85.13208
"28157","95509","2015",57,42,15,212436.4,2683.491,85.38596
"28158","95510","2015",3,3,0,317581.7,2385.667,137
"28159","95523","2015",3,2,1,234833.3,2961,72.66667
"28160","95527","2015",19,6,13,215163.4,3526.053,65.78947
"28161","95529","2015",7,7,0,283857.1,2979.286,110.7143
"28162","95535","2015",10,9,1,285070,2431.8,125.2
"28163","95539","2015",186,84,102,245543.2,3075.102,82.07527
"28164","95541","2015",10,8,2,273513.5,2581.9,95.4
"28165","95543","2015",3,3,0,190333.3,1595,125.3333
"28166","95554","2015",13,13,0,182661.5,2171.077,91.23077
"28167","95555","2015",241,63,178,231801.1,3327.83,71.07054
"28168","95563","2015",234,152,82,281704.4,3444.65,85.25641
"28169","95566","2015",34,30,4,214455.9,2604.529,86.29412
"28170","95572","2015",280,108,172,185697.9,2689.407,71.55714
"28171","95574","2015",92,82,10,369342.4,3743.848,103.5435
"28172","95580","2015",42,28,14,326624,2936.5,113.9524
"28173","95582","2015",309,118,191,237851.1,3348.524,72.22977
"28174","95584","2015",3,2,1,224666.7,2602,87.66667
"28175","95585","2015",240,82,158,167054.1,2274.196,75.975
"28176","95592","2015",17,15,2,254194.1,2960.412,94.64706
"28177","95594","2015",11,8,3,231922,2467.182,92.09091
"28178","95598","2015",198,96,102,269201.8,3596.626,77.32323
"28179","95604","2015",47,20,27,176582.6,2566.489,73.31915
"28180","95607","2015",336,175,161,226153.2,2938.074,79.56845
"28181","95610","2015",2,2,0,236600,2750,93
"28182","95612","2015",40,25,15,193179.8,2662.45,75.85
"28183","95625","2015",13,13,0,241623.1,2363,103
"28184","95627","2015",10,9,1,310382.5,2553.8,127
"28185","95628","2015",17,12,5,206661.8,3642.176,61.88235
"28186","95633","2015",2,2,0,149000,3039,49.5
"28187","95637","2015",163,128,35,251822.9,2954.816,88.04294
"28188","95641","2015",25,18,7,219081.8,2841.76,84.04
"28189","95651","2015",12,12,0,138861.1,1841,81
"28190","95652","2015",53,46,7,234655.3,2813.509,86.62264
"28191","95656","2015",4,4,0,266750,1620.75,160.25
"28192","95658","2015",11,11,0,285781.6,2093.636,139.7273
"28193","95660","2015",7,5,2,274142.9,3048.429,87
"28194","95675","2015",10,6,4,296350,3099.7,100.8
"28195","95676","2015",9,9,0,258613.3,1935.333,134.4444
"28196","95678","2015",23,23,0,297669.6,2909.957,103.8261
"28197","95680","2015",128,49,79,159191.6,2296.094,71.39062
"28198","95682","2015",2,2,0,222500,2504.5,89
"28199","95690","2015",4,4,0,198000,1832.5,104.5
"28200",NA,"2015",6551,NA,NA,178263.6,2403.474,76.2508
