"","INSEE_COM","Annee","Nb_mutations","NbMaisons","NbApparts","PrixMoyen","Prixm2Moyen","SurfaceMoy"
"1","01001","2016",7,7,0,225428.571428571,1994.71428571429,128.857142857143
"2","01002","2016",6,6,0,83261.6666666667,1105.66666666667,70.1666666666667
"3","01004","2016",138,90,48,165378.34057971,1864.51449275362,88.7536231884058
"4","01005","2016",25,18,7,188922.96,1909.52,102.08
"5","01007","2016",28,28,0,182799.321428571,1972.82142857143,95.3571428571429
"6","01008","2016",8,7,1,125887.5,1377.5,89.875
"7","01009","2016",2,2,0,280570,2437,115
"8","01010","2016",8,6,2,140961.25,1968.625,72.5
"9","01011","2016",3,2,1,144033.333333333,1977.66666666667,74.3333333333333
"10","01012","2016",4,4,0,107282.5,1399.5,88.25
"11","01013","2016",1,1,0,40000,465,86
"12","01014","2016",16,14,2,154146.875,1681.3125,88.875
"13","01015","2016",4,4,0,135250,1473.75,94.75
"14","01016","2016",3,3,0,134800,1480.66666666667,91.6666666666667
"15","01017","2016",7,5,2,88542.8571428571,1070.71428571429,90.2857142857143
"16","01019","2016",1,1,0,1e+05,2000,50
"17","01021","2016",13,10,3,183251.230769231,1989.92307692308,92.9230769230769
"18","01022","2016",11,11,0,154631.454545455,1617.36363636364,105.363636363636
"19","01024","2016",46,39,7,174544.5,1673.89130434783,109.891304347826
"20","01025","2016",36,35,1,172730.611111111,1659.38888888889,107.555555555556
"21","01026","2016",11,11,0,158935.909090909,1461.54545454545,114.818181818182
"22","01027","2016",15,13,2,235275.933333333,2639.26666666667,105.333333333333
"23","01028","2016",8,8,0,193812.5,1980.875,104
"24","01029","2016",5,5,0,124457.4,1199.6,107
"25","01030","2016",17,14,3,149569.588235294,1714,90.8235294117647
"26","01031","2016",24,6,18,108854.166666667,1466.5,70.9166666666667
"27","01032","2016",21,17,4,218132.857142857,2237.42857142857,102.285714285714
"28","01033","2016",161,59,102,187434.602484472,2305.6149068323,81.6645962732919
"29","01034","2016",75,42,33,136463.986666667,1500.24,93.2133333333333
"30","01035","2016",1,1,0,95000,1188,80
"31","01036","2016",11,11,0,144410.909090909,1583.45454545455,98.7272727272727
"32","01037","2016",4,4,0,169375,1262.5,130.5
"33","01038","2016",4,4,0,134373.75,1096.5,132
"34","01040","2016",2,2,0,177125,1438.5,123
"35","01041","2016",5,5,0,171563,1779.6,103.4
"36","01042","2016",3,3,0,234883.333333333,1769.33333333333,142.333333333333
"37","01043","2016",58,49,9,281663.327586207,2693.94827586207,105.586206896552
"38","01044","2016",7,7,0,310617.142857143,2755,115.142857142857
"39","01045","2016",4,4,0,237880,2220,110
"40","01046","2016",6,6,0,207441.666666667,1593.16666666667,129.833333333333
"41","01047","2016",11,11,0,253950,2036,137.363636363636
"42","01049","2016",36,32,4,229345.472222222,2305.77777777778,107.944444444444
"43","01050","2016",1,1,0,203700,2079,98
"44","01051","2016",2,2,0,128000,1178,89.5
"45","01052","2016",7,7,0,204257.142857143,2128.71428571429,98.8571428571429
"46","01053","2016",484,123,361,129949.768595041,1666.76652892562,78.797520661157
"47","01054","2016",10,10,0,230324.9,2106.9,113
"48","01056","2016",3,3,0,161863.333333333,1494.33333333333,111.333333333333
"49","01057","2016",4,4,0,131367.5,1364.25,99.75
"50","01058","2016",8,8,0,106750,1469.5,75.125
"51","01060","2016",5,4,1,134816,1268.2,103.6
"52","01061","2016",15,12,3,170910,1770.86666666667,100.8
"53","01062","2016",16,13,3,248320.8125,2348.4375,106.5
"54","01063","2016",3,3,0,115000,1141,102.333333333333
"55","01064","2016",7,7,0,169871.428571429,1505.42857142857,117.428571428571
"56","01065","2016",17,16,1,196927.529411765,1766.29411764706,120
"57","01066","2016",5,4,1,64800,697.2,94.2
"58","01067","2016",2,2,0,82325,860,95.5
"59","01068","2016",4,4,0,127350,1213.75,110
"60","01069","2016",14,11,3,171156.428571429,1783.07142857143,95.5
"61","01071","2016",50,28,22,449683.26,4133.86,110.36
"62","01072","2016",35,28,7,213679.8,2030.6,103.828571428571
"63","01073","2016",11,10,1,144041.818181818,1480.81818181818,102.363636363636
"64","01074","2016",20,14,6,160408.5,1784.95,92.6
"65","01075","2016",8,8,0,241114.125,2733.25,98.625
"66","01076","2016",5,5,0,89620,1061.2,94.6
"67","01077","2016",2,2,0,108980,796.5,132.5
"68","01078","2016",16,7,9,414001.8125,3882.1875,112.625
"69","01079","2016",3,3,0,67166.6666666667,881.333333333333,75.3333333333333
"70","01080","2016",8,8,0,176983.75,1331.75,135.25
"71","01081","2016",5,5,0,260000,2851.8,106.6
"72","01082","2016",8,8,0,148062.5,1765,104
"73","01083","2016",7,7,0,239789.285714286,1808.28571428571,139.142857142857
"74","01084","2016",9,9,0,153783.444444444,1543.55555555556,99
"75","01085","2016",2,2,0,1e+05,924,109.5
"76","01087","2016",5,3,2,121100,1230.6,107.6
"77","01088","2016",10,7,3,201032.8,2129.6,91.1
"78","01089","2016",16,15,1,186511.875,1791.375,105.25
"79","01090","2016",3,3,0,130333.333333333,1754,85.6666666666667
"80","01092","2016",16,16,0,193493.75,1765.625,108.875
"81","01093","2016",65,44,21,174067.892307692,1973.73846153846,91.2769230769231
"82","01094","2016",2,2,0,95000,838.5,110.5
"83","01095","2016",6,6,0,96059.5,977.166666666667,94.3333333333333
"84","01096","2016",7,7,0,181465.714285714,1590,116.142857142857
"85","01098","2016",8,8,0,138073.5,1441.25,100
"86","01099","2016",11,11,0,181439.454545455,1587.36363636364,115.909090909091
"87","01100","2016",1,1,0,86800,1315,66
"88","01101","2016",1,1,0,183000,2011,91
"89","01102","2016",8,8,0,193925,1558.875,130.5
"90","01103","2016",28,14,14,390329.285714286,3921.10714285714,96.8571428571429
"91","01104","2016",6,5,1,150925,1875.66666666667,71.8333333333333
"92","01105","2016",11,9,2,274624.545454545,2504.45454545455,111.636363636364
"93","01106","2016",3,3,0,106228.333333333,1350,73.6666666666667
"94","01107","2016",3,3,0,168933.333333333,1266.33333333333,137
"95","01108","2016",11,11,0,134219.090909091,1357.09090909091,101.181818181818
"96","01109","2016",33,28,5,335881.333333333,3299.06060606061,112.666666666667
"97","01110","2016",5,5,0,137539,1239.8,127.8
"98","01111","2016",3,3,0,142300,2059.66666666667,75
"99","01112","2016",4,4,0,173125,1473.75,119
"100","01113","2016",11,11,0,198866.363636364,1646.09090909091,126
"101","01114","2016",3,3,0,126666.666666667,1465.33333333333,79.3333333333333
"102","01115","2016",7,7,0,150691.428571429,1498.42857142857,103.285714285714
"103","01116","2016",7,6,1,148474.285714286,1520.14285714286,99.5714285714286
"104","01117","2016",3,3,0,95000,1270,73
"105","01118","2016",10,8,2,157050,2445.6,80.1
"106","01121","2016",1,1,0,120000,1290,93
"107","01123","2016",6,6,0,183808.333333333,1529.33333333333,118.333333333333
"108","01124","2016",7,7,0,134174.857142857,1254.57142857143,111.714285714286
"109","01125","2016",9,9,0,120962.222222222,1031.11111111111,112.666666666667
"110","01127","2016",8,8,0,100900,1289.75,85.25
"111","01128","2016",2,2,0,173000,1480,116.5
"112","01129","2016",3,3,0,98333.3333333333,1159.33333333333,79
"113","01130","2016",18,18,0,194629.722222222,1734.22222222222,112.444444444444
"114","01133","2016",3,3,0,229150,2125,114
"115","01134","2016",15,14,1,181710,1636.93333333333,110.4
"116","01135","2016",18,13,5,559391.111111111,4655.83333333333,130.166666666667
"117","01136","2016",9,8,1,160765.555555556,1580.33333333333,102.444444444444
"118","01138","2016",28,22,6,129176.607142857,1515.96428571429,86.3571428571429
"119","01139","2016",7,7,0,114142.857142857,1337.71428571429,88.2857142857143
"120","01140","2016",6,6,0,169811.666666667,1674,105
"121","01141","2016",4,4,0,164462.5,2017,81.5
"122","01142","2016",61,33,28,193513.639344262,2232.16393442623,90.4754098360656
"123","01143","2016",173,48,125,515502.861271676,5021.28323699422,100.635838150289
"124","01145","2016",9,9,0,187776.666666667,1697.77777777778,109.333333333333
"125","01146","2016",5,5,0,241948.8,1991.4,136.6
"126","01147","2016",3,3,0,100666.666666667,1175,94
"127","01148","2016",19,16,3,153110.789473684,1480.89473684211,105
"128","01149","2016",11,10,1,204690.909090909,2227.36363636364,89.9090909090909
"129","01150","2016",1,1,0,77000,1375,56
"130","01151","2016",13,13,0,172365,1951.61538461538,95.8461538461538
"131","01152","2016",6,6,0,162746.666666667,1682.5,97.5
"132","01153","2016",26,24,2,526582.692307692,4297.34615384615,123.730769230769
"133","01155","2016",3,3,0,127621.666666667,1302,102.666666666667
"134","01156","2016",3,2,1,242633.333333333,2348.66666666667,101
"135","01157","2016",26,21,5,220509.230769231,2339.26923076923,99.6538461538462
"136","01158","2016",8,8,0,480923.625,3806.75,127.75
"137","01159","2016",20,20,0,164869.15,1535.15,106.45
"138","01160","2016",145,22,123,328243.868965517,4044.23448275862,80.3448275862069
"139","01162","2016",1,1,0,156000,1248,125
"140","01163","2016",15,15,0,187726.333333333,1653.26666666667,114
"141","01165","2016",22,22,0,226074.090909091,2147.31818181818,107.863636363636
"142","01166","2016",22,16,6,226789.090909091,2342.81818181818,99.9545454545455
"143","01167","2016",6,6,0,152633.333333333,1727.83333333333,96
"144","01169","2016",4,4,0,177170,1715.25,107.25
"145","01170","2016",3,3,0,140178.666666667,1509.66666666667,90
"146","01171","2016",5,5,0,177680,1389.6,132.6
"147","01173","2016",172,44,128,316537.773255814,3821.62209302326,81.8953488372093
"148","01175","2016",11,11,0,143513.090909091,1337.72727272727,107.181818181818
"149","01177","2016",2,2,0,108000,724.5,137
"150","01179","2016",15,15,0,167951.333333333,1679.4,102.266666666667
"151","01180","2016",6,5,1,856000,5748.83333333333,158.333333333333
"152","01181","2016",9,9,0,183516.666666667,1971.44444444444,92
"153","01183","2016",9,9,0,267627.777777778,2171.44444444444,129.111111111111
"154","01184","2016",12,12,0,129906.666666667,1395.5,102.5
"155","01185","2016",32,24,8,110527.78125,1418.75,89.8125
"156","01187","2016",11,8,3,118786.363636364,1325.90909090909,89.8181818181818
"157","01188","2016",3,3,0,182266.666666667,1486.33333333333,118.666666666667
"158","01189","2016",11,10,1,251218.181818182,2412.36363636364,115.272727272727
"159","01190","2016",2,2,0,46000,684,74.5
"160","01191","2016",1,1,0,174720,1713,102
"161","01192","2016",13,12,1,176130.153846154,1898.38461538462,96.8461538461538
"162","01193","2016",3,3,0,166943.333333333,1636.66666666667,102
"163","01194","2016",54,29,25,200664.333333333,2314.98148148148,87.7407407407407
"164","01195","2016",16,12,4,139525,1459.0625,91.4375
"165","01196","2016",6,5,1,139500,1596.5,96.3333333333333
"166","01197","2016",3,3,0,148736.666666667,1365,103
"167","01199","2016",22,20,2,135409.318181818,1464.45454545455,98.0454545454545
"168","01200","2016",2,2,0,58150,556,101
"169","01202","2016",67,39,28,154146.417910448,1669.22388059701,94.6268656716418
"170","01203","2016",11,11,0,148823.545454545,1549.36363636364,97.4545454545455
"171","01204","2016",5,5,0,175830,1200.4,154
"172","01206","2016",1,1,0,110000,1375,80
"173","01207","2016",4,4,0,264436.25,2409.75,111.25
"174","01208","2016",1,1,0,43000,1075,40
"175","01209","2016",3,3,0,286000,2104,133.333333333333
"176","01210","2016",18,1,17,68412.8333333333,1962.83333333333,35.7222222222222
"177","01211","2016",9,9,0,163429.444444444,1898.44444444444,84.3333333333333
"178","01212","2016",5,5,0,104936,1085.6,99.6
"179","01213","2016",16,16,0,176735.9375,1819.25,97.5
"180","01214","2016",1,1,0,189000,995,190
"181","01215","2016",1,1,0,304000,2714,112
"182","01216","2016",7,7,0,85678.5714285714,1322.14285714286,75.5714285714286
"183","01219","2016",1,1,0,68000,1115,61
"184","01224","2016",37,27,10,178971.432432432,1906.13513513514,96.7297297297297
"185","01225","2016",6,4,2,236376.666666667,2120.16666666667,114.5
"186","01227","2016",2,2,0,120000,1438,83.5
"187","01228","2016",4,4,0,127902.5,1416.25,95
"188","01229","2016",8,8,0,130415.375,1466.375,88
"189","01230","2016",11,11,0,132529.090909091,1350,104.363636363636
"190","01231","2016",16,16,0,175451.25,1676,109.125
"191","01232","2016",16,15,1,156212.5,1511.9375,102.8125
"192","01233","2016",1,1,0,147000,919,160
"193","01234","2016",1,1,0,175000,1750,100
"194","01235","2016",4,4,0,162125,1471.75,118.75
"195","01236","2016",7,7,0,153450,1309.85714285714,114.285714285714
"196","01237","2016",12,10,2,166315.833333333,1575,107.333333333333
"197","01238","2016",19,18,1,273950.894736842,2549.05263157895,106.789473684211
"198","01239","2016",10,9,1,154428,1468.2,107.4
"199","01240","2016",7,7,0,129142.857142857,1342.85714285714,106.571428571429
"200","01241","2016",14,14,0,161957.642857143,1351.28571428571,116.857142857143
"201","01243","2016",15,14,1,182588,1987,93.2666666666667
"202","01244","2016",82,65,17,195848.512195122,2190.57317073171,93.609756097561
"203","01245","2016",6,6,0,168258.333333333,1334.16666666667,125.5
"204","01246","2016",14,14,0,138548.571428571,1339.92857142857,113.928571428571
"205","01247","2016",9,3,6,108056.666666667,2295.33333333333,42
"206","01248","2016",19,14,5,299611.947368421,3029.26315789474,106.947368421053
"207","01249","2016",98,49,49,247896.367346939,2628.79591836735,95.7244897959184
"208","01250","2016",19,19,0,262948.421052632,2577.36842105263,108.315789473684
"209","01252","2016",17,17,0,163694.117647059,1757.58823529412,98.7647058823529
"210","01254","2016",10,10,0,217982,2016.9,113.2
"211","01255","2016",11,11,0,154648.181818182,1740.90909090909,87.0909090909091
"212","01257","2016",2,2,0,233500,2194,105
"213","01258","2016",9,9,0,242562.222222222,2049.22222222222,123.222222222222
"214","01259","2016",5,5,0,239721,2203.6,116
"215","01260","2016",5,5,0,148421.6,1809.6,95
"216","01261","2016",8,8,0,221462.5,2216.875,96.375
"217","01262","2016",67,25,42,181900.298507463,2151.46268656716,83.3731343283582
"218","01263","2016",45,40,5,204829.244444444,2125.06666666667,98.6444444444444
"219","01264","2016",9,8,1,152144.444444444,1530.77777777778,101.333333333333
"220","01265","2016",28,13,15,184785.714285714,2079.75,89.3214285714286
"221","01266","2016",24,14,10,133570.5,1523.58333333333,94.2916666666667
"222","01267","2016",8,8,0,181116.5,1577.125,128.875
"223","01268","2016",4,4,0,172500,1810.5,95.25
"224","01269","2016",21,6,15,89088.2380952381,1119.38095238095,81.1904761904762
"225","01272","2016",15,15,0,173422.666666667,1633.4,105.8
"226","01273","2016",22,19,3,119405.772727273,1441.5,83.4545454545455
"227","01274","2016",3,3,0,107333.333333333,1056.33333333333,111.333333333333
"228","01275","2016",29,20,9,306260.344827586,2548.37931034483,125.448275862069
"229","01276","2016",25,24,1,244994.08,2167,113
"230","01277","2016",3,3,0,122333.333333333,936,132.333333333333
"231","01279","2016",1,1,0,80000,1000,80
"232","01280","2016",6,6,0,153800,1573.83333333333,96.5
"233","01281","2016",50,29,21,416904.54,4331.7,98.38
"234","01283","2016",152,66,86,114988.125,1359.125,85.7171052631579
"235","01284","2016",3,3,0,113676.666666667,1234.33333333333,95.6666666666667
"236","01285","2016",7,6,1,259392.857142857,2286.71428571429,117.714285714286
"237","01286","2016",13,13,0,199054.692307692,1504.15384615385,141.230769230769
"238","01288","2016",23,15,8,319214.391304348,3113.5652173913,108.130434782609
"239","01289","2016",60,45,15,165672.8,1735.48333333333,97.8666666666667
"240","01290","2016",10,9,1,253612,2249.2,123
"241","01291","2016",6,6,0,137500,1304.33333333333,99
"242","01293","2016",2,2,0,142500,1032.5,140
"243","01294","2016",5,5,0,128357.6,1281.8,99
"244","01295","2016",9,9,0,205066.666666667,1916.77777777778,106.888888888889
"245","01296","2016",5,5,0,132900,1396.2,98.4
"246","01297","2016",7,7,0,222831.571428571,2104.14285714286,106.571428571429
"247","01299","2016",4,4,0,180225,1416.25,120.5
"248","01301","2016",17,10,7,175938.588235294,1707.70588235294,110.823529411765
"249","01302","2016",2,2,0,176150,1528.5,119.5
"250","01303","2016",17,15,2,141124.705882353,1210.88235294118,121.882352941176
"251","01304","2016",37,33,4,139770.621621622,1419.67567567568,101.216216216216
"252","01305","2016",16,12,4,121509.375,1419.625,86.8125
"253","01306","2016",19,11,8,126683.473684211,1614,77.3157894736842
"254","01307","2016",5,3,2,158479.2,1591.2,104.4
"255","01308","2016",7,7,0,349782,3118.57142857143,134.714285714286
"256","01309","2016",1,1,0,50000,500,100
"257","01313","2016",107,52,55,458555.990654206,4534.29906542056,101.775700934579
"258","01314","2016",23,20,3,161580.47826087,1506.5652173913,107.04347826087
"259","01317","2016",4,4,0,142131.25,1206.25,116.75
"260","01318","2016",7,7,0,210477.142857143,2061.57142857143,102.714285714286
"261","01319","2016",5,5,0,167104,1450.6,122.2
"262","01320","2016",42,39,3,178970.619047619,1942.16666666667,102.238095238095
"263","01321","2016",12,11,1,173770.833333333,1366.41666666667,126.166666666667
"264","01322","2016",50,41,9,275211.78,2577.1,112.94
"265","01323","2016",6,6,0,164150,1386.83333333333,117.5
"266","01325","2016",12,12,0,218138.333333333,1979.66666666667,117.166666666667
"267","01328","2016",4,4,0,234500,1627.25,153.5
"268","01329","2016",2,2,0,93250,1334.5,70
"269","01331","2016",1,1,0,144500,1680,86
"270","01332","2016",8,8,0,196806.25,1637.75,122.375
"271","01333","2016",29,21,8,205329.586206897,2336.51724137931,92.8275862068966
"272","01334","2016",10,10,0,238983,2172.3,109.7
"273","01335","2016",7,7,0,201661.428571429,1786.14285714286,109.714285714286
"274","01336","2016",7,7,0,181969.285714286,1494.85714285714,129.142857142857
"275","01337","2016",8,8,0,151918.75,1202.875,129.25
"276","01338","2016",11,11,0,169606.818181818,1460.81818181818,117.545454545455
"277","01339","2016",13,13,0,325375.384615385,2509.53846153846,139.846153846154
"278","01342","2016",8,8,0,336390,2490.75,128.5
"279","01343","2016",14,13,1,172922.142857143,1465.78571428571,119.785714285714
"280","01344","2016",66,54,12,169634.818181818,1760.21212121212,97.0454545454545
"281","01345","2016",31,24,7,158651.935483871,1765.35483870968,90.4516129032258
"282","01346","2016",13,12,1,180311.461538462,1703.30769230769,110.153846153846
"283","01347","2016",22,22,0,283388.454545455,2454,120
"284","01348","2016",33,32,1,175240.606060606,1913.72727272727,101.090909090909
"285","01349","2016",3,3,0,214666.666666667,1513.66666666667,146
"286","01350","2016",25,21,4,188016.2,1659.12,113.12
"287","01351","2016",24,24,0,206280.416666667,1897.79166666667,122.625
"288","01352","2016",9,9,0,125298.111111111,1151.33333333333,106.444444444444
"289","01353","2016",18,18,0,267000.277777778,2266.88888888889,117
"290","01354","2016",173,56,117,389690.50867052,3825.32369942197,101.895953757225
"291","01355","2016",3,3,0,153400,1994.66666666667,78
"292","01356","2016",4,4,0,186973.75,1255.75,143.5
"293","01357","2016",9,7,2,129944.444444444,1550.22222222222,91.5555555555556
"294","01358","2016",4,4,0,140962.5,1383.5,106.75
"295","01359","2016",4,4,0,199262.5,1842,112.25
"296","01360","2016",21,14,7,417074.19047619,3689.28571428571,119.761904761905
"297","01361","2016",16,16,0,280300.5,2154.4375,140.0625
"298","01362","2016",7,7,0,257810.571428571,2268,121.142857142857
"299","01363","2016",17,15,2,144775.294117647,1558.88235294118,94.1176470588235
"300","01364","2016",14,14,0,147139.285714286,1417.85714285714,113.214285714286
"301","01365","2016",9,9,0,139255.555555556,1812.55555555556,80.2222222222222
"302","01366","2016",13,12,1,197434.615384615,1956.61538461538,99.6153846153846
"303","01367","2016",14,14,0,114477.142857143,1127.42857142857,106
"304","01368","2016",7,7,0,184588.571428571,1400.71428571429,135.142857142857
"305","01369","2016",11,9,2,189447.727272727,1501.27272727273,131.454545454545
"306","01370","2016",38,5,33,95971.1052631579,1388.60526315789,71.5526315789474
"307","01371","2016",11,8,3,207990,2415.63636363636,87.7272727272727
"308","01372","2016",3,3,0,296260,3161.33333333333,98.3333333333333
"309","01373","2016",6,6,0,158800,1657.5,98.6666666666667
"310","01374","2016",21,21,0,161260.047619048,1416.61904761905,118.333333333333
"311","01375","2016",13,13,0,158992.307692308,1520.30769230769,104.230769230769
"312","01376","2016",39,11,28,181801.384615385,2191.25641025641,82.2307692307692
"313","01378","2016",26,26,0,252567,2272.19230769231,113.923076923077
"314","01379","2016",11,11,0,172023.636363636,1416.09090909091,123.454545454545
"315","01380","2016",8,8,0,85175,970,92.375
"316","01381","2016",11,10,1,193627.272727273,1874.09090909091,106.818181818182
"317","01382","2016",3,3,0,260420,1919,135.333333333333
"318","01383","2016",15,12,3,201597,1940.13333333333,103.333333333333
"319","01384","2016",18,15,3,105390.944444444,1247.77777777778,91.1666666666667
"320","01385","2016",7,6,1,199928.571428571,1893.14285714286,111.571428571429
"321","01386","2016",16,14,2,170702,2009.1875,90.6875
"322","01387","2016",2,2,0,162075,1288.5,126.5
"323","01388","2016",8,7,1,113545,1210.25,94.5
"324","01389","2016",15,12,3,187143,1699.53333333333,113.266666666667
"325","01390","2016",12,10,2,216660,2111.41666666667,104.583333333333
"326","01391","2016",3,3,0,101666.666666667,867,129.333333333333
"327","01392","2016",6,6,0,180925,1822.16666666667,98.1666666666667
"328","01393","2016",9,9,0,265165.777777778,1910.55555555556,140.666666666667
"329","01396","2016",6,6,0,141473.333333333,1492.66666666667,91.8333333333333
"330","01397","2016",7,4,3,579814.285714286,4130.71428571429,140
"331","01398","2016",15,14,1,234899.333333333,1785.06666666667,146.266666666667
"332","01399","2016",29,13,16,398864.482758621,3799.86206896552,107.448275862069
"333","01400","2016",3,3,0,101266.666666667,920.666666666667,105.666666666667
"334","01401","2016",16,12,4,474618.125,3813.8125,125.375
"335","01402","2016",6,6,0,125333.333333333,1446.16666666667,90.3333333333333
"336","01403","2016",14,13,1,136762.142857143,1483.35714285714,95.2142857142857
"337","01404","2016",3,3,0,131300,1806.66666666667,81
"338","01405","2016",10,8,2,159033.3,1587.7,101.2
"339","01406","2016",1,1,0,127000,1067,119
"340","01407","2016",16,5,11,131586.875,1747.1875,76.1875
"341","01408","2016",6,6,0,163150,1480.83333333333,132.833333333333
"342","01411","2016",6,5,1,122925,1450.83333333333,79.8333333333333
"343","01412","2016",3,3,0,240833.333333333,1381.66666666667,173
"344","01415","2016",5,5,0,133810,1405.6,93.8
"345","01416","2016",13,11,2,85336.9230769231,1101.15384615385,73.1538461538462
"346","01418","2016",7,5,2,273185.714285714,2536.57142857143,106.428571428571
"347","01419","2016",52,36,16,415609.769230769,4050.25,102.711538461538
"348","01420","2016",19,9,10,120091.052631579,1219.84210526316,98.5789473684211
"349","01421","2016",12,12,0,105383.333333333,1342,78.6666666666667
"350","01422","2016",10,10,0,189989,1801.5,102.2
"351","01423","2016",12,12,0,269107.083333333,2720.33333333333,105.333333333333
"352","01424","2016",13,11,2,293654.230769231,2427.23076923077,127.076923076923
"353","01425","2016",2,2,0,179500,1428,126.5
"354","01426","2016",28,23,5,145913.5,1266.89285714286,118.821428571429
"355","01427","2016",92,42,50,190639.706521739,2172.05434782609,88.2717391304348
"356","01428","2016",1,1,0,169000,1341,126
"357","01429","2016",7,7,0,95871.4285714286,1129.42857142857,90.2857142857143
"358","01430","2016",5,4,1,143704,1564.8,88.4
"359","01431","2016",12,12,0,133600.25,1531.16666666667,89.5
"360","01432","2016",3,3,0,125278.333333333,1493.66666666667,83
"361","01433","2016",5,5,0,83600,1036.2,82.6
"362","01434","2016",3,3,0,279166.666666667,5454,73.6666666666667
"363","01435","2016",20,14,6,452847.5,4209.35,109.1
"364","01436","2016",5,4,1,551000,4024.4,146.4
"365","01437","2016",4,4,0,125918.75,1296.75,96
"366","01441","2016",8,8,0,141707.75,1384.25,101.25
"367","01443","2016",65,44,21,193235.753846154,2113.38461538462,95.1384615384615
"368","01444","2016",21,21,0,106036.666666667,1334.2380952381,82.1428571428571
"369","01445","2016",5,4,1,169272,1739.8,97.4
"370","01446","2016",21,19,2,254321.904761905,2208.80952380952,117.52380952381
"371","01447","2016",8,8,0,111593.75,1166.5,92.75
"372","01448","2016",3,2,1,204066.666666667,2068.33333333333,98.6666666666667
"373","01449","2016",3,3,0,157500,1461,99
"374","01450","2016",38,37,1,203436.210526316,1946.97368421053,105.421052631579
"375","01451","2016",49,46,3,220032.591836735,1939.75510204082,114.530612244898
"376","01452","2016",15,14,1,102637.466666667,1380.26666666667,74.4666666666667
"377","01453","2016",7,7,0,102100,1182.71428571429,87.1428571428571
"378","01454","2016",16,14,2,142656.8125,1953.3125,88.375
"379","01457","2016",33,30,3,173151.545454545,1710.24242424242,101.090909090909
"380","02001","2016",3,3,0,121500,1321,95
"381","02002","2016",5,5,0,92200,1054.8,83.8
"382","02003","2016",8,8,0,141700,1443.5,97
"383","02005","2016",4,4,0,147250,1472.5,97.25
"384","02006","2016",3,3,0,57866.6666666667,1229,70
"385","02008","2016",7,7,0,116242.857142857,1242.85714285714,92
"386","02009","2016",3,3,0,149600,1426.66666666667,105
"387","02010","2016",4,4,0,145625,1212,124.5
"388","02011","2016",13,13,0,97061.5384615385,1141.92307692308,85.9230769230769
"389","02012","2016",1,1,0,105000,1167,90
"390","02013","2016",6,6,0,187591.666666667,1280.33333333333,145
"391","02014","2016",10,10,0,131850,1301.8,105.8
"392","02015","2016",2,2,0,241950,1536,162.5
"393","02016","2016",2,2,0,94250,928.5,105.5
"394","02017","2016",2,2,0,47500,783.5,60.5
"395","02018","2016",24,24,0,105595.041666667,1240.83333333333,86.2083333333333
"396","02019","2016",2,2,0,82500,866,96.5
"397","02020","2016",10,10,0,108810,1076.2,100.1
"398","02021","2016",3,3,0,56000,758,75.3333333333333
"399","02022","2016",1,1,0,90000,1607,56
"400","02025","2016",2,2,0,90000,1081,79
"401","02027","2016",1,1,0,75000,708,106
"402","02028","2016",26,26,0,126453.461538462,1308.15384615385,103.076923076923
"403","02029","2016",4,4,0,164806.25,1212.5,136.25
"404","02030","2016",1,1,0,80000,667,120
"405","02031","2016",9,9,0,94940,898.777777777778,111.111111111111
"406","02032","2016",2,2,0,193000,1566,121.5
"407","02033","2016",1,1,0,75000,610,123
"408","02034","2016",2,2,0,187500,1226,155
"409","02035","2016",4,4,0,120337.5,1087.75,109.5
"410","02037","2016",10,10,0,141640,1188.3,121.5
"411","02038","2016",1,1,0,170000,1349,126
"412","02039","2016",2,2,0,91000,676.5,124.5
"413","02040","2016",1,1,0,131500,1384,95
"414","02041","2016",5,5,0,154000,1681.8,98.4
"415","02042","2016",6,6,0,116250,1546.16666666667,84.6666666666667
"416","02046","2016",6,6,0,123900,1207,106
"417","02049","2016",11,11,0,91909.0909090909,1075.09090909091,83.9090909090909
"418","02050","2016",6,6,0,134612,1378.16666666667,106.333333333333
"419","02051","2016",4,4,0,194255,1375.5,143
"420","02052","2016",3,3,0,91166.6666666667,913,109.333333333333
"421","02053","2016",7,7,0,108428.571428571,860.285714285714,125.714285714286
"422","02054","2016",5,5,0,160504,1135.4,143
"423","02055","2016",1,1,0,129000,843,153
"424","02056","2016",2,2,0,72500,946.5,77
"425","02057","2016",11,11,0,98381.8181818182,790.727272727273,125.090909090909
"426","02058","2016",5,5,0,125020,1348.4,99.8
"427","02059","2016",18,18,0,57237.2222222222,725.222222222222,80.5555555555556
"428","02060","2016",2,2,0,104350,874,123.5
"429","02061","2016",6,6,0,73166.6666666667,888.833333333333,89
"430","02062","2016",2,2,0,141500,1329,106
"431","02063","2016",4,4,0,87750,972.75,91.25
"432","02064","2016",20,17,3,122007.5,1583.5,78.65
"433","02065","2016",9,9,0,104878.888888889,1039.22222222222,100
"434","02068","2016",1,1,0,40000,519,77
"435","02069","2016",1,1,0,114700,663,173
"436","02070","2016",4,4,0,137850,1156.75,109.5
"437","02071","2016",7,7,0,118428.571428571,1235.14285714286,91.1428571428571
"438","02072","2016",3,3,0,99166.6666666667,1000.33333333333,102
"439","02073","2016",6,6,0,186883.333333333,1428.5,143.5
"440","02074","2016",7,7,0,108142.857142857,1126.85714285714,100
"441","02075","2016",3,3,0,165500,1937.33333333333,89.6666666666667
"442","02076","2016",2,2,0,225825,1476.5,157.5
"443","02077","2016",5,5,0,127200,1237.8,100.2
"444","02078","2016",2,2,0,85000,866.5,95
"445","02079","2016",1,1,0,69500,448,155
"446","02080","2016",3,3,0,144741,1239.33333333333,121.666666666667
"447","02081","2016",1,1,0,40000,580,69
"448","02083","2016",11,10,1,130427.272727273,1308.18181818182,104.909090909091
"449","02084","2016",4,4,0,146750,1452.25,105.25
"450","02085","2016",15,15,0,157854.666666667,1802.46666666667,89.3333333333333
"451","02086","2016",13,13,0,111846.153846154,1314.38461538462,96.3076923076923
"452","02088","2016",1,1,0,110000,1209,91
"453","02089","2016",15,15,0,151991.533333333,1587.73333333333,97.6666666666667
"454","02090","2016",2,2,0,245000,1252.5,184.5
"455","02093","2016",14,14,0,112378.571428571,1145.07142857143,99.2857142857143
"456","02094","2016",1,1,0,185000,1555,119
"457","02095","2016",51,50,1,64401.2156862745,674.960784313726,93.5882352941177
"458","02096","2016",2,2,0,98000,1127,89.5
"459","02097","2016",2,2,0,97750,1077.5,88
"460","02098","2016",2,2,0,126000,1464.5,87.5
"461","02099","2016",4,4,0,121450,1137.5,107
"462","02100","2016",1,1,0,135000,1378,98
"463","02101","2016",1,1,0,143000,905,158
"464","02102","2016",2,2,0,163825,1822.5,101
"465","02103","2016",15,15,0,74833.3333333333,882.066666666667,84.6666666666667
"466","02105","2016",3,3,0,86333.3333333333,817,96.3333333333333
"467","02106","2016",10,10,0,114505,1295.8,90.2
"468","02107","2016",2,2,0,93388.5,710,137.5
"469","02108","2016",2,2,0,99000,986,106.5
"470","02109","2016",7,7,0,138857.142857143,2370.57142857143,87.8571428571429
"471","02110","2016",20,18,2,116250,1198.55,100.45
"472","02111","2016",7,7,0,113285.714285714,1578,78
"473","02112","2016",7,7,0,76928.5714285714,811.857142857143,101.142857142857
"474","02114","2016",7,6,1,134000,1579.42857142857,84.4285714285714
"475","02115","2016",2,2,0,135000,1646,82.5
"476","02116","2016",2,2,0,59750,727.5,81.5
"477","02117","2016",1,1,0,115000,1307,88
"478","02118","2016",1,1,0,95000,913,104
"479","02119","2016",3,3,0,71666.6666666667,933.333333333333,77
"480","02121","2016",3,3,0,112333.333333333,912.333333333333,125
"481","02124","2016",6,6,0,91115.6666666667,1451.5,82
"482","02125","2016",2,2,0,132000,1365,122
"483","02126","2016",2,2,0,75500,771,115.5
"484","02128","2016",14,13,1,91265.1428571429,1063.14285714286,85.2142857142857
"485","02130","2016",2,2,0,155000,873.5,164
"486","02131","2016",24,23,1,157404.166666667,1799.08333333333,87.25
"487","02132","2016",3,3,0,124766.666666667,1248.33333333333,105.666666666667
"488","02133","2016",2,2,0,66000,477.5,145
"489","02134","2016",14,14,0,101192.857142857,945.642857142857,106.214285714286
"490","02135","2016",10,10,0,94660,910.6,117
"491","02137","2016",1,1,0,255000,1771,144
"492","02138","2016",3,3,0,181933.333333333,1368.33333333333,140
"493","02139","2016",3,3,0,138333.333333333,1005.66666666667,143.666666666667
"494","02140","2016",8,8,0,90087.5,923.875,116.5
"495","02141","2016",9,9,0,82955.5555555556,832.444444444444,96.1111111111111
"496","02142","2016",4,4,0,92250,1379,69.25
"497","02144","2016",2,2,0,130500,1177.5,115
"498","02145","2016",2,2,0,184250,1538.5,122
"499","02148","2016",5,5,0,138710,2025.6,68.6
"500","02150","2016",1,1,0,65000,1226,53
"501","02151","2016",2,2,0,140000,830,166
"502","02153","2016",11,11,0,107979.090909091,1150.72727272727,93.3636363636364
"503","02154","2016",6,6,0,143833.333333333,1026.16666666667,140.833333333333
"504","02155","2016",1,1,0,152000,1034,147
"505","02157","2016",7,7,0,137142.857142857,1482.28571428571,94.8571428571429
"506","02158","2016",3,3,0,110466.666666667,1283.66666666667,86.3333333333333
"507","02159","2016",4,4,0,77500,1037.25,83.5
"508","02160","2016",4,4,0,82675,947,89.5
"509","02162","2016",1,1,0,175000,1667,105
"510","02163","2016",25,20,5,141776,1463.56,100.04
"511","02164","2016",3,3,0,71450,904.666666666667,78.3333333333333
"512","02165","2016",16,16,0,74112.5,776.625,93.875
"513","02166","2016",9,9,0,344543.666666667,2819.44444444444,95.1111111111111
"514","02167","2016",7,6,1,119815.714285714,1163.42857142857,105.142857142857
"515","02168","2016",148,78,70,127200.337837838,1621.02702702703,79.8310810810811
"516","02171","2016",3,3,0,88000,919.333333333333,109
"517","02172","2016",1,1,0,75000,735,102
"518","02173","2016",116,96,20,100313.189655172,1127.27586206897,87.9051724137931
"519","02174","2016",11,11,0,105890,1203.27272727273,105.272727272727
"520","02175","2016",1,1,0,125000,1126,111
"521","02176","2016",3,3,0,109166.666666667,943.333333333333,116
"522","02177","2016",1,1,0,87900,656,134
"523","02178","2016",2,2,0,139000,1524.5,106.5
"524","02179","2016",4,4,0,127125,1110.25,117.75
"525","02180","2016",8,8,0,74398.75,956,78.375
"526","02181","2016",1,1,0,60000,1200,50
"527","02183","2016",1,1,0,2e+05,1250,160
"528","02184","2016",3,3,0,65000,658.666666666667,98.6666666666667
"529","02185","2016",3,3,0,138866.666666667,1548,89
"530","02186","2016",15,14,1,137729.666666667,1666.6,94.1333333333333
"531","02187","2016",13,13,0,165696.538461538,1679.76923076923,97.1538461538462
"532","02188","2016",1,1,0,125000,1096,114
"533","02189","2016",4,4,0,100750,919,113.5
"534","02190","2016",4,4,0,119250,1383.25,91
"535","02191","2016",6,6,0,129382.833333333,1140.83333333333,106.5
"536","02192","2016",3,3,0,120366.666666667,1424,86.6666666666667
"537","02194","2016",1,1,0,110000,1209,91
"538","02195","2016",5,5,0,139600,1254.2,115.6
"539","02196","2016",6,6,0,125933.333333333,1188.66666666667,109.5
"540","02197","2016",3,3,0,69733.3333333333,926.666666666667,79
"541","02199","2016",3,3,0,58833.3333333333,819.666666666667,68.3333333333333
"542","02201","2016",6,6,0,119210.333333333,1906,69.1666666666667
"543","02203","2016",11,11,0,112122.727272727,1122.27272727273,106.454545454545
"544","02204","2016",1,1,0,80000,930,86
"545","02205","2016",2,2,0,150500,1475.5,102
"546","02207","2016",3,3,0,133000,1370.66666666667,98
"547","02208","2016",7,7,0,142657.142857143,1335.85714285714,116.428571428571
"548","02209","2016",10,10,0,85875,1039.8,87.1
"549","02210","2016",3,3,0,131666.666666667,1169.66666666667,114.666666666667
"550","02212","2016",2,2,0,75250,1152,67
"551","02213","2016",2,2,0,61000,835,75
"552","02215","2016",6,6,0,147428.333333333,1387.16666666667,108.5
"553","02216","2016",3,3,0,90500,915.333333333333,93.6666666666667
"554","02217","2016",12,12,0,113772.916666667,1189.33333333333,96.4166666666667
"555","02218","2016",4,4,0,88000,875.5,102
"556","02219","2016",3,3,0,105866.666666667,1011.33333333333,105.333333333333
"557","02220","2016",6,6,0,92000,929.5,106.833333333333
"558","02221","2016",2,2,0,107000,1175.5,91
"559","02223","2016",1,1,0,170000,1062,160
"560","02225","2016",2,2,0,180000,1115,161
"561","02226","2016",13,13,0,106517.384615385,1260,86.8461538461538
"562","02228","2016",3,3,0,161500,1587.33333333333,104
"563","02229","2016",1,1,0,51000,962,53
"564","02230","2016",3,3,0,98666.6666666667,911.666666666667,110.333333333333
"565","02231","2016",5,5,0,130000,1253.8,113.4
"566","02232","2016",3,3,0,181733.333333333,1906,97
"567","02234","2016",1,1,0,60000,561,107
"568","02235","2016",1,1,0,159400,1791,89
"569","02236","2016",3,3,0,74206.6666666667,862.333333333333,91
"570","02237","2016",9,9,0,80388.8888888889,731.555555555556,120.666666666667
"571","02238","2016",19,18,1,95976,1055,96.2631578947368
"572","02239","2016",9,9,0,86000,1067.77777777778,82.2222222222222
"573","02240","2016",4,4,0,133437.5,823.25,143
"574","02242","2016",12,11,1,104833.333333333,1544.25,81.75
"575","02243","2016",32,30,2,113896.1875,1350.34375,84.625
"576","02244","2016",1,1,0,86000,860,100
"577","02245","2016",15,12,3,101717.066666667,1410.2,72.7333333333333
"578","02248","2016",1,1,0,100270,1729,58
"579","02249","2016",1,1,0,69400,1509,46
"580","02250","2016",3,3,0,220300,1716.66666666667,132
"581","02252","2016",1,1,0,143500,908,158
"582","02253","2016",6,6,0,128833.333333333,1222,115.666666666667
"583","02254","2016",1,1,0,115000,1855,62
"584","02255","2016",5,5,0,114100,1352,84
"585","02258","2016",6,6,0,173616.666666667,1781.66666666667,97.1666666666667
"586","02259","2016",3,3,0,162666.666666667,2109.66666666667,89.6666666666667
"587","02260","2016",5,5,0,79700,1092,70.8
"588","02261","2016",6,6,0,77725,840.333333333333,93.6666666666667
"589","02262","2016",2,2,0,120400,1224.5,102
"590","02264","2016",4,4,0,50750,609.5,81
"591","02265","2016",1,1,0,60000,741,81
"592","02267","2016",6,6,0,145083.333333333,1939.66666666667,80.6666666666667
"593","02268","2016",8,8,0,152437.5,1618.5,98.375
"594","02270","2016",2,2,0,45000,534.5,82.5
"595","02271","2016",2,2,0,107500,844,125
"596","02272","2016",3,3,0,100500,1200,83
"597","02273","2016",3,3,0,116833.333333333,1396.33333333333,82.3333333333333
"598","02275","2016",3,3,0,53333.3333333333,675.333333333333,78.6666666666667
"599","02276","2016",1,1,0,1e+05,500,200
"600","02277","2016",4,4,0,119075,1168.25,111
"601","02278","2016",1,1,0,120000,1200,100
"602","02279","2016",11,11,0,163272.727272727,1465.45454545455,118.090909090909
"603","02280","2016",3,3,0,177333.333333333,1400,130.333333333333
"604","02281","2016",4,4,0,191375,1744.25,109.75
"605","02283","2016",1,1,0,201750,1040,194
"606","02286","2016",7,7,0,80857.1428571429,888.428571428571,91.2857142857143
"607","02287","2016",8,8,0,94381.75,1167,80.25
"608","02288","2016",2,2,0,101000,1177,82.5
"609","02289","2016",4,4,0,117250,1812,70.75
"610","02290","2016",16,16,0,171437.5,1538.5,116.1875
"611","02291","2016",1,1,0,61100,555,110
"612","02292","2016",9,9,0,137666.666666667,1610.88888888889,87.6666666666667
"613","02293","2016",6,6,0,100833.333333333,931.666666666667,112.5
"614","02294","2016",2,2,0,203500,1482,145
"615","02295","2016",2,2,0,37500,451,87.5
"616","02296","2016",8,8,0,142737.5,1085,132.375
"617","02297","2016",2,2,0,91750,1279.5,68
"618","02298","2016",11,11,0,60000,665.181818181818,89.0909090909091
"619","02299","2016",5,5,0,118340,1246,97
"620","02302","2016",2,2,0,262500,7025,62.5
"621","02303","2016",9,9,0,146194.444444444,1481.55555555556,98.8888888888889
"622","02304","2016",12,11,1,70833.3333333333,801.5,85.0833333333333
"623","02305","2016",26,26,0,115025,1192.5,101
"624","02306","2016",6,6,0,73000,1004.33333333333,85.3333333333333
"625","02307","2016",23,20,3,149158.695652174,1479.04347826087,98.9130434782609
"626","02308","2016",6,6,0,82583.3333333333,792.666666666667,103.666666666667
"627","02309","2016",6,6,0,136166.666666667,1248.66666666667,108
"628","02311","2016",2,2,0,143000,1551,94
"629","02312","2016",7,7,0,104787.285714286,816.714285714286,129.142857142857
"630","02313","2016",1,1,0,100500,773,130
"631","02315","2016",22,22,0,91931.8181818182,917.454545454545,101.545454545455
"632","02316","2016",4,4,0,154350,2048.5,78.5
"633","02317","2016",4,4,0,95575,1213.5,82.25
"634","02318","2016",8,8,0,65250,867.25,79.25
"635","02319","2016",6,6,0,95600,1111.16666666667,84.8333333333333
"636","02320","2016",1,1,0,40000,385,104
"637","02321","2016",5,5,0,117100,1207.2,90.6
"638","02322","2016",6,6,0,104666.666666667,1198.16666666667,88.8333333333333
"639","02323","2016",3,3,0,118080,1200.66666666667,98.6666666666667
"640","02324","2016",4,4,0,110400,966.25,112.25
"641","02326","2016",7,7,0,165142.857142857,1397.14285714286,119.285714285714
"642","02327","2016",1,1,0,73000,936,78
"643","02328","2016",6,6,0,166093.333333333,1417.16666666667,124.333333333333
"644","02329","2016",4,4,0,103750,863.5,134.25
"645","02330","2016",1,1,0,91600,1078,85
"646","02331","2016",2,2,0,106350,737,145.5
"647","02332","2016",1,1,0,120000,1481,81
"648","02333","2016",2,2,0,71000,819.5,83.5
"649","02334","2016",22,22,0,97859.0909090909,1026.77272727273,97.8636363636364
"650","02335","2016",2,2,0,84500,1027,82.5
"651","02336","2016",5,5,0,97500,1235.2,83
"652","02337","2016",3,3,0,103333.333333333,1032.33333333333,104.333333333333
"653","02339","2016",9,9,0,138211.111111111,1623,96.5555555555556
"654","02340","2016",68,65,3,92964.25,1164.51470588235,81.0147058823529
"655","02341","2016",3,3,0,65000,631.333333333333,102.666666666667
"656","02342","2016",2,2,0,119145,987.5,121.5
"657","02346","2016",3,3,0,122333.333333333,805.666666666667,149
"658","02347","2016",4,4,0,105007.25,1330.5,79.75
"659","02350","2016",1,1,0,57000,655,87
"660","02351","2016",1,1,0,169000,1742,97
"661","02352","2016",9,9,0,80722.2222222222,857.333333333333,99.7777777777778
"662","02353","2016",3,3,0,83333.3333333333,817,102.333333333333
"663","02355","2016",9,9,0,100555.555555556,1141.88888888889,87.7777777777778
"664","02356","2016",6,6,0,112166.666666667,1469.33333333333,85.3333333333333
"665","02358","2016",3,3,0,101048.333333333,820.333333333333,120.333333333333
"666","02359","2016",10,10,0,132130,1378.5,94.7
"667","02360","2016",31,31,0,149441.935483871,1765.03225806452,85.9032258064516
"668","02361","2016",43,41,2,73962.1162790698,813.720930232558,90.9767441860465
"669","02362","2016",4,4,0,101100,950.25,106.75
"670","02363","2016",5,5,0,69660,1111.2,60.6
"671","02364","2016",1,1,0,139000,1738,80
"672","02366","2016",2,2,0,63000,735,95.5
"673","02368","2016",4,4,0,154568.25,1428.25,108
"674","02369","2016",4,4,0,55625,493.5,118.75
"675","02370","2016",4,4,0,124625,1402.5,97.25
"676","02371","2016",12,12,0,111877.5,1086.33333333333,100.666666666667
"677","02372","2016",6,6,0,122250,1059.83333333333,120.166666666667
"678","02374","2016",10,10,0,91160,932.4,93.3
"679","02375","2016",4,4,0,151750,1544.75,94.75
"680","02376","2016",1,1,0,125000,1106,113
"681","02377","2016",1,1,0,75000,708,106
"682","02378","2016",2,2,0,83170,968,85.5
"683","02379","2016",1,1,0,54000,360,150
"684","02381","2016",70,68,2,69130.9,780,86.6142857142857
"685","02382","2016",8,8,0,176037,1497,117.5
"686","02383","2016",8,5,3,110962.5,1197.5,87.875
"687","02384","2016",1,1,0,68000,660,103
"688","02386","2016",1,1,0,195000,1189,164
"689","02387","2016",8,8,0,151512.5,1479.125,110.125
"690","02388","2016",1,1,0,42500,644,66
"691","02389","2016",9,9,0,153974.444444444,1623.44444444444,95.4444444444444
"692","02390","2016",2,2,0,108000,635,178.5
"693","02391","2016",4,4,0,95362.5,1207.5,76
"694","02392","2016",4,4,0,63000,723.25,90.25
"695","02393","2016",1,1,0,111300,1855,60
"696","02395","2016",2,2,0,90000,931,94
"697","02396","2016",2,2,0,75750,930.5,81
"698","02397","2016",11,11,0,115259.090909091,1188.45454545455,95.1818181818182
"699","02398","2016",4,4,0,104550,1049,98.25
"700","02399","2016",3,3,0,200500,1338,158.666666666667
"701","02400","2016",1,1,0,127500,1536,83
"702","02401","2016",6,6,0,57288,663.333333333333,88.3333333333333
"703","02403","2016",2,2,0,55000,678,77
"704","02404","2016",2,2,0,123500,964.5,131
"705","02405","2016",3,3,0,63333.3333333333,1061.33333333333,73.3333333333333
"706","02406","2016",2,2,0,131900,1418,93.5
"707","02407","2016",1,1,0,190500,977,195
"708","02408","2016",186,115,71,85231.8548387097,1075.52150537634,80.8602150537634
"709","02409","2016",2,2,0,96500,1275,80
"710","02410","2016",1,1,0,102000,1417,72
"711","02411","2016",5,5,0,154400,1735.2,98
"712","02412","2016",1,1,0,49500,990,50
"713","02413","2016",1,1,0,263000,1218,216
"714","02414","2016",2,2,0,98700,1156,89.5
"715","02415","2016",2,2,0,131250,1120,116
"716","02416","2016",6,6,0,105000,919.333333333333,118.5
"717","02417","2016",2,2,0,102500,937.5,109
"718","02418","2016",3,3,0,85016.6666666667,1140.33333333333,78.6666666666667
"719","02419","2016",1,1,0,55000,902,61
"720","02420","2016",9,9,0,111722.222222222,1311.33333333333,87.1111111111111
"721","02422","2016",9,9,0,71222.2222222222,833,77.3333333333333
"722","02423","2016",2,2,0,145800,1307.5,121
"723","02424","2016",1,1,0,130000,1300,100
"724","02426","2016",8,8,0,88375,1035.75,85.5
"725","02427","2016",2,2,0,93000,980,101.5
"726","02430","2016",8,7,1,113035,895.375,112.75
"727","02431","2016",4,4,0,71750,982.25,76.75
"728","02432","2016",1,1,0,1e+05,1493,67
"729","02433","2016",4,4,0,90000,778.25,116.25
"730","02438","2016",2,2,0,125000,1607,78.5
"731","02439","2016",13,12,1,108566.923076923,1332.07692307692,88.1538461538462
"732","02441","2016",2,2,0,164950,1855,91
"733","02442","2016",1,1,0,35000,407,86
"734","02443","2016",2,2,0,141000,1779,81.5
"735","02444","2016",2,2,0,75050,772.5,96
"736","02445","2016",2,2,0,114000,1130.5,101
"737","02446","2016",1,1,0,153000,1354,113
"738","02447","2016",2,2,0,75000,701.5,90
"739","02452","2016",1,1,0,133900,881,152
"740","02453","2016",5,5,0,120480,1219.8,101.2
"741","02454","2016",2,2,0,164900,1619.5,101.5
"742","02455","2016",3,3,0,111000,1007,105.333333333333
"743","02456","2016",3,3,0,151000,1387,120
"744","02457","2016",3,3,0,69000,763.333333333333,85
"745","02458","2016",10,10,0,144700,1250.3,122.7
"746","02459","2016",1,1,0,79000,1082,73
"747","02460","2016",2,2,0,80000,1095.5,79
"748","02461","2016",3,3,0,69166.6666666667,731,102.666666666667
"749","02462","2016",1,1,0,60000,652,92
"750","02464","2016",3,3,0,176666.666666667,1311.33333333333,137.666666666667
"751","02465","2016",10,10,0,162000,1567.6,108.7
"752","02466","2016",3,3,0,120333.333333333,1974,65
"753","02467","2016",2,2,0,147500,1138,111.5
"754","02468","2016",11,11,0,67727.2727272727,964.272727272727,79.3636363636364
"755","02469","2016",5,5,0,61600,798,77.6
"756","02470","2016",3,3,0,71333.3333333333,831.666666666667,86
"757","02471","2016",1,1,0,135000,2177,62
"758","02472","2016",2,2,0,66625,986.5,70.5
"759","02473","2016",1,1,0,112000,1047,107
"760","02474","2016",4,4,0,127875,1702.5,90.75
"761","02476","2016",8,8,0,73000,775.75,92.875
"762","02477","2016",7,7,0,163714.285714286,1645.42857142857,97.5714285714286
"763","02478","2016",2,2,0,132500,1298.5,97.5
"764","02481","2016",2,2,0,202400,1558,128.5
"765","02483","2016",4,4,0,108750,1222,90.5
"766","02484","2016",3,3,0,131933.333333333,1471.33333333333,93
"767","02485","2016",1,1,0,133200,1497,89
"768","02487","2016",6,6,0,115998.333333333,1267.5,99.1666666666667
"769","02488","2016",4,4,0,52750,546.5,96.25
"770","02489","2016",7,7,0,129414.285714286,1493.57142857143,88.1428571428571
"771","02491","2016",3,3,0,71166.6666666667,682.333333333333,101.333333333333
"772","02492","2016",2,2,0,50000,625.5,80.5
"773","02493","2016",2,2,0,110950,1234,90.5
"774","02494","2016",3,3,0,50433.3333333333,1523.66666666667,73.3333333333333
"775","02495","2016",8,8,0,109987.5,965.25,123
"776","02496","2016",1,1,0,148640,1039,143
"777","02497","2016",12,12,0,128645.666666667,1133.16666666667,117.416666666667
"778","02498","2016",5,4,1,82679,855.4,95.8
"779","02500","2016",7,7,0,73285.7142857143,878,88.4285714285714
"780","02502","2016",10,9,1,100525,1330,97.8
"781","02503","2016",2,2,0,75850,887.5,85.5
"782","02504","2016",17,17,0,112558.823529412,1139.41176470588,99.1764705882353
"783","02505","2016",5,5,0,129400,1614.8,92.4
"784","02506","2016",3,3,0,258666.666666667,2349,112
"785","02508","2016",2,2,0,57550,918.5,71.5
"786","02509","2016",2,2,0,160000,1114,168
"787","02511","2016",2,2,0,60000,566,105
"788","02512","2016",2,2,0,189000,2075.5,89.5
"789","02513","2016",3,3,0,93166.6666666667,914.666666666667,100
"790","02514","2016",6,6,0,182722,1542,123.666666666667
"791","02517","2016",4,4,0,78000,842.25,94.75
"792","02518","2016",3,3,0,96666.6666666667,608.333333333333,176
"793","02519","2016",1,1,0,47000,1044,45
"794","02520","2016",7,7,0,121223.714285714,1235,99.1428571428571
"795","02521","2016",20,20,0,168242.5,1857.1,96.8
"796","02522","2016",4,4,0,98875,819,125.25
"797","02524","2016",7,7,0,161000,1639.14285714286,102
"798","02525","2016",6,6,0,124666.666666667,1301,95.8333333333333
"799","02527","2016",5,5,0,103500,1107.8,94
"800","02528","2016",3,3,0,153216.666666667,1641.66666666667,95
"801","02529","2016",4,4,0,77700,930.5,84.75
"802","02531","2016",1,1,0,123200,522,236
"803","02532","2016",6,6,0,110083.333333333,1058.5,101.333333333333
"804","02533","2016",3,3,0,142333.333333333,881,167.666666666667
"805","02534","2016",1,1,0,165000,1650,100
"806","02537","2016",3,3,0,116378,1315.33333333333,89.6666666666667
"807","02538","2016",1,1,0,40000,714,56
"808","02539","2016",6,6,0,87750,1026.16666666667,87
"809","02540","2016",8,8,0,143375,1628.75,92
"810","02541","2016",9,9,0,141100,1380.66666666667,105
"811","02543","2016",19,19,0,135184.210526316,1320.68421052632,107.421052631579
"812","02544","2016",4,4,0,88000,875.75,95
"813","02545","2016",2,2,0,94750,730,124.5
"814","02546","2016",7,7,0,87928.5714285714,1002.85714285714,93
"815","02548","2016",3,3,0,97250,958,110.333333333333
"816","02549","2016",10,10,0,106325,1157.1,87.4
"817","02550","2016",2,2,0,107250,807,142
"818","02551","2016",1,1,0,86000,642,134
"819","02552","2016",1,1,0,108000,1029,105
"820","02553","2016",2,2,0,91500,667,137
"821","02554","2016",2,2,0,156000,1201,140
"822","02555","2016",28,28,0,116827.607142857,1341.32142857143,96.4285714285714
"823","02556","2016",2,2,0,76039,586.5,113.5
"824","02557","2016",2,2,0,150500,1643,92.5
"825","02558","2016",15,15,0,108100,1266.66666666667,83.4666666666667
"826","02559","2016",2,2,0,66000,631,128
"827","02560","2016",1,1,0,63000,558,113
"828","02561","2016",2,2,0,157500,1140,134
"829","02562","2016",1,1,0,60000,1000,60
"830","02564","2016",5,5,0,128200,1379.8,93.4
"831","02565","2016",4,4,0,156875,953,156
"832","02566","2016",17,17,0,114610,1302.35294117647,86.1176470588235
"833","02567","2016",3,3,0,74533.3333333333,763.666666666667,99.6666666666667
"834","02568","2016",1,1,0,180000,1957,92
"835","02569","2016",5,5,0,56840,643.6,86.8
"836","02571","2016",6,6,0,152250,1332.33333333333,115.833333333333
"837","02572","2016",4,4,0,202462.5,1882,111.5
"838","02574","2016",10,10,0,96568,1069.6,88.3
"839","02575","2016",17,17,0,81265.6470588235,888.117647058824,91.7058823529412
"840","02576","2016",3,3,0,187333.333333333,1347.33333333333,140.666666666667
"841","02577","2016",1,1,0,113000,1507,75
"842","02579","2016",1,1,0,64500,1152,56
"843","02580","2016",6,6,0,113516.666666667,1231.5,96.3333333333333
"844","02581","2016",4,4,0,200875,3567,100.5
"845","02585","2016",1,1,0,106910,2673,40
"846","02586","2016",1,1,0,30000,429,70
"847","02587","2016",3,3,0,106833.333333333,1416.66666666667,75.3333333333333
"848","02588","2016",1,1,0,25000,926,27
"849","02589","2016",1,1,0,97000,1276,76
"850","02590","2016",5,5,0,109600,1480.4,79
"851","02591","2016",3,3,0,61666.6666666667,755,90.6666666666667
"852","02592","2016",3,3,0,55666.6666666667,663,85
"853","02593","2016",7,7,0,133600,1543.71428571429,85.7142857142857
"854","02594","2016",3,3,0,79333.3333333333,1293.66666666667,75
"855","02595","2016",1,1,0,65000,1204,54
"856","02596","2016",7,7,0,158000,1490.57142857143,108
"857","02598","2016",10,9,1,130320,1644.7,88
"858","02599","2016",1,1,0,130000,2031,64
"859","02600","2016",3,3,0,115866.666666667,976.666666666667,119.666666666667
"860","02601","2016",1,1,0,2e+05,1250,160
"861","02602","2016",23,23,0,106860.869565217,1267,89.1739130434783
"862","02606","2016",3,3,0,137725.666666667,1417.33333333333,96.6666666666667
"863","02608","2016",10,10,0,75841,795.4,94.2
"864","02610","2016",5,5,0,123220,1329.4,94.4
"865","02613","2016",7,7,0,124828.571428571,1387.14285714286,94
"866","02614","2016",1,1,0,183000,1130,162
"867","02615","2016",2,2,0,100750,963,109.5
"868","02616","2016",1,1,0,94500,700,135
"869","02617","2016",6,6,0,89883.3333333333,863.5,105.833333333333
"870","02618","2016",3,3,0,92900,1033,97
"871","02619","2016",6,6,0,79921.6666666667,858.333333333333,98.5
"872","02620","2016",3,3,0,125333.333333333,1105.66666666667,121.333333333333
"873","02621","2016",5,5,0,126700,996.2,116.2
"874","02623","2016",1,1,0,110000,1467,75
"875","02624","2016",3,3,0,63833.3333333333,600.666666666667,105
"876","02625","2016",1,1,0,27500,458,60
"877","02626","2016",6,6,0,107014.666666667,1289.33333333333,82.6666666666667
"878","02628","2016",3,3,0,118333.333333333,1299,96.6666666666667
"879","02629","2016",1,1,0,52500,665,79
"880","02631","2016",7,7,0,129526,1606.42857142857,97
"881","02632","2016",1,1,0,137000,1489,92
"882","02635","2016",3,3,0,102833.333333333,786.666666666667,153
"883","02636","2016",1,1,0,90000,1034,87
"884","02637","2016",1,1,0,315750,1148,275
"885","02638","2016",1,1,0,81000,942,86
"886","02639","2016",2,2,0,154750,1183.5,130.5
"887","02640","2016",1,1,0,60000,714,84
"888","02641","2016",1,1,0,65000,765,85
"889","02642","2016",1,1,0,80000,976,82
"890","02643","2016",7,7,0,148714.285714286,1493,99.2857142857143
"891","02644","2016",5,5,0,162600,1831.2,97.6
"892","02645","2016",1,1,0,140000,1157,121
"893","02647","2016",2,2,0,135000,683.5,200
"894","02648","2016",19,19,0,82594.7368421053,913.578947368421,97.7368421052632
"895","02649","2016",1,1,0,77000,453,170
"896","02650","2016",1,1,0,142000,947,150
"897","02651","2016",1,1,0,104400,1135,92
"898","02652","2016",1,1,0,171000,1221,140
"899","02653","2016",8,8,0,152375,1754.875,91.5
"900","02654","2016",1,1,0,27500,573,48
"901","02655","2016",2,2,0,82500,860,95.5
"902","02656","2016",3,3,0,246350,1539.33333333333,157.666666666667
"903","02657","2016",3,3,0,49966.6666666667,652.333333333333,75.6666666666667
"904","02658","2016",3,3,0,67666.6666666667,775.666666666667,88.6666666666667
"905","02659","2016",2,2,0,180000,1315,127
"906","02660","2016",2,2,0,95000,727.5,145.5
"907","02661","2016",3,3,0,107966.666666667,1191.66666666667,92.6666666666667
"908","02662","2016",5,5,0,107100,1211.8,86.8
"909","02663","2016",3,3,0,167416.666666667,1333.33333333333,125.333333333333
"910","02665","2016",4,4,0,127500,1339.75,95.75
"911","02666","2016",10,10,0,77550,882.7,84.8
"912","02668","2016",6,6,0,96166.6666666667,831.833333333333,116
"913","02670","2016",1,1,0,138250,1152,120
"914","02671","2016",1,1,0,90000,957,94
"915","02672","2016",4,4,0,164500,1182.25,140.25
"916","02673","2016",4,4,0,153945,1530.5,101.75
"917","02675","2016",4,4,0,164925,1453.5,119.25
"918","02676","2016",16,15,1,157520,1550.625,118.3125
"919","02679","2016",4,4,0,144125,1283.5,111
"920","02680","2016",29,28,1,89289.6551724138,982.724137931035,88.5862068965517
"921","02681","2016",1,1,0,45000,556,81
"922","02682","2016",2,2,0,104000,1291,83.5
"923","02683","2016",3,3,0,78916.6666666667,981.666666666667,89.3333333333333
"924","02684","2016",23,20,3,85708.6956521739,908,87.4347826086957
"925","02685","2016",3,3,0,184266.666666667,1187.33333333333,171.666666666667
"926","02686","2016",2,2,0,235000,1086,211
"927","02687","2016",3,3,0,288166.666666667,1724,164.666666666667
"928","02690","2016",1,1,0,45900,977,47
"929","02691","2016",508,421,87,92278.0354330709,1041.32283464567,87.5314960629921
"930","02693","2016",3,3,0,172000,1813,89.6666666666667
"931","02694","2016",6,6,0,93583.3333333333,948.5,101.666666666667
"932","02697","2016",3,3,0,195366.666666667,980.333333333333,224.666666666667
"933","02698","2016",1,1,0,130000,1313,99
"934","02699","2016",3,3,0,120000,953,146.666666666667
"935","02701","2016",7,7,0,114714.285714286,1439.57142857143,88.1428571428571
"936","02702","2016",6,6,0,111633.333333333,1191,92.8333333333333
"937","02703","2016",4,4,0,78500,851.75,91.5
"938","02704","2016",1,1,0,60000,1132,53
"939","02706","2016",4,4,0,154650,1275.25,120.5
"940","02708","2016",5,5,0,100300,912.8,104.2
"941","02709","2016",1,1,0,62000,608,102
"942","02710","2016",9,9,0,97111.1111111111,1056.11111111111,87.7777777777778
"943","02711","2016",4,4,0,216750,1423.75,146.5
"944","02712","2016",1,1,0,41000,1577,26
"945","02713","2016",1,1,0,45000,978,46
"946","02714","2016",1,1,0,92625,955,97
"947","02716","2016",5,5,0,123500,1294.6,97.2
"948","02717","2016",7,7,0,151191.428571429,1171.42857142857,126.285714285714
"949","02718","2016",4,4,0,108625,1318,75
"950","02719","2016",23,23,0,95280.4347826087,1158.5652173913,80.8695652173913
"951","02720","2016",17,17,0,101819.705882353,1061.35294117647,102.058823529412
"952","02721","2016",4,4,0,146875,1133,132.75
"953","02722","2016",222,125,97,128934.779279279,1584.75675675676,83.6711711711712
"954","02723","2016",2,2,0,47500,598,79.5
"955","02728","2016",1,1,0,73000,859,85
"956","02729","2016",4,4,0,180250,2077.25,96
"957","02731","2016",3,3,0,67333.3333333333,594.333333333333,106.666666666667
"958","02734","2016",2,2,0,175250,1829,98.5
"959","02736","2016",2,2,0,131000,2041,67.5
"960","02737","2016",2,2,0,90750,1247,72
"961","02738","2016",98,96,2,90706.7448979592,1053.75510204082,90.734693877551
"962","02739","2016",5,5,0,137400,1273.2,118.2
"963","02740","2016",2,2,0,125000,832,126
"964","02741","2016",2,2,0,29000,442,66
"965","02743","2016",3,3,0,76233.3333333333,843.666666666667,93.6666666666667
"966","02746","2016",5,5,0,97800,1113.6,88.4
"967","02748","2016",12,12,0,152075,1259.58333333333,125.333333333333
"968","02749","2016",3,3,0,157473.333333333,1308.33333333333,122.333333333333
"969","02750","2016",8,8,0,105000,1022.75,100.875
"970","02751","2016",4,4,0,138500,1434.5,108.25
"971","02752","2016",3,3,0,112966.666666667,869.333333333333,146.333333333333
"972","02753","2016",4,4,0,109062.5,826,117.75
"973","02754","2016",1,1,0,151000,1480,102
"974","02755","2016",4,4,0,95850,932.5,98.75
"975","02756","2016",5,5,0,115200,1251.4,96.4
"976","02757","2016",4,4,0,50875,603.75,86
"977","02758","2016",18,18,0,132841.666666667,1405.55555555556,101.944444444444
"978","02759","2016",2,2,0,100200,1052,128.5
"979","02760","2016",1,1,0,51500,572,90
"980","02761","2016",2,2,0,150000,1750.5,94
"981","02762","2016",1,1,0,90000,882,102
"982","02763","2016",2,2,0,91500,1280.5,71
"983","02764","2016",1,1,0,198000,1489,133
"984","02765","2016",2,2,0,254500,1625.5,155
"985","02766","2016",2,2,0,127750,1293,99.5
"986","02767","2016",2,2,0,253350,1844.5,133.5
"987","02768","2016",6,6,0,124333.333333333,1237,110.666666666667
"988","02769","2016",4,3,1,95950,1759.5,87.75
"989","02770","2016",10,10,0,137625,1772.9,86.6
"990","02772","2016",2,2,0,62500,755,84
"991","02775","2016",8,8,0,81000,1471.5,67.75
"992","02776","2016",8,8,0,112491.125,1008.625,107.375
"993","02777","2016",3,3,0,173333.333333333,1384.66666666667,133
"994","02778","2016",1,1,0,78000,897,87
"995","02779","2016",1,1,0,23300,388,60
"996","02780","2016",9,9,0,113066.666666667,1288.55555555556,87.2222222222222
"997","02781","2016",3,3,0,166333.333333333,1402,118
"998","02782","2016",3,3,0,117433.333333333,893,133.666666666667
"999","02783","2016",1,1,0,97000,951,102
"1000","02784","2016",1,1,0,35000,417,84
"1001","02785","2016",5,5,0,85340,1085.8,79.4
"1002","02787","2016",2,2,0,75000,711,104
"1003","02788","2016",8,8,0,124837.5,1219.125,100.5
"1004","02789","2016",18,17,1,115980.944444444,1027.83333333333,113.388888888889
"1005","02790","2016",1,1,0,80000,727,110
"1006","02791","2016",3,3,0,96666.6666666667,1345.33333333333,71
"1007","02792","2016",2,2,0,73750,1202,61.5
"1008","02794","2016",1,1,0,172810,1964,88
"1009","02795","2016",9,9,0,133037.222222222,1139.11111111111,108.555555555556
"1010","02796","2016",3,3,0,107166.666666667,1083,98
"1011","02797","2016",4,4,0,108625,1385.25,73.75
"1012","02798","2016",23,23,0,154143.47826087,1524.82608695652,96.304347826087
"1013","02799","2016",4,4,0,102000,968,123.5
"1014","02800","2016",4,4,0,112000,953.5,122.5
"1015","02801","2016",1,1,0,50000,357,140
"1016","02803","2016",1,1,0,179200,1457,123
"1017","02805","2016",29,23,6,125339.655172414,1411,88.1379310344828
"1018","02806","2016",3,3,0,128333.333333333,1350,111.333333333333
"1019","02807","2016",6,6,0,137333.333333333,1258.33333333333,113
"1020","02808","2016",5,5,0,94240,1002.4,95.8
"1021","02809","2016",2,2,0,159000,1235,131.5
"1022","02810","2016",73,52,21,141464.178082192,1774.97260273973,84.2602739726027
"1023","02812","2016",3,3,0,163530,1273,125.333333333333
"1024","02813","2016",1,1,0,170000,939,181
"1025","02815","2016",6,6,0,103066.666666667,1390.66666666667,74.8333333333333
"1026","02816","2016",3,3,0,130036.666666667,1284.33333333333,100.666666666667
"1027","02818","2016",12,11,1,134026.25,1569.5,89.5
"1028","02819","2016",1,1,0,57000,1018,56
"1029","02820","2016",10,10,0,114220,1199.4,100.5
"1030","02821","2016",4,4,0,89125,791.5,109.5
"1031","02822","2016",6,6,0,148916.666666667,1200.33333333333,123
"1032","02824","2016",6,6,0,114000,1176.66666666667,97.3333333333333
"1033","02826","2016",5,5,0,104822,945.4,109
"1034","02827","2016",3,3,0,50000,766.666666666667,68.3333333333333
"1035","02828","2016",1,1,0,85000,1197,71
"1036","02829","2016",1,1,0,38000,585,65
"1037","02830","2016",5,5,0,68900,820.8,74.2
"1038","02831","2016",3,3,0,98666.6666666667,1159.33333333333,83.6666666666667
"1039","02832","2016",1,1,0,155019,1824,85
"1040","02833","2016",5,5,0,118800,1165.6,100.4
"1041","02834","2016",1,1,0,137000,1851,74
"1042","03001","2016",42,42,0,122275.595238095,1347.85714285714,92.4047619047619
"1043","03002","2016",2,2,0,90000,781.5,113.5
"1044","03003","2016",4,4,0,41375,544.75,78
"1045","03005","2016",5,5,0,81700,963,94.6
"1046","03006","2016",15,15,0,68032.6666666667,840.866666666667,77.2
"1047","03007","2016",5,5,0,66400,713.8,82.8
"1048","03008","2016",4,4,0,54250,779.75,80.75
"1049","03009","2016",2,2,0,88200,1053.5,87
"1050","03010","2016",3,3,0,98166.6666666667,1176.66666666667,86.6666666666667
"1051","03011","2016",4,4,0,138625,1321.25,103
"1052","03012","2016",1,1,0,123500,1342,92
"1053","03013","2016",30,30,0,152380,1494.83333333333,102.533333333333
"1054","03016","2016",1,1,0,72000,867,83
"1055","03017","2016",2,2,0,75000,920.5,80
"1056","03018","2016",8,7,1,84011.25,973.125,85.75
"1057","03019","2016",12,12,0,60133.3333333333,803.083333333333,78.0833333333333
"1058","03020","2016",5,5,0,114700,1132.6,104.4
"1059","03021","2016",9,9,0,113066.666666667,1190.22222222222,105.888888888889
"1060","03022","2016",11,11,0,66921.1818181818,906.181818181818,76.8181818181818
"1061","03023","2016",123,90,33,130434.739837398,1393.91869918699,92.2276422764228
"1062","03024","2016",2,2,0,64500,834.5,76
"1063","03025","2016",14,14,0,121257.142857143,1203.42857142857,106.285714285714
"1064","03026","2016",11,11,0,113000,922.090909090909,119.181818181818
"1065","03027","2016",10,10,0,76051,878.1,89.6
"1066","03028","2016",3,3,0,83450,1063.66666666667,76.6666666666667
"1067","03029","2016",9,9,0,83782.2222222222,1038.44444444444,80.3333333333333
"1068","03030","2016",5,5,0,115350,1220.2,97.6
"1069","03031","2016",2,2,0,102425,704,132.5
"1070","03032","2016",1,1,0,75000,682,110
"1071","03033","2016",2,2,0,111775,1214,91.5
"1072","03034","2016",8,8,0,62062.5,707.75,92.75
"1073","03035","2016",1,1,0,52500,833,63
"1074","03036","2016",18,15,3,120375.555555556,1313.16666666667,97.2777777777778
"1075","03037","2016",5,5,0,135200,959.8,140.4
"1076","03038","2016",6,6,0,71166.6666666667,803.5,86.8333333333333
"1077","03039","2016",8,8,0,99081.25,975.125,103
"1078","03040","2016",10,10,0,143600,1402.4,103.4
"1079","03041","2016",4,4,0,239575,2355.5,87
"1080","03042","2016",7,7,0,92114.2857142857,1070.42857142857,83.8571428571429
"1081","03043","2016",10,10,0,88940,1025.1,86
"1082","03044","2016",18,18,0,125922.222222222,1212.83333333333,107.166666666667
"1083","03045","2016",13,13,0,111614.615384615,1028.38461538462,115.153846153846
"1084","03046","2016",11,10,1,106160,1099.45454545455,89.7272727272727
"1085","03047","2016",7,7,0,88000,1164.71428571429,69.1428571428571
"1086","03048","2016",21,21,0,52967.2380952381,740.285714285714,76.5238095238095
"1087","03049","2016",9,9,0,92722.2222222222,1105.77777777778,85
"1088","03050","2016",4,4,0,50193.75,961.25,61.75
"1089","03051","2016",5,5,0,84561,963.2,85
"1090","03052","2016",8,8,0,102210,1107.625,91.625
"1091","03053","2016",11,11,0,85623.6363636364,941.818181818182,89.4545454545455
"1092","03054","2016",1,1,0,1e+05,909,110
"1093","03055","2016",9,8,1,78777.7777777778,938,85.2222222222222
"1094","03056","2016",5,5,0,126423.8,831,172.2
"1095","03057","2016",2,2,0,64000,1260.5,48
"1096","03058","2016",3,3,0,41666.6666666667,577.666666666667,79.3333333333333
"1097","03059","2016",4,4,0,122875,1324.5,95.25
"1098","03060","2016",6,6,0,184223.166666667,1809.83333333333,104.666666666667
"1099","03061","2016",6,6,0,112691.666666667,980.333333333333,128
"1100","03062","2016",4,4,0,132562.5,1418.75,91.5
"1101","03063","2016",9,9,0,112500,1163.88888888889,93
"1102","03064","2016",2,2,0,82157,1411,67.5
"1103","03065","2016",2,2,0,86500,873.5,110
"1104","03066","2016",9,9,0,67807.7777777778,775.333333333333,89.3333333333333
"1105","03067","2016",1,1,0,80000,930,86
"1106","03068","2016",1,1,0,35000,778,45
"1107","03069","2016",3,3,0,149166.666666667,1414.33333333333,99
"1108","03071","2016",5,5,0,110360,789.6,142.8
"1109","03072","2016",4,4,0,87500,880.75,96
"1110","03073","2016",4,4,0,93200,1156.5,82.5
"1111","03074","2016",4,3,1,76000,1004,73.75
"1112","03075","2016",3,3,0,124666.666666667,1187,106
"1113","03076","2016",2,2,0,143785,1336.5,107
"1114","03077","2016",2,2,0,31500,525,60
"1115","03078","2016",5,5,0,153070.6,1100.4,133
"1116","03079","2016",5,5,0,81128,1195.4,69
"1117","03081","2016",3,3,0,70563.3333333333,745,87.6666666666667
"1118","03082","2016",57,54,3,69499.649122807,878.052631578947,78.3157894736842
"1119","03083","2016",5,5,0,85800,929.2,92.6
"1120","03084","2016",33,33,0,85835.9090909091,909.636363636364,89.9393939393939
"1121","03085","2016",3,3,0,51666.6666666667,807,67.3333333333333
"1122","03086","2016",6,6,0,75416.6666666667,877.333333333333,85.5
"1123","03087","2016",10,10,0,71500,809,88.9
"1124","03088","2016",7,7,0,119530.571428571,1511.42857142857,78.2857142857143
"1125","03089","2016",1,1,0,48700,974,50
"1126","03090","2016",2,2,0,59250,651,93
"1127","03091","2016",2,2,0,52500,958,53.5
"1128","03092","2016",7,7,0,110785.714285714,1193.28571428571,95.4285714285714
"1129","03093","2016",13,13,0,147983.461538462,1406.53846153846,104.076923076923
"1130","03094","2016",33,33,0,147188.909090909,1350.21212121212,105.484848484848
"1131","03095","2016",160,112,48,103189.75625,1195.16875,84.20625
"1132","03096","2016",2,2,0,76250,676.5,102.5
"1133","03097","2016",6,6,0,107867.666666667,1069.5,106.5
"1134","03098","2016",47,42,5,91374.4680851064,1184.06382978723,77.4893617021277
"1135","03099","2016",2,2,0,96250,667.5,130
"1136","03100","2016",12,12,0,92770.8333333333,955.416666666667,94.4166666666667
"1137","03101","2016",77,72,5,96292.4545454545,1097.02597402597,86.9350649350649
"1138","03102","2016",29,28,1,81962.4137931034,1000.86206896552,84.6206896551724
"1139","03103","2016",5,5,0,52800,547.8,98.4
"1140","03104","2016",15,15,0,73746.6666666667,807.333333333333,88.7333333333333
"1141","03105","2016",2,2,0,157258,907,172
"1142","03106","2016",15,15,0,102103.333333333,945.333333333333,111.8
"1143","03107","2016",13,13,0,81961.5384615385,961.615384615385,93.6153846153846
"1144","03108","2016",5,5,0,72660,781.2,95.4
"1145","03109","2016",8,8,0,102375,1244.75,85.375
"1146","03110","2016",9,9,0,102643.333333333,1068.88888888889,103.111111111111
"1147","03111","2016",7,7,0,80001.4285714286,975.571428571429,81.5714285714286
"1148","03112","2016",8,8,0,79500,687.375,117.375
"1149","03113","2016",2,2,0,89500,844,91.5
"1150","03114","2016",3,3,0,90166.6666666667,812,112
"1151","03115","2016",2,2,0,124500,962,136
"1152","03116","2016",2,2,0,70000,744.5,91
"1153","03117","2016",5,5,0,85330,832,90
"1154","03118","2016",63,57,6,97149.8412698413,1148.44444444444,85.6507936507936
"1155","03119","2016",2,2,0,95500,811,115
"1156","03120","2016",2,2,0,66500,711.5,94
"1157","03121","2016",6,6,0,145188.166666667,1248.5,116.333333333333
"1158","03122","2016",3,3,0,96665,1638.66666666667,70.6666666666667
"1159","03124","2016",2,2,0,109000,1589,68
"1160","03125","2016",1,1,0,150550,1673,90
"1161","03126","2016",7,6,1,108514.285714286,1134.71428571429,93.5714285714286
"1162","03127","2016",10,10,0,84190,764.5,107.3
"1163","03128","2016",16,15,1,99855.0625,922.9375,107.125
"1164","03129","2016",3,3,0,30666.6666666667,482,73.3333333333333
"1165","03130","2016",1,1,0,35000,412,85
"1166","03131","2016",10,9,1,93395,962.3,97.7
"1167","03132","2016",4,4,0,98000,1043.75,92
"1168","03133","2016",11,11,0,104644.454545455,978.545454545455,121.181818181818
"1169","03134","2016",1,1,0,178000,2697,66
"1170","03135","2016",5,5,0,70200,812.8,100.2
"1171","03136","2016",2,2,0,138500,1224.5,114
"1172","03138","2016",28,26,2,99997.5,979.821428571429,96.9642857142857
"1173","03139","2016",4,4,0,48807.25,764.5,64.75
"1174","03140","2016",9,9,0,106944.444444444,1043.88888888889,97.3333333333333
"1175","03141","2016",4,4,0,103900,1587.25,72
"1176","03142","2016",5,5,0,120910,1189.2,105.2
"1177","03143","2016",1,1,0,85000,1133,75
"1178","03144","2016",2,2,0,62030,1199,55
"1179","03145","2016",3,3,0,109953.333333333,1006.33333333333,108.666666666667
"1180","03146","2016",1,1,0,75000,728,103
"1181","03147","2016",4,4,0,67250,783.25,88.5
"1182","03148","2016",5,5,0,103170,1108.6,97.2
"1183","03149","2016",2,2,0,122250,1429,89
"1184","03150","2016",1,1,0,53500,435,123
"1185","03151","2016",1,1,0,15000,417,36
"1186","03152","2016",5,5,0,51360,659.6,80.4
"1187","03154","2016",3,3,0,263900,1219.33333333333,187.666666666667
"1188","03155","2016",31,31,0,95831.6129032258,838.838709677419,115.451612903226
"1189","03156","2016",12,12,0,136180.833333333,1344,103.833333333333
"1190","03157","2016",10,10,0,124709,1213.2,107.4
"1191","03158","2016",11,11,0,89554.5454545455,955.636363636364,90.5454545454545
"1192","03159","2016",5,5,0,78942,734.6,115
"1193","03160","2016",3,3,0,97746.6666666667,892.666666666667,102
"1194","03161","2016",10,10,0,89022,892.1,104.6
"1195","03163","2016",8,7,1,140155,1131.75,135.25
"1196","03164","2016",1,1,0,145000,1368,106
"1197","03165","2016",16,15,1,97125.625,1007.5,97.25
"1198","03166","2016",2,2,0,179290,1729,107
"1199","03167","2016",1,1,0,58000,1000,58
"1200","03168","2016",10,10,0,89645,1066.8,83.4
"1201","03169","2016",3,3,0,136116.666666667,1773,97
"1202","03170","2016",1,1,0,57715,1013,57
"1203","03171","2016",5,5,0,67300,973.6,68.6
"1204","03172","2016",3,3,0,88563,1022.33333333333,90.6666666666667
"1205","03173","2016",5,5,0,108580,979.4,115.8
"1206","03174","2016",11,11,0,113447.272727273,1227.72727272727,99.5454545454545
"1207","03175","2016",3,3,0,82666.6666666667,711.666666666667,118
"1208","03176","2016",9,8,1,126371.111111111,1108.55555555556,108.888888888889
"1209","03177","2016",3,3,0,160333.333333333,1396,118.666666666667
"1210","03178","2016",3,3,0,51366.6666666667,602.333333333333,71
"1211","03179","2016",1,1,0,120000,1263,95
"1212","03180","2016",6,6,0,97500,1139.66666666667,83
"1213","03181","2016",7,7,0,40814.2857142857,657.857142857143,62.7142857142857
"1214","03183","2016",1,1,0,174000,1192,146
"1215","03184","2016",5,5,0,102300,1036,96.8
"1216","03185","2016",365,206,159,76558.7178082192,945.797260273973,80.6958904109589
"1217","03186","2016",13,13,0,62330.7692307692,737.846153846154,82.3076923076923
"1218","03187","2016",6,6,0,84150.6666666667,951.666666666667,93
"1219","03188","2016",1,1,0,73000,658,111
"1220","03189","2016",8,8,0,72228.125,814.875,92.125
"1221","03190","2016",222,92,130,88104.3693693694,1197.37387387387,73.6351351351351
"1222","03191","2016",1,1,0,70000,824,85
"1223","03193","2016",3,3,0,106333.333333333,1061,94.3333333333333
"1224","03194","2016",2,2,0,34500,510,63
"1225","03195","2016",33,30,3,128249.787878788,1760.48484848485,93.4242424242424
"1226","03196","2016",1,1,0,105820,1058,100
"1227","03197","2016",12,12,0,102957.083333333,1116.66666666667,93.5
"1228","03198","2016",4,4,0,63500,805.25,84
"1229","03200","2016",6,5,1,304340,2342.33333333333,126
"1230","03201","2016",3,3,0,84333.3333333333,1368,72.6666666666667
"1231","03202","2016",9,9,0,65555.5555555556,880,87.2222222222222
"1232","03203","2016",2,2,0,93642.5,1161,80.5
"1233","03204","2016",4,4,0,128547.5,1475.25,83.25
"1234","03205","2016",3,3,0,143566.666666667,1108,136
"1235","03206","2016",1,1,0,35000,438,80
"1236","03207","2016",3,3,0,47753.3333333333,631.666666666667,75
"1237","03208","2016",5,5,0,67002.2,764,84.8
"1238","03209","2016",2,2,0,87629.5,1036,91.5
"1239","03210","2016",5,5,0,67715,767.4,92
"1240","03211","2016",32,32,0,135953.125,1379.625,97.8125
"1241","03212","2016",13,13,0,142230.769230769,1273.38461538462,114.923076923077
"1242","03213","2016",1,1,0,133000,930,143
"1243","03214","2016",2,2,0,68000,741.5,96.5
"1244","03215","2016",4,4,0,82587.5,819,94.25
"1245","03217","2016",3,3,0,75000,1235.33333333333,64.3333333333333
"1246","03218","2016",1,1,0,120000,1818,66
"1247","03219","2016",3,3,0,73333.3333333333,839.666666666667,87.3333333333333
"1248","03220","2016",8,8,0,111137.5,1239.625,91.375
"1249","03221","2016",7,7,0,112871.428571429,1030.57142857143,105.714285714286
"1250","03222","2016",2,2,0,104000,682,130
"1251","03223","2016",5,5,0,83300,933.2,88.6
"1252","03224","2016",7,7,0,90592.8571428571,926.857142857143,97.7142857142857
"1253","03225","2016",3,3,0,111666.666666667,1111.66666666667,98
"1254","03226","2016",2,2,0,88250,1103,80
"1255","03227","2016",4,4,0,116250,1176,92.25
"1256","03229","2016",6,6,0,101000,1149,90
"1257","03230","2016",7,7,0,120437.285714286,1267.57142857143,92.2857142857143
"1258","03231","2016",1,1,0,60500,644,94
"1259","03232","2016",5,5,0,127213.4,1504.4,89.6
"1260","03233","2016",3,3,0,115000,954.666666666667,119.666666666667
"1261","03234","2016",9,9,0,77515.5555555556,900.555555555556,90.4444444444444
"1262","03235","2016",4,3,1,134095,856.5,106
"1263","03236","2016",37,35,2,83520.2702702703,1067.16216216216,79.4054054054054
"1264","03237","2016",2,2,0,360150,3009.5,107
"1265","03238","2016",3,3,0,74333.3333333333,759.333333333333,96.3333333333333
"1266","03239","2016",2,2,0,47500,719,70
"1267","03240","2016",6,6,0,62000,757.333333333333,83.3333333333333
"1268","03241","2016",2,2,0,100750,1085.5,93.5
"1269","03242","2016",4,4,0,57500,626,94.5
"1270","03243","2016",3,3,0,74666.6666666667,1131.33333333333,60.3333333333333
"1271","03245","2016",2,2,0,90725,780,117.5
"1272","03246","2016",5,5,0,63496,684.8,86.6
"1273","03247","2016",8,8,0,97954,1079.5,95.25
"1274","03249","2016",3,3,0,137533.333333333,910.666666666667,160
"1275","03250","2016",2,2,0,62330,601.5,106.5
"1276","03251","2016",11,11,0,74213.1818181818,830.363636363636,90.5454545454545
"1277","03252","2016",10,10,0,102530,991.2,101
"1278","03253","2016",5,5,0,78675,905,86.8
"1279","03254","2016",60,51,9,98085,1108.25,94.6333333333333
"1280","03255","2016",3,3,0,81333.3333333333,1444.66666666667,58.3333333333333
"1281","03256","2016",3,3,0,197333.333333333,1336.66666666667,156
"1282","03257","2016",9,9,0,61554.4444444444,822.222222222222,74
"1283","03258","2016",13,13,0,108395.384615385,1305.23076923077,86
"1284","03259","2016",5,5,0,65500,806.4,82.4
"1285","03260","2016",2,2,0,106471.5,1199.5,90
"1286","03261","2016",2,2,0,139270,1445,87.5
"1287","03262","2016",17,17,0,124527.588235294,1218.82352941176,103.411764705882
"1288","03263","2016",2,2,0,60500,863.5,94.5
"1289","03264","2016",28,27,1,83844.8214285714,960.428571428571,86.0357142857143
"1290","03265","2016",2,2,0,46000,544.5,83.5
"1291","03266","2016",2,2,0,170000,1480,109
"1292","03267","2016",7,7,0,105236.571428571,1059.85714285714,102.428571428571
"1293","03268","2016",5,5,0,135240,1195.6,127.6
"1294","03271","2016",9,9,0,180588.888888889,1458.44444444444,119.888888888889
"1295","03272","2016",1,1,0,145050,884,164
"1296","03273","2016",4,3,1,120750,1467.75,85
"1297","03274","2016",4,4,0,78380,768,101.75
"1298","03275","2016",16,16,0,91281.25,941,89.25
"1299","03276","2016",1,1,0,52500,486,108
"1300","03277","2016",1,1,0,75000,536,140
"1301","03279","2016",5,5,0,96800,1144.4,82.8
"1302","03280","2016",1,1,0,50000,794,63
"1303","03281","2016",6,6,0,84866.6666666667,744.833333333333,110.5
"1304","03282","2016",4,4,0,150002.5,2307.75,85
"1305","03283","2016",6,6,0,68166.6666666667,858,78
"1306","03284","2016",3,3,0,39333.3333333333,823.333333333333,47.3333333333333
"1307","03285","2016",1,1,0,90000,918,98
"1308","03286","2016",6,6,0,154283.333333333,1436.16666666667,112.333333333333
"1309","03287","2016",5,5,0,95700,820.2,122
"1310","03288","2016",8,8,0,59062.5,661.875,91.25
"1311","03289","2016",5,5,0,74920,770,96.6
"1312","03290","2016",12,12,0,146350.083333333,1231.91666666667,120.416666666667
"1313","03291","2016",5,5,0,81080,884.8,101
"1314","03292","2016",11,11,0,79624.5454545455,768.545454545455,98.0909090909091
"1315","03293","2016",7,7,0,95857.1428571429,1202,82.1428571428571
"1316","03294","2016",4,4,0,96300,1070.25,91
"1317","03295","2016",2,2,0,124925,951.5,130.5
"1318","03296","2016",6,6,0,48416.6666666667,730.666666666667,64.8333333333333
"1319","03297","2016",23,23,0,96555.2173913044,973.260869565217,99.7826086956522
"1320","03298","2016",27,25,2,85241.1111111111,1059.14814814815,78.8518518518518
"1321","03299","2016",2,2,0,61500,776.5,76
"1322","03300","2016",4,4,0,56217.5,832,62.75
"1323","03301","2016",10,10,0,117117,1135.9,99.2
"1324","03302","2016",1,1,0,79000,878,90
"1325","03303","2016",3,3,0,85666.6666666667,1008.33333333333,103.666666666667
"1326","03304","2016",32,32,0,151130.46875,1479.375,104.3125
"1327","03305","2016",5,5,0,98980,953.6,101.6
"1328","03306","2016",18,18,0,136792.277777778,1333.33333333333,100.055555555556
"1329","03307","2016",3,3,0,99300,1169.33333333333,104
"1330","03308","2016",1,1,0,118000,756,156
"1331","03309","2016",6,6,0,100325,829.5,108.5
"1332","03310","2016",550,145,405,104651.685454545,1375.16909090909,74.3836363636364
"1333","03311","2016",5,5,0,55810,839.4,66.8
"1334","03312","2016",1,1,0,218160,1283,170
"1335","03313","2016",4,4,0,75250,740,96.75
"1336","03314","2016",14,14,0,144008.571428571,1295.78571428571,118.5
"1337","03315","2016",3,3,0,91000,1008.66666666667,86
"1338","03316","2016",10,10,0,88600,1093.2,82.9
"1339","03317","2016",5,5,0,71800,815.6,89.8
"1340","03319","2016",7,7,0,93500,925.142857142857,100.857142857143
"1341","03320","2016",5,5,0,104110,1180.2,80.4
"1342","03321","2016",163,138,25,112063.312883436,1315.57668711656,85.7055214723926
"1343","04001","2016",9,8,1,301744.444444444,2658.55555555556,104.666666666667
"1344","04004","2016",7,7,0,128722.857142857,1678,77.2857142857143
"1345","04005","2016",1,1,0,206300,1875,110
"1346","04006","2016",110,7,103,66138.4454545455,2151.83636363636,29.3818181818182
"1347","04008","2016",9,3,6,99744.4444444444,1393.11111111111,74.3333333333333
"1348","04013","2016",4,4,0,222250,1878.75,118.5
"1349","04017","2016",2,1,1,52500,1108.5,42.5
"1350","04018","2016",8,8,0,255187.5,2620.875,104
"1351","04019","2016",58,11,47,113843.448275862,1965.93103448276,58.5
"1352","04022","2016",3,2,1,36200,881,41.6666666666667
"1353","04023","2016",1,1,0,175000,2500,70
"1354","04024","2016",1,1,0,80000,930,86
"1355","04025","2016",11,10,1,93552.2727272727,1478.63636363636,69.2727272727273
"1356","04028","2016",2,2,0,189750,2179.5,82.5
"1357","04030","2016",2,2,0,160500,1965.5,75.5
"1358","04031","2016",1,1,0,174398,1661,105
"1359","04032","2016",1,1,0,204000,2914,70
"1360","04033","2016",8,5,3,150030.875,3789.125,70.125
"1361","04034","2016",11,11,0,167688.636363636,2219.81818181818,76.7272727272727
"1362","04035","2016",5,4,1,208546.6,2791,81
"1363","04036","2016",6,6,0,206750,1759.66666666667,120.333333333333
"1364","04039","2016",9,5,4,144085.111111111,1522.44444444444,85.1111111111111
"1365","04041","2016",1,1,0,70000,843,83
"1366","04042","2016",1,1,0,127500,2500,51
"1367","04045","2016",13,13,0,161333.076923077,2101.38461538462,81.3846153846154
"1368","04046","2016",6,6,0,103143.666666667,1346.5,75.8333333333333
"1369","04047","2016",3,3,0,204516.666666667,2044,96.3333333333333
"1370","04049","2016",43,21,22,146096.162790698,1804.51162790698,85.1860465116279
"1371","04053","2016",6,6,0,130790,1639.33333333333,84.5
"1372","04054","2016",1,1,0,110000,1692,65
"1373","04055","2016",2,2,0,123550,1543,79
"1374","04058","2016",2,2,0,140000,1506,93.5
"1375","04059","2016",1,1,0,164900,1683,98
"1376","04061","2016",11,6,5,92900,1772.18181818182,48
"1377","04062","2016",4,2,2,55460,1256.75,43
"1378","04063","2016",7,7,0,168235.714285714,1588,111.571428571429
"1379","04065","2016",7,7,0,174500.857142857,2115,82.1428571428571
"1380","04066","2016",5,5,0,305970,2620.6,117.6
"1381","04067","2016",3,3,0,115000,1493.66666666667,81.6666666666667
"1382","04068","2016",5,5,0,226200,2260,100.2
"1383","04069","2016",1,1,0,102800,1389,74
"1384","04070","2016",131,37,94,110205.580152672,1668.36641221374,65.8015267175573
"1385","04072","2016",2,2,0,232625,1380.5,173.5
"1386","04073","2016",38,6,32,84909.3421052632,2107.65789473684,38.2631578947368
"1387","04074","2016",1,0,1,36000,706,51
"1388","04075","2016",1,1,0,236000,1494,158
"1389","04076","2016",12,8,4,136500,2134.41666666667,64.5833333333333
"1390","04079","2016",9,6,3,134669.888888889,1680.22222222222,82.1111111111111
"1391","04081","2016",11,9,2,152426.363636364,2184.72727272727,63.8181818181818
"1392","04084","2016",4,4,0,144235.5,1607,84.25
"1393","04086","2016",2,2,0,260000,2686.5,92.5
"1394","04087","2016",1,1,0,74500,1146,65
"1395","04088","2016",55,31,24,179296.490909091,2075.63636363636,83.3272727272727
"1396","04090","2016",2,2,0,85000,1128.5,77
"1397","04091","2016",2,2,0,116435,1835.5,63.5
"1398","04094","2016",84,29,55,128927.035714286,2419.96428571429,52.4166666666667
"1399","04095","2016",2,2,0,82500,1468,80
"1400","04096","2016",17,8,9,140398.235294118,1922.88235294118,73.2352941176471
"1401","04097","2016",1,1,0,55000,1279,43
"1402","04099","2016",1,1,0,148300,1348,110
"1403","04101","2016",1,1,0,60000,750,80
"1404","04102","2016",2,1,1,89525,1512.5,56
"1405","04104","2016",5,5,0,161520,2087.2,81
"1406","04106","2016",1,1,0,125000,1042,120
"1407","04107","2016",1,1,0,44000,1023,43
"1408","04108","2016",10,7,3,136370,1643,79.8
"1409","04109","2016",9,9,0,257311.111111111,2396.77777777778,105.333333333333
"1410","04110","2016",4,4,0,166000,1895.75,92.75
"1411","04111","2016",8,6,2,156236.25,2124.375,76.125
"1412","04112","2016",233,88,145,157486.566523605,2047.48497854077,76.2231759656652
"1413","04116","2016",31,25,6,142375.806451613,1747.32258064516,82.0967741935484
"1414","04121","2016",5,3,2,101600,1530.4,61.8
"1415","04122","2016",2,2,0,145000,2379.5,59.5
"1416","04123","2016",7,7,0,166718.857142857,1587,103.285714285714
"1417","04124","2016",12,11,1,122045.833333333,1633.16666666667,72.9166666666667
"1418","04126","2016",42,10,32,81917.8571428571,1903.90476190476,43.6428571428571
"1419","04127","2016",1,1,0,27000,871,31
"1420","04130","2016",2,2,0,152500,2328,56
"1421","04132","2016",1,1,0,330000,2037,162
"1422","04133","2016",1,0,1,20000,385,52
"1423","04134","2016",3,3,0,116333.333333333,2874.66666666667,43
"1424","04135","2016",2,2,0,146500,1969,70
"1425","04136","2016",5,5,0,83860,1287.4,68.8
"1426","04138","2016",2,2,0,139500,3179.5,70.5
"1427","04139","2016",6,5,1,126805.5,1643.66666666667,76
"1428","04140","2016",1,1,0,43500,435,100
"1429","04141","2016",3,3,0,150300,1963.66666666667,78
"1430","04142","2016",3,2,1,288333.333333333,1876.33333333333,138.666666666667
"1431","04143","2016",64,51,13,176830.171875,2217.453125,80.171875
"1432","04144","2016",2,2,0,130000,2151.5,72.5
"1433","04145","2016",12,11,1,186755.083333333,2030.33333333333,89.25
"1434","04148","2016",5,5,0,102112,1573.2,64
"1435","04149","2016",19,15,4,173801.578947368,1970.94736842105,84.4210526315789
"1436","04151","2016",7,7,0,249988.571428571,2140,110.142857142857
"1437","04152","2016",42,40,2,283699.238095238,2619.19047619048,107.428571428571
"1438","04155","2016",1,1,0,150000,2344,64
"1439","04156","2016",3,3,0,71000,1142,60.3333333333333
"1440","04157","2016",10,9,1,205465,1864.5,102.1
"1441","04158","2016",11,11,0,122757.272727273,2175.45454545455,82.2727272727273
"1442","04160","2016",19,17,2,204865.789473684,2103.68421052632,95.4736842105263
"1443","04161","2016",4,4,0,147862.5,2267,82.5
"1444","04162","2016",4,4,0,176875,1699.5,99.5
"1445","04163","2016",3,3,0,96666.6666666667,1375.66666666667,72.6666666666667
"1446","04164","2016",1,1,0,30000,1000,30
"1447","04166","2016",10,7,3,262056,1710.8,114
"1448","04167","2016",1,1,0,145000,1933,75
"1449","04169","2016",2,2,0,390000,2958.5,122
"1450","04171","2016",1,1,0,210000,2100,100
"1451","04172","2016",3,3,0,143000,1680.33333333333,84.6666666666667
"1452","04173","2016",13,8,5,134688.461538462,1740.46153846154,81.4615384615385
"1453","04174","2016",1,1,0,170000,1604,106
"1454","04175","2016",1,1,0,275000,2068,133
"1455","04176","2016",5,1,4,129984,2426.2,55.2
"1456","04178","2016",18,16,2,199578.888888889,2315.94444444444,86.3888888888889
"1457","04179","2016",1,1,0,120000,4000,30
"1458","04181","2016",1,1,0,63000,1212,52
"1459","04182","2016",1,1,0,183298,2156,85
"1460","04186","2016",3,2,1,101666.666666667,1978.33333333333,52
"1461","04187","2016",1,1,0,94080,941,100
"1462","04188","2016",10,9,1,210275,2242.8,106.5
"1463","04189","2016",14,13,1,125336.285714286,1993.64285714286,63.8571428571429
"1464","04190","2016",1,1,0,435000,1933,225
"1465","04192","2016",15,13,2,263812,2761.6,94
"1466","04193","2016",3,3,0,158116.666666667,1569.66666666667,108
"1467","04194","2016",1,1,0,190000,1118,170
"1468","04195","2016",11,4,7,170754.545454545,2017.81818181818,81
"1469","04197","2016",34,26,8,142912,1847.97058823529,78.1470588235294
"1470","04199","2016",2,2,0,466000,6628.5,86
"1471","04200","2016",5,4,1,232900,2049.6,114.8
"1472","04201","2016",1,1,0,335000,2913,115
"1473","04202","2016",1,0,1,54000,1174,46
"1474","04203","2016",2,2,0,139750,2350.5,59
"1475","04204","2016",6,4,2,159668.333333333,1749.33333333333,90.3333333333333
"1476","04205","2016",23,18,5,108661.956521739,1534.82608695652,69.2173913043478
"1477","04206","2016",5,4,1,116150,1813.6,68.4
"1478","04207","2016",2,2,0,147675,1286.5,117
"1479","04208","2016",9,7,2,160506.666666667,1708.66666666667,93.2222222222222
"1480","04209","2016",83,44,39,130061.445783133,1682.80722891566,75.9277108433735
"1481","04210","2016",2,2,0,88500,2251,39.5
"1482","04211","2016",2,2,0,80000,1250,60
"1483","04214","2016",2,2,0,105837,1730.5,64.5
"1484","04216","2016",2,2,0,102695,1500.5,68.5
"1485","04217","2016",2,2,0,310450,1829,183.5
"1486","04218","2016",3,3,0,85833.3333333333,1401.66666666667,60
"1487","04219","2016",8,7,1,121637.5,1870,70
"1488","04220","2016",6,3,3,171100,1715,101.333333333333
"1489","04222","2016",4,3,1,103875,1093.5,84.25
"1490","04224","2016",2,2,0,65000,1807.5,38
"1491","04226","2016",96,7,89,96454.7916666667,2387.38541666667,39.2708333333333
"1492","04227","2016",3,3,0,191333.333333333,2718.66666666667,66.6666666666667
"1493","04229","2016",5,5,0,191670,1920.8,96.2
"1494","04230","2016",40,35,5,172963.5,2169.425,84
"1495","04233","2016",5,5,0,226500,2044.4,101
"1496","04234","2016",2,2,0,189000,1570.5,120.5
"1497","04237","2016",3,2,1,78333.3333333333,1534,52.3333333333333
"1498","04240","2016",3,2,1,127440.333333333,1378.33333333333,93.6666666666667
"1499","04241","2016",1,1,0,260000,2281,114
"1500","04242","2016",36,33,3,219417.111111111,2094,103.805555555556
"1501","04244","2016",14,14,0,184778.571428571,1879.28571428571,99.2142857142857
"1502","04245","2016",19,16,3,190749.105263158,2230.63157894737,84.7894736842105
"1503","05001","2016",9,1,8,121730.222222222,2295.44444444444,53.2222222222222
"1504","05003","2016",8,0,8,58403.125,1161,52
"1505","05004","2016",35,4,31,85345.3428571429,2103.45714285714,44.3142857142857
"1506","05006","2016",16,8,8,136879,1558.6875,87.125
"1507","05007","2016",7,3,4,109408.571428571,1714.28571428571,70
"1508","05008","2016",3,3,0,108881.666666667,1611.66666666667,68.3333333333333
"1509","05009","2016",2,2,0,100700,1366.5,80.5
"1510","05010","2016",7,7,0,123542.857142857,1601.57142857143,93.7142857142857
"1511","05012","2016",11,3,8,182630.818181818,3334.45454545455,55.6363636363636
"1512","05014","2016",5,5,0,127585.8,1844.6,73
"1513","05016","2016",7,7,0,109518.571428571,1415.57142857143,74
"1514","05017","2016",24,19,5,184117.875,2036.29166666667,96.625
"1515","05018","2016",2,2,0,242075,1807.5,135
"1516","05019","2016",2,2,0,133750,1036.5,129
"1517","05021","2016",2,2,0,137500,2778,63
"1518","05022","2016",2,2,0,108450,1409,73.5
"1519","05023","2016",168,42,126,150293.797619048,2142.92261904762,70.75
"1520","05024","2016",3,3,0,73666.6666666667,693,95.6666666666667
"1521","05025","2016",1,1,0,90000,1059,85
"1522","05026","2016",7,1,6,221387.857142857,2984.42857142857,92
"1523","05027","2016",5,1,4,100096.2,1819.2,51
"1524","05029","2016",8,6,2,150937.5,1683,88.5
"1525","05031","2016",1,1,0,78000,1114,70
"1526","05032","2016",2,1,1,97352,1832.5,59.5
"1527","05033","2016",2,2,0,225000,1533.5,147
"1528","05036","2016",8,8,0,183265.625,2125.625,86.5
"1529","05037","2016",1,1,0,130000,2600,50
"1530","05038","2016",1,1,0,2e+05,1481,135
"1531","05039","2016",4,3,1,120000,1692.75,76
"1532","05040","2016",33,19,14,173944.878787879,2546.18181818182,76
"1533","05044","2016",4,2,2,203100,3418,62.25
"1534","05045","2016",8,7,1,229378.75,3805.75,80.5
"1535","05046","2016",118,25,93,155691.584745763,2519.07627118644,63.8220338983051
"1536","05047","2016",2,2,0,57000,1406,34
"1537","05048","2016",1,1,0,205000,1881,109
"1538","05049","2016",2,2,0,49000,725.5,65
"1539","05050","2016",3,2,1,141141.666666667,1710.33333333333,73
"1540","05052","2016",6,5,1,138916.666666667,1583,88.1666666666667
"1541","05053","2016",7,7,0,180500,2073.71428571429,89
"1542","05055","2016",1,1,0,126000,1537,82
"1543","05056","2016",1,1,0,25000,694,36
"1544","05057","2016",1,1,0,218110,2423,90
"1545","05058","2016",3,2,1,156666.666666667,2083.66666666667,70
"1546","05059","2016",7,7,0,229633.142857143,2208.85714285714,106.857142857143
"1547","05060","2016",3,2,1,162018.333333333,1931.66666666667,87.6666666666667
"1548","05061","2016",488,128,360,162311.176229508,2107.76229508197,77.7213114754098
"1549","05062","2016",2,2,0,137500,2098,65.5
"1550","05063","2016",3,1,2,107380,1812.33333333333,124
"1551","05064","2016",3,3,0,87710,1239.66666666667,66.6666666666667
"1552","05065","2016",40,15,25,172409.25,2408.8,73.3
"1553","05068","2016",5,5,0,216000,1823.4,123.6
"1554","05070","2016",30,19,11,131567.333333333,1510.33333333333,91.8333333333333
"1555","05071","2016",5,5,0,182181,2139,87.6
"1556","05072","2016",9,2,7,79941.6666666667,1968.55555555556,38.6666666666667
"1557","05073","2016",2,2,0,255450,2180.5,115.5
"1558","05074","2016",3,1,2,159290,1921.66666666667,80
"1559","05075","2016",9,9,0,195624.444444444,2564.44444444444,90.5555555555556
"1560","05077","2016",9,3,6,151361.111111111,1814,89.6666666666667
"1561","05078","2016",1,1,0,207850,2417,86
"1562","05079","2016",40,7,33,225719,3720.525,62.325
"1563","05080","2016",3,3,0,58666.6666666667,731.666666666667,88.3333333333333
"1564","05082","2016",3,3,0,202666.666666667,1916.66666666667,106.666666666667
"1565","05084","2016",4,4,0,248375,2348.5,108.25
"1566","05085","2016",46,7,39,194296.630434783,3705.89130434783,52.195652173913
"1567","05086","2016",2,2,0,159300,1607.5,95
"1568","05087","2016",3,3,0,153833.333333333,1456.66666666667,107.333333333333
"1569","05090","2016",2,2,0,127500,1720.5,84.5
"1570","05091","2016",2,2,0,248825,2161,104.5
"1571","05092","2016",2,2,0,215200,2001.5,95
"1572","05093","2016",12,3,9,122529.333333333,2768,44.3333333333333
"1573","05095","2016",4,3,1,145250,1975,75.75
"1574","05096","2016",82,7,75,92947.0121951219,2057.87804878049,47.0243902439024
"1575","05097","2016",4,3,1,167000,2141.5,79.75
"1576","05098","2016",51,4,47,99269.1568627451,2494.21568627451,40.3137254901961
"1577","05099","2016",2,2,0,153890,1464,108
"1578","05100","2016",4,3,1,170687.5,1811.25,92.5
"1579","05101","2016",26,7,19,140893.461538462,2791.26923076923,62
"1580","05102","2016",1,1,0,50000,610,82
"1581","05103","2016",4,4,0,157680,1698.75,93.75
"1582","05104","2016",9,9,0,180361.111111111,1842.55555555556,104.888888888889
"1583","05106","2016",3,2,1,116968.333333333,1713.66666666667,95.6666666666667
"1584","05107","2016",1,1,0,269214,2958,91
"1585","05108","2016",1,1,0,327050,3270,100
"1586","05109","2016",4,4,0,250824.25,1981,128.5
"1587","05110","2016",68,6,62,68843.9558823529,1952.13235294118,33.4411764705882
"1588","05111","2016",4,3,1,295750,3138,94.75
"1589","05112","2016",2,2,0,43500,1812.5,24
"1590","05114","2016",12,3,9,97270.8333333333,2365.25,40.6666666666667
"1591","05115","2016",5,5,0,143070,2067.8,74.2
"1592","05116","2016",1,1,0,240000,3000,80
"1593","05118","2016",7,7,0,175104.285714286,2111.85714285714,82.5714285714286
"1594","05119","2016",85,3,82,99933.2823529412,2911.22352941176,33.4941176470588
"1595","05121","2016",2,1,1,105000,1428.5,62.5
"1596","05122","2016",7,5,2,190445.714285714,1975.28571428571,95.7142857142857
"1597","05123","2016",16,14,2,227802.5625,2409.3125,96.75
"1598","05124","2016",5,4,1,227950,2008.8,114
"1599","05126","2016",4,3,1,58176.25,885.25,61.5
"1600","05127","2016",7,4,3,91000,1182.42857142857,80.7142857142857
"1601","05128","2016",5,4,1,202280,2191.2,89.8
"1602","05129","2016",2,2,0,81700,1351.5,101
"1603","05132","2016",25,10,15,105743.2,1634.8,65.56
"1604","05133","2016",56,4,52,183056.714285714,3025.44642857143,57.9821428571429
"1605","05134","2016",5,4,1,99081.2,1180.4,85
"1606","05135","2016",2,1,1,130950,2289.5,58.5
"1607","05136","2016",2,2,0,77445,1698.5,57
"1608","05139","2016",112,8,104,63055.6160714286,1839.11607142857,31.5357142857143
"1609","05142","2016",9,7,2,128003.333333333,2035,70.6666666666667
"1610","05145","2016",12,6,6,74833.3333333333,1351.25,59
"1611","05146","2016",1,1,0,174955,1923,91
"1612","05147","2016",3,3,0,168169,1608,110.333333333333
"1613","05148","2016",3,2,1,122000,1929,70.3333333333333
"1614","05149","2016",19,1,18,62981.5789473684,1672.36842105263,37.3684210526316
"1615","05151","2016",7,5,2,234902.714285714,2385.57142857143,106.285714285714
"1616","05152","2016",2,1,1,75000,1311,52
"1617","05153","2016",22,1,21,58394.6363636364,1887.22727272727,31.3181818181818
"1618","05154","2016",2,2,0,110825,1490.5,66
"1619","05156","2016",5,4,1,307908,2789.6,102.6
"1620","05157","2016",1,0,1,290000,5800,50
"1621","05159","2016",4,4,0,131750,1586,97.75
"1622","05160","2016",2,2,0,76096,1612,56.5
"1623","05161","2016",83,11,72,191975.662650602,3383.39759036145,54.2409638554217
"1624","05162","2016",21,10,11,147041.047619048,1795.61904761905,84.6190476190476
"1625","05163","2016",3,2,1,221388.333333333,3452,66.6666666666667
"1626","05164","2016",16,8,8,211989,2779.5625,73.125
"1627","05165","2016",4,4,0,141155,1682.75,80.5
"1628","05166","2016",16,11,5,130000,1485.3125,82.1875
"1629","05167","2016",1,1,0,45000,750,60
"1630","05168","2016",8,8,0,223325,2328.875,94.625
"1631","05169","2016",1,1,0,50000,515,97
"1632","05170","2016",24,18,6,124312.083333333,1596.20833333333,87.875
"1633","05171","2016",1,0,1,63000,2625,24
"1634","05172","2016",3,3,0,90666.6666666667,1197.33333333333,80
"1635","05173","2016",3,2,1,105666.666666667,1483.33333333333,71.6666666666667
"1636","05174","2016",3,1,2,116233.333333333,1550.33333333333,81.3333333333333
"1637","05176","2016",2,2,0,98000,1248.5,67.5
"1638","05177","2016",103,6,97,124175.27184466,3181.34951456311,37.8834951456311
"1639","05178","2016",5,5,0,199700,2176,86
"1640","05179","2016",34,18,16,101200,1427.79411764706,71.2647058823529
"1641","05180","2016",3,2,1,164595,1887.33333333333,90.3333333333333
"1642","05181","2016",4,3,1,88990,1745.5,54
"1643","05183","2016",8,6,2,264746.125,2769.375,103.25
"1644","05184","2016",1,1,0,115000,1797,64
"1645","06001","2016",3,2,1,166966.666666667,1768.33333333333,119.333333333333
"1646","06003","2016",19,8,11,119763.157894737,1549.42105263158,71
"1647","06004","2016",1772,190,1582,268451.625846501,4225.13769751693,61.9407449209932
"1648","06005","2016",7,4,3,88105,1446.14285714286,62
"1649","06006","2016",29,21,8,398034.482758621,3850.31034482759,104.51724137931
"1650","06007","2016",38,31,7,384497.631578947,4251.15789473684,92.6315789473684
"1651","06010","2016",40,24,16,291205.4,3417.025,90.05
"1652","06011","2016",103,4,99,354807.980582524,5905.18446601942,59.1165048543689
"1653","06012","2016",257,10,247,289131.311284047,5414.27626459144,52.2529182879377
"1654","06013","2016",24,10,14,94829.1666666667,2037.83333333333,46.1666666666667
"1655","06014","2016",7,5,2,268857.142857143,3026.42857142857,87.4285714285714
"1656","06015","2016",17,13,4,222451.470588235,2621.11764705882,78.3529411764706
"1657","06016","2016",24,9,15,139983.958333333,2935.20833333333,51.1666666666667
"1658","06017","2016",4,4,0,134500,2695.25,44.75
"1659","06018","2016",91,60,31,483795.703296703,4788.58241758242,99.6813186813187
"1660","06019","2016",10,2,8,247162,3872.4,72.4
"1661","06020","2016",10,8,2,152009,1912.2,78.6
"1662","06021","2016",8,7,1,202600,2992.625,66.875
"1663","06022","2016",6,4,2,201711.666666667,2057.66666666667,93.5
"1664","06023","2016",30,18,12,117797.666666667,1907.16666666667,60.4
"1665","06024","2016",1,1,0,180000,2250,80
"1666","06025","2016",15,9,6,218100,3107.33333333333,79.5333333333333
"1667","06026","2016",29,25,4,397019.655172414,3308.8275862069,117.724137931034
"1668","06027","2016",846,108,738,233067.98108747,3920.39243498818,60.7364066193853
"1669","06028","2016",5,5,0,128700,2732.2,45.8
"1670","06029","2016",2073,92,1981,305146.826821032,4786.14857694163,61.4032802701399
"1671","06030","2016",830,76,754,226898.459036145,3333.79277108434,65.5373493975904
"1672","06031","2016",6,5,1,275666.666666667,4726.16666666667,87
"1673","06032","2016",64,4,60,374003.21875,6678.03125,57.90625
"1674","06033","2016",93,40,53,257169.23655914,3192.12903225806,81.6021505376344
"1675","06034","2016",13,10,3,346461.538461538,3339.23076923077,111.461538461538
"1676","06035","2016",10,5,5,331100,3715.9,80.5
"1677","06036","2016",11,6,5,281136.363636364,3738.18181818182,79.3636363636364
"1678","06037","2016",5,4,1,116200,2004.4,64.4
"1679","06038","2016",44,34,10,556906.477272727,4416.90909090909,120.477272727273
"1680","06039","2016",10,9,1,274200,2876.8,96.5
"1681","06041","2016",9,6,3,137466.666666667,1727.11111111111,79.4444444444444
"1682","06042","2016",9,7,2,151900,2471.33333333333,61.1111111111111
"1683","06043","2016",11,7,4,143318.181818182,3017.63636363636,59.8181818181818
"1684","06044","2016",92,63,29,475011.02173913,4366.90217391304,108.152173913043
"1685","06046","2016",23,16,7,304347.826086957,3497.82608695652,81.4347826086957
"1686","06048","2016",62,34,28,274199,3279.45161290323,87.5806451612903
"1687","06049","2016",2,2,0,75500,2255,36
"1688","06050","2016",7,4,3,169572.857142857,2101,79.4285714285714
"1689","06052","2016",1,1,0,256750,2568,100
"1690","06053","2016",1,0,1,60580,918,66
"1691","06054","2016",21,13,8,244764.285714286,3156.28571428571,80.2380952380952
"1692","06056","2016",3,3,0,105333.333333333,1655.33333333333,58.6666666666667
"1693","06057","2016",32,10,22,176756.25,2280.9375,76.4375
"1694","06058","2016",8,7,1,154375,2226.75,66.5
"1695","06059","2016",53,16,37,571490.660377358,6398.54716981132,85.5094339622642
"1696","06060","2016",14,11,3,514428.571428571,4262.14285714286,121.142857142857
"1697","06062","2016",5,3,2,87000,1725.8,46.2
"1698","06063","2016",1,1,0,35000,778,45
"1699","06064","2016",24,17,7,292523.958333333,3667.75,85.0416666666667
"1700","06065","2016",80,59,21,355339.675,3743.075,97.6
"1701","06066","2016",19,12,7,197785.526315789,3155.15789473684,63.1052631578947
"1702","06067","2016",21,9,12,275273.142857143,4308.47619047619,70.0476190476191
"1703","06068","2016",10,6,4,227225,3142.7,73.4
"1704","06069","2016",745,226,519,229208.055033557,2978.50872483221,74.1261744966443
"1705","06070","2016",17,6,11,103154.647058824,2592,46.8823529411765
"1706","06071","2016",29,6,23,133584.827586207,3207.93103448276,44.0344827586207
"1707","06072","2016",3,2,1,71100,897.666666666667,80
"1708","06073","2016",93,8,85,117319.731182796,3096.77419354839,36.6989247311828
"1709","06074","2016",20,11,9,97100,1773.55,58.8
"1710","06075","2016",39,35,4,307284.102564103,3192.23076923077,96.2307692307692
"1711","06076","2016",1,1,0,46000,1211,38
"1712","06077","2016",26,16,10,125711.538461538,2385.34615384615,59.1923076923077
"1713","06078","2016",5,4,1,154500,2179,77.4
"1714","06079","2016",633,82,551,257706.293838863,4004.26066350711,62.7914691943128
"1715","06081","2016",4,4,0,86250,2020.25,56
"1716","06082","2016",2,2,0,130750,1991,71.5
"1717","06083","2016",713,39,674,226504.082748948,4135.62973352034,56.1107994389902
"1718","06084","2016",129,72,57,410056.441860465,3842.03875968992,103.418604651163
"1719","06085","2016",276,120,156,481439.949275362,4484.11594202899,99.0833333333333
"1720","06086","2016",5,1,4,90600,992.8,76.6
"1721","06088","2016",6810,278,6532,224916.601615272,3772.13685756241,59.1415565345081
"1722","06089","2016",23,22,1,708042.565217391,5784.21739130435,129.652173913043
"1723","06090","2016",96,52,44,288527.229166667,3905.11458333333,74.8020833333333
"1724","06091","2016",26,19,7,222142.384615385,3013.03846153846,72
"1725","06092","2016",7,5,2,249110,2621.14285714286,97.7142857142857
"1726","06093","2016",2,1,1,265000,1720,135
"1727","06094","2016",48,7,41,168771.875,3103.64583333333,55.2083333333333
"1728","06095","2016",141,90,51,279062.496453901,3258.70212765957,85.5957446808511
"1729","06097","2016",1,1,0,260000,2261,115
"1730","06098","2016",3,3,0,170000,1416.66666666667,119
"1731","06099","2016",17,5,12,135715.882352941,2012.41176470588,66.3529411764706
"1732","06100","2016",1,1,0,438000,1738,252
"1733","06101","2016",1,0,1,55000,1897,29
"1734","06102","2016",2,1,1,60000,1300,47.5
"1735","06103","2016",27,9,18,107259.259259259,2003.40740740741,54.8888888888889
"1736","06104","2016",373,29,344,341521.335120643,5494.64075067024,58.8364611260054
"1737","06105","2016",86,81,5,587891.360465116,4455.01162790698,131.918604651163
"1738","06106","2016",10,8,2,119065,1515.6,74.4
"1739","06107","2016",1,1,0,68000,1015,67
"1740","06108","2016",40,30,10,455309.05,4211.5,107.45
"1741","06109","2016",6,5,1,233750,3200.16666666667,76.6666666666667
"1742","06110","2016",3,3,0,129507.666666667,2161.33333333333,65.3333333333333
"1743","06111","2016",2,1,1,58440,1670,32.5
"1744","06113","2016",18,11,7,270427.777777778,4030.77777777778,70.1111111111111
"1745","06114","2016",45,7,38,191479.444444444,3324.11111111111,58.5111111111111
"1746","06115","2016",1,1,0,159000,1988,80
"1747","06116","2016",2,2,0,95717.5,1352,89.5
"1748","06117","2016",9,7,2,222097.777777778,2617.77777777778,93.8888888888889
"1749","06118","2016",49,46,3,340150.408163265,3344.32653061224,105.102040816327
"1750","06119","2016",1,1,0,220000,1833,120
"1751","06120","2016",66,5,61,207258.621212121,4183.63636363636,46.2272727272727
"1752","06121","2016",20,2,18,816602.5,8767.55,86.3
"1753","06122","2016",26,21,5,395070.384615385,3805.07692307692,105.615384615385
"1754","06123","2016",497,54,443,238425.118712274,3962.88329979879,60.8571428571429
"1755","06125","2016",1,1,0,60000,1364,44
"1756","06126","2016",23,11,12,245938.913043478,3219.60869565217,79.4782608695652
"1757","06127","2016",49,15,34,117325.918367347,2144.28571428571,56.6530612244898
"1758","06128","2016",38,27,11,592209.578947368,4743.47368421053,122.342105263158
"1759","06129","2016",3,0,3,50666.6666666667,968.666666666667,50.6666666666667
"1760","06130","2016",55,48,7,280521.818181818,2930.14545454545,102.763636363636
"1761","06131","2016",1,1,0,21000,875,24
"1762","06132","2016",5,1,4,54080,2185.4,31.6
"1763","06133","2016",1,1,0,80000,1039,77
"1764","06134","2016",16,13,3,183560.25,1772.3125,87
"1765","06135","2016",4,3,1,129750,2074.75,56
"1766","06136","2016",51,26,25,203130.705882353,2850.13725490196,72.5294117647059
"1767","06137","2016",13,13,0,531653.846153846,3698.92307692308,150.230769230769
"1768","06138","2016",93,21,72,521014.516129032,6487.95698924731,71.1290322580645
"1769","06139","2016",2,2,0,48500,796.5,61.5
"1770","06140","2016",35,31,4,356957.857142857,3739.22857142857,98.7714285714286
"1771","06141","2016",2,2,0,293500,1999.5,145.5
"1772","06142","2016",6,2,4,115011.666666667,1842,54.8333333333333
"1773","06143","2016",5,4,1,164000,2015.8,77.6
"1774","06144","2016",2,2,0,254750,4172.5,65.5
"1775","06145","2016",2,2,0,155000,2611.5,59.5
"1776","06146","2016",1,1,0,275000,2895,95
"1777","06147","2016",31,24,7,305164.451612903,3571.96774193548,86.4838709677419
"1778","06148","2016",48,42,6,549426.25,4366.85416666667,125.729166666667
"1779","06149","2016",91,32,59,225021.120879121,2942.23076923077,79.1978021978022
"1780","06150","2016",49,21,28,452890.408163265,4945.77551020408,85.1020408163265
"1781","06151","2016",11,9,2,180181.818181818,2758.45454545455,71.7272727272727
"1782","06152","2016",169,73,96,388631.26035503,4098.03550295858,89.207100591716
"1783","06153","2016",30,12,18,128873.333333333,1871.26666666667,68.3666666666667
"1784","06154","2016",4,2,2,158000,1674.25,87.5
"1785","06155","2016",581,99,482,265729.464716007,3903.79690189329,62.8760757314974
"1786","06157","2016",303,95,208,305908.607260726,3687.27722772277,79.6171617161716
"1787","06158","2016",8,5,3,143775,1856.625,67.875
"1788","06159","2016",130,15,115,477779.084615385,6519.37692307692,68.6538461538462
"1789","06161","2016",444,91,353,306275.123873874,4866.30855855856,60.9707207207207
"1790","06162","2016",8,3,5,64500,1172.625,55.125
"1791","06163","2016",23,5,18,72581.3043478261,1320.21739130435,53.9565217391304
"1792","07001","2016",2,2,0,157500,1618.5,97.5
"1793","07002","2016",6,6,0,224308.333333333,1859.33333333333,122
"1794","07004","2016",4,3,1,152200,1560,98.5
"1795","07005","2016",9,9,0,190654.444444444,1510.77777777778,118
"1796","07006","2016",3,3,0,176666.666666667,2270,81.6666666666667
"1797","07007","2016",15,15,0,149133.333333333,1472.73333333333,100.733333333333
"1798","07008","2016",12,11,1,187300.833333333,1996.58333333333,98.1666666666667
"1799","07009","2016",18,14,4,95061.3888888889,1156.83333333333,82.3888888888889
"1800","07010","2016",162,71,91,103652.654320988,1222.50617283951,83.1604938271605
"1801","07011","2016",9,8,1,142632.333333333,1713,86.6666666666667
"1802","07012","2016",3,3,0,131533.333333333,3883.33333333333,59
"1803","07013","2016",7,7,0,130511.428571429,1369,92.2857142857143
"1804","07014","2016",5,5,0,188660,2768.8,81.8
"1805","07015","2016",3,3,0,90500,1192,75
"1806","07017","2016",6,6,0,190783.333333333,2368.66666666667,82.3333333333333
"1807","07019","2016",136,51,85,117281.110294118,1548.46323529412,77.8382352941177
"1808","07020","2016",2,2,0,114000,1471.5,79
"1809","07022","2016",12,12,0,167474.166666667,1761.08333333333,90.75
"1810","07023","2016",3,3,0,254200,1925.66666666667,131.666666666667
"1811","07024","2016",6,6,0,175854.166666667,1777.33333333333,100.5
"1812","07025","2016",2,2,0,81000,1016.5,75
"1813","07026","2016",1,1,0,50000,427,117
"1814","07027","2016",14,13,1,183578.571428571,1895.85714285714,100.071428571429
"1815","07028","2016",6,6,0,152500,1762.5,98.8333333333333
"1816","07029","2016",4,4,0,131000,1282,90
"1817","07030","2016",4,4,0,130193.75,1641,98.75
"1818","07031","2016",8,8,0,230728.5,1792.875,118
"1819","07032","2016",2,2,0,106200,1994.5,65
"1820","07033","2016",5,5,0,175200,2349.2,79.2
"1821","07035","2016",6,5,1,161406.666666667,1417.16666666667,102.666666666667
"1822","07036","2016",3,3,0,138166.666666667,1258,111
"1823","07037","2016",4,4,0,101075,2490.75,50.25
"1824","07039","2016",2,2,0,75625,1147.5,67.5
"1825","07040","2016",8,8,0,115487.5,1636.875,77.25
"1826","07041","2016",22,21,1,155434.909090909,1724.04545454545,93.8181818181818
"1827","07042","2016",82,41,41,110628.719512195,1299.10975609756,84.2317073170732
"1828","07044","2016",4,4,0,123000,1428,84.25
"1829","07045","2016",13,10,3,137382.307692308,1818.53846153846,72.7692307692308
"1830","07048","2016",9,9,0,90733.3333333333,1137.66666666667,75.8888888888889
"1831","07049","2016",1,1,0,42000,600,70
"1832","07050","2016",10,10,0,243822.8,2234,117.2
"1833","07051","2016",2,2,0,144040,1562,93
"1834","07052","2016",10,10,0,116833.2,1354.2,89.2
"1835","07053","2016",6,6,0,163370,1924,83.1666666666667
"1836","07054","2016",2,2,0,62000,750,92
"1837","07055","2016",18,17,1,247469.444444444,2252.72222222222,108.222222222222
"1838","07056","2016",7,7,0,178335.714285714,1664.57142857143,108.285714285714
"1839","07058","2016",13,13,0,158035.153846154,1615.84615384615,101.538461538462
"1840","07059","2016",1,1,0,125000,1582,79
"1841","07060","2016",5,5,0,103530,1571,71.8
"1842","07061","2016",6,6,0,102080,1706.33333333333,61.3333333333333
"1843","07063","2016",4,4,0,147250,1553.75,99.25
"1844","07064","2016",16,11,5,112201.0625,1648.5,85.0625
"1845","07065","2016",2,2,0,169500,1766.5,95
"1846","07066","2016",25,21,4,142974,1562.04,92.68
"1847","07067","2016",3,3,0,171666.666666667,1419,124
"1848","07068","2016",5,5,0,185350,1525,120
"1849","07069","2016",2,2,0,84650,1238.5,66.5
"1850","07070","2016",19,19,0,189365.052631579,1866.84210526316,102.578947368421
"1851","07071","2016",8,8,0,88887.5,1051.75,101.75
"1852","07072","2016",10,10,0,162480,1662.1,100.1
"1853","07073","2016",4,4,0,106250,1556.75,63.75
"1854","07074","2016",3,3,0,168333.333333333,1847.33333333333,89.6666666666667
"1855","07075","2016",1,1,0,50000,1429,35
"1856","07076","2016",19,19,0,144979.473684211,1482.26315789474,101.105263157895
"1857","07077","2016",2,2,0,97700,1110.5,87.5
"1858","07078","2016",31,22,9,166454.032258065,1604.12903225806,102.129032258065
"1859","07079","2016",11,10,1,105640.909090909,1429.18181818182,71.5454545454545
"1860","07080","2016",4,4,0,164500,1716.75,88
"1861","07081","2016",6,6,0,119166.666666667,2354.5,77.5
"1862","07082","2016",2,2,0,113000,1167,96
"1863","07083","2016",6,6,0,133666.666666667,1881.83333333333,75.8333333333333
"1864","07084","2016",7,7,0,122628.571428571,1229.85714285714,102
"1865","07085","2016",5,5,0,104294,1565.2,63.4
"1866","07086","2016",6,6,0,211648.333333333,1748.5,131
"1867","07087","2016",2,2,0,123500,2058,60
"1868","07088","2016",3,3,0,123030,1793.33333333333,68.6666666666667
"1869","07089","2016",11,10,1,194090.909090909,1831.81818181818,107.818181818182
"1870","07090","2016",8,7,1,126562.5,1438.25,85.625
"1871","07091","2016",1,1,0,132000,3300,40
"1872","07093","2016",2,2,0,149000,1984,62.5
"1873","07094","2016",2,2,0,113950,1165.5,108.5
"1874","07095","2016",7,7,0,109385.714285714,1257,103
"1875","07096","2016",1,1,0,50000,510,98
"1876","07097","2016",5,4,1,118802,1464.2,80.6
"1877","07098","2016",2,2,0,124000,1471.5,82.5
"1878","07099","2016",5,5,0,224336,2379.4,96.4
"1879","07100","2016",4,4,0,123500,1745.25,71.25
"1880","07101","2016",13,12,1,276846.153846154,2354.53846153846,122.692307692308
"1881","07102","2016",166,50,116,161479.734939759,1956.25903614458,82.1144578313253
"1882","07103","2016",4,3,1,89662.5,1239.75,70.25
"1883","07104","2016",4,4,0,145000,2196.5,63
"1884","07105","2016",2,2,0,68125,1368,56.5
"1885","07106","2016",4,4,0,90750,1350.75,75
"1886","07107","2016",13,12,1,140115.384615385,1710,79.3076923076923
"1887","07108","2016",1,1,0,177950,1483,120
"1888","07109","2016",10,10,0,186242,2023.4,98.6
"1889","07110","2016",26,20,6,160155.384615385,2002.88461538462,78.3461538461538
"1890","07111","2016",2,2,0,117500,1062.5,104.5
"1891","07112","2016",9,8,1,98058.8888888889,1363.22222222222,77.6666666666667
"1892","07113","2016",3,3,0,373666.666666667,2704.33333333333,129.666666666667
"1893","07115","2016",6,6,0,222250,2018.66666666667,110.166666666667
"1894","07116","2016",13,7,6,115907.692307692,1305.30769230769,85.3846153846154
"1895","07117","2016",15,15,0,178766,1841.13333333333,100.733333333333
"1896","07118","2016",3,3,0,122000,1118.66666666667,94
"1897","07119","2016",2,1,1,190000,1698,96
"1898","07120","2016",3,3,0,121366.666666667,1579.66666666667,79.3333333333333
"1899","07121","2016",3,3,0,57000,1412.66666666667,52.6666666666667
"1900","07122","2016",12,12,0,193892.5,2260.66666666667,107.666666666667
"1901","07123","2016",2,2,0,156350,1324.5,117.5
"1902","07126","2016",11,11,0,188972.727272727,1851.90909090909,111.909090909091
"1903","07127","2016",7,6,1,132428.571428571,1562.14285714286,85.7142857142857
"1904","07128","2016",3,2,1,63863,991.666666666667,66.3333333333333
"1905","07129","2016",19,13,6,122925.526315789,1405.78947368421,85.3157894736842
"1906","07130","2016",3,3,0,131666.666666667,3028.66666666667,50.3333333333333
"1907","07131","2016",7,7,0,152694.142857143,1823.57142857143,84.8571428571429
"1908","07132","2016",13,12,1,157941.538461538,1749.53846153846,97.3076923076923
"1909","07133","2016",4,4,0,179750,1687.75,107.5
"1910","07134","2016",6,6,0,132833.333333333,2005.83333333333,66.1666666666667
"1911","07137","2016",1,1,0,60000,600,100
"1912","07138","2016",11,11,0,119332.727272727,1700,75.5454545454545
"1913","07139","2016",1,1,0,105000,1750,60
"1914","07140","2016",3,3,0,77000,793.666666666667,109.666666666667
"1915","07141","2016",3,3,0,174766.666666667,1555,110.666666666667
"1916","07142","2016",2,2,0,86500,1870.5,50.5
"1917","07143","2016",5,5,0,130080,1512.4,87.4
"1918","07145","2016",7,7,0,182690,1744.85714285714,110.428571428571
"1919","07146","2016",1,1,0,261100,2374,110
"1920","07147","2016",5,5,0,212600,2175.4,99.2
"1921","07148","2016",3,3,0,192000,1484.33333333333,112.666666666667
"1922","07149","2016",4,4,0,43350,642.5,70
"1923","07150","2016",2,2,0,92500,1132,65
"1924","07151","2016",2,2,0,126000,1247,109
"1925","07152","2016",13,10,3,168290,1963.61538461538,101.153846153846
"1926","07153","2016",8,8,0,171331.25,1842.625,114.5
"1927","07154","2016",6,6,0,96000,1073.16666666667,90.5
"1928","07155","2016",5,3,2,157897.8,2195.4,82.6
"1929","07156","2016",11,10,1,101863.636363636,1460,73.0909090909091
"1930","07157","2016",8,8,0,167150,1762.25,90.5
"1931","07158","2016",1,0,1,43780,625,70
"1932","07159","2016",9,7,2,157391.111111111,1682.88888888889,91.3333333333333
"1933","07161","2016",10,9,1,134887,1749.2,77.7
"1934","07162","2016",4,4,0,182500,2001.5,93.75
"1935","07165","2016",8,8,0,92187.5,1790.25,53.125
"1936","07166","2016",2,2,0,62500,538.5,111
"1937","07167","2016",14,14,0,136821.428571429,1815.14285714286,75.3571428571429
"1938","07168","2016",9,8,1,237405.555555556,2344.77777777778,106.888888888889
"1939","07169","2016",3,3,0,168700,1953.33333333333,82
"1940","07170","2016",2,2,0,197000,3512,56
"1941","07171","2016",9,9,0,185644.444444444,2217.66666666667,91.2222222222222
"1942","07172","2016",15,15,0,179523.4,1756.73333333333,99.4666666666667
"1943","07174","2016",5,3,2,109000,1354.2,76
"1944","07176","2016",3,3,0,199333.333333333,1552,121.333333333333
"1945","07177","2016",7,6,1,167428.571428571,1498.28571428571,102.142857142857
"1946","07178","2016",3,3,0,164650,2415.33333333333,86.6666666666667
"1947","07179","2016",1,1,0,155000,1360,114
"1948","07181","2016",21,14,7,123497.047619048,1469.33333333333,83.2380952380952
"1949","07182","2016",13,13,0,149047.615384615,1615.15384615385,86.6153846153846
"1950","07183","2016",4,3,1,111125,1718.75,65.75
"1951","07184","2016",1,1,0,226025,2330,97
"1952","07185","2016",8,8,0,182632.5,1599.25,117.125
"1953","07186","2016",84,36,48,114058.904761905,1353.15476190476,83.0357142857143
"1954","07187","2016",4,4,0,128728.75,2333.5,73.25
"1955","07188","2016",12,12,0,177970.833333333,1679.58333333333,106.333333333333
"1956","07189","2016",2,2,0,115000,1476.5,77
"1957","07190","2016",4,4,0,204000,3546,56
"1958","07191","2016",14,11,3,175543,1826.92857142857,92.7142857142857
"1959","07192","2016",5,5,0,139500,2078.6,84
"1960","07193","2016",2,2,0,70000,787,87
"1961","07194","2016",6,6,0,295400,2995.16666666667,98.5
"1962","07195","2016",1,1,0,1e+05,2500,40
"1963","07196","2016",1,1,0,258965,1439,180
"1964","07197","2016",16,15,1,153406.25,1391.75,115.875
"1965","07198","2016",8,8,0,128552.5,1458.125,86.25
"1966","07199","2016",11,11,0,199071.090909091,1982.81818181818,106.727272727273
"1967","07200","2016",1,1,0,150000,1685,89
"1968","07201","2016",25,13,12,135706,1937.2,73.96
"1969","07202","2016",5,5,0,123800,2002.8,63
"1970","07203","2016",2,2,0,126050,2714,80
"1971","07204","2016",17,14,3,112329.411764706,1526.23529411765,76.2941176470588
"1972","07205","2016",9,9,0,155170,1388.66666666667,109.777777777778
"1973","07206","2016",1,1,0,75000,694,108
"1974","07207","2016",10,9,1,194267.5,1465.7,133.5
"1975","07208","2016",2,2,0,151000,998,138
"1976","07210","2016",5,4,1,114005.6,1107.6,92.8
"1977","07211","2016",5,5,0,146990,2141.4,86.4
"1978","07212","2016",2,2,0,96500,1030,107
"1979","07213","2016",2,2,0,115000,1628.5,83.5
"1980","07214","2016",2,2,0,175000,2028,85
"1981","07215","2016",1,1,0,80000,571,140
"1982","07216","2016",8,8,0,150098.75,1622.75,110.625
"1983","07217","2016",4,4,0,167750,1740.5,101.75
"1984","07218","2016",6,6,0,217211.666666667,2036.16666666667,123.166666666667
"1985","07220","2016",4,4,0,139375,1474,96
"1986","07221","2016",2,2,0,84000,1292.5,60.5
"1987","07222","2016",3,3,0,271100,2914.33333333333,101.333333333333
"1988","07224","2016",1,1,0,130000,1008,129
"1989","07225","2016",4,4,0,235100,1716.25,135.75
"1990","07226","2016",2,2,0,102500,1090.5,97.5
"1991","07227","2016",7,6,1,154185.714285714,1622.85714285714,97
"1992","07228","2016",4,3,1,98875,1293.25,76.25
"1993","07229","2016",6,6,0,209666.666666667,1800.83333333333,111.333333333333
"1994","07230","2016",5,5,0,223738,2135.8,98.8
"1995","07231","2016",13,13,0,192044.615384615,1993.46153846154,101.692307692308
"1996","07232","2016",4,4,0,88325,1219,71.75
"1997","07233","2016",4,4,0,109625,1326,91.5
"1998","07235","2016",2,2,0,112500,1010.5,115
"1999","07236","2016",16,15,1,179606.8125,1681.6875,101.125
"2000","07237","2016",8,8,0,113125,1306.625,90.125
"2001","07238","2016",3,3,0,225000,4481,74.6666666666667
"2002","07240","2016",17,13,4,197925.058823529,1763.76470588235,112.117647058824
"2003","07241","2016",3,3,0,190000,1812.33333333333,107.333333333333
"2004","07242","2016",1,1,0,75000,1875,40
"2005","07243","2016",1,1,0,133000,1956,68
"2006","07244","2016",2,2,0,87000,1235.5,72.5
"2007","07245","2016",14,14,0,155932.142857143,1487.42857142857,101.571428571429
"2008","07247","2016",5,4,1,126360,1691.4,80.6
"2009","07248","2016",6,6,0,96433.3333333333,1004.5,102.5
"2010","07249","2016",1,1,0,158000,1053,150
"2011","07250","2016",3,2,1,66800,1235.66666666667,51.3333333333333
"2012","07251","2016",2,2,0,59200,1662.5,35.5
"2013","07253","2016",3,3,0,56333.3333333333,861.666666666667,63.3333333333333
"2014","07254","2016",7,7,0,170000,1824.57142857143,92.1428571428571
"2015","07255","2016",17,15,2,148506.764705882,1628.17647058824,92
"2016","07257","2016",1,1,0,50000,625,80
"2017","07258","2016",4,4,0,123162.5,1041.25,119
"2018","07259","2016",11,8,3,125971.363636364,1467.27272727273,82.2727272727273
"2019","07260","2016",7,7,0,257371.428571429,1897.42857142857,131.428571428571
"2020","07261","2016",18,17,1,123611.111111111,1412.22222222222,91.1111111111111
"2021","07263","2016",2,2,0,166000,1914,75
"2022","07264","2016",22,22,0,194184.545454545,1968.63636363636,105.909090909091
"2023","07265","2016",8,6,2,127090.125,1324.625,98
"2024","07267","2016",2,1,1,87500,1202,73
"2025","07268","2016",10,9,1,245100,2590.9,104.3
"2026","07269","2016",7,6,1,73311.8571428571,862.571428571429,76
"2027","07270","2016",2,2,0,197500,1839,103.5
"2028","07272","2016",3,3,0,241598,2714,81.6666666666667
"2029","07273","2016",1,1,0,134000,964,139
"2030","07274","2016",5,5,0,108300,1246,82.8
"2031","07275","2016",2,2,0,82500,958,90
"2032","07276","2016",3,2,1,108333.333333333,1185.33333333333,86
"2033","07278","2016",5,3,2,118360,1427.4,87.8
"2034","07279","2016",18,18,0,181039.722222222,1711.16666666667,109.833333333333
"2035","07280","2016",14,13,1,152442.857142857,2248.64285714286,69.6428571428571
"2036","07281","2016",80,61,19,220395.9625,2177.7125,98.7375
"2037","07282","2016",2,2,0,182500,2100.5,98.5
"2038","07284","2016",6,6,0,173033.333333333,1789.66666666667,92.6666666666667
"2039","07285","2016",1,1,0,33000,943,35
"2040","07286","2016",5,5,0,110580,1527,71.6
"2041","07287","2016",1,1,0,226000,2756,82
"2042","07288","2016",7,7,0,169521.428571429,1847.28571428571,90.7142857142857
"2043","07289","2016",13,13,0,149767.076923077,1832.15384615385,87.7692307692308
"2044","07291","2016",10,9,1,132260.5,1970.8,71.6
"2045","07292","2016",5,5,0,124190,1298,90.6
"2046","07293","2016",7,7,0,202842.857142857,1746.14285714286,114.428571428571
"2047","07294","2016",4,4,0,197500,3197.75,63.5
"2048","07295","2016",10,6,4,109428,1548.3,79.9
"2049","07296","2016",9,9,0,190480.444444444,2081.77777777778,98.3333333333333
"2050","07297","2016",2,2,0,65000,829,77.5
"2051","07298","2016",6,6,0,167250,1924.33333333333,87
"2052","07299","2016",1,1,0,212900,2241,95
"2053","07300","2016",6,6,0,172333.333333333,1460.5,106.166666666667
"2054","07301","2016",6,6,0,135457,1232.5,110.833333333333
"2055","07302","2016",10,10,0,257140,2141.3,109.8
"2056","07303","2016",2,2,0,162250,2266,75.5
"2057","07304","2016",31,9,22,112147.516129032,2141.03225806452,52.741935483871
"2058","07305","2016",5,5,0,207200,2056.8,108.8
"2059","07306","2016",4,3,1,159500,3013,57
"2060","07307","2016",5,5,0,258850,2940.2,88.4
"2061","07308","2016",20,19,1,128025,1458.5,86.25
"2062","07309","2016",16,16,0,126587.5,1367.25,96.4375
"2063","07310","2016",4,4,0,184225,1737.75,104.25
"2064","07311","2016",4,4,0,115750,1409.5,84
"2065","07312","2016",3,3,0,170833.333333333,1760.66666666667,89
"2066","07313","2016",9,7,2,92922.2222222222,1183.44444444444,86.2222222222222
"2067","07314","2016",7,7,0,97192.8571428571,1261.85714285714,86.1428571428571
"2068","07315","2016",3,3,0,82333.3333333333,1548.66666666667,58.3333333333333
"2069","07316","2016",15,12,3,183900,1834.66666666667,98.8
"2070","07317","2016",9,9,0,143355.555555556,1355.88888888889,110.111111111111
"2071","07318","2016",2,2,0,243500,2448.5,102
"2072","07319","2016",75,46,29,120005.333333333,1523.02666666667,77.1866666666667
"2073","07321","2016",1,1,0,150000,1667,90
"2074","07322","2016",8,7,1,91500,1148.75,77.125
"2075","07323","2016",10,10,0,242363,2188.5,111.7
"2076","07324","2016",130,55,75,140495.215384615,1732,83.3538461538461
"2077","07325","2016",27,23,4,138871.481481481,1725.40740740741,86.5185185185185
"2078","07326","2016",3,3,0,138533.333333333,801.333333333333,168.333333333333
"2079","07327","2016",3,3,0,73000,807.333333333333,95.6666666666667
"2080","07328","2016",14,11,3,215722.5,2324.92857142857,97.7142857142857
"2081","07329","2016",7,6,1,94785.7142857143,1243.85714285714,83.4285714285714
"2082","07330","2016",28,25,3,175173.928571429,2414.75,83.3928571428571
"2083","07331","2016",32,11,21,100087.875,1479,68.78125
"2084","07332","2016",1,1,0,130000,1884,69
"2085","07333","2016",10,10,0,110655.8,1234.1,86.7
"2086","07334","2016",38,29,9,188843.342105263,2182.71052631579,86.4473684210526
"2087","07335","2016",1,1,0,207000,4140,50
"2088","07336","2016",4,4,0,197250,2748.5,100
"2089","07337","2016",17,17,0,174569.117647059,1721.11764705882,106.294117647059
"2090","07338","2016",17,16,1,137552.941176471,1387.11764705882,94.4705882352941
"2091","07339","2016",13,13,0,183218.461538462,1751,101.615384615385
"2092","07340","2016",12,12,0,183991.666666667,1774.16666666667,104.666666666667
"2093","07341","2016",29,27,2,158838.206896552,1695.48275862069,88.8620689655172
"2094","07342","2016",3,3,0,176033.333333333,1550,114
"2095","07343","2016",9,9,0,179964.444444444,2122.55555555556,84
"2096","07345","2016",8,8,0,144839.375,1903.5,81.375
"2097","07346","2016",30,25,5,132137.033333333,1414.23333333333,88.6
"2098","07347","2016",9,7,2,71128.8888888889,904.666666666667,91.2222222222222
"2099","07348","2016",8,6,2,139062.5,1803,80
"2100","07349","2016",43,21,22,119301.023255814,1407.72093023256,81.6511627906977
"2101","08001","2016",3,3,0,134333.333333333,1312,96.6666666666667
"2102","08003","2016",8,8,0,129812.5,1441.75,94
"2103","08004","2016",3,3,0,125300,1468.66666666667,86
"2104","08005","2016",1,1,0,76800,2327,33
"2105","08008","2016",8,8,0,95718.75,1041,94.625
"2106","08010","2016",1,1,0,145000,1115,130
"2107","08011","2016",1,1,0,176800,1922,92
"2108","08021","2016",1,1,0,160000,1143,140
"2109","08022","2016",2,2,0,211250,1551,136.5
"2110","08024","2016",15,15,0,155546.666666667,1669.26666666667,100.066666666667
"2111","08028","2016",13,12,1,99169.2307692308,1213.30769230769,83
"2112","08029","2016",2,2,0,192562.5,1622,105
"2113","08032","2016",3,3,0,170500,2220.66666666667,88.3333333333333
"2114","08038","2016",2,2,0,70624,992,76.5
"2115","08039","2016",5,5,0,58180,885.8,67.4
"2116","08040","2016",6,6,0,144900,1374,105.666666666667
"2117","08043","2016",16,14,2,116837.3125,1163.0625,112.3125
"2118","08044","2016",4,4,0,115975,1157,116.5
"2119","08046","2016",5,5,0,127000,1394.6,97.6
"2120","08048","2016",3,3,0,176000,1577,115
"2121","08053","2016",29,29,0,132059.620689655,1303.03448275862,102.48275862069
"2122","08058","2016",1,1,0,218000,1473,148
"2123","08060","2016",2,2,0,152823,1138,148.5
"2124","08062","2016",1,1,0,45000,484,93
"2125","08064","2016",1,1,0,180000,1440,125
"2126","08070","2016",2,2,0,128600,1164.5,109
"2127","08078","2016",4,4,0,92000,933.75,106.5
"2128","08081","2016",40,37,3,87769.5,956.025,92.625
"2129","08084","2016",2,1,1,125000,1487,83.5
"2130","08096","2016",7,7,0,169371.428571429,1425.57142857143,120
"2131","08101","2016",2,2,0,134300,1465.5,93
"2132","08105","2016",450,233,217,104827.72,1239.68222222222,86.0133333333333
"2133","08106","2016",3,3,0,193333.333333333,1069.33333333333,169.333333333333
"2134","08107","2016",10,10,0,98580,1162.7,84.4
"2135","08111","2016",6,6,0,148925.5,1447.83333333333,108.833333333333
"2136","08119","2016",5,5,0,115600,1161.6,101
"2137","08122","2016",10,10,0,104168.4,1200.9,88.4
"2138","08125","2016",5,5,0,175900,1384.2,129.4
"2139","08126","2016",1,1,0,55000,846,65
"2140","08132","2016",2,2,0,140500,1307.5,107.5
"2141","08133","2016",6,6,0,85633.3333333333,1204.16666666667,78.1666666666667
"2142","08136","2016",3,3,0,169333.333333333,1546.66666666667,111.666666666667
"2143","08137","2016",6,6,0,192416.666666667,1768.16666666667,113.166666666667
"2144","08140","2016",12,11,1,140266.666666667,1205.75,125.166666666667
"2145","08142","2016",7,5,2,120700,1361.42857142857,92.7142857142857
"2146","08148","2016",1,1,0,2e+05,1667,120
"2147","08150","2016",3,3,0,125000,1141.66666666667,121.666666666667
"2148","08158","2016",1,1,0,174000,696,250
"2149","08162","2016",2,2,0,160000,2242.5,72
"2150","08166","2016",2,2,0,46500,869,54
"2151","08169","2016",1,1,0,60000,366,164
"2152","08170","2016",1,1,0,149000,1072,139
"2153","08172","2016",2,2,0,67500,780,102
"2154","08173","2016",10,10,0,103420,1309.7,80.4
"2155","08174","2016",24,24,0,95281.5416666667,1118.79166666667,88.625
"2156","08175","2016",1,1,0,162000,1000,162
"2157","08179","2016",6,6,0,86550,677.166666666667,116.5
"2158","08180","2016",9,9,0,122644.444444444,1410.33333333333,88.1111111111111
"2159","08183","2016",8,8,0,144750,1411.625,104.375
"2160","08185","2016",22,19,3,63022.7272727273,848.727272727273,76.1818181818182
"2161","08187","2016",2,2,0,162225,1063.5,164.5
"2162","08188","2016",6,6,0,97833.3333333333,1115.66666666667,91.8333333333333
"2163","08190","2016",35,28,7,91588.2857142857,969.6,97.7142857142857
"2164","08191","2016",7,7,0,98085.7142857143,956.857142857143,103.285714285714
"2165","08194","2016",8,8,0,113812.5,1371.875,87
"2166","08195","2016",3,3,0,143433.333333333,1494,99
"2167","08199","2016",10,9,1,106480,905.2,128
"2168","08207","2016",2,2,0,86250,1319,57.5
"2169","08209","2016",5,5,0,145400,987.8,143.2
"2170","08210","2016",2,2,0,51000,473.5,110
"2171","08214","2016",6,6,0,93116.6666666667,731.5,124.5
"2172","08216","2016",2,2,0,180000,1391,126.5
"2173","08218","2016",6,6,0,88833.3333333333,845.333333333333,98.3333333333333
"2174","08222","2016",22,22,0,88829.5454545455,967.409090909091,89.0454545454545
"2175","08226","2016",2,2,0,56000,637.5,103
"2176","08229","2016",1,1,0,149700,2994,50
"2177","08230","2016",2,2,0,246150,1739,144.5
"2178","08232","2016",2,2,0,93500,956.5,97.5
"2179","08234","2016",2,2,0,77200,746.5,105.5
"2180","08235","2016",4,4,0,93250,1309.25,85.5
"2181","08239","2016",8,8,0,147950,1544.125,107.625
"2182","08246","2016",2,2,0,62500,614,102.5
"2183","08248","2016",8,8,0,112312.5,1197.375,90.625
"2184","08262","2016",4,4,0,114742.5,1160.25,110.25
"2185","08263","2016",8,8,0,124687.5,1336.125,91.625
"2186","08284","2016",4,4,0,92625,929.5,97.25
"2187","08287","2016",2,2,0,149900,1142.5,111.5
"2188","08289","2016",6,6,0,90441.6666666667,955.333333333333,87.3333333333333
"2189","08294","2016",2,2,0,101500,1201,87
"2190","08298","2016",21,21,0,122557.619047619,1408,89.6666666666667
"2191","08311","2016",20,17,3,88215,993.3,89.65
"2192","08313","2016",2,2,0,97400,969.5,99.5
"2193","08314","2016",8,8,0,201031.25,1575.125,131.125
"2194","08316","2016",5,5,0,51400,651.8,77.6
"2195","08320","2016",5,5,0,153060,1501.6,102.4
"2196","08327","2016",11,11,0,146856.363636364,1348.54545454545,113.818181818182
"2197","08328","2016",42,39,3,105150,1115.02380952381,94.5952380952381
"2198","08330","2016",6,6,0,149321.666666667,1171.66666666667,122
"2199","08331","2016",7,7,0,91321.4285714286,1109.85714285714,84.8571428571429
"2200","08339","2016",2,2,0,167750,1164,144.5
"2201","08340","2016",1,1,0,155000,1384,112
"2202","08342","2016",2,2,0,114000,1511.5,79.5
"2203","08343","2016",11,11,0,80547.2727272727,927,89.5454545454545
"2204","08346","2016",15,15,0,156180,1470.26666666667,109.6
"2205","08349","2016",3,3,0,54000,518.333333333333,109.666666666667
"2206","08350","2016",4,4,0,127500,1132.5,114.25
"2207","08353","2016",8,8,0,121750,1241.625,96.25
"2208","08361","2016",15,15,0,139333.333333333,1118.2,130.933333333333
"2209","08362","2016",63,44,19,118705.158730159,1452.71428571429,86.5396825396825
"2210","08363","2016",52,47,5,71928.8461538462,879.769230769231,80.3076923076923
"2211","08367","2016",20,20,0,99567.5,1096.85,95.05
"2212","08368","2016",1,1,0,141000,1175,120
"2213","08377","2016",1,1,0,135000,1227,110
"2214","08381","2016",7,7,0,109253.571428571,1123.42857142857,98.8571428571429
"2215","08385","2016",7,7,0,175000,1517.57142857143,117.571428571429
"2216","08386","2016",2,2,0,132500,885.5,156.5
"2217","08391","2016",5,5,0,69410,811.2,87
"2218","08396","2016",1,1,0,29000,362,80
"2219","08400","2016",4,4,0,119397.5,1165,103.5
"2220","08402","2016",9,9,0,131022.222222222,1055.44444444444,130.888888888889
"2221","08403","2016",17,17,0,130043.529411765,1378.29411764706,99.1764705882353
"2222","08404","2016",2,2,0,164500,1581.5,105.5
"2223","08408","2016",4,4,0,134825,1039.25,131.5
"2224","08409","2016",132,62,70,88477.3863636364,1039.17424242424,84.2348484848485
"2225","08413","2016",4,4,0,95617.5,946.75,98.5
"2226","08415","2016",6,6,0,91800,1093.83333333333,105.166666666667
"2227","08418","2016",1,1,0,20000,357,56
"2228","08420","2016",10,10,0,80809.8,1006.7,95.1
"2229","08427","2016",2,2,0,94000,938,103.5
"2230","08435","2016",7,7,0,161714.285714286,1508.14285714286,113.428571428571
"2231","08440","2016",2,2,0,85500,714,120.5
"2232","08445","2016",2,2,0,214500,1452.5,149.5
"2233","08448","2016",11,11,0,78909.0909090909,967.181818181818,78.4545454545455
"2234","08451","2016",6,6,0,118550,1338.66666666667,94.8333333333333
"2235","08452","2016",3,3,0,167000,1352,122.333333333333
"2236","08457","2016",17,16,1,159076.470588235,1438.64705882353,109.941176470588
"2237","08476","2016",5,5,0,156800,1470.4,133.8
"2238","08480","2016",28,28,0,125698.214285714,1407.35714285714,92.1785714285714
"2239","08481","2016",3,3,0,122666.666666667,1096.66666666667,116.666666666667
"2240","08483","2016",2,2,0,107000,1294.5,82
"2241","08486","2016",12,12,0,77416.6666666667,852.25,84.75
"2242","08487","2016",19,18,1,133605.263157895,1253.47368421053,109
"2243","08488","2016",18,18,0,156927.777777778,1347.5,113
"2244","08490","2016",22,17,5,85670.6363636364,1024.63636363636,87.3181818181818
"2245","08491","2016",30,30,0,116976.666666667,1156.4,107.6
"2246","08492","2016",3,3,0,156566.666666667,1480,109.666666666667
"2247","08497","2016",18,17,1,138916.666666667,1565.33333333333,95.2222222222222
"2248","08498","2016",3,3,0,156666.666666667,1549.33333333333,101.666666666667
"2249","09002","2016",3,3,0,164200,1670.66666666667,98
"2250","09003","2016",8,8,0,73450,842.75,91.125
"2251","09004","2016",1,1,0,76000,874,87
"2252","09008","2016",7,7,0,65142.8571428571,1002.14285714286,56.1428571428571
"2253","09009","2016",3,3,0,71666.6666666667,1778.33333333333,43.3333333333333
"2254","09011","2016",1,1,0,71000,710,100
"2255","09012","2016",1,1,0,123570,2332,53
"2256","09013","2016",1,1,0,43680,672,65
"2257","09014","2016",2,2,0,76500,814,95
"2258","09015","2016",5,5,0,132000,1233.8,102
"2259","09016","2016",1,1,0,25000,595,42
"2260","09017","2016",4,4,0,106363.5,2160.5,59.5
"2261","09019","2016",4,4,0,177500,1109,164.75
"2262","09020","2016",2,2,0,140350,1916.5,76.5
"2263","09021","2016",2,2,0,182500,1402.5,122
"2264","09022","2016",2,2,0,80000,819.5,105
"2265","09023","2016",4,4,0,173037.5,1711,106.25
"2266","09025","2016",2,2,0,83207.5,858,102
"2267","09026","2016",3,3,0,128643.333333333,1844.33333333333,83.6666666666667
"2268","09027","2016",1,1,0,52500,709,74
"2269","09029","2016",4,1,3,36895.25,846,44.75
"2270","09030","2016",10,9,1,63500,873.6,74.1
"2271","09032","2016",79,12,67,85827.4303797468,1973.21518987342,46.8481012658228
"2272","09034","2016",2,2,0,126805,1692.5,73.5
"2273","09035","2016",2,2,0,87000,1256,66
"2274","09038","2016",4,4,0,217631.5,1347.75,158.25
"2275","09039","2016",3,3,0,88666.6666666667,654.666666666667,135.333333333333
"2276","09040","2016",5,5,0,98990,1136.6,97.2
"2277","09041","2016",5,5,0,103600,1039.8,107.2
"2278","09042","2016",7,7,0,115318.571428571,1374.71428571429,101.285714285714
"2279","09043","2016",10,10,0,140785,1222.8,123
"2280","09044","2016",3,3,0,121166.666666667,1598.66666666667,76.3333333333333
"2281","09045","2016",2,2,0,49000,891.5,55
"2282","09047","2016",17,17,0,89540.2941176471,904.647058823529,110.647058823529
"2283","09049","2016",1,1,0,20000,588,34
"2284","09050","2016",6,6,0,124500,1383.5,81.5
"2285","09052","2016",1,1,0,160000,812,197
"2286","09054","2016",4,4,0,210747.5,1209.25,166.75
"2287","09055","2016",1,1,0,70000,1000,70
"2288","09056","2016",4,4,0,184455,1651.5,120
"2289","09057","2016",10,10,0,80390,1477.6,57
"2290","09058","2016",2,2,0,91375,1721.5,50
"2291","09059","2016",7,7,0,83803.5714285714,1875.57142857143,51.7142857142857
"2292","09060","2016",11,11,0,98001.0909090909,969.181818181818,103.727272727273
"2293","09061","2016",9,9,0,62211.1111111111,633.111111111111,100.111111111111
"2294","09062","2016",5,5,0,55569,1130.2,48.6
"2295","09063","2016",4,4,0,75250,777.75,94.25
"2296","09065","2016",8,8,0,105662.5,1149.5,92
"2297","09066","2016",3,3,0,129573,1445.66666666667,90
"2298","09068","2016",1,1,0,30000,1200,25
"2299","09070","2016",2,2,0,108000,1149,94
"2300","09071","2016",3,3,0,116200,1300.33333333333,86.3333333333333
"2301","09073","2016",2,2,0,46055.5,601,86
"2302","09074","2016",4,4,0,113875,842.5,138.75
"2303","09075","2016",6,6,0,86208.3333333333,1287.66666666667,74.6666666666667
"2304","09076","2016",1,1,0,159000,1606,99
"2305","09077","2016",4,4,0,83920,1027.5,97.5
"2306","09078","2016",1,1,0,66000,835,79
"2307","09079","2016",10,9,1,154524,1678.3,92.6
"2308","09080","2016",3,3,0,51000,782,72
"2309","09081","2016",2,2,0,194250,1506,129
"2310","09082","2016",8,8,0,92375,1302.625,66.375
"2311","09085","2016",2,2,0,80500,646,127
"2312","09086","2016",2,2,0,52500,894,66
"2313","09087","2016",1,1,0,162500,1826,89
"2314","09091","2016",1,1,0,205000,1464,140
"2315","09092","2016",4,4,0,102125,1288,85
"2316","09095","2016",1,1,0,130000,1074,121
"2317","09098","2016",1,1,0,149000,2865,52
"2318","09099","2016",2,2,0,218750,2044.5,111.5
"2319","09100","2016",2,2,0,45500,1058.5,44
"2320","09101","2016",3,3,0,165573.333333333,1695,99.6666666666667
"2321","09103","2016",5,5,0,163200,1215.2,129.2
"2322","09104","2016",9,8,1,164477.777777778,1526.66666666667,105.333333333333
"2323","09105","2016",13,13,0,118923.076923077,1224.76923076923,92.7692307692308
"2324","09106","2016",3,3,0,118300,1255,104
"2325","09107","2016",4,4,0,100750,914.5,114
"2326","09108","2016",2,2,0,82250,993.5,87
"2327","09110","2016",3,3,0,71633.3333333333,991.333333333333,70.6666666666667
"2328","09111","2016",4,4,0,114237.5,973.75,127.5
"2329","09113","2016",7,7,0,81085.7142857143,1072.85714285714,80.1428571428571
"2330","09114","2016",5,5,0,97152,1117.6,83.6
"2331","09115","2016",3,3,0,191833.333333333,1230.66666666667,166
"2332","09116","2016",5,5,0,110200,888.6,110.6
"2333","09117","2016",1,1,0,215000,1414,152
"2334","09118","2016",3,3,0,174750,1970.66666666667,100
"2335","09119","2016",7,7,0,64857.1428571429,984,68.7142857142857
"2336","09120","2016",2,2,0,217750,3749,76
"2337","09121","2016",5,5,0,158780,1540.6,105.6
"2338","09122","2016",111,69,42,106954.765765766,1240.68468468468,85.963963963964
"2339","09124","2016",10,10,0,135760,1404.7,100.9
"2340","09125","2016",6,6,0,97600,910.5,107.833333333333
"2341","09126","2016",2,2,0,79000,753,107
"2342","09127","2016",1,1,0,80000,1000,80
"2343","09128","2016",4,4,0,87000,941,97
"2344","09129","2016",1,1,0,189545,3268,58
"2345","09130","2016",11,11,0,89909.0909090909,1223.81818181818,73.6363636363636
"2346","09131","2016",1,1,0,153000,1594,96
"2347","09132","2016",3,3,0,117833.333333333,1341.66666666667,86.6666666666667
"2348","09136","2016",1,1,0,55000,887,62
"2349","09138","2016",3,2,1,1e+05,1454.66666666667,68.3333333333333
"2350","09140","2016",6,6,0,222199.166666667,2263,95
"2351","09142","2016",2,2,0,87925,1356,71
"2352","09143","2016",1,1,0,85000,1012,84
"2353","09145","2016",2,2,0,190000,1559,122
"2354","09147","2016",1,1,0,225000,1891,119
"2355","09148","2016",1,1,0,175000,729,240
"2356","09149","2016",5,5,0,91914,1338.6,77.4
"2357","09150","2016",9,8,1,154236.666666667,1168.55555555556,109.666666666667
"2358","09151","2016",1,1,0,120000,1690,71
"2359","09152","2016",2,2,0,52000,1293.5,41
"2360","09153","2016",1,1,0,97000,951,102
"2361","09154","2016",2,2,0,155000,2016.5,80
"2362","09156","2016",1,1,0,80000,1143,70
"2363","09157","2016",25,24,1,93140.4,989.08,95.56
"2364","09158","2016",1,1,0,185000,1164,159
"2365","09160","2016",55,50,5,81686.0909090909,875.090909090909,92.5090909090909
"2366","09161","2016",8,8,0,82781.25,1121.375,89.875
"2367","09162","2016",1,1,0,45000,608,74
"2368","09164","2016",1,1,0,150000,1744,86
"2369","09165","2016",2,2,0,87500,643,122.5
"2370","09166","2016",2,2,0,302500,1579,170.5
"2371","09167","2016",25,23,2,124054,1279.04,100.16
"2372","09170","2016",3,3,0,166666.666666667,1364.33333333333,121.333333333333
"2373","09174","2016",4,4,0,129400,1498.75,90
"2374","09176","2016",6,5,1,101633.333333333,1092.83333333333,98.5
"2375","09177","2016",3,3,0,138333.333333333,1569,95
"2376","09181","2016",12,12,0,96260.5833333333,1010.91666666667,95.75
"2377","09182","2016",14,14,0,105015,1401.85714285714,79.0714285714286
"2378","09183","2016",1,1,0,120000,845,142
"2379","09185","2016",44,43,1,129944.045454545,1296.79545454545,99.0909090909091
"2380","09186","2016",1,1,0,360000,3243,111
"2381","09187","2016",5,5,0,100500,966.8,101.8
"2382","09188","2016",17,17,0,106374.117647059,1715.76470588235,85.8823529411765
"2383","09189","2016",1,1,0,29000,527,55
"2384","09190","2016",2,2,0,55835,870,63.5
"2385","09192","2016",1,1,0,96000,970,99
"2386","09194","2016",41,35,6,146709.975609756,1572.46341463415,94.2682926829268
"2387","09197","2016",1,1,0,130000,1605,81
"2388","09198","2016",2,2,0,138000,1496.5,96
"2389","09199","2016",6,6,0,160608.333333333,1381.5,114.833333333333
"2390","09202","2016",2,2,0,149800,1317,124
"2391","09203","2016",3,3,0,115500,1256.66666666667,92
"2392","09206","2016",28,13,15,62705.7142857143,1308.25,58.7142857142857
"2393","09207","2016",13,13,0,116042.307692308,1310.69230769231,92.0769230769231
"2394","09208","2016",1,1,0,270000,1500,180
"2395","09209","2016",6,6,0,148877,1361.33333333333,105.833333333333
"2396","09210","2016",2,2,0,54500,1030.5,51.5
"2397","09211","2016",3,3,0,138166.666666667,982.333333333333,159
"2398","09213","2016",3,3,0,158333.333333333,1063,159
"2399","09214","2016",19,19,0,110769.736842105,1417.26315789474,83.6315789473684
"2400","09215","2016",4,4,0,43000,555.75,75
"2401","09217","2016",4,4,0,94540,1292.75,80.5
"2402","09218","2016",1,1,0,155700,2224,70
"2403","09219","2016",2,2,0,68500,1023,70
"2404","09220","2016",4,4,0,119875,1355.5,93
"2405","09221","2016",2,2,0,122000,1597.5,116.5
"2406","09222","2016",3,3,0,132376.666666667,1668.33333333333,97.6666666666667
"2407","09223","2016",2,2,0,87700,1366,67.5
"2408","09224","2016",10,10,0,116677.5,1163.7,97.6
"2409","09225","2016",178,118,60,98899.5280898876,1189.78651685393,83.9719101123596
"2410","09227","2016",1,1,0,105000,1193,88
"2411","09228","2016",3,3,0,142833.333333333,1315,131
"2412","09229","2016",2,2,0,121500,907.5,134.5
"2413","09230","2016",1,1,0,110000,1222,90
"2414","09231","2016",4,4,0,63125,1399,56.25
"2415","09232","2016",1,1,0,48500,404,120
"2416","09235","2016",7,6,1,100357.142857143,1109.28571428571,102.428571428571
"2417","09236","2016",4,4,0,118000,1396.25,83.25
"2418","09237","2016",1,1,0,64000,842,76
"2419","09238","2016",8,8,0,150141.25,1271.75,123.75
"2420","09239","2016",3,3,0,69010,1125.66666666667,62
"2421","09240","2016",8,8,0,160296.875,1416.125,111.375
"2422","09241","2016",6,6,0,127770,1485.5,86.3333333333333
"2423","09242","2016",1,1,0,95000,1033,92
"2424","09244","2016",9,9,0,118666.666666667,1200,92.3333333333333
"2425","09245","2016",13,13,0,143627.692307692,1519.53846153846,92.6153846153846
"2426","09246","2016",6,6,0,136333.333333333,1338.83333333333,106.166666666667
"2427","09247","2016",4,4,0,66250,1197.5,58.75
"2428","09249","2016",4,4,0,171500,1464.5,115.25
"2429","09250","2016",1,1,0,110000,1196,92
"2430","09251","2016",3,3,0,155666.666666667,1216.33333333333,133.333333333333
"2431","09252","2016",2,1,1,45000,787,54
"2432","09253","2016",5,5,0,41220.6,583.2,68.8
"2433","09254","2016",7,7,0,146497.142857143,1422.71428571429,105.428571428571
"2434","09257","2016",13,13,0,105123.461538462,1516,74.8461538461538
"2435","09258","2016",6,6,0,136333.333333333,1295.66666666667,107.666666666667
"2436","09261","2016",60,42,18,112813.083333333,1283.11666666667,91.8
"2437","09262","2016",3,2,1,198166.666666667,1176,178.333333333333
"2438","09264","2016",8,8,0,157880.875,1583.375,98.75
"2439","09265","2016",16,16,0,174720.875,1557.9375,112.0625
"2440","09266","2016",2,2,0,153067.5,1304,105
"2441","09267","2016",7,7,0,58710,1012.28571428571,62.8571428571429
"2442","09268","2016",15,14,1,122700,1201.26666666667,101.066666666667
"2443","09269","2016",1,1,0,124000,1442,86
"2444","09270","2016",3,3,0,83117,911.333333333333,80.3333333333333
"2445","09271","2016",3,3,0,125636.666666667,1085.33333333333,109.666666666667
"2446","09272","2016",8,8,0,119828.75,1370.75,95.875
"2447","09273","2016",14,14,0,127939.285714286,1430.35714285714,90.5
"2448","09274","2016",2,2,0,107000,1133.5,99
"2449","09275","2016",4,4,0,113750,1045.5,111
"2450","09276","2016",2,2,0,131900,1363.5,96
"2451","09277","2016",8,8,0,136106.25,1481,97.375
"2452","09279","2016",1,1,0,25000,833,30
"2453","09280","2016",7,7,0,98557.1428571429,1288.28571428571,94.7142857142857
"2454","09281","2016",2,2,0,141500,1259.5,112.5
"2455","09282","2016",46,45,1,144995.173913043,1602.76086956522,96.195652173913
"2456","09283","2016",5,3,2,78400,1248.2,73.8
"2457","09284","2016",6,6,0,128625,1263.16666666667,94.8333333333333
"2458","09285","2016",14,14,0,91654.3571428571,1144.35714285714,79.5
"2459","09287","2016",1,1,0,103000,1776,58
"2460","09289","2016",10,10,0,130450,1550.7,86.6
"2461","09290","2016",1,1,0,280000,3889,72
"2462","09291","2016",1,1,0,80000,1600,50
"2463","09292","2016",2,2,0,141000,1384,106.5
"2464","09293","2016",11,11,0,147987.636363636,1554.09090909091,95.0909090909091
"2465","09295","2016",8,8,0,115347.125,1200.75,92.875
"2466","09296","2016",2,2,0,104150,1433.5,73.5
"2467","09298","2016",3,3,0,146790,1926.33333333333,77.6666666666667
"2468","09299","2016",3,3,0,84000,1285.66666666667,70.6666666666667
"2469","09300","2016",1,1,0,35000,972,36
"2470","09301","2016",7,7,0,90289.2857142857,1153.85714285714,77
"2471","09303","2016",3,3,0,141500,1219,113.666666666667
"2472","09304","2016",1,1,0,250000,2381,105
"2473","09305","2016",3,3,0,142233.333333333,1213.33333333333,121.666666666667
"2474","09306","2016",21,16,5,114698,1347.52380952381,92.3333333333333
"2475","09307","2016",4,4,0,118000,1688,72.25
"2476","09308","2016",3,3,0,148350,1046,132.333333333333
"2477","09309","2016",3,3,0,133333.333333333,948,144.333333333333
"2478","09312","2016",36,36,0,164064.75,1672.63888888889,99.75
"2479","09313","2016",5,5,0,80380,765.6,105.6
"2480","09314","2016",1,1,0,50000,500,100
"2481","09315","2016",1,1,0,31000,775,40
"2482","09316","2016",1,1,0,139000,1448,96
"2483","09318","2016",1,1,0,187000,2791,67
"2484","09319","2016",2,2,0,305000,1831.5,157
"2485","09321","2016",5,4,1,97200,1156.8,77.8
"2486","09322","2016",32,23,9,74315.5625,1415.65625,54.09375
"2487","09324","2016",37,34,3,119206.621621622,1275.91891891892,92.0810810810811
"2488","09326","2016",6,6,0,66666.6666666667,842,97.5
"2489","09327","2016",1,1,0,38000,365,104
"2490","09328","2016",3,3,0,68680,1693,51.3333333333333
"2491","09329","2016",4,4,0,67625,797.25,95.25
"2492","09331","2016",9,9,0,132144.444444444,2281.88888888889,117.333333333333
"2493","09332","2016",21,21,0,150043.571428571,1319.47619047619,113.380952380952
"2494","09334","2016",9,6,3,58618.8888888889,933.222222222222,80.5555555555556
"2495","09335","2016",1,1,0,119000,700,170
"2496","09336","2016",9,9,0,122633.333333333,878.444444444444,147.444444444444
"2497","09338","2016",1,1,0,35000,380,92
"2498","09339","2016",3,3,0,182733.333333333,1561.33333333333,115
"2499","09340","2016",1,1,0,84000,1527,55
"2500","09341","2016",1,1,0,120000,851,141
"2501","09342","2016",5,5,0,122900,1103,118
"2502","10002","2016",1,1,0,170000,1000,170
"2503","10003","2016",34,34,0,99226.4705882353,1067.88235294118,94.1176470588235
"2504","10004","2016",2,2,0,84445,891,93
"2505","10006","2016",29,28,1,95099.9655172414,965.068965517241,103.137931034483
"2506","10009","2016",5,5,0,99260,986,102.2
"2507","10011","2016",1,1,0,95000,1583,60
"2508","10012","2016",2,2,0,87500,787,108.5
"2509","10013","2016",1,1,0,143000,1682,85
"2510","10014","2016",1,1,0,160000,1739,92
"2511","10015","2016",5,5,0,139900,1410,103
"2512","10017","2016",1,1,0,142500,1228,116
"2513","10018","2016",11,11,0,90780,753.272727272727,119.181818181818
"2514","10021","2016",1,1,0,65400,727,90
"2515","10024","2016",1,1,0,30000,476,63
"2516","10030","2016",7,6,1,159857.142857143,1775.85714285714,91
"2517","10031","2016",6,6,0,131650,975.666666666667,143
"2518","10032","2016",1,1,0,90000,818,110
"2519","10033","2016",31,26,5,128724.838709677,1217.25806451613,110.774193548387
"2520","10034","2016",26,19,7,92738.4615384615,1083.69230769231,87.3076923076923
"2521","10035","2016",6,6,0,95883.3333333333,1030.16666666667,88.5
"2522","10037","2016",4,4,0,124375,1279.5,94.5
"2523","10038","2016",4,4,0,114750,1219.25,92.25
"2524","10040","2016",3,3,0,85000,558,153.333333333333
"2525","10041","2016",1,1,0,35000,461,76
"2526","10042","2016",2,2,0,116750,973.5,121.5
"2527","10043","2016",1,1,0,55000,655,84
"2528","10049","2016",4,4,0,120900,1163.75,103
"2529","10050","2016",1,1,0,105000,1810,58
"2530","10051","2016",9,9,0,157422.222222222,1574.33333333333,99.4444444444444
"2531","10052","2016",1,1,0,93500,1169,80
"2532","10053","2016",3,3,0,144666.666666667,1365,107
"2533","10054","2016",2,2,0,167500,892.5,164.5
"2534","10056","2016",2,2,0,82500,756,108.5
"2535","10060","2016",29,26,3,166983.896551724,1673.44827586207,107
"2536","10061","2016",5,4,1,116800,1039.8,116.8
"2537","10062","2016",4,4,0,119750,1170.5,103
"2538","10066","2016",4,4,0,138125,1544.25,88.75
"2539","10067","2016",13,10,3,146769.230769231,1430.15384615385,102.307692307692
"2540","10074","2016",3,3,0,131333.333333333,1033.33333333333,125.666666666667
"2541","10075","2016",1,1,0,6e+05,5217,115
"2542","10077","2016",1,1,0,130000,1313,99
"2543","10078","2016",1,1,0,62333,779,80
"2544","10080","2016",3,2,1,126666.666666667,1296.66666666667,135
"2545","10081","2016",78,40,38,108387.782051282,1419.07692307692,76.3589743589744
"2546","10082","2016",1,1,0,165000,1875,88
"2547","10083","2016",4,4,0,168625,1779.25,96
"2548","10084","2016",18,18,0,176883.333333333,1371.83333333333,130.222222222222
"2549","10086","2016",1,1,0,136400,1049,130
"2550","10089","2016",3,3,0,160333.333333333,1272.33333333333,128
"2551","10092","2016",2,2,0,149500,1391,106
"2552","10093","2016",1,1,0,151800,1332,114
"2553","10096","2016",9,9,0,112850,1114.77777777778,124.444444444444
"2554","10098","2016",5,5,0,91600,938.4,104.4
"2555","10099","2016",6,6,0,127583.333333333,852.5,149.833333333333
"2556","10100","2016",10,10,0,136010,1327.3,109.8
"2557","10101","2016",1,1,0,145000,1318,110
"2558","10102","2016",1,1,0,4e+05,2000,200
"2559","10104","2016",5,5,0,237920,1539.8,153.4
"2560","10105","2016",1,1,0,139500,481,290
"2561","10106","2016",1,1,0,101000,2020,50
"2562","10107","2016",1,1,0,66000,660,100
"2563","10108","2016",1,1,0,60000,857,70
"2564","10110","2016",9,9,0,187506.111111111,1734,110
"2565","10112","2016",1,1,0,252000,840,300
"2566","10113","2016",1,1,0,89000,1309,68
"2567","10114","2016",4,4,0,134000,1479,96.5
"2568","10115","2016",21,20,1,192027.714285714,1775.14285714286,108
"2569","10116","2016",1,1,0,164600,791,208
"2570","10117","2016",2,2,0,147500,1209.5,122
"2571","10120","2016",1,1,0,23000,390,59
"2572","10121","2016",1,1,0,125000,735,170
"2573","10122","2016",4,4,0,76000,905.5,83.5
"2574","10124","2016",1,1,0,169440,1554,109
"2575","10125","2016",2,2,0,123000,1026.5,126.5
"2576","10127","2016",1,1,0,163900,1205,136
"2577","10129","2016",1,1,0,1e+05,1163,86
"2578","10130","2016",2,2,0,126000,1344,91
"2579","10131","2016",3,3,0,136333.333333333,1153.33333333333,136.333333333333
"2580","10132","2016",1,1,0,110000,1964,56
"2581","10133","2016",1,1,0,120000,649,185
"2582","10139","2016",1,1,0,85000,773,110
"2583","10140","2016",6,6,0,82166.6666666667,924.666666666667,91.1666666666667
"2584","10141","2016",6,5,1,85766.6666666667,1014.16666666667,77.3333333333333
"2585","10142","2016",30,29,1,128570,1233.36666666667,107.366666666667
"2586","10144","2016",1,1,0,175000,1054,166
"2587","10145","2016",1,1,0,35200,587,60
"2588","10146","2016",1,1,0,97000,1516,64
"2589","10147","2016",1,1,0,138000,1221,113
"2590","10148","2016",5,5,0,115600,1413.8,81.4
"2591","10149","2016",5,5,0,161040,1593.2,102.2
"2592","10150","2016",5,5,0,160600,1308.6,122.8
"2593","10151","2016",7,7,0,140674.285714286,1351.57142857143,107.857142857143
"2594","10156","2016",5,5,0,108590,1267.2,89.4
"2595","10157","2016",1,1,0,97500,1300,75
"2596","10158","2016",9,9,0,140557.777777778,1357.88888888889,103.222222222222
"2597","10164","2016",4,4,0,139000,1242.75,111.5
"2598","10165","2016",4,4,0,113600,1230.75,97.5
"2599","10166","2016",5,5,0,122400,1008.6,133
"2600","10168","2016",2,2,0,81500,697.5,119.5
"2601","10170","2016",3,3,0,102000,1426.33333333333,73.3333333333333
"2602","10171","2016",3,3,0,121950,1182.33333333333,105
"2603","10172","2016",2,2,0,119500,1025,132.5
"2604","10173","2016",1,1,0,160000,1684,95
"2605","10174","2016",3,3,0,132870,1280.66666666667,109.666666666667
"2606","10177","2016",1,1,0,175000,1591,110
"2607","10178","2016",2,2,0,100500,818.5,124.5
"2608","10179","2016",4,4,0,89500,792.5,109
"2609","10180","2016",1,1,0,50000,704,71
"2610","10181","2016",3,3,0,94666.6666666667,1194.66666666667,80.3333333333333
"2611","10184","2016",1,1,0,105000,1250,84
"2612","10185","2016",1,1,0,25000,521,48
"2613","10186","2016",5,4,1,184310,1540.8,129.4
"2614","10187","2016",1,1,0,175000,670,261
"2615","10190","2016",3,3,0,123163.333333333,1258,95
"2616","10191","2016",6,6,0,203241.5,1677,129
"2617","10194","2016",1,1,0,45000,450,100
"2618","10196","2016",3,2,1,105333.333333333,2121,85.3333333333333
"2619","10197","2016",1,1,0,123000,1382,89
"2620","10198","2016",1,1,0,190000,1357,140
"2621","10199","2016",4,4,0,108250,895.75,140.75
"2622","10200","2016",3,3,0,85666.6666666667,1083.66666666667,74
"2623","10202","2016",1,1,0,75000,1271,59
"2624","10204","2016",1,1,0,138000,1568,88
"2625","10207","2016",1,1,0,220000,1279,172
"2626","10208","2016",7,7,0,107428.571428571,1099,104.714285714286
"2627","10209","2016",16,14,2,142117.5,1468.9375,99.1875
"2628","10210","2016",3,3,0,196433.333333333,1849.66666666667,108
"2629","10211","2016",8,8,0,178398.75,1632.5,109.5
"2630","10213","2016",2,2,0,101250,943,111.5
"2631","10215","2016",2,2,0,108000,1206,90.5
"2632","10216","2016",6,6,0,136000,1401,100.666666666667
"2633","10218","2016",1,1,0,158000,1060,149
"2634","10220","2016",19,19,0,121001.052631579,1357.31578947368,90.7368421052632
"2635","10222","2016",10,10,0,92300,1124.8,83.2
"2636","10223","2016",3,3,0,112000,1166,100.333333333333
"2637","10224","2016",17,17,0,120160.176470588,1184.47058823529,95.7647058823529
"2638","10225","2016",6,6,0,93166.6666666667,1179.83333333333,80.1666666666667
"2639","10227","2016",3,3,0,101666.666666667,1142.33333333333,87
"2640","10230","2016",9,9,0,151115.555555556,1466.88888888889,109.111111111111
"2641","10233","2016",9,9,0,105388.888888889,1159.22222222222,93
"2642","10234","2016",2,2,0,166000,1738.5,95.5
"2643","10236","2016",1,1,0,118000,486,243
"2644","10237","2016",4,4,0,106375,1082.75,102.5
"2645","10238","2016",7,6,1,109228.571428571,2244.57142857143,62
"2646","10239","2016",3,3,0,165000,1783,95
"2647","10240","2016",8,8,0,161462.5,1370.75,128.625
"2648","10243","2016",1,1,0,241400,2099,115
"2649","10245","2016",5,5,0,180540,1668.8,109
"2650","10246","2016",1,1,0,184300,1013,182
"2651","10248","2016",2,2,0,147500,1331.5,109
"2652","10249","2016",2,2,0,121500,1284.5,95.5
"2653","10250","2016",1,1,0,180000,1125,160
"2654","10251","2016",2,2,0,77500,1133.5,82.5
"2655","10254","2016",8,8,0,137340,1346.5,101.375
"2656","10255","2016",2,2,0,137500,1808,77.5
"2657","10256","2016",2,2,0,188700,1604,118
"2658","10257","2016",1,1,0,190000,1173,162
"2659","10258","2016",3,3,0,79833.3333333333,802,99.6666666666667
"2660","10259","2016",3,2,1,96900,988.333333333333,93.6666666666667
"2661","10260","2016",5,5,0,142300,1737.8,86.2
"2662","10261","2016",5,5,0,62200,796.4,89.4
"2663","10263","2016",11,11,0,107570.454545455,1013.18181818182,111.272727272727
"2664","10265","2016",29,29,0,147665.517241379,1663.10344827586,89.6551724137931
"2665","10266","2016",2,2,0,120000,1149,101
"2666","10267","2016",3,3,0,99666.6666666667,773,125
"2667","10268","2016",51,45,6,142469.411764706,1598.78431372549,92.3137254901961
"2668","10269","2016",3,3,0,187666.666666667,1218.33333333333,147
"2669","10270","2016",1,1,0,38500,611,63
"2670","10271","2016",8,8,0,111601.25,1309.625,84.875
"2671","10274","2016",3,3,0,114333.333333333,1092.33333333333,106
"2672","10275","2016",7,7,0,151142.857142857,1315,112.142857142857
"2673","10276","2016",4,4,0,116625,1086,108.5
"2674","10278","2016",2,2,0,132500,1052,127
"2675","10280","2016",10,9,1,116237,1273.9,95.1
"2676","10281","2016",1,1,0,175000,1944,90
"2677","10282","2016",12,12,0,165840.833333333,1608.66666666667,105.583333333333
"2678","10284","2016",2,2,0,95500,994,105
"2679","10287","2016",6,6,0,132000,1212,97.5
"2680","10290","2016",6,6,0,81250,938.833333333333,84.1666666666667
"2681","10293","2016",2,2,0,80500,818.5,108
"2682","10296","2016",1,1,0,66000,776,85
"2683","10297","2016",44,33,11,152247.727272727,1566.36363636364,99.9545454545455
"2684","10299","2016",6,6,0,76516.6666666667,912.333333333333,87.3333333333333
"2685","10300","2016",4,4,0,133625,1210.5,110.5
"2686","10301","2016",4,4,0,82825,868.25,103.75
"2687","10306","2016",5,5,0,89580,1084.6,84.4
"2688","10307","2016",1,1,0,227850,1280,178
"2689","10308","2016",3,3,0,103333.333333333,1376,73.6666666666667
"2690","10309","2016",2,2,0,99250,963,105.5
"2691","10312","2016",1,1,0,149000,1064,140
"2692","10314","2016",2,2,0,99900,618.5,160.5
"2693","10316","2016",2,2,0,43700,582,84.5
"2694","10317","2016",7,7,0,91385.7142857143,1014.28571428571,93.2857142857143
"2695","10318","2016",2,2,0,156400,1365,121.5
"2696","10319","2016",4,4,0,64125,755.5,89.25
"2697","10320","2016",1,1,0,181000,1708,106
"2698","10321","2016",34,34,0,189963.5,1732.70588235294,109.558823529412
"2699","10323","2016",143,129,14,91005.1398601399,1141.1958041958,81.972027972028
"2700","10324","2016",1,1,0,231550,1631,142
"2701","10325","2016",37,30,7,193878.918918919,1730.45945945946,112.351351351351
"2702","10329","2016",5,4,1,174600,1862.4,101.4
"2703","10331","2016",5,5,0,121556,1432,83.8
"2704","10332","2016",2,2,0,299150,1714,174
"2705","10333","2016",181,83,98,120270.773480663,1455.81767955801,80.7845303867403
"2706","10335","2016",1,1,0,82500,825,100
"2707","10339","2016",1,1,0,1e+05,575,174
"2708","10340","2016",19,19,0,180765.578947368,1732.26315789474,103.578947368421
"2709","10341","2016",5,5,0,127300,1547.4,103.6
"2710","10342","2016",5,5,0,147030,1141.2,122
"2711","10343","2016",83,61,22,142706.506024096,1517.42168674699,94.6746987951807
"2712","10344","2016",11,11,0,203746.818181818,1625.63636363636,131.636363636364
"2713","10346","2016",2,2,0,70000,1147,60
"2714","10347","2016",3,3,0,115666.666666667,1439.33333333333,83.6666666666667
"2715","10348","2016",1,1,0,82000,1079,76
"2716","10349","2016",28,26,2,164648.428571429,1625.42857142857,106.035714285714
"2717","10350","2016",6,6,0,93333.3333333333,902.5,97
"2718","10351","2016",4,4,0,86750,902.75,96.75
"2719","10352","2016",6,6,0,176833.333333333,1869.33333333333,105.166666666667
"2720","10353","2016",12,12,0,139850,1595.08333333333,88.1666666666667
"2721","10354","2016",2,2,0,172000,888,189.5
"2722","10355","2016",3,3,0,106666.666666667,1210.66666666667,90
"2723","10356","2016",2,2,0,153500,1323,118.5
"2724","10357","2016",38,35,3,157229.210526316,1663.18421052632,98.7368421052632
"2725","10359","2016",3,3,0,50333.3333333333,795.333333333333,57.6666666666667
"2726","10360","2016",7,7,0,161857.142857143,1469,107.714285714286
"2727","10362","2016",155,77,78,123533.219354839,1612.62580645161,76.4709677419355
"2728","10363","2016",7,7,0,158557.142857143,1523.28571428571,113.285714285714
"2729","10365","2016",2,2,0,102500,1005.5,104
"2730","10368","2016",9,9,0,150833.333333333,1497.44444444444,100.444444444444
"2731","10371","2016",2,2,0,101250,1313.5,85.5
"2732","10373","2016",7,7,0,145142.857142857,1475.85714285714,98.4285714285714
"2733","10375","2016",5,5,0,200050,1615.8,128.2
"2734","10376","2016",1,1,0,95000,720,132
"2735","10379","2016",4,4,0,111721.25,1168.5,92
"2736","10380","2016",1,1,0,83500,1606,52
"2737","10381","2016",8,8,0,174175,1443.25,123.875
"2738","10387","2016",973,244,729,97518.5272353546,1420.52209660843,70.1593011305242
"2739","10391","2016",3,3,0,150333.333333333,1378,113.666666666667
"2740","10392","2016",4,4,0,132500,1308.75,100.5
"2741","10394","2016",1,1,0,87000,870,100
"2742","10395","2016",4,4,0,109500,1036.25,110.5
"2743","10396","2016",9,9,0,142564.444444444,1319.11111111111,116.666666666667
"2744","10400","2016",3,3,0,133061.666666667,953.666666666667,137.333333333333
"2745","10401","2016",6,6,0,125500,1268.16666666667,106.333333333333
"2746","10402","2016",4,4,0,174625,1735.5,101
"2747","10404","2016",4,4,0,118500,826,134.5
"2748","10406","2016",17,15,2,164008.176470588,1778.35294117647,90.8235294117647
"2749","10409","2016",7,7,0,161328.571428571,1760.42857142857,96.1428571428571
"2750","10411","2016",1,1,0,85000,944,90
"2751","10412","2016",2,2,0,171000,1566,102.5
"2752","10416","2016",2,2,0,135000,1786,75.5
"2753","10418","2016",1,1,0,103500,1150,90
"2754","10423","2016",6,6,0,121425,1398.16666666667,85
"2755","10425","2016",2,2,0,148250,1281.5,115
"2756","10428","2016",1,1,0,145000,1051,138
"2757","10430","2016",1,1,0,111244,556,200
"2758","10431","2016",1,1,0,35000,500,70
"2759","10433","2016",1,1,0,35000,897,39
"2760","10434","2016",1,1,0,176000,2047,86
"2761","10435","2016",1,1,0,1e+05,676,148
"2762","10436","2016",1,1,0,168000,1680,100
"2763","10437","2016",2,2,0,133500,2364,57
"2764","10440","2016",3,3,0,70500,689.666666666667,90.3333333333333
"2765","10441","2016",4,4,0,108775,976.75,108
"2766","10442","2016",6,6,0,156306.666666667,1348.33333333333,119
"2767","10443","2016",1,1,0,45000,536,84
"2768","10444","2016",6,6,0,92000,811.333333333333,116.333333333333
"2769","11001","2016",7,7,0,95257.1428571429,855.571428571429,112.142857142857
"2770","11002","2016",3,3,0,190000,1563.66666666667,126.666666666667
"2771","11003","2016",3,3,0,72666.6666666667,978.333333333333,74.3333333333333
"2772","11004","2016",3,3,0,192296.666666667,1839.33333333333,94.3333333333333
"2773","11005","2016",10,10,0,151164,1470.4,104
"2774","11006","2016",3,3,0,195000,1733.66666666667,112.333333333333
"2775","11007","2016",1,1,0,195000,1140,171
"2776","11008","2016",9,8,1,229666.666666667,1656.55555555556,119.333333333333
"2777","11009","2016",10,10,0,109952.5,1163.6,93.7
"2778","11010","2016",5,5,0,122600,1615,102
"2779","11011","2016",6,6,0,183500,1545.5,108.666666666667
"2780","11012","2016",30,28,2,157999,1751.26666666667,89.1333333333333
"2781","11013","2016",3,3,0,122400,1562,80
"2782","11014","2016",19,19,0,187864.736842105,1893.89473684211,100.894736842105
"2783","11015","2016",4,4,0,124906.25,1375.5,91.25
"2784","11016","2016",1,1,0,72500,1036,70
"2785","11018","2016",14,14,0,109664.285714286,1384,80.4285714285714
"2786","11020","2016",1,1,0,97000,1066,91
"2787","11021","2016",10,10,0,85529,1155.5,79.8
"2788","11022","2016",22,21,1,120545.454545455,1141.77272727273,107.954545454545
"2789","11023","2016",7,7,0,132428.571428571,1295.28571428571,99.1428571428571
"2790","11024","2016",11,11,0,210982.272727273,2070.18181818182,106.454545454545
"2791","11025","2016",3,3,0,71500,930,66.3333333333333
"2792","11026","2016",1,1,0,93500,1612,58
"2793","11027","2016",7,6,1,99142.8571428571,1119.71428571429,89.4285714285714
"2794","11028","2016",6,6,0,189463.333333333,1504.83333333333,117.166666666667
"2795","11030","2016",1,1,0,3e+05,1596,188
"2796","11031","2016",1,1,0,42000,442,95
"2797","11032","2016",3,3,0,161566.666666667,1167,144.333333333333
"2798","11033","2016",9,8,1,95766.6666666667,1017.44444444444,91.2222222222222
"2799","11034","2016",7,7,0,115428.571428571,1010.14285714286,114
"2800","11035","2016",6,6,0,140722.5,1513.33333333333,105.833333333333
"2801","11036","2016",2,2,0,64250,1313,47.5
"2802","11037","2016",7,6,1,128024.285714286,1476,79
"2803","11038","2016",3,3,0,74333.3333333333,943.666666666667,93.3333333333333
"2804","11040","2016",13,13,0,144121.923076923,1754.53846153846,84.4615384615385
"2805","11041","2016",20,19,1,141352.5,1470.05,94.55
"2806","11042","2016",2,2,0,91000,823,114
"2807","11044","2016",2,2,0,181000,1694,101.5
"2808","11045","2016",4,4,0,78700,1228.75,70.25
"2809","11047","2016",4,4,0,55232.5,769,79.5
"2810","11048","2016",9,9,0,135372.222222222,1441.55555555556,95.1111111111111
"2811","11049","2016",22,21,1,146364.090909091,1332.90909090909,117.727272727273
"2812","11051","2016",5,5,0,145500,1140.6,139.6
"2813","11052","2016",6,6,0,135300,1319.16666666667,106.666666666667
"2814","11053","2016",5,5,0,123880,1155.2,107
"2815","11054","2016",5,5,0,142000,1540.4,97
"2816","11055","2016",4,4,0,191921.25,1539.75,128.75
"2817","11056","2016",3,3,0,76500,1091.33333333333,61
"2818","11058","2016",2,2,0,202500,1475,132
"2819","11059","2016",1,1,0,95000,772,123
"2820","11061","2016",4,4,0,107000,869.5,134.75
"2821","11062","2016",1,1,0,30000,588,51
"2822","11063","2016",7,7,0,135657.142857143,1230,109.428571428571
"2823","11064","2016",3,3,0,104000,1154,92.6666666666667
"2824","11065","2016",1,1,0,62000,925,67
"2825","11066","2016",6,6,0,117916.666666667,1013.16666666667,114.5
"2826","11067","2016",26,25,1,157241.192307692,1582.30769230769,99.1538461538462
"2827","11068","2016",25,25,0,94928.6,1021.76,92.76
"2828","11069","2016",610,381,229,111872.016393443,1275.20491803279,87.2672131147541
"2829","11070","2016",4,4,0,175625,1408,111.5
"2830","11071","2016",5,5,0,114600,1209.8,102.2
"2831","11072","2016",3,3,0,92200,1204.33333333333,95.3333333333333
"2832","11073","2016",1,1,0,1e+05,1429,70
"2833","11075","2016",4,4,0,64950,758,77.25
"2834","11076","2016",89,77,12,115313.988764045,1244.5393258427,94.3370786516854
"2835","11077","2016",7,6,1,128428.571428571,1122.14285714286,117
"2836","11078","2016",2,2,0,104000,1213.5,88
"2837","11079","2016",5,5,0,130200,1238.6,115.4
"2838","11080","2016",4,4,0,146606.25,1629.75,101.75
"2839","11081","2016",20,20,0,130692.65,1331.6,103.75
"2840","11084","2016",7,7,0,143852.857142857,1317.28571428571,111.142857142857
"2841","11085","2016",10,10,0,111988,1232.6,95.6
"2842","11086","2016",11,11,0,224749.363636364,1988.72727272727,114.636363636364
"2843","11087","2016",1,1,0,65606,841,78
"2844","11088","2016",19,19,0,153348.684210526,1511.52631578947,101.473684210526
"2845","11089","2016",3,3,0,89766.6666666667,799.666666666667,101.333333333333
"2846","11090","2016",6,6,0,86800,1037.16666666667,87.3333333333333
"2847","11091","2016",12,12,0,104736.666666667,1112.16666666667,107.583333333333
"2848","11093","2016",1,1,0,35000,565,62
"2849","11095","2016",6,6,0,150308.166666667,1600,99.3333333333333
"2850","11096","2016",1,1,0,50000,500,100
"2851","11098","2016",13,13,0,158368.692307692,1617.46153846154,104.384615384615
"2852","11099","2016",31,31,0,123932.161290323,1207.8064516129,100.838709677419
"2853","11102","2016",7,7,0,113311.428571429,1190.57142857143,97.5714285714286
"2854","11103","2016",12,12,0,95153,1030.33333333333,90.9166666666667
"2855","11104","2016",1,1,0,40000,1000,40
"2856","11105","2016",3,3,0,129666.666666667,1256.33333333333,114.666666666667
"2857","11106","2016",65,59,6,132839.507692308,1596.87692307692,85.3846153846154
"2858","11107","2016",1,1,0,50000,385,130
"2859","11111","2016",6,6,0,164518.333333333,1748.5,98.1666666666667
"2860","11112","2016",2,2,0,53000,1218.5,46.5
"2861","11113","2016",1,1,0,160000,1481,108
"2862","11114","2016",1,1,0,254500,2175,117
"2863","11115","2016",6,6,0,97150,1716.5,60
"2864","11116","2016",60,60,0,147881.966666667,1574.63333333333,95.3666666666667
"2865","11117","2016",3,3,0,36666.6666666667,721.333333333333,52.3333333333333
"2866","11118","2016",1,1,0,65000,1016,64
"2867","11119","2016",5,5,0,104700,1014.2,101.2
"2868","11121","2016",1,1,0,128000,895,143
"2869","11122","2016",8,7,1,76027.5,932.25,80.25
"2870","11123","2016",2,2,0,40500,1127.5,35.5
"2871","11124","2016",8,8,0,109381.25,1479.25,71.125
"2872","11125","2016",5,5,0,83000,1640.6,67
"2873","11126","2016",6,6,0,130458.666666667,1348.16666666667,99.1666666666667
"2874","11127","2016",2,2,0,60500,515,115.5
"2875","11129","2016",28,25,3,93122.1428571429,1200.85714285714,83.1785714285714
"2876","11130","2016",5,5,0,85000,898.2,100.6
"2877","11131","2016",4,4,0,62750,983.25,82
"2878","11132","2016",17,16,1,112999.529411765,1283.82352941176,84.0588235294118
"2879","11133","2016",1,1,0,152000,1126,135
"2880","11135","2016",1,1,0,42000,583,72
"2881","11136","2016",7,6,1,135071.428571429,970.571428571429,134.571428571429
"2882","11137","2016",3,3,0,95000,1069.66666666667,94
"2883","11138","2016",3,3,0,166833.333333333,1553.33333333333,98.3333333333333
"2884","11139","2016",4,4,0,109205,826.75,120.25
"2885","11140","2016",9,9,0,147052.777777778,1329.44444444444,107.111111111111
"2886","11141","2016",1,1,0,60000,577,104
"2887","11142","2016",2,2,0,69450,809,87
"2888","11143","2016",1,1,0,67000,838,80
"2889","11144","2016",27,24,3,157383.888888889,1728.92592592593,90.9259259259259
"2890","11145","2016",245,135,110,105339.47755102,2645.35102040816,45.530612244898
"2891","11146","2016",5,5,0,117312.4,1054.8,105.4
"2892","11148","2016",9,9,0,121545,996.888888888889,122.222222222222
"2893","11150","2016",11,11,0,90409.0909090909,1297.81818181818,70.0909090909091
"2894","11151","2016",11,11,0,131594.727272727,1343.36363636364,98.9090909090909
"2895","11152","2016",4,4,0,79268,1320.75,57.75
"2896","11153","2016",3,3,0,91500,2198.66666666667,59.3333333333333
"2897","11155","2016",1,1,0,40000,1176,34
"2898","11156","2016",3,3,0,38000,539,69.3333333333333
"2899","11157","2016",1,1,0,50000,442,113
"2900","11158","2016",1,1,0,68000,872,78
"2901","11159","2016",3,3,0,143500,1396,106.333333333333
"2902","11160","2016",1,1,0,52000,743,70
"2903","11161","2016",3,3,0,113333.333333333,864,126.666666666667
"2904","11163","2016",2,2,0,62000,1052.5,65
"2905","11164","2016",20,20,0,161255.5,1582.8,97.25
"2906","11165","2016",2,2,0,231000,2375.5,99.5
"2907","11166","2016",1,1,0,409700,2090,196
"2908","11170","2016",384,171,213,121424.713541667,2935.65104166667,41.9375
"2909","11172","2016",8,8,0,95371.25,1584.125,68.5
"2910","11173","2016",2,2,0,92500,1080,89
"2911","11174","2016",1,0,1,90000,600,150
"2912","11175","2016",3,3,0,70333.3333333333,1092,72
"2913","11176","2016",1,1,0,15000,333,45
"2914","11177","2016",1,1,0,45000,833,54
"2915","11178","2016",9,9,0,126413.555555556,1398.22222222222,86
"2916","11180","2016",3,3,0,61666.6666666667,943.666666666667,56.3333333333333
"2917","11181","2016",5,5,0,135006,1400.4,84.2
"2918","11182","2016",2,2,0,134500,1398,116.5
"2919","11183","2016",4,4,0,195087.5,1448.25,133.5
"2920","11184","2016",3,3,0,123333.333333333,1365.33333333333,113.333333333333
"2921","11185","2016",3,3,0,94015,1413.66666666667,78.3333333333333
"2922","11187","2016",3,3,0,104850,1747.33333333333,64.6666666666667
"2923","11188","2016",16,16,0,166281.875,1767.75,93.125
"2924","11189","2016",2,2,0,44407.5,745.5,59
"2925","11190","2016",15,15,0,103269.666666667,1098.26666666667,95.8666666666667
"2926","11191","2016",3,3,0,70666.6666666667,898,74.3333333333333
"2927","11192","2016",7,7,0,180500,1380.42857142857,117.428571428571
"2928","11193","2016",5,5,0,132822,1282.8,104.4
"2929","11194","2016",5,5,0,97680,1082.8,94.6
"2930","11195","2016",2,2,0,203365,2457,76.5
"2931","11196","2016",6,6,0,115218.333333333,1289.83333333333,92.1666666666667
"2932","11197","2016",3,3,0,170000,1463,108.333333333333
"2933","11198","2016",15,15,0,92813,838.733333333333,115.933333333333
"2934","11199","2016",12,12,0,145775.833333333,1526.08333333333,96
"2935","11200","2016",4,4,0,68720,753.75,97.5
"2936","11201","2016",9,9,0,133888.888888889,1345.55555555556,111.777777777778
"2937","11202","2016",419,186,233,108393.417661098,2703.82338902148,40.1909307875895
"2938","11203","2016",112,102,10,125746.160714286,1387.07142857143,91.2589285714286
"2939","11206","2016",122,108,14,121854.491803279,1281.94262295082,93.4590163934426
"2940","11207","2016",2,2,0,118125,1307.5,83
"2941","11209","2016",2,2,0,123690,915.5,134.5
"2942","11210","2016",11,11,0,161807.636363636,1566.90909090909,105.272727272727
"2943","11211","2016",2,2,0,140000,1292,97.5
"2944","11212","2016",11,11,0,131513.636363636,1215,107.090909090909
"2945","11214","2016",5,5,0,101095.4,1123.8,80.6
"2946","11215","2016",11,11,0,160090.909090909,1350.81818181818,117.272727272727
"2947","11216","2016",6,6,0,129111.666666667,1298.66666666667,102.333333333333
"2948","11217","2016",20,20,0,194857.25,1926.2,101.45
"2949","11218","2016",1,1,0,195000,1196,163
"2950","11220","2016",7,6,1,128841.428571429,1981.28571428571,74.1428571428571
"2951","11221","2016",7,7,0,75128.5714285714,1001.71428571429,76.7142857142857
"2952","11222","2016",4,4,0,132625,2752.25,73.75
"2953","11225","2016",6,6,0,147200,1605.66666666667,103.666666666667
"2954","11228","2016",1,1,0,71000,546,130
"2955","11230","2016",1,1,0,40000,381,105
"2956","11231","2016",1,1,0,25000,510,49
"2957","11232","2016",2,2,0,191500,1792.5,96
"2958","11233","2016",6,6,0,169333.333333333,1616.5,105.333333333333
"2959","11234","2016",2,2,0,237500,2476,94.5
"2960","11236","2016",3,3,0,135333.333333333,1222.33333333333,115
"2961","11239","2016",1,1,0,149000,1419,105
"2962","11240","2016",5,5,0,96400,1165.2,82.6
"2963","11241","2016",3,3,0,121700,1125.33333333333,111
"2964","11242","2016",2,2,0,140911.5,1389,106
"2965","11243","2016",2,2,0,229830,1451.5,163
"2966","11244","2016",5,5,0,52600,794.2,81.4
"2967","11245","2016",2,2,0,127000,1967.5,74.5
"2968","11250","2016",1,1,0,43184,939,46
"2969","11251","2016",8,8,0,103428.75,1018.5,97.125
"2970","11252","2016",5,4,1,101600,860.6,120
"2971","11253","2016",13,13,0,150429.307692308,1097.92307692308,135.230769230769
"2972","11254","2016",22,22,0,139574.545454545,1408.95454545455,99.0909090909091
"2973","11255","2016",18,17,1,149447.222222222,1598.33333333333,88.3888888888889
"2974","11256","2016",7,7,0,143396.428571429,1367.71428571429,111.714285714286
"2975","11257","2016",5,5,0,124228.6,1251,95.4
"2976","11258","2016",32,31,1,163556.03125,1667,101.375
"2977","11259","2016",11,11,0,142181.818181818,1358,96.3636363636364
"2978","11260","2016",2,2,0,62750,1060,62.5
"2979","11261","2016",4,3,1,71250,898.25,78
"2980","11262","2016",880,393,487,147641.317045455,2107.49204545455,71.8340909090909
"2981","11263","2016",5,5,0,102600,1193.8,92.8
"2982","11264","2016",11,10,1,147418.181818182,1501.36363636364,93.6363636363636
"2983","11265","2016",1,1,0,47500,792,60
"2984","11266","2016",159,79,80,105478.830188679,2092.06918238994,53.8679245283019
"2985","11267","2016",14,14,0,137647.857142857,1473,93.2857142857143
"2986","11269","2016",32,32,0,103256.84375,1162.90625,91.65625
"2987","11270","2016",6,6,0,73991.6666666667,744.833333333333,86.8333333333333
"2988","11272","2016",20,20,0,185198.65,1758,106.2
"2989","11273","2016",9,9,0,129426.666666667,1379.55555555556,87.8888888888889
"2990","11274","2016",8,8,0,186513.125,1459.75,131.375
"2991","11276","2016",8,8,0,68672,961.25,69.25
"2992","11277","2016",1,1,0,510000,4857,105
"2993","11278","2016",2,2,0,1e+05,1096,90.5
"2994","11279","2016",26,26,0,121506.5,1232.07692307692,105.115384615385
"2995","11280","2016",13,13,0,134345.461538462,1387.46153846154,104.153846153846
"2996","11281","2016",8,8,0,101882.5,965.375,110.375
"2997","11283","2016",1,1,0,65000,722,90
"2998","11284","2016",3,3,0,96666.6666666667,1177.66666666667,93.3333333333333
"2999","11285","2016",19,18,1,210383.789473684,2043.84210526316,106
"3000","11286","2016",20,20,0,105515.1,1015.85,108.65
"3001","11287","2016",2,2,0,173500,1338.5,139
"3002","11288","2016",13,13,0,141180.769230769,1510.61538461538,93
"3003","11289","2016",12,12,0,152245.833333333,1225.25,113.083333333333
"3004","11290","2016",2,2,0,137000,2487.5,55.5
"3005","11293","2016",11,11,0,138713.636363636,1430.81818181818,94.6363636363636
"3006","11295","2016",15,12,3,163437.066666667,1728,99.2666666666667
"3007","11296","2016",14,13,1,139698.571428571,1523.57142857143,89.3571428571429
"3008","11297","2016",5,5,0,70733.8,1058.6,65.4
"3009","11299","2016",10,10,0,135091,1470.9,90.6
"3010","11301","2016",9,9,0,103466.666666667,1152.77777777778,94.1111111111111
"3011","11302","2016",5,5,0,73100,803.8,89.6
"3012","11303","2016",6,6,0,85586.6666666667,1001.16666666667,94.8333333333333
"3013","11304","2016",51,46,5,113783.647058824,1143.27450980392,100.764705882353
"3014","11305","2016",1,1,0,66000,1138,58
"3015","11307","2016",1,1,0,120000,1188,101
"3016","11308","2016",4,4,0,161250,1545,103.5
"3017","11309","2016",1,1,0,227075,2468,92
"3018","11310","2016",7,3,4,61857.1428571429,1444.42857142857,43.7142857142857
"3019","11311","2016",6,6,0,124833.333333333,1545.16666666667,82.5
"3020","11313","2016",3,3,0,148500,1280.66666666667,118
"3021","11314","2016",1,1,0,51000,638,80
"3022","11315","2016",18,17,1,110527.777777778,1226.88888888889,91.1111111111111
"3023","11316","2016",3,3,0,65000,604.666666666667,97
"3024","11317","2016",3,3,0,58046.6666666667,448,135.666666666667
"3025","11318","2016",2,2,0,189250,1842,104
"3026","11320","2016",4,4,0,81250,940.5,89.75
"3027","11321","2016",1,1,0,79710,1139,70
"3028","11322","2016",7,7,0,160332.142857143,1701.85714285714,95.7142857142857
"3029","11323","2016",6,6,0,132833.333333333,1148.33333333333,98.3333333333333
"3030","11324","2016",5,5,0,99100,1207.6,81.4
"3031","11325","2016",2,2,0,129000,1308,90.5
"3032","11326","2016",2,2,0,60000,493.5,121.5
"3033","11327","2016",1,1,0,98000,1441,68
"3034","11328","2016",2,2,0,110650,1308,89.5
"3035","11330","2016",6,6,0,161878.333333333,1381.16666666667,114.166666666667
"3036","11331","2016",3,3,0,159900,1175,120
"3037","11332","2016",17,16,1,170997.588235294,1733.58823529412,100.411764705882
"3038","11333","2016",2,2,0,75000,1218,62.5
"3039","11334","2016",2,2,0,115500,1321.5,88
"3040","11336","2016",4,4,0,82500,1028.75,79.75
"3041","11337","2016",6,6,0,126500,1060.5,119.166666666667
"3042","11339","2016",5,5,0,155800,1958.2,80.2
"3043","11340","2016",5,5,0,182200,1403.4,117
"3044","11341","2016",2,2,0,59750,606,105.5
"3045","11342","2016",4,4,0,148187.5,1255,116.5
"3046","11344","2016",7,7,0,120278.571428571,1355.42857142857,78.1428571428571
"3047","11345","2016",6,6,0,108828.333333333,1139.83333333333,100.166666666667
"3048","11346","2016",2,2,0,149125,1732.5,110
"3049","11350","2016",1,1,0,73000,1327,55
"3050","11351","2016",14,14,0,141012.142857143,1531.64285714286,100.214285714286
"3051","11352","2016",3,3,0,74666.6666666667,711.666666666667,108
"3052","11353","2016",26,26,0,161564.230769231,1609.80769230769,105.5
"3053","11354","2016",1,1,0,61000,726,84
"3054","11355","2016",5,5,0,223170,1458,138.8
"3055","11356","2016",3,3,0,180463.333333333,1617.66666666667,113.333333333333
"3056","11357","2016",1,1,0,114000,2280,50
"3057","11358","2016",2,2,0,83000,912,85
"3058","11359","2016",6,6,0,150690,2187.33333333333,70.6666666666667
"3059","11360","2016",28,28,0,198619.642857143,1796.42857142857,110.464285714286
"3060","11361","2016",8,8,0,120756,1070,108.875
"3061","11363","2016",4,4,0,159760,1746.75,88.75
"3062","11364","2016",3,3,0,92780,1238.33333333333,75
"3063","11366","2016",12,12,0,159670.833333333,1665.33333333333,100.083333333333
"3064","11367","2016",4,4,0,66792.5,843,82.25
"3065","11368","2016",1,1,0,25000,781,32
"3066","11369","2016",35,34,1,177829.342857143,1777.68571428571,100.314285714286
"3067","11370","2016",60,59,1,185401.566666667,1812.31666666667,103.1
"3068","11371","2016",7,7,0,118471.428571429,1380.14285714286,92.5714285714286
"3069","11372","2016",2,2,0,94750,1029,92.5
"3070","11373","2016",2,2,0,46525,724,70
"3071","11376","2016",1,1,0,180000,1169,154
"3072","11378","2016",2,2,0,52000,730.5,69
"3073","11379","2016",72,60,12,142550.75,1709.22222222222,87.5972222222222
"3074","11381","2016",1,1,0,320001,1067,300
"3075","11382","2016",4,4,0,190437.5,1669,114.75
"3076","11383","2016",2,2,0,105955,1254,82
"3077","11384","2016",1,0,1,25000,694,36
"3078","11385","2016",2,2,0,107500,1622.5,64.5
"3079","11386","2016",4,4,0,72500,838.25,91
"3080","11390","2016",9,9,0,106296.666666667,1482.55555555556,69.7777777777778
"3081","11391","2016",1,1,0,95000,1827,52
"3082","11392","2016",7,7,0,103357.142857143,1056.71428571429,106.285714285714
"3083","11393","2016",3,3,0,131266.666666667,1545.66666666667,89
"3084","11394","2016",1,1,0,122000,762,160
"3085","11396","2016",7,7,0,109542.857142857,1214.57142857143,94.7142857142857
"3086","11397","2016",52,46,6,104799.615384615,1175.51923076923,88.9230769230769
"3087","11398","2016",1,1,0,150000,1807,83
"3088","11400","2016",4,4,0,127500,1078.75,125.25
"3089","11401","2016",12,11,1,98083.3333333333,1298.16666666667,84.1666666666667
"3090","11404","2016",9,9,0,126358.888888889,1282.66666666667,96.5555555555556
"3091","11405","2016",8,8,0,200958.75,1945.25,103.625
"3092","11407","2016",5,5,0,168622,1441,112
"3093","11408","2016",4,4,0,98875,1022.5,93.25
"3094","11409","2016",1,1,0,64000,610,105
"3095","11410","2016",15,15,0,130326.666666667,1344.93333333333,95.8666666666667
"3096","11411","2016",3,3,0,160166.666666667,3153.33333333333,84.6666666666667
"3097","11412","2016",2,2,0,47500,916.5,57.5
"3098","11413","2016",8,8,0,126798.75,1366.25,95.25
"3099","11415","2016",1,1,0,27500,688,40
"3100","11416","2016",1,1,0,172300,805,214
"3101","11417","2016",3,3,0,126666.666666667,1737.33333333333,71
"3102","11418","2016",15,15,0,174165.666666667,1773.6,99.2
"3103","11420","2016",2,2,0,123000,1388.5,87.5
"3104","11421","2016",11,11,0,141084.545454545,1254.63636363636,114.818181818182
"3105","11422","2016",1,1,0,160000,1524,105
"3106","11423","2016",1,1,0,149000,937,159
"3107","11424","2016",1,1,0,205000,1667,123
"3108","11425","2016",16,14,2,96493.75,1037.1875,94.25
"3109","11426","2016",12,10,2,166191.666666667,1625,95.5
"3110","11427","2016",4,4,0,128250,1199.25,109.5
"3111","11428","2016",2,2,0,87000,614,146
"3112","11429","2016",43,39,4,155276.953488372,1677.3488372093,94.6511627906977
"3113","11430","2016",15,15,0,157212.666666667,1524.33333333333,105.866666666667
"3114","11431","2016",3,3,0,299933.333333333,1700.66666666667,195
"3115","11432","2016",2,2,0,99500,987.5,87.5
"3116","11433","2016",14,13,1,98821.4285714286,1108.5,90.4285714285714
"3117","11434","2016",11,10,1,170237.818181818,1366.27272727273,110
"3118","11435","2016",1,0,1,15000,500,30
"3119","11436","2016",8,8,0,144025,1863.75,100.75
"3120","11437","2016",14,14,0,123017.857142857,1232.21428571429,100.5
"3121","11438","2016",4,4,0,113175,1245,84
"3122","11439","2016",10,10,0,120732,1418.4,87
"3123","11441","2016",26,23,3,171560.384615385,1961.88461538462,89.1538461538462
"3124","12001","2016",5,5,0,122000,1317,99.8
"3125","12002","2016",8,8,0,141756.25,1429.625,97.25
"3126","12003","2016",3,3,0,107521.333333333,1180,137.666666666667
"3127","12004","2016",4,4,0,81842.5,697.25,121.25
"3128","12006","2016",8,8,0,94851.25,1002.125,97.75
"3129","12007","2016",2,2,0,85725,1078,88.5
"3130","12008","2016",9,9,0,142382,1239.44444444444,117.666666666667
"3131","12009","2016",1,1,0,17000,425,40
"3132","12010","2016",3,3,0,115333.333333333,718.666666666667,164
"3133","12011","2016",7,7,0,78857.1428571429,723.857142857143,110
"3134","12012","2016",10,10,0,121936,1457.4,96.4
"3135","12013","2016",26,25,1,82741.9230769231,1067.19230769231,76.3076923076923
"3136","12016","2016",3,3,0,104666.666666667,872,116.666666666667
"3137","12017","2016",4,4,0,84500,846.75,92.25
"3138","12018","2016",2,2,0,127650,997,128
"3139","12021","2016",12,12,0,126658.666666667,1547.75,80.25
"3140","12022","2016",4,4,0,85500,1305,62.25
"3141","12024","2016",2,2,0,149750,1339,113
"3142","12025","2016",4,3,1,97154,1087,85.75
"3143","12026","2016",4,4,0,51050,931,54
"3144","12027","2016",2,2,0,199840,2141,94
"3145","12028","2016",6,5,1,67048,802.166666666667,87.1666666666667
"3146","12030","2016",2,2,0,130000,1388,93.5
"3147","12031","2016",2,2,0,122300,923,145.5
"3148","12032","2016",2,2,0,67500,580,113.5
"3149","12033","2016",26,23,3,148824.423076923,1567.30769230769,95.5769230769231
"3150","12034","2016",4,4,0,108350,925,116.25
"3151","12035","2016",2,2,0,183250,1239,122
"3152","12036","2016",3,3,0,66006.6666666667,725,91.3333333333333
"3153","12037","2016",2,2,0,49667.5,819.5,69
"3154","12038","2016",4,4,0,135500,1212.5,115
"3155","12039","2016",5,4,1,77132,823,92
"3156","12041","2016",4,4,0,87250,1111.75,86.75
"3157","12043","2016",15,15,0,182467.533333333,1714.06666666667,110
"3158","12044","2016",12,11,1,102214.166666667,1122.75,96.5
"3159","12045","2016",2,2,0,132000,1401.5,89
"3160","12046","2016",5,5,0,76300,924.6,82.2
"3161","12047","2016",6,6,0,107966.666666667,1135.83333333333,96.3333333333333
"3162","12048","2016",6,6,0,83041.6666666667,1181.66666666667,79.6666666666667
"3163","12049","2016",2,2,0,101200,2387.5,42
"3164","12050","2016",5,5,0,124900,1372,89.8
"3165","12051","2016",2,2,0,59000,840,84.5
"3166","12052","2016",54,49,5,104825.888888889,1189.98148148148,91.0185185185185
"3167","12053","2016",1,1,0,161660,879,184
"3168","12054","2016",3,3,0,110840,1251.66666666667,90.6666666666667
"3169","12055","2016",2,2,0,51475,895.5,60
"3170","12056","2016",31,21,10,127179.741935484,1523.8064516129,89.3870967741936
"3171","12057","2016",7,7,0,88565.7142857143,975.571428571429,94.7142857142857
"3172","12059","2016",4,4,0,123237.5,1056.25,121.25
"3173","12060","2016",1,1,0,80495,624,129
"3174","12061","2016",8,8,0,122071.25,1463.5,87.25
"3175","12062","2016",4,4,0,119193.75,1457.25,97
"3176","12063","2016",12,10,2,125702.5,1581.91666666667,77
"3177","12064","2016",2,2,0,146000,1117.5,130.5
"3178","12065","2016",5,5,0,118600,940,128.4
"3179","12066","2016",2,2,0,140000,1466.5,92.5
"3180","12067","2016",3,3,0,58333.3333333333,943.666666666667,56
"3181","12068","2016",1,1,0,60000,857,70
"3182","12069","2016",1,1,0,54000,540,100
"3183","12070","2016",6,5,1,128641.666666667,1436.5,84.5
"3184","12071","2016",3,3,0,164987.333333333,1113,153.333333333333
"3185","12072","2016",1,1,0,82000,1281,64
"3186","12073","2016",3,3,0,122833.333333333,1516.66666666667,92.6666666666667
"3187","12074","2016",3,3,0,89376.6666666667,1160,81
"3188","12075","2016",2,2,0,53000,1528.5,47.5
"3189","12076","2016",18,17,1,136023.055555556,1731.94444444444,78.7777777777778
"3190","12077","2016",4,4,0,110000,978.5,104.75
"3191","12078","2016",3,3,0,284242.333333333,1314.33333333333,218.333333333333
"3192","12079","2016",2,2,0,117000,902,124
"3193","12080","2016",3,3,0,119000,846.666666666667,148.666666666667
"3194","12082","2016",3,2,1,111333.333333333,1105,110.333333333333
"3195","12083","2016",14,14,0,71517.8571428571,891.928571428571,77.8571428571429
"3196","12084","2016",16,14,2,147497.5,1852.875,80.1875
"3197","12085","2016",1,1,0,55000,688,80
"3198","12086","2016",1,1,0,231000,2567,90
"3199","12088","2016",1,1,0,168900,1408,120
"3200","12089","2016",39,22,17,79329.3076923077,969.025641025641,82.7179487179487
"3201","12090","2016",13,13,0,184127.153846154,1911.69230769231,99.7692307692308
"3202","12091","2016",1,1,0,18000,383,47
"3203","12092","2016",2,2,0,125000,1058.5,109.5
"3204","12094","2016",9,7,2,109345.555555556,950.777777777778,112.555555555556
"3205","12095","2016",1,1,0,115000,1211,95
"3206","12096","2016",52,23,29,107413.788461538,1264.25,83.6923076923077
"3207","12097","2016",3,3,0,74000,1075.66666666667,82.6666666666667
"3208","12098","2016",5,5,0,129600,1220.2,103.6
"3209","12099","2016",3,3,0,49980,656,80
"3210","12100","2016",21,21,0,86668.5714285714,1002.61904761905,83.7142857142857
"3211","12101","2016",6,5,1,92066.6666666667,1170.83333333333,81.8333333333333
"3212","12102","2016",25,23,2,148645.6,1516.36,97.4
"3213","12103","2016",2,2,0,84538,940,84.5
"3214","12104","2016",5,5,0,81000,762.2,101.6
"3215","12105","2016",18,18,0,127198.277777778,1254.83333333333,107.222222222222
"3216","12106","2016",7,7,0,134507.142857143,1385.57142857143,96.5714285714286
"3217","12107","2016",1,1,0,236000,1494,158
"3218","12108","2016",1,1,0,135000,1688,80
"3219","12109","2016",2,2,0,136350,1083.5,134
"3220","12110","2016",4,4,0,128000,1738.5,91.5
"3221","12111","2016",4,4,0,136925,1003,157
"3222","12113","2016",4,4,0,117375,1478.5,84
"3223","12115","2016",7,7,0,120400,1459.14285714286,88.8571428571429
"3224","12116","2016",1,1,0,81560,544,150
"3225","12118","2016",4,4,0,80700,1141.5,68
"3226","12119","2016",19,11,8,81223.1052631579,1119.68421052632,78.7894736842105
"3227","12120","2016",19,9,10,124689.473684211,1714.89473684211,80.6315789473684
"3228","12121","2016",3,2,1,124923.333333333,1395.66666666667,93.6666666666667
"3229","12122","2016",2,2,0,127500,1052,130.5
"3230","12124","2016",2,2,0,74500,1054,74
"3231","12125","2016",4,4,0,133150,1187.25,107.75
"3232","12127","2016",6,6,0,76833.3333333333,902.833333333333,83
"3233","12128","2016",2,2,0,169500,2709,62
"3234","12129","2016",2,2,0,104000,2028,51
"3235","12130","2016",8,8,0,115670,1133.5,102.125
"3236","12131","2016",5,5,0,247800,2019,140
"3237","12133","2016",65,43,22,145315.923076923,1722.26153846154,87.9692307692308
"3238","12134","2016",2,2,0,76400,1035,80
"3239","12135","2016",2,2,0,60250,818.5,75.5
"3240","12136","2016",5,5,0,160900,1342,142.4
"3241","12137","2016",7,7,0,140050,1697.85714285714,79.8571428571429
"3242","12138","2016",11,10,1,132772.727272727,1276.27272727273,107.727272727273
"3243","12140","2016",11,11,0,147715.363636364,1329.90909090909,115.909090909091
"3244","12142","2016",2,2,0,166500,1688,99
"3245","12144","2016",2,2,0,107500,1053,108
"3246","12145","2016",259,106,153,111329.015444015,1469.69498069498,75.4903474903475
"3247","12146","2016",75,54,21,147530.24,1771,82.3066666666667
"3248","12147","2016",2,2,0,75750,1066.5,71
"3249","12148","2016",13,13,0,107717.692307692,1515,74.7692307692308
"3250","12149","2016",1,1,0,132000,1245,106
"3251","12150","2016",3,3,0,81666.6666666667,1008.33333333333,81
"3252","12151","2016",3,3,0,99333.3333333333,1151.66666666667,93.3333333333333
"3253","12152","2016",1,1,0,151446,1683,90
"3254","12153","2016",5,5,0,76980,999.2,74.8
"3255","12154","2016",4,4,0,87582.5,1358.75,83.25
"3256","12155","2016",1,1,0,145300,741,196
"3257","12156","2016",1,1,0,76000,745,102
"3258","12157","2016",18,18,0,140298.888888889,1359.16666666667,103.277777777778
"3259","12158","2016",3,3,0,146050,1667.66666666667,89.3333333333333
"3260","12159","2016",2,2,0,137500,1209.5,117.5
"3261","12160","2016",6,5,1,126465,1254.16666666667,99
"3262","12161","2016",1,1,0,150000,1875,80
"3263","12162","2016",5,5,0,158060,1225.8,125.2
"3264","12163","2016",1,1,0,150000,1875,80
"3265","12164","2016",5,3,2,71990,889.4,73.6
"3266","12165","2016",4,4,0,132440,1733,79.25
"3267","12166","2016",1,1,0,1e+05,1786,56
"3268","12167","2016",12,11,1,111297.166666667,1227.91666666667,92.1666666666667
"3269","12168","2016",15,14,1,92433.3333333333,1238.2,78.1333333333333
"3270","12169","2016",22,22,0,125531.818181818,1250.5,103.5
"3271","12170","2016",5,5,0,74200,1029.4,75
"3272","12172","2016",8,8,0,94167.5,1014.25,95
"3273","12174","2016",41,28,13,165256.87804878,1868.14634146341,87.5365853658537
"3274","12175","2016",1,1,0,390000,1696,230
"3275","12176","2016",140,55,85,135425.664285714,1762.39285714286,78.5714285714286
"3276","12177","2016",10,10,0,124501,1446,91.3
"3277","12178","2016",3,3,0,83000,1137.66666666667,70.6666666666667
"3278","12181","2016",4,4,0,62171.25,703.25,81.25
"3279","12182","2016",1,1,0,30000,500,60
"3280","12183","2016",2,2,0,83645,878,92
"3281","12184","2016",1,1,0,95000,1067,89
"3282","12185","2016",9,9,0,91505.5555555556,1120.88888888889,91.4444444444444
"3283","12186","2016",1,1,0,1e+05,1316,76
"3284","12187","2016",3,1,2,41200,858,52.3333333333333
"3285","12188","2016",4,4,0,125375,1342,92.5
"3286","12189","2016",3,3,0,130000,747.666666666667,196.333333333333
"3287","12190","2016",3,2,1,65566.6666666667,942.333333333333,69.6666666666667
"3288","12191","2016",3,3,0,80616.6666666667,1241,65
"3289","12193","2016",2,2,0,202500,1928,96.5
"3290","12194","2016",3,3,0,112366.666666667,1029.66666666667,112
"3291","12195","2016",7,6,1,97371.4285714286,1068.42857142857,88
"3292","12197","2016",13,13,0,96037.9230769231,971.384615384615,93.5384615384615
"3293","12198","2016",18,16,2,90929.1666666667,1083.61111111111,85.7222222222222
"3294","12199","2016",13,9,4,112838.461538462,1332.38461538462,86.3076923076923
"3295","12200","2016",3,3,0,142890,1351.33333333333,106.666666666667
"3296","12201","2016",11,11,0,146350,1383.54545454545,104.090909090909
"3297","12202","2016",483,60,423,101109.505175983,1528.42028985507,68.2815734989648
"3298","12203","2016",3,2,1,102400,1193,85.3333333333333
"3299","12204","2016",3,3,0,77000,997.333333333333,94
"3300","12205","2016",7,7,0,114523.714285714,1323.42857142857,94.8571428571429
"3301","12206","2016",5,5,0,86550,1443.2,63.6
"3302","12207","2016",2,2,0,46010,683.5,65
"3303","12208","2016",96,66,30,115483.53125,1375.66666666667,84.0208333333333
"3304","12209","2016",7,7,0,92323.5714285714,868.857142857143,104.285714285714
"3305","12210","2016",8,8,0,114445.625,1295.5,85.25
"3306","12211","2016",1,1,0,62000,1476,42
"3307","12212","2016",3,3,0,103666.666666667,1077,89.6666666666667
"3308","12213","2016",3,3,0,143100,1556,96
"3309","12214","2016",10,8,2,109969.9,1043.4,107.5
"3310","12215","2016",9,9,0,158728.888888889,1519.33333333333,112.777777777778
"3311","12216","2016",11,11,0,122219.090909091,1377.36363636364,102.090909090909
"3312","12217","2016",10,10,0,169777.5,1439,118.1
"3313","12219","2016",3,3,0,62000,1145.33333333333,66.3333333333333
"3314","12220","2016",3,3,0,104666.666666667,1301.33333333333,76.6666666666667
"3315","12221","2016",2,2,0,136500,1681,81.5
"3316","12222","2016",5,5,0,84870,1154.2,71.2
"3317","12223","2016",14,13,1,92335.7142857143,967,98.7857142857143
"3318","12224","2016",30,23,7,90062.3,1214.56666666667,72.6
"3319","12225","2016",4,4,0,95375,1006.5,92.25
"3320","12226","2016",7,7,0,58414.2857142857,839,86.1428571428571
"3321","12227","2016",2,2,0,118000,1608.5,70.5
"3322","12228","2016",6,6,0,61666.6666666667,724.5,84.1666666666667
"3323","12229","2016",1,1,0,113900,1539,74
"3324","12231","2016",17,14,3,79714.7647058823,1046.82352941176,71.4117647058823
"3325","12232","2016",4,4,0,118250,1074.5,122.5
"3326","12233","2016",3,3,0,50333.3333333333,1110.66666666667,44.3333333333333
"3327","12234","2016",6,6,0,184588.333333333,1716.16666666667,107.5
"3328","12235","2016",1,1,0,180000,957,188
"3329","12237","2016",8,7,1,70025,956,84.25
"3330","12238","2016",1,1,0,150000,1000,150
"3331","12239","2016",5,5,0,94930,1305.6,78.4
"3332","12241","2016",17,17,0,228007.058823529,1896,119.470588235294
"3333","12242","2016",2,2,0,63750,750,90
"3334","12243","2016",15,14,1,129078,1639.53333333333,85.2
"3335","12244","2016",11,9,2,97055.4545454545,999.454545454545,100.272727272727
"3336","12246","2016",2,2,0,132500,1303.5,103
"3337","12247","2016",4,4,0,71095.75,813.75,98
"3338","12248","2016",1,1,0,75000,872,86
"3339","12250","2016",3,3,0,88333.3333333333,1170.66666666667,100
"3340","12252","2016",6,6,0,130366.666666667,1380.33333333333,97.8333333333333
"3341","12253","2016",12,12,0,127483.333333333,1716.41666666667,77.25
"3342","12254","2016",10,10,0,215906.5,1575.7,147.2
"3343","12255","2016",7,7,0,83892.8571428571,1162.71428571429,74.7142857142857
"3344","12256","2016",2,2,0,130000,1850,70
"3345","12257","2016",6,6,0,106000,1003,96.3333333333333
"3346","12258","2016",16,16,0,115775.9375,1177.5625,96.375
"3347","12259","2016",2,2,0,210650,1846,112
"3348","12260","2016",6,6,0,101833.333333333,1128.83333333333,85.8333333333333
"3349","12261","2016",1,1,0,146700,1630,90
"3350","12262","2016",3,3,0,103916.666666667,1280.66666666667,80.6666666666667
"3351","12263","2016",2,2,0,146150,1706.5,86.5
"3352","12264","2016",22,21,1,162854,1793.04545454545,94.1818181818182
"3353","12265","2016",2,2,0,78500,951.5,81
"3354","12266","2016",1,1,0,163000,1583,103
"3355","12267","2016",2,2,0,105000,1285.5,85
"3356","12268","2016",1,1,0,65000,699,93
"3357","12269","2016",1,1,0,149000,1202,124
"3358","12270","2016",30,21,9,95046.5333333333,1127.73333333333,83.2333333333333
"3359","12272","2016",2,2,0,95000,592,160.5
"3360","12273","2016",2,2,0,133000,1506,95
"3361","12275","2016",3,3,0,44300,614.666666666667,70.3333333333333
"3362","12276","2016",1,1,0,74000,1321,56
"3363","12277","2016",4,4,0,107500,1040,108.75
"3364","12278","2016",3,3,0,100666.666666667,956,101.666666666667
"3365","12280","2016",2,2,0,80000,632.5,131.5
"3366","12281","2016",8,8,0,155037.5,1444.75,109.5
"3367","12282","2016",4,4,0,98775,933.25,100.5
"3368","12283","2016",4,4,0,80000,796,110.5
"3369","12284","2016",5,5,0,123400,1143,110
"3370","12286","2016",11,11,0,92497.7272727273,1278.81818181818,75.2727272727273
"3371","12287","2016",3,3,0,176000,1367,144.666666666667
"3372","12288","2016",15,15,0,147892.333333333,1854.33333333333,91
"3373","12289","2016",4,4,0,95375,1087,91.25
"3374","12290","2016",2,2,0,263636,1258.5,167.5
"3375","12291","2016",4,3,1,89777.5,1247.75,78.75
"3376","12292","2016",4,4,0,119407.5,956.25,113.5
"3377","12293","2016",1,0,1,40000,500,80
"3378","12294","2016",5,5,0,110106,1105.6,96.4
"3379","12295","2016",2,2,0,105000,1432.5,73
"3380","12296","2016",5,5,0,95780,878.2,94.4
"3381","12297","2016",4,4,0,101500,2304,57
"3382","12298","2016",2,2,0,134084,3047,45
"3383","12299","2016",13,10,3,102319.230769231,1265.23076923077,80.5384615384615
"3384","12300","2016",84,59,25,114321.107142857,1297.41666666667,89.9761904761905
"3385","12301","2016",10,10,0,108110,1362.6,80.6
"3386","12303","2016",3,3,0,221376.666666667,1562.33333333333,144.666666666667
"3387","12305","2016",15,14,1,59170,899.666666666667,67.3333333333333
"3388","12307","2016",5,5,0,89326.8,1049.4,85.8
"3389","13001","2016",1964,295,1669,265922.588594705,4079.96741344196,65.8034623217923
"3390","13002","2016",154,99,55,277872.344155844,3546.86363636364,79.6623376623377
"3391","13003","2016",23,22,1,271902.173913043,2814.69565217391,105.95652173913
"3392","13004","2016",455,304,151,185720.494505495,2271.14945054945,81.356043956044
"3393","13005","2016",369,132,237,228459.696476965,2939.45799457995,78.3333333333333
"3394","13006","2016",11,10,1,221894.636363636,2759.36363636364,83.7272727272727
"3395","13007","2016",96,67,29,263461.354166667,3143.53125,84.4166666666667
"3396","13008","2016",7,6,1,289585.714285714,3255.28571428571,92.4285714285714
"3397","13009","2016",5,5,0,411982,3015,145.6
"3398","13010","2016",35,28,7,278569.142857143,2784.42857142857,99.8571428571429
"3399","13011","2016",2,2,0,525000,6779.5,65.5
"3400","13012","2016",2,2,0,564500,4958.5,116
"3401","13013","2016",11,10,1,296951.272727273,3750.90909090909,84.6363636363636
"3402","13014","2016",82,53,29,204449.329268293,2563.10975609756,78.8048780487805
"3403","13015","2016",124,94,30,381491.935483871,4065.34677419355,98.1290322580645
"3404","13016","2016",53,41,12,272926.226415094,3273.2641509434,84.6037735849057
"3405","13017","2016",3,3,0,286000,2653.33333333333,103.333333333333
"3406","13018","2016",5,4,1,283761,2052.8,140
"3407","13019","2016",113,97,16,429541.876106195,3837.49557522124,111.973451327434
"3408","13020","2016",22,16,6,223287.727272727,3100.77272727273,73.4545454545455
"3409","13021","2016",101,42,59,403082.584158416,4785.81188118812,88.0693069306931
"3410","13022","2016",133,28,105,408512.338345865,5761.12781954887,70.3834586466165
"3411","13023","2016",50,41,9,427376.56,3787.62,108.52
"3412","13024","2016",19,15,4,198439.473684211,2485.10526315789,82.2105263157895
"3413","13025","2016",11,11,0,599268,4681.18181818182,133
"3414","13026","2016",171,98,73,220206.040935673,3081.01754385965,76.9122807017544
"3415","13027","2016",138,91,47,203956.5,2196.40579710145,89.9202898550725
"3416","13028","2016",667,145,522,240105.503748126,3931.86056971514,62.1709145427286
"3417","13029","2016",10,9,1,404690,3787.2,119.6
"3418","13030","2016",42,35,7,248771.428571429,2982.07142857143,88.3333333333333
"3419","13031","2016",38,22,16,235812.631578947,2933.71052631579,82.0526315789474
"3420","13032","2016",81,61,20,501414.320987654,4276.9012345679,109.938271604938
"3421","13033","2016",50,46,4,418788.9,4144.98,103.74
"3422","13034","2016",26,26,0,492085.269230769,4605.80769230769,106.807692307692
"3423","13035","2016",78,63,15,233788.051282051,3135.78205128205,80.1025641025641
"3424","13036","2016",42,36,6,286128.119047619,2555.5,106.785714285714
"3425","13037","2016",84,77,7,285956.345238095,3114.86904761905,92.9642857142857
"3426","13038","2016",32,26,6,265890.09375,2991.53125,92.625
"3427","13039","2016",150,112,38,212555.293333333,2622.28,82.64
"3428","13040","2016",93,69,24,318321.88172043,3594.59139784946,89.9247311827957
"3429","13041","2016",192,88,104,235043.385416667,3089.86458333333,77.03125
"3430","13042","2016",47,41,6,443126.829787234,4157.74468085106,110.340425531915
"3431","13043","2016",101,80,21,249962.485148515,2911.36633663366,88.6930693069307
"3432","13044","2016",46,36,10,277637.043478261,2751.47826086957,100.739130434783
"3433","13045","2016",42,41,1,257641.714285714,2345.88095238095,107.857142857143
"3434","13046","2016",24,20,4,321416.25,3714.91666666667,84.0416666666667
"3435","13047","2016",472,275,197,205425.802966102,2605.87288135593,80.5868644067797
"3436","13048","2016",35,30,5,259866.028571429,2677.25714285714,98.7142857142857
"3437","13049","2016",19,18,1,275833.684210526,3002.68421052632,93.4736842105263
"3438","13050","2016",92,65,27,306022.413043478,3141.88043478261,95.5652173913043
"3439","13051","2016",79,66,13,289630.367088608,3285.96202531646,88.1139240506329
"3440","13052","2016",24,21,3,296342.916666667,2731.125,97.4583333333333
"3441","13053","2016",69,45,24,248166.753623188,3027.72463768116,84.304347826087
"3442","13054","2016",361,160,201,195718.185595568,2608.82271468144,75.6315789473684
"3443","13055","2016",10164,1441,8723,176926.744785518,2613.10438803621,65.6651908697363
"3444","13056","2016",441,171,270,225785.342403628,3128.68027210884,75.2789115646258
"3445","13057","2016",4,4,0,323062.5,2636.75,126.5
"3446","13058","2016",32,29,3,438217.65625,4261.9375,100.1875
"3447","13059","2016",45,38,7,272724.511111111,2935.91111111111,96.5111111111111
"3448","13060","2016",36,31,5,430399.111111111,4013.97222222222,107.416666666667
"3449","13061","2016",2,2,0,193600,2390,82
"3450","13062","2016",33,32,1,417784.242424242,3723.72727272727,118.181818181818
"3451","13063","2016",177,113,64,187870.333333333,2308.8418079096,83.3107344632768
"3452","13064","2016",15,15,0,307287.666666667,2938.46666666667,103.133333333333
"3453","13065","2016",36,34,2,339189.694444444,3408.30555555556,101.75
"3454","13066","2016",6,6,0,358083.333333333,2821.16666666667,121.666666666667
"3455","13067","2016",13,12,1,231465.153846154,2434.38461538462,94.3076923076923
"3456","13068","2016",34,33,1,489669.705882353,3684.55882352941,126.323529411765
"3457","13069","2016",118,96,22,266150.677966102,3149.98305084746,86.2118644067797
"3458","13070","2016",79,45,34,264644.594936709,3431.3417721519,78.7088607594937
"3459","13071","2016",194,145,49,268750.180412371,3206.58762886598,86.4123711340206
"3460","13072","2016",36,24,12,293119.722222222,3657.94444444444,90.5833333333333
"3461","13073","2016",57,44,13,298902.649122807,3453.17543859649,90.719298245614
"3462","13074","2016",46,34,12,235932.956521739,2643.13043478261,86.2608695652174
"3463","13075","2016",125,63,62,258325.64,3253.384,79.232
"3464","13076","2016",27,23,4,211854.481481481,1905.92592592593,102.148148148148
"3465","13077","2016",131,76,55,170433.167938931,2300.3893129771,74.4427480916031
"3466","13078","2016",39,24,15,150624.871794872,2084.4358974359,74.3589743589744
"3467","13079","2016",18,16,2,421900,3756.33333333333,102.611111111111
"3468","13080","2016",47,39,8,328792.468085106,3438.29787234043,95.6382978723404
"3469","13081","2016",132,93,39,245280.477272727,2898.81818181818,86.6439393939394
"3470","13082","2016",37,30,7,403382.702702703,3545.48648648649,113.567567567568
"3471","13083","2016",22,22,0,248207.227272727,2604.31818181818,98.1818181818182
"3472","13084","2016",51,43,8,191013.529411765,2368.43137254902,82.9411764705882
"3473","13085","2016",55,35,20,319655.290909091,3629.96363636364,93.7818181818182
"3474","13086","2016",69,43,26,279206.304347826,3315.75362318841,86.4202898550725
"3475","13087","2016",44,30,14,284798.772727273,3499.27272727273,87
"3476","13088","2016",55,39,16,255525.527272727,3590.16363636364,75.4
"3477","13089","2016",23,21,2,261478.260869565,2530.91304347826,98.0869565217391
"3478","13090","2016",1,1,0,1763235,8816,200
"3479","13091","2016",68,60,8,367975.985294118,3555.22058823529,105.691176470588
"3480","13092","2016",86,49,37,207610.73255814,2505.6976744186,84.546511627907
"3481","13093","2016",5,5,0,332164,3222.8,102.2
"3482","13094","2016",24,22,2,342047.916666667,2993.04166666667,111.666666666667
"3483","13095","2016",7,5,2,703635.714285714,4412.71428571429,162.571428571429
"3484","13096","2016",78,25,53,178867.756410256,3531.0641025641,49.9358974358974
"3485","13097","2016",83,65,18,245551.397590361,2664.36144578313,94.7710843373494
"3486","13098","2016",78,70,8,281388.897435897,3155.16666666667,90.9230769230769
"3487","13099","2016",7,4,3,174142.857142857,2163,77.7142857142857
"3488","13100","2016",120,90,30,433714.558333333,3955.725,105.091666666667
"3489","13101","2016",34,21,13,265386.764705882,3406.32352941176,82.0588235294118
"3490","13102","2016",38,25,13,258209.421052632,3242.36842105263,78.5789473684211
"3491","13103","2016",534,195,339,187894.578651685,2480.39138576779,76.1367041198502
"3492","13104","2016",144,69,75,282798.604166667,5034.00694444444,60.1111111111111
"3493","13105","2016",41,35,6,217085.853658537,2481.73170731707,91.5365853658537
"3494","13106","2016",121,65,56,232888.760330579,3143.66115702479,77.1074380165289
"3495","13107","2016",56,43,13,335863.267857143,3588.01785714286,94.3035714285714
"3496","13108","2016",134,84,50,144136.104477612,1762.76119402985,82.6492537313433
"3497","13109","2016",30,21,9,570568.633333333,4004.86666666667,129.833333333333
"3498","13110","2016",131,95,36,253108.854961832,2995.26717557252,88.2824427480916
"3499","13111","2016",11,8,3,414849,4174.45454545455,101.818181818182
"3500","13112","2016",79,66,13,321994.64556962,3464.44303797468,94.5063291139241
"3501","13113","2016",85,53,32,316647.176470588,3564.23529411765,91.1882352941176
"3502","13114","2016",45,40,5,408512.533333333,3516.04444444444,122.6
"3503","13115","2016",17,17,0,292508.529411765,2622.23529411765,117.705882352941
"3504","13116","2016",12,12,0,284590,2348.91666666667,120.416666666667
"3505","13117","2016",346,182,164,219708.89017341,2805.60115606936,79.0549132947977
"3506","13118","2016",39,34,5,318839.153846154,3514.66666666667,93.5384615384615
"3507","13119","2016",81,49,32,321927.777777778,3483.58024691358,92.7037037037037
"3508","14001","2016",22,22,0,183743.181818182,1855.90909090909,100.5
"3509","14003","2016",3,3,0,196500,1550,124
"3510","14005","2016",19,19,0,243272.105263158,1707.78947368421,137.631578947368
"3511","14006","2016",8,8,0,216253.125,1902.25,129.125
"3512","14007","2016",2,2,0,176000,1302.5,142
"3513","14009","2016",26,25,1,211932.692307692,1970.76923076923,110.692307692308
"3514","14011","2016",21,21,0,148036.666666667,1759.09523809524,100.095238095238
"3515","14012","2016",3,3,0,209591.333333333,3061.66666666667,106.333333333333
"3516","14014","2016",14,14,0,241375,1815.57142857143,130.142857142857
"3517","14015","2016",7,7,0,201785.714285714,1912,101.428571428571
"3518","14016","2016",4,4,0,166070,1711.5,94.5
"3519","14019","2016",4,4,0,232287.5,1634.75,138
"3520","14020","2016",2,2,0,154250,1573.5,95
"3521","14021","2016",7,7,0,204500,2043.14285714286,99.7142857142857
"3522","14022","2016",13,12,1,158893.076923077,2605.92307692308,64.8461538461538
"3523","14023","2016",3,3,0,141333.333333333,1598.33333333333,91.6666666666667
"3524","14024","2016",6,5,1,191000,2155.83333333333,93.5
"3525","14025","2016",4,4,0,150900,1014.5,152.75
"3526","14026","2016",13,13,0,172381.538461538,1956.15384615385,90.8461538461538
"3527","14027","2016",48,46,2,112721.458333333,1199.04166666667,95.4375
"3528","14030","2016",15,15,0,268681.333333333,2255.8,120.533333333333
"3529","14032","2016",7,7,0,265871.428571429,1536,157.285714285714
"3530","14034","2016",8,8,0,214262.5,1759,121.375
"3531","14035","2016",14,14,0,104932.714285714,1010.35714285714,107.928571428571
"3532","14036","2016",2,2,0,143000,1801.5,71
"3533","14037","2016",6,6,0,136416.666666667,1614.33333333333,90.3333333333333
"3534","14038","2016",13,13,0,177738.461538462,1578.23076923077,111.692307692308
"3535","14039","2016",5,5,0,160950,1771.2,90.6
"3536","14040","2016",1,1,0,194700,1708,114
"3537","14041","2016",4,4,0,202500,1925.25,91
"3538","14042","2016",9,9,0,220455.777777778,2003.88888888889,111.111111111111
"3539","14044","2016",13,13,0,231538.461538462,1959.53846153846,119
"3540","14045","2016",5,5,0,123800,1623.4,80.4
"3541","14046","2016",25,24,1,198588,1826.16,111.36
"3542","14047","2016",181,89,92,155408.817679558,1738.25414364641,87.060773480663
"3543","14049","2016",1,1,0,132750,1562,85
"3544","14050","2016",1,1,0,107000,1338,80
"3545","14053","2016",3,3,0,140666.666666667,1991.66666666667,76.3333333333333
"3546","14054","2016",2,2,0,199250,1275,157
"3547","14055","2016",6,6,0,177250,1929.66666666667,91.5
"3548","14057","2016",14,14,0,169523.571428571,1786.64285714286,95.2857142857143
"3549","14059","2016",46,16,30,286888.586956522,3776.36956521739,71.5217391304348
"3550","14060","2016",21,21,0,261491.238095238,2232.2380952381,122.428571428571
"3551","14061","2016",83,82,1,110238.590361446,1071.87951807229,105.843373493976
"3552","14062","2016",4,4,0,193400,2314.25,85.75
"3553","14063","2016",2,2,0,68500,968,77.5
"3554","14064","2016",2,2,0,1e+05,1126.5,81.5
"3555","14066","2016",50,36,14,152504.62,2224.72,72.94
"3556","14068","2016",39,29,10,205527.153846154,2208.41025641026,91.8717948717949
"3557","14069","2016",14,11,3,113164.285714286,1284.64285714286,82.5714285714286
"3558","14070","2016",3,2,1,169533.333333333,2210.33333333333,83
"3559","14076","2016",60,44,16,172198.1,1988.43333333333,86.7333333333333
"3560","14077","2016",8,8,0,298187.5,2242.125,132.125
"3561","14078","2016",6,6,0,141583.333333333,1278.33333333333,110.833333333333
"3562","14079","2016",78,21,57,162728.58974359,2758.35897435897,58.0128205128205
"3563","14082","2016",5,5,0,201100,2791.6,101.4
"3564","14083","2016",6,6,0,255483.333333333,2182.66666666667,107.166666666667
"3565","14084","2016",1,1,0,275000,1599,172
"3566","14085","2016",14,13,1,151588.857142857,1533.5,102.5
"3567","14086","2016",7,7,0,609067.142857143,3448.71428571429,169.142857142857
"3568","14087","2016",1,1,0,50000,581,86
"3569","14088","2016",5,5,0,181400,1552,116.6
"3570","14089","2016",4,4,0,194500,1590,120.5
"3571","14090","2016",5,5,0,141140,1656,86.8
"3572","14091","2016",3,3,0,292666.666666667,3464,82.3333333333333
"3573","14092","2016",19,18,1,214947.736842105,2031.42105263158,107.157894736842
"3574","14093","2016",4,4,0,221000,1609.5,146.25
"3575","14096","2016",1,1,0,48668,608,80
"3576","14097","2016",2,2,0,172225,1117,198
"3577","14098","2016",44,42,2,164633.636363636,1755.56818181818,98.25
"3578","14100","2016",2,2,0,113750,1310.5,86.5
"3579","14101","2016",46,43,3,228142.826086957,2317.28260869565,99.1739130434783
"3580","14102","2016",11,11,0,232813.636363636,1798.54545454545,123.181818181818
"3581","14103","2016",3,3,0,132666.666666667,1303.66666666667,109.666666666667
"3582","14106","2016",7,7,0,196914.571428571,1984.85714285714,98.5714285714286
"3583","14107","2016",1,1,0,74500,2014,37
"3584","14110","2016",2,2,0,153111,1677,91.5
"3585","14111","2016",5,5,0,138960,1164.8,119
"3586","14116","2016",1,1,0,120000,750,160
"3587","14117","2016",397,77,320,143775.743073048,3051.68261964736,45.9395465994962
"3588","14118","2016",1821,315,1506,140960.424492037,2132.48544755629,66.9912136188907
"3589","14119","2016",13,13,0,175500,1634.92307692308,111.076923076923
"3590","14120","2016",15,15,0,139206.666666667,1459.13333333333,102.133333333333
"3591","14121","2016",5,5,0,176820,1304.2,143.6
"3592","14122","2016",1,1,0,19000,339,56
"3593","14123","2016",25,25,0,251574.2,2101.72,120.68
"3594","14124","2016",7,7,0,135000,1168.85714285714,110.714285714286
"3595","14125","2016",25,23,2,254376.36,2344.52,109.64
"3596","14126","2016",18,18,0,204255.555555556,1851.27777777778,118.722222222222
"3597","14127","2016",4,4,0,114850,1157.5,98.5
"3598","14130","2016",1,1,0,153300,1460,105
"3599","14131","2016",5,5,0,212400,1772.2,117.6
"3600","14132","2016",4,4,0,111212.5,931.75,118.75
"3601","14135","2016",2,2,0,225000,2556.5,87.5
"3602","14136","2016",1,1,0,158000,1681,94
"3603","14137","2016",22,21,1,182764.318181818,2053.72727272727,91.1818181818182
"3604","14138","2016",1,1,0,115000,767,150
"3605","14140","2016",3,3,0,109000,1033.33333333333,109.666666666667
"3606","14141","2016",3,3,0,211000,1666,126.666666666667
"3607","14143","2016",37,37,0,116625.297297297,1176.13513513514,105.297297297297
"3608","14145","2016",7,7,0,121700,1235,110.142857142857
"3609","14147","2016",2,2,0,67000,1034,65
"3610","14149","2016",10,10,0,127350,1413.5,91.7
"3611","14150","2016",7,7,0,126842.142857143,1197.85714285714,100.285714285714
"3612","14160","2016",1,1,0,90000,968,93
"3613","14161","2016",1,1,0,234125,1510,155
"3614","14162","2016",28,28,0,115693.785714286,1323,91.2857142857143
"3615","14163","2016",4,4,0,195250,1328.25,149.25
"3616","14165","2016",4,4,0,121550,1005.25,104.75
"3617","14166","2016",43,40,3,221543.651162791,2483.95348837209,92
"3618","14167","2016",32,25,7,169352.6875,2132.6875,83.25
"3619","14168","2016",2,2,0,137000,1370,108.5
"3620","14169","2016",3,3,0,154333.333333333,1206.33333333333,123.333333333333
"3621","14171","2016",3,3,0,172963.333333333,1792,113.666666666667
"3622","14172","2016",7,7,0,181071.428571429,1395,137.428571428571
"3623","14173","2016",7,7,0,133691.428571429,1481.57142857143,95.8571428571429
"3624","14174","2016",45,39,6,82791.1111111111,883.444444444444,94.2666666666667
"3625","14175","2016",4,4,0,193362.5,1779.5,108.25
"3626","14177","2016",9,9,0,142032.777777778,1591.11111111111,87
"3627","14181","2016",38,26,12,154437.052631579,1776.31578947368,88.5
"3628","14182","2016",11,11,0,114463.636363636,997.272727272727,118.090909090909
"3629","14183","2016",4,4,0,68000,829.5,81.25
"3630","14190","2016",1,1,0,47000,1880,25
"3631","14191","2016",182,56,126,110193.148351648,2273.23626373626,49.0659340659341
"3632","14193","2016",6,6,0,168333.333333333,2115.5,95.3333333333333
"3633","14194","2016",11,11,0,128718.181818182,1325.27272727273,106.363636363636
"3634","14195","2016",2,2,0,147500,1090.5,141
"3635","14196","2016",2,2,0,97500,997.5,97
"3636","14197","2016",7,7,0,301260.714285714,2521.28571428571,121
"3637","14198","2016",1,1,0,138000,1704,81
"3638","14200","2016",19,19,0,168873.684210526,1647.15789473684,102.105263157895
"3639","14202","2016",4,4,0,311850,3749.25,88.75
"3640","14204","2016",1,1,0,65000,1083,60
"3641","14206","2016",4,4,0,109500,904.5,116.5
"3642","14207","2016",4,4,0,192767.5,1544.75,126.5
"3643","14209","2016",5,5,0,147750,1572.4,97
"3644","14211","2016",4,4,0,168025,1896.75,89.5
"3645","14214","2016",1,1,0,52500,700,75
"3646","14215","2016",23,23,0,170108.695652174,1861.17391304348,93.7826086956522
"3647","14216","2016",2,2,0,85000,1528,62
"3648","14218","2016",1,1,0,430000,3583,120
"3649","14220","2016",232,45,187,288788.784482759,4331.95689655172,65.2887931034483
"3650","14221","2016",29,29,0,202120,2214.65517241379,96.6896551724138
"3651","14224","2016",1,1,0,138500,1489,93
"3652","14225","2016",90,65,25,155764.044444444,2619.62222222222,64.6111111111111
"3653","14226","2016",3,3,0,151666.666666667,1325.66666666667,128
"3654","14227","2016",1,1,0,136950,1929,71
"3655","14228","2016",65,54,11,221832.107692308,2077.44615384615,106.061538461538
"3656","14229","2016",39,39,0,127124.051282051,1527.5641025641,84.9230769230769
"3657","14231","2016",10,10,0,159690.6,2049.6,86.2
"3658","14232","2016",6,6,0,198966.666666667,1444.83333333333,136.666666666667
"3659","14236","2016",2,2,0,185740,1808.5,104
"3660","14237","2016",7,7,0,200785.714285714,1737.14285714286,122
"3661","14238","2016",2,2,0,678825,3437,190
"3662","14240","2016",6,6,0,114833.333333333,1481.33333333333,81.5
"3663","14241","2016",5,5,0,174982.6,1559.6,108
"3664","14242","2016",18,16,2,215910.444444444,2303.66666666667,97.2222222222222
"3665","14243","2016",13,11,2,263215.384615385,2297.84615384615,118.923076923077
"3666","14244","2016",5,5,0,211000,1426.8,145.2
"3667","14245","2016",2,2,0,102000,944.5,108
"3668","14246","2016",7,7,0,184664.714285714,2278.85714285714,86.8571428571429
"3669","14248","2016",3,3,0,147500,1493.66666666667,108
"3670","14249","2016",17,16,1,181941.470588235,1798.47058823529,107.352941176471
"3671","14250","2016",6,6,0,167635.833333333,1451.83333333333,117.333333333333
"3672","14251","2016",5,5,0,127520,1458.4,90
"3673","14252","2016",2,2,0,130000,1092.5,118
"3674","14254","2016",12,11,1,226426,2165.41666666667,108.666666666667
"3675","14256","2016",4,4,0,168550,1723,98.5
"3676","14257","2016",15,15,0,204560,1760.06666666667,121.133333333333
"3677","14260","2016",5,5,0,198562,1897.6,101.4
"3678","14261","2016",3,3,0,346808.333333333,1709,188.333333333333
"3679","14266","2016",12,12,0,216250,2147.08333333333,106.75
"3680","14269","2016",2,2,0,272500,1919,151.5
"3681","14270","2016",3,3,0,125716.666666667,1359.66666666667,105
"3682","14271","2016",45,42,3,221249.777777778,1990.97777777778,113.088888888889
"3683","14272","2016",1,1,0,45000,763,59
"3684","14273","2016",1,1,0,195000,1083,180
"3685","14274","2016",24,24,0,214140.208333333,2083.25,103.583333333333
"3686","14275","2016",6,6,0,198866.666666667,1901.5,107
"3687","14276","2016",3,3,0,126000,1480.33333333333,83
"3688","14277","2016",25,24,1,179998,1856.32,96.32
"3689","14278","2016",13,13,0,185137.076923077,1749.76923076923,116.615384615385
"3690","14280","2016",2,2,0,2e+05,1722,121.5
"3691","14281","2016",7,7,0,136925.714285714,1578.57142857143,117
"3692","14282","2016",2,2,0,68850,1111,67
"3693","14283","2016",2,2,0,147500,1139,129.5
"3694","14284","2016",1,1,0,20000,370,54
"3695","14285","2016",1,1,0,330000,2050,161
"3696","14286","2016",5,5,0,237638,2269.8,105.6
"3697","14287","2016",19,19,0,176326.315789474,1895.94736842105,97.6315789473684
"3698","14288","2016",11,11,0,230984.727272727,1664.09090909091,149.181818181818
"3699","14289","2016",4,4,0,131125,1414.25,93.75
"3700","14290","2016",13,13,0,174280.769230769,1670,103.538461538462
"3701","14291","2016",3,3,0,75473.3333333333,630,119.333333333333
"3702","14293","2016",4,4,0,140000,1485.5,94.5
"3703","14297","2016",4,4,0,202250,1886.5,111.75
"3704","14299","2016",12,12,0,244250,2312.25,106.083333333333
"3705","14300","2016",2,2,0,573709,2712.5,184
"3706","14301","2016",35,34,1,175674.285714286,2063.82857142857,91.4857142857143
"3707","14302","2016",2,2,0,455000,4568,105.5
"3708","14303","2016",9,9,0,185288.888888889,1710.11111111111,110.222222222222
"3709","14304","2016",13,13,0,326007.692307692,2192.61538461538,138.538461538462
"3710","14305","2016",18,18,0,333609.722222222,2455.66666666667,133.833333333333
"3711","14306","2016",4,4,0,222750,2430.25,95.75
"3712","14308","2016",1,1,0,25000,385,65
"3713","14309","2016",9,8,1,118888.888888889,1600.33333333333,72.4444444444444
"3714","14310","2016",10,10,0,143690,1446.9,103.1
"3715","14311","2016",11,11,0,142513.636363636,1698.18181818182,93
"3716","14312","2016",66,46,20,93928.8333333333,1471.36363636364,61.1515151515151
"3717","14316","2016",5,5,0,211200,2006.6,111.2
"3718","14318","2016",9,9,0,176366.666666667,1899,96.5555555555556
"3719","14319","2016",4,4,0,178750,2021.5,88.75
"3720","14320","2016",3,3,0,136833.333333333,1474.33333333333,92.6666666666667
"3721","14322","2016",3,3,0,161466.666666667,1218,146.666666666667
"3722","14325","2016",52,45,7,191462.5,2219.88461538462,85.2307692307692
"3723","14326","2016",5,5,0,171580,1756.4,116
"3724","14327","2016",191,67,124,122819.544502618,1705.32984293194,71.3507853403141
"3725","14328","2016",13,13,0,215884.615384615,2103.15384615385,110.615384615385
"3726","14329","2016",1,1,0,220000,1833,120
"3727","14332","2016",5,5,0,110000,1204.6,90.8
"3728","14333","2016",161,83,78,177154.577639752,2410.73913043478,74.1801242236025
"3729","14334","2016",5,5,0,176740,1825.8,98.8
"3730","14335","2016",5,5,0,232314,1862.4,121.4
"3731","14336","2016",4,4,0,148875,1246.5,131.25
"3732","14337","2016",6,6,0,341521.5,1794.66666666667,156
"3733","14338","2016",146,62,84,169914.726027397,2804.57534246575,60.7808219178082
"3734","14341","2016",119,83,36,158096.74789916,1804.17647058824,88.8067226890756
"3735","14342","2016",30,28,2,104666.666666667,1082.46666666667,99.4
"3736","14343","2016",1,1,0,65000,520,125
"3737","14344","2016",7,7,0,214785.714285714,1869.57142857143,121.428571428571
"3738","14345","2016",6,6,0,114666.666666667,1353.66666666667,110.5
"3739","14346","2016",10,10,0,174934.2,1388.1,124.6
"3740","14347","2016",7,7,0,101000,890.714285714286,111.142857142857
"3741","14349","2016",17,17,0,205727.058823529,2058.35294117647,104.705882352941
"3742","14352","2016",9,9,0,91277.7777777778,899.666666666667,104.777777777778
"3743","14353","2016",9,9,0,143284.888888889,1248.33333333333,117.777777777778
"3744","14354","2016",32,26,6,156745.5,2334.4375,70.71875
"3745","14355","2016",16,16,0,170731.25,1655,108.625
"3746","14357","2016",7,7,0,88760.4285714286,879.285714285714,100.714285714286
"3747","14358","2016",1,1,0,79000,1519,52
"3748","14360","2016",1,1,0,52000,743,70
"3749","14362","2016",2,2,0,163700,1435.5,119
"3750","14364","2016",6,6,0,136333.333333333,1501.66666666667,103
"3751","14365","2016",57,44,13,176563.614035088,2345.54385964912,79.0350877192982
"3752","14366","2016",255,113,142,106407.101960784,1372.9137254902,77.6509803921569
"3753","14367","2016",3,3,0,90000,1081,85.6666666666667
"3754","14368","2016",4,4,0,162500,1792.75,100.25
"3755","14369","2016",2,2,0,79000,762,103.5
"3756","14370","2016",23,23,0,122902.608695652,1446.69565217391,87.6521739130435
"3757","14371","2016",59,59,0,145275.881355932,1409.38983050847,103.372881355932
"3758","14374","2016",3,3,0,100666.666666667,1225.33333333333,96
"3759","14375","2016",3,3,0,121666.666666667,1553.33333333333,80.3333333333333
"3760","14377","2016",5,5,0,202442,1721.6,112.2
"3761","14378","2016",7,7,0,115642.857142857,1000.28571428571,121.428571428571
"3762","14379","2016",7,7,0,138928.571428571,1371.57142857143,100.571428571429
"3763","14380","2016",3,3,0,192100,1584.66666666667,121.666666666667
"3764","14381","2016",1,1,0,70000,412,170
"3765","14383","2016",27,23,4,188211.037037037,2245.74074074074,85.8888888888889
"3766","14384","2016",69,41,28,163667.391304348,2241.28985507246,74
"3767","14385","2016",3,3,0,195333.333333333,1568,129.666666666667
"3768","14390","2016",1,1,0,178000,1935,92
"3769","14391","2016",5,5,0,168860,1684.2,99.2
"3770","14393","2016",3,3,0,142000,1572.66666666667,102.333333333333
"3771","14394","2016",4,4,0,117750,1228.5,97.75
"3772","14396","2016",12,12,0,214915.833333333,1974.58333333333,109.75
"3773","14397","2016",4,4,0,165500,1432.75,117.25
"3774","14398","2016",2,2,0,173000,1740.5,101.5
"3775","14399","2016",3,3,0,230576.666666667,2553.33333333333,98
"3776","14402","2016",1,1,0,61000,1173,52
"3777","14403","2016",7,7,0,177085.714285714,1348.14285714286,127.428571428571
"3778","14405","2016",1,1,0,65250,502,130
"3779","14406","2016",5,5,0,267245,1633.4,160.4
"3780","14407","2016",26,24,2,299844.615384615,2177.23076923077,139.076923076923
"3781","14408","2016",14,12,2,145342.142857143,1794,90.7857142857143
"3782","14409","2016",84,48,36,157846.071428571,2772.96428571429,58.3333333333333
"3783","14410","2016",14,14,0,165818.428571429,1538.92857142857,109.785714285714
"3784","14419","2016",6,6,0,200666.666666667,1582.16666666667,134
"3785","14421","2016",10,10,0,152268.6,1436.5,119.1
"3786","14424","2016",2,2,0,136000,888,155
"3787","14425","2016",3,3,0,158333.333333333,1434.66666666667,115.333333333333
"3788","14426","2016",1,1,0,282900,1347,210
"3789","14427","2016",7,7,0,79800,934.571428571429,87.7142857142857
"3790","14430","2016",2,2,0,262500,1498,179.5
"3791","14431","2016",68,68,0,133662.794117647,1381.47058823529,98.5147058823529
"3792","14435","2016",2,2,0,141500,1589.5,88.5
"3793","14436","2016",10,10,0,169500,1372.3,124.5
"3794","14437","2016",59,38,21,135664.983050847,1954.06779661017,71.4745762711864
"3795","14438","2016",8,8,0,184797.5,1533.625,131
"3796","14439","2016",1,1,0,40000,952,42
"3797","14445","2016",1,1,0,156000,1857,84
"3798","14446","2016",1,1,0,1e+05,690,145
"3799","14449","2016",4,4,0,226250,1593.25,145.25
"3800","14452","2016",4,4,0,112250,1185,96.75
"3801","14453","2016",2,2,0,179650,1674,111.5
"3802","14454","2016",14,14,0,197390,1875.07142857143,116.214285714286
"3803","14455","2016",4,4,0,139000,1276,110.5
"3804","14456","2016",14,14,0,199045.071428571,1905.07142857143,110.714285714286
"3805","14457","2016",3,3,0,128744,1030,120.333333333333
"3806","14458","2016",6,6,0,143000,1251.83333333333,119
"3807","14460","2016",18,18,0,174027.777777778,1615.16666666667,111.277777777778
"3808","14461","2016",3,3,0,160833.333333333,1346.33333333333,121
"3809","14465","2016",8,8,0,208231.25,1695.375,125.75
"3810","14466","2016",2,2,0,320000,2369,130
"3811","14467","2016",2,2,0,162500,1464,120.5
"3812","14468","2016",2,2,0,166000,1339,124
"3813","14473","2016",1,1,0,145000,1559,93
"3814","14474","2016",3,3,0,333000,2386.33333333333,126
"3815","14475","2016",24,24,0,163185.166666667,1607.75,107.5
"3816","14476","2016",3,3,0,144433.333333333,1749,101
"3817","14478","2016",22,19,3,72522.7272727273,1003.18181818182,76.3181818181818
"3818","14480","2016",5,5,0,133400,1394.8,99.6
"3819","14482","2016",1,1,0,180000,1406,128
"3820","14483","2016",1,1,0,1e+05,893,112
"3821","14484","2016",4,4,0,232500,2148.5,106.5
"3822","14486","2016",6,6,0,169183.333333333,1519,109.666666666667
"3823","14487","2016",7,7,0,140892.857142857,1769.57142857143,89.2857142857143
"3824","14488","2016",213,122,91,185979.464788732,2645,72.4460093896714
"3825","14491","2016",2,2,0,231500,1353,184
"3826","14492","2016",2,2,0,229500,3464,69.5
"3827","14494","2016",1,1,0,43451,2173,20
"3828","14495","2016",4,4,0,421517.5,2361.5,173
"3829","14497","2016",5,5,0,96200,846,109.2
"3830","14499","2016",4,4,0,208402.5,2163.75,99.5
"3831","14500","2016",6,6,0,411333.333333333,3231.5,116.166666666667
"3832","14501","2016",7,4,3,67071.4285714286,1089,81.1428571428571
"3833","14502","2016",1,1,0,68000,829,82
"3834","14504","2016",8,8,0,228125,1965.875,110
"3835","14506","2016",4,4,0,96375,914.75,107.5
"3836","14509","2016",1,1,0,250000,2101,119
"3837","14510","2016",2,2,0,661500,3068,139
"3838","14514","2016",52,41,11,211658.961538462,2060.94230769231,105.153846153846
"3839","14515","2016",26,20,6,151069.230769231,1717.73076923077,85.4615384615385
"3840","14516","2016",25,25,0,106786,1552.04,72.92
"3841","14519","2016",2,2,0,162500,1039,166.5
"3842","14520","2016",8,8,0,161487.5,1481.5,110.25
"3843","14522","2016",4,4,0,199082.5,1503.25,145
"3844","14524","2016",3,3,0,146833.333333333,2044.33333333333,74.3333333333333
"3845","14527","2016",3,3,0,125000,1172,109.333333333333
"3846","14528","2016",3,3,0,167000,1859.66666666667,91
"3847","14529","2016",2,2,0,220600,1653,161
"3848","14530","2016",17,17,0,187034.235294118,1912.35294117647,98.8823529411765
"3849","14534","2016",5,5,0,426270,3498.6,112
"3850","14535","2016",4,4,0,231600,1928.25,118.5
"3851","14538","2016",14,14,0,206146.428571429,1997.85714285714,105.714285714286
"3852","14540","2016",4,4,0,306650,2416,135
"3853","14542","2016",4,4,0,272250,1752.75,156.75
"3854","14543","2016",24,23,1,217470.666666667,1991.29166666667,109.666666666667
"3855","14546","2016",3,3,0,149683.333333333,1041.66666666667,145.333333333333
"3856","14550","2016",3,3,0,182166.666666667,1954.33333333333,93
"3857","14552","2016",5,5,0,115500,910.8,138.6
"3858","14554","2016",5,5,0,201288.6,2304.2,95.2
"3859","14555","2016",6,5,1,134066.666666667,1873.83333333333,70.3333333333333
"3860","14556","2016",11,11,0,203036.363636364,2167.54545454545,95.4545454545455
"3861","14557","2016",22,13,9,224863.636363636,2764.18181818182,87.9090909090909
"3862","14558","2016",11,11,0,213318.181818182,2107.27272727273,106.454545454545
"3863","14559","2016",5,5,0,97300,1013.8,98.4
"3864","14562","2016",77,52,25,177090.909090909,2308.45454545455,77.4545454545455
"3865","14563","2016",4,4,0,254200,1755.25,145.25
"3866","14565","2016",8,8,0,155875,2055.375,110.875
"3867","14566","2016",23,22,1,250261.52173913,2098.78260869565,116.173913043478
"3868","14569","2016",5,5,0,204930,1520.8,136
"3869","14570","2016",29,29,0,123803.448275862,1225.31034482759,105.48275862069
"3870","14571","2016",6,6,0,180650,1674.66666666667,109.666666666667
"3871","14572","2016",8,8,0,93493.75,1106.625,89.625
"3872","14574","2016",18,18,0,197675,1700.77777777778,119.666666666667
"3873","14575","2016",5,5,0,345222,2543.4,142.2
"3874","14576","2016",5,5,0,116000,1284,86.6
"3875","14578","2016",18,18,0,253463.944444444,2597.44444444444,101
"3876","14579","2016",6,6,0,174500,1347.33333333333,139
"3877","14582","2016",7,7,0,129357.142857143,1155.57142857143,111.428571428571
"3878","14586","2016",3,3,0,97666.6666666667,1514,86.6666666666667
"3879","14587","2016",13,13,0,183269.230769231,1804.30769230769,100.846153846154
"3880","14588","2016",4,4,0,167572.5,1526.75,126.25
"3881","14589","2016",14,14,0,106936.428571429,1609.57142857143,73
"3882","14591","2016",8,8,0,187630,1677.5,120.125
"3883","14592","2016",10,10,0,194810,1556.2,121.8
"3884","14593","2016",13,13,0,291080.846153846,2086.69230769231,138.846153846154
"3885","14598","2016",2,2,0,182500,1734.5,103.5
"3886","14601","2016",3,3,0,142440,1549,113.333333333333
"3887","14602","2016",7,7,0,122364.285714286,1056.57142857143,118.857142857143
"3888","14603","2016",6,6,0,148200,1316.16666666667,113.333333333333
"3889","14605","2016",4,4,0,257425,2260.25,104.25
"3890","14606","2016",1,1,0,180000,2250,80
"3891","14607","2016",1,1,0,145000,2101,69
"3892","14609","2016",6,6,0,191916.666666667,1507.66666666667,123.833333333333
"3893","14610","2016",21,20,1,197162.857142857,1895.38095238095,110.333333333333
"3894","14614","2016",7,7,0,85500,1060.57142857143,86.8571428571429
"3895","14619","2016",3,3,0,46933.3333333333,615.666666666667,77
"3896","14620","2016",3,3,0,151106.666666667,1918.66666666667,76.6666666666667
"3897","14621","2016",3,3,0,87700,1096.66666666667,81
"3898","14622","2016",3,3,0,146666.666666667,1111,129.333333333333
"3899","14623","2016",27,27,0,181211.555555556,1789.07407407407,101.962962962963
"3900","14625","2016",5,5,0,237200,2200,100.2
"3901","14626","2016",8,8,0,144312.5,1291.75,112.875
"3902","14627","2016",4,4,0,116975,1364.75,86.75
"3903","14630","2016",5,5,0,210760,1811.6,126
"3904","14635","2016",4,4,0,108250,1603.25,70.5
"3905","14637","2016",1,1,0,70000,673,104
"3906","14639","2016",2,2,0,148750,2161,70.5
"3907","14640","2016",1,1,0,123500,1342,92
"3908","14643","2016",18,18,0,156557.166666667,1466.16666666667,117.611111111111
"3909","14644","2016",10,10,0,218687,1707.2,141.7
"3910","14645","2016",3,3,0,452416.666666667,2935.33333333333,174.333333333333
"3911","14646","2016",6,6,0,145389.166666667,1249,116.833333333333
"3912","14648","2016",3,3,0,157666.666666667,1361,108
"3913","14649","2016",1,1,0,154000,1711,90
"3914","14650","2016",1,1,0,157000,981,160
"3915","14651","2016",2,2,0,120000,882,119
"3916","14654","2016",70,70,0,137078.771428571,1392.28571428571,101.471428571429
"3917","14656","2016",9,9,0,88586.1111111111,1430.11111111111,59.8888888888889
"3918","14657","2016",4,4,0,206625,2088,109.75
"3919","14658","2016",51,50,1,89215.3137254902,1003.86274509804,91.4901960784314
"3920","14659","2016",11,11,0,168780,1559.81818181818,114.272727272727
"3921","14660","2016",1,1,0,50691,1536,33
"3922","14661","2016",1,1,0,189000,1673,113
"3923","14663","2016",32,29,3,179021.28125,1858.84375,98.78125
"3924","14664","2016",1,1,0,96000,681,141
"3925","14665","2016",1,1,0,266500,2401,111
"3926","14666","2016",13,12,1,148846.153846154,1761.07692307692,87.3846153846154
"3927","14667","2016",1,1,0,62500,1603,39
"3928","14668","2016",1,1,0,214000,1497,143
"3929","14669","2016",1,1,0,105000,1167,90
"3930","14672","2016",6,6,0,142733.333333333,1371.66666666667,97.1666666666667
"3931","14674","2016",1,1,0,145000,1142,127
"3932","14675","2016",18,18,0,174878.777777778,1719.44444444444,104.111111111111
"3933","14676","2016",16,16,0,154404.6875,1517.75,105.625
"3934","14678","2016",3,3,0,166333.333333333,1401.33333333333,119.666666666667
"3935","14679","2016",10,10,0,173750,1662.9,109.8
"3936","14680","2016",2,2,0,166875,1807,96.5
"3937","14681","2016",2,2,0,105000,2305,72.5
"3938","14682","2016",5,5,0,256400,1920.6,128.6
"3939","14684","2016",1,1,0,180000,1277,141
"3940","14685","2016",25,24,1,218395.24,1770.72,124.32
"3941","14687","2016",1,1,0,207000,1683,123
"3942","14689","2016",38,38,0,122715.710526316,1321.42105263158,96.9736842105263
"3943","14692","2016",15,15,0,169766.666666667,1636.93333333333,106.333333333333
"3944","14694","2016",8,8,0,253568.75,2736.375,100.75
"3945","14698","2016",4,4,0,197500,1771.25,132.25
"3946","14699","2016",76,44,32,177272.381578947,2586.64473684211,70.1184210526316
"3947","14700","2016",4,4,0,144250,1784.25,79.5
"3948","14701","2016",62,14,48,276311.580645161,3788.24193548387,77.3387096774194
"3949","14705","2016",1,1,0,94000,1492,63
"3950","14706","2016",1,1,0,270000,1875,144
"3951","14707","2016",11,11,0,188385.454545455,1853.90909090909,102.727272727273
"3952","14708","2016",4,4,0,122875,1914.5,76.25
"3953","14709","2016",7,7,0,198142.857142857,1636.57142857143,117.571428571429
"3954","14710","2016",3,3,0,140232,1028,163.666666666667
"3955","14711","2016",10,10,0,127155,1505.9,86
"3956","14712","2016",31,30,1,163170.322580645,1718.25806451613,97.6774193548387
"3957","14713","2016",3,3,0,120666.666666667,1929,73
"3958","14714","2016",11,11,0,118042.727272727,1087.81818181818,110.272727272727
"3959","14715","2016",306,96,210,207896.810457516,3573.90196078431,61.9542483660131
"3960","14716","2016",3,3,0,142325.333333333,1210.66666666667,115.666666666667
"3961","14719","2016",7,6,1,152444.285714286,1845,85
"3962","14720","2016",5,5,0,119600,1163.6,106.6
"3963","14721","2016",5,5,0,218200,1717.4,130.8
"3964","14723","2016",2,2,0,97400,1235.5,85
"3965","14724","2016",45,24,21,224709,3086.4,78.9777777777778
"3966","14726","2016",61,60,1,89321.7213114754,907.55737704918,97.7049180327869
"3967","14728","2016",3,3,0,115666.666666667,821.333333333333,125.333333333333
"3968","14731","2016",3,3,0,485666.666666667,2937,149.333333333333
"3969","14732","2016",2,2,0,120500,973.5,109
"3970","14733","2016",4,4,0,153750,1147.75,139.5
"3971","14734","2016",4,4,0,174002.5,1470,118
"3972","14735","2016",9,9,0,107777.777777778,1275.11111111111,87.2222222222222
"3973","14737","2016",4,4,0,222412.5,1704.75,128.25
"3974","14738","2016",57,50,7,190023.315789474,2022.61403508772,96.4736842105263
"3975","14739","2016",32,31,1,173668.125,1949.1875,90.9375
"3976","14740","2016",9,9,0,128222.222222222,1264.22222222222,99.2222222222222
"3977","14741","2016",4,4,0,70200,1017,60.5
"3978","14742","2016",1,1,0,256500,2882,89
"3979","14745","2016",6,4,2,137700.833333333,1569.83333333333,78.8333333333333
"3980","14747","2016",8,8,0,221320,1928.125,120.375
"3981","14748","2016",2,2,0,173060,1918,90
"3982","14751","2016",2,2,0,142000,1418.5,98.5
"3983","14753","2016",8,8,0,177993.75,1436.5,126.625
"3984","14754","2016",280,37,243,119565.014285714,2850.70357142857,40.9464285714286
"3985","14755","2016",21,18,3,207591.666666667,2590.09523809524,86.2857142857143
"3986","14756","2016",2,2,0,102480,1119,90
"3987","14758","2016",7,7,0,297000,1917.71428571429,154
"3988","14759","2016",3,3,0,251200,1816.66666666667,130.333333333333
"3989","14760","2016",5,5,0,110840,1030,97.8
"3990","14761","2016",6,6,0,198300,1894.16666666667,107.5
"3991","14762","2016",191,139,52,111928.083769634,1255.64921465969,93.4607329842932
"3992","14764","2016",17,17,0,87070.5882352941,1132.88235294118,77.4117647058823
"3993","15001","2016",14,12,2,71278.5714285714,801.142857142857,86.1428571428571
"3994","15002","2016",1,1,0,22000,367,60
"3995","15003","2016",6,6,0,92200,1535.5,67.1666666666667
"3996","15004","2016",3,3,0,192166.666666667,1690.66666666667,110.333333333333
"3997","15005","2016",1,1,0,182800,1693,108
"3998","15006","2016",2,2,0,108750,1263,87
"3999","15007","2016",1,1,0,180000,1017,177
"4000","15008","2016",2,2,0,32500,588,52
"4001","15009","2016",3,3,0,77333.3333333333,627,130
"4002","15010","2016",2,1,1,71500,1041,68
"4003","15011","2016",2,2,0,33750,684.5,48
"4004","15012","2016",55,41,14,129542.109090909,1409.87272727273,92.3636363636364
"4005","15013","2016",2,2,0,126375,885,137
"4006","15014","2016",405,104,301,97018.2345679012,1228.94320987654,76.1506172839506
"4007","15015","2016",2,2,0,76500,794.5,99.5
"4008","15016","2016",6,6,0,159333.333333333,1093.83333333333,144.5
"4009","15017","2016",2,2,0,84950,1164.5,79
"4010","15018","2016",1,1,0,122000,1017,120
"4011","15019","2016",4,4,0,80250,956,83.75
"4012","15020","2016",5,5,0,94666.8,1308.6,78.4
"4013","15021","2016",8,8,0,91820,1103.125,83
"4014","15022","2016",2,2,0,90800,1154,78
"4015","15025","2016",1,0,1,112000,1806,62
"4016","15026","2016",1,1,0,1e+05,1250,80
"4017","15027","2016",9,9,0,103466.666666667,1052.55555555556,104.888888888889
"4018","15028","2016",2,2,0,121000,1643,65
"4019","15030","2016",3,3,0,74353.3333333333,782.333333333333,95
"4020","15034","2016",3,3,0,105250,1263.66666666667,103.333333333333
"4021","15036","2016",2,2,0,189200,3493.5,74
"4022","15037","2016",6,6,0,103611,946.833333333333,114.5
"4023","15038","2016",11,11,0,83636.3636363636,934.545454545455,89.1818181818182
"4024","15041","2016",1,1,0,125000,940,133
"4025","15042","2016",2,2,0,66625,743.5,91
"4026","15045","2016",10,9,1,63720,1085.8,60.7
"4027","15046","2016",3,3,0,108250,1003,104.333333333333
"4028","15049","2016",3,3,0,108666.666666667,1843.33333333333,66.3333333333333
"4029","15050","2016",1,1,0,48000,738,65
"4030","15051","2016",1,1,0,68000,618,110
"4031","15052","2016",2,2,0,117500,940,127
"4032","15053","2016",2,2,0,81500,1307.5,73.5
"4033","15054","2016",9,7,2,84794.4444444444,978.333333333333,89.7777777777778
"4034","15055","2016",2,2,0,179500,1071,173
"4035","15056","2016",5,5,0,131750,1429.8,92.4
"4036","15057","2016",2,2,0,50000,567,89
"4037","15058","2016",1,1,0,1e+05,833,120
"4038","15060","2016",2,2,0,90000,1391.5,83
"4039","15061","2016",2,2,0,65750,457,142.5
"4040","15063","2016",6,6,0,55068.3333333333,931.833333333333,76.6666666666667
"4041","15066","2016",4,2,2,79030,1135,95.25
"4042","15067","2016",3,3,0,80066.6666666667,707.333333333333,112
"4043","15069","2016",4,4,0,98086.25,982,99.75
"4044","15070","2016",3,3,0,84000,791,98.3333333333333
"4045","15072","2016",1,1,0,115000,983,117
"4046","15074","2016",4,4,0,117250,1306,93.25
"4047","15075","2016",1,1,0,140000,1400,100
"4048","15076","2016",1,1,0,89270,1144,78
"4049","15077","2016",1,1,0,50000,595,84
"4050","15079","2016",1,1,0,65000,878,74
"4051","15080","2016",1,1,0,194500,940,207
"4052","15081","2016",2,2,0,42500,601,65.5
"4053","15082","2016",3,3,0,88833.3333333333,1241.66666666667,68.3333333333333
"4054","15083","2016",17,17,0,136557.294117647,1406.82352941176,99.2352941176471
"4055","15084","2016",2,2,0,83750,1369,66.5
"4056","15085","2016",6,6,0,135443.333333333,1208.5,115.5
"4057","15087","2016",1,1,0,70000,654,107
"4058","15088","2016",10,10,0,121166,1092.5,108.5
"4059","15089","2016",1,1,0,94000,1119,84
"4060","15090","2016",4,4,0,118250,1107,117.25
"4061","15091","2016",1,1,0,49153,451,109
"4062","15092","2016",13,13,0,98301.9230769231,1091,93.2307692307692
"4063","15093","2016",1,1,0,34000,680,50
"4064","15094","2016",9,8,1,103476.666666667,1069.77777777778,103.777777777778
"4065","15095","2016",4,4,0,154700,1164,133.5
"4066","15096","2016",3,3,0,155000,1822.33333333333,95.6666666666667
"4067","15097","2016",1,0,1,22000,629,35
"4068","15098","2016",1,1,0,46500,505,92
"4069","15100","2016",1,1,0,161200,2178,74
"4070","15101","2016",33,4,29,77313.9393939394,2184.51515151515,37.7878787878788
"4071","15103","2016",1,1,0,115000,1716,67
"4072","15104","2016",2,1,1,53500,907,65
"4073","15107","2016",2,2,0,45000,546.5,82
"4074","15108","2016",9,8,1,130345.555555556,1282.66666666667,112
"4075","15110","2016",1,1,0,36500,480,76
"4076","15111","2016",3,3,0,73666.6666666667,663,106.666666666667
"4077","15113","2016",7,7,0,93328.5714285714,1046.28571428571,88.5714285714286
"4078","15114","2016",5,5,0,160083.8,1383.6,128.2
"4079","15116","2016",3,3,0,124666.666666667,852.333333333333,153.333333333333
"4080","15117","2016",5,5,0,109000,995.2,113.4
"4081","15118","2016",3,2,1,92333.3333333333,1169.33333333333,79
"4082","15119","2016",21,16,5,103172.380952381,1165.28571428571,86.8095238095238
"4083","15120","2016",29,18,11,95158.6206896552,1143.20689655172,86.5862068965517
"4084","15121","2016",2,2,0,280886,1051,229
"4085","15122","2016",12,11,1,119454.166666667,1289.58333333333,98.5
"4086","15123","2016",2,2,0,86500,939,84.5
"4087","15124","2016",3,3,0,57433.3333333333,789.666666666667,75.6666666666667
"4088","15126","2016",2,2,0,47500,457.5,115
"4089","15127","2016",4,4,0,63250,1258.25,54.25
"4090","15129","2016",1,1,0,42000,955,44
"4091","15130","2016",1,1,0,62000,689,90
"4092","15131","2016",2,2,0,86500,773.5,113
"4093","15133","2016",2,2,0,52550,693.5,92.5
"4094","15134","2016",11,9,2,94132.2727272727,1296.09090909091,89.8181818181818
"4095","15135","2016",2,2,0,98500,1370,82
"4096","15137","2016",4,4,0,66375,760.25,98.75
"4097","15138","2016",9,6,3,75000,1513.44444444444,68.1111111111111
"4098","15139","2016",1,1,0,75400,539,140
"4099","15140","2016",27,27,0,185725.074074074,1572.40740740741,116.222222222222
"4100","15141","2016",15,13,2,93180,816.6,113.733333333333
"4101","15142","2016",14,14,0,110918.5,1156.42857142857,99.5714285714286
"4102","15143","2016",1,1,0,76000,776,98
"4103","15144","2016",1,1,0,50000,1000,50
"4104","15146","2016",2,2,0,89000,1144,75
"4105","15147","2016",1,1,0,140500,1338,105
"4106","15148","2016",3,3,0,73203.3333333333,755.666666666667,114
"4107","15149","2016",4,4,0,145877,1268.25,133.5
"4108","15151","2016",1,1,0,80000,727,110
"4109","15152","2016",5,5,0,50300,757.2,65.6
"4110","15153","2016",17,15,2,83095.8823529412,929.647058823529,95
"4111","15154","2016",14,14,0,105767.857142857,1317.85714285714,84.5714285714286
"4112","15155","2016",3,3,0,46666.6666666667,728.666666666667,61
"4113","15156","2016",7,7,0,182145.714285714,1634,106
"4114","15157","2016",2,2,0,94000,1514.5,72.5
"4115","15158","2016",1,1,0,149176,1421,105
"4116","15160","2016",7,7,0,179137.142857143,1726,106
"4117","15161","2016",1,1,0,40000,400,100
"4118","15162","2016",22,21,1,118315.454545455,1223.63636363636,97.0909090909091
"4119","15163","2016",2,2,0,140000,1501,106
"4120","15164","2016",3,3,0,142350,1365,106.333333333333
"4121","15165","2016",1,1,0,70000,1591,44
"4122","15168","2016",9,9,0,94542.2222222222,1167.22222222222,78
"4123","15169","2016",5,5,0,93760,890.6,107
"4124","15170","2016",2,2,0,90000,591.5,150
"4125","15173","2016",1,1,0,163000,881,185
"4126","15174","2016",1,1,0,184650,1420,130
"4127","15175","2016",9,8,1,99966.6666666667,983.111111111111,107.888888888889
"4128","15176","2016",2,2,0,137500,1276,108
"4129","15178","2016",3,3,0,113666.666666667,906.666666666667,130
"4130","15179","2016",4,4,0,154375,1485.5,108.75
"4131","15180","2016",1,1,0,62050,1724,36
"4132","15181","2016",4,4,0,145875,1127.25,125.25
"4133","15182","2016",4,3,1,109500,3533.75,76.25
"4134","15183","2016",2,2,0,204374,2059,93.5
"4135","15184","2016",4,4,0,103650,1156.75,87.75
"4136","15185","2016",2,2,0,149500,1647,92.5
"4137","15186","2016",5,5,0,50560,622.8,83
"4138","15187","2016",42,24,18,107934.523809524,1202.47619047619,90.8095238095238
"4139","15188","2016",10,10,0,158883,1511.7,108.4
"4140","15189","2016",5,5,0,124014,1730.6,90.4
"4141","15190","2016",1,1,0,40000,417,96
"4142","15191","2016",2,2,0,81050,627.5,115
"4143","15192","2016",8,7,1,119590,1392.625,85.125
"4144","15196","2016",7,7,0,92000,980.714285714286,99
"4145","15200","2016",3,3,0,85000,1073.66666666667,79.3333333333333
"4146","15201","2016",1,1,0,115000,639,180
"4147","15202","2016",5,5,0,91706.4,1042,88.8
"4148","15203","2016",2,2,0,72000,888,92
"4149","15204","2016",10,10,0,141405,1315.5,107.7
"4150","15205","2016",3,3,0,79833.3333333333,1794.33333333333,40.6666666666667
"4151","15206","2016",2,2,0,101000,2241.5,38
"4152","15207","2016",1,1,0,115000,575,200
"4153","15208","2016",3,3,0,38333.3333333333,562,76.6666666666667
"4154","15209","2016",1,1,0,65000,985,66
"4155","15212","2016",7,7,0,117533.285714286,1268.57142857143,93.7142857142857
"4156","15213","2016",1,1,0,80000,615,130
"4157","15214","2016",4,4,0,66443.75,985.5,64
"4158","15215","2016",5,5,0,113700,1466,76.2
"4159","15216","2016",1,1,0,40000,800,50
"4160","15217","2016",2,2,0,89730,1050.5,86.5
"4161","15218","2016",1,1,0,65000,929,70
"4162","15219","2016",3,2,1,126666.666666667,2556.33333333333,68.6666666666667
"4163","15220","2016",1,1,0,56000,933,60
"4164","15221","2016",13,13,0,121461.538461538,1253.38461538462,99.1538461538462
"4165","15222","2016",1,1,0,306000,3400,90
"4166","15223","2016",1,1,0,50000,446,112
"4167","15225","2016",2,2,0,38100,602,65.5
"4168","15226","2016",2,2,0,74927.5,1239,70
"4169","15228","2016",4,4,0,75662.5,737.25,92.5
"4170","15231","2016",6,5,1,94700,988.833333333333,104.166666666667
"4171","15232","2016",1,1,0,188000,1106,170
"4172","15234","2016",2,2,0,67375,757,89
"4173","15235","2016",3,3,0,124150,1640.33333333333,76.3333333333333
"4174","15236","2016",5,5,0,56200,794.6,74
"4175","15240","2016",1,1,0,15000,500,30
"4176","15241","2016",2,2,0,32500,1666.5,22.5
"4177","15242","2016",2,2,0,79950,690.5,92
"4178","15243","2016",6,6,0,96500,928.833333333333,103.5
"4179","15244","2016",4,4,0,182287.5,1577,121.25
"4180","15245","2016",2,2,0,92750,852,116
"4181","15246","2016",1,1,0,101000,1074,94
"4182","15248","2016",4,4,0,103625,1047.25,104.75
"4183","15249","2016",1,1,0,59000,484,122
"4184","15250","2016",8,8,0,81487.5,851.5,101
"4185","15251","2016",1,1,0,50000,1000,50
"4186","15252","2016",4,4,0,101000,1277.5,81.5
"4187","15254","2016",1,1,0,30000,476,63
"4188","15255","2016",6,6,0,124333.333333333,1304.66666666667,96.5
"4189","15258","2016",16,15,1,114340.875,1176.5625,97.6875
"4190","15259","2016",2,2,0,128425,1136,114.5
"4191","15260","2016",2,2,0,139750,1639,89.5
"4192","15261","2016",9,9,0,97433.3333333333,1195.77777777778,82.4444444444444
"4193","15262","2016",4,4,0,128725,1439.25,95.25
"4194","15264","2016",2,2,0,169784,826.5,167.5
"4195","15265","2016",18,17,1,75037.2222222222,897.166666666667,84.4444444444444
"4196","15266","2016",10,10,0,102430,978,97.4
"4197","15267","2016",37,37,0,162202.702702703,1430.08108108108,117.162162162162
"4198","15268","2016",7,7,0,119892.857142857,1253.85714285714,92
"4199","16001","2016",7,7,0,46814.2857142857,627.285714285714,76
"4200","16002","2016",4,4,0,72500,780.75,98
"4201","16003","2016",8,8,0,89175,1016,82.375
"4202","16005","2016",12,12,0,117283.333333333,808.083333333333,145.5
"4203","16007","2016",6,6,0,75308.3333333333,776,92.8333333333333
"4204","16008","2016",3,3,0,87000,792,98.6666666666667
"4205","16009","2016",2,2,0,70000,718.5,89
"4206","16011","2016",8,8,0,127437.5,1002.125,129.875
"4207","16012","2016",5,5,0,118800,1274.6,96
"4208","16013","2016",2,2,0,136775,1069.5,127
"4209","16014","2016",1,1,0,90000,1111,81
"4210","16015","2016",545,349,196,113274.908256881,1348.08256880734,86.5211009174312
"4211","16016","2016",14,14,0,65600,860.071428571429,77.7142857142857
"4212","16018","2016",4,4,0,194537.5,1213.5,157
"4213","16019","2016",13,13,0,124328.769230769,1094.61538461538,109.153846153846
"4214","16020","2016",4,4,0,123183.75,1515.5,82
"4215","16023","2016",6,6,0,124816.666666667,1212.33333333333,106.833333333333
"4216","16024","2016",2,2,0,71000,728,91.5
"4217","16025","2016",13,12,1,130838.461538462,1259.53846153846,98.3076923076923
"4218","16026","2016",9,9,0,108888.888888889,1292,86.6666666666667
"4219","16027","2016",3,3,0,75663.3333333333,544.333333333333,144.333333333333
"4220","16028","2016",57,57,0,115968,1226.84210526316,101.315789473684
"4221","16030","2016",8,8,0,157200.375,1164,135
"4222","16031","2016",4,4,0,125500,1063.5,117
"4223","16032","2016",7,7,0,130085.714285714,1253.85714285714,109.857142857143
"4224","16034","2016",3,3,0,101000,786.666666666667,124.666666666667
"4225","16036","2016",3,3,0,127333.333333333,1143.33333333333,111
"4226","16037","2016",1,1,0,93000,762,122
"4227","16038","2016",3,3,0,103333.333333333,1490.33333333333,77
"4228","16039","2016",6,6,0,109092,841,115.666666666667
"4229","16040","2016",3,3,0,95783.3333333333,694.666666666667,137.333333333333
"4230","16041","2016",4,4,0,128775,1194.5,101.75
"4231","16042","2016",3,3,0,151666.666666667,831,208
"4232","16044","2016",3,3,0,112333.333333333,927.666666666667,135.333333333333
"4233","16045","2016",4,4,0,121250,1209.75,99.75
"4234","16046","2016",3,3,0,153226.666666667,1516.66666666667,111.333333333333
"4235","16047","2016",1,1,0,83000,865,96
"4236","16049","2016",8,8,0,162705,1280.5,137.375
"4237","16050","2016",3,3,0,152921.666666667,1048.66666666667,140.333333333333
"4238","16052","2016",1,1,0,190000,1357,140
"4239","16054","2016",2,2,0,137500,1620,72.5
"4240","16055","2016",7,7,0,158637.142857143,1179.28571428571,117.857142857143
"4241","16056","2016",8,8,0,142923.75,1184.5,113.875
"4242","16057","2016",3,3,0,123333.333333333,659,192.666666666667
"4243","16058","2016",21,20,1,115106.285714286,1331.80952380952,87.9047619047619
"4244","16059","2016",1,1,0,46000,622,74
"4245","16060","2016",5,5,0,112607.4,908.2,121
"4246","16061","2016",34,34,0,138422.352941176,1387.73529411765,104.676470588235
"4247","16062","2016",1,1,0,36000,571,63
"4248","16063","2016",3,3,0,200405,1193.66666666667,180.333333333333
"4249","16064","2016",13,13,0,95334,1194.53846153846,92.3846153846154
"4250","16065","2016",3,3,0,131833.333333333,1322.33333333333,89.6666666666667
"4251","16066","2016",7,7,0,91928,965.857142857143,93.7142857142857
"4252","16067","2016",5,4,1,107900,1295,87.6
"4253","16068","2016",9,9,0,59874.5555555556,629.444444444444,87.3333333333333
"4254","16069","2016",2,2,0,102500,752.5,145
"4255","16070","2016",24,24,0,89008.5833333333,919.625,105.083333333333
"4256","16071","2016",6,6,0,130633.333333333,1064.5,111.666666666667
"4257","16072","2016",5,5,0,108600,1046.8,119.8
"4258","16073","2016",25,25,0,82682,902.56,94.08
"4259","16074","2016",3,3,0,94416.6666666667,791.666666666667,105.333333333333
"4260","16076","2016",7,7,0,59857.1428571429,966.142857142857,81
"4261","16077","2016",4,4,0,139250,1427,96.5
"4262","16078","2016",49,49,0,174447.857142857,1439.63265306122,119.326530612245
"4263","16079","2016",2,2,0,136150,1010.5,135
"4264","16081","2016",5,5,0,86400,1135.4,84.4
"4265","16082","2016",5,5,0,85800,819.6,102.4
"4266","16083","2016",5,5,0,98145,950,101.6
"4267","16084","2016",6,6,0,112466.666666667,1077.33333333333,90.5
"4268","16085","2016",33,31,2,84986.0606060606,1076.78787878788,84.0909090909091
"4269","16086","2016",14,14,0,84950.7142857143,990.642857142857,84.0714285714286
"4270","16087","2016",2,2,0,66000,988.5,67
"4271","16088","2016",12,12,0,127806.833333333,1203.41666666667,104.25
"4272","16089","2016",45,42,3,131295.111111111,1436.53333333333,94.8222222222222
"4273","16090","2016",40,40,0,98644.25,1018.475,97.525
"4274","16091","2016",3,3,0,206000,1661,119.666666666667
"4275","16093","2016",7,7,0,97089.2857142857,1174,96.5714285714286
"4276","16095","2016",1,1,0,98000,609,161
"4277","16096","2016",6,6,0,130343,1445.5,122.833333333333
"4278","16097","2016",22,22,0,128201.727272727,1246.31818181818,102.318181818182
"4279","16098","2016",1,1,0,199000,1474,135
"4280","16099","2016",6,6,0,86750,887,97.1666666666667
"4281","16100","2016",4,4,0,61000,620.5,105
"4282","16101","2016",5,5,0,154100,1276.4,123.2
"4283","16102","2016",277,229,48,125295.205776173,1276.92057761733,96.7581227436823
"4284","16103","2016",1,1,0,155950,2228,70
"4285","16104","2016",5,5,0,153900,1044,136.2
"4286","16105","2016",10,10,0,105980,892.7,125.3
"4287","16106","2016",26,26,0,75236.3461538462,783.615384615385,102.307692307692
"4288","16107","2016",10,10,0,88190,1149.3,81.6
"4289","16109","2016",7,7,0,92578.5714285714,1033.14285714286,87.2857142857143
"4290","16110","2016",7,7,0,96214.2857142857,920.142857142857,111.714285714286
"4291","16111","2016",6,6,0,107066.666666667,828.166666666667,127.833333333333
"4292","16113","2016",54,49,5,102021.296296296,1150.87037037037,92.4444444444444
"4293","16114","2016",3,3,0,111550,1630.66666666667,71.3333333333333
"4294","16116","2016",1,1,0,92000,876,105
"4295","16117","2016",1,1,0,125000,744,168
"4296","16118","2016",3,3,0,109266.666666667,776.333333333333,139.666666666667
"4297","16119","2016",13,13,0,128968.461538462,1364.76923076923,116.615384615385
"4298","16120","2016",15,15,0,141162.666666667,1502.46666666667,112.533333333333
"4299","16121","2016",2,2,0,88750,1030,86.5
"4300","16122","2016",1,1,0,63000,741,85
"4301","16123","2016",2,2,0,99750,698.5,151.5
"4302","16124","2016",16,16,0,108817.25,1086.75,87.5
"4303","16125","2016",5,5,0,77810,962,82.2
"4304","16127","2016",6,6,0,66238.3333333333,682.5,106.333333333333
"4305","16128","2016",2,2,0,65500,899,70
"4306","16130","2016",1,1,0,2e+05,1117,179
"4307","16131","2016",5,5,0,126000,1034,119.8
"4308","16132","2016",11,11,0,93145.4545454545,1027.90909090909,93.2727272727273
"4309","16133","2016",2,2,0,140165,1199.5,111
"4310","16134","2016",7,7,0,92642.8571428571,1021.14285714286,94.5714285714286
"4311","16135","2016",3,3,0,76666.6666666667,953,79.3333333333333
"4312","16136","2016",9,9,0,78688.8888888889,843.222222222222,89.2222222222222
"4313","16137","2016",3,3,0,86333.3333333333,935,88.3333333333333
"4314","16138","2016",31,31,0,144860.322580645,1345.58064516129,113.838709677419
"4315","16139","2016",3,3,0,120266.666666667,1120.33333333333,122.333333333333
"4316","16140","2016",4,4,0,115500,1035,111
"4317","16141","2016",3,3,0,132000,1073,103
"4318","16142","2016",3,3,0,133783.333333333,658.666666666667,190.666666666667
"4319","16143","2016",7,7,0,99249.5714285714,964.857142857143,110.142857142857
"4320","16144","2016",4,4,0,67640,700.25,93.5
"4321","16145","2016",3,3,0,799446.666666667,2530.33333333333,224.333333333333
"4322","16146","2016",13,13,0,129892.307692308,1202.38461538462,108.846153846154
"4323","16147","2016",3,3,0,122333.333333333,1094,121.666666666667
"4324","16148","2016",9,9,0,99972.2222222222,1021.55555555556,98.7777777777778
"4325","16150","2016",9,9,0,144768,1329.44444444444,123.666666666667
"4326","16151","2016",6,6,0,96620.8333333333,1016.33333333333,92.5
"4327","16152","2016",4,4,0,102050,1084.5,100.75
"4328","16153","2016",3,3,0,138666.666666667,1449.66666666667,96
"4329","16154","2016",74,67,7,115204.175675676,1293.01351351351,90.0810810810811
"4330","16155","2016",1,1,0,20000,465,43
"4331","16157","2016",3,3,0,153500,1240.33333333333,123.666666666667
"4332","16158","2016",4,4,0,83962.5,1065.25,75
"4333","16161","2016",1,1,0,116000,1415,82
"4334","16163","2016",13,13,0,122927.692307692,1226.38461538462,103.076923076923
"4335","16164","2016",5,5,0,60048,918.6,68.8
"4336","16165","2016",6,6,0,121938.333333333,905.333333333333,123.5
"4337","16166","2016",56,54,2,114519.946428571,1270.80357142857,90.5892857142857
"4338","16167","2016",73,67,6,103704.452054795,1093.87671232877,95.4383561643836
"4339","16168","2016",12,12,0,124541.666666667,1286.08333333333,103.5
"4340","16169","2016",8,8,0,134062.5,948.875,143.875
"4341","16170","2016",4,4,0,87375,996,84.5
"4342","16171","2016",6,6,0,156000,1190.5,130.666666666667
"4343","16173","2016",4,4,0,147750,950.5,170
"4344","16174","2016",4,4,0,155545.75,1360.25,114.25
"4345","16175","2016",8,8,0,129803.125,1063.375,115.375
"4346","16176","2016",1,1,0,150000,949,158
"4347","16177","2016",1,1,0,83000,446,186
"4348","16178","2016",1,1,0,155000,1360,114
"4349","16180","2016",1,1,0,275000,2292,120
"4350","16181","2016",11,11,0,84822.7272727273,713.818181818182,113.727272727273
"4351","16182","2016",6,6,0,101333.333333333,810.5,108.666666666667
"4352","16183","2016",4,4,0,69750,621.75,116
"4353","16186","2016",4,4,0,72502.75,1062,70.25
"4354","16187","2016",18,18,0,122106.611111111,1255.61111111111,104
"4355","16188","2016",6,6,0,74333.3333333333,732.833333333333,95.5
"4356","16190","2016",4,4,0,135750,1367,111.75
"4357","16191","2016",2,2,0,35000,1097,42
"4358","16192","2016",20,20,0,100160.6,917.95,109.15
"4359","16193","2016",12,12,0,146166.666666667,984.5,140.25
"4360","16194","2016",1,1,0,23000,460,50
"4361","16195","2016",4,4,0,71750,650,116.5
"4362","16196","2016",10,10,0,77050,725.8,107.3
"4363","16197","2016",2,2,0,44000,636.5,68.5
"4364","16198","2016",2,2,0,95425,1061.5,90
"4365","16199","2016",43,43,0,103659.88372093,1221.3023255814,84.1860465116279
"4366","16200","2016",4,4,0,137187.5,1467.25,95
"4367","16203","2016",1,1,0,108800,1110,98
"4368","16204","2016",11,11,0,98805.4545454545,847.181818181818,113.545454545455
"4369","16205","2016",5,5,0,119681,1574.4,101.2
"4370","16206","2016",18,18,0,107755.555555556,1114.77777777778,102.277777777778
"4371","16207","2016",7,7,0,82714.2857142857,1037,93.7142857142857
"4372","16208","2016",6,6,0,139636.666666667,1116,129.166666666667
"4373","16209","2016",16,16,0,147009.375,1153.3125,130.75
"4374","16210","2016",8,8,0,133400,1144.75,113.625
"4375","16211","2016",4,4,0,72500,997.25,70.75
"4376","16212","2016",6,6,0,53416.6666666667,718,77.5
"4377","16213","2016",4,4,0,117775,1019.25,110.25
"4378","16216","2016",7,7,0,121852.142857143,1338,102
"4379","16217","2016",15,15,0,106201.666666667,1045.8,103.2
"4380","16218","2016",6,6,0,209983.333333333,1838.16666666667,112
"4381","16220","2016",5,5,0,155351,1364.4,113
"4382","16221","2016",2,2,0,33750,554.5,61
"4383","16222","2016",4,4,0,45250,957.75,54
"4384","16223","2016",25,25,0,93101.48,886.36,106.88
"4385","16224","2016",5,5,0,183820,967.4,200.2
"4386","16225","2016",11,11,0,79709.0909090909,748.363636363636,102.909090909091
"4387","16226","2016",10,10,0,105923.3,816,119.3
"4388","16227","2016",4,4,0,124125,854,151.5
"4389","16229","2016",1,1,0,77000,500,154
"4390","16230","2016",26,26,0,105084.807692308,948.692307692308,109.653846153846
"4391","16232","2016",20,20,0,127983.65,1294.5,110.5
"4392","16233","2016",7,7,0,144164.285714286,1087.71428571429,131.285714285714
"4393","16234","2016",7,7,0,112857.142857143,1090.28571428571,108.285714285714
"4394","16236","2016",17,17,0,142864.705882353,1436.58823529412,102.705882352941
"4395","16237","2016",1,1,0,160000,909,176
"4396","16238","2016",1,1,0,118500,1039,114
"4397","16239","2016",2,2,0,117000,1500,76
"4398","16240","2016",2,2,0,160000,1231,128
"4399","16241","2016",2,2,0,117140,1251.5,96
"4400","16242","2016",27,27,0,105869.074074074,962.037037037037,113.444444444444
"4401","16243","2016",6,6,0,175075,1391.16666666667,133
"4402","16244","2016",19,18,1,137913.421052632,1322.31578947368,108.368421052632
"4403","16245","2016",3,3,0,71666.6666666667,909.333333333333,75.6666666666667
"4404","16246","2016",5,5,0,97400,936.4,107.2
"4405","16248","2016",1,1,0,65000,756,86
"4406","16249","2016",10,10,0,110300,1106.2,100.2
"4407","16250","2016",2,2,0,2e+05,1680,119
"4408","16251","2016",1,1,0,85000,850,100
"4409","16252","2016",5,5,0,185000,1473,119.4
"4410","16253","2016",3,3,0,79333.3333333333,1003.33333333333,80
"4411","16254","2016",3,3,0,104233.333333333,1404.66666666667,73.6666666666667
"4412","16255","2016",1,1,0,195000,2321,84
"4413","16256","2016",3,3,0,174333.333333333,1026.66666666667,167
"4414","16258","2016",4,4,0,120750,1254,106
"4415","16260","2016",4,4,0,116125,1300.25,97.5
"4416","16261","2016",3,3,0,72233.3333333333,878.333333333333,74.6666666666667
"4417","16263","2016",4,4,0,112750,852,128.75
"4418","16264","2016",8,8,0,99137.5,1122,86.75
"4419","16267","2016",2,2,0,99005,587,185
"4420","16268","2016",3,3,0,69666.6666666667,835.333333333333,85.6666666666667
"4421","16269","2016",7,7,0,143977.142857143,1084.28571428571,145.714285714286
"4422","16270","2016",6,6,0,106350,862.5,147.666666666667
"4423","16271","2016",11,11,0,193646.545454545,1546.09090909091,123.818181818182
"4424","16272","2016",3,3,0,116366.666666667,1215.33333333333,94.6666666666667
"4425","16273","2016",3,3,0,117166.666666667,1378,108.666666666667
"4426","16275","2016",1,1,0,24000,667,36
"4427","16276","2016",9,9,0,99236,992.333333333333,109.555555555556
"4428","16277","2016",7,7,0,182242.857142857,1341,142.857142857143
"4429","16279","2016",5,5,0,107134,871.8,116
"4430","16280","2016",25,25,0,109525.8,1268.48,87.84
"4431","16281","2016",50,46,4,96621,1137.7,90.46
"4432","16282","2016",4,4,0,123162.5,1289.75,89.5
"4433","16283","2016",7,7,0,147114.285714286,1404.71428571429,106.142857142857
"4434","16284","2016",2,2,0,230650,1560,137.5
"4435","16285","2016",7,7,0,71610,888,87.1428571428571
"4436","16286","2016",36,35,1,124667.222222222,1020.08333333333,111.75
"4437","16287","2016",45,45,0,134209.8,1291.42222222222,106.288888888889
"4438","16289","2016",3,3,0,195848.333333333,1049.33333333333,202
"4439","16290","2016",9,9,0,144566.666666667,1183.88888888889,115.222222222222
"4440","16291","2016",100,100,0,104981.95,1249.34,84.89
"4441","16292","2016",39,39,0,90282.0512820513,1043.74358974359,86.6666666666667
"4442","16293","2016",1,1,0,105000,610,172
"4443","16295","2016",9,9,0,112427.777777778,1037.11111111111,107.111111111111
"4444","16297","2016",4,4,0,129175,820,163
"4445","16298","2016",4,4,0,132340,1126.25,104.5
"4446","16300","2016",9,9,0,130800,1436.33333333333,100
"4447","16301","2016",2,2,0,114000,852.5,131.5
"4448","16302","2016",4,4,0,107812.5,769.75,129.25
"4449","16303","2016",1,1,0,127650,1264,101
"4450","16304","2016",10,10,0,162650,1436.8,117.7
"4451","16306","2016",3,3,0,64403.3333333333,1101,66.6666666666667
"4452","16308","2016",12,11,1,93342.3333333333,999.416666666667,123.166666666667
"4453","16310","2016",3,3,0,98666.6666666667,951,100.333333333333
"4454","16312","2016",9,9,0,103666.666666667,965.555555555556,110.333333333333
"4455","16316","2016",3,3,0,221000,843,246.666666666667
"4456","16317","2016",7,7,0,117500,889.285714285714,109.285714285714
"4457","16318","2016",6,6,0,89660,992.5,87.8333333333333
"4458","16320","2016",10,10,0,114250,1208.3,94.5
"4459","16323","2016",4,4,0,87500,960.5,90.25
"4460","16325","2016",3,3,0,68000,757.666666666667,92
"4461","16329","2016",5,5,0,105700,980.2,108.2
"4462","16330","2016",5,5,0,106645,1121.6,93.6
"4463","16334","2016",2,2,0,71500,1081,68.5
"4464","16335","2016",1,1,0,237700,798,298
"4465","16336","2016",4,4,0,69075,929.75,81.5
"4466","16337","2016",7,7,0,91585.7142857143,929.285714285714,93.2857142857143
"4467","16338","2016",2,2,0,199500,1277,157
"4468","16339","2016",2,2,0,59000,666.5,84.5
"4469","16340","2016",8,8,0,129819.25,1219.5,108.75
"4470","16341","2016",31,24,7,99068.5161290323,1321.87096774194,75.8387096774194
"4471","16343","2016",7,7,0,105700,1137,99
"4472","16345","2016",4,4,0,62250,643,88
"4473","16346","2016",1,1,0,67000,459,146
"4474","16347","2016",6,6,0,166808.333333333,1263,125
"4475","16348","2016",14,14,0,181170.785714286,1413.21428571429,127.142857142857
"4476","16349","2016",2,2,0,113200,1091.5,101.5
"4477","16350","2016",18,18,0,113455.166666667,1112.77777777778,107.944444444444
"4478","16352","2016",1,1,0,59000,819,72
"4479","16353","2016",8,8,0,140415,1474.875,101.625
"4480","16355","2016",9,9,0,186674.444444444,1385.44444444444,146.888888888889
"4481","16357","2016",1,1,0,90000,732,123
"4482","16358","2016",73,72,1,157301.095890411,1484.45205479452,107.890410958904
"4483","16359","2016",9,9,0,123466.666666667,1088.55555555556,115.666666666667
"4484","16360","2016",4,4,0,90000,752.5,122.25
"4485","16361","2016",6,6,0,128633.333333333,1205,106.5
"4486","16362","2016",5,5,0,153800,1344.4,113.4
"4487","16363","2016",9,9,0,109019.888888889,980.777777777778,106.555555555556
"4488","16364","2016",2,2,0,57500,839.5,69
"4489","16365","2016",1,1,0,130000,1000,130
"4490","16366","2016",24,23,1,118275,1075.125,114.25
"4491","16368","2016",7,7,0,100142.857142857,810,120.142857142857
"4492","16369","2016",11,11,0,126154.545454545,1116.36363636364,114.363636363636
"4493","16370","2016",8,8,0,121560.625,1206.625,95.125
"4494","16372","2016",3,3,0,151619,1146,130.333333333333
"4495","16373","2016",1,1,0,98400,674,146
"4496","16374","2016",73,64,9,104199.506849315,1225.90410958904,85.6575342465753
"4497","16375","2016",9,9,0,97477.7777777778,989.444444444444,101.111111111111
"4498","16378","2016",2,2,0,72500,923,82.5
"4499","16379","2016",13,13,0,133742.307692308,1213,112
"4500","16380","2016",4,4,0,110305,803.25,147.75
"4501","16381","2016",2,2,0,242000,1551,182
"4502","16382","2016",6,6,0,141258.333333333,1032.83333333333,129.833333333333
"4503","16383","2016",8,8,0,95533.5,925,108
"4504","16384","2016",1,1,0,75000,915,82
"4505","16385","2016",8,8,0,106137.5,1180.625,82.375
"4506","16387","2016",4,4,0,148875,1302.5,128.5
"4507","16388","2016",8,8,0,168037.5,1368.125,120
"4508","16389","2016",1,1,0,87600,876,100
"4509","16390","2016",4,4,0,53750,628.25,79.75
"4510","16392","2016",2,2,0,1e+05,1130.5,90.5
"4511","16393","2016",24,24,0,124183.916666667,1203.54166666667,103.75
"4512","16394","2016",2,2,0,64082.5,931,69.5
"4513","16395","2016",2,2,0,166250,1003,166.5
"4514","16396","2016",3,3,0,147166.666666667,781.333333333333,187
"4515","16397","2016",3,3,0,104063.333333333,770.666666666667,118
"4516","16399","2016",1,1,0,107200,771,139
"4517","16400","2016",16,16,0,95549.0625,956.875,100.125
"4518","16401","2016",3,3,0,140000,1459.66666666667,95
"4519","16402","2016",9,9,0,94111.1111111111,972.333333333333,108.333333333333
"4520","16403","2016",1,1,0,48000,585,82
"4521","16404","2016",1,1,0,153000,1195,128
"4522","16408","2016",9,9,0,139066.666666667,1596.66666666667,94.8888888888889
"4523","16409","2016",7,7,0,68531.4285714286,878.857142857143,82.1428571428571
"4524","16412","2016",4,4,0,127250,1267.25,102.5
"4525","16413","2016",1,1,0,48504,713,68
"4526","16414","2016",4,4,0,90372,789.25,106.75
"4527","16415","2016",9,9,0,111917.777777778,1154.44444444444,98
"4528","16416","2016",8,8,0,88312.5,884.125,91.875
"4529","16418","2016",14,14,0,128423.571428571,1194.78571428571,106.357142857143
"4530","16419","2016",2,2,0,199461,1551.5,105
"4531","16420","2016",3,3,0,116233.333333333,801.333333333333,123.333333333333
"4532","16422","2016",10,10,0,120501,1018.4,124.8
"4533","16423","2016",4,4,0,59500,752.5,77.25
"4534","16424","2016",4,4,0,74436.25,675.5,110.25
"4535","16425","2016",1,1,0,30000,545,55
"4536","17002","2016",1,1,0,90000,1452,62
"4537","17003","2016",54,54,0,170996.351851852,1750.81481481481,97.8518518518518
"4538","17004","2016",5,3,2,329500,7403.2,54
"4539","17005","2016",2,2,0,200500,1052,189.5
"4540","17006","2016",3,3,0,175860,1079.33333333333,170.333333333333
"4541","17007","2016",3,3,0,88500,1057.66666666667,86.6666666666667
"4542","17008","2016",37,36,1,186402.702702703,2002.59459459459,100.648648648649
"4543","17009","2016",9,9,0,209565.555555556,1750.77777777778,114.444444444444
"4544","17010","2016",38,37,1,273513,2622.31578947368,105.157894736842
"4545","17011","2016",4,4,0,1e+05,1073,84.75
"4546","17012","2016",4,4,0,137387.5,1325.25,109.75
"4547","17013","2016",4,4,0,74696.25,733.75,98.25
"4548","17015","2016",8,8,0,185925,1468.375,139.375
"4549","17016","2016",7,7,0,94864.2857142857,1460.57142857143,83.7142857142857
"4550","17017","2016",11,11,0,133953.818181818,1263.54545454545,106.090909090909
"4551","17018","2016",8,8,0,199487.5,1384.25,145.625
"4552","17019","2016",38,36,2,381640.394736842,5321.73684210526,77.2631578947368
"4553","17020","2016",1,1,0,194000,655,296
"4554","17021","2016",61,58,3,156489.262295082,1725.37704918033,92.344262295082
"4555","17022","2016",12,12,0,105008.333333333,1010.33333333333,99.5833333333333
"4556","17024","2016",20,20,0,101945,985.9,103.15
"4557","17025","2016",3,3,0,144083.333333333,1258.33333333333,116
"4558","17026","2016",6,6,0,110800,1030.83333333333,106.333333333333
"4559","17027","2016",2,2,0,111250,1110.5,99
"4560","17028","2016",149,98,51,180666.375838926,2509.93959731544,74.9664429530201
"4561","17029","2016",2,2,0,98750,884.5,98.5
"4562","17030","2016",7,7,0,111764.285714286,1155.85714285714,96.4285714285714
"4563","17031","2016",3,3,0,101333.333333333,1507,67.6666666666667
"4564","17032","2016",14,14,0,183441.428571429,1527.14285714286,126
"4565","17033","2016",4,4,0,172500,963.75,157
"4566","17034","2016",11,11,0,153483.636363636,1498.90909090909,101.090909090909
"4567","17036","2016",16,16,0,153456.25,1536.75,102.1875
"4568","17037","2016",7,7,0,115800,1049.71428571429,106.857142857143
"4569","17038","2016",3,3,0,88333.3333333333,866.666666666667,97.3333333333333
"4570","17039","2016",1,1,0,152000,2338,65
"4571","17041","2016",24,24,0,139864.416666667,1525.66666666667,95.5
"4572","17042","2016",7,7,0,159935.714285714,1294.57142857143,124.142857142857
"4573","17043","2016",7,7,0,83785.7142857143,924.285714285714,89.8571428571429
"4574","17044","2016",9,9,0,178944.444444444,1248.66666666667,136.555555555556
"4575","17045","2016",7,7,0,129214.285714286,1121.71428571429,125.857142857143
"4576","17046","2016",2,2,0,108500,1407.5,79
"4577","17047","2016",2,2,0,134300,1407,95
"4578","17048","2016",4,4,0,112750,1009.25,119
"4579","17050","2016",4,4,0,139425,1333,91.75
"4580","17051","2016",49,46,3,537503.857142857,5129.36734693878,108.734693877551
"4581","17052","2016",8,8,0,178593.75,1369.125,132.625
"4582","17053","2016",23,23,0,111758.695652174,1180.69565217391,99.7391304347826
"4583","17054","2016",5,5,0,143587.4,1063.4,121
"4584","17055","2016",2,2,0,151000,2310,80
"4585","17056","2016",5,5,0,87631.2,855.8,105.6
"4586","17057","2016",15,15,0,157170,1608.46666666667,97.4
"4587","17058","2016",66,66,0,146851.212121212,1872.40909090909,80.8939393939394
"4588","17059","2016",12,12,0,219280,1957.33333333333,111.833333333333
"4589","17060","2016",6,6,0,130125,1237,95.3333333333333
"4590","17062","2016",2,2,0,138345,1422,111
"4591","17063","2016",7,7,0,129714.285714286,1169.14285714286,120
"4592","17064","2016",49,49,0,259348.897959184,2301.08163265306,113.510204081633
"4593","17065","2016",15,15,0,158716.666666667,1515.8,101.066666666667
"4594","17066","2016",1,1,0,50000,758,66
"4595","17067","2016",1,1,0,50000,980,51
"4596","17068","2016",1,1,0,80200,757,106
"4597","17069","2016",3,3,0,69666.6666666667,749.666666666667,88
"4598","17070","2016",8,8,0,120675,1119.5,116.25
"4599","17071","2016",3,3,0,53333.3333333333,638.333333333333,88
"4600","17072","2016",11,11,0,120002.272727273,945.363636363636,134.545454545455
"4601","17073","2016",25,25,0,148896,1337.12,107.44
"4602","17074","2016",12,11,1,125825.916666667,1129.33333333333,115.75
"4603","17075","2016",15,15,0,150493.333333333,1595.46666666667,93.0666666666667
"4604","17076","2016",1,1,0,145000,2042,71
"4605","17077","2016",12,12,0,134875,1347.16666666667,103.25
"4606","17078","2016",1,1,0,95500,1592,60
"4607","17079","2016",25,25,0,169887.6,1618.72,106.92
"4608","17080","2016",7,7,0,168107.142857143,1527.57142857143,100.857142857143
"4609","17081","2016",3,3,0,93500,654.333333333333,150.666666666667
"4610","17082","2016",4,4,0,151505,1276.75,122
"4611","17083","2016",10,10,0,148440,1557,95.7
"4612","17084","2016",7,7,0,98538.8571428571,1019.42857142857,112.714285714286
"4613","17085","2016",7,7,0,82071.4285714286,1069.42857142857,78.7142857142857
"4614","17086","2016",34,34,0,149509.264705882,1422.05882352941,104.176470588235
"4615","17087","2016",2,2,0,102500,760,134
"4616","17089","2016",14,14,0,160550,1474.21428571429,109.642857142857
"4617","17091","2016",21,21,0,195858.095238095,1763.52380952381,108.619047619048
"4618","17092","2016",1,1,0,85000,1062,80
"4619","17093","2016",73,72,1,188663.465753425,2336.72602739726,84.1506849315068
"4620","17094","2016",172,126,46,234072.488372093,3291.92441860465,76.2267441860465
"4621","17095","2016",5,5,0,136536.8,888.8,169.8
"4622","17097","2016",10,10,0,169051,1561.6,111.3
"4623","17098","2016",20,19,1,116087.5,1219.05,101.9
"4624","17099","2016",11,11,0,125563.636363636,1049.18181818182,117.636363636364
"4625","17100","2016",9,9,0,125160.555555556,1205.55555555556,129.666666666667
"4626","17101","2016",2,2,0,76100,692,111
"4627","17102","2016",10,10,0,171591,1552.2,110.3
"4628","17104","2016",8,8,0,84562.5,909.25,92.25
"4629","17105","2016",1,1,0,62500,631,99
"4630","17106","2016",3,3,0,109466.666666667,1271.33333333333,78.6666666666667
"4631","17107","2016",18,18,0,164715.666666667,1887.72222222222,97.8888888888889
"4632","17108","2016",2,2,0,206207.5,1507.5,138.5
"4633","17109","2016",28,25,3,231355.714285714,2165.14285714286,110.607142857143
"4634","17110","2016",6,6,0,109837.833333333,1004,109.833333333333
"4635","17111","2016",14,14,0,103419,1068.42857142857,97.2142857142857
"4636","17112","2016",8,8,0,125862.5,1195.5,106.875
"4637","17113","2016",8,8,0,132737.5,1083.75,123.875
"4638","17114","2016",4,4,0,79300,825,96.75
"4639","17115","2016",4,4,0,129550,1199.5,107
"4640","17116","2016",1,1,0,109000,908,120
"4641","17118","2016",2,2,0,164660,1769.5,93
"4642","17119","2016",17,17,0,136278.823529412,1392.35294117647,97.7058823529412
"4643","17120","2016",20,20,0,152299.7,1425.85,106.25
"4644","17121","2016",43,40,3,449236.976744186,4734.6511627907,99.3720930232558
"4645","17122","2016",1,1,0,25000,333,75
"4646","17124","2016",3,3,0,105666.666666667,1075,103.333333333333
"4647","17125","2016",7,7,0,124974.285714286,1104.71428571429,108.285714285714
"4648","17126","2016",2,2,0,161000,1794,118.5
"4649","17127","2016",30,30,0,140083.333333333,1322.9,108
"4650","17128","2016",8,8,0,103998.75,1389.25,69.5
"4651","17129","2016",5,5,0,137000,988,146.2
"4652","17130","2016",2,2,0,87500,780,117
"4653","17131","2016",24,24,0,159081.25,1590.79166666667,103.958333333333
"4654","17132","2016",11,11,0,100877.272727273,1172.27272727273,94.7272727272727
"4655","17133","2016",5,5,0,159410,1242.6,127.2
"4656","17134","2016",6,6,0,180500,1222.66666666667,128.5
"4657","17135","2016",3,3,0,62333.3333333333,667.333333333333,83.3333333333333
"4658","17136","2016",16,15,1,199924.8125,1880.125,109.125
"4659","17137","2016",2,2,0,95000,695,143.5
"4660","17138","2016",5,5,0,123200,896.2,141.6
"4661","17139","2016",2,2,0,131500,812,160
"4662","17140","2016",77,69,8,203707.012987013,2835.1038961039,78.8181818181818
"4663","17141","2016",10,10,0,123348.6,1221.7,114.2
"4664","17142","2016",55,53,2,243121.254545455,2202.89090909091,115.490909090909
"4665","17143","2016",7,6,1,101765.714285714,979.142857142857,100.714285714286
"4666","17145","2016",9,9,0,99292.2222222222,1098.66666666667,83.7777777777778
"4667","17146","2016",47,44,3,144439.361702128,1567.27659574468,93.4893617021277
"4668","17147","2016",17,17,0,120117.647058824,1012,121.411764705882
"4669","17148","2016",3,3,0,128790,1205,108.666666666667
"4670","17149","2016",1,1,0,30000,600,50
"4671","17150","2016",7,7,0,114817.142857143,906.142857142857,121.571428571429
"4672","17151","2016",11,11,0,143695.454545455,1363.72727272727,107.727272727273
"4673","17152","2016",5,5,0,117600,1071,106.4
"4674","17153","2016",26,26,0,211547.307692308,2198.30769230769,96.4615384615385
"4675","17154","2016",7,7,0,128890.857142857,1408.71428571429,98.4285714285714
"4676","17155","2016",43,43,0,177709.465116279,1743.93023255814,100.116279069767
"4677","17156","2016",2,2,0,70214.5,572,130
"4678","17157","2016",4,4,0,133250,1246.5,110.25
"4679","17158","2016",13,13,0,207846.153846154,1702.07692307692,123.692307692308
"4680","17159","2016",2,2,0,106500,982,93.5
"4681","17160","2016",3,3,0,158076.666666667,1450.66666666667,108.666666666667
"4682","17161","2016",68,55,13,427087.720588235,5156.64705882353,86.9117647058823
"4683","17162","2016",7,7,0,84928.5714285714,840,111.285714285714
"4684","17163","2016",6,6,0,136483.333333333,1151.5,131.833333333333
"4685","17164","2016",28,28,0,145528.214285714,1419.39285714286,103.642857142857
"4686","17165","2016",2,2,0,152500,1105.5,139
"4687","17166","2016",17,17,0,180426.470588235,1557.41176470588,128.235294117647
"4688","17167","2016",6,6,0,137486.166666667,1699.16666666667,89
"4689","17168","2016",117,95,22,246179.623931624,3007.99145299145,83.8119658119658
"4690","17171","2016",8,8,0,164625,1372.75,112
"4691","17172","2016",30,30,0,122643.333333333,1237.03333333333,105.3
"4692","17173","2016",2,2,0,136288.5,1090.5,128.5
"4693","17174","2016",12,12,0,129025,1180.25,117.833333333333
"4694","17175","2016",2,2,0,123675,1154.5,106.5
"4695","17176","2016",2,2,0,90000,1068,84.5
"4696","17177","2016",1,1,0,446000,2703,165
"4697","17179","2016",17,14,3,132985.176470588,1528.58823529412,91.5882352941177
"4698","17181","2016",4,4,0,84300,1217,79
"4699","17182","2016",8,8,0,176032.625,1514.375,111.5
"4700","17183","2016",12,12,0,221109.75,1615.83333333333,154.083333333333
"4701","17184","2016",5,5,0,176740,1418.4,135.6
"4702","17185","2016",24,23,1,134912.5,1350.75,107.625
"4703","17186","2016",7,7,0,112914.285714286,1144.71428571429,100.571428571429
"4704","17187","2016",8,8,0,111035,1168.25,95.625
"4705","17188","2016",3,3,0,147666.666666667,973,155
"4706","17190","2016",30,30,0,350839.333333333,2890.06666666667,119.1
"4707","17191","2016",6,6,0,122949.166666667,1549.16666666667,102.5
"4708","17192","2016",5,5,0,162852,1071.4,161.6
"4709","17193","2016",25,25,0,268569.64,2104.88,125.44
"4710","17194","2016",45,44,1,196861.088888889,1887.82222222222,105.555555555556
"4711","17195","2016",4,4,0,108000,995,113.5
"4712","17196","2016",3,3,0,140201,1090,143.333333333333
"4713","17197","2016",51,37,14,115371.862745098,1534.88235294118,90.0392156862745
"4714","17198","2016",3,3,0,125833.333333333,1307.66666666667,109
"4715","17199","2016",1,1,0,50000,588,85
"4716","17200","2016",104,99,5,253224.144230769,2462.86538461538,104.240384615385
"4717","17201","2016",7,7,0,167557.142857143,1416.42857142857,124.571428571429
"4718","17202","2016",5,5,0,96200,1163.4,80.8
"4719","17203","2016",9,9,0,135361.111111111,1187,117.555555555556
"4720","17204","2016",4,4,0,132125,1143.5,128.5
"4721","17205","2016",5,5,0,186800,1461.8,133.2
"4722","17206","2016",4,4,0,128825,1110.75,117.75
"4723","17207","2016",18,17,1,542888.888888889,4534.38888888889,121.333333333333
"4724","17208","2016",6,6,0,192750,2081.66666666667,92.1666666666667
"4725","17209","2016",2,2,0,138500,924.5,147
"4726","17210","2016",9,9,0,102222.222222222,1485.66666666667,85
"4727","17211","2016",5,5,0,73800,778,98.8
"4728","17213","2016",1,1,0,48000,658,73
"4729","17214","2016",5,5,0,137000,1391.4,100.8
"4730","17216","2016",10,10,0,121370,1295.4,98
"4731","17217","2016",2,2,0,112000,1269,88.5
"4732","17218","2016",71,63,8,125842.112676056,1335.57746478873,95.6619718309859
"4733","17219","2016",97,90,7,137226.041237113,1780.15463917526,81.5773195876289
"4734","17220","2016",4,4,0,126500,1145.5,115
"4735","17221","2016",13,13,0,155850.769230769,1165.23076923077,133.923076923077
"4736","17222","2016",45,45,0,268707.444444444,2253.46666666667,121.533333333333
"4737","17223","2016",2,2,0,35500,700,50
"4738","17224","2016",19,18,1,94985.7894736842,1064.15789473684,97.9473684210526
"4739","17225","2016",107,95,12,193155.38317757,3330.81308411215,65.2429906542056
"4740","17226","2016",11,11,0,123209.090909091,1214.54545454545,103.454545454545
"4741","17227","2016",5,5,0,56560,561,106.2
"4742","17228","2016",38,34,4,195901.815789474,1927.94736842105,108.973684210526
"4743","17229","2016",1,1,0,67000,744,90
"4744","17230","2016",94,87,7,191180.170212766,2388.81914893617,84.5212765957447
"4745","17231","2016",1,1,0,30000,1500,20
"4746","17232","2016",21,19,2,132958.571428571,1138.66666666667,115.571428571429
"4747","17233","2016",2,2,0,102500,635.5,170
"4748","17234","2016",5,5,0,114840,887.8,124
"4749","17235","2016",2,2,0,103500,801,144
"4750","17236","2016",17,15,2,93699.4117647059,1075.64705882353,87.5882352941177
"4751","17237","2016",7,7,0,149695.714285714,1517.57142857143,99.2857142857143
"4752","17239","2016",4,4,0,71000,770.5,92
"4753","17240","2016",50,48,2,94375.2,1258.06,82.08
"4754","17241","2016",15,15,0,91086.6666666667,868,108.6
"4755","17242","2016",12,12,0,118857,1327,95.9166666666667
"4756","17243","2016",8,8,0,83729.375,750.25,106.875
"4757","17244","2016",3,3,0,182500,1288.33333333333,160
"4758","17245","2016",13,13,0,209545.538461538,2145.76923076923,99.0769230769231
"4759","17246","2016",4,4,0,154500,1485,101.75
"4760","17247","2016",13,13,0,214276.923076923,2279.61538461538,100.461538461538
"4761","17248","2016",24,23,1,129258.333333333,1177.875,108.875
"4762","17250","2016",5,5,0,102200,1109.6,92.2
"4763","17252","2016",3,3,0,115000,1093.33333333333,103.666666666667
"4764","17253","2016",22,22,0,130280,1204.22727272727,112.318181818182
"4765","17254","2016",2,2,0,60000,830,71.5
"4766","17255","2016",12,12,0,145180,1379.83333333333,104
"4767","17256","2016",2,2,0,94198.5,1143,84
"4768","17257","2016",8,8,0,123005.5,1054,113.25
"4769","17258","2016",2,2,0,149000,1138.5,142.5
"4770","17259","2016",1,1,0,625000,1883,332
"4771","17260","2016",6,6,0,144413.333333333,1246.83333333333,114.333333333333
"4772","17261","2016",8,8,0,152375,1052.125,143.25
"4773","17262","2016",15,15,0,190680.866666667,1836.46666666667,107.933333333333
"4774","17263","2016",7,7,0,158790.714285714,1003.85714285714,138.428571428571
"4775","17264","2016",71,70,1,247472.577464789,2365.49295774648,106.845070422535
"4776","17265","2016",19,19,0,160113.789473684,1627.52631578947,100.263157894737
"4777","17266","2016",6,6,0,111131.666666667,1072.83333333333,100.666666666667
"4778","17267","2016",22,22,0,179436.363636364,1737.31818181818,105
"4779","17268","2016",2,2,0,149525,1225.5,127
"4780","17269","2016",7,7,0,97000,1343.85714285714,75.2857142857143
"4781","17270","2016",12,12,0,90692.5,1597.5,68.25
"4782","17271","2016",3,3,0,126700,904.333333333333,133.666666666667
"4783","17273","2016",7,7,0,183480,1359.14285714286,133.142857142857
"4784","17274","2016",99,82,17,278670.646464646,2708.78787878788,104.373737373737
"4785","17275","2016",6,6,0,128200,1304,98.8333333333333
"4786","17277","2016",6,6,0,113351.666666667,1049.33333333333,97.8333333333333
"4787","17278","2016",11,11,0,172353.636363636,1544.09090909091,117
"4788","17279","2016",4,4,0,142025,1367.75,106.25
"4789","17280","2016",7,7,0,186185.714285714,1559.71428571429,115.571428571429
"4790","17281","2016",1,1,0,45500,650,70
"4791","17282","2016",2,2,0,159023.5,656,217
"4792","17283","2016",44,42,2,121697.159090909,1171.18181818182,102.727272727273
"4793","17284","2016",15,15,0,173232.266666667,1432.93333333333,124.666666666667
"4794","17285","2016",15,15,0,117540,1153.8,111.066666666667
"4795","17286","2016",30,30,0,654546.4,5682.13333333333,112.833333333333
"4796","17287","2016",3,3,0,121666.666666667,968.333333333333,136
"4797","17289","2016",6,6,0,121666.666666667,1020.5,127.666666666667
"4798","17290","2016",1,1,0,130000,1444,90
"4799","17291","2016",80,68,12,236925.225,2385.5625,104.125
"4800","17292","2016",6,6,0,154391.666666667,1241,127.666666666667
"4801","17293","2016",6,6,0,138666.666666667,1165.33333333333,140.166666666667
"4802","17294","2016",4,4,0,147475,1875.25,80.25
"4803","17295","2016",3,3,0,108333.333333333,1253.33333333333,81.6666666666667
"4804","17296","2016",8,8,0,166650,1692.75,112.75
"4805","17297","2016",55,54,1,450936.963636364,4631.89090909091,101.854545454545
"4806","17298","2016",15,15,0,194507.333333333,1454.13333333333,137.466666666667
"4807","17299","2016",464,250,214,124055.232758621,1630.13577586207,79.3405172413793
"4808","17300","2016",1552,535,1017,202388.681056701,3160.82860824742,66.902706185567
"4809","17302","2016",3,3,0,162666.666666667,1099.66666666667,150
"4810","17303","2016",15,15,0,137653.333333333,1359.66666666667,104.466666666667
"4811","17304","2016",3,3,0,78353.3333333333,646.333333333333,117
"4812","17305","2016",4,4,0,130250,1144,112.5
"4813","17306","2016",671,294,377,198220.898658718,2738.34724292101,72.7242921013413
"4814","17308","2016",33,33,0,167105.151515152,1584.54545454545,107.393939393939
"4815","17309","2016",22,22,0,85559.0909090909,1014,86.7727272727273
"4816","17310","2016",18,18,0,146510.055555556,1319.66666666667,112.277777777778
"4817","17311","2016",29,29,0,182857.517241379,2155.51724137931,85.2758620689655
"4818","17312","2016",10,10,0,115885,1074.9,113.9
"4819","17313","2016",5,5,0,97200,863,102.6
"4820","17314","2016",10,10,0,104600,1279.7,91
"4821","17315","2016",2,2,0,2e+05,1728.5,116
"4822","17316","2016",2,2,0,39000,440.5,88.5
"4823","17317","2016",5,5,0,164750,1409.8,121
"4824","17318","2016",29,29,0,361215.931034483,3727.72413793103,93.5862068965517
"4825","17319","2016",2,2,0,164400,1139,145
"4826","17320","2016",6,6,0,118000,1137.16666666667,117.833333333333
"4827","17321","2016",8,8,0,137243.75,1017.25,135.375
"4828","17322","2016",3,3,0,108333.333333333,1449.66666666667,75
"4829","17323","2016",40,38,2,195926.375,2836.25,73.975
"4830","17324","2016",1,1,0,145000,1318,110
"4831","17325","2016",9,9,0,81611.1111111111,917.888888888889,99.1111111111111
"4832","17326","2016",2,2,0,220900,1174.5,190.5
"4833","17327","2016",2,2,0,107500,700.5,153.5
"4834","17328","2016",13,13,0,107176.923076923,1056.61538461538,102.076923076923
"4835","17329","2016",7,7,0,133428.571428571,1405.28571428571,97.2857142857143
"4836","17330","2016",15,15,0,129300,1560.73333333333,87.5333333333333
"4837","17331","2016",12,12,0,104090.833333333,1278.08333333333,81.9166666666667
"4838","17332","2016",4,4,0,102750,1957.25,87
"4839","17333","2016",224,140,84,207716.339285714,3069.0625,70.1964285714286
"4840","17334","2016",4,4,0,149560,1097.25,144.5
"4841","17335","2016",10,10,0,110745,1137.4,100.2
"4842","17336","2016",23,23,0,191738.260869565,1658.82608695652,122.478260869565
"4843","17337","2016",157,148,9,189381.732484076,2687.71974522293,77.7324840764331
"4844","17338","2016",20,20,0,116241,1176.95,100.4
"4845","17339","2016",11,11,0,116390.909090909,1127.54545454545,111.545454545455
"4846","17340","2016",13,13,0,149269.230769231,1216.76923076923,124.153846153846
"4847","17341","2016",4,4,0,191250,1449.75,141.25
"4848","17342","2016",4,4,0,83875,1600,65
"4849","17343","2016",2,2,0,165000,1249,182.5
"4850","17344","2016",13,13,0,168474.230769231,1413.76923076923,120.692307692308
"4851","17345","2016",3,3,0,185500,1510.33333333333,119.333333333333
"4852","17346","2016",15,15,0,159505.066666667,1394.86666666667,112.2
"4853","17347","2016",75,71,4,116389.293333333,1107.28,112.413333333333
"4854","17348","2016",6,6,0,133713.333333333,1268.83333333333,112.833333333333
"4855","17349","2016",40,40,0,167077.25,1537.9,110
"4856","17350","2016",12,12,0,124088.333333333,1240.91666666667,101.166666666667
"4857","17351","2016",26,26,0,137072.538461538,1644.69230769231,86.0384615384615
"4858","17353","2016",38,38,0,210530.263157895,2044.55263157895,105.578947368421
"4859","17354","2016",5,5,0,141202,1254.8,118.6
"4860","17355","2016",2,2,0,135000,1580.5,83.5
"4861","17356","2016",6,6,0,96833.3333333333,1048.33333333333,91.5
"4862","17357","2016",2,2,0,98750,724.5,177.5
"4863","17358","2016",1,1,0,138000,993,139
"4864","17359","2016",16,16,0,144468.75,1247.5625,113.4375
"4865","17360","2016",81,80,1,488263.172839506,4574.20987654321,112.246913580247
"4866","17361","2016",2,2,0,88500,1066,76
"4867","17362","2016",2,2,0,112900,944,111
"4868","17363","2016",6,6,0,151588.333333333,1615.33333333333,96
"4869","17364","2016",5,5,0,235222,2414.2,144.6
"4870","17365","2016",6,6,0,116716.666666667,1141.83333333333,106.5
"4871","17366","2016",6,6,0,98666.6666666667,922,97
"4872","17367","2016",4,4,0,86250,606.5,137.25
"4873","17369","2016",59,31,28,382958.491525424,5030.62711864407,76.1186440677966
"4874","17373","2016",1,1,0,280000,1094,256
"4875","17374","2016",4,4,0,110712.5,1005,117.75
"4876","17375","2016",16,16,0,124862.5,1258.125,98.5625
"4877","17376","2016",15,15,0,184173.333333333,1904.26666666667,100
"4878","17377","2016",3,3,0,109166.666666667,963.666666666667,111.333333333333
"4879","17378","2016",6,6,0,107416.666666667,1049.16666666667,107.166666666667
"4880","17379","2016",1,1,0,44500,556,80
"4881","17380","2016",146,104,42,223745.315068493,3385.23287671233,72.9315068493151
"4882","17381","2016",3,3,0,108833.333333333,1046,96
"4883","17382","2016",3,3,0,116333.333333333,1308,88.6666666666667
"4884","17383","2016",3,3,0,162213.333333333,1159.66666666667,141
"4885","17384","2016",3,3,0,61000,826,69.6666666666667
"4886","17385","2016",155,152,3,189099.535483871,2466.02580645161,79.7161290322581
"4887","17386","2016",2,2,0,69000,707.5,102
"4888","17387","2016",15,15,0,149548.8,1451.93333333333,103.933333333333
"4889","17388","2016",2,2,0,210000,1592,128.5
"4890","17389","2016",3,3,0,259500,1679.33333333333,161
"4891","17391","2016",18,17,1,282802.777777778,2409.38888888889,115.5
"4892","17393","2016",17,17,0,142122.941176471,1223,116.705882352941
"4893","17394","2016",11,11,0,110518.181818182,1052.27272727273,111.727272727273
"4894","17395","2016",3,3,0,142000,1242.33333333333,114
"4895","17396","2016",20,19,1,166433.75,1649.25,101.55
"4896","17397","2016",28,28,0,112975,1231.85714285714,93.5
"4897","17398","2016",2,2,0,269500,2099,125
"4898","17400","2016",10,10,0,163229,1251.9,131.6
"4899","17401","2016",1,1,0,97000,626,155
"4900","17403","2016",10,10,0,146505,1558.5,99.2
"4901","17404","2016",8,8,0,150067.5,1399.75,108.5
"4902","17405","2016",2,2,0,139000,1018,130
"4903","17406","2016",6,6,0,146326.833333333,1673.66666666667,88.6666666666667
"4904","17407","2016",44,39,5,212351.477272727,1905.31818181818,113.727272727273
"4905","17408","2016",8,8,0,132775,1253.625,108
"4906","17409","2016",42,42,0,232634.166666667,2170.69047619048,105.904761904762
"4907","17410","2016",10,10,0,99579.5,1038.3,103
"4908","17411","2016",42,39,3,201669.047619048,3116.28571428571,69.6428571428571
"4909","17412","2016",6,6,0,137250,1398.33333333333,96.3333333333333
"4910","17413","2016",20,20,0,234362.5,2427.85,96.1
"4911","17414","2016",56,52,4,224531.5,2236.98214285714,101.357142857143
"4912","17415","2016",407,319,88,135313.493857494,1574.19656019656,87.4103194103194
"4913","17416","2016",3,3,0,98333.3333333333,833.333333333333,131.333333333333
"4914","17417","2016",1,1,0,97000,808,120
"4915","17418","2016",4,4,0,135000,842.75,155.75
"4916","17420","2016",28,28,0,248119.642857143,2381.78571428571,113.892857142857
"4917","17421","2016",150,133,17,159805.426666667,1866.34666666667,87.6266666666667
"4918","17422","2016",5,5,0,118400,782.8,139.2
"4919","17423","2016",1,1,0,90000,857,105
"4920","17424","2016",4,4,0,116818,916.75,130.75
"4921","17425","2016",25,25,0,183264.64,1821.28,103.36
"4922","17426","2016",6,6,0,109716.666666667,1186.33333333333,98.3333333333333
"4923","17427","2016",2,2,0,94000,737.5,117
"4924","17428","2016",2,2,0,89900,822,111
"4925","17429","2016",11,11,0,194909.090909091,1815.18181818182,108.545454545455
"4926","17430","2016",5,5,0,160600,2167.2,88.4
"4927","17431","2016",2,2,0,104000,1259,80
"4928","17432","2016",10,10,0,135088.9,1288.2,105.5
"4929","17433","2016",2,2,0,158750,1298,122
"4930","17434","2016",75,68,7,129467.133333333,1397.24,92.2533333333333
"4931","17435","2016",2,2,0,171250,1376.5,136
"4932","17436","2016",9,9,0,120792.222222222,1081.44444444444,111.666666666667
"4933","17437","2016",4,4,0,289950,2262.5,139
"4934","17438","2016",1,1,0,107400,1264,85
"4935","17439","2016",17,17,0,88200,1152.64705882353,81.9411764705882
"4936","17440","2016",7,7,0,103726.571428571,1201.42857142857,88.5714285714286
"4937","17441","2016",15,15,0,154233.333333333,1443.53333333333,112.133333333333
"4938","17442","2016",6,6,0,187125,1278.5,146
"4939","17443","2016",29,29,0,189882.068965517,1726.10344827586,112.137931034483
"4940","17444","2016",13,12,1,137192.307692308,1587.84615384615,90.3076923076923
"4941","17445","2016",1,1,0,47000,427,110
"4942","17446","2016",5,5,0,110000,1268.8,89.8
"4943","17447","2016",21,20,1,150000.952380952,1578.33333333333,99.3809523809524
"4944","17448","2016",22,21,1,108090.909090909,1180.95454545455,91.3181818181818
"4945","17449","2016",101,86,15,136229.97029703,1487.82178217822,91.4752475247525
"4946","17450","2016",1,1,0,126000,1448,87
"4947","17451","2016",2,2,0,59250,1132.5,83.5
"4948","17452","2016",117,107,10,186023.213675214,2444.81196581197,84.1880341880342
"4949","17453","2016",31,13,18,170491.129032258,5690.12903225806,55.2903225806452
"4950","17454","2016",6,6,0,126641.666666667,1194.16666666667,109.166666666667
"4951","17455","2016",3,3,0,96000,1128,84.3333333333333
"4952","17457","2016",14,14,0,122471.428571429,1391.92857142857,94.1428571428571
"4953","17458","2016",1,1,0,335000,1791,187
"4954","17459","2016",7,7,0,154700,983,134.714285714286
"4955","17460","2016",15,15,0,151638.333333333,1504.33333333333,100.866666666667
"4956","17461","2016",175,106,69,221991.142857143,3329.92571428571,69.96
"4957","17462","2016",12,12,0,139034.583333333,1472.83333333333,99.1666666666667
"4958","17463","2016",7,7,0,187872.571428571,1807.57142857143,102.571428571429
"4959","17464","2016",2,2,0,95000,759.5,132.5
"4960","17465","2016",2,2,0,83500,602.5,126
"4961","17466","2016",29,29,0,213201.379310345,1725.72413793103,128.793103448276
"4962","17467","2016",2,2,0,222500,2301.5,101
"4963","17468","2016",1,1,0,180100,1407,128
"4964","17469","2016",6,6,0,123945,1309.33333333333,103.333333333333
"4965","17470","2016",5,5,0,75040,914.6,98.2
"4966","17471","2016",4,4,0,59350,784.75,81.75
"4967","17472","2016",36,36,0,183238.888888889,2117.91666666667,90.75
"4968","17473","2016",2,2,0,126425,1048.5,181
"4969","17474","2016",11,11,0,121730.909090909,1033.27272727273,117.454545454545
"4970","17476","2016",3,3,0,97900,778,121.666666666667
"4971","17477","2016",1,1,0,76000,1520,50
"4972","17479","2016",1,1,0,116000,829,140
"4973","17480","2016",11,11,0,157215.454545455,1265.27272727273,131.818181818182
"4974","17481","2016",1,1,0,291400,928,314
"4975","17482","2016",7,7,0,150500.285714286,1494.14285714286,106.142857142857
"4976","17483","2016",18,18,0,242225,2192.72222222222,112.5
"4977","17484","2016",37,36,1,146813.72972973,1753.7027027027,84.4864864864865
"4978","17485","2016",25,25,0,234317.92,2774.08,85.6
"4979","17486","2016",41,40,1,176063.536585366,3113.07317073171,61.1463414634146
"4980","18001","2016",4,4,0,84897.5,999,86.25
"4981","18002","2016",3,3,0,38666.6666666667,625.666666666667,57.3333333333333
"4982","18003","2016",15,15,0,97833.3333333333,1104.6,98.6
"4983","18004","2016",14,14,0,118900.714285714,1112.14285714286,105.357142857143
"4984","18005","2016",10,10,0,101095,1150.5,85.1
"4985","18006","2016",3,3,0,102000,1040,95.6666666666667
"4986","18008","2016",12,12,0,150389.166666667,1374.41666666667,120.416666666667
"4987","18010","2016",1,1,0,75000,833,90
"4988","18011","2016",25,24,1,79583.68,1010.92,81.92
"4989","18012","2016",6,6,0,78750,928.166666666667,78.5
"4990","18013","2016",1,1,0,75000,765,98
"4991","18014","2016",3,3,0,1e+05,1301,77.3333333333333
"4992","18015","2016",56,55,1,102059.125,1210.01785714286,81.6607142857143
"4993","18016","2016",3,3,0,164166.666666667,1258.33333333333,129.666666666667
"4994","18017","2016",7,7,0,59714.2857142857,713.142857142857,81.2857142857143
"4995","18018","2016",20,20,0,116161,1250.7,94.45
"4996","18019","2016",3,3,0,82833.3333333333,676.333333333333,119.666666666667
"4997","18020","2016",10,10,0,87200,945.5,90.1
"4998","18021","2016",4,4,0,61000,713.75,90.5
"4999","18022","2016",1,1,0,80000,714,112
"5000","18023","2016",26,26,0,125746.153846154,1211.84615384615,107.692307692308
"5001","18024","2016",1,1,0,18000,375,48
"5002","18025","2016",6,6,0,97916.6666666667,991.833333333333,96.1666666666667
"5003","18026","2016",4,4,0,82250,1141.5,73
"5004","18027","2016",10,10,0,87750,895.1,102.8
"5005","18028","2016",16,16,0,145539.75,1458.1875,98.8125
"5006","18029","2016",2,2,0,72500,1128.5,95
"5007","18030","2016",11,11,0,115015.454545455,1209.18181818182,95.6363636363636
"5008","18031","2016",8,8,0,82000,956.25,87
"5009","18032","2016",18,18,0,102930.555555556,1204.27777777778,91.7222222222222
"5010","18033","2016",845,470,375,118070.10295858,1449.28165680473,81.6804733727811
"5011","18034","2016",2,2,0,105000,1045.5,100.5
"5012","18035","2016",13,13,0,167155.384615385,1297.53846153846,126.230769230769
"5013","18036","2016",1,1,0,2e+05,1770,113
"5014","18037","2016",9,9,0,116055.555555556,1139.88888888889,100.555555555556
"5015","18038","2016",1,1,0,190000,1092,174
"5016","18039","2016",2,2,0,185000,2101,91
"5017","18040","2016",4,4,0,90000,857.25,120.25
"5018","18042","2016",5,5,0,98500,1147.8,80.8
"5019","18044","2016",2,2,0,117500,1034.5,114
"5020","18045","2016",10,10,0,84700,777.3,103
"5021","18046","2016",2,2,0,105000,1084.5,97
"5022","18047","2016",7,7,0,85321.4285714286,1059,75.7142857142857
"5023","18048","2016",7,7,0,79928.5714285714,1104.85714285714,82.1428571428571
"5024","18049","2016",6,6,0,91166.6666666667,879.666666666667,99.3333333333333
"5025","18050","2016",24,24,0,136943.75,1357.625,99.1666666666667
"5026","18051","2016",3,3,0,119000,980.666666666667,119.333333333333
"5027","18052","2016",7,7,0,78214.2857142857,805.714285714286,96.2857142857143
"5028","18053","2016",1,1,0,102500,788,130
"5029","18054","2016",3,3,0,344950.666666667,3368.66666666667,125
"5030","18055","2016",10,10,0,89750,832.4,104.3
"5031","18056","2016",2,2,0,420250,3659,98
"5032","18057","2016",13,13,0,55846.1538461538,729.692307692308,80.1538461538462
"5033","18058","2016",9,9,0,78911.1111111111,956.888888888889,83.7777777777778
"5034","18059","2016",5,5,0,92700,980.8,96.6
"5035","18061","2016",1,1,0,597368,5106,117
"5036","18062","2016",2,2,0,155000,1747,87
"5037","18063","2016",1,1,0,132000,1282,103
"5038","18064","2016",4,4,0,58875,924.25,66.25
"5039","18065","2016",6,6,0,59091.6666666667,700,88
"5040","18066","2016",6,6,0,119583.333333333,1122,107.833333333333
"5041","18067","2016",13,13,0,116070.384615385,1177.92307692308,99.3076923076923
"5042","18069","2016",5,5,0,104300,1150.8,88.6
"5043","18071","2016",2,2,0,97500,1079.5,90
"5044","18072","2016",3,3,0,68666.6666666667,860.333333333333,74.6666666666667
"5045","18073","2016",3,3,0,78333.3333333333,649,119.666666666667
"5046","18074","2016",4,4,0,57750,856.25,72
"5047","18075","2016",15,14,1,104320,1223,88.8
"5048","18076","2016",8,8,0,98250,1059.5,94.25
"5049","18077","2016",4,4,0,87000,1077.25,77.25
"5050","18078","2016",1,1,0,145000,954,152
"5051","18079","2016",5,5,0,407386.6,2737.8,101.4
"5052","18080","2016",3,3,0,78000,950.666666666667,82
"5053","18081","2016",6,6,0,130333.333333333,1268.83333333333,105
"5054","18082","2016",19,19,0,117256.736842105,1229.94736842105,96.4736842105263
"5055","18083","2016",6,5,1,71141.8333333333,939,83
"5056","18084","2016",2,2,0,284677.5,1185.5,203.5
"5057","18085","2016",6,6,0,96183.3333333333,1086.66666666667,89.6666666666667
"5058","18086","2016",9,9,0,133605.555555556,1065.44444444444,116.777777777778
"5059","18087","2016",40,40,0,81942.85,931.275,85.3
"5060","18089","2016",6,6,0,112012.333333333,1178.83333333333,80.8333333333333
"5061","18090","2016",5,5,0,90400,864.8,102.8
"5062","18091","2016",2,2,0,161000,2905.5,72.5
"5063","18092","2016",13,13,0,115961.538461538,1367.92307692308,87.9230769230769
"5064","18093","2016",1,1,0,116600,707,165
"5065","18094","2016",3,3,0,95000,929.333333333333,92.6666666666667
"5066","18096","2016",25,25,0,89531,1141.92,78.84
"5067","18097","2016",15,15,0,159906.666666667,1444.8,110.733333333333
"5068","18098","2016",3,3,0,77666.6666666667,840.333333333333,85
"5069","18099","2016",4,4,0,67500,765.75,85.25
"5070","18100","2016",10,10,0,56050,675.2,86.3
"5071","18101","2016",9,9,0,64111.1111111111,847.333333333333,76.4444444444444
"5072","18102","2016",3,3,0,89666.6666666667,989.333333333333,87.3333333333333
"5073","18103","2016",19,19,0,67528.9473684211,878.526315789474,79.8421052631579
"5074","18105","2016",10,10,0,104814.6,1187.1,88.9
"5075","18106","2016",4,4,0,62000,582.5,100.25
"5076","18107","2016",2,2,0,67000,848.5,78
"5077","18108","2016",30,30,0,83146.1666666667,914.133333333333,92.7
"5078","18109","2016",23,23,0,87814.347826087,980.913043478261,91.3478260869565
"5079","18110","2016",9,9,0,101111.111111111,994.111111111111,103.777777777778
"5080","18111","2016",3,3,0,115500,1025.66666666667,110
"5081","18112","2016",8,8,0,78897.5,1028.75,74.625
"5082","18113","2016",3,3,0,62500,734.666666666667,78.6666666666667
"5083","18115","2016",15,15,0,98866.6666666667,1172.33333333333,90.4
"5084","18116","2016",5,5,0,99548,942.6,109
"5085","18117","2016",5,5,0,115800,847.8,142.6
"5086","18118","2016",18,18,0,84363.5,822.222222222222,93.7777777777778
"5087","18120","2016",6,6,0,67375,785.333333333333,79.3333333333333
"5088","18121","2016",2,2,0,132500,1377.5,90.5
"5089","18122","2016",3,3,0,95000,994.333333333333,102.333333333333
"5090","18124","2016",2,2,0,55275,713.5,73
"5091","18125","2016",11,11,0,82181.8181818182,941.272727272727,100.818181818182
"5092","18126","2016",13,13,0,113896.769230769,1107.61538461538,109.692307692308
"5093","18127","2016",12,11,1,64158.3333333333,966.916666666667,69.4166666666667
"5094","18128","2016",2,2,0,80000,1000,80
"5095","18129","2016",4,4,0,177000,1376,130.75
"5096","18130","2016",6,5,1,66000,835.333333333333,80.1666666666667
"5097","18132","2016",1,1,0,142000,1136,125
"5098","18133","2016",13,13,0,69707.6923076923,795.076923076923,81.6153846153846
"5099","18134","2016",6,6,0,207833.333333333,1180.5,186.333333333333
"5100","18135","2016",3,3,0,101500,1180.33333333333,82.6666666666667
"5101","18136","2016",1,1,0,40000,645,62
"5102","18137","2016",4,4,0,119725,1095,107.75
"5103","18138","2016",25,23,2,137506.4,1316.76,106
"5104","18139","2016",11,10,1,91772.7272727273,1115.27272727273,87.6363636363636
"5105","18140","2016",16,16,0,92418.75,1071,87
"5106","18141","2016",85,82,3,105319.352941176,1203.87058823529,90.2470588235294
"5107","18142","2016",6,6,0,61041.6666666667,719.5,79.6666666666667
"5108","18144","2016",6,6,0,82833.3333333333,801.833333333333,94.5
"5109","18145","2016",12,12,0,129041.666666667,1249.58333333333,105.75
"5110","18146","2016",5,5,0,69700,812.8,83
"5111","18147","2016",1,1,0,1e+05,1220,82
"5112","18148","2016",18,18,0,108263.888888889,1156.5,96.1111111111111
"5113","18149","2016",7,7,0,140571.428571429,1357.42857142857,107
"5114","18150","2016",5,5,0,61800,881.4,71.8
"5115","18151","2016",5,5,0,91900,1038.2,88.6
"5116","18152","2016",1,1,0,188800,1349,140
"5117","18153","2016",1,1,0,125000,1250,100
"5118","18154","2016",3,3,0,81666.6666666667,926,83
"5119","18155","2016",7,7,0,63571.4285714286,667.285714285714,96.5714285714286
"5120","18156","2016",2,2,0,125850,1369,91.5
"5121","18157","2016",13,13,0,143233.538461538,1419.84615384615,100.615384615385
"5122","18158","2016",5,5,0,177520,1621.8,109
"5123","18159","2016",7,7,0,104600,1241.28571428571,85
"5124","18160","2016",11,11,0,73652.7272727273,839.181818181818,88.3636363636364
"5125","18161","2016",7,7,0,69142.8571428571,784.857142857143,90
"5126","18162","2016",1,1,0,71000,628,113
"5127","18163","2016",2,2,0,56450,826,78.5
"5128","18164","2016",1,1,0,71000,910,78
"5129","18165","2016",17,17,0,131911.764705882,1921.64705882353,85.2941176470588
"5130","18166","2016",3,3,0,104333.333333333,1144,84.3333333333333
"5131","18167","2016",3,3,0,39666.6666666667,672,59.6666666666667
"5132","18168","2016",4,4,0,146375,1147.5,114
"5133","18169","2016",4,4,0,143997.5,1207,108.25
"5134","18170","2016",12,12,0,87541.6666666667,989.333333333333,91.3333333333333
"5135","18171","2016",1,1,0,91500,817,112
"5136","18172","2016",10,10,0,65090,953.8,66.8
"5137","18173","2016",2,2,0,59500,815,78.5
"5138","18175","2016",10,10,0,101100,1133.5,94.5
"5139","18176","2016",3,3,0,123333.333333333,776.333333333333,137.333333333333
"5140","18178","2016",2,2,0,88500,794,111.5
"5141","18179","2016",9,8,1,110711.111111111,1163,95
"5142","18180","2016",17,17,0,150274.705882353,1299.05882352941,112.823529411765
"5143","18181","2016",2,2,0,111500,2210,90
"5144","18182","2016",5,5,0,95300,1185.6,96
"5145","18183","2016",1,1,0,40000,741,54
"5146","18184","2016",2,2,0,33000,541,59
"5147","18185","2016",1,1,0,450000,1406,320
"5148","18186","2016",2,2,0,117500,818.5,136
"5149","18187","2016",5,5,0,90400,917,94.4
"5150","18188","2016",3,3,0,65000,1127.66666666667,55.3333333333333
"5151","18189","2016",5,5,0,86500,876.2,100.6
"5152","18190","2016",11,11,0,66590.9090909091,841.272727272727,78.6363636363636
"5153","18191","2016",2,2,0,143500,1189,115
"5154","18192","2016",4,4,0,59752.5,695,87.25
"5155","18193","2016",1,1,0,70000,438,160
"5156","18194","2016",5,5,0,132700,1405.6,97.4
"5157","18195","2016",8,8,0,79437.5,823.875,101.875
"5158","18196","2016",2,2,0,61000,588.5,105
"5159","18197","2016",114,100,14,97242.4561403509,1074.64912280702,90.7543859649123
"5160","18198","2016",3,3,0,76333.3333333333,809.333333333333,83
"5161","18199","2016",4,4,0,76250,726.75,112.5
"5162","18200","2016",1,1,0,36100,802,45
"5163","18201","2016",3,3,0,157666.666666667,1492.33333333333,104.666666666667
"5164","18202","2016",1,1,0,63000,1000,63
"5165","18204","2016",3,3,0,130983.333333333,815.333333333333,162.333333333333
"5166","18205","2016",112,109,3,163080.803571429,1535.52678571429,106.75
"5167","18206","2016",13,13,0,167446.153846154,1329.84615384615,126.076923076923
"5168","18207","2016",63,58,5,89985.4761904762,1137.07936507937,80.8730158730159
"5169","18208","2016",8,8,0,122500,1337.375,95.125
"5170","18209","2016",5,5,0,133500,1340.2,109.2
"5171","18210","2016",7,7,0,124285.714285714,1377.57142857143,90.8571428571429
"5172","18211","2016",6,6,0,122316.666666667,1111,108.666666666667
"5173","18212","2016",6,6,0,97166.6666666667,1031.5,89.1666666666667
"5174","18213","2016",39,39,0,122674.358974359,1357.79487179487,94.1282051282051
"5175","18214","2016",3,3,0,98333.3333333333,1078,94.6666666666667
"5176","18215","2016",2,2,0,102000,970,105.5
"5177","18216","2016",6,6,0,51250,769.833333333333,63.5
"5178","18217","2016",2,2,0,61750,678.5,91
"5179","18218","2016",2,2,0,53250,710.5,87
"5180","18219","2016",5,5,0,96235.8,897.6,106
"5181","18220","2016",8,8,0,67750,790.625,82.375
"5182","18221","2016",3,3,0,137500,995,139.333333333333
"5183","18223","2016",28,27,1,129213.928571429,1288.89285714286,106
"5184","18224","2016",8,8,0,82437.5,1219.25,67.125
"5185","18225","2016",2,2,0,52500,554.5,95.5
"5186","18226","2016",1,1,0,137000,1142,120
"5187","18227","2016",3,3,0,587633.333333333,5029.66666666667,72.3333333333333
"5188","18228","2016",2,2,0,87500,1235,61
"5189","18229","2016",5,5,0,110230,1148,101.6
"5190","18230","2016",2,2,0,132500,1378.5,96.5
"5191","18231","2016",8,8,0,93025,938.875,95.875
"5192","18232","2016",6,6,0,74333.3333333333,1612.5,51.6666666666667
"5193","18233","2016",15,14,1,83243.6,999.066666666667,86.8
"5194","18234","2016",10,10,0,64004,804.5,88.3
"5195","18235","2016",14,14,0,126660.714285714,1235.5,102.928571428571
"5196","18236","2016",1,1,0,131000,970,135
"5197","18237","2016",5,5,0,90050,1062.4,72.8
"5198","18238","2016",2,2,0,39250,500,78
"5199","18240","2016",6,6,0,105666.666666667,943.5,114.833333333333
"5200","18241","2016",18,14,4,115277.777777778,1366.94444444444,82.6666666666667
"5201","18242","2016",37,37,0,81097.2972972973,844.837837837838,100.72972972973
"5202","18243","2016",4,4,0,60375,818.5,69.5
"5203","18245","2016",5,5,0,70460,699,115.2
"5204","18246","2016",17,17,0,91094.1176470588,989.588235294118,95.8235294117647
"5205","18247","2016",5,5,0,96400,1072.8,95.2
"5206","18248","2016",4,4,0,126250,1255,99.25
"5207","18249","2016",9,9,0,64966.6666666667,955.444444444444,74.2222222222222
"5208","18250","2016",1,1,0,530623,7370,72
"5209","18252","2016",6,6,0,96166.6666666667,1220.33333333333,81.6666666666667
"5210","18253","2016",5,4,1,118000,1099,105.8
"5211","18254","2016",4,4,0,185875,1165.25,148.5
"5212","18255","2016",6,6,0,178000,1709.5,105.5
"5213","18256","2016",3,3,0,93666.6666666667,1104,87
"5214","18257","2016",5,5,0,94400,1110,95
"5215","18258","2016",3,3,0,156333.333333333,2112.33333333333,80.6666666666667
"5216","18259","2016",2,2,0,64500,870,75.5
"5217","18260","2016",2,2,0,49000,460,109
"5218","18261","2016",8,8,0,119855,1469.25,90.25
"5219","18262","2016",2,2,0,99870,1444,78
"5220","18263","2016",8,8,0,143750,971.75,132.5
"5221","18264","2016",1,1,0,122000,961,127
"5222","18265","2016",11,11,0,72045.4545454545,869.818181818182,84.4545454545455
"5223","18266","2016",4,4,0,69526.75,908,80.75
"5224","18267","2016",21,21,0,152375.238095238,1408.2380952381,108.047619047619
"5225","18268","2016",5,5,0,73500,757.8,94.4
"5226","18269","2016",8,8,0,77853.75,969,79.625
"5227","18270","2016",4,4,0,95250,1006.75,90.25
"5228","18271","2016",13,13,0,152638.692307692,1657.84615384615,94.9230769230769
"5229","18272","2016",5,5,0,54400,610.2,90.4
"5230","18273","2016",10,10,0,72060,903.4,76.5
"5231","18274","2016",4,4,0,105750,907.5,124.25
"5232","18275","2016",2,2,0,59682,495.5,121.5
"5233","18276","2016",3,3,0,88437.3333333333,1040.66666666667,76.6666666666667
"5234","18278","2016",10,10,0,61350,942.1,68
"5235","18279","2016",271,226,45,75114.3136531365,969.191881918819,79.760147601476
"5236","18280","2016",3,3,0,173000,1255.33333333333,136.333333333333
"5237","18281","2016",29,29,0,119427.586206897,1170.41379310345,104.48275862069
"5238","18282","2016",7,7,0,113071.428571429,1159.28571428571,95.7142857142857
"5239","18283","2016",1,1,0,77000,1013,76
"5240","18285","2016",4,4,0,71000,834.75,91
"5241","18286","2016",7,7,0,70214.2857142857,696.428571428571,102.285714285714
"5242","18287","2016",1,1,0,97000,1212,80
"5243","18288","2016",3,3,0,74750,854.666666666667,98.6666666666667
"5244","18289","2016",8,8,0,120812.5,1135,113.75
"5245","18290","2016",7,7,0,93000,1237.57142857143,77.5714285714286
"5246","19002","2016",5,5,0,86500,1082.2,88
"5247","19004","2016",6,6,0,105286.333333333,1109.33333333333,94
"5248","19005","2016",33,32,1,117434.848484848,1220.57575757576,99.1515151515152
"5249","19007","2016",12,12,0,158658.333333333,1317.16666666667,118.916666666667
"5250","19008","2016",2,2,0,130950,1048.5,115.5
"5251","19010","2016",32,30,2,129079.6875,1289,102.59375
"5252","19011","2016",14,13,1,134032.285714286,1123.28571428571,117.714285714286
"5253","19012","2016",1,1,0,75000,1210,62
"5254","19013","2016",7,7,0,120800,1375,81.7142857142857
"5255","19014","2016",4,4,0,121250,1637.5,78
"5256","19015","2016",8,8,0,93125,943.125,102.75
"5257","19016","2016",4,4,0,70575,609.75,110.25
"5258","19018","2016",1,1,0,45000,417,108
"5259","19019","2016",14,12,2,91745.3571428571,1381.92857142857,74.7142857142857
"5260","19021","2016",3,3,0,93833.3333333333,1036.33333333333,92.3333333333333
"5261","19022","2016",4,4,0,74487.5,1128,72.5
"5262","19023","2016",14,14,0,124165,1623.92857142857,78.5
"5263","19024","2016",4,4,0,170500,1604.5,105.25
"5264","19025","2016",2,2,0,107950,1360,77.5
"5265","19027","2016",3,3,0,41980,755,57
"5266","19029","2016",1,1,0,173000,2471,70
"5267","19030","2016",10,10,0,132430,1264.4,108.7
"5268","19031","2016",630,318,312,113709.865079365,1430.9380952381,79.4301587301587
"5269","19033","2016",6,6,0,58654.1666666667,645.666666666667,94
"5270","19035","2016",2,2,0,72100,1410.5,57
"5271","19036","2016",17,17,0,86808.2352941177,970,94.2941176470588
"5272","19037","2016",14,14,0,84607.1428571429,1026.21428571429,85.6428571428571
"5273","19038","2016",8,8,0,119500,1221.875,104.75
"5274","19039","2016",2,2,0,73500,814.5,95
"5275","19041","2016",4,4,0,161625,1211.5,139
"5276","19042","2016",8,8,0,113875,1285.25,90.875
"5277","19043","2016",5,5,0,147330,1346.2,109.2
"5278","19044","2016",6,6,0,93666.6666666667,1213.66666666667,89.8333333333333
"5279","19045","2016",2,2,0,124057.5,1941,92.5
"5280","19047","2016",2,2,0,136525,1250.5,124.5
"5281","19048","2016",2,2,0,150000,1689,89
"5282","19049","2016",5,4,1,128600,2115.4,72
"5283","19050","2016",6,6,0,144450,1633.33333333333,98.5
"5284","19051","2016",4,4,0,65125,954.5,73.25
"5285","19052","2016",1,1,0,39000,390,100
"5286","19053","2016",3,3,0,148333.333333333,1522.33333333333,95
"5287","19054","2016",1,1,0,48500,622,78
"5288","19055","2016",4,4,0,107362.5,1354.25,87
"5289","19056","2016",1,1,0,126850,900,141
"5290","19057","2016",8,7,1,140884.5,1872.25,86.125
"5291","19058","2016",2,2,0,92500,975,95
"5292","19060","2016",3,3,0,123666.666666667,1033,128.333333333333
"5293","19061","2016",9,9,0,102655.555555556,1138,93
"5294","19062","2016",8,8,0,155348.75,1534.875,110.25
"5295","19063","2016",28,28,0,185121.25,1532.53571428571,126.428571428571
"5296","19064","2016",1,1,0,25000,385,65
"5297","19066","2016",19,19,0,133048.842105263,1270.73684210526,109.105263157895
"5298","19067","2016",4,4,0,162625,1185.5,153.5
"5299","19068","2016",4,4,0,148475,1586.25,102.25
"5300","19072","2016",36,33,3,133577.444444444,1314.25,102.361111111111
"5301","19073","2016",25,22,3,77010,917.88,88.28
"5302","19075","2016",5,5,0,107200,1092.2,102.4
"5303","19076","2016",5,5,0,174060,1402,124.4
"5304","19077","2016",4,4,0,253500,1345.75,187.25
"5305","19078","2016",5,5,0,56800,831.6,71.4
"5306","19079","2016",7,7,0,90857.1428571429,968.857142857143,88.7142857142857
"5307","19080","2016",5,5,0,53100,879.2,66
"5308","19081","2016",5,5,0,111560,1127.6,93.6
"5309","19082","2016",1,1,0,175300,1753,100
"5310","19084","2016",3,3,0,44000,638.666666666667,70
"5311","19085","2016",10,8,2,103150,1203.2,87.7
"5312","19087","2016",1,1,0,55000,1058,52
"5313","19088","2016",1,1,0,45000,484,93
"5314","19089","2016",3,3,0,73333.3333333333,752.666666666667,84.3333333333333
"5315","19093","2016",7,7,0,190191.428571429,1443.42857142857,131.857142857143
"5316","19094","2016",12,12,0,112125,1201.16666666667,97.5833333333333
"5317","19096","2016",2,2,0,100250,1084.5,92.5
"5318","19097","2016",2,2,0,85000,666.5,130
"5319","19098","2016",6,6,0,116242.833333333,1337,92.8333333333333
"5320","19100","2016",16,16,0,88837.5,1011.4375,91.1875
"5321","19101","2016",13,13,0,88530.7692307692,949,91.6923076923077
"5322","19102","2016",3,3,0,29433.3333333333,437.333333333333,66.6666666666667
"5323","19103","2016",1,1,0,56000,757,74
"5324","19105","2016",1,1,0,124000,1033,120
"5325","19106","2016",6,6,0,70666.6666666667,880.5,80
"5326","19107","2016",12,9,3,115725.833333333,1356.91666666667,86.75
"5327","19109","2016",3,3,0,161866.666666667,2235,72.3333333333333
"5328","19111","2016",2,2,0,97000,1516.5,66
"5329","19113","2016",7,7,0,108914.285714286,1052.57142857143,104.285714285714
"5330","19114","2016",1,1,0,45000,474,95
"5331","19115","2016",1,1,0,83000,2371,35
"5332","19116","2016",3,3,0,122333.333333333,1265.66666666667,100.666666666667
"5333","19117","2016",8,8,0,149500,1274.5,112.875
"5334","19119","2016",1,1,0,50000,694,72
"5335","19120","2016",1,1,0,225240,2145,105
"5336","19121","2016",14,13,1,75992.8571428571,847.571428571429,90.5
"5337","19123","2016",76,67,9,133757.763157895,1470.97368421053,92.0394736842105
"5338","19124","2016",9,8,1,143444.444444444,1844.11111111111,80.1111111111111
"5339","19125","2016",7,7,0,86852.1428571429,1170.71428571429,95.1428571428571
"5340","19126","2016",3,3,0,77540,967.666666666667,82
"5341","19128","2016",1,1,0,94000,1093,86
"5342","19129","2016",10,10,0,72400,773.4,97.9
"5343","19130","2016",1,1,0,21500,430,50
"5344","19131","2016",7,7,0,100333.285714286,1081.42857142857,95.4285714285714
"5345","19132","2016",1,1,0,55000,550,100
"5346","19134","2016",5,5,0,78600,966.6,82.2
"5347","19135","2016",2,2,0,132825,1238.5,118
"5348","19136","2016",25,20,5,86312.4,907.96,92.76
"5349","19138","2016",15,15,0,126289.333333333,1382.06666666667,98.4666666666667
"5350","19140","2016",7,7,0,86285.7142857143,1046.28571428571,82.4285714285714
"5351","19143","2016",4,4,0,101312.5,997.5,107.75
"5352","19144","2016",4,4,0,74375,1448.25,50
"5353","19145","2016",6,6,0,75166.6666666667,1040.83333333333,72.8333333333333
"5354","19146","2016",15,15,0,123196.333333333,1072.4,119
"5355","19147","2016",2,2,0,132500,1095.5,101.5
"5356","19148","2016",13,13,0,87856.7692307692,1060.30769230769,84
"5357","19149","2016",5,5,0,54610,814.4,67.6
"5358","19150","2016",1,1,0,88000,2200,40
"5359","19151","2016",8,8,0,144550,1460,99.25
"5360","19152","2016",4,4,0,107400,1334.75,81
"5361","19153","2016",31,23,8,99619.2258064516,1384.12903225806,73.0322580645161
"5362","19154","2016",6,6,0,111916.666666667,1270.66666666667,84.6666666666667
"5363","19155","2016",5,5,0,68260,1020,70.2
"5364","19157","2016",4,4,0,65750,1037.75,63.25
"5365","19160","2016",5,5,0,65176,693.8,96.8
"5366","19161","2016",2,2,0,180000,1329,114.5
"5367","19162","2016",13,13,0,91861.5384615385,1288.15384615385,76.4615384615385
"5368","19163","2016",3,3,0,187833.333333333,1484.33333333333,126.666666666667
"5369","19164","2016",4,4,0,62075,799.5,84.75
"5370","19169","2016",4,4,0,120812.5,1383,77.5
"5371","19170","2016",5,5,0,94200,1135.4,82.8
"5372","19175","2016",3,3,0,90000,1099,88
"5373","19176","2016",4,3,1,136250,1416.25,98
"5374","19178","2016",5,5,0,115650,1198.2,104.6
"5375","19179","2016",2,2,0,101000,1074,93
"5376","19180","2016",7,7,0,101435.714285714,909,109
"5377","19181","2016",7,6,1,79044,922.857142857143,90.4285714285714
"5378","19182","2016",6,6,0,103316.666666667,1192.5,87.1666666666667
"5379","19184","2016",2,2,0,73000,1089.5,66.5
"5380","19186","2016",2,2,0,74000,1225,60
"5381","19187","2016",2,2,0,57500,816,70
"5382","19188","2016",3,3,0,132333.333333333,996,130
"5383","19190","2016",1,1,0,110000,1358,81
"5384","19191","2016",2,2,0,96000,1103.5,86.5
"5385","19192","2016",8,8,0,81900,811.75,100.875
"5386","19194","2016",11,10,1,125952.272727273,1379.45454545455,89.3636363636364
"5387","19195","2016",1,1,0,150000,1515,99
"5388","19196","2016",4,4,0,198001.25,1768.75,122.25
"5389","19198","2016",1,1,0,48000,440,109
"5390","19199","2016",5,5,0,64400,674,96
"5391","19201","2016",11,11,0,95010.4545454545,1070.54545454545,91.1818181818182
"5392","19202","2016",12,11,1,150691.083333333,1369.5,108.166666666667
"5393","19203","2016",9,9,0,115787.777777778,1230.44444444444,100.222222222222
"5394","19204","2016",1,1,0,118000,1475,80
"5395","19206","2016",2,1,1,97500,1210,80
"5396","19207","2016",10,10,0,131168,1527.7,90.6
"5397","19208","2016",3,3,0,65666.6666666667,1087.33333333333,57.6666666666667
"5398","19210","2016",1,1,0,115000,1322,87
"5399","19211","2016",5,5,0,179153,1428.4,148.4
"5400","19213","2016",4,4,0,89250,752.75,116.75
"5401","19216","2016",3,3,0,69000,639.333333333333,110.333333333333
"5402","19217","2016",3,3,0,188830,1671,124
"5403","19219","2016",2,2,0,88400,999,88.5
"5404","19220","2016",4,4,0,132475,1190.25,110.5
"5405","19221","2016",3,3,0,82333.3333333333,976.666666666667,97.3333333333333
"5406","19222","2016",9,9,0,81055.5555555556,1092.55555555556,75.1111111111111
"5407","19223","2016",2,2,0,192500,2693.5,70
"5408","19225","2016",8,7,1,70911.25,928.625,75.75
"5409","19226","2016",1,1,0,60000,1667,36
"5410","19227","2016",13,13,0,162604.307692308,1637.53846153846,98.9230769230769
"5411","19229","2016",38,35,3,138796.815789474,1523.44736842105,93.4210526315789
"5412","19230","2016",5,5,0,145800,1429.6,101.4
"5413","19231","2016",1,1,0,1e+05,1493,67
"5414","19233","2016",3,3,0,86846.6666666667,883.666666666667,95
"5415","19234","2016",1,1,0,160000,1416,113
"5416","19235","2016",1,1,0,20000,417,48
"5417","19237","2016",5,5,0,153900,962.2,156.8
"5418","19238","2016",6,6,0,59158.3333333333,744.333333333333,77.5
"5419","19239","2016",2,2,0,72500,861,85
"5420","19240","2016",4,4,0,83732.5,783.25,100.25
"5421","19241","2016",6,6,0,76786.6666666667,885.833333333333,83.1666666666667
"5422","19242","2016",3,2,1,66250,871.666666666667,73.3333333333333
"5423","19243","2016",14,14,0,118928.571428571,1433.14285714286,83.9285714285714
"5424","19245","2016",3,3,0,103333.333333333,960.666666666667,124.666666666667
"5425","19246","2016",11,11,0,116459.090909091,1386.27272727273,83.9090909090909
"5426","19247","2016",3,3,0,80666.6666666667,953,81
"5427","19248","2016",5,5,0,121336,1075.4,112.2
"5428","19249","2016",4,4,0,64975,774.5,82
"5429","19250","2016",6,6,0,90250,1047,87.8333333333333
"5430","19251","2016",4,4,0,106797.5,957,136.75
"5431","19252","2016",6,6,0,149000,1355,105
"5432","19253","2016",1,1,0,288000,3310,87
"5433","19254","2016",3,3,0,56000,911.666666666667,59.6666666666667
"5434","19255","2016",8,8,0,131262.5,1384.75,92.875
"5435","19256","2016",4,4,0,85790,996.5,79.25
"5436","19257","2016",4,4,0,107125,1140.75,90.5
"5437","19260","2016",2,2,0,111500,1602.5,69
"5438","19261","2016",8,8,0,88206.25,1030,85.625
"5439","19263","2016",3,3,0,104616.666666667,1098.66666666667,89.6666666666667
"5440","19264","2016",1,1,0,92300,863,107
"5441","19265","2016",4,4,0,105000,1459,91
"5442","19269","2016",24,23,1,85353.75,850.583333333333,102.541666666667
"5443","19270","2016",8,8,0,107750,997.25,107.375
"5444","19271","2016",5,5,0,184834,1784,97
"5445","19272","2016",127,51,76,79973.8188976378,985.952755905512,81.8267716535433
"5446","19273","2016",8,8,0,150500,1731.125,92.25
"5447","19274","2016",26,25,1,185061.538461538,1778.30769230769,111.923076923077
"5448","19275","2016",61,48,13,81897.3278688525,1040.03278688525,79.0491803278689
"5449","19276","2016",23,20,3,77635.2173913044,923.173913043478,89.9130434782609
"5450","19278","2016",14,14,0,118233.571428571,1495.85714285714,80.1428571428571
"5451","19279","2016",2,2,0,214500,1035,207.5
"5452","19280","2016",3,3,0,64666.6666666667,1046,78.3333333333333
"5453","19285","2016",17,17,0,104032.941176471,1474.52941176471,84.8823529411765
"5454","19286","2016",11,11,0,101136.363636364,1227.18181818182,81.4545454545455
"5455","19288","2016",11,11,0,82968.1818181818,1213.18181818182,75.8181818181818
"5456","19289","2016",7,7,0,119714.285714286,1427.42857142857,92
"5457","21001","2016",3,3,0,255000,2083.33333333333,126.333333333333
"5458","21002","2016",3,3,0,227786.666666667,1667,135
"5459","21003","2016",15,12,3,264040,2091.8,132.333333333333
"5460","21004","2016",2,2,0,110000,912.5,120.5
"5461","21005","2016",19,19,0,179466,1738,105.736842105263
"5462","21007","2016",3,3,0,98666.6666666667,996,89.3333333333333
"5463","21008","2016",3,3,0,114266.666666667,1146,92.3333333333333
"5464","21009","2016",2,2,0,80300,754,105
"5465","21010","2016",2,2,0,190000,2019.5,92.5
"5466","21012","2016",2,2,0,101500,932,114
"5467","21013","2016",6,6,0,185083.333333333,1620.66666666667,115.333333333333
"5468","21015","2016",2,2,0,119500,793.5,142
"5469","21016","2016",11,11,0,204040.909090909,2062.81818181818,105.090909090909
"5470","21017","2016",7,7,0,118560,1274.14285714286,87.5714285714286
"5471","21020","2016",3,3,0,107166.666666667,986.333333333333,108
"5472","21021","2016",26,25,1,204800.961538462,2067.07692307692,102.230769230769
"5473","21022","2016",3,3,0,104333.333333333,1213,105.666666666667
"5474","21023","2016",9,6,3,69690,847,79.4444444444444
"5475","21024","2016",2,2,0,127500,1417.5,90
"5476","21025","2016",2,2,0,85000,1065.5,101
"5477","21026","2016",4,4,0,137681.25,1156,129.75
"5478","21027","2016",5,3,2,249800,2238.6,106.8
"5479","21028","2016",15,15,0,145284.666666667,1490.6,101.2
"5480","21031","2016",7,7,0,151961.428571429,1726.14285714286,91.5714285714286
"5481","21032","2016",6,6,0,127316.666666667,1349.5,104.166666666667
"5482","21034","2016",3,3,0,70666.6666666667,543,132
"5483","21035","2016",3,3,0,141666.666666667,1268,119
"5484","21037","2016",1,1,0,390000,2053,190
"5485","21038","2016",63,45,18,117250.253968254,1247.19047619048,94.4126984126984
"5486","21041","2016",2,2,0,185000,1593.5,121
"5487","21042","2016",2,2,0,124500,1270.5,96
"5488","21043","2016",4,4,0,66812.5,610.25,108.25
"5489","21045","2016",6,6,0,121666.666666667,1267.16666666667,93.6666666666667
"5490","21046","2016",1,1,0,65000,542,120
"5491","21047","2016",1,1,0,116500,1226,95
"5492","21048","2016",6,6,0,221866.666666667,1850.33333333333,125.166666666667
"5493","21049","2016",1,1,0,110000,1100,100
"5494","21050","2016",1,1,0,180000,2400,75
"5495","21051","2016",1,1,0,232000,1398,166
"5496","21052","2016",2,2,0,84625,648.5,125
"5497","21053","2016",2,2,0,97000,622.5,156
"5498","21054","2016",292,102,190,164924.917808219,2008.02397260274,81.0513698630137
"5499","21056","2016",6,5,1,250558.333333333,1834.83333333333,129.166666666667
"5500","21057","2016",7,7,0,181378.571428571,1798.28571428571,99.5714285714286
"5501","21058","2016",1,1,0,35000,778,45
"5502","21059","2016",7,7,0,261665.714285714,2048,127.142857142857
"5503","21060","2016",12,12,0,197546.666666667,1835.58333333333,106.75
"5504","21062","2016",3,3,0,144633.333333333,1430,99
"5505","21063","2016",1,1,0,26000,441,59
"5506","21064","2016",2,2,0,99750,1107.5,83
"5507","21067","2016",7,7,0,166714.285714286,1575,107
"5508","21068","2016",2,2,0,125500,816,154
"5509","21069","2016",3,3,0,50000,854.666666666667,58.3333333333333
"5510","21070","2016",2,2,0,84800,1257.5,66
"5511","21071","2016",13,13,0,134600,1319.38461538462,97.3846153846154
"5512","21072","2016",1,1,0,168000,1714,98
"5513","21074","2016",2,2,0,144000,1223,121
"5514","21076","2016",11,11,0,182500,1969.72727272727,97.5454545454545
"5515","21077","2016",2,2,0,31000,465,64.5
"5516","21078","2016",1,1,0,145000,1208,120
"5517","21079","2016",1,1,0,103000,1471,70
"5518","21080","2016",9,9,0,123944.444444444,1168.33333333333,109.333333333333
"5519","21081","2016",1,1,0,190000,1203,158
"5520","21086","2016",10,10,0,235687.5,1914,121.9
"5521","21087","2016",7,5,2,83205.7142857143,889.142857142857,91.4285714285714
"5522","21088","2016",3,3,0,176510,1698,102.666666666667
"5523","21089","2016",8,8,0,159725,1310.625,129.25
"5524","21090","2016",1,1,0,55000,550,100
"5525","21091","2016",2,2,0,148672.5,1463,101
"5526","21092","2016",2,2,0,177500,1162,162
"5527","21093","2016",3,3,0,134666.666666667,1330.66666666667,136.333333333333
"5528","21094","2016",2,2,0,137500,1008,126.5
"5529","21095","2016",1,1,0,49000,831,59
"5530","21096","2016",1,1,0,144600,702,206
"5531","21098","2016",1,1,0,45600,616,74
"5532","21099","2016",6,6,0,164816.666666667,1910.33333333333,89.1666666666667
"5533","21101","2016",2,2,0,118127.5,1046.5,114
"5534","21103","2016",21,21,0,156403.571428571,1420,114.238095238095
"5535","21105","2016",9,9,0,247466.666666667,1986.44444444444,127
"5536","21106","2016",7,7,0,359564.857142857,3320.57142857143,116.714285714286
"5537","21107","2016",9,7,2,254561.111111111,2139.77777777778,115.111111111111
"5538","21108","2016",2,2,0,84250,1138,73.5
"5539","21109","2016",2,2,0,46785,767,56.5
"5540","21110","2016",3,3,0,124166.666666667,1247.33333333333,104
"5541","21111","2016",4,4,0,270130,2018.75,133.75
"5542","21112","2016",6,6,0,148383.333333333,1566.5,105.166666666667
"5543","21113","2016",1,1,0,308800,2159,143
"5544","21114","2016",2,2,0,1e+05,1209,84
"5545","21115","2016",4,4,0,123750,1391.75,87.75
"5546","21116","2016",2,2,0,46200,512.5,90.5
"5547","21117","2016",2,2,0,92500,1072.5,89.5
"5548","21120","2016",3,3,0,143983.333333333,1380.33333333333,104.666666666667
"5549","21121","2016",1,1,0,223000,1115,200
"5550","21122","2016",2,2,0,147275,1007.5,147
"5551","21123","2016",1,1,0,54000,372,145
"5552","21124","2016",3,3,0,61333.3333333333,995.333333333333,70
"5553","21125","2016",1,1,0,76000,429,177
"5554","21126","2016",5,5,0,206000,1737.8,116
"5555","21127","2016",1,1,0,485000,2413,201
"5556","21128","2016",3,3,0,59433.3333333333,753.333333333333,86.6666666666667
"5557","21129","2016",1,1,0,50000,833,60
"5558","21130","2016",4,4,0,185425,1332.75,170.75
"5559","21131","2016",2,2,0,65000,795,91
"5560","21132","2016",5,5,0,176200,1352.4,131
"5561","21133","2016",2,2,0,234500,1990,116.5
"5562","21134","2016",2,2,0,90000,1274.5,80.5
"5563","21135","2016",3,3,0,172666.666666667,2130.66666666667,96.3333333333333
"5564","21138","2016",12,11,1,137825.416666667,1355.16666666667,103.583333333333
"5565","21139","2016",10,10,0,136770,1488.5,99.9
"5566","21140","2016",1,1,0,90000,1000,90
"5567","21142","2016",2,2,0,139125,1285,108
"5568","21146","2016",2,2,0,170000,1109,161
"5569","21147","2016",1,1,0,232230,2299,101
"5570","21148","2016",2,2,0,213000,1680.5,127
"5571","21149","2016",1,1,0,60000,435,138
"5572","21150","2016",2,2,0,88600,1246.5,84.5
"5573","21151","2016",2,2,0,206000,1459.5,133
"5574","21152","2016",5,5,0,83440,1395.4,68.4
"5575","21153","2016",2,2,0,64500,603.5,110
"5576","21154","2016",71,46,25,82182.676056338,940.845070422535,88.3802816901408
"5577","21155","2016",1,1,0,47700,954,50
"5578","21159","2016",1,1,0,22000,367,60
"5579","21161","2016",1,1,0,146050,1248,117
"5580","21162","2016",6,6,0,186095,1553,122.833333333333
"5581","21163","2016",2,2,0,88500,920.5,102.5
"5582","21164","2016",2,2,0,82500,1342,65
"5583","21166","2016",125,48,77,131181.2,1649.568,79.488
"5584","21167","2016",2,2,0,195350,1260.5,154.5
"5585","21169","2016",3,3,0,1e+05,1291.66666666667,69.3333333333333
"5586","21170","2016",5,5,0,154471.6,1114,136.6
"5587","21171","2016",108,42,66,177162.657407407,2017.40740740741,88.7592592592593
"5588","21172","2016",1,1,0,96000,768,125
"5589","21173","2016",3,3,0,152333.333333333,1973.33333333333,80.6666666666667
"5590","21176","2016",1,1,0,218500,1986,110
"5591","21177","2016",2,2,0,52250,1241.5,90
"5592","21178","2016",4,4,0,173490,1820.25,95.5
"5593","21179","2016",9,9,0,279927.777777778,2192.33333333333,129.555555555556
"5594","21180","2016",3,3,0,141060,1069.66666666667,144.666666666667
"5595","21182","2016",2,2,0,171000,1663.5,103
"5596","21183","2016",14,14,0,157090.5,1589.28571428571,104.714285714286
"5597","21185","2016",2,2,0,195000,1796.5,110.5
"5598","21186","2016",7,7,0,162428.571428571,1791.14285714286,95.4285714285714
"5599","21187","2016",5,5,0,142600,955.4,146.8
"5600","21189","2016",6,6,0,184833.333333333,1536,136
"5601","21190","2016",2,2,0,147675,2311,71.5
"5602","21191","2016",12,12,0,205866.666666667,1900.91666666667,114.25
"5603","21192","2016",4,4,0,164625,1734.5,90
"5604","21193","2016",5,5,0,138680,1203.4,116.8
"5605","21194","2016",10,10,0,152955,1655.6,88.6
"5606","21195","2016",3,3,0,104000,940.666666666667,101.666666666667
"5607","21196","2016",4,4,0,182465,1755.5,103.75
"5608","21198","2016",3,3,0,68333.3333333333,884,74
"5609","21199","2016",1,1,0,2e+05,1258,159
"5610","21200","2016",15,13,2,186133.333333333,1911.26666666667,93.6666666666667
"5611","21201","2016",1,1,0,150000,1007,149
"5612","21203","2016",3,3,0,71333.3333333333,941.333333333333,79
"5613","21204","2016",3,3,0,90000,980,92.6666666666667
"5614","21207","2016",2,2,0,103000,1384.5,83
"5615","21208","2016",2,2,0,151100,1621,93.5
"5616","21209","2016",30,28,2,249098.333333333,2188.43333333333,116.966666666667
"5617","21210","2016",5,5,0,147486,1544.4,100.4
"5618","21211","2016",1,1,0,144550,1902,76
"5619","21212","2016",2,1,1,120000,1323.5,90.5
"5620","21214","2016",2,2,0,233500,2224.5,99
"5621","21215","2016",3,3,0,170000,1746.66666666667,107
"5622","21216","2016",1,1,0,30000,400,75
"5623","21217","2016",1,1,0,194700,1786,109
"5624","21218","2016",2,2,0,114705,1363.5,79.5
"5625","21219","2016",3,3,0,230150,2054.66666666667,111
"5626","21220","2016",3,3,0,183000,1085,160.333333333333
"5627","21222","2016",2,2,0,114000,1044,110.5
"5628","21223","2016",11,11,0,400729.090909091,2674,142.090909090909
"5629","21225","2016",4,4,0,143137.5,1050,137
"5630","21226","2016",4,4,0,77652.75,904.25,74.75
"5631","21227","2016",5,5,0,281120,2092.8,137.6
"5632","21228","2016",1,1,0,90800,1044,87
"5633","21229","2016",1,1,0,140000,1273,110
"5634","21230","2016",4,4,0,120250,1162.5,116.75
"5635","21231","2016",2789,391,2398,133490.661885981,2127.4277518824,63.6995338831122
"5636","21233","2016",3,3,0,127540,1377.66666666667,93
"5637","21235","2016",1,1,0,63000,467,135
"5638","21236","2016",4,4,0,177750,1922.25,96.75
"5639","21237","2016",2,2,0,107000,860,113
"5640","21238","2016",2,1,1,80114.5,820.5,97
"5641","21239","2016",11,11,0,130244.181818182,1262.18181818182,111.636363636364
"5642","21240","2016",5,5,0,161170,1406.4,114.8
"5643","21241","2016",2,2,0,167750,1915.5,81
"5644","21242","2016",4,4,0,151850,1835.5,84
"5645","21243","2016",2,2,0,205150,3271.5,69.5
"5646","21245","2016",8,8,0,224187.5,1669.75,136.125
"5647","21246","2016",1,1,0,215000,2337,92
"5648","21247","2016",10,9,1,119850,1320,96.2
"5649","21249","2016",9,9,0,127629.555555556,1279.77777777778,103.111111111111
"5650","21250","2016",2,2,0,31250,539,58
"5651","21251","2016",5,5,0,141542,1394.6,109.8
"5652","21255","2016",2,2,0,359050,1706.5,212
"5653","21256","2016",1,1,0,134105,1490,90
"5654","21257","2016",1,1,0,70000,693,101
"5655","21258","2016",1,1,0,26000,426,61
"5656","21259","2016",1,1,0,143000,941,152
"5657","21261","2016",6,6,0,259266.666666667,1993.5,142.166666666667
"5658","21263","2016",8,8,0,258600,2041.25,127.875
"5659","21265","2016",9,9,0,211444.444444444,2124.55555555556,96.8888888888889
"5660","21267","2016",7,7,0,218874.285714286,2061.85714285714,109
"5661","21268","2016",1,1,0,118500,1288,92
"5662","21269","2016",5,5,0,188060,1770.4,108.2
"5663","21270","2016",2,2,0,95000,2815.5,45
"5664","21271","2016",5,4,1,201600,2017.4,108.4
"5665","21272","2016",1,0,1,60000,545,110
"5666","21273","2016",18,17,1,212031.666666667,2313.66666666667,105.444444444444
"5667","21274","2016",6,6,0,114625,1172.5,104.333333333333
"5668","21275","2016",3,3,0,83150,1002.33333333333,85
"5669","21277","2016",10,10,0,102450,1072.5,97.4
"5670","21278","2016",104,50,54,216150.346153846,2281.98076923077,92.8173076923077
"5671","21280","2016",1,1,0,103750,1313,79
"5672","21283","2016",1,1,0,105000,583,180
"5673","21284","2016",2,2,0,174000,1532.5,115
"5674","21285","2016",6,6,0,93666.6666666667,1130.83333333333,87.1666666666667
"5675","21286","2016",1,1,0,263995,2357,112
"5676","21287","2016",2,2,0,76500,828.5,87.5
"5677","21288","2016",1,1,0,153000,933,164
"5678","21290","2016",9,9,0,139550,1476.88888888889,98.6666666666667
"5679","21291","2016",4,4,0,99000,1240.75,77
"5680","21292","2016",74,59,15,144614.513513514,1624.36486486486,90.9864864864865
"5681","21293","2016",2,2,0,87825,956,77.5
"5682","21294","2016",3,3,0,154000,1476.33333333333,130.333333333333
"5683","21295","2016",9,4,5,131668.666666667,1758.88888888889,73.4444444444444
"5684","21296","2016",4,4,0,40000,532.25,76
"5685","21297","2016",7,5,2,142589.285714286,1729,83.8571428571429
"5686","21298","2016",1,1,0,1e+05,1087,92
"5687","21299","2016",3,3,0,60666.6666666667,937,62
"5688","21300","2016",5,5,0,201532,1845.8,120.4
"5689","21301","2016",5,5,0,145137,1331.6,108.2
"5690","21302","2016",1,1,0,1e+05,1220,82
"5691","21304","2016",3,3,0,98333.3333333333,1112.33333333333,95.6666666666667
"5692","21305","2016",2,2,0,40000,885.5,45.5
"5693","21306","2016",2,2,0,219000,1963.5,117.5
"5694","21307","2016",1,1,0,150000,1724,87
"5695","21308","2016",4,4,0,86450,1130.5,102.5
"5696","21309","2016",2,2,0,212000,1476.5,140
"5697","21313","2016",1,1,0,31600,395,80
"5698","21314","2016",1,1,0,103510,1232,84
"5699","21315","2016",9,9,0,308035.555555556,2293.55555555556,132.333333333333
"5700","21316","2016",4,4,0,101250,1187,84.75
"5701","21317","2016",39,35,4,162117.641025641,1579.35897435897,106.205128205128
"5702","21319","2016",8,8,0,217050,1774.375,121.75
"5703","21320","2016",7,7,0,212871.428571429,2050.71428571429,104.285714285714
"5704","21321","2016",1,1,0,120000,800,150
"5705","21322","2016",2,2,0,155000,1418,110
"5706","21323","2016",3,3,0,88666.6666666667,887.666666666667,113.666666666667
"5707","21325","2016",4,4,0,60500,605.5,97.75
"5708","21326","2016",2,2,0,112695,982.5,115
"5709","21327","2016",3,2,1,106833.333333333,1280,87.3333333333333
"5710","21328","2016",1,1,0,41600,447,93
"5711","21330","2016",4,4,0,114075,1294,88.75
"5712","21331","2016",2,2,0,93750,1019.5,91.5
"5713","21332","2016",7,7,0,123857.142857143,1360.42857142857,87.7142857142857
"5714","21334","2016",8,8,0,103781.25,1016,107.625
"5715","21335","2016",2,2,0,137500,924.5,146
"5716","21336","2016",8,8,0,62487.5,789.125,86.5
"5717","21337","2016",21,21,0,119383,1257.57142857143,101.428571428571
"5718","21338","2016",1,1,0,180000,1500,120
"5719","21339","2016",3,3,0,90312.3333333333,1254.66666666667,73
"5720","21340","2016",3,3,0,156410,1008,147.666666666667
"5721","21342","2016",2,2,0,161500,1640,94
"5722","21344","2016",2,2,0,121750,1463,101
"5723","21345","2016",4,4,0,84350,1039.75,84.75
"5724","21346","2016",3,3,0,57333.3333333333,554.666666666667,103
"5725","21347","2016",3,2,1,441183.333333333,4247.33333333333,120.666666666667
"5726","21349","2016",3,3,0,110500,1067.33333333333,105.666666666667
"5727","21351","2016",10,10,0,192886,1839.5,111.7
"5728","21352","2016",7,7,0,156586.571428571,1798.85714285714,87.1428571428571
"5729","21353","2016",14,14,0,213146.428571429,1775.5,124.214285714286
"5730","21355","2016",102,38,64,145972.921568627,1857.05882352941,75.8627450980392
"5731","21356","2016",23,23,0,135363.043478261,1381.4347826087,100.086956521739
"5732","21358","2016",3,3,0,74666.6666666667,994.333333333333,84.6666666666667
"5733","21360","2016",1,1,0,65000,722,90
"5734","21361","2016",2,2,0,226950,1543.5,141
"5735","21363","2016",1,1,0,130000,1250,104
"5736","21366","2016",3,3,0,147500,1286.66666666667,121
"5737","21367","2016",3,3,0,132000,1555.66666666667,83.6666666666667
"5738","21368","2016",3,3,0,214333.333333333,1677,153.666666666667
"5739","21369","2016",2,2,0,162750,1007,169.5
"5740","21370","2016",5,5,0,200050,1980.6,101
"5741","21371","2016",9,9,0,129672.222222222,1212.77777777778,111.777777777778
"5742","21373","2016",6,6,0,208370.333333333,1635.33333333333,122.166666666667
"5743","21375","2016",3,3,0,45000,746.333333333333,56.6666666666667
"5744","21378","2016",2,2,0,115800,2253,55.5
"5745","21379","2016",3,3,0,165666.666666667,1283.66666666667,139.333333333333
"5746","21380","2016",1,1,0,168000,955,176
"5747","21382","2016",3,3,0,89683.3333333333,941,96.6666666666667
"5748","21383","2016",11,11,0,153403.636363636,1582.45454545455,100.545454545455
"5749","21384","2016",1,1,0,220000,1257,175
"5750","21385","2016",2,2,0,150000,1100,119
"5751","21386","2016",2,2,0,159170,1318.5,126
"5752","21387","2016",3,3,0,119833.333333333,905,150.666666666667
"5753","21388","2016",11,11,0,188747.272727273,1813.54545454545,105.545454545455
"5754","21389","2016",3,3,0,130833.333333333,1375.66666666667,94.6666666666667
"5755","21390","2016",67,63,4,189576.268656716,2080.65671641791,90.4776119402985
"5756","21391","2016",8,8,0,299962.5,2244.5,133
"5757","21392","2016",1,1,0,143500,997,144
"5758","21393","2016",1,1,0,49000,462,106
"5759","21398","2016",1,1,0,92000,989,93
"5760","21399","2016",1,1,0,129000,992,130
"5761","21401","2016",6,6,0,97000,1170,84.5
"5762","21402","2016",1,1,0,113000,1018,111
"5763","21403","2016",2,2,0,58000,608.5,96.5
"5764","21404","2016",2,2,0,175000,1215.5,143
"5765","21405","2016",8,8,0,191456.25,1637.25,113.5
"5766","21406","2016",2,2,0,204500,2106,100
"5767","21407","2016",3,3,0,147833.333333333,2486.33333333333,65.6666666666667
"5768","21408","2016",17,10,7,199970.588235294,2029.41176470588,102.764705882353
"5769","21409","2016",10,10,0,161712,1671.2,95.1
"5770","21411","2016",5,5,0,168000,1402.2,112.6
"5771","21412","2016",21,19,2,219626.19047619,2227.09523809524,98.2857142857143
"5772","21413","2016",4,4,0,137155,1193.25,117
"5773","21414","2016",4,4,0,114542.5,1121,104
"5774","21415","2016",6,6,0,91833.1666666667,789.166666666667,119.666666666667
"5775","21416","2016",17,14,3,160850,1724,95.5882352941177
"5776","21417","2016",2,2,0,232650,994,229.5
"5777","21419","2016",1,1,0,68000,1700,40
"5778","21420","2016",1,1,0,50000,769,65
"5779","21421","2016",1,1,0,2e+05,1000,200
"5780","21423","2016",4,4,0,171250,1973.5,80.75
"5781","21424","2016",5,5,0,123000,1030,125
"5782","21425","2016",53,33,20,82540.5660377358,1081.79245283019,76.5283018867924
"5783","21426","2016",3,3,0,111233.333333333,1087,99.6666666666667
"5784","21427","2016",1,1,0,50000,1667,30
"5785","21428","2016",3,3,0,206666.666666667,2147.66666666667,96
"5786","21429","2016",3,3,0,201000,1208.33333333333,177.333333333333
"5787","21431","2016",3,3,0,98900,975,95.6666666666667
"5788","21432","2016",7,7,0,87337.1428571429,762,114.857142857143
"5789","21433","2016",4,4,0,49000,509,100
"5790","21434","2016",3,3,0,107000,1208.33333333333,83
"5791","21437","2016",3,3,0,136283.333333333,1128,127.333333333333
"5792","21438","2016",1,1,0,40000,645,62
"5793","21440","2016",3,3,0,138500,1706,82
"5794","21441","2016",5,5,0,117953,956.2,115.6
"5795","21442","2016",3,3,0,128000,1259.33333333333,91
"5796","21444","2016",2,2,0,62500,546.5,120
"5797","21445","2016",3,3,0,56666.6666666667,1006.33333333333,60.6666666666667
"5798","21446","2016",3,3,0,94666.6666666667,1111.66666666667,83
"5799","21450","2016",2,2,0,120000,1022,120
"5800","21452","2016",22,22,0,200431.045454545,1905,105.954545454545
"5801","21454","2016",1,1,0,15000,441,34
"5802","21455","2016",2,2,0,181500,874.5,196
"5803","21456","2016",1,1,0,225600,1504,150
"5804","21457","2016",3,3,0,72000,714.333333333333,101
"5805","21458","2016",6,6,0,191750,1880,106.5
"5806","21459","2016",3,3,0,157116.666666667,1566.33333333333,99.6666666666667
"5807","21460","2016",1,1,0,70000,761,92
"5808","21461","2016",18,18,0,101532.777777778,1225.33333333333,90.8888888888889
"5809","21462","2016",10,9,1,267808,2520.2,106.3
"5810","21463","2016",1,1,0,134000,971,138
"5811","21464","2016",62,45,17,172066.209677419,1880.62903225806,93.5
"5812","21465","2016",1,1,0,150000,1485,101
"5813","21468","2016",1,1,0,75000,1271,59
"5814","21469","2016",2,2,0,221425,2098,111
"5815","21472","2016",1,1,0,40500,779,52
"5816","21473","2016",4,4,0,240200,1819,135
"5817","21474","2016",3,3,0,130000,1480,90.3333333333333
"5818","21475","2016",7,7,0,95285.7142857143,1115.57142857143,84.2857142857143
"5819","21476","2016",2,2,0,159975,1078,149
"5820","21477","2016",1,1,0,88000,889,99
"5821","21478","2016",1,1,0,231400,2163,107
"5822","21479","2016",1,1,0,86550,618,140
"5823","21480","2016",3,3,0,161333.333333333,1679,100.666666666667
"5824","21481","2016",11,9,2,254840.272727273,2357.63636363636,110.909090909091
"5825","21482","2016",4,4,0,91875,2001.75,74
"5826","21483","2016",2,2,0,234360,1442,160
"5827","21484","2016",1,1,0,63000,663,95
"5828","21485","2016",28,22,6,175305.357142857,2062.5,87.4642857142857
"5829","21487","2016",5,5,0,177300,1796.2,98.4
"5830","21488","2016",6,6,0,58850,587.333333333333,101.333333333333
"5831","21492","2016",4,2,2,146250,1378,103.5
"5832","21493","2016",7,6,1,127828.571428571,1424.28571428571,90.1428571428571
"5833","21496","2016",16,15,1,111148.125,1445.125,84.3125
"5834","21497","2016",4,4,0,202000,1242,165.75
"5835","21498","2016",2,2,0,37500,737,53
"5836","21500","2016",1,1,0,45000,600,75
"5837","21501","2016",11,9,2,134427.272727273,1745.09090909091,83.7272727272727
"5838","21502","2016",9,9,0,115166.666666667,1041.11111111111,106.666666666667
"5839","21503","2016",3,3,0,99000,849.666666666667,129.333333333333
"5840","21504","2016",1,1,0,132785,1071,124
"5841","21505","2016",4,4,0,98250,1068.75,101.25
"5842","21506","2016",4,2,2,94250,1324,74.75
"5843","21508","2016",8,8,0,210812.5,1741.25,118.125
"5844","21511","2016",2,2,0,82390,871,88.5
"5845","21512","2016",3,3,0,134500,3036.33333333333,81.6666666666667
"5846","21514","2016",1,1,0,43000,478,90
"5847","21515","2016",103,41,62,151307.466019417,1910.5145631068,79.4854368932039
"5848","21516","2016",2,2,0,163750,1670,82.5
"5849","21517","2016",12,7,5,179570.833333333,1562.75,117.166666666667
"5850","21518","2016",1,1,0,45000,726,62
"5851","21519","2016",2,2,0,62500,493,117.5
"5852","21520","2016",1,1,0,208000,1908,109
"5853","21521","2016",5,5,0,207090,1935.8,111
"5854","21522","2016",3,3,0,112666.666666667,1102.66666666667,102
"5855","21523","2016",1,1,0,145000,1151,126
"5856","21525","2016",8,8,0,88125,921.25,98.5
"5857","21527","2016",3,3,0,116600,1380,119
"5858","21528","2016",2,2,0,122500,1104,112
"5859","21530","2016",3,3,0,40000,629.333333333333,66
"5860","21531","2016",11,11,0,53681.8181818182,717.090909090909,74.5454545454545
"5861","21532","2016",13,13,0,213134.615384615,1805.69230769231,126.692307692308
"5862","21533","2016",2,2,0,43083.5,655.5,67
"5863","21534","2016",8,8,0,222821.75,1781.5,121
"5864","21535","2016",8,8,0,264843.75,2290.5,119
"5865","21536","2016",3,3,0,128866.666666667,951,138.666666666667
"5866","21537","2016",1,1,0,73000,912,80
"5867","21538","2016",2,2,0,41500,446.5,90.5
"5868","21539","2016",4,4,0,109383.5,1010.25,104.75
"5869","21540","2016",83,50,33,202588.698795181,2389.80722891566,86.4457831325301
"5870","21541","2016",1,1,0,60100,523,115
"5871","21542","2016",2,2,0,178000,1751,105.5
"5872","21543","2016",1,1,0,136440,916,149
"5873","21545","2016",5,5,0,98090,1169.6,85.6
"5874","21546","2016",3,3,0,103000,1305,77
"5875","21547","2016",2,2,0,105000,1000,99
"5876","21548","2016",2,2,0,68000,1365.5,51
"5877","21550","2016",1,1,0,40000,533,75
"5878","21553","2016",3,3,0,100186.666666667,981,97
"5879","21554","2016",20,8,12,87032.5,1064.4,93.15
"5880","21555","2016",14,13,1,268819.357142857,2009,139.214285714286
"5881","21556","2016",7,7,0,117750,1128.57142857143,103.714285714286
"5882","21558","2016",13,13,0,184600,1586,121.230769230769
"5883","21559","2016",12,11,1,190758.333333333,1734.41666666667,111.833333333333
"5884","21560","2016",1,1,0,210000,1654,127
"5885","21561","2016",6,6,0,124166.666666667,993.833333333333,120.166666666667
"5886","21562","2016",2,2,0,69000,694,111.5
"5887","21563","2016",3,3,0,75250,1712.66666666667,44.6666666666667
"5888","21565","2016",9,9,0,163248.666666667,1601.88888888889,114
"5889","21567","2016",4,4,0,85750,1197,71.25
"5890","21568","2016",11,11,0,105052.727272727,1081.45454545455,94.4545454545455
"5891","21569","2016",3,3,0,140000,844.666666666667,168
"5892","21570","2016",1,1,0,86500,1109,78
"5893","21571","2016",1,1,0,146000,2000,73
"5894","21572","2016",2,2,0,166250,1695,95
"5895","21573","2016",3,3,0,101000,1346,76
"5896","21574","2016",7,7,0,93257.1428571429,963.857142857143,112.142857142857
"5897","21575","2016",8,7,1,113937.5,1183.125,96
"5898","21576","2016",4,4,0,135295,1209.5,146.5
"5899","21577","2016",11,11,0,153836.363636364,1371.63636363636,114.636363636364
"5900","21578","2016",2,2,0,142500,1081.5,124.5
"5901","21581","2016",1,1,0,107000,1354,79
"5902","21582","2016",5,5,0,163560,1876.8,101
"5903","21583","2016",1,1,0,75000,1271,59
"5904","21584","2016",23,22,1,131413.043478261,1715.95652173913,104.565217391304
"5905","21585","2016",10,8,2,151020,1821.1,85.2
"5906","21586","2016",8,8,0,205600,1662.5,123.5
"5907","21587","2016",5,5,0,146500,1273.8,125
"5908","21589","2016",4,4,0,113400,1466.25,78.75
"5909","21590","2016",14,12,2,153826.285714286,1590.57142857143,100.071428571429
"5910","21591","2016",7,7,0,200957.142857143,1880.57142857143,107.142857142857
"5911","21592","2016",2,2,0,267500,1372,199
"5912","21593","2016",2,2,0,41000,551.5,79.5
"5913","21596","2016",4,4,0,173061,1512.5,108.75
"5914","21597","2016",1,1,0,110300,2507,44
"5915","21598","2016",2,2,0,143000,1570.5,92
"5916","21599","2016",32,29,3,138395.46875,1366.5625,100.75
"5917","21601","2016",3,3,0,133866.666666667,1175.33333333333,124.666666666667
"5918","21602","2016",1,1,0,37000,416,89
"5919","21603","2016",26,21,5,140244.230769231,1520,100.961538461538
"5920","21604","2016",1,1,0,35000,660,53
"5921","21605","2016",15,15,0,214556.333333333,2064.06666666667,104.6
"5922","21606","2016",18,17,1,188301.111111111,1669.5,111.722222222222
"5923","21607","2016",28,25,3,109678.571428571,1229.10714285714,90.6071428571429
"5924","21609","2016",1,1,0,178000,1290,138
"5925","21610","2016",5,5,0,133530,1185,117.4
"5926","21611","2016",11,10,1,161975,1636.27272727273,100.181818181818
"5927","21612","2016",1,1,0,275000,1608,171
"5928","21613","2016",2,2,0,100569.5,848.5,95.5
"5929","21614","2016",6,6,0,245991.666666667,1573.83333333333,161.666666666667
"5930","21615","2016",5,5,0,64730,835.8,84.8
"5931","21616","2016",1,1,0,270000,2030,133
"5932","21617","2016",130,55,75,191206.246153846,2103.10769230769,89.7230769230769
"5933","21618","2016",5,5,0,123017.4,1459.8,89.2
"5934","21620","2016",1,1,0,264570,1038,255
"5935","21622","2016",1,1,0,195000,2167,90
"5936","21623","2016",18,18,0,181183.333333333,2019.66666666667,93.3333333333333
"5937","21624","2016",2,2,0,121050,1563.5,76
"5938","21626","2016",1,1,0,65000,474,137
"5939","21627","2016",1,1,0,31600,545,58
"5940","21629","2016",4,4,0,80371,929,87.25
"5941","21631","2016",1,1,0,69000,561,123
"5942","21632","2016",9,7,2,180444.444444444,1751.11111111111,98.7777777777778
"5943","21633","2016",3,3,0,88333.3333333333,1032.33333333333,85
"5944","21634","2016",2,2,0,119660,1122.5,106.5
"5945","21635","2016",1,1,0,55000,688,80
"5946","21636","2016",3,3,0,44333.3333333333,710.333333333333,61.3333333333333
"5947","21637","2016",2,1,1,118250,1429.5,90
"5948","21638","2016",7,6,1,149259.428571429,1322.28571428571,108.428571428571
"5949","21639","2016",9,8,1,154277.888888889,1512.22222222222,99.8888888888889
"5950","21640","2016",3,3,0,103166.666666667,1158.66666666667,87
"5951","21641","2016",3,3,0,101666.666666667,1084.66666666667,94
"5952","21642","2016",1,1,0,50000,543,92
"5953","21643","2016",8,8,0,157356.25,1306.375,125.25
"5954","21644","2016",3,3,0,147000,1083.33333333333,132.333333333333
"5955","21645","2016",10,10,0,118110,1360.4,90.1
"5956","21647","2016",2,2,0,153300,2244.5,91.5
"5957","21648","2016",3,3,0,105479.333333333,944.666666666667,109.666666666667
"5958","21649","2016",2,2,0,51500,701,66
"5959","21651","2016",3,3,0,137333.333333333,955.333333333333,148
"5960","21652","2016",5,5,0,100600,961.6,109.4
"5961","21655","2016",4,4,0,78962.5,640.75,134.5
"5962","21656","2016",2,2,0,217900,1857.5,118.5
"5963","21657","2016",28,27,1,254933.964285714,2180.53571428571,116.785714285714
"5964","21661","2016",18,15,3,218933.055555556,1863.77777777778,118.777777777778
"5965","21662","2016",1,1,0,40000,615,65
"5966","21663","2016",21,20,1,127318.571428571,1462.42857142857,90.3333333333333
"5967","21664","2016",1,1,0,290000,1812,160
"5968","21665","2016",1,1,0,135000,1250,108
"5969","21666","2016",2,2,0,154750,1590.5,97
"5970","21667","2016",2,2,0,106000,1078.5,98.5
"5971","21669","2016",2,2,0,126700,1470.5,85
"5972","21670","2016",5,5,0,96360,963.4,105.8
"5973","21671","2016",1,1,0,20000,400,50
"5974","21673","2016",3,3,0,87600,862,92
"5975","21674","2016",1,1,0,55000,1375,40
"5976","21675","2016",1,1,0,58000,446,130
"5977","21677","2016",1,1,0,52500,750,70
"5978","21678","2016",1,1,0,129200,867,149
"5979","21680","2016",13,12,1,111215.384615385,1121.46153846154,107.769230769231
"5980","21682","2016",5,5,0,172500,1127.4,160.6
"5981","21683","2016",4,4,0,39437.5,465.5,86.25
"5982","21684","2016",10,10,0,216220,2040.3,110.3
"5983","21685","2016",1,1,0,50000,463,108
"5984","21687","2016",1,1,0,50000,521,96
"5985","21688","2016",1,1,0,25000,568,44
"5986","21689","2016",1,1,0,35000,814,43
"5987","21690","2016",3,3,0,73666.6666666667,784,92.6666666666667
"5988","21691","2016",5,5,0,128600,1159.2,116.8
"5989","21692","2016",4,4,0,153850,1448.5,129
"5990","21693","2016",4,4,0,60500,1633.25,52
"5991","21695","2016",1,1,0,140000,1333,105
"5992","21696","2016",2,2,0,85350,758,107
"5993","21698","2016",4,4,0,191625,2206.75,89.75
"5994","21699","2016",13,13,0,181896.923076923,1895.07692307692,101.615384615385
"5995","21700","2016",1,1,0,50000,625,80
"5996","21701","2016",2,2,0,127250,1233,98.5
"5997","21702","2016",6,6,0,167553.333333333,1360.5,118.5
"5998","21705","2016",2,2,0,127500,1462.5,81.5
"5999","21706","2016",2,2,0,136560,1425.5,91.5
"6000","21707","2016",2,2,0,92500,1054.5,91
"6001","21708","2016",1,1,0,152000,1505,101
"6002","21710","2016",8,8,0,92750,1035.875,96.75
"6003","21712","2016",3,3,0,176666.666666667,2377.66666666667,71.6666666666667
"6004","21713","2016",4,4,0,113629,1107.75,107.25
"6005","21714","2016",1,0,1,135000,1125,120
"6006","21715","2016",2,2,0,36500,557,65.5
"6007","21716","2016",3,3,0,214000,2266,91.3333333333333
"6008","21717","2016",4,4,0,70750,619.5,117.5
"6009","22001","2016",4,4,0,108000,1308.75,82.5
"6010","22002","2016",10,10,0,132693,1367.3,100.6
"6011","22003","2016",6,6,0,181684.333333333,1678.5,110.5
"6012","22004","2016",57,55,2,104585.175438596,1093.36842105263,100.280701754386
"6013","22005","2016",15,14,1,85826.6,989.333333333333,87.6
"6014","22006","2016",7,7,0,92857.1428571429,862,110.142857142857
"6015","22008","2016",12,12,0,114971.666666667,1168.91666666667,94.5833333333333
"6016","22009","2016",3,3,0,60000,754,81
"6017","22011","2016",12,12,0,123816.666666667,1244.33333333333,102
"6018","22012","2016",12,12,0,167195.833333333,1483.66666666667,113.75
"6019","22013","2016",17,17,0,70462.3529411765,896.294117647059,79
"6020","22014","2016",14,14,0,108800,1096.42857142857,103.214285714286
"6021","22015","2016",15,15,0,115702.666666667,1278,95.6666666666667
"6022","22016","2016",11,11,0,588887,4520.72727272727,113.454545454545
"6023","22018","2016",4,4,0,114500,1110.25,104.5
"6024","22019","2016",6,6,0,88833.3333333333,895,98.6666666666667
"6025","22020","2016",27,25,2,103120.555555556,1035.66666666667,96.8148148148148
"6026","22021","2016",15,15,0,131583.333333333,1322.06666666667,100.133333333333
"6027","22023","2016",3,3,0,217333.333333333,2099.66666666667,77.6666666666667
"6028","22024","2016",3,3,0,56400,795.666666666667,74.6666666666667
"6029","22025","2016",38,38,0,65168.4210526316,819.526315789474,85.7105263157895
"6030","22026","2016",14,14,0,127317.857142857,1414.85714285714,92.2142857142857
"6031","22027","2016",4,4,0,73750,1001.75,77.5
"6032","22028","2016",12,12,0,121971.75,1141.91666666667,110.083333333333
"6033","22029","2016",6,6,0,98300,1152.16666666667,90
"6034","22030","2016",8,8,0,117154.375,1441.375,92.5
"6035","22031","2016",8,8,0,104125,1369.125,90
"6036","22032","2016",32,32,0,107768.125,1137.09375,100.59375
"6037","22033","2016",6,6,0,49833.3333333333,697.5,74.3333333333333
"6038","22034","2016",16,15,1,103560.8125,1191.0625,97.125
"6039","22035","2016",14,14,0,130857.142857143,1235.28571428571,108.571428571429
"6040","22036","2016",1,1,0,88500,983,90
"6041","22037","2016",3,3,0,49250,716.333333333333,69.6666666666667
"6042","22039","2016",8,7,1,110812.5,869.5,115.25
"6043","22040","2016",6,6,0,139416.666666667,1196.66666666667,115
"6044","22041","2016",3,3,0,105183.333333333,1408,74.6666666666667
"6045","22042","2016",4,4,0,99250,1842.5,61.25
"6046","22043","2016",6,6,0,88851.3333333333,758,111.666666666667
"6047","22044","2016",18,18,0,131981.666666667,1349,100.5
"6048","22045","2016",2,2,0,145000,1273,110.5
"6049","22046","2016",43,42,1,93822.9534883721,986.604651162791,97.4418604651163
"6050","22047","2016",12,12,0,71312.5,849.416666666667,88.5833333333333
"6051","22048","2016",24,24,0,139875.5,1462.83333333333,95
"6052","22049","2016",16,16,0,127313.125,1625.5,79.25
"6053","22050","2016",218,89,129,143578.766055046,1712.20642201835,84.1330275229358
"6054","22052","2016",7,7,0,89085.7142857143,871.142857142857,94
"6055","22053","2016",10,10,0,99344,965.8,98.6
"6056","22054","2016",112,86,26,182147.151785714,2276.84821428571,84.5625
"6057","22055","2016",146,118,28,182207.191780822,1983.63698630137,95.9452054794521
"6058","22056","2016",17,17,0,143032.352941176,1376,105.647058823529
"6059","22057","2016",8,8,0,91556.25,907.125,107.625
"6060","22059","2016",12,12,0,153666.666666667,1405.91666666667,112
"6061","22060","2016",2,2,0,106500,851,112
"6062","22061","2016",20,20,0,92040,884.5,103.1
"6063","22062","2016",4,4,0,102457.25,858.25,130.75
"6064","22063","2016",12,12,0,69408.1666666667,867.5,82.8333333333333
"6065","22064","2016",11,11,0,74645.4545454545,783.545454545455,91.6363636363636
"6066","22065","2016",17,17,0,122032.117647059,1732.23529411765,74.4117647058823
"6067","22067","2016",22,21,1,112668.181818182,1218.27272727273,95.2272727272727
"6068","22068","2016",6,6,0,99517.5,1035.83333333333,106.166666666667
"6069","22069","2016",2,2,0,145909,851.5,149
"6070","22070","2016",81,55,26,89354.7777777778,1102.37037037037,85.1604938271605
"6071","22071","2016",5,5,0,122800,2480.4,73.6
"6072","22072","2016",3,3,0,69666.6666666667,727.333333333333,87
"6073","22073","2016",10,10,0,68100,912.2,73.2
"6074","22074","2016",10,10,0,79590,941.8,90.9
"6075","22076","2016",21,21,0,108123.80952381,1219,97.2380952380952
"6076","22077","2016",14,14,0,136396.5,1264.78571428571,110.928571428571
"6077","22079","2016",18,18,0,104252.777777778,1190.5,88.2222222222222
"6078","22081","2016",44,44,0,153684,1549.36363636364,103.954545454545
"6079","22082","2016",8,8,0,110721.875,1169.75,96.625
"6080","22083","2016",6,6,0,94811,832.5,112.333333333333
"6081","22084","2016",22,22,0,122704.545454545,1285.72727272727,96.0454545454545
"6082","22085","2016",8,8,0,120312.5,1840.625,69.875
"6083","22086","2016",5,5,0,138020,1448.6,100.8
"6084","22087","2016",12,12,0,103393.333333333,1244.08333333333,96.5833333333333
"6085","22088","2016",5,5,0,38700,615.2,65
"6086","22090","2016",16,16,0,156453.125,1472.25,107.25
"6087","22092","2016",2,2,0,123050,1697,81.5
"6088","22093","2016",222,179,43,142719.554054054,1557.41891891892,93.6261261261261
"6089","22094","2016",29,23,6,224213.448275862,2760.34482758621,82.1724137931034
"6090","22095","2016",4,4,0,97490,1078.25,88.75
"6091","22096","2016",3,3,0,110000,1144,96.6666666666667
"6092","22097","2016",4,4,0,135000,1433.5,101
"6093","22098","2016",16,16,0,129336.1875,1164.9375,111.5625
"6094","22099","2016",7,7,0,119142.857142857,1327.71428571429,93.5714285714286
"6095","22101","2016",18,18,0,88528.6111111111,1111.33333333333,81.2777777777778
"6096","22103","2016",13,13,0,143653.846153846,1604.15384615385,90.7692307692308
"6097","22104","2016",7,7,0,80785.7142857143,1069.85714285714,73.5714285714286
"6098","22105","2016",13,13,0,167411.538461538,1977.69230769231,92.3076923076923
"6099","22106","2016",91,76,15,148421.56043956,1650.32967032967,92.2197802197802
"6100","22107","2016",18,18,0,75017.4444444444,957,79.2777777777778
"6101","22108","2016",2,2,0,66500,1172,59.5
"6102","22109","2016",4,4,0,150500,1354.25,94.75
"6103","22110","2016",6,6,0,140333.333333333,1308.66666666667,105.5
"6104","22111","2016",11,11,0,190409.090909091,1982.81818181818,99.5454545454545
"6105","22112","2016",4,4,0,121250,1221,99.25
"6106","22113","2016",260,186,74,122427.25,1386.25,89.2
"6107","22114","2016",10,10,0,104800,1324.8,82.5
"6108","22115","2016",5,5,0,51426.8,695.2,80.8
"6109","22116","2016",12,12,0,94725,1274,79.5
"6110","22117","2016",17,17,0,137342.941176471,1295.41176470588,106
"6111","22118","2016",39,35,4,162815.641025641,1532.05128205128,111.333333333333
"6112","22119","2016",10,10,0,110070.5,945.3,110.4
"6113","22121","2016",23,22,1,118174.782608696,1413.30434782609,84.4782608695652
"6114","22122","2016",9,9,0,52388.8888888889,697.222222222222,71
"6115","22124","2016",7,7,0,73027.4285714286,831.428571428571,94.5714285714286
"6116","22127","2016",23,23,0,156560.869565217,1488.86956521739,102.347826086957
"6117","22128","2016",9,9,0,78666.6666666667,1040.66666666667,74.3333333333333
"6118","22129","2016",2,2,0,49000,518,88
"6119","22131","2016",7,7,0,66428.5714285714,738.428571428571,88
"6120","22132","2016",2,2,0,54000,900,60
"6121","22133","2016",6,6,0,122416.666666667,1091.66666666667,107.833333333333
"6122","22134","2016",31,30,1,164827.516129032,1779.96774193548,92.6451612903226
"6123","22135","2016",27,27,0,102211.111111111,1103.25925925926,93.9259259259259
"6124","22136","2016",110,95,15,107377.8,1083.87272727273,100.790909090909
"6125","22137","2016",23,23,0,68764.5652173913,766.695652173913,90.4782608695652
"6126","22138","2016",9,9,0,53288.8888888889,947.222222222222,59.4444444444444
"6127","22139","2016",1,1,0,60000,882,68
"6128","22140","2016",5,5,0,114260,1354.8,80.6
"6129","22141","2016",2,2,0,160000,1170,137
"6130","22143","2016",16,15,1,132152.3125,1517.4375,85.875
"6131","22144","2016",9,9,0,165200,1487.55555555556,110.888888888889
"6132","22145","2016",12,11,1,103625,1133.08333333333,93.25
"6133","22146","2016",9,9,0,55166.6666666667,785.222222222222,74.2222222222222
"6134","22147","2016",27,25,2,89567.7037037037,945.62962962963,96.1481481481482
"6135","22148","2016",5,5,0,59235,673.2,85.2
"6136","22149","2016",5,5,0,90760,808,115.2
"6137","22150","2016",9,9,0,131611.111111111,1074.11111111111,120.555555555556
"6138","22152","2016",15,15,0,104340,1210.8,95.0666666666667
"6139","22153","2016",9,9,0,103322.222222222,952.555555555556,112.777777777778
"6140","22155","2016",20,19,1,114197.5,1279.7,90.45
"6141","22156","2016",7,7,0,101000,933.285714285714,110.285714285714
"6142","22157","2016",5,5,0,125000,1418.6,91.4
"6143","22158","2016",19,19,0,94050.5789473684,1069.52631578947,89.8421052631579
"6144","22160","2016",3,3,0,82771.3333333333,1233.66666666667,69
"6145","22161","2016",36,36,0,104633.055555556,1202.86111111111,87.8333333333333
"6146","22162","2016",124,99,25,157659.919354839,1721.25,95.0806451612903
"6147","22163","2016",8,8,0,99776.375,995.625,102.25
"6148","22164","2016",14,14,0,118646.428571429,963.571428571429,119.642857142857
"6149","22165","2016",5,5,0,126860,1319.2,97.8
"6150","22166","2016",45,43,2,177800,1869.26666666667,95.8444444444444
"6151","22168","2016",192,114,78,174244.645833333,2250.9375,80.875
"6152","22169","2016",5,5,0,65000,820.4,81.2
"6153","22170","2016",17,17,0,112552.647058824,1163.23529411765,96.2941176470588
"6154","22171","2016",38,37,1,139504.894736842,1316.52631578947,107.815789473684
"6155","22172","2016",24,17,7,133253.75,1384.83333333333,93.0833333333333
"6156","22174","2016",6,6,0,129641.666666667,1330.16666666667,105.5
"6157","22175","2016",16,16,0,118292.125,1190.375,98.3125
"6158","22176","2016",67,67,0,131243.119402985,1374.41791044776,95.7014925373134
"6159","22177","2016",13,13,0,125688.307692308,1294.76923076923,96.1538461538462
"6160","22178","2016",14,14,0,120786.428571429,1205.57142857143,98.2142857142857
"6161","22179","2016",31,27,4,197338.709677419,2304.45161290323,89.258064516129
"6162","22180","2016",17,17,0,170514.705882353,1465.58823529412,113.941176470588
"6163","22181","2016",12,12,0,89936.6666666667,1610.66666666667,72.5
"6164","22182","2016",28,28,0,140162.5,1248.32142857143,110.142857142857
"6165","22183","2016",30,27,3,69592.7,780.6,89.4666666666667
"6166","22184","2016",21,21,0,85538.0952380952,822.809523809524,109.714285714286
"6167","22185","2016",37,36,1,87186.2972972973,1025.83783783784,88.3783783783784
"6168","22186","2016",123,72,51,206460.18699187,2543.12195121951,85.4715447154472
"6169","22187","2016",180,149,31,168483.166666667,1847.39444444444,93.1277777777778
"6170","22188","2016",4,4,0,94500,1175.25,77.25
"6171","22189","2016",6,6,0,114275,1074.83333333333,103.166666666667
"6172","22190","2016",52,49,3,124266.615384615,1274.30769230769,99.9423076923077
"6173","22193","2016",8,8,0,122375,1161.875,103.25
"6174","22194","2016",55,52,3,138305.727272727,1462.70909090909,98.4909090909091
"6175","22195","2016",47,47,0,131481.276595745,1547.57446808511,92.6595744680851
"6176","22196","2016",20,20,0,121545,1166.1,105.7
"6177","22197","2016",37,34,3,167138.918918919,1750.91891891892,100.405405405405
"6178","22198","2016",61,58,3,164025.491803279,1719.52459016393,96.0819672131148
"6179","22199","2016",16,16,0,128387.8125,1380,101.75
"6180","22200","2016",4,4,0,149500,1413.5,103.75
"6181","22201","2016",12,12,0,170416.666666667,1692.25,99.5
"6182","22202","2016",8,8,0,86562.5,980.375,92
"6183","22203","2016",52,51,1,111650.980769231,1221.84615384615,92.6923076923077
"6184","22204","2016",23,23,0,79565.2173913044,773.391304347826,107.304347826087
"6185","22205","2016",4,4,0,89000,958,96.25
"6186","22206","2016",23,23,0,150411.47826087,1424.04347826087,108.826086956522
"6187","22207","2016",22,22,0,103687.272727273,1144.54545454545,95.9545454545455
"6188","22208","2016",22,22,0,121022.727272727,1224.90909090909,102.363636363636
"6189","22209","2016",64,49,15,160906,1759,98.828125
"6190","22210","2016",68,68,0,207761.573529412,1969.88235294118,105.926470588235
"6191","22211","2016",51,51,0,126603.725490196,1381.74509803922,92.8235294117647
"6192","22212","2016",23,23,0,74000,963.304347826087,83.7391304347826
"6193","22213","2016",32,32,0,209578.125,1832.9375,115.03125
"6194","22214","2016",65,65,0,136842.538461538,1555.52307692308,92.8461538461538
"6195","22215","2016",116,112,4,131276.155172414,1395.98275862069,97.6465517241379
"6196","22216","2016",11,11,0,71345.4545454545,738.727272727273,98.7272727272727
"6197","22217","2016",4,4,0,51587.5,850,70
"6198","22218","2016",25,24,1,184800,1952.4,97.68
"6199","22219","2016",25,25,0,95176,869.96,112.6
"6200","22220","2016",12,12,0,67980.0833333333,865,77
"6201","22221","2016",23,23,0,125112.782608696,1366.65217391304,90.4782608695652
"6202","22222","2016",92,87,5,139972.565217391,1614.77173913043,88.7608695652174
"6203","22223","2016",20,20,0,98982.5,1262.8,80.35
"6204","22224","2016",18,18,0,151638.333333333,1614.5,97.8333333333333
"6205","22225","2016",55,53,2,114777,1172.05454545455,97.4363636363636
"6206","22226","2016",24,24,0,143383.375,1396.41666666667,99.4166666666667
"6207","22227","2016",8,8,0,83614,1167.375,73.375
"6208","22228","2016",16,16,0,74815.625,841.625,89.5625
"6209","22229","2016",18,18,0,73572.3333333333,947.944444444444,81.5555555555556
"6210","22231","2016",6,6,0,66083.3333333333,815,93.1666666666667
"6211","22232","2016",32,32,0,151701.71875,1402.0625,110
"6212","22233","2016",29,29,0,133332.75862069,1398.8275862069,98.3448275862069
"6213","22234","2016",21,21,0,123686.428571429,1133.47619047619,110.190476190476
"6214","22235","2016",3,3,0,117666.666666667,1176.33333333333,100
"6215","22236","2016",4,4,0,187025,1241.75,153.25
"6216","22237","2016",15,15,0,159833.333333333,1464.2,114.2
"6217","22238","2016",11,11,0,72122.7272727273,823.181818181818,92.7272727272727
"6218","22239","2016",19,19,0,120752.631578947,1245.10526315789,96.1578947368421
"6219","22240","2016",16,16,0,94690.625,1073.6875,88.5
"6220","22241","2016",11,11,0,59986.3636363636,748.454545454545,85.5454545454545
"6221","22242","2016",21,21,0,157238.285714286,1740.2380952381,93.9523809523809
"6222","22243","2016",10,10,0,90467,806.6,111.3
"6223","22244","2016",9,9,0,87438.8888888889,970.111111111111,87.4444444444444
"6224","22245","2016",12,12,0,83953.25,840.666666666667,102.25
"6225","22246","2016",13,12,1,150646.153846154,1487.07692307692,103.461538461538
"6226","22248","2016",30,29,1,93772.5666666667,1038.2,96.2666666666667
"6227","22249","2016",15,15,0,62833.3333333333,671.333333333333,96.8
"6228","22250","2016",12,11,1,100400,976.916666666667,100.25
"6229","22251","2016",66,62,4,183297.227272727,1898.48484848485,98.969696969697
"6230","22254","2016",11,11,0,89100,1014.81818181818,85.4545454545455
"6231","22255","2016",6,5,1,66499.1666666667,744,92
"6232","22256","2016",16,16,0,110780.625,1195.625,95.25
"6233","22257","2016",8,8,0,102000,1044.875,94.75
"6234","22258","2016",48,47,1,130074.416666667,1431.8125,91.7708333333333
"6235","22259","2016",53,51,2,150676.566037736,1507.47169811321,101.471698113208
"6236","22260","2016",8,8,0,84293.75,790.25,109.625
"6237","22261","2016",3,3,0,137000,1344.33333333333,104
"6238","22262","2016",20,18,2,122875,1343.25,105
"6239","22263","2016",5,5,0,155600,1414.4,111.2
"6240","22264","2016",35,35,0,88814.2857142857,1012.08571428571,91.9714285714286
"6241","22265","2016",16,16,0,129710.9375,1399,95.5625
"6242","22266","2016",53,53,0,77356.8867924528,862.320754716981,88.8679245283019
"6243","22267","2016",4,4,0,82500,728.25,104.75
"6244","22268","2016",6,6,0,109000,1177.5,99.5
"6245","22269","2016",4,4,0,83750,1150.75,69
"6246","22272","2016",16,14,2,123985.625,1289.75,100.875
"6247","22273","2016",22,21,1,183736.363636364,1779.72727272727,107.136363636364
"6248","22274","2016",1,1,0,175000,1458,120
"6249","22275","2016",12,12,0,123565.833333333,1114,111.75
"6250","22276","2016",3,3,0,117050,1099.66666666667,111.333333333333
"6251","22277","2016",18,18,0,140751.777777778,1645.55555555556,92.3333333333333
"6252","22278","2016",724,350,374,101163.737569061,1281.12845303867,77.0690607734807
"6253","22279","2016",5,5,0,119993.8,1355.2,85
"6254","22280","2016",8,8,0,145837.5,1456.125,100
"6255","22281","2016",13,13,0,116015.384615385,1156.69230769231,99.7692307692308
"6256","22282","2016",94,57,37,198613.968085106,2444.73404255319,86.4574468085106
"6257","22283","2016",10,10,0,83015,889.5,92
"6258","22284","2016",3,3,0,80100,926.333333333333,90.6666666666667
"6259","22285","2016",5,5,0,55600,873.6,63.4
"6260","22286","2016",7,7,0,108637.142857143,1110.14285714286,97.4285714285714
"6261","22287","2016",10,9,1,137182.6,1352.4,102.9
"6262","22288","2016",4,4,0,87750,821.75,101.25
"6263","22289","2016",2,2,0,59000,732.5,80.5
"6264","22291","2016",1,1,0,125000,1488,84
"6265","22293","2016",5,5,0,108500,941.2,119
"6266","22294","2016",4,4,0,70000,789.75,86.25
"6267","22295","2016",4,4,0,102175,852.5,112.75
"6268","22296","2016",5,5,0,136438,1771,81
"6269","22299","2016",9,9,0,118744.444444444,1455.77777777778,82
"6270","22300","2016",3,3,0,81433.3333333333,1260.66666666667,69.6666666666667
"6271","22302","2016",17,14,3,207632.352941176,2395.58823529412,93.2352941176471
"6272","22304","2016",4,4,0,116500,1208,100
"6273","22305","2016",3,3,0,109000,872,121
"6274","22306","2016",4,4,0,147275,1929.25,83
"6275","22307","2016",21,21,0,141421.428571429,1405.80952380952,102.190476190476
"6276","22308","2016",5,5,0,127780,1255.2,93.8
"6277","22309","2016",1,1,0,330000,2308,143
"6278","22310","2016",6,6,0,108858.333333333,1111.33333333333,99.8333333333333
"6279","22311","2016",11,11,0,130822.727272727,1167.09090909091,114.727272727273
"6280","22312","2016",2,2,0,176750,1854,117.5
"6281","22313","2016",1,1,0,50000,625,80
"6282","22314","2016",2,2,0,107000,972,107.5
"6283","22315","2016",5,5,0,151200,1497.6,107.6
"6284","22316","2016",4,4,0,79162.5,847,89.25
"6285","22318","2016",3,3,0,103466.666666667,1373,86
"6286","22319","2016",5,5,0,159010,1676.2,95.6
"6287","22320","2016",2,2,0,80850,744.5,108.5
"6288","22321","2016",24,24,0,65000.0833333333,781.583333333333,87.375
"6289","22322","2016",5,5,0,136656.2,1122.6,122.6
"6290","22323","2016",11,11,0,162590.909090909,1464.36363636364,118.272727272727
"6291","22324","2016",11,11,0,148245.454545455,1441.45454545455,103.818181818182
"6292","22325","2016",125,69,56,158073.576,2230.072,74.232
"6293","22326","2016",5,5,0,118489,1535.6,78.4
"6294","22327","2016",20,20,0,167468.15,1521.85,107.05
"6295","22328","2016",8,8,0,64400,881.25,72.125
"6296","22330","2016",4,4,0,107674.25,843,119.75
"6297","22331","2016",4,4,0,118343.75,1059.5,118.75
"6298","22332","2016",4,4,0,156050,1309.75,122.75
"6299","22333","2016",10,10,0,77422,828.7,95.8
"6300","22335","2016",3,3,0,70838,1034.33333333333,63
"6301","22337","2016",10,10,0,99350,1027.5,99.2
"6302","22338","2016",2,2,0,92500,1239.5,80.5
"6303","22339","2016",31,31,0,148267.096774194,1414.22580645161,101.548387096774
"6304","22340","2016",12,12,0,126574.166666667,1102.08333333333,120.083333333333
"6305","22341","2016",5,5,0,118600,1411.6,90.8
"6306","22342","2016",3,3,0,82733.3333333333,1100,76
"6307","22343","2016",74,53,21,186757.567567568,2179.59459459459,89.6216216216216
"6308","22344","2016",7,7,0,68785.7142857143,930.142857142857,75.2857142857143
"6309","22345","2016",11,11,0,87727.2727272727,848.909090909091,111.090909090909
"6310","22346","2016",12,12,0,114804.083333333,1214.58333333333,97.4166666666667
"6311","22347","2016",22,22,0,104204.545454545,1202.86363636364,88.0454545454545
"6312","22348","2016",4,4,0,100500,1416,72
"6313","22349","2016",27,26,1,164168.296296296,1734.77777777778,97.8148148148148
"6314","22350","2016",9,9,0,131111.111111111,1525.11111111111,98.7777777777778
"6315","22351","2016",6,6,0,101666.666666667,839,127.5
"6316","22352","2016",2,2,0,60750,1174.5,51.5
"6317","22353","2016",57,43,14,217895.543859649,2508.12280701754,89.9122807017544
"6318","22354","2016",9,9,0,79833.3333333333,837.888888888889,98
"6319","22356","2016",8,8,0,141653.75,1418.5,127.375
"6320","22358","2016",1,1,0,162750,1565,104
"6321","22359","2016",7,7,0,109785.714285714,877.142857142857,113.142857142857
"6322","22360","2016",84,79,5,139864.535714286,1518.7619047619,95.3690476190476
"6323","22361","2016",14,14,0,114450,1226.35714285714,95.9285714285714
"6324","22362","2016",29,25,4,113672.75862069,1269.1724137931,90.448275862069
"6325","22363","2016",17,17,0,189642.647058824,1827.17647058824,104.823529411765
"6326","22364","2016",26,26,0,152986.923076923,1405.34615384615,106.807692307692
"6327","22365","2016",3,3,0,87985,844,115.333333333333
"6328","22366","2016",8,8,0,90521.25,1243.375,75.75
"6329","22368","2016",5,5,0,144148,1803.4,83.4
"6330","22369","2016",2,2,0,71400,693,108.5
"6331","22370","2016",3,3,0,74103.3333333333,1168,68
"6332","22371","2016",11,10,1,100300,976.818181818182,104.909090909091
"6333","22372","2016",19,18,1,119835,1217.15789473684,98.3684210526316
"6334","22373","2016",2,2,0,49000,703,72
"6335","22375","2016",3,3,0,148333.333333333,1405,113.333333333333
"6336","22376","2016",10,10,0,109287.5,1065.8,104.5
"6337","22377","2016",13,13,0,133197.692307692,1267.30769230769,122.153846153846
"6338","22378","2016",4,4,0,110236.25,1060.25,101
"6339","22379","2016",31,30,1,165915.483870968,1846.8064516129,92.5483870967742
"6340","22380","2016",3,3,0,120000,1594.66666666667,76
"6341","22381","2016",3,3,0,139333.333333333,1771.66666666667,77
"6342","22383","2016",3,3,0,69333.3333333333,635,117.666666666667
"6343","22384","2016",10,10,0,86963.5,931.2,90.9
"6344","22385","2016",12,12,0,234283.333333333,1821.66666666667,124.75
"6345","22386","2016",8,8,0,98187.5,968.625,93.625
"6346","22387","2016",16,16,0,90581.25,910.6875,100.6875
"6347","22388","2016",11,11,0,94272.7272727273,1139.72727272727,86.0909090909091
"6348","22389","2016",31,28,3,139731.612903226,1457.87096774194,94.9032258064516
"6349","22390","2016",16,16,0,123234.8125,1234.4375,96.5
"6350","22391","2016",18,18,0,119050,992.666666666667,118.777777777778
"6351","23001","2016",10,10,0,68423.8,1131.5,76.9
"6352","23002","2016",6,6,0,75166.6666666667,917.166666666667,86.8333333333333
"6353","23003","2016",2,2,0,97000,854,113.5
"6354","23004","2016",5,5,0,83680,941.6,86.6
"6355","23005","2016",3,3,0,55290,606.666666666667,92.3333333333333
"6356","23006","2016",4,4,0,92998.75,910.5,105
"6357","23007","2016",4,4,0,50620,558.75,88
"6358","23008","2016",28,23,5,64055.1428571429,769.392857142857,86.9642857142857
"6359","23010","2016",1,1,0,136500,875,156
"6360","23011","2016",2,2,0,46500,427.5,104.5
"6361","23012","2016",1,1,0,120000,938,128
"6362","23013","2016",13,13,0,94156.5384615385,949.615384615385,111
"6363","23014","2016",1,1,0,55000,688,80
"6364","23015","2016",8,8,0,56719.375,758.75,76.25
"6365","23016","2016",2,2,0,57500,500,115
"6366","23017","2016",5,5,0,64101,663.2,100.8
"6367","23018","2016",4,4,0,66250,854.25,76
"6368","23019","2016",1,1,0,40600,549,74
"6369","23020","2016",4,4,0,84570,693.25,129.75
"6370","23021","2016",5,5,0,52459.2,587.2,88.8
"6371","23022","2016",10,10,0,67476.7,1034.3,68.9
"6372","23023","2016",1,1,0,68005,716,95
"6373","23024","2016",6,6,0,73566.6666666667,937,77.5
"6374","23025","2016",21,21,0,75088.0952380952,797.333333333333,96.4285714285714
"6375","23026","2016",6,6,0,59939.1666666667,666.666666666667,107.333333333333
"6376","23027","2016",3,3,0,49979.6666666667,823.666666666667,59
"6377","23028","2016",1,1,0,118000,1180,100
"6378","23029","2016",5,5,0,62760,787.8,79.6
"6379","23030","2016",19,19,0,117547.947368421,1016.52631578947,110
"6380","23031","2016",11,9,2,94090.9090909091,960.363636363636,109.272727272727
"6381","23032","2016",9,9,0,126711.333333333,1412.55555555556,91.7777777777778
"6382","23033","2016",4,4,0,114000,906.75,128
"6383","23035","2016",2,2,0,131500,1103,105
"6384","23036","2016",12,12,0,72550.0833333333,887.833333333333,82.25
"6385","23038","2016",4,4,0,57000,955.5,70
"6386","23039","2016",9,9,0,109511.111111111,1122.11111111111,112
"6387","23040","2016",1,1,0,60000,541,111
"6388","23041","2016",3,3,0,78498.3333333333,790,120.666666666667
"6389","23042","2016",3,3,0,49666.6666666667,563.333333333333,81.6666666666667
"6390","23043","2016",1,1,0,139500,918,152
"6391","23044","2016",1,1,0,105400,925,114
"6392","23045","2016",7,7,0,35390,594.714285714286,59.5714285714286
"6393","23046","2016",1,1,0,96000,1185,81
"6394","23048","2016",4,4,0,113512.5,644,180.5
"6395","23049","2016",5,5,0,50545.6,799.2,70.8
"6396","23052","2016",3,3,0,122000,1259,96.6666666666667
"6397","23053","2016",1,1,0,32000,681,47
"6398","23054","2016",2,2,0,139000,1142,122
"6399","23056","2016",8,8,0,67935.625,869.75,80.5
"6400","23057","2016",4,4,0,65375,956.5,67.75
"6401","23058","2016",1,1,0,40000,500,80
"6402","23059","2016",2,2,0,221410,1084,152
"6403","23060","2016",2,2,0,55500,938,59
"6404","23061","2016",4,3,1,37250,610.25,69.25
"6405","23062","2016",12,12,0,65142.5,1044.75,76.0833333333333
"6406","23064","2016",15,15,0,66903.8,794.933333333333,88.9333333333333
"6407","23065","2016",3,3,0,49666.6666666667,916.333333333333,55
"6408","23066","2016",2,2,0,42500,700.5,68.5
"6409","23067","2016",7,7,0,74464.2857142857,900.571428571429,81
"6410","23068","2016",4,4,0,99000,818.5,97.75
"6411","23069","2016",3,3,0,83000,680.666666666667,115.333333333333
"6412","23070","2016",12,12,0,69487.0833333333,1140.91666666667,74
"6413","23071","2016",4,4,0,59151.25,711.75,80.5
"6414","23072","2016",7,7,0,108214.285714286,1419.42857142857,83.1428571428571
"6415","23073","2016",4,4,0,56000,806.5,67
"6416","23074","2016",1,1,0,150000,441,340
"6417","23075","2016",12,12,0,96404.1666666667,888.916666666667,109.833333333333
"6418","23076","2016",14,13,1,66035.7142857143,874.214285714286,79.6428571428571
"6419","23077","2016",5,5,0,75800,778,102.2
"6420","23079","2016",13,10,3,93646.1538461538,1033.30769230769,96.6923076923077
"6421","23080","2016",2,2,0,136945,961.5,154
"6422","23081","2016",2,2,0,52750,603,90
"6423","23082","2016",5,5,0,63900,787.8,80.4
"6424","23083","2016",5,5,0,54600,719.4,79.8
"6425","23084","2016",2,2,0,90000,509,177
"6426","23086","2016",6,6,0,69333.3333333333,690.666666666667,95.1666666666667
"6427","23087","2016",6,6,0,54333.3333333333,761.166666666667,71.6666666666667
"6428","23088","2016",1,1,0,119000,1190,100
"6429","23089","2016",6,6,0,58250,821.5,82.8333333333333
"6430","23090","2016",6,5,1,83966.6666666667,711.666666666667,106.333333333333
"6431","23091","2016",2,2,0,47750,1238,49.5
"6432","23092","2016",4,4,0,91000,915,99.25
"6433","23093","2016",18,18,0,91758.8888888889,907.5,106.055555555556
"6434","23095","2016",14,13,1,96457.1428571429,986.071428571429,93.5
"6435","23096","2016",129,87,42,89326.2403100775,1058.07751937984,86.0232558139535
"6436","23097","2016",2,2,0,60000,493,120
"6437","23099","2016",10,10,0,77500,761.8,102.8
"6438","23100","2016",4,4,0,54650,631,88.25
"6439","23101","2016",3,3,0,62333.3333333333,626,103.333333333333
"6440","23102","2016",3,3,0,64826.6666666667,854.666666666667,64.3333333333333
"6441","23103","2016",1,1,0,57500,858,67
"6442","23104","2016",2,2,0,76500,923.5,82.5
"6443","23105","2016",4,4,0,52875,939.5,52
"6444","23106","2016",1,1,0,82000,586,140
"6445","23108","2016",1,1,0,59455,376,158
"6446","23109","2016",3,3,0,67333.3333333333,1023.66666666667,69.6666666666667
"6447","23111","2016",3,2,1,90024.3333333333,912.666666666667,122
"6448","23112","2016",8,8,0,77404.5,973.375,86.375
"6449","23113","2016",5,5,0,60200,666.6,87.6
"6450","23114","2016",4,4,0,83462.5,1166.75,82.75
"6451","23115","2016",5,5,0,52080,697.6,86.6
"6452","23116","2016",7,7,0,79239.8571428571,830.571428571429,97.2857142857143
"6453","23117","2016",4,4,0,52888,662.75,78
"6454","23118","2016",1,1,0,233000,1294,180
"6455","23119","2016",1,1,0,70000,500,140
"6456","23123","2016",1,1,0,55000,859,64
"6457","23124","2016",5,5,0,73110,873.6,86
"6458","23127","2016",7,7,0,79685.7142857143,779.571428571429,104.571428571429
"6459","23130","2016",8,8,0,46812.5,623.125,76.625
"6460","23131","2016",7,7,0,85019.8571428571,749,111.142857142857
"6461","23132","2016",2,2,0,82500,568.5,135.5
"6462","23133","2016",9,9,0,78733.3333333333,1005,89.1111111111111
"6463","23134","2016",3,3,0,85100,966.666666666667,87.3333333333333
"6464","23136","2016",1,1,0,26000,1130,23
"6465","23137","2016",5,5,0,96590,1095,92.4
"6466","23138","2016",2,2,0,65000,855,78
"6467","23139","2016",5,5,0,49900,724.6,75.4
"6468","23140","2016",3,3,0,58666.6666666667,717.333333333333,80
"6469","23141","2016",13,13,0,63725.3076923077,752.846153846154,82.2307692307692
"6470","23142","2016",2,2,0,60000,681,90
"6471","23143","2016",4,4,0,68000,767.5,106.5
"6472","23144","2016",1,1,0,66000,635,104
"6473","23145","2016",2,2,0,72000,899,72
"6474","23146","2016",5,5,0,71500,784.8,92.8
"6475","23147","2016",3,3,0,40000,492,82.3333333333333
"6476","23148","2016",8,8,0,57874.875,666.375,104
"6477","23149","2016",3,3,0,81833.3333333333,968.333333333333,73.6666666666667
"6478","23150","2016",1,1,0,54500,363,150
"6479","23151","2016",8,8,0,58406.25,633,96
"6480","23152","2016",2,2,0,70000,507.5,140.5
"6481","23154","2016",13,13,0,74703.4615384615,878,86.2307692307692
"6482","23155","2016",4,4,0,89750,1118.25,77.75
"6483","23157","2016",2,2,0,54250,592,99
"6484","23158","2016",3,3,0,63900,652.333333333333,103.666666666667
"6485","23159","2016",2,2,0,35000,742,43
"6486","23162","2016",6,6,0,53750,912.166666666667,70.3333333333333
"6487","23164","2016",6,6,0,59141.3333333333,917.833333333333,59.3333333333333
"6488","23165","2016",12,12,0,78027.75,1426.83333333333,68.1666666666667
"6489","23166","2016",1,1,0,60000,600,100
"6490","23167","2016",4,4,0,86910,902,92.75
"6491","23168","2016",13,13,0,59184.6153846154,819.692307692308,73.9230769230769
"6492","23169","2016",9,9,0,96366.6666666667,989.666666666667,97.1111111111111
"6493","23170","2016",5,5,0,84238.6,783.4,100.6
"6494","23171","2016",5,5,0,85340,1215.6,76.8
"6495","23174","2016",10,10,0,64430,853.1,77
"6496","23175","2016",4,4,0,180085,1368.25,120.25
"6497","23176","2016",35,31,4,98197.1428571429,999.6,94.4571428571429
"6498","23177","2016",10,10,0,100200,1163.8,86.9
"6499","23179","2016",3,3,0,90000,718.333333333333,135.333333333333
"6500","23180","2016",5,5,0,84510,772.8,110
"6501","23181","2016",1,1,0,105000,814,129
"6502","23182","2016",1,1,0,90000,1139,79
"6503","23183","2016",2,2,0,98000,1021,96
"6504","23184","2016",2,2,0,48500,1578,43
"6505","23185","2016",3,3,0,89666.6666666667,689.666666666667,123.666666666667
"6506","23187","2016",2,2,0,52250,760.5,67.5
"6507","23188","2016",1,1,0,147700,1078,137
"6508","23189","2016",10,10,0,69245.4,729.6,89
"6509","23191","2016",3,3,0,142666.666666667,1396.33333333333,93
"6510","23192","2016",14,14,0,80607.5,790.857142857143,100.285714285714
"6511","23193","2016",25,25,0,115703.6,1077.44,105.4
"6512","23195","2016",7,7,0,103428.571428571,1066.14285714286,94.1428571428571
"6513","23196","2016",1,1,0,41500,461,90
"6514","23197","2016",7,7,0,77428.5714285714,857,97.7142857142857
"6515","23198","2016",2,2,0,62140,1047.5,64
"6516","23199","2016",2,2,0,76974,1348,56.5
"6517","23200","2016",3,3,0,78806.6666666667,819,91.6666666666667
"6518","23201","2016",3,3,0,87500,784.333333333333,107
"6519","23202","2016",2,2,0,77500,578.5,128
"6520","23203","2016",3,3,0,45833.3333333333,532.666666666667,90.3333333333333
"6521","23204","2016",3,3,0,32333.3333333333,749,54
"6522","23205","2016",1,1,0,65000,471,138
"6523","23206","2016",5,5,0,109573,1001.8,120.6
"6524","23207","2016",1,1,0,33000,367,90
"6525","23208","2016",1,1,0,125000,947,132
"6526","23209","2016",4,4,0,74250,686.25,110.25
"6527","23210","2016",2,2,0,57500,442.5,127
"6528","23211","2016",2,2,0,50500,769,65.5
"6529","23212","2016",1,1,0,120000,909,132
"6530","23213","2016",2,2,0,40000,412,97
"6531","23215","2016",2,2,0,63952.5,664,90
"6532","23216","2016",1,1,0,215000,1303,165
"6533","23217","2016",5,5,0,128861,1189,130.2
"6534","23218","2016",4,4,0,33750,384.25,89.25
"6535","23219","2016",13,13,0,93116.9230769231,970.615384615385,96.5384615384615
"6536","23220","2016",4,4,0,68875,803.75,112.5
"6537","23221","2016",2,2,0,59750,809.5,76
"6538","23222","2016",2,2,0,56850,488.5,114.5
"6539","23223","2016",5,5,0,131820.8,1113.2,107.4
"6540","23224","2016",1,1,0,131500,939,140
"6541","23225","2016",1,1,0,37500,457,82
"6542","23226","2016",1,1,0,90000,495,182
"6543","23227","2016",3,3,0,91166.6666666667,973.666666666667,93
"6544","23228","2016",2,2,0,90000,966,90.5
"6545","23229","2016",3,3,0,47333.3333333333,484.666666666667,96.6666666666667
"6546","23230","2016",1,1,0,70000,714,98
"6547","23232","2016",2,2,0,75500,654,115
"6548","23233","2016",1,1,0,51000,823,62
"6549","23234","2016",1,1,0,250000,962,260
"6550","23235","2016",7,7,0,110703.714285714,901.571428571429,129.857142857143
"6551","23236","2016",3,3,0,53166.6666666667,731.666666666667,75
"6552","23238","2016",5,5,0,91140,753.8,126
"6553","23239","2016",5,5,0,74700,755.6,94.6
"6554","23240","2016",2,2,0,144750,1373,108
"6555","23242","2016",2,2,0,39500,626.5,63
"6556","23243","2016",4,4,0,114750,979,119.25
"6557","23244","2016",6,6,0,64916.6666666667,1152.5,74.8333333333333
"6558","23245","2016",9,9,0,99305.2222222222,897.222222222222,112.111111111111
"6559","23246","2016",4,4,0,83196,1071,80
"6560","23247","2016",9,9,0,53666.6666666667,701.888888888889,73
"6561","23248","2016",3,3,0,50833.3333333333,452.333333333333,114.666666666667
"6562","23249","2016",5,5,0,101168.4,1168.6,87.6
"6563","23250","2016",1,1,0,125000,1276,98
"6564","23251","2016",1,1,0,171995,1229,140
"6565","23252","2016",3,3,0,70000,660.333333333333,114
"6566","23253","2016",4,4,0,144012.75,912.25,164.75
"6567","23254","2016",2,2,0,57500,695.5,86.5
"6568","23255","2016",3,3,0,71833.3333333333,942.666666666667,83.3333333333333
"6569","23257","2016",6,6,0,138506.833333333,1292.33333333333,103.5
"6570","23258","2016",1,1,0,120000,750,160
"6571","23259","2016",1,1,0,95000,1056,90
"6572","23260","2016",4,4,0,57500,554.75,100.5
"6573","23261","2016",2,1,1,61400,860.5,80
"6574","23262","2016",2,2,0,103750,742.5,139.5
"6575","23263","2016",1,1,0,70000,1186,59
"6576","23264","2016",1,1,0,91000,1213,75
"6577","23266","2016",2,2,0,108000,732.5,148
"6578","24001","2016",9,9,0,138111.111111111,2555.55555555556,78.2222222222222
"6579","24002","2016",12,11,1,137836.25,1203.91666666667,118.666666666667
"6580","24004","2016",3,3,0,138666.666666667,1558.66666666667,88.6666666666667
"6581","24005","2016",2,2,0,138850,1092,129
"6582","24006","2016",1,1,0,105000,808,130
"6583","24007","2016",4,4,0,118900,1270.75,91.75
"6584","24008","2016",6,6,0,74500,1153.66666666667,73.1666666666667
"6585","24009","2016",2,2,0,71500,772.5,97
"6586","24010","2016",10,10,0,131050,1341.2,100.2
"6587","24011","2016",6,6,0,174133.333333333,1460.5,124.666666666667
"6588","24012","2016",1,1,0,170000,2099,81
"6589","24014","2016",5,5,0,148688.6,1665.2,90.2
"6590","24015","2016",2,2,0,140500,1947.5,83.5
"6591","24016","2016",6,6,0,47166.6666666667,796.5,67
"6592","24018","2016",6,6,0,166683.333333333,2156.16666666667,85.3333333333333
"6593","24019","2016",7,7,0,78418.5714285714,1207.57142857143,66.7142857142857
"6594","24020","2016",7,7,0,105413.571428571,1375.14285714286,80.8571428571429
"6595","24021","2016",3,3,0,133066.666666667,1341.66666666667,89.3333333333333
"6596","24022","2016",5,5,0,252586.6,1894.4,130
"6597","24023","2016",2,2,0,189000,1853.5,101.5
"6598","24024","2016",1,1,0,374000,1069,350
"6599","24025","2016",4,4,0,164017.5,2301,73.75
"6600","24026","2016",32,32,0,172766.5625,1402.4375,118.75
"6601","24027","2016",5,5,0,120600,1413.8,84.8
"6602","24028","2016",14,13,1,131860,1464.57142857143,99.4285714285714
"6603","24029","2016",3,3,0,78000,911.333333333333,86.6666666666667
"6604","24030","2016",7,7,0,113307.142857143,1220.71428571429,93.2857142857143
"6605","24032","2016",6,6,0,59166.6666666667,848.166666666667,70.5
"6606","24035","2016",9,9,0,154848.666666667,1075.66666666667,129.555555555556
"6607","24036","2016",3,3,0,138846.666666667,1854.66666666667,79
"6608","24037","2016",373,292,81,119779.908847185,1337.83646112601,91.2144772117963
"6609","24038","2016",2,2,0,135045,1125.5,120
"6610","24040","2016",8,8,0,223750,2050.5,110.75
"6611","24042","2016",10,10,0,126273.4,1358.6,105.8
"6612","24043","2016",4,4,0,167428.75,1778.5,103.75
"6613","24045","2016",4,4,0,106230,1229.25,90
"6614","24050","2016",3,3,0,173200,1493.33333333333,117
"6615","24051","2016",2,2,0,134593,928,145.5
"6616","24052","2016",1,1,0,65000,1327,49
"6617","24053","2016",97,83,14,140235.907216495,1452.38144329897,96.4948453608247
"6618","24054","2016",8,8,0,147209,1553.75,101.375
"6619","24055","2016",8,8,0,132357.5,1492.375,97.75
"6620","24056","2016",3,3,0,200333.333333333,2016.33333333333,104.333333333333
"6621","24058","2016",3,3,0,182140,1339,123
"6622","24059","2016",3,3,0,64833.3333333333,676.333333333333,93.3333333333333
"6623","24061","2016",1,1,0,160000,1633,98
"6624","24062","2016",3,3,0,83861.6666666667,785.333333333333,125
"6625","24063","2016",2,2,0,384000,8075,80
"6626","24064","2016",34,33,1,156699.676470588,1542.41176470588,105.705882352941
"6627","24066","2016",4,4,0,126325,1492.5,90.75
"6628","24067","2016",38,37,1,138117.736842105,1398,98.5263157894737
"6629","24068","2016",19,19,0,137368.421052632,1310.78947368421,101.947368421053
"6630","24069","2016",6,6,0,122228.333333333,1370.5,86.3333333333333
"6631","24070","2016",8,8,0,125618.75,1092.625,104.5
"6632","24071","2016",3,3,0,96000,1235.33333333333,82.3333333333333
"6633","24073","2016",9,9,0,138833.333333333,1339.88888888889,102.888888888889
"6634","24074","2016",3,3,0,133466.666666667,1503,87.6666666666667
"6635","24075","2016",4,4,0,88000,1249.25,69.5
"6636","24076","2016",4,4,0,145875,1444.5,109.25
"6637","24080","2016",3,3,0,140333.333333333,1649,83.6666666666667
"6638","24081","2016",11,10,1,183789.363636364,1413.18181818182,137.272727272727
"6639","24082","2016",16,16,0,188004.375,1779.9375,107
"6640","24083","2016",1,1,0,61000,545,112
"6641","24084","2016",1,1,0,214000,2140,100
"6642","24086","2016",8,8,0,399210,2376.125,162.875
"6643","24087","2016",10,10,0,163490,1359.9,121.2
"6644","24088","2016",3,3,0,297300,2780.33333333333,103.666666666667
"6645","24090","2016",7,7,0,99071.4285714286,903.571428571429,110.285714285714
"6646","24091","2016",9,9,0,164315,1598.55555555556,101.222222222222
"6647","24094","2016",3,3,0,304600,1790.33333333333,166.666666666667
"6648","24096","2016",9,9,0,139166.666666667,1518.22222222222,103
"6649","24097","2016",7,7,0,108822.857142857,850,135.428571428571
"6650","24098","2016",26,25,1,174192.307692308,1635.23076923077,109.153846153846
"6651","24100","2016",13,13,0,121993.076923077,1138.30769230769,110.461538461538
"6652","24101","2016",4,4,0,89765,958.25,91
"6653","24102","2016",52,49,3,142812.5,1500.34615384615,96.3269230769231
"6654","24104","2016",4,4,0,96250,1113,80.75
"6655","24105","2016",2,2,0,63500,555.5,118
"6656","24106","2016",6,6,0,171033.333333333,1822.83333333333,86.5
"6657","24107","2016",3,3,0,70666.6666666667,1370.33333333333,65.3333333333333
"6658","24108","2016",10,10,0,159403,1476.1,106.8
"6659","24109","2016",1,1,0,385000,1791,215
"6660","24113","2016",1,1,0,205985,981,210
"6661","24115","2016",21,21,0,182279.476190476,2001.33333333333,95.5238095238095
"6662","24116","2016",2,2,0,97500,1975,50
"6663","24117","2016",2,2,0,162500,1574,110
"6664","24119","2016",8,8,0,112312.5,996.25,117.25
"6665","24120","2016",7,7,0,86928.5714285714,1161,75.4285714285714
"6666","24121","2016",3,3,0,102666.666666667,1261.66666666667,94.3333333333333
"6667","24124","2016",2,2,0,99000,970.5,102
"6668","24126","2016",3,3,0,123333.333333333,773.666666666667,138
"6669","24129","2016",7,7,0,86885.7142857143,944.571428571429,101.714285714286
"6670","24130","2016",6,6,0,90113.5,1178.5,76.8333333333333
"6671","24132","2016",1,1,0,60000,706,85
"6672","24134","2016",11,11,0,114954.454545455,1275.27272727273,94.4545454545455
"6673","24135","2016",5,5,0,125520,1373,90.4
"6674","24136","2016",5,5,0,119500,1404,93.4
"6675","24137","2016",7,7,0,140135.714285714,1281.42857142857,112.714285714286
"6676","24138","2016",114,107,7,119627.631578947,1403.27192982456,86.0701754385965
"6677","24139","2016",22,22,0,174509.545454545,1600.68181818182,108.545454545455
"6678","24140","2016",12,12,0,172250,1579.58333333333,108.583333333333
"6679","24142","2016",16,16,0,177382.625,1770.1875,104.125
"6680","24143","2016",12,12,0,103830,1048.83333333333,83.0833333333333
"6681","24144","2016",1,1,0,118000,1044,113
"6682","24145","2016",20,19,1,158111.5,1323,113.15
"6683","24147","2016",17,16,1,111271.764705882,1340.29411764706,84.9411764705882
"6684","24148","2016",7,7,0,169421.428571429,1649.28571428571,109.428571428571
"6685","24150","2016",8,8,0,223825,1609.25,138
"6686","24152","2016",17,17,0,174681.058823529,2062.76470588235,101.117647058824
"6687","24153","2016",6,6,0,156008.333333333,1289.33333333333,116.333333333333
"6688","24154","2016",5,5,0,159800,1045,140.2
"6689","24156","2016",15,15,0,146350,1671.73333333333,96.1333333333333
"6690","24157","2016",14,14,0,141178.571428571,1183.78571428571,119.071428571429
"6691","24158","2016",5,5,0,87000,1085.6,80.6
"6692","24159","2016",4,4,0,118267.75,1220,102.25
"6693","24160","2016",6,6,0,136833.333333333,1209,108.666666666667
"6694","24163","2016",1,1,0,54000,675,80
"6695","24164","2016",10,10,0,83110,1013.3,87.1
"6696","24165","2016",5,5,0,105500,1068.6,105.8
"6697","24167","2016",47,47,0,123854.042553191,1234.02127659574,102.297872340426
"6698","24168","2016",7,7,0,217642.857142857,1482.85714285714,129.285714285714
"6699","24171","2016",5,5,0,73860,737,103.2
"6700","24172","2016",14,14,0,166235.714285714,1563.85714285714,108.5
"6701","24175","2016",3,3,0,172333.333333333,1226.33333333333,151.666666666667
"6702","24177","2016",4,4,0,97125,996.25,88
"6703","24179","2016",8,8,0,108125,1159.875,96.75
"6704","24182","2016",12,12,0,123908.333333333,1329.08333333333,114.5
"6705","24183","2016",10,10,0,171855.6,2297.2,82.1
"6706","24184","2016",2,2,0,146500,1461.5,100
"6707","24186","2016",6,6,0,137551.5,1082.33333333333,125.333333333333
"6708","24188","2016",6,6,0,153000,1079.16666666667,144.5
"6709","24189","2016",4,4,0,140112.5,881,152.75
"6710","24190","2016",2,2,0,120000,1100.5,122.5
"6711","24191","2016",1,1,0,157000,1090,144
"6712","24194","2016",17,17,0,126808.823529412,1259.17647058824,103.941176470588
"6713","24196","2016",4,4,0,138475,1005.5,138.25
"6714","24197","2016",14,14,0,169289.642857143,1370.42857142857,119.071428571429
"6715","24199","2016",2,2,0,1e+05,640,125
"6716","24200","2016",8,8,0,121879.625,1142,98.75
"6717","24202","2016",2,2,0,120850,942,149.5
"6718","24205","2016",6,6,0,114820.333333333,1428.83333333333,78.1666666666667
"6719","24207","2016",10,10,0,114009,1440.1,83.7
"6720","24208","2016",1,1,0,35000,2333,15
"6721","24209","2016",1,1,0,128000,1153,111
"6722","24210","2016",12,11,1,94770.0833333333,1165.5,77.0833333333333
"6723","24212","2016",13,13,0,184230.769230769,1408.38461538462,135.692307692308
"6724","24213","2016",2,2,0,137500,1448,86.5
"6725","24214","2016",4,4,0,82500,861,105
"6726","24216","2016",2,2,0,102500,1095.5,94
"6727","24217","2016",5,5,0,310068,2422.4,111.8
"6728","24218","2016",21,21,0,83103.0952380952,1043.19047619048,84.4285714285714
"6729","24220","2016",4,4,0,162456.75,1750.5,96
"6730","24222","2016",39,39,0,142611.025641026,1387.71794871795,104.487179487179
"6731","24223","2016",43,42,1,165289.534883721,1833.3023255814,96.2093023255814
"6732","24224","2016",5,5,0,225600,1693.4,115.6
"6733","24225","2016",32,32,0,133188.5,1251.53125,104.5625
"6734","24226","2016",14,14,0,134425,1451.85714285714,93.7142857142857
"6735","24227","2016",8,8,0,110583,1179.25,98.25
"6736","24228","2016",3,3,0,142666.666666667,1409,112.333333333333
"6737","24229","2016",17,16,1,104864.411764706,1627.82352941176,74.5294117647059
"6738","24230","2016",1,1,0,49000,1256,39
"6739","24231","2016",1,1,0,145000,1611,90
"6740","24232","2016",3,3,0,140666.666666667,1710.66666666667,76.6666666666667
"6741","24234","2016",4,4,0,170250,1211,142.5
"6742","24236","2016",12,12,0,138208.583333333,1438.75,98.8333333333333
"6743","24237","2016",12,12,0,240433.333333333,1747.91666666667,132.333333333333
"6744","24238","2016",2,2,0,171100,1623,106
"6745","24240","2016",4,4,0,126875,1643,76
"6746","24241","2016",1,1,0,93400,1334,70
"6747","24242","2016",2,2,0,257000,1563.5,160
"6748","24243","2016",13,13,0,103720.076923077,1025.46153846154,113.461538461538
"6749","24246","2016",3,3,0,156333.333333333,1177,142.666666666667
"6750","24247","2016",1,1,0,122000,744,164
"6751","24248","2016",3,3,0,103333.333333333,1028,102
"6752","24251","2016",4,4,0,172500,1402.5,120.75
"6753","24252","2016",5,5,0,127800,1170.8,106.6
"6754","24253","2016",22,21,1,114086.363636364,944.454545454545,127.227272727273
"6755","24254","2016",1,1,0,160000,2424,66
"6756","24255","2016",1,1,0,165000,1941,85
"6757","24256","2016",36,35,1,129105.833333333,1317.97222222222,97.9166666666667
"6758","24257","2016",4,4,0,163500,1927,84.75
"6759","24260","2016",7,7,0,147049.571428571,1766.28571428571,97.7142857142857
"6760","24261","2016",2,2,0,94500,1408.5,66
"6761","24262","2016",4,4,0,91375,867,96.5
"6762","24263","2016",3,3,0,111666.666666667,988,113.333333333333
"6763","24264","2016",18,18,0,141504.166666667,1236.77777777778,113.888888888889
"6764","24266","2016",15,15,0,121330,1331,88.0666666666667
"6765","24268","2016",8,8,0,305950,2161.375,140.875
"6766","24269","2016",15,15,0,76613.3333333333,967.066666666667,77.8
"6767","24271","2016",9,9,0,71777.7777777778,840.888888888889,82.5555555555556
"6768","24272","2016",5,5,0,125810,1375.2,100.6
"6769","24273","2016",1,1,0,133500,1335,100
"6770","24274","2016",9,9,0,220683.666666667,1721.22222222222,118.444444444444
"6771","24277","2016",1,1,0,125850,839,150
"6772","24279","2016",1,1,0,134000,2062,65
"6773","24280","2016",7,7,0,148571.428571429,1519.71428571429,98.7142857142857
"6774","24281","2016",3,3,0,167266.666666667,1382,117
"6775","24282","2016",3,3,0,401666.666666667,2120.66666666667,196.666666666667
"6776","24284","2016",2,2,0,104000,1369.5,88.5
"6777","24286","2016",4,4,0,135705,1100.75,127
"6778","24287","2016",2,2,0,92000,1149.5,79.5
"6779","24288","2016",1,1,0,98000,891,110
"6780","24289","2016",8,8,0,113950,1070.125,106.875
"6781","24290","2016",1,1,0,142000,2328,61
"6782","24291","2016",33,33,0,143332.121212121,1754.36363636364,80.3939393939394
"6783","24292","2016",8,8,0,120856.25,1016.875,130.5
"6784","24293","2016",4,4,0,267000,1885.25,121
"6785","24294","2016",72,68,4,98966.6666666667,1109.90277777778,90.5277777777778
"6786","24295","2016",8,8,0,107875,1166,104.875
"6787","24296","2016",16,16,0,111076.25,1043.1875,101.75
"6788","24297","2016",12,12,0,125863.333333333,1192.08333333333,104.75
"6789","24299","2016",43,38,5,106747.651162791,1044.62790697674,101.604651162791
"6790","24300","2016",1,1,0,145000,1450,100
"6791","24301","2016",3,3,0,92833.3333333333,973,101
"6792","24302","2016",1,1,0,2e+05,2857,70
"6793","24303","2016",2,2,0,109330,1150,96.5
"6794","24304","2016",9,9,0,165500,1344.55555555556,123.222222222222
"6795","24305","2016",4,4,0,122250,1268.5,94.25
"6796","24306","2016",1,1,0,315810,1680,188
"6797","24308","2016",5,5,0,106700,904.6,104.4
"6798","24309","2016",26,25,1,124635.576923077,1293.15384615385,93.8461538461538
"6799","24311","2016",27,23,4,79129.6296296296,910.444444444444,87.1481481481482
"6800","24312","2016",34,29,5,146666.764705882,1502.41176470588,96.0882352941177
"6801","24313","2016",1,1,0,220000,2558,86
"6802","24316","2016",6,6,0,117166.666666667,1391.83333333333,88.3333333333333
"6803","24318","2016",8,8,0,214669.375,2047.125,106.125
"6804","24319","2016",8,8,0,139997.5,1400.625,99.5
"6805","24320","2016",13,12,1,79971.5384615385,854.307692307692,90.5384615384615
"6806","24322","2016",469,192,277,109527.144989339,1497.44349680171,77.3390191897655
"6807","24323","2016",1,1,0,248000,1192,208
"6808","24324","2016",4,4,0,162500,1564.75,97.25
"6809","24325","2016",17,17,0,156273.529411765,1359.94117647059,115.235294117647
"6810","24327","2016",4,4,0,208762.5,2095,129.5
"6811","24328","2016",19,18,1,104710.526315789,1113.52631578947,99.6842105263158
"6812","24329","2016",10,10,0,93271,1324.2,74.8
"6813","24330","2016",8,8,0,142765,1603.375,90.875
"6814","24335","2016",25,25,0,130645.6,1174.72,113.92
"6815","24336","2016",6,6,0,176510.833333333,1884.16666666667,99.5
"6816","24337","2016",2,2,0,171250,1696.5,117
"6817","24338","2016",3,3,0,86000,1330.66666666667,82.3333333333333
"6818","24339","2016",1,1,0,60000,857,70
"6819","24340","2016",47,47,0,149609.021276596,1400.57446808511,107.170212765957
"6820","24341","2016",6,6,0,146383.333333333,1223.5,127.333333333333
"6821","24345","2016",8,8,0,188556.25,1463.5,144.75
"6822","24346","2016",1,1,0,165000,1093,151
"6823","24348","2016",2,2,0,150000,1848.5,83
"6824","24350","2016",21,21,0,110156.428571429,1211.7619047619,92.7619047619048
"6825","24352","2016",34,33,1,95425.8823529412,1153.08823529412,91.2352941176471
"6826","24353","2016",6,5,1,101333.333333333,804.166666666667,132.333333333333
"6827","24354","2016",25,25,0,103514.8,1307.32,93.12
"6828","24355","2016",5,5,0,224670,1978,123.8
"6829","24356","2016",19,19,0,157756.842105263,1550.73684210526,104.789473684211
"6830","24359","2016",1,1,0,275000,1375,200
"6831","24360","2016",5,5,0,166200,1810.6,91.4
"6832","24361","2016",4,4,0,151400,1500,106.5
"6833","24362","2016",18,18,0,182538.888888889,1415.16666666667,121.611111111111
"6834","24364","2016",3,3,0,197437.333333333,1834,121
"6835","24365","2016",4,4,0,243750,3351.75,116.75
"6836","24366","2016",6,6,0,192903.333333333,1620.16666666667,123
"6837","24367","2016",3,3,0,126933.333333333,1549.66666666667,88
"6838","24370","2016",18,18,0,123688.888888889,1153.11111111111,107.055555555556
"6839","24371","2016",3,3,0,197110,1482.33333333333,153
"6840","24372","2016",72,71,1,124865.763888889,1280.01388888889,98.5833333333333
"6841","24373","2016",3,3,0,170333.333333333,1671.33333333333,111.666666666667
"6842","24374","2016",4,4,0,150375,1376.75,108.75
"6843","24375","2016",3,3,0,192666.666666667,2217.33333333333,81.6666666666667
"6844","24376","2016",22,22,0,121461.681818182,1155.77272727273,113.863636363636
"6845","24379","2016",2,2,0,267300,2118,118
"6846","24380","2016",1,1,0,84000,1120,75
"6847","24381","2016",3,3,0,87000,1624,57.6666666666667
"6848","24382","2016",9,9,0,95466.6666666667,1229.11111111111,84.6666666666667
"6849","24383","2016",2,2,0,180000,1721.5,116.5
"6850","24386","2016",4,4,0,91126,1278.75,75.75
"6851","24388","2016",3,3,0,2e+05,2933.66666666667,61
"6852","24390","2016",1,1,0,104000,2122,49
"6853","24392","2016",3,3,0,205866.666666667,1812.66666666667,144.666666666667
"6854","24393","2016",1,1,0,30000,789,38
"6855","24394","2016",1,1,0,243000,2406,101
"6856","24395","2016",4,4,0,147125,1289.5,110.5
"6857","24396","2016",17,16,1,127205.882352941,1284.58823529412,89.5882352941177
"6858","24397","2016",4,4,0,144500,1535,98
"6859","24398","2016",1,1,0,170000,1250,136
"6860","24399","2016",1,1,0,65000,903,72
"6861","24401","2016",4,4,0,112450,1094.5,101.75
"6862","24403","2016",2,2,0,113945,687.5,167.5
"6863","24405","2016",3,3,0,157363.333333333,1407.66666666667,117
"6864","24406","2016",1,1,0,160000,1569,102
"6865","24407","2016",2,2,0,229462.5,1818,127.5
"6866","24409","2016",14,14,0,116100,1245.42857142857,93.1428571428571
"6867","24410","2016",7,7,0,97857.1428571429,1150,82.4285714285714
"6868","24411","2016",2,2,0,241500,1975,123.5
"6869","24412","2016",2,2,0,132500,2915,53
"6870","24415","2016",1,1,0,173000,1236,140
"6871","24416","2016",4,4,0,165867.5,1224.75,158
"6872","24417","2016",3,3,0,150416.666666667,1672,92.3333333333333
"6873","24418","2016",9,9,0,110666.666666667,1243.77777777778,102.222222222222
"6874","24419","2016",8,8,0,194326.25,1928.625,112.25
"6875","24421","2016",1,1,0,252716,2553,99
"6876","24424","2016",1,1,0,190000,2021,94
"6877","24425","2016",3,3,0,140000,1331,103.666666666667
"6878","24429","2016",2,2,0,139500,1861.5,66
"6879","24432","2016",13,13,0,187296.538461538,1800.38461538462,103.846153846154
"6880","24434","2016",1,1,0,109500,1217,90
"6881","24436","2016",14,14,0,151829,1234.5,112.285714285714
"6882","24437","2016",9,9,0,205825.555555556,1738.44444444444,118.777777777778
"6883","24438","2016",4,4,0,121250,1430.75,89.75
"6884","24441","2016",2,2,0,307575,1559,186.5
"6885","24442","2016",18,18,0,99662.2222222222,1208.05555555556,84.5
"6886","24443","2016",7,6,1,203000,2488.85714285714,93
"6887","24444","2016",1,1,0,113000,1299,87
"6888","24445","2016",1,1,0,115400,796,145
"6889","24448","2016",7,7,0,112785.714285714,1135.85714285714,93.4285714285714
"6890","24449","2016",9,9,0,138111.111111111,1388.77777777778,99.5555555555556
"6891","24450","2016",13,13,0,137946.153846154,1428.84615384615,99.0769230769231
"6892","24451","2016",13,13,0,114023.076923077,1850.69230769231,84.7692307692308
"6893","24452","2016",4,4,0,201930,1023,196.5
"6894","24453","2016",4,4,0,94875,937.75,104.5
"6895","24454","2016",10,10,0,113250,1282,88.6
"6896","24455","2016",5,5,0,125900,1360.8,94
"6897","24458","2016",1,1,0,80000,611,131
"6898","24459","2016",6,6,0,160033.333333333,1254,125.833333333333
"6899","24460","2016",2,2,0,103000,1004,103.5
"6900","24461","2016",13,13,0,145880.769230769,1367.46153846154,104.923076923077
"6901","24462","2016",17,17,0,96223.5294117647,1065.76470588235,92.4705882352941
"6902","24463","2016",4,4,0,132000,1144.25,120
"6903","24465","2016",2,2,0,90500,692.5,117
"6904","24466","2016",3,3,0,129183.333333333,1432.33333333333,104.666666666667
"6905","24468","2016",1,1,0,438536,2249,195
"6906","24470","2016",5,5,0,147800,1330.6,110.4
"6907","24471","2016",4,4,0,192000,1426,127.25
"6908","24472","2016",4,4,0,144125,1390.75,100.75
"6909","24473","2016",9,9,0,121888.888888889,1437.66666666667,87.7777777777778
"6910","24474","2016",3,3,0,90583.3333333333,1133,91.3333333333333
"6911","24476","2016",2,2,0,110250,1050.5,107.5
"6912","24477","2016",2,2,0,113609,1422,79.5
"6913","24479","2016",11,11,0,109345.454545455,1101.63636363636,94.8181818181818
"6914","24480","2016",4,4,0,147475,1509.75,98.5
"6915","24482","2016",3,3,0,78333.3333333333,983,88.3333333333333
"6916","24484","2016",6,6,0,135583.333333333,1349.16666666667,105
"6917","24485","2016",4,4,0,122375,911.25,123.75
"6918","24487","2016",19,19,0,124286.842105263,1171.36842105263,113.684210526316
"6919","24488","2016",3,3,0,156333.333333333,1704.66666666667,97.6666666666667
"6920","24491","2016",3,3,0,80000,2021,46
"6921","24492","2016",1,1,0,105000,1019,103
"6922","24494","2016",3,3,0,271666.666666667,1223.66666666667,211
"6923","24496","2016",1,1,0,170000,723,235
"6924","24498","2016",10,10,0,105700,1157.8,101.3
"6925","24499","2016",9,9,0,152016.666666667,1355.66666666667,116.333333333333
"6926","24501","2016",10,10,0,144788,1385,112.4
"6927","24502","2016",2,2,0,89875,861.5,104
"6928","24504","2016",3,3,0,165966.666666667,1420,113
"6929","24505","2016",6,6,0,69666.6666666667,862.833333333333,90.6666666666667
"6930","24507","2016",1,1,0,82000,1051,78
"6931","24508","2016",4,4,0,96653.75,868.25,108.5
"6932","24509","2016",5,5,0,101000,1142.6,83.4
"6933","24510","2016",2,2,0,257250,2603.5,99
"6934","24513","2016",2,2,0,192724,1525,124
"6935","24514","2016",1,1,0,55000,965,57
"6936","24515","2016",2,2,0,96000,1194,80.5
"6937","24516","2016",8,8,0,172362.5,1613,115.875
"6938","24517","2016",2,2,0,90000,1348,63.5
"6939","24518","2016",2,2,0,122500,963.5,134.5
"6940","24519","2016",4,4,0,261500,2622.5,111.25
"6941","24520","2016",113,73,40,155882.371681416,1774.05309734513,89.4955752212389
"6942","24521","2016",12,12,0,146400,1354.75,112.666666666667
"6943","24522","2016",9,9,0,150225.555555556,1423,116.555555555556
"6944","24524","2016",3,3,0,182280,1598,112
"6945","24525","2016",2,2,0,182500,1585.5,132
"6946","24526","2016",8,8,0,77312.5,861.125,97.875
"6947","24527","2016",13,13,0,126097.769230769,1252.92307692308,107.538461538462
"6948","24529","2016",2,2,0,86500,921,97.5
"6949","24531","2016",1,1,0,85000,1133,75
"6950","24532","2016",6,6,0,119429.166666667,979.833333333333,133
"6951","24534","2016",1,1,0,196486,1637,120
"6952","24535","2016",4,4,0,339250,2061.5,177.5
"6953","24536","2016",6,6,0,152564.166666667,1317.16666666667,111.333333333333
"6954","24538","2016",9,9,0,157111.111111111,1498.77777777778,92.4444444444444
"6955","24540","2016",10,10,0,151003.5,1493.7,102.5
"6956","24541","2016",1,1,0,50000,1923,26
"6957","24542","2016",1,1,0,120000,1348,89
"6958","24543","2016",10,10,0,114826,1418,89.6
"6959","24544","2016",3,3,0,161456.666666667,1883,87.6666666666667
"6960","24545","2016",1,1,0,30000,1000,30
"6961","24547","2016",72,60,12,99934.6666666667,1314.30555555556,79.5138888888889
"6962","24548","2016",4,4,0,86250,1123.25,74
"6963","24550","2016",13,13,0,129318.615384615,1448.07692307692,101.846153846154
"6964","24551","2016",42,36,6,97056.1904761905,1130.85714285714,96.4761904761905
"6965","24552","2016",4,4,0,215875,1901,119.25
"6966","24553","2016",16,16,0,132281.25,1316.5625,110.8125
"6967","24554","2016",4,4,0,169431.25,1584.75,102.5
"6968","24555","2016",7,7,0,247357.142857143,1466.85714285714,177.714285714286
"6969","24557","2016",75,57,18,137221.346666667,1542.49333333333,90.5866666666667
"6970","24558","2016",10,10,0,137058,1587.5,92.3
"6971","24559","2016",4,4,0,151000,1715,135
"6972","24560","2016",1,1,0,160000,1649,97
"6973","24562","2016",2,2,0,96335,972.5,89
"6974","24563","2016",5,5,0,216070,1932.8,106.8
"6975","24564","2016",6,6,0,122794.333333333,920.833333333333,136.333333333333
"6976","24565","2016",4,4,0,102250,934.25,112
"6977","24566","2016",3,3,0,131183.333333333,1317.33333333333,98.3333333333333
"6978","24567","2016",3,3,0,151566.666666667,1424.66666666667,105.333333333333
"6979","24568","2016",8,8,0,86500,941,89
"6980","24569","2016",2,2,0,70000,946.5,75
"6981","24571","2016",18,15,3,118488.888888889,1496.44444444444,92.1111111111111
"6982","24572","2016",1,1,0,110000,1774,62
"6983","24573","2016",7,7,0,136071.428571429,1342.14285714286,115.428571428571
"6984","24574","2016",2,2,0,220500,1860,123.5
"6985","24575","2016",3,3,0,124833.333333333,1603.66666666667,86.3333333333333
"6986","24576","2016",2,2,0,129725,1622,80
"6987","24577","2016",8,8,0,160703.75,1533.375,102.25
"6988","24580","2016",4,4,0,70000,783,86.5
"6989","24582","2016",2,2,0,60000,605,96
"6990","24584","2016",14,14,0,136250,1474.28571428571,105.071428571429
"6991","24585","2016",8,8,0,106325,925.125,104.25
"6992","24586","2016",10,10,0,153806.5,1159.6,135.1
"6993","24587","2016",7,7,0,192519.714285714,1688.57142857143,115
"6994","25001","2016",3,3,0,99246.6666666667,1100.66666666667,92
"6995","25002","2016",2,2,0,98000,874,121.5
"6996","25003","2016",5,5,0,118000,1081.2,112.6
"6997","25004","2016",8,7,1,173250,1712.375,100.625
"6998","25005","2016",1,1,0,73000,912,80
"6999","25007","2016",3,3,0,219666.666666667,1769,128.666666666667
"7000","25008","2016",4,4,0,84067.5,973.5,86.75
"7001","25009","2016",2,2,0,167750,1502,115.5
"7002","25011","2016",3,3,0,103333.333333333,1285,90.6666666666667
"7003","25014","2016",4,4,0,125875,1595.75,80.25
"7004","25015","2016",7,4,3,119881.428571429,956.285714285714,128.857142857143
"7005","25016","2016",2,2,0,161620,1491,109
"7006","25018","2016",7,6,1,94928.5714285714,947.142857142857,110.285714285714
"7007","25019","2016",3,3,0,95733.3333333333,1588,70.3333333333333
"7008","25020","2016",9,6,3,129288.888888889,1457.33333333333,90.6666666666667
"7009","25021","2016",15,15,0,129182,1398.53333333333,95.2
"7010","25022","2016",16,15,1,137590.75,1395.6875,103.875
"7011","25024","2016",3,2,1,266300,2276,115
"7012","25025","2016",7,7,0,189038.571428571,1604.42857142857,122.857142857143
"7013","25026","2016",8,8,0,135262.5,1303.375,111.625
"7014","25029","2016",1,1,0,218500,2511,87
"7015","25030","2016",2,2,0,237600,1998.5,123
"7016","25031","2016",113,71,42,110479.07079646,1265.46017699115,88.5221238938053
"7017","25033","2016",1,1,0,144000,1516,95
"7018","25035","2016",18,17,1,220800,1941.22222222222,118.722222222222
"7019","25036","2016",19,14,5,172623.210526316,1587.31578947368,108
"7020","25038","2016",1,1,0,50000,794,63
"7021","25039","2016",8,8,0,202368.75,1982.375,109.375
"7022","25040","2016",7,4,3,91187.1428571429,1017.42857142857,91.1428571428571
"7023","25041","2016",2,1,1,90000,1302,83
"7024","25042","2016",1,1,0,180000,1915,94
"7025","25043","2016",14,10,4,137120.714285714,1363.21428571429,99.2857142857143
"7026","25044","2016",1,1,0,15000,1000,15
"7027","25046","2016",2,2,0,184500,2024.5,103
"7028","25047","2016",56,32,24,115383.214285714,1355.64285714286,89.5892857142857
"7029","25048","2016",27,22,5,126561.555555556,1373.77777777778,91.037037037037
"7030","25049","2016",2,2,0,357660,2475,143.5
"7031","25051","2016",4,4,0,103000,1125.5,97.25
"7032","25052","2016",1,1,0,47900,798,60
"7033","25053","2016",2,2,0,97050,692,138.5
"7034","25054","2016",2,2,0,127250,1179.5,108
"7035","25055","2016",9,9,0,174357.777777778,1706.55555555556,105.888888888889
"7036","25056","2016",1626,206,1420,120432.352398524,1767.89790897909,69.0984009840098
"7037","25057","2016",30,26,4,106977.5,1218.8,89.1333333333333
"7038","25058","2016",12,9,3,179620.833333333,1757.91666666667,114
"7039","25060","2016",5,4,1,202720,1834,109.2
"7040","25061","2016",2,2,0,124000,1207.5,113.5
"7041","25062","2016",2,2,0,310290,2187,146
"7042","25063","2016",13,10,3,157338.461538462,1569.38461538462,101.615384615385
"7043","25065","2016",1,1,0,111650,1139,98
"7044","25067","2016",4,4,0,78750,790.25,101
"7045","25070","2016",2,2,0,143343,1802.5,82
"7046","25071","2016",4,3,1,139000,1459,96.25
"7047","25073","2016",6,4,2,183598.333333333,1701,103
"7048","25074","2016",3,3,0,252733.333333333,1830.33333333333,149.333333333333
"7049","25075","2016",2,2,0,264500,2178,129
"7050","25078","2016",5,5,0,188140,1608.2,120.8
"7051","25079","2016",1,1,0,275000,1627,169
"7052","25082","2016",7,7,0,151714.285714286,1327.57142857143,119.142857142857
"7053","25083","2016",2,2,0,149500,1319,114.5
"7054","25084","2016",12,5,7,146474.916666667,1631.33333333333,88.8333333333333
"7055","25085","2016",2,1,1,223750,1677,118
"7056","25086","2016",2,2,0,178175,1746,108
"7057","25087","2016",3,3,0,67000,1502.33333333333,47.6666666666667
"7058","25089","2016",1,1,0,214200,1635,131
"7059","25090","2016",2,2,0,298150,1411.5,209
"7060","25092","2016",1,1,0,162600,1626,100
"7061","25094","2016",1,1,0,70000,700,100
"7062","25095","2016",1,1,0,170000,1062,160
"7063","25100","2016",1,1,0,165000,1269,130
"7064","25101","2016",3,3,0,208390.333333333,1635.66666666667,128.666666666667
"7065","25103","2016",6,6,0,192608.333333333,1367.16666666667,148.833333333333
"7066","25104","2016",2,2,0,135000,1024,131.5
"7067","25105","2016",4,4,0,134925,1464.5,104
"7068","25106","2016",1,1,0,60000,1277,47
"7069","25107","2016",3,3,0,115046.666666667,1224,103.333333333333
"7070","25108","2016",5,2,3,168400,1930,84
"7071","25109","2016",1,1,0,170000,1619,105
"7072","25110","2016",8,6,2,267862.5,2439.875,114.25
"7073","25111","2016",4,4,0,187775,1439.25,131.5
"7074","25112","2016",12,7,5,151874.5,1991,75.75
"7075","25113","2016",2,2,0,85000,629.5,137
"7076","25114","2016",4,4,0,144775,1607,90.25
"7077","25115","2016",2,1,1,152000,1992.5,73.5
"7078","25116","2016",3,3,0,128116.666666667,1000.66666666667,127.333333333333
"7079","25119","2016",1,1,0,269000,2402,112
"7080","25120","2016",2,2,0,182000,1509,127
"7081","25121","2016",2,1,1,67952.5,1036,70.5
"7082","25122","2016",6,4,2,139475,1465.16666666667,104
"7083","25124","2016",4,4,0,229050,1860.75,162
"7084","25125","2016",3,3,0,110000,1407.66666666667,70.6666666666667
"7085","25126","2016",2,2,0,162500,1646,99
"7086","25127","2016",21,9,12,148496.666666667,1524.52380952381,95.1428571428571
"7087","25129","2016",1,1,0,213760,1961,109
"7088","25131","2016",1,1,0,50000,588,85
"7089","25133","2016",21,20,1,262150,2205.33333333333,120.238095238095
"7090","25136","2016",7,7,0,198668.571428571,1843.28571428571,110.714285714286
"7091","25139","2016",7,7,0,148657.142857143,1567.28571428571,91.5714285714286
"7092","25142","2016",8,6,2,155727.5,1778,90.25
"7093","25143","2016",2,2,0,107035,998.5,107
"7094","25147","2016",8,8,0,245831.25,2001.625,121.875
"7095","25148","2016",4,4,0,235858.5,2332,101.75
"7096","25149","2016",8,7,1,149107.5,1726.625,92.625
"7097","25150","2016",1,1,0,238000,1497,159
"7098","25151","2016",1,1,0,250000,2083,120
"7099","25152","2016",3,3,0,198666.666666667,2205.33333333333,90
"7100","25153","2016",3,3,0,207666.666666667,2135,97.3333333333333
"7101","25154","2016",3,3,0,107783.333333333,919.666666666667,115
"7102","25155","2016",1,1,0,165900,1864,89
"7103","25156","2016",11,11,0,92272.7272727273,996.909090909091,92.8181818181818
"7104","25157","2016",15,7,8,190548,2461.73333333333,80.6666666666667
"7105","25159","2016",9,7,2,148088.888888889,1324.44444444444,111.555555555556
"7106","25160","2016",5,5,0,222460,2021.6,107.8
"7107","25164","2016",1,1,0,1e+05,769,130
"7108","25170","2016",15,7,8,130034,1496.26666666667,87.2
"7109","25172","2016",5,4,1,130780,1541,87.8
"7110","25173","2016",1,1,0,219130,1611,136
"7111","25174","2016",2,2,0,123865.5,1139,112.5
"7112","25175","2016",1,1,0,140000,1400,100
"7113","25176","2016",1,0,1,1e+05,725,138
"7114","25177","2016",2,2,0,155925,1225.5,118.5
"7115","25178","2016",2,2,0,88500,1412.5,63.5
"7116","25180","2016",4,4,0,104637.5,1381,82.5
"7117","25181","2016",3,3,0,141033.333333333,1492.66666666667,95
"7118","25182","2016",2,2,0,82500,1249,67
"7119","25184","2016",2,2,0,178610,1502,118.5
"7120","25185","2016",1,1,0,89000,500,178
"7121","25186","2016",10,9,1,220033,1764.8,125.4
"7122","25187","2016",4,4,0,145375,1239,123.25
"7123","25188","2016",5,4,1,170210,1656.6,104.8
"7124","25189","2016",1,1,0,80000,1333,60
"7125","25190","2016",14,10,4,129187.428571429,1232.07142857143,97.0714285714286
"7126","25191","2016",7,6,1,135542.857142857,1308.71428571429,106.285714285714
"7127","25192","2016",1,1,0,98000,1089,90
"7128","25193","2016",19,12,7,172104.210526316,1808,101.157894736842
"7129","25195","2016",10,9,1,188540,1818.4,108.8
"7130","25196","2016",14,12,2,156352.142857143,1630.57142857143,94.1428571428571
"7131","25197","2016",12,4,8,81208.3333333333,1095.16666666667,72.1666666666667
"7132","25198","2016",4,2,2,75887.5,1002.75,75.25
"7133","25199","2016",5,5,0,141770,1706.8,96.2
"7134","25200","2016",14,9,5,157939.857142857,1715.14285714286,87.4285714285714
"7135","25201","2016",4,3,1,324000,2268,145.75
"7136","25204","2016",31,16,15,237202.580645161,2527.93548387097,94.4193548387097
"7137","25207","2016",2,2,0,87500,937.5,90
"7138","25208","2016",1,0,1,42000,689,61
"7139","25209","2016",1,1,0,85500,1425,60
"7140","25210","2016",2,2,0,226500,1642.5,137
"7141","25211","2016",1,1,0,73750,1603,46
"7142","25212","2016",21,13,8,194152.714285714,2016.09523809524,95.4285714285714
"7143","25213","2016",5,5,0,200747,1788.6,106.4
"7144","25214","2016",2,2,0,135270,1479,89
"7145","25215","2016",1,1,0,131500,1096,120
"7146","25216","2016",4,4,0,124750,962.75,125.5
"7147","25217","2016",7,6,1,152992.857142857,1616.71428571429,102.571428571429
"7148","25218","2016",1,1,0,98000,1633,60
"7149","25219","2016",4,4,0,222187.5,1625,148
"7150","25220","2016",1,1,0,148000,1495,99
"7151","25222","2016",8,6,2,172105,1677.25,109.125
"7152","25223","2016",5,4,1,90000,866.8,104
"7153","25224","2016",8,8,0,126537.5,1377,92.125
"7154","25226","2016",2,2,0,165000,1179,134
"7155","25228","2016",34,26,8,123877.941176471,1374.94117647059,90.3823529411765
"7156","25229","2016",1,0,1,50000,714,70
"7157","25230","2016",34,31,3,130676.470588235,1462.35294117647,89
"7158","25231","2016",1,1,0,234100,2188,107
"7159","25233","2016",1,1,0,140000,1414,99
"7160","25234","2016",5,4,1,199940,1767.6,112.2
"7161","25235","2016",4,2,2,138810,1378.75,121.75
"7162","25236","2016",1,1,0,41400,518,80
"7163","25237","2016",25,21,4,104486.8,1247.28,83.08
"7164","25238","2016",4,4,0,176027.5,1606,111.5
"7165","25239","2016",1,1,0,65000,812,80
"7166","25240","2016",21,16,5,225578.80952381,2475.33333333333,97.6190476190476
"7167","25241","2016",1,1,0,158500,1601,99
"7168","25243","2016",5,4,1,199900,2161.6,102
"7169","25244","2016",3,3,0,169000,1433.33333333333,118
"7170","25245","2016",7,4,3,192314.285714286,1890.28571428571,108.142857142857
"7171","25246","2016",2,2,0,102500,825.5,120.5
"7172","25247","2016",1,1,0,150000,909,165
"7173","25248","2016",6,6,0,179245,1656,113
"7174","25252","2016",2,2,0,182500,1722,114.5
"7175","25253","2016",4,4,0,120700,1133.75,110.5
"7176","25254","2016",20,9,11,170464.5,2016.8,81.75
"7177","25255","2016",2,2,0,228000,3353.5,63.5
"7178","25256","2016",9,8,1,167625.555555556,2021.88888888889,88.7777777777778
"7179","25257","2016",2,2,0,211500,1900.5,110
"7180","25258","2016",10,7,3,202675,1625.6,123.9
"7181","25259","2016",23,13,10,170782.608695652,1643.5652173913,104.130434782609
"7182","25264","2016",1,1,0,30000,375,80
"7183","25265","2016",8,8,0,304925,2287.75,136.625
"7184","25266","2016",1,1,0,119000,633,188
"7185","25267","2016",3,3,0,158870,1485.66666666667,101.666666666667
"7186","25268","2016",1,1,0,209967,2210,95
"7187","25269","2016",2,2,0,50500,448.5,105.5
"7188","25270","2016",1,1,0,116265,1163,100
"7189","25271","2016",15,10,5,197018.133333333,1826.26666666667,111.933333333333
"7190","25273","2016",2,2,0,59500,716,87.5
"7191","25274","2016",6,3,3,70541.6666666667,889.833333333333,76.6666666666667
"7192","25275","2016",3,2,1,115000,1754.66666666667,66.6666666666667
"7193","25276","2016",3,3,0,133333.333333333,1301.66666666667,107.333333333333
"7194","25277","2016",1,1,0,140000,757,185
"7195","25278","2016",2,2,0,109225,1039.5,107.5
"7196","25279","2016",1,1,0,169500,1185,143
"7197","25280","2016",5,5,0,154040,1876.6,81.8
"7198","25281","2016",1,1,0,169000,1943,87
"7199","25282","2016",5,4,1,145620,1152.4,121.6
"7200","25284","2016",45,31,14,122332.733333333,1400.4,88.2
"7201","25285","2016",8,6,2,227550,2013.125,118
"7202","25286","2016",2,2,0,129000,1955.5,104.5
"7203","25287","2016",10,8,2,193495,1828.1,106.4
"7204","25288","2016",9,7,2,198460.444444444,1650.55555555556,119.333333333333
"7205","25289","2016",1,1,0,135000,1274,106
"7206","25290","2016",1,1,0,60000,619,97
"7207","25293","2016",15,10,5,271450.933333333,2445.53333333333,110.8
"7208","25295","2016",2,1,1,255210,2245,117.5
"7209","25296","2016",6,4,2,197450,1849.33333333333,105.166666666667
"7210","25298","2016",2,2,0,93690.5,997,94
"7211","25299","2016",3,2,1,202666.666666667,2140,95.3333333333333
"7212","25300","2016",3,3,0,160260,1290.66666666667,128
"7213","25301","2016",3,3,0,223556.666666667,2104.33333333333,109
"7214","25303","2016",1,1,0,105000,2059,51
"7215","25304","2016",31,22,9,98885.1612903226,1208.58064516129,80.0967741935484
"7216","25305","2016",4,3,1,155155,1486.75,109.75
"7217","25307","2016",20,8,12,204032.5,2646.4,75.35
"7218","25308","2016",4,3,1,279243.25,2705.5,105
"7219","25309","2016",10,6,4,206622,2476,86.4
"7220","25310","2016",3,3,0,89666.6666666667,822.333333333333,101.666666666667
"7221","25311","2016",5,5,0,87020,747.8,117.6
"7222","25312","2016",4,4,0,25375,771.25,37.25
"7223","25313","2016",1,1,0,177000,1967,90
"7224","25314","2016",2,2,0,102775,973,110
"7225","25315","2016",30,27,3,104087.5,1098.63333333333,94.7
"7226","25316","2016",1,1,0,320000,1280,250
"7227","25317","2016",2,2,0,101000,927,108
"7228","25318","2016",29,13,16,189940.344827586,2545,74.1379310344828
"7229","25320","2016",22,5,17,161532.863636364,1973.68181818182,79.5
"7230","25321","2016",56,30,26,212236.428571429,2418.21428571429,86.0892857142857
"7231","25322","2016",3,3,0,192733.333333333,1678.33333333333,113.333333333333
"7232","25323","2016",6,6,0,135025,1469.5,92.3333333333333
"7233","25324","2016",2,2,0,76500,818,99.5
"7234","25325","2016",1,1,0,250000,1295,193
"7235","25326","2016",4,4,0,164725,1373.25,126
"7236","25328","2016",9,5,4,199166.666666667,1639.88888888889,115.444444444444
"7237","25329","2016",1,1,0,86000,1365,63
"7238","25330","2016",2,2,0,154835,776.5,262.5
"7239","25331","2016",4,4,0,112974.5,1302,93.5
"7240","25332","2016",3,3,0,140233.333333333,1570,92.6666666666667
"7241","25333","2016",5,3,2,99954.6,761.8,136
"7242","25334","2016",19,12,7,152417.631578947,1478.10526315789,104.736842105263
"7243","25335","2016",4,4,0,162775,1952.75,78
"7244","25336","2016",7,6,1,117507.857142857,1161.28571428571,112.571428571429
"7245","25338","2016",1,1,0,120040,1000,120
"7246","25339","2016",5,3,2,143200,2408,86.2
"7247","25340","2016",3,3,0,113333.333333333,889.666666666667,138
"7248","25342","2016",1,1,0,50000,556,90
"7249","25345","2016",11,11,0,128049.090909091,1358.45454545455,93.2727272727273
"7250","25347","2016",4,3,1,212625,1392,158
"7251","25348","2016",6,4,2,416066.666666667,2345.33333333333,163.166666666667
"7252","25350","2016",7,7,0,122887.571428571,1390.71428571429,88.2857142857143
"7253","25351","2016",3,1,2,172666.666666667,1369.66666666667,126.333333333333
"7254","25356","2016",38,22,16,152490.526315789,1895.94736842105,83.6578947368421
"7255","25357","2016",2,2,0,279986,2261,127
"7256","25359","2016",3,3,0,100833.333333333,901.666666666667,118.666666666667
"7257","25360","2016",2,2,0,197250,1757.5,102
"7258","25361","2016",23,6,17,187002.260869565,3079.60869565217,64.8695652173913
"7259","25362","2016",4,2,2,214487.5,1890.75,113.75
"7260","25364","2016",7,7,0,203035.714285714,2266.85714285714,120.857142857143
"7261","25365","2016",3,3,0,90500,1473.33333333333,61.6666666666667
"7262","25366","2016",1,1,0,263400,2832,93
"7263","25367","2016",39,31,8,109915.051282051,1253.79487179487,88.8205128205128
"7264","25368","2016",12,10,2,179562.5,1514.08333333333,122.75
"7265","25370","2016",9,9,0,143596.666666667,1384.88888888889,106
"7266","25371","2016",2,2,0,172350,1403,115.5
"7267","25372","2016",3,2,1,122666.666666667,1356.33333333333,87.6666666666667
"7268","25374","2016",5,5,0,190228.2,1555,123.4
"7269","25375","2016",2,2,0,240250,1817.5,131.5
"7270","25376","2016",1,1,0,203900,2581,79
"7271","25377","2016",3,3,0,182450,1727.66666666667,112.333333333333
"7272","25378","2016",6,6,0,133500,1316.66666666667,99.5
"7273","25379","2016",1,1,0,1e+05,1136,88
"7274","25380","2016",79,29,50,122663.46835443,2887.62025316456,43.253164556962
"7275","25381","2016",12,9,3,276807.5,2031.08333333333,128.083333333333
"7276","25382","2016",6,6,0,159683.333333333,1587.5,106
"7277","25383","2016",1,1,0,108950,3405,32
"7278","25384","2016",1,1,0,132440,1104,120
"7279","25385","2016",1,1,0,169900,944,180
"7280","25386","2016",1,1,0,130000,1529,85
"7281","25387","2016",3,3,0,155531.666666667,1845,88.6666666666667
"7282","25388","2016",214,55,159,89801.4018691589,1101.97196261682,80.088785046729
"7283","25389","2016",1,1,0,250000,2193,114
"7284","25390","2016",5,4,1,180100,2114,87.2
"7285","25392","2016",1,1,0,217000,2438,89
"7286","25393","2016",5,4,1,108700,1135,92.4
"7287","25394","2016",12,11,1,153918.333333333,1484.58333333333,107.083333333333
"7288","25395","2016",18,15,3,251241.111111111,2133.11111111111,119.222222222222
"7289","25397","2016",22,17,5,173185.363636364,1811.36363636364,91.8181818181818
"7290","25400","2016",8,7,1,132475,1238.25,111.375
"7291","25402","2016",1,1,0,121200,932,130
"7292","25403","2016",15,7,8,225941.666666667,2262.66666666667,100.533333333333
"7293","25405","2016",8,7,1,305756.25,2616,117.75
"7294","25406","2016",4,4,0,104100,1190,104.75
"7295","25408","2016",2,2,0,131250,928,136.5
"7296","25410","2016",10,10,0,215469.3,1926.2,110.8
"7297","25411","2016",83,20,63,180616.518072289,2155.6265060241,85.1927710843374
"7298","25413","2016",13,4,9,167561.538461538,2319.15384615385,79
"7299","25415","2016",5,5,0,101109.2,978,111.8
"7300","25416","2016",1,1,0,133000,1220,109
"7301","25417","2016",6,6,0,144516.666666667,944.333333333333,151.333333333333
"7302","25418","2016",13,11,2,200282.846153846,1535.46153846154,135.307692307692
"7303","25419","2016",2,2,0,105525,874,128.5
"7304","25420","2016",3,2,1,75333.3333333333,661.333333333333,118.333333333333
"7305","25424","2016",5,5,0,170076,1699.2,101.2
"7306","25425","2016",2,2,0,286000,3330,86
"7307","25427","2016",1,1,0,213000,1821,117
"7308","25428","2016",12,10,2,143741.666666667,1638.83333333333,89.8333333333333
"7309","25429","2016",11,10,1,130188.181818182,1415.54545454545,95.6363636363636
"7310","25432","2016",16,13,3,197238.375,2049.125,99.6875
"7311","25433","2016",1,1,0,354000,2329,152
"7312","25434","2016",46,33,13,128068.891304348,1464.86956521739,86.0217391304348
"7313","25435","2016",3,3,0,145333.333333333,962.666666666667,147.333333333333
"7314","25436","2016",2,2,0,152500,1872.5,81
"7315","25437","2016",2,2,0,79000,1224,59.5
"7316","25438","2016",8,7,1,160702.5,1728,93.5
"7317","25439","2016",1,0,1,58000,1115,52
"7318","25440","2016",2,2,0,153600,2062.5,80
"7319","25442","2016",4,1,3,236162.5,2793.75,87.75
"7320","25443","2016",1,1,0,75000,625,120
"7321","25447","2016",1,1,0,115000,1150,100
"7322","25448","2016",13,12,1,182405.384615385,1584.69230769231,119.307692307692
"7323","25451","2016",3,3,0,192666.666666667,2534.33333333333,87.6666666666667
"7324","25452","2016",1,1,0,176500,1261,140
"7325","25453","2016",14,13,1,158635.714285714,1528.07142857143,121.857142857143
"7326","25454","2016",20,15,5,186396,1993.95,97.55
"7327","25455","2016",1,1,0,166200,1847,90
"7328","25456","2016",1,1,0,194673,1533,127
"7329","25458","2016",3,3,0,152493.333333333,1559,111.666666666667
"7330","25460","2016",1,1,0,55000,534,103
"7331","25462","2016",267,51,216,160997.483146067,2272.07490636704,72.1610486891386
"7332","25463","2016",28,12,16,112796.428571429,1394.39285714286,86.6428571428571
"7333","25464","2016",1,1,0,160000,1455,110
"7334","25465","2016",3,3,0,105216.666666667,1110,100.666666666667
"7335","25466","2016",6,5,1,200371.666666667,1961,102.833333333333
"7336","25467","2016",16,14,2,221365.625,2174.5,99.625
"7337","25469","2016",6,6,0,123833.333333333,1252.83333333333,98.3333333333333
"7338","25470","2016",1,1,0,82000,1367,60
"7339","25471","2016",4,4,0,195350,1460.25,137
"7340","25473","2016",2,2,0,188265,2134.5,89
"7341","25475","2016",7,7,0,132229.571428571,1273,113.428571428571
"7342","25477","2016",6,6,0,155333.333333333,1403.83333333333,112.333333333333
"7343","25479","2016",4,3,1,53500,557,106.25
"7344","25481","2016",2,2,0,70000,763,90
"7345","25482","2016",5,5,0,165660,1711.6,98
"7346","25483","2016",1,1,0,99960,1369,73
"7347","25485","2016",4,4,0,141812.5,1220,126.5
"7348","25486","2016",4,3,1,167250,2191.75,85
"7349","25488","2016",1,1,0,175000,1167,150
"7350","25489","2016",2,2,0,153750,900.5,173
"7351","25492","2016",1,1,0,170000,1241,137
"7352","25493","2016",8,7,1,239750.125,2191.5,114
"7353","25494","2016",7,5,2,189402.714285714,2436.57142857143,79.1428571428571
"7354","25495","2016",17,8,9,118047.058823529,1539.47058823529,80.3529411764706
"7355","25497","2016",1,1,0,300300,2705,111
"7356","25499","2016",3,3,0,138333.333333333,1149.66666666667,119.666666666667
"7357","25500","2016",1,1,0,70000,1094,64
"7358","25502","2016",2,2,0,196215,1600,122.5
"7359","25504","2016",1,1,0,75000,1667,45
"7360","25505","2016",13,11,2,100500,1116.38461538462,91
"7361","25508","2016",7,6,1,133428.571428571,1363.85714285714,101.428571428571
"7362","25510","2016",1,1,0,68000,1046,65
"7363","25511","2016",1,1,0,26600,375,71
"7364","25512","2016",17,6,11,134063.529411765,1722.23529411765,82.7647058823529
"7365","25514","2016",2,2,0,334000,2496.5,146
"7366","25515","2016",10,5,5,207110,1862.9,121.9
"7367","25516","2016",1,1,0,93000,930,100
"7368","25517","2016",3,2,1,147333.333333333,1770.66666666667,84.3333333333333
"7369","25519","2016",7,4,3,132890,1257.85714285714,104.428571428571
"7370","25520","2016",2,2,0,153650,1751.5,88
"7371","25522","2016",2,2,0,188500,2320,97.5
"7372","25523","2016",6,6,0,195450,1443.83333333333,140
"7373","25524","2016",5,5,0,74200,1028.4,77
"7374","25525","2016",2,1,1,285000,2677.5,97
"7375","25526","2016",8,3,5,121825,1374.5,89.5
"7376","25527","2016",46,30,16,152475.847826087,1646.5652173913,98.2173913043478
"7377","25529","2016",18,15,3,116366.666666667,1085.66666666667,107.611111111111
"7378","25532","2016",36,24,12,167823.333333333,1756.19444444444,97.1666666666667
"7379","25534","2016",2,2,0,290005,2572.5,114.5
"7380","25535","2016",1,1,0,283950,1786,159
"7381","25536","2016",2,2,0,118250,1844,70.5
"7382","25539","2016",53,37,16,123561.981132075,1379.16981132075,90.4528301886792
"7383","25540","2016",2,2,0,98100,991,100.5
"7384","25541","2016",2,2,0,133500,1125,130
"7385","25542","2016",14,10,4,166028.785714286,1861.21428571429,92.4285714285714
"7386","25544","2016",2,2,0,93000,592.5,147.5
"7387","25547","2016",20,3,17,75644,971.3,79.1
"7388","25548","2016",3,3,0,110166.666666667,1104,107.333333333333
"7389","25549","2016",1,1,0,163550,794,206
"7390","25550","2016",2,2,0,169000,1892,89.5
"7391","25552","2016",1,1,0,67000,644,104
"7392","25553","2016",3,3,0,128333.333333333,1545,84
"7393","25555","2016",15,7,8,166806.666666667,1561.73333333333,107.466666666667
"7394","25557","2016",3,3,0,205866.666666667,1767.33333333333,112.666666666667
"7395","25558","2016",5,4,1,203200,1632.2,129.8
"7396","25560","2016",37,31,6,196611.027027027,1947.10810810811,102.540540540541
"7397","25561","2016",2,1,1,88500,1267,70
"7398","25562","2016",1,1,0,173000,1545,112
"7399","25563","2016",2,2,0,111648,675,187.5
"7400","25564","2016",6,5,1,189950,1658.83333333333,114.833333333333
"7401","25565","2016",2,1,1,231235,2489,89.5
"7402","25566","2016",4,4,0,163350,1548.75,105.75
"7403","25569","2016",2,2,0,197900,1502,132
"7404","25571","2016",3,2,1,164216.666666667,1788,88.3333333333333
"7405","25574","2016",1,1,0,70000,700,100
"7406","25575","2016",5,5,0,107220,1345.4,71.2
"7407","25578","2016",58,35,23,169851.344827586,1859.06896551724,95.7068965517241
"7408","25579","2016",1,1,0,165000,1571,105
"7409","25580","2016",80,46,34,103007.45,1189.7875,86.9875
"7410","25582","2016",2,2,0,113000,1327,95.5
"7411","25583","2016",1,1,0,199000,1453,137
"7412","25586","2016",4,4,0,159250,1253.75,142.5
"7413","25591","2016",2,2,0,133000,1162,113.5
"7414","25592","2016",6,4,2,232650,2172.33333333333,97
"7415","25594","2016",1,1,0,169000,1470,115
"7416","25595","2016",2,2,0,67500,490,140
"7417","25597","2016",2,2,0,72500,824.5,92.5
"7418","25598","2016",5,5,0,199208,1646.8,131
"7419","25599","2016",2,2,0,204850,1861.5,110.5
"7420","25601","2016",14,11,3,166907.142857143,1472.35714285714,116.642857142857
"7421","25602","2016",2,2,0,107500,1046,100
"7422","25604","2016",1,1,0,88500,2058,43
"7423","25605","2016",1,0,1,113500,873,130
"7424","25608","2016",3,3,0,137283.333333333,1514,98.6666666666667
"7425","25609","2016",3,2,1,174333.333333333,1764,99.3333333333333
"7426","25611","2016",2,2,0,166400,1814,84
"7427","25612","2016",4,3,1,159250,3058.75,86.75
"7428","25613","2016",2,2,0,67000,978.5,68.5
"7429","25614","2016",27,23,4,132449.259259259,1440.03703703704,92.7407407407407
"7430","25615","2016",6,6,0,114970,1277.33333333333,86.3333333333333
"7431","25616","2016",4,4,0,136137.5,1294.5,107.75
"7432","25617","2016",4,3,1,165125,1693.25,109.5
"7433","25618","2016",3,3,0,131000,1223,104.333333333333
"7434","25619","2016",1,1,0,367251,2199,167
"7435","25620","2016",1,1,0,250000,4167,60
"7436","25622","2016",2,2,0,118500,1389,85
"7437","25623","2016",1,1,0,64400,638,101
"7438","25624","2016",2,2,0,131320,1081,106
"7439","25626","2016",2,2,0,89000,1175.5,75.5
"7440","25627","2016",2,2,0,124128,1009.5,124
"7441","25629","2016",1,0,1,135000,1406,96
"7442","25631","2016",2,2,0,217400,2125.5,101.5
"7443","25632","2016",30,20,10,138016.333333333,1561.5,88.5333333333333
"7444","25633","2016",5,5,0,141768,1445.6,99.8
"7445","25634","2016",5,1,4,182648,2403.2,82.8
"7446","25635","2016",2,2,0,92150,1385.5,64
"7447","26001","2016",4,4,0,218587.5,2566.5,88.25
"7448","26002","2016",17,15,2,160458.058823529,1651.41176470588,98.1176470588235
"7449","26003","2016",2,2,0,192460,2301.5,83.5
"7450","26004","2016",22,21,1,179939.045454545,1693.27272727273,108.545454545455
"7451","26005","2016",18,17,1,269449,2340.77777777778,115.388888888889
"7452","26006","2016",18,16,2,202876.111111111,1993.94444444444,103.5
"7453","26007","2016",1,1,0,313000,2608,120
"7454","26008","2016",14,14,0,181585.714285714,2063.21428571429,91.5
"7455","26009","2016",5,4,1,134070,1353.6,96.4
"7456","26010","2016",28,21,7,148241.071428571,1538.39285714286,99.1071428571429
"7457","26011","2016",22,19,3,168831.227272727,2062.81818181818,88.9545454545455
"7458","26014","2016",4,4,0,237187.5,2290.5,104.75
"7459","26016","2016",3,2,1,112666.666666667,1426.66666666667,79.6666666666667
"7460","26020","2016",1,1,0,295850,1972,150
"7461","26023","2016",11,10,1,160807.272727273,1754.45454545455,91.8181818181818
"7462","26024","2016",3,3,0,298066.666666667,2760,117
"7463","26027","2016",1,1,0,175500,1640,107
"7464","26031","2016",9,8,1,181063.444444444,1645,105.111111111111
"7465","26032","2016",1,1,0,440000,3099,142
"7466","26033","2016",10,7,3,178848.2,3685.6,71.2
"7467","26034","2016",4,3,1,220375,1821.5,123.25
"7468","26035","2016",5,5,0,151000,1511.8,100
"7469","26037","2016",34,34,0,222493.588235294,2094,104.941176470588
"7470","26038","2016",6,6,0,230909.333333333,2310.5,102.833333333333
"7471","26039","2016",11,9,2,145829.090909091,1413.72727272727,113.090909090909
"7472","26041","2016",11,8,3,160449.636363636,1492.63636363636,108.545454545455
"7473","26042","2016",13,12,1,203914.307692308,1993.53846153846,104.076923076923
"7474","26045","2016",26,18,8,164875.5,1690.73076923077,92.9615384615385
"7475","26049","2016",8,8,0,203862.5,1656.375,122
"7476","26051","2016",1,1,0,168000,1366,123
"7477","26052","2016",5,5,0,287630,2265.2,123.8
"7478","26054","2016",9,8,1,207835.555555556,1934.44444444444,108
"7479","26056","2016",8,7,1,186875,1889.625,102.125
"7480","26057","2016",113,62,51,145714.079646018,1710.29203539823,83.9557522123894
"7481","26058","2016",256,111,145,140306.765625,1714.625,80.08984375
"7482","26059","2016",6,6,0,212783.333333333,3782.16666666667,93.8333333333333
"7483","26060","2016",3,3,0,176083.333333333,1912,111.666666666667
"7484","26061","2016",5,5,0,177380,1565.6,110.4
"7485","26062","2016",2,2,0,96500,904,110
"7486","26063","2016",33,30,3,220082.242424242,2264.09090909091,100.909090909091
"7487","26064","2016",77,56,21,210886.441558442,2303.75324675325,96.1948051948052
"7488","26065","2016",4,4,0,301662.5,2977.75,97
"7489","26068","2016",1,1,0,180000,1579,114
"7490","26069","2016",2,2,0,193000,1648.5,116.5
"7491","26070","2016",9,9,0,198662.333333333,2083,95.1111111111111
"7492","26071","2016",7,7,0,202285.714285714,1921.14285714286,99.8571428571429
"7493","26072","2016",10,9,1,197770,2010.2,104.4
"7494","26073","2016",3,3,0,484850,3411,176
"7495","26074","2016",7,6,1,135928.571428571,1809.14285714286,71.1428571428571
"7496","26077","2016",8,5,3,195931.25,1802.875,117.5
"7497","26078","2016",9,9,0,237648.888888889,2115.66666666667,114
"7498","26079","2016",9,9,0,262905.555555556,2189.11111111111,123.555555555556
"7499","26081","2016",2,2,0,413000,2154.5,203.5
"7500","26083","2016",15,14,1,204865,1612.13333333333,129.266666666667
"7501","26084","2016",34,32,2,193748.235294118,1977.52941176471,108.176470588235
"7502","26085","2016",29,24,5,176018.517241379,1881.44827586207,94.3448275862069
"7503","26086","2016",9,8,1,130445.777777778,1588.11111111111,88.8888888888889
"7504","26087","2016",11,10,1,184154.545454545,1789,101.454545454545
"7505","26088","2016",54,44,10,193751.444444444,1970.37037037037,100.611111111111
"7506","26092","2016",5,4,1,195042.4,2096.8,91.4
"7507","26093","2016",1,1,0,540670,2787,194
"7508","26094","2016",9,9,0,185433.333333333,1805,109.333333333333
"7509","26095","2016",8,8,0,214951.25,2108,103.625
"7510","26096","2016",21,19,2,145655,1507.04761904762,94.4761904761905
"7511","26097","2016",6,5,1,260801.666666667,2866.16666666667,91.1666666666667
"7512","26098","2016",3,3,0,291513.333333333,2253,142.333333333333
"7513","26099","2016",5,5,0,397380,3092.8,123.6
"7514","26100","2016",3,3,0,217283.333333333,2142,98.3333333333333
"7515","26101","2016",1,1,0,75000,789,95
"7516","26102","2016",1,1,0,480000,4174,115
"7517","26103","2016",5,4,1,269286,2333,125.8
"7518","26106","2016",11,9,2,150582.272727273,1650.81818181818,89.8181818181818
"7519","26107","2016",6,6,0,112566.666666667,1218.5,92.6666666666667
"7520","26108","2016",97,67,30,145538.154639175,1677.59793814433,86.0103092783505
"7521","26110","2016",5,5,0,178985,2177.2,81.8
"7522","26111","2016",1,1,0,4e+05,2410,166
"7523","26113","2016",53,43,10,171885.169811321,1957.01886792453,93.2830188679245
"7524","26114","2016",52,34,18,176663.75,1965.71153846154,95
"7525","26115","2016",3,2,1,98333.3333333333,672,120
"7526","26116","2016",49,41,8,144481.857142857,1609.36734693878,95.5510204081633
"7527","26118","2016",18,18,0,168518.5,1547.38888888889,116.333333333333
"7528","26119","2016",7,7,0,166571.428571429,1866.71428571429,86.8571428571429
"7529","26121","2016",13,13,0,276859.615384615,2203.30769230769,124.538461538462
"7530","26122","2016",2,2,0,129075,2865.5,44
"7531","26124","2016",44,39,5,235981.045454545,2204.06818181818,108.454545454545
"7532","26125","2016",11,11,0,214990.909090909,2185.72727272727,104.090909090909
"7533","26127","2016",2,2,0,294500,2409.5,127
"7534","26128","2016",1,1,0,179000,2754,65
"7535","26129","2016",10,10,0,189762,1719,115.7
"7536","26131","2016",2,2,0,235000,3714.5,57.5
"7537","26133","2016",3,2,1,239840.333333333,2114,123.333333333333
"7538","26135","2016",4,1,3,157603,3592.5,50.25
"7539","26138","2016",18,17,1,249288.277777778,2059.33333333333,118.055555555556
"7540","26139","2016",19,18,1,238421.894736842,2097.36842105263,112.684210526316
"7541","26140","2016",6,5,1,228750,2081.5,118.166666666667
"7542","26141","2016",5,5,0,214990,2383.2,111
"7543","26143","2016",10,10,0,176199,1281.7,143.1
"7544","26144","2016",23,19,4,214301.304347826,2078.34782608696,101.434782608696
"7545","26145","2016",7,7,0,239151.428571429,2032.57142857143,117.714285714286
"7546","26146","2016",15,13,2,314610,2732.53333333333,117.2
"7547","26148","2016",15,14,1,164680,1588.93333333333,101.8
"7548","26149","2016",14,9,5,151005.714285714,1475.64285714286,107.357142857143
"7549","26154","2016",2,2,0,133975,1749,86
"7550","26155","2016",14,13,1,165121.428571429,1661.64285714286,99.2857142857143
"7551","26156","2016",4,4,0,190025,1840,102.25
"7552","26157","2016",7,7,0,192471.428571429,2135.28571428571,93.1428571428571
"7553","26159","2016",2,2,0,135500,1804.5,74
"7554","26160","2016",9,7,2,181200,1799.22222222222,99.8888888888889
"7555","26162","2016",9,8,1,106038.888888889,1346.11111111111,82.1111111111111
"7556","26163","2016",2,2,0,32500,399,79
"7557","26164","2016",3,3,0,72666.6666666667,971,76
"7558","26165","2016",108,82,26,170353.259259259,1804.00925925926,92.8055555555556
"7559","26166","2016",67,61,6,174232.597014925,1782.22388059701,99.3432835820896
"7560","26167","2016",9,9,0,136000,1400.88888888889,96.8888888888889
"7561","26168","2016",12,8,4,85284,1262.83333333333,78.5833333333333
"7562","26169","2016",19,18,1,214495.105263158,2162.42105263158,103.947368421053
"7563","26170","2016",26,23,3,223213.461538462,2086.11538461538,111.038461538462
"7564","26171","2016",6,6,0,139438.333333333,1471.83333333333,90.8333333333333
"7565","26172","2016",6,5,1,161166.666666667,1575.16666666667,104.5
"7566","26173","2016",4,4,0,94625,1048,89.5
"7567","26174","2016",10,10,0,176492,1767.1,100.9
"7568","26175","2016",2,2,0,147750,1284.5,102
"7569","26176","2016",15,14,1,234396.333333333,2226.8,104.733333333333
"7570","26177","2016",5,5,0,231036,2196.6,105.6
"7571","26179","2016",20,19,1,208827.5,1756.3,120.25
"7572","26180","2016",2,2,0,112500,1059,105
"7573","26181","2016",5,5,0,133710,1905,74.4
"7574","26182","2016",20,17,3,200607.5,2667.05,81.3
"7575","26183","2016",11,10,1,230381.636363636,2408,98.1818181818182
"7576","26185","2016",7,7,0,284264.285714286,2369,126.285714285714
"7577","26188","2016",19,17,2,210080,2296.42105263158,96.4210526315789
"7578","26191","2016",37,31,6,215638.108108108,2316.72972972973,94.7567567567568
"7579","26192","2016",1,1,0,320000,2038,157
"7580","26193","2016",8,7,1,174900.875,2048.375,83.875
"7581","26194","2016",7,7,0,170857.142857143,1921.85714285714,85.7142857142857
"7582","26195","2016",4,4,0,195386.25,2518.25,78.25
"7583","26196","2016",7,7,0,277637.142857143,1989.42857142857,148.285714285714
"7584","26197","2016",31,26,5,253282.903225806,3148.8064516129,103.645161290323
"7585","26198","2016",510,231,279,146744.17254902,1740.59607843137,83.3647058823529
"7586","26202","2016",4,4,0,178331.5,1477.25,125.75
"7587","26203","2016",2,2,0,224275,2352,86
"7588","26204","2016",1,1,0,297380,2288,130
"7589","26205","2016",2,2,0,60000,1333.5,50
"7590","26206","2016",29,27,2,239135.620689655,2381.75862068966,101
"7591","26207","2016",3,3,0,190500,1789,105.666666666667
"7592","26208","2016",12,12,0,183826.666666667,2105.33333333333,89.9166666666667
"7593","26209","2016",1,1,0,267420,2757,97
"7594","26210","2016",8,7,1,165793.75,2256.875,86.5
"7595","26211","2016",8,7,1,300343.125,2644.25,108.5
"7596","26212","2016",6,6,0,177500,1860,99.8333333333333
"7597","26213","2016",9,8,1,112144.444444444,1429.66666666667,83.4444444444444
"7598","26215","2016",10,9,1,115676.7,1444.8,92.5
"7599","26216","2016",6,4,2,184030,2155.66666666667,103.5
"7600","26217","2016",1,1,0,359000,2992,120
"7601","26218","2016",32,30,2,221984.875,2014.28125,116.125
"7602","26220","2016",109,45,64,162760.944954128,2128.75229357798,75.6422018348624
"7603","26223","2016",4,4,0,200802.25,3381.25,86.5
"7604","26225","2016",2,2,0,139500,1217.5,95.5
"7605","26226","2016",2,2,0,320000,3218,95
"7606","26227","2016",1,1,0,168300,2104,80
"7607","26231","2016",27,24,3,231450.555555556,1951.51851851852,115.777777777778
"7608","26232","2016",5,5,0,169200,1626,100
"7609","26233","2016",3,3,0,325312.666666667,3355.33333333333,109
"7610","26234","2016",12,11,1,199681,2300.75,103.083333333333
"7611","26235","2016",88,65,23,147182.386363636,1701.14772727273,89.7954545454545
"7612","26236","2016",3,3,0,142233.333333333,1868,72.3333333333333
"7613","26239","2016",1,1,0,195000,1773,110
"7614","26240","2016",3,3,0,150425,1507.33333333333,101.333333333333
"7615","26243","2016",16,13,3,161261,1541.9375,98.9375
"7616","26246","2016",1,1,0,115000,1186,97
"7617","26247","2016",5,4,1,149900,1717.6,95
"7618","26249","2016",9,9,0,287837.777777778,2183.33333333333,129
"7619","26250","2016",37,30,7,197735.243243243,2014.51351351351,102.594594594595
"7620","26251","2016",6,6,0,260190,2647.83333333333,91.6666666666667
"7621","26252","2016",138,73,65,154614.492753623,1940.00724637681,81.195652173913
"7622","26254","2016",1,1,0,92940,1549,60
"7623","26257","2016",3,3,0,198866.666666667,1717.33333333333,125
"7624","26258","2016",12,12,0,204918.916666667,2046,98.75
"7625","26261","2016",6,6,0,318291.666666667,2407.33333333333,127.5
"7626","26263","2016",1,1,0,120000,1846,65
"7627","26264","2016",3,2,1,102543.333333333,1375.33333333333,74.3333333333333
"7628","26268","2016",2,2,0,109950,724,130
"7629","26271","2016",30,24,6,217362.466666667,2248.13333333333,102.6
"7630","26272","2016",1,1,0,252700,2407,105
"7631","26273","2016",9,9,0,263481.111111111,1988.22222222222,133.555555555556
"7632","26275","2016",10,9,1,194140,1851.3,104.4
"7633","26276","2016",4,4,0,233250,3311.25,84.25
"7634","26277","2016",3,3,0,269500,2895.66666666667,90.6666666666667
"7635","26278","2016",3,3,0,306183.333333333,2298.66666666667,108.333333333333
"7636","26281","2016",447,200,247,128669.617449664,1556.22818791946,81.7628635346756
"7637","26282","2016",1,1,0,224000,2462,91
"7638","26284","2016",4,4,0,256000,2117.25,99.75
"7639","26285","2016",2,2,0,176000,2043,77.5
"7640","26287","2016",2,2,0,260075,2650.5,101
"7641","26288","2016",2,2,0,193075,1597,119.5
"7642","26289","2016",20,15,5,170021.15,1820.4,99.65
"7643","26290","2016",13,6,7,113449.846153846,1820.07692307692,62.1538461538462
"7644","26292","2016",5,5,0,215400,2786,102.8
"7645","26293","2016",4,4,0,146400,1425.75,98.75
"7646","26294","2016",2,2,0,185000,1574,116.5
"7647","26295","2016",11,11,0,158117.272727273,1679.63636363636,99.6363636363636
"7648","26298","2016",9,9,0,131300,1261,113.777777777778
"7649","26300","2016",1,1,0,297290,2654,112
"7650","26301","2016",47,32,15,174247.808510638,1869.06382978723,95.4255319148936
"7651","26302","2016",11,11,0,157904.545454545,1698.54545454545,96.4545454545455
"7652","26303","2016",3,3,0,251266.666666667,2380,100.666666666667
"7653","26305","2016",15,13,2,227075.066666667,1923.66666666667,118.533333333333
"7654","26306","2016",5,4,1,108610,1538.2,77.4
"7655","26307","2016",24,19,5,119562.083333333,1442.5,91.125
"7656","26308","2016",1,1,0,169000,3073,55
"7657","26309","2016",3,2,1,103333.333333333,796,129.333333333333
"7658","26311","2016",8,7,1,157250,1317,122.25
"7659","26312","2016",11,10,1,210302.090909091,2073.27272727273,101.363636363636
"7660","26313","2016",48,43,5,194615.333333333,1934.52083333333,104.270833333333
"7661","26314","2016",6,4,2,201342.166666667,1793.33333333333,108
"7662","26315","2016",9,6,3,134071.111111111,1313.11111111111,111.555555555556
"7663","26316","2016",1,1,0,125000,1276,98
"7664","26317","2016",6,6,0,191169.666666667,1597.83333333333,113.666666666667
"7665","26319","2016",11,9,2,171076.363636364,1874.45454545455,93.1818181818182
"7666","26320","2016",18,17,1,117167.222222222,1295,90.0555555555556
"7667","26321","2016",2,2,0,124930,2055.5,60.5
"7668","26322","2016",4,3,1,168112.5,1893.75,86.75
"7669","26323","2016",12,10,2,212668.333333333,2115.33333333333,102.166666666667
"7670","26324","2016",87,51,36,189277.988505747,1989.25287356322,95.0574712643678
"7671","26325","2016",59,44,15,140876.016949153,1646.86440677966,86.3898305084746
"7672","26326","2016",18,16,2,363506.111111111,3045.11111111111,117.277777777778
"7673","26327","2016",4,4,0,194357.5,1761.5,112.25
"7674","26328","2016",1,1,0,195000,2786,70
"7675","26330","2016",18,16,2,172011.111111111,1624.22222222222,109.222222222222
"7676","26331","2016",3,3,0,193666.666666667,1481.33333333333,132
"7677","26332","2016",15,12,3,126253.333333333,1294.26666666667,103
"7678","26333","2016",36,12,24,81354.1666666667,1210.22222222222,67.75
"7679","26334","2016",1,1,0,328200,2626,125
"7680","26335","2016",3,3,0,413083.333333333,3004.66666666667,190.333333333333
"7681","26336","2016",7,6,1,254000,2147.14285714286,108.428571428571
"7682","26337","2016",17,16,1,202843.529411765,2125.35294117647,96.7647058823529
"7683","26338","2016",10,10,0,244466,2210.2,113.5
"7684","26339","2016",9,8,1,304558.888888889,2250.66666666667,144.111111111111
"7685","26341","2016",9,9,0,170366.666666667,1457.33333333333,118
"7686","26342","2016",2,2,0,368095.5,3013,148.5
"7687","26343","2016",1,1,0,130000,2321,56
"7688","26344","2016",3,3,0,205050,3000.66666666667,66.6666666666667
"7689","26345","2016",17,15,2,187541.176470588,1996.64705882353,94.5294117647059
"7690","26346","2016",1,1,0,65900,1318,50
"7691","26347","2016",69,35,34,167828.68115942,1794.97101449275,87.2173913043478
"7692","26348","2016",12,12,0,160407.083333333,1853.75,86
"7693","26349","2016",2,2,0,230500,1493,154.5
"7694","26351","2016",1,1,0,89000,1112,80
"7695","26352","2016",2,2,0,359445,2501.5,141
"7696","26353","2016",12,8,4,147377.083333333,1748.66666666667,83.0833333333333
"7697","26355","2016",1,1,0,260000,2301,113
"7698","26357","2016",16,12,4,187584.375,2208.25,89.625
"7699","26358","2016",13,13,0,263158.230769231,2243.92307692308,117.153846153846
"7700","26360","2016",5,5,0,293677,3037.4,105.4
"7701","26362","2016",967,224,743,134420.865563599,1739.08066184074,77.2657704239917
"7702","26365","2016",4,4,0,196580,2258.5,87.25
"7703","26367","2016",7,7,0,237692.857142857,2535,95.4285714285714
"7704","26368","2016",4,4,0,151068.25,1516.75,97.5
"7705","26373","2016",3,3,0,246000,2557.66666666667,97.6666666666667
"7706","26374","2016",1,1,0,130000,1000,130
"7707","26376","2016",5,5,0,197740,2270.8,83
"7708","26377","2016",7,7,0,186428.571428571,2167,87
"7709","26378","2016",1,1,0,40000,833,48
"7710","26379","2016",5,5,0,166502,1931.6,92.8
"7711","26380","2016",3,3,0,181000,1800.33333333333,97.3333333333333
"7712","26381","2016",9,8,1,187168.888888889,1848.66666666667,101.111111111111
"7713","26382","2016",3,3,0,181933.333333333,1927.33333333333,95.3333333333333
"7714","27001","2016",5,5,0,76200,773.4,95.6
"7715","27002","2016",5,5,0,103800,1055.2,102
"7716","27003","2016",12,12,0,194691.666666667,1680.75,119.083333333333
"7717","27004","2016",4,4,0,210525,1592.75,138.25
"7718","27005","2016",14,14,0,173000,1903.14285714286,107.285714285714
"7719","27006","2016",5,5,0,118940,1249,90.4
"7720","27008","2016",12,12,0,177608.333333333,2109.58333333333,85.9166666666667
"7721","27009","2016",3,3,0,95333.3333333333,1658.33333333333,64.6666666666667
"7722","27010","2016",2,2,0,112000,1573,71
"7723","27011","2016",11,11,0,153444.090909091,2040.45454545455,78.1818181818182
"7724","27012","2016",2,2,0,136000,1800,75
"7725","27013","2016",3,3,0,155333.333333333,1319.33333333333,115.666666666667
"7726","27014","2016",10,10,0,167660,1678.6,105.5
"7727","27015","2016",8,8,0,150925.375,1622.75,94.875
"7728","27016","2016",73,67,6,145969.164383562,1593.7397260274,91.9452054794521
"7729","27017","2016",9,9,0,210060.555555556,3059.77777777778,103.444444444444
"7730","27019","2016",1,1,0,176300,1160,152
"7731","27020","2016",19,19,0,160856.842105263,1749.63157894737,93.2631578947368
"7732","27022","2016",34,34,0,169326.470588235,1835.11764705882,95.6470588235294
"7733","27023","2016",10,10,0,167964,1785.3,102.5
"7734","27025","2016",12,12,0,139889.166666667,1457.83333333333,107.166666666667
"7735","27026","2016",4,2,2,151750,1765.25,99
"7736","27027","2016",2,2,0,196000,2800,70
"7737","27031","2016",12,12,0,180166.666666667,1789.25,99.9166666666667
"7738","27032","2016",16,16,0,165485.625,1531.125,105.625
"7739","27033","2016",3,3,0,145500,1489,111.333333333333
"7740","27034","2016",9,9,0,172222.222222222,2032.77777777778,87.8888888888889
"7741","27036","2016",8,8,0,168506,1527.125,106.375
"7742","27037","2016",8,8,0,133750,1386.5,104.375
"7743","27038","2016",3,3,0,101333.333333333,1105.33333333333,88.6666666666667
"7744","27039","2016",2,2,0,158000,1723,92
"7745","27043","2016",6,6,0,110000,1324.16666666667,100.5
"7746","27044","2016",5,5,0,168200,1516.6,110
"7747","27045","2016",5,5,0,212600,2074.6,107.2
"7748","27047","2016",8,8,0,117875,1206.5,96.25
"7749","27048","2016",7,7,0,163428.571428571,1707.42857142857,119.857142857143
"7750","27049","2016",49,49,0,113804.285714286,1221.28571428571,92.9387755102041
"7751","27052","2016",3,3,0,199000,1541,125.666666666667
"7752","27054","2016",6,6,0,148500,1297.16666666667,116.5
"7753","27055","2016",3,3,0,155166.666666667,1290,119.666666666667
"7754","27056","2016",119,89,30,134441.176470588,1619.20168067227,85.6386554621849
"7755","27057","2016",2,2,0,155000,1406.5,110.5
"7756","27058","2016",14,12,2,148678.571428571,1763,86.2857142857143
"7757","27059","2016",4,4,0,153000,1610,95.5
"7758","27061","2016",3,3,0,127000,1526,84.3333333333333
"7759","27062","2016",9,9,0,135841.444444444,1537.33333333333,88.6666666666667
"7760","27064","2016",11,11,0,129272.727272727,1935.27272727273,74.2727272727273
"7761","27065","2016",44,40,4,170168.5,1681.79545454545,100.522727272727
"7762","27066","2016",2,2,0,175000,2394.5,90
"7763","27067","2016",12,12,0,177541.666666667,1999.83333333333,99.3333333333333
"7764","27068","2016",4,4,0,99500,1101.75,90.5
"7765","27069","2016",8,8,0,136125,1327.5,106.5
"7766","27070","2016",20,20,0,149695,1665.5,97.55
"7767","27072","2016",6,6,0,224416.666666667,2186.83333333333,103.166666666667
"7768","27073","2016",18,18,0,176108.333333333,1917.5,95.9444444444444
"7769","27075","2016",5,5,0,86200,1337.2,70
"7770","27076","2016",5,5,0,168152,1742.2,100.6
"7771","27077","2016",9,9,0,132556.555555556,1402.77777777778,100.222222222222
"7772","27078","2016",1,1,0,151000,2127,71
"7773","27079","2016",4,4,0,178525,1514,115.25
"7774","27081","2016",4,4,0,194262.5,2382.75,96.25
"7775","27082","2016",15,14,1,134661.333333333,1430.2,96.3333333333333
"7776","27085","2016",9,9,0,181450,1675.66666666667,109
"7777","27089","2016",6,6,0,146333.333333333,1575.16666666667,97.3333333333333
"7778","27090","2016",36,36,0,182908.333333333,1740.33333333333,104.805555555556
"7779","27091","2016",11,11,0,171386.363636364,1774.09090909091,99.9090909090909
"7780","27095","2016",9,9,0,143466.666666667,1460.88888888889,99.8888888888889
"7781","27096","2016",7,7,0,130099.571428571,1194.57142857143,109.428571428571
"7782","27097","2016",4,4,0,157000,2129.75,77
"7783","27099","2016",8,8,0,172629.5,1723.625,100.625
"7784","27100","2016",6,6,0,213608.333333333,1877.33333333333,114.5
"7785","27101","2016",3,3,0,183233.333333333,1683,106.333333333333
"7786","27102","2016",13,13,0,191809.230769231,1805.84615384615,105.307692307692
"7787","27103","2016",29,28,1,176357,1913.55172413793,94.7931034482759
"7788","27104","2016",8,8,0,161655,1462.5,111.25
"7789","27105","2016",46,45,1,174147.239130435,1750.19565217391,104.652173913043
"7790","27107","2016",12,12,0,174187.5,1665.83333333333,99.5833333333333
"7791","27108","2016",14,13,1,109642.857142857,1479.28571428571,75.9285714285714
"7792","27109","2016",7,7,0,142957.142857143,1414.42857142857,103.857142857143
"7793","27110","2016",6,6,0,163666.666666667,1368,120.333333333333
"7794","27111","2016",6,6,0,212516.666666667,1997.33333333333,115.333333333333
"7795","27112","2016",35,33,2,114344.428571429,1357.14285714286,86.1428571428571
"7796","27113","2016",2,2,0,80125,1555,58
"7797","27114","2016",12,12,0,232739.166666667,2058.33333333333,122.416666666667
"7798","27115","2016",5,5,0,179200,2193.6,93.8
"7799","27116","2016",57,57,0,116342.631578947,1312.98245614035,92.140350877193
"7800","27117","2016",12,12,0,102766.666666667,920.75,119.75
"7801","27118","2016",4,4,0,110100,1630.25,69.25
"7802","27119","2016",11,11,0,178824.545454545,1884.54545454545,97.7272727272727
"7803","27120","2016",3,3,0,151866.666666667,1624.33333333333,93.6666666666667
"7804","27123","2016",1,0,1,147500,1967,75
"7805","27124","2016",2,2,0,336125,1614,210
"7806","27125","2016",7,7,0,121711.428571429,1212.85714285714,98.1428571428571
"7807","27126","2016",8,8,0,154775,1475.125,108.75
"7808","27127","2016",6,6,0,156791.666666667,1547.66666666667,105.666666666667
"7809","27129","2016",6,6,0,156333.333333333,1449,119
"7810","27130","2016",5,5,0,128590,1495.6,86
"7811","27132","2016",8,8,0,151167.75,1474.625,92.375
"7812","27133","2016",9,9,0,256035.555555556,1808.66666666667,138.666666666667
"7813","27134","2016",5,5,0,104379.6,1185,90.6
"7814","27135","2016",4,4,0,152962.5,1454.25,113
"7815","27136","2016",6,6,0,197525,1071.33333333333,184.833333333333
"7816","27137","2016",2,2,0,65500,925.5,68
"7817","27138","2016",4,4,0,89875,1629.5,62
"7818","27139","2016",2,2,0,96000,1323.5,77.5
"7819","27140","2016",8,8,0,161125,1731.5,101.25
"7820","27141","2016",4,4,0,187500,1245,147.75
"7821","27142","2016",4,4,0,199250,2023.5,103
"7822","27144","2016",5,5,0,147000,1496.4,101.2
"7823","27147","2016",5,5,0,178600,1616.8,116.4
"7824","27148","2016",8,8,0,157678.75,1981.5,92.625
"7825","27151","2016",16,14,2,125525.5625,1392.8125,95.1875
"7826","27152","2016",5,3,2,138520,1937,82
"7827","27153","2016",5,5,0,148280,2279,69
"7828","27154","2016",4,4,0,141250,1510,94.5
"7829","27155","2016",2,2,0,80000,592,156.5
"7830","27156","2016",2,2,0,150000,1721.5,89
"7831","27157","2016",13,13,0,150184.615384615,1457,108.384615384615
"7832","27158","2016",8,8,0,152625,1510.875,106.375
"7833","27161","2016",11,11,0,168309.090909091,1727.63636363636,100.545454545455
"7834","27162","2016",4,4,0,146750,1792,89.25
"7835","27163","2016",1,1,0,55000,688,80
"7836","27165","2016",43,37,6,121531.395348837,1424.6511627907,86.5116279069767
"7837","27168","2016",7,7,0,270071.428571429,3181,92
"7838","27169","2016",12,12,0,142041.666666667,1435.41666666667,96.3333333333333
"7839","27171","2016",2,2,0,248160,1205.5,167.5
"7840","27174","2016",14,14,0,166723.571428571,1498.5,114.928571428571
"7841","27177","2016",8,8,0,129837.5,1418.875,99.375
"7842","27179","2016",15,15,0,144440,1463.46666666667,104.533333333333
"7843","27180","2016",16,16,0,179036.1875,1924.1875,95
"7844","27183","2016",32,30,2,165265.625,1870.9375,90.6875
"7845","27184","2016",1,1,0,152000,1747,87
"7846","27185","2016",4,4,0,121070,1312,94
"7847","27187","2016",2,2,0,217600,1653,130
"7848","27188","2016",15,15,0,158690,1772.46666666667,94.2
"7849","27189","2016",3,3,0,221000,1560.33333333333,145.333333333333
"7850","27190","2016",4,4,0,245500,2588.75,89
"7851","27191","2016",17,17,0,186043.529411765,1706.35294117647,112.529411764706
"7852","27192","2016",7,7,0,191071.428571429,2038.14285714286,103.142857142857
"7853","27193","2016",29,29,0,166148.275862069,1847.27586206897,100.068965517241
"7854","27194","2016",1,1,0,157000,1308,120
"7855","27196","2016",11,11,0,209479.090909091,1818.09090909091,115.818181818182
"7856","27198","2016",49,49,0,145420.408163265,1499.73469387755,100.387755102041
"7857","27199","2016",5,5,0,167000,2315.8,89
"7858","27201","2016",1,1,0,65000,756,86
"7859","27202","2016",2,2,0,192500,2266.5,82.5
"7860","27203","2016",6,6,0,358068.333333333,3694.83333333333,111.333333333333
"7861","27204","2016",4,4,0,173750,1682.75,104.25
"7862","27207","2016",9,9,0,122444.444444444,1326.55555555556,94.2222222222222
"7863","27209","2016",4,4,0,372250,3440.5,124.75
"7864","27210","2016",3,3,0,154000,1359.33333333333,115.666666666667
"7865","27212","2016",2,2,0,142438.5,1505,86
"7866","27213","2016",66,66,0,175162.545454545,1886.59090909091,100.318181818182
"7867","27214","2016",6,6,0,111833.333333333,1355,83.1666666666667
"7868","27215","2016",2,2,0,131500,1554.5,87
"7869","27216","2016",3,3,0,181833.333333333,2316,79.3333333333333
"7870","27217","2016",7,7,0,178493.142857143,1679,112.428571428571
"7871","27219","2016",3,3,0,150100,1385.66666666667,107.666666666667
"7872","27220","2016",2,2,0,87230,1330,104
"7873","27222","2016",5,5,0,155388,1729.2,100
"7874","27224","2016",2,2,0,171500,1882,96
"7875","27226","2016",44,39,5,147793.045454545,1727.18181818182,94.4545454545455
"7876","27227","2016",7,7,0,138714.285714286,1451.85714285714,98.4285714285714
"7877","27229","2016",515,222,293,118553.141747573,1635.25048543689,72.978640776699
"7878","27230","2016",55,49,6,156504.690909091,1909.45454545455,89.6363636363636
"7879","27231","2016",2,2,0,290000,2212.5,135
"7880","27232","2016",4,4,0,182021.25,1853.5,99
"7881","27233","2016",11,11,0,211195.454545455,1943.63636363636,110.727272727273
"7882","27234","2016",5,5,0,146130,1709.8,86.8
"7883","27235","2016",4,4,0,366781.25,2417.25,138.25
"7884","27238","2016",7,7,0,139867.857142857,1596.57142857143,90.5714285714286
"7885","27240","2016",2,2,0,53750,907.5,58.5
"7886","27241","2016",2,2,0,142250,1793.5,83.5
"7887","27242","2016",19,19,0,129531.578947368,1500.63157894737,96.6315789473684
"7888","27243","2016",8,8,0,229648.75,1771.25,122.625
"7889","27245","2016",3,3,0,1e+05,1306.33333333333,78
"7890","27246","2016",24,24,0,114977.416666667,1344.29166666667,89.0416666666667
"7891","27247","2016",4,4,0,137750,1802.5,76.75
"7892","27249","2016",6,6,0,180833.333333333,1795.16666666667,102.666666666667
"7893","27254","2016",19,19,0,244792.315789474,1679.15789473684,147.842105263158
"7894","27256","2016",7,7,0,167142.857142857,1854.57142857143,91
"7895","27258","2016",2,2,0,213175,2393,91
"7896","27259","2016",2,2,0,153250,1339.5,110.5
"7897","27260","2016",7,7,0,172431.428571429,1425.28571428571,120.142857142857
"7898","27261","2016",4,4,0,143750,1439.25,108
"7899","27263","2016",10,10,0,139510,1146.9,120.2
"7900","27266","2016",7,7,0,168542.857142857,1337.14285714286,123.857142857143
"7901","27269","2016",1,1,0,85000,1062,80
"7902","27271","2016",5,5,0,194320,1647.6,126.6
"7903","27273","2016",3,3,0,167583.333333333,1058,160.333333333333
"7904","27275","2016",74,38,36,111443.351351351,1606.05405405405,71.2432432432432
"7905","27276","2016",1,1,0,172000,3018,57
"7906","27277","2016",5,5,0,123260,1224.8,101.8
"7907","27278","2016",27,27,0,183693.666666667,1894.03703703704,99.2962962962963
"7908","27279","2016",37,30,7,143604.891891892,1784.45945945946,82.2702702702703
"7909","27280","2016",2,2,0,143000,1718,85
"7910","27281","2016",3,3,0,153000,1470.33333333333,104.333333333333
"7911","27282","2016",3,3,0,193666.666666667,1691,117
"7912","27284","2016",123,89,34,154929.796747967,1963.9593495935,83.3577235772358
"7913","27285","2016",12,12,0,299371.666666667,2800.75,108
"7914","27287","2016",16,16,0,166183.125,1866.5,104.625
"7915","27289","2016",7,7,0,151214.285714286,1303.71428571429,115.285714285714
"7916","27290","2016",15,15,0,130193.333333333,1325.13333333333,105.333333333333
"7917","27291","2016",4,4,0,110250,1357.5,86.75
"7918","27294","2016",15,15,0,141048.333333333,1540.2,95.9333333333333
"7919","27298","2016",6,6,0,135833.333333333,1373.33333333333,104.666666666667
"7920","27299","2016",33,22,11,135117.878787879,1599.66666666667,88.7878787878788
"7921","27301","2016",10,10,0,181553,1785.8,112.8
"7922","27302","2016",12,12,0,159262.5,2126.75,93.75
"7923","27304","2016",2,2,0,210500,2041,107
"7924","27306","2016",18,18,0,167350,1817.16666666667,96.8333333333333
"7925","27307","2016",3,3,0,107666.666666667,753.666666666667,138.333333333333
"7926","27309","2016",6,6,0,137333.333333333,2047.16666666667,66
"7927","27310","2016",3,3,0,90000,1319,69
"7928","27311","2016",8,8,0,141500,1645.25,88.75
"7929","27312","2016",4,4,0,273090,1849.25,149.5
"7930","27313","2016",5,5,0,166740,1473,112.8
"7931","27315","2016",2,2,0,157500,2068.5,103
"7932","27316","2016",16,16,0,175697,1716.25,102.25
"7933","27317","2016",2,2,0,159080,2121,82
"7934","27318","2016",3,3,0,132533.333333333,1405,96.3333333333333
"7935","27319","2016",1,1,0,80000,2000,40
"7936","27320","2016",4,4,0,178625,1840.5,96.75
"7937","27321","2016",1,1,0,385000,2037,189
"7938","27322","2016",12,12,0,156150.833333333,1681.33333333333,93.0833333333333
"7939","27323","2016",4,4,0,130750,1243.5,111.5
"7940","27324","2016",5,5,0,261978,2327.6,108.6
"7941","27325","2016",3,3,0,166333.333333333,1112,153
"7942","27326","2016",1,1,0,8e+05,2500,320
"7943","27327","2016",4,4,0,182250,2124,89
"7944","27329","2016",7,7,0,140306.857142857,1504.71428571429,94.2857142857143
"7945","27331","2016",3,3,0,191333.333333333,2063.66666666667,95
"7946","27332","2016",7,6,1,156857.142857143,1831.57142857143,89.8571428571429
"7947","27333","2016",9,9,0,151210.444444444,1771.44444444444,91.1111111111111
"7948","27335","2016",5,5,0,204260,1538.4,141.4
"7949","27336","2016",3,3,0,234735,1971.33333333333,120.666666666667
"7950","27337","2016",3,3,0,163616.666666667,1564,108.333333333333
"7951","27338","2016",7,7,0,122500,1438.42857142857,90
"7952","27339","2016",11,11,0,197472.727272727,1607.18181818182,131.545454545455
"7953","27340","2016",5,5,0,286200,1652.6,187.6
"7954","27341","2016",2,2,0,169425,1525,113
"7955","27343","2016",13,13,0,269153.846153846,2036.76923076923,138.230769230769
"7956","27346","2016",2,2,0,108650,1507.5,70.5
"7957","27347","2016",8,8,0,192693.75,1702.5,118.5
"7958","27348","2016",13,13,0,173699.923076923,1738,101.307692307692
"7959","27349","2016",4,4,0,154637.5,1449.5,107.75
"7960","27351","2016",9,9,0,174511.111111111,1868.33333333333,96.6666666666667
"7961","27353","2016",3,3,0,141666.666666667,1821,79.3333333333333
"7962","27354","2016",6,6,0,134083.333333333,1559.16666666667,87.3333333333333
"7963","27355","2016",32,23,9,141895.9375,1757,84.3125
"7964","27358","2016",6,6,0,206583.166666667,2068.83333333333,99.3333333333333
"7965","27360","2016",4,4,0,141750,1564.75,92.75
"7966","27361","2016",7,7,0,166622.857142857,1892,87.8571428571429
"7967","27363","2016",4,4,0,129012.5,1473.75,87.5
"7968","27365","2016",19,17,2,140678.947368421,1483.57894736842,95.2631578947368
"7969","27366","2016",3,3,0,139800,1426,100
"7970","27367","2016",17,17,0,119422.882352941,1455.23529411765,89.3529411764706
"7971","27368","2016",3,3,0,258666.666666667,1724.66666666667,147.666666666667
"7972","27369","2016",2,2,0,102500,959.5,110
"7973","27370","2016",3,3,0,133833.333333333,1281.66666666667,110.333333333333
"7974","27371","2016",3,3,0,155500,1379,115
"7975","27372","2016",8,8,0,153880.625,1400.25,117
"7976","27373","2016",2,2,0,134000,1500.5,93.5
"7977","27374","2016",6,6,0,123960,1237.5,102.166666666667
"7978","27375","2016",153,122,31,142725.215686275,1661.42483660131,87.2091503267974
"7979","27376","2016",5,5,0,168800,2366.8,96.2
"7980","27377","2016",8,8,0,165750,1671.5,112.125
"7981","27378","2016",11,11,0,140972.090909091,1716,87.7272727272727
"7982","27379","2016",7,7,0,150277.142857143,2140,76.1428571428571
"7983","27380","2016",3,3,0,219216.666666667,2030.66666666667,111
"7984","27381","2016",2,2,0,155500,1551.5,101.5
"7985","27382","2016",3,3,0,122333.333333333,1362,93.6666666666667
"7986","27383","2016",4,4,0,155250,1338.25,121.25
"7987","27384","2016",7,7,0,127571.428571429,1343.71428571429,95.7142857142857
"7988","27385","2016",17,15,2,111720.470588235,1305.52941176471,84.5294117647059
"7989","27386","2016",12,12,0,134188.333333333,1547.33333333333,88.6666666666667
"7990","27388","2016",9,9,0,134888.888888889,1429.88888888889,98.4444444444444
"7991","27389","2016",3,3,0,151666.666666667,1336.66666666667,120.666666666667
"7992","27391","2016",16,16,0,190081.25,1578.5625,122.3125
"7993","27393","2016",6,6,0,204533.333333333,1696.83333333333,130.5
"7994","27394","2016",1,1,0,120000,1053,114
"7995","27396","2016",5,5,0,122500,1545.8,92.2
"7996","27397","2016",22,22,0,188909.090909091,1971.13636363636,100.772727272727
"7997","27398","2016",17,17,0,120802.941176471,1366.35294117647,88.0588235294118
"7998","27400","2016",11,11,0,202313.818181818,1783.90909090909,114.272727272727
"7999","27401","2016",4,4,0,186125,1681.75,113.75
"8000","27403","2016",2,2,0,217750,2157,99
"8001","27405","2016",2,2,0,173000,1792.5,96.5
"8002","27406","2016",10,9,1,172295,1724.6,98.9
"8003","27407","2016",4,4,0,169000,1912.5,104.25
"8004","27408","2016",5,5,0,150800,1472.2,102.6
"8005","27410","2016",5,5,0,167000,1749.8,95.6
"8006","27412","2016",7,7,0,172857.142857143,1542.71428571429,120.571428571429
"8007","27414","2016",12,12,0,108175,1384.08333333333,91.8333333333333
"8008","27417","2016",8,8,0,156437.5,1406,115
"8009","27418","2016",1,1,0,252700,1541,164
"8010","27419","2016",17,17,0,170667.058823529,1915.58823529412,92.8823529411765
"8011","27420","2016",4,4,0,164875,2783.75,80.5
"8012","27421","2016",11,11,0,177409.090909091,1712.54545454545,111.636363636364
"8013","27422","2016",12,12,0,159116.666666667,1681.75,96.75
"8014","27424","2016",1,1,0,171000,1693,101
"8015","27425","2016",16,16,0,98925.6875,1135.25,92.6875
"8016","27426","2016",13,13,0,190103.076923077,2091.30769230769,96
"8017","27427","2016",5,5,0,133600,1829.2,81.2
"8018","27428","2016",42,40,2,152767.904761905,1625.30952380952,99.5714285714286
"8019","27429","2016",3,3,0,232600,1791.33333333333,149.666666666667
"8020","27430","2016",8,8,0,168068.25,1855.125,94
"8021","27431","2016",7,6,1,76285.7142857143,1066.28571428571,71.7142857142857
"8022","27432","2016",8,6,2,150575,1645.75,106.625
"8023","27433","2016",2,2,0,145180,1725.5,104.5
"8024","27436","2016",4,4,0,96000,1079.5,88
"8025","27437","2016",1,1,0,83500,1740,48
"8026","27438","2016",19,19,0,134717.631578947,1458.84210526316,99.5263157894737
"8027","27439","2016",8,8,0,262717.125,3223.25,94.75
"8028","27440","2016",6,6,0,216500,2033,104.166666666667
"8029","27442","2016",6,6,0,72000,881.166666666667,84.5
"8030","27444","2016",3,3,0,144206.666666667,1425.33333333333,101
"8031","27445","2016",3,3,0,138333.333333333,1648.66666666667,95.3333333333333
"8032","27447","2016",10,10,0,143985,1431.4,99.8
"8033","27448","2016",53,49,4,217808.301886792,2220.52830188679,109.490566037736
"8034","27451","2016",2,2,0,219225,1723.5,138
"8035","27453","2016",21,21,0,115595.238095238,1449.80952380952,81.9047619047619
"8036","27454","2016",4,4,0,129325,1550.75,84.5
"8037","27456","2016",3,3,0,161566.666666667,1821.66666666667,95.6666666666667
"8038","27457","2016",6,6,0,110661.666666667,1283,88
"8039","27458","2016",23,23,0,133594.130434783,1469.4347826087,93.3913043478261
"8040","27460","2016",2,2,0,82100,1338.5,66.5
"8041","27463","2016",4,4,0,114500,1346.75,83.25
"8042","27464","2016",7,7,0,150285.714285714,1671.14285714286,97.1428571428571
"8043","27465","2016",6,6,0,177666.666666667,1970.16666666667,97
"8044","27467","2016",97,71,26,117996.082474227,1471.40206185567,81.4742268041237
"8045","27468","2016",4,4,0,85250,1127,77.25
"8046","27469","2016",35,33,2,145760.571428571,1782.22857142857,83.4
"8047","27470","2016",8,8,0,163687.5,1738.375,100.125
"8048","27471","2016",1,1,0,226800,1350,168
"8049","27472","2016",2,2,0,122500,1177.5,104
"8050","27473","2016",15,15,0,213500,1989.73333333333,111.333333333333
"8051","27474","2016",8,8,0,203608.75,1994.625,109.125
"8052","27476","2016",6,6,0,102750,1010.83333333333,112.5
"8053","27477","2016",4,4,0,278000,2148.25,141.75
"8054","27478","2016",6,6,0,193450,1977.83333333333,110.333333333333
"8055","27480","2016",8,8,0,127450,1893.875,70.5
"8056","27481","2016",5,5,0,217530,1688.6,134
"8057","27482","2016",3,3,0,121000,875,156
"8058","27483","2016",2,2,0,161500,2078.5,77.5
"8059","27485","2016",11,11,0,81136.3636363636,1011.09090909091,74.7272727272727
"8060","27486","2016",13,13,0,172811.538461538,1684.53846153846,102.076923076923
"8061","27487","2016",9,9,0,118344.444444444,1508.88888888889,79.8888888888889
"8062","27488","2016",6,6,0,124891.666666667,1336.83333333333,93.6666666666667
"8063","27489","2016",6,6,0,163758.333333333,1597.83333333333,104.5
"8064","27490","2016",4,4,0,168750,1775,95
"8065","27493","2016",35,35,0,135860.6,1437.97142857143,97.1142857142857
"8066","27495","2016",6,6,0,146158.333333333,1324.66666666667,113.833333333333
"8067","27496","2016",4,4,0,128712.5,1561,86
"8068","27497","2016",8,8,0,177893.75,1514.75,116.125
"8069","27500","2016",17,17,0,141935.294117647,1519.70588235294,95.9411764705882
"8070","27501","2016",1,1,0,215500,2799,77
"8071","27502","2016",29,27,2,89899.1034482759,1151.03448275862,81.551724137931
"8072","27504","2016",8,8,0,185675,1480.625,126
"8073","27505","2016",3,3,0,88975,1225.66666666667,77
"8074","27507","2016",45,40,5,137953.4,1825.57777777778,80.8666666666667
"8075","27508","2016",1,1,0,130000,2031,64
"8076","27511","2016",6,6,0,124541.666666667,1563.33333333333,82.8333333333333
"8077","27514","2016",5,5,0,127340,1339,94.6
"8078","27517","2016",11,11,0,170713.636363636,1927.63636363636,91.8181818181818
"8079","27518","2016",5,5,0,117862,1210.8,102.4
"8080","27521","2016",3,3,0,191261,2611,69.6666666666667
"8081","27524","2016",8,8,0,164375,1381.625,144.375
"8082","27525","2016",6,6,0,235716.666666667,2081.33333333333,112.666666666667
"8083","27527","2016",4,4,0,171750,1414.5,123.5
"8084","27528","2016",24,20,4,171245.833333333,1763.54166666667,97.2083333333333
"8085","27529","2016",6,6,0,174610.833333333,1405,131.166666666667
"8086","27531","2016",1,1,0,82000,901,91
"8087","27533","2016",8,7,1,172759.5,1892.875,91.25
"8088","27534","2016",2,2,0,202000,1478,138.5
"8089","27535","2016",1,1,0,90000,2432,37
"8090","27536","2016",3,3,0,165016.666666667,1684,98.6666666666667
"8091","27537","2016",4,3,1,95375,1222,81.25
"8092","27539","2016",5,5,0,172560,1638.4,108.4
"8093","27540","2016",6,6,0,215858.333333333,1811.83333333333,118
"8094","27543","2016",17,17,0,178208.941176471,1751.64705882353,111.588235294118
"8095","27544","2016",1,1,0,145000,1933,75
"8096","27545","2016",2,2,0,208000,1700,131.5
"8097","27546","2016",1,1,0,120000,1481,81
"8098","27547","2016",10,10,0,151300,1323.7,110.9
"8099","27548","2016",13,13,0,160497.384615385,1580.69230769231,106.538461538462
"8100","27552","2016",2,2,0,107500,1343.5,80
"8101","27553","2016",5,5,0,54600,1104.2,42
"8102","27554","2016",22,20,2,213508.409090909,1942.31818181818,115.045454545455
"8103","27555","2016",4,4,0,179025,1543.75,119.25
"8104","27556","2016",3,3,0,156648.333333333,1444.66666666667,106
"8105","27557","2016",3,3,0,74000,1013.33333333333,72.3333333333333
"8106","27558","2016",1,1,0,216800,2168,100
"8107","27560","2016",4,4,0,194700,2984,75
"8108","27561","2016",10,10,0,189830,1850,119.3
"8109","27562","2016",40,30,10,176528.125,1919.675,92.45
"8110","27563","2016",9,9,0,150855.555555556,1355.77777777778,109.777777777778
"8111","27564","2016",4,4,0,78125,909,86.75
"8112","27565","2016",4,4,0,121000,1161.75,104
"8113","27567","2016",2,2,0,162500,2259,70.5
"8114","27568","2016",2,2,0,158000,1939.5,110.5
"8115","27569","2016",2,2,0,221300,1621.5,135.5
"8116","27572","2016",3,3,0,115000,1524,72.6666666666667
"8117","27577","2016",8,8,0,157712.875,1377.125,107.375
"8118","27578","2016",4,4,0,96250,844.5,115.5
"8119","27580","2016",20,20,0,213055,2018.2,107.2
"8120","27582","2016",12,11,1,162233.333333333,1890.5,93.25
"8121","27584","2016",1,1,0,120000,1846,65
"8122","27586","2016",5,5,0,89500,1099.8,81.2
"8123","27589","2016",7,7,0,195214.285714286,1753,112.285714285714
"8124","27590","2016",4,4,0,70625,1098.25,65.25
"8125","27592","2016",1,1,0,156000,1472,106
"8126","27593","2016",15,15,0,168550,1824.93333333333,95.8666666666667
"8127","27595","2016",8,8,0,153081.25,1477,103.75
"8128","27597","2016",6,6,0,173416.666666667,1990.83333333333,90.1666666666667
"8129","27598","2016",17,17,0,148655.882352941,1625.17647058824,93.8235294117647
"8130","27599","2016",7,7,0,147604.285714286,1393.57142857143,104.714285714286
"8131","27601","2016",10,10,0,185970,1563.6,113.8
"8132","27602","2016",47,47,0,155114.404255319,1570.04255319149,98.4893617021277
"8133","27604","2016",1,1,0,190000,2111,90
"8134","27606","2016",4,3,1,108250,1815.75,62.75
"8135","27608","2016",5,5,0,109600,1254.8,90.6
"8136","27609","2016",10,10,0,152810,1733.6,106.3
"8137","27610","2016",1,1,0,98000,1181,83
"8138","27611","2016",9,9,0,139216.666666667,1650.22222222222,90.2222222222222
"8139","27612","2016",3,3,0,218333.333333333,2079.66666666667,105.666666666667
"8140","27614","2016",3,3,0,123333.333333333,2016,61.6666666666667
"8141","27615","2016",1,1,0,122500,1571,78
"8142","27616","2016",25,25,0,168641.32,1553.32,112.28
"8143","27617","2016",5,5,0,126784,1393.8,97
"8144","27618","2016",5,5,0,118120,1386.8,95
"8145","27620","2016",2,2,0,126100,1702,73.5
"8146","27621","2016",1,1,0,210000,2593,81
"8147","27623","2016",4,4,0,167378.75,2225.5,83.5
"8148","27624","2016",8,8,0,169250,1674.5,107.875
"8149","27625","2016",4,4,0,158000,1613.5,103
"8150","27631","2016",4,4,0,155500,1785,90.75
"8151","27632","2016",3,3,0,114333.333333333,1150.33333333333,108.333333333333
"8152","27633","2016",6,6,0,171166.666666667,1809.16666666667,100.166666666667
"8153","27638","2016",17,17,0,153308.823529412,1527.94117647059,103.647058823529
"8154","27640","2016",2,2,0,111000,1194.5,99.5
"8155","27641","2016",2,2,0,167500,1382,121
"8156","27643","2016",16,15,1,99125,1262.5,85.875
"8157","27644","2016",5,5,0,255400,1793.4,143.4
"8158","27645","2016",3,3,0,147333.333333333,906,157.333333333333
"8159","27646","2016",8,8,0,157125,1695.625,94.75
"8160","27649","2016",9,9,0,126200,1273.33333333333,104.333333333333
"8161","27650","2016",3,3,0,169166.666666667,1591.66666666667,105.333333333333
"8162","27652","2016",2,2,0,140250,1576.5,105.5
"8163","27654","2016",7,7,0,146928.571428571,1540.42857142857,101.714285714286
"8164","27655","2016",10,10,0,169080,1637,99.3
"8165","27656","2016",9,9,0,145272.222222222,1420.44444444444,102.444444444444
"8166","27659","2016",3,3,0,185666.666666667,2219,76.6666666666667
"8167","27660","2016",9,9,0,114000,1153.44444444444,97.4444444444444
"8168","27661","2016",2,2,0,184600,1387.5,130
"8169","27662","2016",3,3,0,117333.333333333,1634.33333333333,70.6666666666667
"8170","27663","2016",2,2,0,163500,1654,100.5
"8171","27664","2016",8,8,0,144750,1475.25,99.25
"8172","27665","2016",8,8,0,122125,1525.5,84.25
"8173","27666","2016",4,4,0,178625,1662,113.5
"8174","27667","2016",1,1,0,146000,1521,96
"8175","27668","2016",7,7,0,180071.428571429,1921.71428571429,99.8571428571429
"8176","27669","2016",4,4,0,156287.5,1496.25,111.25
"8177","27670","2016",10,9,1,168709,1591.2,115.5
"8178","27671","2016",2,2,0,220000,2124,112.5
"8179","27672","2016",4,4,0,96125,1263,74.25
"8180","27674","2016",5,4,1,302422,2173,137.6
"8181","27677","2016",4,4,0,139775,1597.25,81.25
"8182","27678","2016",14,14,0,177285.714285714,1777.42857142857,102.785714285714
"8183","27679","2016",71,56,15,130298.591549296,1443.54929577465,89.2112676056338
"8184","27680","2016",2,2,0,122900,1467,85
"8185","27681","2016",233,128,105,165120.506437768,2135.12446351931,80.2274678111588
"8186","27682","2016",7,7,0,206728.571428571,1849.57142857143,118.285714285714
"8187","27683","2016",1,1,0,131000,1191,110
"8188","27684","2016",11,11,0,183711.090909091,1774.18181818182,111.818181818182
"8189","27685","2016",5,5,0,108400,1393,89.2
"8190","27686","2016",3,3,0,125833.333333333,1840.33333333333,71.3333333333333
"8191","27689","2016",5,5,0,229700,2744.2,94.2
"8192","27690","2016",2,2,0,195000,1797,109.5
"8193","27691","2016",4,4,0,170887.5,2171.5,84.25
"8194","27692","2016",3,3,0,139333.333333333,1232.66666666667,109.666666666667
"8195","27693","2016",9,9,0,207033.333333333,1591.33333333333,155.333333333333
"8196","27694","2016",4,4,0,208225,1735.5,120.75
"8197","27695","2016",2,2,0,137900,1486,94.5
"8198","27696","2016",7,7,0,169788.571428571,1465.28571428571,120.571428571429
"8199","27697","2016",7,7,0,228592.857142857,1728.85714285714,152.142857142857
"8200","27698","2016",3,3,0,138333.333333333,1840,74.3333333333333
"8201","27700","2016",4,4,0,151625,1388.5,124.75
"8202","27701","2016",55,52,3,115379.545454545,1257.25454545455,94.7454545454545
"8203","28001","2016",28,26,2,195711.75,1958.82142857143,105.785714285714
"8204","28003","2016",1,1,0,56500,715,79
"8205","28004","2016",2,2,0,101000,991,101
"8206","28005","2016",9,9,0,89066.6666666667,1023,93.8888888888889
"8207","28006","2016",17,17,0,173269.117647059,1858.70588235294,95.7058823529412
"8208","28007","2016",37,37,0,210517.567567568,1920.10810810811,118.945945945946
"8209","28008","2016",4,4,0,108750,1052.75,115
"8210","28010","2016",4,4,0,84942.5,1023,79.5
"8211","28012","2016",56,56,0,90380.2321428571,1077.625,88.2321428571429
"8212","28013","2016",17,17,0,171976.470588235,1894.29411764706,96.4117647058823
"8213","28014","2016",7,7,0,147128.571428571,1446.28571428571,103
"8214","28015","2016",75,70,5,183469.946666667,1981.46666666667,95.2533333333333
"8215","28016","2016",2,2,0,91500,828,109
"8216","28018","2016",21,21,0,76630.2380952381,937.809523809524,82.7619047619048
"8217","28019","2016",5,5,0,109400,1022.2,114
"8218","28021","2016",15,15,0,138358.733333333,1484,95.0666666666667
"8219","28022","2016",12,12,0,200508.333333333,1762.25,118.666666666667
"8220","28023","2016",14,14,0,206100,1933.07142857143,111.428571428571
"8221","28024","2016",11,11,0,222268.181818182,2183.63636363636,103.545454545455
"8222","28025","2016",1,1,0,65000,1383,47
"8223","28026","2016",5,5,0,141080,1823.8,79.4
"8224","28027","2016",12,12,0,92000,947,109.416666666667
"8225","28028","2016",2,2,0,103750,1279,89
"8226","28029","2016",8,8,0,98312.5,1257,78
"8227","28030","2016",4,4,0,87250,1035.75,94
"8228","28031","2016",4,4,0,123525,904,112.75
"8229","28032","2016",9,9,0,133777.777777778,1220.22222222222,119.111111111111
"8230","28033","2016",10,10,0,108800,1146.8,93.1
"8231","28034","2016",8,8,0,172956.25,1700.75,106.875
"8232","28035","2016",7,7,0,205928.571428571,1663.57142857143,136.285714285714
"8233","28036","2016",18,18,0,225144.722222222,2245.94444444444,104.444444444444
"8234","28037","2016",8,8,0,129625,1269.125,106.625
"8235","28038","2016",1,1,0,97500,4062,24
"8236","28039","2016",22,20,2,170118.363636364,1932.36363636364,90.3636363636364
"8237","28040","2016",6,6,0,226162.5,1451,166.333333333333
"8238","28041","2016",4,4,0,165500,1509,129
"8239","28045","2016",1,1,0,220000,1358,162
"8240","28046","2016",6,6,0,113658.333333333,1400.66666666667,86.3333333333333
"8241","28047","2016",10,10,0,129600,1240.2,104.9
"8242","28048","2016",8,8,0,152970,1501.5,100.375
"8243","28049","2016",1,1,0,136000,1360,100
"8244","28050","2016",3,3,0,252333.333333333,2012,127
"8245","28051","2016",57,52,5,108820.403508772,1363.05263157895,82.2280701754386
"8246","28052","2016",9,9,0,216500,2452,104.888888888889
"8247","28053","2016",1,1,0,130000,1327,98
"8248","28054","2016",6,6,0,178816.666666667,1689,124.166666666667
"8249","28055","2016",7,7,0,194716.857142857,1642.85714285714,126.571428571429
"8250","28056","2016",14,13,1,264356.428571429,2098.35714285714,125.642857142857
"8251","28057","2016",7,7,0,112490.571428571,1284,93.2857142857143
"8252","28058","2016",6,6,0,190000,1839.66666666667,111.5
"8253","28059","2016",15,15,0,102688.933333333,1159.73333333333,91.5333333333333
"8254","28060","2016",3,3,0,142249.666666667,1223,121.333333333333
"8255","28061","2016",51,48,3,99002.9411764706,1227.52941176471,85.2156862745098
"8256","28062","2016",6,5,1,214895.5,2062.16666666667,111.333333333333
"8257","28064","2016",16,15,1,177639.0625,1695.25,106.5625
"8258","28065","2016",1,1,0,48000,667,72
"8259","28067","2016",2,2,0,1e+05,693,144
"8260","28068","2016",3,3,0,194333.333333333,2007.66666666667,99.6666666666667
"8261","28070","2016",46,45,1,225518.043478261,2165.0652173913,107.521739130435
"8262","28071","2016",9,9,0,125169.444444444,1430.44444444444,91.4444444444444
"8263","28072","2016",2,2,0,170000,1043.5,163
"8264","28073","2016",2,2,0,205000,1828,125
"8265","28074","2016",5,5,0,206400,1671.6,127.2
"8266","28075","2016",14,14,0,117594.285714286,1262,94.8571428571429
"8267","28076","2016",1,1,0,220000,2785,79
"8268","28077","2016",2,2,0,191550,1668,112.5
"8269","28078","2016",6,6,0,45916.6666666667,741.166666666667,73.5
"8270","28079","2016",2,2,0,97500,699.5,156
"8271","28080","2016",5,5,0,152300,1150.6,138.2
"8272","28081","2016",3,3,0,75000,1408,53.6666666666667
"8273","28082","2016",9,9,0,154050.444444444,1617.44444444444,105.222222222222
"8274","28084","2016",6,6,0,205535.833333333,2128.5,99.8333333333333
"8275","28085","2016",532,190,342,160325.04887218,2169.8477443609,74.0131578947368
"8276","28086","2016",4,4,0,98387.5,1300.75,94.5
"8277","28088","2016",117,101,16,101441.717948718,1168.74358974359,87.6153846153846
"8278","28089","2016",20,16,4,106270.15,1462.5,72
"8279","28090","2016",2,2,0,142350,1247,115
"8280","28091","2016",2,2,0,177075,1421.5,117.5
"8281","28092","2016",1,1,0,139000,1363,102
"8282","28094","2016",28,26,2,142892.857142857,1946.07142857143,75.2857142857143
"8283","28095","2016",2,2,0,168750,1899,91
"8284","28096","2016",15,13,2,177376.666666667,1944.26666666667,96.1333333333333
"8285","28098","2016",19,19,0,201121.052631579,2137.05263157895,97.6315789473684
"8286","28099","2016",12,12,0,106625,1518.33333333333,71.3333333333333
"8287","28100","2016",4,4,0,197750,2094,94.25
"8288","28102","2016",11,11,0,145190.454545455,1436,102.727272727273
"8289","28103","2016",62,62,0,101163.112903226,1149.37096774194,91.5
"8290","28104","2016",11,11,0,145218.181818182,1657.27272727273,91.5454545454545
"8291","28105","2016",10,10,0,144600,1824.6,81.6
"8292","28106","2016",5,5,0,125600,1041.2,117
"8293","28107","2016",3,3,0,218255,1824.66666666667,118.666666666667
"8294","28108","2016",4,4,0,84250,1266,70
"8295","28109","2016",4,4,0,108250,1484.25,97.75
"8296","28110","2016",43,20,23,196244.534883721,2366.76744186047,83.6976744186046
"8297","28111","2016",5,5,0,131600,1450.8,90.8
"8298","28113","2016",21,17,4,177443.857142857,1972.57142857143,95.2380952380952
"8299","28116","2016",34,33,1,140328.794117647,1590.35294117647,90.9117647058823
"8300","28117","2016",7,7,0,194457.142857143,1482.42857142857,140.857142857143
"8301","28118","2016",4,4,0,197500,1756.25,114
"8302","28119","2016",2,2,0,135357.5,1704.5,79.5
"8303","28120","2016",8,8,0,138437.5,995.875,143
"8304","28121","2016",2,2,0,130000,1182.5,112.5
"8305","28122","2016",16,15,1,163671.875,1727.5625,99.25
"8306","28123","2016",5,5,0,118000,1131.2,102.2
"8307","28124","2016",11,11,0,180095.454545455,1301.45454545455,138.181818181818
"8308","28126","2016",2,2,0,107750,1038,109
"8309","28127","2016",22,21,1,93434.0909090909,1207.63636363636,87.3636363636364
"8310","28128","2016",2,2,0,225250,1334,149.5
"8311","28129","2016",9,9,0,190038.888888889,1888.66666666667,111
"8312","28130","2016",9,9,0,123308.888888889,1361.77777777778,95.4444444444444
"8313","28132","2016",6,6,0,112166.666666667,1092.16666666667,105.833333333333
"8314","28134","2016",270,156,114,122848.159259259,1586.03333333333,79.0444444444445
"8315","28135","2016",18,17,1,261094.444444444,2178.83333333333,131.944444444444
"8316","28136","2016",2,2,0,127610,1036,124
"8317","28137","2016",10,10,0,211005.2,2086.8,102.6
"8318","28139","2016",5,5,0,200784.4,1862.6,116.4
"8319","28140","2016",75,32,43,167461,2385.57333333333,72.2266666666667
"8320","28141","2016",7,7,0,150571.428571429,1399.57142857143,112.571428571429
"8321","28142","2016",2,2,0,93250,1276,73.5
"8322","28143","2016",4,4,0,169925,1690,118.75
"8323","28144","2016",5,5,0,117800,1381.4,88
"8324","28146","2016",18,16,2,254642.222222222,1938.11111111111,141.944444444444
"8325","28147","2016",8,8,0,123112.5,1299.375,100.375
"8326","28148","2016",8,8,0,137424.5,1069.25,129.125
"8327","28149","2016",5,5,0,119100,1218.4,99.6
"8328","28151","2016",3,3,0,80500,1183,74.6666666666667
"8329","28153","2016",2,2,0,99000,979.5,100.5
"8330","28154","2016",19,19,0,182594.736842105,1614.26315789474,118.052631578947
"8331","28155","2016",2,2,0,179000,2373,82.5
"8332","28156","2016",15,15,0,122600,1121.4,111.733333333333
"8333","28157","2016",3,3,0,145500,989.666666666667,161.333333333333
"8334","28158","2016",7,7,0,271185.714285714,2081,133.857142857143
"8335","28159","2016",4,4,0,160625,1378.25,119.25
"8336","28160","2016",9,9,0,155214.333333333,1735.11111111111,92.6666666666667
"8337","28161","2016",4,4,0,62725,919.5,75.75
"8338","28162","2016",3,3,0,171666.666666667,2751.66666666667,79.6666666666667
"8339","28164","2016",13,13,0,159307.692307692,1597.76923076923,105.692307692308
"8340","28166","2016",2,2,0,82000,942.5,75.5
"8341","28167","2016",2,2,0,158500,1332.5,121.5
"8342","28168","2016",35,28,7,149429.714285714,1769.48571428571,88.6571428571429
"8343","28169","2016",4,3,1,243625,2729,97.25
"8344","28170","2016",1,1,0,180000,2000,90
"8345","28171","2016",13,13,0,164588.461538462,1560,111.615384615385
"8346","28172","2016",12,12,0,199089.166666667,2144.08333333333,96.4166666666667
"8347","28173","2016",12,12,0,188259,1771.5,107.75
"8348","28175","2016",4,4,0,112125,1381.25,92.75
"8349","28176","2016",9,9,0,125555.555555556,1110,115.111111111111
"8350","28177","2016",7,7,0,196428.571428571,1937.85714285714,119.714285714286
"8351","28178","2016",6,6,0,215500,1686.83333333333,136.666666666667
"8352","28180","2016",4,4,0,197275,1903,130
"8353","28183","2016",6,6,0,162733.333333333,1480,120.5
"8354","28184","2016",6,6,0,137366.666666667,1453.5,94.6666666666667
"8355","28185","2016",21,19,2,238972.619047619,2553.95238095238,100.47619047619
"8356","28187","2016",5,5,0,214400,1700.8,149.4
"8357","28188","2016",15,15,0,188257.333333333,2119.06666666667,96.4666666666667
"8358","28189","2016",1,1,0,155000,775,200
"8359","28190","2016",2,2,0,102500,748.5,133
"8360","28191","2016",31,29,2,209319.032258065,2188.67741935484,102.161290322581
"8361","28192","2016",4,4,0,73650,1141.75,65.75
"8362","28193","2016",1,1,0,90000,1667,54
"8363","28194","2016",5,5,0,166560,1685.4,101
"8364","28195","2016",5,5,0,201400,2002.8,101.4
"8365","28196","2016",26,26,0,138015,1442.38461538462,98.2307692307692
"8366","28197","2016",4,4,0,145000,2067,76
"8367","28198","2016",8,8,0,133497.5,1312,101.875
"8368","28199","2016",35,32,3,115708.571428571,1346.02857142857,86.2285714285714
"8369","28200","2016",4,4,0,158500,2011.5,91.5
"8370","28201","2016",20,20,0,201725,1991.45,104.9
"8371","28202","2016",6,6,0,119583.333333333,1304.83333333333,90.5
"8372","28203","2016",5,5,0,140600,1808.8,75.2
"8373","28206","2016",3,3,0,76000,903.666666666667,76.6666666666667
"8374","28207","2016",1,1,0,115000,1533,75
"8375","28208","2016",5,5,0,316380,2471.4,127.8
"8376","28209","2016",49,44,5,196297.244897959,2165.48979591837,93.9387755102041
"8377","28210","2016",3,3,0,118666.666666667,1368,94.3333333333333
"8378","28211","2016",4,4,0,135500,1208.25,112.25
"8379","28212","2016",1,1,0,60000,667,90
"8380","28213","2016",12,11,1,180329.166666667,2129.83333333333,88.3333333333333
"8381","28214","2016",31,30,1,100045.161290323,1145.77419354839,89.6774193548387
"8382","28215","2016",5,5,0,121100,1465.2,86.2
"8383","28216","2016",1,1,0,155000,1649,94
"8384","28217","2016",2,2,0,149250,1463.5,101.5
"8385","28218","2016",104,59,45,141158.653846154,1913.82692307692,76.4615384615385
"8386","28219","2016",5,5,0,108500,1188.2,88.6
"8387","28220","2016",70,59,11,201580.714285714,2131.9,98
"8388","28221","2016",2,2,0,71000,807.5,89
"8389","28222","2016",3,3,0,160500,1129,139.333333333333
"8390","28223","2016",13,13,0,161320,1646.61538461538,107.846153846154
"8391","28225","2016",7,7,0,138448.571428571,1544.85714285714,87.7142857142857
"8392","28226","2016",12,12,0,139183.333333333,1196.5,116.5
"8393","28227","2016",61,45,16,184553.737704918,2456.19672131148,76.8032786885246
"8394","28229","2016",87,42,45,145591.896551724,1995.7816091954,74.551724137931
"8395","28230","2016",6,6,0,178166.666666667,1505.83333333333,118.333333333333
"8396","28231","2016",3,3,0,108000,715,152.333333333333
"8397","28232","2016",9,9,0,104677.777777778,1040.11111111111,96.5555555555556
"8398","28233","2016",15,15,0,85229.0666666667,1057.66666666667,82.4666666666667
"8399","28234","2016",4,4,0,121350,1400.75,91.25
"8400","28235","2016",4,4,0,235064.5,2023.25,117
"8401","28236","2016",29,27,2,95917.2413793103,1135.72413793103,83.7241379310345
"8402","28237","2016",2,2,0,116453,1244.5,92
"8403","28239","2016",13,13,0,143807.692307692,1771.84615384615,86.5384615384615
"8404","28240","2016",2,2,0,155000,1115.5,139
"8405","28243","2016",2,2,0,138500,1279.5,110
"8406","28245","2016",5,5,0,178140,1457.8,163
"8407","28246","2016",13,13,0,141364.769230769,1464.30769230769,103.615384615385
"8408","28247","2016",3,3,0,324646.666666667,2665.66666666667,143.333333333333
"8409","28248","2016",6,6,0,102166.666666667,913.333333333333,122.5
"8410","28249","2016",17,17,0,193302.352941176,2018.76470588235,95.5294117647059
"8411","28251","2016",6,6,0,178833.333333333,1579.16666666667,120.5
"8412","28252","2016",5,5,0,153600,1130.8,120.4
"8413","28253","2016",7,5,2,140914.285714286,1530.85714285714,102.571428571429
"8414","28254","2016",12,12,0,131200,1544.66666666667,88.0833333333333
"8415","28255","2016",1,1,0,225000,1243,181
"8416","28256","2016",10,10,0,97920,1030.2,97.4
"8417","28257","2016",1,1,0,175000,1250,140
"8418","28259","2016",5,5,0,69764.4,886,79.8
"8419","28260","2016",1,1,0,50000,658,76
"8420","28261","2016",12,12,0,105268.583333333,1032.75,103.5
"8421","28263","2016",1,1,0,154000,1426,108
"8422","28264","2016",3,3,0,120666.666666667,837.666666666667,134
"8423","28265","2016",3,3,0,76333.3333333333,866,87.3333333333333
"8424","28267","2016",10,10,0,225240,1775.6,126.1
"8425","28269","2016",15,14,1,195686.666666667,1941,103.333333333333
"8426","28270","2016",3,3,0,78333.3333333333,1284,66.3333333333333
"8427","28271","2016",2,2,0,110000,1478,75.5
"8428","28272","2016",2,2,0,145500,1316.5,118.5
"8429","28273","2016",3,3,0,96333.3333333333,1427.66666666667,67.6666666666667
"8430","28274","2016",5,5,0,125900,1739,72.8
"8431","28275","2016",7,7,0,204985.714285714,1616.71428571429,136
"8432","28276","2016",3,3,0,341666.666666667,2016,155.666666666667
"8433","28277","2016",5,5,0,96860.4,923.6,102.8
"8434","28278","2016",13,12,1,208774.615384615,2094.30769230769,117.769230769231
"8435","28279","2016",25,19,6,157606,2117,86.4
"8436","28280","2016",111,87,24,98850.981981982,1146.34234234234,85.981981981982
"8437","28281","2016",2,2,0,164500,2150.5,77.5
"8438","28282","2016",9,9,0,130605.555555556,1649,92.4444444444444
"8439","28283","2016",4,4,0,94400,984.5,100
"8440","28284","2016",5,5,0,134600,1604.6,90.8
"8441","28285","2016",5,5,0,231330,1859.8,124
"8442","28286","2016",9,9,0,105672.222222222,1122.44444444444,92
"8443","28287","2016",13,13,0,110670.769230769,1166.61538461538,103
"8444","28289","2016",1,1,0,210200,1695,124
"8445","28290","2016",8,8,0,142750,1622.25,89.125
"8446","28291","2016",11,11,0,112590.909090909,1456.45454545455,76.8181818181818
"8447","28292","2016",15,15,0,173333.333333333,1702.66666666667,112.6
"8448","28293","2016",18,18,0,196700,1883.38888888889,111.111111111111
"8449","28294","2016",4,4,0,244186,1939,136
"8450","28296","2016",4,4,0,148000,1566.25,92.5
"8451","28298","2016",44,42,2,185054.545454545,2036.38636363636,94
"8452","28299","2016",1,1,0,253100,1875,135
"8453","28300","2016",1,1,0,119000,1352,88
"8454","28301","2016",2,2,0,209000,1982.5,114
"8455","28302","2016",21,20,1,95642.8571428571,1349.7619047619,77.3809523809524
"8456","28303","2016",1,1,0,88000,880,100
"8457","28304","2016",8,8,0,134731.25,1395.25,100.875
"8458","28305","2016",4,4,0,121773,1496.25,81
"8459","28306","2016",2,2,0,118500,1580,75
"8460","28308","2016",1,1,0,116000,758,153
"8461","28309","2016",7,7,0,124000,1358.71428571429,100.714285714286
"8462","28310","2016",2,2,0,135500,1074.5,127.5
"8463","28312","2016",2,2,0,131514.5,1069.5,119.5
"8464","28313","2016",1,1,0,209000,2322,90
"8465","28314","2016",2,2,0,62500,1128,60
"8466","28316","2016",4,4,0,117510,1338.5,88.75
"8467","28317","2016",5,5,0,144400,1810.6,85.4
"8468","28319","2016",6,6,0,198099,1621,128.166666666667
"8469","28321","2016",11,11,0,222264.818181818,1923.81818181818,117.181818181818
"8470","28322","2016",6,6,0,133333.333333333,1066.66666666667,139.5
"8471","28323","2016",5,5,0,170500,1335.2,129.4
"8472","28324","2016",8,8,0,146500,1459.5,101.375
"8473","28325","2016",7,7,0,171078.571428571,1535.28571428571,112
"8474","28326","2016",4,4,0,110125,1573,76.25
"8475","28327","2016",1,1,0,122000,1627,75
"8476","28329","2016",2,2,0,95000,815,112.5
"8477","28330","2016",19,19,0,106711.263157895,1021.63157894737,112.315789473684
"8478","28331","2016",24,24,0,88225,1166.08333333333,78.2083333333333
"8479","28332","2016",8,8,0,216387.5,1601.125,139.375
"8480","28333","2016",2,2,0,105500,968.5,113
"8481","28334","2016",17,17,0,122082.352941176,1434.82352941176,88.1764705882353
"8482","28335","2016",12,12,0,108500,1128,99.1666666666667
"8483","28336","2016",2,2,0,95900,1637.5,61.5
"8484","28337","2016",28,28,0,160392.857142857,1921.89285714286,89.0714285714286
"8485","28339","2016",7,7,0,125000,1123.42857142857,112.428571428571
"8486","28341","2016",2,2,0,164000,1823,93.5
"8487","28342","2016",1,1,0,55000,679,81
"8488","28343","2016",6,6,0,204500,2490.5,95.8333333333333
"8489","28344","2016",3,3,0,209000,1664.33333333333,125.333333333333
"8490","28347","2016",6,6,0,246608.333333333,1980.16666666667,125.666666666667
"8491","28348","2016",38,38,0,136718.894736842,1564.10526315789,91.2105263157895
"8492","28349","2016",6,6,0,378850,2005,214.666666666667
"8493","28350","2016",14,14,0,127071.428571429,1385.78571428571,95
"8494","28351","2016",7,7,0,110142.857142857,1224.85714285714,105.714285714286
"8495","28352","2016",16,16,0,248343.75,1776.5,138.4375
"8496","28353","2016",4,4,0,149000,1563.5,98
"8497","28354","2016",2,2,0,132500,1287,104.5
"8498","28355","2016",2,2,0,253160,1999,129.5
"8499","28357","2016",15,15,0,164886.666666667,1884.86666666667,93.5333333333333
"8500","28358","2016",31,30,1,189039.032258065,1825.38709677419,110.483870967742
"8501","28359","2016",31,30,1,142484.806451613,1440.74193548387,101.903225806452
"8502","28360","2016",11,11,0,136909.090909091,1444.18181818182,101
"8503","28362","2016",6,6,0,97333.3333333333,1075.66666666667,97.8333333333333
"8504","28363","2016",8,8,0,174750,1826.25,102.625
"8505","28364","2016",13,13,0,90846.1538461538,1251.69230769231,74.3846153846154
"8506","28365","2016",2,2,0,176000,1587.5,110
"8507","28366","2016",6,6,0,142250,1860.5,81.1666666666667
"8508","28367","2016",1,1,0,46000,730,63
"8509","28368","2016",1,1,0,115000,966,119
"8510","28369","2016",6,6,0,156166.666666667,1564.16666666667,99.1666666666667
"8511","28370","2016",8,8,0,111602.5,1402,92.375
"8512","28371","2016",10,8,2,145810,1826.3,83.3
"8513","28372","2016",9,9,0,246822.222222222,1860.11111111111,138.222222222222
"8514","28373","2016",51,49,2,100495.980392157,1129.70588235294,93.6274509803922
"8515","28374","2016",5,5,0,136166.8,1505,89
"8516","28375","2016",7,7,0,179357.142857143,1559.85714285714,113.428571428571
"8517","28377","2016",42,41,1,164060.5,1800.19047619048,96.6190476190476
"8518","28378","2016",8,8,0,98562.5,970.75,111.75
"8519","28379","2016",4,4,0,193000,1827.75,111.5
"8520","28380","2016",27,27,0,184964.296296296,1781.81481481481,103.814814814815
"8521","28382","2016",9,9,0,147586.666666667,1755.33333333333,76.7777777777778
"8522","28383","2016",7,7,0,129035.714285714,1143,111
"8523","28385","2016",4,4,0,158375,1731,93.75
"8524","28386","2016",26,26,0,128245,1422.84615384615,93.1153846153846
"8525","28387","2016",9,9,0,101055.555555556,1062.33333333333,94.7777777777778
"8526","28388","2016",10,10,0,175930,2039.1,94.7
"8527","28389","2016",6,6,0,95666.6666666667,1028.5,95.3333333333333
"8528","28390","2016",4,4,0,115875,1715.75,68
"8529","28391","2016",26,22,4,120463.461538462,1429.23076923077,87.5769230769231
"8530","28392","2016",4,4,0,139250,1750,87.25
"8531","28393","2016",37,37,0,139261.486486486,1442.24324324324,98.7027027027027
"8532","28394","2016",15,15,0,144076.666666667,1749.46666666667,85.4
"8533","28395","2016",5,5,0,151835,1528,100.4
"8534","28396","2016",4,4,0,114643.75,1111.75,103.75
"8535","28397","2016",6,6,0,165583.333333333,2021,97.6666666666667
"8536","28398","2016",16,16,0,109396.9375,1569.875,72.375
"8537","28400","2016",4,4,0,112625,1271,89
"8538","28401","2016",5,5,0,135196,1150.8,126.2
"8539","28403","2016",8,8,0,251300,1757,131.5
"8540","28404","2016",104,92,12,143661.951923077,1769.29807692308,84.6442307692308
"8541","28405","2016",11,11,0,125824.545454545,1551.09090909091,86
"8542","28406","2016",26,26,0,126395.961538462,1292.03846153846,103.346153846154
"8543","28407","2016",3,3,0,115866.666666667,1346,80.3333333333333
"8544","28408","2016",1,1,0,232000,1241,187
"8545","28409","2016",6,6,0,128333.333333333,1358.66666666667,103.333333333333
"8546","28410","2016",5,5,0,99940,754.6,126.2
"8547","28411","2016",1,1,0,75000,1210,62
"8548","28414","2016",1,1,0,138000,1468,94
"8549","28415","2016",35,33,2,153757.142857143,1749.54285714286,91.0571428571429
"8550","28417","2016",19,19,0,216394.736842105,2160.36842105263,101.526315789474
"8551","28418","2016",5,5,0,170296,2780.2,56
"8552","28419","2016",3,3,0,123766.666666667,1583.33333333333,80.3333333333333
"8553","28421","2016",3,3,0,182500,1938,95.6666666666667
"8554","28422","2016",49,46,3,114508.979591837,1373.14285714286,85.6326530612245
"8555","28423","2016",9,9,0,165777.777777778,1959.22222222222,87.5555555555556
"8556","28424","2016",22,22,0,114950.590909091,1421.36363636364,82.5454545454545
"8557","28425","2016",8,8,0,164577.5,2034.625,82.75
"8558","28426","2016",3,3,0,147000,1475,101.666666666667
"8559","29001","2016",5,5,0,122601.2,1366.8,104
"8560","29002","2016",11,10,1,148749.545454545,1425.90909090909,104.636363636364
"8561","29003","2016",74,60,14,130430.283783784,1511.2972972973,89.972972972973
"8562","29004","2016",65,65,0,115098.153846154,1196.50769230769,98.5230769230769
"8563","29005","2016",10,10,0,146550,1792.9,82.2
"8564","29006","2016",83,36,47,170196.686746988,2406.59036144578,71.1204819277108
"8565","29007","2016",14,14,0,105745.785714286,1183.21428571429,91.0714285714286
"8566","29008","2016",7,7,0,127428.571428571,1592.28571428571,87.8571428571429
"8567","29010","2016",7,7,0,119365,1285.85714285714,90.5714285714286
"8568","29011","2016",15,14,1,216363.333333333,1656.53333333333,127.666666666667
"8569","29012","2016",1,1,0,80000,833,96
"8570","29013","2016",7,7,0,73491.4285714286,840,92.4285714285714
"8571","29014","2016",8,7,1,69000,786,88
"8572","29015","2016",39,37,2,157216.666666667,1474.97435897436,109.179487179487
"8573","29016","2016",15,15,0,77244.8666666667,941.533333333333,85.7333333333333
"8574","29017","2016",7,7,0,127607.142857143,1293.85714285714,97.5714285714286
"8575","29018","2016",5,5,0,74910,981.6,91
"8576","29019","2016",2430,613,1817,102904.394238683,1410.42139917695,72.2987654320988
"8577","29020","2016",62,61,1,132672.677419355,1317,106.58064516129
"8578","29021","2016",23,23,0,140717.173913043,1276.95652173913,112.086956521739
"8579","29022","2016",56,52,4,133771.196428571,1451.875,97.3392857142857
"8580","29023","2016",50,36,14,220541.78,2190.84,97.28
"8581","29024","2016",98,88,10,89603.2653061225,1067.45918367347,87.8877551020408
"8582","29025","2016",12,12,0,99700,1170,82.25
"8583","29026","2016",45,40,5,90567.7777777778,970.244444444444,99.4222222222222
"8584","29027","2016",36,36,0,98847.5,993.333333333333,101.444444444444
"8585","29028","2016",15,15,0,112366.666666667,1146.8,106.733333333333
"8586","29029","2016",12,12,0,75879.1666666667,1044.5,73.8333333333333
"8587","29030","2016",50,49,1,117839.96,1386.12,95.18
"8588","29031","2016",87,70,17,176860.701149425,2231.68965517241,84.8505747126437
"8589","29032","2016",30,30,0,235707.666666667,1936.6,127.5
"8590","29033","2016",7,7,0,71571.4285714286,956,76.5714285714286
"8591","29034","2016",13,13,0,87170,926.461538461538,96.6153846153846
"8592","29035","2016",7,7,0,166042.857142857,1703.71428571429,100.857142857143
"8593","29036","2016",15,14,1,60233.3333333333,640.4,95.7333333333333
"8594","29037","2016",49,47,2,198307.020408163,2173.97959183673,97.6530612244898
"8595","29038","2016",10,10,0,121435,1152.6,110.1
"8596","29039","2016",319,193,126,158824.620689655,1934.8934169279,83.2037617554859
"8597","29040","2016",56,47,9,135026.678571429,1852.96428571429,77.1428571428571
"8598","29041","2016",12,12,0,99062.5,1096.66666666667,95.25
"8599","29042","2016",121,95,26,156259.950413223,1943.48760330579,86.8512396694215
"8600","29043","2016",21,20,1,160454.761904762,1566.90476190476,105.857142857143
"8601","29044","2016",9,9,0,97078.5555555556,967,100.555555555556
"8602","29045","2016",11,11,0,163646.363636364,1530.81818181818,107.909090909091
"8603","29046","2016",196,141,55,117588.265306122,1349.95408163265,88.3367346938775
"8604","29047","2016",19,19,0,126544.473684211,1137.15789473684,115.421052631579
"8605","29048","2016",18,17,1,118352.777777778,1199.55555555556,95
"8606","29049","2016",31,31,0,121649.193548387,1177.06451612903,100.58064516129
"8607","29051","2016",53,47,6,150380.528301887,1489.90566037736,102.641509433962
"8608","29053","2016",29,29,0,121043.965517241,1262.24137931034,98.9655172413793
"8609","29054","2016",12,12,0,70933.3333333333,1256.75,65.75
"8610","29055","2016",31,30,1,133622.580645161,1286,104.193548387097
"8611","29056","2016",26,25,1,159423.846153846,1460.88461538462,109.461538461538
"8612","29057","2016",38,25,13,209077.578947368,2321.52631578947,95.9473684210526
"8613","29058","2016",177,149,28,213038.242937853,2242.5593220339,98.3389830508475
"8614","29059","2016",7,7,0,122367.142857143,1216,97.2857142857143
"8615","29060","2016",53,51,2,214492.320754717,1802.11320754717,119.943396226415
"8616","29061","2016",66,64,2,193420.984848485,1828.0303030303,106.030303030303
"8617","29062","2016",5,5,0,72127.2,810.6,93.8
"8618","29063","2016",11,11,0,92018.1818181818,1333.18181818182,80.9090909090909
"8619","29064","2016",8,8,0,92686.25,1315.125,70.125
"8620","29065","2016",11,10,1,140136.363636364,1746.72727272727,89.1818181818182
"8621","29066","2016",8,8,0,190125,1476.375,119.375
"8622","29067","2016",11,11,0,66054.5454545455,860.727272727273,78.9090909090909
"8623","29068","2016",21,20,1,117595.238095238,1158.95238095238,102
"8624","29069","2016",67,62,5,159630.089552239,1629.91044776119,100.477611940299
"8625","29070","2016",1,1,0,163378,1361,120
"8626","29071","2016",7,7,0,119142.857142857,1018.85714285714,113.428571428571
"8627","29072","2016",73,67,6,123174.109589041,1446.06849315068,85.6712328767123
"8628","29073","2016",12,12,0,143022.666666667,1713.91666666667,87
"8629","29074","2016",8,8,0,101237.5,1048.25,97.125
"8630","29075","2016",134,121,13,173351.462686567,1702.94776119403,102.134328358209
"8631","29076","2016",30,30,0,172729.333333333,1725.23333333333,101.833333333333
"8632","29077","2016",30,30,0,135283.333333333,1319.56666666667,104.133333333333
"8633","29078","2016",23,23,0,116903.043478261,1495.86956521739,95.4347826086957
"8634","29079","2016",15,15,0,145911.666666667,1379.66666666667,105.666666666667
"8635","29080","2016",26,26,0,149351.961538462,1551.38461538462,95.7692307692308
"8636","29081","2016",28,26,2,84139.2857142857,1023.25,85.6428571428571
"8637","29082","2016",10,10,0,228775,2966.5,74.8
"8638","29085","2016",20,14,6,189780,2846.4,78.15
"8639","29086","2016",15,15,0,150590.6,1449.86666666667,110.266666666667
"8640","29087","2016",6,6,0,139000,1160,120.666666666667
"8641","29089","2016",7,7,0,95042.8571428571,1120.28571428571,85
"8642","29090","2016",5,5,0,185000,1399.8,122.4
"8643","29091","2016",29,29,0,121277.586206897,1447.62068965517,89.1724137931034
"8644","29093","2016",7,7,0,123714.285714286,1312.71428571429,91.8571428571429
"8645","29094","2016",8,8,0,120537.5,1319.75,94.75
"8646","29095","2016",6,6,0,194916.666666667,1479.33333333333,131.166666666667
"8647","29097","2016",10,10,0,120525,1212,103.1
"8648","29098","2016",33,31,2,156202,1927.45454545455,86.5151515151515
"8649","29099","2016",8,8,0,167062.5,1633,103
"8650","29100","2016",1,1,0,173000,1802,96
"8651","29101","2016",36,28,8,151916.388888889,1617.44444444444,94.2222222222222
"8652","29102","2016",16,16,0,82353.75,948.1875,89.25
"8653","29103","2016",207,139,68,123663.816425121,1446.19323671498,86.024154589372
"8654","29104","2016",6,6,0,143166.666666667,1351.33333333333,118.833333333333
"8655","29105","2016",103,91,12,116199.349514563,1235.87378640777,93.4660194174757
"8656","29106","2016",12,11,1,142841.25,1479.33333333333,96.4166666666667
"8657","29107","2016",7,7,0,137508.571428571,1282.71428571429,106.428571428571
"8658","29108","2016",10,10,0,135500,1198.7,111.1
"8659","29109","2016",20,20,0,191016.2,1734.9,108.65
"8660","29110","2016",10,10,0,118150,1199.5,108.6
"8661","29111","2016",18,17,1,118872.222222222,1116.38888888889,111.333333333333
"8662","29112","2016",16,15,1,198312.5,1820.5,108.8125
"8663","29113","2016",17,17,0,123804.117647059,1338.47058823529,104.352941176471
"8664","29114","2016",2,2,0,85000,841.5,101
"8665","29115","2016",3,3,0,80000,575,137.666666666667
"8666","29117","2016",56,52,4,128503.035714286,1346.375,97.1428571428571
"8667","29119","2016",14,14,0,150400,1544.71428571429,100.285714285714
"8668","29120","2016",24,21,3,112625,1128.625,97.1666666666667
"8669","29122","2016",13,13,0,109615.384615385,1255.61538461538,91.6153846153846
"8670","29123","2016",4,4,0,116250,1330.5,85.5
"8671","29124","2016",102,77,25,113456.264705882,1295.67647058824,90.4509803921569
"8672","29125","2016",5,5,0,82604,834.4,99.4
"8673","29126","2016",2,2,0,149000,1475.5,102
"8674","29130","2016",42,40,2,203072.5,1894.19047619048,108.190476190476
"8675","29131","2016",2,2,0,101500,818,124
"8676","29132","2016",9,9,0,118243.333333333,1259.55555555556,94.3333333333333
"8677","29133","2016",24,21,3,167968.75,2020.25,86.125
"8678","29134","2016",8,8,0,147062.5,1939.125,74.375
"8679","29135","2016",69,65,4,169867.188405797,1798.71014492754,98.9710144927536
"8680","29136","2016",9,9,0,138592.222222222,1231,105.555555555556
"8681","29137","2016",31,31,0,141143.387096774,1483.61290322581,99.6451612903226
"8682","29139","2016",8,8,0,157925,1369.375,124.625
"8683","29140","2016",31,31,0,174323.322580645,1567.38709677419,113.096774193548
"8684","29141","2016",3,3,0,79000,942.666666666667,82.6666666666667
"8685","29142","2016",6,6,0,128916.666666667,1208.5,104.833333333333
"8686","29143","2016",9,9,0,117171.111111111,976.111111111111,122.444444444444
"8687","29144","2016",6,6,0,139783.333333333,1296.33333333333,109.5
"8688","29145","2016",7,7,0,146285.714285714,1411.42857142857,100.142857142857
"8689","29146","2016",26,26,0,132668.846153846,1277.5,108.653846153846
"8690","29147","2016",29,27,2,158721.034482759,1547.51724137931,105.413793103448
"8691","29148","2016",5,5,0,127962,1125.8,111
"8692","29150","2016",109,99,10,160924.082568807,1780.44036697248,94.7706422018349
"8693","29151","2016",200,124,76,87184.095,1067.705,80.76
"8694","29152","2016",5,5,0,88840,876.2,88.4
"8695","29153","2016",80,78,2,193657.2125,1915.375,103.375
"8696","29155","2016",12,12,0,176750,1981.75,91.75
"8697","29156","2016",18,16,2,162200,1551.44444444444,108.777777777778
"8698","29158","2016",114,104,10,136979.105263158,1406.80701754386,97.1052631578947
"8699","29159","2016",5,5,0,78000,728.2,103.4
"8700","29160","2016",84,82,2,145764.166666667,1515.75,97.5833333333333
"8701","29161","2016",11,11,0,192011.272727273,1771.09090909091,114.636363636364
"8702","29162","2016",34,34,0,108495.735294118,1068.67647058824,100.735294117647
"8703","29163","2016",40,39,1,101522.7,1034.275,97.25
"8704","29165","2016",50,48,2,156265.98,1513.2,104.28
"8705","29166","2016",9,8,1,133164.444444444,1734.77777777778,101.555555555556
"8706","29167","2016",14,14,0,115750,1215.07142857143,100.714285714286
"8707","29168","2016",21,21,0,105332.857142857,1130.61904761905,93.1904761904762
"8708","29169","2016",21,21,0,151088.095238095,1359.47619047619,112.952380952381
"8709","29170","2016",26,25,1,153401.961538462,1447.61538461538,103.076923076923
"8710","29171","2016",32,31,1,162704.375,1693.9375,103.625
"8711","29172","2016",33,28,5,136336.393939394,1483.81818181818,99.9090909090909
"8712","29173","2016",24,24,0,152000,1418.95833333333,109.708333333333
"8713","29174","2016",55,55,0,148979.763636364,1410.4,107.218181818182
"8714","29175","2016",29,29,0,93519.3103448276,889.758620689655,104.551724137931
"8715","29176","2016",26,26,0,138715.384615385,1382.80769230769,101.461538461538
"8716","29177","2016",42,42,0,179648.976190476,1857.38095238095,101.952380952381
"8717","29178","2016",97,92,5,157855.773195876,1595.0618556701,102.134020618557
"8718","29179","2016",27,27,0,114937.888888889,1242.51851851852,89.5555555555556
"8719","29180","2016",9,9,0,117605.555555556,1090.44444444444,109.111111111111
"8720","29181","2016",35,34,1,152700.742857143,1416.77142857143,110.314285714286
"8721","29182","2016",9,9,0,92688.8888888889,963.666666666667,96
"8722","29183","2016",4,4,0,63250,698.25,89
"8723","29184","2016",20,20,0,96300,1182.75,86.95
"8724","29185","2016",67,65,2,110100.447761194,1195.77611940299,98.4328358208955
"8725","29186","2016",15,15,0,199686.666666667,1631.13333333333,123.2
"8726","29187","2016",4,4,0,131600,1323.5,112.75
"8727","29188","2016",61,57,4,186691.393442623,1757.85245901639,102.426229508197
"8728","29189","2016",126,114,12,206719.063492063,1903.9126984127,107.388888888889
"8729","29190","2016",64,47,17,171302.921875,1845.515625,91.515625
"8730","29191","2016",34,34,0,109540.352941176,1094.47058823529,97.7941176470588
"8731","29192","2016",20,20,0,144415,1406.5,105
"8732","29193","2016",12,12,0,111208.333333333,1086.41666666667,106.25
"8733","29195","2016",101,99,2,149653.564356436,1620.46534653465,95.039603960396
"8734","29196","2016",19,17,2,120927.210526316,1272.36842105263,95.7368421052632
"8735","29197","2016",64,63,1,144210.4375,1433.71875,99.09375
"8736","29198","2016",14,14,0,142151.357142857,1281.92857142857,110.142857142857
"8737","29199","2016",50,50,0,112511,1250.3,90.74
"8738","29201","2016",26,25,1,161794.230769231,1537.34615384615,108.730769230769
"8739","29202","2016",13,13,0,83865.3846153846,926.846153846154,94.4615384615385
"8740","29204","2016",21,21,0,139354.761904762,1421.95238095238,104.047619047619
"8741","29205","2016",8,8,0,114593.75,1114,102.25
"8742","29206","2016",35,35,0,105761.428571429,1035.28571428571,105.742857142857
"8743","29207","2016",47,44,3,103100.489361702,1114.97872340426,96.0212765957447
"8744","29208","2016",7,7,0,159142.857142857,1315,129.285714285714
"8745","29209","2016",35,33,2,134623.457142857,1447.57142857143,96.0571428571429
"8746","29210","2016",25,25,0,90768,914.36,103.32
"8747","29211","2016",11,11,0,53341.7272727273,682.636363636364,76.7272727272727
"8748","29212","2016",108,103,5,171289.916666667,1655.88888888889,104.898148148148
"8749","29213","2016",16,16,0,111882,1160.8125,98.3125
"8750","29214","2016",8,8,0,138125,1320.625,119.25
"8751","29215","2016",42,41,1,143372.928571429,1367.57142857143,106.571428571429
"8752","29216","2016",37,37,0,176574.864864865,1608.91891891892,110.297297297297
"8753","29217","2016",44,40,4,117984.818181818,1476.70454545455,84.2954545454545
"8754","29218","2016",20,20,0,98620,1050.6,103.8
"8755","29220","2016",124,93,31,134007.322580645,1539.93548387097,86.3145161290323
"8756","29221","2016",23,23,0,163717.391304348,1700.13043478261,101.826086956522
"8757","29222","2016",6,6,0,101068.333333333,1050.5,96
"8758","29224","2016",10,10,0,110850,965.2,122.4
"8759","29225","2016",36,36,0,118674.972222222,1234.05555555556,100.305555555556
"8760","29226","2016",7,7,0,146726.857142857,1247.71428571429,117.571428571429
"8761","29227","2016",26,26,0,71986.9615384615,961.192307692308,78.9615384615385
"8762","29228","2016",18,18,0,123361.388888889,1305.22222222222,98.7777777777778
"8763","29229","2016",7,7,0,94714.2857142857,1082.57142857143,87
"8764","29230","2016",16,16,0,95046.875,1138.25,91.5625
"8765","29232","2016",1202,573,629,117251.193011647,1473.35607321131,78.9043261231281
"8766","29233","2016",131,100,31,134721.687022901,1458.16030534351,94.6106870229008
"8767","29234","2016",16,16,0,188661.4375,1785.0625,108.0625
"8768","29235","2016",133,100,33,173982.977443609,1875.73684210526,92.4436090225564
"8769","29236","2016",53,53,0,171504.283018868,1708.39622641509,105.264150943396
"8770","29237","2016",16,16,0,136756.25,1392.75,94.5
"8771","29238","2016",24,24,0,147945.125,1818.5,86
"8772","29239","2016",76,51,25,160878.289473684,1916.90789473684,89.8289473684211
"8773","29240","2016",15,15,0,173897.333333333,1542,113.466666666667
"8774","29241","2016",86,79,7,113708.325581395,1230.47674418605,94.6744186046512
"8775","29243","2016",6,6,0,70500,909.833333333333,77.8333333333333
"8776","29244","2016",8,8,0,109984.375,1025.25,104.25
"8777","29245","2016",10,10,0,147002,1480.7,101.7
"8778","29246","2016",1,1,0,122000,1326,92
"8779","29247","2016",24,23,1,176030.541666667,1738.58333333333,105.958333333333
"8780","29248","2016",6,6,0,121741.666666667,1264.83333333333,98.6666666666667
"8781","29249","2016",11,11,0,49136.3636363636,651.636363636364,71.9090909090909
"8782","29250","2016",11,11,0,53200,807.454545454545,67.8181818181818
"8783","29251","2016",13,13,0,126795.076923077,1196.23076923077,106.923076923077
"8784","29252","2016",14,14,0,136385.714285714,1352.57142857143,101.428571428571
"8785","29254","2016",45,43,2,104301.733333333,1163.46666666667,91.8666666666667
"8786","29255","2016",5,5,0,166286,1513.2,110.6
"8787","29256","2016",17,8,9,101417.647058824,1928.35294117647,64.0588235294118
"8788","29257","2016",18,18,0,133222.222222222,1379.11111111111,96.5555555555556
"8789","29259","2016",98,84,14,127840.918367347,1362.90816326531,94.6224489795918
"8790","29260","2016",89,74,15,160329.887640449,1686.59550561798,96.752808988764
"8791","29261","2016",2,2,0,45611.5,772.5,83
"8792","29262","2016",4,4,0,136250,1061.75,129.25
"8793","29263","2016",16,16,0,122741.5625,1179.375,106.375
"8794","29264","2016",3,3,0,110333.333333333,882,127.666666666667
"8795","29265","2016",8,8,0,141425,1194.875,124.125
"8796","29266","2016",37,37,0,110059.459459459,1075.83783783784,106.189189189189
"8797","29267","2016",7,7,0,75785.7142857143,1104.85714285714,81.8571428571429
"8798","29268","2016",11,11,0,209368.545454545,1932.81818181818,114
"8799","29269","2016",15,15,0,82970,970.4,87.2
"8800","29270","2016",20,20,0,159720.5,1462.25,111.95
"8801","29271","2016",7,6,1,111285.714285714,1053.85714285714,110.714285714286
"8802","29272","2016",24,24,0,150428,1315.375,121.958333333333
"8803","29273","2016",30,30,0,205109.666666667,1805.46666666667,114.7
"8804","29274","2016",58,57,1,93570.4482758621,1021.55172413793,92.3620689655172
"8805","29275","2016",23,23,0,73082.6086956522,881.608695652174,76.695652173913
"8806","29276","2016",14,14,0,132142.857142857,1576.85714285714,86.1428571428571
"8807","29277","2016",24,24,0,99104.1666666667,1011.54166666667,98.2916666666667
"8808","29278","2016",27,27,0,90675.9259259259,945.444444444444,94.4814814814815
"8809","29279","2016",28,28,0,118876.785714286,1218.92857142857,101.321428571429
"8810","29280","2016",32,31,1,154742.65625,1499.4375,103.03125
"8811","29281","2016",12,12,0,119413.333333333,1251.58333333333,94.5
"8812","29282","2016",9,9,0,149138.888888889,1436.77777777778,108.555555555556
"8813","29284","2016",35,35,0,144935.714285714,1501.31428571429,101.485714285714
"8814","29285","2016",3,3,0,95000,959.333333333333,100.666666666667
"8815","29287","2016",15,15,0,116900,1169.93333333333,104.466666666667
"8816","29288","2016",6,6,0,140318.333333333,1516.5,92.8333333333333
"8817","29289","2016",1,1,0,99203,973,102
"8818","29290","2016",5,5,0,97800,1097.4,94.8
"8819","29291","2016",11,11,0,82890.9090909091,881.454545454545,93.7272727272727
"8820","29292","2016",4,3,1,143750,2612.75,57.5
"8821","29293","2016",86,76,10,162409.174418605,1786.56976744186,94.5581395348837
"8822","29294","2016",11,11,0,105818.181818182,1019.27272727273,108.909090909091
"8823","29295","2016",6,6,0,143666.833333333,1262.66666666667,116.833333333333
"8824","29296","2016",5,5,0,130647.2,1997.8,69.4
"8825","29297","2016",24,23,1,144635.041666667,1551.16666666667,97.75
"8826","29298","2016",4,4,0,178985,1577,112.25
"8827","29299","2016",1,1,0,168500,1560,108
"8828","29300","2016",10,10,0,146414,1452.3,102.4
"8829","29301","2016",1,1,0,124150,1379,90
"8830","29302","2016",47,46,1,96649.5744680851,1061,90.7872340425532
"8831","2A001","2016",20,13,7,302489.5,2574.1,117.6
"8832","2A004","2016",648,28,620,216018.273148148,3057.47685185185,71.6867283950617
"8833","2A006","2016",17,16,1,363879,3500.23529411765,113.647058823529
"8834","2A008","2016",38,16,22,393381.421052632,4519.81578947368,91.3684210526316
"8835","2A017","2016",7,6,1,219841.714285714,4353.42857142857,59.1428571428571
"8836","2A018","2016",1,1,0,240000,2824,85
"8837","2A021","2016",1,0,1,38000,1267,30
"8838","2A024","2016",3,3,0,50700,761,67
"8839","2A026","2016",2,2,0,204250,2613,80
"8840","2A027","2016",1,1,0,90000,2195,41
"8841","2A028","2016",2,1,1,98750,1775,55
"8842","2A031","2016",4,4,0,147500,1807.75,74.25
"8843","2A032","2016",12,10,2,297831.333333333,3317.33333333333,93.0833333333333
"8844","2A035","2016",1,1,0,249736,3568,70
"8845","2A040","2016",6,3,3,98166.6666666667,2536.5,45.3333333333333
"8846","2A041","2016",30,12,18,455347.833333333,4639.63333333333,88
"8847","2A048","2016",15,7,8,281498.2,3740.26666666667,85.8
"8848","2A056","2016",1,0,1,20000,1000,20
"8849","2A060","2016",1,1,0,180000,1607,112
"8850","2A061","2016",1,1,0,140000,1772,79
"8851","2A062","2016",4,4,0,139500,2244.5,64.75
"8852","2A065","2016",16,10,6,274599.25,4822.8125,75.6875
"8853","2A070","2016",9,1,8,163001.111111111,3857.55555555556,45.1111111111111
"8854","2A071","2016",1,0,1,135000,3140,43
"8855","2A085","2016",18,9,9,259486.777777778,3172.33333333333,81.7222222222222
"8856","2A089","2016",3,1,2,49000,1370,44.6666666666667
"8857","2A090","2016",7,5,2,218195.285714286,3267,67.7142857142857
"8858","2A091","2016",1,1,0,88800,1153,77
"8859","2A092","2016",9,5,4,201461.666666667,3861.44444444444,52.7777777777778
"8860","2A098","2016",17,13,4,774449.117647059,4737.23529411765,136.117647058824
"8861","2A099","2016",1,1,0,95000,594,160
"8862","2A103","2016",11,10,1,289761,3303.27272727273,91.1818181818182
"8863","2A104","2016",4,4,0,327550,2626.75,119.75
"8864","2A108","2016",4,3,1,69500,930.75,65.75
"8865","2A114","2016",12,9,3,214946.666666667,2430.41666666667,92
"8866","2A118","2016",1,1,0,60000,667,90
"8867","2A119","2016",1,0,1,22000,1100,20
"8868","2A127","2016",1,1,0,40000,952,42
"8869","2A128","2016",1,0,1,60000,1714,35
"8870","2A130","2016",73,20,53,259021.356164384,4502.16438356164,58.958904109589
"8871","2A131","2016",1,1,0,125000,1050,119
"8872","2A132","2016",1,0,1,30500,610,50
"8873","2A133","2016",1,1,0,81000,1446,56
"8874","2A139","2016",19,9,10,554934.315789474,5823.84210526316,78.6315789473684
"8875","2A141","2016",1,1,0,15000,375,40
"8876","2A142","2016",2,1,1,82000,1492,49.5
"8877","2A154","2016",4,3,1,77250,1251.25,70.75
"8878","2A160","2016",1,1,0,1e+05,1887,53
"8879","2A163","2016",5,3,2,83950,1621.4,61
"8880","2A181","2016",1,1,0,320000,2078,154
"8881","2A186","2016",5,4,1,167960,1910.6,89
"8882","2A189","2016",10,5,5,322700,2936.3,97.2
"8883","2A196","2016",2,2,0,43500,995,45
"8884","2A197","2016",1,0,1,17000,531,32
"8885","2A198","2016",1,0,1,15708,714,22
"8886","2A200","2016",2,1,1,80000,1185,77.5
"8887","2A203","2016",1,0,1,95000,2375,40
"8888","2A204","2016",4,3,1,35000,805,43
"8889","2A209","2016",6,6,0,304818.166666667,2818.83333333333,107.666666666667
"8890","2A211","2016",5,2,3,183800,1548,91.2
"8891","2A212","2016",4,4,0,479750,4335.25,97
"8892","2A215","2016",7,5,2,285417.142857143,4209.57142857143,72
"8893","2A228","2016",21,18,3,630956.904761905,5381.47619047619,117.380952380952
"8894","2A232","2016",1,0,1,55000,1146,48
"8895","2A240","2016",1,0,1,90000,1452,62
"8896","2A247","2016",146,74,72,404197.493150685,4426.37671232877,88.6780821917808
"8897","2A249","2016",43,10,33,233075.11627907,3390.86046511628,65.3488372093023
"8898","2A254","2016",2,1,1,26000,866.5,30.5
"8899","2A268","2016",1,1,0,30000,545,55
"8900","2A269","2016",15,6,9,214605.933333333,2417.4,88.2
"8901","2A270","2016",1,1,0,60000,600,100
"8902","2A271","2016",23,12,11,235218.043478261,3001.60869565217,81.1304347826087
"8903","2A272","2016",18,4,14,198780.555555556,2290.5,78.2777777777778
"8904","2A276","2016",5,3,2,362536,4019.6,80
"8905","2A278","2016",2,0,2,85455,1344,61.5
"8906","2A279","2016",2,2,0,280000,2518.5,129
"8907","2A282","2016",1,1,0,80000,1667,48
"8908","2A288","2016",6,6,0,252133.333333333,2684.16666666667,95.1666666666667
"8909","2A295","2016",2,2,0,240000,3214.5,72
"8910","2A300","2016",12,12,0,290249.5,3486.83333333333,91.75
"8911","2A308","2016",3,2,1,300198.333333333,1913.33333333333,107
"8912","2A310","2016",1,1,0,373900,2991,125
"8913","2A312","2016",3,3,0,258900,2313.33333333333,112.333333333333
"8914","2A323","2016",2,2,0,210500,2705,85.5
"8915","2A324","2016",5,4,1,139520,2357,53.2
"8916","2A326","2016",2,1,1,60000,2781,23
"8917","2A330","2016",8,4,4,107318.75,1697.625,68
"8918","2A336","2016",4,4,0,220242.5,2721.25,91
"8919","2A345","2016",4,2,2,152000,2279,65.25
"8920","2A348","2016",10,2,8,220338.6,2918.8,76.8
"8921","2A349","2016",2,2,0,413150,3380,118
"8922","2A351","2016",2,2,0,450701,3323.5,137
"8923","2A357","2016",1,0,1,80000,2424,33
"8924","2A358","2016",2,1,1,51000,860,65
"8925","2A359","2016",1,0,1,120000,1714,70
"8926","2A362","2016",41,29,12,301998.804878049,3385.51219512195,84.2439024390244
"8927","2B002","2016",1,1,0,110000,1528,72
"8928","2B005","2016",1,0,1,35000,438,80
"8929","2B009","2016",18,10,8,146241,1711,89
"8930","2B010","2016",5,0,5,143838,4856,29.8
"8931","2B012","2016",1,1,0,129000,2186,59
"8932","2B016","2016",5,2,3,132800,1881.6,67.2
"8933","2B020","2016",5,3,2,586464,5405.8,90.4
"8934","2B023","2016",1,1,0,180000,3214,56
"8935","2B025","2016",1,1,0,202000,2149,94
"8936","2B029","2016",1,0,1,40000,1053,38
"8937","2B030","2016",1,1,0,30000,1000,30
"8938","2B033","2016",304,12,292,161713.118421053,2352.73684210526,70.6019736842105
"8939","2B034","2016",7,4,3,172590,2261.28571428571,84.2857142857143
"8940","2B037","2016",64,27,37,213062.40625,2352.265625,90.015625
"8941","2B039","2016",3,3,0,140790,2183.66666666667,68.3333333333333
"8942","2B042","2016",82,36,46,173401.109756098,2432.57317073171,73.4756097560976
"8943","2B043","2016",16,8,8,351301.875,3610.75,94.125
"8944","2B045","2016",1,1,0,114000,838,136
"8945","2B046","2016",1,0,1,70000,1750,40
"8946","2B047","2016",2,2,0,141000,2002.5,59
"8947","2B049","2016",34,23,11,240764.264705882,2824.35294117647,82.2058823529412
"8948","2B050","2016",93,13,80,200855.774193548,4121.48387096774,48.7311827956989
"8949","2B051","2016",1,1,0,30000,1111,27
"8950","2B052","2016",1,0,1,85000,1417,60
"8951","2B055","2016",1,1,0,30000,789,38
"8952","2B057","2016",4,4,0,172500,2553.5,60.25
"8953","2B058","2016",4,2,2,140100,2004.5,64.5
"8954","2B059","2016",2,2,0,127500,1982,63.5
"8955","2B072","2016",1,1,0,65000,1083,60
"8956","2B074","2016",4,4,0,195500,1773.5,99
"8957","2B077","2016",2,2,0,296638.5,2910,127
"8958","2B078","2016",1,1,0,1e+05,1667,60
"8959","2B079","2016",6,6,0,128925,1969.33333333333,74.8333333333333
"8960","2B080","2016",3,1,2,48060,1218,43
"8961","2B083","2016",2,1,1,176500,1502.5,99
"8962","2B084","2016",3,1,2,214333.333333333,3486.66666666667,63.3333333333333
"8963","2B086","2016",1,1,0,80000,1212,66
"8964","2B087","2016",5,5,0,140600,2349.8,60.2
"8965","2B088","2016",2,2,0,110000,2916.5,39
"8966","2B093","2016",11,9,2,456381.818181818,5474,80.5454545454545
"8967","2B096","2016",58,7,51,121324.068965517,2233.39655172414,59.551724137931
"8968","2B101","2016",1,0,1,20000,556,36
"8969","2B102","2016",1,0,1,25000,714,35
"8970","2B106","2016",1,1,0,230000,2300,100
"8971","2B107","2016",2,2,0,172500,2526,67.5
"8972","2B109","2016",4,2,2,170000,2720.5,64.5
"8973","2B112","2016",3,1,2,71600,1418,43.6666666666667
"8974","2B120","2016",32,17,15,194894.03125,2292.3125,85.40625
"8975","2B121","2016",1,0,1,20000,741,27
"8976","2B123","2016",19,11,8,171390.789473684,2112.57894736842,79.1052631578947
"8977","2B124","2016",5,3,2,91890,1186.8,76.6
"8978","2B125","2016",2,1,1,152000,1727.5,93
"8979","2B134","2016",59,2,57,197325.050847458,3728.69491525424,55.5084745762712
"8980","2B136","2016",2,1,1,94000,1095,104
"8981","2B138","2016",2,2,0,211250,2506.5,88.5
"8982","2B140","2016",1,1,0,122000,2179,56
"8983","2B143","2016",11,5,6,103027.272727273,2394.81818181818,48.6363636363636
"8984","2B145","2016",1,1,0,45000,1500,30
"8985","2B148","2016",46,26,20,140451.739130435,2105.45652173913,69.3695652173913
"8986","2B150","2016",37,7,30,235798.243243243,4473.64864864865,51.8108108108108
"8987","2B152","2016",9,6,3,153333.333333333,1954.66666666667,73.8888888888889
"8988","2B153","2016",1,1,0,110000,1571,70
"8989","2B159","2016",3,3,0,158164,2705,58.3333333333333
"8990","2B162","2016",6,5,1,183055.5,1940.33333333333,93.5
"8991","2B164","2016",1,1,0,45691,609,75
"8992","2B165","2016",1,0,1,36000,1241,29
"8993","2B166","2016",5,4,1,95800,1588,67.8
"8994","2B167","2016",6,4,2,225070.833333333,2987.83333333333,73
"8995","2B168","2016",10,5,5,285713.6,3857.4,76.3
"8996","2B169","2016",2,2,0,93500,1187,72
"8997","2B170","2016",2,1,1,100500,1130.5,107.5
"8998","2B172","2016",9,5,4,85094.4444444444,1306.11111111111,63.1111111111111
"8999","2B173","2016",1,0,1,69000,2300,30
"9000","2B175","2016",1,1,0,153000,1866,82
"9001","2B176","2016",1,1,0,230000,1139,202
"9002","2B177","2016",1,1,0,20000,357,56
"9003","2B178","2016",1,1,0,250000,2336,107
"9004","2B179","2016",1,1,0,28000,467,60
"9005","2B180","2016",1,0,1,23000,657,35
"9006","2B185","2016",14,6,8,250055.8,3243.357,76.28571
"9007","2B188","2016",9,7,2,186222.2,2090,85.88889
"9008","2B193","2016",4,3,1,104975,1697.75,69.75
"9009","2B195","2016",1,1,0,80000,2857,28
"9010","2B199","2016",2,0,2,135000,1764.5,68.5
"9011","2B205","2016",7,4,3,182142.9,2800.286,76
"9012","2B207","2016",21,13,8,198604.4,2152.143,88.85714
"9013","2B208","2016",1,0,1,50000,625,80
"9014","2B210","2016",2,1,1,141354,2257.5,50
"9015","2B218","2016",3,1,2,66000,895.3333,87.33333
"9016","2B220","2016",1,1,0,150000,1210,124
"9017","2B223","2016",4,0,4,69001.5,1670.75,42.25
"9018","2B224","2016",7,4,3,167357.1,1916.571,81.28571
"9019","2B225","2016",2,1,1,97500,1815,51.5
"9020","2B226","2016",1,1,0,105000,2100,50
"9021","2B230","2016",1,0,1,62500,1359,46
"9022","2B233","2016",1,1,0,270000,3375,80
"9023","2B236","2016",2,1,1,85000,1250,68
"9024","2B238","2016",1,1,0,242000,2547,95
"9025","2B239","2016",4,3,1,223125,3522.75,77.25
"9026","2B242","2016",15,14,1,133369.4,2244.333,66.06667
"9027","2B248","2016",1,1,0,90000,1607,56
"9028","2B251","2016",24,17,7,175001.3,2154.792,87.75
"9029","2B252","2016",1,1,0,118000,2622,45
"9030","2B257","2016",1,1,0,4e+05,3636,110
"9031","2B261","2016",9,7,2,151772.2,2104.889,69.44444
"9032","2B263","2016",2,0,2,38500,855.5,55
"9033","2B264","2016",1,1,0,20000,488,41
"9034","2B265","2016",1,1,0,91000,1138,80
"9035","2B274","2016",1,1,0,135000,2077,65
"9036","2B275","2016",1,0,1,41600,1387,30
"9037","2B277","2016",3,3,0,149510,1410.333,91.33333
"9038","2B280","2016",1,0,1,65000,1413,46
"9039","2B281","2016",11,7,4,152312.7,2527.273,61.72727
"9040","2B283","2016",4,2,2,190206.2,3028.25,67.75
"9041","2B286","2016",3,1,2,108333.3,1640.333,64
"9042","2B287","2016",4,2,2,87500,1635.75,56.75
"9043","2B289","2016",1,1,0,1e+05,1667,60
"9044","2B290","2016",5,5,0,129100,2093.4,54.6
"9045","2B291","2016",1,0,1,35000,614,57
"9046","2B292","2016",3,2,1,40500,621.6667,66
"9047","2B293","2016",3,1,2,48332.33,750,68
"9048","2B296","2016",3,2,1,646333.3,4412.333,161.3333
"9049","2B298","2016",21,5,16,242316.7,3095.524,82.19048
"9050","2B303","2016",4,3,1,171528.2,2272.25,68
"9051","2B305","2016",26,7,19,259753.7,2961.308,82.88462
"9052","2B306","2016",2,2,0,100500,1410,75
"9053","2B307","2016",18,8,10,152111.7,2317.611,67.72222
"9054","2B309","2016",19,10,9,301697.6,2775.053,105.3158
"9055","2B311","2016",11,11,0,178698.2,2121.727,91.18182
"9056","2B313","2016",41,7,34,116133.1,2470.683,49.82927
"9057","2B314","2016",2,1,1,161750,1178,108.5
"9058","2B315","2016",1,1,0,238000,2833,84
"9059","2B316","2016",7,2,5,171628.6,2079.429,85.42857
"9060","2B318","2016",3,2,1,115144.7,1758.333,69
"9061","2B319","2016",5,4,1,167000,1718.8,97.6
"9062","2B320","2016",2,2,0,221500,3091,121
"9063","2B329","2016",1,1,0,42620,852,50
"9064","2B332","2016",3,2,1,2e+05,1876.333,110.6667
"9065","2B333","2016",1,1,0,767869,7383,104
"9066","2B334","2016",1,0,1,20000,400,50
"9067","2B335","2016",3,3,0,323133.3,2925,107.6667
"9068","2B337","2016",1,1,0,210000,2100,100
"9069","2B339","2016",1,1,0,75000,682,110
"9070","2B341","2016",2,1,1,89500,1494,48
"9071","2B342","2016",11,8,3,217181.8,2760.636,97
"9072","2B343","2016",10,7,3,147458.2,2158,67.4
"9073","2B346","2016",17,12,5,172777.1,1962.059,87.17647
"9074","2B347","2016",5,0,5,61484.6,1283.2,53
"9075","2B350","2016",1,1,0,190000,1188,160
"9076","2B352","2016",3,2,1,320166.7,3097,107.6667
"9077","2B353","2016",27,2,25,236302.6,2858.148,80.96296
"9078","2B361","2016",1,1,0,275350,3202,86
"9079","2B364","2016",1,1,0,150000,1562,96
"9080","30001","2016",7,7,0,361441.4,2927.429,127.5714
"9081","30002","2016",10,10,0,251526.2,1885.1,134.1
"9082","30003","2016",141,118,23,237947.6,3025.05,82.43972
"9083","30004","2016",43,38,5,199573.1,2158.372,93.32558
"9084","30005","2016",2,2,0,157250,2079.5,80
"9085","30006","2016",54,47,7,208501.3,2135.778,98.05556
"9086","30007","2016",341,176,165,117243.5,1469.041,78.94428
"9087","30008","2016",6,6,0,209554.2,1875.833,112.1667
"9088","30009","2016",3,3,0,76833.33,1014.333,79.33333
"9089","30010","2016",36,28,8,161472.1,1791.75,90.19444
"9090","30011","2016",139,92,47,221159.4,2609.086,85.92086
"9091","30012","2016",28,25,3,178463.9,1926.107,93.32143
"9092","30013","2016",7,7,0,220488.6,2211.571,115.8571
"9093","30014","2016",12,12,0,332419.2,2414.75,136.5833
"9094","30015","2016",1,1,0,260000,2955,88
"9095","30016","2016",2,1,1,29500,408,75
"9096","30017","2016",3,3,0,46111,639,74.66667
"9097","30018","2016",3,3,0,269776.3,2318.333,128
"9098","30019","2016",35,32,3,238715.3,2328.571,107.4286
"9099","30020","2016",19,19,0,246963.2,2068.737,123.8947
"9100","30021","2016",6,6,0,292561.7,2334,127.8333
"9101","30022","2016",2,2,0,90000,1012,72.5
"9102","30023","2016",9,9,0,227966.7,2429,93.88889
"9103","30024","2016",4,4,0,103257.5,1645.25,67.25
"9104","30025","2016",2,1,1,99667.5,1626.5,62
"9105","30026","2016",15,14,1,133768.3,1319.2,107.2
"9106","30027","2016",9,9,0,244078.8,2280.667,96.88889
"9107","30028","2016",168,80,88,133043.8,1629.125,79.7381
"9108","30029","2016",13,12,1,194576.9,2170.615,88.53846
"9109","30030","2016",4,4,0,336250,3516.75,109
"9110","30031","2016",3,3,0,257333.3,1839.333,156.3333
"9111","30032","2016",116,74,42,134279.2,1607.155,82.7069
"9112","30033","2016",47,45,2,182077.5,1925.426,95.46809
"9113","30034","2016",57,49,8,185447.6,2126.596,86.7193
"9114","30035","2016",2,2,0,267000,2962.5,88
"9115","30036","2016",33,28,5,194036.9,2149.182,91.0303
"9116","30037","2016",21,14,7,79156.67,973.8095,81.7619
"9117","30038","2016",4,3,1,144518.8,1364.25,96.5
"9118","30039","2016",16,15,1,147040.6,1617.75,88.6875
"9119","30040","2016",1,1,0,78000,821,95
"9120","30041","2016",25,25,0,271710,2429.52,110.2
"9121","30042","2016",20,20,0,234505,2124.15,112.95
"9122","30043","2016",4,4,0,299762.5,1949.75,157.25
"9123","30044","2016",1,1,0,75000,750,100
"9124","30045","2016",4,3,1,111625,1645.75,62.5
"9125","30046","2016",17,17,0,137735.3,1583,88.41176
"9126","30047","2016",51,43,8,206806.7,2011.039,104.4706
"9127","30048","2016",4,4,0,202214.2,2061,91.5
"9128","30049","2016",8,8,0,322931.1,1962.75,138.375
"9129","30050","2016",1,1,0,250000,1773,141
"9130","30051","2016",11,10,1,139309.2,1249.182,109.0909
"9131","30052","2016",8,8,0,110937.5,1685.625,74.25
"9132","30053","2016",9,8,1,160250,1773.444,94
"9133","30054","2016",2,2,0,509567.5,2846,195
"9134","30055","2016",2,2,0,168750,1537.5,107.5
"9135","30056","2016",7,7,0,332933.3,2636.714,126.2857
"9136","30057","2016",12,12,0,234996.4,2087.917,112.6667
"9137","30058","2016",1,1,0,289500,1448,200
"9138","30059","2016",37,34,3,187541.8,2063.784,90.7027
"9139","30060","2016",37,35,2,205246.2,2144.676,98.75676
"9140","30061","2016",13,12,1,151884.6,1713.231,89
"9141","30062","2016",75,55,20,213156,2307.867,91.97333
"9142","30064","2016",1,1,0,96500,804,120
"9143","30065","2016",8,7,1,173417.5,1412.625,121
"9144","30066","2016",3,3,0,182333.3,2349.667,78
"9145","30068","2016",4,4,0,162625,1875,85.5
"9146","30069","2016",4,4,0,202836.2,1774.25,123.75
"9147","30070","2016",3,3,0,212006.7,5053.333,73.66667
"9148","30071","2016",4,4,0,114500,1199.5,90.75
"9149","30072","2016",2,2,0,540500,2858.5,187.5
"9150","30073","2016",19,19,0,295625.8,2452.947,116.8421
"9151","30075","2016",31,29,2,237162.3,2262.129,101.5161
"9152","30076","2016",8,8,0,215681.2,2561.75,79.625
"9153","30077","2016",13,13,0,181277.1,1718.462,110.7692
"9154","30079","2016",5,5,0,126750,1878.4,61
"9155","30080","2016",6,4,2,63083.33,977.3333,65
"9156","30081","2016",6,5,1,179150,1821.167,98.33333
"9157","30082","2016",44,42,2,218759,2335.568,93.70455
"9158","30083","2016",21,16,5,199259.8,2095.524,96.28571
"9159","30084","2016",4,4,0,157305,1426,111.25
"9160","30085","2016",7,7,0,215500,2293.714,96.42857
"9161","30086","2016",3,3,0,144776.7,1305,109.3333
"9162","30087","2016",2,2,0,220000,2233.5,98.5
"9163","30088","2016",6,6,0,210768.5,2130.833,98.5
"9164","30089","2016",16,16,0,172358.6,1938.25,88.3125
"9165","30090","2016",3,3,0,126166.7,1144.667,91
"9166","30091","2016",23,23,0,241844.3,2560.565,100.087
"9167","30094","2016",2,1,1,256500,2172,113.5
"9168","30095","2016",10,10,0,160027.7,1832.8,93.6
"9169","30096","2016",12,12,0,238231.1,2793.083,113.3333
"9170","30097","2016",2,2,0,212825,2847.5,79
"9171","30098","2016",3,3,0,124405,1123.333,111
"9172","30099","2016",2,2,0,99500,1494.5,60
"9173","30100","2016",4,4,0,216705.5,2124.75,101.75
"9174","30101","2016",1,1,0,170000,1977,86
"9175","30102","2016",4,4,0,158750,1893.25,85.75
"9176","30103","2016",3,3,0,301233.3,2665.667,117
"9177","30104","2016",5,5,0,170174.4,1642.8,95.2
"9178","30105","2016",10,10,0,94902,1588.5,62.4
"9179","30106","2016",4,4,0,142250,1559.5,93.25
"9180","30107","2016",3,3,0,387192.3,3035.667,134
"9181","30108","2016",1,1,0,297320,5406,55
"9182","30109","2016",3,3,0,205238,1301,143.6667
"9183","30110","2016",10,10,0,402434,2758.4,143.1
"9184","30111","2016",3,3,0,209590,1853.333,114.6667
"9185","30112","2016",13,13,0,209580.8,1988.769,105.8462
"9186","30113","2016",2,2,0,199500,2491.5,81
"9187","30114","2016",1,1,0,348700,2858,122
"9188","30115","2016",3,3,0,238316.7,5282.667,49.33333
"9189","30116","2016",13,13,0,151076.5,1748.231,88.46154
"9190","30117","2016",24,21,3,149543.5,2176.25,71.375
"9191","30120","2016",10,7,3,142400,1496.7,92.1
"9192","30121","2016",3,3,0,320066.7,2500,131
"9193","30122","2016",3,3,0,150966.7,1232,119
"9194","30123","2016",47,42,5,233326.8,2552.064,90.44681
"9195","30124","2016",3,3,0,274450,2920,98
"9196","30125","2016",29,26,3,187623.4,2198.241,86.75862
"9197","30126","2016",4,4,0,224187.5,1778.75,128.5
"9198","30127","2016",7,7,0,283357.1,2196,126.1429
"9199","30128","2016",40,35,5,167953.4,1778.275,95.975
"9200","30129","2016",6,5,1,103583.3,1631.5,68
"9201","30130","2016",13,12,1,112447.2,1366.077,80.07692
"9202","30131","2016",15,15,0,231265.1,2283.533,98.73333
"9203","30132","2016",23,15,8,65708.7,810.3043,78.26087
"9204","30133","2016",679,41,638,146863,3851.711,37.54786
"9205","30134","2016",2,2,0,252745.5,2963,86
"9206","30135","2016",19,17,2,175959.2,2199,85.52632
"9207","30136","2016",12,12,0,171013.3,2505.167,81.5
"9208","30137","2016",1,1,0,120800,1060,114
"9209","30139","2016",5,5,0,65600,1155,60.2
"9210","30140","2016",13,9,4,106142.5,1378,78.07692
"9211","30141","2016",39,38,1,179231.9,1976.872,92.92308
"9212","30142","2016",5,5,0,147252.6,1531.4,96.2
"9213","30143","2016",2,2,0,226500,2628,85
"9214","30144","2016",4,4,0,252577.5,2568.5,99.75
"9215","30145","2016",12,11,1,184395.8,2062.417,90.16667
"9216","30146","2016",9,9,0,185984.4,1721.556,102.3333
"9217","30147","2016",7,7,0,217531.4,2217.143,97.42857
"9218","30148","2016",2,2,0,196720,2089,92
"9219","30149","2016",8,7,1,248486.2,2580.125,97
"9220","30150","2016",1,1,0,175000,1716,102
"9221","30151","2016",7,7,0,237571.4,2128.143,119.7143
"9222","30152","2016",16,15,1,153343.8,1724.125,85.4375
"9223","30153","2016",2,2,0,99500,1891.5,77.5
"9224","30154","2016",3,3,0,768433.3,3442.333,170
"9225","30155","2016",54,51,3,197584.1,2061.685,97.96296
"9226","30156","2016",98,89,9,183540.6,2055.153,89.91837
"9227","30158","2016",3,3,0,234766.7,2173.667,108.6667
"9228","30159","2016",9,5,4,91776,858.3333,104
"9229","30160","2016",2,2,0,142250,1794.5,84
"9230","30161","2016",2,2,0,215600,1420.5,169.5
"9231","30162","2016",7,5,2,150278.6,1521.429,96
"9232","30163","2016",1,1,0,140000,1296,108
"9233","30164","2016",15,15,0,95050,1443.533,60.6
"9234","30165","2016",7,7,0,206692.9,2115.857,94.71429
"9235","30166","2016",17,17,0,171472.6,1811.412,93
"9236","30167","2016",11,9,2,136181.8,1523.273,90.09091
"9237","30168","2016",3,2,1,65000,1144,53
"9238","30169","2016",51,45,6,153861.3,2041.196,80.62745
"9239","30170","2016",4,4,0,132577.5,1527.25,85.75
"9240","30171","2016",7,4,3,104857.1,1211.143,80.14286
"9241","30172","2016",6,6,0,206350,2082.833,114.5
"9242","30173","2016",7,7,0,200007.1,1839.571,136.8571
"9243","30174","2016",20,20,0,237638.5,2269.65,105.2
"9244","30175","2016",1,1,0,195000,2600,75
"9245","30176","2016",3,1,2,63166.67,1550.667,49.66667
"9246","30177","2016",2,2,0,269000,2481,107.5
"9247","30178","2016",18,16,2,159131.3,1822.111,87.5
"9248","30179","2016",38,37,1,149655.3,1697.474,89.71053
"9249","30180","2016",7,7,0,255438.3,1705.143,150.1429
"9250","30181","2016",2,1,1,172970,1507,101
"9251","30182","2016",15,12,3,185300,2017.2,95.93333
"9252","30183","2016",6,5,1,148425,1775.833,86.5
"9253","30184","2016",13,12,1,138264.2,1461.692,92.30769
"9254","30185","2016",13,13,0,224132.3,2213.846,102.0769
"9255","30186","2016",16,16,0,311184.4,2641.625,116.9375
"9256","30187","2016",3,3,0,150283.3,1763,87.66667
"9257","30188","2016",3,3,0,124670,2665.667,62
"9258","30189","2016",1941,542,1399,141831.5,2008.612,71.26172
"9259","30191","2016",11,11,0,192360.5,1854.727,106.6364
"9260","30192","2016",3,3,0,228766.7,1729,159.6667
"9261","30193","2016",5,5,0,135630,1833.2,82.6
"9262","30194","2016",5,5,0,157400,1937.8,86
"9263","30195","2016",1,1,0,70500,452,156
"9264","30196","2016",3,3,0,210162.7,2224.667,94.66667
"9265","30198","2016",1,1,0,55000,585,94
"9266","30200","2016",11,10,1,117681.8,1074.182,107.3636
"9267","30201","2016",4,3,1,84500,1286.75,65
"9268","30202","2016",122,73,49,131299.1,1499.016,85.71311
"9269","30203","2016",2,2,0,135000,1652,86.5
"9270","30204","2016",2,2,0,231000,2039.5,115.5
"9271","30205","2016",3,3,0,205833.3,1883.333,118
"9272","30206","2016",56,54,2,235738.8,2194.286,103.1786
"9273","30207","2016",10,9,1,217630,1874.3,117.4
"9274","30209","2016",41,36,5,290645.5,3014.024,107.3415
"9275","30210","2016",36,34,2,181730,1985.972,93.19444
"9276","30211","2016",43,39,4,213420.3,2302.14,96.30233
"9277","30212","2016",32,22,10,185706.1,2214.969,89.25
"9278","30214","2016",14,14,0,197675,2014.714,95.71429
"9279","30215","2016",3,3,0,153333.3,1388,108.3333
"9280","30216","2016",8,7,1,123538.2,1292,101.5
"9281","30217","2016",64,61,3,256560,2610.875,98.39062
"9282","30218","2016",3,3,0,80520,1068.667,75
"9283","30220","2016",4,4,0,160125,2332.75,74
"9284","30221","2016",46,37,9,159068.2,1912.783,81.43478
"9285","30222","2016",3,3,0,236666.7,2560,96.66667
"9286","30223","2016",30,30,0,172963.7,1945.3,91.26667
"9287","30224","2016",3,2,1,207416.7,2232.667,90.33333
"9288","30225","2016",20,20,0,199400,2015.65,103.3
"9289","30226","2016",8,8,0,319904.4,2550.75,121
"9290","30227","2016",33,26,7,123144.2,1362.727,84.93939
"9291","30228","2016",20,19,1,173909.5,1765.3,95.1
"9292","30229","2016",12,10,2,99825.42,1295.5,79.16667
"9293","30230","2016",7,7,0,266400,2453.571,101.4286
"9294","30231","2016",10,10,0,100100,1098.9,95.9
"9295","30232","2016",5,5,0,244740,1894.6,149.4
"9296","30233","2016",5,5,0,251390,1942.6,127.4
"9297","30234","2016",2,2,0,67000,670,100
"9298","30235","2016",10,7,3,136752.3,1699.7,77.6
"9299","30237","2016",7,7,0,166000.9,1875.571,86.28571
"9300","30239","2016",4,3,1,83913.75,1234,72
"9301","30240","2016",3,3,0,154733.3,2032.667,84.33333
"9302","30241","2016",16,16,0,197659.4,1782.688,118.0625
"9303","30242","2016",2,2,0,140000,1956.5,76
"9304","30243","2016",58,47,11,184304.7,1873.086,98.93103
"9305","30244","2016",6,6,0,200180,1942.833,101.5
"9306","30245","2016",8,7,1,184098,1857.625,103.5
"9307","30246","2016",1,1,0,240000,1752,137
"9308","30247","2016",3,3,0,126666.7,1898,77.66667
"9309","30248","2016",3,3,0,199143.3,2441.667,81.33333
"9310","30249","2016",10,8,2,223070.1,2213.7,102.4
"9311","30250","2016",2,2,0,587500,4496.5,120
"9312","30251","2016",1,1,0,122000,1525,80
"9313","30252","2016",1,1,0,1e+05,1000,100
"9314","30253","2016",8,8,0,130950.6,1544.5,82.75
"9315","30254","2016",21,17,4,153968.1,1920.619,80.28571
"9316","30255","2016",27,24,3,160872.6,1595.926,98.7037
"9317","30256","2016",6,6,0,159058.3,1884.5,101.1667
"9318","30257","2016",12,12,0,197849,2150.333,90.58333
"9319","30258","2016",131,96,35,146241,1804.794,81.61069
"9320","30259","2016",32,30,2,166259.3,1740.469,98.1875
"9321","30260","2016",11,10,1,171453.6,1843.909,90.18182
"9322","30262","2016",6,6,0,294075,2053.333,140.3333
"9323","30263","2016",24,20,4,149858.8,1578.292,97.79167
"9324","30265","2016",2,2,0,219000,2226,100.5
"9325","30266","2016",8,8,0,164907.5,1853.375,94.75
"9326","30267","2016",3,3,0,90333.33,872,101.3333
"9327","30268","2016",4,3,1,83475,1158.25,70.75
"9328","30269","2016",15,14,1,118810.3,1203.333,104.2667
"9329","30270","2016",8,8,0,190501.2,1943.875,95.5
"9330","30271","2016",7,5,2,138417.9,1539.571,86.42857
"9331","30272","2016",2,1,1,79750,2500,35
"9332","30273","2016",15,15,0,199684,2237.867,94.13333
"9333","30274","2016",19,17,2,175626.7,1863.263,93.42105
"9334","30275","2016",2,2,0,232500,2049.5,117
"9335","30276","2016",42,34,8,166573.8,2222.571,78.40476
"9336","30277","2016",5,5,0,171300,2124.6,81.6
"9337","30278","2016",27,25,2,200645.6,2031.741,98.55556
"9338","30279","2016",8,8,0,274703.8,2299.75,113.625
"9339","30280","2016",7,5,2,76383.71,1030.857,68.71429
"9340","30281","2016",20,19,1,194435.1,1970.2,103.35
"9341","30282","2016",11,11,0,167053.6,1746.818,91.45455
"9342","30283","2016",3,3,0,49000,1049.667,49.66667
"9343","30284","2016",29,26,3,143771.7,1553.379,94.13793
"9344","30285","2016",5,5,0,166770,1719.6,99.4
"9345","30286","2016",15,14,1,250173.7,2281.867,107.2
"9346","30287","2016",8,8,0,144995,1506.25,96.5
"9347","30288","2016",1,1,0,185000,1968,94
"9348","30290","2016",10,10,0,169964.8,1988.8,98.8
"9349","30291","2016",2,2,0,256235,2462.5,111
"9350","30292","2016",2,2,0,118750,1614,73
"9351","30293","2016",3,3,0,206666.7,2175,100.3333
"9352","30294","2016",56,35,21,152441.3,1836.518,83.625
"9353","30295","2016",44,43,1,225623,2498.455,90.38636
"9354","30297","2016",12,11,1,107429.3,1897.333,58.83333
"9355","30298","2016",5,5,0,214800,2309.4,90.6
"9356","30299","2016",13,13,0,296490,2274,132.1538
"9357","30300","2016",6,4,2,199298.8,1968.667,101.3333
"9358","30301","2016",2,2,0,225600,2146.5,105
"9359","30302","2016",15,14,1,210557.3,2261,96.33333
"9360","30303","2016",11,11,0,149663.6,1578.455,88.81818
"9361","30304","2016",2,2,0,194900,1885.5,101.5
"9362","30305","2016",19,18,1,137344.7,1504.526,95.15789
"9363","30306","2016",3,3,0,229966.7,2388.667,95
"9364","30307","2016",13,12,1,111807.7,1146.462,96.46154
"9365","30308","2016",13,13,0,243106.9,2371.846,101
"9366","30309","2016",6,6,0,145500,1920.667,78.83333
"9367","30310","2016",1,1,0,95000,2500,38
"9368","30311","2016",15,13,2,181758.1,1799,102
"9369","30312","2016",24,22,2,214916.8,2023.542,110.2083
"9370","30313","2016",8,8,0,212043.8,1872.75,120.25
"9371","30314","2016",1,1,0,250000,1389,180
"9372","30315","2016",11,11,0,213831.8,2288.636,101.9091
"9373","30316","2016",4,4,0,125000,1788,64.25
"9374","30317","2016",25,17,8,148705.6,1627.88,90.08
"9375","30318","2016",1,1,0,365000,1667,219
"9376","30319","2016",4,4,0,280900,2041.5,133.75
"9377","30320","2016",4,4,0,180673.8,2505,81.75
"9378","30321","2016",44,36,8,200066.9,2351.341,86.36364
"9379","30322","2016",4,4,0,264750,1774,154.25
"9380","30323","2016",1,1,0,52000,456,114
"9381","30324","2016",8,8,0,254293.8,2367,115.125
"9382","30325","2016",14,7,7,103626.1,1278.571,87
"9383","30326","2016",14,14,0,213646.4,2023.929,108.7857
"9384","30327","2016",1,1,0,366400,2714,135
"9385","30328","2016",6,6,0,198033.7,2285.167,87.66667
"9386","30329","2016",1,1,0,70000,1750,40
"9387","30330","2016",10,10,0,179557,1930,89.9
"9388","30331","2016",13,12,1,173365.4,1663.923,108.3077
"9389","30332","2016",2,2,0,66000,919,70
"9390","30333","2016",57,49,8,189989.5,2049.895,93.5614
"9391","30334","2016",148,71,77,249434.8,2685.615,91.10811
"9392","30335","2016",2,2,0,2e+05,2020.5,99
"9393","30336","2016",18,18,0,179822.2,2362,76.83333
"9394","30337","2016",6,6,0,256150,2117,122.1667
"9395","30338","2016",4,4,0,267500,1688.75,141.75
"9396","30339","2016",23,16,7,97556.96,1407.13,72.13043
"9397","30340","2016",3,3,0,387191.7,4640.333,102
"9398","30341","2016",122,92,30,152061.4,1874.844,84.92623
"9399","30342","2016",9,9,0,242410,2249.444,106.5556
"9400","30343","2016",5,5,0,216330,2016,108.4
"9401","30344","2016",56,52,4,219707.9,2236,100.6964
"9402","30345","2016",4,2,2,57000,922,56.5
"9403","30346","2016",32,32,0,226399.6,2373.438,96.21875
"9404","30347","2016",12,10,2,182285.8,2616.917,76.91667
"9405","30348","2016",13,13,0,247389.2,2294.154,117.4615
"9406","30349","2016",5,5,0,148522.6,1565.4,101.8
"9407","30350","2016",33,14,19,103832.4,1231.545,84.93939
"9408","30351","2016",169,111,58,272447.4,2846.331,95.99408
"9409","30352","2016",12,10,2,206250,2071.417,108.1667
"9410","30354","2016",4,4,0,206500,1861.5,113.5
"9411","30355","2016",4,4,0,180750,1934.25,89.75
"9412","30356","2016",16,16,0,184406.2,1737.875,109.5625
"9413","31001","2016",1,1,0,190000,1508,126
"9414","31002","2016",2,2,0,311275,1990.5,143
"9415","31003","2016",9,8,1,340788.9,2795,121.7778
"9416","31004","2016",21,20,1,202226.1,2118.714,97.33333
"9417","31005","2016",2,2,0,114000,1036,151.5
"9418","31006","2016",2,2,0,213500,1862,113.5
"9419","31007","2016",1,1,0,144500,1257,115
"9420","31008","2016",2,2,0,207500,903,237
"9421","31009","2016",1,1,0,63000,606,104
"9422","31010","2016",1,1,0,96230,713,135
"9423","31011","2016",6,6,0,107833.3,1418,90.66667
"9424","31013","2016",1,1,0,140000,1538,91
"9425","31014","2016",2,2,0,72000,1025,75
"9426","31015","2016",1,1,0,120000,960,125
"9427","31017","2016",1,1,0,51000,1020,50
"9428","31018","2016",1,1,0,70000,824,85
"9429","31020","2016",19,19,0,98139.26,1036.421,99
"9430","31021","2016",1,1,0,160000,1280,125
"9431","31022","2016",173,52,121,146992.7,2251.266,66.0578
"9432","31023","2016",3,3,0,126318,1229.667,97.33333
"9433","31024","2016",3,3,0,170666.7,1685.333,98.66667
"9434","31025","2016",7,7,0,497014.3,3162.857,152.8571
"9435","31026","2016",20,20,0,156850.5,1725.15,95.7
"9436","31027","2016",1,1,0,176000,1956,90
"9437","31028","2016",5,5,0,124548.6,1224,111.4
"9438","31029","2016",3,3,0,262653.3,1902.667,142.6667
"9439","31030","2016",1,1,0,69300,1238,56
"9440","31031","2016",2,2,0,118000,1016,110.5
"9441","31032","2016",80,58,22,214735.4,2266.113,96.475
"9442","31033","2016",8,8,0,254493.8,2067.5,131.25
"9443","31034","2016",2,2,0,158000,1196,132.5
"9444","31035","2016",30,19,11,281723,2627.833,113.1
"9445","31036","2016",36,24,12,220598.8,2618.583,86.16667
"9446","31037","2016",9,8,1,175058.9,1721.111,103.4444
"9447","31038","2016",1,1,0,205900,1514,136
"9448","31040","2016",1,1,0,124000,2102,59
"9449","31042","2016",124,17,107,93192.27,1830.984,50.33065
"9450","31044","2016",199,87,112,267316.6,2911.955,91.0402
"9451","31045","2016",5,5,0,152400,1201.8,119.6
"9452","31047","2016",1,1,0,140000,1414,99
"9453","31048","2016",36,35,1,232164.3,2215.583,110.1667
"9454","31049","2016",3,3,0,248700,1872,135.3333
"9455","31050","2016",4,4,0,123425,853.25,133.75
"9456","31051","2016",2,2,0,162500,1470,108
"9457","31052","2016",11,11,0,233083.6,1969.545,121.7273
"9458","31053","2016",8,8,0,252375,2487.125,102.875
"9459","31054","2016",1,1,0,95000,1056,90
"9460","31056","2016",53,35,18,232057.3,2601.642,87.67925
"9461","31057","2016",32,23,9,226249.7,2435.031,93.46875
"9462","31059","2016",2,2,0,131900,1371,94.5
"9463","31061","2016",2,2,0,218975,2024,106.5
"9464","31062","2016",1,1,0,247500,2152,115
"9465","31065","2016",27,27,0,218293.7,1861.556,117.2963
"9466","31066","2016",55,45,10,160328.5,1801.582,86.43636
"9467","31067","2016",2,2,0,68837.5,1112,61.5
"9468","31068","2016",1,1,0,134250,2315,58
"9469","31069","2016",333,118,215,206748.2,2711.345,75.72673
"9470","31070","2016",2,2,0,72000,918.5,84.5
"9471","31071","2016",4,4,0,127500,1163,102.75
"9472","31072","2016",1,1,0,125000,1667,75
"9473","31073","2016",5,5,0,154700,1608.6,97.8
"9474","31074","2016",5,5,0,306226,2294.4,136.4
"9475","31075","2016",7,7,0,239207.1,1792.857,135.5714
"9476","31076","2016",4,4,0,127250,1246,94.75
"9477","31077","2016",3,3,0,206166.7,1696.333,123.3333
"9478","31078","2016",1,1,0,145872,1089,134
"9479","31079","2016",34,34,0,263446.1,2503.147,107.0882
"9480","31080","2016",14,14,0,108925,1178.143,100
"9481","31082","2016",10,8,2,174410,1792.1,97.3
"9482","31083","2016",2,2,0,77000,706,99.5
"9483","31084","2016",7,7,0,143624.3,1446.143,100.8571
"9484","31085","2016",11,8,3,84100,1511.636,55.09091
"9485","31086","2016",1,1,0,154000,922,167
"9486","31087","2016",2,2,0,336800,2171.5,177.5
"9487","31088","2016",12,12,0,283209.1,2368.833,120.1667
"9488","31089","2016",3,3,0,325116.7,2787.333,116.6667
"9489","31092","2016",2,2,0,77500,810.5,100
"9490","31093","2016",4,4,0,141550,936,141
"9491","31094","2016",33,32,1,162243.3,1847.03,87.42424
"9492","31095","2016",1,1,0,175000,1207,145
"9493","31096","2016",2,2,0,232500,1914.5,128
"9494","31097","2016",3,3,0,217033.3,1750.667,117
"9495","31098","2016",12,11,1,159001.3,1587.25,102.3333
"9496","31099","2016",2,2,0,362500,2114,133
"9497","31100","2016",31,31,0,125750.6,1316.742,95.54839
"9498","31101","2016",4,4,0,266438.2,2354.25,120
"9499","31104","2016",5,5,0,148317,1443.8,112.2
"9500","31106","2016",20,20,0,214753.7,1783,120.3
"9501","31107","2016",52,49,3,157949.7,1780.615,93.71154
"9502","31108","2016",4,4,0,120000,1283.5,113.5
"9503","31109","2016",3,3,0,142666.7,999,152
"9504","31110","2016",4,4,0,133701.2,1231,113.5
"9505","31111","2016",2,2,0,2e+05,1451,132
"9506","31112","2016",1,1,0,75000,636,118
"9507","31113","2016",154,61,93,217870.5,2731.11,81.53247
"9508","31114","2016",1,1,0,50000,694,72
"9509","31115","2016",1,1,0,125020,1226,102
"9510","31116","2016",135,70,65,175115.7,2273.585,77.44444
"9511","31117","2016",39,38,1,297482.4,2684.821,116.6923
"9512","31118","2016",73,41,32,160603.7,1888.671,86.0137
"9513","31119","2016",2,2,0,156425,1655.5,94.5
"9514","31120","2016",7,7,0,212542.9,2331.143,90.85714
"9515","31123","2016",1,1,0,1e+05,606,165
"9516","31124","2016",3,3,0,129666.7,1171.667,107
"9517","31126","2016",4,3,1,224020,1713,142.25
"9518","31128","2016",15,15,0,210798,1807.333,125.6667
"9519","31129","2016",1,1,0,190000,1727,110
"9520","31131","2016",1,1,0,207900,1485,140
"9521","31133","2016",2,2,0,108150,1797,101
"9522","31135","2016",52,41,11,134716.2,1509.038,94.88462
"9523","31136","2016",15,11,4,184676.7,1877.533,96
"9524","31137","2016",1,1,0,307500,1887,163
"9525","31138","2016",2,2,0,74000,712,97.5
"9526","31139","2016",4,4,0,111250,1428.5,86.25
"9527","31140","2016",1,1,0,250000,1220,205
"9528","31141","2016",1,1,0,150000,1852,81
"9529","31142","2016",2,2,0,127050,1402.5,90.5
"9530","31143","2016",2,2,0,136000,882,157.5
"9531","31144","2016",9,9,0,73000.56,963.2222,79.22222
"9532","31145","2016",37,35,2,129768,1519.243,87.94595
"9533","31147","2016",5,5,0,154100,1441.4,110.6
"9534","31148","2016",1,1,0,140000,1750,80
"9535","31149","2016",417,194,223,198974.8,2305.055,84.05036
"9536","31150","2016",68,52,16,220136.9,2502.676,92.33824
"9537","31151","2016",7,7,0,339651.4,2657,128.7143
"9538","31152","2016",2,2,0,142000,1416,100.5
"9539","31153","2016",11,11,0,165337.7,1521.091,108.8182
"9540","31155","2016",1,1,0,80000,661,121
"9541","31156","2016",8,8,0,172856.2,1427.625,124.375
"9542","31157","2016",210,100,110,202347.2,2438.829,81.01905
"9543","31158","2016",3,3,0,114333.3,1017.667,104.3333
"9544","31159","2016",2,2,0,90000,1071,83
"9545","31160","2016",23,23,0,247886.1,2382.652,107.7826
"9546","31161","2016",12,9,3,261003.9,2492.583,101.75
"9547","31162","2016",9,9,0,278733.3,2316.222,119.7778
"9548","31163","2016",18,15,3,277276.6,2475.167,112.8333
"9549","31164","2016",5,5,0,180111.4,1732.2,101.6
"9550","31165","2016",1,1,0,223000,2624,85
"9551","31166","2016",3,3,0,197090,1789.667,119
"9552","31167","2016",6,6,0,138950,1360.833,102.8333
"9553","31169","2016",39,31,8,294470.9,2737.897,109.9231
"9554","31170","2016",3,3,0,136333.3,1221.333,108.6667
"9555","31171","2016",3,3,0,258000,2196,121
"9556","31172","2016",1,1,0,160000,1081,148
"9557","31173","2016",1,1,0,197630,1976,100
"9558","31174","2016",7,7,0,120142.9,1288.429,90.71429
"9559","31175","2016",5,5,0,152400,1096,137
"9560","31178","2016",1,1,0,70500,500,141
"9561","31179","2016",4,4,0,159315.5,1515,109.5
"9562","31180","2016",1,1,0,295000,1405,210
"9563","31181","2016",18,17,1,210309.7,1865.056,113
"9564","31182","2016",43,32,11,225347.8,2508.047,92.76744
"9565","31183","2016",1,1,0,61500,732,84
"9566","31184","2016",3,3,0,246633.3,1635.667,152
"9567","31185","2016",1,1,0,207600,2257,92
"9568","31186","2016",59,21,38,142125.9,2107.864,66.57627
"9569","31187","2016",156,111,45,212904.4,2240.558,92.19231
"9570","31188","2016",43,43,0,266032.8,2371.721,114.9535
"9571","31190","2016",6,6,0,54989.17,858.1667,75
"9572","31192","2016",6,6,0,244643.3,2229.667,111
"9573","31193","2016",20,19,1,147681.5,1614.4,91.4
"9574","31194","2016",3,3,0,426050,3838.667,110.3333
"9575","31196","2016",2,2,0,146250,858.5,165
"9576","31197","2016",1,1,0,297500,2479,120
"9577","31198","2016",2,2,0,304500,1955.5,156
"9578","31199","2016",4,4,0,71250,780.25,92.25
"9579","31200","2016",1,1,0,97020,1294,75
"9580","31202","2016",56,43,13,196304.8,1962.643,101.2321
"9581","31203","2016",77,55,22,215492.6,2598.506,90.77922
"9582","31204","2016",1,1,0,197673,1532,129
"9583","31205","2016",63,22,41,160718.9,2124.19,74.49206
"9584","31206","2016",8,8,0,261998.4,1743.875,134.625
"9585","31207","2016",1,1,0,63000,1658,38
"9586","31208","2016",2,2,0,184000,1357,134.5
"9587","31210","2016",17,16,1,186957.6,1772.176,108.1765
"9588","31211","2016",6,6,0,261303.3,2281.333,116.6667
"9589","31212","2016",9,7,2,210935.6,2188.444,99.66667
"9590","31213","2016",1,1,0,190000,3519,54
"9591","31215","2016",3,3,0,262666.7,1771.667,141.3333
"9592","31216","2016",2,2,0,1e+05,1952.5,51.5
"9593","31219","2016",1,1,0,135000,1607,84
"9594","31220","2016",4,4,0,205827.5,1684,123.25
"9595","31221","2016",8,2,6,82063.88,1402.75,58.875
"9596","31222","2016",1,1,0,150000,2027,74
"9597","31223","2016",2,2,0,92500,635,147
"9598","31224","2016",17,14,3,106485.3,1407.765,87.94118
"9599","31227","2016",15,13,2,419163.3,2725.467,155.2667
"9600","31228","2016",18,13,5,237840,2359.778,99.55556
"9601","31229","2016",6,6,0,171016.7,1196.667,144.6667
"9602","31230","2016",37,34,3,221624.7,2407.757,93.83784
"9603","31231","2016",9,9,0,122527.8,1405.111,87.22222
"9604","31232","2016",94,74,20,190768.5,2058.383,96.54255
"9605","31233","2016",5,5,0,172400,1827.6,105
"9606","31234","2016",9,9,0,181433.3,1673.222,113.8889
"9607","31235","2016",2,2,0,79950,1157,69
"9608","31237","2016",2,2,0,66820,687,118
"9609","31238","2016",2,2,0,207350,1305.5,165
"9610","31239","2016",24,24,0,105700.6,1117,96.20833
"9611","31240","2016",4,4,0,256412.5,2065.75,124.5
"9612","31241","2016",5,5,0,103323,1195.8,90.8
"9613","31243","2016",1,1,0,129550,1246,104
"9614","31244","2016",3,2,1,270666.7,2391.333,119
"9615","31245","2016",3,3,0,68666.67,584,129.6667
"9616","31246","2016",14,14,0,154214.3,1450.286,119.6429
"9617","31247","2016",12,11,1,106304.2,1078.333,96.66667
"9618","31248","2016",50,45,5,220808.4,2169.02,104.04
"9619","31249","2016",10,10,0,208646.2,2228.6,93
"9620","31250","2016",13,13,0,171227.7,1766.538,101.5385
"9621","31252","2016",15,13,2,197253.7,2168.067,95
"9622","31253","2016",21,19,2,192904.3,2058.952,95.90476
"9623","31254","2016",26,16,10,262337.5,2730.154,96.11538
"9624","31255","2016",6,6,0,58725,614.3333,97
"9625","31256","2016",1,1,0,75000,1154,65
"9626","31258","2016",2,2,0,171050,1724.5,102
"9627","31259","2016",15,12,3,358633.3,3000,118.5333
"9628","31261","2016",13,13,0,199440.8,1739.769,111.0769
"9629","31262","2016",1,1,0,170000,1809,94
"9630","31263","2016",35,32,3,197156.7,2016.971,101.6857
"9631","31264","2016",3,3,0,123966.7,2733,55.66667
"9632","31265","2016",2,2,0,240523,2499,102
"9633","31267","2016",1,1,0,61500,1230,50
"9634","31268","2016",2,2,0,126500,1262.5,109.5
"9635","31269","2016",10,10,0,190126,2082.1,92.2
"9636","31270","2016",2,2,0,166000,1383.5,120.5
"9637","31271","2016",21,16,5,223177,2252.238,102
"9638","31273","2016",15,14,1,231191.7,2044.267,113.1333
"9639","31274","2016",1,1,0,45000,409,110
"9640","31275","2016",2,2,0,155000,2278.5,85.5
"9641","31276","2016",3,3,0,164266.7,1254,128
"9642","31277","2016",14,14,0,241271.8,2039.286,115
"9643","31278","2016",2,2,0,110975,1112,103.5
"9644","31280","2016",2,2,0,145000,1858,95.5
"9645","31281","2016",12,11,1,196575,2011.167,98.41667
"9646","31282","2016",82,45,37,186682.5,2590.329,75.10976
"9647","31283","2016",5,5,0,172066,1588,107
"9648","31284","2016",16,15,1,397423.8,2822.938,143.1875
"9649","31285","2016",4,4,0,244670,2347.5,93.75
"9650","31286","2016",6,6,0,149333.3,1281.5,119.1667
"9651","31287","2016",13,13,0,169597.7,1751.692,97.07692
"9652","31288","2016",4,4,0,212916.8,2279,120.75
"9653","31289","2016",1,1,0,87500,486,180
"9654","31291","2016",149,87,62,187818.9,2383.564,79.44966
"9655","31293","2016",25,19,6,191365.6,2246.96,86.92
"9656","31296","2016",3,3,0,149000,1289.333,117
"9657","31297","2016",22,20,2,214798.2,2187.727,103
"9658","31299","2016",52,45,7,187153,1878.75,99.67308
"9659","31300","2016",1,1,0,240000,1600,150
"9660","31301","2016",3,3,0,212416.7,1309.667,158.6667
"9661","31302","2016",1,1,0,80000,1053,76
"9662","31303","2016",34,27,7,154157.2,1693.882,89.58824
"9663","31304","2016",3,3,0,136083.3,1370.333,102.6667
"9664","31306","2016",2,2,0,72500,1000.5,71
"9665","31309","2016",4,4,0,196552.5,1920.75,106.25
"9666","31310","2016",4,4,0,209675,1725.75,119.5
"9667","31311","2016",4,4,0,224337.5,2355.75,99
"9668","31313","2016",1,1,0,65000,1275,51
"9669","31314","2016",3,3,0,96666.67,1029.667,95.66667
"9670","31315","2016",9,8,1,121705.6,1122.667,106.2222
"9671","31316","2016",4,3,1,77750,795.5,106.75
"9672","31317","2016",4,4,0,124400,1126.5,120.25
"9673","31318","2016",3,3,0,156190,1700.667,91.33333
"9674","31319","2016",1,1,0,55000,917,60
"9675","31320","2016",7,7,0,206571.4,2245,109.5714
"9676","31321","2016",1,1,0,50000,1111,45
"9677","31322","2016",1,1,0,123000,1538,80
"9678","31323","2016",4,4,0,87325,987,79.5
"9679","31324","2016",23,20,3,131848,1584.87,102.3043
"9680","31325","2016",1,1,0,186670,2146,87
"9681","31326","2016",1,1,0,239000,3319,72
"9682","31327","2016",3,3,0,180973.3,1015.667,171
"9683","31328","2016",3,3,0,190333.3,1657.333,130.3333
"9684","31329","2016",2,2,0,190125,1794,106
"9685","31330","2016",2,2,0,340875,1771,204
"9686","31331","2016",3,3,0,248400,1606,150
"9687","31332","2016",2,2,0,116000,1574,76
"9688","31333","2016",4,4,0,136625,1120.25,117
"9689","31334","2016",7,7,0,262093.7,1791.429,150.1429
"9690","31336","2016",5,5,0,109066,1258.6,85.2
"9691","31337","2016",3,3,0,1e+05,1496,66.66667
"9692","31338","2016",10,10,0,250887.5,1966.6,133.4
"9693","31339","2016",1,1,0,130000,2600,50
"9694","31340","2016",2,2,0,472095,3024.5,158
"9695","31341","2016",91,56,35,180410,2048.077,85.74725
"9696","31342","2016",1,1,0,29900,507,59
"9697","31344","2016",7,6,1,83097.14,1075.143,84.85714
"9698","31345","2016",23,23,0,160278.9,1660.565,96.91304
"9699","31346","2016",15,15,0,191136.3,1743.6,113.4667
"9700","31347","2016",4,4,0,175640,1285,136.5
"9701","31348","2016",1,1,0,123000,1118,110
"9702","31349","2016",12,12,0,189628.3,1520.667,129.4167
"9703","31350","2016",1,1,0,150000,625,240
"9704","31351","2016",52,41,11,240259.8,2471.654,97.09615
"9705","31355","2016",9,9,0,499860.6,3180.444,158.8889
"9706","31356","2016",14,11,3,238728.9,2442,99.28571
"9707","31357","2016",3,3,0,123500,958.3333,124.3333
"9708","31358","2016",50,44,6,252427.2,2217.44,118.64
"9709","31360","2016",8,7,1,151506.2,1898.125,78.25
"9710","31361","2016",3,3,0,310833.3,2039.667,148.3333
"9711","31362","2016",1,1,0,75000,773,97
"9712","31363","2016",1,1,0,140000,1474,95
"9713","31364","2016",3,3,0,274766.7,1964.333,139.3333
"9714","31365","2016",7,7,0,112814.3,1055.571,122
"9715","31366","2016",8,8,0,325958.8,1637.5,204.375
"9716","31367","2016",1,1,0,215000,2150,100
"9717","31368","2016",2,2,0,218000,1378,156
"9718","31371","2016",3,3,0,207163.3,2107.667,100.6667
"9719","31372","2016",6,6,0,117666.7,1266.167,95.83333
"9720","31373","2016",1,1,0,75556,675,112
"9721","31374","2016",10,10,0,215174.3,2161.7,114.6
"9722","31375","2016",30,30,0,132859.1,1375.633,102.9
"9723","31376","2016",1,1,0,90000,1343,67
"9724","31377","2016",5,5,0,242320,1566,162
"9725","31378","2016",1,1,0,90400,942,96
"9726","31380","2016",4,4,0,155687.5,1311.5,119.25
"9727","31381","2016",30,28,2,173997.2,2106.5,83
"9728","31383","2016",16,16,0,230148.7,2220.562,113.25
"9729","31384","2016",15,15,0,268890.3,2580,107.2
"9730","31385","2016",6,6,0,107925,1132.333,129.1667
"9731","31387","2016",2,2,0,119290,1317.5,101
"9732","31388","2016",3,3,0,210333.3,2152.333,101.3333
"9733","31389","2016",37,23,14,238455.4,2533.135,94.83784
"9734","31390","2016",30,27,3,86966,960.9667,89.63333
"9735","31391","2016",4,4,0,167000,1239.25,141.5
"9736","31394","2016",1,1,0,238490,1509,158
"9737","31395","2016",235,129,106,166589.1,1989.464,84.0766
"9738","31396","2016",41,30,11,181899.4,1850.317,96.82927
"9739","31397","2016",1,1,0,179000,2325,77
"9740","31398","2016",1,1,0,320000,2192,146
"9741","31399","2016",19,17,2,166469.3,1719.421,97.21053
"9742","31401","2016",2,2,0,227850,1947.5,117
"9743","31402","2016",8,8,0,196495,2163.125,97
"9744","31403","2016",7,7,0,211365.7,1799.571,131.1429
"9745","31405","2016",1,1,0,18000,340,53
"9746","31406","2016",6,6,0,153546.7,1283.833,118.5
"9747","31407","2016",24,23,1,223432.5,2318.458,104.6667
"9748","31408","2016",1,1,0,227000,1135,200
"9749","31409","2016",10,6,4,205062,2190.5,94.7
"9750","31410","2016",42,36,6,270634.9,2472.095,111.8571
"9751","31411","2016",6,6,0,562691.7,4030,153.5
"9752","31412","2016",3,3,0,266666.7,1433.333,194.6667
"9753","31413","2016",3,3,0,228700,2389,95.66667
"9754","31415","2016",1,1,0,150000,1667,90
"9755","31416","2016",7,7,0,202664.3,1709.429,119.1429
"9756","31417","2016",84,74,10,331763.4,2914.5,116.4286
"9757","31418","2016",8,8,0,470201.2,2776.375,173.5
"9758","31419","2016",1,1,0,130000,1300,100
"9759","31420","2016",30,26,4,221395.9,2559.367,95.2
"9760","31421","2016",27,24,3,232847.4,2324.556,98.92593
"9761","31422","2016",1,1,0,78000,1000,78
"9762","31423","2016",3,3,0,165066.7,1698.333,98
"9763","31424","2016",183,129,54,222428.4,2415.82,92.45355
"9764","31425","2016",9,9,0,110677.8,1078.778,109.7778
"9765","31426","2016",6,6,0,122750,1054.667,116.1667
"9766","31427","2016",5,5,0,95800,850.6,105.6
"9767","31429","2016",28,13,15,215128.2,2354.714,92.46429
"9768","31430","2016",4,4,0,159425,1078.5,154.75
"9769","31431","2016",2,2,0,74450,1183,64
"9770","31432","2016",2,2,0,115000,1310,92.5
"9771","31433","2016",103,87,16,207448.2,2274.456,92.53398
"9772","31434","2016",1,0,1,161550,3107,52
"9773","31435","2016",6,6,0,192358.3,1804,109.5
"9774","31436","2016",7,7,0,147542.7,1634.143,91.85714
"9775","31439","2016",6,6,0,302181.7,2151,145.6667
"9776","31441","2016",4,4,0,238175,2176.5,111
"9777","31442","2016",4,4,0,162650,1726.5,105.5
"9778","31443","2016",5,5,0,113008,993.6,116.2
"9779","31445","2016",40,30,10,305534.2,2943.8,103.375
"9780","31446","2016",209,39,170,172624.8,2566.636,68.05742
"9781","31447","2016",1,1,0,115000,1438,80
"9782","31448","2016",3,3,0,433450,2591,166.6667
"9783","31449","2016",1,1,0,95000,805,118
"9784","31450","2016",7,7,0,193007.1,1963.286,93.14286
"9785","31451","2016",93,84,9,148698.7,1485.237,103.2473
"9786","31452","2016",1,1,0,195000,1840,106
"9787","31453","2016",2,2,0,112000,1346,81.5
"9788","31454","2016",27,20,7,124475.2,1431.185,89.7037
"9789","31455","2016",33,33,0,149505.3,1409.152,110.1212
"9790","31456","2016",1,1,0,146000,811,180
"9791","31457","2016",9,9,0,99888.89,1337.556,77
"9792","31458","2016",49,30,19,213295.7,2244.531,98.69388
"9793","31459","2016",5,5,0,264962,2630.4,104.4
"9794","31460","2016",33,27,6,237704.2,2384.152,99.57576
"9795","31461","2016",4,4,0,133562.5,1437.25,92
"9796","31462","2016",37,13,24,191058.3,2162.216,75.43243
"9797","31463","2016",1,1,0,150000,1579,95
"9798","31464","2016",2,2,0,138500,1342.5,103
"9799","31466","2016",4,4,0,240441.5,2558,95.5
"9800","31467","2016",56,36,20,198573.1,2396.25,83.51786
"9801","31468","2016",3,3,0,188333.3,1394,136
"9802","31469","2016",2,2,0,183875,1326.5,138
"9803","31470","2016",5,2,3,93160,1499.6,62.6
"9804","31471","2016",8,8,0,84012.5,776.25,107.5
"9805","31473","2016",4,2,2,137027.8,1759.5,86.75
"9806","31474","2016",2,2,0,104550,710,142.5
"9807","31475","2016",10,9,1,197122,1867.9,108.2
"9808","31476","2016",6,6,0,157416.7,1404.333,115.5
"9809","31477","2016",1,1,0,50000,556,90
"9810","31478","2016",10,10,0,188170,1303.3,163
"9811","31480","2016",22,18,4,272089.8,2544.682,114.8636
"9812","31481","2016",26,19,7,189567.4,1782.962,102.3846
"9813","31482","2016",1,1,0,37090,412,90
"9814","31483","2016",125,83,42,98698.36,1075.272,92.024
"9815","31484","2016",18,17,1,269831.4,2362.444,115.8889
"9816","31485","2016",3,3,0,312750,2284.667,147.3333
"9817","31486","2016",8,8,0,198487.5,1793,109.5
"9818","31487","2016",1,1,0,74000,673,110
"9819","31488","2016",144,92,52,222635.3,2585.556,86
"9820","31489","2016",1,1,0,301300,2410,125
"9821","31490","2016",2,2,0,180000,1624.5,109
"9822","31491","2016",7,7,0,123421.4,1098.429,125
"9823","31492","2016",4,4,0,217597.5,1750.25,128.25
"9824","31493","2016",1,1,0,171553,969,177
"9825","31494","2016",1,1,0,35000,583,60
"9826","31495","2016",14,14,0,168669.3,1535.714,112.2143
"9827","31497","2016",18,17,1,273412.2,2646.944,108.8889
"9828","31498","2016",1,1,0,127000,1058,120
"9829","31499","2016",110,95,15,204066.1,2128.527,99.09091
"9830","31500","2016",15,9,6,141138.3,2190,67.8
"9831","31502","2016",2,2,0,74750,786,88.5
"9832","31503","2016",12,11,1,91305.5,884.9167,98.5
"9833","31504","2016",3,3,0,158433.3,1754,117.6667
"9834","31505","2016",5,5,0,173620,1962.2,90
"9835","31506","2016",158,94,64,235552.6,2627.127,89.11392
"9836","31507","2016",13,9,4,178423.1,2121.692,80.23077
"9837","31508","2016",1,1,0,466420,2897,161
"9838","31509","2016",2,2,0,73500,682.5,94.5
"9839","31511","2016",2,2,0,242500,2062.5,124.5
"9840","31512","2016",3,3,0,234766.7,2366.333,102.3333
"9841","31513","2016",3,3,0,144333.3,1428.667,94.33333
"9842","31514","2016",1,1,0,170000,1889,90
"9843","31515","2016",4,4,0,141695,1776.75,82.25
"9844","31516","2016",18,18,0,255694.4,2435.667,110.6111
"9845","31517","2016",18,18,0,162542.2,1658.444,112.1667
"9846","31518","2016",6,6,0,293775,2264.667,130.5
"9847","31519","2016",1,1,0,167000,1392,120
"9848","31521","2016",2,2,0,182500,1151,158.5
"9849","31523","2016",11,8,3,136236.4,1503.636,96.90909
"9850","31524","2016",2,2,0,74500,798.5,95.5
"9851","31525","2016",8,8,0,202262.5,1590.75,125
"9852","31526","2016",87,72,15,233476.9,2438.138,97.25287
"9853","31528","2016",2,2,0,197500,1567,119.5
"9854","31529","2016",2,2,0,112250,1187,94
"9855","31530","2016",2,2,0,174000,902,184
"9856","31533","2016",16,14,2,270033.4,2295.188,121
"9857","31534","2016",1,1,0,288760,2649,109
"9858","31535","2016",10,10,0,144461,1089.5,148.7
"9859","31536","2016",1,1,0,130000,1368,95
"9860","31537","2016",4,4,0,153500,1214.5,127.5
"9861","31538","2016",1,1,0,290000,1895,153
"9862","31539","2016",1,1,0,135000,931,145
"9863","31540","2016",5,5,0,236820,1977.6,125.2
"9864","31541","2016",62,23,39,207226.3,2518.952,81.16129
"9865","31542","2016",1,1,0,113420,1400,81
"9866","31543","2016",1,1,0,147350,1352,109
"9867","31544","2016",1,1,0,137000,1522,90
"9868","31545","2016",3,3,0,153333.3,1116,136.6667
"9869","31546","2016",1,1,0,4e+05,4938,81
"9870","31547","2016",88,68,20,199292.1,2207.977,96.35227
"9871","31549","2016",1,1,0,120000,1500,80
"9872","31550","2016",4,4,0,100350,1141,91
"9873","31551","2016",8,8,0,226809.5,2166.125,110.875
"9874","31552","2016",3,3,0,95000,879.6667,102
"9875","31553","2016",11,11,0,211327.3,2060.545,106.1818
"9876","31554","2016",6,6,0,155920,1296.667,126.5
"9877","31555","2016",7459,1143,6316,178631.9,2847.13,63.36493
"9878","31556","2016",1,1,0,222550,2473,90
"9879","31557","2016",309,192,117,267526.1,2845.647,93.91909
"9880","31558","2016",2,2,0,195500,1823,113
"9881","31560","2016",3,3,0,106962.3,1028.667,114.6667
"9882","31561","2016",143,111,32,262631.6,2883.692,92.66434
"9883","31563","2016",11,10,1,266632.7,2110.636,127.8182
"9884","31564","2016",1,1,0,171000,977,175
"9885","31565","2016",9,9,0,107777.8,1151.111,94
"9886","31566","2016",2,2,0,310750,1822.5,177.5
"9887","31567","2016",1,1,0,650000,2826,230
"9888","31568","2016",1,1,0,385000,2391,161
"9889","31569","2016",4,4,0,217335,1773,119.5
"9890","31571","2016",2,2,0,241250,2019.5,124
"9891","31572","2016",23,20,3,193479.1,2338.652,83.13043
"9892","31573","2016",31,26,5,194493.6,1999.548,100.4516
"9893","31574","2016",31,31,0,223303.9,2187.548,102.129
"9894","31575","2016",7,7,0,666336.3,3320.429,203.4286
"9895","31576","2016",1,1,0,110000,1250,88
"9896","31577","2016",3,3,0,142215,1908,79.33333
"9897","31578","2016",8,8,0,503718.8,3148.375,163
"9898","31579","2016",8,8,0,249537.5,1811.375,157.125
"9899","31580","2016",2,1,1,115250,1690,65.5
"9900","31581","2016",16,16,0,201499.4,1781.625,115.4375
"9901","31582","2016",54,49,5,179239.5,1836.611,100.5
"9902","31583","2016",8,7,1,174823.8,1706.375,100.875
"9903","31584","2016",69,66,3,149924,1648.188,92.73913
"9904","31585","2016",16,16,0,143751.9,1226.75,116.5
"9905","31586","2016",7,7,0,143442.9,1366.571,106.5714
"9906","31587","2016",13,13,0,243542.3,2147.846,115.7692
"9907","31588","2016",100,74,26,194111.5,2289.06,85.72
"9908","31589","2016",10,9,1,272263,2028.2,136.2
"9909","31592","2016",6,6,0,250308.3,2026.833,127.1667
"9910","32001","2016",9,9,0,110672.2,1008.778,122.1111
"9911","32002","2016",2,2,0,96000,1115.5,70
"9912","32005","2016",3,3,0,128333.3,868.3333,135.6667
"9913","32007","2016",2,2,0,179175,1749,104.5
"9914","32008","2016",3,3,0,202166.7,1546.333,137.6667
"9915","32009","2016",1,1,0,187000,890,210
"9916","32012","2016",13,13,0,138438.5,1175.846,123.1538
"9917","32013","2016",252,143,109,124183.8,1502.881,82.89286
"9918","32014","2016",2,2,0,155000,1152,146
"9919","32016","2016",7,7,0,180264.1,1523.286,123.8571
"9920","32017","2016",1,1,0,23000,1045,22
"9921","32018","2016",4,4,0,171610,1777.25,96.5
"9922","32019","2016",10,9,1,151200.2,1243.1,123.8
"9923","32020","2016",2,2,0,176975,1210,147.5
"9924","32022","2016",3,3,0,263550,2432.667,109.6667
"9925","32024","2016",2,2,0,120500,951.5,115.5
"9926","32027","2016",12,11,1,118941.7,1325.25,94.58333
"9927","32029","2016",2,2,0,122890,1707,72
"9928","32030","2016",1,1,0,160000,1250,128
"9929","32031","2016",1,1,0,118900,1132,105
"9930","32032","2016",4,4,0,73516.25,543.5,122.75
"9931","32036","2016",3,3,0,215033.3,1475.333,156.6667
"9932","32038","2016",2,2,0,132750,927.5,138
"9933","32040","2016",1,1,0,57082,408,140
"9934","32041","2016",2,2,0,97300,923.5,127.5
"9935","32042","2016",2,2,0,190000,1130.5,167
"9936","32043","2016",2,2,0,216000,1237.5,163.5
"9937","32044","2016",1,1,0,160000,930,172
"9938","32045","2016",3,3,0,162000,1558.333,100.6667
"9939","32046","2016",5,5,0,108100,1026.4,99.4
"9940","32047","2016",3,3,0,202066.7,1330.667,144.3333
"9941","32048","2016",1,1,0,332500,2078,160
"9942","32049","2016",1,1,0,148000,1175,126
"9943","32050","2016",3,3,0,67273.33,832.3333,83
"9944","32051","2016",1,1,0,162500,1204,135
"9945","32052","2016",2,2,0,45750,545.5,85.5
"9946","32054","2016",2,2,0,141050,1002.5,136
"9947","32059","2016",1,1,0,346500,2987,116
"9948","32060","2016",1,1,0,133000,1023,130
"9949","32061","2016",1,1,0,150000,2143,70
"9950","32063","2016",4,4,0,101411.2,1159,85.75
"9951","32064","2016",3,3,0,156166.7,1910.667,87.66667
"9952","32065","2016",2,2,0,85000,932.5,93.5
"9953","32066","2016",3,3,0,195253.3,1491,130.3333
"9954","32067","2016",1,1,0,159480,759,210
"9955","32068","2016",5,5,0,202378,1636.6,135.4
"9956","32069","2016",1,1,0,97340,1202,81
"9957","32070","2016",3,3,0,126883.3,1187.333,117
"9958","32071","2016",1,1,0,235000,2282,103
"9959","32072","2016",1,1,0,143000,1375,104
"9960","32073","2016",2,2,0,124750,641,194.5
"9961","32075","2016",2,2,0,195000,1594.5,122
"9962","32076","2016",8,8,0,138612.5,1032.375,137.125
"9963","32077","2016",2,2,0,231000,2028.5,117
"9964","32078","2016",2,2,0,121000,1463,86
"9965","32079","2016",9,9,0,110618.9,921.6667,126.7778
"9966","32080","2016",1,1,0,151000,1007,150
"9967","32081","2016",2,2,0,157500,1090.5,155
"9968","32082","2016",4,4,0,164650,1049.5,180
"9969","32083","2016",12,12,0,122757.1,1113.917,110.25
"9970","32085","2016",1,1,0,116000,892,130
"9971","32086","2016",1,1,0,287000,1335,215
"9972","32087","2016",1,1,0,214525,1430,150
"9973","32088","2016",3,3,0,159000,1353.333,117.6667
"9974","32089","2016",3,3,0,209333.3,1586.333,144
"9975","32090","2016",2,2,0,509500,2877,163.5
"9976","32091","2016",5,5,0,165735.4,1381,120.2
"9977","32092","2016",1,1,0,85000,1889,45
"9978","32095","2016",9,9,0,106555.6,1085.556,97.55556
"9979","32096","2016",55,14,41,69379.85,1286.436,50.2
"9980","32097","2016",1,1,0,225000,1875,120
"9981","32098","2016",3,3,0,179030,1570.333,114
"9982","32099","2016",1,1,0,274108,2265,121
"9983","32100","2016",2,2,0,181500,2247.5,89
"9984","32102","2016",2,2,0,134800,1270,107.5
"9985","32103","2016",4,4,0,143125,1211.5,118.75
"9986","32106","2016",4,4,0,174762.5,1422.75,128.25
"9987","32107","2016",73,70,3,133850.7,1236.712,106.3425
"9988","32108","2016",3,3,0,137000,1110.667,145.6667
"9989","32109","2016",4,3,1,130000,894.75,144.75
"9990","32110","2016",6,6,0,92141.67,1009.333,96.5
"9991","32111","2016",1,1,0,162500,1280,127
"9992","32112","2016",1,1,0,32000,340,94
"9993","32113","2016",1,1,0,68000,680,100
"9994","32114","2016",1,1,0,139450,715,195
"9995","32115","2016",3,3,0,135000,1042.333,121.6667
"9996","32116","2016",1,1,0,162231,1159,140
"9997","32117","2016",4,4,0,174875,1378.75,128.5
"9998","32119","2016",26,24,2,119686.9,1213.115,105.8077
"9999","32120","2016",3,3,0,114000,1371.333,86.66667
"10000","32121","2016",3,3,0,283666.7,1270.667,228.6667
"10001","32122","2016",2,2,0,114850,1338,86
"10002","32123","2016",4,4,0,242570,2357.25,113.25
"10003","32124","2016",1,1,0,150000,2000,75
"10004","32125","2016",1,1,0,215000,1762,122
"10005","32126","2016",1,1,0,160000,1231,130
"10006","32127","2016",10,9,1,122317.1,1023.3,115.7
"10007","32128","2016",2,2,0,169650,1839,92
"10008","32129","2016",3,2,1,156166.7,1242.333,125.6667
"10009","32130","2016",3,3,0,187000,1747.667,96.66667
"10010","32131","2016",2,2,0,217500,1753,135
"10011","32132","2016",75,67,8,115240.7,1263.253,96.29333
"10012","32133","2016",2,2,0,232500,1255.5,193
"10013","32134","2016",3,3,0,250066.7,2376.667,112.3333
"10014","32138","2016",2,2,0,101500,1120,90.5
"10015","32139","2016",1,1,0,175000,1190,147
"10016","32141","2016",3,3,0,207000,1137,181.6667
"10017","32142","2016",1,1,0,110000,1528,72
"10018","32143","2016",3,3,0,168666.7,1153.333,147.6667
"10019","32144","2016",1,1,0,165000,1667,99
"10020","32146","2016",2,2,0,112500,1014.5,128
"10021","32147","2016",43,39,4,129664.2,1359.302,97.46512
"10022","32149","2016",14,14,0,239814.3,1656.429,137.7143
"10023","32150","2016",3,3,0,212583.3,1363.333,159.3333
"10024","32151","2016",1,1,0,70000,1400,50
"10025","32152","2016",10,10,0,119900,1230.1,100.1
"10026","32153","2016",1,1,0,80000,432,185
"10027","32155","2016",6,6,0,92133.33,1038.167,96.16667
"10028","32156","2016",5,5,0,181200,1221.2,153.2
"10029","32157","2016",1,1,0,160000,1391,115
"10030","32158","2016",2,2,0,97500,1091.5,90.5
"10031","32159","2016",4,4,0,106000,651.25,180.25
"10032","32160","2016",122,83,39,186737.3,2073.377,91.54918
"10033","32161","2016",1,1,0,40000,930,43
"10034","32162","2016",13,12,1,89428.77,876.1538,109.5385
"10035","32163","2016",3,3,0,97006.67,1431,69
"10036","32165","2016",3,3,0,115266.7,1039,120
"10037","32167","2016",2,2,0,148000,1373,108.5
"10038","32169","2016",1,1,0,85000,924,92
"10039","32170","2016",1,1,0,201700,1090,185
"10040","32171","2016",1,1,0,54200,350,155
"10041","32173","2016",2,2,0,171174.5,1422,120.5
"10042","32174","2016",2,2,0,88500,837,117.5
"10043","32175","2016",2,2,0,65000,1250,62.5
"10044","32177","2016",2,2,0,116550,1237.5,93
"10045","32178","2016",1,1,0,280000,2074,135
"10046","32180","2016",5,5,0,315742.4,1745.4,168.6
"10047","32181","2016",2,2,0,57500,761.5,94.5
"10048","32182","2016",2,2,0,127925,1834,73.5
"10049","32183","2016",2,2,0,199000,1946,104
"10050","32184","2016",1,1,0,122000,1017,120
"10051","32185","2016",1,1,0,165000,1122,147
"10052","32186","2016",1,1,0,157500,1731,91
"10053","32187","2016",2,2,0,182207.5,1305.5,118
"10054","32188","2016",1,1,0,48080,1603,30
"10055","32190","2016",5,5,0,110600,955,103.8
"10056","32192","2016",2,2,0,187440,1652,112
"10057","32193","2016",2,2,0,256200,1222.5,219.5
"10058","32196","2016",1,1,0,269130,2691,100
"10059","32197","2016",2,2,0,128000,1303.5,99.5
"10060","32199","2016",1,1,0,69000,595,116
"10061","32200","2016",3,3,0,200973.3,2529,99
"10062","32201","2016",4,4,0,70450,698.25,101.25
"10063","32202","2016",6,6,0,108833.3,1535.333,79.5
"10064","32203","2016",1,1,0,205000,2440,84
"10065","32204","2016",2,2,0,191500,1511.5,126
"10066","32206","2016",5,5,0,188974,1874,101.4
"10067","32208","2016",48,42,6,142346.3,1269.208,112.6875
"10068","32209","2016",3,3,0,92851,944,95.66667
"10069","32210","2016",6,6,0,141210,1339.667,104.1667
"10070","32211","2016",2,2,0,205800,1548,131.5
"10071","32212","2016",2,2,0,69750,817,81
"10072","32213","2016",40,37,3,140484,1572.525,93.85
"10073","32214","2016",1,1,0,95500,415,230
"10074","32215","2016",1,1,0,80000,630,127
"10075","32216","2016",1,1,0,136000,1347,101
"10076","32219","2016",4,4,0,143930,1298.5,105
"10077","32221","2016",1,1,0,90000,1084,83
"10078","32222","2016",1,1,0,142340,1483,96
"10079","32224","2016",3,3,0,297500,1886.667,138
"10080","32227","2016",7,7,0,120632.7,1073.857,117.4286
"10081","32228","2016",1,1,0,422000,2131,198
"10082","32229","2016",2,2,0,201100,1914.5,106
"10083","32231","2016",5,5,0,274140,1884,133.6
"10084","32233","2016",11,10,1,207595.5,1710.636,113.7273
"10085","32234","2016",1,1,0,170500,1833,93
"10086","32237","2016",5,5,0,193790,1831,115.4
"10087","32238","2016",3,3,0,137648.3,1283.667,100.3333
"10088","32239","2016",5,5,0,118821,1370,94.8
"10089","32242","2016",15,13,2,101200,1047.733,95.73333
"10090","32243","2016",3,3,0,103333.3,1287.333,88.66667
"10091","32244","2016",1,1,0,80000,1067,75
"10092","32245","2016",2,2,0,136478.5,2017.5,69
"10093","32246","2016",2,2,0,52500,577,91.5
"10094","32247","2016",3,3,0,201700,1743,115.3333
"10095","32249","2016",19,18,1,115907.9,1174.474,100.4211
"10096","32252","2016",13,13,0,128859.2,1126.385,116.3846
"10097","32253","2016",3,3,0,230066.7,1686,129.6667
"10098","32254","2016",4,4,0,175625,1407.5,124.5
"10099","32255","2016",1,1,0,170000,1062,160
"10100","32256","2016",37,36,1,105939.7,1042.081,100.5135
"10101","32258","2016",2,2,0,120500,1075,108.5
"10102","32261","2016",3,3,0,127500,1028,123
"10103","32262","2016",4,4,0,170850,1641.75,117.75
"10104","32265","2016",1,1,0,104000,765,136
"10105","32266","2016",2,2,0,130000,1038.5,123.5
"10106","32267","2016",4,4,0,291125,2156.25,147.5
"10107","32268","2016",5,5,0,145564,1182.8,108.8
"10108","32269","2016",9,9,0,140778.6,1242.556,118.3333
"10109","32270","2016",2,2,0,247987.5,1985.5,115
"10110","32271","2016",2,2,0,68650,722,107
"10111","32272","2016",3,3,0,86333.33,856,102.3333
"10112","32274","2016",2,2,0,148500,1054.5,161.5
"10113","32278","2016",2,2,0,182437.5,1317.5,132.5
"10114","32279","2016",12,12,0,178049.2,1531.167,122.9167
"10115","32280","2016",2,2,0,110320,975,116
"10116","32281","2016",2,2,0,161500,940.5,177.5
"10117","32282","2016",3,3,0,152666.7,1343.333,112.3333
"10118","32283","2016",1,1,0,126000,1400,90
"10119","32284","2016",1,1,0,160000,988,162
"10120","32285","2016",6,6,0,80382.5,861.1667,98.66667
"10121","32286","2016",7,7,0,114924.3,1193.857,96.28571
"10122","32287","2016",1,1,0,190000,2639,72
"10123","32288","2016",1,1,0,204000,1200,170
"10124","32289","2016",2,2,0,127500,1546.5,79.5
"10125","32290","2016",18,18,0,148193.1,1559.611,100.1111
"10126","32292","2016",2,2,0,85000,888,89.5
"10127","32296","2016",12,12,0,102775,950.6667,103.9167
"10128","32297","2016",1,1,0,150000,1000,150
"10129","32298","2016",1,1,0,226400,1530,148
"10130","32300","2016",3,3,0,180966.7,1932.667,95
"10131","32301","2016",12,12,0,194989.6,1655.417,118
"10132","32302","2016",1,1,0,390000,1950,200
"10133","32304","2016",1,1,0,148000,987,150
"10134","32305","2016",1,1,0,235000,805,292
"10135","32306","2016",5,5,0,167360,1501.4,116.4
"10136","32307","2016",24,24,0,148848.1,1505.792,100.5417
"10137","32308","2016",1,1,0,218500,2276,96
"10138","32309","2016",1,1,0,235827,1604,147
"10139","32310","2016",2,2,0,164550,1710.5,91
"10140","32311","2016",4,4,0,114500,1364.25,90.75
"10141","32312","2016",4,4,0,125142.5,1292,99.25
"10142","32313","2016",2,2,0,130000,866,141.5
"10143","32314","2016",1,1,0,141650,1771,80
"10144","32315","2016",2,2,0,44500,856,52
"10145","32316","2016",1,1,0,118000,663,178
"10146","32318","2016",1,1,0,297500,1740,171
"10147","32319","2016",14,14,0,118317.9,1043.071,114.8571
"10148","32320","2016",1,1,0,138000,1122,123
"10149","32321","2016",2,2,0,269913.5,2792.5,94
"10150","32322","2016",1,1,0,259000,1824,142
"10151","32325","2016",1,1,0,65000,663,98
"10152","32326","2016",1,1,0,2e+05,1562,128
"10153","32328","2016",1,1,0,144000,1200,120
"10154","32329","2016",3,3,0,156666.7,1267.333,166.6667
"10155","32331","2016",10,10,0,198753.5,1863.4,108.7
"10156","32332","2016",1,1,0,4e+05,1026,390
"10157","32333","2016",4,4,0,167355,1475.5,119.75
"10158","32334","2016",11,10,1,346831.8,2773.182,123.3636
"10159","32335","2016",2,2,0,193999.5,1668.5,116
"10160","32336","2016",4,4,0,272737.5,1766,169.75
"10161","32338","2016",1,1,0,48000,480,100
"10162","32339","2016",1,1,0,279500,1780,157
"10163","32340","2016",6,6,0,126883.8,1298,94.33333
"10164","32341","2016",3,3,0,160333.3,1310.333,127
"10165","32343","2016",3,3,0,158866.7,1494,108.3333
"10166","32344","2016",16,15,1,114925,973.5625,114.5625
"10167","32345","2016",7,7,0,305092.9,1448.571,182.1429
"10168","32346","2016",3,3,0,128000,1157.667,110
"10169","32347","2016",3,3,0,317926.7,4174.333,86
"10170","32348","2016",7,7,0,174431.4,1403,112.7143
"10171","32349","2016",2,2,0,159250,1376,117.5
"10172","32350","2016",1,1,0,80000,1455,55
"10173","32351","2016",1,1,0,1e+05,971,103
"10174","32352","2016",1,1,0,195000,1318,148
"10175","32353","2016",2,2,0,212180.5,1447,137.5
"10176","32354","2016",1,1,0,155000,969,160
"10177","32355","2016",1,1,0,174000,1289,135
"10178","32356","2016",1,1,0,50000,485,103
"10179","32357","2016",3,3,0,274433.3,1698.667,160.3333
"10180","32361","2016",1,1,0,170000,2000,85
"10181","32362","2016",4,4,0,114571.2,1267.25,92
"10182","32367","2016",1,1,0,53000,473,112
"10183","32368","2016",6,5,1,121534,1429,90.5
"10184","32370","2016",13,12,1,130779.2,950.3077,125
"10185","32372","2016",3,3,0,183166.7,1795.667,104.3333
"10186","32373","2016",2,2,0,137500,1426,120.5
"10187","32374","2016",3,3,0,137476.7,1458.333,97.66667
"10188","32375","2016",2,2,0,165525,1543.5,114.5
"10189","32376","2016",5,5,0,201732,1434.8,153.4
"10190","32377","2016",2,2,0,210725,1930,111
"10191","32378","2016",4,4,0,96852.5,1116,96.75
"10192","32379","2016",5,5,0,170560,2478.8,78.2
"10193","32380","2016",2,2,0,156000,1129,138
"10194","32381","2016",3,3,0,123966.7,1299.333,104.3333
"10195","32382","2016",3,3,0,177583.3,1215.667,156.3333
"10196","32383","2016",3,3,0,82666.67,686.3333,113.6667
"10197","32384","2016",2,2,0,100770,1054.5,97.5
"10198","32385","2016",1,1,0,192700,983,196
"10199","32386","2016",4,4,0,164400,984.5,173.5
"10200","32387","2016",2,2,0,184100,2048,103
"10201","32388","2016",3,3,0,204866.7,1416,155.6667
"10202","32389","2016",3,3,0,176666.7,1404,119.6667
"10203","32390","2016",1,1,0,170000,1223,139
"10204","32391","2016",4,4,0,149240,1482.25,105
"10205","32392","2016",1,1,0,230000,1769,130
"10206","32393","2016",2,2,0,137000,1308,105
"10207","32394","2016",3,3,0,128690,1126.667,116.6667
"10208","32395","2016",2,2,0,104000,969.5,102.5
"10209","32396","2016",3,3,0,146433.3,1519.667,98
"10210","32397","2016",2,2,0,203925,2131.5,86.5
"10211","32398","2016",2,2,0,81750,748.5,110
"10212","32402","2016",3,3,0,120666.7,2487.333,48.33333
"10213","32403","2016",2,2,0,166450,961.5,183
"10214","32404","2016",6,6,0,171166.7,1924.833,99
"10215","32405","2016",1,1,0,117000,1315,89
"10216","32406","2016",2,2,0,137982.5,1516,138.5
"10217","32407","2016",2,2,0,147000,1470.5,104.5
"10218","32408","2016",1,1,0,170000,1214,140
"10219","32410","2016",23,21,2,144799.6,1598.304,92.13043
"10220","32411","2016",1,1,0,150000,1200,125
"10221","32412","2016",11,10,1,85190.91,1050.727,85.81818
"10222","32414","2016",1,1,0,70000,787,89
"10223","32415","2016",1,1,0,148840,1445,103
"10224","32416","2016",5,5,0,112636.8,1161.4,101
"10225","32417","2016",5,5,0,211093,1580.8,146.2
"10226","32418","2016",4,4,0,304750,2234.25,121.25
"10227","32421","2016",1,1,0,129500,1727,75
"10228","32422","2016",1,1,0,150000,1000,150
"10229","32423","2016",1,1,0,125000,893,140
"10230","32424","2016",1,1,0,198200,1490,133
"10231","32425","2016",12,12,0,205712.5,2142.333,94.83333
"10232","32426","2016",14,13,1,113332.1,1162.143,100.4286
"10233","32427","2016",1,1,0,184000,1122,164
"10234","32428","2016",1,1,0,230000,1150,200
"10235","32429","2016",4,4,0,235652.5,1751.5,134.25
"10236","32432","2016",5,5,0,117200,927,126.8
"10237","32433","2016",8,8,0,116567.5,1035.25,121.625
"10238","32435","2016",3,3,0,159150,1476,113.3333
"10239","32436","2016",1,1,0,40000,333,120
"10240","32437","2016",1,1,0,124600,1449,86
"10241","32438","2016",1,1,0,140000,1429,98
"10242","32439","2016",2,2,0,81390,792,103.5
"10243","32440","2016",1,1,0,126000,1273,99
"10244","32442","2016",6,6,0,131416.7,1554.833,99.66667
"10245","32443","2016",2,2,0,67500,1062.5,63
"10246","32444","2016",3,3,0,202733.3,1510,134
"10247","32445","2016",3,3,0,122000,1054.667,122.3333
"10248","32446","2016",2,1,1,110000,2833.5,67.5
"10249","32447","2016",1,1,0,162901,1253,130
"10250","32448","2016",4,4,0,192812.8,1341.25,141.75
"10251","32449","2016",1,1,0,55000,524,105
"10252","32450","2016",1,1,0,210000,1312,160
"10253","32451","2016",2,2,0,177750,1343.5,123
"10254","32452","2016",3,3,0,122333.3,897.3333,140.3333
"10255","32454","2016",1,1,0,110000,1196,92
"10256","32455","2016",2,2,0,167290,1007,165
"10257","32456","2016",2,2,0,188335,1131.5,158
"10258","32457","2016",3,3,0,136666.7,981.6667,149.6667
"10259","32458","2016",3,3,0,71000,924,75.66667
"10260","32459","2016",11,10,1,141158.6,1279.455,120.2727
"10261","32460","2016",1,1,0,133000,1511,88
"10262","32462","2016",42,40,2,109059.5,1047.69,104.4762
"10263","32463","2016",9,9,0,135040.6,1384.778,120.1111
"10264","32464","2016",8,8,0,164181.2,1400.375,113.875
"10265","32465","2016",1,1,0,183540,1311,140
"10266","32466","2016",1,1,0,106000,1071,99
"10267","32467","2016",1,1,0,212500,2335,91
"10268","33001","2016",22,21,1,122781.7,1197,101.1818
"10269","33002","2016",6,6,0,169100,1099.667,138.1667
"10270","33003","2016",148,130,18,182984.8,2166.439,88.7973
"10271","33004","2016",28,24,4,134857.1,1717.464,84.28571
"10272","33005","2016",247,183,64,289414,3661.668,84.44534
"10273","33006","2016",10,10,0,97268,905,108.9
"10274","33007","2016",6,6,0,177116.7,2056.167,89.83333
"10275","33008","2016",4,4,0,172187.5,1381.25,117
"10276","33009","2016",571,153,418,329110.3,5090.089,64.99825
"10277","33010","2016",11,11,0,154989.9,1728.273,90.36364
"10278","33011","2016",126,107,19,266679.8,3327,83.06349
"10279","33012","2016",37,37,0,231179.2,2113.973,111.6757
"10280","33013","2016",72,54,18,240425.8,2700.764,91.33333
"10281","33014","2016",11,11,0,164139.1,1528.364,103.2727
"10282","33015","2016",22,21,1,162170.5,1657.955,100.9545
"10283","33016","2016",4,4,0,176327.5,1756,108
"10284","33017","2016",2,2,0,228150,1657.5,141.5
"10285","33018","2016",29,29,0,193181.8,1844.379,104.3448
"10286","33019","2016",140,115,25,212069.9,2475.35,88.53571
"10287","33021","2016",10,10,0,161170,1535.3,107.4
"10288","33022","2016",36,35,1,192364.1,1946.306,101.1111
"10289","33023","2016",15,15,0,243161.3,2315.533,106.2
"10290","33024","2016",2,2,0,162000,1405,116
"10291","33025","2016",3,3,0,280000,2677.667,104.3333
"10292","33026","2016",10,10,0,184283,1465,134.4
"10293","33027","2016",6,6,0,133666.7,1102.833,134.5
"10294","33028","2016",10,10,0,199351,1648.1,132.1
"10295","33029","2016",71,54,17,205240,2290.437,89.92958
"10296","33030","2016",31,29,2,119617.7,1210.194,100.1613
"10297","33031","2016",3,3,0,153312.7,1124,136.6667
"10298","33032","2016",50,40,10,207303.9,2446.4,91.72
"10299","33033","2016",8,8,0,209157.5,1993.5,102.875
"10300","33034","2016",7,7,0,107371.4,1365.143,80
"10301","33035","2016",7,7,0,74871.43,1164.286,78.57143
"10302","33036","2016",36,32,4,130297.2,1444.583,92.66667
"10303","33037","2016",21,21,0,199784,1874.857,109.7143
"10304","33038","2016",14,14,0,170648.8,1292.786,136.2857
"10305","33039","2016",404,221,183,206774.3,2858.488,73.54455
"10306","33040","2016",9,9,0,130016.7,1181.333,112
"10307","33042","2016",64,61,3,207708.4,1860.656,113.4375
"10308","33043","2016",2,2,0,225450,1728,130.5
"10309","33044","2016",2,2,0,209500,2118,95
"10310","33046","2016",12,12,0,126524.2,1356.917,93.08333
"10311","33047","2016",16,16,0,167908.4,1311.75,125.25
"10312","33048","2016",2,2,0,302500,1364,199.5
"10313","33049","2016",20,20,0,190298,1908.8,104.85
"10314","33050","2016",6,6,0,159916.7,1443.667,112.8333
"10315","33051","2016",161,132,29,207513.2,2424.807,88.3913
"10316","33052","2016",15,15,0,141583.3,1301.4,111
"10317","33053","2016",5,5,0,173740,1470.8,127.8
"10318","33054","2016",1,1,0,220000,1128,195
"10319","33055","2016",8,8,0,119831.2,1324.125,95.625
"10320","33056","2016",157,103,54,225067.6,2560.439,88.91083
"10321","33057","2016",8,8,0,183730,1464.5,126.5
"10322","33058","2016",55,47,8,118275.1,1294.927,95.8
"10323","33059","2016",1,1,0,173000,2035,85
"10324","33060","2016",6,6,0,214966.7,1504.667,144
"10325","33061","2016",16,16,0,261528.8,2202.812,117.625
"10326","33062","2016",10,10,0,286146.5,2739.6,118.3
"10327","33063","2016",5071,1271,3800,246208.5,3533.079,71.02327
"10328","33065","2016",37,37,0,386147.5,3142.486,130.3243
"10329","33067","2016",23,22,1,114975.9,1198,102.2174
"10330","33068","2016",1,1,0,205000,1464,140
"10331","33069","2016",459,212,247,279479.7,3263.353,85.45534
"10332","33070","2016",7,7,0,198003.6,1833.857,104.5714
"10333","33071","2016",17,17,0,150250,1521.647,105.4118
"10334","33073","2016",11,11,0,116640.1,1239.636,104
"10335","33074","2016",2,2,0,106000,944.5,116
"10336","33075","2016",239,100,139,233778.2,2814.586,81.70293
"10337","33076","2016",13,13,0,147538.5,1514.615,105.2308
"10338","33077","2016",28,28,0,208167.1,1855.643,115.8929
"10339","33079","2016",2,2,0,197700,1773.5,112.5
"10340","33080","2016",71,58,13,198636,2458.014,87.88732
"10341","33081","2016",31,25,6,123137.1,1408.871,101.129
"10342","33082","2016",10,10,0,188050.2,1737.1,106.9
"10343","33083","2016",14,14,0,210464.4,2161,107.1429
"10344","33084","2016",26,26,0,256397.7,2260.962,114.0769
"10345","33085","2016",34,34,0,274085.6,2594.618,108.2353
"10346","33086","2016",4,4,0,158134.8,1566.75,106.5
"10347","33087","2016",5,5,0,131340,1303,97
"10348","33088","2016",8,8,0,137137.5,1095.75,129.25
"10349","33089","2016",8,8,0,119906.2,1083.875,108.25
"10350","33090","2016",47,45,2,243857.5,2758.809,93.78723
"10351","33093","2016",12,12,0,187596.2,1663.75,109.8333
"10352","33094","2016",2,2,0,101500,772.5,132
"10353","33095","2016",22,22,0,130218.2,1197,113.7727
"10354","33096","2016",101,72,29,189205.1,2167.683,87.36634
"10355","33097","2016",93,55,38,160614.8,2615.172,64.56989
"10356","33098","2016",1,1,0,150000,1875,80
"10357","33099","2016",36,33,3,285955.8,2512.306,112.7222
"10358","33100","2016",12,11,1,139958.3,1465.667,95.83333
"10359","33101","2016",6,6,0,149583.3,1401.833,117.3333
"10360","33102","2016",4,4,0,130875,1055.25,122.75
"10361","33103","2016",2,2,0,75000,915,82
"10362","33104","2016",75,55,20,158050.8,1922.24,83.10667
"10363","33105","2016",1,1,0,138000,1500,92
"10364","33106","2016",15,15,0,156466.7,1334.667,118.4
"10365","33108","2016",29,27,2,83593.1,989.9655,89.58621
"10366","33109","2016",28,28,0,199841.9,2212.821,92.10714
"10367","33111","2016",11,9,2,156090.9,1464.909,115.6364
"10368","33112","2016",2,2,0,107400,995,109.5
"10369","33113","2016",4,4,0,141125,1149.25,127.25
"10370","33114","2016",23,23,0,167934.3,1773.13,97.65217
"10371","33115","2016",4,4,0,122000,817,116.75
"10372","33116","2016",5,5,0,223820,1770.2,123.2
"10373","33117","2016",4,4,0,100500,877.25,177.5
"10374","33118","2016",18,18,0,251003.9,2207.778,113.1667
"10375","33119","2016",287,145,142,167054,2339.136,72.33101
"10376","33120","2016",20,19,1,142284.8,1563.8,92.15
"10377","33121","2016",1,1,0,90000,1059,85
"10378","33122","2016",145,138,7,297114.7,2845.869,106.9241
"10379","33123","2016",31,31,0,159733.8,1542.645,108.4839
"10380","33124","2016",4,4,0,160725,1160.25,129.25
"10381","33125","2016",24,24,0,162382.4,1420.833,116.0417
"10382","33126","2016",7,7,0,145678.6,2491.286,92.14286
"10383","33127","2016",2,2,0,77000,570,132
"10384","33128","2016",7,7,0,118714.3,1064.429,111.5714
"10385","33129","2016",4,4,0,271050,1419.5,195.75
"10386","33130","2016",14,13,1,168316.6,1624.357,106.0714
"10387","33131","2016",1,1,0,173700,1737,100
"10388","33132","2016",5,5,0,105281,915.6,122.2
"10389","33133","2016",1,1,0,50000,556,90
"10390","33134","2016",5,5,0,165216.8,1399.6,113.8
"10391","33135","2016",1,1,0,140300,1461,96
"10392","33136","2016",1,1,0,140000,1167,120
"10393","33137","2016",3,3,0,146650,1479.333,100
"10394","33138","2016",96,88,8,127358.9,1435.729,91.28125
"10395","33140","2016",81,67,14,166671.7,1938.395,84.98765
"10396","33141","2016",5,5,0,248600,2136.4,115
"10397","33142","2016",19,19,0,180672.1,1934.053,102.2632
"10398","33143","2016",32,30,2,180086.7,1858.344,104.0938
"10399","33144","2016",12,12,0,157271.2,1416.167,116.1667
"10400","33145","2016",7,7,0,196578.6,1954.286,99.42857
"10401","33146","2016",26,26,0,137348.1,1336.538,103.5
"10402","33147","2016",5,5,0,165000,1642,110
"10403","33148","2016",2,2,0,214950,1666,132.5
"10404","33149","2016",1,1,0,150000,1500,100
"10405","33150","2016",2,2,0,168800,1689.5,108.5
"10406","33151","2016",7,7,0,114285.7,1016.429,116.1429
"10407","33152","2016",3,3,0,259000,1818.667,135.6667
"10408","33153","2016",2,2,0,143500,1300.5,114.5
"10409","33154","2016",17,16,1,116529.4,1138.647,107.7647
"10410","33155","2016",3,3,0,144666.7,1129.333,126
"10411","33156","2016",1,1,0,218000,1267,172
"10412","33157","2016",7,7,0,245821.4,2038.714,120.1429
"10413","33158","2016",4,4,0,242250,2220.75,120
"10414","33159","2016",11,9,2,111181.8,1106,101
"10415","33160","2016",10,10,0,138750,1080,118.6
"10416","33161","2016",11,11,0,121663.6,1212.818,99.81818
"10417","33162","2016",260,177,83,230779.3,2701.05,87.90769
"10418","33163","2016",4,4,0,153675,1551.75,104.5
"10419","33164","2016",24,24,0,202404,1848.042,110.7917
"10420","33165","2016",41,23,18,190475.7,2466.951,80.34146
"10421","33166","2016",6,6,0,129450,1047.833,122.3333
"10422","33167","2016",173,123,50,208040.4,2528.092,86.4104
"10423","33168","2016",4,4,0,116950,1169.75,99.25
"10424","33170","2016",8,8,0,120362.5,1392.5,85.75
"10425","33172","2016",2,2,0,156000,906.5,172
"10426","33174","2016",10,10,0,171102.5,1731.9,111.2
"10427","33175","2016",4,3,1,134472.5,1496.25,106.75
"10428","33176","2016",2,2,0,194500,1804,108
"10429","33177","2016",30,30,0,173364.1,1455.633,118.5667
"10430","33178","2016",3,3,0,126666.7,1470.333,83.66667
"10431","33179","2016",27,27,0,164314.1,1548.556,101.7778
"10432","33180","2016",1,1,0,212000,1178,180
"10433","33181","2016",2,2,0,228637.5,1531.5,149.5
"10434","33182","2016",8,8,0,132612.5,1104.375,126.5
"10435","33183","2016",16,16,0,161748.4,1607.188,103.875
"10436","33184","2016",5,5,0,81247,910.6,84.4
"10437","33185","2016",15,13,2,203368.8,1888,104.6
"10438","33186","2016",12,12,0,150729.2,1161.75,134.5
"10439","33187","2016",12,11,1,98962.25,817.25,137.9167
"10440","33188","2016",3,3,0,102333.3,731.3333,159
"10441","33189","2016",4,4,0,94750,1073.75,97.5
"10442","33191","2016",3,3,0,76333.33,1148.667,70
"10443","33192","2016",313,113,200,198413.2,2707.141,74.82428
"10444","33193","2016",17,17,0,173833.5,1912.882,91.76471
"10445","33194","2016",4,4,0,129875,1492.25,109.5
"10446","33195","2016",11,11,0,101672.7,907.3636,120.6364
"10447","33197","2016",4,4,0,110050,1558.25,80.75
"10448","33198","2016",26,25,1,126535.2,1105.269,119.0385
"10449","33199","2016",425,355,70,253175.2,3061.264,85.29647
"10450","33200","2016",123,102,21,269099.6,2840.114,94.97561
"10451","33201","2016",5,4,1,223100,2222.8,99.6
"10452","33202","2016",23,21,2,158621.7,1934.304,96.82609
"10453","33203","2016",130,104,26,152407.2,2261.315,71.49231
"10454","33204","2016",7,7,0,140111.4,1411,100.2857
"10455","33205","2016",12,12,0,257457.5,2781.75,111.75
"10456","33206","2016",4,4,0,235387.5,3656.5,80.75
"10457","33207","2016",61,58,3,222579.5,2151.377,107.7049
"10458","33208","2016",13,13,0,120455.2,1469.769,95.38462
"10459","33209","2016",4,4,0,126000,1187.75,103.25
"10460","33210","2016",1,1,0,147500,2269,65
"10461","33211","2016",9,9,0,172038.9,1805.778,96.88889
"10462","33212","2016",3,3,0,110666.7,1156,87.33333
"10463","33213","2016",35,32,3,296559.3,2698.057,114.3143
"10464","33214","2016",243,179,64,203130.7,3400.675,64.40329
"10465","33215","2016",3,3,0,181363.3,1160.333,171.3333
"10466","33216","2016",2,2,0,162500,1510,107.5
"10467","33218","2016",10,10,0,135720,1380.9,97.9
"10468","33219","2016",28,25,3,179943.7,1808.179,108.75
"10469","33220","2016",11,11,0,130705.5,1413.727,92.45455
"10470","33221","2016",7,7,0,93242.86,1050.714,91.71429
"10471","33222","2016",3,3,0,394450,2386,179.6667
"10472","33223","2016",1,1,0,97000,1386,70
"10473","33225","2016",18,18,0,201159.3,1625.556,132.1667
"10474","33226","2016",41,40,1,165106.1,1548.707,112.1951
"10475","33227","2016",91,69,22,148898.3,1695.857,88.65934
"10476","33228","2016",5,5,0,161842,1418,118
"10477","33229","2016",134,117,17,270779.4,3138.336,91.39552
"10478","33230","2016",4,4,0,123375,1017,125
"10479","33231","2016",3,3,0,318533.3,1468.333,187
"10480","33232","2016",1,1,0,67000,475,141
"10481","33233","2016",22,22,0,141885.7,1462.045,99.95455
"10482","33234","2016",35,35,0,343731.4,3221.914,112.9143
"10483","33235","2016",5,5,0,204360,1922,122.8
"10484","33236","2016",143,119,24,482511,4951.063,98.95804
"10485","33237","2016",7,7,0,156034.3,1486.571,106.5714
"10486","33238","2016",106,101,5,282589.8,2668.689,109.3774
"10487","33239","2016",7,7,0,121500,960,136.7143
"10488","33240","2016",72,60,12,129891.7,1530.264,94.47222
"10489","33241","2016",10,8,2,125940,1655.7,81.3
"10490","33242","2016",2,2,0,221200,949.5,205
"10491","33243","2016",351,242,109,141705.2,1760.601,83.05698
"10492","33244","2016",3,3,0,140000,1156,149.3333
"10493","33245","2016",8,8,0,405746.9,2443.5,165.75
"10494","33246","2016",2,2,0,116500,1227.5,95
"10495","33248","2016",41,35,6,151198.9,1502.78,100.7317
"10496","33249","2016",231,87,144,160184.1,2279.182,73.50216
"10497","33250","2016",3,3,0,120666.7,995.6667,121.3333
"10498","33251","2016",7,7,0,222257.1,1585.143,140.8571
"10499","33252","2016",9,9,0,265622.2,2396.556,109.2222
"10500","33253","2016",10,10,0,143230,1470.2,98.5
"10501","33254","2016",4,4,0,129462.5,1074.75,131.5
"10502","33255","2016",1,1,0,210000,1615,130
"10503","33256","2016",61,55,6,215122.7,2229.705,99.4918
"10504","33257","2016",3,3,0,203833.3,1772.333,121.3333
"10505","33259","2016",11,10,1,149768.2,1349,109.5455
"10506","33260","2016",9,9,0,186675.7,1686,119.6667
"10507","33261","2016",3,3,0,56666.67,974,61.66667
"10508","33262","2016",62,59,3,205608.8,2199.419,96.56452
"10509","33263","2016",3,3,0,214200,1721.333,126.6667
"10510","33264","2016",6,6,0,98602.67,1128,83.66667
"10511","33266","2016",6,6,0,166016.7,1451.667,119.1667
"10512","33268","2016",39,37,2,321120.6,2236.026,105.2821
"10513","33269","2016",4,4,0,241250,1589.25,139
"10514","33271","2016",1,1,0,180000,1782,101
"10515","33272","2016",8,8,0,200412.5,1674,121.5
"10516","33273","2016",72,62,10,284670.2,2717.556,107.4583
"10517","33274","2016",27,21,6,252701.9,2475.519,102.4815
"10518","33275","2016",1,1,0,182550,2173,84
"10519","33277","2016",2,2,0,144000,1325,105
"10520","33278","2016",1,1,0,150000,1181,127
"10521","33279","2016",6,6,0,208583.3,1355.5,153
"10522","33280","2016",4,4,0,163000,1508.25,110.75
"10523","33281","2016",1235,452,783,204861.8,2685.869,76.64534
"10524","33282","2016",3,3,0,150000,1531.667,104.3333
"10525","33283","2016",2,2,0,112500,1022.5,110
"10526","33284","2016",134,124,10,230634.8,2308.41,103.3358
"10527","33285","2016",6,6,0,135083.3,1386.5,107
"10528","33287","2016",10,10,0,126508.6,1100.4,115.8
"10529","33288","2016",3,3,0,166540,1265.333,125.6667
"10530","33289","2016",25,23,2,125439.6,1174.08,108.36
"10531","33290","2016",16,16,0,193300,1593.125,119.6875
"10532","33293","2016",26,23,3,214011.5,2104.808,103.4615
"10533","33294","2016",2,2,0,83750,821.5,97.5
"10534","33296","2016",11,11,0,129841.4,1276,106.5455
"10535","33297","2016",19,18,1,182999.2,1872.737,102.2632
"10536","33298","2016",9,9,0,282333.3,1739.333,140.1111
"10537","33299","2016",1,1,0,197000,1231,160
"10538","33300","2016",17,17,0,155657.9,1795.412,90.05882
"10539","33301","2016",1,1,0,76375,955,80
"10540","33302","2016",3,3,0,120333.3,1354.667,91.33333
"10541","33303","2016",6,6,0,140816.7,1535.667,93.5
"10542","33304","2016",1,1,0,120000,1121,107
"10543","33305","2016",3,3,0,105666.7,1352.667,81
"10544","33306","2016",3,3,0,227000,2592,93
"10545","33307","2016",17,17,0,167294.1,1465.882,116.1765
"10546","33308","2016",5,5,0,158450,1388.8,114.4
"10547","33309","2016",2,2,0,117500,928,123
"10548","33311","2016",8,7,1,141687.5,1619.875,97.125
"10549","33312","2016",72,60,12,214298.5,2476.972,89.02778
"10550","33314","2016",63,60,3,130480,1482.032,90.68254
"10551","33315","2016",15,15,0,144748,1329.467,113.6667
"10552","33316","2016",9,9,0,143240,1344.667,107.1111
"10553","33317","2016",5,5,0,150270,1725.4,91.8
"10554","33318","2016",742,451,291,243932.6,2849.801,86.06469
"10555","33319","2016",3,3,0,91333.33,886,97.66667
"10556","33320","2016",7,7,0,107571.9,1180.571,94.85714
"10557","33321","2016",16,16,0,200287.5,2085,97.375
"10558","33322","2016",77,75,2,258746.2,2444.195,108.3247
"10559","33323","2016",10,10,0,181750,1484.9,120.5
"10560","33324","2016",52,49,3,113686.5,1252.904,95.78846
"10561","33325","2016",11,11,0,127340.9,1524.727,90.90909
"10562","33326","2016",3,3,0,150000,1214,121
"10563","33327","2016",27,27,0,161000.7,1818.519,93.77778
"10564","33328","2016",5,5,0,134011.2,1299.4,102.6
"10565","33329","2016",7,7,0,210082.1,1587.143,139.2857
"10566","33330","2016",35,25,10,236892,2643.886,97.51429
"10567","33331","2016",5,5,0,264179.4,1795.8,154.8
"10568","33332","2016",14,14,0,128073.6,1297.214,103.9286
"10569","33333","2016",38,38,0,232046.1,2427.974,98.76316
"10570","33334","2016",29,27,2,207560,1995.517,108.7241
"10571","33335","2016",7,7,0,186227.7,1970.857,92.14286
"10572","33336","2016",17,17,0,142255.9,1508.941,106.7647
"10573","33337","2016",19,18,1,135900,1351.789,106.5263
"10574","33339","2016",23,23,0,155382.6,1443.652,114.4348
"10575","33341","2016",19,19,0,154368.9,1658.105,105.3684
"10576","33342","2016",10,9,1,197175.8,1765.7,115.4
"10577","33343","2016",11,11,0,174493.2,1620.818,106.8182
"10578","33344","2016",7,7,0,101900,1182.286,84.42857
"10579","33345","2016",6,6,0,179258.3,1701.167,101.3333
"10580","33346","2016",4,4,0,166428,1822,103.75
"10581","33347","2016",1,1,0,40000,500,80
"10582","33348","2016",15,15,0,109586.5,1507.133,80.53333
"10583","33349","2016",23,23,0,319756.5,2357.609,137.9565
"10584","33350","2016",15,15,0,128251.5,1204.8,107.2
"10585","33351","2016",18,18,0,87872.22,929.6667,96
"10586","33352","2016",44,40,4,112942.9,1308.5,89.5
"10587","33353","2016",4,4,0,137625,1156.5,125.75
"10588","33354","2016",2,2,0,83000,1007,86
"10589","33355","2016",18,18,0,162331.5,1588.778,101.8889
"10590","33356","2016",4,4,0,178770,1505.5,121.25
"10591","33357","2016",20,20,0,203707.5,1730.6,116.35
"10592","33358","2016",3,3,0,182000,1393.333,133
"10593","33359","2016",2,2,0,1e+05,1041,98
"10594","33360","2016",5,5,0,107200,1118.6,95.6
"10595","33361","2016",9,9,0,230844.9,1417,160.8889
"10596","33362","2016",13,13,0,110342.3,1301.538,87.30769
"10597","33363","2016",46,45,1,261479.3,2137.587,120.4348
"10598","33364","2016",3,3,0,239800,1908.667,125
"10599","33365","2016",1,1,0,82000,781,105
"10600","33366","2016",125,107,18,169599.1,1860.768,96.04
"10601","33367","2016",2,1,1,275500,1953,144.5
"10602","33369","2016",4,4,0,184493.2,1297,146.5
"10603","33370","2016",5,5,0,105862,912.8,127
"10604","33373","2016",6,6,0,103370,1154.167,88.66667
"10605","33374","2016",4,4,0,137960,852.75,137.25
"10606","33375","2016",6,6,0,262891.7,2921.167,86.16667
"10607","33376","2016",71,65,6,349848.8,2948.352,122.2676
"10608","33378","2016",13,13,0,124892.3,1206.462,105.5385
"10609","33379","2016",3,3,0,159766.7,1557,100.3333
"10610","33380","2016",15,15,0,114086,995.6667,124.4667
"10611","33381","2016",26,25,1,257982.3,2447.769,104.5769
"10612","33382","2016",16,16,0,126291.6,1174.438,107.8125
"10613","33383","2016",11,11,0,163009.1,1328.273,111
"10614","33384","2016",4,4,0,204675,2353,90.75
"10615","33385","2016",6,6,0,138933.3,1139.167,118.6667
"10616","33386","2016",3,3,0,161000,1076,143.3333
"10617","33387","2016",13,13,0,169576.9,1492.308,113.2308
"10618","33388","2016",5,5,0,135340,1203,117
"10619","33389","2016",27,27,0,110609.3,1110.667,100.1852
"10620","33390","2016",7,7,0,205514.3,1766.429,118.7143
"10621","33391","2016",4,4,0,199750,1217.5,158.5
"10622","33392","2016",8,7,1,132756.9,1168.75,119.75
"10623","33393","2016",49,48,1,142599,1465.714,99.93878
"10624","33394","2016",16,13,3,276481.2,3093.312,106.5625
"10625","33395","2016",24,24,0,117727.4,1141.75,106.2083
"10626","33396","2016",5,5,0,190200,2078.6,98.4
"10627","33397","2016",42,41,1,239357.3,2263.381,107.5238
"10628","33398","2016",2,2,0,140650,1351,93.5
"10629","33399","2016",4,4,0,217375,1694.5,124
"10630","33400","2016",12,12,0,124346.6,946.6667,140.5833
"10631","33401","2016",2,2,0,162625,1611,101
"10632","33402","2016",32,19,13,75384.38,824.75,86.625
"10633","33403","2016",1,1,0,140000,2295,61
"10634","33404","2016",2,2,0,212000,1522.5,142.5
"10635","33405","2016",5,5,0,193000,1439.6,126.2
"10636","33406","2016",6,6,0,245383.3,1762.833,129.3333
"10637","33407","2016",10,10,0,167726.5,1473.6,125.7
"10638","33408","2016",5,5,0,287980,2244,136.4
"10639","33412","2016",15,15,0,146043.7,1365.267,111.2
"10640","33413","2016",19,18,1,171876.3,1655.526,105.5789
"10641","33415","2016",21,17,4,185158.3,1605.143,119.3333
"10642","33416","2016",8,8,0,95751.25,842.5,119
"10643","33417","2016",33,33,0,231653.6,2262.485,108.6061
"10644","33418","2016",3,3,0,122000,1179.667,110
"10645","33421","2016",6,6,0,166666.7,1228,137.1667
"10646","33422","2016",58,43,15,279719.7,2846.328,101.5862
"10647","33423","2016",6,6,0,113500,1604.833,74.33333
"10648","33424","2016",61,60,1,153648.5,1518.295,103.8033
"10649","33425","2016",20,19,1,154992.5,1730.05,95.55
"10650","33426","2016",2,2,0,260700,2023.5,126.5
"10651","33427","2016",4,4,0,210180,1891.75,113.25
"10652","33429","2016",6,6,0,147533.3,1274.667,119.8333
"10653","33431","2016",1,1,0,230950,1375,168
"10654","33433","2016",94,90,4,209122.2,2139.191,100.4787
"10655","33434","2016",20,19,1,174601.5,1753.3,105.95
"10656","33435","2016",27,24,3,134266.7,1253.074,107.1852
"10657","33436","2016",7,7,0,167513.6,1684.286,98.85714
"10658","33437","2016",26,26,0,163008.4,2028.269,90.69231
"10659","33438","2016",18,18,0,163926.1,1598.611,107.1667
"10660","33439","2016",15,15,0,169556.7,1608.4,103.2667
"10661","33440","2016",1,1,0,75000,688,109
"10662","33441","2016",10,10,0,134829,1241,114.6
"10663","33442","2016",6,6,0,202443.3,1506.333,130.6667
"10664","33443","2016",1,1,0,138000,920,150
"10665","33444","2016",4,4,0,157562.5,1434.25,137.25
"10666","33445","2016",6,6,0,135000,1267.667,111.6667
"10667","33447","2016",23,22,1,93845.91,1236,81.3913
"10668","33448","2016",25,23,2,252572.4,2551.96,99.6
"10669","33449","2016",329,286,43,278846.8,2810.754,101.8906
"10670","33450","2016",3,3,0,89520.67,954.3333,100
"10671","33451","2016",6,6,0,211600,1699.667,130.3333
"10672","33452","2016",5,5,0,184934,1704.4,120.2
"10673","33453","2016",2,2,0,219225,1766,120
"10674","33454","2016",10,10,0,356578,2311.9,151
"10675","33456","2016",3,3,0,169333.3,1611.667,98
"10676","33457","2016",8,8,0,173153.8,1478.5,123.625
"10677","33458","2016",8,8,0,73062.5,828.375,89.125
"10678","33459","2016",2,2,0,308500,3360.5,92.5
"10679","33460","2016",4,4,0,330000,2191.5,132.75
"10680","33461","2016",6,6,0,194583.3,1131,150.1667
"10681","33462","2016",5,5,0,140420,1341,113.4
"10682","33463","2016",10,10,0,149960.5,1474.3,103.8
"10683","33464","2016",2,2,0,222500,1041,207
"10684","33465","2016",8,8,0,116477.9,1360.25,86.125
"10685","33466","2016",22,19,3,147477.3,1641.909,92.59091
"10686","33467","2016",2,2,0,176000,1549.5,112.5
"10687","33468","2016",3,3,0,182975,1354,140.6667
"10688","33470","2016",8,8,0,168687.5,1770.125,99.875
"10689","33471","2016",12,12,0,107438.7,1173.417,90.66667
"10690","33472","2016",6,6,0,245070.3,1704.667,137.1667
"10691","33473","2016",27,27,0,136305.2,1534.815,94.66667
"10692","33474","2016",44,42,2,259680.5,2390.341,110.4091
"10693","33475","2016",7,7,0,147881.4,1224.571,111.1429
"10694","33476","2016",6,6,0,80706.67,739.5,115.8333
"10695","33477","2016",6,6,0,121047.5,1233.5,98.66667
"10696","33478","2016",34,34,0,126520.9,1342.706,89.67647
"10697","33479","2016",3,3,0,281166.7,1675.333,157.3333
"10698","33480","2016",10,10,0,208606,1766.1,121.6
"10699","33482","2016",2,2,0,325025,2125,150
"10700","33483","2016",44,41,3,264415.7,2326.205,116.5227
"10701","33484","2016",23,22,1,113504.3,1142.348,98.6087
"10702","33485","2016",20,20,0,146922.5,1228.3,122.6
"10703","33486","2016",4,4,0,128250,1288.75,95.25
"10704","33487","2016",6,6,0,187350,2191.167,82.83333
"10705","33488","2016",3,3,0,165000,1494,108
"10706","33489","2016",2,2,0,222997,2185,104.5
"10707","33490","2016",32,31,1,161271.1,2145.969,99.03125
"10708","33491","2016",1,1,0,182318,1842,99
"10709","33492","2016",29,28,1,132126.7,1411.138,93.86207
"10710","33493","2016",1,1,0,68400,752,91
"10711","33494","2016",7,7,0,194828.6,2169.857,89.14286
"10712","33496","2016",28,27,1,229881.4,2308.214,100.6786
"10713","33498","2016",105,98,7,233599.1,2166.505,110.4476
"10714","33499","2016",1,1,0,50000,617,81
"10715","33500","2016",4,4,0,175162.5,2082.25,96.5
"10716","33501","2016",43,41,2,255722.4,2248.837,120.1163
"10717","33502","2016",4,4,0,120152.5,941.75,122.25
"10718","33503","2016",7,7,0,219578.6,2025,112.1429
"10719","33504","2016",10,10,0,215550,1428.7,157.2
"10720","33505","2016",15,15,0,220520.7,1969.6,112.2
"10721","33506","2016",22,22,0,162895.5,1312.273,121.4091
"10722","33507","2016",2,2,0,207557.5,1786,117.5
"10723","33508","2016",9,9,0,157976.7,1462.889,117.7778
"10724","33509","2016",4,4,0,162500,1253.5,146
"10725","33510","2016",2,2,0,107000,845,135
"10726","33511","2016",2,2,0,163000,1340,118.5
"10727","33512","2016",3,3,0,123500,1144.667,111.3333
"10728","33514","2016",116,90,26,177027.2,2593.905,74.28448
"10729","33515","2016",4,4,0,147550,1391.75,113.75
"10730","33516","2016",3,3,0,85000,827,106.3333
"10731","33517","2016",20,20,0,162422.3,1646.6,96.55
"10732","33518","2016",11,11,0,201500,1854,114.3636
"10733","33519","2016",113,102,11,282375.6,2745.381,105.0088
"10734","33520","2016",3,3,0,111666.7,984,113.3333
"10735","33521","2016",14,14,0,211035.7,1740.786,102
"10736","33522","2016",683,248,435,194453.6,3065.331,66.15227
"10737","33523","2016",14,13,1,176240.7,1823.071,97.35714
"10738","33524","2016",3,3,0,222844,1714.333,128
"10739","33525","2016",14,14,0,159057.1,1486.071,103.2857
"10740","33526","2016",2,2,0,110000,1611.5,84.5
"10741","33527","2016",106,92,14,239746.8,2611.057,92.92453
"10742","33528","2016",12,12,0,212970.8,1802,119.0833
"10743","33529","2016",506,382,124,345220.4,3701.028,90.63439
"10744","33530","2016",10,10,0,167970,1386.6,125.3
"10745","33531","2016",2,2,0,287500,2048.5,138.5
"10746","33532","2016",2,2,0,153000,1021,163.5
"10747","33533","2016",29,23,6,129979,1594.759,81.13793
"10748","33534","2016",9,9,0,219168.9,2177,108.5556
"10749","33535","2016",40,39,1,265860,2620.65,103.525
"10750","33536","2016",3,3,0,212806.7,2186.667,96.66667
"10751","33537","2016",6,6,0,138283.3,1492,90.66667
"10752","33538","2016",4,4,0,84755,938.5,92.5
"10753","33539","2016",38,34,4,184610.5,1840.5,100.1053
"10754","33540","2016",69,68,1,178987.6,2131.681,90.75362
"10755","33541","2016",12,12,0,202897.1,2578.583,89.58333
"10756","33542","2016",7,5,2,156975,1276,128.8571
"10757","33543","2016",9,9,0,148064.8,1539.889,96.22222
"10758","33544","2016",47,31,16,108112.4,1557.745,71.19149
"10759","33545","2016",17,17,0,125196.5,1232.353,105.4118
"10760","33546","2016",9,9,0,193570.6,1564.111,129.4444
"10761","33547","2016",15,14,1,145330,1338.867,103.6667
"10762","33548","2016",11,11,0,178752.3,1548.364,121
"10763","33549","2016",4,4,0,158350,1481.75,106.75
"10764","33550","2016",432,309,123,234330.2,2775.708,85.97454
"10765","33551","2016",4,4,0,121717.5,1224.25,107
"10766","33552","2016",9,9,0,173796.7,1523.778,123
"10767","33553","2016",9,8,1,181314.4,1994.778,93.22222
"10768","33554","2016",29,28,1,218174.8,2288.586,97.10345
"10769","33555","2016",53,44,9,224772.5,2586.113,93.92453
"10770","34001","2016",20,20,0,142291.1,1544.1,90.55
"10771","34002","2016",7,7,0,167192.9,1541.429,109.2857
"10772","34003","2016",1417,342,1075,128000.2,3139.171,44.57092
"10773","34004","2016",1,1,0,92900,1602,58
"10774","34006","2016",3,3,0,142666.7,1486,85
"10775","34007","2016",4,4,0,96850,1131.25,86
"10776","34008","2016",9,8,1,122975,1668.333,83.88889
"10777","34009","2016",25,24,1,169352,1730,96.36
"10778","34010","2016",33,31,2,178007.9,2118.182,85.75758
"10779","34011","2016",4,4,0,146450,1442.75,107
"10780","34012","2016",8,8,0,246840,2154.5,118.75
"10781","34013","2016",21,17,4,173620.7,1866.286,88.14286
"10782","34014","2016",8,8,0,428709.4,2865.125,166.125
"10783","34015","2016",1,1,0,193915,2204,88
"10784","34016","2016",3,2,1,200466.7,1685.333,107.3333
"10785","34017","2016",9,9,0,159611.1,1762.444,91
"10786","34018","2016",15,15,0,196213.3,1837.267,114.1333
"10787","34019","2016",6,6,0,96666.67,1330.833,82.33333
"10788","34020","2016",6,6,0,140833.3,1701,87.83333
"10789","34021","2016",1,1,0,110000,1833,60
"10790","34022","2016",87,67,20,264722.4,2855.552,94.51724
"10791","34023","2016",232,59,173,156143.7,3723.116,48.18534
"10792","34024","2016",42,36,6,263324.5,2783.119,97.33333
"10793","34025","2016",15,15,0,198307.3,2047.733,97.66667
"10794","34026","2016",2,2,0,122577.5,1522.5,69.5
"10795","34027","2016",12,11,1,334045.8,2725.833,117.5
"10796","34028","2016",65,39,26,101033.1,1310.123,76.13846
"10797","34029","2016",8,8,0,164156.2,1753.125,89.375
"10798","34030","2016",3,3,0,120833.3,1352,86.33333
"10799","34031","2016",55,46,9,139000.1,1835.145,75.09091
"10800","34032","2016",962,395,567,112318.4,1455.965,77.4106
"10801","34033","2016",29,22,7,205151,2464.069,84.96552
"10802","34034","2016",1,1,0,15000,500,30
"10803","34035","2016",7,7,0,286451.6,2308.714,117.1429
"10804","34036","2016",16,14,2,187549.1,2053.938,94.5625
"10805","34037","2016",38,25,13,156498.1,2141.447,78.60526
"10806","34038","2016",17,8,9,75143.53,986.8235,78.17647
"10807","34039","2016",24,19,5,283553.3,2773.167,100.1667
"10808","34041","2016",6,6,0,217148.3,1891.667,112.3333
"10809","34042","2016",5,5,0,182110,1913,101.8
"10810","34043","2016",1,1,0,80000,2105,38
"10811","34044","2016",4,4,0,152750,1930,80.5
"10812","34045","2016",7,7,0,205714.3,2138.714,98.57143
"10813","34046","2016",1,1,0,27500,367,75
"10814","34047","2016",14,13,1,223548.6,1944.5,121.6429
"10815","34048","2016",3,3,0,142833.3,1479.667,108.3333
"10816","34049","2016",4,3,1,84750,1039.75,84.25
"10817","34050","2016",30,28,2,219396.6,2272.3,96.23333
"10818","34051","2016",35,33,2,210574.1,2045.2,103.0857
"10819","34052","2016",35,33,2,164386.9,1698.971,100.0286
"10820","34053","2016",2,2,0,356978,2165,162
"10821","34054","2016",2,2,0,88205,995,73.5
"10822","34055","2016",2,2,0,183782.5,1151.5,123.5
"10823","34056","2016",11,11,0,199923.7,2064.909,100.4545
"10824","34057","2016",240,121,119,302194.5,3362.392,88.31667
"10825","34058","2016",68,56,12,267052.3,2854.809,94.33824
"10826","34059","2016",7,7,0,103785.7,1116.286,96.28571
"10827","34060","2016",5,5,0,143840,1504.4,89.2
"10828","34061","2016",10,9,1,165126.3,1475.7,109.4
"10829","34062","2016",3,3,0,122169.3,1394.333,102.3333
"10830","34063","2016",30,29,1,175203,1878.533,91.43333
"10831","34064","2016",6,6,0,134833.3,1296,111.8333
"10832","34065","2016",3,3,0,220666.7,1647,144.6667
"10833","34066","2016",2,2,0,704100,3061,217.5
"10834","34067","2016",8,8,0,185300,1878.125,100.375
"10835","34068","2016",8,8,0,228773.1,1712.5,124.375
"10836","34069","2016",63,59,4,134444.3,1482.444,93.31746
"10837","34070","2016",10,10,0,118885,1541.3,80.4
"10838","34071","2016",6,6,0,92482.5,988.8333,87
"10839","34072","2016",1,1,0,320000,3765,85
"10840","34073","2016",23,23,0,197627,2106.609,99.69565
"10841","34074","2016",30,30,0,130762.3,1408.233,101.9333
"10842","34075","2016",8,8,0,128132.5,1225,111.125
"10843","34076","2016",17,17,0,208058.8,2237.059,94.76471
"10844","34077","2016",53,46,7,320910.9,2918,109.9811
"10845","34078","2016",11,11,0,217029.8,2119.818,109.2727
"10846","34079","2016",98,52,46,142143.4,1796.714,76.39796
"10847","34080","2016",8,8,0,127675,1555.625,82.625
"10848","34081","2016",31,29,2,170897,1813.839,98.87097
"10849","34082","2016",8,6,2,335014.4,2653.5,132.125
"10850","34083","2016",2,2,0,198500,1881,104
"10851","34084","2016",12,12,0,137716.7,1358.583,100.6667
"10852","34085","2016",10,10,0,219474.5,1617.4,135.6
"10853","34086","2016",2,2,0,29010,636.5,55
"10854","34088","2016",72,60,12,204872,2190.347,96.81944
"10855","34089","2016",15,15,0,114168,1404.467,81.13333
"10856","34090","2016",95,80,15,285374.9,2961.505,99.52632
"10857","34091","2016",1,1,0,180000,2500,72
"10858","34092","2016",9,9,0,126772.2,1140.667,119
"10859","34093","2016",5,5,0,79016,1184,65.6
"10860","34094","2016",10,9,1,207270,1945.4,103.7
"10861","34095","2016",67,52,15,223230.2,2495.955,90.91045
"10862","34096","2016",10,9,1,113560,1353.2,84.7
"10863","34097","2016",8,8,0,115266.8,1158.625,96.125
"10864","34098","2016",3,3,0,163333.3,1322.667,112.3333
"10865","34099","2016",1,1,0,210000,1694,124
"10866","34100","2016",1,1,0,151000,1079,140
"10867","34101","2016",49,48,1,154021.4,1914.306,81.14286
"10868","34102","2016",3,3,0,334090,2641.667,127
"10869","34103","2016",14,13,1,90517.86,1097.214,77.28571
"10870","34104","2016",1,1,0,127000,2048,62
"10871","34105","2016",1,1,0,41000,506,81
"10872","34106","2016",2,2,0,114155,2069,55
"10873","34107","2016",3,2,1,108566.7,1267.333,86
"10874","34108","2016",345,190,155,178736.9,2736.904,69.33043
"10875","34109","2016",13,13,0,114507.7,1397.385,81.46154
"10876","34110","2016",4,3,1,414655.5,3627.25,119
"10877","34111","2016",31,22,9,113519.5,1560.742,70.3871
"10878","34112","2016",1,1,0,431000,2293,188
"10879","34113","2016",72,60,12,230789.9,2403.444,96.23611
"10880","34114","2016",52,44,8,215483.7,2309.462,93.26923
"10881","34115","2016",1,1,0,44500,556,80
"10882","34116","2016",106,48,58,195395.2,2561.33,75.0566
"10883","34117","2016",6,5,1,63939.67,1022,80.83333
"10884","34118","2016",1,1,0,495000,1934,256
"10885","34119","2016",14,11,3,117465,1159.571,96.85714
"10886","34120","2016",68,50,18,251255.4,3089.147,82.94118
"10887","34121","2016",3,3,0,141553.3,1588.667,86.66667
"10888","34122","2016",5,5,0,229160,2007,116
"10889","34123","2016",107,70,37,264444.3,2851.299,95.94393
"10890","34124","2016",1,1,0,245000,1655,148
"10891","34126","2016",55,15,40,84438.18,1802.073,49.90909
"10892","34127","2016",35,30,5,235784.3,2458.886,102.0286
"10893","34128","2016",15,15,0,214595.8,2243,93.66667
"10894","34129","2016",275,108,167,262565.5,3395.04,77.84
"10895","34130","2016",20,20,0,185694.5,1701.85,110.25
"10896","34131","2016",3,3,0,401300,3053,131.3333
"10897","34132","2016",2,2,0,98000,1613,59
"10898","34133","2016",1,1,0,20000,606,33
"10899","34134","2016",27,20,7,261183.3,2827.037,96.2963
"10900","34135","2016",27,26,1,152340.3,1539.37,98.62963
"10901","34136","2016",19,18,1,177029.2,1760.789,101.4211
"10902","34137","2016",3,3,0,137800,2599.333,56
"10903","34138","2016",2,2,0,366650,2981,120.5
"10904","34139","2016",14,13,1,170480.7,1871.357,86.5
"10905","34140","2016",35,34,1,195157.7,1933.143,99
"10906","34141","2016",10,10,0,116531.1,1332.9,95.3
"10907","34142","2016",67,44,23,127503,1446.299,87.59701
"10908","34143","2016",29,28,1,174141.4,2833.552,70.41379
"10909","34144","2016",8,8,0,108850,1393.75,83.125
"10910","34145","2016",288,190,98,163681.4,2007.535,81.76389
"10911","34146","2016",29,26,3,196033.1,2274.276,90.58621
"10912","34147","2016",38,38,0,204465.2,1882.447,104.7105
"10913","34148","2016",53,48,5,194007.9,1785.472,110.6038
"10914","34149","2016",7,7,0,235428.6,2092.286,110.4286
"10915","34150","2016",293,155,138,148181.8,2896.403,55.87713
"10916","34151","2016",78,55,23,158628.3,2016.218,81.32051
"10917","34152","2016",2,2,0,291250,2794,107.5
"10918","34153","2016",12,9,3,357769.8,3040.75,122.1667
"10919","34154","2016",355,124,231,205006.1,3373.808,62.6
"10920","34155","2016",28,27,1,159095.8,1621.75,96.64286
"10921","34156","2016",1,1,0,315400,1923,164
"10922","34157","2016",192,122,70,195348.8,2551.365,78.31771
"10923","34158","2016",1,1,0,153000,2040,75
"10924","34159","2016",31,28,3,258914.5,2774.419,92.90323
"10925","34160","2016",6,6,0,123166.7,1490.167,72.66667
"10926","34161","2016",52,51,1,187965.7,1992.481,98.40385
"10927","34162","2016",53,49,4,143324.1,1699.604,83.92453
"10928","34164","2016",3,3,0,288366.7,2978,97.33333
"10929","34165","2016",32,27,5,225314.1,2409.312,97.375
"10930","34166","2016",32,32,0,156255.3,1700.125,90.59375
"10931","34167","2016",2,2,0,171412.5,1764,99
"10932","34168","2016",1,1,0,38000,613,62
"10933","34169","2016",26,21,5,369621.9,3105.423,120.9615
"10934","34170","2016",4,4,0,136562.5,1208,97.75
"10935","34172","2016",4427,494,3933,158839,2722.557,60.11475
"10936","34173","2016",21,20,1,177845,2000.524,90.47619
"10937","34174","2016",5,5,0,178000,2052.6,93
"10938","34175","2016",1,1,0,55000,1000,55
"10939","34176","2016",34,23,11,211746.3,2555.5,81.64706
"10940","34177","2016",5,5,0,298180,2012.4,137.4
"10941","34178","2016",28,27,1,143220,1673.107,85.21429
"10942","34179","2016",16,15,1,224282.9,2309.25,96.125
"10943","34180","2016",18,18,0,152365.8,1742.833,91.05556
"10944","34181","2016",11,11,0,181471.4,1906.273,98.81818
"10945","34182","2016",26,25,1,225004.3,2246.808,101.6154
"10946","34183","2016",45,42,3,147600.5,1539.844,95.95556
"10947","34184","2016",11,11,0,178475.5,1683.909,102.6364
"10948","34185","2016",5,5,0,198506,2077.4,86.8
"10949","34186","2016",7,6,1,197667.1,1830.143,110.2857
"10950","34187","2016",5,5,0,103620,1367,68.4
"10951","34188","2016",2,2,0,332632.5,1822,188
"10952","34189","2016",25,23,2,100308.7,1075.16,95.28
"10953","34190","2016",5,4,1,216100,1458.8,139.4
"10954","34191","2016",5,4,1,235408,1956.4,117.6
"10955","34192","2016",280,31,249,200657.6,4140.625,48.52857
"10956","34193","2016",4,4,0,196925,2250.25,91.25
"10957","34194","2016",60,58,2,162522.5,1871.883,87.83333
"10958","34195","2016",2,2,0,294000,2655.5,105
"10959","34196","2016",2,2,0,1e+05,1791.5,56
"10960","34197","2016",18,17,1,129040.6,1473.111,86
"10961","34198","2016",109,80,29,300823.7,3497.587,88.9633
"10962","34199","2016",97,57,40,177306.9,1930.062,87.30928
"10963","34200","2016",3,3,0,89333.33,971.6667,92.33333
"10964","34201","2016",3,3,0,296666.7,2163.667,121.6667
"10965","34202","2016",66,43,23,227295.5,2793.985,83.75758
"10966","34203","2016",18,18,0,153244.4,2040.056,73.55556
"10967","34204","2016",11,10,1,162740.9,2113.091,89.27273
"10968","34205","2016",6,6,0,197833.3,2113.667,108.3333
"10969","34206","2016",9,8,1,179504.2,2131.111,93.66667
"10970","34207","2016",32,32,0,148066.9,1842.844,80.28125
"10971","34208","2016",3,3,0,132000,1470,97.33333
"10972","34209","2016",85,72,13,158563.4,2965.318,57.85882
"10973","34210","2016",28,26,2,182731.1,1931.107,96.82143
"10974","34211","2016",14,14,0,102653.6,1084,97
"10975","34212","2016",2,2,0,162200,2157,56.5
"10976","34213","2016",73,61,12,199811,2453.575,83.68493
"10977","34214","2016",11,10,1,164063.6,1690.909,94.72727
"10978","34215","2016",6,6,0,181198.3,1883.167,101.6667
"10979","34216","2016",3,3,0,155633.3,1346.333,105.3333
"10980","34217","2016",70,58,12,299296.7,2904.943,103.1286
"10981","34218","2016",6,6,0,97041.67,1329.167,70.83333
"10982","34219","2016",7,7,0,137710,1391,102.2857
"10983","34220","2016",2,2,0,297500,2366,113.5
"10984","34221","2016",5,5,0,196045,2325,88.4
"10985","34222","2016",8,8,0,255251.2,1990.375,123.375
"10986","34223","2016",13,11,2,163063.5,1813.846,87.46154
"10987","34224","2016",22,22,0,178132.7,1703.364,104.1364
"10988","34225","2016",32,28,4,134941.3,1434.5,94.15625
"10989","34226","2016",31,31,0,151003.5,1381.258,104.4516
"10990","34227","2016",16,15,1,307297.2,2996.25,112.125
"10991","34228","2016",1,1,0,97000,693,140
"10992","34229","2016",9,8,1,129316.7,1277.111,96.77778
"10993","34230","2016",4,4,0,122500,1786,73.5
"10994","34232","2016",10,10,0,186200,2021.5,94.1
"10995","34233","2016",1,1,0,67250,560,120
"10996","34235","2016",6,6,0,60333.33,843,71.66667
"10997","34237","2016",33,33,0,140878.8,1613.152,84.57576
"10998","34239","2016",54,46,8,171179.1,1786.389,93.46296
"10999","34240","2016",35,27,8,261879.7,2796.629,98.71429
"11000","34241","2016",8,7,1,153283.1,1766.25,88.5
"11001","34242","2016",5,5,0,319477,2195.4,138.6
"11002","34243","2016",16,15,1,161459.1,1747.938,89.5
"11003","34244","2016",24,18,6,253894.8,2822.375,90
"11004","34245","2016",31,29,2,130294,1327,94.22581
"11005","34246","2016",23,19,4,261902.5,2419.043,107.5652
"11006","34247","2016",53,46,7,435646.7,3392.623,129.1132
"11007","34248","2016",2,2,0,260950,2371.5,109
"11008","34249","2016",15,15,0,295268.6,2744.067,105
"11009","34250","2016",4,4,0,105000,1090.75,99.5
"11010","34251","2016",8,8,0,190870,2118.125,98.625
"11011","34252","2016",4,3,1,125000,1145.75,106.25
"11012","34254","2016",14,14,0,219025.5,2010.714,107.2143
"11013","34255","2016",98,86,12,378023.2,3268.827,112.551
"11014","34256","2016",17,17,0,283283.5,2556.353,107.9412
"11015","34257","2016",1,1,0,43000,430,100
"11016","34258","2016",22,22,0,191638.2,2103.818,97.18182
"11017","34259","2016",47,37,10,290917.9,2874.766,98.59574
"11018","34260","2016",9,8,1,90055.56,876.1111,90.44444
"11019","34261","2016",4,3,1,138625,1982.5,69.25
"11020","34262","2016",4,4,0,290992.5,2003.75,146.25
"11021","34263","2016",3,3,0,86266.67,1272.333,71.33333
"11022","34264","2016",2,1,1,99583.5,905.5,97
"11023","34265","2016",6,6,0,308166.7,2469.833,135.3333
"11024","34266","2016",1,1,0,389660,2547,153
"11025","34267","2016",13,12,1,215646.2,2130.154,96.07692
"11026","34268","2016",3,2,1,126489.7,1394.667,80.66667
"11027","34269","2016",3,3,0,146566.7,904,141.6667
"11028","34270","2016",154,87,67,286367.7,3139.981,91.20779
"11029","34271","2016",2,2,0,67000,1319,47.5
"11030","34272","2016",25,24,1,238542,2410.2,97.32
"11031","34273","2016",7,7,0,133484.3,1556.286,90.85714
"11032","34274","2016",21,21,0,295922.7,2766.714,112.7619
"11033","34276","2016",31,26,5,305709.4,2885.742,107.5806
"11034","34277","2016",4,4,0,104000,2032.5,56.5
"11035","34278","2016",2,2,0,100500,1246.5,80.5
"11036","34279","2016",7,7,0,54446.29,736.7143,75.28571
"11037","34280","2016",3,3,0,124166.7,1775,72
"11038","34281","2016",35,35,0,172621.6,1768.086,98.48571
"11039","34282","2016",8,5,3,282560.9,2878.375,96.875
"11040","34284","2016",16,11,5,102160.6,1270.812,84.1875
"11041","34285","2016",5,5,0,112607.6,1835.2,67.8
"11042","34286","2016",4,4,0,103000,1281.25,76.5
"11043","34287","2016",4,3,1,74002.25,1009,90.5
"11044","34288","2016",6,6,0,282654.2,2962,98.5
"11045","34289","2016",37,31,6,144025.7,1728.27,90.13514
"11046","34290","2016",5,4,1,371636,3347.4,114.2
"11047","34291","2016",4,4,0,156676.2,1574,97
"11048","34292","2016",3,3,0,107166.7,1888.333,63.33333
"11049","34293","2016",38,37,1,105827.2,1315,82.52632
"11050","34294","2016",9,8,1,245333.3,2811.111,99.22222
"11051","34295","2016",18,16,2,266425,2295.222,118.5556
"11052","34296","2016",11,11,0,196307.3,2372.727,99.90909
"11053","34297","2016",5,5,0,252274.6,2691.8,94.4
"11054","34298","2016",65,63,2,199850.8,2041.738,98.36923
"11055","34299","2016",82,72,10,171941.2,2111.037,79.79268
"11056","34300","2016",51,49,2,178575.4,1874.608,94.21569
"11057","34301","2016",951,156,795,160609.7,2470.414,64.15142
"11058","34302","2016",21,21,0,143777.1,1611.619,94.66667
"11059","34303","2016",1,1,0,147000,1934,76
"11060","34304","2016",12,12,0,135219.2,1500.833,87.41667
"11061","34305","2016",7,7,0,129771.4,1773.714,80.71429
"11062","34306","2016",2,2,0,116500,1730,59
"11063","34307","2016",26,20,6,287019.1,2692.577,108.6538
"11064","34308","2016",3,3,0,90933.33,860.3333,107.6667
"11065","34309","2016",49,43,6,318228.1,2932.571,110.9796
"11066","34310","2016",27,22,5,149614.8,1613.889,92.81481
"11067","34311","2016",18,18,0,227497.8,2151.5,101.7222
"11068","34312","2016",15,14,1,132383.3,1521.2,88.6
"11069","34313","2016",6,6,0,124400,1156,105
"11070","34314","2016",3,3,0,425938.3,4346.667,115.6667
"11071","34315","2016",3,3,0,209966.7,2017.667,101.6667
"11072","34316","2016",2,2,0,171267.5,1664.5,102.5
"11073","34317","2016",2,2,0,42000,787.5,55
"11074","34318","2016",5,5,0,249190,2861,90.6
"11075","34319","2016",4,4,0,168175,1559,104.25
"11076","34320","2016",15,15,0,329788.4,2758.467,119.8667
"11077","34321","2016",15,14,1,271729.4,3114.133,95.13333
"11078","34322","2016",6,6,0,328685,2949.5,113.6667
"11079","34324","2016",259,90,169,131898.2,2944.162,46.64479
"11080","34325","2016",21,20,1,193462.1,1877.619,103.619
"11081","34326","2016",1,1,0,58000,841,69
"11082","34327","2016",64,54,10,291391.1,3029.516,97.32812
"11083","34328","2016",9,9,0,189588.9,2058.444,91.55556
"11084","34329","2016",56,49,7,177739.3,2735.5,72.64286
"11085","34331","2016",1,1,0,65000,1083,60
"11086","34332","2016",126,109,17,142627.3,2433.659,63.7381
"11087","34333","2016",80,78,2,159164.4,4117.438,46.425
"11088","34334","2016",5,5,0,156725,1374.8,100.6
"11089","34335","2016",3,3,0,120353.3,1775.667,68
"11090","34336","2016",44,36,8,143853.7,1633.295,87.09091
"11091","34337","2016",89,68,21,242294.2,2689.921,91.44944
"11092","34338","2016",1,1,0,270000,2269,119
"11093","34339","2016",3,3,0,99631.67,1224.667,80.33333
"11094","34340","2016",11,11,0,294610.9,2692.545,118.9091
"11095","34341","2016",34,33,1,183148.8,2134.882,91.23529
"11096","34343","2016",11,11,0,225001.5,1989.182,104.9091
"11097","34344","2016",735,50,685,157261.8,3859.973,39.66259
"11098","35001","2016",87,59,28,207959.2,2352.506,90.8046
"11099","35002","2016",12,12,0,160431,1236.667,138.25
"11100","35003","2016",12,12,0,160662.5,1532.75,113
"11101","35004","2016",7,7,0,153285.7,1606.857,102.4286
"11102","35006","2016",28,25,3,156073.9,1599.536,99.03571
"11103","35007","2016",6,6,0,169696.7,1675.833,102
"11104","35008","2016",7,7,0,98242.86,1218.143,76.28571
"11105","35009","2016",19,18,1,108520.5,1257,85.52632
"11106","35010","2016",14,14,0,155326.9,1459.929,108.2143
"11107","35012","2016",92,78,14,149967.1,1535.946,99.33696
"11108","35013","2016",37,36,1,136250.5,1268.541,105.5946
"11109","35014","2016",18,17,1,128033.3,1427.167,92.61111
"11110","35015","2016",17,17,0,147354.1,1348.176,117.8235
"11111","35016","2016",22,22,0,148351.8,1471.955,105.5
"11112","35017","2016",9,9,0,154633.3,1517.889,106.3333
"11113","35018","2016",2,2,0,122500,1233,105.5
"11114","35019","2016",29,29,0,94688.31,973.5517,100.4483
"11115","35021","2016",7,7,0,163857.1,1534.571,111.8571
"11116","35022","2016",12,11,1,143333.3,1200.917,133.8333
"11117","35023","2016",36,31,5,168365.6,1721.25,100.0278
"11118","35024","2016",137,78,59,223093.2,2422.372,93.10219
"11119","35025","2016",6,6,0,69916.67,692.6667,99.33333
"11120","35026","2016",1,1,0,138000,986,140
"11121","35027","2016",12,12,0,147414.8,1393.583,107
"11122","35028","2016",3,3,0,108973,1129.667,90.33333
"11123","35029","2016",20,20,0,116259.5,1376.3,87.4
"11124","35030","2016",5,5,0,140360,1662.6,90.8
"11125","35031","2016",54,50,4,166482.9,1707.796,100.3333
"11126","35032","2016",56,36,20,164731.1,1858.768,91.14286
"11127","35033","2016",37,36,1,176007.9,1746.514,102.8919
"11128","35034","2016",14,14,0,95592.14,1060.286,90.28571
"11129","35035","2016",8,8,0,128712.5,1293.625,99.5
"11130","35037","2016",66,55,11,170856.6,1769.182,99.62121
"11131","35038","2016",12,12,0,107322.4,1169,91.91667
"11132","35039","2016",21,19,2,187272,1801.429,108.2857
"11133","35040","2016",35,21,14,142832.3,1735.057,84.94286
"11134","35041","2016",7,7,0,173782.9,1377.571,128
"11135","35042","2016",3,3,0,97000,976,91
"11136","35044","2016",1,1,0,155000,3100,50
"11137","35045","2016",3,3,0,86000,1013.667,82.33333
"11138","35046","2016",5,5,0,98007.2,1068.2,95.8
"11139","35047","2016",258,123,135,191420,2290.682,85.1938
"11140","35049","2016",113,79,34,201124.2,2417.142,88.04425
"11141","35050","2016",7,7,0,183642.9,1475,117.2857
"11142","35051","2016",186,92,94,251858.7,2644.849,96.30645
"11143","35052","2016",5,5,0,117900,1288,95
"11144","35054","2016",14,14,0,169967.9,1726.429,100
"11145","35055","2016",123,46,77,191913,2442.602,79.52033
"11146","35056","2016",10,10,0,125758.8,1155.8,109.2
"11147","35057","2016",13,13,0,135858.2,1387.385,95.07692
"11148","35058","2016",20,20,0,150314.1,1710.6,95.85
"11149","35059","2016",47,34,13,210787.6,2116.66,101.617
"11150","35060","2016",3,3,0,158633.3,1419,113.3333
"11151","35061","2016",6,6,0,118591,1203.333,111.5
"11152","35062","2016",6,6,0,126000,1320,87.83333
"11153","35063","2016",6,6,0,114583.3,1114.333,109.8333
"11154","35064","2016",18,18,0,78782.78,960.3889,84.55556
"11155","35065","2016",25,25,0,190856.2,1919.36,99.72
"11156","35066","2016",101,55,46,169218.3,2147.297,80.45545
"11157","35067","2016",19,19,0,206943.4,1789.526,121.1579
"11158","35068","2016",80,59,21,173160.3,1863.225,95.3625
"11159","35069","2016",103,69,34,194438.9,2034.942,97.01942
"11160","35070","2016",18,16,2,138867.9,1453.389,96.94444
"11161","35071","2016",6,6,0,113583.3,1057.333,97.83333
"11162","35072","2016",18,18,0,105730.1,1159.944,98.16667
"11163","35075","2016",6,6,0,111833.3,1402.833,79
"11164","35076","2016",59,38,21,179280.3,2016.763,90.9322
"11165","35077","2016",3,3,0,113000,966,106.6667
"11166","35078","2016",19,19,0,132984.2,1610.368,88.21053
"11167","35079","2016",16,15,1,251564.4,2323.75,108.4375
"11168","35080","2016",19,18,1,205273.1,1973.842,109
"11169","35081","2016",1,1,0,152827,1887,81
"11170","35082","2016",18,18,0,107366.7,1307.056,82.72222
"11171","35084","2016",1,1,0,60000,833,72
"11172","35085","2016",62,54,8,140109.6,1550.726,89.5
"11173","35086","2016",6,6,0,129698.5,1338,94
"11174","35087","2016",6,6,0,147156.5,1547.833,101.6667
"11175","35088","2016",30,26,4,176581.5,1770.267,107.7333
"11176","35089","2016",6,6,0,177845.3,1651.5,97.16667
"11177","35090","2016",22,16,6,150553.4,1723.864,90.09091
"11178","35091","2016",6,6,0,106833.3,1429.333,75.66667
"11179","35092","2016",9,9,0,168166.7,1420.556,119.8889
"11180","35093","2016",360,154,206,256178.8,3324.328,78.39722
"11181","35094","2016",19,19,0,128338.2,1358.842,102.6316
"11182","35095","2016",66,42,24,129299.1,1493.636,90.51515
"11183","35096","2016",21,16,5,132562.7,1565.381,91.57143
"11184","35097","2016",16,16,0,128343.8,1388.375,94.6875
"11185","35098","2016",8,8,0,115421.2,1163.75,93
"11186","35099","2016",46,29,17,180625,1954.63,93.54348
"11187","35101","2016",4,4,0,144875,1146.75,121.5
"11188","35102","2016",5,5,0,87000,995.4,84.8
"11189","35103","2016",3,3,0,56666.67,560,104
"11190","35104","2016",21,21,0,169309.5,1559.905,108.5714
"11191","35105","2016",9,9,0,155033.3,1418.778,109.1111
"11192","35106","2016",25,25,0,95877.76,1034.96,96.24
"11193","35107","2016",15,15,0,193213.3,1812.467,111.6667
"11194","35108","2016",6,6,0,146475,1718,91.5
"11195","35109","2016",16,15,1,133322.5,1420.125,94.1875
"11196","35110","2016",9,9,0,122722.2,1440.556,94.77778
"11197","35111","2016",8,8,0,99697.5,993,120.875
"11198","35112","2016",7,7,0,145057.1,1284.857,111.2857
"11199","35114","2016",2,2,0,125000,1246,99
"11200","35115","2016",266,127,139,103015,1300.158,79.17669
"11201","35116","2016",24,23,1,156521.2,1457.5,112.625
"11202","35117","2016",18,17,1,70951.5,849.3333,81.11111
"11203","35118","2016",10,10,0,165800,1321.9,127.3
"11204","35119","2016",6,6,0,108333.3,1462.167,88.16667
"11205","35120","2016",63,53,10,192933.4,2011.73,99.01587
"11206","35121","2016",17,17,0,201187.1,1852.706,110.8235
"11207","35122","2016",26,24,2,201582.1,1762,113.9231
"11208","35123","2016",50,42,8,153478.8,1635.1,96.44
"11209","35124","2016",23,23,0,128249.3,1201.652,106.0435
"11210","35125","2016",38,33,5,107640.2,1271.816,87.10526
"11211","35126","2016",85,75,10,186744,2000.212,98.36471
"11212","35127","2016",34,31,3,154513.7,1506.794,102.5882
"11213","35128","2016",16,16,0,115018.8,1468.188,79.5
"11214","35130","2016",27,25,2,159303.5,1758.111,92.44444
"11215","35131","2016",50,36,14,179173.1,2007.56,90.52
"11216","35132","2016",17,16,1,141077.5,1570.882,92.76471
"11217","35133","2016",43,40,3,139510.7,1459.465,101.1395
"11218","35134","2016",5,5,0,165800,2083,86.8
"11219","35135","2016",19,19,0,155338.7,1550.158,101.6842
"11220","35136","2016",84,57,27,149227.9,1634.881,93.21429
"11221","35137","2016",11,11,0,170618.2,1442.455,116.8182
"11222","35138","2016",13,13,0,133900,1514.769,88.38462
"11223","35139","2016",50,40,10,208328.7,1916.02,110.1
"11224","35140","2016",7,7,0,97528.57,1189.429,89
"11225","35141","2016",6,6,0,151333.3,1464.333,108
"11226","35142","2016",16,16,0,109423.4,1201.562,98.0625
"11227","35143","2016",14,14,0,125818.4,1229.286,101.3571
"11228","35144","2016",13,12,1,160223.1,1849.615,86.30769
"11229","35145","2016",22,22,0,96338.18,1029.364,95.36364
"11230","35146","2016",4,4,0,173162.5,1415.5,125
"11231","35148","2016",1,1,0,85000,563,151
"11232","35149","2016",20,20,0,162401.6,1619.65,100.85
"11233","35150","2016",22,22,0,151256.9,1403.045,105.8636
"11234","35151","2016",5,5,0,125100,1394,88.8
"11235","35152","2016",97,74,23,200962.4,2147.732,99.8866
"11236","35153","2016",5,5,0,159860,1420.8,120
"11237","35154","2016",18,18,0,119187.6,1357.944,87.22222
"11238","35155","2016",3,3,0,129000,1264.333,98
"11239","35156","2016",5,5,0,120600,1103,104
"11240","35157","2016",8,8,0,82025,851.75,94.625
"11241","35159","2016",2,2,0,122500,1271,100
"11242","35160","2016",3,3,0,125516.7,1122,114.6667
"11243","35161","2016",15,15,0,104434.1,1236.267,85.8
"11244","35162","2016",31,29,2,107052.8,1178,89.25806
"11245","35163","2016",17,17,0,98378.71,1194.353,83.47059
"11246","35164","2016",8,8,0,105125,1017,102.125
"11247","35165","2016",10,9,1,92560,1184.4,79.2
"11248","35166","2016",5,5,0,57292.8,1010,55.2
"11249","35167","2016",20,20,0,96765,1014.65,102.35
"11250","35168","2016",35,34,1,116053.7,1179.2,100.0286
"11251","35169","2016",17,17,0,128202.9,1405.353,91.35294
"11252","35170","2016",5,5,0,134200,1564.6,84.8
"11253","35171","2016",19,19,0,143273.7,1327.211,112.1053
"11254","35172","2016",19,18,1,114363.2,1369,90.36842
"11255","35173","2016",78,71,7,242456.9,2173.436,114.2821
"11256","35174","2016",6,6,0,146666.7,1292,103.1667
"11257","35175","2016",4,4,0,116831.2,1633.5,72.5
"11258","35176","2016",63,62,1,96261.49,1149.127,83.98413
"11259","35177","2016",53,44,9,234916.8,2193.226,109.0377
"11260","35178","2016",9,9,0,170729.6,1728.333,109.3333
"11261","35179","2016",51,49,2,141343.5,1499.51,96.43137
"11262","35180","2016",2,2,0,149250,1429,104
"11263","35181","2016",15,14,1,317941.3,2505.333,128.2667
"11264","35183","2016",10,10,0,124061.3,1318.3,102
"11265","35184","2016",46,38,8,139967,1521.304,94.15217
"11266","35185","2016",1,1,0,36500,514,71
"11267","35186","2016",11,11,0,122074.8,1339.273,98.36364
"11268","35187","2016",14,14,0,154560,1731,91.28571
"11269","35188","2016",73,50,23,160865.9,1820.37,91.39726
"11270","35189","2016",34,25,9,264733.5,2395.206,116.2353
"11271","35190","2016",1,1,0,112000,757,148
"11272","35191","2016",11,11,0,106772.7,1249.727,82.36364
"11273","35192","2016",1,1,0,228819,2359,97
"11274","35193","2016",22,22,0,189631.7,1883.818,102.7273
"11275","35194","2016",11,11,0,181802.7,1550.273,117.2727
"11276","35195","2016",37,32,5,136007,1514.595,92.10811
"11277","35196","2016",96,38,58,172673,2140.781,81.6875
"11278","35197","2016",25,24,1,190683.1,1739.84,111.16
"11279","35198","2016",9,9,0,136777.8,1214.444,117.1111
"11280","35199","2016",3,3,0,146333.3,1115.667,128.3333
"11281","35200","2016",7,7,0,88857.14,1071.286,83.71429
"11282","35201","2016",8,8,0,91543.75,763.375,125.5
"11283","35202","2016",8,8,0,114937.5,1251.25,92.25
"11284","35203","2016",4,4,0,115916.5,1025.75,108.25
"11285","35204","2016",32,31,1,177686.4,1723.094,103.25
"11286","35205","2016",10,10,0,85450,1057.7,81.1
"11287","35206","2016",66,43,23,206907.4,2138.758,102.697
"11288","35207","2016",50,32,18,198587.6,2096.66,96.6
"11289","35208","2016",46,38,8,197975,1957.13,101.7826
"11290","35210","2016",122,83,39,257740.3,2339.377,108.9344
"11291","35211","2016",24,24,0,117641.5,1430.333,85.58333
"11292","35212","2016",13,13,0,124938.5,1285.538,92.53846
"11293","35214","2016",6,6,0,109660.8,1578,72.16667
"11294","35215","2016",11,11,0,83890.91,1098.455,77.27273
"11295","35216","2016",22,17,5,196603.5,1807.909,110.5455
"11296","35217","2016",8,8,0,146787.1,1371.25,103.875
"11297","35218","2016",6,6,0,146666.7,1814.333,95
"11298","35219","2016",29,29,0,103662.1,1178.517,89.2069
"11299","35220","2016",29,29,0,180601,1556.414,121.3103
"11300","35221","2016",22,22,0,128135.9,1302.136,97.63636
"11301","35222","2016",22,21,1,123490.9,1352.818,91.31818
"11302","35223","2016",46,42,4,128866.4,1331.37,103.087
"11303","35224","2016",26,26,0,135985.2,1279.192,106.5769
"11304","35225","2016",5,5,0,126576,1126.8,148.8
"11305","35226","2016",19,19,0,132926.3,1329.526,111.5263
"11306","35227","2016",37,33,4,193635.4,1920.054,105.5135
"11307","35228","2016",121,83,38,162954.7,1961.496,83.2562
"11308","35229","2016",15,15,0,184310.3,1662.533,115
"11309","35230","2016",1,1,0,106620,1088,98
"11310","35231","2016",15,15,0,131673.3,1246.8,104.5333
"11311","35232","2016",4,4,0,42625,885.75,53.25
"11312","35233","2016",13,13,0,167323.3,1406.385,113.3077
"11313","35234","2016",15,15,0,91896.67,948.2,101
"11314","35235","2016",10,10,0,85345.8,1167.7,71.2
"11315","35236","2016",127,81,46,122008.4,1389.063,89.14961
"11316","35237","2016",4,4,0,32750,597.75,52
"11317","35238","2016",3395,489,2906,173178.3,2655.394,65.32548
"11318","35239","2016",38,38,0,128879.2,1291.342,102.5526
"11319","35240","2016",136,78,58,193883.8,2276.5,88.92647
"11320","35241","2016",27,24,3,274553.7,2447.889,112.2222
"11321","35242","2016",3,3,0,178741,1622.667,114.6667
"11322","35243","2016",17,17,0,164182.7,1499.176,107.6471
"11323","35244","2016",5,5,0,94800,924.4,101
"11324","35245","2016",42,36,6,182398.6,1831.333,101.0714
"11325","35246","2016",14,13,1,113071.4,1329.571,85.78571
"11326","35247","2016",10,10,0,96535,1063.8,94.5
"11327","35248","2016",6,6,0,72166.67,1009.833,74.5
"11328","35249","2016",7,6,1,70405.71,853.7143,85
"11329","35250","2016",31,24,7,181138.4,2227.742,90
"11330","35251","2016",40,33,7,158960.7,1728.825,94.45
"11331","35252","2016",6,6,0,150962.8,1667,95.83333
"11332","35253","2016",34,29,5,147454.7,1531.471,93.91176
"11333","35255","2016",15,14,1,174812,1699.2,103.4
"11334","35256","2016",60,52,8,346670.7,3429.55,108.1833
"11335","35257","2016",31,30,1,114870.6,1270.548,90.83871
"11336","35258","2016",1,1,0,185000,1233,150
"11337","35259","2016",13,13,0,109963.8,1147.462,101.3846
"11338","35260","2016",9,9,0,110619.3,1127.556,100.1111
"11339","35261","2016",3,3,0,116890,1407.333,80
"11340","35262","2016",1,1,0,140000,1261,111
"11341","35263","2016",38,37,1,270333.4,2387.447,109.6842
"11342","35264","2016",16,15,1,171268.8,1715.938,100.375
"11343","35265","2016",27,24,3,144015.9,1543.593,102.7778
"11344","35266","2016",44,27,17,179580.8,2014.295,89.06818
"11345","35268","2016",6,6,0,63166.67,936.3333,74.33333
"11346","35270","2016",4,4,0,86644.75,1275.25,88.25
"11347","35271","2016",12,12,0,88966.17,1076.333,95.16667
"11348","35272","2016",5,5,0,126357.6,1714.4,73.2
"11349","35273","2016",11,11,0,123145.5,1239.455,100.0909
"11350","35274","2016",9,8,1,153100,1574.556,108
"11351","35275","2016",44,30,14,204029,2099.273,99.75
"11352","35276","2016",3,3,0,146266.7,1461.333,97.33333
"11353","35277","2016",1,1,0,158500,961,165
"11354","35278","2016",113,66,47,268677.3,2638.292,101.4513
"11355","35279","2016",17,17,0,187735.3,1847.706,105.7059
"11356","35280","2016",11,11,0,76297.64,1197.091,63.09091
"11357","35281","2016",183,56,127,146001.6,2119.066,68.74863
"11358","35282","2016",30,30,0,118814.5,1323.633,90.93333
"11359","35283","2016",15,14,1,167044.5,1732.6,96.2
"11360","35284","2016",21,19,2,266152.4,2421.905,110.619
"11361","35285","2016",9,9,0,135943.3,1166.667,106.1111
"11362","35286","2016",5,5,0,135860,1438.8,100.2
"11363","35287","2016",48,42,6,346557,3145.729,112.2917
"11364","35288","2016",965,371,594,217304.3,2917.561,75.63834
"11365","35289","2016",16,16,0,112878.6,1465.312,79.9375
"11366","35290","2016",8,8,0,98937.5,831.5,118.75
"11367","35291","2016",3,3,0,85000,1647,54
"11368","35292","2016",16,16,0,98427.31,1050.438,81.4375
"11369","35294","2016",25,25,0,111663.8,1186.32,89.92
"11370","35295","2016",7,7,0,107914.3,1096.429,96.57143
"11371","35296","2016",14,14,0,152407.1,1509.357,107.2143
"11372","35297","2016",46,37,9,126057,1384.63,91.95652
"11373","35299","2016",55,53,2,214878.4,1924.436,110.9455
"11374","35300","2016",6,6,0,142250,1176.167,116.5
"11375","35302","2016",9,9,0,121633.3,1203.889,112.8889
"11376","35304","2016",9,9,0,128153.1,1378.667,99.11111
"11377","35305","2016",4,4,0,118900,1546,87.25
"11378","35306","2016",28,27,1,216612.9,1872.571,129.5714
"11379","35307","2016",11,11,0,128472.7,1518.364,95
"11380","35308","2016",45,44,1,133995.9,1284.978,107.6222
"11381","35309","2016",15,15,0,114988.5,1145.2,101.8667
"11382","35310","2016",10,10,0,176420,1594.9,110.3
"11383","35311","2016",6,6,0,86160,984,87
"11384","35312","2016",17,17,0,103865,1381.882,77.05882
"11385","35314","2016",11,11,0,268350.8,2543.364,110.3636
"11386","35315","2016",20,20,0,218165.2,1927.95,114.45
"11387","35316","2016",7,7,0,130142.9,1099,120
"11388","35317","2016",6,6,0,161883.3,1848,93.66667
"11389","35318","2016",8,8,0,143601,1376.75,107.875
"11390","35319","2016",29,27,2,168268.1,1752.931,100.7586
"11391","35320","2016",2,2,0,224000,1598.5,140
"11392","35321","2016",4,4,0,104993.5,1470,71
"11393","35322","2016",5,5,0,101000,1349.6,70.8
"11394","35324","2016",2,2,0,123175,1140,107
"11395","35326","2016",16,16,0,163185.9,1597.875,112
"11396","35327","2016",32,27,5,187986.1,1961.375,98.21875
"11397","35328","2016",28,27,1,104895.7,1134.393,94.39286
"11398","35329","2016",5,5,0,82360,1004.4,87.8
"11399","35330","2016",7,7,0,121329,1129,110.4286
"11400","35331","2016",37,36,1,166063.3,1704.676,103.3784
"11401","35332","2016",13,13,0,114582.7,1073.231,111
"11402","35333","2016",12,12,0,141767.1,1533.5,94.58333
"11403","35334","2016",86,64,22,234890.5,2255.872,104.1279
"11404","35335","2016",9,9,0,115394.2,1297.333,85.44444
"11405","35336","2016",4,4,0,94000,1037.25,87.5
"11406","35337","2016",32,30,2,155452.5,1657.375,96.5625
"11407","35338","2016",2,2,0,124500,901,151.5
"11408","35339","2016",7,7,0,73785.71,876.1429,81.85714
"11409","35340","2016",10,10,0,131445,1315,101.8
"11410","35343","2016",13,13,0,117113.8,1095.462,105.4615
"11411","35345","2016",11,11,0,137000,1205.909,116.4545
"11412","35346","2016",2,2,0,75000,767,95
"11413","35347","2016",22,22,0,155452.7,1434.182,107.5
"11414","35350","2016",5,5,0,150600,1297.2,119.4
"11415","35351","2016",7,7,0,198718.7,1812.143,110.7143
"11416","35352","2016",75,55,20,212482.3,2360.64,93.78667
"11417","35353","2016",47,32,15,198252.5,2257.745,88.95745
"11418","35354","2016",2,2,0,75000,917,106
"11419","35355","2016",16,16,0,119133.2,1456.688,83.625
"11420","35356","2016",8,6,2,163956.2,1527.375,111.875
"11421","35357","2016",3,3,0,77166.67,1167.667,79
"11422","35358","2016",18,18,0,149733.3,1707.278,95.83333
"11423","35359","2016",7,7,0,88892.86,1149.714,84.85714
"11424","35360","2016",208,109,99,157155.4,1784.779,90.64904
"11425","35361","2016",15,15,0,148710,1642,95.2
"11426","35362","2016",20,19,1,140925,1523.7,95.1
"11427","35363","2016",54,44,10,204389.9,1992.519,102.7963
"11428","36001","2016",9,9,0,64124.44,717.1111,90.22222
"11429","36002","2016",5,5,0,86600,1209.2,70.6
"11430","36003","2016",6,6,0,95966.67,1268,86.83333
"11431","36004","2016",5,5,0,127100,1420.2,78.4
"11432","36005","2016",31,30,1,169340.3,1499.129,99.93548
"11433","36006","2016",57,54,3,84962.91,1035.754,83.22807
"11434","36007","2016",7,7,0,64642.86,811.5714,86.42857
"11435","36008","2016",1,1,0,130000,1605,81
"11436","36009","2016",11,11,0,155454.5,1457.636,113.5455
"11437","36010","2016",12,12,0,56895.83,718.5833,85
"11438","36011","2016",2,2,0,169517.5,1603.5,124
"11439","36012","2016",1,1,0,50000,714,70
"11440","36013","2016",1,1,0,35000,625,56
"11441","36014","2016",7,7,0,90500,934.2857,96.57143
"11442","36015","2016",2,2,0,58500,523,109.5
"11443","36016","2016",6,6,0,127193.3,1159.833,103.5
"11444","36017","2016",5,5,0,66700,902.2,70.8
"11445","36018","2016",55,54,1,81105.2,975.4909,90.34545
"11446","36019","2016",6,6,0,109690.2,1258.667,96.66667
"11447","36021","2016",5,5,0,106020,1181.6,91.8
"11448","36022","2016",7,7,0,62000,921.4286,65.71429
"11449","36023","2016",2,2,0,67750,1018,65
"11450","36025","2016",8,8,0,103731.2,1009.75,110.5
"11451","36026","2016",4,4,0,119450,1201.25,103.75
"11452","36028","2016",2,2,0,62850,537,123.5
"11453","36029","2016",2,2,0,86640,1011,113
"11454","36030","2016",3,3,0,102666.7,1690.667,60.66667
"11455","36031","2016",38,37,1,88828.03,932.0263,94.76316
"11456","36032","2016",11,11,0,86363.64,976.1818,88.90909
"11457","36033","2016",5,5,0,101100,1114.4,95.2
"11458","36034","2016",47,46,1,71442.23,914.7021,79.04255
"11459","36035","2016",12,12,0,42666.67,643.1667,70.58333
"11460","36036","2016",3,3,0,195000,1195.333,175.6667
"11461","36037","2016",4,4,0,106040,850.5,123.25
"11462","36040","2016",1,1,0,113000,551,205
"11463","36041","2016",2,2,0,68500,1127.5,61
"11464","36042","2016",7,7,0,120500,1250.571,94.57143
"11465","36043","2016",8,8,0,79175,959.375,80.125
"11466","36044","2016",482,340,142,100369.3,1179.919,86.19087
"11467","36045","2016",17,17,0,102911.8,966.2941,109.5294
"11468","36046","2016",41,39,2,92631,974.4146,96.53659
"11469","36047","2016",7,7,0,60142.86,809.4286,69.42857
"11470","36048","2016",3,3,0,41356.33,670.3333,62.33333
"11471","36049","2016",2,2,0,41000,743.5,56.5
"11472","36050","2016",3,3,0,108333.3,1037,102.6667
"11473","36051","2016",6,6,0,85750,951.1667,97.66667
"11474","36052","2016",2,2,0,81500,814,96
"11475","36053","2016",5,5,0,63846.4,834,79.4
"11476","36054","2016",3,3,0,63333.33,1125,55.33333
"11477","36055","2016",13,13,0,80893.92,941.3846,93
"11478","36056","2016",7,6,1,63325,748.8571,87.14286
"11479","36057","2016",4,4,0,78975,776.5,112.5
"11480","36058","2016",10,10,0,89200,977.2,87.1
"11481","36059","2016",2,2,0,112000,1097.5,122.5
"11482","36060","2016",5,5,0,54800,581.8,102.8
"11483","36061","2016",4,4,0,36000,567.75,65
"11484","36062","2016",7,7,0,79285.71,1102.714,81.42857
"11485","36063","2016",82,78,4,107412,1262.366,87.60976
"11486","36064","2016",3,3,0,117166.7,827.3333,139.3333
"11487","36065","2016",2,2,0,110000,1018,124.5
"11488","36066","2016",2,2,0,94500,850.5,102
"11489","36068","2016",2,2,0,86500,539.5,162.5
"11490","36069","2016",9,9,0,74722.22,971.5556,76.11111
"11491","36070","2016",26,26,0,80876.27,946.0385,87.88462
"11492","36071","2016",6,6,0,149566.7,1520.5,96.16667
"11493","36073","2016",2,2,0,91250,1036,90
"11494","36074","2016",7,7,0,60000,847.7143,72.57143
"11495","36075","2016",1,1,0,112760,1253,90
"11496","36076","2016",2,2,0,95500,1412.5,66.5
"11497","36077","2016",2,2,0,100500,921,107
"11498","36078","2016",4,4,0,64750,745.5,100.75
"11499","36079","2016",1,1,0,95000,950,100
"11500","36080","2016",1,1,0,50000,575,87
"11501","36081","2016",3,3,0,91166.67,919.3333,94.33333
"11502","36083","2016",2,2,0,112500,796,173.5
"11503","36084","2016",1,1,0,130500,989,132
"11504","36085","2016",3,3,0,110666.7,993,111.3333
"11505","36086","2016",5,5,0,114980,1152.8,111
"11506","36087","2016",3,3,0,54333.33,619.3333,91
"11507","36088","2016",109,99,10,84045.15,1006.303,84.72477
"11508","36089","2016",6,6,0,129000,1289.667,105.1667
"11509","36091","2016",7,7,0,138214.3,1325.143,103.2857
"11510","36092","2016",4,4,0,67500,973.5,70
"11511","36093","2016",26,24,2,75882.69,897.9615,85
"11512","36094","2016",8,7,1,121375,1152.625,73
"11513","36095","2016",3,3,0,113000,940.3333,106
"11514","36096","2016",5,5,0,90244,919,96.8
"11515","36097","2016",1,1,0,105000,1029,102
"11516","36098","2016",1,1,0,89000,631,141
"11517","36099","2016",3,3,0,49333.33,705.6667,68
"11518","36101","2016",14,14,0,132271,1353.571,94.71429
"11519","36102","2016",2,2,0,51750,700,74.5
"11520","36103","2016",9,9,0,75888.89,932.1111,82.11111
"11521","36104","2016",3,3,0,71500,872.6667,75
"11522","36105","2016",1,1,0,29000,403,72
"11523","36107","2016",8,8,0,67761.62,856,77.125
"11524","36108","2016",2,2,0,90000,1000,92
"11525","36109","2016",7,7,0,129107.1,1141.286,113.8571
"11526","36111","2016",2,2,0,76500,959.5,81
"11527","36112","2016",10,10,0,91650,1130,80.8
"11528","36113","2016",14,14,0,80964.29,869.3571,93.42857
"11529","36114","2016",3,3,0,82000,1092.333,72.66667
"11530","36115","2016",1,1,0,35720,518,69
"11531","36116","2016",2,2,0,107500,799,122.5
"11532","36117","2016",4,4,0,51833.25,436,112.5
"11533","36119","2016",4,4,0,75000,870.25,84.75
"11534","36120","2016",6,6,0,113033.3,994.3333,115
"11535","36121","2016",2,2,0,90250,826.5,108
"11536","36122","2016",1,1,0,116000,1137,102
"11537","36123","2016",16,16,0,70725,873,77.5
"11538","36124","2016",4,4,0,131000,1270.5,99.25
"11539","36126","2016",4,4,0,80125,1091.25,80.25
"11540","36127","2016",11,11,0,98313.64,1139.273,91.63636
"11541","36128","2016",11,11,0,130480.5,1368.909,98.27273
"11542","36129","2016",5,5,0,1e+05,1134.2,87
"11543","36131","2016",3,3,0,197666.7,1291,149.3333
"11544","36133","2016",2,2,0,54500,776.5,69.5
"11545","36134","2016",3,3,0,73224.67,953.6667,77
"11546","36135","2016",1,1,0,80000,714,112
"11547","36136","2016",3,3,0,79166.67,782.3333,103.3333
"11548","36137","2016",6,6,0,98115.83,1070.167,89.83333
"11549","36138","2016",1,1,0,22000,1222,18
"11550","36139","2016",6,6,0,105782.7,1084,97.5
"11551","36140","2016",19,19,0,94516,945.3158,102.0526
"11552","36141","2016",12,12,0,83183.33,830.8333,105.3333
"11553","36142","2016",8,8,0,93304.75,1012.5,88.25
"11554","36143","2016",5,5,0,112950,1096,94.8
"11555","36144","2016",1,1,0,120000,1212,99
"11556","36145","2016",1,1,0,87400,892,98
"11557","36146","2016",8,8,0,86062.5,1067.125,83.5
"11558","36147","2016",1,1,0,40000,471,85
"11559","36148","2016",1,1,0,174000,1243,140
"11560","36149","2016",13,12,1,100944.2,857.3846,109.8462
"11561","36150","2016",9,9,0,60500,813.1111,74.33333
"11562","36152","2016",4,4,0,89987.5,835,96
"11563","36153","2016",5,5,0,51800,626,80.4
"11564","36154","2016",24,24,0,94645.83,1022.667,93.29167
"11565","36155","2016",16,16,0,85312.5,852.5625,95.1875
"11566","36156","2016",6,6,0,67106,791.1667,98.16667
"11567","36157","2016",3,3,0,112500,1212.667,88.66667
"11568","36158","2016",15,15,0,111063.9,1035.933,112.2
"11569","36159","2016",46,46,0,148049.6,1417.217,104.9783
"11570","36160","2016",3,3,0,41333.33,734.6667,55
"11571","36161","2016",5,5,0,91380,1006,99.8
"11572","36162","2016",12,12,0,68046.58,817.6667,82.25
"11573","36163","2016",8,8,0,70125,823.625,77.25
"11574","36165","2016",8,8,0,96437.5,986.25,99.375
"11575","36166","2016",2,2,0,84500,925.5,87
"11576","36168","2016",5,4,1,39532.6,604.2,70.6
"11577","36169","2016",7,7,0,82285.71,867.7143,94.42857
"11578","36170","2016",2,2,0,248000,1415,171
"11579","36171","2016",22,22,0,89295.45,929.3182,95.81818
"11580","36173","2016",1,1,0,76000,826,92
"11581","36174","2016",4,4,0,57700,722.25,81.25
"11582","36175","2016",7,7,0,80320,996.8571,88.71429
"11583","36176","2016",1,1,0,97000,1090,89
"11584","36177","2016",4,4,0,44325.75,701.75,62.5
"11585","36178","2016",3,3,0,82333.33,1053.333,93
"11586","36179","2016",2,2,0,80500,1027.5,68
"11587","36180","2016",9,9,0,74288.89,907.1111,81.55556
"11588","36182","2016",8,7,1,138397.2,1187,131.25
"11589","36184","2016",6,6,0,71283.33,607.8333,133.6667
"11590","36185","2016",6,6,0,90783.33,692.3333,137.5
"11591","36186","2016",4,4,0,56625,659.75,78.5
"11592","36187","2016",4,4,0,108875,712.5,166.75
"11593","36188","2016",4,4,0,95812.5,967.75,84.25
"11594","36189","2016",14,14,0,93826.79,919.5,109.7857
"11595","36190","2016",4,4,0,111500,1092.25,102
"11596","36191","2016",2,1,1,83900,1292.5,66
"11597","36192","2016",14,14,0,75192.86,924.0714,84.07143
"11598","36193","2016",6,6,0,45166.67,805.6667,59
"11599","36194","2016",12,12,0,76933.33,813.8333,100.75
"11600","36195","2016",2,2,0,118500,1354,87.5
"11601","36197","2016",4,4,0,105750,834.25,117.75
"11602","36199","2016",7,7,0,61107.14,637.7143,97.14286
"11603","36200","2016",19,19,0,72289.47,966.0526,74.10526
"11604","36202","2016",20,20,0,137355,1338.9,103.3
"11605","36204","2016",3,3,0,86333.33,795,102.3333
"11606","36205","2016",1,1,0,30000,492,61
"11607","36207","2016",8,8,0,78083.12,1027.75,83.625
"11608","36208","2016",6,3,3,140120,1227.333,139.1667
"11609","36209","2016",2,2,0,58500,790.5,73
"11610","36210","2016",2,2,0,56360,688,92.5
"11611","36211","2016",3,3,0,101000,903.3333,115.6667
"11612","36212","2016",4,4,0,224101,2321.25,120.25
"11613","36213","2016",1,1,0,62000,827,75
"11614","36214","2016",3,3,0,55333.33,884,62.33333
"11615","36215","2016",8,8,0,96937.5,972.25,95.875
"11616","36216","2016",2,2,0,106000,993.5,131.5
"11617","36217","2016",1,1,0,114090,761,150
"11618","36218","2016",1,1,0,55000,647,85
"11619","36219","2016",6,6,0,99666.67,951.1667,103.6667
"11620","36220","2016",3,3,0,78533.33,835.6667,97.66667
"11621","36221","2016",4,4,0,91500,784.75,107.75
"11622","36222","2016",2,2,0,47000,802,59
"11623","36223","2016",1,1,0,50000,1111,45
"11624","36224","2016",12,12,0,72794.58,782.5833,93.41667
"11625","36225","2016",1,1,0,40000,625,64
"11626","36226","2016",4,4,0,71587.5,1074,73.5
"11627","36227","2016",4,4,0,80000,801.5,94.75
"11628","36228","2016",16,16,0,84399.69,934.625,93.6875
"11629","36229","2016",3,3,0,66520,683,89.33333
"11630","36230","2016",23,23,0,87160.87,1015.217,88.08696
"11631","36231","2016",9,9,0,117674.2,1377.667,90.55556
"11632","36232","2016",9,9,0,70777.78,807.1111,87.44444
"11633","36233","2016",13,13,0,82657.69,825.6154,99.84615
"11634","36234","2016",5,5,0,80100,998,78.8
"11635","36235","2016",1,1,0,25000,403,62
"11636","36236","2016",3,3,0,73033.33,914.6667,99.33333
"11637","36237","2016",13,13,0,62454.23,750.5385,85.38462
"11638","36238","2016",1,1,0,106400,818,130
"11639","36239","2016",2,2,0,240500,2802.5,115
"11640","36240","2016",4,4,0,56875,705,81
"11641","36241","2016",28,28,0,106591.1,1116.143,96.46429
"11642","36242","2016",1,1,0,108000,1091,99
"11643","36243","2016",1,1,0,85000,1308,65
"11644","36244","2016",11,11,0,68792.91,919.6364,78.81818
"11645","36246","2016",3,3,0,325636.3,3064.333,111.3333
"11646","36247","2016",10,10,0,98900,1104,92.8
"11647","36248","2016",2,2,0,76000,809,83
"11648","37001","2016",9,9,0,116444.4,1115.222,109.1111
"11649","37002","2016",16,16,0,169189.6,1726.75,103.8125
"11650","37003","2016",162,129,33,178638.4,2046.204,90.5679
"11651","37004","2016",5,5,0,91513.2,1110.8,77.8
"11652","37005","2016",2,2,0,103000,1327,80.5
"11653","37006","2016",27,27,0,162136.1,1652.333,104.0741
"11654","37007","2016",5,5,0,215400,2025.6,111.2
"11655","37008","2016",24,24,0,192872.5,2003.625,104.2917
"11656","37009","2016",5,5,0,137500,1556.2,95.4
"11657","37010","2016",19,18,1,140376.5,1520.684,93.73684
"11658","37011","2016",13,12,1,142842.3,1593,98.61538
"11659","37012","2016",8,8,0,150854.4,1289.875,108.875
"11660","37013","2016",3,3,0,145000,1186,126.3333
"11661","37014","2016",45,42,3,176257,1849.444,101.6444
"11662","37015","2016",29,29,0,190328.4,1847.862,111.2414
"11663","37016","2016",3,3,0,115000,1188,93.33333
"11664","37018","2016",107,87,20,222493.7,2148.327,106.2243
"11665","37019","2016",5,5,0,103200,1165.4,91.6
"11666","37020","2016",20,20,0,128675,1538.6,86.7
"11667","37021","2016",16,16,0,163335.2,1594,107.8125
"11668","37022","2016",22,22,0,149006.5,1637.136,95.95455
"11669","37024","2016",8,8,0,117375,1132,108.875
"11670","37025","2016",11,11,0,226800,2277.091,103.5455
"11671","37026","2016",8,8,0,64446.25,802.375,83.5
"11672","37027","2016",55,52,3,148676,1641.945,91.6
"11673","37028","2016",5,5,0,86120,946,84.6
"11674","37029","2016",3,3,0,123566.7,1207.333,98.66667
"11675","37030","2016",7,7,0,151642.9,1486.714,107
"11676","37031","2016",37,34,3,131104.9,1268.459,104.1622
"11677","37032","2016",4,4,0,93500,980.25,100.75
"11678","37033","2016",6,6,0,108913.3,929.1667,114
"11679","37034","2016",6,6,0,107758.3,920.6667,122.6667
"11680","37035","2016",3,3,0,109000,952,103.3333
"11681","37036","2016",4,4,0,143875,1463,94.25
"11682","37037","2016",3,3,0,95333.33,1472,66.33333
"11683","37038","2016",6,6,0,192533.3,1867.833,99
"11684","37039","2016",3,3,0,118000,991.6667,150.3333
"11685","37040","2016",2,2,0,185000,1389.5,138.5
"11686","37041","2016",4,4,0,146500,1158.75,126.25
"11687","37042","2016",1,1,0,450000,1500,300
"11688","37043","2016",13,13,0,155153.8,1525,103.9231
"11689","37044","2016",1,1,0,67000,918,73
"11690","37045","2016",9,9,0,97000,1037.222,94.33333
"11691","37046","2016",4,4,0,153918.8,1489,108
"11692","37047","2016",9,9,0,201930,1929.444,107.8889
"11693","37048","2016",1,1,0,40000,625,64
"11694","37049","2016",7,6,1,99642.86,1208.714,86
"11695","37050","2016",157,79,78,157636.6,2027.847,79.50955
"11696","37051","2016",7,7,0,105428.6,929.2857,101.1429
"11697","37052","2016",3,3,0,165360,1407.333,109.3333
"11698","37054","2016",26,25,1,200560.7,1982.731,104.6154
"11699","37055","2016",7,7,0,116214.3,1346.857,88.71429
"11700","37056","2016",3,3,0,163333.3,1575.333,108.6667
"11701","37057","2016",9,9,0,115983.3,1435.556,83.55556
"11702","37058","2016",18,18,0,100766.7,1156.778,89
"11703","37059","2016",8,8,0,221625,2145,105.5
"11704","37060","2016",16,16,0,192604.4,2090.625,99.0625
"11705","37061","2016",7,7,0,101585.7,1101.714,107.8571
"11706","37062","2016",17,16,1,104470.6,1357.176,78.94118
"11707","37063","2016",43,39,4,99837.21,1231.605,82.95349
"11708","37064","2016",4,4,0,108875,1160.25,100.75
"11709","37065","2016",3,3,0,92833.33,1094.333,85.66667
"11710","37066","2016",6,6,0,85485,1214.333,66.16667
"11711","37067","2016",20,20,0,178379,1627.65,112.65
"11712","37068","2016",6,6,0,120525.3,1124.333,118.6667
"11713","37069","2016",1,1,0,202500,892,227
"11714","37070","2016",6,6,0,207811.3,1680.833,139.5
"11715","37071","2016",1,1,0,79000,919,86
"11716","37072","2016",104,84,20,148323.1,1591.769,94.11538
"11717","37073","2016",4,4,0,121006.2,953.5,121.25
"11718","37074","2016",18,18,0,127969.3,1409.944,90.72222
"11719","37075","2016",2,2,0,172500,1714.5,105
"11720","37076","2016",2,2,0,87700,951,83
"11721","37077","2016",37,37,0,168348.6,1833.459,96.75676
"11722","37078","2016",4,4,0,81000,1072.5,73.75
"11723","37079","2016",22,22,0,153286.4,1613.091,98.18182
"11724","37080","2016",1,1,0,110000,917,120
"11725","37081","2016",16,16,0,139446.1,1365.062,107.6875
"11726","37082","2016",3,3,0,129333.3,1368,112.6667
"11727","37083","2016",24,23,1,161872.5,1614.708,101.2917
"11728","37084","2016",6,6,0,158250,2145.167,81.33333
"11729","37085","2016",9,9,0,217097.8,1861.111,114
"11730","37086","2016",4,3,1,119500,1318.75,81.25
"11731","37087","2016",4,4,0,107250,992.75,116.75
"11732","37089","2016",3,3,0,169000,1421.667,118.3333
"11733","37090","2016",1,1,0,190000,950,200
"11734","37091","2016",24,24,0,160306.2,1726.917,99.25
"11735","37092","2016",7,7,0,156357.1,1661.143,92.42857
"11736","37093","2016",5,5,0,81000,1073.2,73.6
"11737","37094","2016",1,1,0,117300,1629,72
"11738","37095","2016",5,5,0,187540,1460.4,139.4
"11739","37096","2016",8,8,0,173746.2,1351.625,130.25
"11740","37097","2016",5,5,0,191710,1367,139.6
"11741","37098","2016",4,4,0,105000,1204.5,94
"11742","37099","2016",7,7,0,133631.1,1721.143,75.71429
"11743","37100","2016",10,10,0,86264,1339,72.4
"11744","37101","2016",2,2,0,131750,1338,113.5
"11745","37103","2016",2,2,0,96000,1169.5,82
"11746","37104","2016",54,53,1,192917.1,1782.611,107.4815
"11747","37105","2016",5,5,0,141650,1010.2,135
"11748","37106","2016",2,2,0,78750,1028.5,66.5
"11749","37107","2016",5,5,0,65700,839.6,77
"11750","37108","2016",8,8,0,175761.9,1490.125,122.125
"11751","37109","2016",128,121,7,256371.8,2211.156,116.875
"11752","37110","2016",17,17,0,136252.9,1437.059,96.64706
"11753","37111","2016",15,15,0,134792.7,1422.2,98.06667
"11754","37112","2016",7,7,0,112000,1620.714,95.57143
"11755","37113","2016",8,8,0,91244,1039.625,91.875
"11756","37114","2016",3,3,0,85333.33,868.6667,93.66667
"11757","37115","2016",33,31,2,93098.79,995.7576,90.21212
"11758","37116","2016",3,3,0,61000,1033,56.66667
"11759","37117","2016",13,13,0,123338.5,1126.231,111.3846
"11760","37118","2016",10,10,0,110093,1378.3,92.6
"11761","37119","2016",25,24,1,99893.64,1033.08,99.32
"11762","37121","2016",6,6,0,100600,1067.833,96.66667
"11763","37122","2016",439,191,248,135679.6,1845.724,74.3508
"11764","37123","2016",51,51,0,147129.8,1605.588,92.78431
"11765","37124","2016",25,25,0,209700.2,2087.92,101.16
"11766","37125","2016",2,2,0,405500,1289.5,246
"11767","37126","2016",9,9,0,118560.9,973.5556,116.4444
"11768","37127","2016",2,2,0,111500,815,141
"11769","37128","2016",12,12,0,172689.2,1550.333,107.5833
"11770","37129","2016",14,14,0,132642.9,1319.143,105.9286
"11771","37130","2016",21,21,0,98741.43,1136.857,88.7619
"11772","37131","2016",11,11,0,171625.7,1529.636,112.4545
"11773","37132","2016",60,55,5,144234.1,1517.833,94.11667
"11774","37133","2016",7,7,0,124343.1,1153.429,103.8571
"11775","37134","2016",18,18,0,151032.2,1432.111,105.8889
"11776","37136","2016",3,3,0,136916.7,1299.333,107.6667
"11777","37137","2016",3,3,0,207333.3,1399.667,151
"11778","37138","2016",10,10,0,152600,2152.8,88.7
"11779","37139","2016",55,52,3,201391.9,1837.582,111.8727
"11780","37140","2016",1,1,0,25000,1250,20
"11781","37141","2016",17,16,1,141658.8,1706.176,88.35294
"11782","37142","2016",4,4,0,187585.8,2221,84.25
"11783","37143","2016",14,14,0,114321.4,1185.857,97.64286
"11784","37144","2016",8,8,0,112987.5,1339.125,82.375
"11785","37145","2016",1,1,0,207000,1294,160
"11786","37146","2016",2,2,0,262500,2363,91
"11787","37147","2016",4,4,0,145872.2,1105.5,118.25
"11788","37148","2016",6,6,0,90066.67,1070.667,83.33333
"11789","37149","2016",3,3,0,135666.7,2523.333,61
"11790","37150","2016",17,17,0,164767.1,1628.824,108.3529
"11791","37151","2016",32,29,3,220933.1,2322.844,108.5625
"11792","37152","2016",19,19,0,244023.7,2483.947,112.8947
"11793","37153","2016",53,52,1,186354.5,1775.208,108.9811
"11794","37154","2016",49,45,4,197833.4,1936.837,102.3265
"11795","37155","2016",12,12,0,79586.67,1221.833,70.5
"11796","37156","2016",114,97,17,172801,1944.447,91.14912
"11797","37157","2016",1,1,0,61000,871,70
"11798","37158","2016",10,10,0,178505,1654.5,110.3
"11799","37159","2016",94,91,3,193242.5,1947.415,101.7234
"11800","37160","2016",5,5,0,133140,1345.8,105.8
"11801","37161","2016",13,13,0,140567.7,1495,99.76923
"11802","37162","2016",3,3,0,163073.3,1249.667,121.6667
"11803","37163","2016",53,53,0,153177.2,1882.434,84.20755
"11804","37165","2016",1,1,0,137000,1384,99
"11805","37166","2016",5,5,0,180472,1213.2,161.2
"11806","37167","2016",22,22,0,156297.7,1610.818,100.3182
"11807","37168","2016",3,3,0,76000,1149.333,69.33333
"11808","37169","2016",13,13,0,162076.9,1433.154,113
"11809","37170","2016",12,12,0,97571.67,986.5833,101.4167
"11810","37171","2016",13,13,0,137892.3,1794.538,81.30769
"11811","37172","2016",23,23,0,211663,2283.783,94.26087
"11812","37173","2016",4,4,0,102375,906.75,120.75
"11813","37174","2016",13,13,0,115553.8,1421.538,90.76923
"11814","37175","2016",8,8,0,131856.2,1412.875,99
"11815","37176","2016",13,13,0,144730.8,1460.231,99.69231
"11816","37177","2016",5,5,0,64000,653,92.4
"11817","37178","2016",2,2,0,135000,1303,105
"11818","37179","2016",14,14,0,275807.1,2392.857,115.8571
"11819","37180","2016",10,10,0,82350,975.5,86.8
"11820","37181","2016",3,3,0,79333.33,966,81
"11821","37182","2016",11,11,0,151672.5,1616.636,93.81818
"11822","37183","2016",10,9,1,125900,1361.3,88.6
"11823","37184","2016",8,8,0,107671.2,1631.625,94.875
"11824","37185","2016",14,13,1,176928.6,1680.571,103.6429
"11825","37186","2016",10,10,0,161947.3,1875.5,86.9
"11826","37187","2016",2,2,0,52500,1020,60.5
"11827","37188","2016",9,9,0,130616.7,1535.556,90.66667
"11828","37189","2016",9,9,0,80333.33,1016.111,81.44444
"11829","37190","2016",1,1,0,73000,859,85
"11830","37191","2016",3,3,0,54166.67,1299,46
"11831","37192","2016",21,21,0,162481,1544.667,113.5714
"11832","37193","2016",15,15,0,141032.7,1223.933,114.6667
"11833","37194","2016",13,13,0,199161.5,1786.462,112.3077
"11834","37195","2016",200,56,144,143562.9,2116.395,67.71
"11835","37196","2016",9,8,1,82450.22,1054.778,78.88889
"11836","37197","2016",11,11,0,113077.3,1325.091,104.7273
"11837","37198","2016",3,3,0,262000,1853.333,130.3333
"11838","37199","2016",3,3,0,110633.3,1144.333,97.66667
"11839","37200","2016",10,10,0,142108.6,1381.3,107.9
"11840","37201","2016",6,6,0,123046.5,1614.5,73.5
"11841","37202","2016",3,3,0,175000,1763.667,100.3333
"11842","37203","2016",46,42,4,262345,2398.891,115.5652
"11843","37204","2016",9,9,0,202902.2,1577.667,130.3333
"11844","37205","2016",19,19,0,128094.7,1918.789,72.84211
"11845","37206","2016",17,17,0,219487.6,1815.588,123.4118
"11846","37207","2016",3,3,0,75000,1344.667,58.33333
"11847","37208","2016",158,126,32,233605.9,2311.222,105.2468
"11848","37210","2016",5,5,0,147514,1464.4,103.6
"11849","37211","2016",20,20,0,200952.3,1873.15,108.25
"11850","37212","2016",9,9,0,110316.7,1289.111,86.77778
"11851","37213","2016",16,16,0,100281.2,1215.938,84.0625
"11852","37214","2016",262,155,107,204922.4,2391.336,86
"11853","37216","2016",13,13,0,165863.1,1323.231,122.6923
"11854","37217","2016",16,15,1,131989.1,1321.062,97.375
"11855","37218","2016",7,7,0,94785.71,950.1429,101.2857
"11856","37219","2016",11,11,0,186033.2,2084.636,91.36364
"11857","37220","2016",6,6,0,91433.33,1229.5,78.5
"11858","37221","2016",9,9,0,110800,1212.333,89.77778
"11859","37222","2016",8,8,0,140852.4,1371.75,105.125
"11860","37223","2016",8,8,0,111000,1245.875,89.125
"11861","37224","2016",5,5,0,130100,1510.6,85
"11862","37225","2016",27,26,1,168044.8,1907,90.92593
"11863","37226","2016",44,41,3,125385.1,1336.159,94.79545
"11864","37228","2016",10,10,0,180452.6,1417.1,122.4
"11865","37229","2016",3,3,0,113166.7,1198,93.33333
"11866","37230","2016",5,5,0,161800,1719.6,95.4
"11867","37231","2016",19,18,1,122105.3,1591.526,86.52632
"11868","37232","2016",14,14,0,152892.9,1501.214,102
"11869","37233","2016",156,90,66,136761.1,1908.846,75.44872
"11870","37234","2016",5,5,0,102000,1066.4,96.2
"11871","37236","2016",6,6,0,190883.3,1695.667,112
"11872","37237","2016",17,17,0,241623.2,2159.765,117.1765
"11873","37238","2016",2,2,0,113750,902.5,129
"11874","37240","2016",9,9,0,151027.8,1757.556,86.77778
"11875","37241","2016",15,15,0,118400,1380,92.6
"11876","37242","2016",11,11,0,167802.9,1383.182,124.0909
"11877","37243","2016",28,27,1,212388.9,2321.25,94.82143
"11878","37244","2016",2,2,0,154000,1156.5,137.5
"11879","37245","2016",18,18,0,186841.1,1667.944,117.1111
"11880","37246","2016",1,1,0,65000,942,69
"11881","37247","2016",6,6,0,192666.7,1536.333,132.5
"11882","37248","2016",6,6,0,94663.33,2333,56
"11883","37249","2016",16,16,0,142296.2,1532.25,99.0625
"11884","37250","2016",28,26,2,162857.1,1785.464,93.85714
"11885","37251","2016",12,12,0,144354.2,1478.667,107.0833
"11886","37252","2016",5,5,0,132300,1496.4,106.4
"11887","37253","2016",2,2,0,235000,1202.5,193
"11888","37254","2016",14,13,1,138828.6,1457.5,95.21429
"11889","37255","2016",5,5,0,109400,1213.6,89.4
"11890","37256","2016",2,2,0,143155,1307.5,110
"11891","37257","2016",17,17,0,176327.6,1454.176,123.8235
"11892","37258","2016",5,5,0,126800,1495.4,85.6
"11893","37259","2016",2,2,0,58295,842.5,71
"11894","37260","2016",2,2,0,146000,1016.5,140
"11895","37261","2016",1984,528,1456,155525.8,2309.52,67.5494
"11896","37262","2016",4,4,0,176687.5,1272.75,143.75
"11897","37263","2016",20,20,0,160164.7,1740.3,92
"11898","37264","2016",13,13,0,174246.2,1726.385,98.23077
"11899","37265","2016",4,4,0,339775,3524.25,113.25
"11900","37266","2016",59,58,1,212203.2,2071.136,108.2542
"11901","37267","2016",31,30,1,207027.4,2041.935,104.6129
"11902","37269","2016",5,5,0,139804,1753,77
"11903","37270","2016",31,31,0,198044.8,1898.194,105.7419
"11904","37271","2016",10,10,0,130600,1405.1,101.6
"11905","37272","2016",5,5,0,134991.8,1942.6,64.4
"11906","37273","2016",41,37,4,173119.1,2024.098,89.02439
"11907","37274","2016",4,4,0,142050,1637.5,93.5
"11908","37276","2016",9,9,0,142155.6,1331.222,104.8889
"11909","37277","2016",7,7,0,177802.6,1471.571,142.4286
"11910","37278","2016",9,9,0,154562.2,1598.444,97.77778
"11911","37279","2016",8,8,0,85375,1062.75,79.75
"11912","37280","2016",3,3,0,77000,910,81
"11913","37281","2016",31,29,2,207736.1,2475.71,89.3871
"11914","37282","2016",14,14,0,147194.3,1082.071,132.7143
"11915","38001","2016",80,50,30,135245.3,1613.162,84.0375
"11916","38002","2016",51,9,42,102030.7,2504.431,40.90196
"11917","38003","2016",11,10,1,207611.4,1952,118.0909
"11918","38004","2016",10,10,0,138580,1676.7,82.5
"11919","38005","2016",28,14,14,127169.9,2063.857,61.78571
"11920","38006","2016",77,31,46,124361.8,1879.247,67.48052
"11921","38009","2016",10,10,0,164355,1677.7,97.2
"11922","38010","2016",6,6,0,210781.7,1691.167,133
"11923","38011","2016",18,16,2,260471.4,2425.944,113.7222
"11924","38012","2016",26,20,6,148968.8,1635.115,89.92308
"11925","38013","2016",32,29,3,218640.3,2037.531,113.1875
"11926","38015","2016",22,21,1,194806.8,2199.091,99.54545
"11927","38017","2016",27,26,1,160320.7,1636.667,98.85185
"11928","38018","2016",1,1,0,74000,740,100
"11929","38019","2016",16,11,5,146904.4,1678.812,85.5625
"11930","38020","2016",28,2,26,69049.11,2222.821,30.21429
"11931","38022","2016",113,91,22,148868.5,1559.15,99.15044
"11932","38026","2016",11,10,1,176139.6,1728.182,103.2727
"11933","38027","2016",25,24,1,239367.2,2149.12,111.44
"11934","38029","2016",20,18,2,144848.8,1477.95,104.25
"11935","38030","2016",12,11,1,175335.4,1872.25,95.66667
"11936","38031","2016",1,1,0,85000,1700,50
"11937","38032","2016",6,6,0,149838,1455.333,108.1667
"11938","38033","2016",2,2,0,263500,2384.5,103.5
"11939","38034","2016",48,40,8,133043.3,1430.958,95.0625
"11940","38035","2016",5,4,1,165000,2073.4,99.8
"11941","38037","2016",7,7,0,189680,1786.143,110
"11942","38038","2016",3,3,0,167583.3,1629.333,108.3333
"11943","38039","2016",30,28,2,344774.2,3258.433,108.2
"11944","38042","2016",6,6,0,201623.3,2180.833,92.5
"11945","38043","2016",16,15,1,185046.8,1954.938,99
"11946","38044","2016",9,8,1,129833.3,1550.222,85.33333
"11947","38045","2016",12,11,1,410458.3,3872.833,111.9167
"11948","38046","2016",12,12,0,172423.8,1538.167,117.8333
"11949","38047","2016",1,1,0,133650,955,140
"11950","38048","2016",10,7,3,176624,1791.8,96.9
"11951","38049","2016",3,3,0,156316.7,1183.333,130.3333
"11952","38050","2016",12,12,0,151315.8,1479.5,104.3333
"11953","38051","2016",12,10,2,137998.3,1553.083,93.58333
"11954","38052","2016",38,18,20,161829.1,2154.632,79.21053
"11955","38053","2016",339,110,229,152118.2,1956.115,79.48968
"11956","38054","2016",11,11,0,136940.9,1495.545,94.18182
"11957","38055","2016",7,7,0,163228.6,1617.286,116.4286
"11958","38057","2016",5,3,2,297796.4,3662.4,83.4
"11959","38058","2016",14,13,1,185966.4,1826.929,104.5714
"11960","38059","2016",20,14,6,320801.8,3194,96.1
"11961","38060","2016",2,2,0,187500,1573.5,117.5
"11962","38061","2016",38,25,13,247765.3,2545.605,97.15789
"11963","38062","2016",4,4,0,206567.5,2329,102.5
"11964","38063","2016",5,4,1,217194,1625,142
"11965","38064","2016",28,28,0,188448.6,1894.143,101.0714
"11966","38065","2016",15,13,2,167339.7,1760.133,101.6
"11967","38067","2016",22,19,3,262032.4,2289.091,117.6364
"11968","38068","2016",7,6,1,348950,3271.429,110.7143
"11969","38069","2016",16,12,4,135171.2,1542.625,88
"11970","38070","2016",17,15,2,207944.1,2165.353,95.35294
"11971","38071","2016",25,16,9,225176,2627,87
"11972","38072","2016",21,20,1,200409.7,1792.381,111.5714
"11973","38073","2016",6,4,2,60833.33,815,73.33333
"11974","38074","2016",5,5,0,172600,1752.4,105.4
"11975","38075","2016",36,30,6,229550.2,2425.083,99.66667
"11976","38076","2016",19,18,1,175250.8,1756.158,103.2632
"11977","38077","2016",5,5,0,162580,1567.8,102.6
"11978","38078","2016",7,7,0,140197.1,1934.429,71.71429
"11979","38080","2016",4,4,0,192175,1479.75,128.5
"11980","38081","2016",22,22,0,196840.5,2037.682,98.72727
"11981","38082","2016",31,26,5,179321.9,1723.968,104.2903
"11982","38083","2016",3,3,0,146666.7,1446.667,110
"11983","38084","2016",7,7,0,244700,2455.429,102.8571
"11984","38085","2016",85,73,12,199125.9,2184.059,91.28235
"11985","38086","2016",2,2,0,175000,1577,111
"11986","38087","2016",55,35,20,185844.5,2156.473,86.98182
"11987","38090","2016",6,6,0,189666.7,2245.333,102.1667
"11988","38091","2016",1,1,0,230000,1211,190
"11989","38093","2016",5,5,0,203540,1727.8,130
"11990","38094","2016",18,16,2,139257.5,1554.778,86.11111
"11991","38095","2016",24,22,2,174030.2,1528.333,118.0417
"11992","38097","2016",49,41,8,209599.8,2310.918,93.71429
"11993","38098","2016",6,6,0,195597.5,1499,144.1667
"11994","38099","2016",3,3,0,233316.7,2243,103.3333
"11995","38100","2016",16,13,3,209833.6,2375.25,87.6875
"11996","38101","2016",6,6,0,204483.3,1870.833,111.8333
"11997","38102","2016",7,7,0,189378.6,1673.714,111
"11998","38103","2016",3,3,0,175483.3,2741.333,64
"11999","38104","2016",11,11,0,143645.5,1555.364,93.45455
"12000","38105","2016",15,14,1,188610,2070.733,95.13333
"12001","38106","2016",4,4,0,177250,2294.5,90
"12002","38107","2016",19,14,5,236610.5,2400.263,104.2105
"12003","38108","2016",2,2,0,326317.5,2923,132.5
"12004","38109","2016",10,10,0,246658.5,2376.1,113.8
"12005","38110","2016",43,42,1,280439.5,2692.791,109.8837
"12006","38111","2016",80,48,32,279195.7,2939.6,95.8125
"12007","38113","2016",2,2,0,182250,1915,105.5
"12008","38114","2016",10,10,0,230093.5,2156.3,112.3
"12009","38115","2016",8,7,1,226887.5,1915.75,126.625
"12010","38117","2016",2,2,0,145000,1669.5,83.5
"12011","38118","2016",12,12,0,197788.3,1912.917,105.75
"12012","38120","2016",3,3,0,265666.7,1726,151.6667
"12013","38124","2016",19,17,2,137827.6,1512.632,92.94737
"12014","38126","2016",58,36,22,411308.8,3646.362,115.6379
"12015","38128","2016",7,6,1,113767.1,1098.571,99.71429
"12016","38129","2016",21,6,15,131956.7,3068.667,39.7619
"12017","38130","2016",52,33,19,145841.8,1677.115,87.92308
"12018","38131","2016",23,20,3,230994.7,2101.478,109.2609
"12019","38132","2016",1,1,0,80000,635,126
"12020","38133","2016",42,35,7,290945.5,2864.452,102.3095
"12021","38134","2016",8,7,1,198112.5,1929.75,98.5
"12022","38135","2016",19,19,0,191805.3,2023,99.73684
"12023","38136","2016",2,2,0,217100,1897,106.5
"12024","38137","2016",6,6,0,269066.7,2377.833,114.3333
"12025","38138","2016",45,23,22,165165.6,2181.867,84.77778
"12026","38139","2016",16,16,0,163394.1,1642.125,100.0625
"12027","38140","2016",64,47,17,309753.8,2932.156,105.375
"12028","38141","2016",8,8,0,151776.2,1707.375,87.75
"12029","38144","2016",30,23,7,218373.9,2616.967,98.16667
"12030","38146","2016",9,7,2,207131.1,2092.444,97.55556
"12031","38147","2016",8,8,0,160061.2,1430.25,111.75
"12032","38148","2016",20,19,1,171517.6,1723.6,101.75
"12033","38149","2016",7,5,2,194227.1,1850.714,103
"12034","38150","2016",65,22,43,187358.6,2510.738,73.64615
"12035","38151","2016",306,33,273,149951.7,2129.239,71.29412
"12036","38152","2016",17,17,0,177638.2,1777.647,103.1765
"12037","38153","2016",3,2,1,201633.3,1949.667,104.3333
"12038","38154","2016",2,2,0,99500,1701.5,61.5
"12039","38155","2016",20,18,2,133575.5,1631.1,82.3
"12040","38156","2016",10,10,0,224133.7,2182.3,102.3
"12041","38157","2016",22,21,1,198520.1,1766.455,112.7273
"12042","38158","2016",122,30,92,198124.3,2593.352,75.29508
"12043","38159","2016",4,4,0,143515.8,1230.75,118.25
"12044","38160","2016",11,11,0,223922.7,1948.182,115.7273
"12045","38161","2016",9,9,0,168693.3,1521.556,115.7778
"12046","38162","2016",14,13,1,175805.1,1438.071,125.7857
"12047","38163","2016",9,9,0,111232.6,1338.222,88.44444
"12048","38166","2016",3,3,0,247905,2661.667,93.66667
"12049","38167","2016",8,8,0,190315,1906.625,101
"12050","38169","2016",252,44,208,142802.2,2018.849,69.75397
"12051","38170","2016",35,13,22,227681.1,2870,79.2
"12052","38171","2016",2,2,0,205000,1951,102.5
"12053","38172","2016",23,23,0,205353.4,1951.826,105.6087
"12054","38173","2016",2,2,0,125000,3191,33.5
"12055","38174","2016",7,7,0,149005.7,1797.286,85.71429
"12056","38175","2016",38,26,12,245129.2,2666,93.52632
"12057","38176","2016",29,29,0,228654.5,2172.379,110.3103
"12058","38177","2016",2,2,0,150500,1645.5,97
"12059","38179","2016",80,21,59,192565,2657.588,73
"12060","38180","2016",5,5,0,224860,2121.2,106.8
"12061","38181","2016",27,17,10,196563.1,2409.37,82.14815
"12062","38182","2016",25,22,3,166279.4,1560.84,105.96
"12063","38183","2016",2,2,0,178250,1645,108.5
"12064","38184","2016",15,13,2,238437.6,2226.867,111.3333
"12065","38185","2016",2486,72,2414,145866.9,2317.614,64.3387
"12066","38186","2016",19,3,16,77882.63,1592.632,50.52632
"12067","38187","2016",30,24,6,220459,2245.467,102.5333
"12068","38188","2016",15,10,5,318650.1,2850.467,110
"12069","38189","2016",57,47,10,274395.1,2598.07,99.01754
"12070","38190","2016",15,14,1,196606.7,1903.267,110.4667
"12071","38191","2016",195,11,184,160631.2,4281.533,35.32308
"12072","38192","2016",1,1,0,162500,2754,59
"12073","38193","2016",171,121,50,165122.3,1984.813,85.1345
"12074","38194","2016",26,20,6,166572.3,1610.154,108.1538
"12075","38195","2016",9,9,0,188422.2,1883.333,105.7778
"12076","38197","2016",18,8,10,205390.6,2424.167,87.44444
"12077","38198","2016",5,4,1,149512,1502,99.4
"12078","38199","2016",15,12,3,247310.2,2643.733,97.73333
"12079","38200","2016",32,25,7,262456.1,2582,102.0312
"12080","38203","2016",4,4,0,159476.2,1697,95.25
"12081","38204","2016",7,6,1,112285.7,1411.857,85.57143
"12082","38205","2016",35,21,14,215170.5,3381.2,64.31429
"12083","38206","2016",6,5,1,223704.2,2165,114
"12084","38207","2016",5,5,0,101928,1431,82.2
"12085","38208","2016",3,3,0,132477.7,2006.333,72.66667
"12086","38209","2016",1,0,1,159000,2338,68
"12087","38210","2016",6,6,0,209900,1747.667,117.6667
"12088","38212","2016",14,13,1,125045,1425.643,92.21429
"12089","38213","2016",5,5,0,183723,1623.8,118.2
"12090","38215","2016",22,21,1,303855,2580.636,123.5909
"12091","38216","2016",4,4,0,108451.5,2948.75,64
"12092","38217","2016",2,2,0,102500,989.5,95.5
"12093","38218","2016",14,13,1,135312.9,1285.786,115.9286
"12094","38219","2016",5,5,0,150852,1491.2,95.6
"12095","38221","2016",2,2,0,127150,1360,85
"12096","38222","2016",12,12,0,164195.8,1558,109.5
"12097","38223","2016",12,11,1,224398.9,2311.333,96
"12098","38225","2016",55,31,24,188128.1,2510.291,79.2
"12099","38226","2016",14,10,4,128664.3,1516,91.71429
"12100","38228","2016",7,7,0,159987.9,1609.429,104.4286
"12101","38229","2016",201,49,152,300959.8,3221.612,91.26368
"12102","38230","2016",12,10,2,246944.2,2245.25,115.8333
"12103","38231","2016",12,12,0,210007.9,2204.833,106.0833
"12104","38232","2016",6,6,0,211888.3,1800.5,121
"12105","38235","2016",6,6,0,230134.7,1950.833,118.5
"12106","38236","2016",15,15,0,159714.7,1857.733,92.73333
"12107","38237","2016",3,2,1,119446.7,1470,73.33333
"12108","38238","2016",21,20,1,182818.6,1671,112.1905
"12109","38239","2016",66,37,29,173465.3,1894.818,89.56061
"12110","38240","2016",6,6,0,126566.7,1272.667,101.6667
"12111","38242","2016",13,12,1,168588.5,1563.462,109.6923
"12112","38243","2016",2,1,1,95000,1674,57
"12113","38244","2016",5,5,0,162140.4,1735.6,100.6
"12114","38245","2016",1,1,0,195500,2444,80
"12115","38246","2016",6,6,0,168803.3,1762.5,93.33333
"12116","38247","2016",60,49,11,126599.8,1523.867,85.43333
"12117","38248","2016",4,4,0,251000,1787.25,135.75
"12118","38249","2016",53,19,34,300338.6,3353.585,89.39623
"12119","38250","2016",7,7,0,256891.4,1855,161.7143
"12120","38253","2016",245,5,240,110568.6,3067.604,34.85714
"12121","38254","2016",5,5,0,204500,1971.4,105
"12122","38256","2016",16,15,1,175600,2110.25,100.5625
"12123","38257","2016",5,5,0,173500,1956,94.4
"12124","38258","2016",2,2,0,189000,2343,80
"12125","38259","2016",11,11,0,183642.7,2073,91.45455
"12126","38260","2016",6,6,0,258800,2893.5,98.83333
"12127","38261","2016",45,31,14,162882.6,1791.933,90
"12128","38263","2016",7,7,0,204785.7,1927,108.5714
"12129","38264","2016",16,10,6,166805,2052.375,76.5
"12130","38265","2016",13,12,1,123284.6,1326.692,92.07692
"12131","38266","2016",8,8,0,125350,1671.75,85.125
"12132","38267","2016",3,3,0,121050,1235.667,95.33333
"12133","38268","2016",4,4,0,190570,1354.5,148.75
"12134","38269","2016",47,20,27,111619.4,1487.17,76.19149
"12135","38270","2016",21,19,2,269196.7,2532.238,107.1429
"12136","38271","2016",2,1,1,350840,2925.5,115.5
"12137","38272","2016",3,2,1,254962.3,1834.667,139
"12138","38273","2016",3,3,0,213230,1674.333,132
"12139","38276","2016",28,23,5,201852.9,1977.786,106.1071
"12140","38277","2016",8,8,0,254454.4,2402.5,111.75
"12141","38278","2016",8,8,0,132225,1504.875,88.5
"12142","38279","2016",11,11,0,248333.2,2288.273,110.1818
"12143","38280","2016",7,7,0,100818.6,1029,107
"12144","38281","2016",14,9,5,235388.2,2441.929,100.6429
"12145","38282","2016",10,10,0,197410,2143.7,94.9
"12146","38284","2016",4,4,0,118000,1709.5,83.25
"12147","38285","2016",4,4,0,159500,2315.25,81.25
"12148","38287","2016",10,10,0,213280,1735,127.4
"12149","38288","2016",17,16,1,234787.1,2369.647,99.64706
"12150","38289","2016",15,4,11,173661.9,3512.2,55.6
"12151","38290","2016",9,9,0,147888.9,1592.889,97.88889
"12152","38291","2016",8,8,0,140161.2,1719.375,102.5
"12153","38292","2016",26,24,2,173055.8,1907.192,92.53846
"12154","38294","2016",3,3,0,139093.3,1830.333,85
"12155","38295","2016",7,7,0,187550,2136,89.71429
"12156","38296","2016",6,6,0,189283.3,1584.833,123.6667
"12157","38297","2016",15,13,2,121200.3,1423.4,96.8
"12158","38298","2016",55,35,20,150486.1,1685.127,91.25455
"12159","38299","2016",2,2,0,105000,1461.5,69.5
"12160","38300","2016",6,6,0,172933,1773.333,104.1667
"12161","38303","2016",3,3,0,194666.7,1760.333,107.3333
"12162","38304","2016",14,13,1,150427.9,1614.857,96
"12163","38307","2016",3,3,0,142666.7,1428.333,106.6667
"12164","38309","2016",9,3,6,227588.9,2950.667,77
"12165","38310","2016",3,3,0,245576.7,2012.667,117
"12166","38311","2016",6,6,0,134588.3,1321.5,108
"12167","38313","2016",4,4,0,83000,1263.75,55.75
"12168","38314","2016",101,53,48,161680.3,2063.396,78.90099
"12169","38315","2016",39,12,27,122708.8,1510.949,82.41026
"12170","38316","2016",81,28,53,130298.6,1825.136,72.88889
"12171","38317","2016",122,17,105,125670.7,1827.779,68.77869
"12172","38318","2016",37,19,18,166127.1,1806.568,94.13514
"12173","38319","2016",9,6,3,77666.67,1113.111,74.11111
"12174","38320","2016",17,17,0,156601.8,1657.588,96.82353
"12175","38321","2016",2,1,1,140000,1196.5,128
"12176","38323","2016",12,12,0,202755.8,1850.083,115.9167
"12177","38324","2016",8,8,0,167318.8,1544.625,111.875
"12178","38325","2016",1,1,0,160000,1667,96
"12179","38326","2016",3,2,1,81383.33,1184,61.66667
"12180","38328","2016",2,2,0,395500,2738,143.5
"12181","38329","2016",1,1,0,25000,397,63
"12182","38330","2016",1,1,0,172000,1344,128
"12183","38331","2016",5,5,0,267210,2192.8,123.6
"12184","38332","2016",28,19,9,148593.9,1698.179,89.71429
"12185","38333","2016",6,6,0,178141.7,2661.667,79.16667
"12186","38334","2016",9,9,0,287594.4,3004.222,110.6667
"12187","38335","2016",4,4,0,203250,1896.75,107.75
"12188","38336","2016",15,13,2,191565.3,1896.8,103.8667
"12189","38337","2016",69,29,40,140958.3,1943.377,74.15942
"12190","38338","2016",11,11,0,204470.5,2012.818,98.36364
"12191","38339","2016",12,10,2,231916.2,2282.917,105.6667
"12192","38340","2016",26,19,7,164635.6,2100.769,79.61538
"12193","38341","2016",2,2,0,166815.5,1925,86.5
"12194","38342","2016",3,3,0,216333.3,1584.667,141.3333
"12195","38343","2016",8,8,0,201537.5,2018.625,107.875
"12196","38344","2016",83,56,27,137197.6,1485.12,94.56627
"12197","38345","2016",6,6,0,169070,1621,103.1667
"12198","38346","2016",2,2,0,254760,1795,142.5
"12199","38347","2016",8,8,0,112175,1279.875,95.625
"12200","38348","2016",43,38,5,246315.7,2014.86,121.3256
"12201","38349","2016",19,18,1,163424.7,1803.895,94
"12202","38350","2016",5,5,0,244560,2382.2,99.2
"12203","38351","2016",8,8,0,214861.5,1804,114.5
"12204","38352","2016",24,17,7,208845.8,2404.542,91.5
"12205","38353","2016",5,5,0,137500,1568.2,88.8
"12206","38354","2016",6,6,0,155196.7,1922.667,86
"12207","38355","2016",1,1,0,167500,2577,65
"12208","38356","2016",3,3,0,174333.3,1932,89
"12209","38357","2016",23,20,3,144551.5,1493.696,104.6957
"12210","38358","2016",10,10,0,166360,1595,102.8
"12211","38359","2016",8,7,1,186306.9,2057.75,92.875
"12212","38360","2016",5,4,1,184080,2068.2,94.2
"12213","38362","2016",11,10,1,309097.3,2755.364,123.8182
"12214","38363","2016",10,10,0,135307.5,1459.5,93.4
"12215","38364","2016",4,4,0,124250,1478,89.75
"12216","38365","2016",5,5,0,184784,1732,106.8
"12217","38366","2016",1,1,0,197150,1408,140
"12218","38368","2016",10,10,0,267531.4,1945.3,138.6
"12219","38369","2016",8,8,0,198980.2,1908.75,108.375
"12220","38370","2016",5,5,0,153940,1683.6,97.6
"12221","38372","2016",3,3,0,147833.3,1185,124.3333
"12222","38373","2016",6,5,1,235760,2684.667,91.66667
"12223","38374","2016",50,41,9,188998.4,1928.46,98.16
"12224","38375","2016",2,2,0,128000,2894.5,44
"12225","38376","2016",10,10,0,124690,1534.2,85.2
"12226","38377","2016",28,23,5,153981.1,1697.643,95.28571
"12227","38378","2016",38,31,7,207013,2114.632,97.57895
"12228","38379","2016",2,2,0,107250,2163,49.5
"12229","38380","2016",7,7,0,156277.1,1485.571,103.8571
"12230","38381","2016",16,16,0,217105,1883.188,118.0625
"12231","38382","2016",179,49,130,210531.4,2506.251,83.26257
"12232","38383","2016",28,25,3,224265.3,2156.536,105.6786
"12233","38384","2016",28,22,6,180224.3,1769.536,101.8214
"12234","38386","2016",20,17,3,174896.5,1638.45,104.6
"12235","38387","2016",4,3,1,148695,1359.75,110.5
"12236","38388","2016",20,17,3,234389.6,2376.35,99.55
"12237","38389","2016",26,19,7,198819.7,1924,101.2692
"12238","38390","2016",3,3,0,109000,1282,85.66667
"12239","38391","2016",2,2,0,92500,1100.5,85
"12240","38392","2016",4,4,0,181250,2696.75,72.5
"12241","38393","2016",14,14,0,215250.3,1913.214,112.2143
"12242","38394","2016",9,8,1,197247.8,1729.667,118.8889
"12243","38395","2016",24,22,2,203992.8,2427.958,91.29167
"12244","38396","2016",8,4,4,108575,1409.375,70.5
"12245","38397","2016",57,47,10,432095.9,3453.474,128.7368
"12246","38398","2016",6,6,0,174058.3,1601,107.6667
"12247","38399","2016",45,37,8,187644.1,1971.222,98.08889
"12248","38400","2016",23,14,9,220260.2,2396.391,90.08696
"12249","38401","2016",16,12,4,185498.1,1742.312,113.5625
"12250","38402","2016",4,4,0,200917.5,1527,130
"12251","38403","2016",3,3,0,141400,1779.333,86.33333
"12252","38405","2016",11,11,0,179518.8,2061.636,99.72727
"12253","38406","2016",1,1,0,224000,1493,150
"12254","38407","2016",4,4,0,175500,1761.5,87.25
"12255","38408","2016",28,28,0,253002,2424.071,106.6071
"12256","38409","2016",12,12,0,150445.8,1578.75,102.6667
"12257","38410","2016",6,6,0,191739.8,1430,128.6667
"12258","38412","2016",34,25,9,213425.8,2418.647,90.26471
"12259","38413","2016",5,5,0,158800,1803,109.6
"12260","38415","2016",5,5,0,236660,1983.4,117.4
"12261","38416","2016",107,35,72,131761.4,1728.047,77.1215
"12262","38417","2016",4,4,0,236675,2640.75,99.5
"12263","38418","2016",3,3,0,89166.67,1853.667,55
"12264","38419","2016",1,1,0,168000,675,249
"12265","38420","2016",2,2,0,90000,1058.5,85
"12266","38421","2016",433,43,390,137209.6,2138.09,65.29561
"12267","38422","2016",68,46,22,333211.6,2899.985,117.7206
"12268","38423","2016",59,12,47,168921.3,2129.136,77.32203
"12269","38424","2016",2,2,0,89250,923,96
"12270","38425","2016",62,51,11,163509.5,1763.048,94.41935
"12271","38426","2016",5,5,0,259150,1944,134.8
"12272","38427","2016",2,2,0,125150,1609,81.5
"12273","38429","2016",6,6,0,125430,2048.833,64.66667
"12274","38430","2016",1,1,0,263000,3169,83
"12275","38431","2016",28,20,8,364154.6,3215.321,113.4643
"12276","38432","2016",8,6,2,228648.8,1682.875,141
"12277","38433","2016",13,8,5,252960,2495.615,101.5385
"12278","38434","2016",11,10,1,160295.5,1647.545,98.36364
"12279","38436","2016",21,20,1,319801.3,3018.238,112.2857
"12280","38437","2016",4,4,0,164758.5,1611.25,102
"12281","38438","2016",2,2,0,179500,2058,112.5
"12282","38439","2016",24,23,1,198926,1983.417,100
"12283","38440","2016",6,6,0,194499.2,1708.833,119.6667
"12284","38442","2016",27,16,11,170666.3,2454.444,72.62963
"12285","38443","2016",4,4,0,119500,1693.25,88
"12286","38445","2016",8,7,1,215975,2505.75,82.75
"12287","38446","2016",8,8,0,141918.8,2444.75,68.5
"12288","38448","2016",13,11,2,209152.3,2119.692,101.8462
"12289","38449","2016",50,44,6,191159.4,2054.56,88.56
"12290","38450","2016",7,7,0,245254.3,2304.143,116.7143
"12291","38451","2016",27,25,2,233271.2,2255.852,104.6296
"12292","38452","2016",2,2,0,172000,1573.5,112
"12293","38453","2016",13,12,1,195173.2,1847.615,107.9231
"12294","38454","2016",6,6,0,188981.7,1524,129.8333
"12295","38455","2016",33,31,2,265147.7,2088.424,121.7273
"12296","38456","2016",4,4,0,171060,1690.75,111.75
"12297","38457","2016",27,22,5,156291.9,1811.259,96.22222
"12298","38458","2016",10,10,0,157340,1341.7,124.2
"12299","38459","2016",7,7,0,214625,1863.714,122.7143
"12300","38460","2016",4,4,0,146387.5,1363.5,114.5
"12301","38462","2016",5,5,0,128250,2294.2,60
"12302","38463","2016",16,16,0,199356.2,1827.062,110.4375
"12303","38464","2016",13,12,1,227380,1822.538,124.9231
"12304","38465","2016",15,14,1,176192.7,1549.267,112.1333
"12305","38466","2016",12,12,0,300013.3,2747.417,119.1667
"12306","38467","2016",9,9,0,210215.6,1797.889,117.6667
"12307","38468","2016",36,30,6,175875,1804.389,102.6944
"12308","38469","2016",1,1,0,175000,2188,80
"12309","38470","2016",7,7,0,165178.6,1547.571,113
"12310","38471","2016",18,15,3,317939.6,3210.611,109.6667
"12311","38472","2016",2,2,0,315425,2402.5,130.5
"12312","38473","2016",8,8,0,183883.8,1585,115.625
"12313","38474","2016",139,29,110,173728.9,2492.144,69.03597
"12314","38475","2016",17,16,1,268976.7,2475.059,111.9412
"12315","38476","2016",9,8,1,226411.1,1809.889,130.1111
"12316","38478","2016",15,14,1,132673.3,2206.933,65.93333
"12317","38479","2016",21,19,2,154266.4,1427.952,111.3333
"12318","38480","2016",21,12,9,196414.3,2309.762,86.71429
"12319","38481","2016",10,10,0,280809,2181,124.1
"12320","38483","2016",14,13,1,160576.8,1704.786,95.64286
"12321","38484","2016",17,16,1,259558.8,2805.176,93.35294
"12322","38485","2016",178,21,157,159474.5,2203.011,70.09551
"12323","38486","2016",82,35,47,307241,3073.817,96.32927
"12324","38487","2016",24,16,8,264822.7,2704.167,103.5417
"12325","38488","2016",8,8,0,221785.4,2269.375,102
"12326","38489","2016",2,2,0,87000,893,96
"12327","38490","2016",12,11,1,156717.9,1602.083,99.41667
"12328","38492","2016",4,4,0,233250,2031.25,114.25
"12329","38494","2016",9,8,1,222431.1,2077.667,109.3333
"12330","38495","2016",7,6,1,124958.6,1356.429,90.71429
"12331","38496","2016",6,6,0,186171.7,1731,108.6667
"12332","38498","2016",6,6,0,238803.8,2301.667,105.5
"12333","38499","2016",20,18,2,122844.8,1490.5,83.1
"12334","38500","2016",5,5,0,171140,1776.6,99.2
"12335","38501","2016",35,14,21,195448.9,2635.343,75.37143
"12336","38503","2016",2,2,0,173550,2272.5,86
"12337","38504","2016",18,18,0,262989.7,2731.111,99.77778
"12338","38505","2016",8,8,0,120521.2,1306.375,97.125
"12339","38507","2016",83,73,10,212804.3,2196.602,99.01205
"12340","38508","2016",6,6,0,198310,1726.833,118.8333
"12341","38509","2016",84,33,51,117266.7,1549.357,78.35714
"12342","38511","2016",24,15,9,215296.2,2456.833,85.70833
"12343","38512","2016",5,5,0,182576.4,1899.4,97.4
"12344","38514","2016",2,2,0,75000,1314,63
"12345","38515","2016",22,20,2,161182.7,2140.091,80.5
"12346","38516","2016",80,18,62,291045.3,3141.588,86.2375
"12347","38517","2016",75,44,31,166008.9,1893.16,91.33333
"12348","38518","2016",4,4,0,137200,1653.5,90.25
"12349","38519","2016",29,24,5,261040.9,2437.103,111.5517
"12350","38520","2016",9,9,0,174897.8,1476.667,117.2222
"12351","38523","2016",8,8,0,196356.2,1662.5,118.875
"12352","38524","2016",46,21,25,231932.5,2799.413,86.43478
"12353","38525","2016",4,4,0,183337.5,1424.5,129.75
"12354","38526","2016",4,4,0,155025,1442.25,102.5
"12355","38527","2016",2,2,0,322250,2478.5,131
"12356","38528","2016",7,7,0,381425.7,2813.429,134.7143
"12357","38529","2016",49,24,25,237780.1,2787.653,83.89796
"12358","38530","2016",43,24,19,179625,2275.233,81.72093
"12359","38531","2016",4,4,0,200609.5,1564.5,143.75
"12360","38532","2016",3,3,0,155458.3,1844,87.66667
"12361","38533","2016",4,4,0,227513.5,3961.25,98.75
"12362","38536","2016",11,11,0,215737.1,1798.091,122.3636
"12363","38537","2016",87,59,28,168443.7,2075.402,82.67816
"12364","38538","2016",65,36,29,242800.2,2775.385,88.38462
"12365","38539","2016",8,8,0,157395.6,1648.75,96.75
"12366","38540","2016",10,10,0,322288.2,2591.2,126
"12367","38542","2016",5,4,1,180704,1849.4,87.8
"12368","38543","2016",23,22,1,177468.5,1736.261,107.8696
"12369","38544","2016",326,87,239,158790,1927.653,81.5
"12370","38545","2016",81,34,47,226369,2770.185,84.19753
"12371","38546","2016",14,14,0,184647.1,1837.857,97
"12372","38547","2016",103,43,60,183643.5,2369.796,77.94175
"12373","38548","2016",193,25,168,125200.3,2536.368,49.17098
"12374","38550","2016",5,3,2,335514,4087.2,65
"12375","38553","2016",149,115,34,165613.4,1776.295,92.38926
"12376","38554","2016",21,20,1,241124.3,2181.381,111.0952
"12377","38555","2016",4,4,0,180087.5,1384.5,137
"12378","38556","2016",10,10,0,201183,1917.1,107.6
"12379","38557","2016",55,49,6,276536.8,2706.236,103.2909
"12380","38558","2016",14,11,3,259794.6,2446.143,109.8571
"12381","38559","2016",33,19,14,142141.2,1624.121,92.27273
"12382","38560","2016",9,9,0,133488.9,1470.556,90.22222
"12383","38561","2016",14,14,0,138103.4,1487.5,96
"12384","38562","2016",81,22,59,146811.9,2076.198,72.09877
"12385","38563","2016",266,52,214,162099.9,2030.383,79.69549
"12386","38565","2016",82,47,35,242488.6,2465.39,99.29268
"12387","38566","2016",9,9,0,260454.2,2701.111,105.6667
"12388","38567","2016",72,2,70,66511.54,1976.292,34.26389
"12389","39001","2016",5,5,0,175420,1913,95.6
"12390","39002","2016",1,1,0,55000,688,80
"12391","39003","2016",1,1,0,187150,1215,154
"12392","39006","2016",5,4,1,90000,1097.6,90.4
"12393","39007","2016",1,1,0,85500,1402,61
"12394","39008","2016",4,4,0,129187.5,1314.25,116.25
"12395","39009","2016",3,1,2,139500,1229.333,107.6667
"12396","39010","2016",1,1,0,49000,576,85
"12397","39011","2016",10,10,0,102650,1013,106.6
"12398","39013","2016",49,40,9,122227.1,1293.898,100.2245
"12399","39014","2016",2,2,0,185000,1156,155
"12400","39016","2016",10,9,1,97113,981.8,114.5
"12401","39017","2016",11,11,0,129672.5,1237.182,104.2727
"12402","39018","2016",2,2,0,95000,875.5,109
"12403","39019","2016",3,2,1,90000,953,100.6667
"12404","39020","2016",1,1,0,105000,2019,52
"12405","39021","2016",2,2,0,101000,744.5,123
"12406","39022","2016",10,9,1,121372,1311.4,95.3
"12407","39024","2016",2,2,0,98925,1156,109
"12408","39025","2016",4,4,0,88250,780.5,112
"12409","39026","2016",2,2,0,142000,1102,126.5
"12410","39028","2016",6,6,0,77166.67,631.1667,120
"12411","39029","2016",2,2,0,107500,1244,82.5
"12412","39030","2016",7,7,0,153857.1,1622.286,94
"12413","39032","2016",6,6,0,206166.7,1537.167,132.1667
"12414","39034","2016",2,2,0,126750,1205.5,104.5
"12415","39035","2016",1,1,0,164500,2193,75
"12416","39037","2016",4,4,0,95375,1312.5,78.25
"12417","39038","2016",4,4,0,73625,710.5,124.5
"12418","39039","2016",2,2,0,141000,1356,103.5
"12419","39040","2016",1,1,0,4e+05,6154,65
"12420","39041","2016",1,1,0,140000,1474,95
"12421","39042","2016",10,6,4,138420,1254.4,114.4
"12422","39043","2016",8,7,1,103629.6,1409.125,74.875
"12423","39046","2016",1,1,0,593000,2636,225
"12424","39047","2016",7,3,4,109108,1539.286,71
"12425","39049","2016",3,3,0,156500,1437,107.3333
"12426","39050","2016",2,2,0,155775,2074.5,93.5
"12427","39051","2016",2,2,0,154800,1435,114
"12428","39053","2016",1,1,0,82000,512,160
"12429","39054","2016",2,2,0,102500,1091.5,94
"12430","39056","2016",18,16,2,104387.8,1164.167,88.94444
"12431","39059","2016",18,7,11,194358.2,2408.944,77.83333
"12432","39060","2016",2,2,0,140000,1359,103
"12433","39063","2016",7,5,2,110006.4,1365,84.42857
"12434","39065","2016",2,2,0,121000,856,147.5
"12435","39066","2016",1,1,0,144000,1286,112
"12436","39068","2016",4,4,0,180105,2329.5,94.25
"12437","39070","2016",1,1,0,212200,1584,134
"12438","39072","2016",5,4,1,96064.4,1117.4,84.4
"12439","39073","2016",2,2,0,199350,947,209.5
"12440","39074","2016",1,1,0,80000,1311,61
"12441","39076","2016",1,1,0,141000,1270,111
"12442","39078","2016",8,8,0,162187.5,1425.75,113.375
"12443","39079","2016",2,2,0,173000,1166,152
"12444","39081","2016",2,2,0,60000,596,115
"12445","39083","2016",5,5,0,141644,1501,101
"12446","39085","2016",3,3,0,129000,1680,84.66667
"12447","39086","2016",3,3,0,92000,1026.333,92
"12448","39088","2016",6,6,0,130750,1188.167,105.6667
"12449","39090","2016",3,3,0,161900,1670.667,101.3333
"12450","39093","2016",1,1,0,162000,1157,140
"12451","39094","2016",2,2,0,277500,1587.5,168
"12452","39096","2016",6,6,0,114425,1247.167,94.66667
"12453","39097","2016",91,37,54,112943,1327.648,85.68132
"12454","39099","2016",2,2,0,108500,1117,94
"12455","39101","2016",14,13,1,139229.9,1349.429,101.7143
"12456","39102","2016",5,4,1,110540,934.6,107.6
"12457","39103","2016",2,2,0,136000,1895.5,71.5
"12458","39104","2016",4,4,0,78782.5,866.75,91.25
"12459","39105","2016",1,1,0,252900,1653,153
"12460","39106","2016",3,2,1,333333.3,4196.333,105.6667
"12461","39107","2016",2,2,0,107500,1442.5,81
"12462","39108","2016",1,1,0,52000,619,84
"12463","39109","2016",1,1,0,85556,679,126
"12464","39111","2016",3,3,0,116533.3,1057,107
"12465","39116","2016",1,1,0,140000,1386,101
"12466","39117","2016",2,1,1,70000,470,158
"12467","39118","2016",2,2,0,149700,1162,125
"12468","39119","2016",2,2,0,102500,1146,96.5
"12469","39120","2016",1,1,0,40000,392,102
"12470","39121","2016",7,7,0,184914.3,1239.857,174.8571
"12471","39122","2016",3,3,0,83290,991,84
"12472","39124","2016",6,6,0,99666.67,1224,85.66667
"12473","39126","2016",2,2,0,76500,675.5,107.5
"12474","39128","2016",17,16,1,104226.5,1192.235,91.82353
"12475","39129","2016",2,2,0,107015,1093,98.5
"12476","39130","2016",4,4,0,164890,1278,129.25
"12477","39131","2016",9,9,0,151805.6,1334.667,107.4444
"12478","39132","2016",1,1,0,84900,1544,55
"12479","39133","2016",2,2,0,116125,1301,101
"12480","39134","2016",3,3,0,96666.67,1277.667,82.66667
"12481","39137","2016",3,3,0,87000,1161.667,75.33333
"12482","39138","2016",3,3,0,122000,1260.667,100.6667
"12483","39141","2016",1,1,0,1e+05,690,145
"12484","39142","2016",2,2,0,46000,898.5,53
"12485","39145","2016",2,2,0,107500,972,112.5
"12486","39146","2016",7,6,1,153578.6,1515.714,102.7143
"12487","39147","2016",1,1,0,210000,1355,155
"12488","39149","2016",1,1,0,1e+05,735,136
"12489","39150","2016",14,13,1,117371.4,1312.071,91.85714
"12490","39151","2016",2,2,0,127000,1818.5,62.5
"12491","39153","2016",8,8,0,140762.5,1303.25,105.5
"12492","39154","2016",13,11,2,150084.6,1546.692,105.0769
"12493","39156","2016",4,4,0,108975,1274.75,85.5
"12494","39159","2016",3,3,0,121333.3,1220.333,99.33333
"12495","39160","2016",7,7,0,121315.7,1169.286,103.1429
"12496","39163","2016",2,2,0,133300,1132,102.5
"12497","39164","2016",10,9,1,91545.6,1224.8,85.3
"12498","39165","2016",1,1,0,110000,2292,48
"12499","39166","2016",2,2,0,137500,1309,105
"12500","39167","2016",4,4,0,94161.25,967,87.25
"12501","39168","2016",1,1,0,64000,1280,50
"12502","39169","2016",9,8,1,153505.6,1557.667,99.66667
"12503","39170","2016",8,8,0,152500,1284.875,119.75
"12504","39171","2016",11,11,0,165402.7,1624.909,111
"12505","39172","2016",2,2,0,130150,1134.5,110
"12506","39173","2016",15,12,3,88013.33,1092.067,83
"12507","39176","2016",6,6,0,162433.3,1302.833,123.1667
"12508","39177","2016",5,5,0,146152,1148.4,137.6
"12509","39179","2016",1,1,0,95000,1319,72
"12510","39180","2016",2,2,0,110000,1383,79.5
"12511","39182","2016",6,6,0,185661.7,1646.167,112.8333
"12512","39183","2016",7,7,0,108970,1122.857,96.71429
"12513","39184","2016",1,1,0,115000,1456,79
"12514","39185","2016",9,9,0,102966.7,1060.889,100.6667
"12515","39187","2016",1,1,0,1e+05,800,125
"12516","39188","2016",7,7,0,140785.7,1284.429,115.1429
"12517","39189","2016",42,39,3,122485.7,1258.738,99.33333
"12518","39190","2016",19,17,2,156179.5,1548.947,103.0526
"12519","39192","2016",1,1,0,166500,832,200
"12520","39193","2016",8,8,0,122546.9,1462.375,86.375
"12521","39194","2016",3,3,0,126666.7,1391.333,100.6667
"12522","39196","2016",1,1,0,107000,1070,100
"12523","39197","2016",1,1,0,140800,848,166
"12524","39198","2016",285,126,159,115268.9,1344.884,85.69474
"12525","39199","2016",10,10,0,146534,1745.7,86.2
"12526","39200","2016",1,1,0,204000,1872,109
"12527","39201","2016",6,4,2,96228.33,1286.667,73.5
"12528","39202","2016",2,2,0,231750,1435.5,183.5
"12529","39205","2016",3,3,0,148666.7,1614.333,94.66667
"12530","39206","2016",1,1,0,147000,1073,137
"12531","39208","2016",1,1,0,289850,1800,161
"12532","39209","2016",1,1,0,125000,1420,88
"12533","39210","2016",5,5,0,215540,1678,131.8
"12534","39211","2016",1,1,0,169000,1006,168
"12535","39214","2016",2,2,0,150000,1116.5,140.5
"12536","39216","2016",2,1,1,103000,1304,75.5
"12537","39217","2016",7,7,0,188750,1318.429,141.2857
"12538","39218","2016",3,3,0,105333.3,1112.333,93.33333
"12539","39219","2016",6,4,2,205466.7,1756.167,114.6667
"12540","39220","2016",3,2,1,152333.3,1430,107
"12541","39222","2016",1,1,0,222000,1306,170
"12542","39223","2016",1,1,0,109000,1079,101
"12543","39225","2016",2,2,0,132500,1522,87.5
"12544","39227","2016",3,3,0,220660,4393.333,100.3333
"12545","39228","2016",16,13,3,164909.4,1762.688,92.8125
"12546","39229","2016",2,2,0,99985,1245.5,78.5
"12547","39230","2016",1,1,0,175000,1136,154
"12548","39232","2016",3,3,0,90667.33,1537,51.66667
"12549","39233","2016",20,15,5,140645,1558,87.65
"12550","39235","2016",17,13,4,142918.8,1308.706,115.2353
"12551","39236","2016",1,1,0,142000,1560,91
"12552","39238","2016",3,3,0,142000,1272,110
"12553","39239","2016",1,1,0,185000,974,190
"12554","39241","2016",3,3,0,96566.67,1519.667,65
"12555","39244","2016",2,2,0,104750,1031.5,101.5
"12556","39245","2016",3,3,0,151733.3,1366.667,111.3333
"12557","39246","2016",3,3,0,160916.7,1080.333,148
"12558","39247","2016",1,1,0,143000,2072,69
"12559","39250","2016",2,2,0,125750,1614.5,79.5
"12560","39251","2016",3,3,0,146333.3,1125.667,128.3333
"12561","39252","2016",3,3,0,88266.67,998.3333,95.66667
"12562","39253","2016",2,2,0,87000,743,115
"12563","39255","2016",4,4,0,64575,883.75,82
"12564","39258","2016",4,4,0,206500,1881,124.5
"12565","39259","2016",1,1,0,145000,1480,98
"12566","39261","2016",2,2,0,42500,503.5,85
"12567","39262","2016",4,4,0,182357.5,1601.75,124.75
"12568","39263","2016",6,4,2,99241.67,1328.5,75.33333
"12569","39265","2016",2,2,0,172500,1904.5,90.5
"12570","39266","2016",7,7,0,111171.4,1076.571,101.5714
"12571","39269","2016",1,1,0,148000,1827,81
"12572","39270","2016",4,4,0,197262.5,1538.5,136.5
"12573","39273","2016",3,3,0,96666.67,930.3333,111
"12574","39274","2016",1,1,0,230000,4792,48
"12575","39275","2016",13,7,6,205130.5,2356.538,84.15385
"12576","39277","2016",1,1,0,170000,1000,170
"12577","39278","2016",1,1,0,275000,2115,130
"12578","39279","2016",6,6,0,182183.3,1520.667,123
"12579","39281","2016",1,0,1,256500,1699,151
"12580","39282","2016",1,1,0,198000,2912,68
"12581","39283","2016",4,4,0,180112.5,1852.75,102
"12582","39284","2016",1,1,0,88300,706,125
"12583","39285","2016",1,1,0,46000,676,68
"12584","39286","2016",12,8,4,110979.2,1186.333,95
"12585","39288","2016",4,4,0,84250,1167.5,81.25
"12586","39290","2016",2,2,0,86500,756,122.5
"12587","39291","2016",1,1,0,129070,729,177
"12588","39292","2016",2,2,0,162500,1559.5,105
"12589","39295","2016",3,3,0,148000,1016.667,144.3333
"12590","39297","2016",7,6,1,134457.1,1296.714,107.5714
"12591","39299","2016",6,6,0,120900,1069.167,113.5
"12592","39300","2016",217,64,153,120050.5,1483.719,83.76037
"12593","39302","2016",2,2,0,117950,854,133.5
"12594","39304","2016",1,1,0,158000,1215,130
"12595","39305","2016",7,7,0,178114.3,1366.857,128.1429
"12596","39306","2016",13,13,0,155977.7,1562.462,106.7692
"12597","39307","2016",8,6,2,192565.6,2056.625,91.875
"12598","39308","2016",2,2,0,118400,1130,105.5
"12599","39310","2016",8,8,0,127735,993.375,133.625
"12600","39312","2016",1,1,0,135000,600,225
"12601","39313","2016",6,6,0,143360,1596,106.5
"12602","39315","2016",2,2,0,169000,1748.5,96
"12603","39317","2016",3,3,0,209800,1502.667,131.6667
"12604","39318","2016",2,2,0,134000,1234.5,106
"12605","39319","2016",2,1,1,36500,436,85
"12606","39320","2016",4,4,0,109564.2,1370,82.25
"12607","39322","2016",1,1,0,120000,1538,78
"12608","39323","2016",2,2,0,91500,984.5,95
"12609","39325","2016",5,5,0,105180,1020,100.8
"12610","39327","2016",2,2,0,173525,2054,82
"12611","39328","2016",1,1,0,180000,1324,136
"12612","39330","2016",1,1,0,187000,1214,154
"12613","39331","2016",7,7,0,189178.6,1275.286,168.5714
"12614","39333","2016",14,11,3,118946.1,1195.214,110.4286
"12615","39334","2016",1,1,0,86000,662,130
"12616","39335","2016",3,3,0,86833.33,818.3333,101.6667
"12617","39336","2016",1,1,0,75000,789,95
"12618","39337","2016",1,1,0,89000,1271,70
"12619","39338","2016",5,5,0,120780,1284.2,103.2
"12620","39339","2016",6,6,0,130204.3,1332.333,99.5
"12621","39342","2016",2,2,0,144100,1308,115
"12622","39344","2016",8,8,0,143205,1737.25,83.875
"12623","39345","2016",2,2,0,234200,2034.5,117
"12624","39346","2016",1,1,0,1e+05,909,110
"12625","39348","2016",3,3,0,157150,1122.333,132.3333
"12626","39350","2016",3,3,0,83333.33,580,157.3333
"12627","39353","2016",2,2,0,95000,834,109.5
"12628","39354","2016",4,4,0,111750,1252.25,91.5
"12629","39356","2016",3,3,0,112666.7,1041.667,112.3333
"12630","39360","2016",4,4,0,115000,780,144
"12631","39361","2016",1,1,0,173000,1730,100
"12632","39362","2016",36,20,16,119455.6,1412.333,83.63889
"12633","39363","2016",1,1,0,43000,462,93
"12634","39364","2016",2,2,0,124385.5,1002,125
"12635","39365","2016",14,14,0,130647.9,1110.214,118.3571
"12636","39367","2016",16,13,3,212381.2,2110.375,101.3125
"12637","39368","2016",40,9,31,96482.38,1239.375,77.725
"12638","39370","2016",9,6,3,92605.56,1086.333,84.88889
"12639","39377","2016",4,4,0,54875,1003.25,64.75
"12640","39378","2016",6,6,0,121750,1133.667,107.6667
"12641","39379","2016",4,4,0,96625,1047.75,86.25
"12642","39381","2016",1,1,0,196600,1244,158
"12643","39385","2016",5,5,0,111594,1193,102.2
"12644","39386","2016",4,4,0,142800,1455,107
"12645","39388","2016",6,6,0,124533.3,1322.667,86.33333
"12646","39389","2016",9,9,0,222718.4,1693.778,137.3333
"12647","39390","2016",1,1,0,211000,1099,192
"12648","39391","2016",5,4,1,108000,941.6,113.4
"12649","39392","2016",1,0,1,70000,680,103
"12650","39393","2016",1,1,0,134800,970,139
"12651","39394","2016",1,1,0,155000,1520,102
"12652","39396","2016",12,9,3,102880.8,1108.5,91.5
"12653","39397","2016",22,20,2,99106.14,1052.5,94.90909
"12654","39398","2016",5,5,0,134240,1119.8,121.6
"12655","39399","2016",5,5,0,141600,988.4,139
"12656","39400","2016",1,1,0,60000,566,106
"12657","39401","2016",2,2,0,148500,1122.5,126
"12658","39402","2016",5,4,1,132780,1285.8,105
"12659","39403","2016",1,1,0,47000,691,68
"12660","39404","2016",4,3,1,105100,1181.25,91.25
"12661","39405","2016",7,7,0,156802.9,1476.429,107.4286
"12662","39406","2016",2,1,1,1e+05,564.5,175
"12663","39407","2016",3,2,1,106166.7,1007.667,117
"12664","39411","2016",24,15,9,118685,1374.125,89.20833
"12665","39412","2016",1,1,0,125134,1438,87
"12666","39413","2016",3,3,0,260000,2267,99.33333
"12667","39415","2016",10,10,0,122140,937,155.4
"12668","39418","2016",3,3,0,86000,1088.667,78.33333
"12669","39419","2016",2,2,0,93877.5,773,120
"12670","39420","2016",3,3,0,127187,650.6667,196
"12671","39421","2016",6,6,0,171733.3,1377.333,111.8333
"12672","39422","2016",5,5,0,112710,1153.4,93.2
"12673","39423","2016",1,1,0,50000,490,102
"12674","39424","2016",2,2,0,138000,1007,126.5
"12675","39426","2016",4,4,0,123637.5,1145.5,105
"12676","39428","2016",1,1,0,130000,861,151
"12677","39429","2016",5,5,0,106400,1106.8,98
"12678","39430","2016",1,1,0,138000,1725,80
"12679","39432","2016",1,1,0,122800,1015,121
"12680","39434","2016",31,28,3,110074.4,1143.677,94.64516
"12681","39435","2016",9,8,1,131931.1,2256.778,79.88889
"12682","39436","2016",2,2,0,121500,1221,99.5
"12683","39437","2016",3,3,0,141450,1375.333,107
"12684","39439","2016",4,4,0,172750,1653,116
"12685","39441","2016",24,4,20,148020.4,2520.458,57.29167
"12686","39443","2016",2,2,0,177300,1470,126
"12687","39445","2016",1,1,0,92500,791,117
"12688","39446","2016",1,1,0,110000,1196,92
"12689","39447","2016",2,2,0,138500,1135,120
"12690","39448","2016",5,5,0,136900,1182,114
"12691","39449","2016",2,2,0,166475,1418.5,116.5
"12692","39451","2016",6,6,0,133180.7,1696.333,86.33333
"12693","39452","2016",5,5,0,139780,1472,101
"12694","39453","2016",4,3,1,157006.2,1205,135
"12695","39456","2016",2,2,0,97000,1140.5,85.5
"12696","39458","2016",1,1,0,71666,543,132
"12697","39460","2016",1,1,0,234000,2571,91
"12698","39462","2016",7,7,0,126983.6,1343,98.28571
"12699","39463","2016",2,2,0,163000,1824,81.5
"12700","39464","2016",6,6,0,171166.7,1509,112.5
"12701","39466","2016",2,2,0,71250,1352.5,52.5
"12702","39467","2016",2,2,0,41000,776,54
"12703","39468","2016",2,2,0,195950,1406,143
"12704","39469","2016",1,1,0,197900,1337,148
"12705","39470","2016",85,8,77,134853.7,2625.588,52.24706
"12706","39471","2016",9,8,1,103323.2,897.5556,108.1111
"12707","39472","2016",3,3,0,86333.33,1094,82.66667
"12708","39473","2016",1,1,0,65000,650,100
"12709","39474","2016",2,2,0,68000,778.5,85
"12710","39475","2016",26,22,4,103380.8,1002.846,103.8462
"12711","39476","2016",11,11,0,146745.5,1469.636,101
"12712","39477","2016",3,3,0,71000,830.6667,84.66667
"12713","39478","2016",46,15,31,92622.48,985.4783,86.45652
"12714","39479","2016",2,2,0,130100,1219,107
"12715","39480","2016",4,4,0,133625,1256.25,103.75
"12716","39481","2016",7,7,0,133107.1,1484.143,91.85714
"12717","39485","2016",10,10,0,123585,1134.8,102.2
"12718","39486","2016",2,2,0,157650,890.5,168
"12719","39487","2016",25,21,4,163480.6,1865.12,90.56
"12720","39489","2016",1,1,0,350000,1934,181
"12721","39490","2016",2,2,0,111500,730.5,145.5
"12722","39491","2016",9,7,2,85277.78,1288,72
"12723","39492","2016",3,3,0,134966.7,1131,114
"12724","39493","2016",6,6,0,135550,1012.167,133.8333
"12725","39494","2016",1,1,0,174000,1160,150
"12726","39495","2016",2,2,0,116500,1362,92.5
"12727","39497","2016",1,1,0,123000,724,170
"12728","39498","2016",6,6,0,181025,1481,125.6667
"12729","39499","2016",2,2,0,52500,732,75.5
"12730","39500","2016",15,6,9,75966.67,916.9333,89.2
"12731","39501","2016",14,12,2,134857.1,1359.286,97.42857
"12732","39502","2016",3,3,0,125000,1383.667,92.33333
"12733","39503","2016",4,3,1,114500,800.25,131
"12734","39504","2016",1,1,0,132000,886,149
"12735","39508","2016",14,13,1,119985.7,1162.357,100.2857
"12736","39510","2016",8,7,1,189935,2230.875,95.875
"12737","39511","2016",1,1,0,82000,683,120
"12738","39512","2016",2,2,0,96500,965,91.5
"12739","39513","2016",5,5,0,157377.2,1380.8,113
"12740","39514","2016",2,2,0,111700,1162,90.5
"12741","39517","2016",2,2,0,141750,1541,93.5
"12742","39518","2016",3,3,0,124083.3,944.3333,134.3333
"12743","39519","2016",2,2,0,80625,931.5,87
"12744","39520","2016",5,5,0,128160,1425,95.6
"12745","39522","2016",4,4,0,97287.5,1087.75,92.25
"12746","39523","2016",2,2,0,132825,1517,99
"12747","39525","2016",6,6,0,100916.7,984.8333,105.1667
"12748","39526","2016",28,23,5,140708.9,1451.071,98.10714
"12749","39527","2016",1,1,0,190400,1587,120
"12750","39528","2016",4,4,0,113863.8,1150.25,128
"12751","39529","2016",1,1,0,110000,1222,90
"12752","39530","2016",8,7,1,98297.5,1648.875,64.875
"12753","39531","2016",2,2,0,111250,1112,104.5
"12754","39533","2016",4,4,0,112537.5,1236.5,91.5
"12755","39534","2016",3,3,0,142850,1941.667,74
"12756","39535","2016",6,6,0,111833.3,1251.5,86.83333
"12757","39538","2016",1,1,0,62500,1116,56
"12758","39539","2016",4,4,0,168650,1358.25,127.75
"12759","39540","2016",2,2,0,125000,1346.5,93
"12760","39543","2016",1,1,0,283500,1249,227
"12761","39546","2016",9,9,0,104000,1127.556,94.77778
"12762","39547","2016",10,10,0,93500,1109.5,83.7
"12763","39548","2016",1,1,0,155000,1476,105
"12764","39551","2016",3,3,0,100933.3,961,90.33333
"12765","39552","2016",4,3,1,103250,1079.25,94.75
"12766","39553","2016",3,3,0,145666.7,1317,119
"12767","39554","2016",3,3,0,117222.3,1104.333,105.6667
"12768","39557","2016",2,2,0,116500,645,172
"12769","39559","2016",4,4,0,102450,1100.25,100.25
"12770","39560","2016",7,6,1,107014.3,1082,97.28571
"12771","39561","2016",1,1,0,160000,2133,75
"12772","39567","2016",1,1,0,139650,1535,91
"12773","39569","2016",4,4,0,160550,1446.5,112
"12774","39570","2016",1,1,0,2e+05,1399,143
"12775","39572","2016",2,2,0,124000,1725.5,62
"12776","39573","2016",9,9,0,154222.2,1469.333,105.4444
"12777","39574","2016",3,3,0,184366.7,1157.333,164
"12778","39576","2016",5,5,0,76600,959.2,80.8
"12779","39577","2016",3,3,0,141655,1343,102.3333
"12780","39579","2016",7,7,0,148957.1,1412.286,110.7143
"12781","39581","2016",2,2,0,89000,1066.5,90
"12782","39582","2016",13,13,0,129346.2,1150.231,113.0769
"12783","39583","2016",1,1,0,70000,1061,66
"12784","39584","2016",1,1,0,1e+05,606,165
"12785","40001","2016",73,60,13,120895.8,1311.658,95.91781
"12786","40002","2016",19,19,0,146924.2,1381,108.4211
"12787","40003","2016",2,2,0,227700,2050.5,113
"12788","40005","2016",3,3,0,124666.7,1395.667,94.66667
"12789","40006","2016",4,4,0,106250,1454.5,80.25
"12790","40007","2016",2,2,0,130200,1035.5,118
"12791","40008","2016",1,1,0,120000,1290,93
"12792","40011","2016",2,2,0,127500,1099,146.5
"12793","40012","2016",5,5,0,162400,1255.6,140.2
"12794","40014","2016",4,4,0,117500,1450.25,81.25
"12795","40015","2016",4,4,0,121035,1256,92.5
"12796","40016","2016",4,4,0,140120,1360.75,103
"12797","40017","2016",2,2,0,142310,1239,119
"12798","40018","2016",1,1,0,225000,1324,170
"12799","40019","2016",16,13,3,141468.8,2136.375,70.1875
"12800","40020","2016",5,5,0,160562,1184.4,136.8
"12801","40021","2016",8,8,0,244709.2,2065.125,118.125
"12802","40022","2016",2,2,0,106500,1063,86.5
"12803","40023","2016",2,2,0,118500,992,110.5
"12804","40025","2016",6,6,0,170083.3,1595.833,106
"12805","40026","2016",9,9,0,184777.8,1608.222,117.7778
"12806","40027","2016",2,2,0,245000,1902,132.5
"12807","40028","2016",1,1,0,40000,625,64
"12808","40029","2016",5,5,0,137171.4,909.4,148.6
"12809","40031","2016",15,15,0,145280,1305.067,113.3333
"12810","40032","2016",2,2,0,126000,1667,75.5
"12811","40033","2016",3,3,0,103200,1020.333,99
"12812","40034","2016",3,3,0,127333.3,1125.333,100.6667
"12813","40035","2016",4,4,0,153000,1566.5,104.5
"12814","40036","2016",48,32,16,186693.6,2358.833,83.39583
"12815","40037","2016",3,3,0,132766.7,1191.333,108.6667
"12816","40038","2016",1,1,0,150000,1364,110
"12817","40039","2016",1,1,0,58000,674,86
"12818","40040","2016",2,2,0,124650,1089,118
"12819","40042","2016",2,2,0,241775,1697.5,144.5
"12820","40043","2016",24,20,4,104229.2,1697.25,64.41667
"12821","40044","2016",7,7,0,256278.6,2376.286,110.4286
"12822","40046","2016",372,216,156,201094,2686.102,78.42742
"12823","40049","2016",1,1,0,129000,1316,98
"12824","40051","2016",3,3,0,201333.3,1512.667,132.6667
"12825","40052","2016",1,1,0,62000,1107,56
"12826","40053","2016",5,5,0,98600,1140.2,92.2
"12827","40054","2016",1,1,0,220000,1833,120
"12828","40055","2016",19,18,1,174104.2,1577.737,118.9474
"12829","40056","2016",11,11,0,121942.7,1295.091,93.63636
"12830","40058","2016",2,2,0,177500,1660,96
"12831","40059","2016",1,1,0,174000,1706,102
"12832","40060","2016",2,2,0,140650,1278.5,110
"12833","40061","2016",8,8,0,161598.4,1514.625,111
"12834","40062","2016",4,4,0,80000,984.25,82.5
"12835","40063","2016",6,6,0,195166.7,1659.167,119
"12836","40064","2016",4,4,0,119181.2,1184.75,100.75
"12837","40065","2016",330,123,207,233817.8,3852.685,64.41515
"12838","40066","2016",8,8,0,174700,1613.5,113.125
"12839","40067","2016",8,8,0,143375,1414.125,107.125
"12840","40068","2016",6,6,0,166850,1302,139.6667
"12841","40069","2016",4,4,0,139875,1066.25,117
"12842","40070","2016",6,6,0,140050,1338.667,108
"12843","40071","2016",6,6,0,149133.3,1094.167,141
"12844","40072","2016",1,1,0,84000,2333,36
"12845","40073","2016",3,3,0,97643,1064,111.3333
"12846","40074","2016",5,5,0,152435.2,1474.6,103.4
"12847","40075","2016",17,16,1,156985.8,1498.471,112
"12848","40076","2016",6,6,0,147115,1293.167,110.6667
"12849","40077","2016",10,10,0,207740,1614.1,116.5
"12850","40078","2016",3,3,0,266606.7,1421.667,183
"12851","40080","2016",20,20,0,108600,1076.85,106.95
"12852","40081","2016",4,4,0,149687.5,1310.25,119.25
"12853","40082","2016",5,5,0,168300,1773,97
"12854","40083","2016",1,1,0,110500,1128,98
"12855","40084","2016",6,6,0,166083.3,1349.333,127.8333
"12856","40085","2016",7,7,0,184838.6,1455.714,122
"12857","40086","2016",2,2,0,145800,1250,117
"12858","40087","2016",2,2,0,100213.5,1380.5,70.5
"12859","40088","2016",356,140,216,120992.5,1777.365,70.44663
"12860","40089","2016",5,5,0,162128,1693.8,97.8
"12861","40090","2016",5,5,0,114800,1065.4,111.6
"12862","40091","2016",6,6,0,145833.3,1935.5,84.66667
"12863","40092","2016",2,2,0,118000,859,140.5
"12864","40093","2016",1,1,0,75000,938,80
"12865","40094","2016",3,3,0,110000,1371.333,76.33333
"12866","40095","2016",8,8,0,178668.4,1472.875,128.75
"12867","40096","2016",2,2,0,113000,1315.5,85
"12868","40097","2016",6,3,3,119814.7,2593.667,54.33333
"12869","40098","2016",1,1,0,213000,1183,180
"12870","40099","2016",1,1,0,220000,2157,102
"12871","40100","2016",4,4,0,231520,1737.5,128.75
"12872","40101","2016",1,1,0,230000,2054,112
"12873","40102","2016",14,14,0,103478.6,1256.929,82.71429
"12874","40103","2016",3,3,0,127333.3,1421,91.66667
"12875","40104","2016",13,12,1,182731.5,1607.846,114.6154
"12876","40105","2016",3,3,0,135333.3,1032.667,139.6667
"12877","40106","2016",2,2,0,212500,1978,102
"12878","40108","2016",11,11,0,217243.6,1963.909,114.5455
"12879","40109","2016",3,3,0,194888.3,1274.667,153
"12880","40110","2016",5,5,0,94100,1001,94.6
"12881","40111","2016",3,3,0,196300,1740,113.6667
"12882","40113","2016",5,5,0,148600,1521.6,101.6
"12883","40114","2016",8,8,0,216206.2,1469,151.375
"12884","40115","2016",5,5,0,256200.2,1841,137.4
"12885","40116","2016",1,1,0,120000,600,200
"12886","40117","2016",28,19,9,103969.1,1141.571,89.71429
"12887","40118","2016",8,8,0,146981.2,1465.5,114.75
"12888","40119","2016",37,33,4,139984.4,1298.432,112.5405
"12889","40120","2016",7,7,0,280642.9,3106.714,135.5714
"12890","40121","2016",5,5,0,133340,1024.8,128
"12891","40122","2016",11,11,0,158909.1,1580,104.5455
"12892","40123","2016",10,10,0,225595,1916.9,125.3
"12893","40125","2016",8,8,0,217375,1708.25,129.25
"12894","40126","2016",29,28,1,176125.7,1670.276,108.3793
"12895","40127","2016",4,4,0,84750,965.25,101.75
"12896","40128","2016",5,5,0,210696,2121.8,118.6
"12897","40129","2016",8,8,0,229866.2,2202.125,108
"12898","40131","2016",13,13,0,141653.8,1323.615,108.1538
"12899","40132","2016",12,12,0,144975,1332.833,113.25
"12900","40133","2016",89,64,25,273863.5,2927.528,95.22472
"12901","40134","2016",24,24,0,130034.6,1256.25,106.75
"12902","40135","2016",17,17,0,95984.12,1027.824,95
"12903","40136","2016",2,2,0,97950,1263.5,79.5
"12904","40137","2016",4,4,0,213275,1369.25,154.5
"12905","40138","2016",3,3,0,96883.33,821.6667,112
"12906","40139","2016",4,4,0,170625,1847.25,90.75
"12907","40140","2016",1,1,0,87000,1160,75
"12908","40141","2016",2,2,0,172700,1378,123.5
"12909","40142","2016",7,7,0,135342.9,1425.857,99.42857
"12910","40144","2016",4,4,0,113500,1216.75,91
"12911","40145","2016",5,5,0,162530,1301.6,133.8
"12912","40146","2016",1,1,0,185000,1581,117
"12913","40147","2016",2,2,0,90000,1006,94.5
"12914","40149","2016",3,3,0,90200,836.3333,103.6667
"12915","40150","2016",35,28,7,206211.4,2234.343,94.85714
"12916","40151","2016",7,7,0,138135.7,1226.429,114.5714
"12917","40152","2016",12,12,0,156481.2,1355.333,124.75
"12918","40153","2016",2,2,0,185000,1069,167
"12919","40154","2016",4,4,0,127000,2161.5,70.25
"12920","40155","2016",16,16,0,189109.6,1784.312,116.875
"12921","40156","2016",4,4,0,162000,1335.5,123.5
"12922","40157","2016",36,22,14,141742.2,2063.444,69.16667
"12923","40158","2016",2,2,0,105000,986.5,106.5
"12924","40159","2016",5,4,1,156000,1715.4,87.6
"12925","40160","2016",2,2,0,126341,1088.5,108
"12926","40162","2016",5,5,0,172400,1470.2,118.2
"12927","40163","2016",9,9,0,124444.4,1112.667,103.4444
"12928","40164","2016",5,5,0,97300,1102.4,87.8
"12929","40165","2016",5,5,0,140000,1463.8,108.4
"12930","40167","2016",3,3,0,175093.3,1250.667,139.6667
"12931","40168","2016",20,16,4,208384,2169.3,97.75
"12932","40169","2016",1,1,0,86000,1089,79
"12933","40170","2016",1,1,0,180000,1463,123
"12934","40171","2016",3,3,0,239666.7,2430,97.33333
"12935","40172","2016",1,1,0,81000,1209,67
"12936","40176","2016",1,1,0,126000,1703,74
"12937","40177","2016",5,5,0,129460,1143.8,128.4
"12938","40178","2016",3,3,0,189833.3,1875.667,98.66667
"12939","40179","2016",24,23,1,227346.9,1803.333,128.125
"12940","40180","2016",14,14,0,159728.7,1571.286,105.3571
"12941","40181","2016",25,23,2,244485.8,2902.28,85.6
"12942","40182","2016",10,10,0,204823,1748.5,124.4
"12943","40183","2016",4,4,0,148125,1410,112.75
"12944","40184","2016",154,85,69,160223.9,2503.812,74.43506
"12945","40185","2016",1,1,0,91000,820,111
"12946","40186","2016",6,6,0,119691.7,1055.833,115.5
"12947","40187","2016",99,53,46,174898.7,3089.758,57.51515
"12948","40188","2016",3,3,0,178152,1135.333,158
"12949","40190","2016",1,1,0,93500,813,115
"12950","40191","2016",8,8,0,121893.8,1392.125,87.25
"12951","40192","2016",416,253,163,130870.3,1670.065,81.52644
"12952","40193","2016",1,1,0,164000,1215,135
"12953","40194","2016",13,12,1,119430,1071.154,111.8462
"12954","40195","2016",5,5,0,161100,1463,113.6
"12955","40196","2016",6,6,0,165171.8,1648.333,101
"12956","40197","2016",44,41,3,117376.4,1356.818,90.84091
"12957","40198","2016",1,1,0,170000,977,174
"12958","40199","2016",1,1,0,52000,867,60
"12959","40200","2016",8,8,0,173487.5,1538,109.375
"12960","40201","2016",11,11,0,125468.2,1301.455,102
"12961","40202","2016",23,20,3,173906.3,1681.348,105.1739
"12962","40203","2016",3,3,0,141863.3,1568,84.66667
"12963","40204","2016",5,5,0,133860,1498.4,90.4
"12964","40205","2016",5,5,0,163280,1289.4,117.8
"12965","40206","2016",7,5,2,129000,1540,86.28571
"12966","40207","2016",10,9,1,173695.5,1804.5,97.5
"12967","40208","2016",2,2,0,122500.5,924.5,132.5
"12968","40209","2016",88,56,32,220100.9,2564.068,89.875
"12969","40210","2016",11,11,0,178330.9,2219.455,94.72727
"12970","40211","2016",6,6,0,352725,2033.5,148.6667
"12971","40212","2016",8,8,0,156062.5,1385.375,112.375
"12972","40213","2016",5,2,3,226300,1786.6,136.8
"12973","40214","2016",5,5,0,169776,1712.2,101.8
"12974","40215","2016",3,3,0,142751.7,1428.667,100.3333
"12975","40216","2016",1,1,0,121000,791,153
"12976","40217","2016",71,61,10,196657.5,2073.239,96.14085
"12977","40218","2016",2,2,0,68500,650,104
"12978","40221","2016",1,1,0,166000,1239,134
"12979","40222","2016",9,9,0,201873.3,1804.444,118.2222
"12980","40223","2016",2,2,0,102550,1323,86
"12981","40224","2016",40,32,8,143943.8,1495.2,99.325
"12982","40225","2016",2,2,0,90915,684,137
"12983","40226","2016",4,4,0,95062.5,1058.5,89.25
"12984","40227","2016",22,22,0,162556.8,1514.273,112.2727
"12985","40228","2016",10,10,0,148672.9,1364.7,112.4
"12986","40229","2016",28,28,0,174334.8,1656.393,106.9643
"12987","40230","2016",17,16,1,128086.8,1545,90.94118
"12988","40231","2016",13,13,0,177805.7,1613.462,114.4615
"12989","40232","2016",1,1,0,195000,1548,126
"12990","40233","2016",18,18,0,187297.8,1769.889,107.1111
"12991","40234","2016",8,8,0,159500,1477.375,116.875
"12992","40235","2016",7,7,0,112445.7,1198.429,107.2857
"12993","40236","2016",2,2,0,145500,1117,128
"12994","40237","2016",8,8,0,129800,1507.25,92.75
"12995","40238","2016",3,3,0,131250,1166,110
"12996","40239","2016",1,1,0,186000,1465,127
"12997","40240","2016",6,6,0,149958.3,1182,131.3333
"12998","40243","2016",26,24,2,131437.7,1458.346,100.7692
"12999","40244","2016",8,6,2,154000,1170.5,127.625
"13000","40245","2016",23,20,3,108204.3,1079.043,94.86957
"13001","40246","2016",6,6,0,137000,1367.5,103.3333
"13002","40247","2016",1,1,0,130000,798,163
"13003","40248","2016",16,16,0,272011.1,2370.062,120.75
"13004","40249","2016",5,5,0,126390.4,1209.4,104.8
"13005","40250","2016",4,4,0,123662.5,1248.25,100.75
"13006","40251","2016",4,4,0,264408.5,2678,105.75
"13007","40252","2016",12,12,0,170962.3,1577.083,108.5833
"13008","40253","2016",2,2,0,106500,1464.5,86
"13009","40254","2016",1,1,0,55000,640,86
"13010","40255","2016",3,3,0,184333.3,1747.667,112.3333
"13011","40256","2016",7,7,0,180328.6,1678,108.8571
"13012","40257","2016",15,15,0,201532,2065.533,104.4
"13013","40258","2016",4,4,0,134462.5,1252.5,107
"13014","40259","2016",4,4,0,138750,1150.5,128.75
"13015","40260","2016",4,4,0,187853,1546.75,133
"13016","40261","2016",41,41,0,212267.3,2238.659,100.439
"13017","40262","2016",5,5,0,182172,1827,98.6
"13018","40263","2016",7,7,0,139571.4,1449.714,95.14286
"13019","40264","2016",23,23,0,191935.7,1886.13,107.8261
"13020","40266","2016",28,20,8,188160.7,2262.179,88
"13021","40267","2016",11,9,2,99358.18,1200.364,82.27273
"13022","40268","2016",10,10,0,170300,1824.4,95.6
"13023","40269","2016",5,5,0,157560,1552,107
"13024","40270","2016",7,7,0,116779.9,1225.143,96.28571
"13025","40271","2016",21,20,1,212024.8,1940.905,116.9524
"13026","40272","2016",24,15,9,197541.8,2144.333,93.91667
"13027","40273","2016",60,32,28,221652.2,2538.283,90.98333
"13028","40274","2016",9,9,0,164127.8,1311,115.5556
"13029","40275","2016",8,8,0,108910,1295.875,84.875
"13030","40276","2016",6,6,0,181523.3,2342.667,84
"13031","40277","2016",4,3,1,186250,1943.75,101
"13032","40278","2016",13,13,0,170300,1844.154,99
"13033","40279","2016",205,119,86,145596.2,1878.459,78.41951
"13034","40280","2016",24,20,4,150342.1,1595.875,95.875
"13035","40281","2016",128,84,44,137409.5,1739.406,79.1875
"13036","40282","2016",54,47,7,143091.4,1471.759,103.3333
"13037","40283","2016",27,25,2,189070.1,1794.185,108.8519
"13038","40284","2016",126,70,56,163527.4,2126.135,78.98413
"13039","40285","2016",4,4,0,158450,1300.25,119.5
"13040","40286","2016",8,8,0,156768.8,1171.875,150.25
"13041","40287","2016",52,42,10,228322.7,2598.327,90.23077
"13042","40288","2016",9,9,0,147552.2,1465.667,106.4444
"13043","40289","2016",1,1,0,121500,1599,76
"13044","40291","2016",20,20,0,311417.5,2306.75,130.65
"13045","40292","2016",14,14,0,310213.6,2089.357,146.6429
"13046","40293","2016",10,10,0,237794.8,2198.7,109.9
"13047","40294","2016",10,10,0,181478,1690,116
"13048","40295","2016",9,9,0,161888.9,1935.222,97
"13049","40296","2016",208,88,120,235653.1,3434.5,67.64904
"13050","40297","2016",3,3,0,152666.7,1644.333,92.66667
"13051","40298","2016",3,3,0,99666.67,1577.333,64
"13052","40299","2016",1,1,0,154000,1413,109
"13053","40300","2016",12,12,0,175146.7,1792.167,97.83333
"13054","40301","2016",2,2,0,148000,1274,109
"13055","40303","2016",5,5,0,113746,1243.2,101.2
"13056","40304","2016",154,76,78,391448.7,4651.662,85.99351
"13057","40306","2016",5,4,1,158500,1186,135.4
"13058","40307","2016",23,22,1,126733.8,1153.435,112.2174
"13059","40308","2016",9,9,0,190519.1,1651.667,126.3333
"13060","40309","2016",7,7,0,145500.6,1435.143,103.4286
"13061","40310","2016",163,114,49,198007.1,2509.049,83.57669
"13062","40311","2016",7,6,1,190321.4,1550.857,126.1429
"13063","40312","2016",151,85,66,214132.1,2676.073,81
"13064","40313","2016",33,31,2,128588,1352.455,104.0909
"13065","40314","2016",16,16,0,221645,2175.062,108.5
"13066","40315","2016",6,6,0,164266.7,1450.167,110
"13067","40316","2016",7,7,0,113085.7,1093,102.5714
"13068","40317","2016",36,31,5,255307.2,2580.222,100.6944
"13069","40318","2016",3,3,0,110000,757,156.3333
"13070","40319","2016",4,4,0,154250,1365.5,110.75
"13071","40320","2016",3,3,0,169666.7,2078,120.6667
"13072","40321","2016",1,1,0,116010,1507,77
"13073","40323","2016",4,4,0,99500,1314.25,88.25
"13074","40324","2016",3,3,0,150833.3,1209.667,118.6667
"13075","40325","2016",2,2,0,144155,1345.5,109
"13076","40326","2016",25,18,7,162288,2231.28,80.92
"13077","40327","2016",1,1,0,86000,1000,86
"13078","40328","2016",98,34,64,168371.7,3110.929,58.93878
"13079","40329","2016",2,2,0,201750,1932,110
"13080","40330","2016",4,4,0,154250,1397,109.5
"13081","40331","2016",27,27,0,133970.4,1286.407,109.5556
"13082","40332","2016",37,37,0,186871.2,1905.027,101.8378
"13083","40333","2016",18,18,0,174339.2,1437.611,126.8889
"13084","40334","2016",3,3,0,190166.7,1643.667,148.3333
"13085","41001","2016",2,2,0,127500,1160,122.5
"13086","41002","2016",8,8,0,103600,970.375,102.75
"13087","41003","2016",1,1,0,55000,625,88
"13088","41004","2016",2,2,0,77500,809,97.5
"13089","41006","2016",6,6,0,124166.7,1320.5,94.33333
"13090","41007","2016",12,12,0,111958.3,1275.917,86.5
"13091","41008","2016",11,10,1,133178.2,1233.636,115.4545
"13092","41009","2016",6,6,0,165183.3,1393,116.6667
"13093","41010","2016",12,12,0,139150,1381,104.25
"13094","41012","2016",1,1,0,110000,1222,90
"13095","41013","2016",1,1,0,145900,1569,93
"13096","41014","2016",3,3,0,55733.33,857.3333,61.66667
"13097","41016","2016",19,19,0,92410.53,991.3158,93.47368
"13098","41017","2016",9,9,0,117500,1152.444,108.2222
"13099","41018","2016",543,222,321,120169.1,1613.7,75.29834
"13100","41019","2016",2,2,0,55500,672.5,88
"13101","41020","2016",4,4,0,63750,1073.75,59.75
"13102","41022","2016",2,2,0,360000,2613,114.5
"13103","41024","2016",6,6,0,97483.33,1149.5,91.66667
"13104","41025","2016",18,18,0,143486.1,1512.889,94.44444
"13105","41026","2016",4,4,0,36000,634.25,56.75
"13106","41027","2016",3,3,0,148370,1208.667,127
"13107","41028","2016",1,1,0,70000,551,127
"13108","41029","2016",18,18,0,141377.8,1383.111,105.1667
"13109","41030","2016",2,1,1,73500,803.5,76.5
"13110","41031","2016",19,19,0,180088.4,1581.105,120.1579
"13111","41032","2016",25,25,0,159061.4,1437.12,108.08
"13112","41035","2016",6,6,0,158308.3,1437.667,112.8333
"13113","41036","2016",7,7,0,125385.7,1277,107.8571
"13114","41038","2016",3,3,0,109246.7,1184.667,102
"13115","41039","2016",7,7,0,116285.7,1233.429,103
"13116","41040","2016",5,5,0,123098,1319.2,102.8
"13117","41041","2016",1,1,0,87000,935,93
"13118","41042","2016",4,4,0,87650,953,86.25
"13119","41043","2016",18,18,0,118383.3,1237.5,96.38889
"13120","41044","2016",15,15,0,71971.47,976.1333,76.86667
"13121","41045","2016",9,9,0,166127.8,1523.222,120.7778
"13122","41046","2016",18,18,0,222118.3,2397.389,91.94444
"13123","41047","2016",68,36,32,136278,1533.691,89.33824
"13124","41048","2016",5,5,0,98650,992.6,107.2
"13125","41049","2016",5,5,0,152380,1302,119.6
"13126","41050","2016",12,12,0,289789.6,2246.333,153.5833
"13127","41051","2016",12,12,0,93600,1214.083,84.91667
"13128","41052","2016",14,14,0,181764.1,1725.929,105.5
"13129","41053","2016",6,6,0,94833.33,962.3333,96.66667
"13130","41054","2016",1,1,0,70000,1000,70
"13131","41055","2016",22,21,1,154930.7,1407.136,111.3636
"13132","41057","2016",2,2,0,124000,1211,100.5
"13133","41059","2016",52,51,1,127054.4,1334.327,95.28846
"13134","41060","2016",7,7,0,71885.71,797.5714,84.85714
"13135","41061","2016",4,4,0,113375,1391.5,79.25
"13136","41062","2016",4,4,0,104450,1218.25,86.25
"13137","41063","2016",8,8,0,101562.5,1204.5,86.25
"13138","41065","2016",3,3,0,96666.67,1286.333,73.66667
"13139","41066","2016",10,10,0,96300,1199,80
"13140","41067","2016",30,28,2,169575.7,1827.567,100.7333
"13141","41068","2016",3,3,0,103500,1076.333,95.66667
"13142","41069","2016",5,5,0,150320,1314.6,114.4
"13143","41070","2016",9,9,0,104555.6,1380.667,78.22222
"13144","41071","2016",6,6,0,106116.7,1542.333,69.66667
"13145","41072","2016",1,1,0,90000,1034,87
"13146","41073","2016",10,10,0,84613.3,904.6,93.4
"13147","41074","2016",14,14,0,100357.1,1038.571,91.71429
"13148","41075","2016",12,12,0,70715.58,967.6667,85.08333
"13149","41077","2016",1,1,0,80000,889,90
"13150","41078","2016",7,7,0,126450,1246.571,104.2857
"13151","41079","2016",1,1,0,65000,385,169
"13152","41080","2016",16,16,0,105300,1157.75,91.6875
"13153","41081","2016",4,4,0,159200,993.25,133.75
"13154","41083","2016",6,5,1,77950,1036.833,72
"13155","41084","2016",13,13,0,104676.9,1223.308,84.76923
"13156","41085","2016",17,17,0,176987.7,1530.706,129.5882
"13157","41086","2016",6,6,0,125136.7,1400,87.16667
"13158","41087","2016",7,7,0,123285.7,1691,77.85714
"13159","41088","2016",3,3,0,102333.3,998.6667,121.3333
"13160","41089","2016",5,5,0,89200,991.4,93.4
"13161","41090","2016",3,3,0,131409.7,1503,90.66667
"13162","41091","2016",8,8,0,186058.8,1812.625,105.875
"13163","41093","2016",3,3,0,72000,933.3333,71.33333
"13164","41094","2016",6,6,0,133136.8,1171.833,109.3333
"13165","41095","2016",18,17,1,105205.6,1168.611,91.83333
"13166","41096","2016",6,6,0,76666.67,1016.167,83.66667
"13167","41097","2016",20,20,0,110487.2,1132.5,95.4
"13168","41098","2016",1,1,0,145000,1208,120
"13169","41099","2016",3,3,0,150279.3,1386,113
"13170","41100","2016",1,1,0,102000,1417,72
"13171","41101","2016",9,7,2,123333.3,1344.778,93
"13172","41102","2016",6,6,0,139500,1246.833,104.5
"13173","41103","2016",3,3,0,149333.3,1297.667,119
"13174","41104","2016",39,38,1,154337.5,1550.487,99.30769
"13175","41105","2016",11,11,0,125118.2,1231.909,104.8182
"13176","41106","2016",33,33,0,128418.2,1488.303,88.18182
"13177","41107","2016",2,2,0,191500,1384,138
"13178","41108","2016",3,3,0,134333.3,1193.333,111.6667
"13179","41109","2016",5,5,0,121600,1339.8,102.6
"13180","41110","2016",8,8,0,90500,911.625,105.875
"13181","41112","2016",1,1,0,125000,1488,84
"13182","41113","2016",3,3,0,82743.33,872,92
"13183","41114","2016",4,4,0,190125,1688.5,111.5
"13184","41115","2016",7,7,0,96857.14,1015.429,92.14286
"13185","41116","2016",2,2,0,105000,1087.5,97.5
"13186","41118","2016",4,4,0,142750,2402,59.25
"13187","41119","2016",5,5,0,92600,1506.8,68.6
"13188","41120","2016",18,18,0,121511.1,1330.611,90.72222
"13189","41122","2016",3,3,0,98333.33,880.3333,102.6667
"13190","41123","2016",11,11,0,108409.1,1050,103.0909
"13191","41124","2016",4,4,0,124500,1275.5,99
"13192","41125","2016",10,10,0,124890,1228.1,105.3
"13193","41126","2016",13,13,0,118453.8,986.6923,112.6154
"13194","41127","2016",7,7,0,173071.4,1761.857,90.85714
"13195","41128","2016",3,3,0,118000,1378.333,83
"13196","41129","2016",6,6,0,113916.7,1034,116.6667
"13197","41130","2016",11,11,0,137762.5,1399.909,108.0909
"13198","41131","2016",11,11,0,150640.9,1222.636,111.9091
"13199","41132","2016",5,5,0,101820,1159.8,91.6
"13200","41134","2016",7,6,1,140500,1654.429,90
"13201","41135","2016",16,16,0,129500,1083.938,93.375
"13202","41136","2016",61,59,2,128268,1476.033,91.98361
"13203","41137","2016",6,6,0,155416.7,1412.833,119.3333
"13204","41138","2016",3,3,0,105500,1139.333,94.66667
"13205","41139","2016",14,14,0,85200,1238.571,70.35714
"13206","41140","2016",6,6,0,153708.3,1373.833,110.5
"13207","41141","2016",10,10,0,84709,960.8,89.5
"13208","41142","2016",21,21,0,153890.5,1448.905,104.4286
"13209","41143","2016",9,8,1,64166.67,760.4444,87
"13210","41144","2016",12,12,0,138190.8,1530.583,89
"13211","41145","2016",7,7,0,124225.7,1373.857,95.57143
"13212","41146","2016",17,17,0,93588.24,1104.235,86.05882
"13213","41147","2016",20,20,0,150539.6,1531.25,103.05
"13214","41148","2016",14,14,0,138550,1539.857,93.85714
"13215","41149","2016",34,33,1,102937.1,1436.353,77.67647
"13216","41150","2016",40,39,1,154107,1504.525,105.7
"13217","41151","2016",50,46,4,117808.2,1279.92,94.76
"13218","41152","2016",11,11,0,189207.9,1434.818,125
"13219","41153","2016",6,6,0,83666.67,1344.5,69.5
"13220","41154","2016",13,13,0,100461.5,1136.769,86
"13221","41155","2016",21,21,0,126011.9,1535.095,84.90476
"13222","41156","2016",4,4,0,117632.5,1570,114.5
"13223","41157","2016",17,17,0,142112.9,1578.529,87.94118
"13224","41158","2016",24,24,0,174725,1534.042,114.625
"13225","41159","2016",11,11,0,181852.7,1583,126
"13226","41160","2016",9,9,0,195287.7,1539.889,122.1111
"13227","41161","2016",33,33,0,130927.3,1348.818,96.9697
"13228","41163","2016",3,3,0,114666.7,845.6667,127.6667
"13229","41164","2016",31,31,0,96854.84,1067.613,96.19355
"13230","41166","2016",2,2,0,131820,1333.5,89
"13231","41167","2016",44,44,0,120451.3,1602.386,85.45455
"13232","41168","2016",3,3,0,95000,1121.333,80.66667
"13233","41171","2016",16,16,0,107559.7,1062,103.5
"13234","41172","2016",3,3,0,105536.7,1281.333,101.3333
"13235","41173","2016",28,27,1,114078.2,1119.321,102.5
"13236","41175","2016",13,13,0,99184.62,1133.385,92.76923
"13237","41176","2016",12,12,0,118480,1259.75,91.83333
"13238","41177","2016",6,6,0,95083.33,914.8333,110
"13239","41179","2016",4,4,0,124332.5,1334.25,97
"13240","41180","2016",15,15,0,150256,1241.533,125.2
"13241","41181","2016",10,10,0,177920,1205.5,127.1
"13242","41182","2016",1,1,0,233000,1294,180
"13243","41184","2016",8,8,0,95250,946.25,100.875
"13244","41185","2016",20,19,1,134611,1233.9,109.1
"13245","41186","2016",1,1,0,220000,2000,110
"13246","41187","2016",4,4,0,130225,1208,107
"13247","41188","2016",2,2,0,60500,805,76.5
"13248","41189","2016",5,5,0,116988,1305.8,90.6
"13249","41191","2016",1,1,0,328250,2431,135
"13250","41192","2016",5,5,0,79868,1092.6,78.2
"13251","41193","2016",2,2,0,54000,843,65
"13252","41194","2016",177,162,15,100180.7,1172.13,86.57627
"13253","41195","2016",1,1,0,153900,3420,45
"13254","41196","2016",4,4,0,62875,759,84.25
"13255","41198","2016",38,38,0,97755.26,1043.526,97.31579
"13256","41199","2016",12,12,0,127395.8,1143.833,115.4167
"13257","41200","2016",4,4,0,194635,1936.25,106.5
"13258","41201","2016",4,4,0,73375,862.75,76.5
"13259","41203","2016",3,3,0,144066.7,1407,118
"13260","41204","2016",13,13,0,144461.5,1455.846,104.2308
"13261","41205","2016",5,5,0,111200,1209.2,87.4
"13262","41206","2016",2,2,0,103750,935.5,119.5
"13263","41207","2016",9,9,0,203405.6,1885.111,112
"13264","41208","2016",1,1,0,190000,1570,121
"13265","41209","2016",15,15,0,140533.3,1459.133,99.93333
"13266","41211","2016",39,39,0,149054.9,1536.949,95.71795
"13267","41212","2016",22,21,1,168042,1633.136,104.7727
"13268","41213","2016",1,1,0,60000,968,62
"13269","41214","2016",5,5,0,100300,1085.4,87.2
"13270","41215","2016",2,2,0,38750,606.5,63.5
"13271","41216","2016",7,7,0,89728.57,1101.571,84.85714
"13272","41217","2016",11,11,0,124527.3,1241.909,98.72727
"13273","41218","2016",7,7,0,144678.6,1479.429,97.42857
"13274","41219","2016",2,2,0,114500,950.5,120.5
"13275","41220","2016",40,40,0,119815,1416.8,90.5
"13276","41221","2016",8,8,0,91775,935.875,107.625
"13277","41222","2016",1,1,0,78000,1068,73
"13278","41223","2016",7,7,0,211855,1498.286,136.1429
"13279","41224","2016",1,1,0,70000,814,86
"13280","41225","2016",3,3,0,110000,934.6667,110.6667
"13281","41226","2016",35,35,0,137922.9,1506.429,92.88571
"13282","41228","2016",4,4,0,59775,704,77.25
"13283","41229","2016",9,9,0,116644.4,1362.556,86.55556
"13284","41230","2016",8,8,0,140316.2,1653.125,87.625
"13285","41231","2016",18,18,0,246859.4,1763.5,122.6667
"13286","41232","2016",44,42,2,139437.2,1280.5,95.95455
"13287","41233","2016",8,8,0,155508.8,1323.875,122.875
"13288","41234","2016",4,4,0,109125,1172.75,98.5
"13289","41235","2016",8,8,0,116518.8,1071.25,105
"13290","41236","2016",3,3,0,118000,1057,113.6667
"13291","41237","2016",8,8,0,126175,1243.625,105.875
"13292","41238","2016",24,21,3,93064.83,1174.708,91
"13293","41239","2016",16,16,0,127996.2,1506.312,86.625
"13294","41241","2016",10,10,0,106695,1088.9,92.4
"13295","41242","2016",41,41,0,82715.41,1027.854,81.80488
"13296","41243","2016",7,7,0,121357.1,1010.857,123
"13297","41245","2016",6,6,0,99500,1019.5,99.83333
"13298","41246","2016",2,2,0,125350,1582.5,79
"13299","41247","2016",10,10,0,119647,1326.9,95.2
"13300","41248","2016",14,14,0,90746.43,1119.929,90.78571
"13301","41249","2016",11,11,0,74589.09,911.3636,85.72727
"13302","41250","2016",5,5,0,104200,1139.6,85.6
"13303","41251","2016",12,12,0,216295.8,1682.75,127.0833
"13304","41252","2016",26,26,0,132196.2,1401.885,97.5
"13305","41253","2016",3,3,0,142166.7,1483.333,107.3333
"13306","41254","2016",1,1,0,170000,1667,102
"13307","41255","2016",7,7,0,87857.14,792.4286,103.1429
"13308","41256","2016",18,18,0,135898.9,1136.444,116
"13309","41258","2016",18,18,0,133038.9,1958,89.05556
"13310","41259","2016",8,8,0,116937.5,1334.625,84.375
"13311","41260","2016",8,8,0,131206.2,1512.125,87.5
"13312","41261","2016",1,1,0,83000,755,110
"13313","41262","2016",9,9,0,129191.7,1383.222,103.1111
"13314","41265","2016",5,5,0,144400,1077,150
"13315","41267","2016",4,4,0,154617.5,1164,134.25
"13316","41269","2016",148,98,50,135273.7,1671.777,84.34459
"13317","41271","2016",6,6,0,82914.17,1055.167,86.83333
"13318","41273","2016",2,2,0,53500,991.5,53.5
"13319","41274","2016",1,1,0,105000,913,115
"13320","41275","2016",6,6,0,130250,1032,130.6667
"13321","41276","2016",17,15,2,169788.2,1550.176,110.8824
"13322","41277","2016",2,2,0,98750,698,131.5
"13323","41278","2016",3,3,0,121510,1031,120.6667
"13324","41279","2016",6,6,0,71775,815,88.5
"13325","41280","2016",33,33,0,98015.27,1011.97,98.06061
"13326","41281","2016",1,1,0,152450,1675,91
"13327","41282","2016",7,7,0,90642.86,827.7143,95.57143
"13328","41283","2016",2,2,0,194500,1381.5,155.5
"13329","41284","2016",2,2,0,87500,1213,82.5
"13330","41285","2016",6,6,0,125083.3,1149,112
"13331","41287","2016",3,3,0,175500,1604.333,108.3333
"13332","41288","2016",11,11,0,146890.9,1527,102.5455
"13333","41289","2016",3,3,0,94500,870,98.33333
"13334","41291","2016",1,1,0,370000,1423,260
"13335","41292","2016",2,2,0,113000,1056.5,103
"13336","41293","2016",2,2,0,182950,1185.5,169
"13337","41294","2016",4,4,0,150750,1650.5,103.75
"13338","41295","2016",60,59,1,195428,1788.4,111.9833
"13339","41296","2016",17,17,0,215854.8,1608.412,124.0588
"13340","41297","2016",4,4,0,145525,1577.25,73.5
"13341","42001","2016",5,5,0,130440,1145,104.4
"13342","42003","2016",17,16,1,140132.9,1243.412,110.4118
"13343","42005","2016",101,57,44,163066.8,1732.98,94.36634
"13344","42006","2016",6,6,0,121455,1213.667,98.66667
"13345","42007","2016",2,2,0,121000,1275,101
"13346","42008","2016",1,1,0,140000,1077,130
"13347","42009","2016",2,2,0,91500,850,97.5
"13348","42010","2016",16,16,0,202759.8,1946.5,104.8125
"13349","42011","2016",32,30,2,146895.4,1636.344,98.6875
"13350","42012","2016",6,6,0,166736.5,1777,95.5
"13351","42013","2016",20,18,2,156220.2,1617.85,98.9
"13352","42014","2016",4,4,0,109552.5,1153.25,103.75
"13353","42015","2016",12,12,0,108687.5,998.9167,110.4167
"13354","42016","2016",8,8,0,135012.5,1208.125,115.375
"13355","42017","2016",6,6,0,152916.7,1534.333,107.1667
"13356","42018","2016",4,4,0,174100,1717.25,101.5
"13357","42019","2016",36,26,10,92811.94,995.3611,90.36111
"13358","42020","2016",14,14,0,183334.3,1860.571,103.2143
"13359","42021","2016",16,16,0,149292.5,1406.125,104.375
"13360","42022","2016",34,32,2,172286.9,1909.029,89.47059
"13361","42023","2016",20,14,6,111747.8,1554.15,75.35
"13362","42026","2016",17,17,0,131409.4,1364.588,101.4706
"13363","42027","2016",6,6,0,129175,1435.333,91.83333
"13364","42028","2016",3,2,1,124900,1650.333,76.66667
"13365","42029","2016",21,21,0,124731,1189.619,106.7619
"13366","42030","2016",6,6,0,97008.33,1177.5,89.83333
"13367","42031","2016",4,4,0,348537.5,2294.25,150.25
"13368","42032","2016",6,6,0,253003.3,2000.667,132.5
"13369","42033","2016",6,6,0,95916.67,942,103.1667
"13370","42034","2016",1,1,0,80000,1270,63
"13371","42036","2016",1,1,0,145000,1611,90
"13372","42037","2016",4,4,0,182875,1449.75,123.25
"13373","42038","2016",4,4,0,123500,1245.5,95.75
"13374","42039","2016",5,5,0,85190,859.2,101.8
"13375","42041","2016",3,3,0,150000,1359.667,113
"13376","42042","2016",4,4,0,167500,1617.25,118.5
"13377","42043","2016",12,11,1,256200,2090.667,121.25
"13378","42044","2016",87,60,27,128541.8,1408.805,91.3908
"13379","42046","2016",21,20,1,156306.3,1664.619,94.38095
"13380","42047","2016",2,2,0,61500,755,80
"13381","42048","2016",14,13,1,154550,1343.714,113.9286
"13382","42049","2016",8,8,0,113893.8,1319.25,91
"13383","42051","2016",2,2,0,300325,2315,129.5
"13384","42052","2016",27,12,15,100898.1,1051.148,99.11111
"13385","42053","2016",8,8,0,233468.8,2336,101.75
"13386","42054","2016",3,3,0,110300,1092,111
"13387","42055","2016",1,1,0,64000,831,77
"13388","42056","2016",17,16,1,184958.8,1885.941,97.35294
"13389","42058","2016",3,3,0,94000,1454,63
"13390","42059","2016",50,36,14,152409,1622.36,101.38
"13391","42060","2016",4,4,0,162982.5,1345.75,120.5
"13392","42061","2016",4,4,0,103750,818.5,122
"13393","42062","2016",1,1,0,240000,1791,134
"13394","42063","2016",5,5,0,121366,914.2,132
"13395","42064","2016",7,6,1,220071.4,1802.857,125.1429
"13396","42065","2016",6,6,0,187533.3,1869.667,102.3333
"13397","42066","2016",5,5,0,196600,1627.8,125.4
"13398","42067","2016",2,2,0,131810,1636.5,83
"13399","42068","2016",3,3,0,116666.7,1042,118.3333
"13400","42069","2016",21,21,0,158211.5,1392.667,113.2857
"13401","42070","2016",9,9,0,114500,1127.889,102.8889
"13402","42071","2016",73,26,47,105390.1,1151.37,89.68493
"13403","42072","2016",1,1,0,40000,597,67
"13404","42073","2016",7,7,0,125600,1031.714,115.5714
"13405","42074","2016",5,5,0,156538,1399.4,111
"13406","42075","2016",13,13,0,202723.1,1952.231,104.3077
"13407","42076","2016",6,6,0,128900,1168.5,110.8333
"13408","42077","2016",1,1,0,91000,1400,65
"13409","42078","2016",3,2,1,75000,1064,74.66667
"13410","42079","2016",7,7,0,111357.1,1041.429,109
"13411","42081","2016",14,12,2,186216.8,1898.143,95.07143
"13412","42083","2016",3,3,0,163783.3,1436.667,108
"13413","42084","2016",1,1,0,45000,750,60
"13414","42085","2016",7,6,1,161057.1,1488.714,104.7143
"13415","42086","2016",4,4,0,130000,1094.5,119.5
"13416","42087","2016",6,6,0,257975,1968.333,132.8333
"13417","42088","2016",7,7,0,196314.3,1677.714,119.1429
"13418","42089","2016",4,4,0,113350,1310.25,85.75
"13419","42090","2016",9,9,0,128744.4,1234.667,98.66667
"13420","42091","2016",7,7,0,174700,1341.143,130
"13421","42092","2016",22,14,8,186159.8,1824.182,104.2727
"13422","42093","2016",11,11,0,229872.7,2285.636,102.1818
"13423","42094","2016",103,72,31,144553.7,1522.097,96.65049
"13424","42095","2016",134,52,82,113046,1286.821,85.72388
"13425","42096","2016",4,4,0,177200,1647,108.75
"13426","42097","2016",40,28,12,216221.8,2055.175,103.8
"13427","42098","2016",5,5,0,114970,1456.2,79
"13428","42099","2016",53,42,11,160292.5,1659.415,96.11321
"13429","42100","2016",2,2,0,110000,1849.5,57.5
"13430","42102","2016",4,4,0,149150,1505.75,100.25
"13431","42103","2016",32,23,9,166847.9,1958.156,86.625
"13432","42104","2016",11,11,0,92786.36,886.6364,107.0909
"13433","42106","2016",1,1,0,50000,424,118
"13434","42107","2016",3,3,0,86166.67,981.3333,85
"13435","42108","2016",9,9,0,204851.1,1770.222,117.5556
"13436","42109","2016",1,1,0,58000,527,110
"13437","42110","2016",24,16,8,143625.9,1713.75,85.91667
"13438","42112","2016",6,6,0,85220,1327.833,70.33333
"13439","42113","2016",3,3,0,182166.7,1530.333,121
"13440","42115","2016",9,8,1,183652.2,1563.333,119.8889
"13441","42116","2016",5,5,0,63500,942.2,75.2
"13442","42117","2016",3,3,0,132666.7,1928.333,68.33333
"13443","42118","2016",6,6,0,101500,1030.333,99.5
"13444","42119","2016",3,3,0,100300,1263,86.33333
"13445","42120","2016",19,19,0,154676.8,1436.526,107.3158
"13446","42122","2016",18,18,0,198967.3,1663.667,116.0556
"13447","42123","2016",29,17,12,157748.3,1967.483,81.86207
"13448","42124","2016",3,3,0,224769,2069.333,109.3333
"13449","42126","2016",13,13,0,147420,1459.385,101.8462
"13450","42127","2016",52,49,3,121166.6,1445.904,85.21154
"13451","42128","2016",6,6,0,105441.7,1072.667,99.83333
"13452","42129","2016",15,15,0,139058,1638.933,93.06667
"13453","42130","2016",4,4,0,161500,1684,97.75
"13454","42131","2016",4,4,0,121350,1101.5,114.5
"13455","42132","2016",5,5,0,245530,2656.2,93.2
"13456","42133","2016",3,3,0,208566.7,1753.667,119.6667
"13457","42134","2016",11,11,0,168239.6,1774.636,97.72727
"13458","42135","2016",2,2,0,338025,1722,196
"13459","42136","2016",5,5,0,174440,1555.8,120.8
"13460","42137","2016",6,6,0,110808.3,1155,104.8333
"13461","42138","2016",5,5,0,118500,1610,75.8
"13462","42139","2016",11,10,1,147279.5,1240.182,132.0909
"13463","42140","2016",3,3,0,159000,1583.667,100
"13464","42141","2016",6,6,0,103466.7,969.6667,131
"13465","42142","2016",3,3,0,160666.7,1489.333,121.3333
"13466","42143","2016",4,3,1,124912.5,1384.5,84.5
"13467","42145","2016",10,10,0,170595,1458.3,122.2
"13468","42147","2016",185,92,93,134617.1,1567.773,87.15135
"13469","42148","2016",7,7,0,113745.7,1382.286,82
"13470","42149","2016",72,49,23,159803.4,1757.556,95.19444
"13471","42150","2016",11,10,1,172418.2,1748,96.36364
"13472","42151","2016",4,4,0,225475,1682.5,135.75
"13473","42152","2016",6,6,0,205283,1617.5,131
"13474","42153","2016",8,8,0,138462.5,1227.875,113.375
"13475","42154","2016",5,5,0,73900,1010.2,69.6
"13476","42155","2016",11,11,0,145469.1,1123.818,138.1818
"13477","42156","2016",6,6,0,131875,1194,110.5
"13478","42157","2016",5,5,0,123611.2,1447.2,85.2
"13479","42158","2016",3,3,0,109000,799.6667,133.3333
"13480","42159","2016",8,6,2,82525,781.875,102.625
"13481","42160","2016",2,2,0,162650,1536.5,107.5
"13482","42161","2016",3,3,0,233750,1551,158.3333
"13483","42162","2016",7,6,1,173171.4,1821.286,98.42857
"13484","42163","2016",6,6,0,105633.3,1192,114.8333
"13485","42165","2016",25,23,2,108092.8,1208.52,96.32
"13486","42166","2016",5,5,0,167020,2905.2,82.2
"13487","42167","2016",1,1,0,192180,2344,82
"13488","42168","2016",37,27,10,161950,1699.73,101.973
"13489","42169","2016",19,19,0,126351.6,1428.947,90.05263
"13490","42170","2016",19,18,1,155073.2,1298.316,117.7895
"13491","42172","2016",19,16,3,190555.8,1733.632,115
"13492","42173","2016",6,6,0,78581.67,823.1667,93.5
"13493","42174","2016",9,9,0,163598.9,1299.444,138.3333
"13494","42175","2016",16,16,0,150376.6,1412.688,107.625
"13495","42176","2016",14,14,0,148101.4,1481.857,102.8571
"13496","42177","2016",25,24,1,113692.8,1305.4,89.92
"13497","42178","2016",5,5,0,127080,1163.6,113.8
"13498","42179","2016",3,3,0,214533.3,1779,121
"13499","42180","2016",9,9,0,166693.3,1794,100.3333
"13500","42181","2016",10,8,2,108279.9,1147.2,92.4
"13501","42182","2016",25,24,1,156252,1584.88,101.32
"13502","42183","2016",32,12,20,85184.38,943.9688,84.96875
"13503","42184","2016",144,95,49,110821.7,1305.924,83.02778
"13504","42185","2016",8,8,0,275350,2107.125,130
"13505","42186","2016",90,53,37,154849.4,1727.711,88.78889
"13506","42187","2016",505,121,384,84465.24,1103.788,76.4396
"13507","42188","2016",3,2,1,102500,1055,86.66667
"13508","42189","2016",87,54,33,169752.4,1913.034,91.63218
"13509","42191","2016",12,11,1,148868.3,1724.167,89.25
"13510","42192","2016",5,4,1,86886,924.2,85.6
"13511","42193","2016",17,17,0,147343.2,1341.882,108.9412
"13512","42194","2016",2,2,0,113000,731.5,168.5
"13513","42195","2016",9,7,2,60760.11,625.6667,93.55556
"13514","42197","2016",15,14,1,131170,1277.6,102.6667
"13515","42198","2016",8,6,2,113293.8,1215,88.25
"13516","42199","2016",17,16,1,134433.1,1220.647,110.1176
"13517","42200","2016",17,17,0,163108.8,1691.882,98.35294
"13518","42201","2016",5,5,0,149083,1496.4,102
"13519","42202","2016",4,4,0,127625,1427.5,100.25
"13520","42203","2016",5,5,0,91518,905.4,105.6
"13521","42204","2016",15,10,5,121736.7,1488.533,89.13333
"13522","42205","2016",5,5,0,119710,1342.4,88
"13523","42206","2016",13,13,0,251541.5,2795.385,122.4615
"13524","42207","2016",240,101,139,134851.7,1522.092,87.77917
"13525","42208","2016",12,12,0,187438.8,1838.167,104.8333
"13526","42209","2016",1,1,0,156350,2057,76
"13527","42210","2016",1,1,0,208000,2144,97
"13528","42211","2016",22,18,4,230862.4,1933.182,120.8636
"13529","42212","2016",16,15,1,121828.1,1336.812,91
"13530","42213","2016",2,2,0,114425,1192,97.5
"13531","42214","2016",13,13,0,186279.2,1755.846,104.6154
"13532","42215","2016",20,20,0,123992.6,1074.35,118.5
"13533","42216","2016",3,2,1,155016.7,1288.333,114
"13534","42217","2016",5,5,0,88600,642,141
"13535","42218","2016",1988,242,1746,83745.74,1107.197,73.48742
"13536","42219","2016",8,8,0,167987.5,1385,121.125
"13537","42221","2016",6,6,0,149275,1378.333,108
"13538","42222","2016",58,44,14,207813.4,2153.052,96.89655
"13539","42223","2016",62,28,34,167544.4,1742.387,94.30645
"13540","42224","2016",20,14,6,179705,1648.45,108.5
"13541","42225","2016",49,41,8,159958.7,1752.469,96.12245
"13542","42226","2016",1,1,0,59000,908,65
"13543","42227","2016",2,2,0,117500,1047.5,115.5
"13544","42228","2016",12,12,0,139839.2,1482.75,94.91667
"13545","42229","2016",3,3,0,78666.67,681.3333,117
"13546","42230","2016",15,14,1,102926.7,1060.4,93
"13547","42231","2016",11,11,0,131827.3,1935.364,83
"13548","42232","2016",12,12,0,121744.2,1216.583,100.4167
"13549","42233","2016",9,9,0,120590,1442.889,86.77778
"13550","42234","2016",27,19,8,168471.6,1658.556,96.85185
"13551","42235","2016",3,3,0,97954.67,1453.333,87
"13552","42236","2016",3,3,0,220933.3,1513.333,148
"13553","42237","2016",47,39,8,165048.5,1740.447,95.61702
"13554","42238","2016",5,5,0,98372.2,789.4,124.8
"13555","42239","2016",11,11,0,117990.9,1217.364,100.2727
"13556","42240","2016",5,5,0,70000,1112.8,66.4
"13557","42241","2016",3,3,0,143400,1439.667,99
"13558","42242","2016",21,20,1,204908.5,2090.333,100.1429
"13559","42245","2016",5,5,0,92500,841.2,118.2
"13560","42246","2016",10,7,3,97010,1155.9,87.8
"13561","42247","2016",2,2,0,92500,1660.5,96.5
"13562","42248","2016",11,11,0,113950,1086.182,103.8182
"13563","42249","2016",11,9,2,100504.5,917.1818,106.3636
"13564","42251","2016",6,6,0,156400,1520.167,97.83333
"13565","42253","2016",9,9,0,193094.4,1708.111,110.6667
"13566","42254","2016",3,3,0,174733.3,1118.333,169.3333
"13567","42255","2016",1,1,0,34250,581,59
"13568","42256","2016",47,41,6,170244,1908.638,91.42553
"13569","42257","2016",10,10,0,98080,1085.6,89
"13570","42259","2016",27,22,5,174697.4,1920.741,92.18519
"13571","42260","2016",3,3,0,115833.3,1159.667,94.33333
"13572","42261","2016",10,10,0,170066,1350.7,128.7
"13573","42262","2016",16,15,1,138447.5,1521.688,95.4375
"13574","42264","2016",9,9,0,233621.7,1722.889,142.5556
"13575","42265","2016",8,8,0,250275,2205.25,110.25
"13576","42266","2016",9,9,0,152122.2,1503.889,115.8889
"13577","42267","2016",18,17,1,135691.7,1444.556,97.22222
"13578","42268","2016",8,8,0,99562.5,982.625,108.25
"13579","42269","2016",4,4,0,220232.5,1963.5,121
"13580","42270","2016",15,12,3,203230,1783.4,110.3333
"13581","42271","2016",37,27,10,196242.4,2158.351,90.18919
"13582","42272","2016",18,14,4,155989.4,1587.833,100.3889
"13583","42273","2016",2,2,0,139900,1288.5,106
"13584","42274","2016",3,3,0,124633.3,999,133.3333
"13585","42275","2016",64,23,41,173832,2039.625,88.15625
"13586","42276","2016",3,3,0,59666.67,775.6667,92.66667
"13587","42277","2016",5,5,0,136300,1594.4,93.4
"13588","42278","2016",1,1,0,114000,1213,94
"13589","42279","2016",159,123,36,189757,1912.786,99.40881
"13590","42280","2016",4,4,0,198000,1356,147.75
"13591","42282","2016",1,1,0,62500,735,85
"13592","42283","2016",5,5,0,196651,1801.6,101
"13593","42284","2016",8,8,0,143500,1377.375,118.625
"13594","42285","2016",33,22,11,152907.6,1664.727,94.87879
"13595","42286","2016",2,2,0,127500,1280,99
"13596","42287","2016",4,4,0,84750,1276,68
"13597","42288","2016",1,1,0,44000,733,60
"13598","42289","2016",21,20,1,150001.6,1375.429,106.8095
"13599","42290","2016",7,7,0,179841.6,2220.286,83.28571
"13600","42293","2016",15,12,3,128896.7,1239.933,103.9333
"13601","42294","2016",12,12,0,218911.8,1556.917,139.6667
"13602","42296","2016",7,7,0,209057.1,1597.857,129
"13603","42297","2016",9,9,0,198733.3,1490.444,138.1111
"13604","42298","2016",1,1,0,240000,9600,25
"13605","42299","2016",32,25,7,164441,1714.438,95.78125
"13606","42300","2016",8,8,0,124202.5,1010.75,128.25
"13607","42301","2016",6,6,0,119500,1244.667,96.66667
"13608","42302","2016",78,52,26,193583.6,2149.513,88.94872
"13609","42303","2016",2,2,0,80000,731.5,125
"13610","42304","2016",38,35,3,162492.4,1780.711,92.94737
"13611","42305","2016",49,29,20,185729.5,2017.061,92.46939
"13612","42306","2016",10,8,2,147102,1574.2,91.8
"13613","42307","2016",9,9,0,191324.1,2209.111,92.22222
"13614","42308","2016",7,5,2,107421.4,1100.143,97.71429
"13615","42311","2016",10,10,0,222890,2178.5,103.9
"13616","42312","2016",1,1,0,163400,1900,86
"13617","42313","2016",6,6,0,141966.7,1311.333,113.3333
"13618","42314","2016",1,1,0,120000,706,170
"13619","42315","2016",5,5,0,244300,2140.2,108.2
"13620","42316","2016",52,36,16,139962.5,1532.923,90.57692
"13621","42317","2016",1,1,0,148700,1487,100
"13622","42318","2016",23,23,0,102176.1,1093.348,92.08696
"13623","42319","2016",7,7,0,153142.9,1366.571,114.4286
"13624","42320","2016",9,9,0,169902.2,1732.444,100.4444
"13625","42321","2016",1,1,0,50000,625,80
"13626","42322","2016",8,6,2,100737.5,1064.25,102.5
"13627","42323","2016",89,55,34,183702.2,2135.146,88.17978
"13628","42324","2016",15,15,0,200360,2145.2,92.86667
"13629","42325","2016",7,7,0,112642.9,939.1429,115.5714
"13630","42326","2016",11,11,0,213765.9,1734.818,128.1818
"13631","42327","2016",6,4,2,166856.7,2099,98
"13632","42328","2016",6,6,0,125726.7,1251.5,95
"13633","42329","2016",3,3,0,125333.3,1486,82
"13634","42330","2016",86,33,53,129751.9,1459.535,86.74419
"13635","42331","2016",5,5,0,125660,1104.8,106
"13636","42332","2016",39,32,7,153031.9,1349.59,117.3846
"13637","42333","2016",3,3,0,151666.7,1175.667,139.6667
"13638","42334","2016",7,7,0,133123.3,1339,101.2857
"13639","42335","2016",2,1,1,155000,1408.5,111.5
"13640","42336","2016",8,8,0,175211.2,1237.25,145.375
"13641","42337","2016",4,4,0,106250,884.25,123.25
"13642","42338","2016",10,9,1,115969.5,1350.4,86.7
"13643","43001","2016",3,3,0,75966.67,441,170
"13644","43002","2016",24,18,6,159788.6,1769.875,94.45833
"13645","43003","2016",6,6,0,82750,1114.5,76
"13646","43004","2016",3,3,0,95833.33,951.6667,98.33333
"13647","43005","2016",4,4,0,94975,1240.75,81.25
"13648","43007","2016",6,6,0,104683.3,1026.333,108.1667
"13649","43008","2016",4,4,0,57511.25,791.25,76.25
"13650","43010","2016",6,6,0,126400,1431.667,92.5
"13651","43011","2016",1,1,0,48000,800,60
"13652","43012","2016",59,45,14,155413.6,1838.898,85.08475
"13653","43013","2016",4,4,0,66375,618.75,109.25
"13654","43016","2016",6,6,0,81875,937.3333,89.16667
"13655","43017","2016",4,4,0,104510,743,131.75
"13656","43018","2016",12,11,1,114714.2,1094.833,108.4167
"13657","43020","2016",43,40,3,137364,1406.116,103.6744
"13658","43021","2016",7,7,0,88142.86,1089.571,79.28571
"13659","43022","2016",4,4,0,58975,851.5,76.75
"13660","43023","2016",2,2,0,131500,1388.5,114
"13661","43024","2016",4,4,0,137100,1346.75,110.25
"13662","43025","2016",36,35,1,97254.83,1199.194,85.08333
"13663","43026","2016",6,6,0,102000,924.5,112.1667
"13664","43027","2016",1,1,0,50000,625,80
"13665","43028","2016",5,5,0,164720,1373.2,123
"13666","43029","2016",2,2,0,112500,927,122
"13667","43030","2016",3,3,0,148000,1506,103.3333
"13668","43031","2016",2,2,0,48750,759.5,61
"13669","43032","2016",9,9,0,131788.9,1301.444,103.5556
"13670","43033","2016",9,9,0,114496.9,1005.889,99
"13671","43034","2016",2,2,0,47750,688.5,71
"13672","43036","2016",4,4,0,127282.5,1347.25,85.5
"13673","43037","2016",1,1,0,68000,1133,60
"13674","43038","2016",6,6,0,76850,998.3333,73.83333
"13675","43039","2016",3,3,0,1e+05,1338.333,101.6667
"13676","43040","2016",56,41,15,95859.91,1105.643,88.03571
"13677","43041","2016",54,29,25,129454.4,1491.204,84.62963
"13678","43042","2016",7,7,0,63404.29,1003.857,64.71429
"13679","43043","2016",1,1,0,20000,357,56
"13680","43044","2016",2,2,0,32500,481.5,69
"13681","43045","2016",8,8,0,145905.6,1148.375,128.125
"13682","43046","2016",21,13,8,126726.2,1482.095,86.09524
"13683","43047","2016",3,3,0,87318.33,1038.333,81.66667
"13684","43048","2016",8,8,0,119458.1,2184.375,80.125
"13685","43049","2016",7,7,0,131842.9,1175.143,111.5714
"13686","43051","2016",58,44,14,116172.1,1330.655,90.77586
"13687","43052","2016",3,3,0,115833.3,1039,106
"13688","43053","2016",7,6,1,155000,2269.857,74.42857
"13689","43055","2016",1,1,0,2e+05,1852,108
"13690","43056","2016",3,3,0,105666.7,1242.667,78.33333
"13691","43057","2016",2,2,0,88875,741,120
"13692","43058","2016",11,10,1,177104.5,1842.455,95.09091
"13693","43061","2016",4,4,0,125685.8,1110.75,109
"13694","43062","2016",3,3,0,171966.7,1376.667,126.6667
"13695","43063","2016",1,1,0,110000,965,114
"13696","43064","2016",2,2,0,53500,716.5,70
"13697","43066","2016",2,2,0,84600,814.5,109
"13698","43067","2016",1,1,0,53800,1281,42
"13699","43068","2016",1,1,0,50000,595,84
"13700","43069","2016",3,3,0,102649,1252,87
"13701","43070","2016",2,2,0,42500,696,62.5
"13702","43071","2016",6,6,0,139083.3,1027.667,149.8333
"13703","43072","2016",1,1,0,40000,690,58
"13704","43073","2016",3,3,0,66000,954,76
"13705","43074","2016",1,1,0,48000,1043,46
"13706","43075","2016",1,1,0,51000,425,120
"13707","43076","2016",3,3,0,83000,927,94.33333
"13708","43077","2016",3,3,0,89000,879.3333,103
"13709","43078","2016",27,23,4,132185.6,1342.667,99.33333
"13710","43079","2016",2,2,0,124750,1254.5,98.5
"13711","43080","2016",18,17,1,101874.4,1062.444,103.0556
"13712","43082","2016",1,1,0,50000,463,108
"13713","43083","2016",2,2,0,58000,687,83.5
"13714","43084","2016",12,12,0,139065.3,1277.333,115.6667
"13715","43085","2016",1,1,0,36500,608,60
"13716","43086","2016",2,2,0,98080,1133.5,77.5
"13717","43087","2016",16,14,2,110612.5,1093.125,101.375
"13718","43088","2016",3,3,0,99333.33,843.6667,113
"13719","43089","2016",59,43,16,117660.1,1294.525,88.25424
"13720","43090","2016",1,1,0,47400,439,108
"13721","43091","2016",6,5,1,173133.3,2219.167,99
"13722","43092","2016",7,7,0,88571.43,938.1429,90.85714
"13723","43093","2016",6,6,0,106083.3,906,123.3333
"13724","43095","2016",2,2,0,71500,607,117
"13725","43096","2016",6,6,0,92041.67,1013.333,88.83333
"13726","43099","2016",9,9,0,122402.8,1190.889,98
"13727","43100","2016",2,2,0,79425,738,105
"13728","43101","2016",3,3,0,71850,743,91.66667
"13729","43102","2016",13,12,1,114838.5,1206.077,96.23077
"13730","43103","2016",2,2,0,57500,1155,56
"13731","43104","2016",1,1,0,55530,854,65
"13732","43105","2016",1,1,0,168000,1615,104
"13733","43106","2016",1,1,0,41000,569,72
"13734","43107","2016",1,1,0,224000,872,257
"13735","43108","2016",6,6,0,111100,837.5,133.3333
"13736","43109","2016",2,2,0,83172.5,838.5,96
"13737","43110","2016",5,5,0,107730,1065.4,104.4
"13738","43111","2016",6,6,0,77250,923.5,82.16667
"13739","43112","2016",47,41,6,83708.51,1002.234,84.34043
"13740","43113","2016",8,8,0,120768.8,1187,97.75
"13741","43114","2016",24,24,0,148985.4,1484.208,102.2083
"13742","43115","2016",8,6,2,89157.62,1123.875,74.125
"13743","43116","2016",3,3,0,64766.67,582,111.6667
"13744","43117","2016",2,2,0,97850,827,109
"13745","43118","2016",7,7,0,73957.14,1020,76.85714
"13746","43119","2016",5,5,0,144800,1692.8,86.6
"13747","43120","2016",15,15,0,97686,971,100.4667
"13748","43121","2016",4,4,0,172000,2350.5,81.25
"13749","43122","2016",2,2,0,62500,562.5,109
"13750","43123","2016",2,2,0,104500,915.5,121.5
"13751","43124","2016",6,6,0,146791.7,1335.5,114.8333
"13752","43125","2016",3,3,0,56000,775.6667,72.33333
"13753","43126","2016",4,4,0,126125,1247.75,103
"13754","43127","2016",14,14,0,108278.6,1341.357,84.35714
"13755","43128","2016",1,1,0,22000,431,51
"13756","43129","2016",1,1,0,157350,1589,99
"13757","43130","2016",22,21,1,115734.1,1167.364,105.3636
"13758","43131","2016",1,1,0,86000,1344,64
"13759","43132","2016",13,13,0,137430.8,1157.538,120.2308
"13760","43134","2016",2,2,0,145700,1766,95
"13761","43135","2016",8,7,1,113462.5,1786.75,83.125
"13762","43136","2016",3,3,0,66666.67,533,129.3333
"13763","43137","2016",85,59,26,153021.1,1692.682,90.15294
"13764","43138","2016",5,5,0,147200,1050.8,138
"13765","43140","2016",4,4,0,184381.5,1465.5,129.5
"13766","43141","2016",9,7,2,115411.1,1178.444,95.88889
"13767","43142","2016",3,3,0,151200,1416.667,104.6667
"13768","43143","2016",1,1,0,60000,632,95
"13769","43144","2016",2,2,0,102000,1615.5,71
"13770","43145","2016",5,5,0,96046,935.8,91.8
"13771","43148","2016",10,10,0,66126,824.1,76.4
"13772","43150","2016",1,1,0,320000,5246,61
"13773","43151","2016",3,3,0,46500,573,86.33333
"13774","43152","2016",21,21,0,154163.7,1638.524,100.2381
"13775","43153","2016",22,19,3,160097.7,1644,109.5455
"13776","43154","2016",5,4,1,35100,544.4,63.8
"13777","43155","2016",1,1,0,95000,1131,84
"13778","43156","2016",4,4,0,76500,1012.25,81
"13779","43157","2016",262,66,196,97669.87,1244.523,79.18702
"13780","43158","2016",3,3,0,176833.3,1445.333,117.3333
"13781","43159","2016",9,9,0,120229.4,1292.889,99.66667
"13782","43160","2016",3,3,0,99323.67,1280.333,82.33333
"13783","43162","2016",41,39,2,97169.51,1079.976,88.73171
"13784","43163","2016",11,11,0,88691.82,985.1818,97.54545
"13785","43164","2016",3,3,0,78200,1066,76.66667
"13786","43165","2016",11,11,0,124000,1315,95.36364
"13787","43166","2016",5,5,0,111814,1222.8,92
"13788","43167","2016",4,4,0,93625,942.5,96.25
"13789","43168","2016",1,1,0,152000,2533,60
"13790","43170","2016",2,2,0,124100,1500,93
"13791","43171","2016",2,2,0,58900,779,73
"13792","43172","2016",2,1,1,82500,1109,71.5
"13793","43173","2016",2,2,0,52000,428.5,120
"13794","43174","2016",7,7,0,119518,1063.429,116.8571
"13795","43175","2016",5,5,0,68000,754,98.2
"13796","43177","2016",22,15,7,115465,1312.227,84.72727
"13797","43178","2016",2,2,0,82072,1201,93.5
"13798","43181","2016",6,5,1,134100,1512,87.33333
"13799","43183","2016",1,1,0,54500,801,68
"13800","43184","2016",24,17,7,169862.5,1787.667,100.2083
"13801","43185","2016",35,35,0,125372.5,1238.086,101.3714
"13802","43186","2016",9,8,1,80308.89,794,97.88889
"13803","43187","2016",2,2,0,85020,806.5,107.5
"13804","43188","2016",2,2,0,140600,1284.5,115
"13805","43189","2016",3,3,0,166440,1256.333,132.3333
"13806","43190","2016",23,23,0,158807.4,1464.87,107.8261
"13807","43191","2016",4,4,0,126877.5,1278.5,102.75
"13808","43192","2016",3,3,0,68333.33,1028.333,67.66667
"13809","43193","2016",2,2,0,73875,1276.5,68.5
"13810","43194","2016",3,3,0,124346.3,1432.667,94.66667
"13811","43195","2016",3,3,0,45550,640.6667,70
"13812","43196","2016",2,2,0,87155,1151,75.5
"13813","43197","2016",4,4,0,117500,716.25,138
"13814","43198","2016",4,4,0,68345,926.5,80
"13815","43199","2016",15,15,0,170590,2006.533,85.26667
"13816","43200","2016",13,11,2,96451.54,1487,71.76923
"13817","43201","2016",3,3,0,145166.7,1852.333,77.33333
"13818","43203","2016",3,3,0,56000,993.3333,52.33333
"13819","43204","2016",1,1,0,190000,1188,160
"13820","43205","2016",25,21,4,138326,1581,86.8
"13821","43207","2016",2,2,0,190010,1149.5,168.5
"13822","43210","2016",3,3,0,45666.67,498,85
"13823","43211","2016",20,19,1,124311.2,1169.95,104.75
"13824","43212","2016",11,11,0,141249.1,1280.727,126.6364
"13825","43213","2016",16,16,0,122555.9,1293.625,98.6875
"13826","43214","2016",1,1,0,108000,885,122
"13827","43215","2016",5,5,0,174886,3417.4,75.4
"13828","43216","2016",11,10,1,145774.1,1386.182,103.6364
"13829","43217","2016",6,6,0,57292.5,817.1667,70.16667
"13830","43218","2016",8,8,0,167156.2,1789.375,94.875
"13831","43219","2016",2,2,0,72500,614.5,116.5
"13832","43220","2016",4,4,0,70997.5,923.75,80.75
"13833","43221","2016",3,3,0,106666.7,1023.333,107
"13834","43222","2016",1,1,0,45000,562,80
"13835","43223","2016",2,2,0,167200,1474,115.5
"13836","43224","2016",41,37,4,121936.6,1387.756,88.82927
"13837","43225","2016",1,1,0,91980,979,94
"13838","43226","2016",1,1,0,42000,840,50
"13839","43227","2016",8,8,0,165687.5,1463.375,119
"13840","43228","2016",2,2,0,80000,917.5,90
"13841","43229","2016",4,4,0,160250,1609.5,98
"13842","43230","2016",15,15,0,121553.4,1215.333,103.1333
"13843","43231","2016",4,4,0,82875,955.25,96.5
"13844","43232","2016",3,3,0,71563.33,694.3333,107.3333
"13845","43233","2016",9,9,0,173343.8,1553.444,116
"13846","43234","2016",15,14,1,60146.67,1016.4,65.26667
"13847","43236","2016",15,10,5,136246.7,1392.867,94.93333
"13848","43237","2016",4,4,0,69000,550.5,120.25
"13849","43238","2016",1,1,0,50000,625,80
"13850","43239","2016",10,10,0,159660,1579.3,97.9
"13851","43240","2016",1,1,0,113000,1242,91
"13852","43241","2016",11,11,0,127122.7,1352.909,97.18182
"13853","43244","2016",29,26,3,128917.2,1321.31,104.4483
"13854","43245","2016",5,5,0,77900,952.2,83.8
"13855","43246","2016",6,6,0,88158.33,1102.333,99.33333
"13856","43249","2016",4,3,1,149517.5,1302,118
"13857","43250","2016",2,2,0,58300,598.5,100.5
"13858","43251","2016",43,20,23,147045.2,1794.07,89.93023
"13859","43253","2016",5,4,1,133509,1501.8,100.4
"13860","43254","2016",2,2,0,166917.5,1311.5,138
"13861","43258","2016",12,12,0,132465,1282.417,103.1667
"13862","43259","2016",5,5,0,80560,872.4,95.8
"13863","43261","2016",6,6,0,116250,1319.5,93.16667
"13864","43262","2016",18,8,10,69230.56,965.2222,64.66667
"13865","43263","2016",3,3,0,75166.67,934,76.66667
"13866","43264","2016",7,7,0,41071,511.2857,81.28571
"13867","43265","2016",14,14,0,164345.7,1699.214,95.85714
"13868","43267","2016",11,11,0,94172.73,960.9091,90.36364
"13869","43268","2016",64,57,7,137021,1435,97.78125
"13870","44001","2016",17,16,1,136979.4,1668.059,95.52941
"13871","44002","2016",51,49,2,176145.6,1858.294,95.11765
"13872","44003","2016",92,61,31,143341.5,1688.228,87.56522
"13873","44005","2016",65,63,2,167761.5,1906.046,91.09231
"13874","44006","2016",30,30,0,182004,1916.967,96.56667
"13875","44007","2016",27,27,0,108473.4,1156.481,97.88889
"13876","44009","2016",52,48,4,320062.4,2598.615,124.5
"13877","44010","2016",81,65,16,212698.8,3314.568,69.62963
"13878","44012","2016",94,73,21,199467.2,2869.479,73.29787
"13879","44013","2016",34,34,0,156650.3,1688.794,95.41176
"13880","44014","2016",29,27,2,196561.7,1995.448,98.58621
"13881","44015","2016",91,83,8,146357.6,1678.088,91.98901
"13882","44016","2016",7,7,0,152785.7,1540,99.57143
"13883","44018","2016",84,66,18,207878.5,2304.988,92.89286
"13884","44019","2016",7,7,0,234078.6,1987.143,121.5714
"13885","44020","2016",188,159,29,203682.5,2463.399,85.39894
"13886","44021","2016",43,43,0,144132.6,1580.07,93.09302
"13887","44022","2016",20,20,0,130261.8,1350.65,98
"13888","44023","2016",22,22,0,157614.3,1565.727,101.5455
"13889","44024","2016",18,18,0,199616.7,2167.833,94.16667
"13890","44025","2016",35,35,0,166922.6,1592.114,105.4286
"13891","44026","2016",234,165,69,258846.8,2690.53,98.62393
"13892","44027","2016",17,17,0,208426.2,1823.824,114.2941
"13893","44028","2016",40,40,0,201489.3,1835.825,109.125
"13894","44029","2016",49,49,0,182999,1913.449,99.4898
"13895","44030","2016",33,32,1,142261.5,1567.273,96.24242
"13896","44031","2016",3,3,0,53333.33,916.6667,56
"13897","44032","2016",36,35,1,193773.9,1974.75,101.6667
"13898","44033","2016",26,26,0,163967.3,1645.577,102.0769
"13899","44035","2016",228,167,61,261032.4,2716.675,99.12719
"13900","44036","2016",127,98,29,113207.9,1424.228,81.96063
"13901","44037","2016",19,19,0,185580.3,1916.211,100.2632
"13902","44038","2016",33,33,0,172178.8,1818.97,97.93939
"13903","44039","2016",19,18,1,231450.5,2020.789,113.7895
"13904","44041","2016",2,2,0,256758,2005.5,127
"13905","44043","2016",82,64,18,191516.1,2228.646,89.26829
"13906","44044","2016",11,11,0,103818.2,1164.364,86.36364
"13907","44045","2016",26,26,0,235857.9,2086.808,112.5385
"13908","44046","2016",27,26,1,186113.5,2246.074,89.85185
"13909","44047","2016",236,202,34,208155.2,2507.042,85.86017
"13910","44048","2016",18,18,0,208655.6,1929.722,121.9444
"13911","44049","2016",148,73,75,213910.9,3153.899,70.63514
"13912","44050","2016",26,26,0,147021.2,1527.577,98.11538
"13913","44051","2016",36,36,0,111179,1164.528,96.97222
"13914","44052","2016",73,72,1,139367.1,1583.452,89.34247
"13915","44053","2016",15,15,0,145950,1528.933,98.33333
"13916","44054","2016",13,13,0,132077.7,1190.385,116.5385
"13917","44055","2016",656,218,438,297411.6,4286.114,72.19512
"13918","44056","2016",32,31,1,155876.6,1643.125,102
"13919","44057","2016",38,38,0,84419.74,1004.789,82.71053
"13920","44058","2016",6,6,0,113333.3,1256,89.83333
"13921","44061","2016",49,49,0,160768.2,1942.592,88.14286
"13922","44062","2016",14,14,0,121392.9,1738.214,74.14286
"13923","44063","2016",41,40,1,155721.7,1682.756,91.07317
"13924","44064","2016",29,28,1,189755.7,2074.517,95
"13925","44065","2016",11,11,0,90318.18,1002,89.63636
"13926","44066","2016",25,25,0,215430,1767.12,128.28
"13927","44067","2016",59,58,1,130586.6,1362.78,101.9153
"13928","44068","2016",40,40,0,122713.6,1319.325,95.65
"13929","44069","2016",206,164,42,241662.9,2465.354,101.4126
"13930","44070","2016",38,36,2,205834.2,2120.789,97.31579
"13931","44071","2016",62,62,0,248807.7,2418,106.9839
"13932","44072","2016",77,76,1,161772.5,1758.13,100.5974
"13933","44073","2016",46,45,1,204072.8,1941.326,109.7826
"13934","44074","2016",58,48,10,181283.3,2434.897,77.2069
"13935","44075","2016",19,19,0,106473.7,1217.526,90.68421
"13936","44076","2016",12,12,0,124720.8,1266.5,104.4167
"13937","44077","2016",28,28,0,129008.9,1271.143,103.5357
"13938","44078","2016",2,2,0,76500,981,78
"13939","44079","2016",16,16,0,188500,1933.062,102.875
"13940","44080","2016",1,1,0,95000,1284,74
"13941","44081","2016",61,61,0,120137.2,1269.787,99.54098
"13942","44082","2016",34,34,0,192893.4,1901.147,102.3824
"13943","44083","2016",18,18,0,169451.9,1558.556,108.1111
"13944","44084","2016",71,59,12,194506,2056.648,101.169
"13945","44085","2016",11,11,0,97060.64,1246.091,84.18182
"13946","44086","2016",8,8,0,82625,979.5,81.75
"13947","44087","2016",70,66,4,139907.4,1584.214,92.47143
"13948","44088","2016",32,32,0,171292.9,1776.906,99.1875
"13949","44089","2016",31,31,0,181742.5,1874.645,105.871
"13950","44090","2016",5,5,0,152400,1669,92
"13951","44091","2016",21,21,0,107242.9,1145.714,95.38095
"13952","44092","2016",7,7,0,59571.43,668.4286,85.85714
"13953","44094","2016",22,22,0,181977.7,1852.409,97.40909
"13954","44095","2016",9,9,0,94788.89,1271,74.11111
"13955","44096","2016",53,53,0,153682.4,1565.358,97.92453
"13956","44097","2016",57,55,2,243104.2,2813.105,91.01754
"13957","44098","2016",57,54,3,160601.8,1554.772,109.6842
"13958","44099","2016",19,19,0,103052.6,1219.579,88.21053
"13959","44100","2016",25,25,0,167524,1775.56,97.04
"13960","44101","2016",84,81,3,207453.3,2390.75,88.88095
"13961","44102","2016",22,22,0,189727.3,1792.545,107.8182
"13962","44103","2016",69,58,11,141123.2,1647.348,86.89855
"13963","44104","2016",9,9,0,123722.2,1272.889,93.66667
"13964","44105","2016",1,1,0,134000,2161,62
"13965","44106","2016",46,45,1,194268.3,2594.674,78.19565
"13966","44107","2016",18,18,0,152388.9,1541,102.5
"13967","44108","2016",26,26,0,181916.6,1883.731,101.5385
"13968","44109","2016",5201,1245,3956,200355,2826.869,69.66833
"13969","44110","2016",85,79,6,201194.4,1954.718,105.4471
"13970","44111","2016",7,7,0,204328.6,1860,111.8571
"13971","44112","2016",3,3,0,43333.33,802,55.33333
"13972","44113","2016",28,28,0,151032.1,1513.107,103.5
"13973","44114","2016",364,208,156,229303.2,2567.775,90.57143
"13974","44115","2016",33,32,1,177294.1,1767.576,100.1515
"13975","44116","2016",49,33,16,115127.5,1541.673,76.71429
"13976","44117","2016",38,30,8,170627.9,1822.263,96.15789
"13977","44118","2016",20,20,0,117449.6,1238.7,97.6
"13978","44119","2016",6,6,0,126166.7,1277.5,102.1667
"13979","44120","2016",58,52,6,185916.3,2176.293,88.15517
"13980","44121","2016",5,5,0,90800,1066.8,82.2
"13981","44122","2016",32,32,0,173228.1,1840.969,97.6875
"13982","44123","2016",10,10,0,111851.4,1178,94.6
"13983","44124","2016",6,6,0,132616.7,1292.833,115.3333
"13984","44125","2016",72,67,5,273851.2,3263.792,90.31944
"13985","44126","2016",102,98,4,184190.8,2840.971,71.61765
"13986","44127","2016",19,19,0,131263.2,1426.632,94.26316
"13987","44128","2016",57,56,1,132735.6,1380.842,102.2456
"13988","44129","2016",99,88,11,141765.4,1590.293,90.83838
"13989","44130","2016",51,51,0,229959.5,2390.941,96.84314
"13990","44131","2016",324,280,44,263684.6,3126.404,89.33951
"13991","44132","2016",325,152,173,276309.3,3853.831,75.10769
"13992","44133","2016",27,25,2,213542.1,2160.889,101.4444
"13993","44134","2016",6,6,0,143833.3,1356.5,111.5
"13994","44135","2016",150,93,57,264905.5,3466.553,79.38
"13995","44136","2016",33,31,2,257011.5,2883.152,91.90909
"13996","44137","2016",29,29,0,159153.3,1729.448,92.89655
"13997","44138","2016",12,12,0,131833.3,1598.167,83.33333
"13998","44139","2016",21,21,0,133690.5,1367.667,104.3333
"13999","44140","2016",16,16,0,152280.6,1389.75,113.5
"14000","44141","2016",11,11,0,195590.9,1756.909,114.6364
"14001","44142","2016",13,13,0,185961.5,1680.923,124
"14002","44143","2016",671,321,350,178889.3,2367.487,75.89568
"14003","44144","2016",25,24,1,149528.9,1486.96,106.56
"14004","44145","2016",36,35,1,169209.7,1725.806,100.6944
"14005","44146","2016",12,12,0,95250.5,1149.667,87.16667
"14006","44148","2016",10,10,0,76850,843.4,90.9
"14007","44149","2016",39,39,0,157050.9,1548,102.4359
"14008","44150","2016",33,33,0,217417.6,2223.515,99.9697
"14009","44151","2016",77,73,4,243921.3,2153.065,111.1169
"14010","44152","2016",19,19,0,165368.4,1574,108.2105
"14011","44153","2016",16,16,0,111500,1116.188,99.4375
"14012","44154","2016",294,207,87,194635.4,2642.323,77.98299
"14013","44155","2016",50,50,0,148324.9,1493.38,102.66
"14014","44156","2016",29,29,0,129000,1459.207,88.58621
"14015","44157","2016",17,17,0,136911.8,1544.765,87.88235
"14016","44158","2016",82,72,10,250658.9,2451.622,104.5854
"14017","44159","2016",13,12,1,193359.2,2087,94.07692
"14018","44161","2016",43,40,3,122738.4,1280.302,96.83721
"14019","44162","2016",619,283,336,176032.8,2187.409,80.50242
"14020","44163","2016",38,38,0,162985.5,1545.632,106.5263
"14021","44164","2016",27,27,0,153023.7,1606.963,95.96296
"14022","44165","2016",23,23,0,176339.1,1772.043,100.5217
"14023","44166","2016",40,39,1,207592.9,2158.85,98.2
"14024","44168","2016",52,52,0,111522.1,1343.346,84.65385
"14025","44169","2016",69,68,1,216776.6,2022.319,109.971
"14026","44170","2016",7,7,0,65928.57,741.4286,94.57143
"14027","44171","2016",8,8,0,216556.2,1895.75,115.875
"14028","44172","2016",120,95,25,251456.3,2661.9,96.50833
"14029","44173","2016",13,13,0,181757.7,1798.077,104.3846
"14030","44174","2016",22,21,1,133718.2,1542.773,90.77273
"14031","44175","2016",33,33,0,209629.8,1834.545,116.7879
"14032","44176","2016",31,31,0,127939.4,1497,88
"14033","44178","2016",19,19,0,189683.7,1777.421,106.1579
"14034","44179","2016",56,56,0,202558.9,2067.125,98.89286
"14035","44180","2016",47,46,1,109813.5,1187.681,95.48936
"14036","44182","2016",128,110,18,183901.2,2718.18,72.21875
"14037","44183","2016",34,34,0,186797,2146.824,97.97059
"14038","44184","2016",981,460,521,154317.7,2027.702,77.20387
"14039","44185","2016",39,37,2,102090,1140.487,89.15385
"14040","44186","2016",80,78,2,193633.4,2006.5,97.1125
"14041","44187","2016",56,53,3,147736.7,1817.321,83.51786
"14042","44188","2016",77,74,3,183286.1,1895.883,98.61039
"14043","44189","2016",16,15,1,139325.6,1684,85.375
"14044","44190","2016",413,241,172,199344.3,2548.91,79.69249
"14045","44192","2016",19,19,0,144686.8,1573.368,96.47368
"14046","44193","2016",19,19,0,98210.53,970.6316,98.42105
"14047","44194","2016",101,73,28,311090.2,2718.881,119.2277
"14048","44195","2016",95,88,7,178774.5,1917.716,96.25263
"14049","44196","2016",25,25,0,105043.6,1241.92,86.16
"14050","44197","2016",17,17,0,90132.94,948.7059,94.52941
"14051","44198","2016",97,72,25,226011.4,2533.722,93.51546
"14052","44199","2016",26,26,0,94585.96,897.4615,105.0385
"14053","44200","2016",6,6,0,88833.33,897.5,103.8333
"14054","44201","2016",51,48,3,262666.2,2471.098,108.6275
"14055","44202","2016",15,15,0,130066.7,1292.8,102.1333
"14056","44203","2016",22,19,3,200163.6,2006.364,103.6818
"14057","44204","2016",82,72,10,243152.3,2630.61,98.5122
"14058","44205","2016",17,16,1,145933.5,1627,87.58824
"14059","44206","2016",26,26,0,100400,1196,87.73077
"14060","44207","2016",10,10,0,145149.4,1245.8,115.3
"14061","44208","2016",12,12,0,125041.7,1220.333,108.0833
"14062","44209","2016",94,89,5,240289.6,2362.309,104.8511
"14063","44210","2016",80,71,9,135807.1,1591.725,87.0625
"14064","44211","2016",130,99,31,206648.7,2886.723,76.96154
"14065","44212","2016",88,82,6,191408.4,1947.932,101.3523
"14066","44213","2016",62,62,0,108486.6,1303.629,86.20968
"14067","44214","2016",27,25,2,155777.8,1541.889,102.2593
"14068","44215","2016",295,246,49,250981.1,2687.79,94.93898
"14069","44216","2016",38,37,1,144373.8,1600.895,93.63158
"14070","44217","2016",62,57,5,235148,2193.339,110.7258
"14071","44218","2016",7,7,0,125955,1140.571,117.7143
"14072","44220","2016",23,23,0,166087,1760.957,96.21739
"14073","44221","2016",9,9,0,164198.7,1747.333,97.11111
"14074","44222","2016",11,11,0,142881.8,1306.909,109.6364
"14075","44223","2016",39,32,7,171866.7,1752.667,97.92308
"14076","44224","2016",5,5,0,89440,1020.8,85.2
"14077","45001","2016",4,4,0,103250,1113.5,98.25
"14078","45002","2016",7,7,0,79178.57,1259.571,62.28571
"14079","45004","2016",145,132,13,132383.9,1495.697,92.78621
"14080","45005","2016",2,2,0,108750,1454.5,83
"14081","45006","2016",12,12,0,300391.2,2670.25,144.25
"14082","45008","2016",18,16,2,179701.9,2070,91.16667
"14083","45009","2016",15,15,0,150360.7,1286.867,120.3333
"14084","45010","2016",11,10,1,139090.9,1519.364,102.1818
"14085","45013","2016",5,5,0,220820,1709.4,131.2
"14086","45014","2016",8,8,0,154977.5,1327,131.75
"14087","45015","2016",9,9,0,154944.4,1587.667,106.6667
"14088","45016","2016",15,15,0,94066.67,1154.667,90.6
"14089","45017","2016",2,2,0,114000,1059,106
"14090","45018","2016",13,13,0,104652.6,1099.692,103.3846
"14091","45019","2016",9,9,0,132895.6,1290,107.3333
"14092","45020","2016",6,6,0,152633.3,1635.167,93.33333
"14093","45021","2016",5,5,0,111200,1186.4,92.4
"14094","45022","2016",4,4,0,103500,1008.5,106.5
"14095","45023","2016",2,2,0,73500,720,118
"14096","45024","2016",24,24,0,142010,1627.417,93.58333
"14097","45025","2016",16,16,0,117248.2,1315.438,94.3125
"14098","45026","2016",7,7,0,118428.6,1210,105.2857
"14099","45027","2016",5,5,0,115400,1315,88.6
"14100","45028","2016",103,74,29,127754,1582.029,83.79612
"14101","45029","2016",28,27,1,100200.5,1118.571,91.17857
"14102","45030","2016",17,17,0,110617.6,1371.941,87.11765
"14103","45031","2016",23,21,2,103466.1,1142.739,96.78261
"14104","45032","2016",4,4,0,123500,1195.5,101.75
"14105","45033","2016",8,8,0,107250,1738.375,72
"14106","45034","2016",16,16,0,193579.7,1746.188,113.625
"14107","45035","2016",7,7,0,132310,1831.429,72.85714
"14108","45036","2016",13,13,0,167771.7,1378.308,122.3846
"14109","45037","2016",6,6,0,132333.2,1574.5,83.66667
"14110","45038","2016",3,3,0,121000,1431.333,97.33333
"14111","45039","2016",5,5,0,109975.2,1319.6,80.4
"14112","45040","2016",21,18,3,81761.9,1090.143,74.95238
"14113","45042","2016",13,13,0,134310,1457.615,92
"14114","45043","2016",5,5,0,227790,1691.8,135.8
"14115","45044","2016",1,1,0,250000,1701,147
"14116","45045","2016",1,1,0,105000,875,120
"14117","45046","2016",3,3,0,133833.3,1428.667,97.66667
"14118","45047","2016",9,9,0,149930,1361.889,114.1111
"14119","45049","2016",11,11,0,187890.9,1668.364,120.8182
"14120","45050","2016",13,13,0,114009.1,1310,97.15385
"14121","45051","2016",19,19,0,167146.7,1839.368,105.7368
"14122","45052","2016",1,1,0,38000,633,60
"14123","45053","2016",63,55,8,100181.8,1429.349,80.92063
"14124","45054","2016",1,1,0,115000,2614,44
"14125","45055","2016",2,2,0,112000,1219,97.5
"14126","45056","2016",4,4,0,212125,1372.5,156.75
"14127","45058","2016",1,1,0,140000,1538,91
"14128","45059","2016",1,1,0,2e+05,2041,98
"14129","45060","2016",4,4,0,94521.25,1196.5,76
"14130","45061","2016",29,29,0,140413.8,1360.379,109.7586
"14131","45062","2016",6,6,0,189501.8,1715.833,109.5
"14132","45063","2016",5,5,0,124891,963.2,123.2
"14133","45064","2016",6,6,0,121666.7,1085.5,110.3333
"14134","45065","2016",2,2,0,140000,1321.5,105
"14135","45066","2016",5,5,0,117500,1413,84.6
"14136","45067","2016",31,31,0,182504.8,1819.581,104.3226
"14137","45068","2016",106,90,16,107460.3,1422.226,77.76415
"14138","45069","2016",16,16,0,124162.5,1510.938,84.875
"14139","45070","2016",1,1,0,75000,1014,74
"14140","45072","2016",2,2,0,1e+05,1027.5,96.5
"14141","45073","2016",10,10,0,133560,1312.2,107
"14142","45075","2016",117,79,38,152490.9,1797.949,86.71795
"14143","45077","2016",10,10,0,95670,1129.3,90.6
"14144","45078","2016",5,5,0,126700,1437.4,88.2
"14145","45079","2016",5,5,0,76000,1285.8,57.6
"14146","45080","2016",5,5,0,145594,1624.6,94.2
"14147","45081","2016",1,1,0,135000,1929,70
"14148","45082","2016",90,73,17,153001.8,1629.989,96.11111
"14149","45083","2016",21,21,0,112511.9,1347.286,86.2381
"14150","45084","2016",4,4,0,162596.8,1455.75,117.5
"14151","45085","2016",29,28,1,94944.48,1175.69,83.17241
"14152","45086","2016",1,1,0,149000,1713,87
"14153","45087","2016",35,35,0,103602,1493.8,80.74286
"14154","45088","2016",2,2,0,150000,1506.5,99.5
"14155","45089","2016",72,61,11,158443.2,1895.958,86.68056
"14156","45091","2016",4,4,0,187166.2,1022.75,189
"14157","45092","2016",9,9,0,146722.2,1552.556,94.33333
"14158","45093","2016",28,28,0,155206.5,1566.429,103.9286
"14159","45094","2016",8,8,0,152791.2,1434,119.375
"14160","45095","2016",25,24,1,124506.2,1542.28,87.36
"14161","45096","2016",10,10,0,94620,1093.6,91.1
"14162","45097","2016",17,17,0,94035.29,1051.588,94.70588
"14163","45098","2016",37,37,0,169650.5,1795.297,99.78378
"14164","45099","2016",10,10,0,194723,1435,122.3
"14165","45100","2016",6,6,0,282985,2722.333,114.1667
"14166","45101","2016",1,1,0,255700,1189,215
"14167","45102","2016",2,2,0,176000,1180,145
"14168","45103","2016",15,15,0,120200,1326.667,96.46667
"14169","45104","2016",24,24,0,140522.8,1328.25,107.5417
"14170","45107","2016",7,7,0,1e+05,1137.429,84.71429
"14171","45108","2016",16,16,0,105404.4,1478.25,73.8125
"14172","45109","2016",4,4,0,135500,1395.75,94.25
"14173","45110","2016",5,5,0,132200,1254.4,118
"14174","45111","2016",9,9,0,115222.2,1510.333,86.22222
"14175","45112","2016",1,1,0,145000,1408,103
"14176","45113","2016",4,4,0,93532.5,1259.75,75.5
"14177","45114","2016",3,3,0,179166.7,1835.667,105
"14178","45115","2016",64,64,0,115000.6,1224.75,99.3125
"14179","45116","2016",11,11,0,131790.9,1411.818,99
"14180","45118","2016",1,1,0,80000,1143,70
"14181","45119","2016",25,25,0,158336.6,1517.12,110.96
"14182","45120","2016",2,2,0,153425,1726,99
"14183","45121","2016",11,11,0,94943,1021.455,95.54545
"14184","45122","2016",11,11,0,106695.4,1217.455,97.63636
"14185","45123","2016",14,13,1,164571.4,1636.929,104.0714
"14186","45124","2016",4,4,0,142250,1659,86.5
"14187","45125","2016",1,1,0,255000,1861,137
"14188","45126","2016",33,32,1,197379.7,2036.576,102.6364
"14189","45127","2016",54,53,1,139962.3,1899.685,80.68519
"14190","45129","2016",18,18,0,90027.78,1268.056,78.27778
"14191","45130","2016",9,9,0,176788.9,2164.333,88.11111
"14192","45131","2016",14,14,0,138846.4,1550,92.07143
"14193","45132","2016",2,2,0,69000,1181.5,61
"14194","45133","2016",6,6,0,122833.3,1439,85.5
"14195","45134","2016",14,14,0,119171.4,1388.929,87
"14196","45135","2016",3,3,0,139500,1091,142.6667
"14197","45136","2016",13,13,0,131987,1610.385,85.92308
"14198","45137","2016",1,1,0,150000,625,240
"14199","45139","2016",11,11,0,190754.5,1416.091,124.6364
"14200","45141","2016",1,1,0,40000,400,100
"14201","45142","2016",45,43,2,199787.4,1763.378,118.3556
"14202","45143","2016",1,1,0,109800,594,185
"14203","45144","2016",9,9,0,153200,1775.222,96
"14204","45145","2016",38,37,1,140797.1,1609.5,90.44737
"14205","45146","2016",80,78,2,165185.9,1654.75,104.1
"14206","45147","2016",237,149,88,142982.4,1767.65,82.25316
"14207","45148","2016",24,24,0,114674,1391.917,84.83333
"14208","45149","2016",7,7,0,132452,1423.429,92.71429
"14209","45150","2016",2,2,0,94000,987.5,94.5
"14210","45151","2016",2,2,0,135000,813.5,159
"14211","45152","2016",1,1,0,169000,1610,105
"14212","45153","2016",6,6,0,121220,1654.5,74
"14213","45154","2016",21,21,0,191139.7,1895.952,105.0476
"14214","45155","2016",145,109,36,98878.56,1222.421,84.52414
"14215","45156","2016",3,3,0,178900,1690.667,123.3333
"14216","45157","2016",4,4,0,158675,1125.25,148.5
"14217","45158","2016",2,2,0,88500,1295,69.5
"14218","45159","2016",4,4,0,95325,1312.75,69.25
"14219","45160","2016",2,2,0,155000,1587.5,98
"14220","45161","2016",15,15,0,97580,1166.667,92.2
"14221","45162","2016",2,2,0,306500,1808.5,156
"14222","45164","2016",5,5,0,164900,1792,102.4
"14223","45165","2016",4,4,0,77437.5,756.5,100.5
"14224","45166","2016",3,3,0,222333.3,1750.333,127.6667
"14225","45167","2016",14,14,0,189531.4,1739.786,115.8571
"14226","45168","2016",8,8,0,119921.9,1229.875,97.375
"14227","45169","2016",68,64,4,205344.2,1943.897,107.1912
"14228","45170","2016",3,3,0,149666.7,1359.667,109.3333
"14229","45171","2016",8,8,0,115937.5,1106.25,104.25
"14230","45173","2016",72,66,6,166039.1,1712.5,99.38889
"14231","45174","2016",3,3,0,110000,1118.333,93.33333
"14232","45175","2016",16,16,0,243007.8,1952.688,134.625
"14233","45176","2016",5,5,0,127000,1262.6,110.6
"14234","45177","2016",1,1,0,160000,2000,80
"14235","45178","2016",12,12,0,106633.3,1330.167,82.41667
"14236","45179","2016",29,29,0,159897.5,1616.138,103.4483
"14237","45180","2016",1,1,0,110000,1028,107
"14238","45181","2016",1,1,0,35000,547,64
"14239","45182","2016",20,20,0,188665,2017.25,106.15
"14240","45183","2016",1,1,0,122000,1109,110
"14241","45184","2016",2,2,0,2e+05,1564.5,123
"14242","45185","2016",4,4,0,128500,1336,97
"14243","45186","2016",6,6,0,128833.3,1192,113.1667
"14244","45187","2016",38,37,1,107621.8,1203.079,97.47368
"14245","45188","2016",15,15,0,189345.3,1776.333,109.9333
"14246","45191","2016",95,76,19,148778.4,1765.242,93.09474
"14247","45193","2016",24,23,1,181990.8,2044.708,94.375
"14248","45194","2016",15,14,1,205038,1985.733,104.4667
"14249","45195","2016",6,6,0,128250,1616.333,101.8333
"14250","45196","2016",15,14,1,178836.7,1729.933,106.5333
"14251","45197","2016",13,13,0,199767.4,1935.385,107.3846
"14252","45198","2016",2,2,0,196000,1713.5,126
"14253","45199","2016",12,12,0,79416.67,1151.75,74.83333
"14254","45200","2016",28,28,0,210666,1795.036,124.6071
"14255","45201","2016",1,1,0,131000,2426,54
"14256","45202","2016",12,12,0,137695.3,1487.5,99.41667
"14257","45203","2016",71,62,9,147778.2,1648.915,91.07042
"14258","45204","2016",3,3,0,192766.7,1421,147
"14259","45205","2016",7,7,0,121514.3,1299.571,90.57143
"14260","45206","2016",5,5,0,119000,1344.4,88.4
"14261","45207","2016",6,6,0,131450,1281.167,103.5
"14262","45208","2016",166,63,103,97185.67,1466.283,71.66265
"14263","45209","2016",3,3,0,113086.7,1044.333,105.3333
"14264","45210","2016",8,8,0,81387.5,1077.625,73
"14265","45212","2016",15,15,0,142866,1474,99.6
"14266","45213","2016",13,13,0,149286.2,1636.231,95.15385
"14267","45215","2016",3,3,0,136416.7,966.3333,137
"14268","45216","2016",2,2,0,127500,1508,84.5
"14269","45217","2016",2,2,0,133000,1759,76.5
"14270","45218","2016",4,4,0,150500,1389.75,113.75
"14271","45219","2016",3,3,0,65666.67,911.3333,66.33333
"14272","45220","2016",6,6,0,108500,1106.167,97.5
"14273","45222","2016",19,19,0,142873.7,1425.474,101.9474
"14274","45223","2016",2,2,0,93000,1365,71.5
"14275","45224","2016",37,33,4,138252.4,1432.73,102.3243
"14276","45225","2016",3,3,0,218066.7,1361,167.6667
"14277","45226","2016",9,9,0,135944.4,1471.889,101.5556
"14278","45227","2016",8,8,0,133312.5,1426,96.5
"14279","45228","2016",14,14,0,125829.3,1245.714,103.4286
"14280","45229","2016",32,31,1,122323.8,1337.406,95.6875
"14281","45230","2016",5,5,0,105200,1410,74.8
"14282","45232","2016",284,156,128,179576.2,2038.092,87.94014
"14283","45233","2016",7,7,0,151685.7,1936,82.57143
"14284","45234","2016",1668,433,1235,139303.2,1978.493,71.51799
"14285","45235","2016",23,22,1,219533.3,2040,113.6087
"14286","45237","2016",6,6,0,128666.7,1491,84.33333
"14287","45238","2016",8,8,0,94000,1083.5,84.5
"14288","45239","2016",7,7,0,77500,991.5714,86.57143
"14289","45240","2016",17,17,0,116429.4,1439.588,84.23529
"14290","45241","2016",3,3,0,203533.3,1791.333,112
"14291","45242","2016",4,3,1,165225,1655,90.25
"14292","45243","2016",3,3,0,135333.3,1239.333,110
"14293","45244","2016",26,26,0,106533.8,1431.615,78.84615
"14294","45245","2016",17,16,1,119362.8,1348,86.47059
"14295","45246","2016",1,1,0,73000,1281,57
"14296","45247","2016",25,25,0,137238.5,1503.36,92.68
"14297","45248","2016",14,13,1,139914.3,1510.429,91.64286
"14298","45249","2016",4,4,0,205500,1646.25,123.75
"14299","45250","2016",1,1,0,95000,1188,80
"14300","45251","2016",2,2,0,158500,997,157
"14301","45252","2016",52,33,19,104810.2,1299.538,85.90385
"14302","45253","2016",12,12,0,158958.3,1431,117.6667
"14303","45254","2016",20,20,0,141751,1460.3,100.4
"14304","45255","2016",4,4,0,146750,1422.75,110.25
"14305","45256","2016",2,2,0,142500,1170,123
"14306","45257","2016",7,7,0,163642.9,1213.429,138.4286
"14307","45258","2016",28,27,1,135637.5,1514.321,95.57143
"14308","45259","2016",6,6,0,134500,1485.667,90.66667
"14309","45260","2016",2,2,0,126000,1173.5,103
"14310","45261","2016",13,13,0,194543.5,1691.769,117.3077
"14311","45262","2016",1,1,0,115000,1045,110
"14312","45263","2016",3,2,1,155333.3,2160.333,78.66667
"14313","45264","2016",4,4,0,151250,1484.25,105.5
"14314","45265","2016",4,4,0,121250,1649.5,73.25
"14315","45266","2016",2,2,0,164000,1841,92.5
"14316","45268","2016",8,8,0,102938.8,1243.375,81.625
"14317","45269","2016",43,41,2,166084.9,1682.186,104.1395
"14318","45270","2016",17,17,0,128977.7,1305.176,101.4706
"14319","45271","2016",11,11,0,110021.8,1215.455,89.36364
"14320","45272","2016",19,19,0,239965.8,2068.316,122.3158
"14321","45273","2016",36,32,4,161018.6,1738.111,95.88889
"14322","45274","2016",69,66,3,210960.5,2128.899,105.7971
"14323","45275","2016",8,8,0,100875,1132.875,92
"14324","45276","2016",7,7,0,93414.29,1085.286,89.14286
"14325","45277","2016",5,5,0,82539.8,1156.6,69.2
"14326","45278","2016",14,14,0,78157.14,988.3571,81.42857
"14327","45279","2016",21,21,0,121367.6,1450.333,85.42857
"14328","45280","2016",16,16,0,124197.1,1308.375,97.3125
"14329","45281","2016",10,10,0,113300,1304.8,96.8
"14330","45282","2016",28,21,7,207614.8,2233.071,95.03571
"14331","45283","2016",3,3,0,131666.7,1128.333,115.6667
"14332","45284","2016",258,115,143,141904.5,1786.798,79.87597
"14333","45285","2016",147,74,73,129917.9,1671.844,78.85034
"14334","45286","2016",141,67,74,157119.7,1906.965,81.60284
"14335","45288","2016",4,4,0,97750,1084.25,91.5
"14336","45289","2016",12,12,0,147757.5,1491.167,105
"14337","45290","2016",13,13,0,162851.7,1711.923,97.07692
"14338","45291","2016",14,14,0,108785.7,1280.5,85.14286
"14339","45292","2016",11,11,0,93741.82,1257.636,75.36364
"14340","45293","2016",15,15,0,137494.3,1279.867,111.6
"14341","45294","2016",1,1,0,65000,1048,62
"14342","45296","2016",13,13,0,155108.2,1505.846,106.5385
"14343","45297","2016",6,6,0,116008.3,1385.667,94
"14344","45298","2016",55,38,17,179171.4,2047,86.10909
"14345","45299","2016",5,5,0,104800,1067,107.2
"14346","45300","2016",33,33,0,205366.7,1871.455,114.7273
"14347","45301","2016",6,6,0,142463.3,1728.833,91.83333
"14348","45302","2016",138,111,27,159486.2,1987.145,83.24638
"14349","45303","2016",7,7,0,136100,1140.143,130.4286
"14350","45305","2016",6,6,0,116695,1246.5,97.5
"14351","45306","2016",11,11,0,103727.3,1090.818,99.09091
"14352","45307","2016",13,13,0,106746.9,1182.077,105.9231
"14353","45308","2016",31,25,6,181247,1740,106.6774
"14354","45309","2016",5,5,0,139004,1454.6,102.6
"14355","45310","2016",21,21,0,163929,1775.333,103.1905
"14356","45311","2016",8,8,0,162471.2,1437.375,114
"14357","45312","2016",2,2,0,127500,1150,112.5
"14358","45313","2016",10,10,0,135354.7,1345.6,96.7
"14359","45314","2016",7,7,0,158714.3,1858.714,103.7143
"14360","45315","2016",49,43,6,138456,1661.388,92.02041
"14361","45316","2016",11,11,0,166379.5,1662.636,112.4545
"14362","45317","2016",14,14,0,178703.6,1740.357,102.1429
"14363","45320","2016",4,4,0,143250,1757.5,84.75
"14364","45321","2016",4,4,0,126625,1446.75,123.5
"14365","45322","2016",3,3,0,104833.3,1035.667,102.6667
"14366","45323","2016",4,4,0,185750,2202,65.5
"14367","45324","2016",9,9,0,354574,2074.444,147.5556
"14368","45325","2016",9,9,0,148477.8,1481.556,101.1111
"14369","45326","2016",6,6,0,161066.7,1149.333,142
"14370","45327","2016",30,30,0,165862,1633.967,103.8667
"14371","45328","2016",4,4,0,150410,1547.25,136.25
"14372","45329","2016",20,20,0,116710,1251.3,96.45
"14373","45330","2016",3,3,0,141000,1526,90
"14374","45331","2016",14,14,0,108671.4,1354.071,93.64286
"14375","45332","2016",23,23,0,134026.5,1358.826,104.7391
"14376","45333","2016",8,8,0,184712.5,2113.625,92.375
"14377","45334","2016",2,2,0,187125,1846,104
"14378","45335","2016",22,22,0,200956.1,1956.591,103.8636
"14379","45336","2016",14,14,0,142933.4,1502.5,97.28571
"14380","45337","2016",5,5,0,103600,918.2,122.8
"14381","45338","2016",69,63,6,134004.4,1695.594,82.65217
"14382","45339","2016",3,3,0,221666.7,2356,98.33333
"14383","45340","2016",6,6,0,363333.3,3059,104.5
"14384","45341","2016",1,1,0,2e+05,1429,140
"14385","45342","2016",1,1,0,84000,712,118
"14386","45343","2016",3,3,0,131500,935.6667,126.3333
"14387","45344","2016",9,9,0,149155.6,1505.667,101.7778
"14388","45345","2016",9,9,0,182765.4,1795.889,110.8889
"14389","45346","2016",25,25,0,147072.7,1579.04,94.92
"14390","45347","2016",9,9,0,145910.4,1529.444,103.2222
"14391","45348","2016",10,10,0,190150,1606.8,122
"14392","46001","2016",8,8,0,123262.5,1297.125,93.875
"14393","46002","2016",2,2,0,99000,1311,74
"14394","46003","2016",4,4,0,144587.5,1281.75,117
"14395","46004","2016",1,1,0,150001,1389,108
"14396","46005","2016",6,6,0,126615,1409,92.66667
"14397","46006","2016",4,4,0,156125,1515.5,89.25
"14398","46007","2016",6,6,0,180800,1518.833,126.6667
"14399","46008","2016",3,3,0,88666.67,1087.667,84.66667
"14400","46009","2016",10,10,0,121279,1225.8,99.8
"14401","46010","2016",1,1,0,130000,1398,93
"14402","46011","2016",1,1,0,30000,789,38
"14403","46012","2016",6,6,0,70500,814.6667,70.66667
"14404","46013","2016",1,1,0,165000,2062,80
"14405","46015","2016",13,13,0,107269.2,1173.154,99.46154
"14406","46016","2016",4,4,0,154210,1587.75,99.5
"14407","46020","2016",3,3,0,85533.33,1717.667,83.33333
"14408","46021","2016",5,5,0,138350,1296.8,110
"14409","46022","2016",4,4,0,124557.5,1415.75,89
"14410","46023","2016",6,6,0,188816.7,2337.833,89.33333
"14411","46024","2016",3,3,0,228566.7,1880,135.3333
"14412","46026","2016",1,1,0,40000,385,104
"14413","46028","2016",16,16,0,114005.2,1206.812,96.6875
"14414","46029","2016",12,12,0,151175.3,1397.25,112.25
"14415","46030","2016",2,2,0,230000,1720.5,135.5
"14416","46031","2016",4,4,0,127048.8,1171.75,106.25
"14417","46032","2016",2,2,0,147500,1899.5,79
"14418","46033","2016",2,2,0,92500,959.5,110
"14419","46034","2016",1,1,0,269000,1416,190
"14420","46035","2016",2,2,0,117000,1400,82.5
"14421","46036","2016",2,2,0,185975,1487.5,133.5
"14422","46037","2016",2,2,0,137600,2104,64.5
"14423","46038","2016",14,14,0,124000,1326,92.42857
"14424","46039","2016",1,1,0,2e+05,1887,106
"14425","46040","2016",3,3,0,132200,1645.333,83
"14426","46041","2016",3,3,0,81500,954.6667,85
"14427","46042","2016",264,135,129,115817.6,1375.208,81.70455
"14428","46043","2016",2,2,0,1e+05,1239.5,80
"14429","46044","2016",5,5,0,126940,1246,99.8
"14430","46045","2016",11,9,2,142454.5,1631.909,87.54545
"14431","46046","2016",2,2,0,109000,1001.5,107.5
"14432","46047","2016",2,2,0,248000,2329,108
"14433","46049","2016",3,3,0,106666.7,2192,49.66667
"14434","46050","2016",3,3,0,192380,1850.667,121.3333
"14435","46051","2016",3,3,0,60000,908.3333,65.66667
"14436","46052","2016",3,3,0,125000,1303.667,89
"14437","46053","2016",2,2,0,145000,1298,117
"14438","46054","2016",7,7,0,144307.1,1573.571,98.57143
"14439","46055","2016",5,5,0,265410,1642.2,160.2
"14440","46056","2016",1,1,0,1e+05,870,115
"14441","46057","2016",3,2,1,197858.3,1792.667,96.33333
"14442","46058","2016",7,7,0,102870,1182,82
"14443","46060","2016",4,4,0,129500,1504,98.25
"14444","46061","2016",1,1,0,860432,3211,268
"14445","46062","2016",6,5,1,111960.5,1181.167,94.66667
"14446","46063","2016",12,11,1,122796.7,1504.75,75.5
"14447","46064","2016",12,12,0,130045.8,1390.833,91.83333
"14448","46065","2016",10,10,0,148295,1718,85.8
"14449","46066","2016",12,12,0,142125,1675.667,90.5
"14450","46068","2016",3,3,0,93846.67,1401.333,69.33333
"14451","46069","2016",1,1,0,1e+05,840,119
"14452","46070","2016",5,5,0,182080,1958.8,106.8
"14453","46072","2016",5,5,0,133800,1029.2,124.2
"14454","46073","2016",7,6,1,118285.7,1186.571,112.7143
"14455","46074","2016",5,5,0,98800,1314.2,78.6
"14456","46075","2016",5,5,0,195690,1844,99.2
"14457","46076","2016",3,3,0,144986.7,861,161.6667
"14458","46080","2016",6,6,0,176296.3,1278.667,121.5
"14459","46081","2016",2,2,0,232000,2804,77
"14460","46082","2016",6,6,0,194250,1679.5,114.6667
"14461","46083","2016",8,8,0,140405,1346,112.125
"14462","46084","2016",7,7,0,184021.4,1273.571,134.1429
"14463","46085","2016",3,3,0,74766.67,894.3333,81.66667
"14464","46086","2016",4,4,0,131900,1227.75,109.5
"14465","46087","2016",4,4,0,121068.8,1221.5,97.25
"14466","46088","2016",7,7,0,119735.7,1186.714,106.4286
"14467","46089","2016",14,13,1,128879.9,1222,106.7857
"14468","46090","2016",3,3,0,90000,1708.333,58.33333
"14469","46091","2016",2,2,0,137500,1278,100
"14470","46092","2016",2,2,0,84800,2160.5,58
"14471","46093","2016",1,1,0,150000,1200,125
"14472","46094","2016",3,3,0,116000,1946,70
"14473","46095","2016",9,9,0,174155.6,1551.222,112.6667
"14474","46096","2016",1,1,0,224000,1556,144
"14475","46097","2016",1,1,0,26738,357,75
"14476","46098","2016",3,3,0,159500,2184.333,73.66667
"14477","46100","2016",6,6,0,176841.7,1616.667,109.3333
"14478","46101","2016",3,3,0,132000,1458.333,88
"14479","46102","2016",119,69,50,116764.4,1498.748,82.54622
"14480","46103","2016",7,7,0,157929.4,1499.714,116.5714
"14481","46104","2016",1,1,0,322000,1533,210
"14482","46105","2016",10,10,0,215885,1757.2,121.2
"14483","46106","2016",2,2,0,87000,1053.5,82
"14484","46108","2016",6,6,0,93800,1486.167,65.83333
"14485","46109","2016",7,7,0,80866.86,996.2857,85.28571
"14486","46111","2016",1,1,0,115120,1175,98
"14487","46113","2016",3,3,0,135050,1529.667,92.33333
"14488","46114","2016",6,6,0,157539.8,1440.667,116.3333
"14489","46115","2016",1,1,0,95000,1173,81
"14490","46116","2016",1,1,0,85000,1062,80
"14491","46117","2016",6,6,0,126216.7,1074.833,114.8333
"14492","46118","2016",5,5,0,116200,1246.6,102
"14493","46119","2016",2,2,0,140000,1952.5,75
"14494","46120","2016",2,2,0,183925,2010.5,91
"14495","46123","2016",2,2,0,93000,2269,40.5
"14496","46124","2016",2,2,0,207500,1734.5,122.5
"14497","46126","2016",2,2,0,161225,1495,106.5
"14498","46127","2016",51,44,7,129219.6,1406.255,90.27451
"14499","46128","2016",31,28,3,117058.1,1310.323,92.70968
"14500","46129","2016",3,3,0,131000,1349.333,91.33333
"14501","46130","2016",8,8,0,136411.9,1177.875,118.625
"14502","46131","2016",1,1,0,165000,954,173
"14503","46132","2016",4,4,0,134462.5,1050,139.75
"14504","46133","2016",1,1,0,255950,2461,104
"14505","46134","2016",5,5,0,144400,1313.2,114.6
"14506","46136","2016",6,6,0,159645.8,1512.667,88.83333
"14507","46137","2016",6,6,0,202883.3,1749.333,115.5
"14508","46138","2016",10,9,1,148848,1565.7,95
"14509","46140","2016",4,4,0,173625,1400,122.25
"14510","46142","2016",1,1,0,203000,1692,120
"14511","46143","2016",9,9,0,135588.9,1366.889,102.3333
"14512","46144","2016",3,3,0,127000,1550,86.33333
"14513","46145","2016",7,7,0,114000,1045.857,107.7143
"14514","46146","2016",1,1,0,92700,1144,81
"14515","46147","2016",1,1,0,181000,1645,110
"14516","46148","2016",17,17,0,139917.2,1717.235,86.05882
"14517","46149","2016",3,3,0,180650,1766.333,99.33333
"14518","46151","2016",1,1,0,99090,1982,50
"14519","46152","2016",6,6,0,102915,993.3333,99.5
"14520","46153","2016",7,7,0,110285.7,1221.714,94.71429
"14521","46154","2016",5,5,0,203300,1405.2,145.6
"14522","46155","2016",3,2,1,73400,1150,66.66667
"14523","46156","2016",15,15,0,142553.3,1314.2,102
"14524","46157","2016",2,2,0,85000,1505.5,69.5
"14525","46159","2016",1,1,0,69000,657,105
"14526","46160","2016",2,2,0,81350,1801.5,47
"14527","46161","2016",4,4,0,107275,1056,98.75
"14528","46162","2016",3,3,0,102666.7,1272.667,80.66667
"14529","46163","2016",6,6,0,108933.3,1179.5,92.66667
"14530","46164","2016",2,2,0,55000,644.5,88
"14531","46165","2016",3,3,0,119166.7,1148.333,108.6667
"14532","46169","2016",1,1,0,287500,2054,140
"14533","46170","2016",4,4,0,125700,1185,105.25
"14534","46171","2016",6,6,0,83250,817.3333,92.16667
"14535","46172","2016",6,6,0,140173.5,1418.5,99.66667
"14536","46173","2016",10,8,2,135000,1367.2,96.5
"14537","46174","2016",1,1,0,164563,1431,115
"14538","46175","2016",6,6,0,156983.3,1874.167,83.5
"14539","46176","2016",6,5,1,117683.3,1194,98.66667
"14540","46177","2016",6,6,0,210458.3,1880.333,131.1667
"14541","46178","2016",4,4,0,156802.5,1342.25,117.25
"14542","46179","2016",2,2,0,73250,694.5,96.5
"14543","46180","2016",2,2,0,216500,1880,112.5
"14544","46181","2016",2,2,0,110500,1567,70.5
"14545","46182","2016",14,14,0,189180.4,1475.643,131.5714
"14546","46183","2016",3,3,0,158782.7,1312.667,121
"14547","46184","2016",5,5,0,218900,2219.6,95
"14548","46185","2016",23,23,0,160363.9,1422.13,115.1739
"14549","46186","2016",1,1,0,86100,1913,45
"14550","46187","2016",3,3,0,84666.67,1011.333,87.33333
"14551","46188","2016",2,2,0,177500,1825.5,98.5
"14552","46189","2016",6,6,0,107510.7,1368.833,91.66667
"14553","46190","2016",1,1,0,138000,1408,98
"14554","46191","2016",13,13,0,114028.8,1304.385,87.23077
"14555","46192","2016",4,4,0,125896.2,1382.5,92.25
"14556","46193","2016",8,8,0,153297.6,1161.875,116.75
"14557","46194","2016",6,5,1,151915,1521,95.5
"14558","46197","2016",14,14,0,204054.8,1999,103.9286
"14559","46198","2016",1,1,0,203000,1173,173
"14560","46199","2016",8,8,0,234750,1852.125,135.875
"14561","46200","2016",3,3,0,124666.7,1746.667,70.33333
"14562","46201","2016",24,23,1,162370.1,1323.875,126
"14563","46202","2016",5,5,0,129570,957,137.2
"14564","46204","2016",5,5,0,135100,880.2,156.2
"14565","46205","2016",7,7,0,156467.9,1606.857,92
"14566","46208","2016",1,1,0,146000,1404,104
"14567","46209","2016",1,1,0,245000,2042,120
"14568","46210","2016",3,3,0,72333.33,815,88
"14569","46211","2016",3,3,0,167666.7,1238,137.3333
"14570","46212","2016",4,4,0,58125,878.5,72.75
"14571","46213","2016",2,2,0,119500,1263.5,90
"14572","46214","2016",4,4,0,138750,1091.75,124
"14573","46215","2016",4,4,0,138500,1459.75,92.75
"14574","46216","2016",8,8,0,148521.9,1611,106.125
"14575","46218","2016",1,1,0,118000,1967,60
"14576","46219","2016",5,5,0,158000,1612.2,95.8
"14577","46220","2016",4,4,0,116000,1223.25,100
"14578","46221","2016",3,3,0,144408,1315,109
"14579","46222","2016",1,1,0,120000,1188,101
"14580","46224","2016",30,25,5,148107,1962.533,84.46667
"14581","46225","2016",29,29,0,180682.4,1826.276,106.1724
"14582","46226","2016",1,1,0,96000,1433,67
"14583","46227","2016",5,5,0,151860,1932.8,82.2
"14584","46228","2016",10,10,0,160652,1613.9,103.5
"14585","46229","2016",13,13,0,129015.4,1425.692,97.30769
"14586","46230","2016",1,1,0,120150,1414,85
"14587","46231","2016",33,29,4,126817.4,1181.667,109.4242
"14588","46232","2016",11,10,1,160918.2,1729.091,102.7273
"14589","46235","2016",1,1,0,85000,1417,60
"14590","46236","2016",2,2,0,140000,1505,92
"14591","46237","2016",1,1,0,171000,1541,111
"14592","46238","2016",4,4,0,96250,1283,66.75
"14593","46239","2016",3,3,0,51000,1090.333,55.33333
"14594","46240","2016",9,9,0,153442.8,1462.444,93.33333
"14595","46241","2016",4,4,0,198862.5,1441.75,126.75
"14596","46242","2016",4,4,0,86250,918.75,98
"14597","46246","2016",2,2,0,255000,1477,172.5
"14598","46247","2016",1,1,0,176000,1128,156
"14599","46250","2016",1,1,0,132500,1104,120
"14600","46251","2016",35,29,6,102112.1,1144.829,90.54286
"14601","46252","2016",8,8,0,168246.4,1682.25,102.75
"14602","46253","2016",4,4,0,114220,1000,108
"14603","46254","2016",2,2,0,102750,1656.5,54
"14604","46255","2016",4,4,0,132417.5,1152.25,106.5
"14605","46256","2016",4,4,0,295000,2929.25,110
"14606","46257","2016",2,2,0,146500,1128,125.5
"14607","46258","2016",1,1,0,45000,738,61
"14608","46260","2016",2,2,0,85300,768.5,135.5
"14609","46262","2016",5,5,0,182900,1387.4,127.8
"14610","46263","2016",2,2,0,103600,943,108.5
"14611","46264","2016",1,1,0,33500,558,60
"14612","46265","2016",4,4,0,121237.5,1322.25,102.75
"14613","46266","2016",1,1,0,90000,1915,47
"14614","46267","2016",8,8,0,118687.5,1136.375,105.375
"14615","46268","2016",7,7,0,176578.6,1486.429,107.7143
"14616","46269","2016",1,1,0,42400,652,65
"14617","46270","2016",3,3,0,195666.7,1635,124
"14618","46271","2016",5,5,0,180080,1970.8,87
"14619","46272","2016",3,3,0,93140,1120,81
"14620","46273","2016",11,10,1,143081.8,1368.091,101.0909
"14621","46276","2016",5,5,0,153354.6,1476.8,102.2
"14622","46277","2016",3,3,0,98333.33,1427.333,70.33333
"14623","46279","2016",2,2,0,71000,806.5,90
"14624","46280","2016",1,1,0,59850,965,62
"14625","46281","2016",3,3,0,104733.3,1239.667,80.66667
"14626","46282","2016",2,2,0,50000,451.5,110
"14627","46283","2016",1,1,0,97000,808,120
"14628","46284","2016",3,3,0,135750,1147,112
"14629","46286","2016",2,2,0,82500,1277,64.5
"14630","46288","2016",1,1,0,120000,1200,100
"14631","46289","2016",3,3,0,105033.3,1424.667,71.66667
"14632","46290","2016",2,2,0,80050,1366,56.5
"14633","46292","2016",5,5,0,172350,1470.6,115.8
"14634","46293","2016",8,8,0,137200,1568.875,89.5
"14635","46294","2016",2,2,0,100200,785,126.5
"14636","46295","2016",2,2,0,125525,1318,96
"14637","46296","2016",9,8,1,179722.2,1356.222,131.6667
"14638","46297","2016",12,12,0,117191.7,1548.25,85.16667
"14639","46299","2016",2,2,0,67640.5,851,117.5
"14640","46301","2016",7,7,0,244800,2156.714,115.7143
"14641","46304","2016",2,2,0,81370,1787.5,46
"14642","46305","2016",1,1,0,2e+05,1290,155
"14643","46306","2016",2,2,0,156000,1321,120.5
"14644","46307","2016",7,7,0,104142.1,1387,80.28571
"14645","46309","2016",37,30,7,107919.9,1476.73,85.51351
"14646","46311","2016",14,14,0,92475.14,1299.857,84
"14647","46312","2016",7,7,0,147157.1,1455,104.5714
"14648","46313","2016",5,5,0,116300,1152.2,107.4
"14649","46314","2016",2,2,0,65000,676,96
"14650","46315","2016",2,2,0,73084,1101,60
"14651","46316","2016",3,3,0,100850,1263.333,75.66667
"14652","46317","2016",4,4,0,147750,2158.25,73
"14653","46318","2016",3,3,0,134000,909.6667,111
"14654","46319","2016",2,2,0,109850,1597,68
"14655","46320","2016",3,3,0,192233.3,1637.667,122
"14656","46321","2016",4,4,0,107350,1171.25,96
"14657","46322","2016",7,7,0,146307.1,1575.714,103.4286
"14658","46323","2016",1,1,0,142450,1187,120
"14659","46324","2016",4,4,0,129250,1607.25,82.75
"14660","46328","2016",3,3,0,108666.7,1132.333,103.3333
"14661","46329","2016",1,1,0,89000,2543,35
"14662","46330","2016",14,14,0,136501.4,1286.571,107.4286
"14663","46332","2016",8,8,0,126875,1247.625,101.5
"14664","46333","2016",1,1,0,53000,815,65
"14665","46334","2016",12,12,0,164925,1557.667,108.5
"14666","46335","2016",6,6,0,223000,1850.5,116.1667
"14667","46337","2016",4,4,0,212530,1580.75,132.25
"14668","46339","2016",3,3,0,96900,1097.333,83.33333
"14669","46340","2016",2,2,0,321425,3298,107.5
"14670","47001","2016",534,222,312,99003.31,1336.049,73.99813
"14671","47002","2016",1,1,0,140000,1085,129
"14672","47003","2016",3,3,0,151333.3,1278,140
"14673","47004","2016",44,42,2,108825,1088.5,107.1364
"14674","47005","2016",5,5,0,129080,1338.4,113
"14675","47006","2016",3,3,0,144766.7,1095.667,144.3333
"14676","47007","2016",1,1,0,254000,2419,105
"14677","47008","2016",3,3,0,116666.7,966,112
"14678","47009","2016",3,3,0,76000,704.6667,109
"14679","47010","2016",1,1,0,50000,481,104
"14680","47011","2016",3,3,0,92666.67,893.3333,110.3333
"14681","47012","2016",6,6,0,138628.3,1419.167,107.5
"14682","47013","2016",6,5,1,196816.7,1600,121.6667
"14683","47014","2016",3,3,0,152666.7,1283.667,127.3333
"14684","47015","2016",13,13,0,110243.8,1109.923,101.0769
"14685","47016","2016",7,7,0,204555.7,1589.143,129.2857
"14686","47017","2016",8,8,0,184162.5,1598.875,124.75
"14687","47018","2016",2,2,0,154008.5,1142,136
"14688","47019","2016",9,9,0,166876.6,1705.333,99.88889
"14689","47020","2016",4,4,0,128682.2,1180,105.75
"14690","47021","2016",16,16,0,116122.1,1295.312,86.9375
"14691","47022","2016",4,4,0,144525,1459.5,100
"14692","47023","2016",2,2,0,187000,1774.5,109.5
"14693","47024","2016",18,18,0,180139.4,1562.944,118.8889
"14694","47025","2016",6,6,0,148033.3,1528.833,96.66667
"14695","47026","2016",3,3,0,31666.67,533.6667,56.33333
"14696","47027","2016",38,38,0,128196.8,1315.684,98.76316
"14697","47028","2016",6,6,0,162105,1469.667,108.6667
"14698","47029","2016",7,7,0,182095.7,1709.286,96.42857
"14699","47030","2016",1,1,0,250000,1724,145
"14700","47031","2016",50,49,1,152267.3,1576.44,100.12
"14701","47032","2016",84,81,3,170116.5,1633.357,101.9167
"14702","47033","2016",2,2,0,90000,1044.5,80
"14703","47034","2016",3,3,0,145033.3,1241.667,123.6667
"14704","47035","2016",4,4,0,114036.2,1270,89.75
"14705","47036","2016",3,3,0,154296.7,1067.667,147.6667
"14706","47037","2016",1,1,0,90000,647,139
"14707","47038","2016",6,6,0,122058.3,1300.5,93
"14708","47040","2016",14,14,0,169424.3,1573.429,110.7857
"14709","47041","2016",7,7,0,125000,1234.857,106
"14710","47042","2016",2,2,0,160500,837,192.5
"14711","47043","2016",10,9,1,86700,920.3,101.5
"14712","47044","2016",5,5,0,213250,1422.4,132.8
"14713","47045","2016",3,3,0,107248,1452,85.66667
"14714","47046","2016",4,4,0,104900,1025.25,101.25
"14715","47047","2016",2,2,0,276700,1722.5,161.5
"14716","47048","2016",11,11,0,138176.4,1255.909,122.9091
"14717","47049","2016",30,29,1,129666.8,1261.5,96.63333
"14718","47050","2016",2,2,0,302000,1516.5,200.5
"14719","47051","2016",30,20,10,151639.3,1488.633,95.8
"14720","47052","2016",44,35,9,126559.1,1387.273,96.15909
"14721","47053","2016",3,3,0,156300,1726,92
"14722","47054","2016",20,20,0,116327.5,1131.2,105.1
"14723","47055","2016",5,3,2,190836,1227.6,133
"14724","47056","2016",8,8,0,140775,1318.5,103.125
"14725","47057","2016",16,15,1,98208.19,945.125,112.125
"14726","47058","2016",7,7,0,170831.4,1469.571,111.7143
"14727","47059","2016",1,1,0,549000,1771,310
"14728","47060","2016",3,3,0,135250,1246.333,108.3333
"14729","47061","2016",11,11,0,114690.9,1090.909,101.1818
"14730","47062","2016",1,1,0,175000,1423,123
"14731","47063","2016",1,1,0,126000,1658,76
"14732","47064","2016",2,2,0,127000,1188,107.5
"14733","47065","2016",26,24,2,116998.1,1179.731,107.3846
"14734","47066","2016",7,7,0,179763.3,1450.286,122.2857
"14735","47067","2016",3,3,0,112700,1171,96.33333
"14736","47068","2016",14,13,1,96892.86,1013.929,107.5714
"14737","47069","2016",19,17,2,138273.7,1412.684,103.4211
"14738","47070","2016",9,9,0,127450,1039.222,113.7778
"14739","47071","2016",2,2,0,85500,1150.5,83.5
"14740","47074","2016",5,5,0,79600,1026,78.2
"14741","47075","2016",11,11,0,138275,1464.273,95.36364
"14742","47076","2016",2,2,0,214220,1461,147.5
"14743","47077","2016",9,9,0,150947.8,1353.889,100.5556
"14744","47078","2016",13,13,0,98542.31,1009.308,97.69231
"14745","47079","2016",11,11,0,144431.8,1430.818,98.90909
"14746","47080","2016",3,3,0,122333.3,1287.667,95
"14747","47081","2016",5,5,0,207900,1326.2,158.6
"14748","47082","2016",3,3,0,248850,1788,145
"14749","47083","2016",1,1,0,2e+05,1242,161
"14750","47084","2016",4,4,0,212973.8,1690,126.25
"14751","47085","2016",3,3,0,81000,1243.667,66
"14752","47086","2016",15,13,2,111536.3,1088.133,107.6667
"14753","47087","2016",2,2,0,83275,1056,78.5
"14754","47088","2016",13,12,1,130179.2,1201.308,124.6154
"14755","47089","2016",1,1,0,168000,848,198
"14756","47090","2016",3,3,0,78333.33,1131,61.33333
"14757","47091","2016",14,10,4,143873.6,1594.643,87.64286
"14758","47092","2016",2,2,0,157500,1229,127.5
"14759","47093","2016",1,1,0,124800,998,125
"14760","47094","2016",5,5,0,92728.2,1150.4,87.2
"14761","47095","2016",4,4,0,166500,1654.75,94.75
"14762","47096","2016",2,2,0,163500,1494.5,128
"14763","47097","2016",8,8,0,141237.5,1234.875,111.125
"14764","47098","2016",2,2,0,280500,1993,141
"14765","47099","2016",5,5,0,165100,1339.4,134.8
"14766","47100","2016",49,49,0,180497.9,1770.551,101.9388
"14767","47101","2016",11,11,0,120490.9,1265.545,97.27273
"14768","47102","2016",9,9,0,154954.2,1292.556,126.3333
"14769","47103","2016",1,1,0,50000,833,60
"14770","47104","2016",1,1,0,48000,453,106
"14771","47105","2016",2,2,0,146000,1030.5,138
"14772","47106","2016",58,55,3,88553.45,971.7414,91.55172
"14773","47108","2016",1,1,0,105000,1875,56
"14774","47109","2016",1,1,0,269000,2538,106
"14775","47110","2016",15,15,0,128571.7,1228.467,111.4667
"14776","47111","2016",3,3,0,63333.33,727.6667,91.33333
"14777","47112","2016",6,6,0,105783.3,779.8333,134.3333
"14778","47113","2016",2,2,0,189000,1413.5,128
"14779","47114","2016",4,4,0,201250,2021.5,103.5
"14780","47115","2016",1,1,0,140000,1489,94
"14781","47117","2016",8,8,0,169284.1,1575.125,109.125
"14782","47118","2016",2,2,0,105000,1128,97.5
"14783","47119","2016",5,5,0,93010,987,99.6
"14784","47120","2016",2,2,0,88546,1362,65.5
"14785","47121","2016",4,4,0,157762.5,1461.25,108.5
"14786","47122","2016",2,2,0,139250,1370.5,101.5
"14787","47123","2016",5,5,0,132000,1362,97.2
"14788","47124","2016",1,1,0,80000,870,92
"14789","47125","2016",3,3,0,90666.67,1290.333,70.33333
"14790","47127","2016",10,10,0,94196.7,948.3,100.8
"14791","47128","2016",24,18,6,127776,1527.875,86.875
"14792","47129","2016",3,3,0,102263,1050,100.6667
"14793","47130","2016",4,4,0,101250,819.5,126.25
"14794","47131","2016",8,8,0,154468.8,1271.375,118.125
"14795","47132","2016",4,4,0,209403,1349,157
"14796","47133","2016",3,3,0,137333.3,1245.667,105.3333
"14797","47134","2016",3,3,0,135000,1273.333,108
"14798","47135","2016",1,1,0,250000,1938,129
"14799","47136","2016",1,1,0,140000,1250,112
"14800","47137","2016",13,13,0,113933.6,1212,91.07692
"14801","47138","2016",17,17,0,154649.1,1438.059,109
"14802","47139","2016",1,1,0,213000,1151,185
"14803","47140","2016",8,8,0,158270.6,1525.375,104.375
"14804","47141","2016",3,3,0,193333.3,1614.333,120
"14805","47142","2016",14,14,0,144189.3,1146.5,129.1429
"14806","47143","2016",22,22,0,117653.2,1094.591,106.0455
"14807","47144","2016",9,9,0,139413.9,1136.778,112.2222
"14808","47145","2016",33,29,4,158912.3,1404.364,108.5455
"14809","47146","2016",11,11,0,153090.9,1331.091,118.1818
"14810","47147","2016",4,4,0,211423.5,1637.5,128.5
"14811","47148","2016",1,1,0,66000,733,90
"14812","47150","2016",2,2,0,140750,1527.5,91.5
"14813","47151","2016",7,7,0,172804.6,1855.286,115.8571
"14814","47152","2016",5,5,0,78740,665,115.2
"14815","47154","2016",1,1,0,95000,1900,50
"14816","47155","2016",7,7,0,246169.3,2756.571,102.8571
"14817","47156","2016",8,8,0,141975,1311.625,106.75
"14818","47157","2016",227,178,49,112474.5,1244.819,90.82819
"14819","47159","2016",14,14,0,116614.3,1136.5,105.7857
"14820","47160","2016",4,4,0,235125,1992.5,122.75
"14821","47161","2016",1,1,0,325000,1806,180
"14822","47163","2016",3,3,0,105833.3,1404.333,78
"14823","47165","2016",14,13,1,118353.6,1237.714,96
"14824","47167","2016",18,18,0,79499,852.9444,92.55556
"14825","47168","2016",48,44,4,84642.29,1017.5,82.4375
"14826","47169","2016",11,11,0,190368.2,1698.909,121.3636
"14827","47170","2016",13,13,0,123418.2,1110.615,111.9231
"14828","47171","2016",2,2,0,178957.5,2143.5,83.5
"14829","47172","2016",7,7,0,233054.3,2091.857,121.5714
"14830","47173","2016",4,4,0,63500,619,100.25
"14831","47174","2016",7,7,0,115761.9,1261,86.42857
"14832","47175","2016",27,27,0,131503.7,1253.222,106.1852
"14833","47176","2016",1,1,0,80000,533,150
"14834","47178","2016",5,5,0,103780,1030.8,92.6
"14835","47179","2016",23,22,1,99297.83,998,97.30435
"14836","47180","2016",3,3,0,163333.3,1801.667,97.33333
"14837","47181","2016",2,2,0,320000,2428,131
"14838","47182","2016",3,3,0,126333.3,1393.333,91.66667
"14839","47183","2016",2,2,0,141000,1463.5,96.5
"14840","47184","2016",1,1,0,135000,1286,105
"14841","47185","2016",36,36,0,94966.67,1146.889,84.83333
"14842","47186","2016",1,1,0,320000,2078,154
"14843","47187","2016",5,5,0,170000,1410.8,129
"14844","47188","2016",1,1,0,170000,1453,117
"14845","47189","2016",3,3,0,189833.3,2422.667,86.66667
"14846","47190","2016",7,7,0,86428.57,1112.857,85.14286
"14847","47191","2016",6,6,0,145950,1353.5,106.6667
"14848","47192","2016",1,1,0,245950,2016,122
"14849","47193","2016",1,1,0,70200,856,82
"14850","47194","2016",3,3,0,128666.7,1265.667,101.6667
"14851","47195","2016",81,81,0,132437.9,1255.691,103.5185
"14852","47196","2016",3,3,0,71000,544,140
"14853","47197","2016",1,1,0,173000,1466,118
"14854","47198","2016",2,2,0,175600,1405,119.5
"14855","47199","2016",5,5,0,198433.8,1661.2,119.2
"14856","47200","2016",1,1,0,68000,1700,40
"14857","47201","2016",148,137,11,125759.1,1515.777,83.02027
"14858","47202","2016",1,1,0,96800,1344,72
"14859","47203","2016",26,26,0,141284.6,1349.615,109.1538
"14860","47204","2016",2,2,0,207500,1335,149.5
"14861","47205","2016",1,1,0,218000,2422,90
"14862","47206","2016",6,6,0,177016.7,1382.667,127.3333
"14863","47207","2016",3,3,0,130666.7,1432,94
"14864","47208","2016",1,1,0,122000,1937,63
"14865","47209","2016",35,35,0,165640.3,1611.486,103.9429
"14866","47210","2016",15,13,2,123153.3,1334,93.53333
"14867","47211","2016",1,1,0,265000,1710,155
"14868","47212","2016",4,4,0,121935,1004,121.75
"14869","47213","2016",8,8,0,138750,1211.125,107.5
"14870","47214","2016",2,2,0,137525,1096.5,124.5
"14871","47215","2016",50,49,1,145200.8,1484.08,103.34
"14872","47216","2016",3,3,0,121000,1095.333,106.3333
"14873","47217","2016",8,8,0,103681.2,1169.625,89
"14874","47218","2016",5,5,0,125170,1337,124.8
"14875","47219","2016",2,2,0,205300,1849.5,116
"14876","47220","2016",3,3,0,300333.3,4771.667,90
"14877","47221","2016",12,12,0,141615.8,1170.75,129.1667
"14878","47222","2016",5,5,0,210009.4,1513.2,149.6
"14879","47223","2016",4,4,0,274125,2250,133.25
"14880","47224","2016",2,2,0,132500,1312.5,90
"14881","47225","2016",17,17,0,186416.1,1682.235,111.6471
"14882","47226","2016",10,10,0,151200,1456.9,111
"14883","47227","2016",2,2,0,127500,1393.5,114
"14884","47228","2016",6,6,0,187704.7,1483,116.6667
"14885","47229","2016",2,2,0,125000,1897,68.5
"14886","47230","2016",1,1,0,158000,1053,150
"14887","47231","2016",5,5,0,186169.8,1656.4,111
"14888","47232","2016",5,5,0,122770,877,140.4
"14889","47233","2016",24,24,0,144545.8,1225.792,120.625
"14890","47234","2016",2,2,0,181350,2021.5,98
"14891","47235","2016",7,7,0,110714.3,1206.286,92
"14892","47236","2016",4,4,0,158500,1949.5,82.5
"14893","47237","2016",2,2,0,112500,981,116
"14894","47238","2016",14,14,0,219389.8,1909.5,110.4286
"14895","47239","2016",9,9,0,159434,1300.111,127
"14896","47240","2016",1,1,0,210000,2165,97
"14897","47241","2016",7,7,0,121300.7,1085.143,106.1429
"14898","47242","2016",2,2,0,124500,1254.5,95.5
"14899","47244","2016",5,5,0,166100,1538.4,128.6
"14900","47245","2016",1,1,0,175160,1390,126
"14901","47246","2016",17,17,0,127416.5,1327.353,102.1176
"14902","47247","2016",6,6,0,131176.2,839.5,154.5
"14903","47248","2016",6,5,1,179916.7,1522,111
"14904","47249","2016",5,5,0,169964.2,1326.6,113.8
"14905","47251","2016",3,3,0,163600,1294.667,127
"14906","47252","2016",70,69,1,122172.3,1423.514,90.67143
"14907","47253","2016",4,4,0,158275,1549.75,113
"14908","47254","2016",3,3,0,221666.7,1964,110.6667
"14909","47255","2016",2,2,0,143500,1556.5,93
"14910","47256","2016",1,1,0,164000,1691,97
"14911","47257","2016",5,5,0,162391,1337.2,136
"14912","47258","2016",4,4,0,324250,2323.5,138.75
"14913","47259","2016",1,1,0,255000,2161,118
"14914","47260","2016",5,5,0,187582,1583.4,108.6
"14915","47263","2016",5,5,0,116000,1294.6,89
"14916","47264","2016",18,18,0,97524.44,1300.778,77.94444
"14917","47265","2016",4,4,0,105625,715.5,171.75
"14918","47266","2016",1,1,0,460000,3239,142
"14919","47267","2016",1,1,0,205550,1136,181
"14920","47269","2016",14,14,0,173550,1563.929,107.9286
"14921","47271","2016",6,6,0,181304,1370.833,129.6667
"14922","47272","2016",2,2,0,190000,1422.5,120
"14923","47273","2016",2,2,0,115300,1131,106.5
"14924","47274","2016",6,6,0,143916.7,1516.5,103
"14925","47275","2016",2,2,0,66000,970,73.5
"14926","47276","2016",5,5,0,102100,1146,87.2
"14927","47277","2016",1,1,0,130000,1083,120
"14928","47278","2016",8,8,0,181723.5,1293.875,141.125
"14929","47279","2016",2,2,0,75000,1062,69.5
"14930","47280","2016",16,15,1,119756.2,1160.562,109.375
"14931","47281","2016",1,1,0,55000,1100,50
"14932","47282","2016",1,1,0,130000,1057,123
"14933","47283","2016",12,11,1,73950,887.5,83.33333
"14934","47284","2016",2,2,0,105000,917,110
"14935","47285","2016",6,6,0,164733.3,1255.333,132
"14936","47286","2016",1,1,0,3e+05,2069,145
"14937","47287","2016",2,2,0,216140,1429,158.5
"14938","47288","2016",8,8,0,181268.8,1699.125,105.375
"14939","47289","2016",8,8,0,164059.5,1373.875,118.125
"14940","47290","2016",13,13,0,158023.1,1158.385,139.3077
"14941","47291","2016",5,5,0,102686,1193.6,95.2
"14942","47292","2016",8,8,0,108062.5,931.75,110.375
"14943","47293","2016",4,4,0,81300,940.75,89.25
"14944","47294","2016",3,3,0,76500,1005.333,104
"14945","47295","2016",6,6,0,174102,1316,135.8333
"14946","47296","2016",4,4,0,85727.5,1152.75,74.75
"14947","47297","2016",1,1,0,281000,1441,195
"14948","47298","2016",3,3,0,94333.33,1015,106.3333
"14949","47299","2016",5,5,0,271900,2188,123
"14950","47300","2016",8,8,0,139768.8,1333.375,108.125
"14951","47301","2016",8,8,0,107247,1299.875,84.75
"14952","47302","2016",11,11,0,92045.45,1278.182,83.09091
"14953","47303","2016",5,5,0,182200,1791.4,92.6
"14954","47304","2016",1,1,0,94500,1277,74
"14955","47305","2016",7,7,0,135935.7,1376.429,101.4286
"14956","47306","2016",14,14,0,174265.7,1354.5,113.0714
"14957","47307","2016",2,2,0,186000,1893.5,106
"14958","47308","2016",2,2,0,131500,1242.5,112.5
"14959","47309","2016",7,7,0,133175,1300.286,100.5714
"14960","47310","2016",111,100,11,106428.3,1054.369,95.77477
"14961","47311","2016",3,3,0,87666.67,1235.333,69.66667
"14962","47312","2016",6,6,0,130258.3,1037.833,134.3333
"14963","47314","2016",8,8,0,143068.8,1229.625,122
"14964","47315","2016",10,10,0,118387.5,1266.3,93.5
"14965","47316","2016",3,3,0,110666.7,873,119
"14966","47317","2016",3,3,0,106500,980.3333,113
"14967","47318","2016",13,11,2,71480.77,856.9231,82
"14968","47320","2016",6,6,0,107500,945.3333,100.6667
"14969","47321","2016",1,1,0,173250,1925,90
"14970","47323","2016",331,281,50,102548.1,1143.677,90.68882
"14971","47324","2016",27,27,0,106470.4,1214.259,91.92593
"14972","47325","2016",6,6,0,103200,995.5,103.6667
"14973","47326","2016",15,15,0,120419,1377.667,90.8
"14974","47327","2016",1,1,0,107000,704,152
"14975","47328","2016",1,1,0,105000,1500,70
"14976","48002","2016",1,1,0,140000,1591,88
"14977","48004","2016",1,1,0,77000,1674,46
"14978","48008","2016",5,5,0,93310.4,1213,83
"14979","48009","2016",13,12,1,96835.77,1233.308,77.30769
"14980","48010","2016",3,3,0,126903.3,2016,62.33333
"14981","48013","2016",5,5,0,177148,1353,156
"14982","48015","2016",3,3,0,130000,1662.333,78
"14983","48016","2016",5,5,0,123000,1492.2,93.4
"14984","48017","2016",9,8,1,57388.89,737.4444,89.66667
"14985","48018","2016",4,4,0,120875,1150.25,92.25
"14986","48019","2016",1,1,0,34000,944,36
"14987","48020","2016",1,1,0,50000,1250,40
"14988","48021","2016",1,1,0,75000,1667,45
"14989","48026","2016",1,1,0,161350,1813,89
"14990","48027","2016",15,12,3,84568.67,1190.267,72.73333
"14991","48028","2016",1,1,0,60000,2000,30
"14992","48029","2016",1,1,0,146000,1921,76
"14993","48030","2016",5,4,1,145580,1749.4,94.2
"14994","48034","2016",15,15,0,120316.7,1182.467,102.1333
"14995","48036","2016",2,2,0,72750,2673,28.5
"14996","48037","2016",4,4,0,74250,897.75,84.75
"14997","48038","2016",2,2,0,55985,829,72.5
"14998","48039","2016",11,11,0,124822.7,1420.182,90
"14999","48041","2016",1,1,0,139500,1395,100
"15000","48042","2016",3,3,0,242996.7,2143.667,114.3333
"15001","48043","2016",4,2,2,104250,804.25,120
"15002","48044","2016",1,1,0,60000,600,100
"15003","48045","2016",5,5,0,94324,1326.8,83.8
"15004","48048","2016",1,1,0,160000,2667,60
"15005","48050","2016",6,6,0,148291.7,1568.333,90.66667
"15006","48051","2016",8,6,2,106505,1059.5,95
"15007","48053","2016",4,4,0,106375,967.25,102.25
"15008","48055","2016",2,2,0,89500,1887.5,40.5
"15009","48056","2016",6,6,0,156800,1608,96.16667
"15010","48059","2016",3,3,0,174666.7,1791.667,92.66667
"15011","48061","2016",12,10,2,153620.8,1711,89.58333
"15012","48063","2016",3,2,1,108333.3,1287,83.33333
"15013","48064","2016",2,2,0,72500,2461,34
"15014","48065","2016",1,1,0,90000,562,160
"15015","48067","2016",1,1,0,150000,1667,90
"15016","48070","2016",9,9,0,110357.3,1113.333,109.3333
"15017","48072","2016",1,1,0,40000,667,60
"15018","48074","2016",1,1,0,55000,1000,55
"15019","48075","2016",8,8,0,154906.2,1943.875,84.375
"15020","48077","2016",1,1,0,67000,957,70
"15021","48079","2016",1,1,0,90000,1216,74
"15022","48080","2016",28,23,5,90824.82,1042,83.96429
"15023","48081","2016",1,1,0,58000,1526,38
"15024","48082","2016",2,2,0,65000,877,68.5
"15025","48083","2016",1,1,0,50000,1000,50
"15026","48085","2016",4,4,0,104800,1126.25,103.75
"15027","48086","2016",6,6,0,141766.7,1774.167,70.5
"15028","48087","2016",1,1,0,85000,1118,76
"15029","48089","2016",6,6,0,90918.17,901,95.33333
"15030","48090","2016",8,8,0,78975,847.625,88.375
"15031","48091","2016",1,1,0,20000,667,30
"15032","48092","2016",35,20,15,93103.71,1351.771,69.62857
"15033","48094","2016",6,6,0,129923.5,1194,107.8333
"15034","48095","2016",80,45,35,148821.1,1855.2,86.2
"15035","48096","2016",6,6,0,147284.2,2464.5,74.5
"15036","48097","2016",2,2,0,58917.5,1148,58.5
"15037","48098","2016",2,2,0,171000,2170,80
"15038","48099","2016",5,5,0,80740,1059.4,70.8
"15039","48103","2016",3,3,0,148100,1240.667,120.3333
"15040","48104","2016",5,5,0,64000,1278.8,58.6
"15041","48105","2016",3,3,0,146186.7,1420.333,100.6667
"15042","48108","2016",2,2,0,143500,1225,120
"15043","48111","2016",1,1,0,40000,714,56
"15044","48115","2016",3,2,1,78270,1004.667,81
"15045","48116","2016",6,5,1,78031.33,1397.5,55.66667
"15046","48117","2016",4,4,0,91325,1599.5,63.5
"15047","48119","2016",2,2,0,79000,1235.5,65
"15048","48127","2016",8,8,0,130562.5,1369.625,98.75
"15049","48128","2016",2,2,0,120000,1093.5,100
"15050","48129","2016",3,3,0,66333.33,1156,58.66667
"15051","48132","2016",9,8,1,98289.78,1377.556,76.66667
"15052","48135","2016",1,1,0,187000,935,200
"15053","48136","2016",1,1,0,67500,1125,60
"15054","48138","2016",1,1,0,1e+05,1429,70
"15055","48139","2016",3,3,0,98833.33,1156.333,91.33333
"15056","48140","2016",20,16,4,116095.5,1351.1,85.6
"15057","48144","2016",5,5,0,129800,2161.2,59.8
"15058","48145","2016",1,1,0,53000,631,84
"15059","48146","2016",13,13,0,167452.7,2007.231,99.30769
"15060","48147","2016",3,3,0,115000,1363.667,79.33333
"15061","48148","2016",3,3,0,213216.7,2072.667,109
"15062","48150","2016",1,1,0,35720,595,60
"15063","48151","2016",1,1,0,58455,928,63
"15064","48152","2016",1,1,0,160000,1818,88
"15065","48155","2016",7,6,1,104352.9,1638.857,75.28571
"15066","48156","2016",2,2,0,155000,1134.5,137.5
"15067","48157","2016",2,2,0,57850,1184,46.5
"15068","48160","2016",5,5,0,85194,1060.8,83.2
"15069","48161","2016",1,1,0,42000,750,56
"15070","48163","2016",1,1,0,218550,1821,120
"15071","48165","2016",1,1,0,255000,1947,131
"15072","48166","2016",3,3,0,79333.33,1200,75
"15073","48169","2016",3,3,0,113666.7,917.6667,122.3333
"15074","48170","2016",4,4,0,187000,1438.75,140.5
"15075","48171","2016",2,2,0,176765,1110,148
"15076","48173","2016",4,4,0,123000,1237.5,99.25
"15077","48176","2016",3,3,0,106393.3,1460,72.66667
"15078","48177","2016",1,1,0,106000,1413,75
"15079","48181","2016",2,2,0,1e+05,988.5,104
"15080","48185","2016",2,2,0,146000,1336,105.5
"15081","48188","2016",2,2,0,94500,901,103.5
"15082","48190","2016",1,1,0,30000,1000,30
"15083","48191","2016",1,1,0,180000,1800,100
"15084","48192","2016",1,1,0,50000,510,98
"15085","48193","2016",5,5,0,58238,935,67.6
"15086","48194","2016",3,3,0,82333.33,1322,60
"15087","48198","2016",5,5,0,75840,1369.6,56.2
"15088","49002","2016",22,21,1,129677.3,1310.682,99.45455
"15089","49003","2016",15,15,0,115493.3,1237.067,97.33333
"15090","49007","2016",2241,616,1625,142414.1,1950.529,72.95895
"15091","49008","2016",11,11,0,100556.9,1108.727,94.81818
"15092","49009","2016",5,5,0,118800,1328.8,94.6
"15093","49010","2016",4,4,0,115125,1104,103.25
"15094","49011","2016",6,6,0,136166.7,1030.167,128.3333
"15095","49012","2016",1,1,0,114000,600,190
"15096","49015","2016",182,126,56,199142.5,2051.681,97.99451
"15097","49017","2016",7,7,0,110328.6,1130,96.28571
"15098","49018","2016",103,103,0,122225.9,1064.359,116.6408
"15099","49020","2016",52,48,4,218513.9,2235.442,98.71154
"15100","49021","2016",76,74,2,143833,1385.026,106.5921
"15101","49022","2016",17,17,0,154717.6,1501.529,106.4706
"15102","49023","2016",164,157,7,121608.2,1289.524,97.46341
"15103","49026","2016",21,21,0,161023.8,1426.714,116.619
"15104","49027","2016",13,13,0,123769.2,1175.923,106.4615
"15105","49028","2016",1,1,0,245000,1369,179
"15106","49029","2016",17,17,0,180475.9,1620.529,112.3529
"15107","49030","2016",13,13,0,126076.9,1340.385,95.23077
"15108","49035","2016",67,64,3,286645.1,2296.97,127.9104
"15109","49036","2016",6,6,0,114421.5,1067.167,113.8333
"15110","49038","2016",4,4,0,90085,1021.5,85.75
"15111","49041","2016",11,11,0,130909.1,1382.909,97
"15112","49045","2016",5,5,0,72600,758.2,92.2
"15113","49048","2016",43,43,0,174550.8,1594.907,109.9767
"15114","49050","2016",88,82,6,172201.1,1669.784,105.5455
"15115","49053","2016",3,3,0,107666.7,1174.333,90.66667
"15116","49054","2016",34,31,3,77602.94,936.9412,81.23529
"15117","49055","2016",26,25,1,171388.1,1857.808,92.26923
"15118","49056","2016",1,1,0,117000,1444,81
"15119","49057","2016",2,2,0,144000,1122.5,132.5
"15120","49058","2016",3,3,0,169500,1517,114.6667
"15121","49060","2016",12,12,0,142208.3,1472.75,95.25
"15122","49061","2016",10,10,0,102180,976.9,99.6
"15123","49063","2016",65,57,8,160028.5,1646.662,98.58462
"15124","49064","2016",7,7,0,140285.7,1156.714,113.7143
"15125","49067","2016",4,4,0,86000,895,94.25
"15126","49068","2016",18,18,0,149530.7,1468.389,101.3889
"15127","49069","2016",117,115,2,141247.8,1546.692,93.13675
"15128","49070","2016",8,8,0,126125,1267.75,102.75
"15129","49076","2016",6,6,0,144666.7,1507.667,97.66667
"15130","49080","2016",39,37,2,142105.2,1357.256,101
"15131","49082","2016",11,11,0,164440.9,1487.091,108
"15132","49086","2016",55,51,4,132600,1351.364,102.0545
"15133","49089","2016",15,15,0,137466.7,1089,132.1333
"15134","49090","2016",9,9,0,160205.6,1517.333,100.7778
"15135","49092","2016",140,139,1,139033.8,1330.429,106.6714
"15136","49099","2016",680,478,202,128327.4,1491.991,86.72794
"15137","49100","2016",1,1,0,110000,940,117
"15138","49102","2016",3,3,0,106333.3,908.3333,118.3333
"15139","49107","2016",5,5,0,184304,3004.6,102.4
"15140","49109","2016",15,14,1,104366.7,1112.8,98.8
"15141","49110","2016",17,17,0,155000,1470.588,107.6471
"15142","49112","2016",9,9,0,131588.9,1257,110.2222
"15143","49113","2016",1,1,0,130000,1688,77
"15144","49114","2016",1,1,0,120000,1463,82
"15145","49120","2016",13,13,0,154769.2,1625.231,96.15385
"15146","49121","2016",4,4,0,148750,1723.25,106
"15147","49123","2016",15,15,0,164254,1548.267,109.5333
"15148","49125","2016",92,90,2,143072.4,1369.5,107.5652
"15149","49127","2016",46,46,0,118641.3,1270.196,98.67391
"15150","49129","2016",43,38,5,177223.3,1849.791,98.53488
"15151","49130","2016",7,7,0,206842.9,1830.286,119.1429
"15152","49131","2016",5,5,0,136700,1367.6,100.6
"15153","49132","2016",27,27,0,128092.6,1166.111,111.0741
"15154","49135","2016",21,21,0,152393.1,1636.381,94.52381
"15155","49138","2016",27,27,0,113847.4,1304.741,90.55556
"15156","49140","2016",12,12,0,100566.7,1106.167,90.91667
"15157","49155","2016",15,15,0,159638.4,1231.8,130.4667
"15158","49160","2016",26,23,3,102014.3,1237.308,84.19231
"15159","49161","2016",2,2,0,241250,2493,93.5
"15160","49163","2016",35,34,1,138520,1256.6,116.7429
"15161","49167","2016",39,36,3,208041,1943.077,105.0256
"15162","49170","2016",15,15,0,107822.8,1254.8,86.93333
"15163","49171","2016",2,2,0,148500,1402.5,116.5
"15164","49174","2016",14,14,0,114321.4,1187.143,92.71429
"15165","49176","2016",47,47,0,145965.1,1385.106,108.234
"15166","49178","2016",7,7,0,114285.7,1217.286,94.57143
"15167","49180","2016",57,56,1,143346.8,1424.526,100.1579
"15168","49182","2016",8,8,0,111125,1262,90.625
"15169","49183","2016",52,51,1,132526.9,1416.154,96.88462
"15170","49188","2016",8,8,0,113926.2,1099.25,101.375
"15171","49192","2016",23,23,0,132130.4,1303.043,104.6522
"15172","49193","2016",43,43,0,117108.1,1165.279,108.2326
"15173","49194","2016",56,56,0,147327.1,1389.286,109.2679
"15174","49195","2016",7,7,0,158152.1,1200.286,132.7143
"15175","49200","2016",37,36,1,188621.8,1819.541,107.8919
"15176","49201","2016",15,15,0,143100,1308.333,112.5333
"15177","49205","2016",11,11,0,106818.2,1187.364,91.27273
"15178","49209","2016",5,5,0,200236,4166,127.4
"15179","49211","2016",5,5,0,171100,1390.6,124.2
"15180","49214","2016",64,58,6,181261.2,1873.328,96.5
"15181","49215","2016",34,34,0,121407.4,1070.471,114.8824
"15182","49216","2016",6,6,0,266450,1931.833,114
"15183","49217","2016",6,6,0,187833.3,1479.667,138.3333
"15184","49218","2016",117,116,1,112321.7,1180.342,95.80342
"15185","49219","2016",9,9,0,126411.1,1439.556,88.55556
"15186","49220","2016",33,33,0,122182.8,1126.545,106
"15187","49221","2016",12,12,0,127583.3,901.0833,127.75
"15188","49222","2016",20,20,0,179730,1545.55,118.25
"15189","49223","2016",66,53,13,191217,1782.136,102.2727
"15190","49224","2016",6,6,0,174633.3,1565.167,111.1667
"15191","49228","2016",49,49,0,85251.02,888.5714,91.61224
"15192","49231","2016",15,15,0,139920,1470.2,99.33333
"15193","49235","2016",9,9,0,141159.7,1373,95.44444
"15194","49236","2016",2,2,0,132500,1295.5,101.5
"15195","49240","2016",15,15,0,102016.4,1562.733,89.6
"15196","49241","2016",21,20,1,191224.8,1698.524,116.2857
"15197","49244","2016",134,129,5,116305.7,1271.567,91.23134
"15198","49246","2016",106,86,20,179715.2,1904.142,97.4717
"15199","49247","2016",23,23,0,165891.3,1620.826,106.6957
"15200","49248","2016",80,78,2,96707.7,995.7375,96.675
"15201","49253","2016",8,8,0,179125,962.125,165
"15202","49257","2016",9,9,0,99333.33,1019.333,102.3333
"15203","49259","2016",26,25,1,142817.3,1446.538,98.92308
"15204","49260","2016",16,16,0,141888.8,1405.125,101.25
"15205","49261","2016",71,70,1,127100,1393.732,93.11268
"15206","49262","2016",5,5,0,118400,1179.6,100.4
"15207","49266","2016",14,14,0,168035.7,1500.286,112.5
"15208","49267","2016",66,51,15,191037.5,1955.152,101.3485
"15209","49269","2016",22,22,0,158563.6,1497.591,107.7273
"15210","49271","2016",35,35,0,181059.3,1682.714,109.5143
"15211","49272","2016",12,12,0,105628.2,1446.917,77.91667
"15212","49278","2016",35,33,2,221490.6,2253.229,108.9429
"15213","49283","2016",33,32,1,149498.5,1522.515,95.0303
"15214","49284","2016",8,8,0,146556.4,1752.375,91
"15215","49288","2016",1,1,0,131000,1170,112
"15216","49291","2016",7,7,0,104285.7,993.2857,105.4286
"15217","49292","2016",30,30,0,172549.2,1516.3,118.0667
"15218","49294","2016",24,24,0,196866.9,1918.958,102.2917
"15219","49298","2016",19,19,0,232794.7,1847.421,129.3158
"15220","49299","2016",31,31,0,154004.5,1549.032,99.96774
"15221","49301","2016",221,220,1,131781.9,1362.846,97.51131
"15222","49302","2016",2,2,0,136000,1240.5,105
"15223","49306","2016",12,12,0,215527.6,1877,115.25
"15224","49307","2016",149,146,3,186456.9,1626.758,116.8926
"15225","49308","2016",11,11,0,235581.8,2001.091,118.2727
"15226","49310","2016",6,6,0,66500,718.8333,94.66667
"15227","49311","2016",13,13,0,149969.2,1234.692,125.3077
"15228","49321","2016",4,4,0,51750,675,76.5
"15229","49323","2016",75,71,4,190434,1939.04,100.3333
"15230","49326","2016",6,6,0,208791.7,1624,133.8333
"15231","49328","2016",303,195,108,125665,1373.634,90.9934
"15232","49329","2016",20,20,0,192045,1690.1,115.05
"15233","49330","2016",14,14,0,183390.4,1472.643,126.7857
"15234","49331","2016",185,165,20,111630.6,1231.908,95.93514
"15235","49332","2016",37,37,0,170859.2,1520.108,109.4865
"15236","49333","2016",36,36,0,128129.3,1384.417,94.47222
"15237","49334","2016",3,3,0,67833.33,910.3333,72.33333
"15238","49336","2016",4,4,0,63125,773.25,80.25
"15239","49338","2016",11,11,0,190454.5,1872.091,109.9091
"15240","49339","2016",10,9,1,153062,1778.1,91
"15241","49341","2016",5,5,0,154050,1420.4,119.2
"15242","49343","2016",25,22,3,150776,1463.64,102.04
"15243","49344","2016",8,8,0,161500,1364.25,127
"15244","49345","2016",51,50,1,146952.9,1441.392,104.3725
"15245","49347","2016",51,51,0,147986.4,1479.549,100.8039
"15246","49352","2016",20,20,0,143344.8,1513.4,97.3
"15247","49353","2016",156,132,24,164601.8,1831.071,91.4359
"15248","49355","2016",22,22,0,120286.4,1334.227,89.68182
"15249","49358","2016",5,5,0,108600,1270.8,93.8
"15250","49359","2016",4,4,0,95500,931.5,101.25
"15251","49361","2016",21,20,1,115210,1266.476,96.95238
"15252","49362","2016",9,9,0,133544.4,1431.444,92.66667
"15253","49364","2016",10,10,0,133206,1201.4,110.7
"15254","49367","2016",57,57,0,145673,1343.211,109
"15255","49368","2016",19,18,1,110868.4,1250.947,99.42105
"15256","49369","2016",17,17,0,93029.41,941.9412,95.76471
"15257","49370","2016",4,4,0,171000,1285.5,150
"15258","49371","2016",11,11,0,136290.9,1228,113
"15259","49373","2016",56,55,1,104112,1046.821,97.625
"15260","49374","2016",5,5,0,129200,1463,85
"15261","49377","2016",45,45,0,174050.4,1652.289,105.8667
"15262","49378","2016",20,20,0,154700,1618.45,92.4
"15263","49381","2016",19,19,0,120587.4,1180.421,101.4737
"15264","50002","2016",53,47,6,136237.7,1383.453,98.20755
"15265","50003","2016",72,67,5,217750.2,2788.264,85.45833
"15266","50004","2016",10,10,0,113450,981.7,115.4
"15267","50006","2016",3,3,0,111540,1052,100
"15268","50008","2016",7,6,1,175500,1668.571,114
"15269","50013","2016",4,4,0,102250,1045,99.25
"15270","50015","2016",4,4,0,143500,2075.25,78
"15271","50016","2016",3,3,0,93733.33,1245.333,88.33333
"15272","50019","2016",4,4,0,91975,929.25,108.25
"15273","50021","2016",3,3,0,170166.7,1073,159
"15274","50022","2016",3,3,0,114666.7,1424.667,94.66667
"15275","50023","2016",4,4,0,113200,950.25,138.5
"15276","50024","2016",3,3,0,144733.3,1352.667,110.3333
"15277","50025","2016",114,80,34,165990.9,1614.447,97.08772
"15278","50026","2016",1,1,0,96000,738,130
"15279","50027","2016",9,9,0,166555.6,1643.778,101.3333
"15280","50028","2016",2,2,0,64950,1035,61
"15281","50029","2016",16,16,0,87050,836.25,109.25
"15282","50030","2016",16,10,6,152432.5,2250.5,76.6875
"15283","50031","2016",59,51,8,179947.1,2263.542,81.79661
"15284","50032","2016",17,17,0,160367.4,1359.706,120.2941
"15285","50033","2016",2,2,0,84700,1245,90
"15286","50034","2016",4,4,0,126824.2,1316.25,94.25
"15287","50036","2016",1,1,0,155000,951,163
"15288","50038","2016",2,2,0,109075,1330.5,83
"15289","50039","2016",1,1,0,1e+05,1351,74
"15290","50040","2016",2,2,0,119500,1656.5,87.5
"15291","50041","2016",77,77,0,168089,1670.169,102.3247
"15292","50042","2016",5,5,0,103000,1345.2,87.4
"15293","50044","2016",4,4,0,149912.5,1626.75,93.75
"15294","50045","2016",6,6,0,173140,1591,128.5
"15295","50046","2016",2,2,0,129375,1133.5,117.5
"15296","50048","2016",10,10,0,118315,1060.4,113.5
"15297","50049","2016",12,12,0,89049.17,986.6667,96.08333
"15298","50050","2016",2,2,0,151300,1713,108
"15299","50052","2016",3,3,0,59500,843.6667,70.33333
"15300","50054","2016",4,4,0,122750,946.25,124.5
"15301","50058","2016",25,25,0,171218,1729.44,99.84
"15302","50059","2016",2,2,0,97500,765.5,122
"15303","50060","2016",2,2,0,65000,706.5,86
"15304","50062","2016",1,1,0,196440,2806,70
"15305","50064","2016",1,1,0,165500,1141,145
"15306","50066","2016",63,49,14,209255.8,2533.143,85.30159
"15307","50069","2016",2,2,0,87500,1349,66.5
"15308","50072","2016",1,1,0,177600,1110,160
"15309","50074","2016",27,25,2,102129.6,1140.963,90.85185
"15310","50076","2016",48,41,7,177292.6,2510.625,84.66667
"15311","50077","2016",13,13,0,147950,1629.154,100.5385
"15312","50078","2016",4,4,0,162837.5,2219.25,84.25
"15313","50079","2016",2,2,0,75000,966,70
"15314","50081","2016",9,9,0,214022.2,1985.889,112.4444
"15315","50082","2016",56,56,0,127301.9,1414.071,91.625
"15316","50083","2016",2,2,0,145000,1779,80
"15317","50084","2016",4,4,0,135650,1555.25,86.25
"15318","50085","2016",11,11,0,170518.2,1790.182,96.72727
"15319","50086","2016",4,4,0,180250,1572,120
"15320","50087","2016",17,17,0,131935.1,1466.706,99.41176
"15321","50088","2016",3,3,0,53666.67,784.6667,71
"15322","50090","2016",2,2,0,128180,1228,104.5
"15323","50092","2016",3,3,0,120000,1070.667,103
"15324","50093","2016",3,3,0,135683.3,1221.667,95.33333
"15325","50094","2016",3,3,0,68220,659,108.6667
"15326","50095","2016",20,20,0,134496.8,1157.95,119.2
"15327","50096","2016",4,4,0,116125,1307,86
"15328","50098","2016",8,8,0,95368.75,1148,79.125
"15329","50099","2016",128,103,25,127293.4,1274.719,100.5703
"15330","50101","2016",1,1,0,42000,1024,41
"15331","50102","2016",20,19,1,242175,2207.65,111.9
"15332","50106","2016",5,5,0,116460,1084.2,98.6
"15333","50108","2016",4,4,0,86825,1104.75,83.5
"15334","50109","2016",17,17,0,87832.35,886.2941,106.5294
"15335","50110","2016",14,14,0,125439.3,1258.786,106.7143
"15336","50111","2016",11,11,0,96063.64,973.1818,101.6364
"15337","50112","2016",5,5,0,156020,1267.8,115.2
"15338","50115","2016",4,4,0,101900,1157.75,86.25
"15339","50117","2016",7,7,0,161857.1,1650.857,98.71429
"15340","50118","2016",5,5,0,109800,1098.8,99
"15341","50120","2016",2,2,0,102700,1270.5,82
"15342","50121","2016",3,3,0,139900,1093.333,122.6667
"15343","50124","2016",1,1,0,84000,933,90
"15344","50126","2016",3,3,0,154333.3,1984.333,86.33333
"15345","50129","2016",723,547,176,135228.4,1634.144,84.26003
"15346","50130","2016",8,8,0,144875,1047.375,137.375
"15347","50135","2016",2,2,0,288000,1774.5,146.5
"15348","50137","2016",7,7,0,113985.7,1562.571,83.28571
"15349","50138","2016",4,4,0,134250,2151,69.5
"15350","50139","2016",35,35,0,149999.7,1212.314,122.2571
"15351","50142","2016",14,14,0,109857.1,1735.143,68.21429
"15352","50143","2016",12,12,0,199166.7,1706.833,113.25
"15353","50144","2016",8,8,0,60466.25,942.25,64
"15354","50145","2016",2,2,0,251800,1813,134
"15355","50146","2016",5,5,0,70844,774.6,91.6
"15356","50147","2016",87,55,32,119605.1,1461,90.33333
"15357","50148","2016",8,8,0,126050,1154.375,110.625
"15358","50149","2016",15,15,0,150933.3,1787.2,89.4
"15359","50150","2016",5,5,0,165400,1259,129.6
"15360","50151","2016",29,27,2,109856.1,1340.483,81.17241
"15361","50152","2016",3,3,0,67500,871.6667,73.33333
"15362","50155","2016",2,2,0,86500,1154.5,79.5
"15363","50158","2016",3,3,0,121666.7,1132.333,115
"15364","50159","2016",11,11,0,97645.45,884.5455,116.0909
"15365","50161","2016",5,5,0,114850,1010.6,106.6
"15366","50162","2016",17,17,0,199985.3,1964.353,106.0588
"15367","50164","2016",10,10,0,103212.5,874.7,121.3
"15368","50165","2016",71,45,26,166733.1,2185.803,78.78873
"15369","50166","2016",3,3,0,163333.3,1233,132
"15370","50167","2016",11,11,0,148626.4,1416.182,106.4545
"15371","50168","2016",15,14,1,134846.7,1277,106.9333
"15372","50169","2016",1,1,0,130000,1494,87
"15373","50172","2016",1,1,0,60000,508,118
"15374","50174","2016",2,2,0,145000,1833.5,77.5
"15375","50175","2016",3,3,0,90700,760.3333,118.6667
"15376","50176","2016",3,3,0,111833.3,1258,84
"15377","50177","2016",6,6,0,82058.33,865.1667,103.1667
"15378","50178","2016",19,19,0,152325.8,1713.316,91.89474
"15379","50181","2016",4,4,0,130500,1079.25,125.5
"15380","50182","2016",3,3,0,39166.67,596.3333,68.66667
"15381","50183","2016",4,4,0,68000,1044.5,69
"15382","50184","2016",16,16,0,143608.1,1601.375,91.0625
"15383","50185","2016",8,8,0,126212.5,1212.875,104.375
"15384","50188","2016",14,14,0,155978.1,1505.286,111.0714
"15385","50190","2016",2,2,0,157700,1564,101
"15386","50192","2016",1,1,0,153000,1500,102
"15387","50193","2016",3,3,0,73333.33,489,147
"15388","50194","2016",6,6,0,120733.3,1229,90.66667
"15389","50195","2016",4,4,0,81000,1262,68
"15390","50196","2016",7,7,0,128642.9,1586.429,85.14286
"15391","50197","2016",18,18,0,103761.1,1196.611,86
"15392","50198","2016",10,10,0,122508,1349.5,100.8
"15393","50199","2016",7,7,0,105905.7,1482.143,75.42857
"15394","50200","2016",12,12,0,74743.33,1038.333,89.66667
"15395","50205","2016",3,3,0,168666.7,1243.667,138.6667
"15396","50208","2016",3,3,0,90100,1335,70.33333
"15397","50209","2016",11,11,0,144545.5,1621.727,95
"15398","50210","2016",4,4,0,90500,927.25,83.25
"15399","50214","2016",3,3,0,99333.33,903,98.33333
"15400","50215","2016",28,28,0,137253.2,1518.857,95.5
"15401","50216","2016",5,5,0,76300,947.2,78.6
"15402","50217","2016",5,5,0,118945.4,1295.8,92
"15403","50218","2016",282,114,168,162365.1,2268.993,72.37234
"15404","50219","2016",6,6,0,140333.3,1484.167,97
"15405","50221","2016",2,2,0,61000,505.5,124.5
"15406","50222","2016",9,9,0,144666.7,1530.667,93.55556
"15407","50225","2016",2,2,0,75000,866,94
"15408","50227","2016",1,1,0,110000,917,120
"15409","50228","2016",17,17,0,93982.94,1062.471,90.94118
"15410","50229","2016",3,3,0,66433.33,635,105.6667
"15411","50230","2016",13,13,0,190098.5,1576.538,123.8462
"15412","50231","2016",16,14,2,166777.5,2088.062,81.75
"15413","50232","2016",5,5,0,97188,1151.4,99.6
"15414","50234","2016",2,2,0,115500,1324.5,99.5
"15415","50235","2016",2,2,0,60000,771,76
"15416","50236","2016",38,38,0,103705.3,1098.105,93.60526
"15417","50237","2016",4,4,0,109500,1182.5,95.75
"15418","50238","2016",3,3,0,201746.7,1563.667,127.6667
"15419","50239","2016",17,17,0,116632.4,1046,113.9412
"15420","50240","2016",5,5,0,221000,1648.4,137.8
"15421","50241","2016",2,2,0,97500,1038.5,108.5
"15422","50243","2016",7,7,0,144685.7,1532.571,95.71429
"15423","50247","2016",2,2,0,121000,1451,73.5
"15424","50251","2016",3,3,0,165300,1959.333,85.33333
"15425","50252","2016",12,12,0,140163.9,1449.417,93.33333
"15426","50253","2016",3,3,0,216000,1934.667,117.6667
"15427","50256","2016",32,32,0,86345.5,1089.438,82.0625
"15428","50259","2016",4,4,0,145749.5,1142.25,139.5
"15429","50260","2016",17,17,0,70229.41,834,92.29412
"15430","50261","2016",1,1,0,86200,1306,66
"15431","50262","2016",5,5,0,129000,1639.6,84.2
"15432","50263","2016",3,3,0,48100,1152,51.33333
"15433","50265","2016",1,1,0,57100,672,85
"15434","50266","2016",3,3,0,123173.3,951,126
"15435","50267","2016",22,22,0,99352.64,1106.864,92.59091
"15436","50268","2016",6,6,0,124000,1408.667,90.33333
"15437","50269","2016",3,3,0,102833.3,1332,77.33333
"15438","50270","2016",3,3,0,145633.3,1439.333,96.66667
"15439","50272","2016",18,18,0,163383.3,1739.833,92.88889
"15440","50273","2016",18,18,0,80502.78,847.2778,93.72222
"15441","50274","2016",7,7,0,86490,911.1429,93.57143
"15442","50275","2016",1,1,0,262500,1227,214
"15443","50276","2016",10,10,0,126201.9,1291.6,96.6
"15444","50277","2016",6,6,0,251983.3,2290.333,111.3333
"15445","50278","2016",1,1,0,26000,481,54
"15446","50279","2016",8,8,0,98937.5,960.75,105.125
"15447","50281","2016",13,13,0,122538.5,1280.308,94.76923
"15448","50282","2016",1,1,0,185000,1341,138
"15449","50285","2016",2,2,0,127500,1655.5,78.5
"15450","50288","2016",8,8,0,108125,1140.75,99.75
"15451","50289","2016",3,3,0,91333.33,908,100
"15452","50290","2016",9,9,0,81400,1093.889,78.66667
"15453","50291","2016",4,4,0,125250,1086.75,114.25
"15454","50292","2016",16,16,0,125724.7,1146,111.6875
"15455","50294","2016",7,7,0,137428.6,1250.857,99.57143
"15456","50295","2016",2,2,0,173375,1191.5,146
"15457","50296","2016",3,3,0,140000,1331.667,103.6667
"15458","50297","2016",6,6,0,119966.7,1104.833,106.5
"15459","50298","2016",8,8,0,122625,1417.125,97.625
"15460","50299","2016",5,5,0,99200,1114.2,86.4
"15461","50300","2016",3,3,0,91000,1761,48.33333
"15462","50302","2016",1,1,0,143000,794,180
"15463","50305","2016",6,6,0,162566.7,1765,97.66667
"15464","50310","2016",1,1,0,143000,1416,101
"15465","50311","2016",4,4,0,149750,1053.25,157.25
"15466","50312","2016",3,3,0,75925.67,1071.667,65.33333
"15467","50317","2016",2,2,0,41500,598.5,72
"15468","50321","2016",2,2,0,114000,912.5,123
"15469","50326","2016",2,2,0,195000,2039,105.5
"15470","50327","2016",1,1,0,110000,688,160
"15471","50328","2016",7,7,0,123928.6,1000.143,136.8571
"15472","50332","2016",5,5,0,166022,1557.6,99.4
"15473","50334","2016",3,3,0,78066.67,884,99.66667
"15474","50335","2016",6,6,0,122333.3,1473.333,84.66667
"15475","50336","2016",3,3,0,95116.67,975.6667,95.66667
"15476","50338","2016",10,10,0,97308,973.8,96.9
"15477","50340","2016",2,2,0,90500,816,116
"15478","50341","2016",21,20,1,99723.81,1091.667,100.0952
"15479","50342","2016",16,16,0,149681.2,1443.938,104.6875
"15480","50345","2016",3,3,0,174333.3,1459,119
"15481","50347","2016",2,2,0,78850,1071,74.5
"15482","50349","2016",17,16,1,133158.8,1389.235,98.41176
"15483","50350","2016",5,5,0,99830,978,100.2
"15484","50352","2016",1,1,0,70000,443,158
"15485","50356","2016",3,3,0,79000,959.3333,73.33333
"15486","50359","2016",30,29,1,79220,891.5333,88.96667
"15487","50360","2016",1,1,0,201000,1675,120
"15488","50361","2016",1,1,0,175000,1215,144
"15489","50362","2016",3,3,0,83666.67,911,79.33333
"15490","50363","2016",10,10,0,94900,889.5,109.1
"15491","50364","2016",9,9,0,81834.44,842.3333,103.4444
"15492","50365","2016",3,3,0,160995,1770,90.33333
"15493","50368","2016",1,1,0,70200,702,100
"15494","50369","2016",8,8,0,154446.6,1665.375,101.125
"15495","50370","2016",2,2,0,151900,2806.5,73.5
"15496","50371","2016",1,1,0,88000,1419,62
"15497","50373","2016",1,1,0,115000,1716,67
"15498","50378","2016",10,10,0,74225,892.7,86.3
"15499","50379","2016",1,1,0,153000,1628,94
"15500","50382","2016",4,4,0,191325,1773,113.75
"15501","50384","2016",1,1,0,135000,1125,120
"15502","50387","2016",4,4,0,87250,1003.25,96.5
"15503","50388","2016",21,21,0,150472.1,1245.619,121.8571
"15504","50389","2016",2,2,0,157000,1423.5,112
"15505","50390","2016",1,1,0,205000,1577,130
"15506","50391","2016",19,19,0,107789.5,1117.263,96
"15507","50393","2016",22,22,0,90309.09,850.6364,105.4545
"15508","50394","2016",23,21,2,120576,1124.652,113.3043
"15509","50395","2016",1,1,0,86500,2060,42
"15510","50397","2016",1,1,0,61000,803,76
"15511","50399","2016",4,4,0,100450,1862,70.75
"15512","50400","2016",25,25,0,114530.8,1186.12,99.56
"15513","50401","2016",5,5,0,135700,1543.8,95.8
"15514","50402","2016",23,22,1,168087,1846.13,93.91304
"15515","50403","2016",37,36,1,118490.5,1942.27,71.7027
"15516","50405","2016",2,2,0,160000,1000,160
"15517","50407","2016",8,8,0,104050,1348,80.375
"15518","50408","2016",11,11,0,124427.3,1323.727,102.3636
"15519","50409","2016",23,18,5,87636.96,991.7826,89.3913
"15520","50410","2016",60,57,3,97613.5,1079.933,92.95
"15521","50411","2016",6,6,0,141233.3,1446.5,97
"15522","50412","2016",51,51,0,145341.4,1834.549,83.58824
"15523","50413","2016",7,7,0,89042.86,1052.714,83.57143
"15524","50417","2016",24,24,0,123792,1391.667,91.125
"15525","50419","2016",17,17,0,141469.1,1331,106.6471
"15526","50420","2016",11,11,0,122118.2,1018.545,119.0909
"15527","50421","2016",5,5,0,233020,2068.4,114.4
"15528","50422","2016",3,3,0,90514.67,1002.667,87.33333
"15529","50423","2016",2,2,0,93000,1120.5,86
"15530","50425","2016",9,9,0,126120.3,1370.444,100.4444
"15531","50426","2016",3,3,0,50333.33,980.3333,61
"15532","50428","2016",10,10,0,80584.7,2184.2,52.3
"15533","50429","2016",8,8,0,127075,1538.75,84.125
"15534","50430","2016",1,1,0,161500,1272,127
"15535","50431","2016",13,13,0,96776.92,1074,92.69231
"15536","50433","2016",16,16,0,127812.5,1699.875,83.75
"15537","50435","2016",6,6,0,112416.7,1335.167,81.5
"15538","50436","2016",5,5,0,130180,2793.4,84
"15539","50437","2016",12,12,0,119128.3,1043.75,118.3333
"15540","50442","2016",2,2,0,66500,1310,51.5
"15541","50443","2016",5,5,0,97500,855.6,105.2
"15542","50444","2016",20,20,0,122269.5,1166.4,107.9
"15543","50445","2016",2,2,0,235000,1158.5,201
"15544","50446","2016",9,9,0,147972.2,1385.556,106.4444
"15545","50447","2016",6,6,0,210165,1784.5,117.3333
"15546","50448","2016",5,5,0,101600,1463.6,77
"15547","50450","2016",3,3,0,35000,589.3333,59
"15548","50451","2016",2,2,0,95175,1070,75.5
"15549","50452","2016",4,4,0,87250,979.75,88.75
"15550","50453","2016",8,8,0,122812.5,1289.75,91
"15551","50454","2016",10,10,0,151400,1393.9,110.3
"15552","50455","2016",6,6,0,175416.7,1316.833,134.5
"15553","50456","2016",7,7,0,94086.43,1112,88.71429
"15554","50457","2016",2,2,0,169000,1536.5,116.5
"15555","50461","2016",1,1,0,87000,702,124
"15556","50462","2016",4,4,0,62437.5,1065.75,74.5
"15557","50463","2016",8,8,0,91587.5,933.75,106.625
"15558","50464","2016",8,8,0,105504.4,1524.5,78.125
"15559","50467","2016",5,5,0,95950,1225.4,85.6
"15560","50468","2016",7,7,0,77684.86,810,97
"15561","50471","2016",12,12,0,121500,1895.667,68.16667
"15562","50472","2016",2,2,0,160000,1870.5,98.5
"15563","50473","2016",6,6,0,145058.3,1059.5,125.5
"15564","50474","2016",9,9,0,75940.56,854.3333,89
"15565","50475","2016",8,8,0,115750,1222.75,94.25
"15566","50476","2016",1,1,0,44000,629,70
"15567","50478","2016",6,6,0,149516.7,1760.667,94.83333
"15568","50479","2016",1,1,0,450000,1758,256
"15569","50480","2016",9,9,0,127033.3,1470.333,90.22222
"15570","50481","2016",30,30,0,121360.7,1794.567,69.7
"15571","50482","2016",2,2,0,98800,966.5,108
"15572","50483","2016",9,9,0,150296,1256.889,118.7778
"15573","50484","2016",41,36,5,109762.5,1153.415,96.19512
"15574","50486","2016",5,5,0,157000,1400.2,145.6
"15575","50487","2016",54,42,12,122967.1,1628.704,90.40741
"15576","50488","2016",3,3,0,172166.7,1433,124
"15577","50489","2016",5,5,0,241000,2699.6,89.6
"15578","50490","2016",5,4,1,161360,2365.4,72.4
"15579","50491","2016",8,8,0,160562.5,1191.25,125.125
"15580","50492","2016",22,22,0,127080,1150.227,110.7273
"15581","50493","2016",15,15,0,134260,1695.133,84.93333
"15582","50495","2016",1,1,0,85000,944,90
"15583","50496","2016",6,5,1,215666.7,2250.333,91.33333
"15584","50498","2016",5,5,0,186600,1999.8,96
"15585","50499","2016",3,3,0,59666.67,723.6667,82
"15586","50500","2016",1,1,0,175000,1182,148
"15587","50502","2016",184,111,73,107584.7,1254.63,87.19565
"15588","50504","2016",4,4,0,140700,1493.75,99.75
"15589","50505","2016",5,5,0,124700,1208.4,102.8
"15590","50506","2016",4,4,0,158750,1786,99.25
"15591","50507","2016",6,6,0,136000,1430.167,102.1667
"15592","50509","2016",9,9,0,138657.2,1390.111,107.7778
"15593","50510","2016",3,3,0,650500,5524.667,107.6667
"15594","50511","2016",3,3,0,100333.3,875.6667,112.3333
"15595","50512","2016",7,7,0,102214.3,989.7143,107.4286
"15596","50513","2016",2,2,0,140000,804.5,174
"15597","50514","2016",4,4,0,65625,742.25,77.25
"15598","50517","2016",4,4,0,192550,1373.5,127.5
"15599","50518","2016",1,1,0,90000,841,107
"15600","50519","2016",9,9,0,170092.4,1437.222,121.4444
"15601","50521","2016",3,3,0,130000,1694.333,91
"15602","50522","2016",2,2,0,83250,876,95
"15603","50523","2016",42,40,2,128548.6,1427.095,97.57143
"15604","50525","2016",6,6,0,71000,888.1667,80.5
"15605","50528","2016",4,4,0,68125,818.5,81.75
"15606","50529","2016",1,1,0,142000,904,157
"15607","50531","2016",10,10,0,113575,1233.5,93.8
"15608","50532","2016",90,71,19,207194.9,2505.211,84.05556
"15609","50535","2016",10,10,0,106600,1243,88.6
"15610","50536","2016",3,3,0,150866.7,1567,89
"15611","50537","2016",1,1,0,105000,1667,63
"15612","50538","2016",4,4,0,118075,1071.5,104
"15613","50539","2016",18,18,0,104250,1167.556,89.72222
"15614","50540","2016",3,3,0,207533.3,1519.667,139.3333
"15615","50541","2016",17,17,0,198558.8,1778.059,111.6471
"15616","50542","2016",6,6,0,95083.33,1281.667,77.83333
"15617","50543","2016",12,12,0,144500,1561.75,93.5
"15618","50546","2016",37,37,0,123630.5,1229.459,101.3514
"15619","50548","2016",1,1,0,170000,1545,110
"15620","50549","2016",6,6,0,146583.3,1555.667,98
"15621","50550","2016",29,29,0,107152.2,1073.828,104.069
"15622","50551","2016",17,16,1,115058.8,1473.353,88.17647
"15623","50552","2016",4,4,0,87625,926.25,97.5
"15624","50553","2016",3,3,0,58333.33,1066.667,61.33333
"15625","50554","2016",14,14,0,154935.7,1669.214,95.21429
"15626","50556","2016",4,4,0,148910,1637.25,99.5
"15627","50562","2016",34,28,6,193546.4,2394.971,88.79412
"15628","50563","2016",6,6,0,106233.3,783.3333,148.8333
"15629","50564","2016",19,19,0,134328.1,1217.421,117.2632
"15630","50565","2016",23,21,2,134825.7,1316.217,100.5217
"15631","50567","2016",15,15,0,145240,1375.933,111.2
"15632","50568","2016",6,6,0,139250,1299,111.1667
"15633","50569","2016",2,2,0,132000,1178.5,112
"15634","50570","2016",3,3,0,75060,924.3333,86.33333
"15635","50572","2016",2,2,0,180000,1661.5,108.5
"15636","50574","2016",1,1,0,62000,705,88
"15637","50575","2016",16,16,0,111103.1,1147.5,95.5
"15638","50576","2016",6,6,0,204712.5,2229.167,99.5
"15639","50577","2016",4,4,0,105775,1322,84.25
"15640","50578","2016",1,1,0,145000,2339,62
"15641","50579","2016",14,14,0,140682.1,1379,103.1429
"15642","50580","2016",5,5,0,165200,2171.8,87.4
"15643","50582","2016",39,38,1,92119.23,1059.41,91.5641
"15644","50584","2016",4,4,0,80000,1035.5,81.25
"15645","50585","2016",10,10,0,120700,1676.3,68.4
"15646","50587","2016",1,1,0,75000,701,107
"15647","50588","2016",6,6,0,130583.3,1150.333,111.8333
"15648","50589","2016",5,5,0,231616,1511.8,158.2
"15649","50590","2016",11,11,0,128190.9,1391.182,92.90909
"15650","50591","2016",19,19,0,86117.37,865.6316,96.47368
"15651","50592","2016",15,15,0,119057.3,1183.4,109.4
"15652","50593","2016",5,5,0,102900,1237.4,81.8
"15653","50594","2016",5,5,0,172640,1575.4,113.6
"15654","50597","2016",8,8,0,123187.5,1406.25,86.625
"15655","50598","2016",5,5,0,158000,1479.6,104.4
"15656","50599","2016",12,12,0,212407.3,1555.917,135.0833
"15657","50601","2016",42,41,1,126696.7,1234.619,103.6905
"15658","50603","2016",13,13,0,173846.2,1663.538,108.6923
"15659","50604","2016",9,9,0,148055.6,1511,97.44444
"15660","50606","2016",3,3,0,119456.7,669,192.3333
"15661","50607","2016",6,6,0,133833.3,1358.833,94.33333
"15662","50609","2016",1,1,0,82500,1031,80
"15663","50610","2016",1,1,0,120000,1500,80
"15664","50612","2016",14,14,0,186264.3,1947.214,91.28571
"15665","50613","2016",9,9,0,129888.9,1415.111,96.88889
"15666","50615","2016",69,51,18,143163.9,1522.797,94.65217
"15667","50616","2016",24,24,0,186145.8,1637.542,109.2083
"15668","50617","2016",4,4,0,83750,1052.25,71.75
"15669","50618","2016",3,3,0,113333.3,1309.333,86
"15670","50619","2016",6,6,0,112833.3,1496.667,91.33333
"15671","50621","2016",1,1,0,110000,1447,76
"15672","50624","2016",2,2,0,74099,626.5,113
"15673","50626","2016",6,6,0,118075,1413.5,84.66667
"15674","50628","2016",1,1,0,166000,1612,103
"15675","50629","2016",9,9,0,98677.78,1048,94.88889
"15676","50633","2016",2,2,0,125000,1170,106
"15677","50637","2016",5,5,0,82560,1050,78.4
"15678","50639","2016",34,32,2,108799.4,1201.5,91.11765
"15679","50641","2016",5,5,0,172600,1202,143.8
"15680","50643","2016",5,5,0,152980,1327.4,118
"15681","50647","2016",13,13,0,172438.5,1648.538,100.1538
"15682","50648","2016",14,14,0,173450,1650.571,105.4286
"15683","51001","2016",1,1,0,191000,927,206
"15684","51003","2016",1,1,0,194500,1473,132
"15685","51006","2016",2,2,0,199300,1198.5,166
"15686","51007","2016",14,14,0,154550,1429.071,108.7857
"15687","51012","2016",1,1,0,174950,1508,116
"15688","51013","2016",1,1,0,169150,1135,149
"15689","51014","2016",3,3,0,235966.7,1521.333,155.6667
"15690","51017","2016",5,5,0,118808,1231.8,96.6
"15691","51018","2016",6,6,0,199166.7,1552.667,140.1667
"15692","51019","2016",1,1,0,155000,1462,106
"15693","51022","2016",1,1,0,63000,797,79
"15694","51023","2016",2,2,0,146625,1833,81.5
"15695","51025","2016",13,13,0,215346.2,1815.154,120.7692
"15696","51027","2016",2,2,0,142250,1102,135
"15697","51029","2016",17,16,1,190941.2,1658.706,113.5294
"15698","51030","2016",55,46,9,153058.8,1659.509,99.10909
"15699","51031","2016",4,4,0,164250,1615.75,102.75
"15700","51036","2016",3,3,0,81333.33,788.3333,93.66667
"15701","51037","2016",2,2,0,164895,1746.5,96.5
"15702","51038","2016",1,0,1,104500,977,107
"15703","51042","2016",4,4,0,111750,1025.75,110
"15704","51043","2016",12,12,0,134358.3,1549.75,90.66667
"15705","51044","2016",11,11,0,195701.8,2077.636,100.6364
"15706","51046","2016",6,6,0,238583.3,2088,114.6667
"15707","51049","2016",1,1,0,170000,1604,106
"15708","51050","2016",4,4,0,137750,1484.75,93.5
"15709","51051","2016",2,2,0,219750,1666.5,134
"15710","51052","2016",6,6,0,212900,1911.167,117.8333
"15711","51054","2016",14,14,0,146905.7,1598.929,96.78571
"15712","51055","2016",47,35,12,192558.9,1986.596,96.40426
"15713","51058","2016",15,11,4,289990.1,2685.667,117.2
"15714","51060","2016",1,1,0,147000,1246,118
"15715","51065","2016",5,5,0,141480,1139.8,127.2
"15716","51066","2016",2,2,0,121500,734,161.5
"15717","51069","2016",1,1,0,180500,1597,113
"15718","51070","2016",2,2,0,261000,1351.5,187
"15719","51072","2016",2,2,0,297700,2345,126
"15720","51073","2016",2,2,0,218550,1470,150.5
"15721","51074","2016",25,25,0,191486,1743.08,112.28
"15722","51075","2016",10,10,0,188820.4,1945.5,94
"15723","51077","2016",1,1,0,190000,1226,155
"15724","51078","2016",2,2,0,120000,1283,94.5
"15725","51079","2016",11,10,1,164240.9,1647.909,101.3636
"15726","51081","2016",3,3,0,262270,2245.667,125.6667
"15727","51086","2016",5,5,0,211940,1878,115
"15728","51088","2016",6,6,0,184643.7,1734,105.8333
"15729","51089","2016",1,1,0,135000,1607,84
"15730","51093","2016",1,1,0,2e+05,1600,125
"15731","51094","2016",1,1,0,47500,540,88
"15732","51097","2016",1,1,0,113350,1303,87
"15733","51099","2016",5,5,0,142800,1678.8,87.4
"15734","51101","2016",8,8,0,233183.8,1849.125,129.5
"15735","51102","2016",5,5,0,185040,1610,118.2
"15736","51105","2016",15,14,1,260623.3,2163.467,124.8667
"15737","51107","2016",1,1,0,150000,1415,106
"15738","51108","2016",381,207,174,119347.4,1360.496,87.75853
"15739","51109","2016",4,4,0,252275,2175,118
"15740","51111","2016",2,2,0,162500,1665.5,97
"15741","51115","2016",7,6,1,269407.1,2500,109.4286
"15742","51117","2016",4,4,0,161625,1284.5,128
"15743","51118","2016",8,8,0,338950,2557.625,128.875
"15744","51122","2016",2,2,0,97750,1201,79.5
"15745","51129","2016",1,1,0,2e+05,704,284
"15746","51130","2016",3,3,0,65166.67,862.3333,74.33333
"15747","51134","2016",5,5,0,99430,1141.4,86.2
"15748","51136","2016",7,7,0,139111.4,1357.286,106.7143
"15749","51139","2016",1,1,0,38000,388,98
"15750","51140","2016",4,3,1,183387.5,1562.25,115.75
"15751","51141","2016",7,7,0,154592.1,1305.429,122.5714
"15752","51142","2016",6,6,0,164616.7,1363.667,122.1667
"15753","51145","2016",4,4,0,262217.5,1679.5,164.5
"15754","51146","2016",3,3,0,192200,1224,172
"15755","51147","2016",2,2,0,110650,1310.5,101.5
"15756","51152","2016",2,2,0,505775,4476.5,113
"15757","51153","2016",8,8,0,205968.8,1972.875,106.125
"15758","51154","2016",1,1,0,135000,1364,99
"15759","51158","2016",4,4,0,100500,1079.5,99.25
"15760","51160","2016",9,9,0,169483.3,1474.778,118.7778
"15761","51161","2016",6,6,0,170891.7,1497.5,117.8333
"15762","51163","2016",1,1,0,85000,766,111
"15763","51166","2016",1,0,1,35500,514,69
"15764","51168","2016",2,2,0,245000,1653,150
"15765","51171","2016",13,13,0,185710.8,1892.923,96.76923
"15766","51172","2016",54,40,14,221251.2,2330.722,94.75926
"15767","51175","2016",2,2,0,166800,1565.5,108
"15768","51181","2016",2,2,0,232500,2035.5,120.5
"15769","51182","2016",1,1,0,115000,858,134
"15770","51183","2016",10,9,1,217021,1887.4,121.1
"15771","51184","2016",1,1,0,126450,1421,89
"15772","51187","2016",5,5,0,148690,1806.4,85.4
"15773","51188","2016",1,1,0,225000,2228,101
"15774","51193","2016",13,13,0,185259.6,1546.692,120.0769
"15775","51194","2016",5,5,0,164630,1257.6,136.8
"15776","51195","2016",6,6,0,133733.3,1286.167,107
"15777","51196","2016",9,9,0,220166.7,1812.333,128.6667
"15778","51197","2016",1,1,0,109000,991,110
"15779","51198","2016",7,7,0,152614.3,1456.571,102
"15780","51199","2016",6,6,0,133233.3,1583,84.5
"15781","51200","2016",4,4,0,169750,1796.5,96.5
"15782","51201","2016",2,2,0,175275,1716.5,107
"15783","51202","2016",6,6,0,164000,1783.5,97.5
"15784","51205","2016",4,4,0,154261.2,1556.75,98.75
"15785","51206","2016",3,3,0,52666.67,409,135.3333
"15786","51208","2016",1,1,0,207500,1609,129
"15787","51212","2016",1,1,0,103500,908,114
"15788","51216","2016",1,1,0,1e+05,870,115
"15789","51218","2016",2,2,0,78000,944.5,82.5
"15790","51220","2016",1,1,0,160000,1391,115
"15791","51223","2016",1,1,0,35000,795,44
"15792","51225","2016",2,2,0,201000,1553,130
"15793","51226","2016",1,1,0,40000,571,70
"15794","51227","2016",3,3,0,191100,1162.667,171.6667
"15795","51228","2016",4,4,0,85875,730.75,111.5
"15796","51230","2016",259,144,115,137313.9,1676.483,80.64865
"15797","51231","2016",7,7,0,148428.6,1425.857,108.7143
"15798","51238","2016",6,6,0,134875,1352.833,101.3333
"15799","51239","2016",1,1,0,80000,988,81
"15800","51242","2016",45,39,6,136516.8,1621.844,89.55556
"15801","51244","2016",1,1,0,127000,1270,100
"15802","51245","2016",6,6,0,158041.7,1932.667,81.83333
"15803","51248","2016",15,15,0,99480.8,1179.8,95.46667
"15804","51250","2016",46,43,3,138074.6,1519.739,97.56522
"15805","51253","2016",2,2,0,85750,782,107.5
"15806","51262","2016",26,26,0,122019,1297,98.84615
"15807","51263","2016",5,5,0,116320,1871.2,71.2
"15808","51264","2016",8,8,0,128687.5,1371,110.875
"15809","51266","2016",7,7,0,172657.1,1857.714,97.57143
"15810","51268","2016",4,4,0,126075,1119.75,116.5
"15811","51272","2016",7,7,0,76057.14,717.4286,105.8571
"15812","51278","2016",1,1,0,154000,1656,93
"15813","51281","2016",5,5,0,176600,1630,110.6
"15814","51282","2016",18,17,1,369605.6,2901,125.2222
"15815","51285","2016",1,1,0,71483,851,84
"15816","51286","2016",1,1,0,120000,800,150
"15817","51289","2016",3,3,0,112666.7,635,172.6667
"15818","51290","2016",1,1,0,50000,581,86
"15819","51291","2016",15,15,0,196775.3,1769.067,112.5333
"15820","51292","2016",1,1,0,134000,1441,93
"15821","51293","2016",4,4,0,160875,1184.5,132.75
"15822","51295","2016",4,4,0,132000,891.25,150.5
"15823","51299","2016",8,8,0,268562.5,1617.875,167.5
"15824","51302","2016",1,1,0,166600,1587,105
"15825","51303","2016",6,6,0,148923.7,1474,103.1667
"15826","51304","2016",2,2,0,117234,797.5,143
"15827","51305","2016",1,1,0,196000,1782,110
"15828","51308","2016",24,24,0,214020.9,2036.042,106.625
"15829","51309","2016",1,1,0,207000,1511,137
"15830","51310","2016",5,5,0,223600,2508.2,111.6
"15831","51311","2016",1,1,0,81000,1246,65
"15832","51312","2016",8,8,0,175331.2,1522.5,117.875
"15833","51314","2016",2,2,0,152250,1425.5,111
"15834","51315","2016",3,3,0,96000,1094.333,86.66667
"15835","51318","2016",2,2,0,204000,1863,140
"15836","51319","2016",1,1,0,63500,882,72
"15837","51321","2016",1,1,0,178200,1697,105
"15838","51326","2016",11,11,0,182672.7,1559.636,124.6364
"15839","51327","2016",1,1,0,55000,982,56
"15840","51328","2016",14,14,0,138860.7,1274.5,113.5
"15841","51329","2016",11,11,0,202038.2,2074.091,102
"15842","51333","2016",2,2,0,162300,2388,70.5
"15843","51334","2016",3,3,0,119333.3,1395,85
"15844","51337","2016",2,2,0,183500,1140.5,160
"15845","51338","2016",4,4,0,217750,1682.5,121
"15846","51340","2016",4,4,0,108800,1384.75,83.75
"15847","51341","2016",1,1,0,97000,729,133
"15848","51342","2016",2,2,0,112000,962.5,112.5
"15849","51344","2016",15,15,0,153894.5,2103.533,90.66667
"15850","51352","2016",6,6,0,140200,1492,96
"15851","51354","2016",1,1,0,105000,1522,69
"15852","51357","2016",6,6,0,175833.3,1458.333,127.1667
"15853","51359","2016",2,2,0,141750,1548,100
"15854","51362","2016",6,6,0,192333.3,1911,100.8333
"15855","51365","2016",8,8,0,320862.5,2365.75,139.625
"15856","51367","2016",9,9,0,129300,1360.889,103.3333
"15857","51372","2016",6,6,0,196041.7,1873,109.8333
"15858","51375","2016",3,3,0,199333.3,2442.667,80.66667
"15859","51378","2016",3,3,0,197566.7,1664.333,124
"15860","51379","2016",7,7,0,226442.9,1527.571,153.1429
"15861","51380","2016",34,34,0,122855.9,1256.735,101.4118
"15862","51384","2016",4,4,0,172305,1403.75,124
"15863","51386","2016",1,1,0,130000,644,202
"15864","51387","2016",3,3,0,171000,2012.333,112
"15865","51388","2016",20,19,1,151472.5,1407.55,109.35
"15866","51389","2016",6,6,0,156250,1665.667,100
"15867","51390","2016",8,8,0,169137.5,1873,95.875
"15868","51391","2016",23,19,4,192771.3,2136,91.43478
"15869","51393","2016",2,2,0,217375,1602,148.5
"15870","51397","2016",2,2,0,75000,819.5,93
"15871","51398","2016",2,2,0,135000,1586.5,92
"15872","51399","2016",5,5,0,93600,921.6,113.2
"15873","51403","2016",2,2,0,237500,1293.5,197.5
"15874","51413","2016",7,7,0,172442.9,1719.286,105.4286
"15875","51415","2016",1,1,0,90000,1184,76
"15876","51418","2016",3,3,0,264500,2268,131.6667
"15877","51420","2016",1,1,0,106500,1268,84
"15878","51422","2016",3,3,0,397000,2685.333,142
"15879","51425","2016",4,4,0,131000,1501.25,94.5
"15880","51428","2016",2,2,0,211000,2230.5,99.5
"15881","51431","2016",17,15,2,179117.1,2048.176,90.88235
"15882","51434","2016",4,4,0,206250,1914.5,117.25
"15883","51435","2016",1,1,0,110000,733,150
"15884","51438","2016",2,2,0,107040,1185,92
"15885","51439","2016",1,1,0,150000,833,180
"15886","51440","2016",22,22,0,186136.1,1567.136,124.2727
"15887","51442","2016",3,3,0,69500,530.3333,131.6667
"15888","51444","2016",5,5,0,286480,1993.8,136.8
"15889","51445","2016",1,1,0,237000,1657,143
"15890","51446","2016",1,1,0,78500,785,100
"15891","51447","2016",1,1,0,317350,1563,203
"15892","51448","2016",9,9,0,175055.6,1853,88.44444
"15893","51449","2016",6,6,0,206216.7,2431.5,86.83333
"15894","51450","2016",1,1,0,374120,2267,165
"15895","51453","2016",3,3,0,174640,1930.333,91
"15896","51454","2016",2125,527,1598,150535.1,2153.781,70.912
"15897","51455","2016",3,3,0,158333.3,1395.333,115.3333
"15898","51460","2016",4,4,0,137000,1164.5,128.25
"15899","51461","2016",12,12,0,269888.3,2188.75,125.9167
"15900","51463","2016",1,1,0,184000,2140,86
"15901","51464","2016",2,2,0,188500,2166.5,97
"15902","51466","2016",2,2,0,134500,1431.5,103
"15903","51468","2016",2,2,0,596100,2458,235
"15904","51469","2016",1,1,0,150000,1119,134
"15905","51471","2016",2,2,0,128500,1490,86.5
"15906","51472","2016",13,13,0,137073.1,1203,112.7692
"15907","51474","2016",28,20,8,183521.6,2063.214,89.42857
"15908","51476","2016",5,5,0,156712,1680.6,108.8
"15909","51477","2016",4,4,0,176900,1677.75,114.5
"15910","51478","2016",6,6,0,184283.3,1394,132.5
"15911","51479","2016",1,1,0,80000,762,105
"15912","51483","2016",3,3,0,184198.3,1712.667,107
"15913","51484","2016",3,3,0,171693.3,1659,106.3333
"15914","51485","2016",1,1,0,182560,2006,91
"15915","51486","2016",4,4,0,127275,964,134.5
"15916","51487","2016",2,2,0,196250,1237,161
"15917","51490","2016",1,1,0,156080,1381,113
"15918","51491","2016",1,1,0,35500,433,82
"15919","51496","2016",4,4,0,159500,1340,115.75
"15920","51501","2016",2,2,0,136650,1211.5,111.5
"15921","51504","2016",8,8,0,149006.2,1499.25,98
"15922","51505","2016",5,5,0,125330,1424.2,90.4
"15923","51506","2016",46,33,13,142178.3,1589.935,94.82609
"15924","51507","2016",50,41,9,90349,949.7,95.76
"15925","51515","2016",4,4,0,91000,831.5,105.75
"15926","51517","2016",1,1,0,92000,692,133
"15927","51518","2016",5,5,0,228760,1780,127.2
"15928","51519","2016",2,2,0,112000,1193,98
"15929","51522","2016",4,4,0,136185,1239.75,104.5
"15930","51523","2016",4,4,0,220075,1672.75,136
"15931","51525","2016",16,16,0,187885.6,1724.875,111.9375
"15932","51526","2016",5,5,0,130740,1082.8,122.4
"15933","51527","2016",2,2,0,173850,1709.5,108.5
"15934","51529","2016",2,2,0,153500,1155,131.5
"15935","51530","2016",5,5,0,198340,1793.6,112.4
"15936","51532","2016",6,6,0,226103.3,2593.167,99.5
"15937","51536","2016",9,7,2,293008.3,2290.333,131.4444
"15938","51539","2016",2,2,0,78500,658.5,118.5
"15939","51544","2016",5,5,0,112100,1089.4,104.2
"15940","51545","2016",4,4,0,117250,1211.5,101.25
"15941","51546","2016",5,5,0,140008,1176.6,116.2
"15942","51547","2016",2,2,0,74025,568,128.5
"15943","51548","2016",4,4,0,157450,1279.25,126.5
"15944","51552","2016",2,2,0,149500,1093.5,136.5
"15945","51553","2016",1,1,0,170000,1429,119
"15946","51555","2016",1,1,0,180000,933,193
"15947","51556","2016",3,3,0,130000,1397,92.66667
"15948","51557","2016",7,7,0,109828.6,953.5714,103.2857
"15949","51559","2016",28,25,3,104092.8,1221.179,84.46429
"15950","51560","2016",1,1,0,48000,1600,30
"15951","51562","2016",19,19,0,301443.7,2520.263,120.2632
"15952","51566","2016",3,3,0,154000,1450.667,110.3333
"15953","51568","2016",2,2,0,250370,1977.5,125.5
"15954","51569","2016",3,3,0,375666.7,2318,162
"15955","51570","2016",1,1,0,285650,2621,109
"15956","51571","2016",6,6,0,263025,2085.5,123.1667
"15957","51572","2016",2,2,0,52000,899,74
"15958","51573","2016",104,63,41,196124.3,2197.923,90.80769
"15959","51576","2016",17,17,0,205501.7,1804.824,102.9412
"15960","51577","2016",2,2,0,285500,1352.5,216
"15961","51578","2016",1,1,0,70000,875,80
"15962","51579","2016",2,2,0,82250,1441.5,57
"15963","51580","2016",3,3,0,320900,2344.667,114.3333
"15964","51581","2016",2,2,0,219065,1911.5,114
"15965","51582","2016",2,2,0,97100,1659,57.5
"15966","51583","2016",2,2,0,141500,1118,129.5
"15967","51584","2016",1,1,0,460000,1797,256
"15968","51586","2016",4,4,0,181650,1475.75,131.5
"15969","51587","2016",2,2,0,210000,1302,160
"15970","51590","2016",2,2,0,116000,1191,101
"15971","51592","2016",2,2,0,76500,1108,69.5
"15972","51594","2016",2,2,0,69000,817.5,85.5
"15973","51595","2016",1,1,0,138000,1062,130
"15974","51596","2016",4,4,0,152000,1271,128.25
"15975","51598","2016",7,7,0,127500,1249,106
"15976","51599","2016",3,3,0,175910.7,1251.667,145
"15977","51600","2016",1,1,0,19000,413,46
"15978","51601","2016",1,1,0,132580,804,165
"15979","51602","2016",1,1,0,143300,1194,120
"15980","51604","2016",1,1,0,80250,933,86
"15981","51608","2016",2,2,0,83500,1082.5,84.5
"15982","51610","2016",2,2,0,109750,1283,87
"15983","51612","2016",31,30,1,218874.2,1957.548,108.871
"15984","51613","2016",8,8,0,164206.2,1798.5,94.625
"15985","51614","2016",13,12,1,204635.5,1673.308,132
"15986","51617","2016",5,5,0,165200,1649.4,102.6
"15987","51619","2016",1,1,0,49500,717,69
"15988","51622","2016",3,3,0,221666.7,1922.333,115
"15989","51623","2016",2,2,0,295000,1695.5,223
"15990","51624","2016",9,9,0,179500,1639.444,113
"15991","51626","2016",5,5,0,86820,725.6,123.8
"15992","51627","2016",4,4,0,269125,1600.25,173.25
"15993","51629","2016",8,5,3,212990,2097,106.5
"15994","51630","2016",4,4,0,112750,1371.25,79
"15995","51632","2016",8,8,0,87750,871.75,110.25
"15996","51633","2016",1,1,0,170000,1619,105
"15997","51634","2016",1,1,0,240000,1297,185
"15998","51636","2016",9,9,0,139288.9,1151.444,124.2222
"15999","51638","2016",1,1,0,157050,1402,112
"16000","51640","2016",3,3,0,108166.7,935.6667,116
"16001","51643","2016",5,5,0,179190,1869.8,108.6
"16002","51647","2016",8,8,0,119418.8,1044.75,116.625
"16003","51649","2016",72,49,23,94705.83,1039.681,94.76389
"16004","51654","2016",1,1,0,121500,1180,103
"16005","51655","2016",2,2,0,608175,2684.5,247
"16006","51656","2016",2,2,0,142000,1310,107.5
"16007","51657","2016",2,2,0,119220,1301,93.5
"16008","51658","2016",1,1,0,45000,506,89
"16009","51660","2016",20,20,0,188889,1946.05,97.75
"16010","51662","2016",45,37,8,217748.7,1909.022,116.0222
"16011","51663","2016",16,16,0,144500,1625.812,92.875
"16012","52006","2016",6,6,0,95333.33,1166.167,84.16667
"16013","52021","2016",2,2,0,146750,1131.5,130
"16014","52034","2016",3,3,0,77500,707.6667,110.6667
"16015","52045","2016",21,21,0,136747.6,1308.476,107.0476
"16016","52053","2016",1,1,0,138800,586,237
"16017","52060","2016",13,13,0,72061.54,733,95.69231
"16018","52061","2016",2,2,0,100500,962.5,103
"16019","52072","2016",3,3,0,73333.33,899.3333,84.66667
"16020","52079","2016",5,5,0,50770.8,647,79
"16021","52088","2016",6,6,0,84833.33,931.5,96.5
"16022","52093","2016",14,14,0,80728.5,900.5714,87.57143
"16023","52104","2016",7,7,0,117968.6,1114.143,112.2857
"16024","52114","2016",14,12,2,68900,732,93.92857
"16025","52121","2016",240,153,87,102154.4,1251.617,81.925
"16026","52125","2016",11,10,1,123310.5,1423.545,96.36364
"16027","52140","2016",7,7,0,98357.14,1021.571,104.5714
"16028","52141","2016",2,2,0,193000,1665.5,111
"16029","52151","2016",1,1,0,150000,1027,146
"16030","52158","2016",3,3,0,130008.3,1104.667,116
"16031","52171","2016",2,2,0,37500,469.5,81
"16032","52175","2016",3,3,0,84400,864,94.66667
"16033","52182","2016",16,15,1,112765.6,1195.5,92.8125
"16034","52193","2016",1,1,0,55000,1833,30
"16035","52198","2016",1,1,0,1e+05,952,105
"16036","52235","2016",2,2,0,1e+05,901.5,103.5
"16037","52244","2016",2,2,0,128400,1347,95
"16038","52250","2016",17,11,6,63281.71,774.4118,78.35294
"16039","52251","2016",9,9,0,151977.8,1388.444,110
"16040","52253","2016",2,2,0,120000,995.5,149.5
"16041","52254","2016",1,1,0,70000,875,80
"16042","52269","2016",55,39,16,96325.93,1113.982,90.72727
"16043","52276","2016",1,1,0,53000,646,82
"16044","52294","2016",7,7,0,107708.6,1164.286,94.57143
"16045","52327","2016",5,5,0,138550,1222.4,114
"16046","52331","2016",17,17,0,120352.9,1289.824,99.82353
"16047","52386","2016",3,3,0,67833.33,741,84
"16048","52391","2016",2,2,0,137452.5,1192.5,110
"16049","52411","2016",11,11,0,114964,898.1818,128.9091
"16050","52413","2016",1,1,0,80000,556,144
"16051","52421","2016",2,2,0,136545,1262.5,110
"16052","52448","2016",168,121,47,97679.94,1178.601,83.94048
"16053","52469","2016",6,5,1,89000,764.6667,124.6667
"16054","52479","2016",1,1,0,55000,859,64
"16055","52487","2016",1,1,0,64100,583,110
"16056","52494","2016",5,5,0,137560,1210.2,121.2
"16057","52497","2016",6,6,0,88250,986.8333,95
"16058","52500","2016",14,14,0,120017.9,1240.286,97.35714
"16059","52510","2016",2,2,0,74600,954.5,80
"16060","52520","2016",1,1,0,45000,634,71
"16061","52534","2016",13,13,0,118461.5,1270.615,95.92308
"16062","52535","2016",7,7,0,100028.6,1101.857,89.28571
"16063","52543","2016",6,6,0,133000,1004,137.1667
"16064","52550","2016",20,20,0,95021.5,854.5,120.75
"16065","53001","2016",22,21,1,125018.2,1249.409,99
"16066","53002","2016",4,4,0,102225,1052.75,92.75
"16067","53003","2016",26,26,0,102993.8,1001.038,102.0769
"16068","53005","2016",21,21,0,102106.7,1259.143,80.61905
"16069","53007","2016",23,23,0,151482.6,1380.826,110.7826
"16070","53008","2016",13,13,0,137935.1,1336.231,102.3077
"16071","53009","2016",7,7,0,132571.4,1284.714,106.2857
"16072","53010","2016",2,2,0,82500,1039,77.5
"16073","53011","2016",10,10,0,129266.9,1275.3,98.4
"16074","53012","2016",6,6,0,124333.3,1219.333,104.5
"16075","53013","2016",2,2,0,82750,981.5,84.5
"16076","53015","2016",25,25,0,130960,1476.52,94.32
"16077","53016","2016",10,10,0,91600,916.5,97.3
"16078","53017","2016",11,11,0,86454.55,1025.727,86.18182
"16079","53018","2016",9,9,0,97222.22,1038.889,92.11111
"16080","53021","2016",6,6,0,173344.3,1328.167,134
"16081","53022","2016",4,4,0,138250,826.25,162.25
"16082","53023","2016",8,8,0,127250,1063.125,116.75
"16083","53025","2016",8,8,0,101025,1037.875,94.625
"16084","53026","2016",3,3,0,110000,1008.667,113.6667
"16085","53027","2016",1,1,0,20000,370,54
"16086","53028","2016",3,3,0,102363.3,1100.667,98.66667
"16087","53029","2016",9,9,0,135577.8,1137,116.6667
"16088","53030","2016",5,5,0,153038,2233.6,92.2
"16089","53031","2016",3,3,0,203333.3,1429.667,140.3333
"16090","53033","2016",2,2,0,265250,2134,167.5
"16091","53034","2016",58,55,3,184020.6,1798.948,105.1207
"16092","53035","2016",8,7,1,111625,1157.125,98.75
"16093","53036","2016",7,7,0,89274.57,1025,76.28571
"16094","53037","2016",8,8,0,129500,1220.875,108.25
"16095","53039","2016",16,14,2,89181.25,972.9375,91.1875
"16096","53040","2016",8,8,0,106253.9,917.125,112.5
"16097","53041","2016",3,3,0,124666.7,1104,113.6667
"16098","53042","2016",5,5,0,111000,1145,97.2
"16099","53043","2016",8,7,1,84750,1249.75,83.625
"16100","53045","2016",7,7,0,101314.3,1083.571,96.42857
"16101","53046","2016",2,2,0,97500,1013,103
"16102","53047","2016",3,3,0,56000,810.3333,72
"16103","53048","2016",17,15,2,106980.5,1193.824,92.05882
"16104","53049","2016",7,7,0,102085.7,1113.429,92.71429
"16105","53051","2016",12,12,0,105273.8,865,122.5
"16106","53052","2016",7,7,0,64900,924.1429,83.28571
"16107","53053","2016",5,5,0,62240,899.6,69
"16108","53054","2016",45,43,2,206375.6,2009.933,106.1333
"16109","53055","2016",5,5,0,68303.8,704,95
"16110","53056","2016",3,3,0,131333.3,1209.667,106.6667
"16111","53057","2016",1,1,0,130000,1016,128
"16112","53058","2016",2,2,0,89750,1285.5,71
"16113","53059","2016",6,6,0,148416.7,1506.667,107.8333
"16114","53061","2016",3,3,0,48333.33,791.3333,59
"16115","53062","2016",181,159,22,123327.4,1353.58,91.37017
"16116","53063","2016",8,8,0,114500,1059.625,105.375
"16117","53064","2016",14,14,0,75958.93,808.7857,93.85714
"16118","53066","2016",17,17,0,116457.1,1155.412,102.5294
"16119","53067","2016",7,7,0,86814.29,936.2857,98
"16120","53068","2016",2,2,0,139500,816.5,158.5
"16121","53069","2016",3,3,0,44116.67,531.3333,75.66667
"16122","53071","2016",6,6,0,91484.17,920,92.83333
"16123","53072","2016",6,6,0,118583.3,1117.833,108.5
"16124","53073","2016",7,7,0,90500,948.4286,87.28571
"16125","53074","2016",8,8,0,102575,1104.375,90.25
"16126","53075","2016",3,3,0,121333.3,1171.333,101.6667
"16127","53076","2016",5,5,0,83520,1099.4,93.2
"16128","53077","2016",25,25,0,113904.4,1094.88,98.64
"16129","53078","2016",7,7,0,130214.3,944.7143,139.1429
"16130","53079","2016",12,12,0,57256.67,731.8333,82.83333
"16131","53080","2016",4,4,0,163375,833,219.5
"16132","53082","2016",6,5,1,162070,1396,102.8333
"16133","53083","2016",9,9,0,84416.67,688,110.7778
"16134","53084","2016",50,49,1,98131.32,1068.34,90.96
"16135","53085","2016",2,2,0,53500,849.5,87
"16136","53086","2016",4,4,0,78750,744.25,100.5
"16137","53087","2016",4,4,0,97500,1072,91.75
"16138","53088","2016",4,4,0,90250,853.25,112
"16139","53089","2016",10,10,0,76628,794.8,90.9
"16140","53090","2016",1,1,0,125000,801,156
"16141","53091","2016",7,7,0,67142.86,1332.429,63.71429
"16142","53093","2016",7,7,0,76922.14,798,99.14286
"16143","53094","2016",9,9,0,143888.9,1626.556,88.66667
"16144","53096","2016",59,59,0,107978.7,1060.102,103.2542
"16145","53097","2016",79,75,4,106839.3,1142.468,95.24051
"16146","53098","2016",4,4,0,100500,972.75,104
"16147","53099","2016",6,6,0,127583.3,1404,91.66667
"16148","53100","2016",12,12,0,58520.83,782.3333,72.58333
"16149","53101","2016",6,6,0,174500,1562,107.3333
"16150","53102","2016",2,2,0,64337,708.5,86.5
"16151","53103","2016",16,16,0,88719.94,940,96.3125
"16152","53104","2016",8,8,0,84625,1094.25,79.375
"16153","53106","2016",4,4,0,90750,1563,69
"16154","53107","2016",23,23,0,87666.09,918.0435,95.65217
"16155","53108","2016",9,9,0,120959.8,1042.556,125
"16156","53109","2016",2,2,0,156250,1334,115
"16157","53110","2016",9,9,0,80888.89,1025.667,80.88889
"16158","53111","2016",2,2,0,69000,889,78
"16159","53112","2016",5,5,0,86436,1065.2,83.8
"16160","53113","2016",4,4,0,82500,1056.5,75
"16161","53115","2016",1,1,0,60000,1000,60
"16162","53116","2016",9,9,0,76633.33,758.1111,101.3333
"16163","53117","2016",7,7,0,93799.57,1147.571,79.85714
"16164","53118","2016",3,3,0,60000,705,76.33333
"16165","53119","2016",30,30,0,195139.6,1808.4,112.0333
"16166","53120","2016",12,12,0,85863.08,966.9167,93.33333
"16167","53121","2016",14,14,0,55678.21,670.7143,82.92857
"16168","53122","2016",11,11,0,97140.91,1125.727,88.45455
"16169","53123","2016",15,15,0,89867.33,884.3333,97.86667
"16170","53124","2016",14,13,1,117675,1078.5,116.5714
"16171","53125","2016",7,7,0,132057.1,1476.714,80.14286
"16172","53126","2016",14,14,0,85943.5,1051.286,74.14286
"16173","53127","2016",25,25,0,78390.24,930.64,87.44
"16174","53128","2016",4,4,0,103000,937.25,115.5
"16175","53129","2016",6,6,0,130183.3,1098.833,123
"16176","53130","2016",668,316,352,120468.5,1475.9,79.82635
"16177","53131","2016",3,3,0,126333.3,761,171.6667
"16178","53132","2016",2,2,0,128500,1143,137.5
"16179","53133","2016",6,6,0,105016.7,1242,66.16667
"16180","53135","2016",4,4,0,147500,1427.75,99.75
"16181","53136","2016",4,4,0,163187.5,1112.5,149.75
"16182","53137","2016",28,28,0,139634.6,1465.036,102.2143
"16183","53139","2016",2,2,0,85000,1020.5,80.5
"16184","53140","2016",46,43,3,145984.8,1525.652,98.58696
"16185","53141","2016",7,7,0,157552.4,1559.143,98.42857
"16186","53142","2016",6,6,0,40460,595.1667,66.33333
"16187","53143","2016",5,5,0,136880,1158.2,131.4
"16188","53144","2016",8,8,0,89657.5,986.25,90.5
"16189","53145","2016",7,7,0,99548.86,1198.429,79.28571
"16190","53146","2016",8,7,1,103787.5,1132.625,85.125
"16191","53147","2016",125,92,33,116873.8,1291.528,91.576
"16192","53148","2016",4,4,0,177650,2112.75,100.75
"16193","53150","2016",8,8,0,93925,986,91.75
"16194","53151","2016",8,8,0,140750,1090.75,125.625
"16195","53152","2016",28,25,3,108747.2,1219.429,88.75
"16196","53153","2016",3,3,0,145666.7,1391,111.3333
"16197","53154","2016",10,10,0,62428,968.5,74.3
"16198","53155","2016",8,8,0,94443.12,964.5,105.5
"16199","53156","2016",5,5,0,137200,1196.2,113.6
"16200","53157","2016",12,12,0,122308.3,1385.917,90.91667
"16201","53158","2016",13,12,1,106453.8,1202.154,86.61538
"16202","53160","2016",9,9,0,107677.8,970.1111,114.6667
"16203","53161","2016",31,29,2,89926.1,1051.29,84.93548
"16204","53162","2016",10,9,1,117850,1311.7,93.6
"16205","53163","2016",9,9,0,71125.56,964.8889,75.55556
"16206","53164","2016",3,3,0,113000,1192,94.33333
"16207","53165","2016",1,1,0,65000,1226,53
"16208","53168","2016",17,17,0,124617.6,1208.235,101.0588
"16209","53169","2016",6,6,0,120416.7,1747.5,70.83333
"16210","53170","2016",10,10,0,92210,871.4,105.6
"16211","53172","2016",5,5,0,127500,1204.8,104.8
"16212","53173","2016",1,1,0,83300,750,111
"16213","53174","2016",4,4,0,232500,1787.5,128.75
"16214","53175","2016",6,6,0,120916.7,1499.333,81.66667
"16215","53176","2016",5,5,0,68980,727.4,94.2
"16216","53178","2016",2,2,0,88300,712.5,123.5
"16217","53179","2016",5,5,0,53168.4,739.4,64.4
"16218","53180","2016",5,5,0,126300,1106.4,108
"16219","53181","2016",6,6,0,80416.67,928,89.16667
"16220","53182","2016",22,22,0,87681.82,970.0455,90.04545
"16221","53185","2016",22,22,0,83090.91,900.9091,92.54545
"16222","53186","2016",21,20,1,105699.9,1103.333,96.66667
"16223","53187","2016",2,2,0,60000,1000.5,63.5
"16224","53188","2016",16,16,0,89498.12,936.3125,98.6875
"16225","53189","2016",2,2,0,149250,2117,64
"16226","53190","2016",5,5,0,59400,836,71.2
"16227","53191","2016",4,4,0,106605,1269.25,84.75
"16228","53192","2016",4,4,0,72385,916.5,81
"16229","53193","2016",4,4,0,103125,856.25,115.5
"16230","53195","2016",3,3,0,124333.3,1541.667,105
"16231","53196","2016",2,2,0,78400,991.5,77
"16232","53197","2016",6,6,0,66833.33,619.6667,110.3333
"16233","53198","2016",3,3,0,116166.7,1003,110
"16234","53199","2016",2,2,0,44500,885,57
"16235","53200","2016",6,6,0,112625,1082.5,107.1667
"16236","53201","2016",76,70,6,147756.2,1585.5,92.82895
"16237","53202","2016",7,7,0,67582.14,728.8571,93.42857
"16238","53203","2016",2,2,0,88250,1174,77
"16239","53204","2016",1,1,0,50000,877,57
"16240","53206","2016",1,1,0,45200,886,51
"16241","53208","2016",5,5,0,89300,1265,69.2
"16242","53209","2016",5,5,0,131400,1289.6,99.8
"16243","53210","2016",11,11,0,137739.5,1310.455,102.8182
"16244","53211","2016",16,15,1,104086.9,954.6875,106.6875
"16245","53212","2016",5,5,0,169200,1613.6,105.8
"16246","53213","2016",4,4,0,74300,679.25,112.75
"16247","53214","2016",2,2,0,152500,1179,131
"16248","53216","2016",6,6,0,106000,1071,104.3333
"16249","53218","2016",3,3,0,38000,767.6667,48
"16250","53219","2016",5,5,0,70940,703.2,107.2
"16251","53221","2016",3,3,0,59666.67,781.6667,75
"16252","53222","2016",4,4,0,116550,1106,102.5
"16253","53223","2016",8,8,0,94662.5,1119.375,103.5
"16254","53224","2016",9,9,0,168666.7,1416.111,118.6667
"16255","53225","2016",5,5,0,147600,1012,149.2
"16256","53226","2016",7,7,0,161071.4,1321.143,130.2857
"16257","53228","2016",6,6,0,114500,1016,127.6667
"16258","53229","2016",17,17,0,150788.2,1251.882,115.4706
"16259","53230","2016",4,4,0,85125,873.5,101.5
"16260","53232","2016",2,2,0,195000,2125.5,91
"16261","53233","2016",3,3,0,168000,1622.333,102.6667
"16262","53234","2016",4,4,0,112400,958.25,109
"16263","53235","2016",2,2,0,54000,706,97.5
"16264","53236","2016",1,1,0,42500,708,60
"16265","53237","2016",5,5,0,103800,1008.2,104
"16266","53238","2016",9,9,0,73746.67,1200.222,64.22222
"16267","53240","2016",4,4,0,316572.5,2312.5,98.5
"16268","53242","2016",4,4,0,75725,1189.5,68.5
"16269","53243","2016",20,20,0,161347.5,1553.15,109.6
"16270","53245","2016",9,9,0,97333.33,1030.111,96.55556
"16271","53246","2016",16,16,0,102903.1,1180.625,84.125
"16272","53247","2016",19,19,0,101849.1,1061.158,99.42105
"16273","53249","2016",15,15,0,81158.93,1071,88.86667
"16274","53250","2016",3,3,0,144666.7,1166.333,124.3333
"16275","53251","2016",4,4,0,74775,910.5,72.75
"16276","53253","2016",3,3,0,130000,1078,125.3333
"16277","53255","2016",11,11,0,107377.3,1203.273,89.54545
"16278","53256","2016",1,1,0,31500,394,80
"16279","53257","2016",3,3,0,87850,930,93.66667
"16280","53258","2016",8,8,0,64187.5,838.625,74
"16281","53259","2016",6,6,0,129533.3,1554.167,96.5
"16282","53260","2016",3,3,0,123113.3,937.3333,124
"16283","53261","2016",2,2,0,80000,548.5,137
"16284","53262","2016",10,10,0,117650,1200.7,99.5
"16285","53263","2016",2,2,0,116650,1587,69
"16286","53264","2016",3,3,0,102683.3,781.3333,134.6667
"16287","53265","2016",7,7,0,105214.3,1105.286,101.2857
"16288","53266","2016",3,3,0,87733.33,1442.333,52
"16289","53267","2016",20,20,0,90809.4,983.6,94.2
"16290","53269","2016",6,6,0,138563.5,1375.167,114.6667
"16291","53270","2016",4,4,0,128462.5,1218.75,108
"16292","53271","2016",22,20,2,85733.18,948.9545,89.86364
"16293","53272","2016",4,4,0,89973.75,1051,99
"16294","53273","2016",7,7,0,125571.4,1195.857,110.4286
"16295","53276","2016",5,5,0,93350,1170.4,83.6
"16296","54001","2016",3,3,0,137633.3,1140.333,119.3333
"16297","54002","2016",3,3,0,90000,1278,72.33333
"16298","54004","2016",3,3,0,156333.3,1017,143
"16299","54006","2016",3,3,0,226666.7,1721.667,132
"16300","54007","2016",4,4,0,181750,1434.5,137
"16301","54008","2016",6,6,0,107416.7,1283.333,90.83333
"16302","54009","2016",1,1,0,148000,860,172
"16303","54010","2016",7,7,0,116678.6,1161,104.4286
"16304","54011","2016",5,5,0,124200,1011,110.4
"16305","54012","2016",2,2,0,165560,1709.5,102.5
"16306","54013","2016",2,2,0,96500,670,147.5
"16307","54014","2016",2,2,0,60000,754.5,85
"16308","54015","2016",1,1,0,85000,452,188
"16309","54016","2016",4,4,0,135100,1315,101
"16310","54017","2016",1,1,0,22000,611,36
"16311","54018","2016",3,3,0,128350,1505,98
"16312","54021","2016",3,3,0,161750,1379,126.6667
"16313","54022","2016",11,10,1,169977.3,1375.455,122.1818
"16314","54023","2016",4,4,0,130700,878.75,144
"16315","54024","2016",2,2,0,136362.5,1539,91
"16316","54025","2016",18,13,5,174381.9,2061.889,85.77778
"16317","54027","2016",9,9,0,160422.2,1672.667,107.4444
"16318","54028","2016",32,20,12,81076.56,1100.125,73.03125
"16319","54029","2016",20,16,4,148863,1484.15,98.2
"16320","54030","2016",1,1,0,107000,1189,90
"16321","54032","2016",2,2,0,162500,1161,131.5
"16322","54034","2016",2,1,1,149550,1178,128.5
"16323","54035","2016",3,3,0,97666.67,612.6667,149
"16324","54036","2016",6,6,0,180223.8,1736.333,104
"16325","54037","2016",1,1,0,225000,2273,99
"16326","54038","2016",10,10,0,123850,1083,122.1
"16327","54039","2016",39,25,14,95630.77,1216,84.15385
"16328","54040","2016",22,22,0,84518.18,802.0455,107
"16329","54042","2016",4,4,0,136000.2,1320,113
"16330","54043","2016",8,5,3,143350,1391.75,101.5
"16331","54045","2016",7,6,1,150000,1382.857,114.5714
"16332","54046","2016",2,2,0,129000,1394,91.5
"16333","54047","2016",1,1,0,136480,1157,118
"16334","54048","2016",5,5,0,101400,902.8,110.8
"16335","54049","2016",8,8,0,107043.8,1344.25,84.375
"16336","54051","2016",7,7,0,118571.4,1420.429,84.28571
"16337","54053","2016",1,1,0,80750,702,115
"16338","54054","2016",12,11,1,149933.3,1276.417,123.8333
"16339","54055","2016",4,3,1,138250,1416.5,109.75
"16340","54056","2016",2,2,0,105000,528,199
"16341","54057","2016",1,1,0,152000,1226,124
"16342","54058","2016",1,1,0,128000,1455,88
"16343","54059","2016",9,9,0,153302.7,1502.667,108.5556
"16344","54060","2016",11,9,2,182281.8,2373.091,84.27273
"16345","54062","2016",4,4,0,112000,1014,111.25
"16346","54065","2016",12,12,0,100533.3,1497.833,82.75
"16347","54066","2016",1,1,0,145000,1768,82
"16348","54067","2016",8,6,2,123875,1274.75,97.375
"16349","54069","2016",3,2,1,232500,2196.667,114.3333
"16350","54070","2016",3,3,0,149880,1438.333,111
"16351","54071","2016",1,1,0,73000,676,108
"16352","54072","2016",3,2,1,119083.3,946,128.6667
"16353","54073","2016",9,9,0,104933.3,1118.222,101.4444
"16354","54075","2016",6,6,0,93966.67,1168.333,73.83333
"16355","54076","2016",45,42,3,128716,1326.356,101.8222
"16356","54077","2016",11,11,0,95409.09,1066.182,98
"16357","54079","2016",25,20,5,109710.4,1401.16,81.76
"16358","54080","2016",9,8,1,122711.1,928.6667,139.7778
"16359","54081","2016",1,1,0,110000,1100,100
"16360","54082","2016",2,2,0,85775,740.5,114.5
"16361","54083","2016",1,1,0,50000,556,90
"16362","54084","2016",13,13,0,81992.69,953.3846,86.53846
"16363","54085","2016",1,1,0,71000,689,103
"16364","54086","2016",6,6,0,92966.67,932.3333,111
"16365","54087","2016",2,2,0,110000,528,207
"16366","54088","2016",2,2,0,85300,739,115.5
"16367","54089","2016",22,20,2,178664.5,1957.273,96.18182
"16368","54090","2016",53,44,9,155695,1720.264,90.98113
"16369","54091","2016",2,2,0,232400,1866.5,122.5
"16370","54092","2016",1,1,0,173400,1576,110
"16371","54093","2016",1,1,0,35000,350,100
"16372","54095","2016",1,1,0,50000,610,82
"16373","54096","2016",2,2,0,271484.5,1963.5,142.5
"16374","54097","2016",1,1,0,108300,902,120
"16375","54098","2016",2,2,0,83500,1034,80
"16376","54099","2016",94,56,38,118232.2,1235.085,90.96809
"16377","54100","2016",8,8,0,145856.2,1476,101.25
"16378","54101","2016",1,1,0,47100,628,75
"16379","54102","2016",8,8,0,149617.5,1113.75,131
"16380","54103","2016",2,2,0,211450,1680.5,130
"16381","54104","2016",1,1,0,149000,1505,99
"16382","54105","2016",10,10,0,120480,1213.3,101
"16383","54107","2016",1,1,0,105300,650,162
"16384","54108","2016",1,1,0,45000,900,50
"16385","54109","2016",11,11,0,163900,1515.273,109.0909
"16386","54110","2016",5,5,0,171945,1785.6,95.6
"16387","54111","2016",32,25,7,123382.2,1410.094,85.65625
"16388","54112","2016",12,12,0,175095.8,1573.833,125.3333
"16389","54113","2016",16,16,0,177832.2,1578.75,120.375
"16390","54114","2016",2,2,0,175000,1794.5,97
"16391","54115","2016",52,29,23,132593.7,1537.096,84.71154
"16392","54116","2016",29,28,1,174871.4,1512.724,117.8276
"16393","54117","2016",1,1,0,74720,946,79
"16394","54118","2016",7,7,0,121714.3,2280.857,82.71429
"16395","54120","2016",2,2,0,134650,1108,122
"16396","54121","2016",1,1,0,175000,1144,153
"16397","54122","2016",10,10,0,153990,1212.1,136.8
"16398","54123","2016",18,17,1,141066.1,1546.111,91.88889
"16399","54125","2016",4,4,0,140212.5,1341,109.25
"16400","54126","2016",2,2,0,255377.5,1576.5,162.5
"16401","54127","2016",2,2,0,126000,875,147
"16402","54128","2016",5,5,0,122200,1078.8,115.2
"16403","54129","2016",11,11,0,69781.82,879,89.36364
"16404","54130","2016",3,3,0,77333.33,763.3333,90.66667
"16405","54131","2016",4,4,0,92512.5,968.5,102
"16406","54132","2016",1,1,0,178000,1262,141
"16407","54133","2016",2,2,0,54000,539.5,108.5
"16408","54134","2016",3,3,0,106000,1447.333,72.66667
"16409","54135","2016",18,17,1,157658.9,1328.833,120.5
"16410","54136","2016",23,21,2,121865.2,1307.435,93.04348
"16411","54137","2016",7,7,0,110928.6,935,116.7143
"16412","54138","2016",26,21,5,205731.2,1985,103.3462
"16413","54139","2016",2,2,0,158100,1408.5,123
"16414","54140","2016",1,1,0,50000,735,68
"16415","54141","2016",2,2,0,201000,1755,118
"16416","54142","2016",3,3,0,63116.67,614,102.3333
"16417","54143","2016",2,2,0,36000,685.5,55
"16418","54144","2016",2,2,0,167250,1502.5,111
"16419","54145","2016",12,11,1,146765,1179.25,124.4167
"16420","54146","2016",2,2,0,130500,845,157
"16421","54147","2016",1,1,0,147000,980,150
"16422","54148","2016",7,7,0,110000,947.2857,122.1429
"16423","54149","2016",24,24,0,150449.5,1559.458,98.45833
"16424","54150","2016",28,27,1,134612.6,1518.143,86.92857
"16425","54151","2016",6,4,2,121883.3,1615.167,79.33333
"16426","54152","2016",38,38,0,145668.8,1419.579,106.6316
"16427","54154","2016",5,5,0,72020,557.8,130.6
"16428","54155","2016",4,3,1,97625,958.5,115
"16429","54156","2016",3,3,0,160700,1302.667,118.6667
"16430","54157","2016",49,46,3,126911.2,1431.347,91.53061
"16431","54158","2016",1,1,0,190650,1306,146
"16432","54159","2016",124,109,15,132070.5,1352.427,100.7177
"16433","54160","2016",5,5,0,113500,1179,101.2
"16434","54161","2016",5,5,0,107400,824.8,133.6
"16435","54162","2016",14,14,0,131739.3,1253.071,105.2143
"16436","54163","2016",3,3,0,70833.33,704.3333,108.6667
"16437","54165","2016",4,4,0,343250,2571.25,128.75
"16438","54167","2016",15,15,0,165810,1492.467,114.6667
"16439","54169","2016",2,2,0,125500,1533.5,85.5
"16440","54171","2016",7,6,1,160414.3,1475.143,110.1429
"16441","54172","2016",2,2,0,272500,2047.5,130.5
"16442","54173","2016",2,2,0,136500,957.5,138.5
"16443","54174","2016",29,24,5,155922.5,1471.966,110.1379
"16444","54175","2016",1,1,0,159750,1452,110
"16445","54176","2016",9,9,0,147833.3,970.6667,132.6667
"16446","54178","2016",2,2,0,121000,753,159
"16447","54179","2016",1,1,0,139000,1544,90
"16448","54181","2016",5,5,0,143600,1519.6,95.8
"16449","54182","2016",10,9,1,97825,904.2,106.5
"16450","54183","2016",1,1,0,44000,721,61
"16451","54184","2016",102,50,52,148427.9,1848.627,79.7549
"16452","54186","2016",14,13,1,212432.1,1833.429,119.2143
"16453","54188","2016",9,9,0,146733.3,1444.222,102.2222
"16454","54189","2016",5,5,0,95500,810.8,116.2
"16455","54192","2016",2,2,0,150750,1419,126
"16456","54194","2016",4,4,0,89462.5,873.5,104
"16457","54195","2016",1,1,0,167000,1670,100
"16458","54196","2016",21,15,6,129497.6,1505.81,94.85714
"16459","54197","2016",23,22,1,251308.5,2132.913,120.3478
"16460","54198","2016",2,2,0,52500,638,89
"16461","54199","2016",1,1,0,210000,1040,202
"16462","54201","2016",4,4,0,62950,940.5,80.5
"16463","54202","2016",6,6,0,194583.3,1833,104.8333
"16464","54203","2016",1,1,0,303000,1870,162
"16465","54204","2016",1,1,0,202000,1683,120
"16466","54205","2016",19,18,1,110289.5,1279,88.42105
"16467","54206","2016",2,2,0,140137.5,1367,100.5
"16468","54208","2016",3,3,0,98800,1423,77.66667
"16469","54209","2016",1,1,0,163400,1021,160
"16470","54210","2016",4,4,0,146125,920,170.25
"16471","54211","2016",2,2,0,87917.5,560.5,160
"16472","54212","2016",6,6,0,210716.7,1121.5,173.6667
"16473","54213","2016",3,3,0,215406.7,1983.667,106.3333
"16474","54214","2016",7,7,0,156280.7,1732.857,95.14286
"16475","54215","2016",69,52,17,126232.4,1418.493,92.47826
"16476","54216","2016",2,2,0,84500,661,113
"16477","54218","2016",1,1,0,72000,766,94
"16478","54219","2016",1,1,0,155000,969,160
"16479","54221","2016",3,3,0,122000,1637.667,74.33333
"16480","54222","2016",13,13,0,115500,1154.615,100.0769
"16481","54223","2016",2,2,0,119450,838.5,148.5
"16482","54224","2016",1,1,0,122000,1220,100
"16483","54225","2016",1,1,0,309200,1636,189
"16484","54226","2016",2,2,0,86000,749,119.5
"16485","54227","2016",6,6,0,97791.67,1193.167,82
"16486","54229","2016",2,2,0,99800,1296.5,79.5
"16487","54231","2016",4,4,0,137312.5,1015.75,138
"16488","54232","2016",25,19,6,173996.4,1587.92,114.04
"16489","54234","2016",31,25,6,139793.3,1749.258,83.70968
"16490","54235","2016",2,2,0,154500,1739.5,88.5
"16491","54236","2016",1,1,0,95000,1188,80
"16492","54238","2016",4,4,0,127971.2,1557,98.5
"16493","54239","2016",3,3,0,138000,1039.667,117.6667
"16494","54240","2016",1,1,0,168000,1135,148
"16495","54242","2016",1,1,0,33000,635,52
"16496","54243","2016",2,2,0,63650,612,99.5
"16497","54245","2016",1,1,0,93500,954,98
"16498","54247","2016",1,1,0,110000,982,112
"16499","54249","2016",3,3,0,118383.3,1080.333,115.6667
"16500","54250","2016",9,9,0,156377.8,1456.556,108.4444
"16501","54251","2016",1,1,0,70000,500,140
"16502","54252","2016",5,4,1,130960,899.2,150
"16503","54253","2016",7,6,1,124528.6,1490.857,85.14286
"16504","54254","2016",31,31,0,149988.4,1663.71,90.67742
"16505","54255","2016",1,1,0,197000,1970,100
"16506","54256","2016",5,5,0,153940,1373.8,112.2
"16507","54257","2016",39,27,12,190027.4,2134.59,90.5641
"16508","54258","2016",2,2,0,63500,644.5,105
"16509","54259","2016",3,3,0,124166.7,973.6667,127
"16510","54260","2016",10,10,0,138250,1226.6,113.9
"16511","54261","2016",65,42,23,103170.4,1257.892,86.33846
"16512","54262","2016",3,3,0,53833.33,608.3333,88.66667
"16513","54263","2016",57,46,11,89336.32,1080.14,83.7193
"16514","54265","2016",18,14,4,235927.8,2202.389,100.9444
"16515","54266","2016",8,8,0,116025.6,957.375,122
"16516","54268","2016",2,2,0,101000,1052.5,97.5
"16517","54269","2016",2,2,0,195000,1485.5,128
"16518","54270","2016",44,41,3,154758.8,1669.409,89.97727
"16519","54272","2016",3,3,0,185883.3,1439.333,127.6667
"16520","54273","2016",71,55,16,105682.2,1242.113,85.98592
"16521","54274","2016",79,34,45,124643.1,1592.304,77.48101
"16522","54275","2016",1,1,0,92000,708,130
"16523","54276","2016",2,2,0,141000,1266.5,112.5
"16524","54277","2016",2,2,0,69000,728,85.5
"16525","54278","2016",1,1,0,32000,533,60
"16526","54279","2016",11,10,1,169968.2,1436.818,116.7273
"16527","54280","2016",85,55,30,68617.76,864.3294,80.76471
"16528","54281","2016",12,12,0,164137.5,1613.5,107.4167
"16529","54284","2016",7,7,0,70378.57,857.7143,83.71429
"16530","54286","2016",9,9,0,129111.1,1686.667,78.66667
"16531","54287","2016",3,3,0,142540,1136.333,126
"16532","54288","2016",7,7,0,134928.6,1131.143,131.5714
"16533","54289","2016",3,3,0,165716.7,1712.667,96.66667
"16534","54291","2016",2,2,0,133275,1044,130
"16535","54292","2016",2,2,0,147500,1085,142.5
"16536","54293","2016",1,1,0,51500,429,120
"16537","54294","2016",1,1,0,163000,1254,130
"16538","54295","2016",10,9,1,106500,993.1,104.3
"16539","54296","2016",3,2,1,225000,2060.333,105
"16540","54297","2016",2,2,0,84500,708,119
"16541","54298","2016",2,2,0,188050,1140,169.5
"16542","54299","2016",1,1,0,166000,1277,130
"16543","54300","2016",58,36,22,168201,1715.69,95.94828
"16544","54301","2016",2,2,0,50150,670,79
"16545","54302","2016",7,7,0,158371.4,1601.143,105.4286
"16546","54303","2016",4,4,0,162375,889,174.5
"16547","54304","2016",155,52,103,151095.9,1757.213,85.31613
"16548","54305","2016",20,19,1,248330.5,2141,123.45
"16549","54306","2016",1,1,0,140800,1380,102
"16550","54307","2016",1,1,0,65000,436,149
"16551","54309","2016",7,7,0,81342.86,1270,70.57143
"16552","54311","2016",9,8,1,177227.8,1571.222,122.1111
"16553","54312","2016",6,6,0,204416.7,1715.5,131.5
"16554","54313","2016",1,1,0,163000,1087,150
"16555","54314","2016",30,23,7,187648.3,1967.933,97.53333
"16556","54315","2016",7,6,1,134428.6,1484.714,92.85714
"16557","54316","2016",6,6,0,178182.5,1648.167,110.8333
"16558","54318","2016",61,56,5,153413.2,1440.59,108.8525
"16559","54320","2016",3,3,0,147566.7,1635,92.66667
"16560","54321","2016",27,23,4,109837.5,1305.444,84.74074
"16561","54322","2016",50,33,17,99054.66,1179.16,86.9
"16562","54323","2016",136,85,51,111168.3,1230.949,91.81618
"16563","54324","2016",1,1,0,146750,1834,80
"16564","54325","2016",2,2,0,108250,865.5,134.5
"16565","54326","2016",2,2,0,85410,922,88.5
"16566","54327","2016",10,10,0,117460,1096,111.5
"16567","54328","2016",51,37,14,197020.5,1930.333,102.0196
"16568","54329","2016",138,82,56,103208.8,1142.058,91.54348
"16569","54330","2016",1,1,0,120000,816,147
"16570","54331","2016",3,3,0,87333.33,705,121.3333
"16571","54332","2016",16,11,5,145639.4,1487.938,99
"16572","54333","2016",4,4,0,142805.5,1153.25,135.25
"16573","54334","2016",9,9,0,119911.1,1134,108.6667
"16574","54335","2016",9,9,0,154716.7,1657.111,102.3333
"16575","54336","2016",10,10,0,163421.4,1408.6,124.3
"16576","54337","2016",1,1,0,160000,1290,124
"16577","54338","2016",11,11,0,135963.6,1381.455,112.0909
"16578","54339","2016",105,47,58,138859.1,1560.905,87.73333
"16579","54340","2016",3,3,0,109343,1290.333,86.66667
"16580","54343","2016",2,2,0,139500,876,159
"16581","54344","2016",3,3,0,143216.7,1622.333,90.66667
"16582","54345","2016",3,3,0,259666.7,2099.667,123.6667
"16583","54346","2016",2,2,0,238729.5,1549.5,149.5
"16584","54348","2016",4,4,0,130025,1044,123
"16585","54350","2016",12,12,0,102916.7,1065.667,98.41667
"16586","54351","2016",30,26,4,120880,1448.633,83.06667
"16587","54352","2016",10,10,0,155108,1504.6,114.1
"16588","54353","2016",9,9,0,113433.3,1046.667,113.1111
"16589","54355","2016",3,3,0,137773.3,1268,110.6667
"16590","54357","2016",57,27,30,122873.3,1657.825,74.50877
"16591","54358","2016",1,1,0,192400,1603,120
"16592","54359","2016",2,2,0,86077.5,802.5,113
"16593","54360","2016",6,6,0,166250,1359.333,131.5
"16594","54362","2016",14,13,1,114076.2,1328.286,88.35714
"16595","54363","2016",1,1,0,170000,1037,164
"16596","54364","2016",6,6,0,196225,1795.167,107.5
"16597","54365","2016",3,3,0,192033.3,1686.667,116.3333
"16598","54366","2016",13,11,2,155839.8,1852.462,83.38462
"16599","54367","2016",18,17,1,163644.4,1706.833,99.05556
"16600","54368","2016",2,2,0,52500,416.5,122.5
"16601","54369","2016",8,8,0,174304.4,1634.375,105.125
"16602","54371","2016",9,9,0,158295.6,1489.333,105.7778
"16603","54372","2016",6,6,0,152803.3,1521.333,103.5
"16604","54373","2016",4,3,1,139625,1132.75,124.75
"16605","54374","2016",5,5,0,148380,1636.2,89.8
"16606","54375","2016",20,15,5,147967.7,1488.2,100.6
"16607","54376","2016",2,2,0,154245,1505,104
"16608","54378","2016",3,3,0,133666.7,1603.333,87.33333
"16609","54379","2016",1,1,0,148750,1549,96
"16610","54380","2016",11,11,0,169932.1,1176,152
"16611","54382","2016",67,55,12,120173.1,1313.134,90.8209
"16612","54383","2016",10,10,0,155144.5,1584.9,99.7
"16613","54385","2016",8,8,0,159972.5,1388.875,111.75
"16614","54386","2016",1,1,0,115000,762,151
"16615","54387","2016",2,2,0,146150,1110,136.5
"16616","54388","2016",2,2,0,77500,854.5,92.5
"16617","54389","2016",3,3,0,124333.3,1005,111.6667
"16618","54390","2016",2,2,0,168500,1517,111.5
"16619","54391","2016",21,21,0,96777.52,1165.857,83.61905
"16620","54392","2016",3,3,0,172416.7,1266.667,137.3333
"16621","54393","2016",6,6,0,127350,1224.333,117.1667
"16622","54395","2016",1652,183,1469,132167.1,1923.89,69.16344
"16623","54396","2016",2,2,0,61500,622,101.5
"16624","54397","2016",56,47,9,128042.6,1502.786,86.76786
"16625","54399","2016",1,1,0,50000,526,95
"16626","54400","2016",14,12,2,143815,1326.929,111
"16627","54402","2016",4,4,0,113000,856.25,147.75
"16628","54403","2016",12,12,0,190470.8,1590.5,122.9167
"16629","54404","2016",1,1,0,90000,789,114
"16630","54405","2016",7,7,0,134857.1,1065.286,140.1429
"16631","54410","2016",5,5,0,170820,1748.2,100
"16632","54411","2016",2,2,0,165875,1327.5,119
"16633","54414","2016",3,3,0,192600,1484.667,133.3333
"16634","54415","2016",51,39,12,146850.4,1523.922,101.8431
"16635","54418","2016",5,5,0,78400,1159.8,86.4
"16636","54420","2016",2,2,0,137500,1166.5,125
"16637","54421","2016",3,3,0,47666.67,617.3333,81.66667
"16638","54423","2016",3,3,0,54000,677.6667,79.33333
"16639","54425","2016",28,26,2,77808.93,853.7143,93.60714
"16640","54426","2016",7,6,1,137528.6,1212.857,121.1429
"16641","54427","2016",2,2,0,1e+05,714,138
"16642","54428","2016",10,8,2,112845,1170.5,101.1
"16643","54429","2016",3,3,0,143333.3,1204.333,139
"16644","54430","2016",60,47,13,111195.6,1332.517,83.68333
"16645","54431","2016",121,64,57,129424.1,1407.248,94.50413
"16646","54432","2016",23,18,5,118547.8,1552.739,88.86957
"16647","54433","2016",1,1,0,130000,1275,102
"16648","54434","2016",3,3,0,158000,1519.667,123.3333
"16649","54435","2016",4,4,0,252335,2090.5,135.75
"16650","54437","2016",10,10,0,108900,1167.8,105.8
"16651","54439","2016",45,38,7,176000.5,1793.933,97.57778
"16652","54441","2016",3,3,0,189683.3,1270.667,166
"16653","54443","2016",1,1,0,147000,1547,95
"16654","54444","2016",4,4,0,174250,1579.5,114.5
"16655","54447","2016",1,1,0,40000,465,86
"16656","54449","2016",9,9,0,149366.7,1513.556,96.66667
"16657","54451","2016",47,37,10,127210.9,1409.681,89.6383
"16658","54452","2016",1,1,0,113000,869,130
"16659","54453","2016",4,3,1,120750,1091.25,98.25
"16660","54455","2016",2,2,0,65000,584.5,120.5
"16661","54456","2016",5,5,0,132510,1060.8,124.4
"16662","54458","2016",1,1,0,175000,1606,109
"16663","54459","2016",29,28,1,205144.1,1817.172,112.3103
"16664","54461","2016",1,1,0,206500,1444,143
"16665","54462","2016",34,25,9,130086.5,1353.324,95.85294
"16666","54463","2016",3,3,0,128833.3,1277.667,96.66667
"16667","54464","2016",1,1,0,195000,929,210
"16668","54465","2016",7,5,2,126451.3,1206.429,107.4286
"16669","54466","2016",6,6,0,118048.7,895.3333,133.8333
"16670","54467","2016",1,1,0,40000,625,64
"16671","54469","2016",4,4,0,191450.2,1039.25,182
"16672","54472","2016",8,6,2,90537.5,923.25,103.25
"16673","54473","2016",3,3,0,64540,665.6667,91
"16674","54474","2016",1,1,0,77000,1185,65
"16675","54475","2016",2,2,0,68000,732.5,91
"16676","54476","2016",8,4,4,59187.5,803.125,81.125
"16677","54477","2016",1,1,0,115000,913,126
"16678","54478","2016",2,0,2,101500,813.5,126.5
"16679","54479","2016",2,2,0,152000,1300.5,117
"16680","54480","2016",1,1,0,145000,1169,124
"16681","54482","2016",154,54,100,143780.8,1697.532,84.12987
"16682","54483","2016",66,45,21,126917,1514.5,85.43939
"16683","54484","2016",2,2,0,71500,425.5,181
"16684","54485","2016",5,5,0,165230,1209.4,139.8
"16685","54486","2016",4,4,0,145375,1147.5,135.5
"16686","54487","2016",1,1,0,71250,950,75
"16687","54489","2016",2,2,0,106250,872.5,121
"16688","54490","2016",12,12,0,140008.3,1300,116.6667
"16689","54491","2016",4,4,0,123500,1497,95
"16690","54492","2016",2,2,0,150000,923,150.5
"16691","54493","2016",38,30,8,108840.8,1219.921,89.15789
"16692","54495","2016",40,39,1,213272.5,1921.325,112.575
"16693","54496","2016",4,4,0,51672.25,646.75,80.75
"16694","54498","2016",63,59,4,169212.2,1752.794,97.74603
"16695","54499","2016",3,3,0,126166.7,682,179.6667
"16696","54500","2016",1,1,0,279000,1641,170
"16697","54502","2016",2,2,0,120000,758.5,168.5
"16698","54504","2016",6,6,0,178683.3,1436.167,124.1667
"16699","54505","2016",5,4,1,157512,1326.6,115.4
"16700","54507","2016",2,2,0,177000,1644,109.5
"16701","54508","2016",3,2,1,98000,1116.333,86.66667
"16702","54509","2016",11,10,1,136136.4,1446.455,94.72727
"16703","54511","2016",2,2,0,157900,1428.5,118.5
"16704","54512","2016",2,2,0,132500,1193.5,112.5
"16705","54513","2016",3,3,0,109166.7,1331,82.33333
"16706","54514","2016",4,3,1,131250,1153.5,102.75
"16707","54515","2016",3,3,0,140666.7,1185.667,123
"16708","54517","2016",1,1,0,159881,1537,104
"16709","54518","2016",5,5,0,133000,1169.4,119.4
"16710","54519","2016",7,7,0,108500,1021.143,119.1429
"16711","54520","2016",3,3,0,94166.67,1164.667,81
"16712","54521","2016",20,16,4,103080.2,1383.1,72.5
"16713","54522","2016",1,1,0,108450,1084,100
"16714","54524","2016",1,1,0,65000,433,150
"16715","54525","2016",6,5,1,228092,1632.167,143.1667
"16716","54526","2016",90,71,19,154854.2,1744.522,88.22222
"16717","54527","2016",8,8,0,182162.5,1492,132.5
"16718","54528","2016",138,84,54,139882.4,1430.877,100.8696
"16719","54529","2016",1,1,0,119080,673,177
"16720","54532","2016",3,3,0,145000,1354.333,108
"16721","54533","2016",19,16,3,134527.4,1368.737,98.94737
"16722","54534","2016",4,4,0,111200,1027.25,104.75
"16723","54535","2016",2,2,0,179000,1347,107.5
"16724","54536","2016",38,35,3,101787.8,1135.526,93.60526
"16725","54537","2016",2,2,0,259700,1796,150
"16726","54538","2016",3,3,0,69366.67,707.3333,104
"16727","54539","2016",3,3,0,91666.67,632.6667,139.6667
"16728","54540","2016",7,7,0,69671.43,817.2857,86.71429
"16729","54541","2016",1,1,0,163000,1207,135
"16730","54542","2016",29,28,1,123958.8,1481.414,82.44828
"16731","54543","2016",1,1,0,35000,354,99
"16732","54544","2016",1,1,0,177000,1180,150
"16733","54545","2016",2,2,0,82600,719.5,102
"16734","54546","2016",11,10,1,120580.1,1227.909,111.4545
"16735","54547","2016",306,84,222,101181.3,1583.722,66.81373
"16736","54548","2016",3,3,0,78766.67,630.3333,116.6667
"16737","54549","2016",48,38,10,118208.8,1338.229,90.9375
"16738","54550","2016",4,1,3,107250,1107.5,95.75
"16739","54551","2016",1,1,0,69000,663,104
"16740","54552","2016",2,2,0,74000,954,80
"16741","54553","2016",1,1,0,148150,1743,85
"16742","54554","2016",1,1,0,70000,486,144
"16743","54557","2016",21,21,0,246173.8,1923.571,131.5714
"16744","54559","2016",3,3,0,181966.7,1475,126
"16745","54560","2016",1,1,0,107050,535,200
"16746","54563","2016",14,14,0,142945.6,1302.714,113.4286
"16747","54564","2016",3,3,0,104100,963.3333,107.6667
"16748","54565","2016",2,2,0,99000,1081.5,92.5
"16749","54566","2016",2,2,0,130500,1119.5,113.5
"16750","54567","2016",4,4,0,122751.2,900.5,136.5
"16751","54568","2016",4,4,0,151125,1267,123.25
"16752","54570","2016",2,2,0,85000,1072.5,79
"16753","54571","2016",3,3,0,151220,1414.667,109
"16754","54572","2016",7,7,0,166221.4,1696.571,100.8571
"16755","54573","2016",4,4,0,186720,1713.75,126.75
"16756","54574","2016",1,1,0,408500,2723,150
"16757","54575","2016",8,7,1,158162.5,1487.875,112.75
"16758","54576","2016",1,1,0,230000,1983,116
"16759","54578","2016",205,93,112,161665.5,1882.244,85.63415
"16760","54579","2016",3,3,0,95433.33,930.6667,102.6667
"16761","54580","2016",142,111,31,114500,1429.408,81.79577
"16762","54581","2016",2,2,0,185000,1618.5,115
"16763","54583","2016",2,2,0,189000,1486.5,129
"16764","54584","2016",10,8,2,177393,1486.3,123.2
"16765","54585","2016",3,3,0,97766.67,1083,78.66667
"16766","54586","2016",8,8,0,134242.5,1416.875,95.875
"16767","54588","2016",1,1,0,153000,2013,76
"16768","54589","2016",1,1,0,131500,1277,103
"16769","54590","2016",9,9,0,177444.4,1594.333,127.5556
"16770","54591","2016",3,3,0,159666.7,1381,143.6667
"16771","54592","2016",5,5,0,147628,1046.2,145.4
"16772","54593","2016",11,11,0,135181.8,1266.818,111.9091
"16773","54594","2016",1,1,0,138000,1314,105
"16774","54595","2016",4,4,0,197625,1579.5,127.5
"16775","54596","2016",4,4,0,142725,1402,104.25
"16776","54597","2016",5,5,0,73600,715,102.8
"16777","54598","2016",3,3,0,75200,482.6667,152
"16778","54599","2016",1,1,0,60000,800,75
"16779","55001","2016",2,2,0,141380,1578,90.5
"16780","55004","2016",1,1,0,40000,471,85
"16781","55009","2016",6,6,0,89250,1160,74.33333
"16782","55010","2016",32,31,1,111685.8,1055.406,113.1562
"16783","55011","2016",4,4,0,77000,810.25,85
"16784","55012","2016",7,7,0,106857.1,961.1429,123
"16785","55013","2016",4,4,0,113835,1093.75,115.25
"16786","55014","2016",4,4,0,119000,998.5,116.25
"16787","55015","2016",5,5,0,122253.8,1238,101
"16788","55024","2016",1,1,0,60000,800,75
"16789","55025","2016",2,2,0,97650,720,136
"16790","55026","2016",1,1,0,42200,469,90
"16791","55027","2016",1,1,0,150000,1429,105
"16792","55029","2016",128,78,50,100973.9,1027.211,96.23438
"16793","55035","2016",1,1,0,27500,458,60
"16794","55038","2016",1,1,0,120000,1348,89
"16795","55041","2016",6,6,0,103120,1077.833,94.83333
"16796","55042","2016",2,2,0,206025,1455.5,141.5
"16797","55043","2016",31,27,4,125703.2,1337.548,96.90323
"16798","55047","2016",2,2,0,106250,889.5,123
"16799","55049","2016",7,7,0,129771.4,1123.143,112.5714
"16800","55053","2016",3,3,0,107833.3,904.3333,117.3333
"16801","55058","2016",2,2,0,108000,796,142.5
"16802","55060","2016",3,3,0,97333.33,854.3333,121
"16803","55063","2016",25,24,1,75299.28,963.16,80.4
"16804","55064","2016",1,1,0,190000,1152,165
"16805","55066","2016",1,1,0,60000,632,95
"16806","55068","2016",3,3,0,58000,674,88.33333
"16807","55069","2016",2,2,0,152500,1366.5,110
"16808","55070","2016",2,2,0,78000,776,116
"16809","55071","2016",2,2,0,88500,850.5,98.5
"16810","55072","2016",2,2,0,48500,390,122
"16811","55073","2016",10,10,0,148342,1357,108.9
"16812","55075","2016",4,4,0,97850,952.5,98.5
"16813","55076","2016",2,2,0,93500,528,169
"16814","55077","2016",3,3,0,88433.33,915.6667,98.33333
"16815","55078","2016",4,4,0,87900,922.25,91.25
"16816","55079","2016",4,4,0,93110,1239.75,86.25
"16817","55082","2016",1,1,0,125000,1471,85
"16818","55085","2016",1,1,0,45000,738,61
"16819","55087","2016",1,1,0,40000,471,85
"16820","55088","2016",4,4,0,72490,960.5,79.5
"16821","55093","2016",3,3,0,102333.3,726,111.6667
"16822","55094","2016",7,7,0,120001.4,1046.857,120
"16823","55096","2016",2,2,0,138000,1330.5,108
"16824","55097","2016",3,3,0,101360,960,117
"16825","55099","2016",1,1,0,90000,750,120
"16826","55102","2016",5,5,0,145200,1295,126.6
"16827","55103","2016",1,1,0,58500,585,100
"16828","55107","2016",1,1,0,165000,1813,91
"16829","55110","2016",1,1,0,40000,714,56
"16830","55111","2016",2,2,0,132000,898,143
"16831","55113","2016",3,3,0,72000,675.3333,115.3333
"16832","55116","2016",1,1,0,79961,635,126
"16833","55117","2016",10,10,0,114945,1015.7,124.8
"16834","55118","2016",3,3,0,60500,657.3333,87.33333
"16835","55119","2016",2,2,0,111000,1241.5,90
"16836","55120","2016",4,4,0,143450,1410.75,102.25
"16837","55121","2016",3,3,0,74333.33,1020.333,80
"16838","55122","2016",42,31,11,100196.4,1144.833,91.40476
"16839","55123","2016",6,6,0,135250,946.8333,156.3333
"16840","55124","2016",2,2,0,74000,1296,59
"16841","55125","2016",2,2,0,125500,1111.5,111.5
"16842","55129","2016",1,1,0,55000,393,140
"16843","55134","2016",2,2,0,157000,1004.5,156.5
"16844","55142","2016",1,1,0,110000,679,162
"16845","55143","2016",1,1,0,82000,863,95
"16846","55144","2016",4,4,0,102095,846.5,122.25
"16847","55145","2016",4,4,0,89866.25,814,114.25
"16848","55146","2016",2,2,0,74500,653.5,104.5
"16849","55153","2016",2,2,0,121500,1353.5,90.5
"16850","55154","2016",13,13,0,102815.4,975.7692,107.3077
"16851","55155","2016",5,5,0,112600,750,150.8
"16852","55156","2016",2,2,0,97500,779,125
"16853","55159","2016",5,5,0,90600,892.6,98.2
"16854","55163","2016",1,1,0,150000,1765,85
"16855","55166","2016",8,8,0,89041.62,939.125,92.875
"16856","55167","2016",9,9,0,74944.44,847.3333,87.88889
"16857","55169","2016",5,5,0,123900,1236.8,93.8
"16858","55170","2016",3,3,0,105000,869.6667,137.3333
"16859","55171","2016",4,4,0,139500,1082.75,134
"16860","55175","2016",1,1,0,45000,662,68
"16861","55178","2016",3,3,0,103400,870,116
"16862","55184","2016",20,20,0,101805,1002.55,105.8
"16863","55185","2016",1,1,0,46000,708,65
"16864","55186","2016",19,19,0,141762.1,1352.632,111.9474
"16865","55193","2016",3,3,0,62333.33,836.6667,79.66667
"16866","55194","2016",2,2,0,42500,561,76
"16867","55196","2016",1,1,0,89000,1328,67
"16868","55198","2016",12,12,0,143323.5,1176.083,125.6667
"16869","55200","2016",4,4,0,120325,1214.5,100.25
"16870","55202","2016",2,2,0,57500,625,100
"16871","55206","2016",2,2,0,78500,2782,57
"16872","55214","2016",3,3,0,85500,738.3333,115.6667
"16873","55218","2016",1,1,0,125000,691,181
"16874","55221","2016",2,2,0,49000,484,101.5
"16875","55222","2016",1,1,0,149250,878,170
"16876","55224","2016",4,4,0,121620,1197.5,101.75
"16877","55225","2016",1,1,0,60000,652,92
"16878","55226","2016",1,1,0,65000,684,95
"16879","55228","2016",4,3,1,90000,1090.25,86.5
"16880","55229","2016",3,3,0,105100,1063.333,102.6667
"16881","55232","2016",1,1,0,70000,538,130
"16882","55236","2016",9,9,0,126211.1,1155,111.1111
"16883","55237","2016",2,2,0,153250,1328.5,115.5
"16884","55242","2016",1,1,0,65000,855,76
"16885","55243","2016",3,3,0,98166.67,910,109
"16886","55245","2016",5,5,0,90800,1100.2,108
"16887","55250","2016",2,2,0,46000,488.5,97.5
"16888","55251","2016",2,2,0,62500,752.5,80.5
"16889","55253","2016",6,5,1,68416.67,840.5,80.66667
"16890","55255","2016",3,3,0,76666.67,916.6667,89.33333
"16891","55258","2016",6,6,0,96855,845.6667,108.6667
"16892","55261","2016",1,1,0,60000,517,116
"16893","55263","2016",2,2,0,75500,522.5,145
"16894","55267","2016",5,5,0,92600,980.2,90.6
"16895","55268","2016",4,4,0,123250,924,135.75
"16896","55271","2016",3,3,0,120716.7,1149,109.3333
"16897","55272","2016",4,4,0,179165,942.5,184.75
"16898","55274","2016",6,6,0,181416.7,1156.167,129.1667
"16899","55276","2016",2,2,0,139000,1236,112.5
"16900","55279","2016",3,3,0,115000,1133.667,98.33333
"16901","55281","2016",1,1,0,110000,1250,88
"16902","55285","2016",1,1,0,72000,545,132
"16903","55286","2016",4,4,0,97375,1025,103
"16904","55288","2016",17,17,0,78441.18,873.1765,91.11765
"16905","55289","2016",1,1,0,50305,457,110
"16906","55291","2016",23,20,3,92953.48,902.4783,99.91304
"16907","55292","2016",2,2,0,81000,902,81
"16908","55296","2016",8,8,0,105962.5,1050.625,101.25
"16909","55297","2016",1,1,0,22000,386,57
"16910","55298","2016",1,1,0,74000,725,102
"16911","55300","2016",3,3,0,89833.33,655.3333,132
"16912","55302","2016",10,9,1,95778.5,964.5,102.7
"16913","55303","2016",4,4,0,72750,1043.25,91.75
"16914","55306","2016",1,1,0,89000,840,106
"16915","55310","2016",1,1,0,97000,1010,96
"16916","55312","2016",2,2,0,62500,599,99.5
"16917","55317","2016",1,1,0,151000,1510,100
"16918","55320","2016",1,1,0,145000,1318,110
"16919","55321","2016",2,2,0,168500,948.5,188.5
"16920","55323","2016",1,1,0,82000,726,113
"16921","55324","2016",1,1,0,57600,411,140
"16922","55326","2016",1,1,0,135000,900,150
"16923","55328","2016",3,3,0,119333.3,1023.667,113
"16924","55329","2016",1,1,0,90000,497,181
"16925","55332","2016",4,4,0,96700,805.25,121.5
"16926","55333","2016",2,2,0,153000,1082.5,150
"16927","55335","2016",1,1,0,156820,1039,151
"16928","55340","2016",1,1,0,98000,1324,74
"16929","55341","2016",2,2,0,51000,358,142
"16930","55345","2016",1,1,0,115000,561,205
"16931","55346","2016",4,4,0,91950,854.5,109.75
"16932","55348","2016",3,3,0,81166.67,678,128
"16933","55349","2016",2,2,0,26000,463.5,56
"16934","55351","2016",18,17,1,112488.9,1222.278,93.88889
"16935","55353","2016",1,1,0,60000,600,100
"16936","55355","2016",2,2,0,49600,683,68.5
"16937","55356","2016",1,1,0,147000,1235,119
"16938","55358","2016",2,2,0,91950,1058.5,91
"16939","55359","2016",1,1,0,74400,767,97
"16940","55360","2016",1,1,0,27000,794,34
"16941","55361","2016",1,1,0,115000,661,174
"16942","55364","2016",3,3,0,111666.7,758.6667,143
"16943","55365","2016",2,2,0,45000,989.5,60.5
"16944","55366","2016",12,12,0,108141.7,978.1667,112.6667
"16945","55369","2016",9,9,0,117281.4,1078.222,104.4444
"16946","55370","2016",2,2,0,123300,1000.5,130.5
"16947","55372","2016",4,4,0,115768.2,1063.5,114.25
"16948","55373","2016",2,2,0,128500,743,172
"16949","55376","2016",1,1,0,115500,947,122
"16950","55386","2016",1,1,0,112100,747,150
"16951","55388","2016",2,2,0,69250,681,93.5
"16952","55389","2016",5,5,0,73728,614.2,122
"16953","55391","2016",2,2,0,79500,719.5,109.5
"16954","55399","2016",2,2,0,105100,956.5,98.5
"16955","55400","2016",1,1,0,85000,531,160
"16956","55408","2016",1,1,0,60000,550,109
"16957","55414","2016",2,2,0,125350,1160,113.5
"16958","55423","2016",1,1,0,180000,1125,160
"16959","55426","2016",6,6,0,118410,1026.833,109.8333
"16960","55427","2016",25,20,5,94100,1061.32,91.72
"16961","55430","2016",1,1,0,47000,1237,38
"16962","55435","2016",8,8,0,82676.25,947.375,85.5
"16963","55437","2016",2,2,0,49000,537,89.5
"16964","55439","2016",1,1,0,175000,1174,149
"16965","55442","2016",1,1,0,123300,771,160
"16966","55457","2016",5,5,0,90556,861,106.8
"16967","55458","2016",2,2,0,65000,591.5,111
"16968","55460","2016",2,2,0,64000,505.5,122
"16969","55463","2016",30,27,3,80176.67,853.6333,98.06667
"16970","55466","2016",3,3,0,93000,818.3333,111.3333
"16971","55467","2016",5,5,0,108880,958,116
"16972","55471","2016",1,1,0,145000,954,152
"16973","55476","2016",5,5,0,134160,1306,100.8
"16974","55477","2016",8,8,0,102672.5,848,131.875
"16975","55490","2016",3,3,0,72666.67,536,132.6667
"16976","55492","2016",2,1,1,74750,911,79
"16977","55493","2016",1,1,0,63000,685,92
"16978","55502","2016",18,17,1,84027.78,854.9444,99.27778
"16979","55504","2016",5,5,0,119500,1034.8,115
"16980","55505","2016",30,27,3,128273.7,1347.367,99.13333
"16981","55507","2016",2,2,0,145050,1178.5,116.5
"16982","55508","2016",2,2,0,128750,975,127
"16983","55514","2016",6,6,0,98275,1034.5,98.66667
"16984","55517","2016",4,4,0,122000,972,125.75
"16985","55519","2016",13,13,0,106358.1,1098.231,105.0769
"16986","55521","2016",3,3,0,78566.67,567.3333,137.3333
"16987","55523","2016",2,2,0,155325,877.5,182.5
"16988","55526","2016",1,1,0,35200,440,80
"16989","55527","2016",7,7,0,92285.71,971.2857,96
"16990","55528","2016",1,1,0,1e+05,1000,100
"16991","55530","2016",2,2,0,134250,739.5,196
"16992","55531","2016",2,2,0,72500,725,100
"16993","55533","2016",12,9,3,73166.67,863.5833,81.25
"16994","55537","2016",1,1,0,152500,1837,83
"16995","55541","2016",3,3,0,151833.3,1245.333,112.3333
"16996","55543","2016",1,1,0,147000,1225,120
"16997","55545","2016",169,102,67,110839.3,1228.373,90.77515
"16998","55551","2016",18,18,0,104247.2,891.4444,121.3333
"16999","55553","2016",11,9,2,101363.6,969.4545,105.4545
"17000","55557","2016",2,2,0,101500,770,131.5
"17001","55560","2016",1,1,0,160000,1119,143
"17002","55561","2016",1,1,0,44000,537,82
"17003","55568","2016",4,4,0,104750,768.5,151
"17004","55571","2016",2,2,0,30000,477.5,63
"17005","55578","2016",1,1,0,40000,741,54
"17006","55583","2016",1,1,0,129000,1075,120
"17007","55586","2016",3,3,0,94363.33,952.6667,95.33333
"17008","56001","2016",33,31,2,119906.1,1070.788,117.5455
"17009","56002","2016",10,10,0,186504.8,1790.5,103.7
"17010","56003","2016",74,64,10,366087.5,3299.324,112.7027
"17011","56004","2016",30,26,4,143206.4,1877.5,81.46667
"17012","56005","2016",131,60,71,235012.8,3617.809,67.53435
"17013","56006","2016",11,11,0,116108.9,1261.182,94.18182
"17014","56007","2016",207,103,104,170540.1,2117.348,82.66667
"17015","56008","2016",65,64,1,359928.8,2936.769,119.1538
"17016","56009","2016",24,24,0,271018.8,3230.958,89.29167
"17017","56010","2016",70,63,7,113652.9,1368.029,86.25714
"17018","56011","2016",26,25,1,139767.3,1234.923,108.0385
"17019","56012","2016",16,16,0,156486.6,1518.312,106.8125
"17020","56013","2016",48,44,4,205445.6,2284.5,93.625
"17021","56014","2016",19,19,0,102218.4,1198.105,83
"17022","56015","2016",16,16,0,156928.8,1906.438,90.375
"17023","56017","2016",13,12,1,118543.1,1316.692,89.69231
"17024","56018","2016",14,12,2,152417.8,1767.857,96.78571
"17025","56019","2016",5,5,0,75700,842,85.6
"17026","56020","2016",5,5,0,144000,1539.4,98.6
"17027","56021","2016",11,11,0,174909.1,1671.455,107.1818
"17028","56022","2016",9,9,0,146211.1,1475.111,109.5556
"17029","56023","2016",43,41,2,237486.2,2157.302,112.4186
"17030","56024","2016",19,19,0,109774.6,1005.737,103
"17031","56025","2016",3,3,0,65000,948,68.66667
"17032","56026","2016",34,33,1,97920,1155.882,86.38235
"17033","56027","2016",4,4,0,73250,1286.25,60.5
"17034","56028","2016",14,14,0,95871.43,989.7857,92.35714
"17035","56029","2016",11,11,0,138045.5,1399.182,100.7273
"17036","56030","2016",12,12,0,165333.3,1782.5,99.91667
"17037","56031","2016",37,36,1,137195.5,1316.703,104.5405
"17038","56032","2016",11,11,0,108496.9,1288.727,85.90909
"17039","56033","2016",27,27,0,97495.19,1224.593,84.18519
"17040","56034","2016",202,86,116,255228.1,3673,72.68317
"17041","56035","2016",10,10,0,121260,1170.2,102.6
"17042","56036","2016",55,49,6,196465,1756.236,111.8909
"17043","56039","2016",13,13,0,149633.8,1411.154,130.6923
"17044","56040","2016",37,35,2,154567.6,1668.27,99.83784
"17045","56041","2016",28,28,0,84877.86,947.5714,85.42857
"17046","56042","2016",18,18,0,145361.1,1351.5,115.7222
"17047","56043","2016",16,16,0,102560,1143.75,95.4375
"17048","56044","2016",3,3,0,141775,1650.667,86
"17049","56045","2016",10,10,0,119150,1615.4,78
"17050","56046","2016",23,23,0,298439.1,2584.478,118.5217
"17051","56047","2016",9,9,0,90638.56,850.4444,105.2222
"17052","56048","2016",3,3,0,134333.3,1442.333,82.33333
"17053","56050","2016",9,9,0,121683.3,1166.444,114.1111
"17054","56051","2016",6,6,0,99512,1046.833,86.33333
"17055","56052","2016",108,75,33,212222.8,3121.472,74.12963
"17056","56053","2016",79,76,3,164107.7,1563.392,107.3418
"17057","56054","2016",62,54,8,216745.7,2754.968,88.64516
"17058","56055","2016",44,29,15,193776,2670.068,85.20455
"17059","56056","2016",2,2,0,32500,656,49
"17060","56057","2016",29,29,0,97874.31,1011,97.86207
"17061","56058","2016",35,33,2,148944.3,1564.029,96.8
"17062","56060","2016",14,14,0,65899.29,856.8571,75.85714
"17063","56061","2016",38,37,1,96649.76,1041.842,91.5
"17064","56062","2016",16,16,0,197541.7,2139.812,92.0625
"17065","56063","2016",17,17,0,214882.4,2056.588,112.8824
"17066","56065","2016",7,7,0,160457.4,1664.429,94.14286
"17067","56066","2016",49,48,1,75610.49,823.5102,93.10204
"17068","56067","2016",51,49,2,177845.8,1702.608,103.1961
"17069","56068","2016",5,5,0,84428.6,843.6,96.2
"17070","56069","2016",47,45,2,212372.3,2398.532,91.34043
"17071","56070","2016",28,28,0,98239.61,1057.786,93.39286
"17072","56071","2016",16,16,0,93053.31,1035.25,90.0625
"17073","56072","2016",5,5,0,61200,867.2,70.6
"17074","56073","2016",19,18,1,74763.16,991.3684,79.31579
"17075","56074","2016",18,18,0,102511.9,1079.167,93.38889
"17076","56075","2016",53,46,7,107455.5,1269.283,84.32075
"17077","56076","2016",12,12,0,118612.5,1126.917,112.0833
"17078","56077","2016",10,10,0,160200,1580.1,106.2
"17079","56078","2016",184,116,68,184642.5,2186.451,86.64674
"17080","56079","2016",18,18,0,91178.33,1001.167,91
"17081","56080","2016",12,12,0,82725.67,947.75,88.75
"17082","56081","2016",20,20,0,79241.35,946.25,83.4
"17083","56082","2016",5,5,0,48090,851.6,56.6
"17084","56083","2016",170,109,61,137202.5,1656.341,82.96471
"17085","56084","2016",2,2,0,176500,2025,89
"17086","56085","2016",5,5,0,454700,5464.2,79.8
"17087","56086","2016",2,2,0,368250,4008.5,92.5
"17088","56087","2016",10,8,2,352505,3590.9,96
"17089","56088","2016",5,5,0,274600,3045.4,87.4
"17090","56089","2016",24,23,1,109533.3,1100.083,102.5
"17091","56090","2016",79,73,6,145532,1583.278,95.41772
"17092","56091","2016",45,42,3,116100.8,1317.022,91.42222
"17093","56092","2016",4,4,0,129250,1147.25,108.75
"17094","56093","2016",7,7,0,114857.1,1171.857,99.85714
"17095","56094","2016",54,50,4,221837.5,1871.537,120.1852
"17096","56096","2016",20,20,0,146134.5,1680.35,93.4
"17097","56097","2016",33,33,0,171359.7,1688.576,103.1515
"17098","56098","2016",269,197,72,143479,1706.632,86.42379
"17099","56099","2016",7,7,0,69396.14,710,89
"17100","56100","2016",31,31,0,94533.81,1063.742,89.93548
"17101","56101","2016",77,60,17,141029.7,1593.286,94.06494
"17102","56102","2016",25,25,0,79275.52,973.32,82.72
"17103","56103","2016",5,5,0,66478,876.2,75.8
"17104","56104","2016",4,4,0,113000,944.5,122.25
"17105","56105","2016",23,23,0,82406.52,1010.391,84.52174
"17106","56106","2016",21,19,2,303674.3,3285.381,98.28571
"17107","56107","2016",140,97,43,318429,3260.979,102.3714
"17108","56108","2016",11,11,0,129753.6,1391.273,93.36364
"17109","56109","2016",6,6,0,155165,1566.5,99.66667
"17110","56110","2016",12,12,0,124401.2,1390.75,87.66667
"17111","56111","2016",20,19,1,104300.5,1030.6,100.45
"17112","56112","2016",8,8,0,99431.25,1026,92.5
"17113","56113","2016",7,7,0,82784.86,953,84
"17114","56114","2016",12,11,1,337560,3329,96.5
"17115","56115","2016",15,15,0,176762.4,1588.867,113.0667
"17116","56116","2016",25,20,5,338112,3671.68,98.6
"17117","56117","2016",43,36,7,121470.9,1293.674,94.69767
"17118","56118","2016",61,53,8,175222.6,2055.344,86.63934
"17119","56119","2016",22,22,0,232664.5,2340.682,104.6818
"17120","56120","2016",21,21,0,176985.2,1456.714,124.381
"17121","56121","2016",805,273,532,130501.9,1719.287,76.43106
"17122","56122","2016",17,17,0,81697.06,923.3529,91.41176
"17123","56123","2016",29,29,0,122496.3,1122.448,97.41379
"17124","56124","2016",26,24,2,128676,1225.423,113.3846
"17125","56125","2016",8,8,0,139432.5,1267.375,108
"17126","56126","2016",25,25,0,142114.3,1375.56,102.8
"17127","56127","2016",23,22,1,106036.1,1026.174,109.3913
"17128","56128","2016",23,23,0,92865.22,1122.261,93.13043
"17129","56129","2016",18,18,0,68406.39,781.2778,85.27778
"17130","56130","2016",32,32,0,165455.8,1690.406,102.4375
"17131","56131","2016",22,22,0,92409.09,1083.864,93.5
"17132","56133","2016",8,8,0,122675,1151.5,102.75
"17133","56134","2016",10,10,0,111715,976.9,116.9
"17134","56135","2016",12,12,0,141331.8,1282.667,106.4167
"17135","56136","2016",17,17,0,99594.29,1100.941,92.94118
"17136","56137","2016",33,33,0,167502.8,1637.667,102.0606
"17137","56139","2016",3,3,0,112166.7,1349.333,81.66667
"17138","56140","2016",25,25,0,133492,1328.28,106.12
"17139","56141","2016",17,17,0,139116.2,1433.765,105.0588
"17140","56143","2016",68,57,11,174590.1,1920.632,92.73529
"17141","56144","2016",30,30,0,87537.3,922.2333,93.3
"17142","56145","2016",9,9,0,73471.67,848.2222,85.55556
"17143","56146","2016",6,6,0,118274.3,1379.5,102.3333
"17144","56147","2016",56,55,1,141403.8,1503.625,96.53571
"17145","56148","2016",16,16,0,198340.6,1768.875,114.5
"17146","56149","2016",26,25,1,155509.6,1384.731,114.1923
"17147","56151","2016",20,20,0,113435,1056.6,100.5
"17148","56152","2016",41,28,13,215302.9,2947.39,74.82927
"17149","56153","2016",35,34,1,143939.4,1399.143,103.2
"17150","56154","2016",14,14,0,92792.14,1043.643,94.28571
"17151","56155","2016",75,69,6,145018.6,2318.093,66.10667
"17152","56156","2016",2,2,0,104931.5,1104.5,92.5
"17153","56157","2016",14,14,0,167190.7,1402.357,121.3571
"17154","56158","2016",62,39,23,194188.8,2042.387,97.20968
"17155","56159","2016",23,23,0,127818.2,1180.478,112.5652
"17156","56160","2016",23,23,0,76500.13,845.9565,86.56522
"17157","56161","2016",34,22,12,164980,2000.412,84.97059
"17158","56162","2016",235,182,53,220963.6,2469.851,95.29362
"17159","56163","2016",17,17,0,100835.3,984.8824,106.6471
"17160","56164","2016",75,65,10,242598.1,2233.693,110.24
"17161","56165","2016",108,86,22,129205.2,1489.843,93.93519
"17162","56166","2016",55,51,4,145447.6,1354.4,108
"17163","56167","2016",27,26,1,296041,2372.963,123.1481
"17164","56168","2016",16,14,2,183825.6,1981.688,95.9375
"17165","56169","2016",75,63,12,180352.3,2000.533,91.36
"17166","56170","2016",15,15,0,92466.67,950.6667,97.86667
"17167","56171","2016",21,21,0,107667,1061.81,103.7143
"17168","56172","2016",30,30,0,105113.3,1195.1,93.5
"17169","56173","2016",43,43,0,98721.47,1157.581,87.74419
"17170","56174","2016",31,31,0,122120.8,1284.968,95.90323
"17171","56175","2016",35,35,0,190580.6,1723.229,111.7429
"17172","56176","2016",64,54,10,200856.2,2036.5,102.7188
"17173","56177","2016",74,71,3,149071.4,1575.743,98.67568
"17174","56178","2016",168,105,63,95698.21,1154.018,87.05952
"17175","56179","2016",35,35,0,174262.9,1679.714,108.0857
"17176","56180","2016",11,11,0,121695.5,1371.909,86.45455
"17177","56181","2016",51,28,23,149753.9,2085.431,73.27451
"17178","56182","2016",5,5,0,129000,1459.8,89
"17179","56184","2016",87,83,4,139189.6,1452.448,96.75862
"17180","56185","2016",79,75,4,178453.4,1808.367,100.6076
"17181","56186","2016",186,90,96,215978.2,3430.995,69.98387
"17182","56188","2016",20,20,0,92350,1115.7,87.35
"17183","56189","2016",8,8,0,72375,833,77.375
"17184","56190","2016",13,13,0,104584.6,947.7692,111.6923
"17185","56191","2016",8,8,0,106575,1183.375,97
"17186","56193","2016",68,68,0,176344.5,1799.368,101.0294
"17187","56194","2016",21,21,0,131142.4,1199.905,110.5714
"17188","56195","2016",19,9,10,124657.9,2227.789,70.31579
"17189","56196","2016",18,18,0,115033.3,1306.056,90.61111
"17190","56197","2016",24,24,0,105701.3,1004.958,106.7917
"17191","56198","2016",15,15,0,87500,832.2667,105.9333
"17192","56199","2016",4,4,0,91000,935.5,103.75
"17193","56200","2016",15,15,0,122085.3,1172,104.1333
"17194","56201","2016",8,8,0,87862.5,909.875,95.125
"17195","56202","2016",1,1,0,67500,865,78
"17196","56203","2016",12,12,0,72237.5,965.6667,79.16667
"17197","56204","2016",7,7,0,104198.3,943.4286,100.4286
"17198","56205","2016",19,19,0,283131.6,2677.421,114.8947
"17199","56206","2016",110,91,19,196150.5,2004.309,97.9
"17200","56207","2016",19,19,0,117843.4,1253.368,99.78947
"17201","56208","2016",2,2,0,179500,2263.5,87.5
"17202","56209","2016",2,2,0,112500,910.5,116
"17203","56210","2016",3,3,0,67000,916.6667,79
"17204","56211","2016",10,10,0,86941.5,966.7,87.9
"17205","56212","2016",35,35,0,110991.4,1398.286,87.77143
"17206","56213","2016",10,10,0,122100,1036.9,112.1
"17207","56214","2016",73,70,3,283817.1,3274.822,93.65753
"17208","56215","2016",4,4,0,88825,1082,76.75
"17209","56216","2016",4,4,0,58000,823.25,74.5
"17210","56218","2016",3,3,0,74000,922,90.66667
"17211","56219","2016",13,13,0,148737.7,1531.077,96.38462
"17212","56220","2016",15,15,0,249393.3,2198.8,110.6
"17213","56221","2016",18,18,0,82116.67,977.5556,82.5
"17214","56222","2016",21,21,0,153948,1799.857,91.04762
"17215","56223","2016",20,20,0,121404,1079.15,110.1
"17216","56224","2016",4,4,0,75535.5,979.5,74.75
"17217","56225","2016",4,4,0,95500,1219,82.75
"17218","56226","2016",6,6,0,155580,1266.5,121.3333
"17219","56227","2016",8,8,0,64612.5,754.875,93.125
"17220","56228","2016",8,8,0,140112.5,1326.25,106.375
"17221","56229","2016",20,20,0,81373.5,1209.3,77.65
"17222","56230","2016",2,2,0,38500,784.5,51
"17223","56231","2016",42,39,3,193790.6,1754.69,112.1905
"17224","56232","2016",6,6,0,144165,1119.167,119.8333
"17225","56233","2016",41,26,15,226799.8,2946,84.39024
"17226","56234","2016",69,61,8,301253.5,3596.13,88.15942
"17227","56236","2016",8,8,0,71125,969.125,71.125
"17228","56237","2016",10,10,0,153350,1441.9,107.1
"17229","56238","2016",4,4,0,78750,786.25,103.25
"17230","56239","2016",10,10,0,114371.2,1167.9,106.3
"17231","56240","2016",172,140,32,243453.3,2825.012,89.52907
"17232","56241","2016",18,14,4,313839.9,3818.556,89.16667
"17233","56242","2016",9,9,0,66873.78,777.6667,86.77778
"17234","56243","2016",98,75,23,245756.4,2554.378,94.52041
"17235","56244","2016",35,35,0,110717.4,1233.657,92.34286
"17236","56245","2016",8,8,0,87062.5,1137.375,79.75
"17237","56246","2016",15,15,0,111986,1285.333,87.53333
"17238","56247","2016",29,29,0,178576,1764.759,104.4828
"17239","56248","2016",44,42,2,215800.1,1886.75,117.2045
"17240","56249","2016",22,22,0,117725.3,1228.318,93.95455
"17241","56250","2016",11,11,0,103578.6,1213.455,83.90909
"17242","56251","2016",76,67,9,229450.4,2187.474,109.5
"17243","56252","2016",30,27,3,220105.4,2236.3,103.1333
"17244","56253","2016",5,5,0,75520,867.2,85.2
"17245","56254","2016",14,14,0,170250.7,1571.786,114.6429
"17246","56255","2016",22,21,1,184031.6,1842.364,105.3636
"17247","56256","2016",1,1,0,35000,686,51
"17248","56257","2016",9,8,1,46177.78,666.3333,75.11111
"17249","56258","2016",54,31,23,368232.6,4005.481,92.31481
"17250","56259","2016",11,11,0,156585.5,1704.455,91.63636
"17251","56260","2016",1098,300,798,168854.8,2294.077,70.89344
"17252","56261","2016",17,17,0,145278.8,1588.294,94.41176
"17253","56262","2016",29,27,2,265356.9,2464.655,112.2069
"17254","56263","2016",42,41,1,198570.6,1791.548,109.8571
"17255","56264","2016",1,1,0,50000,943,53
"17256","58001","2016",3,3,0,63000,1013.667,62
"17257","58002","2016",15,15,0,92627.33,856.7333,109.6
"17258","58003","2016",7,7,0,85414.29,764,103.8571
"17259","58004","2016",4,4,0,52875,894,59.5
"17260","58005","2016",4,4,0,43750,688.25,73.5
"17261","58006","2016",2,2,0,47750,592.5,79
"17262","58007","2016",5,5,0,85400,1088.2,90
"17263","58008","2016",2,2,0,74750,782,95.5
"17264","58009","2016",3,3,0,115333.3,1723.667,61.66667
"17265","58010","2016",15,14,1,61016.67,936.2667,68.53333
"17266","58011","2016",2,2,0,31750,567.5,58.5
"17267","58012","2016",7,7,0,72757.14,877.4286,79.14286
"17268","58013","2016",2,2,0,64000,948,70.5
"17269","58015","2016",2,2,0,90250,923.5,112
"17270","58016","2016",1,1,0,40000,615,65
"17271","58017","2016",5,5,0,61950,840.4,70.8
"17272","58019","2016",2,2,0,83500,979,85.5
"17273","58020","2016",2,2,0,79500,976.5,71
"17274","58021","2016",2,2,0,80500,693,109
"17275","58024","2016",7,7,0,58214.29,778.5714,79.14286
"17276","58025","2016",3,2,1,83400,996,79.66667
"17277","58026","2016",2,2,0,63500,949,64
"17278","58027","2016",2,2,0,92500,722.5,111.5
"17279","58028","2016",1,1,0,135000,1125,120
"17280","58029","2016",5,5,0,76500,1300.8,69.4
"17281","58030","2016",3,3,0,78833.33,965.3333,90.33333
"17282","58031","2016",3,3,0,81666.67,698.3333,122.3333
"17283","58032","2016",6,6,0,51857.5,716.6667,74
"17284","58033","2016",3,3,0,112666.7,1227.667,94
"17285","58034","2016",4,4,0,65178.75,1075.25,59
"17286","58035","2016",3,3,0,55666.67,810.6667,67.33333
"17287","58036","2016",10,10,0,91116.2,962.4,95.9
"17288","58037","2016",11,10,1,94745.45,1296.818,82.36364
"17289","58038","2016",1,1,0,1e+05,962,104
"17290","58039","2016",1,1,0,106500,1197,89
"17291","58041","2016",4,4,0,102000,876.25,126
"17292","58042","2016",1,1,0,1e+05,730,137
"17293","58043","2016",2,2,0,40000,657,60
"17294","58044","2016",6,6,0,79833.33,1105,80.5
"17295","58045","2016",3,3,0,65666.67,648.3333,82.33333
"17296","58046","2016",15,12,3,83158.27,837.6667,92.53333
"17297","58047","2016",6,6,0,70754.67,1009,70.5
"17298","58050","2016",2,2,0,116500,1132.5,97
"17299","58051","2016",8,8,0,132625,1192.375,103.375
"17300","58053","2016",5,5,0,77300,696.6,110
"17301","58054","2016",1,1,0,66000,660,100
"17302","58055","2016",3,3,0,48000,622.3333,82.66667
"17303","58056","2016",2,2,0,111000,1046.5,102
"17304","58057","2016",13,13,0,72015.38,1081,65.69231
"17305","58058","2016",6,6,0,94250,1057.833,91
"17306","58059","2016",56,41,15,93648.04,1145.875,83.30357
"17307","58060","2016",9,9,0,69190,767.6667,92.33333
"17308","58062","2016",14,13,1,53072.86,686.7857,77.14286
"17309","58063","2016",5,5,0,69400,780.8,87.6
"17310","58064","2016",5,5,0,96000,903.4,86
"17311","58065","2016",12,12,0,72000,778.3333,93.41667
"17312","58066","2016",1,1,0,109000,1028,106
"17313","58067","2016",21,21,0,140401,1466.048,105.0952
"17314","58068","2016",11,11,0,85636.36,1441.909,63.63636
"17315","58069","2016",3,3,0,69666.67,1165.333,60
"17316","58070","2016",2,2,0,40000,535,76
"17317","58071","2016",3,3,0,43000,831.3333,58.66667
"17318","58072","2016",8,8,0,105912.5,1090.625,100.375
"17319","58073","2016",1,1,0,60000,522,115
"17320","58074","2016",9,9,0,81566.67,931.5556,90.44444
"17321","58075","2016",5,5,0,55800,808,75.2
"17322","58076","2016",1,1,0,150000,882,170
"17323","58077","2016",9,9,0,117926.7,896.1111,123.1111
"17324","58079","2016",34,31,3,74110.29,915.3824,83.23529
"17325","58080","2016",2,2,0,52000,1199.5,49.5
"17326","58081","2016",3,3,0,100833.3,959.6667,109.3333
"17327","58082","2016",8,8,0,106625,988.125,103.375
"17328","58083","2016",19,18,1,70521.05,813.2632,90.10526
"17329","58084","2016",2,2,0,43000,486,88
"17330","58085","2016",8,8,0,51400,745.875,73
"17331","58086","2016",132,117,15,103204.7,1165.462,87.7803
"17332","58087","2016",5,5,0,91600,858.2,100.2
"17333","58088","2016",37,35,2,119122.4,1297,90.32432
"17334","58089","2016",4,4,0,82750,1191.75,69.25
"17335","58090","2016",2,2,0,55000,720,74
"17336","58092","2016",7,7,0,74642.86,852,92
"17337","58093","2016",2,2,0,75850,808,95
"17338","58094","2016",9,8,1,76666.67,798,89.88889
"17339","58095","2016",63,46,17,75437.3,963.6349,76.68254
"17340","58096","2016",3,3,0,57666.67,861,63.33333
"17341","58098","2016",1,1,0,63000,467,135
"17342","58099","2016",4,4,0,45625,750,70.25
"17343","58102","2016",18,16,2,79666.67,969.2778,92.5
"17344","58103","2016",2,2,0,80000,973,82
"17345","58104","2016",10,10,0,93590,1382.7,74.7
"17346","58105","2016",3,3,0,50000,676.6667,70
"17347","58106","2016",10,10,0,63863,908.6,73.9
"17348","58107","2016",3,3,0,85825,929.6667,86.33333
"17349","58108","2016",1,1,0,35000,427,82
"17350","58109","2016",12,12,0,62666.67,791.9167,80.41667
"17351","58110","2016",3,3,0,62000,959.6667,77.66667
"17352","58111","2016",2,2,0,87500,1377,67.5
"17353","58112","2016",7,7,0,122839.3,1320.429,92.71429
"17354","58113","2016",1,1,0,50000,403,124
"17355","58114","2016",1,1,0,115000,2396,48
"17356","58115","2016",2,2,0,95000,1058,86.5
"17357","58116","2016",1,1,0,155000,1314,118
"17358","58117","2016",25,21,4,97056.24,1144.92,89.04
"17359","58118","2016",8,8,0,76062.5,742.25,101.875
"17360","58119","2016",1,1,0,1e+05,1075,93
"17361","58120","2016",3,3,0,62406.67,864.3333,75
"17362","58121","2016",41,38,3,91109.76,1167.488,79.95122
"17363","58122","2016",7,6,1,87071.43,1473.714,68.14286
"17364","58123","2016",2,2,0,38750,350,110.5
"17365","58124","2016",5,5,0,154386,2062.4,78.2
"17366","58125","2016",1,1,0,192500,1887,102
"17367","58126","2016",4,4,0,110750,1357.25,80.75
"17368","58127","2016",3,3,0,45433.33,684,75.66667
"17369","58129","2016",2,2,0,119000,1075.5,149.5
"17370","58130","2016",3,3,0,39833.33,582.6667,59.66667
"17371","58131","2016",24,24,0,83534.54,1050.083,83.70833
"17372","58132","2016",2,2,0,52800,652,81.5
"17373","58133","2016",2,2,0,77500,1184,77.5
"17374","58134","2016",29,26,3,70896.55,952.8276,74.93103
"17375","58135","2016",1,1,0,57000,655,87
"17376","58137","2016",2,2,0,67200,1019,69.5
"17377","58138","2016",9,9,0,99140.89,1087.778,91.88889
"17378","58139","2016",1,1,0,27000,540,50
"17379","58140","2016",9,9,0,91172.22,942.8889,83.88889
"17380","58142","2016",4,3,1,49359,507.75,97.25
"17381","58143","2016",1,1,0,2e+05,1333,150
"17382","58144","2016",6,6,0,63858.33,815.6667,80.33333
"17383","58145","2016",14,14,0,76632.86,878.3571,85
"17384","58146","2016",7,7,0,83000,1143.429,71.14286
"17385","58147","2016",5,5,0,107434.2,1016.2,107.6
"17386","58148","2016",6,6,0,131600.8,1370.333,98.66667
"17387","58149","2016",21,21,0,82634.86,974.0952,83.80952
"17388","58150","2016",1,1,0,48000,436,110
"17389","58151","2016",36,36,0,59343.89,850.0833,67.66667
"17390","58152","2016",13,13,0,97338.46,1132.923,89.38462
"17391","58153","2016",2,2,0,136000,1063.5,121.5
"17392","58155","2016",7,7,0,82428.57,1200,75
"17393","58156","2016",1,1,0,59610,852,70
"17394","58157","2016",8,8,0,102812.5,1187.625,84.625
"17395","58158","2016",4,4,0,166963.8,1273.25,122.75
"17396","58159","2016",2,2,0,35500,474,75.5
"17397","58160","2016",42,42,0,155581.5,1410.833,109.381
"17398","58161","2016",4,4,0,147000,1329.25,103.25
"17399","58162","2016",1,1,0,28000,412,68
"17400","58163","2016",5,5,0,30200,456.4,64.6
"17401","58164","2016",4,4,0,71375,994.25,69.5
"17402","58165","2016",3,3,0,36666.67,546.3333,71
"17403","58166","2016",5,5,0,56500,861.6,66.6
"17404","58168","2016",4,4,0,80375,1052.75,74.75
"17405","58170","2016",2,2,0,101250,965.5,100.5
"17406","58171","2016",8,8,0,71262.5,836.625,79.875
"17407","58172","2016",1,1,0,122000,1109,110
"17408","58173","2016",1,1,0,40000,714,56
"17409","58174","2016",1,1,0,160000,1720,93
"17410","58175","2016",5,5,0,45265.2,533.4,81.4
"17411","58176","2016",8,8,0,131060,1158.25,120.75
"17412","58177","2016",7,7,0,87471.43,1066.143,90.14286
"17413","58178","2016",2,2,0,86750,1130,76.5
"17414","58179","2016",6,6,0,57083.33,854.1667,73.83333
"17415","58180","2016",17,16,1,106568.8,1294.588,88.52941
"17416","58181","2016",1,1,0,50000,538,93
"17417","58182","2016",16,16,0,68286.88,991,79.5625
"17418","58184","2016",1,1,0,368300,2669,138
"17419","58185","2016",10,10,0,75212.7,1193,66.8
"17420","58186","2016",5,5,0,92600,1134.2,107.6
"17421","58187","2016",4,4,0,72350,796,90.5
"17422","58188","2016",2,2,0,53000,1302,44.5
"17423","58189","2016",6,6,0,105750,883.5,109.5
"17424","58190","2016",6,6,0,38666.67,532.3333,73.33333
"17425","58191","2016",1,1,0,77500,881,88
"17426","58192","2016",2,2,0,48250,677,67
"17427","58193","2016",21,21,0,81770.24,915.2857,95
"17428","58194","2016",481,218,263,81767.28,1047.015,78.53015
"17429","58195","2016",2,2,0,85500,1197,74
"17430","58196","2016",3,3,0,56376,542,114
"17431","58197","2016",2,2,0,45500,934.5,49
"17432","58198","2016",4,4,0,77625,1455.5,65.5
"17433","58200","2016",3,3,0,64666.67,659.3333,100.6667
"17434","58201","2016",3,3,0,65666.67,757.3333,83.33333
"17435","58203","2016",4,4,0,79250,995,87.5
"17436","58204","2016",3,3,0,107866.7,873.6667,112.6667
"17437","58205","2016",18,18,0,71793,1016.444,73.61111
"17438","58206","2016",1,1,0,45000,692,65
"17439","58207","2016",11,10,1,139330.9,1356.273,105.2727
"17440","58208","2016",2,2,0,59900,536,110
"17441","58209","2016",1,1,0,40000,741,54
"17442","58210","2016",8,8,0,97670,894.625,96.25
"17443","58211","2016",4,4,0,69500,716,92
"17444","58212","2016",6,6,0,161666.7,1103.333,119.5
"17445","58213","2016",3,3,0,39666.67,591.6667,65.33333
"17446","58214","2016",22,19,3,110576.6,1172.636,93.04545
"17447","58215","2016",26,25,1,72153.85,892.1538,79.07692
"17448","58216","2016",1,1,0,38755,646,60
"17449","58217","2016",2,2,0,62500,741,96.5
"17450","58218","2016",15,15,0,76206.67,818.6,98
"17451","58219","2016",6,6,0,113238,1088.333,105.8333
"17452","58220","2016",7,7,0,70612.86,876.8571,78.28571
"17453","58221","2016",2,2,0,48100,830,63
"17454","58223","2016",5,5,0,86400.2,1020.6,90.8
"17455","58224","2016",1,1,0,52000,945,55
"17456","58225","2016",3,3,0,110000,789.3333,153
"17457","58226","2016",1,1,0,85000,1149,74
"17458","58227","2016",15,14,1,76500,849.7333,90.2
"17459","58228","2016",8,8,0,60712.5,780.875,75.375
"17460","58229","2016",2,2,0,110850,945.5,123
"17461","58231","2016",10,10,0,89165,900.1,99.3
"17462","58232","2016",16,16,0,118823.1,1071.938,113.6875
"17463","58233","2016",3,3,0,46000,568.6667,78
"17464","58234","2016",1,1,0,75000,1027,73
"17465","58235","2016",4,4,0,63250,1078,57.5
"17466","58236","2016",3,3,0,61333.33,591,107
"17467","58238","2016",18,17,1,121270.6,1224.833,100.2778
"17468","58240","2016",3,3,0,79000,890,90.33333
"17469","58241","2016",5,5,0,112200,1008,95.2
"17470","58243","2016",2,2,0,59750,1472.5,41
"17471","58244","2016",1,1,0,358768,1580,227
"17472","58245","2016",5,5,0,62000,724.2,84.4
"17473","58246","2016",12,11,1,78166.67,735.6667,99.91667
"17474","58247","2016",6,6,0,101945.7,864.3333,118.1667
"17475","58248","2016",1,1,0,36000,562,64
"17476","58249","2016",5,5,0,66500,921.8,79.2
"17477","58250","2016",16,15,1,77375,961.1875,78.9375
"17478","58251","2016",9,9,0,85222.22,926.8889,88.55556
"17479","58252","2016",3,3,0,91000,725,132.6667
"17480","58253","2016",2,2,0,327500,2251.5,116.5
"17481","58254","2016",5,5,0,109800,1049.4,112
"17482","58255","2016",11,11,0,81528.18,775.7273,97.72727
"17483","58256","2016",2,2,0,99000,969.5,101
"17484","58257","2016",1,1,0,39500,840,47
"17485","58258","2016",6,6,0,107951,895.6667,114.3333
"17486","58259","2016",2,2,0,75500,710.5,109.5
"17487","58260","2016",5,5,0,122200,974.2,127.8
"17488","58261","2016",15,15,0,107400,1162.133,101.7333
"17489","58262","2016",3,3,0,99666.67,869.6667,106.3333
"17490","58263","2016",3,3,0,102333.3,1022.667,98.33333
"17491","58264","2016",15,15,0,101440,988.6667,105.6667
"17492","58265","2016",2,2,0,115500,638.5,170
"17493","58266","2016",2,2,0,103500,833,124.5
"17494","58267","2016",5,5,0,58000,945.2,62.2
"17495","58268","2016",2,2,0,49250,868,59
"17496","58269","2016",2,2,0,62000,689,82.5
"17497","58270","2016",5,5,0,76400,1319,61
"17498","58271","2016",2,2,0,19000,609,36
"17499","58272","2016",3,3,0,72333.33,589.6667,125
"17500","58273","2016",17,17,0,135940.5,1253.176,116.2353
"17501","58274","2016",2,2,0,80750,1794,42
"17502","58275","2016",1,1,0,202000,1247,162
"17503","58276","2016",3,3,0,67333.33,1178,63
"17504","58277","2016",3,3,0,53333.33,809.3333,73.33333
"17505","58278","2016",10,10,0,127142.9,1353.7,94.7
"17506","58279","2016",1,1,0,58500,609,96
"17507","58280","2016",7,7,0,110142.9,1231.714,89.42857
"17508","58281","2016",10,10,0,73850,716.9,95.5
"17509","58282","2016",7,7,0,80785.71,906.2857,86
"17510","58284","2016",1,1,0,1e+05,1136,88
"17511","58285","2016",1,1,0,85000,1062,80
"17512","58286","2016",4,4,0,60000,1395,51.25
"17513","58287","2016",2,2,0,181000,1838,95.5
"17514","58288","2016",1,1,0,50000,909,55
"17515","58289","2016",3,3,0,79166.67,736,100.6667
"17516","58290","2016",3,3,0,209333.3,2452.333,77.66667
"17517","58291","2016",2,2,0,46000,1007.5,53
"17518","58292","2016",3,3,0,81000,839,98
"17519","58293","2016",6,6,0,125583.3,1080.5,102.5
"17520","58294","2016",2,2,0,79250,808,92.5
"17521","58295","2016",10,10,0,93800,1027.1,87.7
"17522","58297","2016",2,2,0,80500,854,104.5
"17523","58298","2016",6,6,0,68270,1159.833,73.33333
"17524","58299","2016",1,1,0,31000,861,36
"17525","58300","2016",19,19,0,121870,1279.105,96.63158
"17526","58301","2016",5,5,0,77000,899.6,97.8
"17527","58302","2016",12,11,1,84158.33,1303.667,77.16667
"17528","58303","2016",76,69,7,103810,1189.474,88.93421
"17529","58304","2016",18,18,0,66957.22,695.6667,101.5
"17530","58305","2016",2,2,0,49000,799,65.5
"17531","58306","2016",7,7,0,68428.57,764.2857,86.14286
"17532","58307","2016",1,1,0,74000,1233,60
"17533","58308","2016",2,2,0,47500,773,78.5
"17534","58309","2016",8,8,0,57487.5,718,75
"17535","58312","2016",3,3,0,85666.67,1365,66.33333
"17536","58313","2016",1,1,0,49000,1225,40
"17537","59001","2016",4,4,0,165250,1603.5,105.75
"17538","59002","2016",34,34,0,116900.8,1209.794,97.67647
"17539","59003","2016",3,3,0,129333.3,1364,100
"17540","59004","2016",18,18,0,215021.8,1715.111,125.1667
"17541","59005","2016",30,30,0,187697.2,1785.7,107.0333
"17542","59006","2016",1,1,0,76247,1017,75
"17543","59007","2016",7,7,0,124000,1313.714,99.71429
"17544","59008","2016",89,88,1,96913.83,1071.685,91.53933
"17545","59009","2016",562,383,179,219012.3,2959.783,85.30783
"17546","59010","2016",2,2,0,217500,1882.5,116
"17547","59011","2016",108,96,12,181831,1875.407,99.42593
"17548","59012","2016",21,21,0,93455.24,967.5238,97.14286
"17549","59013","2016",12,12,0,212322.2,2088,98.75
"17550","59014","2016",131,120,11,86739.11,1024.405,87.55725
"17551","59015","2016",27,27,0,180392.3,1482.815,125.8519
"17552","59016","2016",16,16,0,202299.4,1791.625,113.1875
"17553","59017","2016",358,277,81,123149.6,1583.645,80.00559
"17554","59018","2016",19,19,0,167352.6,1570.368,109.6316
"17555","59019","2016",8,8,0,219685.1,1744.5,128.375
"17556","59021","2016",20,20,0,131269.4,1407.45,96.4
"17557","59022","2016",20,20,0,233212.5,2067.15,113.7
"17558","59023","2016",4,4,0,77250,991,81.5
"17559","59024","2016",44,44,0,111690,1184.114,94.27273
"17560","59025","2016",12,10,2,240354.2,2089.5,113.8333
"17561","59026","2016",13,13,0,109807.7,1230.231,94
"17562","59027","2016",12,12,0,187468.5,1629.667,111.9167
"17563","59028","2016",61,61,0,116557.1,1277.656,93.86885
"17564","59029","2016",16,16,0,237139.6,2120,120.0625
"17565","59031","2016",2,2,0,172650,1598,105.5
"17566","59032","2016",56,56,0,130492.5,1369.661,95.53571
"17567","59033","2016",74,73,1,94441.76,1133.324,85.02703
"17568","59034","2016",21,19,2,249367.6,2391.857,105.619
"17569","59035","2016",19,19,0,116784.7,1421.579,94.94737
"17570","59036","2016",24,23,1,93663.29,936.9583,100.0833
"17571","59037","2016",49,48,1,82632.65,870,96.46939
"17572","59038","2016",17,17,0,124465.3,1197.235,104.6471
"17573","59039","2016",7,7,0,140900,1407.857,100.8571
"17574","59041","2016",18,18,0,132147.2,1455.444,91.72222
"17575","59042","2016",21,21,0,262222.4,2299,114.619
"17576","59043","2016",138,129,9,185395.5,1859.254,102.5
"17577","59044","2016",61,60,1,233580.4,2452.459,99.67213
"17578","59045","2016",2,2,0,95250,621.5,155
"17579","59046","2016",7,7,0,204664.3,1944.714,107.1429
"17580","59047","2016",4,4,0,128750,949,135.25
"17581","59048","2016",4,4,0,156875,1515,107.25
"17582","59049","2016",7,7,0,139321.4,1245,109.5714
"17583","59050","2016",3,3,0,102666.7,1054.333,101.3333
"17584","59051","2016",92,89,3,143857.9,1610.946,93.19565
"17585","59052","2016",67,67,0,151745.1,1607.164,97.22388
"17586","59053","2016",30,29,1,113206.7,1176.333,95.26667
"17587","59054","2016",6,6,0,127850,1317.333,103.3333
"17588","59055","2016",2,2,0,90000,690.5,127
"17589","59056","2016",7,7,0,221528.6,1807.143,137.2857
"17590","59057","2016",6,6,0,164458.3,1314,124
"17591","59058","2016",15,15,0,104250.1,1094.8,99.26667
"17592","59059","2016",2,2,0,85000,871,97.5
"17593","59060","2016",4,4,0,108000,1015.25,107.25
"17594","59061","2016",1,1,0,108000,991,109
"17595","59063","2016",14,14,0,81901.79,931.5714,91.85714
"17596","59064","2016",8,8,0,153768.8,1777.125,93.875
"17597","59065","2016",8,8,0,142400,1151.75,139.5
"17598","59066","2016",1,1,0,65000,422,154
"17599","59067","2016",39,29,10,144470.6,1749.205,88.58974
"17600","59068","2016",35,35,0,116171.4,1188.571,95.25714
"17601","59069","2016",10,10,0,138400,1320.3,104.3
"17602","59070","2016",3,3,0,165823.3,1079.667,147.3333
"17603","59071","2016",25,25,0,252911.5,2200,124.36
"17604","59072","2016",3,3,0,141000,1433.333,96.66667
"17605","59073","2016",10,10,0,260910,2193.5,126.7
"17606","59074","2016",19,19,0,105552.6,1104.842,98.57895
"17607","59075","2016",9,9,0,109111.1,967.1111,109.4444
"17608","59076","2016",2,2,0,141000,1387,111.5
"17609","59077","2016",1,1,0,253400,1891,134
"17610","59078","2016",9,9,0,64000,611.1111,103.6667
"17611","59079","2016",30,29,1,112385,1222.267,90.5
"17612","59080","2016",34,34,0,161013.4,1586.294,105.4706
"17613","59081","2016",8,8,0,102262.5,976.875,104.375
"17614","59082","2016",18,18,0,212282.6,1805.667,118.6111
"17615","59084","2016",14,14,0,167121.4,1633.5,111.2857
"17616","59086","2016",33,33,0,170377,2029,91.75758
"17617","59087","2016",10,10,0,113310,1201.1,95.9
"17618","59088","2016",18,17,1,241797.4,2234.5,109.8333
"17619","59089","2016",21,21,0,156627.6,1457.524,118.0476
"17620","59090","2016",125,117,8,380134.2,3161.544,119.16
"17621","59091","2016",9,9,0,185929.4,1391.889,126.7778
"17622","59092","2016",63,63,0,119730,1294.508,94.68254
"17623","59093","2016",2,2,0,164020,2012.5,84
"17624","59094","2016",71,67,4,113563.1,1365.761,84.38028
"17625","59096","2016",22,22,0,285302,2488.545,116.4545
"17626","59097","2016",1,1,0,157000,1377,114
"17627","59098","2016",67,65,2,234228.6,2096.597,112.5821
"17628","59099","2016",13,12,1,87340.77,839.9231,103.5385
"17629","59100","2016",2,2,0,307500,2459,128
"17630","59101","2016",7,7,0,102136.4,1052,100
"17631","59102","2016",2,2,0,118850,1338,89
"17632","59103","2016",4,4,0,97750,1258,81
"17633","59104","2016",30,30,0,83949,954.0333,91.53333
"17634","59105","2016",20,20,0,221770,1919.2,117.8
"17635","59106","2016",9,9,0,227122.2,2418.556,93.55556
"17636","59107","2016",110,40,70,160163.3,2803.618,62.8
"17637","59108","2016",5,5,0,109300,1101.6,99.2
"17638","59109","2016",4,4,0,237967.5,1674.75,167.25
"17639","59110","2016",16,16,0,185485.6,1635.125,117.5
"17640","59111","2016",8,8,0,132117.5,1457.75,93.5
"17641","59112","2016",80,80,0,110934.5,1254.475,90.7375
"17642","59113","2016",8,8,0,184625,1534.75,122.75
"17643","59114","2016",16,16,0,178994.3,1707.688,103.375
"17644","59115","2016",4,4,0,125000,1005,130.75
"17645","59116","2016",9,9,0,243594.4,1649.556,145.6667
"17646","59117","2016",11,11,0,106818.2,1065.455,109.4545
"17647","59118","2016",30,30,0,83575,799.7333,102.4
"17648","59119","2016",9,9,0,228806.7,2260.667,111
"17649","59120","2016",22,22,0,194590.2,1534.364,128.5
"17650","59121","2016",6,6,0,130940,1256.5,101
"17651","59122","2016",388,279,109,111415.9,1270.33,88.82474
"17652","59123","2016",15,15,0,248968.3,2236.4,115.0667
"17653","59124","2016",12,12,0,288791.7,2607,111.25
"17654","59125","2016",3,3,0,161666.7,1124.333,144
"17655","59126","2016",12,11,1,138475,1511.417,92.91667
"17656","59127","2016",2,2,0,115000,1264.5,85
"17657","59128","2016",20,19,1,284590,2679.7,105.1
"17658","59129","2016",21,21,0,268649.2,2476.667,115.7143
"17659","59130","2016",11,11,0,187536.2,1588.091,116.0909
"17660","59131","2016",53,53,0,149660.2,1564.415,97.60377
"17661","59132","2016",15,15,0,147761.6,1455.2,112
"17662","59133","2016",13,13,0,201883.5,1976.385,103.8462
"17663","59134","2016",5,5,0,92300,1008.6,89.6
"17664","59135","2016",39,37,2,153070.4,1583.692,104.1282
"17665","59136","2016",74,71,3,76450.99,872.4459,86.60811
"17666","59137","2016",7,7,0,72714.29,720,102.4286
"17667","59138","2016",10,9,1,136700,1421,85.1
"17668","59139","2016",141,135,6,85813.4,898.1418,93.9078
"17669","59140","2016",3,3,0,92333.33,833,115.3333
"17670","59141","2016",6,6,0,127750,1185.167,107.8333
"17671","59142","2016",5,5,0,142360,1787.2,82.2
"17672","59143","2016",103,98,5,203939.8,2049.126,99.30097
"17673","59144","2016",12,12,0,179208.3,1795.25,101.8333
"17674","59145","2016",10,10,0,205555,2077.2,100.7
"17675","59146","2016",37,35,2,257177.8,2611.054,99.21622
"17676","59147","2016",1,1,0,145000,1495,97
"17677","59148","2016",5,5,0,133360,1029.2,126.4
"17678","59149","2016",11,11,0,94545.45,893.4545,109.2727
"17679","59150","2016",3,3,0,221666.7,2245.333,99
"17680","59151","2016",22,22,0,126536.5,1210.364,105.5909
"17681","59152","2016",132,129,3,203573.4,1995.068,101.7576
"17682","59153","2016",55,55,0,123526.2,1258.473,101.2364
"17683","59155","2016",217,199,18,128164.3,1489.415,87.07834
"17684","59156","2016",28,26,2,146486.1,1442.036,105.6786
"17685","59157","2016",19,18,1,83373.68,1047.947,79.36842
"17686","59158","2016",36,36,0,244123.4,2167,115.4722
"17687","59159","2016",6,6,0,206750,2017.333,105.1667
"17688","59160","2016",37,36,1,99979.7,1079.892,96.40541
"17689","59161","2016",8,8,0,147012.5,1087.875,141.25
"17690","59162","2016",7,7,0,174857.1,1350.857,138.5714
"17691","59163","2016",315,216,99,188700.8,2069.644,88.81905
"17692","59164","2016",5,5,0,130200,1005.8,126
"17693","59165","2016",61,61,0,135383.1,1460.197,92.7377
"17694","59166","2016",15,15,0,146903.3,1451.267,101.2667
"17695","59167","2016",3,3,0,121166.7,1350,94.33333
"17696","59168","2016",1,1,0,241000,3493,69
"17697","59169","2016",4,4,0,198500,1755.75,108.5
"17698","59170","2016",38,38,0,121119.7,1216.079,104.7895
"17699","59172","2016",141,138,3,76245.96,922.5816,83.61702
"17700","59173","2016",20,20,0,252845,2242.1,111.2
"17701","59174","2016",2,2,0,80000,1002.5,80.5
"17702","59175","2016",3,3,0,243566.7,1590.667,130.3333
"17703","59176","2016",2,2,0,113500,2204,54
"17704","59177","2016",5,5,0,75200,866.2,85.4
"17705","59178","2016",372,217,155,120327.3,1467.406,84.23656
"17706","59179","2016",70,69,1,95331.5,1090.386,87.42857
"17707","59180","2016",11,11,0,177909.1,1957.636,88.90909
"17708","59181","2016",1,1,0,67000,870,77
"17709","59182","2016",3,3,0,204783.3,1540.333,130
"17710","59183","2016",951,618,333,141722,1669.56,88.45426
"17711","59184","2016",5,5,0,64546,833.4,64
"17712","59185","2016",8,8,0,110641.8,1277.25,90.5
"17713","59187","2016",2,2,0,147500,1162,126.5
"17714","59188","2016",1,1,0,30000,400,75
"17715","59189","2016",9,9,0,168666.7,1490,117.6667
"17716","59190","2016",13,13,0,171713.8,1428.846,118.4615
"17717","59191","2016",7,7,0,60171.43,764.7143,77.57143
"17718","59192","2016",14,13,1,116428.6,1264.357,91.28571
"17719","59193","2016",35,35,0,240252,2193.943,106.9429
"17720","59194","2016",10,10,0,94400,1020.7,95.1
"17721","59195","2016",15,15,0,294040,2755.867,108.0667
"17722","59196","2016",17,16,1,305357.6,2523.588,130.5294
"17723","59197","2016",28,28,0,237858.7,2383.679,102.2857
"17724","59198","2016",1,1,0,215000,4778,45
"17725","59199","2016",5,5,0,161264,1500.6,105.2
"17726","59200","2016",9,9,0,161257.8,1381.778,112.8889
"17727","59201","2016",5,5,0,263800,2307.8,106
"17728","59202","2016",59,56,3,170102.7,1863.373,91
"17729","59203","2016",10,9,1,75039,1030.2,72.1
"17730","59204","2016",5,5,0,96600,1144.2,86
"17731","59205","2016",60,60,0,86604.4,989.7167,86.48333
"17732","59206","2016",34,34,0,104279.4,1084.029,100.2941
"17733","59207","2016",21,21,0,134906.6,1173.667,118.1429
"17734","59208","2016",4,4,0,302875,2554.25,122.25
"17735","59209","2016",9,9,0,99911.11,917.3333,106.3333
"17736","59210","2016",17,16,1,160136.4,1529.647,106.7647
"17737","59211","2016",7,7,0,130871.4,1441.571,89
"17738","59212","2016",69,63,6,173743.4,1733.058,102.5507
"17739","59213","2016",5,5,0,155800,1403,109.4
"17740","59214","2016",15,15,0,138386.7,1303.8,102.6
"17741","59215","2016",9,9,0,210111.1,1437.222,145
"17742","59216","2016",4,4,0,130027.5,1621.5,80.25
"17743","59217","2016",3,3,0,174500,1671,107.6667
"17744","59218","2016",15,14,1,100120,900.6667,113.9333
"17745","59219","2016",9,9,0,166208.9,1600.556,102.3333
"17746","59220","2016",221,179,42,172765.7,2037.887,84.14027
"17747","59221","2016",18,9,9,139229.4,1921,68.5
"17748","59222","2016",19,19,0,211051.1,1993.316,110.1053
"17749","59223","2016",6,6,0,184042.5,1407.333,141.3333
"17750","59224","2016",19,19,0,129940.8,1273.526,101.5789
"17751","59225","2016",56,55,1,112256.6,1149.375,98.82143
"17752","59226","2016",7,7,0,133642.9,1381.571,105.2857
"17753","59227","2016",59,59,0,128959.2,1321.932,98.76271
"17754","59228","2016",14,14,0,167942.9,1584.214,107.0714
"17755","59229","2016",5,5,0,188900,1601.4,141.6
"17756","59230","2016",46,45,1,102879.1,1138.5,91.65217
"17757","59231","2016",5,5,0,183300,1489.8,132.6
"17758","59232","2016",3,3,0,131083.3,1405,90.33333
"17759","59233","2016",3,3,0,61433.33,721.3333,81
"17760","59234","2016",47,47,0,116160,1297.936,89.57447
"17761","59236","2016",2,2,0,127000,1414,91.5
"17762","59237","2016",8,8,0,187625,1597.5,129.25
"17763","59238","2016",17,17,0,168188.2,1589.235,111.2353
"17764","59239","2016",53,53,0,145248.3,1485.528,98.54717
"17765","59240","2016",3,3,0,148000,1625,78.66667
"17766","59241","2016",5,5,0,76900,692.4,106.6
"17767","59242","2016",9,9,0,106888.9,1073.889,101.3333
"17768","59243","2016",11,11,0,107000,999.4545,104.3636
"17769","59244","2016",12,12,0,105917.9,1136.333,92.75
"17770","59246","2016",5,5,0,95400,829.4,100.2
"17771","59247","2016",21,21,0,199567.1,2238.238,85.42857
"17772","59249","2016",102,96,6,77406.18,979.1863,86.26471
"17773","59250","2016",25,24,1,238071.5,2176.36,110.88
"17774","59251","2016",6,6,0,217006.7,1261.833,177.3333
"17775","59252","2016",22,22,0,178362,2128.591,85.5
"17776","59253","2016",65,64,1,105520.1,1163.4,95.06154
"17777","59254","2016",12,12,0,152508.3,1270.833,118.6667
"17778","59255","2016",3,3,0,125000,1254,98.66667
"17779","59256","2016",48,47,1,212003,2189.062,98.375
"17780","59257","2016",15,15,0,253844.7,2033.933,118.6667
"17781","59258","2016",26,26,0,282620.4,2443.692,119.4231
"17782","59259","2016",5,5,0,204580,1587,117.6
"17783","59260","2016",55,54,1,164861.6,1858.691,91.83636
"17784","59261","2016",8,8,0,105187.9,1011.75,100.875
"17785","59262","2016",23,23,0,223636.5,1810.522,127.2174
"17786","59263","2016",14,14,0,153339.3,1526.857,103.7143
"17787","59264","2016",5,5,0,157800,1409,112.6
"17788","59265","2016",27,27,0,118879.8,1219.815,100.3704
"17789","59266","2016",46,45,1,201176.4,1974,102.3478
"17790","59267","2016",3,3,0,56283.33,739,86.66667
"17791","59268","2016",52,47,5,147291.7,1635.462,89.71154
"17792","59269","2016",12,12,0,132458.3,1325.833,110.3333
"17793","59270","2016",6,6,0,111529.2,1279.5,102.6667
"17794","59271","2016",98,86,12,126312.8,1428.796,90.73469
"17795","59272","2016",43,43,0,115350.7,1449.093,81.97674
"17796","59273","2016",100,90,10,157684,1626.37,98.76
"17797","59274","2016",5,5,0,212300,1881.6,107
"17798","59275","2016",11,9,2,394512.5,3225,121.9091
"17799","59276","2016",30,30,0,125672.1,1351,92.43333
"17800","59277","2016",4,4,0,160750,1531.75,114.5
"17801","59278","2016",51,51,0,214929.3,2281.725,95.90196
"17802","59279","2016",248,231,17,175941.2,1954.738,89.96371
"17803","59280","2016",7,7,0,110571.4,1051.571,102.4286
"17804","59281","2016",18,18,0,183435.9,1844.889,99.5
"17805","59282","2016",3,3,0,107000,1498.667,70.66667
"17806","59283","2016",9,9,0,173522.2,1617.111,110
"17807","59284","2016",48,46,2,155325.3,1567.812,100.3125
"17808","59285","2016",19,19,0,111078.9,1176.632,101.6842
"17809","59286","2016",193,162,31,158497.1,1906.249,85.19171
"17810","59287","2016",1,1,0,181400,860,211
"17811","59288","2016",20,20,0,101137.5,1075.8,93.25
"17812","59289","2016",14,14,0,84305.64,904.5,93.78571
"17813","59290","2016",3,3,0,58333.33,941,62
"17814","59291","2016",103,101,2,88810.01,1037.641,89.63107
"17815","59292","2016",20,20,0,123850,1436.85,89.35
"17816","59293","2016",11,11,0,155127.3,1272.273,112.4545
"17817","59294","2016",3,3,0,141966.7,1090,118
"17818","59295","2016",238,205,33,148803.5,1687.277,90.63866
"17819","59296","2016",7,7,0,124218.6,1314,99.14286
"17820","59297","2016",23,23,0,119493.5,1204.739,98.43478
"17821","59299","2016",188,178,10,237969.8,2368.787,97.5
"17822","59300","2016",2,2,0,100500,1275,85
"17823","59301","2016",42,41,1,144568.3,1522.071,96.85714
"17824","59302","2016",39,39,0,118006.9,1266.231,93.15385
"17825","59303","2016",17,17,0,218490.5,2256.765,96.94118
"17826","59304","2016",7,7,0,242950,2088.286,115.1429
"17827","59305","2016",16,16,0,133409.4,1414.812,101.625
"17828","59306","2016",1,1,0,75000,938,80
"17829","59307","2016",5,5,0,90200,1157.4,79.2
"17830","59308","2016",10,10,0,179800,1895.1,101.1
"17831","59309","2016",42,42,0,150088.7,1412.167,113.6429
"17832","59310","2016",4,4,0,157702.5,1306,116
"17833","59311","2016",1,1,0,40000,465,86
"17834","59312","2016",10,10,0,140130,1169,123.8
"17835","59313","2016",10,10,0,130590,1333.9,99.2
"17836","59314","2016",27,27,0,143823.9,1420.333,103.3704
"17837","59315","2016",3,3,0,183333.3,1184.333,170.6667
"17838","59316","2016",29,29,0,211951.3,2181.379,104.1379
"17839","59317","2016",110,108,2,146669.5,1815.873,83.09091
"17840","59318","2016",20,19,1,136396,1381.5,106.9
"17841","59319","2016",25,25,0,196172,1801,109.88
"17842","59320","2016",20,20,0,171545.5,1779.85,99.85
"17843","59321","2016",9,9,0,77166.67,798.6667,100.3333
"17844","59322","2016",32,32,0,96105.47,1055.781,92.0625
"17845","59323","2016",16,16,0,176386.2,1645.875,111.875
"17846","59324","2016",78,74,4,94087.27,1040.564,92.71795
"17847","59325","2016",10,10,0,169544.1,1405.3,118.4
"17848","59326","2016",11,11,0,164754.5,1676.455,96
"17849","59327","2016",36,36,0,139007.9,1393.667,99.86111
"17850","59328","2016",440,298,142,232069.7,2579.893,89.72727
"17851","59329","2016",54,49,5,134494.4,1468.722,90.40741
"17852","59330","2016",28,28,0,232506.4,2166.679,113.3571
"17853","59331","2016",30,30,0,114133.3,1163.867,99.83333
"17854","59332","2016",38,22,16,108378.8,1552.211,72.31579
"17855","59333","2016",1,1,0,85000,895,95
"17856","59334","2016",14,14,0,133828.6,1373.786,95
"17857","59335","2016",33,31,2,189663.6,1836.03,104.8788
"17858","59336","2016",18,18,0,114727.8,1360.278,89.27778
"17859","59337","2016",5,5,0,124420,1567,85
"17860","59338","2016",9,9,0,102000,1235.333,83.44444
"17861","59339","2016",110,108,2,202376,2138.155,95
"17862","59340","2016",44,37,7,164698.4,1783.5,91.88636
"17863","59341","2016",4,4,0,103280.8,1166.75,85.5
"17864","59342","2016",1,1,0,136000,965,141
"17865","59343","2016",96,93,3,212786.3,2440.406,88.48958
"17866","59344","2016",24,23,1,117573.8,1244.583,95.79167
"17867","59345","2016",19,18,1,129820.5,1195.737,107.3684
"17868","59346","2016",50,50,0,196287.3,2285.96,87.72
"17869","59347","2016",14,14,0,141205.3,1234.786,115.2857
"17870","59348","2016",13,13,0,123307.7,1163.923,112.1538
"17871","59349","2016",16,16,0,131789.8,946,141.6875
"17872","59350","2016",3556,1123,2433,171882.1,2746.723,66.53825
"17873","59351","2016",6,6,0,110188.7,1060.833,104.5
"17874","59352","2016",105,97,8,246587.9,2371.8,103.0571
"17875","59353","2016",2,2,0,147500,1244.5,98.5
"17876","59354","2016",8,8,0,202287.5,1732.5,120
"17877","59356","2016",31,30,1,301363.5,2641.613,115.6129
"17878","59357","2016",18,18,0,123794.4,1251.667,101.1667
"17879","59358","2016",17,17,0,128491.2,1414.353,90.11765
"17880","59359","2016",63,63,0,158118.3,1642.889,98.07937
"17881","59360","2016",292,168,124,144510.1,2067.945,73.2637
"17882","59361","2016",21,21,0,81847.62,953.4762,85.90476
"17883","59363","2016",10,10,0,142050,1235.9,106
"17884","59364","2016",11,10,1,246900,2548.545,103
"17885","59365","2016",40,38,2,74910.5,891.525,88.6
"17886","59366","2016",6,6,0,152083.3,1665.333,93.66667
"17887","59367","2016",179,152,27,168769.2,1915.385,88.41341
"17888","59368","2016",432,155,277,206939,2607.312,79.27083
"17889","59369","2016",35,35,0,127106.2,1340.429,96.22857
"17890","59370","2016",6,6,0,159166.7,1320,118.3333
"17891","59371","2016",14,14,0,286321.4,2198.857,136.2143
"17892","59372","2016",4,4,0,79250,801.5,102.5
"17893","59374","2016",4,4,0,121750,1179.75,106.25
"17894","59375","2016",49,49,0,148092,1607.857,94.55102
"17895","59377","2016",10,10,0,144125,1250.9,120.7
"17896","59378","2016",672,415,257,284787.8,2937.195,93.43006
"17897","59379","2016",7,7,0,123628,1326.429,91.57143
"17898","59381","2016",5,5,0,112200,1258,90.8
"17899","59382","2016",17,17,0,87117.65,731.0588,119.0588
"17900","59383","2016",103,93,10,126460.1,1375.845,90.40777
"17901","59384","2016",12,12,0,119066.7,1003.583,117.9167
"17902","59385","2016",26,25,1,86452.31,1052.385,83.92308
"17903","59386","2016",121,114,7,214603.4,2447.281,88.90083
"17904","59387","2016",19,19,0,119190.7,1241.211,97.26316
"17905","59388","2016",22,21,1,244404.1,2192.273,111.7273
"17906","59389","2016",27,26,1,106555.6,1078.593,97.59259
"17907","59390","2016",20,20,0,122005,1277.35,97.85
"17908","59391","2016",7,7,0,94912.86,1089,95
"17909","59392","2016",210,158,52,89231.45,1065.181,86.31429
"17910","59393","2016",8,7,1,148781.5,1373,112.75
"17911","59394","2016",3,3,0,79333.33,900.3333,90.33333
"17912","59395","2016",4,4,0,116250,1310.25,93.75
"17913","59396","2016",4,4,0,131300,1313,99
"17914","59397","2016",9,9,0,162216.7,1502,102
"17915","59398","2016",39,39,0,360361.4,2684.769,139.9487
"17916","59399","2016",8,8,0,213312.5,1713.75,130.5
"17917","59400","2016",91,91,0,143784.4,1516.099,94.41758
"17918","59401","2016",22,22,0,217413.6,1689.5,129.3636
"17919","59402","2016",14,14,0,153923.1,1504.571,107.4286
"17920","59403","2016",7,7,0,190100,2123.286,99
"17921","59405","2016",9,9,0,102444.4,978.2222,102.7778
"17922","59406","2016",2,2,0,62250,721,93.5
"17923","59407","2016",3,3,0,178333.3,1518.333,131.3333
"17924","59408","2016",19,19,0,190922.6,1752.316,107.1579
"17925","59409","2016",20,20,0,121527.4,1289.3,96.05
"17926","59410","2016",219,129,90,152618.2,1880.292,78.69406
"17927","59411","2016",29,29,0,212405.7,2035.621,111.6207
"17928","59413","2016",8,8,0,107625,1167.625,87.625
"17929","59414","2016",35,35,0,151667.7,1576.657,98.22857
"17930","59415","2016",1,1,0,185000,1850,100
"17931","59416","2016",34,34,0,175249,1789.882,104.9412
"17932","59418","2016",14,14,0,126992.9,1117.214,113.6429
"17933","59419","2016",15,15,0,223803.3,1993.933,115.6667
"17934","59421","2016",237,198,39,291623.2,2728.008,103.8903
"17935","59422","2016",8,8,0,163736.9,1184.5,138.5
"17936","59423","2016",18,18,0,166708.3,1487.167,116.7222
"17937","59424","2016",12,12,0,141695.8,1322.167,108.8333
"17938","59425","2016",1,1,0,120000,774,155
"17939","59426","2016",143,135,8,212845.9,2189.441,97.41958
"17940","59427","2016",7,7,0,299842.9,2231.714,134.4286
"17941","59428","2016",52,52,0,105271.7,1193.038,87.80769
"17942","59429","2016",41,41,0,100905.4,1117.049,92.19512
"17943","59430","2016",8,8,0,103250,1054.25,103.625
"17944","59431","2016",71,71,0,191872.9,1875.676,102.5352
"17945","59432","2016",5,5,0,171400,1596.4,99.2
"17946","59433","2016",6,6,0,117916.7,1092.167,103.3333
"17947","59434","2016",12,12,0,214819.4,1873.583,109.75
"17948","59435","2016",19,19,0,217039.9,2301.421,94.26316
"17949","59436","2016",8,8,0,132143.8,1384.375,106
"17950","59437","2016",9,9,0,214202.2,2304.889,93.77778
"17951","59438","2016",4,4,0,158452.5,1490,109.25
"17952","59439","2016",2,2,0,202500,1549.5,106.5
"17953","59440","2016",6,6,0,74750,1023.667,71.83333
"17954","59441","2016",1,1,0,102000,1020,100
"17955","59442","2016",3,3,0,84363.33,836.6667,103.3333
"17956","59443","2016",3,3,0,103666.7,1216,77.33333
"17957","59444","2016",7,7,0,172784.3,1688.143,108.2857
"17958","59445","2016",13,12,1,115692.3,1055.615,111.3846
"17959","59446","2016",6,6,0,176759,1472,115.8333
"17960","59447","2016",85,85,0,125984.1,1333.824,93.68235
"17961","59448","2016",3,3,0,184733.3,1263.333,159.3333
"17962","59449","2016",87,75,12,151929.2,1717.782,90.09195
"17963","59450","2016",8,8,0,121125,1115,111.375
"17964","59451","2016",10,10,0,250667.6,1923.3,130.3
"17965","59452","2016",45,45,0,156613.9,1752.956,95.15556
"17966","59453","2016",7,7,0,201285.7,1996.857,107.8571
"17967","59454","2016",10,10,0,189095,1437.6,131.8
"17968","59455","2016",16,16,0,129243.8,1530.875,100.0625
"17969","59456","2016",34,34,0,127274.1,1292.294,94.41176
"17970","59457","2016",86,77,9,180536.3,2105.709,88.96512
"17971","59458","2016",11,11,0,287754.5,2350.909,123
"17972","59459","2016",43,40,3,125590.8,1412.419,89.81395
"17973","59462","2016",66,55,11,217620.5,2229.561,99.37879
"17974","59463","2016",17,17,0,152797.1,1481.118,106.1765
"17975","59464","2016",20,20,0,136692.1,1188.55,115.75
"17976","59465","2016",5,5,0,112425,1242.2,95.4
"17977","59466","2016",24,20,4,209350,2239.542,96.75
"17978","59467","2016",31,30,1,98467.48,1253.806,89.09677
"17979","59468","2016",5,5,0,199284.2,1605,123.4
"17980","59469","2016",3,3,0,170166.7,1126.333,146.6667
"17981","59470","2016",16,15,1,228975,2181.812,104.375
"17982","59471","2016",23,23,0,154862.4,1591.391,105.5217
"17983","59472","2016",6,6,0,107408.3,1108.333,101
"17984","59473","2016",2,2,0,360500,1950,181
"17985","59474","2016",5,5,0,91140,1000.8,96
"17986","59475","2016",13,13,0,110076.9,1245.615,87.69231
"17987","59476","2016",35,35,0,157082.9,1380.286,111.7429
"17988","59477","2016",60,60,0,149903.8,1705.9,92.53333
"17989","59478","2016",12,12,0,148758.3,1647.5,89.33333
"17990","59479","2016",29,29,0,138583.4,1480.138,99.62069
"17991","59480","2016",7,7,0,116571.4,1359.429,84.28571
"17992","59481","2016",41,40,1,127996.6,1374.268,95.41463
"17993","59482","2016",73,68,5,266884,2410.425,108.4795
"17994","59484","2016",49,48,1,94464.29,1046.918,87.79592
"17995","59485","2016",20,20,0,91850,1033.25,88.4
"17996","59486","2016",29,29,0,144319,1474.759,100
"17997","59487","2016",14,13,1,327114.3,2371.214,139.5714
"17998","59488","2016",29,29,0,129436.2,1311.138,97.89655
"17999","59489","2016",46,46,0,135118.5,1403.174,98.36957
"18000","59490","2016",1,1,0,85000,773,110
"18001","59491","2016",107,105,2,107835.5,1345.664,86.58879
"18002","59492","2016",2,2,0,117250,1152,99
"18003","59493","2016",3,3,0,186666.7,812.3333,225.3333
"18004","59494","2016",1,1,0,96900,1101,88
"18005","59495","2016",24,24,0,90792.17,943.9583,96.125
"18006","59496","2016",3,3,0,65166.67,654.6667,102.6667
"18007","59497","2016",10,10,0,164380,1514.5,109.8
"18008","59498","2016",6,6,0,113666.7,928.8333,118.3333
"18009","59499","2016",19,19,0,168256.7,1602,108.4211
"18010","59500","2016",5,5,0,177600,1397.2,126.8
"18011","59501","2016",15,15,0,125273.3,1402.267,89.93333
"18012","59502","2016",14,14,0,81434,995.5,86
"18013","59503","2016",4,4,0,103575,847.5,118
"18014","59504","2016",41,41,0,103676.6,1121.439,93.07317
"18015","59505","2016",5,5,0,220508,1945.6,112.8
"18016","59506","2016",6,6,0,102833.3,1112.667,89.83333
"18017","59507","2016",240,181,59,174446.8,2031.042,87.19167
"18018","59508","2016",188,140,48,218754.4,2323.309,92.92021
"18019","59509","2016",62,61,1,131194.3,1396.145,92.22581
"18020","59511","2016",22,22,0,211364.2,1921.818,113.7727
"18021","59512","2016",688,494,194,124421.9,1410.533,88.31541
"18022","59513","2016",4,4,0,171630,1753.75,98.75
"18023","59514","2016",55,47,8,108353.8,1158.764,93.92727
"18024","59515","2016",3,3,0,144033.3,1186.667,118
"18025","59516","2016",12,12,0,157954.2,1475.417,112.25
"18026","59517","2016",8,8,0,98687.5,1036.25,93.625
"18027","59518","2016",5,5,0,128300,1507,83.6
"18028","59519","2016",21,21,0,239473.8,2017.524,116.1905
"18029","59520","2016",20,20,0,135615,1327,105
"18030","59521","2016",3,3,0,88583.33,851.6667,96
"18031","59522","2016",24,24,0,279244.2,2656.708,101.125
"18032","59523","2016",28,27,1,291467.9,2683.321,105.8214
"18033","59524","2016",68,68,0,198958.3,2190.191,91.69118
"18034","59525","2016",18,18,0,93269.44,927.5556,106.1667
"18035","59526","2016",167,160,7,150990.6,1612.036,94.98802
"18036","59527","2016",163,115,48,193734.3,2456.344,80.10429
"18037","59528","2016",14,14,0,114128.6,1088.571,105.6429
"18038","59529","2016",5,5,0,189200,1328.8,145.2
"18039","59530","2016",3,3,0,199000,1565.333,131.6667
"18040","59531","2016",4,4,0,121500,1273.5,92.5
"18041","59533","2016",22,22,0,94414.55,1075.182,88.04545
"18042","59534","2016",6,6,0,85166.67,812.1667,106.5
"18043","59535","2016",23,23,0,215570.9,1936.261,117.7391
"18044","59536","2016",8,8,0,213363.2,1922,119.75
"18045","59537","2016",2,2,0,228030,1600,142
"18046","59538","2016",1,1,0,182075,1434,127
"18047","59539","2016",9,9,0,146821.7,1357.889,108.4444
"18048","59541","2016",10,10,0,69800,777.8,87.7
"18049","59542","2016",6,6,0,170838.8,1540.333,107.1667
"18050","59543","2016",17,17,0,123548.8,1267.294,102.4706
"18051","59544","2016",106,88,18,146372.8,1662.528,88.4717
"18052","59545","2016",17,17,0,73205.88,927.1765,93.47059
"18053","59546","2016",11,11,0,164731.8,1512.636,109.3636
"18054","59547","2016",9,9,0,81838.89,890.8889,86.22222
"18055","59548","2016",3,3,0,171100,1654.333,111.6667
"18056","59549","2016",2,2,0,117950,1366,86.5
"18057","59550","2016",36,36,0,141855.6,1701.583,86.44444
"18058","59551","2016",15,15,0,234832,2028.6,120.4
"18059","59552","2016",1,1,0,80000,825,97
"18060","59553","2016",61,60,1,237530.4,2039,115.5902
"18061","59554","2016",10,10,0,250980,2023.4,133.6
"18062","59555","2016",9,9,0,118311.1,1290.667,85.66667
"18063","59556","2016",1,1,0,68000,596,114
"18064","59557","2016",14,12,2,133759.3,1526.786,86.92857
"18065","59558","2016",11,11,0,129090.9,1310.636,107.0909
"18066","59559","2016",13,12,1,224603.5,2134.308,118.1538
"18067","59560","2016",139,109,30,174968.6,2099.345,86.45324
"18068","59562","2016",3,3,0,136416.7,1112.667,119.6667
"18069","59563","2016",2,2,0,225500,1562,145
"18070","59564","2016",33,30,3,117915.2,1282.818,91.54545
"18071","59565","2016",5,5,0,147780,1351.6,103.6
"18072","59566","2016",44,42,2,185087.8,2077.364,88.22727
"18073","59567","2016",4,4,0,104497.2,1154.5,94.5
"18074","59568","2016",4,4,0,208750,1740.5,118.25
"18075","59569","2016",144,127,17,116872,1318.451,87.55556
"18076","59570","2016",8,8,0,241025,1644.25,149.75
"18077","59571","2016",46,46,0,100661,986.587,103.8913
"18078","59572","2016",15,15,0,125360,1247,100.5333
"18079","59573","2016",4,4,0,203600,2134.75,126.5
"18080","59574","2016",98,97,1,114977.8,1238.173,95.13265
"18081","59575","2016",6,6,0,117333.3,1416.167,82.66667
"18082","59576","2016",12,12,0,195850,1900.167,102.8333
"18083","59577","2016",7,7,0,190534.3,1774.571,112.1429
"18084","59578","2016",16,16,0,136411.2,1352.688,105.8125
"18085","59579","2016",9,9,0,177865.6,1670.111,105.4444
"18086","59580","2016",51,47,4,158428.8,1702.196,96.45098
"18087","59581","2016",25,25,0,188601.2,1837.32,105.44
"18088","59582","2016",13,13,0,175969.2,1982,91.92308
"18089","59583","2016",7,7,0,92571.43,1206.429,75.57143
"18090","59584","2016",5,5,0,136200,1624.8,85.6
"18091","59585","2016",44,37,7,184538.3,2158.523,87.15909
"18092","59586","2016",76,74,2,239921.2,2418.197,101.6053
"18093","59587","2016",3,3,0,164366.7,1747.333,100.6667
"18094","59588","2016",66,64,2,235952.6,2015.576,119.4697
"18095","59589","2016",27,27,0,122237,1414.556,88.2963
"18096","59590","2016",10,10,0,127163,1316.2,99.4
"18097","59591","2016",4,4,0,123687.5,1403.75,92.25
"18098","59592","2016",52,50,2,196788.1,1902.404,101.4038
"18099","59593","2016",8,8,0,136821.5,1172.375,111.25
"18100","59594","2016",16,16,0,189074.4,1837.125,109.25
"18101","59595","2016",4,4,0,148862.5,1411.25,106.25
"18102","59596","2016",8,8,0,283250,1751.75,162.625
"18103","59597","2016",4,4,0,187375,1628.75,111
"18104","59598","2016",56,53,3,220292,2281.411,97.60714
"18105","59599","2016",1171,885,286,131604.4,1549.799,86.79419
"18106","59600","2016",14,14,0,298947.9,2147.571,139.8571
"18107","59601","2016",21,21,0,84953.81,891,95.95238
"18108","59602","2016",21,19,2,308597.6,2786.81,108.7619
"18109","59603","2016",60,58,2,112877.8,1309.533,90.45
"18110","59604","2016",5,5,0,105660,1121.2,92.8
"18111","59605","2016",22,22,0,199284.1,1848,109.2273
"18112","59606","2016",530,317,213,120939.2,1531.442,83.19434
"18113","59607","2016",7,7,0,149990.9,1248.857,124.7143
"18114","59608","2016",14,14,0,189321.9,1517.643,123.7143
"18115","59609","2016",20,19,1,277282.8,2240,124.45
"18116","59610","2016",10,10,0,161798.5,1462.4,110.4
"18117","59611","2016",32,32,0,318030.8,2650.875,117.5625
"18118","59612","2016",8,8,0,143625,1164.25,118.5
"18119","59613","2016",11,11,0,141283.6,1327.636,103.5455
"18120","59614","2016",14,14,0,113428.6,953.2143,121.7857
"18121","59615","2016",25,25,0,192554.6,1518.68,129.6
"18122","59616","2016",82,82,0,111857.9,1314.159,89.60976
"18123","59617","2016",4,4,0,87062.5,1115.5,77.75
"18124","59618","2016",7,7,0,145100,1427,103.8571
"18125","59619","2016",10,10,0,137393.1,1612.2,87.9
"18126","59620","2016",4,4,0,162600,1353.75,116.75
"18127","59622","2016",10,10,0,103900,1204.1,91.1
"18128","59623","2016",9,9,0,123166.7,1251.556,103
"18129","59624","2016",21,21,0,80628.57,824.619,101.2857
"18130","59625","2016",5,5,0,148600,1113,142
"18131","59626","2016",10,10,0,242672.2,1841.9,132.9
"18132","59627","2016",9,9,0,104611.1,1146.778,97.44444
"18133","59628","2016",5,5,0,150600,1419.6,120.2
"18134","59629","2016",16,16,0,174863.8,1649.25,110.625
"18135","59630","2016",32,32,0,148441.1,1753.844,84.65625
"18136","59631","2016",31,31,0,108416.4,1017.419,111.0645
"18137","59632","2016",41,41,0,127886.8,1466.78,87.36585
"18138","59633","2016",1,1,0,120000,811,148
"18139","59634","2016",8,7,1,174737.5,1448.125,120.875
"18140","59635","2016",4,4,0,170375,1420,119
"18141","59636","2016",155,127,28,265250.6,2692.884,99.08387
"18142","59637","2016",20,20,0,168597.3,1579.65,104.75
"18143","59638","2016",18,18,0,227856.1,2396.167,96.44444
"18144","59639","2016",11,11,0,166825.1,1514.636,118.2727
"18145","59640","2016",5,5,0,123200,1255.4,98
"18146","59641","2016",17,17,0,191900,1530.706,132.9412
"18147","59642","2016",3,3,0,136333.3,1053,130
"18148","59643","2016",2,2,0,180913.5,2395.5,75
"18149","59645","2016",4,4,0,100500,1516.5,95.75
"18150","59646","2016",275,232,43,239752,2465.182,95.80364
"18151","59647","2016",30,30,0,110394.8,1205.733,92.6
"18152","59648","2016",155,113,42,193465.4,2027.252,94.10968
"18153","59650","2016",427,403,24,136058,1691.211,82.89696
"18154","59651","2016",11,11,0,92295.91,1109.818,83.63636
"18155","59653","2016",105,103,2,191435.7,2075.981,90.6381
"18156","59654","2016",48,47,1,98912.67,1134.917,89.125
"18157","59655","2016",2,2,0,220250,1032,226
"18158","59656","2016",64,53,11,209136.8,2306.438,91.98438
"18159","59657","2016",7,7,0,146842.9,1395.429,109.8571
"18160","59658","2016",6,6,0,232481.7,2058.5,117.1667
"18161","59659","2016",26,26,0,74252.62,910.9615,85.5
"18162","59660","2016",33,31,2,238662.3,2416.455,99.63636
"18163","59661","2016",1,1,0,50000,877,57
"18164","59662","2016",15,15,0,139756,1427.867,106.0667
"18165","59663","2016",58,54,4,173367.9,1648.034,107.4828
"18166","59664","2016",2,2,0,132723.5,1586.5,83
"18167","59665","2016",2,2,0,129500,1668,77.5
"18168","59666","2016",17,17,0,152579.4,1401.412,108.5294
"18169","59667","2016",4,4,0,164000,1591.75,105.25
"18170","59668","2016",15,15,0,184741.7,1869.333,95.53333
"18171","59669","2016",7,7,0,185740,1381.857,137.4286
"18172","59670","2016",18,18,0,163286.1,1835.667,88.77778
"18173","60001","2016",11,11,0,97522.73,1213.545,82.45455
"18174","60002","2016",9,9,0,188985.3,1539,127.7778
"18175","60003","2016",6,6,0,201855.8,1874.833,107.8333
"18176","60004","2016",5,5,0,144500,1605.8,89.4
"18177","60005","2016",21,20,1,155091,1721.476,91.61905
"18178","60006","2016",14,14,0,184579.6,1921.929,105.6429
"18179","60007","2016",25,25,0,195071.4,1794.92,114.24
"18180","60008","2016",4,4,0,165250,1553.5,110.25
"18181","60009","2016",12,12,0,211426.2,1928.75,115.5
"18182","60010","2016",22,21,1,204050,2381,87.63636
"18183","60011","2016",8,7,1,113812.5,1164.375,102.625
"18184","60012","2016",44,43,1,185345.5,2204.182,89.45455
"18185","60013","2016",15,15,0,202960,2188.667,97.8
"18186","60014","2016",5,5,0,143200,1951,77.8
"18187","60015","2016",16,12,4,146468.8,1575.562,94.6875
"18188","60016","2016",1,1,0,253090,1861,136
"18189","60017","2016",12,12,0,148375,1503.25,94.83333
"18190","60019","2016",9,9,0,139394.4,1715.889,84
"18191","60020","2016",5,5,0,208600,2678.2,91
"18192","60021","2016",4,4,0,92750,1164.75,85
"18193","60022","2016",12,12,0,303761.2,2977.333,107
"18194","60023","2016",5,5,0,239309,2241,109.4
"18195","60024","2016",2,2,0,165100,1805,95
"18196","60025","2016",18,18,0,149055.6,1903.944,83.16667
"18197","60026","2016",4,4,0,132725,1946.25,85.5
"18198","60027","2016",11,11,0,162518.2,1603.273,101.0909
"18199","60028","2016",8,8,0,441972.5,3116,147
"18200","60029","2016",25,25,0,171976.7,1800.88,99.16
"18201","60030","2016",5,5,0,156394,1667,97.6
"18202","60031","2016",4,4,0,125765.2,1355.5,105.5
"18203","60032","2016",7,7,0,144571.4,1448.571,101.8571
"18204","60033","2016",15,15,0,369125,3417.6,117.3333
"18205","60034","2016",8,8,0,155125,1808.875,90.375
"18206","60035","2016",3,3,0,128333.3,1347,96.33333
"18207","60036","2016",3,3,0,245000,2435,102.3333
"18208","60037","2016",7,7,0,151714.3,1153.143,130.7143
"18209","60039","2016",5,5,0,123200,1447.8,92.4
"18210","60040","2016",5,5,0,174040,2450.6,76.6
"18211","60041","2016",10,9,1,147700,2078.8,76.1
"18212","60042","2016",22,22,0,190522.7,2105.636,94
"18213","60043","2016",8,8,0,140956.2,1596.125,87.75
"18214","60044","2016",10,10,0,145091.2,1647.4,97.3
"18215","60045","2016",3,3,0,303933.3,3737,85
"18216","60046","2016",1,1,0,223000,1798,124
"18217","60047","2016",11,11,0,268113.6,2448.273,119
"18218","60048","2016",3,3,0,146666.7,1826.333,84.66667
"18219","60049","2016",1,1,0,80000,1067,75
"18220","60050","2016",6,6,0,200350,2105.5,93.16667
"18221","60051","2016",4,4,0,116677.5,1089.75,105
"18222","60052","2016",2,2,0,75000,1056.5,71
"18223","60053","2016",4,4,0,87750,998,82.25
"18224","60054","2016",4,4,0,236712.5,2026,126.25
"18225","60055","2016",2,2,0,148400,1614.5,96
"18226","60057","2016",513,256,257,132045.6,1833.265,74.23782
"18227","60058","2016",7,7,0,122357.1,1586.286,88.85714
"18228","60059","2016",2,2,0,85000,982,92
"18229","60060","2016",6,6,0,275166.7,2553.5,122.6667
"18230","60061","2016",2,2,0,169000,1412.5,130
"18231","60062","2016",4,4,0,112500,1371.75,91.25
"18232","60063","2016",9,9,0,148113,1704.889,89.66667
"18233","60064","2016",14,14,0,146093.1,1461.714,101.7143
"18234","60065","2016",12,12,0,170000,1948.667,90.41667
"18235","60066","2016",2,2,0,163750,2823,84
"18236","60067","2016",16,15,1,155018.8,1834.625,85.25
"18237","60068","2016",31,31,0,149543.5,1648.065,93.6129
"18238","60069","2016",11,5,6,172170.5,2137.545,82.27273
"18239","60070","2016",4,4,0,277000,1992,116
"18240","60071","2016",1,1,0,150000,1442,104
"18241","60072","2016",2,2,0,119000,1758.5,65.5
"18242","60073","2016",2,2,0,145000,1559.5,105
"18243","60074","2016",16,16,0,231250,2573.812,95.5
"18244","60076","2016",5,5,0,129600,1043.6,126.2
"18245","60077","2016",3,3,0,128333.3,1424.333,92.66667
"18246","60079","2016",14,13,1,192128.2,1862.214,109.3571
"18247","60081","2016",6,6,0,148512.5,1542.333,99.5
"18248","60082","2016",10,10,0,140545,1739.9,86.6
"18249","60083","2016",10,10,0,166350,1785,95.8
"18250","60084","2016",5,5,0,156600,1506.2,107.4
"18251","60085","2016",1,1,0,163000,1358,120
"18252","60086","2016",29,28,1,238567.6,2636.931,97.17241
"18253","60087","2016",4,4,0,278425,2970.25,97.25
"18254","60088","2016",48,38,10,188718.6,2500.292,80.8125
"18255","60089","2016",5,5,0,173064,2752,81
"18256","60090","2016",4,4,0,248000,2779.25,91.75
"18257","60091","2016",9,8,1,185833.3,2355.889,83.11111
"18258","60092","2016",2,2,0,221000,1902,112.5
"18259","60093","2016",5,5,0,112600,1509.2,77.6
"18260","60094","2016",7,7,0,184428.6,1732.714,119.8571
"18261","60095","2016",7,7,0,222142.9,2343.286,96
"18262","60097","2016",1,1,0,140000,1918,73
"18263","60098","2016",2,2,0,110500,1189,93
"18264","60099","2016",3,2,1,112666.7,1668,65
"18265","60100","2016",1,1,0,165000,4342,38
"18266","60101","2016",10,10,0,180700,1991.6,96
"18267","60102","2016",21,19,2,175778.3,1986.095,89.7619
"18268","60103","2016",43,37,6,148070,1861.209,81.62791
"18269","60104","2016",30,30,0,140442.3,1501.567,96.16667
"18270","60105","2016",4,4,0,130991.2,1408,93
"18271","60106","2016",26,23,3,184046.2,2072.654,91.38462
"18272","60107","2016",21,20,1,190879.5,1934.476,101.1429
"18273","60108","2016",4,4,0,138000,2046.5,70.5
"18274","60109","2016",2,2,0,62066.5,527,115
"18275","60110","2016",2,2,0,148500,1842,81.5
"18276","60112","2016",6,6,0,118000,1781.5,76
"18277","60113","2016",2,2,0,120589.5,1438.5,84.5
"18278","60114","2016",1,1,0,177000,1844,96
"18279","60115","2016",8,8,0,132343.8,1899.75,71.5
"18280","60116","2016",32,30,2,160703.1,2072.844,83.375
"18281","60118","2016",6,6,0,108916.7,1329.667,85.83333
"18282","60119","2016",10,9,1,141220,1440.9,98.4
"18283","60120","2016",8,8,0,164375,1928.875,91.625
"18284","60122","2016",3,3,0,135000,1501.333,77
"18285","60123","2016",5,5,0,125906.8,1288.6,98.4
"18286","60124","2016",5,5,0,139200,1816.4,78.6
"18287","60125","2016",13,13,0,190469.2,1756.769,109.7692
"18288","60126","2016",5,5,0,138000,1453,94.2
"18289","60127","2016",8,8,0,161875,1544.875,102.75
"18290","60128","2016",1,1,0,75000,1500,50
"18291","60129","2016",17,17,0,127129.4,1541.412,87.29412
"18292","60130","2016",10,10,0,224010,2128.6,106.5
"18293","60131","2016",2,2,0,77500,1227.5,62.5
"18294","60132","2016",2,2,0,145500,1643.5,88.5
"18295","60133","2016",4,4,0,165750,1892.75,88.5
"18296","60134","2016",31,31,0,186028.3,2000.032,96.58065
"18297","60135","2016",23,23,0,181806.7,1972.13,100.913
"18298","60136","2016",10,10,0,146570,1616.6,89.4
"18299","60137","2016",3,3,0,113416.7,1134,116
"18300","60138","2016",9,8,1,347924,3045.667,112.4444
"18301","60139","2016",105,68,37,196245.8,2706,75.2381
"18302","60140","2016",6,6,0,198666.7,2123.833,114.8333
"18303","60141","2016",190,25,165,251221.5,3511.347,71.67368
"18304","60142","2016",45,24,21,218376.6,3016.956,76.51111
"18305","60143","2016",25,20,5,186596.2,2173.48,94.68
"18306","60145","2016",11,11,0,208181.8,1523.818,135.1818
"18307","60146","2016",2,2,0,110500,1061.5,110.5
"18308","60147","2016",6,6,0,151333.3,1805.333,86.5
"18309","60148","2016",6,6,0,189500,1915.833,94.66667
"18310","60149","2016",15,15,0,190363.3,2343.067,88.66667
"18311","60150","2016",10,10,0,129310.5,1425.2,90.9
"18312","60151","2016",37,36,1,205673.4,2047.811,102.2162
"18313","60152","2016",1,1,0,230000,1643,140
"18314","60153","2016",1,1,0,115000,1085,106
"18315","60154","2016",24,24,0,212268.6,2313.708,103.75
"18316","60155","2016",49,39,10,159129.4,2061,81.2449
"18317","60156","2016",22,21,1,189890.3,1860.727,103.2727
"18318","60157","2016",144,90,54,131460.5,1892.604,71.27778
"18319","60158","2016",5,5,0,139400,1553,101.2
"18320","60159","2016",527,169,358,174573.1,2304.038,76.70778
"18321","60160","2016",9,9,0,140611.1,1386.556,123.3333
"18322","60162","2016",5,4,1,136800,1855.8,73.2
"18323","60163","2016",4,4,0,126500,1688.5,96.25
"18324","60164","2016",3,3,0,122645.3,1774.333,65.66667
"18325","60165","2016",5,5,0,200278,1992.4,103
"18326","60166","2016",12,12,0,193911.7,2038.083,97.5
"18327","60167","2016",2,2,0,129000,2071,61.5
"18328","60168","2016",2,2,0,166250,1489.5,123
"18329","60169","2016",10,10,0,154735,2109.5,74.2
"18330","60170","2016",6,6,0,409016.7,3211.167,125.6667
"18331","60171","2016",3,3,0,204333.3,2188.333,100
"18332","60172","2016",57,30,27,272356.2,3415.526,88.33333
"18333","60173","2016",4,4,0,179125,1894.25,119.75
"18334","60174","2016",1,1,0,167636,1643,102
"18335","60175","2016",179,49,130,107170.9,1698.039,65.20112
"18336","60176","2016",175,108,67,194045,2449.566,81.92571
"18337","60177","2016",4,4,0,152400,1504.75,100.75
"18338","60178","2016",32,29,3,130890.6,1491.438,92.46875
"18339","60179","2016",2,2,0,122500,2016,61.5
"18340","60180","2016",9,9,0,144749.9,1719.889,84.55556
"18341","60181","2016",7,7,0,133071.4,1297.714,103.7143
"18342","60182","2016",4,4,0,81025,1247.75,78
"18343","60184","2016",1,1,0,180000,1125,160
"18344","60185","2016",11,11,0,211909.1,2263.545,99.90909
"18345","60186","2016",3,3,0,199230,1426,140.6667
"18346","60187","2016",19,19,0,175974.7,1909.421,97.15789
"18347","60188","2016",36,36,0,140936.1,1697.083,88.97222
"18348","60189","2016",9,9,0,140488.9,1504,99.22222
"18349","60190","2016",6,6,0,216000,2406,93.33333
"18350","60191","2016",7,7,0,152071.4,1964.857,81.42857
"18351","60192","2016",2,2,0,137500,1958,69
"18352","60193","2016",3,3,0,107666.7,1043.333,99.66667
"18353","60194","2016",4,4,0,144750,1318.75,115.5
"18354","60195","2016",6,6,0,176833.3,2258,79.16667
"18355","60196","2016",6,6,0,184333.3,1627.5,125
"18356","60197","2016",14,14,0,226778.6,2415.714,97
"18357","60198","2016",1,1,0,121000,1779,68
"18358","60199","2016",3,3,0,142666.7,1521.333,94.33333
"18359","60200","2016",1,1,0,140000,1400,100
"18360","60201","2016",5,5,0,106400,1073.2,101.4
"18361","60203","2016",3,3,0,168333.3,2032,90.66667
"18362","60204","2016",5,5,0,121600,1109.2,114.4
"18363","60205","2016",2,2,0,108500,1493,79.5
"18364","60206","2016",8,8,0,155625,1687.5,95.875
"18365","60207","2016",3,3,0,174666.7,1947,94.33333
"18366","60208","2016",4,4,0,170125,1476.25,127.25
"18367","60209","2016",2,2,0,158500,1783,94.5
"18368","60210","2016",8,8,0,157312.5,1708,100.875
"18369","60211","2016",7,7,0,157857.1,2193,73.57143
"18370","60212","2016",8,6,2,166100,2181.5,76.5
"18371","60213","2016",7,7,0,258528.6,2748.857,110.1429
"18372","60215","2016",2,2,0,192000,1888,101
"18373","60216","2016",4,4,0,164750,1824.5,98.25
"18374","60217","2016",1,1,0,210000,1533,137
"18375","60218","2016",14,13,1,255657.1,2376,107.1429
"18376","60219","2016",3,3,0,130466.7,1411.333,90.33333
"18377","60220","2016",10,10,0,144700,1478.2,97.9
"18378","60221","2016",14,14,0,93857.14,1175.714,80.5
"18379","60222","2016",4,4,0,178250,1797.75,101.25
"18380","60223","2016",30,30,0,173033.3,2107.667,85.93333
"18381","60224","2016",4,4,0,174000,1992.25,100.75
"18382","60225","2016",6,6,0,143000,1357.833,99.66667
"18383","60226","2016",8,8,0,242750,2891.25,85.75
"18384","60227","2016",7,7,0,131642.9,1153.143,121.7143
"18385","60228","2016",8,8,0,239625,2242,113.75
"18386","60229","2016",2,2,0,245000,2865,87
"18387","60230","2016",4,4,0,138125,1585.75,94.75
"18388","60231","2016",7,7,0,191964.3,2130.429,97.85714
"18389","60232","2016",2,2,0,130000,2026.5,66.5
"18390","60233","2016",11,11,0,102272.7,1207.636,87
"18391","60234","2016",26,22,4,171445,1978.385,95.42308
"18392","60235","2016",13,13,0,163007.7,2154.154,78.15385
"18393","60236","2016",4,4,0,128000,1224.25,108.75
"18394","60237","2016",2,2,0,74500,853,88
"18395","60238","2016",20,20,0,229574.1,2212,106.7
"18396","60239","2016",9,9,0,298266.7,2406,123.2222
"18397","60240","2016",2,2,0,110500,1513.5,73
"18398","60241","2016",1,1,0,398500,4744,84
"18399","60242","2016",5,5,0,126000,1510.8,83
"18400","60244","2016",4,4,0,175375,1301.75,154.5
"18401","60245","2016",15,15,0,91233.33,1118.333,83
"18402","60247","2016",4,4,0,244500,2322,111.75
"18403","60248","2016",1,1,0,80000,1481,54
"18404","60249","2016",1,1,0,319000,1313,243
"18405","60250","2016",2,2,0,228000,1708.5,145.5
"18406","60251","2016",1,1,0,210000,2386,88
"18407","60252","2016",3,3,0,135666.7,1225.333,124.6667
"18408","60253","2016",9,9,0,109333.3,1296,83
"18409","60254","2016",6,5,1,200025,1891.167,115.8333
"18410","60255","2016",4,4,0,98875,1024.75,94.25
"18411","60256","2016",16,15,1,180906.2,1798.438,107.625
"18412","60257","2016",7,7,0,185142.9,1672.286,113
"18413","60258","2016",1,1,0,145000,1133,128
"18414","60259","2016",15,15,0,256146.7,2494.133,107.4667
"18415","60260","2016",7,7,0,169300,1578.429,106
"18416","60261","2016",10,10,0,273089.9,2088.2,126.7
"18417","60262","2016",2,2,0,136000,1982,69
"18418","60263","2016",1,1,0,105000,1419,74
"18419","60264","2016",5,5,0,205509.8,2294.2,89.8
"18420","60265","2016",7,7,0,121571.4,1214.286,106.4286
"18421","60267","2016",1,1,0,152000,1788,85
"18422","60268","2016",8,8,0,130875,1577,90.875
"18423","60269","2016",3,3,0,177646.7,1791.333,100.6667
"18424","60270","2016",2,2,0,110000,1453,75.5
"18425","60271","2016",2,2,0,139500,1399,102
"18426","60272","2016",15,15,0,155253.3,2150,79.86667
"18427","60273","2016",6,6,0,166083.3,1704,102.5
"18428","60274","2016",2,2,0,144000,3414,46
"18429","60275","2016",3,3,0,162000,1353.333,122
"18430","60276","2016",2,2,0,120000,1373,89.5
"18431","60277","2016",18,18,0,192577.6,1976.222,97.27778
"18432","60278","2016",6,6,0,106498.2,1081.333,97
"18433","60279","2016",5,5,0,163380,1674.2,99.8
"18434","60280","2016",2,2,0,91500,1317,72.5
"18435","60281","2016",9,9,0,179372.2,2134.222,89.11111
"18436","60282","2016",145,91,54,302697.2,3092.062,100.5793
"18437","60284","2016",23,23,0,199819.6,2020.87,104.0435
"18438","60285","2016",6,6,0,138166.7,1659.667,86.16667
"18439","60286","2016",20,19,1,114552.5,1384.25,83.8
"18440","60287","2016",2,2,0,105383,1667.5,64.5
"18441","60288","2016",7,7,0,152321.4,1450.571,108.7143
"18442","60290","2016",5,5,0,213700,2432.2,94.8
"18443","60291","2016",12,12,0,100059,1085.833,94.5
"18444","60292","2016",3,3,0,145000,1419.667,103
"18445","60293","2016",4,4,0,369450,3377.25,107.75
"18446","60294","2016",1,1,0,145000,725,200
"18447","60295","2016",2,2,0,105500,1948,55
"18448","60296","2016",1,1,0,116000,1172,99
"18449","60297","2016",5,5,0,128712,1444.4,96
"18450","60298","2016",5,5,0,150500,1285,127.6
"18451","60299","2016",4,4,0,129250,1491.25,84
"18452","60301","2016",2,2,0,83750,793.5,105.5
"18453","60302","2016",9,9,0,176455.6,1861.778,99.22222
"18454","60303","2016",1,1,0,160000,904,177
"18455","60304","2016",2,2,0,96250,893,130
"18456","60306","2016",2,2,0,123000,986.5,125
"18457","60307","2016",16,16,0,161483.1,2163.625,80.875
"18458","60308","2016",6,6,0,199080,1875.833,114.6667
"18459","60309","2016",16,16,0,241221.6,2131.562,123.6875
"18460","60310","2016",3,3,0,172666.7,2010.333,85.33333
"18461","60311","2016",5,5,0,112790,1295,86.4
"18462","60312","2016",1,1,0,75500,1079,70
"18463","60313","2016",15,13,2,173700,1992.067,90.33333
"18464","60314","2016",5,5,0,105724.6,1113.2,104.8
"18465","60315","2016",7,7,0,158000,2639.714,66.28571
"18466","60316","2016",2,2,0,149858.5,1998,75
"18467","60317","2016",13,13,0,207988.5,1938.308,113.3846
"18468","60318","2016",8,8,0,174398.2,2098.75,90
"18469","60319","2016",9,9,0,137277.8,1655.556,86.33333
"18470","60320","2016",3,3,0,142666.7,1909.667,76.66667
"18471","60321","2016",11,11,0,219154.5,2259.636,107.1818
"18472","60322","2016",1,1,0,205000,1708,120
"18473","60323","2016",7,7,0,162857.1,1957.143,85.14286
"18474","60324","2016",7,7,0,131071.4,1429.143,92
"18475","60325","2016",12,10,2,252417.9,2272,112.4167
"18476","60326","2016",8,8,0,225851.2,2442.375,99
"18477","60327","2016",23,23,0,176933.5,1881.261,100.7391
"18478","60328","2016",3,3,0,154666.7,2114.333,75
"18479","60330","2016",16,16,0,193125,2077.875,97.3125
"18480","60331","2016",9,9,0,191811.1,1881,113.8889
"18481","60332","2016",11,11,0,178545.5,2200.455,89.54545
"18482","60333","2016",12,12,0,159941.7,2245.833,84.08333
"18483","60334","2016",13,13,0,231384.6,2297.385,104.1538
"18484","60336","2016",2,2,0,149500,1644,98
"18485","60337","2016",7,7,0,246014.3,2189.429,116.4286
"18486","60338","2016",49,40,9,211103.1,2237.204,95.16327
"18487","60339","2016",2,2,0,159250,1613,100.5
"18488","60340","2016",4,4,0,181000,1760.25,107
"18489","60341","2016",20,20,0,273526.5,2798.35,101.5
"18490","60342","2016",50,40,10,164923.4,2086.2,80.08
"18491","60343","2016",3,3,0,146666.7,1963.667,81
"18492","60344","2016",4,4,0,114200,1493,73.75
"18493","60345","2016",3,3,0,174730,1702,104
"18494","60346","2016",124,85,39,344609.5,3305.266,111.9677
"18495","60347","2016",3,3,0,127000,1258,112
"18496","60348","2016",5,5,0,148320,1320.4,113.6
"18497","60350","2016",11,11,0,125239.2,1501.182,88.72727
"18498","60351","2016",1,1,0,205000,1667,123
"18499","60352","2016",2,2,0,172500,2676.5,65.5
"18500","60355","2016",10,10,0,147350,1937.3,76.9
"18501","60356","2016",1,1,0,240000,2353,102
"18502","60357","2016",5,5,0,154200,1835.6,92.8
"18503","60358","2016",23,23,0,240811.3,2233.739,109
"18504","60359","2016",2,2,0,205250,1713,131
"18505","60360","2016",77,57,20,133018.4,1778.649,78.64935
"18506","60361","2016",1,1,0,113000,1507,75
"18507","60362","2016",1,1,0,120000,945,127
"18508","60364","2016",8,8,0,152625,1742.25,89.875
"18509","60365","2016",4,4,0,130250,1405.5,92.5
"18510","60366","2016",3,3,0,171575.3,1377.667,122.6667
"18511","60367","2016",5,5,0,200040,2096,99.8
"18512","60368","2016",20,20,0,161177,1943.7,89.15
"18513","60369","2016",18,17,1,193661.1,2257.056,101.8333
"18514","60370","2016",16,16,0,189031.2,2194.562,89.625
"18515","60371","2016",1,1,0,137500,1136,121
"18516","60372","2016",7,7,0,143071.4,1625.714,91.14286
"18517","60373","2016",10,10,0,174340,1821.4,106
"18518","60374","2016",26,26,0,129846.2,1505.846,95.19231
"18519","60375","2016",6,6,0,171916.7,1886.5,92
"18520","60376","2016",1,1,0,170000,810,210
"18521","60377","2016",3,3,0,109333.3,1284,87.33333
"18522","60378","2016",4,4,0,178294.2,1810,104
"18523","60379","2016",13,13,0,140538.5,1478.846,99.61538
"18524","60380","2016",19,17,2,164000,1935.789,87.78947
"18525","60381","2016",2,2,0,146000,996.5,146.5
"18526","60382","2016",116,68,48,168274.3,2257.543,77.81897
"18527","60383","2016",7,7,0,192428.6,2012.429,110.5714
"18528","60385","2016",9,9,0,158166.7,1866.667,89.88889
"18529","60386","2016",3,3,0,184235.7,1995,94
"18530","60387","2016",12,12,0,99241.08,1560.167,77.33333
"18531","60388","2016",4,4,0,180250,1585.5,120
"18532","60389","2016",3,3,0,120833.3,1663.333,74.33333
"18533","60390","2016",6,6,0,138021.3,1483.167,95.16667
"18534","60391","2016",1,1,0,248500,1868,133
"18535","60392","2016",7,7,0,156000,1830,93.71429
"18536","60393","2016",14,14,0,179685.7,1886.5,96.35714
"18537","60394","2016",1,1,0,182000,1556,117
"18538","60395","2016",127,93,34,151662.8,2067.575,76.29134
"18539","60396","2016",6,6,0,124000,1495.5,86.5
"18540","60398","2016",30,26,4,202651.7,2525.967,84.86667
"18541","60399","2016",2,2,0,113485,1016,105
"18542","60400","2016",4,4,0,179550,1652.25,104.25
"18543","60401","2016",13,13,0,177300,1876.154,98.84615
"18544","60402","2016",28,25,3,215729.7,2138.929,104.2857
"18545","60403","2016",16,16,0,110750,1366.625,81.5
"18546","60404","2016",17,15,2,176411.8,2239.235,88.52941
"18547","60405","2016",9,9,0,93333.33,1231.333,79
"18548","60406","2016",8,8,0,222687.5,2403.875,93
"18549","60407","2016",1,1,0,115000,1797,64
"18550","60408","2016",12,8,4,250302.5,1944.25,126.4167
"18551","60409","2016",21,21,0,209638.1,2268.667,93.04762
"18552","60410","2016",1,1,0,136800,1849,74
"18553","60411","2016",13,13,0,226818.5,2776.846,93.84615
"18554","60412","2016",10,10,0,172765,2040.7,82.5
"18555","60413","2016",11,9,2,229454.5,2398.273,98.27273
"18556","60414","2016",68,53,15,141329.4,1864.779,78.07353
"18557","60415","2016",1,1,0,390000,1573,248
"18558","60416","2016",1,1,0,88000,1048,84
"18559","60418","2016",9,9,0,162407.4,1787.444,90
"18560","60420","2016",8,8,0,198333.8,1985.375,128
"18561","60421","2016",5,5,0,209380,2401,81.8
"18562","60422","2016",5,5,0,279769,2490.6,128.2
"18563","60423","2016",7,7,0,162000,1824.571,93.28571
"18564","60424","2016",2,2,0,160500,1954,101
"18565","60425","2016",5,5,0,125200,1561,81.2
"18566","60426","2016",4,4,0,164250,1967.25,84
"18567","60427","2016",2,2,0,301300,2410.5,126.5
"18568","60428","2016",7,7,0,215714.3,1874.857,116
"18569","60429","2016",5,5,0,304200,2318,131.6
"18570","60430","2016",13,13,0,187110.4,2014.077,95.84615
"18571","60431","2016",7,7,0,126666.6,1462.429,89.85714
"18572","60432","2016",14,12,2,240364.3,2690,92.42857
"18573","60433","2016",10,10,0,206400,2057.8,101.3
"18574","60434","2016",2,2,0,140000,1812.5,81
"18575","60435","2016",4,4,0,126425,1383,95
"18576","60436","2016",1,1,0,120000,1364,88
"18577","60438","2016",1,1,0,119000,1919,62
"18578","60439","2016",71,60,11,140517.6,1988.944,81.56338
"18579","60440","2016",8,8,0,179423.4,2049.125,92.625
"18580","60441","2016",11,11,0,207472.7,2070.455,104.4545
"18581","60442","2016",1,1,0,163000,1811,90
"18582","60443","2016",5,5,0,100820,1455.6,68.6
"18583","60444","2016",1,1,0,195000,1681,116
"18584","60446","2016",56,40,16,209562.6,2480.982,91.73214
"18585","60447","2016",12,12,0,213141.7,1946.333,110.8333
"18586","60448","2016",2,2,0,101500,1395,65
"18587","60449","2016",4,4,0,150658,1650.75,92.75
"18588","60450","2016",55,45,10,189030,2391.564,86.43636
"18589","60451","2016",25,25,0,173221.2,1830,96.68
"18590","60452","2016",6,6,0,232583.3,2306.333,109
"18591","60454","2016",4,4,0,145000,1565.5,90.75
"18592","60456","2016",6,6,0,146275,1466.5,111.1667
"18593","60458","2016",1,1,0,180000,1268,142
"18594","60459","2016",1,1,0,135000,1688,80
"18595","60460","2016",2,2,0,177500,1955.5,91.5
"18596","60461","2016",1,1,0,188000,2066,91
"18597","60462","2016",28,26,2,180548.2,2056.357,91.92857
"18598","60463","2016",132,74,58,140282.9,1865.409,78.37879
"18599","60464","2016",15,15,0,184440.1,2058.333,103.2667
"18600","60466","2016",5,5,0,168800,1549.8,112.8
"18601","60468","2016",2,2,0,143500,1689,93
"18602","60469","2016",6,6,0,204509.2,1800.5,110.5
"18603","60470","2016",8,8,0,157375,1696.375,91.125
"18604","60471","2016",97,73,24,120688.6,1394.361,86.94845
"18605","60472","2016",1,1,0,137500,1719,80
"18606","60473","2016",3,3,0,234000,1810.667,122.6667
"18607","60474","2016",1,1,0,160000,1404,114
"18608","60476","2016",1,1,0,171500,1429,120
"18609","60477","2016",16,16,0,133234.4,1660.312,87.625
"18610","60478","2016",3,3,0,193666.7,1648.667,116.3333
"18611","60479","2016",10,10,0,186389,1876.2,105.1
"18612","60480","2016",2,2,0,162500,1595.5,123.5
"18613","60481","2016",11,11,0,161421.8,1887.818,87.45455
"18614","60482","2016",37,31,6,260782.5,3077.865,86.94595
"18615","60483","2016",7,7,0,140128.6,1874.286,76.57143
"18616","60484","2016",1,1,0,161500,1718,94
"18617","60486","2016",7,7,0,92187,1070.857,91
"18618","60487","2016",2,2,0,210000,2475.5,90.5
"18619","60488","2016",4,4,0,151375,1452,105.25
"18620","60489","2016",18,17,1,214466.7,2339.722,98.33333
"18621","60490","2016",5,5,0,247120,2743,116.4
"18622","60491","2016",33,31,2,194293.7,2061,100.4242
"18623","60492","2016",13,13,0,147737.5,1618.154,94.92308
"18624","60493","2016",2,2,0,157500,1882.5,87.5
"18625","60494","2016",21,19,2,280092.9,3003.714,102.2381
"18626","60495","2016",4,4,0,100250,1466,68.25
"18627","60496","2016",2,2,0,107500,1460.5,74.5
"18628","60497","2016",1,1,0,146000,1759,83
"18629","60498","2016",1,1,0,185000,1697,109
"18630","60499","2016",2,2,0,116000,1483.5,83
"18631","60500","2016",51,29,22,196451,2738.078,75.19608
"18632","60501","2016",15,14,1,150323.3,1814.667,88.46667
"18633","60502","2016",1,1,0,101000,1365,74
"18634","60504","2016",12,12,0,201758.3,1860.917,118.1667
"18635","60505","2016",12,8,4,267034.2,2816.917,99.41667
"18636","60506","2016",7,7,0,93971.43,1005.857,94.71429
"18637","60507","2016",5,5,0,131880,1197.6,112.8
"18638","60508","2016",39,31,8,202826.9,2184.487,94.5641
"18639","60509","2016",139,98,41,147977.7,1982.252,77.33813
"18640","60510","2016",7,7,0,200078,1899,105.5714
"18641","60511","2016",3,3,0,81185.33,1018.667,89.33333
"18642","60512","2016",3,3,0,190000,1851,105.3333
"18643","60513","2016",32,29,3,233575.5,2564.094,95.25
"18644","60514","2016",3,3,0,94612.33,1251.667,77.66667
"18645","60515","2016",5,5,0,156000,1555.8,104.6
"18646","60516","2016",6,6,0,173983.3,1917,93.5
"18647","60517","2016",14,13,1,216522.9,2088.5,110.9286
"18648","60518","2016",2,2,0,153500,1831.5,87
"18649","60520","2016",2,2,0,118000,2767.5,54.5
"18650","60521","2016",6,6,0,126500,1274.5,96.83333
"18651","60522","2016",5,5,0,143200,1826.8,79.4
"18652","60523","2016",12,12,0,169500,1711,101.4167
"18653","60524","2016",40,24,16,130678.8,1713.275,79.625
"18654","60525","2016",1,1,0,475000,2582,184
"18655","60526","2016",10,9,1,131100,1603.7,89.1
"18656","60527","2016",2,2,0,292500,2194.5,166
"18657","60528","2016",4,4,0,357580,1892.5,187
"18658","60531","2016",15,15,0,178228.7,1904.2,99.4
"18659","60533","2016",18,14,4,132022.2,1749.889,78.38889
"18660","60534","2016",8,8,0,207787.5,2390.75,93
"18661","60535","2016",3,3,0,164666.7,1830.333,90.66667
"18662","60537","2016",31,29,2,150044.7,1874.71,86.12903
"18663","60538","2016",4,4,0,161500,1527.5,116.75
"18664","60539","2016",16,15,1,189937.5,2309.5,86.8125
"18665","60540","2016",5,5,0,123200,1654.8,78.8
"18666","60542","2016",9,8,1,187902.2,2391.222,84.22222
"18667","60543","2016",1,1,0,245000,3828,64
"18668","60544","2016",3,3,0,110780.7,1125,98.66667
"18669","60545","2016",4,4,0,108750,1181,91
"18670","60546","2016",3,3,0,209333.3,1836.667,116.6667
"18671","60547","2016",13,13,0,225733.9,2121.308,114.0769
"18672","60548","2016",13,13,0,177901.5,2316.308,87.46154
"18673","60549","2016",2,2,0,102500,1449.5,70.5
"18674","60550","2016",1,1,0,130000,1529,85
"18675","60551","2016",4,4,0,161000,1769.5,96.5
"18676","60552","2016",6,6,0,224666.7,1879.5,121.5
"18677","60553","2016",2,2,0,190990,2907,66.5
"18678","60554","2016",3,3,0,193850,1897.667,103
"18679","60555","2016",1,1,0,316017,5016,63
"18680","60556","2016",3,3,0,93566.67,1490.333,65
"18681","60557","2016",5,5,0,147800,1609.2,99.2
"18682","60558","2016",6,6,0,139166.7,1282,104.1667
"18683","60559","2016",7,7,0,197000,1915.714,110.2857
"18684","60560","2016",10,10,0,232250,2792.6,91.2
"18685","60561","2016",4,4,0,207283.5,2112.75,107.75
"18686","60562","2016",21,20,1,194292.8,1853.238,108.0952
"18687","60563","2016",8,8,0,194493.8,1968.75,103.125
"18688","60564","2016",1,1,0,85000,1328,64
"18689","60565","2016",5,5,0,167500,1370.2,131.6
"18690","60566","2016",3,3,0,150666.7,1314,121
"18691","60567","2016",7,7,0,165500,1847.429,93
"18692","60568","2016",5,5,0,236000,2199.8,112.2
"18693","60569","2016",7,7,0,183000,1715.286,110.4286
"18694","60570","2016",19,19,0,192950.1,1813.579,112.7368
"18695","60571","2016",1,1,0,205000,1519,135
"18696","60572","2016",3,3,0,166666.7,2245.667,74.66667
"18697","60573","2016",3,3,0,84859,933,106.3333
"18698","60574","2016",6,6,0,188666.7,1784.167,110.3333
"18699","60575","2016",38,34,4,197684.7,2026.947,105.6842
"18700","60576","2016",3,3,0,167666.7,1533,120
"18701","60577","2016",26,26,0,143646.2,2145.769,74.84615
"18702","60578","2016",14,13,1,169683,2024.286,90.57143
"18703","60579","2016",8,8,0,260815,2383.625,149.875
"18704","60581","2016",75,56,19,122513.3,1664.133,79.96
"18705","60582","2016",8,8,0,146500,1816.75,86.5
"18706","60583","2016",2,2,0,264788,1978.5,131.5
"18707","60584","2016",54,47,7,191199.8,2380.204,81.90741
"18708","60585","2016",8,8,0,129125,1503.625,87.25
"18709","60586","2016",14,14,0,172367.4,1895.786,92.78571
"18710","60587","2016",20,20,0,194940,2048.5,100.75
"18711","60588","2016",4,4,0,103250,1401.75,75.5
"18712","60589","2016",23,19,4,220895.7,2801.87,81.91304
"18713","60590","2016",7,7,0,139357.1,2083,74.14286
"18714","60591","2016",15,15,0,197140.3,1982.067,110.4667
"18715","60592","2016",7,7,0,137142.9,1675.571,82.28571
"18716","60593","2016",1,1,0,176650,1821,97
"18717","60594","2016",2,2,0,144500,1325,102.5
"18718","60595","2016",3,3,0,143000,1840.333,85
"18719","60596","2016",2,2,0,123000,1894,64.5
"18720","60597","2016",12,12,0,189004.2,2003.25,94.58333
"18721","60598","2016",11,11,0,178936.4,1819.545,102.2727
"18722","60599","2016",2,2,0,125250,1411,89
"18723","60600","2016",10,10,0,174150,1897.4,98.2
"18724","60601","2016",10,6,4,136087,2027.5,73.1
"18725","60603","2016",13,12,1,134531.5,1580.308,84.61538
"18726","60604","2016",3,3,0,103500,804,121
"18727","60605","2016",5,5,0,110800,1294,83.8
"18728","60608","2016",2,2,0,40000,533.5,75
"18729","60609","2016",3,3,0,160000,2138.333,76
"18730","60610","2016",8,8,0,121359.1,1228.375,95.5
"18731","60611","2016",7,7,0,131942.1,1451.571,97
"18732","60612","2016",203,91,112,241474.5,2979.833,81.52709
"18733","60613","2016",4,4,0,179000,2097.5,89.25
"18734","60614","2016",3,3,0,172933.3,1984,88.33333
"18735","60615","2016",1,1,0,90000,1268,71
"18736","60616","2016",30,30,0,147483.6,1790.6,85.76667
"18737","60617","2016",2,2,0,187500,1907,101
"18738","60618","2016",1,1,0,187000,2033,92
"18739","60619","2016",20,16,4,226479,2480.95,99.2
"18740","60620","2016",6,6,0,272000,1899.833,131.5
"18741","60621","2016",1,1,0,89500,1356,66
"18742","60622","2016",6,6,0,122166.7,1354.667,92.33333
"18743","60623","2016",7,7,0,127000,1501.429,86.14286
"18744","60624","2016",1,1,0,60000,1154,52
"18745","60625","2016",4,4,0,123725,961.75,130.5
"18746","60626","2016",15,15,0,152833.3,1719.2,94
"18747","60628","2016",14,14,0,183675.3,1872.5,100.5714
"18748","60630","2016",1,1,0,220000,1719,128
"18749","60631","2016",9,8,1,277061.1,2669.556,104.1111
"18750","60632","2016",19,19,0,130136.8,1468.158,94.89474
"18751","60633","2016",2,2,0,179000,1462.5,128
"18752","60634","2016",4,4,0,89750,1111.75,82.75
"18753","60635","2016",6,5,1,134666.7,1908,73
"18754","60636","2016",33,33,0,144476.7,1611.97,91.72727
"18755","60637","2016",5,5,0,152860,1879,98.8
"18756","60638","2016",9,9,0,190977.8,2078,96.88889
"18757","60639","2016",5,5,0,211600,2050.2,125.8
"18758","60640","2016",4,4,0,211625,1986.5,110.25
"18759","60641","2016",18,18,0,149572.2,1668.167,97.16667
"18760","60642","2016",17,17,0,154722.7,1752.882,91.64706
"18761","60643","2016",23,23,0,125391.3,1299.087,99.30435
"18762","60644","2016",27,26,1,184816.7,1973.519,106.2222
"18763","60645","2016",7,7,0,201185.7,2707.286,79.14286
"18764","60646","2016",12,12,0,190118.3,2360.333,94.16667
"18765","60647","2016",21,21,0,134262.4,1646.952,83.19048
"18766","60648","2016",6,6,0,144416.7,1749.5,89.5
"18767","60650","2016",2,2,0,219500,2526,86
"18768","60651","2016",24,24,0,210783.3,2121.458,102.75
"18769","60652","2016",17,17,0,168000,2044.059,85.94118
"18770","60653","2016",3,3,0,114014.7,1208.667,95
"18771","60654","2016",5,5,0,142000,1567.6,100
"18772","60655","2016",2,2,0,102500,1190,88.5
"18773","60656","2016",4,4,0,179875,1866,99.5
"18774","60657","2016",4,4,0,124000,1240.25,119.75
"18775","60658","2016",9,9,0,191888.9,1732.111,113.7778
"18776","60659","2016",4,4,0,234875,1960.5,120.75
"18777","60660","2016",6,6,0,151833.3,1490.667,112.8333
"18778","60661","2016",9,7,2,163333.3,1925,93.55556
"18779","60662","2016",5,5,0,152900,1556.6,100.4
"18780","60663","2016",2,2,0,194000,1455,133.5
"18781","60664","2016",4,4,0,131500,1631.75,80.25
"18782","60665","2016",33,26,7,164314.8,2028.515,83.48485
"18783","60666","2016",22,22,0,266572.7,3007.091,94.09091
"18784","60667","2016",45,36,9,169803.6,2082.489,87.97778
"18785","60668","2016",8,8,0,175875,1975.875,93.5
"18786","60669","2016",1,1,0,161000,2038,79
"18787","60670","2016",63,53,10,203700.5,2325.175,91.90476
"18788","60671","2016",3,3,0,280000,2295.667,118
"18789","60672","2016",2,2,0,2e+05,2171,94.5
"18790","60673","2016",4,4,0,118500,1824,77.75
"18791","60674","2016",9,9,0,243777.8,1835.778,135.4444
"18792","60675","2016",7,7,0,169428.6,1814.714,90
"18793","60676","2016",6,6,0,117666.7,1645.667,75.33333
"18794","60677","2016",4,4,0,127000,1274.75,106.5
"18795","60678","2016",16,12,4,183293.8,2463.438,76.3125
"18796","60679","2016",1,1,0,168000,1806,93
"18797","60680","2016",8,8,0,275637.5,2263.625,122.875
"18798","60681","2016",3,3,0,216333.3,1998,111.3333
"18799","60682","2016",12,11,1,351012.1,2984.5,124.5
"18800","60683","2016",2,2,0,219500,2846,77.5
"18801","60684","2016",50,39,11,165297.3,2230.9,80.88
"18802","60685","2016",5,5,0,132211.8,1522.6,87.6
"18803","60686","2016",33,31,2,228630.3,2381.909,99.45455
"18804","60687","2016",1,1,0,170000,1417,120
"18805","60688","2016",3,3,0,157000,1715,91
"18806","60689","2016",22,22,0,231067.2,1953.409,124.0909
"18807","60691","2016",1,1,0,210000,1826,115
"18808","60692","2016",5,5,0,157000,2099.6,103.8
"18809","60693","2016",3,3,0,99966.67,975,104.3333
"18810","60695","2016",23,14,9,358206.5,3535.87,102.1739
"18811","60698","2016",2,2,0,126000,2110,65
"18812","60699","2016",2,2,0,171850,3364.5,51.5
"18813","60700","2016",12,12,0,176916.7,2168.833,87.91667
"18814","60701","2016",12,12,0,133300,1497.5,94.5
"18815","60702","2016",2,2,0,124500,1233.5,101.5
"18816","60703","2016",9,9,0,172111.1,1907.778,92.11111
"18817","61001","2016",275,168,107,98571.51,1250.982,78.59636
"18818","61002","2016",11,11,0,124590.9,1159.727,101.8182
"18819","61005","2016",2,2,0,172607.5,2087,95
"18820","61006","2016",85,72,13,92841.53,1130.906,83.78824
"18821","61007","2016",39,38,1,104167.6,1027.897,100.6154
"18822","61008","2016",15,15,0,94070,1248.267,76.13333
"18823","61010","2016",4,4,0,150500,1381,104.75
"18824","61011","2016",3,3,0,149500,1387.667,107.3333
"18825","61012","2016",2,2,0,115500,1227.5,92.5
"18826","61013","2016",4,4,0,100125,926,105.25
"18827","61014","2016",5,5,0,106766,1024,98.4
"18828","61015","2016",4,4,0,121250,1310.75,92
"18829","61017","2016",4,4,0,88250,1000,81.75
"18830","61020","2016",3,3,0,151151.7,1169.667,130.3333
"18831","61021","2016",2,2,0,81500,984.5,83
"18832","61023","2016",7,7,0,112428.6,995.8571,106.2857
"18833","61024","2016",8,8,0,61524.88,1040.75,62.25
"18834","61026","2016",2,2,0,110000,1993.5,57
"18835","61028","2016",4,4,0,118050,1105,108.5
"18836","61029","2016",10,10,0,103845,1513.6,75.9
"18837","61030","2016",4,3,1,130537.5,1484.5,87.5
"18838","61032","2016",7,7,0,115854.3,1250,100.7143
"18839","61034","2016",4,4,0,170750,1610.75,110.25
"18840","61036","2016",1,1,0,96235,764,126
"18841","61038","2016",22,21,1,113307.3,1067.545,104.6818
"18842","61039","2016",2,2,0,109500,917,138.5
"18843","61040","2016",9,9,0,89546.44,1059.333,95.88889
"18844","61041","2016",6,6,0,113071.7,1375.333,83.16667
"18845","61043","2016",9,9,0,96100,1111.889,87.11111
"18846","61044","2016",3,3,0,75666.67,641.6667,117.3333
"18847","61046","2016",2,2,0,210000,1829,110.5
"18848","61048","2016",2,2,0,123510,1204,99.5
"18849","61049","2016",1,1,0,162500,739,220
"18850","61050","2016",8,8,0,107026.2,1215.75,103.375
"18851","61051","2016",5,5,0,181100,2487.8,85
"18852","61052","2016",2,2,0,121150,1358.5,90
"18853","61053","2016",7,7,0,191142.9,1413.286,130.2857
"18854","61054","2016",2,2,0,101692.5,1082,95
"18855","61055","2016",8,8,0,107937.5,809,130.125
"18856","61056","2016",1,1,0,40000,727,55
"18857","61060","2016",1,1,0,80600,1075,75
"18858","61061","2016",21,21,0,102761.9,1197.048,90.28571
"18859","61063","2016",5,5,0,102800,1059.8,100.6
"18860","61066","2016",2,2,0,101000,1182,87
"18861","61068","2016",1,1,0,80000,741,108
"18862","61069","2016",4,4,0,84875,853,104.5
"18863","61070","2016",8,8,0,87175,1064.375,85.375
"18864","61072","2016",4,4,0,132750,1113.75,117.75
"18865","61074","2016",5,4,1,65628.2,789.2,85
"18866","61075","2016",11,11,0,118559.1,916.4545,127.7273
"18867","61076","2016",4,4,0,115750,929.75,143.75
"18868","61077","2016",9,9,0,135433.3,1277.556,105.4444
"18869","61078","2016",3,3,0,106666.7,1347,77
"18870","61079","2016",19,19,0,88200,965.2105,104.4211
"18871","61080","2016",1,1,0,55000,846,65
"18872","61081","2016",7,7,0,125000,1143.571,107.8571
"18873","61084","2016",1,1,0,110000,2444,45
"18874","61085","2016",1,1,0,168000,2800,60
"18875","61086","2016",4,4,0,102500,1070,98.75
"18876","61088","2016",1,1,0,130000,1250,104
"18877","61089","2016",2,2,0,82500,790,101.5
"18878","61091","2016",14,14,0,65965.79,823.9286,81.64286
"18879","61092","2016",11,10,1,121418.2,1442.636,89.27273
"18880","61093","2016",13,13,0,97774.62,944.3077,101.7692
"18881","61094","2016",9,9,0,120577.8,1182.222,107.4444
"18882","61095","2016",4,3,1,59875,724.5,83.5
"18883","61096","2016",26,26,0,85986.54,1052.231,81.84615
"18884","61097","2016",6,6,0,135333.3,1701.667,82.33333
"18885","61098","2016",5,5,0,101400,1060.6,97.4
"18886","61099","2016",2,2,0,135450,1474,101
"18887","61100","2016",1,1,0,122000,2440,50
"18888","61102","2016",1,1,0,32500,551,59
"18889","61103","2016",4,4,0,132000,1251.5,108.75
"18890","61107","2016",4,4,0,85857.5,1087.5,71.25
"18891","61108","2016",2,2,0,57000,683.5,80
"18892","61111","2016",3,3,0,94000,1019,101
"18893","61114","2016",3,3,0,201000,1720,115.3333
"18894","61116","2016",28,28,0,127843.6,1354.071,99.64286
"18895","61117","2016",20,19,1,139885,1366.2,103.1
"18896","61118","2016",1,1,0,127000,1270,100
"18897","61120","2016",1,1,0,350000,1667,210
"18898","61121","2016",3,3,0,88174,2207.333,44.66667
"18899","61123","2016",1,1,0,22000,423,52
"18900","61124","2016",5,5,0,73850,972.2,72.6
"18901","61126","2016",6,6,0,156550,1116,128.1667
"18902","61129","2016",4,4,0,131250,930,132
"18903","61130","2016",4,4,0,103875,1317,70.75
"18904","61133","2016",12,11,1,103385,983.1667,106.1667
"18905","61137","2016",1,1,0,37500,543,69
"18906","61139","2016",3,3,0,199333.3,1320,139
"18907","61140","2016",7,7,0,99928.57,1003.143,107
"18908","61141","2016",3,3,0,171964.7,1478.667,116.6667
"18909","61142","2016",1,1,0,110000,846,130
"18910","61143","2016",25,20,5,118272,1549.4,78.12
"18911","61145","2016",37,36,1,97232.97,1237.919,85.56757
"18912","61146","2016",3,3,0,125166.7,1461,88.33333
"18913","61148","2016",4,4,0,217500,1909,110.75
"18914","61149","2016",2,2,0,99750,1019.5,103
"18915","61150","2016",6,6,0,124916.7,1282.667,91.5
"18916","61151","2016",5,5,0,123390,1075.8,116
"18917","61153","2016",19,19,0,141900,1272.579,113.2105
"18918","61156","2016",6,6,0,77833.33,945.8333,79.66667
"18919","61158","2016",1,1,0,78970,699,113
"18920","61160","2016",7,7,0,195378.1,1613,104.1429
"18921","61163","2016",15,15,0,86400,1089,78.6
"18922","61164","2016",1,1,0,166000,912,182
"18923","61165","2016",3,3,0,135800,1687.667,93
"18924","61166","2016",6,6,0,179283.3,1463.833,116.6667
"18925","61167","2016",32,32,0,104419.7,1069.156,102.375
"18926","61168","2016",37,33,4,86676.73,1014.054,89.86486
"18927","61169","2016",132,88,44,91262.8,1032.947,90.37121
"18928","61170","2016",3,3,0,69666.67,767.6667,89.66667
"18929","61171","2016",1,1,0,139000,1562,89
"18930","61176","2016",1,1,0,49710,765,65
"18931","61180","2016",2,2,0,200400,1902,105
"18932","61181","2016",16,15,1,87712.5,1145.625,82.8125
"18933","61182","2016",4,4,0,90900,1164,79.5
"18934","61183","2016",2,2,0,96500,687.5,137
"18935","61187","2016",1,1,0,78000,975,80
"18936","61189","2016",4,4,0,120500,1298.5,103.25
"18937","61190","2016",2,2,0,130000,1066.5,126.5
"18938","61193","2016",2,2,0,130000,1632,79.5
"18939","61194","2016",10,10,0,111485,1039.7,109.4
"18940","61195","2016",3,3,0,157640,1212.333,133
"18941","61196","2016",20,20,0,104440,1204.75,87.8
"18942","61197","2016",1,1,0,91280,702,130
"18943","61198","2016",3,3,0,144144.7,1179.333,122
"18944","61199","2016",3,3,0,166416.7,1245.333,132.3333
"18945","61202","2016",1,1,0,65000,677,96
"18946","61203","2016",14,14,0,125907.1,1387.929,93
"18947","61206","2016",6,6,0,111916.7,1227.667,89.16667
"18948","61207","2016",8,8,0,136787.5,1078.375,113.75
"18949","61208","2016",8,8,0,104937.5,1277.125,86.125
"18950","61209","2016",3,3,0,138500,963,155
"18951","61210","2016",3,3,0,128333.3,1070.333,116.3333
"18952","61211","2016",18,18,0,85765.56,854,99.05556
"18953","61213","2016",1,1,0,189900,2110,90
"18954","61214","2016",69,57,12,105200,1214.507,92.44928
"18955","61215","2016",2,2,0,157575,936,162
"18956","61218","2016",19,19,0,101810.5,1100.895,98.26316
"18957","61221","2016",6,6,0,83716.67,1141.333,81.83333
"18958","61222","2016",5,5,0,71200,992.4,76.8
"18959","61224","2016",4,4,0,95975,904,103.25
"18960","61227","2016",1,1,0,65000,855,76
"18961","61228","2016",3,3,0,96166.67,969.6667,98.66667
"18962","61229","2016",1,1,0,130000,1340,97
"18963","61230","2016",42,41,1,113237,1273.881,91.09524
"18964","61232","2016",6,6,0,58783.33,805.3333,78.66667
"18965","61233","2016",3,3,0,130625,1062.667,113
"18966","61234","2016",9,8,1,151155.6,1787.333,85.55556
"18967","61237","2016",4,4,0,100606.2,991,101.75
"18968","61238","2016",1,1,0,320000,1667,192
"18969","61240","2016",3,3,0,110000,981.6667,120.3333
"18970","61241","2016",4,4,0,96500,1508.25,64.5
"18971","61242","2016",2,2,0,145750,1496.5,98
"18972","61243","2016",10,10,0,121300,1038.5,113.2
"18973","61244","2016",2,2,0,117150,1491.5,81.5
"18974","61248","2016",4,3,1,57375,704.25,82.75
"18975","61251","2016",3,3,0,132683.3,1120,118.3333
"18976","61252","2016",3,3,0,95000,1176,81.33333
"18977","61255","2016",7,7,0,87714.29,754,122
"18978","61256","2016",1,1,0,65000,542,120
"18979","61257","2016",4,4,0,80000,1088,69
"18980","61258","2016",8,8,0,73687.5,1023.75,77.75
"18981","61260","2016",7,7,0,65285.71,812.2857,82.14286
"18982","61261","2016",2,2,0,42000,703.5,57.5
"18983","61262","2016",2,2,0,49000,705,70.5
"18984","61263","2016",1,1,0,95000,1667,57
"18985","61266","2016",1,1,0,140000,1414,99
"18986","61267","2016",4,4,0,64000,690.75,90.5
"18987","61268","2016",3,3,0,84500,1465.667,68
"18988","61269","2016",7,7,0,88731.14,880.4286,100
"18989","61273","2016",3,3,0,87000,783.6667,112.6667
"18990","61274","2016",5,5,0,117400,1400.4,84.6
"18991","61275","2016",8,8,0,110356.2,1175.25,121.25
"18992","61276","2016",3,3,0,75006.67,766.6667,96
"18993","61277","2016",3,3,0,144733,1505,111.3333
"18994","61278","2016",16,16,0,105859.4,1059.688,97.5
"18995","61279","2016",2,2,0,128250,1099,112
"18996","61281","2016",2,2,0,115000,1165,97.5
"18997","61284","2016",3,3,0,110033.3,1038.333,111
"18998","61286","2016",1,1,0,187500,2500,75
"18999","61287","2016",10,9,1,78416,1012.8,80.6
"19000","61288","2016",13,13,0,102481.2,1149.077,92
"19001","61289","2016",2,2,0,106900,1006.5,102
"19002","61291","2016",2,2,0,73250,688.5,97
"19003","61292","2016",7,7,0,136745,1977.286,96.28571
"19004","61293","2016",27,25,2,105620.1,1243,90.48148
"19005","61294","2016",4,4,0,111250,1217.25,102.5
"19006","61295","2016",4,4,0,114000,1148.75,107.5
"19007","61297","2016",9,8,1,84935.33,953.1111,87.77778
"19008","61298","2016",3,3,0,96666.67,1009,95.66667
"19009","61300","2016",4,4,0,106500,1023.5,108.5
"19010","61301","2016",3,3,0,111666.7,1070,106.6667
"19011","61303","2016",3,3,0,58333.33,677,80.66667
"19012","61307","2016",2,2,0,131250,2180.5,60.5
"19013","61309","2016",24,24,0,147725,1361.125,102.4167
"19014","61310","2016",4,4,0,60000,870.25,81.75
"19015","61314","2016",5,5,0,98031,1000.6,111.2
"19016","61316","2016",1,1,0,69000,1211,57
"19017","61317","2016",2,2,0,113000,1233.5,80
"19018","61319","2016",3,3,0,83666.67,1103.667,70.33333
"19019","61321","2016",4,4,0,138125,1008.75,120.5
"19020","61322","2016",1,1,0,128000,1471,87
"19021","61323","2016",2,2,0,124000,1378,90
"19022","61324","2016",20,20,0,75819.5,805.9,90.95
"19023","61326","2016",2,2,0,84750,946.5,85.5
"19024","61327","2016",7,7,0,72628.57,1026.857,74.42857
"19025","61328","2016",2,2,0,90000,1094,84.5
"19026","61329","2016",6,6,0,104001.7,1149.333,91.16667
"19027","61330","2016",3,3,0,179333.3,1151.667,151.6667
"19028","61331","2016",3,3,0,118081.3,1218.667,96.33333
"19029","61333","2016",2,2,0,107537.5,1291.5,82.5
"19030","61336","2016",2,2,0,78825,986,79.5
"19031","61339","2016",16,16,0,149206.2,1449.188,99.875
"19032","61341","2016",14,14,0,118872.6,1234.857,93.92857
"19033","61342","2016",13,13,0,83488.46,1015.308,88.23077
"19034","61344","2016",10,10,0,73319,1018.8,79.4
"19035","61345","2016",23,23,0,139521.7,1316.13,109
"19036","61346","2016",2,2,0,165150,1173,139.5
"19037","61347","2016",5,5,0,91600,794.2,107.6
"19038","61348","2016",4,4,0,161822.5,1585.75,102
"19039","61350","2016",3,3,0,111666.7,1282.667,87
"19040","61351","2016",2,2,0,131500,1193,110
"19041","61352","2016",1,1,0,110000,1803,61
"19042","61357","2016",1,1,0,104000,819,127
"19043","61360","2016",3,3,0,194666.7,1227.333,155.6667
"19044","61362","2016",2,2,0,119000,1218,94.5
"19045","61363","2016",1,1,0,45000,474,95
"19046","61365","2016",6,6,0,137850,1319,101.1667
"19047","61366","2016",5,5,0,108071.4,751.2,142
"19048","61367","2016",3,3,0,185833.3,1792.333,98.66667
"19049","61369","2016",11,11,0,59038.27,737.5455,80.63636
"19050","61370","2016",1,1,0,110000,1594,69
"19051","61371","2016",3,3,0,166100,1217.333,130
"19052","61372","2016",3,3,0,124500,930.3333,127
"19053","61373","2016",5,5,0,80400,920.8,107
"19054","61374","2016",4,4,0,71760,1025.75,97.5
"19055","61375","2016",10,10,0,108430,1142.8,103.9
"19056","61376","2016",10,10,0,63380,686.8,93.9
"19057","61381","2016",1,1,0,3e+05,2143,140
"19058","61382","2016",11,11,0,125345.5,1237.364,100.6364
"19059","61384","2016",3,3,0,72666.67,712.3333,97.33333
"19060","61385","2016",8,8,0,94173.75,1350.625,70.125
"19061","61386","2016",10,10,0,88200,861.7,103.9
"19062","61387","2016",13,13,0,75610.77,795.9231,93.69231
"19063","61388","2016",2,2,0,56625,836,67.5
"19064","61389","2016",6,6,0,95100,1107.667,77.5
"19065","61390","2016",1,1,0,40000,690,58
"19066","61391","2016",27,26,1,124326.8,1356.741,88.85185
"19067","61392","2016",2,2,0,110250,1336,70
"19068","61394","2016",9,9,0,111000,998.4444,107
"19069","61397","2016",41,41,0,133184.1,1398.171,97.63415
"19070","61398","2016",2,2,0,137500,1754.5,78
"19071","61400","2016",3,3,0,77666.67,1316.667,65.33333
"19072","61401","2016",1,1,0,119000,832,143
"19073","61402","2016",1,1,0,110000,1964,56
"19074","61404","2016",7,7,0,119402.3,1233,100.5714
"19075","61405","2016",7,7,0,124142.9,1273.143,96.71429
"19076","61407","2016",6,6,0,113916.7,1275.167,94.16667
"19077","61411","2016",8,8,0,135737.2,1331.875,105
"19078","61412","2016",10,10,0,111230,1125.5,97.6
"19079","61413","2016",1,1,0,172000,1211,142
"19080","61414","2016",10,10,0,128418.5,1395.9,93.4
"19081","61415","2016",6,6,0,126383.3,1055.667,108
"19082","61418","2016",2,2,0,119500,1770,66.5
"19083","61419","2016",2,2,0,55750,671.5,77
"19084","61420","2016",1,1,0,135000,1688,80
"19085","61421","2016",6,6,0,51290,717.6667,70.16667
"19086","61422","2016",7,7,0,85857.14,1236.571,73.14286
"19087","61423","2016",5,5,0,119500,1212.6,102.4
"19088","61424","2016",3,3,0,139666.7,1192.667,116
"19089","61425","2016",2,2,0,77505,924,86
"19090","61426","2016",9,9,0,125111.1,1180.222,112.6667
"19091","61427","2016",4,4,0,112842.5,1034.25,102.5
"19092","61429","2016",8,8,0,74083.75,979.625,79.125
"19093","61432","2016",8,7,1,130544.5,1743.5,105.375
"19094","61433","2016",4,4,0,157750,1551,104.25
"19095","61435","2016",3,3,0,128333.3,1777,80
"19096","61436","2016",5,5,0,135000,1344,81.2
"19097","61439","2016",2,2,0,76125,1353,55.5
"19098","61440","2016",6,6,0,136833.3,1539.333,88.5
"19099","61442","2016",3,3,0,77333.33,860.6667,94.66667
"19100","61443","2016",2,2,0,113500,946,113.5
"19101","61444","2016",1,1,0,150000,1531,98
"19102","61445","2016",4,4,0,89250,796.25,128.25
"19103","61447","2016",16,16,0,85350.94,992,78.375
"19104","61448","2016",3,3,0,130666.7,1373,98
"19105","61450","2016",1,1,0,120000,1263,95
"19106","61451","2016",1,1,0,160000,2078,77
"19107","61453","2016",2,2,0,92872.5,1231.5,74
"19108","61454","2016",6,6,0,134733.3,1236.833,115.1667
"19109","61456","2016",23,23,0,120580.4,1253.13,100.9565
"19110","61457","2016",3,3,0,110000,1105.667,95
"19111","61459","2016",2,2,0,107500,1300,85
"19112","61460","2016",10,10,0,92309.5,994.4,90
"19113","61461","2016",4,4,0,272500,1638.5,146
"19114","61462","2016",9,9,0,122111.1,1427.444,85.33333
"19115","61463","2016",16,16,0,95398.88,1207.438,81.25
"19116","61464","2016",39,39,0,85005.13,1020.308,82.17949
"19117","61466","2016",14,14,0,96837.43,1013.286,93
"19118","61467","2016",3,3,0,126833.3,1102.667,115.3333
"19119","61472","2016",2,2,0,98500,1101,92
"19120","61473","2016",1,1,0,144250,1472,98
"19121","61474","2016",45,45,0,114970.3,1158.2,97.24444
"19122","61475","2016",9,9,0,93245.56,1100.444,87.22222
"19123","61476","2016",1,1,0,97200,1144,85
"19124","61479","2016",1,1,0,50000,714,70
"19125","61480","2016",3,3,0,127931,789,152
"19126","61481","2016",3,3,0,77500,1174.333,71.66667
"19127","61482","2016",4,4,0,63750,751,87.5
"19128","61483","2016",88,25,63,79750.05,1448.466,56.39773
"19129","61484","2016",36,36,0,105367.7,1202.472,88.05556
"19130","61485","2016",2,2,0,193000,1757.5,114
"19131","61486","2016",37,33,4,90929.38,903.7568,100.6757
"19132","61487","2016",3,3,0,96666.67,962.6667,101.3333
"19133","61488","2016",4,4,0,203500,1880.75,108.25
"19134","61490","2016",3,3,0,216250,1430.667,160.3333
"19135","61491","2016",38,38,0,103853.2,1297.421,91.05263
"19136","61492","2016",1,1,0,30000,625,48
"19137","61494","2016",10,9,1,74688,859.9,88.2
"19138","61497","2016",8,8,0,130681.2,1379.625,95.75
"19139","61498","2016",1,1,0,55000,573,96
"19140","61499","2016",2,2,0,117006,1520,77
"19141","61500","2016",1,1,0,80000,2286,35
"19142","61501","2016",8,8,0,79987.5,1145,70.125
"19143","61503","2016",2,2,0,118600,1187.5,97.5
"19144","61507","2016",6,6,0,205338.8,2365,100.3333
"19145","61508","2016",28,23,5,105780.5,1368.5,86.5
"19146","61512","2016",1,1,0,70000,1045,67
"19147","62001","2016",16,16,0,161865.6,1747.812,95.125
"19148","62003","2016",4,4,0,190458,1546.25,124.75
"19149","62004","2016",86,82,4,148770.9,1655.709,96.90698
"19150","62005","2016",7,7,0,129892.9,1232.429,99.57143
"19151","62006","2016",5,5,0,122110,1067,121
"19152","62007","2016",2,2,0,203200,2192.5,89.5
"19153","62008","2016",6,6,0,129333.3,1346,95.66667
"19154","62009","2016",2,2,0,118500,917,131
"19155","62010","2016",2,2,0,94087.5,1353.5,65.5
"19156","62011","2016",5,5,0,160810,1627.8,98.4
"19157","62013","2016",23,23,0,140463.9,1493.783,96.65217
"19158","62014","2016",79,72,7,120145.2,1257.241,97.56962
"19159","62015","2016",4,4,0,143750,1210.5,119.5
"19160","62016","2016",1,1,0,333000,3142,106
"19161","62017","2016",1,1,0,80000,748,107
"19162","62018","2016",5,5,0,140850,1430,96.6
"19163","62019","2016",32,32,0,150293.8,1569,98.3125
"19164","62020","2016",7,7,0,188000,1749.857,116.1429
"19165","62021","2016",5,5,0,142800,1333.4,112.2
"19166","62023","2016",35,35,0,115657.1,1219.057,93.74286
"19167","62024","2016",8,8,0,154845,1535.875,102.625
"19168","62025","2016",36,33,3,194968.5,2568.389,83.30556
"19169","62026","2016",2,2,0,154000,1405,114
"19170","62028","2016",4,4,0,107858.5,1045.75,100.5
"19171","62029","2016",7,7,0,79000,783.8571,118.1429
"19172","62030","2016",4,4,0,119900,1217,100.75
"19173","62031","2016",15,15,0,140993.3,1379.8,107.3333
"19174","62032","2016",37,37,0,142513.5,1501.973,98.94595
"19175","62033","2016",41,41,0,142992.5,1400.317,103.2683
"19176","62034","2016",13,13,0,146576.1,1406.692,105.1538
"19177","62035","2016",68,67,1,138670.9,1472.985,92.55882
"19178","62036","2016",5,5,0,137200,1535.6,89.4
"19179","62037","2016",29,28,1,228762.8,1909.31,119.8276
"19180","62038","2016",42,40,2,147026.7,1343.619,108.5238
"19181","62039","2016",8,8,0,209787.5,1933.125,107.625
"19182","62040","2016",85,81,4,125481.6,1348.565,94.64706
"19183","62041","2016",512,277,235,131039.9,1744.078,77.78125
"19184","62042","2016",11,11,0,210590.9,1537.455,136.9091
"19185","62043","2016",22,22,0,131532.7,1365.455,98.63636
"19186","62044","2016",2,2,0,75000,717.5,98.5
"19187","62045","2016",5,4,1,145680,1326,110.6
"19188","62046","2016",11,11,0,110363.6,1156.182,96.27273
"19189","62047","2016",2,2,0,89577.5,725,110
"19190","62048","2016",85,83,2,88890.18,956.9647,94.72941
"19191","62049","2016",4,4,0,160862.5,1280,125
"19192","62050","2016",9,8,1,65444.44,887.5556,74.22222
"19193","62051","2016",48,48,0,126463.1,1385.333,93.125
"19194","62052","2016",4,4,0,232250,1495.75,156
"19195","62053","2016",1,1,0,135000,1467,92
"19196","62054","2016",13,13,0,209113.3,2242.462,96.69231
"19197","62055","2016",6,6,0,172425,1449.5,124.6667
"19198","62056","2016",15,13,2,220660,2483.6,93.4
"19199","62057","2016",37,37,0,167604.1,1634.054,107.3784
"19200","62060","2016",21,21,0,86061.9,1059.381,81.52381
"19201","62061","2016",1,1,0,192900,1253,154
"19202","62062","2016",2,2,0,157500,1580.5,99.5
"19203","62063","2016",13,12,1,125973.1,1250.538,95.30769
"19204","62064","2016",1,1,0,122000,1371,89
"19205","62065","2016",105,100,5,120620.6,1356.352,90.50476
"19206","62067","2016",2,2,0,129500,905.5,141.5
"19207","62068","2016",5,5,0,93100,1098.6,87.2
"19208","62069","2016",1,1,0,1e+05,909,110
"19209","62070","2016",3,3,0,85000,997.6667,90.33333
"19210","62071","2016",1,1,0,90000,947,95
"19211","62073","2016",13,13,0,162023.1,1661.923,98.69231
"19212","62074","2016",2,2,0,174100,1543.5,113.5
"19213","62075","2016",10,10,0,211531.1,1702.5,117
"19214","62076","2016",5,5,0,194700,1596.2,123.6
"19215","62077","2016",2,2,0,194350,2151.5,91
"19216","62078","2016",14,14,0,125221.4,1483.786,90.64286
"19217","62079","2016",1,1,0,90000,652,138
"19218","62080","2016",21,19,2,91411.29,1002.286,95.42857
"19219","62081","2016",5,5,0,182514,1227.8,141.8
"19220","62082","2016",4,4,0,90875,858,112.5
"19221","62083","2016",42,42,0,112939.3,1294.429,91.16667
"19222","62085","2016",1,1,0,167000,1465,114
"19223","62086","2016",3,3,0,146266.7,1407.333,106.6667
"19224","62087","2016",6,6,0,125500,1520.833,81.5
"19225","62088","2016",4,4,0,112500,1046.75,110.75
"19226","62089","2016",2,2,0,193500,1787.5,109.5
"19227","62090","2016",2,2,0,84250,761,108
"19228","62091","2016",1,1,0,85000,1700,50
"19229","62092","2016",2,2,0,123500,1520.5,79
"19230","62093","2016",1,1,0,105000,1419,74
"19231","62094","2016",5,5,0,134850,1546,94.6
"19232","62095","2016",2,2,0,112500,839.5,128.5
"19233","62096","2016",3,3,0,66000,736.3333,83
"19234","62097","2016",8,8,0,151387.5,1420.5,106.5
"19235","62099","2016",50,45,5,152233.2,1661.74,91.88
"19236","62100","2016",13,13,0,111115.4,1258.615,85.38462
"19237","62102","2016",2,2,0,177500,1311.5,142.5
"19238","62104","2016",5,5,0,212880,1743.6,124.4
"19239","62105","2016",3,3,0,194333.3,1325,143.3333
"19240","62106","2016",1,1,0,207230,1818,114
"19241","62107","2016",3,3,0,148000,1929.333,92.66667
"19242","62108","2016",277,125,152,112244,2029.267,60.62816
"19243","62109","2016",3,3,0,101166.7,1000,95.66667
"19244","62111","2016",5,5,0,153555.2,1192.2,124.8
"19245","62112","2016",4,4,0,110750,1223.25,91
"19246","62113","2016",4,4,0,151500,1082.5,151.75
"19247","62114","2016",1,1,0,140000,631,222
"19248","62115","2016",4,4,0,158250,1450.75,105.25
"19249","62116","2016",2,2,0,151000,2474.5,65
"19250","62117","2016",13,13,0,96538.46,1001.308,100.6154
"19251","62118","2016",3,3,0,160773.3,1656.333,97.33333
"19252","62119","2016",312,222,90,120723.2,1421.189,88.63462
"19253","62120","2016",2,2,0,164350,1740.5,94.5
"19254","62121","2016",2,2,0,98800,1468,65.5
"19255","62122","2016",5,5,0,71567,1143.2,76.2
"19256","62123","2016",3,3,0,168950,1851.667,91.33333
"19257","62124","2016",7,7,0,142142.9,1398.143,101
"19258","62125","2016",5,5,0,215408,2034.2,106.6
"19259","62126","2016",93,88,5,127419.6,1464.796,89.27957
"19260","62127","2016",2,2,0,161812.5,1325.5,120.5
"19261","62128","2016",37,37,0,128841.2,1542.865,87.24324
"19262","62130","2016",4,4,0,87750,764,115.25
"19263","62131","2016",3,3,0,112333.3,1272,90
"19264","62132","2016",39,39,0,147910.4,1622.795,89.87179
"19265","62133","2016",65,64,1,113848.1,1248.477,91.78462
"19266","62134","2016",2,2,0,176250,866.5,205
"19267","62135","2016",1,1,0,75000,1190,63
"19268","62137","2016",4,4,0,121500,1237,108.25
"19269","62138","2016",6,6,0,111000,952.8333,115
"19270","62139","2016",61,61,0,109490.2,1261.525,89.54098
"19271","62140","2016",4,4,0,144287.5,1288,113.5
"19272","62141","2016",8,8,0,143181.2,1414.25,103.625
"19273","62142","2016",2,2,0,66000,555,104
"19274","62144","2016",7,7,0,159042.9,1380.286,119
"19275","62145","2016",5,5,0,138260,1539.2,97.6
"19276","62146","2016",4,4,0,130250,1405.25,90
"19277","62147","2016",1,1,0,60000,938,64
"19278","62148","2016",10,10,0,151665,1725.7,90.4
"19279","62149","2016",1,1,0,170850,1659,103
"19280","62150","2016",4,4,0,148000,1624,97.5
"19281","62151","2016",3,3,0,155333.3,1420,108
"19282","62152","2016",1,1,0,148500,1442,103
"19283","62153","2016",5,5,0,75000,1656.2,56.6
"19284","62154","2016",9,9,0,90188.89,1040,88.77778
"19285","62155","2016",5,5,0,150900,1351.8,111.4
"19286","62156","2016",11,11,0,209213.6,2215,107.8182
"19287","62157","2016",1,1,0,109000,948,115
"19288","62158","2016",10,9,1,90750,1775.7,75.5
"19289","62160","2016",342,183,159,113786.2,1388.073,82.90058
"19290","62161","2016",4,4,0,122500,1976.5,85.25
"19291","62162","2016",6,6,0,99000,1332.5,77.5
"19292","62164","2016",10,10,0,144280,1217.6,116.7
"19293","62165","2016",2,2,0,119000,1638,72.5
"19294","62166","2016",3,3,0,100333.3,1231.667,79
"19295","62167","2016",3,3,0,160333.3,1476.667,147.6667
"19296","62168","2016",5,5,0,103640,1173.4,83.6
"19297","62169","2016",3,3,0,78000,1160.667,60.66667
"19298","62170","2016",21,21,0,193317.2,1773.476,114.0476
"19299","62172","2016",5,5,0,146400,1671,93.4
"19300","62173","2016",48,48,0,146904.5,1436.771,99.97917
"19301","62174","2016",16,16,0,148381.2,1635.812,92.8125
"19302","62176","2016",5,5,0,210802,1657.8,132.4
"19303","62177","2016",13,13,0,119565.4,1437.692,85.92308
"19304","62178","2016",133,121,12,110711.1,1183.917,95.11278
"19305","62179","2016",3,3,0,188466.7,1177.667,160.6667
"19306","62180","2016",1,1,0,85000,780,109
"19307","62181","2016",9,9,0,121896.7,1372.667,104.6667
"19308","62182","2016",3,3,0,119000,1158.333,91.33333
"19309","62183","2016",10,10,0,102503.6,1112.1,88.7
"19310","62184","2016",3,3,0,126000,1196.333,100.3333
"19311","62185","2016",2,2,0,165000,1269.5,130
"19312","62186","2016",90,84,6,129324.9,1378.522,95.75556
"19313","62188","2016",29,29,0,109840,1157.517,95.24138
"19314","62189","2016",2,2,0,129500,1307,117.5
"19315","62190","2016",7,7,0,151264.3,1429.143,105.2857
"19316","62191","2016",5,5,0,175000,1826.4,98.8
"19317","62192","2016",2,2,0,137500,1434,93
"19318","62193","2016",784,601,183,109207.3,1340.867,83.96429
"19319","62194","2016",26,26,0,115595.8,1126.077,103.0769
"19320","62195","2016",12,12,0,161658.3,1697.083,100.1667
"19321","62196","2016",7,7,0,200428.6,2152.429,96.57143
"19322","62197","2016",19,19,0,95880,1017.684,93.84211
"19323","62199","2016",11,11,0,170454.5,1580.909,113.1818
"19324","62200","2016",25,25,0,156873.9,1679.48,94.84
"19325","62201","2016",104,59,45,122438.4,2478.115,53.39423
"19326","62202","2016",9,9,0,94655.56,1309.556,71.33333
"19327","62203","2016",4,4,0,97750,1126.5,91.75
"19328","62204","2016",14,14,0,150146.4,1338.571,114
"19329","62205","2016",11,11,0,293745.5,2595.182,118.3636
"19330","62206","2016",3,3,0,202333.3,1649,126
"19331","62207","2016",8,8,0,159237.5,1550,98.875
"19332","62209","2016",1,1,0,60000,1395,43
"19333","62212","2016",5,5,0,128600,1364,97.2
"19334","62214","2016",4,4,0,237500,2159.5,118.5
"19335","62215","2016",152,144,8,146087.6,1592.836,92.73026
"19336","62216","2016",2,2,0,147500,1730,85
"19337","62217","2016",24,24,0,111726.2,1213.792,95.70833
"19338","62219","2016",2,2,0,71250,870,85
"19339","62220","2016",2,2,0,125000,1491,89.5
"19340","62221","2016",3,3,0,126223.3,847.3333,145
"19341","62222","2016",3,3,0,102333.3,1351.667,79.66667
"19342","62223","2016",1,1,0,190810,1817,105
"19343","62224","2016",21,21,0,142236.2,1502.143,95.04762
"19344","62225","2016",7,7,0,223307.1,1842.571,114.7143
"19345","62228","2016",2,2,0,103000,1467,70.5
"19346","62229","2016",6,6,0,112200,1326.5,95.66667
"19347","62230","2016",3,3,0,214166.7,1446.333,155.6667
"19348","62231","2016",2,2,0,193500,2190.5,97
"19349","62232","2016",4,4,0,107362.5,1006.5,113.5
"19350","62233","2016",13,13,0,156384.6,1524.615,102.2308
"19351","62234","2016",3,3,0,106833.3,954,117.6667
"19352","62235","2016",21,21,0,224706,1968.619,124.6667
"19353","62236","2016",2,2,0,196750,1602.5,117.5
"19354","62237","2016",3,3,0,181966.7,1826.333,98.33333
"19355","62239","2016",46,26,20,208925.2,2148.478,98.93478
"19356","62240","2016",14,14,0,114951.8,1311.214,91.57143
"19357","62241","2016",4,4,0,163250,1434,120.25
"19358","62242","2016",2,2,0,49000,492,108.5
"19359","62243","2016",3,3,0,94666.67,855.3333,102
"19360","62244","2016",71,71,0,141741.5,1568.93,91.8169
"19361","62245","2016",6,6,0,121930,1291.833,96.33333
"19362","62246","2016",3,3,0,108060.7,1089.333,99
"19363","62247","2016",2,2,0,96750,1038,93
"19364","62248","2016",9,9,0,121500,1167.889,98.88889
"19365","62249","2016",61,61,0,115041.5,1341.197,87.80328
"19366","62250","2016",83,81,2,134100.8,1403.301,99.28916
"19367","62251","2016",5,5,0,112996,1090.8,104
"19368","62252","2016",17,17,0,235055.9,2026.353,122.1176
"19369","62254","2016",6,6,0,128308.3,1292.5,101.8333
"19370","62255","2016",2,2,0,190500,2351.5,80.5
"19371","62256","2016",1,1,0,35000,467,75
"19372","62257","2016",5,5,0,95898,1241.2,84.4
"19373","62258","2016",1,1,0,110000,1009,109
"19374","62259","2016",8,8,0,120308.8,1279.75,92.75
"19375","62260","2016",1,1,0,156000,1472,106
"19376","62261","2016",198,110,88,172560.6,2581.929,70.77273
"19377","62262","2016",17,17,0,129984.1,1281.176,102.2941
"19378","62263","2016",67,64,3,162495.4,1861.358,90.28358
"19379","62264","2016",6,6,0,111083.3,1692.167,72.5
"19380","62265","2016",4,4,0,286500,1728.25,175
"19381","62266","2016",1,1,0,80000,635,126
"19382","62267","2016",5,5,0,150740,1506.2,103.6
"19383","62268","2016",51,51,0,108074.3,1171.137,93.13725
"19384","62269","2016",1,1,0,70000,625,112
"19385","62270","2016",43,43,0,106816.9,1055.209,101.186
"19386","62271","2016",5,5,0,167424,1307.2,130.6
"19387","62272","2016",4,4,0,172125,1748.25,102
"19388","62273","2016",3,3,0,169000,1516.667,118.6667
"19389","62274","2016",64,61,3,137798.2,1403.234,101.7031
"19390","62275","2016",3,3,0,121616.7,1157.333,100.3333
"19391","62276","2016",55,54,1,132506.2,1393.091,97.09091
"19392","62277","2016",31,30,1,139416.1,1563.613,91.58065
"19393","62278","2016",4,4,0,232450,1226.25,183.5
"19394","62279","2016",13,13,0,225369.2,1752.769,131.8462
"19395","62280","2016",3,3,0,104000,1023.667,100
"19396","62281","2016",3,3,0,294333.3,2441.333,124.6667
"19397","62282","2016",1,1,0,150000,888,169
"19398","62284","2016",23,23,0,130355.4,1475.696,93.34783
"19399","62285","2016",7,7,0,161956.1,1235.143,134
"19400","62286","2016",5,5,0,176248.8,1667.6,106.8
"19401","62288","2016",16,15,1,157762.5,1802.125,101.3125
"19402","62289","2016",4,4,0,202250,1858,113
"19403","62290","2016",4,4,0,275500,1846.75,142.75
"19404","62291","2016",27,24,3,118663,1460.778,83.44444
"19405","62292","2016",3,3,0,148555,1615.333,92.66667
"19406","62293","2016",4,4,0,118750,1530.25,80
"19407","62295","2016",13,13,0,119678.5,1205.462,97.15385
"19408","62296","2016",1,1,0,216500,2640,82
"19409","62297","2016",21,21,0,149992.9,1425.333,111.8095
"19410","62298","2016",3,3,0,91666.67,737.6667,138.3333
"19411","62299","2016",3,3,0,108833.3,988,98
"19412","62300","2016",32,30,2,154654.2,1678.5,96.125
"19413","62303","2016",2,2,0,82000,1135.5,72.5
"19414","62304","2016",1,1,0,109000,1912,57
"19415","62306","2016",3,3,0,184166.7,1435.333,135
"19416","62307","2016",1,1,0,269300,2362,114
"19417","62308","2016",1,1,0,154450,2305,67
"19418","62309","2016",14,14,0,108386,1178.357,94.14286
"19419","62310","2016",13,13,0,146991.2,1677.231,89.46154
"19420","62311","2016",17,17,0,151317.6,1732.294,94.35294
"19421","62313","2016",11,11,0,90545.45,1013.182,90.36364
"19422","62314","2016",3,3,0,198766.7,1454.333,134.6667
"19423","62315","2016",2,2,0,88590,1668.5,55
"19424","62317","2016",7,7,0,191942.9,1312.857,147.2857
"19425","62318","2016",115,105,10,140095.9,1594.617,88.75652
"19426","62319","2016",4,4,0,271250,2547,112
"19427","62320","2016",7,7,0,153707.1,1793.429,84.14286
"19428","62321","2016",24,24,0,131305,1450.75,91.25
"19429","62322","2016",1,1,0,74000,881,84
"19430","62323","2016",17,17,0,179167.3,1672.882,124.0588
"19431","62324","2016",6,6,0,150225,1669.167,89.83333
"19432","62325","2016",5,5,0,88600,866.2,107.4
"19433","62326","2016",3,3,0,66333.33,856,78
"19434","62327","2016",4,4,0,147250,1290.5,119.75
"19435","62328","2016",7,7,0,80865.71,1544.714,68.57143
"19436","62329","2016",11,11,0,132000,1220.091,109
"19437","62330","2016",13,13,0,169235.6,1456,119.6923
"19438","62331","2016",12,12,0,153075,1640.333,89.25
"19439","62332","2016",1,1,0,209000,2322,90
"19440","62333","2016",2,2,0,149000,1207.5,126.5
"19441","62334","2016",8,8,0,153840.4,1478.25,109
"19442","62335","2016",6,6,0,92500,982.1667,92.83333
"19443","62336","2016",6,6,0,122333.3,991.6667,120.1667
"19444","62337","2016",5,5,0,176000,1155,154.8
"19445","62338","2016",30,30,0,267976.7,2260.4,120.1667
"19446","62339","2016",2,2,0,127500,1187.5,107
"19447","62340","2016",8,8,0,138800,1287,109
"19448","62341","2016",3,3,0,111333.3,890.3333,121.3333
"19449","62342","2016",2,2,0,94000,968,94.5
"19450","62343","2016",1,1,0,197000,1527,129
"19451","62344","2016",1,1,0,146721,2010,73
"19452","62346","2016",6,6,0,64166.67,840.8333,79.16667
"19453","62347","2016",1,1,0,103550,1698,61
"19454","62348","2016",1,1,0,120000,863,139
"19455","62349","2016",13,13,0,140346.2,1491.308,96.23077
"19456","62350","2016",7,7,0,140298.6,1868.857,74.71429
"19457","62351","2016",45,43,2,128288.4,1504.711,86.64444
"19458","62352","2016",1,1,0,143000,1000,143
"19459","62353","2016",2,2,0,170350,1003,160
"19460","62354","2016",13,13,0,149538.5,1518.692,100.6154
"19461","62355","2016",5,5,0,156740,1672.2,92
"19462","62356","2016",12,12,0,143371.7,1332,109.6667
"19463","62357","2016",1,1,0,89000,1309,68
"19464","62358","2016",2,2,0,202965,1924.5,105.5
"19465","62359","2016",6,6,0,127875,1510,85
"19466","62360","2016",10,10,0,180300.8,1618.8,112.5
"19467","62361","2016",23,22,1,67368.7,842.5652,78.13043
"19468","62363","2016",2,2,0,297500,3661,83
"19469","62364","2016",14,14,0,101321.4,914.1429,114.4286
"19470","62365","2016",2,2,0,52375,1038,54
"19471","62366","2016",5,5,0,111177,1187.2,98.8
"19472","62367","2016",5,5,0,151600,1279,124.8
"19473","62368","2016",1,1,0,150000,1531,98
"19474","62369","2016",7,7,0,225025.7,2195.714,107.7143
"19475","62370","2016",3,3,0,108729.3,844,134.3333
"19476","62371","2016",20,20,0,180915,1709.4,109
"19477","62372","2016",1,1,0,92000,1533,60
"19478","62373","2016",6,6,0,146483.3,1593,92.66667
"19479","62374","2016",2,2,0,140000,1174.5,130
"19480","62375","2016",2,2,0,98500,1016.5,95
"19481","62376","2016",24,24,0,149048.2,1449.5,109.4167
"19482","62377","2016",8,8,0,96562.5,1121,86.125
"19483","62378","2016",2,2,0,173650,1301.5,140
"19484","62379","2016",2,2,0,242500,1552.5,152.5
"19485","62380","2016",4,4,0,237712.5,1785.5,146.5
"19486","62381","2016",4,4,0,103500,1050,97.75
"19487","62382","2016",7,7,0,123003.6,1249.857,98.57143
"19488","62383","2016",15,15,0,192487.5,1534.067,129.0667
"19489","62384","2016",6,6,0,166883.3,1310.833,123.3333
"19490","62385","2016",1,1,0,211000,1287,164
"19491","62386","2016",18,18,0,193322.2,2135.167,95.5
"19492","62387","2016",6,6,0,107916.7,929.3333,117.8333
"19493","62388","2016",4,4,0,122500,1235.25,97
"19494","62390","2016",14,14,0,174785.7,1894.357,96.71429
"19495","62391","2016",13,13,0,107657.7,1176.923,90
"19496","62392","2016",5,5,0,166300,1736.4,95.4
"19497","62393","2016",14,14,0,154550,1423,106.8571
"19498","62395","2016",1,1,0,81000,853,95
"19499","62397","2016",58,56,2,117192.2,1405.897,84.18966
"19500","62398","2016",6,6,0,151833.3,1344.333,129.1667
"19501","62399","2016",7,7,0,176042.9,1501.714,119
"19502","62400","2016",42,42,0,109742.9,1215.905,92.61905
"19503","62401","2016",45,45,0,129781.8,1404.289,92.82222
"19504","62402","2016",2,2,0,222425,1437.5,153.5
"19505","62403","2016",14,14,0,134885.7,1448.071,95.42857
"19506","62405","2016",3,3,0,213833.3,1764.667,132.6667
"19507","62406","2016",3,3,0,110333.3,1200.333,91.33333
"19508","62407","2016",8,8,0,128000,1209.875,105.875
"19509","62408","2016",10,10,0,134125,1633.8,81.5
"19510","62409","2016",3,3,0,108000,1110.333,104.3333
"19511","62410","2016",2,2,0,109250,1021.5,103
"19512","62411","2016",1,1,0,105000,1265,83
"19513","62412","2016",16,16,0,140312.5,1491.688,97.625
"19514","62413","2016",76,72,4,114804.4,1358.868,87.38158
"19515","62414","2016",5,5,0,155360,1303,118.4
"19516","62418","2016",3,3,0,144300,1223.333,109.6667
"19517","62419","2016",2,2,0,82500,965.5,84.5
"19518","62421","2016",3,3,0,87083.33,845.3333,97.33333
"19519","62422","2016",6,6,0,110250,1143.333,102.3333
"19520","62423","2016",19,19,0,144065.8,1419.263,99.10526
"19521","62424","2016",1,1,0,60000,800,75
"19522","62426","2016",4,4,0,132625,1479.75,88
"19523","62427","2016",226,218,8,123923,1313.292,95.0708
"19524","62428","2016",3,3,0,116000,1163.333,100
"19525","62429","2016",1,1,0,202000,1629,124
"19526","62430","2016",1,1,0,120000,902,133
"19527","62432","2016",3,3,0,139966.7,1437,97.66667
"19528","62434","2016",2,2,0,1e+05,988.5,103
"19529","62435","2016",1,1,0,60000,652,92
"19530","62436","2016",3,3,0,106000,863,113.6667
"19531","62437","2016",2,2,0,115822.5,1563,72.5
"19532","62438","2016",4,4,0,181750,1622.75,111
"19533","62439","2016",3,3,0,173000,1298.333,131.3333
"19534","62440","2016",10,10,0,107334,1155.6,94.1
"19535","62441","2016",4,4,0,189222.5,1646.25,113
"19536","62442","2016",2,2,0,81250,1048.5,78.5
"19537","62443","2016",46,45,1,128012,1359.283,94
"19538","62444","2016",3,3,0,246666.7,1828,137.6667
"19539","62445","2016",10,9,1,118780,1228.4,96.4
"19540","62446","2016",7,7,0,169170.3,1752.286,97.71429
"19541","62447","2016",21,18,3,90719.05,1167,78.38095
"19542","62448","2016",18,18,0,173189.4,1517.056,116.2222
"19543","62449","2016",1,1,0,50000,1220,41
"19544","62450","2016",1,1,0,50000,714,70
"19545","62451","2016",3,3,0,172733.3,1510,121
"19546","62452","2016",8,8,0,126084.4,1478.625,90.625
"19547","62453","2016",1,1,0,50000,625,80
"19548","62454","2016",35,35,0,191233.1,1707.714,114.0571
"19549","62455","2016",1,1,0,152000,1708,89
"19550","62456","2016",8,8,0,134438.8,1303.75,97.625
"19551","62457","2016",40,38,2,126018,1295,96.4
"19552","62458","2016",11,11,0,101572.7,1507.636,67.27273
"19553","62459","2016",5,5,0,84000,811.4,107.4
"19554","62460","2016",3,3,0,182666.7,2202,91
"19555","62461","2016",6,6,0,91333.33,1176.833,86.66667
"19556","62463","2016",1,1,0,120000,1071,112
"19557","62464","2016",26,26,0,171211.2,1617.231,108
"19558","62465","2016",4,4,0,113000,1255.75,88
"19559","62466","2016",2,2,0,113000,1550,72.5
"19560","62467","2016",5,5,0,83060,1030.6,83.2
"19561","62468","2016",6,6,0,99666.67,915.3333,112.8333
"19562","62469","2016",1,1,0,30000,588,51
"19563","62471","2016",8,8,0,161618.8,1449.25,114.375
"19564","62472","2016",3,3,0,213083.3,1692.333,136.6667
"19565","62473","2016",77,76,1,112388.4,1150.377,99.97403
"19566","62474","2016",8,8,0,132401.9,1416.5,100.375
"19567","62475","2016",2,2,0,242500,1132.5,189
"19568","62476","2016",6,6,0,171166.7,1553,104.6667
"19569","62477","2016",10,10,0,141200,1404.4,104.7
"19570","62478","2016",3,3,0,96666.67,1155.667,83.33333
"19571","62479","2016",19,19,0,130410.5,1135.526,113.3684
"19572","62480","2016",25,25,0,157537.5,1529.64,99.52
"19573","62481","2016",2,2,0,120500,1076,112.5
"19574","62483","2016",1,1,0,65000,1625,40
"19575","62484","2016",2,2,0,113200,1387,105
"19576","62485","2016",6,6,0,103500,1095.667,93
"19577","62486","2016",5,5,0,101800,1147,87.8
"19578","62487","2016",4,4,0,190750,1732.5,113.25
"19579","62488","2016",7,7,0,141090.3,1509.429,99.42857
"19580","62489","2016",40,40,0,120262.5,1319.375,90.675
"19581","62491","2016",46,44,2,177221.7,1804.217,101.2174
"19582","62492","2016",3,3,0,77666.67,878.6667,95.66667
"19583","62493","2016",4,4,0,116500,1262.75,90.75
"19584","62494","2016",2,2,0,100500,1229,80.5
"19585","62495","2016",3,3,0,170701.7,1352.667,125.6667
"19586","62496","2016",3,3,0,210000,1658,130.3333
"19587","62497","2016",52,52,0,165268.5,1619.75,102.0769
"19588","62498","2016",207,149,58,109692.6,1423.937,82.67633
"19589","62499","2016",3,3,0,95366.67,1365.333,70.66667
"19590","62500","2016",1,1,0,45000,506,89
"19591","62501","2016",4,4,0,108750,1537.75,81
"19592","62502","2016",51,50,1,202523.5,1706.961,119.6863
"19593","62503","2016",3,3,0,187666.7,2685.333,75.33333
"19594","62504","2016",1,1,0,227590,2775,82
"19595","62505","2016",5,5,0,170200,1559.6,109.4
"19596","62506","2016",7,7,0,120500,1486.714,82
"19597","62507","2016",1,1,0,1e+05,1124,89
"19598","62508","2016",2,2,0,165250,1337,144
"19599","62509","2016",1,1,0,65000,1250,52
"19600","62510","2016",192,173,19,112531.3,1291.766,87.60938
"19601","62511","2016",1,1,0,155000,1020,152
"19602","62512","2016",8,8,0,130875,1225.25,107.5
"19603","62513","2016",4,4,0,92562.5,869.75,111.25
"19604","62514","2016",1,1,0,110000,1134,97
"19605","62515","2016",3,3,0,136666.7,1016.667,137
"19606","62516","2016",109,108,1,100407.7,1090.477,89.30275
"19607","62517","2016",2,2,0,112750,1023.5,101.5
"19608","62518","2016",3,3,0,89000,894,102
"19609","62519","2016",2,2,0,102500,713,145
"19610","62520","2016",18,18,0,156535.7,1600.333,102.8889
"19611","62521","2016",3,3,0,100500,1365.667,86.66667
"19612","62522","2016",3,3,0,121666.7,959.6667,121.3333
"19613","62523","2016",52,52,0,116070.4,1350.731,87.92308
"19614","62524","2016",10,10,0,156950,1607.2,101.2
"19615","62525","2016",80,76,4,135006.2,1473.612,92.875
"19616","62526","2016",1,1,0,130000,1340,97
"19617","62527","2016",5,5,0,197500,1692.2,105.6
"19618","62528","2016",60,58,2,138132.5,1450.233,98.23333
"19619","62529","2016",17,17,0,259982.4,1975.353,130.4118
"19620","62530","2016",4,4,0,91870,1158.25,80.75
"19621","62531","2016",10,10,0,166630,1418.3,117.5
"19622","62532","2016",8,8,0,90771.25,1019.5,84.625
"19623","62533","2016",2,2,0,141900,1100.5,127.5
"19624","62534","2016",42,41,1,113388.5,1232.786,93.61905
"19625","62535","2016",2,2,0,194750,2103.5,97
"19626","62536","2016",5,5,0,138100,2027,81.4
"19627","62537","2016",4,4,0,86675,1077.75,92.5
"19628","62538","2016",5,5,0,106000,1524.4,76.8
"19629","62540","2016",9,9,0,162107.4,1470.667,113.7778
"19630","62541","2016",1,1,0,50000,610,82
"19631","62543","2016",12,12,0,141250,1328,110.8333
"19632","62544","2016",1,1,0,171000,2111,81
"19633","62545","2016",2,2,0,62500,1021.5,67
"19634","62546","2016",4,4,0,276671,2152,127.5
"19635","62547","2016",1,1,0,312000,1209,258
"19636","62548","2016",100,94,6,161081.8,1654.4,99.57
"19637","62549","2016",16,15,1,120450,1243.375,95.25
"19638","62550","2016",7,7,0,91714.29,1108.143,83.85714
"19639","62551","2016",5,5,0,112200,1162.2,92.6
"19640","62553","2016",2,2,0,187750,1565,122.5
"19641","62554","2016",1,1,0,295000,1695,174
"19642","62555","2016",24,24,0,102369.6,1192.667,87.75
"19643","62556","2016",5,5,0,93200,1509.8,60.6
"19644","62557","2016",26,26,0,182582.2,1593.192,113.5769
"19645","62558","2016",1,1,0,140000,1239,113
"19646","62559","2016",7,7,0,139707.1,1582.429,77.71429
"19647","62560","2016",53,51,2,134687.7,1504.83,94.75472
"19648","62561","2016",2,2,0,113000,726,166
"19649","62562","2016",3,3,0,88666.67,1009,85
"19650","62563","2016",43,43,0,130548.5,1397.512,93.11628
"19651","62564","2016",4,4,0,156250,1314.75,119.5
"19652","62565","2016",1,1,0,145000,1986,73
"19653","62566","2016",3,3,0,175333.3,1842.333,98.33333
"19654","62567","2016",3,3,0,115333.3,906,124.3333
"19655","62568","2016",12,12,0,133191.7,1560.5,86.25
"19656","62569","2016",4,4,0,129825,1393.5,92.25
"19657","62570","2016",73,72,1,123810.8,1404.904,88.15068
"19658","62571","2016",120,76,44,152923.5,2376.317,70.15833
"19659","62572","2016",8,8,0,88062.5,752.375,113.125
"19660","62573","2016",39,39,0,152106.4,1523.564,99.10256
"19661","62574","2016",2,2,0,176000,1694,101.5
"19662","62578","2016",1,1,0,175000,2188,80
"19663","62580","2016",4,4,0,118075,1486.5,84.5
"19664","62581","2016",2,2,0,81000,947.5,87
"19665","62582","2016",4,4,0,194187.5,1555.75,119.75
"19666","62583","2016",7,7,0,142199.6,1456.857,96.85714
"19667","62584","2016",6,6,0,142483.3,1609.833,107
"19668","62585","2016",5,5,0,177400,1713,110.2
"19669","62586","2016",3,3,0,191000,1713,116.3333
"19670","62587","2016",76,72,4,125659.3,1539.5,85.23684
"19671","62588","2016",26,21,5,155216.6,1956.923,90.19231
"19672","62589","2016",12,12,0,197923.1,1604.833,130.6667
"19673","62590","2016",1,1,0,167000,1518,110
"19674","62591","2016",2,2,0,122500,1265,95
"19675","62592","2016",2,2,0,106000,1756,59
"19676","62593","2016",1,1,0,169000,1444,117
"19677","62594","2016",5,5,0,98800,1161.8,86.4
"19678","62595","2016",12,12,0,127416.7,1433.417,98.66667
"19679","62596","2016",2,2,0,83750,989.5,87
"19680","62597","2016",1,1,0,185000,1555,119
"19681","62598","2016",9,9,0,150000,1636.667,95.22222
"19682","62599","2016",4,4,0,124875,1201,99.5
"19683","62600","2016",2,2,0,181750,1575,119
"19684","62602","2016",3,3,0,101666.7,969.3333,142.3333
"19685","62603","2016",13,13,0,110807.7,1304.923,89.53846
"19686","62604","2016",136,70,66,246235.8,3134.243,88.51471
"19687","62606","2016",17,17,0,217323.5,1928.588,114.8235
"19688","62609","2016",9,9,0,186915.6,1991.889,95.11111
"19689","62610","2016",3,3,0,103333.3,1039.333,102.6667
"19690","62611","2016",3,3,0,164600,1676.667,95.33333
"19691","62612","2016",1,1,0,50000,1087,46
"19692","62613","2016",5,5,0,125200,1555.6,80.2
"19693","62614","2016",5,5,0,111472,1506.4,93.2
"19694","62615","2016",1,1,0,160000,2133,75
"19695","62616","2016",1,1,0,120000,1481,81
"19696","62617","2016",112,106,6,105937.9,1280.429,85.33036
"19697","62618","2016",12,12,0,166650,1607,107.4167
"19698","62620","2016",13,13,0,110746.2,1132.077,97.07692
"19699","62621","2016",7,7,0,156485.7,1497,107.7143
"19700","62622","2016",2,2,0,175775,1531,116.5
"19701","62623","2016",4,4,0,180100,1631.75,110.5
"19702","62624","2016",43,43,0,131731.4,1498.488,90.65116
"19703","62625","2016",1,1,0,128000,1422,90
"19704","62626","2016",14,14,0,155446.2,1529.643,103.5714
"19705","62627","2016",6,6,0,174333.3,1416.833,123.5
"19706","62628","2016",39,37,2,101997.9,1352.923,77.51282
"19707","62629","2016",2,2,0,113000,1327.5,91
"19708","62630","2016",5,5,0,137700,1308.6,104.8
"19709","62631","2016",3,3,0,94966.67,1163,82
"19710","62633","2016",2,2,0,158500,1365.5,123.5
"19711","62634","2016",7,7,0,126998,1453.286,84
"19712","62635","2016",2,2,0,94650,1137.5,82.5
"19713","62636","2016",2,2,0,276500,1728,160
"19714","62637","2016",71,67,4,138580.2,1588.521,93.59155
"19715","62638","2016",10,10,0,116550,1288.4,93.3
"19716","62639","2016",3,3,0,208333.3,1501.667,138.3333
"19717","62640","2016",2,2,0,75000,847,86
"19718","62641","2016",2,2,0,128250,985,137.5
"19719","62642","2016",5,5,0,111400,1285.2,84.2
"19720","62643","2016",134,128,6,127144.2,1372.299,93.47015
"19721","62644","2016",5,5,0,138590,1123.2,126.8
"19722","62645","2016",49,49,0,165069.4,1630.939,102.6122
"19723","62646","2016",7,7,0,105292.9,1158.714,90
"19724","62647","2016",12,12,0,117208.3,1160.5,101
"19725","62648","2016",4,4,0,148625,1003.75,172.25
"19726","62649","2016",4,4,0,84500,1028,78.5
"19727","62650","2016",6,6,0,157966.7,1390.333,119.3333
"19728","62651","2016",3,3,0,52666.67,694,76
"19729","62652","2016",17,17,0,113829.4,1223.647,94.41176
"19730","62653","2016",4,4,0,186168.5,1993,96.75
"19731","62654","2016",10,10,0,229850,1879.8,123.4
"19732","62655","2016",2,2,0,90500,874.5,96.5
"19733","62656","2016",10,10,0,144160,1324.5,106.4
"19734","62657","2016",5,5,0,154122.2,1895.6,91.8
"19735","62659","2016",1,1,0,137000,979,140
"19736","62660","2016",5,5,0,131200,1585.4,86.6
"19737","62661","2016",7,7,0,133714.3,1479,90.57143
"19738","62662","2016",9,9,0,149287.2,1392,103
"19739","62663","2016",4,4,0,152500,1370.5,115.5
"19740","62664","2016",3,3,0,135833.3,1248.333,106.3333
"19741","62665","2016",1,1,0,63000,900,70
"19742","62666","2016",34,34,0,111957.6,1263.471,88.29412
"19743","62667","2016",89,72,17,109919.4,1276.742,90.8427
"19744","62668","2016",1,1,0,105800,867,122
"19745","62669","2016",1,1,0,115000,1139,101
"19746","62670","2016",4,4,0,137000,1870,78.75
"19747","62671","2016",3,3,0,81350,1243.333,66.33333
"19748","62672","2016",6,6,0,99883.33,1249.333,82.33333
"19749","62673","2016",9,9,0,121277.8,1120.222,111.4444
"19750","62674","2016",5,5,0,163262,1493,115.6
"19751","62675","2016",3,3,0,107500,1156,91.33333
"19752","62676","2016",3,3,0,125633.3,1502,83.66667
"19753","62678","2016",4,4,0,160250,1337.5,132.25
"19754","62679","2016",4,4,0,154125,1058.75,150.75
"19755","62680","2016",12,12,0,161162.5,1443.083,112
"19756","62681","2016",2,2,0,131500,1489,89
"19757","62684","2016",22,22,0,137009.1,1436.955,97.09091
"19758","62685","2016",1,1,0,1e+05,1111,90
"19759","62686","2016",1,1,0,162150,1622,100
"19760","62688","2016",56,56,0,142378.7,1738.161,83.07143
"19761","62689","2016",5,5,0,138220,1002.6,138.6
"19762","62690","2016",6,6,0,120364.2,1025.667,119.1667
"19763","62691","2016",6,6,0,143500,1635,91.16667
"19764","62692","2016",4,4,0,169750,1614.5,106.75
"19765","62693","2016",8,8,0,168031.2,1190.875,139.875
"19766","62694","2016",4,4,0,207947.5,2220.25,80.25
"19767","62695","2016",5,5,0,103200,1030,100.4
"19768","62696","2016",1,1,0,118000,1113,106
"19769","62697","2016",3,3,0,161000,1503,111
"19770","62698","2016",5,5,0,109000,1253.4,83.8
"19771","62699","2016",3,3,0,194866.7,2033,94.33333
"19772","62700","2016",4,4,0,129500,1280.25,106
"19773","62701","2016",1,1,0,105000,897,117
"19774","62702","2016",2,2,0,90500,1222.5,74
"19775","62703","2016",3,3,0,167100,1585,106.3333
"19776","62704","2016",4,4,0,111875,1100.25,97.75
"19777","62705","2016",24,24,0,145915.6,1597.875,94.70833
"19778","62706","2016",24,24,0,209315.1,1746.958,121.9167
"19779","62709","2016",7,7,0,130142.9,1152.429,106.1429
"19780","62710","2016",3,3,0,63666.67,951,61.66667
"19781","62711","2016",31,31,0,116895.2,1430.452,85.41935
"19782","62712","2016",18,18,0,160616.7,1479.778,106.0556
"19783","62713","2016",11,11,0,150407.3,1545.182,92.45455
"19784","62714","2016",4,4,0,207500,1790.25,113.25
"19785","62715","2016",1,1,0,55000,743,74
"19786","62716","2016",9,9,0,138361.1,1381.667,99.11111
"19787","62717","2016",4,4,0,1e+05,1017.5,102.75
"19788","62718","2016",15,15,0,128143.3,1421.667,91
"19789","62719","2016",2,2,0,160000,1038,159.5
"19790","62720","2016",1,1,0,220000,2200,100
"19791","62721","2016",17,17,0,149795.6,1409.765,107.1176
"19792","62722","2016",3,3,0,68000,709,115.6667
"19793","62724","2016",50,50,0,130314.5,1479.72,88.98
"19794","62725","2016",2,2,0,95000,1120,86
"19795","62727","2016",16,15,1,136400,1341.5,109.3125
"19796","62728","2016",2,2,0,77000,828,94.5
"19797","62729","2016",2,2,0,132500,1661,79
"19798","62730","2016",18,18,0,150859.4,1500.278,102.2222
"19799","62731","2016",4,4,0,105750,941.75,117.75
"19800","62732","2016",2,2,0,176250,1917,92.5
"19801","62733","2016",3,3,0,1e+05,1075.667,91.66667
"19802","62734","2016",5,5,0,205500,2105,97.4
"19803","62735","2016",20,20,0,139953.5,1351.3,106.75
"19804","62736","2016",58,58,0,187556,1825.224,103.4828
"19805","62737","2016",37,37,0,122236.1,1343.243,91.37838
"19806","62738","2016",3,3,0,127333.3,1167.667,110.6667
"19807","62739","2016",1,1,0,5e+05,8333,60
"19808","62740","2016",2,2,0,131000,1202.5,114.5
"19809","62741","2016",1,1,0,187000,1336,140
"19810","62742","2016",3,3,0,224566.7,2633.667,86
"19811","62743","2016",2,2,0,75000,876.5,114.5
"19812","62744","2016",51,39,12,184553.9,1731.059,107.098
"19813","62745","2016",4,4,0,184125,1545,127.75
"19814","62746","2016",40,39,1,156500.9,1592.65,99.7
"19815","62747","2016",3,3,0,166200,1383.333,121.6667
"19816","62748","2016",23,23,0,162141.1,1682.652,99.17391
"19817","62749","2016",8,8,0,113600,1032.625,108.375
"19818","62750","2016",10,10,0,101960,1018.1,101.8
"19819","62751","2016",8,8,0,177767.1,1929.75,94.375
"19820","62752","2016",8,8,0,311875,1833.875,169.625
"19821","62753","2016",90,73,17,140661.7,1605.778,89.96667
"19822","62754","2016",6,6,0,135333.3,1406.667,94.16667
"19823","62755","2016",39,37,2,175856.2,1761.308,96.5641
"19824","62756","2016",12,12,0,121166.7,1534.667,81.25
"19825","62757","2016",53,52,1,145703.2,1555.17,96.18868
"19826","62758","2016",146,119,27,143019.4,1610.432,95.30822
"19827","62759","2016",3,3,0,185000,1720.667,108
"19828","62760","2016",4,4,0,121750,1243,96.5
"19829","62761","2016",1,1,0,128100,1472,87
"19830","62763","2016",7,7,0,117714.3,1251.429,95.14286
"19831","62764","2016",33,31,2,159049.2,1465.515,107.7879
"19832","62765","2016",148,90,58,108189.5,1429.48,81.2027
"19833","62766","2016",13,13,0,147115.4,1367.385,106.7692
"19834","62767","2016",29,28,1,97362.07,1205.379,89.82759
"19835","62768","2016",1,1,0,123000,1139,108
"19836","62769","2016",8,8,0,191187.5,1900.375,111.75
"19837","62770","2016",32,32,0,159476.4,1582.906,100
"19838","62771","2016",35,35,0,107116.3,1246.8,87.05714
"19839","62772","2016",5,5,0,112030,1181.8,101.2
"19840","62773","2016",57,57,0,139461.9,1865.544,82.22807
"19841","62774","2016",69,60,9,171879.4,1866.348,91.28986
"19842","62775","2016",3,3,0,131433.3,1206,109.6667
"19843","62776","2016",2,2,0,177800,1529,116.5
"19844","62777","2016",1,1,0,76000,1086,70
"19845","62778","2016",1,1,0,188000,1554,121
"19846","62780","2016",1,1,0,38400,1200,32
"19847","62781","2016",4,4,0,109750,1367.25,83.5
"19848","62782","2016",3,3,0,159166.7,1582.667,105
"19849","62783","2016",2,2,0,122500,914.5,133.5
"19850","62784","2016",5,5,0,109100,918,113.8
"19851","62785","2016",6,6,0,124683.3,1469.5,93.33333
"19852","62787","2016",1,1,0,135000,951,142
"19853","62788","2016",4,4,0,132625,1799,69.75
"19854","62789","2016",5,5,0,126600,1453,95
"19855","62790","2016",1,1,0,265000,2008,132
"19856","62791","2016",1,1,0,150000,1304,115
"19857","62792","2016",10,10,0,149722.5,1577.9,93.5
"19858","62793","2016",5,5,0,170900,1428.8,116.8
"19859","62794","2016",6,6,0,116083.3,1175.833,98.33333
"19860","62795","2016",3,3,0,70000,877,83
"19861","62796","2016",6,6,0,172466.7,1908,97.16667
"19862","62797","2016",1,1,0,170738,1186,144
"19863","62798","2016",2,2,0,93250,1032.5,100.5
"19864","62799","2016",8,8,0,167493.8,1588.375,111.375
"19865","62800","2016",1,1,0,153000,1594,96
"19866","62801","2016",35,34,1,172448.6,1716.914,106.4
"19867","62802","2016",1,1,0,80000,615,130
"19868","62803","2016",3,3,0,134666.7,2173,59
"19869","62804","2016",4,4,0,151887.5,984.25,151.5
"19870","62805","2016",1,1,0,99000,1165,85
"19871","62808","2016",4,4,0,94480,876.5,107.75
"19872","62809","2016",2,2,0,115250,947,120.5
"19873","62810","2016",11,11,0,173545.5,1718.273,101.1818
"19874","62811","2016",14,14,0,142964.3,1276.071,113.7143
"19875","62812","2016",5,5,0,134240,1442.4,95
"19876","62814","2016",3,3,0,53333.33,663,85.66667
"19877","62815","2016",3,3,0,156000,1467.667,122.6667
"19878","62817","2016",12,12,0,174960.2,1801.083,95.58333
"19879","62819","2016",15,15,0,216143.3,2337.067,112.8667
"19880","62820","2016",2,2,0,117500,867,131
"19881","62821","2016",2,2,0,168250,1777.5,106
"19882","62824","2016",2,2,0,136500,1050.5,129
"19883","62825","2016",11,11,0,149527.3,1400.909,109.8182
"19884","62826","2016",489,149,340,303279.1,4402.998,69.60532
"19885","62827","2016",10,10,0,142550,1251.6,120.1
"19886","62828","2016",2,2,0,132500,1241.5,101.5
"19887","62829","2016",6,6,0,113166.7,1180,89.66667
"19888","62830","2016",2,2,0,127680,1024,119.5
"19889","62831","2016",2,2,0,173000,1671.5,103.5
"19890","62832","2016",2,2,0,190500,1999,96
"19891","62833","2016",1,1,0,50000,1042,48
"19892","62834","2016",6,6,0,80200,927.6667,83.83333
"19893","62835","2016",4,4,0,99142.5,1145.75,90
"19894","62836","2016",6,6,0,239683.3,1750,136.6667
"19895","62837","2016",3,3,0,148833.3,1363,110.3333
"19896","62838","2016",1,1,0,56000,596,94
"19897","62839","2016",9,9,0,84665.33,1011.444,90.88889
"19898","62840","2016",3,3,0,65833.33,611.6667,107.3333
"19899","62841","2016",13,13,0,132310.8,1462.846,92.76923
"19900","62842","2016",57,53,4,142136.6,1527.474,96.38596
"19901","62843","2016",2,2,0,80800,1013.5,80
"19902","62844","2016",4,4,0,137250,1423.5,101
"19903","62845","2016",2,2,0,170000,1659.5,101
"19904","62846","2016",45,45,0,129479.8,1352.644,104.1111
"19905","62847","2016",14,14,0,124918.6,1448.929,86.64286
"19906","62848","2016",34,34,0,123367.6,1278.971,95.91176
"19907","62849","2016",20,19,1,181577.5,1943.45,97.35
"19908","62850","2016",7,7,0,166357.1,1082.857,158
"19909","62851","2016",4,4,0,133250,1464.75,87
"19910","62852","2016",19,19,0,169284.4,1793.263,99.42105
"19911","62853","2016",2,2,0,130852,891,160.5
"19912","62854","2016",8,8,0,173012.5,1335.875,128.75
"19913","62855","2016",2,2,0,165000,1077.5,170.5
"19914","62856","2016",2,2,0,158325,1606,102.5
"19915","62857","2016",1,1,0,170000,1545,110
"19916","62858","2016",2,2,0,167690,1538.5,108.5
"19917","62859","2016",2,2,0,160000,1076.5,143.5
"19918","62860","2016",1,1,0,80000,714,112
"19919","62861","2016",45,45,0,172427.2,1653.378,105.1111
"19920","62862","2016",1,1,0,115000,1438,80
"19921","62863","2016",25,25,0,168116,1691.6,105.32
"19922","62864","2016",10,10,0,163943.5,1368.1,126
"19923","62865","2016",44,44,0,132249.9,1391.227,97.29545
"19924","62866","2016",7,7,0,205428.6,1815.857,110.8571
"19925","62867","2016",4,4,0,234207.5,2128.5,117.75
"19926","62868","2016",7,7,0,147464.3,1393.143,111
"19927","62869","2016",9,9,0,203861.1,1672.333,119.7778
"19928","62870","2016",8,8,0,121782.5,1481.125,81.25
"19929","62871","2016",4,4,0,110750,1141.75,98
"19930","62872","2016",2,2,0,161500,1036.5,150.5
"19931","62873","2016",6,6,0,182500,1701.5,106.5
"19932","62874","2016",7,7,0,181035.7,1417.429,120.4286
"19933","62875","2016",4,4,0,160125,1375.75,142.5
"19934","62876","2016",1,1,0,172400,1249,138
"19935","62877","2016",1,1,0,47099,841,56
"19936","62878","2016",1,1,0,229400,1778,129
"19937","62881","2016",2,2,0,107500,821.5,121.5
"19938","62882","2016",7,7,0,114014.3,1433,82.71429
"19939","62883","2016",7,7,0,104500,1071.857,104.4286
"19940","62885","2016",1,1,0,125000,1453,86
"19941","62886","2016",4,4,0,124500,1298.5,107
"19942","62887","2016",2,2,0,221075,2151,103
"19943","62888","2016",4,4,0,145625,1417.75,107.75
"19944","62889","2016",2,2,0,145833.5,1215,120
"19945","62890","2016",3,3,0,84000,763.6667,105.6667
"19946","62891","2016",2,2,0,148750,1597,90
"19947","62892","2016",7,7,0,183114.3,1276.571,140.2857
"19948","62893","2016",138,73,65,204337,2905.094,72.95652
"19949","62894","2016",35,35,0,153814.5,1703.571,89.65714
"19950","62895","2016",69,62,7,115122.8,1447.203,84.85507
"19951","62896","2016",6,6,0,197553.3,2289.333,93.83333
"19952","62897","2016",4,4,0,130750,1289.75,102.75
"19953","62898","2016",1,1,0,2e+05,1942,103
"19954","62899","2016",38,22,16,259780.8,3599.947,77.60526
"19955","62900","2016",9,9,0,156511.1,1446.222,113.7778
"19956","62901","2016",12,12,0,158662.5,1542,105.3333
"19957","62902","2016",31,30,1,123638.1,1371.355,91.70968
"19958","62903","2016",4,4,0,158375,1726,96
"19959","62904","2016",5,5,0,101600,1039,97
"19960","62905","2016",6,6,0,181600,1557.5,121.3333
"19961","62906","2016",15,15,0,147266.7,1235.467,121.4667
"19962","62907","2016",46,45,1,147226.1,1589.435,92.97826
"19963","62908","2016",13,13,0,215888.5,2010.615,112.8462
"19964","62909","2016",5,5,0,98400,836.2,112.6
"19965","63001","2016",18,18,0,120862.8,1256.556,101.3889
"19966","63002","2016",2,2,0,69625,1006.5,70
"19967","63003","2016",56,47,9,91950.89,1098.982,90.625
"19968","63004","2016",20,18,2,69382.5,907.95,77.95
"19969","63005","2016",5,5,0,101774,897.2,111.8
"19970","63006","2016",2,2,0,56250,1082.5,50.5
"19971","63007","2016",2,2,0,113675,1284,89.5
"19972","63008","2016",6,6,0,55583.33,651.1667,82
"19973","63009","2016",9,9,0,94811.67,1019.889,90
"19974","63010","2016",14,14,0,109132.6,1116.286,100.6429
"19975","63011","2016",1,1,0,49900,674,74
"19976","63012","2016",16,16,0,131018.1,1326,95.8125
"19977","63013","2016",7,7,0,166914.3,1666,101.7143
"19978","63014","2016",120,82,38,167918.9,2125.542,79.98333
"19979","63015","2016",4,3,1,58250,748.5,76.75
"19980","63016","2016",9,9,0,97396.67,817.1111,110.4444
"19981","63017","2016",1,1,0,112500,1541,73
"19982","63019","2016",27,24,3,146413.4,1802.37,82
"19983","63020","2016",3,3,0,74146.67,1287,58
"19984","63021","2016",4,4,0,181862.5,1835.25,91.75
"19985","63022","2016",39,39,0,88595.9,1084.462,82.12821
"19986","63023","2016",5,5,0,73265,774.6,99.6
"19987","63024","2016",3,3,0,121536.7,1719.333,73
"19988","63026","2016",20,20,0,202444,2447.15,97.6
"19989","63027","2016",2,2,0,69520,1191.5,81
"19990","63028","2016",6,6,0,79983.33,1056.833,78.66667
"19991","63029","2016",5,5,0,118664.2,1326,87.8
"19992","63030","2016",8,8,0,103162.5,1032.375,111.25
"19993","63031","2016",4,4,0,155500,1493,101
"19994","63032","2016",146,59,87,146662.7,1907.267,76.14384
"19995","63033","2016",2,2,0,140150,1318,105.5
"19996","63034","2016",19,19,0,138572.9,1374.421,102.2632
"19997","63035","2016",14,14,0,155937.9,1861,84.42857
"19998","63036","2016",3,3,0,109476.7,1264.333,83
"19999","63037","2016",3,3,0,110130,797.3333,133
"20000","63038","2016",54,20,34,123083.4,2420.815,54.37037
"20001","63039","2016",2,2,0,74550,1097,68.5
"20002","63040","2016",55,51,4,129231.5,1485.509,86.58182
"20003","63041","2016",6,6,0,91923.33,752.3333,125.3333
"20004","63042","2016",21,20,1,178205,2080,85.61905
"20005","63043","2016",5,5,0,77200,910.8,93.6
"20006","63044","2016",3,3,0,97083.33,943.6667,112
"20007","63045","2016",5,5,0,53206,774.2,66.4
"20008","63046","2016",5,5,0,91470,1243.2,85.6
"20009","63047","2016",74,21,53,70683.97,1326.351,57.02703
"20010","63048","2016",11,11,0,77603.64,865.3636,91
"20011","63049","2016",6,6,0,150925,1632.333,100.1667
"20012","63050","2016",35,35,0,88387.71,1077.171,84.54286
"20013","63051","2016",3,3,0,149843.3,1206,123.3333
"20014","63052","2016",6,6,0,157383.3,1559,106.8333
"20015","63053","2016",1,1,0,75000,843,89
"20016","63054","2016",9,9,0,167270,1471.556,112.5556
"20017","63055","2016",5,5,0,131060,1291.6,100.8
"20018","63056","2016",6,6,0,103300,1119.833,93.66667
"20019","63057","2016",6,6,0,46500,837,71
"20020","63058","2016",8,8,0,176743.8,1593.75,109.5
"20021","63059","2016",5,5,0,150186,1439.8,107.4
"20022","63060","2016",2,2,0,26859.5,368,71.5
"20023","63061","2016",2,2,0,145800,1263.5,89.5
"20024","63062","2016",2,2,0,88088,1308,77
"20025","63063","2016",63,57,6,184651.4,2036.206,96.07937
"20026","63064","2016",2,2,0,80807.5,1039,93
"20027","63066","2016",13,13,0,109719.2,900.9231,107.6154
"20028","63067","2016",2,2,0,89999.5,771.5,104.5
"20029","63069","2016",46,41,5,176594.3,1802.63,99
"20030","63070","2016",65,55,10,235508.6,2220.831,104.6462
"20031","63071","2016",9,9,0,176227.8,1597.111,117.4444
"20032","63072","2016",12,12,0,135970.8,1149.417,118.5
"20033","63073","2016",4,4,0,144150,1490,94.25
"20034","63075","2016",353,47,306,152755.2,2024.416,73.29745
"20035","63076","2016",1,1,0,71500,737,97
"20036","63077","2016",8,8,0,152005,1994,83.125
"20037","63080","2016",28,25,3,139803.6,2096.857,87.53571
"20038","63081","2016",2,2,0,50500,656,70.5
"20039","63082","2016",5,5,0,98250,1236.6,82.4
"20040","63083","2016",4,4,0,228325,1579.5,146
"20041","63084","2016",13,13,0,229911.9,1956.308,121.6923
"20042","63085","2016",8,7,1,94871.25,1296.625,75.25
"20043","63086","2016",6,6,0,75433.33,746.6667,87
"20044","63088","2016",1,1,0,99400,1242,80
"20045","63089","2016",10,10,0,200591,2018.2,98.7
"20046","63090","2016",4,4,0,119800,1372,85.75
"20047","63091","2016",7,6,1,120765.4,1286.571,94.57143
"20048","63092","2016",16,16,0,121359.7,1339.875,91.3125
"20049","63093","2016",13,13,0,135976.9,1460.308,99.30769
"20050","63094","2016",7,6,1,109658.6,1009.143,109.1429
"20051","63095","2016",3,3,0,107000,1002.667,106
"20052","63096","2016",2,2,0,178128.5,2191,79.5
"20053","63098","2016",9,7,2,103428.9,1840.111,61
"20054","63099","2016",28,25,3,193084.7,1974.071,100.8929
"20055","63100","2016",3,3,0,55166.67,723,76.66667
"20056","63101","2016",1,1,0,60000,632,95
"20057","63102","2016",8,8,0,58956.25,814.75,68.75
"20058","63103","2016",93,51,42,128181.1,1628.71,77.83871
"20059","63104","2016",2,2,0,52245,798.5,62
"20060","63105","2016",2,2,0,62500,1060,65
"20061","63106","2016",19,19,0,150432.6,1358,106.9474
"20062","63107","2016",4,4,0,208010,1927,136
"20063","63108","2016",3,3,0,206046.7,1494,148.3333
"20064","63109","2016",5,5,0,54700,691.4,75
"20065","63110","2016",3,3,0,77333.33,926.6667,80.33333
"20066","63112","2016",4,4,0,164723.8,1616.75,102.75
"20067","63113","2016",1965,274,1691,116228,1883.982,63.23817
"20068","63114","2016",3,3,0,43500,536,76.33333
"20069","63115","2016",2,2,0,67500,502.5,130.5
"20070","63116","2016",25,24,1,128427.1,1640.12,80.64
"20071","63118","2016",3,3,0,64883.33,643.6667,105.3333
"20072","63119","2016",2,2,0,47500,528.5,85
"20073","63120","2016",18,18,0,174199.2,1623.222,106.8333
"20074","63121","2016",19,19,0,142128.5,1494.263,95.94737
"20075","63123","2016",2,2,0,154700,1128,135
"20076","63124","2016",209,140,69,173703.9,1974.163,88.2823
"20077","63125","2016",42,41,1,108014.8,1129.357,97.16667
"20078","63126","2016",4,4,0,298125,2353.5,128.25
"20079","63128","2016",12,12,0,127691.7,1284.5,104.3333
"20080","63130","2016",6,6,0,77665,1161.833,75.33333
"20081","63131","2016",5,5,0,155858.8,1642,95.6
"20082","63132","2016",4,4,0,149980,1129,138.5
"20083","63134","2016",1,1,0,135090,1351,100
"20084","63135","2016",6,6,0,160550,1518.167,102
"20085","63136","2016",4,4,0,78837.5,922.5,82.75
"20086","63137","2016",2,2,0,56625,582.5,85
"20087","63138","2016",8,8,0,129865,1306.375,94.25
"20088","63139","2016",2,2,0,228137.5,1278,177.5
"20089","63140","2016",3,3,0,66633.33,737.6667,88.33333
"20090","63141","2016",18,18,0,276184.2,2624.444,106
"20091","63142","2016",4,4,0,84345,1005.25,82.25
"20092","63143","2016",9,9,0,114902.2,1198.667,91.33333
"20093","63144","2016",5,4,1,60800,717.8,83.8
"20094","63146","2016",13,13,0,144850,1540.308,102.6154
"20095","63147","2016",2,2,0,97500,738,125
"20096","63148","2016",17,17,0,206532.9,2014.588,103.0588
"20097","63149","2016",9,9,0,95777.78,1412.444,67.88889
"20098","63150","2016",18,18,0,222941.9,1728.056,124.8889
"20099","63151","2016",12,12,0,108290,1250.25,91.75
"20100","63152","2016",5,5,0,76300,883,75.6
"20101","63153","2016",2,2,0,66300,1274,51.5
"20102","63154","2016",4,4,0,166125.8,1804.75,89
"20103","63155","2016",4,4,0,119387.5,1265.5,92.75
"20104","63157","2016",8,8,0,156435.6,1346,125.25
"20105","63158","2016",2,2,0,103650,964.5,106.5
"20106","63159","2016",1,1,0,96500,1122,86
"20107","63160","2016",4,4,0,195037.5,1673,120.5
"20108","63161","2016",3,3,0,53833.33,711.3333,72.33333
"20109","63162","2016",9,9,0,80705.56,799,110.1111
"20110","63163","2016",9,8,1,95008.89,1210,85.33333
"20111","63164","2016",103,65,38,147142,1765.524,84.33981
"20112","63165","2016",4,4,0,138907.5,781.5,163.5
"20113","63166","2016",4,4,0,206912.5,1490,133.75
"20114","63167","2016",3,3,0,152950,1824.667,85.66667
"20115","63168","2016",8,8,0,159687.5,1529.375,96.125
"20116","63170","2016",3,3,0,192050,1276.333,141.3333
"20117","63171","2016",4,4,0,85537.5,667.5,123
"20118","63173","2016",4,4,0,94242.5,1010.25,99.5
"20119","63174","2016",2,2,0,60700,664.5,96
"20120","63175","2016",1,1,0,93800,947,99
"20121","63177","2016",5,5,0,163460,1591.8,105
"20122","63178","2016",183,113,70,135163.9,1637.814,82.42623
"20123","63179","2016",15,15,0,85648.67,975.6,84.33333
"20124","63180","2016",13,13,0,132285.8,1342.692,95
"20125","63181","2016",8,8,0,158837.5,1445.625,95.625
"20126","63182","2016",4,4,0,58025,777.75,68.25
"20127","63183","2016",2,2,0,41000,675.5,61
"20128","63184","2016",6,6,0,61833.33,827.5,77
"20129","63185","2016",7,7,0,139150,1084.143,118.2857
"20130","63186","2016",1,1,0,197450,1452,136
"20131","63187","2016",5,5,0,67780,854.2,93.6
"20132","63188","2016",6,6,0,176808.3,1944.833,118.6667
"20133","63189","2016",3,3,0,105833.3,977.6667,96.66667
"20134","63190","2016",3,3,0,79000,1368.667,56.66667
"20135","63191","2016",2,2,0,31500,784.5,42.5
"20136","63192","2016",11,10,1,107660,1337.818,89.45455
"20137","63193","2016",70,60,10,165639.5,1859.757,92.44286
"20138","63194","2016",1,1,0,31000,620,50
"20139","63195","2016",50,50,0,136581.9,1510.56,91.38
"20140","63196","2016",6,6,0,123331.7,1209.5,103.8333
"20141","63197","2016",3,3,0,65064.67,996.3333,68.66667
"20142","63198","2016",12,12,0,175459.2,1714.083,109.5833
"20143","63199","2016",5,5,0,142262,1299.4,112.4
"20144","63200","2016",5,5,0,107300,1327.4,80.4
"20145","63201","2016",12,12,0,100147.6,1055.583,97
"20146","63202","2016",3,3,0,67666.67,733.3333,94.66667
"20147","63203","2016",6,6,0,182655,1777.333,98.33333
"20148","63204","2016",11,11,0,173778.2,1713.364,107.8182
"20149","63205","2016",7,7,0,102485.7,1105.857,95.14286
"20150","63206","2016",13,13,0,133344.2,1343.692,103
"20151","63207","2016",7,7,0,74757.14,873.8571,90
"20152","63208","2016",7,7,0,141472.9,1459.286,103
"20153","63209","2016",1,1,0,135000,1688,80
"20154","63210","2016",30,30,0,131800.5,1287.067,108.2
"20155","63211","2016",9,7,2,76433.33,1302,78
"20156","63212","2016",22,18,4,225643.9,1809.909,121.2727
"20157","63213","2016",10,10,0,157419.9,1528.2,105.6
"20158","63214","2016",39,36,3,173193.2,1736.462,99.30769
"20159","63215","2016",7,7,0,183559.9,1616.429,106.2857
"20160","63216","2016",3,3,0,131373.3,1244,116.6667
"20161","63218","2016",2,2,0,46022.5,637,73.5
"20162","63219","2016",4,4,0,206225,2363.75,93.5
"20163","63221","2016",1,1,0,117500,1679,70
"20164","63222","2016",6,6,0,76916.67,1292.5,62.16667
"20165","63223","2016",5,5,0,77640,897.8,81.4
"20166","63224","2016",16,16,0,158762.6,1579.688,103
"20167","63225","2016",11,10,1,64454.55,678.2727,94.72727
"20168","63226","2016",40,40,0,180526.2,1736.275,100.025
"20169","63227","2016",3,3,0,135866.7,1857.333,73.33333
"20170","63229","2016",10,10,0,161226.8,1858.6,95.7
"20171","63230","2016",6,6,0,76735,1004.5,95.16667
"20172","63231","2016",9,8,1,83222.22,891.2222,97.77778
"20173","63232","2016",7,7,0,106750,1086.143,96.14286
"20174","63233","2016",4,4,0,90612.5,875.75,99.5
"20175","63234","2016",13,13,0,127695.6,1653.385,82.30769
"20176","63235","2016",9,9,0,114238.9,1209.444,88.33333
"20177","63236","2016",100,12,88,88779.15,2190.89,40.61
"20178","63237","2016",5,5,0,62400,669,92.4
"20179","63238","2016",1,1,0,129700,1425,91
"20180","63239","2016",5,5,0,164630,2097,81.4
"20181","63240","2016",2,2,0,171550,1377.5,129.5
"20182","63241","2016",8,8,0,259758.8,1905.5,130.75
"20183","63242","2016",5,5,0,144680,1636.6,101
"20184","63243","2016",1,1,0,81000,1052,77
"20185","63244","2016",13,13,0,192850.8,1884.385,103.3077
"20186","63245","2016",36,35,1,180975.3,1960.472,94.5
"20187","63246","2016",14,10,4,112421.1,1346.143,80
"20188","63247","2016",5,4,1,91573,1315.4,78.4
"20189","63248","2016",9,8,1,178681.1,1683.444,109.5556
"20190","63249","2016",6,6,0,140875,1650.833,83.66667
"20191","63250","2016",9,9,0,123377.8,1546.556,76.88889
"20192","63251","2016",2,2,0,79550,868.5,97
"20193","63252","2016",3,3,0,235666.7,1398,181.3333
"20194","63253","2016",2,2,0,151400,1402,107
"20195","63254","2016",20,19,1,195265,1910.3,102.5
"20196","63255","2016",6,6,0,111590,1165.167,93.5
"20197","63256","2016",2,2,0,54500,553,103.5
"20198","63257","2016",4,4,0,90718.75,1401.75,64
"20199","63258","2016",8,8,0,77879.75,757,97.875
"20200","63259","2016",5,5,0,94159.4,1056.8,77
"20201","63260","2016",4,4,0,79807.5,760.25,100.5
"20202","63261","2016",5,5,0,144900,1313.8,107.8
"20203","63262","2016",29,28,1,186852.9,1812.379,103.1034
"20204","63263","2016",14,13,1,226795.4,2246.286,104.4286
"20205","63264","2016",1,1,0,127120,1816,70
"20206","63265","2016",23,23,0,192373.9,1627.391,124.5217
"20207","63267","2016",7,7,0,62928.57,673.5714,91.42857
"20208","63268","2016",2,2,0,178500,1244,142
"20209","63269","2016",7,7,0,73585.71,1122.429,68.85714
"20210","63270","2016",1,1,0,99700,804,124
"20211","63271","2016",11,11,0,105462.7,1234.091,88.63636
"20212","63272","2016",33,32,1,244440,2355.061,107.0606
"20213","63273","2016",16,16,0,214521.9,2036.75,104.5
"20214","63274","2016",1,1,0,83100,923,90
"20215","63275","2016",5,5,0,177690,1551.4,116.2
"20216","63276","2016",14,13,1,127978.7,1284.143,98.35714
"20217","63277","2016",1,1,0,70500,860,82
"20218","63278","2016",5,5,0,169010,1632.6,103.4
"20219","63279","2016",8,8,0,100593.8,1305.75,77
"20220","63280","2016",3,3,0,115666.7,1032.667,111.6667
"20221","63281","2016",12,12,0,81782.5,1026.5,83.75
"20222","63282","2016",16,16,0,124958.4,1257.5,98.6875
"20223","63283","2016",6,6,0,92816.67,609.1667,152.3333
"20224","63284","2016",116,111,5,188618.8,1843.681,104.5259
"20225","63285","2016",2,2,0,214725,2218,96
"20226","63286","2016",3,3,0,100543.3,1314.333,84.66667
"20227","63287","2016",1,1,0,70000,714,98
"20228","63288","2016",3,3,0,142683.3,1346.333,103
"20229","63289","2016",1,1,0,150000,1364,110
"20230","63290","2016",10,10,0,108399,1360.6,79.1
"20231","63291","2016",28,23,5,116292.9,1212.964,93.57143
"20232","63293","2016",3,3,0,39333.33,687.6667,65.33333
"20233","63294","2016",1,1,0,111000,793,140
"20234","63295","2016",18,18,0,111883.3,1190.889,92
"20235","63296","2016",8,8,0,188491.2,1425.625,132.375
"20236","63297","2016",2,2,0,166400,2050,81.5
"20237","63298","2016",1,1,0,63000,2172,29
"20238","63300","2016",224,144,80,153134.8,1714.036,91.01339
"20239","63301","2016",5,5,0,114910,1202.8,95.8
"20240","63302","2016",25,25,0,191119.6,1824.4,103.44
"20241","63304","2016",1,1,0,50000,556,90
"20242","63305","2016",4,4,0,71150,1007.75,71.5
"20243","63306","2016",6,6,0,204665,1955,95
"20244","63307","2016",77,55,22,152667.5,1803.961,84.49351
"20245","63308","2016",93,31,62,150443.6,1926.989,69.63441
"20246","63309","2016",6,6,0,86666.67,1266.667,72
"20247","63310","2016",2,2,0,45000,638.5,75
"20248","63311","2016",2,2,0,176350,1636.5,106.5
"20249","63312","2016",3,3,0,79173.33,815,102.3333
"20250","63314","2016",3,3,0,85178.33,1037.667,94.33333
"20251","63315","2016",10,10,0,173157,1934.3,106.6
"20252","63317","2016",9,9,0,158227.8,1402.222,117.7778
"20253","63318","2016",7,7,0,117271.4,1007,126.4286
"20254","63319","2016",4,4,0,72332.5,796,92.25
"20255","63320","2016",1,1,0,71000,507,140
"20256","63321","2016",7,7,0,152000,1934.429,84.42857
"20257","63322","2016",21,21,0,180408,1675.381,108.619
"20258","63323","2016",5,5,0,73394,904.2,85.8
"20259","63324","2016",5,5,0,128032,946.4,130.2
"20260","63326","2016",8,8,0,157580,1327.375,114.125
"20261","63327","2016",27,26,1,165210,1745.296,94.33333
"20262","63328","2016",2,2,0,67000,602.5,123
"20263","63329","2016",3,3,0,130833.3,1574,75
"20264","63330","2016",1,1,0,96000,1091,88
"20265","63331","2016",3,3,0,54666.67,619,90.66667
"20266","63332","2016",6,6,0,89750,1145.5,88.16667
"20267","63333","2016",5,5,0,124920,982.8,120
"20268","63334","2016",6,6,0,114133.3,1475.167,85.83333
"20269","63335","2016",1,1,0,108410,1902,57
"20270","63336","2016",8,8,0,67625,1061,76.125
"20271","63337","2016",1,1,0,44960,608,74
"20272","63338","2016",26,24,2,69133.58,759.6923,92.46154
"20273","63339","2016",2,2,0,57000,573.5,104
"20274","63340","2016",2,2,0,130500,838.5,189
"20275","63341","2016",6,6,0,55666.67,670,85.83333
"20276","63342","2016",4,4,0,120980,1272.25,92.75
"20277","63343","2016",6,6,0,57250,978,62.5
"20278","63345","2016",25,24,1,173351.9,1755.44,107.96
"20279","63346","2016",3,3,0,131166.7,1313.667,107
"20280","63347","2016",5,5,0,118660,1253.4,97.8
"20281","63348","2016",1,1,0,88000,880,100
"20282","63349","2016",14,14,0,133421.4,1103.429,123.9286
"20283","63350","2016",10,10,0,177870,1649,112.3
"20284","63351","2016",1,1,0,78500,714,110
"20285","63352","2016",18,18,0,104948.6,934.6667,111.3333
"20286","63353","2016",9,9,0,85565.56,1071.111,89.55556
"20287","63354","2016",8,8,0,79821.25,948.75,83.875
"20288","63355","2016",4,4,0,54875,826.5,64
"20289","63356","2016",6,6,0,80441.67,757.1667,110
"20290","63357","2016",1,1,0,30000,526,57
"20291","63358","2016",7,7,0,104571.4,1005.571,113.7143
"20292","63360","2016",2,2,0,53000,645.5,84
"20293","63362","2016",6,6,0,178420,1536.667,118.5
"20294","63363","2016",1,1,0,113908,883,129
"20295","63364","2016",8,8,0,138143.8,1396.25,98.375
"20296","63365","2016",12,12,0,124799.2,1152.5,106.5833
"20297","63366","2016",3,3,0,174933.3,1447.667,110.3333
"20298","63367","2016",1,1,0,143000,1059,135
"20299","63368","2016",11,11,0,132794.5,1580.364,91
"20300","63369","2016",2,2,0,80750,576.5,152.5
"20301","63371","2016",2,2,0,58600,807.5,73
"20302","63372","2016",8,8,0,144525,1647.25,93.75
"20303","63373","2016",1,1,0,149795,1498,100
"20304","63374","2016",3,3,0,80666.67,1121,78.66667
"20305","63375","2016",2,2,0,70000,878,79.5
"20306","63376","2016",2,2,0,36000,604.5,64
"20307","63377","2016",6,6,0,66260.83,653.1667,103.5
"20308","63378","2016",16,16,0,136753.1,1457,94.5
"20309","63379","2016",4,4,0,146612.5,1651.25,89.25
"20310","63380","2016",16,10,6,75907,1275.5,60.8125
"20311","63381","2016",11,11,0,125794.5,1503,83.54545
"20312","63382","2016",6,6,0,109105,1137.667,94.16667
"20313","63383","2016",3,3,0,67333.33,1085.333,74.66667
"20314","63384","2016",5,5,0,77540,928.4,96.2
"20315","63385","2016",4,4,0,77600,1062.25,78
"20316","63386","2016",4,4,0,137200,1559,76.75
"20317","63387","2016",8,8,0,123825,1229.875,101
"20318","63388","2016",2,2,0,93500,981.5,91
"20319","63390","2016",6,6,0,86791.67,991.5,95.66667
"20320","63391","2016",3,2,1,94266,803,117.6667
"20321","63392","2016",13,13,0,131761.5,1212.077,106.1538
"20322","63393","2016",23,20,3,81354.96,988.6522,81.91304
"20323","63394","2016",3,3,0,94333.33,1008,91
"20324","63395","2016",8,8,0,120971.2,1494.5,79.375
"20325","63396","2016",16,16,0,180363.6,1599.562,98.3125
"20326","63397","2016",14,14,0,130984.6,1849,71.57143
"20327","63398","2016",2,2,0,70900,1012,67
"20328","63399","2016",1,1,0,50000,641,78
"20329","63400","2016",5,5,0,146644,1268,121.6
"20330","63401","2016",3,3,0,29148,613.6667,50
"20331","63402","2016",4,4,0,49187.5,642.5,77.75
"20332","63403","2016",1,1,0,180100,1766,102
"20333","63404","2016",6,6,0,228281.7,2056.5,114.1667
"20334","63405","2016",6,6,0,147895.8,1699.333,92.66667
"20335","63406","2016",3,3,0,174333.3,1095,161.6667
"20336","63407","2016",4,4,0,187500,2787,117
"20337","63408","2016",5,5,0,88800,1016.6,77.8
"20338","63409","2016",4,4,0,88725,1261,68.5
"20339","63410","2016",1,1,0,52000,433,120
"20340","63411","2016",3,3,0,137133.3,1148.333,128
"20341","63412","2016",7,7,0,51500,642.2857,82.42857
"20342","63413","2016",9,9,0,187593.3,1966.556,95.33333
"20343","63414","2016",4,4,0,144325,1178,112
"20344","63415","2016",13,13,0,74807.69,1114.308,80.38462
"20345","63416","2016",2,2,0,39500,695,57.5
"20346","63417","2016",23,23,0,190659.6,1917.435,97.91304
"20347","63418","2016",8,8,0,144196.9,1209.375,131.75
"20348","63419","2016",4,4,0,136375,2856.75,80.75
"20349","63420","2016",4,4,0,165878.2,1677,98.5
"20350","63421","2016",3,3,0,72953.33,871.3333,76.66667
"20351","63422","2016",1,1,0,77000,917,84
"20352","63423","2016",13,13,0,96332.23,1242.692,79.76923
"20353","63425","2016",12,12,0,243760.1,1994.667,122.75
"20354","63426","2016",2,2,0,60325,869.5,68.5
"20355","63427","2016",3,3,0,280666.7,1287.667,223
"20356","63428","2016",3,3,0,65475,1284,60.66667
"20357","63429","2016",1,1,0,44000,677,65
"20358","63430","2016",92,74,18,91173.5,943.2065,97.94565
"20359","63431","2016",2,2,0,108187.5,1128,99
"20360","63432","2016",10,10,0,135268,1393.7,94.7
"20361","63434","2016",3,3,0,61666.67,727.6667,92
"20362","63435","2016",5,5,0,116190,1068.6,108.4
"20363","63438","2016",6,6,0,101475,1174,85.16667
"20364","63439","2016",4,4,0,336925,1570.75,192.75
"20365","63440","2016",2,2,0,74150,922,80.5
"20366","63441","2016",5,5,0,85640,826.8,91
"20367","63442","2016",2,2,0,27500,550,50
"20368","63443","2016",4,4,0,178875,1825,96.25
"20369","63444","2016",2,2,0,108700,1382,77
"20370","63445","2016",3,3,0,99920,1079.667,109.6667
"20371","63446","2016",6,6,0,158000,1378.833,111.6667
"20372","63448","2016",15,15,0,76324.67,1035.4,72.26667
"20373","63449","2016",1,1,0,30000,600,50
"20374","63450","2016",2,2,0,45200,524.5,89
"20375","63451","2016",1,1,0,78000,2229,35
"20376","63453","2016",28,26,2,174940.9,1753.071,99.57143
"20377","63454","2016",5,5,0,97300,908.2,101.4
"20378","63455","2016",40,39,1,228790,1883.525,118.95
"20379","63456","2016",2,2,0,101089,667.5,147.5
"20380","63457","2016",62,56,6,155184,1720.306,89.75806
"20381","63458","2016",2,2,0,123860,749,168
"20382","63459","2016",3,3,0,103166.7,1191.333,81.33333
"20383","63461","2016",4,4,0,132525,1061,120.75
"20384","63462","2016",7,7,0,118914.3,1196.714,106.1429
"20385","63463","2016",3,3,0,48566.67,705,64.66667
"20386","63464","2016",3,3,0,137133.3,1379.333,99.66667
"20387","63465","2016",5,5,0,75000,869.8,86.8
"20388","63466","2016",2,2,0,99375,848,107
"20389","63468","2016",5,5,0,73300,796.8,95.6
"20390","63469","2016",3,3,0,112656.7,832,144.3333
"20391","63470","2016",42,40,2,153022.4,1650.405,94.97619
"20392","63471","2016",6,6,0,55416.67,632.6667,83
"20393","63472","2016",4,4,0,161830,1690,101.25
"20394","63473","2016",5,5,0,132686,1682.4,78.6
"20395","64001","2016",1,1,0,210600,1239,170
"20396","64002","2016",1,1,0,170000,1809,94
"20397","64003","2016",4,4,0,132750,1110.5,118
"20398","64004","2016",2,2,0,110000,1044,105.5
"20399","64005","2016",2,2,0,205500,1811,113.5
"20400","64006","2016",1,1,0,287000,2050,140
"20401","64007","2016",8,8,0,162136,1605.125,99.375
"20402","64008","2016",2,1,1,205475,1653,110
"20403","64009","2016",15,7,8,294234,3209.6,89.4
"20404","64010","2016",6,6,0,173666.7,1639.833,111.1667
"20405","64012","2016",1,1,0,78194,782,100
"20406","64013","2016",2,2,0,92500,572,161.5
"20407","64014","2016",2,2,0,430700,2450.5,175.5
"20408","64015","2016",1,0,1,75000,728,103
"20409","64016","2016",2,2,0,132500,1365,99.5
"20410","64017","2016",6,6,0,129166.7,1200,117.3333
"20411","64018","2016",3,2,1,198333.3,2221.667,93.33333
"20412","64019","2016",1,1,0,148000,1138,130
"20413","64021","2016",9,9,0,201900,1543.778,141
"20414","64022","2016",1,1,0,254420,2623,97
"20415","64023","2016",12,12,0,157001.3,1621.917,96.08333
"20416","64024","2016",753,200,553,277030,3689.533,73.82072
"20417","64026","2016",3,3,0,239883.3,1812.333,134.3333
"20418","64027","2016",1,1,0,211430,2093,101
"20419","64028","2016",2,2,0,147500,1352,122
"20420","64029","2016",5,5,0,133200.2,1273.8,111.6
"20421","64031","2016",1,1,0,175330,1609,109
"20422","64032","2016",3,3,0,130666.7,985,142.3333
"20423","64033","2016",3,3,0,175670,1487.333,125
"20424","64034","2016",1,1,0,175000,1667,105
"20425","64035","2016",19,17,2,500547.3,4261.684,122.8947
"20426","64036","2016",2,2,0,120500,1130,105.5
"20427","64037","2016",7,7,0,190392.9,1685.143,118.7143
"20428","64038","2016",37,19,18,381334.6,3309.432,113.5946
"20429","64039","2016",4,4,0,245037.5,1765.75,134.75
"20430","64040","2016",28,8,20,71621.11,1886.786,44.39286
"20431","64041","2016",7,5,2,188302.9,1819,111.1429
"20432","64042","2016",5,5,0,181600,1443,138
"20433","64043","2016",2,2,0,167500,2121.5,82.5
"20434","64047","2016",2,2,0,102600,1098,88.5
"20435","64049","2016",1,1,0,115000,1045,110
"20436","64050","2016",1,1,0,225000,1480,152
"20437","64051","2016",2,1,1,140321,1295.5,112
"20438","64052","2016",1,1,0,70000,1061,66
"20439","64053","2016",1,1,0,178340,1462,122
"20440","64057","2016",21,21,0,146362.9,1437.19,105.2381
"20441","64058","2016",5,5,0,127000,1037.6,136.6
"20442","64059","2016",8,8,0,245796.2,2047.125,123
"20443","64060","2016",23,20,3,207542,1944.913,110.6522
"20444","64061","2016",23,20,3,152774.4,1792.217,87.21739
"20445","64062","2016",20,17,3,146130,1338.05,111.9
"20446","64063","2016",3,3,0,97216.67,694.3333,152
"20447","64064","2016",2,2,0,97000,1032,100.5
"20448","64065","2016",65,40,25,355551.5,3066.446,109.8308
"20449","64067","2016",16,14,2,212539.4,1704.5,130
"20450","64068","2016",16,16,0,157150.6,1411.125,122.375
"20451","64069","2016",4,4,0,115012.5,1431.25,81.75
"20452","64070","2016",3,3,0,233516.7,2102.667,115
"20453","64071","2016",2,2,0,97527.5,1185.5,79.5
"20454","64072","2016",3,3,0,165000,1571.667,121.6667
"20455","64073","2016",1,1,0,190000,2159,88
"20456","64075","2016",1,1,0,105000,593,177
"20457","64078","2016",1,1,0,192500,1310,147
"20458","64080","2016",1,1,0,280000,2000,140
"20459","64081","2016",2,2,0,205425,2351,87
"20460","64083","2016",3,3,0,210000,1736.333,125.6667
"20461","64085","2016",1,1,0,20000,625,32
"20462","64086","2016",4,4,0,300438.2,2293.25,137.25
"20463","64087","2016",9,9,0,151922.2,1384.778,112.7778
"20464","64088","2016",3,3,0,117470,873.6667,134.3333
"20465","64091","2016",5,5,0,198210,1815.8,125.6
"20466","64093","2016",3,3,0,180666.7,1341.333,129.3333
"20467","64094","2016",7,7,0,296728.6,2030.143,144.8571
"20468","64095","2016",5,5,0,180764,1660.2,112.6
"20469","64096","2016",5,5,0,148184,1276.2,117.4
"20470","64097","2016",5,5,0,177989.4,1459.2,121
"20471","64098","2016",1,1,0,1e+05,1250,80
"20472","64099","2016",1,1,0,57000,509,112
"20473","64100","2016",35,24,11,429580.9,3629.2,114.4
"20474","64101","2016",7,6,1,190257.1,1521.429,133.7143
"20475","64102","2016",899,99,800,183176.5,2724.642,67.50834
"20476","64103","2016",1,1,0,190000,1959,97
"20477","64104","2016",3,3,0,85833.33,806.6667,107.6667
"20478","64105","2016",1,1,0,165600,1075,154
"20479","64106","2016",4,4,0,163732.5,1213.5,137.75
"20480","64108","2016",7,7,0,137998.9,1041.714,152.2857
"20481","64109","2016",21,21,0,182311,1408.857,128.5714
"20482","64110","2016",4,4,0,134857.5,1348.5,102.75
"20483","64111","2016",1,1,0,20000,426,47
"20484","64112","2016",6,6,0,136613.3,1154,129.8333
"20485","64114","2016",5,5,0,207474.2,1610,130.2
"20486","64115","2016",1,1,0,125000,817,153
"20487","64116","2016",3,3,0,141763.3,1433.667,100.6667
"20488","64119","2016",4,4,0,194173.2,1750.75,117.5
"20489","64120","2016",2,2,0,220385,1075,202.5
"20490","64121","2016",2,2,0,314000,2623.5,119
"20491","64122","2016",820,138,682,318318.5,4694.105,68.71829
"20492","64123","2016",10,9,1,198436,1934.9,108.5
"20493","64124","2016",3,3,0,263000,1856.667,143
"20494","64125","2016",138,55,83,325604.7,4027.732,85.60145
"20495","64126","2016",9,8,1,146206.7,1265.222,119.7778
"20496","64127","2016",4,4,0,124375,1224.75,109
"20497","64128","2016",3,3,0,142160,1876.667,95
"20498","64129","2016",245,73,172,123623,1774.882,70.02041
"20499","64130","2016",8,4,4,208962.5,2108.25,92.625
"20500","64131","2016",4,4,0,158500,1447,104.25
"20501","64132","2016",34,27,7,218020.6,1879.765,118.1176
"20502","64133","2016",7,6,1,174628.6,2038.714,85.28571
"20503","64134","2016",2,2,0,260700,1950,120
"20504","64135","2016",6,6,0,153166.7,1256.667,122.5
"20505","64136","2016",1,1,0,55000,887,62
"20506","64137","2016",6,6,0,183710,1382,138.6667
"20507","64138","2016",19,18,1,182425.3,1740.947,110.2105
"20508","64139","2016",6,6,0,228500,1497,154.6667
"20509","64140","2016",114,53,61,207888.4,2673.325,79.2807
"20510","64141","2016",4,4,0,140000,1432.5,102.75
"20511","64142","2016",5,5,0,243072,2574.4,97.6
"20512","64143","2016",1,1,0,97000,1078,90
"20513","64145","2016",5,5,0,177452.4,1166.6,158.6
"20514","64146","2016",5,5,0,224022,1577.6,142.6
"20515","64147","2016",33,22,11,250735.7,2305.121,111.4848
"20516","64149","2016",1,1,0,135000,1164,116
"20517","64151","2016",2,2,0,146000,1226.5,119
"20518","64152","2016",10,10,0,284482.5,2308.9,121.8
"20519","64153","2016",1,1,0,95000,1397,68
"20520","64155","2016",1,1,0,80000,421,190
"20521","64156","2016",2,2,0,185000,1962,97.5
"20522","64157","2016",9,9,0,118649,1173.889,97.33333
"20523","64160","2016",106,32,74,159980.5,2466.887,68.49057
"20524","64161","2016",11,11,0,211752.1,2048.545,112.8182
"20525","64162","2016",1,1,0,65100,814,80
"20526","64165","2016",3,3,0,138333.3,1299.333,109.3333
"20527","64166","2016",1,1,0,315000,2423,130
"20528","64168","2016",6,6,0,117666.7,1051.833,116.3333
"20529","64170","2016",1,1,0,2e+05,1587,126
"20530","64171","2016",2,2,0,174850,1465.5,117.5
"20531","64172","2016",2,2,0,112500,1206.5,83
"20532","64173","2016",1,1,0,142000,1578,90
"20533","64175","2016",3,3,0,122333.3,4924.667,72.66667
"20534","64176","2016",2,2,0,257250,1910,138
"20535","64177","2016",3,3,0,120333.3,1336.667,101.6667
"20536","64178","2016",4,4,0,135027.5,1287.25,114.5
"20537","64179","2016",2,2,0,199000,1916.5,104.5
"20538","64180","2016",3,3,0,146983.3,1324,110
"20539","64181","2016",1,1,0,235000,1536,153
"20540","64183","2016",3,3,0,237666.7,1987.667,117.6667
"20541","64184","2016",4,4,0,166880.5,1452.25,120
"20542","64185","2016",1,1,0,30000,1071,28
"20543","64188","2016",5,5,0,67480,807.6,86
"20544","64189","2016",208,33,175,294200.4,4037.452,74.01442
"20545","64191","2016",11,11,0,216990.8,1494.364,148.1818
"20546","64192","2016",2,2,0,116000,1144,102
"20547","64195","2016",1,1,0,185000,1276,145
"20548","64196","2016",1,1,0,63000,788,80
"20549","64197","2016",1,1,0,407500,1852,220
"20550","64198","2016",17,17,0,205733.5,1929.471,112.4118
"20551","64199","2016",2,2,0,90000,791.5,112
"20552","64200","2016",1,1,0,80000,526,152
"20553","64201","2016",1,1,0,219120,1481,148
"20554","64202","2016",4,4,0,164750,1416.5,116.75
"20555","64203","2016",4,4,0,282625,1890,151.75
"20556","64204","2016",45,6,39,68057.76,1613.133,45.55556
"20557","64206","2016",1,1,0,90443,1739,52
"20558","64207","2016",1,1,0,165000,589,280
"20559","64208","2016",1,1,0,148300,734,202
"20560","64210","2016",3,3,0,124516.7,1060.333,122.3333
"20561","64211","2016",3,3,0,226491.7,1625.333,143
"20562","64213","2016",8,7,1,307650,3096.375,108.375
"20563","64214","2016",4,4,0,137042.5,1304.75,106.5
"20564","64215","2016",2,2,0,175000,1129.5,155
"20565","64216","2016",2,2,0,214050,1989.5,107
"20566","64217","2016",5,5,0,196916,1367.4,152.2
"20567","64218","2016",1,1,0,45000,354,127
"20568","64219","2016",2,2,0,170000,1550.5,112.5
"20569","64220","2016",4,4,0,115750,1344.75,94
"20570","64221","2016",2,2,0,153000,1118,152.5
"20571","64223","2016",2,2,0,105500,1172,87
"20572","64224","2016",5,5,0,188400,1694.2,118.4
"20573","64225","2016",6,5,1,142250,1031.5,139.1667
"20574","64226","2016",2,2,0,159000,2120,76
"20575","64227","2016",6,6,0,168200.2,1623.333,107.5
"20576","64228","2016",4,4,0,181350,1405.25,136
"20577","64229","2016",1,0,1,115000,1173,98
"20578","64230","2016",54,50,4,191041.8,1684,111.2222
"20579","64231","2016",5,5,0,142900,1496,103
"20580","64232","2016",2,2,0,171215,1414.5,136
"20581","64233","2016",12,12,0,123858.3,1151.417,109.5
"20582","64234","2016",4,4,0,186875,1438,139.5
"20583","64235","2016",2,2,0,176150,1222,167.5
"20584","64236","2016",1,1,0,145000,780,186
"20585","64237","2016",35,24,11,178427.1,1877.657,94.02857
"20586","64238","2016",14,14,0,220962.9,1767.714,124.7857
"20587","64239","2016",2,2,0,94000,1331,67
"20588","64240","2016",3,3,0,134648.3,1600.667,83.33333
"20589","64241","2016",4,4,0,167500,1609.75,110.25
"20590","64242","2016",1,1,0,376560,1837,205
"20591","64243","2016",3,3,0,206366.7,1945,106.3333
"20592","64244","2016",1,1,0,160000,1067,150
"20593","64245","2016",3,3,0,139666.7,1508.333,96.66667
"20594","64246","2016",5,5,0,177400,1731,108.4
"20595","64247","2016",1,1,0,142000,1268,112
"20596","64249","2016",34,10,24,404542.5,5706.147,74.5
"20597","64250","2016",6,6,0,266483.3,1850,149.8333
"20598","64251","2016",3,2,1,84000,956,94.33333
"20599","64252","2016",4,4,0,162500,1593.75,101.5
"20600","64253","2016",1,1,0,2e+05,897,223
"20601","64254","2016",5,5,0,169960,1153.2,151.6
"20602","64255","2016",8,7,1,269656,2153.125,135.625
"20603","64256","2016",56,25,31,187700,2053.946,97.41071
"20604","64257","2016",4,4,0,164863.8,1732.25,105.5
"20605","64259","2016",3,2,1,189803.3,1586.333,108
"20606","64260","2016",386,57,329,174084.9,2932.645,60.93782
"20607","64263","2016",1,1,0,235000,1691,139
"20608","64264","2016",1,1,0,103500,1278,81
"20609","64265","2016",1,1,0,208600,1329,157
"20610","64266","2016",2,2,0,162079,1055.5,147
"20611","64269","2016",39,32,7,251280.5,2110.615,118.0769
"20612","64270","2016",6,6,0,166016.7,1404.167,120
"20613","64271","2016",3,2,1,103666.7,975,101.6667
"20614","64273","2016",3,3,0,113333.3,988.3333,132.3333
"20615","64276","2016",1,1,0,670700,2771,242
"20616","64277","2016",2,2,0,217039.5,1692.5,128.5
"20617","64279","2016",4,3,1,213450,1686.75,134
"20618","64280","2016",2,2,0,132050,1843,71.5
"20619","64281","2016",3,3,0,177600,1490.667,116.6667
"20620","64282","2016",7,7,0,279032.7,2893.714,104.4286
"20621","64284","2016",90,51,39,175269.3,1754.678,99.66667
"20622","64286","2016",4,4,0,158540,1672,95.25
"20623","64287","2016",1,1,0,260000,1625,160
"20624","64288","2016",1,1,0,244750,1990,123
"20625","64289","2016",3,3,0,229000,2097.667,113.6667
"20626","64290","2016",1,1,0,221335,1456,152
"20627","64291","2016",3,3,0,114666.7,1243.667,91
"20628","64292","2016",2,2,0,162900,1266.5,128.5
"20629","64296","2016",2,2,0,63200,799.5,83.5
"20630","64297","2016",2,0,2,98000,805,124
"20631","64298","2016",2,2,0,105500,1550,92.5
"20632","64299","2016",1,1,0,50000,338,148
"20633","64301","2016",10,10,0,119670,1204.3,109.1
"20634","64302","2016",7,7,0,199475,1450.143,144.8571
"20635","64304","2016",40,14,26,210512.5,2382.3,89.3
"20636","64305","2016",6,6,0,87322.83,1061.167,81.33333
"20637","64306","2016",3,3,0,149666.7,1465,118.6667
"20638","64307","2016",2,2,0,186750,1533,123
"20639","64308","2016",1,1,0,2e+05,6667,30
"20640","64309","2016",1,1,0,87500,478,183
"20641","64310","2016",2,2,0,163900,1012,169
"20642","64312","2016",3,3,0,135333.3,1009.333,131.6667
"20643","64313","2016",2,2,0,90000,726.5,117.5
"20644","64314","2016",2,2,0,142900,1249.5,118
"20645","64315","2016",2,2,0,224700,2200.5,113
"20646","64317","2016",11,8,3,266040.9,2448.818,119.9091
"20647","64318","2016",1,1,0,215000,1075,200
"20648","64319","2016",2,2,0,131000,937.5,145
"20649","64320","2016",19,4,15,59878.26,1635.474,42.94737
"20650","64321","2016",1,1,0,95000,1583,60
"20651","64322","2016",2,2,0,343427.5,2107,173
"20652","64324","2016",13,13,0,184420.4,1204.615,142.9231
"20653","64325","2016",1,1,0,185645,1658,112
"20654","64327","2016",2,2,0,242750,1192,226
"20655","64328","2016",4,4,0,169375,1390.5,121.75
"20656","64329","2016",14,14,0,352148.6,2167.357,163.3571
"20657","64330","2016",5,5,0,76600,1303.2,67.6
"20658","64331","2016",5,5,0,89100,808.6,113.2
"20659","64332","2016",3,3,0,157056.7,1592.333,104.6667
"20660","64334","2016",1,1,0,137500,859,160
"20661","64335","2016",77,58,19,224118.7,2094,106.2338
"20662","64336","2016",1,1,0,143000,947,151
"20663","64337","2016",1,1,0,280900,6107,46
"20664","64339","2016",9,8,1,141961.3,1294.556,115.2222
"20665","64340","2016",2,2,0,160000,1702,94.5
"20666","64342","2016",2,2,0,114000,1071.5,108.5
"20667","64343","2016",6,6,0,188058.3,2031,93
"20668","64344","2016",4,4,0,143937.5,1497.5,107.25
"20669","64346","2016",1,1,0,156000,1660,94
"20670","64347","2016",1,1,0,363000,2135,170
"20671","64348","2016",130,80,50,201312.8,2048.962,97.58462
"20672","64349","2016",4,4,0,215211,1580.75,130
"20673","64350","2016",5,4,1,188280,1997,88.6
"20674","64351","2016",2,2,0,90000,1260,73
"20675","64352","2016",5,5,0,165200,1421.4,129.6
"20676","64353","2016",8,6,2,116346.2,1483.125,81.5
"20677","64354","2016",3,3,0,130666.7,1674.667,87.33333
"20678","64356","2016",2,2,0,80000,646,103
"20679","64357","2016",2,2,0,122500,1123,106.5
"20680","64358","2016",3,3,0,178666.7,1528.667,124.6667
"20681","64359","2016",5,5,0,155000,969.6,180
"20682","64360","2016",2,2,0,109750,900.5,136
"20683","64362","2016",1,1,0,227500,1649,138
"20684","64363","2016",2,2,0,145650,981,148.5
"20685","64365","2016",3,3,0,108666.7,1225.667,96.33333
"20686","64366","2016",1,1,0,70000,761,92
"20687","64367","2016",6,6,0,94835,1064.167,97.66667
"20688","64368","2016",1,1,0,255000,3228,79
"20689","64369","2016",3,3,0,162233.3,1393.333,113.3333
"20690","64370","2016",4,4,0,226040,1861,122.75
"20691","64371","2016",21,10,11,99173.62,1204.286,88.7619
"20692","64372","2016",1,1,0,123500,1273,97
"20693","64373","2016",11,11,0,180817,1773.727,102.3636
"20694","64374","2016",7,7,0,205854.3,1966,114.4286
"20695","64375","2016",1,1,0,65000,677,96
"20696","64376","2016",8,8,0,181835.5,1359.125,146.625
"20697","64377","2016",3,2,1,82411.67,755.3333,123
"20698","64378","2016",1,1,0,160000,1290,124
"20699","64379","2016",1,1,0,319000,1994,160
"20700","64380","2016",1,1,0,45000,750,60
"20701","64381","2016",1,1,0,115000,1438,80
"20702","64382","2016",2,2,0,185750,1397.5,130
"20703","64383","2016",1,1,0,180000,1565,115
"20704","64385","2016",5,5,0,163430,1356.8,125.8
"20705","64386","2016",15,11,4,148394.4,1412.067,103.4667
"20706","64387","2016",1,1,0,275150,1834,150
"20707","64388","2016",2,2,0,225550,1762.5,127.5
"20708","64389","2016",2,2,0,201875,1654,122
"20709","64390","2016",3,3,0,85000,691.6667,124
"20710","64392","2016",2,2,0,144500,1343.5,109
"20711","64393","2016",45,38,7,148328.5,1613.911,96.75556
"20712","64396","2016",7,7,0,155905.7,1566.286,101.4286
"20713","64398","2016",5,5,0,176200,1296.2,129.6
"20714","64399","2016",18,17,1,275289.2,2018.111,135.5
"20715","64400","2016",7,7,0,141635.7,1284.714,125.1429
"20716","64401","2016",1,1,0,120000,1176,102
"20717","64403","2016",1,1,0,45000,776,58
"20718","64404","2016",1,1,0,149000,2483,60
"20719","64405","2016",32,30,2,220919.4,1943.188,134.25
"20720","64406","2016",6,6,0,179466.7,1180.833,160
"20721","64407","2016",40,31,9,291915.2,2845.7,104.425
"20722","64409","2016",9,9,0,142500,1261.556,113.3333
"20723","64410","2016",33,17,16,109639.1,1238.727,88.90909
"20724","64411","2016",3,3,0,108333.3,1208.667,92
"20725","64412","2016",1,1,0,60000,536,112
"20726","64413","2016",6,5,1,260333.3,2263.167,107.1667
"20727","64414","2016",2,2,0,192500,2019,97
"20728","64415","2016",12,12,0,218714.9,1923.667,114.9167
"20729","64416","2016",7,7,0,149971.4,1202,144.2857
"20730","64417","2016",28,17,11,136661.9,1455.75,96.92857
"20731","64418","2016",1,1,0,154000,1974,78
"20732","64419","2016",12,11,1,200789.2,1692.5,115.5
"20733","64421","2016",11,11,0,164918.2,1569.727,105.2727
"20734","64422","2016",104,56,48,114050,1318.856,88.74038
"20735","64423","2016",1,1,0,351400,1065,330
"20736","64424","2016",3,3,0,100133.3,948,106
"20737","64425","2016",3,3,0,255611.7,1867.667,134
"20738","64426","2016",1,1,0,165000,1410,117
"20739","64430","2016",107,67,40,119471.4,1454.916,87.29907
"20740","64431","2016",2,2,0,121000,1482.5,80
"20741","64432","2016",2,2,0,127500,881.5,143.5
"20742","64436","2016",3,3,0,190666.7,1530.333,123.3333
"20743","64437","2016",2,1,1,120000,1231,98
"20744","64438","2016",1,1,0,205000,1783,115
"20745","64439","2016",13,13,0,230631.5,2010.231,114.1538
"20746","64440","2016",4,4,0,163750,1464.5,111.25
"20747","64442","2016",1,1,0,120000,1500,80
"20748","64443","2016",6,6,0,135783.3,1282,111.3333
"20749","64444","2016",1,1,0,221600,1119,198
"20750","64445","2016",1472,227,1245,118043.2,1683.243,70.28668
"20751","64448","2016",15,14,1,204753,1723.733,120.3333
"20752","64449","2016",1,1,0,285000,2036,140
"20753","64450","2016",2,2,0,198250,1722,116.5
"20754","64451","2016",1,1,0,238000,1587,150
"20755","64452","2016",4,4,0,195675,1258,161.25
"20756","64453","2016",21,18,3,161767.9,1491.476,110.0476
"20757","64454","2016",1,1,0,239200,1495,160
"20758","64455","2016",2,2,0,53625,682,86.5
"20759","64457","2016",1,1,0,191000,1364,140
"20760","64458","2016",8,8,0,156625,1508.75,103.875
"20761","64460","2016",7,7,0,129471.4,1043.714,121.4286
"20762","64461","2016",14,13,1,144907.1,1371.643,113.5
"20763","64462","2016",7,7,0,147364.3,1506.857,95.42857
"20764","64463","2016",8,8,0,159008.8,1451.875,116.25
"20765","64464","2016",1,1,0,175000,1316,133
"20766","64466","2016",6,5,1,121666.7,1195.5,113.5
"20767","64467","2016",2,2,0,210000,1783,114
"20768","64468","2016",2,2,0,111500,914,116
"20769","64469","2016",2,2,0,175500,1981,88.5
"20770","64470","2016",7,7,0,171350,1437.429,122
"20771","64471","2016",3,3,0,139488.3,1343.667,106
"20772","64472","2016",7,7,0,200814.3,1718.286,113.1429
"20773","64473","2016",4,4,0,141750,1313.25,106
"20774","64474","2016",2,2,0,135750,874.5,148
"20775","64475","2016",1,1,0,27000,397,68
"20776","64476","2016",6,6,0,205183.3,1757.667,123
"20777","64477","2016",9,9,0,171833.3,1623.889,95.88889
"20778","64478","2016",5,5,0,201780,1698,124.6
"20779","64479","2016",1,1,0,145000,2101,69
"20780","64480","2016",2,2,0,157500,1162.5,160
"20781","64482","2016",2,2,0,145350,1631,81
"20782","64483","2016",286,55,231,332262,4550.469,70.88811
"20783","64484","2016",4,3,1,111000,1139.5,107.5
"20784","64485","2016",14,8,6,186946.4,1523.857,121.7857
"20785","64486","2016",1,1,0,65000,619,105
"20786","64488","2016",1,1,0,205000,2356,87
"20787","64489","2016",1,0,1,181000,2586,70
"20788","64490","2016",2,2,0,172500,1690,101.5
"20789","64492","2016",2,1,1,125000,1670.5,76
"20790","64493","2016",20,13,7,153230.4,1490.65,109.9
"20791","64494","2016",3,3,0,85333.33,1075.333,78.66667
"20792","64495","2016",77,36,41,245603.1,2643.727,92.7013
"20793","64496","2016",42,29,13,274288.5,2845.833,96.95238
"20794","64498","2016",2,2,0,208900,1646.5,127.5
"20795","64499","2016",57,40,17,146814,1562.912,95.33333
"20796","64501","2016",3,3,0,177666.7,1575.333,111.3333
"20797","64502","2016",9,9,0,222355.6,1684,121
"20798","64504","2016",11,9,2,363388.2,2973.818,119
"20799","64505","2016",3,3,0,213733.3,1322.333,175.3333
"20800","64506","2016",2,2,0,63125,811,80.5
"20801","64507","2016",1,1,0,197000,1858,106
"20802","64508","2016",1,1,0,134000,2062,65
"20803","64509","2016",3,3,0,74666.67,589.3333,134.6667
"20804","64510","2016",8,8,0,161529.5,1407,116.75
"20805","64511","2016",24,24,0,240596.7,1971.25,125.25
"20806","64513","2016",10,9,1,132900,1117,121.8
"20807","64514","2016",1,1,0,194000,1732,112
"20808","64515","2016",1,1,0,191700,1389,138
"20809","64516","2016",2,2,0,206050,1684,122
"20810","64518","2016",3,3,0,274350,1815.667,154.3333
"20811","64519","2016",28,27,1,261287.5,2193.143,118.1071
"20812","64520","2016",3,3,0,419500,2649.667,162
"20813","64521","2016",8,6,2,156576.2,1557.375,97.125
"20814","64522","2016",4,4,0,129750,1010,126.75
"20815","64523","2016",5,5,0,156400,1525.6,108.6
"20816","64524","2016",6,6,0,132500,1169.167,111.3333
"20817","64525","2016",9,9,0,208283.1,2075.222,100.4444
"20818","64526","2016",17,17,0,201317.6,1905.412,109.2941
"20819","64527","2016",4,4,0,306000,2014.5,159.75
"20820","64529","2016",4,4,0,157500,1436.75,122.5
"20821","64530","2016",4,4,0,135539,1621,84.5
"20822","64531","2016",1,1,0,105000,729,144
"20823","64532","2016",1,1,0,57000,640,89
"20824","64533","2016",7,4,3,107067.9,1034.286,102.8571
"20825","64534","2016",1,1,0,219000,1450,151
"20826","64535","2016",2,2,0,301795,2464,121
"20827","64536","2016",9,9,0,187431.1,1572,144.3333
"20828","64537","2016",2,2,0,95500,1404.5,67
"20829","64538","2016",10,4,6,120649.2,1856.9,69
"20830","64539","2016",2,2,0,160000,1316.5,118.5
"20831","64540","2016",28,23,5,278678,2506.429,112.1071
"20832","64541","2016",1,1,0,126000,881,143
"20833","64542","2016",2,2,0,62000,799,76
"20834","64543","2016",1,1,0,140000,2333,60
"20835","64545","2016",159,56,103,274075.6,3110.874,89.11321
"20836","64546","2016",20,18,2,257681,2435.4,104.4
"20837","64547","2016",55,33,22,212933.3,2324.473,98.89091
"20838","64549","2016",5,5,0,163100,1236,132.4
"20839","64550","2016",6,6,0,330000,1672.167,177.3333
"20840","64551","2016",2,2,0,160000,1326.5,124.5
"20841","64555","2016",1,1,0,147000,919,160
"20842","64556","2016",2,2,0,368000,3221,118
"20843","64557","2016",5,5,0,162860,1271,144.4
"20844","64558","2016",20,15,5,314508.8,2610.5,121.75
"20845","64559","2016",3,2,1,131666.7,1753.333,78
"20846","64560","2016",2,2,0,196925,1812.5,108
"20847","65001","2016",1,1,0,280000,1628,172
"20848","65002","2016",5,5,0,144990,1536.4,94.6
"20849","65003","2016",1,1,0,85000,1149,74
"20850","65005","2016",2,2,0,198325,1883,105.5
"20851","65006","2016",7,5,2,122651,1401.286,93
"20852","65007","2016",10,10,0,129150,1203.7,106.6
"20853","65009","2016",1,1,0,205000,1464,140
"20854","65010","2016",2,2,0,204000,1577,127.5
"20855","65011","2016",1,1,0,342000,1443,237
"20856","65012","2016",2,2,0,85000,1304.5,66.5
"20857","65014","2016",2,2,0,162000,1724,94
"20858","65016","2016",2,2,0,233250,1381.5,154
"20859","65017","2016",29,4,25,64658.1,1740.345,39.03448
"20860","65018","2016",4,4,0,80293.75,1085.25,79.75
"20861","65019","2016",7,7,0,150660,1431.571,103.1429
"20862","65020","2016",1,1,0,162000,1500,108
"20863","65021","2016",1,1,0,248100,2034,122
"20864","65024","2016",2,2,0,169500,936,203
"20865","65025","2016",49,19,30,131119.6,1916.918,72.22449
"20866","65029","2016",4,4,0,155137.5,1324.75,115.25
"20867","65031","2016",13,8,5,127092.3,1861,79.92308
"20868","65032","2016",10,9,1,133362,1833.3,79.6
"20869","65033","2016",3,3,0,98000,893.6667,103.3333
"20870","65035","2016",5,5,0,127324,1122,127
"20871","65036","2016",2,1,1,115750,1173,82.5
"20872","65039","2016",1,1,0,115000,1575,73
"20873","65040","2016",4,4,0,109875,1068.5,100.5
"20874","65041","2016",3,3,0,137333.3,1979,77
"20875","65042","2016",6,6,0,130533.3,1478,103
"20876","65043","2016",1,1,0,112250,1247,90
"20877","65044","2016",3,3,0,173016.7,1494.333,121.6667
"20878","65045","2016",2,1,1,64500,878.5,77.5
"20879","65046","2016",2,2,0,102500,1171,80
"20880","65047","2016",78,57,21,116173.3,1338.513,87.44872
"20881","65048","2016",4,4,0,207923.5,1683.25,120.5
"20882","65049","2016",2,2,0,169900,1985,86.5
"20883","65050","2016",2,2,0,179800,2746.5,65.5
"20884","65051","2016",1,1,0,64500,1075,60
"20885","65052","2016",2,2,0,138000,1035.5,138
"20886","65054","2016",1,1,0,88000,1313,67
"20887","65055","2016",4,4,0,182212.5,2283.5,88.75
"20888","65056","2016",4,4,0,187375,1191.25,182.5
"20889","65057","2016",1,1,0,133444,598,223
"20890","65058","2016",1,1,0,150000,1261,119
"20891","65059","2016",173,55,118,83646.26,1496.52,60.21387
"20892","65060","2016",1,1,0,110000,1000,110
"20893","65061","2016",1,1,0,216000,1662,130
"20894","65062","2016",31,29,2,175827.8,1711.548,104.7419
"20895","65063","2016",2,2,0,165350,1405.5,125
"20896","65064","2016",1,1,0,176000,2071,85
"20897","65065","2016",3,3,0,147000,1241.333,119.3333
"20898","65066","2016",1,1,0,120000,1053,114
"20899","65069","2016",8,8,0,136625,1647.875,79
"20900","65070","2016",4,4,0,204250,1608.5,127
"20901","65071","2016",1,1,0,105000,1694,62
"20902","65072","2016",17,17,0,155782,1601.176,99
"20903","65077","2016",8,8,0,194779.6,1905,111.5
"20904","65078","2016",5,5,0,132004,1223.8,107.2
"20905","65079","2016",2,2,0,133330,1341,99.5
"20906","65080","2016",1,1,0,169000,1199,141
"20907","65081","2016",3,3,0,129500,1354,94
"20908","65083","2016",7,7,0,169750.7,1689.857,102.2857
"20909","65084","2016",2,2,0,198245,1861.5,106.5
"20910","65090","2016",1,1,0,152000,1267,120
"20911","65091","2016",1,1,0,160000,727,220
"20912","65092","2016",1,1,0,88854,1021,87
"20913","65093","2016",4,4,0,82310,944,96
"20914","65095","2016",1,1,0,434420,1546,281
"20915","65096","2016",1,1,0,15000,429,35
"20916","65098","2016",6,6,0,187116.7,1425.833,131.6667
"20917","65099","2016",9,3,6,99666.67,1554.222,82.66667
"20918","65100","2016",44,43,1,141907.7,1480.205,97.25
"20919","65101","2016",9,9,0,141790.6,1383.889,104.8889
"20920","65104","2016",4,4,0,250341.2,1735.25,144.75
"20921","65105","2016",1,1,0,190980,1854,103
"20922","65106","2016",2,0,2,117000,2651,42.5
"20923","65108","2016",6,5,1,127845,1360.5,96.33333
"20924","65111","2016",4,4,0,72600,1215.25,69.5
"20925","65112","2016",2,2,0,142000,1950,73.5
"20926","65113","2016",1,1,0,150000,1364,110
"20927","65114","2016",2,2,0,114000,802,156
"20928","65115","2016",5,5,0,144500,1351,112.8
"20929","65116","2016",2,2,0,122000,1152,108
"20930","65119","2016",3,3,0,50166.67,607.3333,90.66667
"20931","65120","2016",3,3,0,169360,1613.333,103.3333
"20932","65121","2016",4,4,0,109875,1122.5,97.75
"20933","65123","2016",52,29,23,108725.1,1849.904,63.86538
"20934","65125","2016",3,3,0,114333.3,1178.333,104.6667
"20935","65126","2016",1,1,0,117000,1286,91
"20936","65127","2016",22,17,5,111612.2,1181.909,96.95455
"20937","65129","2016",6,4,2,90000,774.3333,116
"20938","65130","2016",8,8,0,187062.5,1071.375,127.75
"20939","65131","2016",3,3,0,120666.7,791,152.3333
"20940","65133","2016",2,2,0,177500,1509,120
"20941","65135","2016",1,1,0,128000,1422,90
"20942","65137","2016",2,2,0,80375,1677,49.5
"20943","65138","2016",126,9,117,92773.71,2327.897,40.26984
"20944","65139","2016",3,3,0,87000,705.3333,122
"20945","65141","2016",1,1,0,75000,625,120
"20946","65143","2016",1,1,0,30000,1000,30
"20947","65146","2016",6,6,0,153246.7,1491.833,100.5
"20948","65147","2016",4,4,0,144775,1717.5,80.5
"20949","65148","2016",1,1,0,114000,1373,83
"20950","65150","2016",6,6,0,158999.2,1553.5,108.6667
"20951","65151","2016",2,2,0,133000,1487.5,90
"20952","65156","2016",2,2,0,171500,1475.5,114.5
"20953","65158","2016",3,3,0,68133.33,764.6667,84
"20954","65159","2016",1,0,1,118800,1080,110
"20955","65160","2016",2,2,0,90150,1125.5,76.5
"20956","65163","2016",1,1,0,40000,952,42
"20957","65164","2016",1,1,0,175000,2215,79
"20958","65165","2016",1,1,0,213740,891,240
"20959","65166","2016",1,1,0,66000,462,143
"20960","65168","2016",19,2,17,93863.68,2413.789,43.42105
"20961","65169","2016",2,2,0,160825,1479,121
"20962","65171","2016",1,1,0,120000,1818,66
"20963","65173","2016",3,1,2,164880,2710.333,55
"20964","65174","2016",1,1,0,93000,969,96
"20965","65175","2016",4,4,0,67000,1150.75,67.5
"20966","65176","2016",1,0,1,46000,730,63
"20967","65177","2016",1,1,0,220000,1497,147
"20968","65179","2016",1,1,0,99645,923,108
"20969","65182","2016",1,1,0,112150,1122,100
"20970","65183","2016",8,8,0,130651.2,1199.625,112.25
"20971","65184","2016",2,2,0,169600,1424,137
"20972","65185","2016",2,2,0,199750,1513,132
"20973","65189","2016",4,4,0,154783.8,1253.75,128.5
"20974","65191","2016",3,3,0,133833.3,1682.667,85
"20975","65192","2016",10,7,3,98430.5,1754.4,62.8
"20976","65193","2016",1,1,0,135700,1696,80
"20977","65195","2016",8,2,6,144913.6,2805.5,58
"20978","65197","2016",1,1,0,291700,3205,91
"20979","65198","2016",8,8,0,136862.5,1629.375,87.125
"20980","65199","2016",11,0,11,176606.1,3427.182,51.36364
"20981","65200","2016",4,4,0,75195,1737.75,51
"20982","65201","2016",4,4,0,169850,1565,110
"20983","65206","2016",1,1,0,235100,1911,123
"20984","65210","2016",2,1,1,80210,1909.5,42
"20985","65211","2016",2,1,1,183650,1843,99
"20986","65212","2016",10,7,3,149421.2,2030,86.1
"20987","65214","2016",1,1,0,139000,1390,100
"20988","65215","2016",1,1,0,150000,938,160
"20989","65216","2016",2,2,0,138000,2237,81
"20990","65218","2016",6,6,0,102704.2,1495.833,67.33333
"20991","65219","2016",1,1,0,75000,670,112
"20992","65220","2016",5,5,0,100700,1132.6,89.6
"20993","65221","2016",3,3,0,195981,1515.667,131.3333
"20994","65223","2016",8,8,0,179053.8,1469.25,123.75
"20995","65224","2016",1,1,0,174000,1611,108
"20996","65226","2016",13,12,1,208496.9,2238.769,101.4615
"20997","65228","2016",2,2,0,130000,1393.5,91
"20998","65229","2016",1,1,0,1e+05,1299,77
"20999","65230","2016",1,1,0,155000,1409,110
"21000","65231","2016",3,3,0,117750,1373.333,86.33333
"21001","65233","2016",2,1,1,142000,1564.5,93.5
"21002","65234","2016",2,1,1,129500,1969,66
"21003","65235","2016",33,33,0,143956.1,1620.939,92.12121
"21004","65236","2016",1,1,0,166000,1953,85
"21005","65237","2016",2,2,0,93500,678,135.5
"21006","65238","2016",4,4,0,133877.5,1353.25,101
"21007","65240","2016",8,8,0,192403.8,1350.75,139.75
"21008","65241","2016",1,1,0,45000,900,50
"21009","65242","2016",2,2,0,170968.5,1416.5,119
"21010","65243","2016",9,9,0,110822.2,1223,89.88889
"21011","65244","2016",5,5,0,176214,1619.4,109.4
"21012","65245","2016",2,2,0,175350,1645,107.5
"21013","65247","2016",1,1,0,87400,817,107
"21014","65248","2016",4,4,0,97325,920,96
"21015","65249","2016",1,1,0,179550,1282,140
"21016","65251","2016",16,16,0,140047.8,1453.75,93.8125
"21017","65252","2016",9,8,1,154511,1549.778,99.66667
"21018","65254","2016",3,3,0,82666.67,695.3333,119
"21019","65256","2016",1,1,0,70000,574,122
"21020","65257","2016",3,3,0,197488.3,1446.333,135.6667
"21021","65258","2016",53,30,23,86118.58,963.1698,90.0566
"21022","65259","2016",1,0,1,36000,750,48
"21023","65260","2016",1,1,0,144160,1153,125
"21024","65261","2016",1,1,0,111250,800,139
"21025","65262","2016",6,6,0,106000,979.1667,129.3333
"21026","65263","2016",2,2,0,121500,1310,93
"21027","65264","2016",4,4,0,178875,1175,149
"21028","65265","2016",3,3,0,135333.3,1138.333,118.6667
"21029","65266","2016",1,1,0,84500,626,135
"21030","65267","2016",4,3,1,128575,1949.75,75
"21031","65271","2016",2,2,0,174800,1362,118.5
"21032","65272","2016",2,2,0,124950,1163,108.5
"21033","65274","2016",3,3,0,107500,868.6667,118
"21034","65280","2016",2,2,0,162500,1480.5,137
"21035","65281","2016",5,5,0,171057.6,1141,151.4
"21036","65282","2016",15,7,8,155802.9,2908.133,59.6
"21037","65284","2016",9,9,0,176733.3,1676.556,105.3333
"21038","65285","2016",1,1,0,66000,1048,63
"21039","65286","2016",174,60,114,97627.27,1283.914,80.85057
"21040","65287","2016",7,6,1,125492.9,893.4286,150.5714
"21041","65289","2016",1,1,0,65000,650,100
"21042","65292","2016",1,1,0,118000,1204,98
"21043","65294","2016",1,1,0,65000,867,75
"21044","65295","2016",43,9,34,89952.26,1867.535,50.34884
"21045","65296","2016",4,4,0,120650,1065.25,114.5
"21046","65298","2016",1,1,0,95000,725,131
"21047","65299","2016",3,3,0,185000,1218.333,172.3333
"21048","65301","2016",2,2,0,138925,1676,82.5
"21049","65303","2016",2,2,0,100450,975,99
"21050","65304","2016",20,20,0,110100.3,1215.25,90.45
"21051","65305","2016",5,5,0,87430,936,97.6
"21052","65306","2016",2,2,0,87860,1319.5,66.5
"21053","65307","2016",1,1,0,80000,889,90
"21054","65310","2016",1,1,0,125000,679,184
"21055","65311","2016",1,1,0,238600,2057,116
"21056","65313","2016",5,5,0,124780,1328,87.4
"21057","65315","2016",5,5,0,86512,1073.2,76.8
"21058","65316","2016",1,1,0,39343,525,75
"21059","65318","2016",4,4,0,175556.2,1366.5,134
"21060","65319","2016",1,1,0,85000,1417,60
"21061","65320","2016",5,5,0,123767,791.8,135.6
"21062","65322","2016",6,6,0,158583.3,1406.5,114.8333
"21063","65324","2016",2,2,0,159000,1442,114
"21064","65326","2016",3,3,0,155000,1582.333,96
"21065","65327","2016",4,4,0,110862.5,1281.75,95.25
"21066","65328","2016",2,2,0,118900,973.5,119
"21067","65329","2016",7,7,0,105236.1,1347.714,80.14286
"21068","65330","2016",3,3,0,196166.7,1568.333,129.6667
"21069","65331","2016",24,23,1,166955.1,1660.958,105.4583
"21070","65332","2016",3,3,0,190700,1582,121
"21071","65333","2016",1,1,0,218500,1150,190
"21072","65334","2016",2,2,0,180000,1924,93
"21073","65335","2016",9,9,0,164852.2,1542,110.4444
"21074","65337","2016",1,1,0,226040,1739,130
"21075","65338","2016",1,1,0,163000,1895,86
"21076","65339","2016",2,2,0,1e+05,1344,81.5
"21077","65340","2016",23,23,0,148638,1498.609,101.3043
"21078","65341","2016",2,2,0,92900,1287,69
"21079","65342","2016",1,1,0,115000,1065,108
"21080","65344","2016",13,13,0,183884.6,1432.923,131.5385
"21081","65345","2016",2,2,0,95000,1362.5,58.5
"21082","65347","2016",1,1,0,178000,1447,123
"21083","65350","2016",11,11,0,129686.3,1601.545,80.63636
"21084","65351","2016",1,1,0,115650,1314,88
"21085","65352","2016",2,2,0,230000,1547,150
"21086","65353","2016",3,3,0,105000,1278.667,83.33333
"21087","65355","2016",1,1,0,250000,1389,180
"21088","65356","2016",1,1,0,80000,860,93
"21089","65361","2016",1,1,0,191000,1690,113
"21090","65362","2016",12,9,3,129066.7,1511.917,88.08333
"21091","65363","2016",2,2,0,78000,900.5,118
"21092","65366","2016",5,5,0,118600,953.8,127.8
"21093","65369","2016",4,4,0,146487.5,1338.75,111
"21094","65370","2016",8,7,1,100025.4,1016.5,96.625
"21095","65371","2016",1,1,0,105000,1750,60
"21096","65372","2016",2,2,0,148650,1797.5,84.5
"21097","65373","2016",3,3,0,243000,1375.333,160
"21098","65374","2016",1,1,0,92800,603,154
"21099","65375","2016",17,17,0,89991.18,961.5882,91.82353
"21100","65376","2016",2,2,0,157798,923.5,166
"21101","65377","2016",2,2,0,88500,1336,66.5
"21102","65378","2016",1,1,0,120000,1579,76
"21103","65382","2016",1,1,0,71000,425,167
"21104","65383","2016",1,1,0,145000,1036,140
"21105","65386","2016",1,1,0,43000,1000,43
"21106","65388","2016",116,3,113,91202.22,2323.147,38.02586
"21107","65389","2016",14,12,2,123857.5,1172.357,107.6429
"21108","65390","2016",3,3,0,185333.3,1247.667,149.3333
"21109","65393","2016",4,4,0,125512.5,1242.75,107
"21110","65394","2016",2,2,0,62500,583.5,110
"21111","65395","2016",14,10,4,89073.07,930.5714,101.8571
"21112","65396","2016",5,2,3,137080,2231,66.8
"21113","65397","2016",2,2,0,112375,736,187
"21114","65398","2016",7,7,0,111957.1,1308.286,88.71429
"21115","65400","2016",2,2,0,143000,1621,89
"21116","65401","2016",7,7,0,235254.9,1985.286,118.7143
"21117","65403","2016",1,1,0,202800,1763,115
"21118","65404","2016",1,1,0,290000,1160,250
"21119","65405","2016",2,2,0,129660,1562,100.5
"21120","65406","2016",2,2,0,92500,999.5,93
"21121","65408","2016",3,1,2,60666.67,812,84.66667
"21122","65409","2016",1,1,0,165000,1435,115
"21123","65410","2016",2,2,0,297425,1825,158
"21124","65412","2016",2,2,0,102000,1065.5,95
"21125","65413","2016",7,5,2,120823.6,2208.714,69
"21126","65415","2016",4,4,0,146287.5,1478.5,118.25
"21127","65416","2016",1,1,0,84000,1273,66
"21128","65417","2016",47,41,6,143660.7,1466.596,99.02128
"21129","65418","2016",4,4,0,146000,1122.25,127.25
"21130","65420","2016",2,2,0,292750,2050.5,138.5
"21131","65421","2016",1,1,0,140000,1273,110
"21132","65422","2016",2,2,0,178500,1216.5,148
"21133","65424","2016",5,1,4,138300,2549.6,57.4
"21134","65425","2016",3,3,0,170366.7,1004.667,167
"21135","65427","2016",4,4,0,87750,1017.25,92.25
"21136","65428","2016",2,2,0,233750,1886.5,125
"21137","65429","2016",3,3,0,153633.3,1235.667,137.3333
"21138","65431","2016",1,1,0,105000,1250,84
"21139","65432","2016",1,1,0,62000,596,104
"21140","65433","2016",35,27,8,121052.3,1419.971,87.05714
"21141","65435","2016",2,2,0,135000,2012,66.5
"21142","65437","2016",1,1,0,80000,1818,44
"21143","65438","2016",1,1,0,50000,610,82
"21144","65439","2016",3,3,0,164666.7,1437,111.6667
"21145","65440","2016",636,177,459,91499.44,1235.947,75.49057
"21146","65441","2016",1,1,0,135000,1125,120
"21147","65444","2016",2,2,0,92555,1077.5,77.5
"21148","65445","2016",3,3,0,149080,1452.667,106
"21149","65446","2016",4,4,0,137487.5,1395.25,93.25
"21150","65447","2016",12,12,0,86587.5,1184.583,75.91667
"21151","65451","2016",10,10,0,152232,1332.1,122
"21152","65452","2016",8,8,0,106387.5,972.625,118.5
"21153","65453","2016",3,3,0,64650,802.6667,83.33333
"21154","65455","2016",4,3,1,153275,1273.25,125.25
"21155","65456","2016",3,3,0,141140,1428.667,98
"21156","65458","2016",1,1,0,269400,2072,130
"21157","65460","2016",51,47,4,127580,1283.039,101.9804
"21158","65461","2016",1,1,0,79400,1059,75
"21159","65462","2016",1,1,0,138000,1150,120
"21160","65463","2016",3,3,0,124586.7,2637.667,49
"21161","65464","2016",2,2,0,231750,1648.5,137.5
"21162","65465","2016",25,4,21,103969.6,2377.24,44.6
"21163","65467","2016",3,3,0,180266.7,2564.667,71.33333
"21164","65468","2016",1,1,0,210150,1078,195
"21165","65469","2016",1,1,0,52600,974,54
"21166","65470","2016",2,2,0,111000,1131,100
"21167","65471","2016",8,3,5,153320.6,2679.625,56.25
"21168","65473","2016",3,3,0,96166.67,1356,81.33333
"21169","65477","2016",1,1,0,67000,893,75
"21170","65478","2016",1,1,0,44680,648,69
"21171","65479","2016",1,1,0,142550,1584,90
"21172","65481","2016",17,0,17,70160,2215.882,31.05882
"21173","65482","2016",2,2,0,141720,1489,95.5
"21174","66001","2016",1,1,0,215000,1792,120
"21175","66002","2016",39,36,3,195982.6,2077.282,94.53846
"21176","66003","2016",149,29,120,77033.32,1375.859,54.12081
"21177","66004","2016",130,35,95,111528.8,2310.538,46.15385
"21178","66005","2016",9,7,2,141466.7,2000.667,71.77778
"21179","66006","2016",4,4,0,103250,1201,107
"21180","66007","2016",1,1,0,105000,1591,66
"21181","66008","2016",382,135,247,145149,2957.505,52.65707
"21182","66010","2016",1,1,0,35000,593,59
"21183","66011","2016",57,49,8,161441.1,1779.702,89.54386
"21184","66012","2016",31,25,6,171382.3,1894.968,91.06452
"21185","66013","2016",2,2,0,45000,969.5,40.5
"21186","66014","2016",34,31,3,129464.7,1467.294,89.47059
"21187","66015","2016",19,17,2,165231.6,1810.158,88.05263
"21188","66016","2016",99,42,57,160425.1,2684.313,62.86869
"21189","66017","2016",431,121,310,99214.72,2588.81,39.35731
"21190","66019","2016",7,7,0,154828.6,1614.143,98.14286
"21191","66020","2016",77,30,47,140767.1,2841.792,48.15584
"21192","66021","2016",66,64,2,171644.4,1821.985,97.21212
"21193","66022","2016",1,1,0,68000,1889,36
"21194","66023","2016",7,6,1,138214.3,1590.857,89.57143
"21195","66024","2016",103,73,30,173142.8,2100.058,83.13592
"21196","66025","2016",18,8,10,122333.3,1984.611,63.05556
"21197","66026","2016",14,14,0,256025.4,2498.429,101
"21198","66027","2016",4,4,0,193971.8,2267.25,90.25
"21199","66028","2016",101,85,16,192076.5,2094.713,92.65347
"21200","66030","2016",6,6,0,198500,1812.333,108.5
"21201","66032","2016",2,2,0,36750,738,54
"21202","66033","2016",4,4,0,155310,1635.25,89.5
"21203","66034","2016",1,1,0,80000,1081,74
"21204","66037","2016",500,125,375,135731.5,2763.364,51.268
"21205","66038","2016",67,63,4,191205.1,2005.299,96.68657
"21206","66039","2016",5,4,1,50400,794.6,68
"21207","66041","2016",11,11,0,173909.5,1879.455,90.45455
"21208","66042","2016",4,4,0,82250,847.75,109
"21209","66043","2016",2,2,0,121500,1589,67.5
"21210","66045","2016",12,12,0,186550.4,1740.5,107.1667
"21211","66046","2016",6,5,1,87250,879.6667,92.83333
"21212","66047","2016",1,1,0,45000,900,50
"21213","66048","2016",26,11,15,143209.8,2611.077,57.84615
"21214","66049","2016",103,75,28,192874.2,2217.388,88.84466
"21215","66050","2016",44,39,5,178515.9,2198.114,79.45455
"21216","66051","2016",3,3,0,112333.3,1345.333,84
"21217","66052","2016",4,4,0,105750,1367.25,84
"21218","66053","2016",69,25,44,242503.8,4107.087,63.27536
"21219","66054","2016",3,3,0,53333.33,1568.667,38.33333
"21220","66055","2016",10,10,0,132200,1683.3,83.7
"21221","66056","2016",13,13,0,157815.4,1627.154,93.53846
"21222","66057","2016",8,6,2,125103.1,1377.125,97.375
"21223","66058","2016",32,31,1,216370.6,1918.125,105.3125
"21224","66059","2016",19,18,1,192402.6,1961.053,99.63158
"21225","66060","2016",5,4,1,166862,1586.6,97.8
"21226","66062","2016",7,6,1,179442.9,2476.571,72.42857
"21227","66063","2016",1,1,0,57600,823,70
"21228","66064","2016",5,2,3,107100,1522.2,72.2
"21229","66065","2016",92,75,17,155047.4,1776.304,88.58696
"21230","66066","2016",12,6,6,118725,1643,74.66667
"21231","66067","2016",13,5,8,129100,1977.692,67.15385
"21232","66068","2016",3,3,0,76000,854,82.66667
"21233","66069","2016",28,26,2,164376.6,1738.214,96.39286
"21234","66070","2016",3,3,0,127000,1499.667,80.33333
"21235","66071","2016",26,26,0,87423.08,1186.923,75.53846
"21236","66072","2016",16,10,6,166219.1,2400.188,75
"21237","66073","2016",2,2,0,59500,915,63.5
"21238","66074","2016",4,4,0,206402.2,2225,103.25
"21239","66075","2016",16,10,6,121012.2,2240.312,53.4375
"21240","66077","2016",1,1,0,115000,1554,74
"21241","66078","2016",4,3,1,94000,1431,72
"21242","66079","2016",1,1,0,141590,2145,66
"21243","66080","2016",3,3,0,54000,1297.333,42
"21244","66081","2016",3,3,0,128980,1429,92.33333
"21245","66082","2016",20,12,8,138172.2,1866.85,84.5
"21246","66084","2016",23,23,0,158614.8,1583.957,102.087
"21247","66085","2016",7,7,0,177310.7,1756.429,98
"21248","66086","2016",1,1,0,36000,1029,35
"21249","66088","2016",51,43,8,126936.6,1498.49,84.35294
"21250","66089","2016",3,3,0,241655,2164.667,117
"21251","66090","2016",2,2,0,150000,1893,76
"21252","66091","2016",5,3,2,85660,1247,63.2
"21253","66092","2016",1,1,0,56500,1345,42
"21254","66093","2016",42,40,2,277179.8,2591.929,113.5714
"21255","66094","2016",43,40,3,185760.5,2306.233,88.25581
"21256","66095","2016",5,4,1,201725,2124.4,91
"21257","66096","2016",14,13,1,122514.3,1108.571,108
"21258","66097","2016",2,2,0,140305,1018.5,135.5
"21259","66098","2016",8,6,2,125562.5,1778.375,77
"21260","66099","2016",4,4,0,267500,1983.5,130.25
"21261","66100","2016",6,5,1,160350,1270,106.3333
"21262","66101","2016",22,21,1,180368.2,2302.545,86.77273
"21263","66103","2016",7,7,0,97187.86,1181.714,82.42857
"21264","66104","2016",10,10,0,205035,1780.5,115.2
"21265","66105","2016",6,6,0,164050,2095.667,76.83333
"21266","66106","2016",39,37,2,151951.4,1687.769,88.97436
"21267","66107","2016",8,8,0,133500,1078.875,113.5
"21268","66108","2016",39,36,3,156025.7,1878.333,91.79487
"21269","66109","2016",6,5,1,111074.2,1601.167,75.66667
"21270","66111","2016",5,5,0,172400,1680.8,102.2
"21271","66112","2016",3,3,0,270000,2099,128.3333
"21272","66113","2016",3,3,0,277666.7,2473.667,113
"21273","66114","2016",16,16,0,258725,2056.375,126.3125
"21274","66115","2016",16,16,0,242015.5,2219.938,101.8125
"21275","66116","2016",5,4,1,210611.2,2609.8,71.2
"21276","66117","2016",3,1,2,151666.7,1218.667,142.6667
"21277","66118","2016",9,9,0,117838.3,1845.778,68.11111
"21278","66119","2016",7,7,0,70571.43,1024.429,65
"21279","66120","2016",1,1,0,357010,2532,141
"21280","66121","2016",23,21,2,119587,1590.609,78.91304
"21281","66122","2016",3,3,0,68333.33,904.3333,69.66667
"21282","66123","2016",1,1,0,29000,690,42
"21283","66124","2016",115,24,91,98677.89,1999.104,49.73913
"21284","66125","2016",5,5,0,77800,1157.6,66
"21285","66126","2016",9,8,1,199427.8,1504,127.5556
"21286","66127","2016",18,17,1,145762.7,1363.889,101.5556
"21287","66128","2016",1,1,0,90000,687,131
"21288","66129","2016",18,17,1,153373.9,1672.389,87.88889
"21289","66130","2016",35,15,20,135556.3,1883.829,71.54286
"21290","66132","2016",9,7,2,211944.4,3099.111,71
"21291","66133","2016",34,33,1,195207.1,2186.647,87.55882
"21292","66134","2016",14,13,1,150149.4,1383,107.2143
"21293","66136","2016",1662,441,1221,115318,1488.633,75.76534
"21294","66137","2016",4,2,2,107653.2,1396,91.5
"21295","66138","2016",16,16,0,123409.4,1545.188,82.8125
"21296","66139","2016",1,1,0,230000,2556,90
"21297","66140","2016",38,36,2,148194.6,1718.105,85.02632
"21298","66141","2016",68,63,5,184706.5,1817.529,100.7647
"21299","66143","2016",1,1,0,2e+05,1212,165
"21300","66144","2016",39,33,6,185673,1963.513,97.79487
"21301","66145","2016",33,31,2,198795.5,2064.788,103.1515
"21302","66146","2016",2,1,1,103999.5,1338.5,72.5
"21303","66147","2016",10,2,8,70575.5,1210.4,55.9
"21304","66148","2016",63,24,39,178163.8,2607.381,68.57143
"21305","66149","2016",70,48,22,119575.5,1448.014,82.47143
"21306","66150","2016",23,12,11,98327.83,1195.174,78.3913
"21307","66152","2016",1,1,0,60000,508,118
"21308","66154","2016",9,9,0,100066.7,2203,56.33333
"21309","66155","2016",2,2,0,38000,667,54
"21310","66156","2016",3,3,0,38000,397.6667,95.66667
"21311","66157","2016",1,1,0,55000,1100,50
"21312","66158","2016",2,2,0,52980,1073,49
"21313","66159","2016",1,1,0,130900,3445,38
"21314","66160","2016",21,19,2,228753.3,1995.714,118.1905
"21315","66161","2016",13,13,0,121024.2,1429.231,90.92308
"21316","66162","2016",14,14,0,183220.7,2386.643,88.14286
"21317","66164","2016",74,67,7,154385.8,1802.23,90.41892
"21318","66165","2016",13,13,0,121472.4,1375.846,92.69231
"21319","66166","2016",4,4,0,84078.25,1208.75,68.75
"21320","66167","2016",14,8,6,142201.8,2278.643,68.57143
"21321","66168","2016",45,41,4,208421.2,2338.933,90.6
"21322","66169","2016",2,2,0,159447.5,1555.5,96.5
"21323","66171","2016",434,200,234,153260.4,2994.671,55.22811
"21324","66172","2016",145,89,56,153627.2,1891.31,80.04828
"21325","66173","2016",15,14,1,148542.7,1629.533,87.86667
"21326","66174","2016",26,25,1,200000.4,2006.038,98.38462
"21327","66175","2016",37,36,1,211957.4,2545.514,84.13514
"21328","66176","2016",45,42,3,193375.2,1970.644,93.6
"21329","66177","2016",14,14,0,173373.6,1955.286,89.14286
"21330","66178","2016",27,24,3,149174.1,1732,85.88889
"21331","66179","2016",15,12,3,68427.67,783.7333,93.66667
"21332","66180","2016",130,121,9,161198.3,1895.654,84.23077
"21333","66181","2016",6,1,5,127250,2325,53.33333
"21334","66182","2016",113,85,28,161027.6,2975.177,59.38938
"21335","66184","2016",1,1,0,54500,973,56
"21336","66185","2016",3,3,0,246673.3,2425,99
"21337","66186","2016",25,24,1,193714.6,1931.56,105.48
"21338","66187","2016",21,17,4,96033.52,1130.429,85.80952
"21339","66188","2016",17,5,12,88521.76,1714,52.35294
"21340","66189","2016",62,51,11,210739.8,2182.145,96.43548
"21341","66190","2016",37,36,1,128634.8,1607.703,80.56757
"21342","66191","2016",2,2,0,118750,1118.5,105.5
"21343","66192","2016",2,2,0,195127.5,1866.5,143.5
"21344","66193","2016",5,5,0,77000,1040.8,78.2
"21345","66194","2016",5,5,0,128700,1384.2,99.8
"21346","66195","2016",76,75,1,171627.4,2012.145,86.27632
"21347","66196","2016",46,44,2,201818.9,2460.739,88.02174
"21348","66198","2016",6,6,0,90775,1225.333,76
"21349","66199","2016",1,1,0,150000,1220,123
"21350","66201","2016",1,1,0,50000,543,92
"21351","66202","2016",5,0,5,65800,1834.2,37.2
"21352","66203","2016",2,2,0,119000,1034,113
"21353","66204","2016",4,4,0,134065,1348.75,95.75
"21354","66205","2016",7,7,0,121271.4,1327.571,87.28571
"21355","66206","2016",1,1,0,78000,780,100
"21356","66207","2016",4,4,0,207500,1932,107
"21357","66208","2016",15,13,2,193218.1,1925.267,107.5333
"21358","66209","2016",2,2,0,60000,779.5,75.5
"21359","66210","2016",65,54,11,148506.7,1926.631,77.07692
"21360","66211","2016",3,3,0,184000,1912.667,96
"21361","66212","2016",104,94,10,164887.4,2235.538,76.125
"21362","66213","2016",54,50,4,216002.4,2108.241,100.2037
"21363","66214","2016",20,19,1,153405.8,1737.4,88.65
"21364","66215","2016",1,1,0,270000,3333,81
"21365","66217","2016",33,30,3,137350.9,1598.212,83.18182
"21366","66218","2016",12,9,3,200658.3,1950.25,101.5833
"21367","66219","2016",1,1,0,65000,481,135
"21368","66222","2016",39,16,23,101421.5,1456.538,64.15385
"21369","66223","2016",7,6,1,96105.71,1209.143,86.57143
"21370","66224","2016",18,16,2,161277.8,1805.111,85.88889
"21371","66225","2016",24,22,2,248354.6,2472.458,101.7917
"21372","66226","2016",9,9,0,143366.7,2023.444,82.55556
"21373","66227","2016",33,29,4,243442.1,2333.485,102.0303
"21374","66230","2016",25,19,6,152173.6,1550,99.24
"21375","66231","2016",6,6,0,100333.3,1003,91.66667
"21376","66232","2016",1,1,0,55000,647,85
"21377","66233","2016",1,1,0,191000,1516,126
"21378","66234","2016",2,2,0,80000,845,94
"21379","69001","2016",4,4,0,173100,1622.25,106.25
"21380","69002","2016",3,3,0,68000,844.3333,85
"21381","69003","2016",35,26,9,259377.6,2614.257,99.6
"21382","69004","2016",13,7,6,237355.4,2316.538,103.9231
"21383","69005","2016",6,5,1,279005,2718.833,104.3333
"21384","69006","2016",50,39,11,99279.04,1250.9,83.16
"21385","69007","2016",17,11,6,233504.7,2235.706,100.3529
"21386","69008","2016",4,4,0,147750,1538,105.75
"21387","69009","2016",81,50,31,224857.5,2482.247,92.88889
"21388","69010","2016",105,36,69,180554.9,2201.2,82.93333
"21389","69012","2016",7,7,0,181037.1,1472.286,133.7143
"21390","69013","2016",37,25,12,192395.4,1794.216,117.1351
"21391","69014","2016",9,9,0,139772.2,1688.222,89.66667
"21392","69016","2016",1,1,0,35000,614,57
"21393","69017","2016",5,5,0,282000,2168.4,132.8
"21394","69018","2016",17,9,8,96148.24,1139.941,82.47059
"21395","69019","2016",130,81,49,173027.2,2007.077,88.16923
"21396","69020","2016",3,3,0,320900,2968,107.3333
"21397","69021","2016",38,22,16,157531.3,2974.974,69.68421
"21398","69022","2016",6,6,0,187826.7,1953,100.1667
"21399","69023","2016",19,18,1,250326.7,2170.368,116.5789
"21400","69024","2016",47,41,6,228943.3,2201.723,106.9362
"21401","69026","2016",4,4,0,262085,1721,147.25
"21402","69027","2016",110,59,51,264046.1,2879.409,92.50909
"21403","69028","2016",78,54,24,324089.2,3138.551,104.2179
"21404","69029","2016",460,96,364,199454.1,2516.387,77.57174
"21405","69030","2016",6,4,2,110400,1217.167,85.33333
"21406","69031","2016",16,16,0,229103.1,1928.75,123.75
"21407","69032","2016",25,20,5,236920.7,2379.92,96.48
"21408","69033","2016",40,36,4,314155.7,2875.525,112.275
"21409","69034","2016",655,78,577,251635,3104.24,79.7542
"21410","69035","2016",5,5,0,178600,1760.6,107.2
"21411","69036","2016",7,7,0,201907.1,1812.714,111.7143
"21412","69037","2016",8,8,0,177676.2,1970.125,92.5
"21413","69038","2016",12,12,0,106962.5,1330.75,87
"21414","69039","2016",9,9,0,187287.8,1871.667,109.4444
"21415","69040","2016",64,26,38,326647.7,3366.984,98.71875
"21416","69042","2016",5,5,0,201340,2199.6,93.8
"21417","69043","2016",81,51,30,302969,3101.765,96.69136
"21418","69044","2016",57,32,25,443821.3,3862.263,112.6316
"21419","69045","2016",16,14,2,218454.4,2159.688,105.625
"21420","69046","2016",43,36,7,382439.8,3113.14,123
"21421","69047","2016",10,9,1,322882,2942.4,115.3
"21422","69049","2016",38,25,13,333813.2,3138.053,107.2632
"21423","69050","2016",28,20,8,236685.4,2400.714,99.32143
"21424","69051","2016",8,6,2,246783.4,2768.75,94.125
"21425","69052","2016",38,28,10,281317.1,2983.132,93.5
"21426","69053","2016",3,3,0,168583.3,1754.667,95.33333
"21427","69054","2016",3,3,0,109000,1100.667,96
"21428","69055","2016",22,18,4,317450.9,2493.364,129.1364
"21429","69056","2016",29,22,7,237375.6,2366.448,105.2069
"21430","69057","2016",5,5,0,211931,3064,83.2
"21431","69059","2016",26,22,4,280502.5,2814.769,102.8077
"21432","69060","2016",6,6,0,91525,992.8333,82.5
"21433","69061","2016",12,12,0,244414.8,2262.5,111.6667
"21434","69062","2016",1,1,0,187000,2367,79
"21435","69063","2016",69,48,21,431479.8,3573.101,121.1594
"21436","69064","2016",46,29,17,170886.9,2136.652,81.63043
"21437","69065","2016",6,6,0,209308.3,1925,110.5
"21438","69066","2016",28,26,2,91700.36,1007.893,95.28571
"21439","69067","2016",11,10,1,130102.3,1454.273,96.72727
"21440","69068","2016",33,24,9,270654.8,2885.667,94.81818
"21441","69069","2016",140,55,85,265117.6,2976.35,89.01429
"21442","69070","2016",11,11,0,146942.7,1605.364,96.54545
"21443","69071","2016",10,9,1,365486,3421.5,109.5
"21444","69072","2016",109,68,41,359537.9,3089.404,114.8716
"21445","69074","2016",10,9,1,203600,2091,96.9
"21446","69075","2016",1,1,0,110000,1528,72
"21447","69076","2016",26,24,2,447185.9,3177.538,143.5769
"21448","69077","2016",9,9,0,196423.3,1995.444,106.6667
"21449","69078","2016",12,11,1,169974.2,1707.083,96.66667
"21450","69080","2016",18,15,3,245870.6,2644.944,98.61111
"21451","69081","2016",227,48,179,309016,3134.863,97.08811
"21452","69082","2016",6,6,0,153608.3,1283,123.3333
"21453","69083","2016",9,9,0,343896.7,3260.889,130.8889
"21454","69084","2016",5,5,0,208210,1908.6,107
"21455","69085","2016",20,14,6,284356.1,2765.05,100.05
"21456","69086","2016",27,18,9,265526.1,2550.963,101.4074
"21457","69087","2016",33,19,14,315530.7,2949.455,104.697
"21458","69088","2016",108,22,86,236566.4,2716.731,83.36111
"21459","69089","2016",189,57,132,262254.7,2904.201,88.63492
"21460","69090","2016",8,8,0,208101.2,2291.75,94.375
"21461","69091","2016",132,73,59,158879.8,1859.545,85.58333
"21462","69092","2016",66,40,26,211286.1,2085.879,97.93939
"21463","69093","2016",24,19,5,118591.8,1238.375,99.45833
"21464","69094","2016",71,38,33,271878.1,2708.831,99.12676
"21465","69095","2016",4,4,0,208750,1665.5,134
"21466","69096","2016",105,53,52,175432.8,2161.429,81.12381
"21467","69097","2016",6,6,0,237635,2364.5,106.5
"21468","69098","2016",2,2,0,155225,1951.5,82
"21469","69099","2016",5,5,0,173300,1569.2,113.2
"21470","69100","2016",77,38,39,231881.1,2643.753,86.36364
"21471","69102","2016",7,7,0,181750,1607,111.4286
"21472","69103","2016",13,13,0,158476.5,1570.308,102.7692
"21473","69104","2016",2,2,0,88250,1134.5,74.5
"21474","69105","2016",11,9,2,229882.3,2218.909,114.5455
"21475","69106","2016",15,12,3,318354.3,2665.467,123.8
"21476","69107","2016",11,8,3,122654.5,1269.273,95.27273
"21477","69108","2016",8,8,0,204506.2,2204.5,98.625
"21478","69109","2016",8,8,0,150192.5,1490,102.875
"21479","69110","2016",14,14,0,184942.1,1723.286,100.2857
"21480","69111","2016",10,8,2,236285,2110.2,108.1
"21481","69112","2016",109,53,56,246984.9,2544.734,98.22018
"21482","69113","2016",6,6,0,196048.2,1560,141.6667
"21483","69115","2016",48,30,18,231057.2,2268.604,99.16667
"21484","69116","2016",47,38,9,486189,3730.957,132.7234
"21485","69117","2016",41,36,5,333225.6,2868.927,120.8537
"21486","69118","2016",15,11,4,190373.3,2056.6,92.46667
"21487","69119","2016",5,5,0,158000,1518,107.2
"21488","69120","2016",3,3,0,107250,1140,94.66667
"21489","69121","2016",30,20,10,247221,2716.633,96.26667
"21490","69122","2016",15,13,2,364324.7,3080.4,121.0667
"21491","69123","2016",7204,185,7019,229879.2,3454.942,67.38298
"21492","69124","2016",4,4,0,141750,1147.75,124.25
"21493","69125","2016",7,6,1,282647.6,2339.571,120.2857
"21494","69126","2016",5,4,1,271170,2842.8,96.2
"21495","69127","2016",26,16,10,286428.5,3228.808,91.19231
"21496","69130","2016",1,1,0,220000,1100,200
"21497","69131","2016",26,12,14,223295.5,2812.423,80.76923
"21498","69132","2016",8,7,1,139206.2,1319.875,111.375
"21499","69133","2016",44,36,8,374042.2,3218.136,119.4318
"21500","69134","2016",1,1,0,219000,2086,105
"21501","69135","2016",14,14,0,106743.6,1176.571,87.71429
"21502","69136","2016",27,21,6,237264.4,2372.37,100
"21503","69137","2016",3,3,0,275833.3,1966.667,141
"21504","69138","2016",3,3,0,274666.7,1877.333,145.6667
"21505","69139","2016",16,13,3,155272.5,1642.438,92.1875
"21506","69140","2016",25,17,8,280972,2451.96,110.92
"21507","69141","2016",62,41,21,255701.3,2788.645,93.27419
"21508","69142","2016",89,8,81,231801.3,2466.775,82.13483
"21509","69143","2016",80,31,49,234679.1,2794.412,85.4
"21510","69145","2016",6,6,0,163283.3,1706.167,101
"21511","69148","2016",27,21,6,284686.7,2644.333,112.1852
"21512","69149","2016",420,62,358,175012.9,2451.938,72.65952
"21513","69151","2016",8,8,0,246032.5,1894,148.125
"21514","69152","2016",109,32,77,158313.1,2155.706,74.82569
"21515","69153","2016",7,6,1,418525.7,3157.571,134.8571
"21516","69154","2016",52,24,28,224061.1,2177.423,99.09615
"21517","69155","2016",10,10,0,237735,1987.9,124.3
"21518","69157","2016",31,21,10,185306.9,1861.806,102.3871
"21519","69159","2016",10,9,1,279712.5,2589.8,108
"21520","69160","2016",5,5,0,114600,1719,74.6
"21521","69161","2016",6,6,0,129221.7,1138.5,120.3333
"21522","69162","2016",11,11,0,205677.7,1784.182,117.3636
"21523","69163","2016",32,28,4,290156.9,2651.688,111.6875
"21524","69164","2016",3,3,0,104583.3,918.3333,111.3333
"21525","69165","2016",13,13,0,199980,1838.692,109.2308
"21526","69166","2016",8,7,1,221537.5,2034.875,113.25
"21527","69167","2016",3,3,0,323933.3,2593.667,127.3333
"21528","69168","2016",13,9,4,394752.3,3649.308,109.4615
"21529","69169","2016",5,5,0,141000,1400,103.6
"21530","69170","2016",13,12,1,285918.5,2530.692,121
"21531","69171","2016",21,12,9,180757.3,2377.619,83.47619
"21532","69172","2016",6,6,0,231166.7,1955.667,117.5
"21533","69173","2016",11,8,3,200662.7,1869.273,110.9091
"21534","69174","2016",5,4,1,94400,1240.8,80.4
"21535","69175","2016",14,14,0,171396.4,1414.929,119.0714
"21536","69176","2016",51,40,11,282541,2902.529,100.0588
"21537","69177","2016",23,22,1,259488,2527.522,107.3043
"21538","69178","2016",2,2,0,252150,2072,123.5
"21539","69179","2016",40,33,7,239545.1,2470.125,98.275
"21540","69180","2016",4,3,1,178400,1376.25,130
"21541","69181","2016",3,3,0,108850,1674.333,70.33333
"21542","69182","2016",7,7,0,88071.43,853,106.8571
"21543","69183","2016",2,2,0,149100,1499.5,98.5
"21544","69184","2016",6,6,0,179606.7,1971,93.83333
"21545","69186","2016",4,4,0,110750,1293.75,80.5
"21546","69187","2016",3,3,0,119333.3,1545.667,79
"21547","69188","2016",6,6,0,230951.7,2026.833,117.3333
"21548","69189","2016",23,7,16,171543.9,2353.739,72.43478
"21549","69190","2016",19,15,4,335459.7,3376.158,112.2105
"21550","69191","2016",76,58,18,553850.7,3948.868,141.1316
"21551","69192","2016",1,1,0,239150,2174,110
"21552","69193","2016",9,9,0,317532.6,2465.556,130.6667
"21553","69194","2016",89,56,33,564494.3,4120.034,143.2921
"21554","69196","2016",5,4,1,139348,1317.8,106
"21555","69197","2016",13,13,0,222256.8,1958,115.2308
"21556","69198","2016",5,5,0,210838,2103.8,97.2
"21557","69199","2016",105,34,71,147088.6,2126.962,70.85714
"21558","69200","2016",14,11,3,171555,1952.286,94.14286
"21559","69201","2016",11,7,4,131081.3,1375.909,109.8182
"21560","69202","2016",324,69,255,283024.3,2949.469,91.37963
"21561","69203","2016",13,9,4,136756.9,1415.154,92.23077
"21562","69204","2016",217,77,140,246679.2,2844.539,84.4977
"21563","69205","2016",53,38,15,300383.6,3075.302,100.1509
"21564","69206","2016",37,30,7,186838.6,1911.865,101.7838
"21565","69207","2016",31,23,8,291127.8,3232.29,92.03226
"21566","69208","2016",28,23,5,257891.2,2208.464,115.9286
"21567","69209","2016",4,4,0,98050,929.25,105
"21568","69212","2016",7,6,1,310137.1,3221.429,95.71429
"21569","69214","2016",11,11,0,149800,1560.182,95.09091
"21570","69215","2016",9,7,2,156181.7,1558.222,98.77778
"21571","69216","2016",4,4,0,165237.5,1722,92.25
"21572","69217","2016",10,10,0,125725,1461.7,94.6
"21573","69218","2016",7,5,2,244275.7,1721.714,144.8571
"21574","69219","2016",23,16,7,234334,2647.652,89.6087
"21575","69220","2016",18,15,3,129062.8,1450.944,92.44444
"21576","69225","2016",3,3,0,140566.7,1887.333,85.33333
"21577","69227","2016",20,20,0,239779.8,2295.8,106.05
"21578","69228","2016",39,32,7,222796.7,2269.795,101.5897
"21579","69229","2016",13,13,0,148978.5,1453.769,103.0769
"21580","69230","2016",2,2,0,146000,1739.5,91.5
"21581","69231","2016",20,17,3,306103,2604.3,116.2
"21582","69233","2016",13,10,3,333470.8,3211.769,102.4615
"21583","69234","2016",13,13,0,227942.3,1909.462,117.2308
"21584","69235","2016",23,9,14,196990.7,2349.435,83.65217
"21585","69236","2016",10,9,1,173500,1813.4,95.3
"21586","69238","2016",46,34,12,160288.8,1734.174,97.5
"21587","69239","2016",11,11,0,252861.4,2345.727,115.2727
"21588","69240","2016",6,6,0,110993.3,1056.5,111.8333
"21589","69241","2016",32,20,12,254342.5,2598.438,101.6875
"21590","69242","2016",11,10,1,216651.8,1949.909,113.4545
"21591","69243","2016",89,50,39,150661.3,1652.022,96.53933
"21592","69244","2016",379,59,320,248504.7,3022.863,79.89974
"21593","69245","2016",9,8,1,219577.8,1944.667,114.2222
"21594","69246","2016",13,8,5,212725.4,2441.154,94.38462
"21595","69248","2016",43,34,9,108546.8,1231.907,90.53488
"21596","69249","2016",23,16,7,214463,2588.826,82.86957
"21597","69250","2016",46,34,12,363763.5,3204.761,117.087
"21598","69252","2016",5,5,0,235400,2300.2,105.4
"21599","69253","2016",4,4,0,252625,3716.75,76.5
"21600","69254","2016",14,14,0,129468.6,1426.571,101.1429
"21601","69255","2016",58,47,11,246366.8,2578.172,95.2931
"21602","69256","2016",277,88,189,157745.2,2214.888,72.19495
"21603","69257","2016",17,15,2,172333.8,1652.882,109.1765
"21604","69258","2016",5,5,0,129728,1204.4,105.6
"21605","69259","2016",447,99,348,161247.4,2260.624,71.3736
"21606","69260","2016",39,26,13,263891.9,2748.59,98.84615
"21607","69263","2016",13,13,0,105392.3,1135.077,89.38462
"21608","69264","2016",449,100,349,147094.9,1955.332,75.03786
"21609","69265","2016",12,12,0,280564.2,2278.417,123.9167
"21610","69266","2016",2150,153,1997,178277.9,2805.682,63.8414
"21611","69267","2016",15,14,1,216960.7,1899.4,120.8
"21612","69268","2016",32,20,12,330700.9,3221.562,101.625
"21613","69269","2016",9,7,2,239722.2,2472.111,99
"21614","69270","2016",45,32,13,318647.5,2873.956,112.2
"21615","69271","2016",105,66,39,321957.8,3356.314,96.4
"21616","69272","2016",42,33,9,301308.4,2920.762,106.4524
"21617","69273","2016",106,63,43,238082,2809.509,85.49057
"21618","69275","2016",249,69,180,193693.1,2609.928,75.21285
"21619","69276","2016",98,50,48,203974.6,2420.367,83.52041
"21620","69277","2016",110,82,28,320977.2,3211.691,104.3182
"21621","69278","2016",62,44,18,278347.9,2623.677,106.1452
"21622","69279","2016",48,45,3,313504.8,3077.833,100.375
"21623","69280","2016",8,7,1,269056.2,2612.375,103.75
"21624","69281","2016",14,12,2,281632.9,2202.786,129
"21625","69282","2016",334,184,150,238483.7,2829.56,84.08982
"21626","69283","2016",104,79,25,244026.5,2816.394,88.77885
"21627","69284","2016",19,19,0,412559.2,3613.053,121.2632
"21628","69285","2016",47,37,10,250014.6,2684.149,96.80851
"21629","69286","2016",203,96,107,249310.4,2626.916,93.65517
"21630","69287","2016",75,54,21,290260.6,2918.093,101.6267
"21631","69288","2016",61,42,19,257202.4,2876.475,90.34426
"21632","69289","2016",38,23,15,273462.1,2788.237,100.6579
"21633","69290","2016",424,124,300,193557.2,2504.788,77.6533
"21634","69291","2016",70,44,26,231455.4,2478.929,96.22857
"21635","69292","2016",56,16,40,240025.1,2932.625,81.5
"21636","69293","2016",23,16,7,351183.4,3477.13,100.2174
"21637","69294","2016",23,7,16,212967.8,2613.348,81.73913
"21638","69295","2016",18,10,8,221300.3,2615.556,89.44444
"21639","69296","2016",18,10,8,238293.1,2584,93.16667
"21640","69297","2016",43,35,8,393525.3,3052.953,111.7907
"21641","69299","2016",14,12,2,233421.7,2338.286,99.92857
"21642","70002","2016",2,2,0,73450,708,104
"21643","70004","2016",4,4,0,106125,1015,108.25
"21644","70005","2016",2,2,0,74500,830,125
"21645","70006","2016",12,11,1,88241.67,885.3333,95.41667
"21646","70008","2016",1,1,0,74500,1284,58
"21647","70010","2016",1,1,0,50000,658,76
"21648","70011","2016",1,1,0,210750,1098,192
"21649","70014","2016",1,1,0,124000,1042,119
"21650","70016","2016",1,1,0,95000,413,230
"21651","70017","2016",1,1,0,142900,940,152
"21652","70018","2016",5,5,0,139200,1107.2,121.4
"21653","70019","2016",1,1,0,149200,1658,90
"21654","70020","2016",3,3,0,160083.3,1092.667,150
"21655","70021","2016",1,1,0,180550,1881,96
"21656","70023","2016",2,2,0,44500,467,95
"21657","70024","2016",2,2,0,48500,492.5,99
"21658","70026","2016",15,13,2,99265.07,1011.467,108.8667
"21659","70028","2016",3,3,0,114756.7,861,131.6667
"21660","70029","2016",3,3,0,147833.3,1248.333,127.3333
"21661","70031","2016",3,3,0,96833.33,1053.333,90.33333
"21662","70032","2016",1,1,0,75000,1103,68
"21663","70037","2016",2,2,0,80000,881,101.5
"21664","70039","2016",2,2,0,203990,1385.5,156
"21665","70041","2016",2,2,0,130100,690.5,185
"21666","70043","2016",1,1,0,130000,788,165
"21667","70044","2016",3,3,0,81010,755.6667,108
"21668","70046","2016",4,4,0,156525,1213.25,129
"21669","70051","2016",1,1,0,60000,674,89
"21670","70054","2016",1,1,0,109500,1129,97
"21671","70061","2016",4,4,0,92350,1032.25,81.75
"21672","70062","2016",2,2,0,93050.5,952,92.5
"21673","70063","2016",1,1,0,74000,685,108
"21674","70066","2016",3,3,0,97166.67,643.6667,154.6667
"21675","70072","2016",1,1,0,102000,962,106
"21676","70076","2016",5,5,0,191050,1562.8,122.2
"21677","70079","2016",2,2,0,122125,1106,110
"21678","70080","2016",4,4,0,99625,1022.75,97
"21679","70082","2016",2,2,0,121500,1102.5,106
"21680","70083","2016",2,2,0,69000,832.5,83.5
"21681","70085","2016",11,9,2,152142.9,1387.182,129.4545
"21682","70087","2016",1,1,0,112000,655,171
"21683","70088","2016",2,1,1,47500,553,88.5
"21684","70090","2016",4,2,2,142990,1028.75,147
"21685","70091","2016",1,1,0,46000,474,97
"21686","70094","2016",2,2,0,62350,555,114
"21687","70096","2016",4,4,0,139050,1458.75,92
"21688","70100","2016",1,1,0,141000,1195,118
"21689","70101","2016",7,7,0,103857.1,1029.143,99.28571
"21690","70103","2016",3,3,0,125233.3,1249.667,114.6667
"21691","70104","2016",3,3,0,80333.33,1001.667,77.66667
"21692","70105","2016",1,0,1,65000,844,77
"21693","70107","2016",3,3,0,246500,2364.667,107.3333
"21694","70109","2016",2,2,0,161900,1489,107
"21695","70111","2016",3,3,0,116333.3,1151,112.6667
"21696","70116","2016",5,5,0,144290.6,1341,108.4
"21697","70117","2016",17,16,1,171524.1,1409.235,127.7647
"21698","70118","2016",4,4,0,94250,1221,78
"21699","70120","2016",33,31,2,107389,1251.485,92.51515
"21700","70121","2016",8,8,0,130530.1,1113.375,113.375
"21701","70124","2016",2,2,0,69500,601.5,102.5
"21702","70125","2016",1,1,0,142000,1315,108
"21703","70128","2016",2,2,0,144000,1841,80
"21704","70129","2016",2,2,0,111500,863.5,145
"21705","70130","2016",4,4,0,65750,703,90.5
"21706","70132","2016",5,4,1,107464,1005.2,106.8
"21707","70134","2016",3,3,0,57500,762.3333,74
"21708","70136","2016",2,2,0,171250,1370.5,125.5
"21709","70138","2016",1,1,0,140000,848,165
"21710","70141","2016",1,1,0,75000,368,204
"21711","70145","2016",2,2,0,226500,1393.5,161.5
"21712","70148","2016",1,1,0,135000,1588,85
"21713","70149","2016",7,7,0,178428.6,1813.857,109.4286
"21714","70152","2016",6,6,0,156243.3,1161.833,145.5
"21715","70154","2016",3,3,0,96333.33,1206.667,81
"21716","70157","2016",1,1,0,180000,1406,128
"21717","70158","2016",1,1,0,150100,1668,90
"21718","70159","2016",2,2,0,92500,1105.5,76.5
"21719","70160","2016",1,1,0,165000,2012,82
"21720","70162","2016",4,4,0,129020,1433,92.25
"21721","70163","2016",3,3,0,133000,1195.667,113
"21722","70165","2016",2,2,0,86000,596,154
"21723","70166","2016",3,3,0,1e+05,957.3333,107.3333
"21724","70168","2016",2,2,0,133250,1420,92.5
"21725","70169","2016",1,1,0,80091,1335,60
"21726","70171","2016",8,8,0,62700,664.625,95.625
"21727","70174","2016",3,3,0,95000,766.6667,112.3333
"21728","70184","2016",12,9,3,117195.8,1210.333,105.1667
"21729","70185","2016",3,3,0,75666.67,956,74
"21730","70186","2016",1,1,0,80950,723,112
"21731","70187","2016",1,1,0,50000,769,65
"21732","70189","2016",2,2,0,90000,1229.5,90
"21733","70190","2016",3,3,0,112225,621.3333,179.6667
"21734","70194","2016",1,1,0,54800,548,100
"21735","70196","2016",2,2,0,110000,825,135.5
"21736","70200","2016",1,1,0,80000,444,180
"21737","70202","2016",1,1,0,72300,1095,66
"21738","70205","2016",2,2,0,120000,1641,73
"21739","70206","2016",4,4,0,142050,1497.75,94.25
"21740","70207","2016",23,18,5,112375.6,1255.304,89.13043
"21741","70211","2016",3,3,0,101166.7,1182,78.66667
"21742","70216","2016",2,2,0,102559,1104.5,93
"21743","70218","2016",2,2,0,136100,1195.5,115
"21744","70219","2016",3,3,0,140000,1487,94
"21745","70220","2016",4,4,0,100500,1036,98.25
"21746","70221","2016",4,4,0,108295,824,127.75
"21747","70222","2016",2,2,0,127150,776,159.5
"21748","70224","2016",4,4,0,205200,1943.5,110
"21749","70225","2016",1,1,0,231010,1848,125
"21750","70226","2016",6,6,0,114288.3,1066.333,102.5
"21751","70227","2016",5,5,0,80500,803.2,96.4
"21752","70228","2016",16,15,1,95887.5,963.6875,101.875
"21753","70232","2016",1,1,0,125000,762,164
"21754","70235","2016",2,2,0,46000,541,85
"21755","70238","2016",2,2,0,66250,720.5,90
"21756","70239","2016",1,0,1,110000,1222,90
"21757","70240","2016",8,8,0,88912.5,993.25,89.875
"21758","70243","2016",4,4,0,112000,1019.5,117.5
"21759","70244","2016",2,2,0,141800,946,150
"21760","70245","2016",27,26,1,95346.33,889.7407,104.8519
"21761","70248","2016",3,3,0,124000,1779.333,91.66667
"21762","70253","2016",3,3,0,145550,1281.667,115.3333
"21763","70254","2016",3,3,0,148666.7,1390.333,108
"21764","70255","2016",6,6,0,111616.7,1105,114.3333
"21765","70256","2016",8,8,0,78382,1182.125,69.375
"21766","70257","2016",9,9,0,94777.78,1106.333,90
"21767","70259","2016",3,3,0,152450,1433.667,111.3333
"21768","70260","2016",4,4,0,107750,1204.5,88.75
"21769","70261","2016",15,15,0,136410,1209.467,114
"21770","70262","2016",2,2,0,82000,881.5,91.5
"21771","70264","2016",1,1,0,103000,1184,87
"21772","70267","2016",5,5,0,77140,771.6,108.2
"21773","70271","2016",5,5,0,103700,1094.8,97
"21774","70275","2016",4,4,0,181295.2,1139.5,163
"21775","70276","2016",7,7,0,130785.7,1072,123.4286
"21776","70277","2016",1,1,0,89300,532,168
"21777","70279","2016",33,16,17,81563.33,926.6667,91.81818
"21778","70280","2016",7,7,0,154842.9,1389.714,114.8571
"21779","70282","2016",5,4,1,107473.4,1055.2,109.6
"21780","70283","2016",5,4,1,63600,724.8,84.2
"21781","70284","2016",1,1,0,110000,724,152
"21782","70285","2016",93,61,32,119223.9,1347.366,89.46237
"21783","70289","2016",1,1,0,59997,741,81
"21784","70290","2016",2,2,0,70750,731,93.5
"21785","70292","2016",10,9,1,63500,691,96.8
"21786","70294","2016",3,3,0,100166.7,1033.333,97.33333
"21787","70295","2016",4,4,0,137500,2949.75,85.25
"21788","70301","2016",1,1,0,162700,1595,102
"21789","70302","2016",2,2,0,130000,824,157
"21790","70306","2016",6,6,0,140611.7,1558.667,96.16667
"21791","70307","2016",2,2,0,77000,594,130
"21792","70310","2016",56,43,13,102844,1172.786,89.33929
"21793","70312","2016",3,3,0,168000,1770.667,100.6667
"21794","70313","2016",4,4,0,113462.5,1135.5,98.75
"21795","70314","2016",2,2,0,55250,799.5,66.5
"21796","70315","2016",4,4,0,90256.25,854.5,107.5
"21797","70317","2016",1,1,0,32900,451,73
"21798","70318","2016",3,3,0,99500,1389.667,76.66667
"21799","70319","2016",1,1,0,147000,1750,84
"21800","70321","2016",9,9,0,132311.1,1366.111,98
"21801","70322","2016",1,1,0,60000,600,100
"21802","70323","2016",2,2,0,96400.5,713,124.5
"21803","70324","2016",3,3,0,140000,834,182.6667
"21804","70325","2016",2,2,0,122700,1486.5,80
"21805","70326","2016",2,2,0,142500,1096,130
"21806","70328","2016",5,5,0,72010,853,87.8
"21807","70331","2016",3,3,0,89500,891.6667,96
"21808","70336","2016",3,3,0,124333.3,1125,113.3333
"21809","70338","2016",5,5,0,91876.6,832,106.8
"21810","70339","2016",18,18,0,113107.2,1221.556,91
"21811","70341","2016",1,1,0,60000,423,142
"21812","70343","2016",2,2,0,39000,483,78.5
"21813","70347","2016",7,7,0,119434,1331.714,92.57143
"21814","70348","2016",5,5,0,91400,1045.8,99.8
"21815","70349","2016",2,2,0,74000,954,77.5
"21816","70352","2016",1,1,0,185500,1461,127
"21817","70355","2016",3,3,0,166133.3,1154,150.6667
"21818","70356","2016",3,3,0,299216.7,1733.333,155.6667
"21819","70357","2016",7,7,0,83000,1036.571,80.71429
"21820","70358","2016",5,5,0,120640,1025.2,108.8
"21821","70360","2016",1,1,0,56000,700,80
"21822","70363","2016",5,4,1,148850,2332.2,77
"21823","70367","2016",1,1,0,125000,2778,45
"21824","70376","2016",7,6,1,117450.6,1060.571,110.2857
"21825","70378","2016",21,18,3,122474.3,1315.095,96.47619
"21826","70383","2016",2,2,0,151000,1358.5,151
"21827","70384","2016",4,4,0,84250,1028.5,91
"21828","70386","2016",1,1,0,285000,1696,168
"21829","70387","2016",2,2,0,100500,1046,96
"21830","70388","2016",18,16,2,135175.6,1469.444,90.88889
"21831","70389","2016",1,1,0,47000,566,83
"21832","70393","2016",8,8,0,123800,1131.375,112.5
"21833","70395","2016",3,3,0,149200,1115,138
"21834","70401","2016",1,1,0,60000,500,120
"21835","70402","2016",2,2,0,122500,883,141
"21836","70403","2016",5,5,0,148580,1368.2,116.6
"21837","70404","2016",8,8,0,84062.5,803.375,100.125
"21838","70405","2016",1,1,0,82000,683,120
"21839","70407","2016",1,1,0,162000,1409,115
"21840","70408","2016",12,12,0,116644.2,1510.583,84.75
"21841","70412","2016",1,1,0,62400,466,134
"21842","70413","2016",20,19,1,129001.5,1601.7,97.55
"21843","70414","2016",8,7,1,89925.62,871.5,114.75
"21844","70415","2016",2,2,0,44000,615,72.5
"21845","70417","2016",1,1,0,120500,1310,92
"21846","70418","2016",5,5,0,72916.2,672.4,115
"21847","70419","2016",3,3,0,76605,680,107.3333
"21848","70421","2016",24,22,2,100940.4,1056.208,100.4583
"21849","70422","2016",1,1,0,90000,732,123
"21850","70425","2016",1,1,0,112000,1109,101
"21851","70427","2016",4,4,0,77875,939,79.75
"21852","70428","2016",6,6,0,148280.5,1217.833,123.5
"21853","70429","2016",3,3,0,111333.3,1140.667,97
"21854","70431","2016",1,1,0,90000,533,169
"21855","70433","2016",12,12,0,136628.3,1467.667,94.41667
"21856","70435","2016",3,3,0,139033.3,1290,106
"21857","70439","2016",3,3,0,106866.7,671,148
"21858","70441","2016",1,1,0,166000,1122,148
"21859","70443","2016",2,2,0,56500,659,82
"21860","70444","2016",1,1,0,132200,918,144
"21861","70445","2016",2,2,0,85485,935,88
"21862","70446","2016",1,1,0,59800,748,80
"21863","70447","2016",12,10,2,151544.8,1584.5,95.41667
"21864","70451","2016",28,25,3,96400,1153,86.17857
"21865","70452","2016",3,3,0,95316.67,1520,65
"21866","70453","2016",4,4,0,119250,1253.25,100.75
"21867","70455","2016",15,15,0,139366.7,1280.267,113.2667
"21868","70457","2016",1,1,0,43050,552,78
"21869","70459","2016",10,10,0,107803.5,1089.2,104.5
"21870","70460","2016",2,2,0,158500,1557,113
"21871","70462","2016",1,1,0,86000,869,99
"21872","70463","2016",1,1,0,136500,780,175
"21873","70464","2016",12,12,0,98137.75,1014.5,99.33333
"21874","70467","2016",12,10,2,73654.08,829.75,92.41667
"21875","70469","2016",3,3,0,97973.33,868.6667,105
"21876","70472","2016",2,2,0,86100,762.5,110
"21877","70474","2016",2,2,0,63500,651.5,99.5
"21878","70477","2016",2,2,0,161000,1164,138
"21879","70478","2016",6,6,0,137533.3,982.1667,158.8333
"21880","70480","2016",2,2,0,49500,741.5,70
"21881","70482","2016",10,9,1,119076.8,1304.2,93.7
"21882","70484","2016",2,2,0,121350,1369,94
"21883","70485","2016",2,2,0,54000,674,78.5
"21884","70487","2016",1,1,0,67000,670,100
"21885","70489","2016",7,7,0,101984.4,1115.143,96.71429
"21886","70490","2016",1,1,0,158150,1550,102
"21887","70492","2016",5,5,0,89400,740,118
"21888","70493","2016",3,3,0,189166.7,1600.667,121.6667
"21889","70498","2016",3,3,0,126666.7,1433,95.33333
"21890","70500","2016",2,2,0,116100,733.5,150.5
"21891","70503","2016",3,3,0,127433.3,1277.333,99.66667
"21892","70504","2016",5,5,0,84680,838,111.4
"21893","70506","2016",5,5,0,150413.6,1515.2,105.8
"21894","70507","2016",2,2,0,198765,1498.5,132.5
"21895","70512","2016",3,3,0,102000,784.3333,132
"21896","70513","2016",8,8,0,147662.5,1280.5,113.875
"21897","70514","2016",2,2,0,45500,462,101
"21898","70517","2016",2,2,0,155000,1205.5,117.5
"21899","70518","2016",2,2,0,130000,769.5,168
"21900","70523","2016",1,1,0,80000,571,140
"21901","70524","2016",3,3,0,62333.33,763,79.66667
"21902","70526","2016",6,6,0,69316.67,863.8333,79.5
"21903","70528","2016",3,3,0,98333.33,917,103.6667
"21904","70529","2016",3,3,0,114990.3,1130.333,102
"21905","70530","2016",1,1,0,155000,1303,119
"21906","70531","2016",1,1,0,148750,1340,111
"21907","70532","2016",1,1,0,41500,519,80
"21908","70533","2016",1,1,0,150000,798,188
"21909","70534","2016",1,1,0,52750,651,81
"21910","70535","2016",3,3,0,84833.33,850.6667,101
"21911","70536","2016",1,1,0,110310,1161,95
"21912","70537","2016",3,3,0,104026.7,1023,102
"21913","70540","2016",1,1,0,350000,1178,297
"21914","70542","2016",1,1,0,65000,361,180
"21915","70547","2016",1,1,0,160000,1684,95
"21916","70550","2016",151,49,102,92807.31,1042.735,87.39735
"21917","70552","2016",2,2,0,120000,969.5,124
"21918","70557","2016",1,1,0,68200,832,82
"21919","70560","2016",1,1,0,2e+05,1709,117
"21920","70561","2016",10,10,0,110899.5,1096.4,100.5
"21921","70563","2016",4,4,0,173275,1669.75,105.75
"21922","70567","2016",2,2,0,154060,1411,109.5
"21923","70573","2016",3,3,0,115833.3,833.6667,135.6667
"21924","70575","2016",6,6,0,180416.7,1867.333,98.66667
"21925","70577","2016",5,5,0,114888,1071,112.6
"21926","70579","2016",5,5,0,165800,1417.2,115
"21927","70581","2016",12,12,0,109833.3,1096.75,102.5833
"21928","70582","2016",1,1,0,150200,1113,135
"21929","71001","2016",9,9,0,130033.3,1241.889,105.1111
"21930","71002","2016",6,6,0,156545,1220.333,133.5
"21931","71003","2016",10,10,0,113720,1063.3,110.7
"21932","71004","2016",15,14,1,191473.3,1544.333,121
"21933","71005","2016",3,3,0,155333.3,1604,117.6667
"21934","71006","2016",1,1,0,326000,1376,237
"21935","71007","2016",1,1,0,60000,750,80
"21936","71008","2016",3,3,0,78333.33,680.6667,115.3333
"21937","71009","2016",20,20,0,66730,876.25,79.85
"21938","71010","2016",5,5,0,95806,755.2,129.8
"21939","71011","2016",4,4,0,127750,1018.75,122.5
"21940","71012","2016",6,6,0,60050,865.5,75.5
"21941","71013","2016",2,2,0,45500,569,76.5
"21942","71014","2016",120,70,50,92395.76,1040.433,89.125
"21943","71015","2016",9,9,0,123100,1277.222,97.33333
"21944","71016","2016",12,12,0,163895.8,1504,107.5833
"21945","71017","2016",2,2,0,153500,997.5,147
"21946","71018","2016",14,14,0,94390,1567.071,79.42857
"21947","71019","2016",1,1,0,188000,1403,134
"21948","71020","2016",1,1,0,30000,500,60
"21949","71021","2016",2,2,0,160087.5,1455.5,119
"21950","71022","2016",4,4,0,169700,1149.75,143.75
"21951","71023","2016",12,12,0,108275,1107.5,97.91667
"21952","71024","2016",6,6,0,118750,1213.833,97.66667
"21953","71025","2016",4,4,0,100500,995,98.5
"21954","71026","2016",4,4,0,97000,1038.25,94
"21955","71027","2016",10,9,1,87800,1176.6,86.8
"21956","71028","2016",1,1,0,98000,1289,76
"21957","71029","2016",6,6,0,90166.67,1086.5,84
"21958","71030","2016",4,4,0,81502.5,1027.5,84.25
"21959","71032","2016",6,6,0,153000,1480.167,96
"21960","71033","2016",8,8,0,99125,1097,91.375
"21961","71034","2016",1,1,0,247500,1904,130
"21962","71035","2016",4,4,0,109950,1300,81.75
"21963","71036","2016",3,3,0,49433.33,775.3333,57.66667
"21964","71037","2016",1,1,0,85000,1545,55
"21965","71038","2016",3,3,0,115200,1272.333,90.33333
"21966","71039","2016",5,5,0,289660,2593.8,99
"21967","71040","2016",38,38,0,108395.1,1167.158,90.71053
"21968","71041","2016",3,3,0,104733.3,1184.667,88.33333
"21969","71042","2016",1,1,0,110000,786,140
"21970","71043","2016",1,1,0,34000,515,66
"21971","71044","2016",4,4,0,127000,1181.5,112.75
"21972","71045","2016",3,3,0,86698,1002.667,76
"21973","71046","2016",1,1,0,35000,556,63
"21974","71047","2016",43,39,4,77390.7,1022.884,77.93023
"21975","71048","2016",2,2,0,192000,1715,105
"21976","71050","2016",6,6,0,182183.3,2383.667,91.16667
"21977","71051","2016",3,3,0,96333.33,1288.667,78.33333
"21978","71052","2016",8,8,0,112143.8,869.375,133.5
"21979","71054","2016",6,6,0,169646.3,1078.667,151
"21980","71056","2016",15,15,0,116753.3,1233.867,89.4
"21981","71057","2016",2,2,0,115000,1441.5,72.5
"21982","71058","2016",1,1,0,174000,1055,165
"21983","71059","2016",24,23,1,111994.2,1331.083,84.54167
"21984","71060","2016",1,1,0,182000,910,200
"21985","71061","2016",7,7,0,145971.4,1347.143,105.7143
"21986","71062","2016",5,5,0,69980,870.8,78
"21987","71063","2016",8,8,0,98125,1143.5,85.25
"21988","71064","2016",5,5,0,172960,2005.6,95.6
"21989","71066","2016",1,1,0,80000,2000,40
"21990","71068","2016",2,2,0,117000,1442,82.5
"21991","71069","2016",5,4,1,231702,1770.2,133.4
"21992","71070","2016",24,22,2,163768.9,1735.042,100.9167
"21993","71071","2016",2,2,0,60250,830,72.5
"21994","71072","2016",1,1,0,133600,897,149
"21995","71073","2016",45,38,7,123855.8,1551.444,82.44444
"21996","71074","2016",6,4,2,158118.8,2274.833,88.16667
"21997","71075","2016",3,3,0,67333.33,539.3333,121
"21998","71076","2016",523,108,415,96508.06,1215.757,77.80115
"21999","71077","2016",4,4,0,76425,720.5,110.5
"22000","71078","2016",3,3,0,130333.3,1359.333,113.3333
"22001","71079","2016",7,7,0,78714.29,829.7143,97.42857
"22002","71081","2016",19,16,3,112542.1,1348.947,81.78947
"22003","71082","2016",1,1,0,146730,1578,93
"22004","71084","2016",4,4,0,197625,2018,97.75
"22005","71085","2016",1,1,0,245200,2695,91
"22006","71086","2016",2,2,0,134150,1412,95
"22007","71087","2016",2,2,0,150000,1541.5,97
"22008","71088","2016",3,3,0,66666.67,744.3333,92
"22009","71089","2016",3,3,0,119000,1605,70
"22010","71090","2016",35,33,2,208639.9,1743.229,126.4571
"22011","71091","2016",1,1,0,114640,1042,110
"22012","71092","2016",5,5,0,132933.4,1154.6,110.8
"22013","71093","2016",11,11,0,132977.3,1463.273,94.36364
"22014","71094","2016",3,3,0,154995,1147.667,145
"22015","71095","2016",5,5,0,57400,731.6,78.8
"22016","71097","2016",5,5,0,74100,725.6,105.6
"22017","71098","2016",6,6,0,87625,1161.833,73.66667
"22018","71099","2016",1,1,0,198900,1730,115
"22019","71100","2016",3,3,0,205875,1075.667,196.6667
"22020","71101","2016",4,4,0,70400,968,73
"22021","71102","2016",4,4,0,195510,1602.5,129.75
"22022","71103","2016",2,2,0,136000,1349,99
"22023","71104","2016",2,2,0,92500,765.5,120
"22024","71105","2016",88,55,33,170564.3,1861.966,92.77273
"22025","71106","2016",30,23,7,118079.9,1231.267,93.6
"22026","71107","2016",1,1,0,58500,443,132
"22027","71108","2016",2,2,0,84750,2687.5,33
"22028","71109","2016",4,4,0,263000,1910.25,133.5
"22029","71110","2016",3,3,0,87500,700,113.6667
"22030","71111","2016",3,3,0,104356.7,891.3333,132
"22031","71112","2016",1,1,0,145000,2736,53
"22032","71113","2016",1,1,0,83000,1122,74
"22033","71115","2016",1,1,0,117000,860,136
"22034","71117","2016",9,9,0,174330,1517.556,116.6667
"22035","71118","2016",70,51,19,124056.9,1628.643,83.32857
"22036","71119","2016",7,7,0,138050,1560.714,88.28571
"22037","71120","2016",39,32,7,92028.03,1041.872,89.07692
"22038","71121","2016",2,2,0,134630,1383.5,97
"22039","71122","2016",6,6,0,68000,993.5,79.5
"22040","71123","2016",3,3,0,68333.33,811.6667,81.66667
"22041","71125","2016",1,1,0,45000,341,132
"22042","71126","2016",5,5,0,251142,2505.4,108
"22043","71127","2016",1,1,0,66420,1356,49
"22044","71128","2016",2,2,0,84050,1005.5,83
"22045","71129","2016",3,3,0,105666.7,919.6667,113.3333
"22046","71130","2016",1,1,0,133000,1662,80
"22047","71131","2016",8,8,0,152800,1698.75,84
"22048","71132","2016",23,21,2,86910.87,1012.565,85.47826
"22049","71133","2016",15,10,5,104876.7,1045.133,100.9333
"22050","71134","2016",4,4,0,149340,1670.25,105.75
"22051","71135","2016",5,5,0,261114,1611.8,162.6
"22052","71137","2016",51,39,12,147831.1,1561.294,94.33333
"22053","71139","2016",4,4,0,76708.25,961.5,92.75
"22054","71141","2016",1,1,0,90500,503,180
"22055","71142","2016",4,4,0,76750,776.25,95
"22056","71143","2016",4,4,0,141750,1569.5,90.25
"22057","71145","2016",7,6,1,128897.1,1294.714,96.85714
"22058","71146","2016",1,1,0,149000,1505,99
"22059","71147","2016",5,5,0,111600,1239.8,99.8
"22060","71148","2016",13,13,0,95079.23,1007.308,104.7692
"22061","71149","2016",5,5,0,134800,1176,121
"22062","71150","2016",29,27,2,162285.5,1704.621,102.3793
"22063","71151","2016",3,3,0,105856.7,1020.333,102.6667
"22064","71152","2016",2,2,0,90300,703,180.5
"22065","71153","2016",157,88,69,83098.52,1146.229,77.26115
"22066","71154","2016",20,20,0,169542,1693.5,104.85
"22067","71155","2016",7,7,0,99000,1011.286,100.1429
"22068","71157","2016",16,16,0,103633.6,1137.125,90.9375
"22069","71158","2016",19,18,1,109139.5,1313.947,84.63158
"22070","71159","2016",3,3,0,160000,1211.667,139.6667
"22071","71160","2016",1,1,0,98000,1400,70
"22072","71161","2016",3,3,0,130000,1233.333,102
"22073","71162","2016",8,8,0,108298.8,1110.5,105.875
"22074","71163","2016",2,2,0,142750,1379.5,122
"22075","71164","2016",2,2,0,101300,1514.5,75.5
"22076","71165","2016",10,10,0,80600,1077.3,73.3
"22077","71167","2016",5,5,0,84200,1243.2,74.4
"22078","71168","2016",5,5,0,123900,1200.6,106
"22079","71169","2016",4,4,0,181750,1731.75,103
"22080","71170","2016",20,19,1,183156,1557.2,121.8
"22081","71171","2016",5,5,0,59200,796,71.4
"22082","71172","2016",3,3,0,58433.33,767.3333,77.33333
"22083","71173","2016",5,5,0,166650,1498.6,112.6
"22084","71175","2016",9,9,0,126111.1,1115.222,120.6667
"22085","71176","2016",65,44,21,81105.57,913.8308,84.64615
"22086","71177","2016",5,5,0,92300,1019,89.6
"22087","71178","2016",11,11,0,133157.3,1218.182,107.0909
"22088","71181","2016",3,3,0,92833.33,1410,66.33333
"22089","71182","2016",12,12,0,197662.5,1854.667,107
"22090","71183","2016",2,2,0,22500,709,31
"22091","71184","2016",8,8,0,94820.62,1068.875,87.5
"22092","71185","2016",6,6,0,97441.67,863.6667,113.6667
"22093","71186","2016",6,6,0,81116.67,982.6667,84.66667
"22094","71187","2016",17,16,1,132720.9,1457.529,96.41176
"22095","71190","2016",12,12,0,106879.2,921.4167,121.75
"22096","71191","2016",5,5,0,114095,910.6,118.4
"22097","71192","2016",17,16,1,78071.47,827.2941,93.23529
"22098","71193","2016",2,2,0,189600,1174.5,144
"22099","71194","2016",7,7,0,132042.9,1210.571,132.7143
"22100","71195","2016",2,2,0,110000,1359,74.5
"22101","71196","2016",7,7,0,79071.43,913.7143,85
"22102","71198","2016",10,10,0,96170,1202.3,80.1
"22103","71199","2016",2,2,0,76250,996,75
"22104","71200","2016",9,9,0,127850,1191.556,107.2222
"22105","71201","2016",1,1,0,152400,1349,113
"22106","71202","2016",19,19,0,177010.5,1524.053,118.3684
"22107","71204","2016",9,9,0,193707.8,1733.889,115.2222
"22108","71205","2016",11,11,0,98936.36,1195.636,88.63636
"22109","71206","2016",5,5,0,78389.6,898,94
"22110","71207","2016",7,7,0,85571.43,1134.857,75
"22111","71208","2016",4,4,0,131500,1213.25,130.5
"22112","71209","2016",5,5,0,85400,1032.6,77.8
"22113","71210","2016",2,2,0,99250,1229,72.5
"22114","71212","2016",14,13,1,92700.36,1053.786,89.21429
"22115","71213","2016",6,6,0,113866.7,1196.167,97
"22116","71214","2016",8,8,0,98100,935,102
"22117","71215","2016",9,8,1,136088.9,1359.333,102.1111
"22118","71216","2016",4,4,0,98875,1172.25,77.5
"22119","71218","2016",6,6,0,158150,1524.167,118.3333
"22120","71219","2016",8,8,0,85875,1095.75,75.5
"22121","71220","2016",4,4,0,140250,1874.75,83.75
"22122","71221","2016",36,34,2,197322,1854.806,108.0556
"22123","71222","2016",5,5,0,131800,1191.4,118.4
"22124","71223","2016",8,8,0,86687.5,922.125,97.375
"22125","71224","2016",1,1,0,50000,1064,47
"22126","71225","2016",3,3,0,160033.3,1517,115.6667
"22127","71226","2016",1,1,0,60000,1500,40
"22128","71227","2016",3,3,0,62666.67,943,66
"22129","71228","2016",6,6,0,153283.3,1514.833,103.1667
"22130","71229","2016",2,2,0,63750,916,72
"22131","71230","2016",51,44,7,79018.63,872.3333,89.72549
"22132","71231","2016",2,2,0,137850,1443,96.5
"22133","71233","2016",2,2,0,144400,1126.5,129.5
"22134","71234","2016",9,9,0,88777.78,1130.111,82.11111
"22135","71235","2016",17,16,1,178341.2,1684.471,107.2353
"22136","71236","2016",8,8,0,244493.5,2316.125,102.375
"22137","71237","2016",3,3,0,63333.33,915.6667,65.33333
"22138","71238","2016",14,14,0,98169.29,1025.214,97.07143
"22139","71239","2016",8,7,1,82187.5,694.625,108.75
"22140","71240","2016",7,7,0,190869.3,1609.857,119
"22141","71241","2016",4,4,0,159014,1433,103
"22142","71242","2016",5,4,1,129400,1246,96.2
"22143","71243","2016",3,3,0,121300,1242.333,97.66667
"22144","71244","2016",4,4,0,164000,1583.5,109
"22145","71245","2016",4,4,0,119500,1072.5,113.75
"22146","71246","2016",4,4,0,176925,1267.25,154.25
"22147","71247","2016",3,3,0,71800,916,78.66667
"22148","71248","2016",10,10,0,99817,1269,75.3
"22149","71249","2016",11,11,0,158120,1292.636,123.3636
"22150","71250","2016",8,8,0,207518.8,1828.875,112.75
"22151","71251","2016",6,6,0,98975,1212.833,83.16667
"22152","71252","2016",3,3,0,96433.33,1259.333,79.33333
"22153","71253","2016",7,7,0,154075,1727.714,89.57143
"22154","71254","2016",3,3,0,75466.67,887.3333,90
"22155","71255","2016",1,1,0,121400,1686,72
"22156","71256","2016",5,5,0,123000,1224.8,100.8
"22157","71257","2016",2,2,0,161250,1784,92.5
"22158","71258","2016",5,5,0,214892,1959,109.6
"22159","71259","2016",3,3,0,84496.67,727,116.3333
"22160","71261","2016",5,5,0,70140,878.8,77.2
"22161","71263","2016",78,52,26,122287.5,1505.038,86.80769
"22162","71264","2016",7,7,0,114142.9,1158.571,101.5714
"22163","71266","2016",4,4,0,100827.5,1031.75,97.75
"22164","71267","2016",6,6,0,126741.7,1119.167,114.1667
"22165","71268","2016",4,4,0,148375,1257.5,118.5
"22166","71269","2016",12,9,3,105629.2,1570.083,78.66667
"22167","71270","2016",342,95,247,114698,1409.336,80.75731
"22168","71271","2016",1,1,0,80000,889,90
"22169","71272","2016",2,2,0,90250,1075.5,88.5
"22170","71273","2016",4,4,0,71250,611,98
"22171","71274","2016",2,2,0,92000,1692.5,54.5
"22172","71275","2016",18,18,0,143287.5,1114.222,123.2778
"22173","71277","2016",10,10,0,145704.2,1143.6,119.7
"22174","71278","2016",1,1,0,167500,3418,49
"22175","71279","2016",2,2,0,52500,648,83.5
"22176","71282","2016",10,10,0,115555,1047.8,105.2
"22177","71283","2016",9,9,0,107555.6,1116.778,91.55556
"22178","71285","2016",3,3,0,101600,1511.333,67.66667
"22179","71286","2016",4,4,0,226941.2,1261.25,164
"22180","71287","2016",3,3,0,89500,1070,75.66667
"22181","71289","2016",6,6,0,145500,1451.167,104.5
"22182","71290","2016",3,3,0,200003.3,1484,119.6667
"22183","71291","2016",11,11,0,136267.3,1327.727,112.4545
"22184","71292","2016",12,10,2,258305.4,2671.083,114.6667
"22185","71293","2016",11,11,0,128323.5,1480.909,86.45455
"22186","71294","2016",9,9,0,390927.8,3443.111,123
"22187","71295","2016",20,20,0,106125,1135.25,95.75
"22188","71296","2016",13,13,0,136500,1319.846,121
"22189","71297","2016",9,9,0,81540,1009.111,86.22222
"22190","71299","2016",4,4,0,186175,2035.75,91.25
"22191","71300","2016",2,2,0,121225,1373,88
"22192","71301","2016",3,3,0,170566.7,1449.333,119.3333
"22193","71302","2016",2,2,0,99250,2231.5,63.5
"22194","71303","2016",9,9,0,112611.1,1330.889,93
"22195","71305","2016",8,8,0,163803.1,1371.375,123.625
"22196","71306","2016",156,112,44,89019.08,1046.455,87.58333
"22197","71307","2016",2,2,0,91400,933.5,104.5
"22198","71308","2016",1,1,0,237000,1445,164
"22199","71309","2016",10,10,0,96935.4,1106.5,92.3
"22200","71310","2016",24,19,5,95932.29,1269.833,78.58333
"22201","71311","2016",9,9,0,75516.67,1008.778,75.33333
"22202","71312","2016",1,1,0,65000,1000,65
"22203","71313","2016",1,1,0,69700,726,96
"22204","71314","2016",5,5,0,113600,1192.6,92
"22205","71315","2016",1,1,0,180000,1161,155
"22206","71316","2016",6,6,0,81925,842.8333,102.6667
"22207","71317","2016",3,3,0,90022.67,1565.667,63.33333
"22208","71318","2016",10,10,0,138450,1696.9,83.4
"22209","71319","2016",13,13,0,128558.8,1150.923,112.0769
"22210","71320","2016",5,4,1,178200,1419.6,129.2
"22211","71321","2016",3,3,0,83666.67,924.3333,82
"22212","71323","2016",2,2,0,49350,822,61
"22213","71324","2016",3,3,0,171633.3,1716,96.66667
"22214","71325","2016",7,7,0,98138.57,1172.857,87.71429
"22215","71326","2016",7,7,0,69285.71,868.7143,77.71429
"22216","71327","2016",2,2,0,81500,727.5,101
"22217","71328","2016",5,5,0,102086,1234.4,92.8
"22218","71329","2016",6,6,0,115750,1237.333,92
"22219","71330","2016",8,8,0,74437.5,752,97.875
"22220","71332","2016",4,4,0,111750,1095.5,96.5
"22221","71333","2016",5,5,0,155880,1770.8,88.4
"22222","71334","2016",4,4,0,145000,1127.5,151.25
"22223","71335","2016",2,1,1,178500,2955.5,67
"22224","71336","2016",26,24,2,146946.2,1472.077,103.2308
"22225","71337","2016",2,2,0,52500,635.5,80.5
"22226","71338","2016",4,4,0,150422.5,1348.5,103.25
"22227","71339","2016",4,4,0,154650,2153,71.5
"22228","71340","2016",14,14,0,100318.9,956.9286,99.5
"22229","71341","2016",1,1,0,1e+05,625,160
"22230","71342","2016",101,56,45,101472,1340.079,80.86139
"22231","71343","2016",4,4,0,120063.8,1052.25,119.5
"22232","71344","2016",1,1,0,85000,752,113
"22233","71345","2016",5,5,0,188781.4,1633.6,116.4
"22234","71346","2016",11,11,0,75297.27,810.4545,97.81818
"22235","71347","2016",9,9,0,115700,1326,90.77778
"22236","71348","2016",1,1,0,130000,1182,110
"22237","71350","2016",6,6,0,119500,1160,90.5
"22238","71351","2016",31,30,1,121239.8,1146.968,105.5161
"22239","71352","2016",1,1,0,175000,893,196
"22240","71353","2016",3,3,0,198666.7,2034.333,99
"22241","71354","2016",6,6,0,97833.33,1027.667,106.5
"22242","71355","2016",4,4,0,90250,1005.25,92
"22243","71356","2016",5,5,0,101020,1038.2,94.2
"22244","71357","2016",4,4,0,136250,1009.25,150.75
"22245","71359","2016",8,8,0,132630.9,1561.5,90
"22246","71360","2016",12,12,0,218637.7,1938.5,117.9167
"22247","71361","2016",1,1,0,83000,606,137
"22248","71362","2016",6,6,0,151025,1540.5,95.83333
"22249","71363","2016",2,2,0,140000,1120,147.5
"22250","71365","2016",6,6,0,112833.3,1056.167,108.5
"22251","71366","2016",5,5,0,115200,1161.6,100.2
"22252","71367","2016",5,5,0,88200,1139,79.8
"22253","71368","2016",7,7,0,116914.3,893.7143,136.1429
"22254","71369","2016",4,4,0,105487.5,1346.75,77
"22255","71370","2016",10,10,0,97980,1015.8,97.6
"22256","71371","2016",15,12,3,171587.3,1731.333,100
"22257","71372","2016",19,19,0,166710.5,1531.211,111.0526
"22258","71373","2016",15,15,0,103165.9,1068.733,99.73333
"22259","71376","2016",4,4,0,71425,812.5,79.75
"22260","71378","2016",10,9,1,188400,1673.6,116.8
"22261","71379","2016",16,16,0,107156.2,1161.625,92.5
"22262","71380","2016",9,9,0,135111.1,1324.111,101
"22263","71381","2016",1,1,0,160000,1495,107
"22264","71382","2016",6,6,0,97237.5,1161.5,89.33333
"22265","71383","2016",1,1,0,135900,2265,60
"22266","71384","2016",2,2,0,136835,1586,84
"22267","71385","2016",5,5,0,325261.6,3282,94
"22268","71387","2016",4,4,0,67000,879.75,75.75
"22269","71388","2016",7,7,0,85400,1186.571,70.57143
"22270","71390","2016",13,13,0,89499.38,1056.615,88
"22271","71391","2016",9,9,0,111181.1,1070.556,104.4444
"22272","71392","2016",5,5,0,74000,936.2,74
"22273","71393","2016",3,3,0,201566.7,1631.333,126
"22274","71394","2016",9,7,2,83694.44,1023.556,86.11111
"22275","71395","2016",2,2,0,150200,1343.5,110
"22276","71396","2016",4,4,0,113050,1156.5,95.5
"22277","71398","2016",11,11,0,155204.5,1563,107
"22278","71399","2016",5,5,0,119051,1226.4,104.2
"22279","71400","2016",3,3,0,116816.7,1747.333,65.66667
"22280","71401","2016",6,6,0,122916.7,1146.167,101.3333
"22281","71402","2016",9,9,0,196442.3,1422.222,136.3333
"22282","71403","2016",5,5,0,143030,1490.4,94
"22283","71404","2016",10,6,4,119672.5,1474.4,80.4
"22284","71405","2016",2,2,0,116000,1286.5,89
"22285","71406","2016",2,2,0,126000,1127,112
"22286","71407","2016",1,1,0,50000,1000,50
"22287","71408","2016",4,4,0,119865.2,944.75,132.75
"22288","71409","2016",4,4,0,96162.25,966.25,108.5
"22289","71410","2016",7,7,0,114982,1228.429,104.5714
"22290","71411","2016",2,2,0,89111,1170,96
"22291","71412","2016",11,11,0,174109.1,1445.545,123.5455
"22292","71413","2016",4,3,1,103000,1112.5,98.25
"22293","71414","2016",4,4,0,67000,817.5,81
"22294","71415","2016",1,1,0,45000,957,47
"22295","71416","2016",3,3,0,93766.67,910.6667,97.66667
"22296","71417","2016",12,12,0,122400,1239.75,91.08333
"22297","71419","2016",31,31,0,110103.2,1155.258,99.87097
"22298","71420","2016",15,15,0,156996.7,1418.733,119.6667
"22299","71421","2016",1,1,0,85000,1232,69
"22300","71422","2016",1,1,0,1e+05,1852,54
"22301","71423","2016",1,1,0,173000,1491,116
"22302","71424","2016",3,3,0,73000,854.3333,84
"22303","71425","2016",5,5,0,123600,1028.8,116.6
"22304","71426","2016",6,6,0,151948.3,1322.167,131
"22305","71427","2016",1,1,0,1e+05,833,120
"22306","71428","2016",6,6,0,87450,1070.333,88.33333
"22307","71430","2016",2,2,0,289000,2161.5,139.5
"22308","71431","2016",5,5,0,136276,1283,111.2
"22309","71433","2016",3,3,0,118296.7,1078.333,109
"22310","71434","2016",3,3,0,162830,1680.333,110.3333
"22311","71435","2016",2,2,0,115250,1292.5,91.5
"22312","71436","2016",4,4,0,153450,1616,93.75
"22313","71437","2016",3,3,0,148800,891,151
"22314","71438","2016",9,9,0,91200,933.7778,91.33333
"22315","71439","2016",3,3,0,99151.67,1166.667,85.33333
"22316","71440","2016",3,3,0,71333.33,773.6667,94
"22317","71442","2016",21,19,2,117935.7,1333.905,92.95238
"22318","71443","2016",22,22,0,166323.2,1640.955,103.5455
"22319","71444","2016",8,8,0,139312.5,1497.875,95.75
"22320","71445","2016",65,53,12,138848.7,1559.723,91.41538
"22321","71446","2016",1,1,0,1e+05,1538,65
"22322","71447","2016",4,4,0,130387.5,1245.5,103.25
"22323","71448","2016",8,8,0,164706.2,1623.5,104.75
"22324","71450","2016",1,1,0,52000,722,72
"22325","71451","2016",2,2,0,87250,988,84
"22326","71452","2016",2,2,0,158750,4199,37.5
"22327","71453","2016",1,1,0,79000,1129,70
"22328","71455","2016",2,2,0,161775,1875.5,155.5
"22329","71456","2016",18,18,0,139775.6,1311.333,113.1111
"22330","71457","2016",1,1,0,160000,1119,143
"22331","71458","2016",1,1,0,97250,1118,87
"22332","71459","2016",3,3,0,165596.7,1427.667,113.6667
"22333","71460","2016",10,10,0,195500,2171.7,96.5
"22334","71461","2016",1,1,0,300400,2329,129
"22335","71462","2016",5,5,0,167520,1588.2,105.8
"22336","71463","2016",2,2,0,134925,1387.5,99
"22337","71464","2016",4,4,0,99125,1452,80.25
"22338","71465","2016",2,2,0,107000,885.5,112
"22339","71466","2016",1,1,0,18000,429,42
"22340","71468","2016",7,7,0,131065.7,1233,107
"22341","71469","2016",5,5,0,47500,633.4,67.8
"22342","71470","2016",4,4,0,163485,1398.25,116.25
"22343","71472","2016",5,5,0,48000,698.2,72
"22344","71475","2016",57,49,8,127503.7,1404.825,90.35088
"22345","71477","2016",5,5,0,158200,1216.2,135.8
"22346","71479","2016",14,14,0,152868.2,1475.429,106
"22347","71480","2016",7,7,0,124287.1,1323.714,96.14286
"22348","71481","2016",9,9,0,199383.3,1734.778,119
"22349","71482","2016",4,4,0,124250,1161.25,99.75
"22350","71484","2016",16,16,0,91125,932.25,100.4375
"22351","71485","2016",7,7,0,171542.9,1401.286,124.8571
"22352","71486","2016",78,70,8,97838.5,1121.115,88.05128
"22353","71488","2016",1,1,0,50000,1064,47
"22354","71489","2016",6,6,0,136216.7,1301.5,107.6667
"22355","71490","2016",8,8,0,90425,919.25,96
"22356","71491","2016",11,11,0,98168.18,931,100.4545
"22357","71492","2016",2,2,0,55500,697.5,78
"22358","71493","2016",5,5,0,61795,895.4,67.4
"22359","71494","2016",2,2,0,107500,1260,87.5
"22360","71495","2016",3,2,1,144000,1341.333,101.3333
"22361","71496","2016",3,3,0,192000,1526.333,120.6667
"22362","71497","2016",18,10,8,176245.7,1915.944,96.61111
"22363","71499","2016",39,39,0,97586.92,1044.615,91.69231
"22364","71502","2016",15,15,0,146727.8,1387.2,111.6
"22365","71503","2016",2,2,0,147100,1406,106.5
"22366","71505","2016",1,1,0,30000,349,86
"22367","71506","2016",14,14,0,105649.1,1207.571,88.21429
"22368","71507","2016",1,1,0,42000,420,100
"22369","71508","2016",9,9,0,94833.33,923.4444,101.7778
"22370","71509","2016",7,7,0,101171.4,1197.857,82.85714
"22371","71510","2016",6,6,0,69050,786.8333,87.83333
"22372","71512","2016",23,21,2,123287,1367.087,97.52174
"22373","71513","2016",9,9,0,169116.7,1533.333,112.3333
"22374","71514","2016",8,8,0,105027.8,956.375,105
"22375","71515","2016",1,1,0,143000,1312,109
"22376","71516","2016",8,8,0,101875,881.25,113
"22377","71517","2016",5,5,0,99160,775,130.2
"22378","71518","2016",3,3,0,171670,1716.333,112.3333
"22379","71520","2016",8,8,0,153910,1626.25,99.625
"22380","71521","2016",2,2,0,59000,1289.5,47.5
"22381","71522","2016",20,19,1,109425,1301,89.95
"22382","71523","2016",12,12,0,101204.2,1185.25,86.91667
"22383","71524","2016",2,2,0,89250,1432,77.5
"22384","71525","2016",10,10,0,192425,1615.1,117.9
"22385","71526","2016",3,3,0,153666.7,1744.667,86.33333
"22386","71527","2016",1,1,0,68000,667,102
"22387","71528","2016",18,18,0,136311.1,1572.556,93.11111
"22388","71529","2016",5,5,0,137100,1230.8,113
"22389","71530","2016",8,8,0,118006.2,943.125,127.5
"22390","71531","2016",1,1,0,212545,1288,165
"22391","71532","2016",1,1,0,159900,1126,142
"22392","71533","2016",2,2,0,55500,535,106
"22393","71535","2016",1,1,0,70000,700,100
"22394","71538","2016",3,3,0,99333.33,1136.333,86.33333
"22395","71539","2016",2,2,0,109000,1298,84.5
"22396","71540","2016",13,13,0,160810,1972.923,109.5385
"22397","71541","2016",3,3,0,134270,1691,93
"22398","71542","2016",9,9,0,73027.78,998,85.33333
"22399","71543","2016",56,45,11,129569.7,1299.232,91.75
"22400","71544","2016",2,2,0,110770,1739.5,72.5
"22401","71545","2016",9,9,0,130633.3,1335,101.3333
"22402","71546","2016",5,5,0,107394,1318.8,87.6
"22403","71547","2016",2,2,0,197175,1082.5,170.5
"22404","71548","2016",4,4,0,117900,1226.25,93.75
"22405","71550","2016",7,7,0,92357.14,918.2857,104.5714
"22406","71551","2016",1,1,0,31447,1258,25
"22407","71552","2016",6,6,0,69150,780.6667,82.16667
"22408","71553","2016",2,2,0,170400,1787.5,96
"22409","71554","2016",2,2,0,71500,570.5,123.5
"22410","71555","2016",13,13,0,172199,1538,109.1538
"22411","71556","2016",7,1,6,133081.7,2178.429,63.42857
"22412","71557","2016",9,9,0,122594.4,1289.778,95.66667
"22413","71558","2016",9,9,0,153253.2,1320.889,118.2222
"22414","71559","2016",4,4,0,72000,841.75,88.25
"22415","71561","2016",4,4,0,166000,1518.75,110.75
"22416","71563","2016",1,1,0,48000,1116,43
"22417","71564","2016",3,3,0,80666.67,942.6667,82
"22418","71565","2016",2,2,0,89000,946,94
"22419","71566","2016",10,9,1,106070,1074.1,106
"22420","71567","2016",1,1,0,240000,2087,115
"22421","71568","2016",1,1,0,70000,625,112
"22422","71570","2016",5,5,0,108400,1134.6,96.4
"22423","71571","2016",2,2,0,110000,989.5,105
"22424","71573","2016",1,1,0,60000,531,113
"22425","71574","2016",10,10,0,173160,1660.4,108.3
"22426","71576","2016",3,3,0,191653.3,1284,150.3333
"22427","71577","2016",1,1,0,260000,1182,220
"22428","71578","2016",3,3,0,130266.7,1355,98.33333
"22429","71579","2016",3,3,0,58333.33,955,74.33333
"22430","71580","2016",2,2,0,101500,1252.5,79.5
"22431","71582","2016",6,6,0,131658.3,1327.833,100.3333
"22432","71583","2016",5,5,0,232800,1837.6,127.2
"22433","71584","2016",8,7,1,153760,1423.125,107.75
"22434","71585","2016",8,7,1,143491.2,1581.25,89.875
"22435","71586","2016",1,1,0,25000,532,47
"22436","71588","2016",11,10,1,107695.5,1130.727,96.63636
"22437","71589","2016",3,3,0,115000,1155.667,94.66667
"22438","71590","2016",2,2,0,122325,1420.5,87.5
"22439","71591","2016",4,4,0,149675,1305.75,116
"22440","72001","2016",1,1,0,172000,1564,110
"22441","72002","2016",1,1,0,75000,824,91
"22442","72003","2016",66,37,29,95058.68,1208.288,75.27273
"22443","72004","2016",10,10,0,121748.9,1314.4,102
"22444","72005","2016",4,4,0,92837.5,906,104.5
"22445","72006","2016",16,16,0,156681.2,1456.125,111.125
"22446","72007","2016",2,2,0,35000,991.5,34
"22447","72008","2016",65,65,0,146950.5,1520.492,97.96923
"22448","72009","2016",4,4,0,130625,1100,117.75
"22449","72010","2016",5,5,0,110460,1497.4,71
"22450","72011","2016",12,12,0,109300,1250.833,87.58333
"22451","72012","2016",4,4,0,69250,1136.75,57.25
"22452","72013","2016",23,22,1,81405.22,1034.435,84.17391
"22453","72015","2016",1,1,0,40000,597,67
"22454","72016","2016",17,17,0,103328.1,1011.294,109.8235
"22455","72017","2016",1,1,0,135000,1731,78
"22456","72018","2016",1,1,0,65000,406,160
"22457","72019","2016",2,2,0,50500,913.5,56.5
"22458","72020","2016",15,15,0,117622.5,1416.8,89.4
"22459","72021","2016",8,8,0,101875,1316.125,75
"22460","72022","2016",11,11,0,106300,1115.727,99.81818
"22461","72023","2016",18,18,0,83197.56,895.8333,90.38889
"22462","72024","2016",38,37,1,163249.7,1699.579,98.71053
"22463","72025","2016",25,24,1,144932.9,1443.76,97.4
"22464","72026","2016",16,16,0,95768.75,1213.062,81.8125
"22465","72027","2016",4,4,0,190625,2926.5,81.75
"22466","72028","2016",10,10,0,100300,899.7,108.7
"22467","72029","2016",19,19,0,112110.5,1255.579,87.31579
"22468","72031","2016",8,8,0,84977.5,1405.625,75.625
"22469","72032","2016",3,3,0,72666.67,914,73.33333
"22470","72034","2016",6,6,0,143333.3,1348.333,114.1667
"22471","72035","2016",22,20,2,76694.68,862.9091,89.31818
"22472","72036","2016",3,3,0,132600,1283.667,110.6667
"22473","72037","2016",5,5,0,82450,991.4,86.8
"22474","72038","2016",11,11,0,95360,1144.909,83.54545
"22475","72039","2016",39,37,2,74599.74,892.6667,80.38462
"22476","72040","2016",2,2,0,90000,916,97.5
"22477","72041","2016",3,3,0,136666.7,1159.333,127
"22478","72042","2016",24,24,0,117183.3,1236.792,99
"22479","72043","2016",3,3,0,82333.33,934,89
"22480","72044","2016",5,5,0,131400,1293,106.2
"22481","72045","2016",11,11,0,148455.4,1403.455,110.8182
"22482","72046","2016",14,14,0,121864.3,1243.071,98.35714
"22483","72047","2016",3,3,0,129333.3,1567,82
"22484","72048","2016",7,7,0,121042.9,1263.429,97.42857
"22485","72049","2016",2,2,0,110000,1053.5,96
"22486","72050","2016",11,11,0,158318.2,1146.818,129.1818
"22487","72051","2016",24,24,0,136132.4,1349.875,103.375
"22488","72052","2016",9,9,0,114000,1093.111,106.6667
"22489","72053","2016",11,11,0,117130.9,1308.909,90.81818
"22490","72054","2016",32,32,0,154931.9,1546.594,102.1875
"22491","72056","2016",14,13,1,138642.9,1533.286,91.35714
"22492","72058","2016",58,57,1,194931,1776.983,113.3103
"22493","72059","2016",7,7,0,113807.1,1021.571,115.5714
"22494","72060","2016",2,2,0,67632.5,1067,68.5
"22495","72061","2016",13,13,0,102260.4,1085.846,94.69231
"22496","72062","2016",9,9,0,120011.1,1191.556,100.3333
"22497","72064","2016",6,6,0,81600,1000.333,78.16667
"22498","72065","2016",16,16,0,186089.7,1744.625,103.25
"22499","72066","2016",8,8,0,140168.8,1487.25,94.875
"22500","72067","2016",21,21,0,118904.8,1377.429,93.95238
"22501","72068","2016",19,18,1,90651.05,1018.789,89.05263
"22502","72070","2016",3,3,0,39833.33,742.3333,51.66667
"22503","72071","2016",53,51,2,85612.26,1057.66,81.9434
"22504","72072","2016",3,3,0,85566.67,917.3333,90.66667
"22505","72073","2016",6,6,0,149000,1505.833,99.83333
"22506","72074","2016",1,1,0,30000,345,87
"22507","72075","2016",6,6,0,120000,1524.667,78.16667
"22508","72076","2016",3,3,0,162383.3,1483.333,109.3333
"22509","72077","2016",6,6,0,58333.33,923.8333,64.66667
"22510","72078","2016",2,2,0,80000,952,83.5
"22511","72079","2016",2,2,0,127000,1648.5,77
"22512","72080","2016",16,16,0,148507.5,1474.75,103.8125
"22513","72083","2016",4,4,0,148625,1453.25,98.5
"22514","72084","2016",19,19,0,114384.2,1208.474,96.73684
"22515","72085","2016",3,3,0,74166.67,582,117.3333
"22516","72087","2016",2,2,0,150050,1458.5,105
"22517","72088","2016",3,3,0,115166.7,1075,117.6667
"22518","72089","2016",26,26,0,106355.3,1216.385,89.92308
"22519","72090","2016",32,32,0,90091.09,1230.781,76.15625
"22520","72091","2016",1,1,0,50000,833,60
"22521","72093","2016",8,8,0,90837.5,1015.75,86
"22522","72094","2016",7,7,0,105614.3,1018.429,106
"22523","72095","2016",47,37,10,143119.7,1529.553,92.40426
"22524","72096","2016",3,3,0,155000,1107.333,147.3333
"22525","72098","2016",4,4,0,47900,764.5,62
"22526","72099","2016",5,5,0,132400,1089.2,129
"22527","72100","2016",7,7,0,77428.57,843.7143,98
"22528","72101","2016",9,9,0,101162,1075.667,91.44444
"22529","72103","2016",6,6,0,174000,1142.667,128.6667
"22530","72104","2016",3,3,0,127666.7,1191,108.3333
"22531","72105","2016",4,4,0,114250,1035,91.25
"22532","72106","2016",5,5,0,130400,1047.8,130
"22533","72107","2016",2,2,0,87500,763,120.5
"22534","72109","2016",2,2,0,60000,762.5,81
"22535","72110","2016",7,7,0,95771.43,1136,85
"22536","72111","2016",3,3,0,105666.7,1022.333,97.33333
"22537","72112","2016",5,5,0,96600,1114.6,93.4
"22538","72113","2016",9,9,0,186055.6,1520.556,126.3333
"22539","72114","2016",3,3,0,111666.7,791.3333,135
"22540","72115","2016",7,7,0,89014.29,1092.571,84
"22541","72118","2016",18,18,0,109593.9,1126.167,97.83333
"22542","72119","2016",4,4,0,94250,1747,59
"22543","72121","2016",4,4,0,63740,616.25,106.25
"22544","72122","2016",11,11,0,112323,1276.727,88.18182
"22545","72123","2016",1,1,0,57500,1402,41
"22546","72124","2016",39,37,2,127336.6,1244.949,105.359
"22547","72125","2016",4,4,0,143750,862.25,171.75
"22548","72126","2016",7,7,0,159544,1449.286,116.1429
"22549","72127","2016",15,15,0,118605.7,1239.733,93.53333
"22550","72128","2016",2,2,0,102500,875.5,124.5
"22551","72129","2016",7,7,0,149380,1536.143,99.85714
"22552","72130","2016",2,2,0,192500,1406.5,135.5
"22553","72131","2016",9,9,0,101532.2,1274.556,74
"22554","72132","2016",100,75,25,115529.4,1367.72,86.86
"22555","72133","2016",12,12,0,176363.3,1616.083,118.5
"22556","72134","2016",8,8,0,84375,942.25,93
"22557","72135","2016",5,5,0,86600,981.8,95.4
"22558","72136","2016",3,3,0,105666.7,1338.333,75.66667
"22559","72137","2016",26,26,0,133055.8,1257.5,105.4231
"22560","72138","2016",24,24,0,93741.67,992.3333,101.4167
"22561","72139","2016",8,8,0,107562.5,1172.75,96.75
"22562","72141","2016",3,3,0,112333.3,1250.333,94
"22563","72142","2016",4,4,0,114890,950.75,128
"22564","72143","2016",13,13,0,88776.92,973.0769,88.30769
"22565","72144","2016",13,13,0,117084.6,1170.462,90.15385
"22566","72145","2016",3,3,0,103333.3,977,99.66667
"22567","72146","2016",33,33,0,162083,1544.061,106.5152
"22568","72147","2016",16,16,0,115381.2,1405.312,83.25
"22569","72148","2016",2,2,0,94400,896.5,105
"22570","72149","2016",5,5,0,173186,1915.8,88.6
"22571","72150","2016",19,19,0,154907.9,1515.211,104.2632
"22572","72151","2016",10,9,1,112240,1144.4,95.9
"22573","72152","2016",4,4,0,96250,1143.25,85.5
"22574","72153","2016",7,7,0,120466,1176.143,105.7143
"22575","72154","2016",157,148,9,125149.5,1306.968,96.98089
"22576","72155","2016",22,22,0,161043.2,1497.591,111.8636
"22577","72156","2016",12,12,0,168021.7,1409.417,108.75
"22578","72157","2016",5,5,0,223500,1346,167.8
"22579","72158","2016",12,12,0,91159.75,1211.083,77.66667
"22580","72160","2016",5,5,0,94000,908.6,95.8
"22581","72161","2016",10,10,0,81700,871.8,89.9
"22582","72163","2016",4,4,0,86187.5,887.5,92
"22583","72164","2016",2,2,0,101565,1198.5,85.5
"22584","72165","2016",22,22,0,128832.1,1306.864,103.1364
"22585","72166","2016",3,3,0,195733.3,2020.333,91.66667
"22586","72167","2016",10,10,0,147070,1451.2,102.9
"22587","72168","2016",21,21,0,96690.52,1030.762,91.42857
"22588","72169","2016",12,12,0,140393.9,1412.25,100.0833
"22589","72171","2016",2,2,0,115500,1224,99.5
"22590","72172","2016",19,19,0,113944.2,1194.789,100.1579
"22591","72173","2016",18,18,0,104972.2,1212.667,91.22222
"22592","72174","2016",1,1,0,80000,2000,40
"22593","72175","2016",25,25,0,119403.9,1220.12,109.52
"22594","72176","2016",20,20,0,93300.35,905.6,99.75
"22595","72177","2016",6,6,0,160093.3,1773.667,89.83333
"22596","72178","2016",3,3,0,116000,1242,123.6667
"22597","72179","2016",27,27,0,72608.52,1028.556,70.66667
"22598","72180","2016",58,52,6,98735.34,1187.155,80.03448
"22599","72181","2016",2011,1108,903,124377.2,1603.979,76.20985
"22600","72182","2016",17,17,0,89297.06,1243.412,72.17647
"22601","72183","2016",9,9,0,132222.2,1258.444,99.22222
"22602","72184","2016",1,1,0,105000,1400,75
"22603","72185","2016",6,6,0,75750,792.6667,103.8333
"22604","72186","2016",12,12,0,113591.7,1236.667,91.66667
"22605","72187","2016",14,14,0,108651.4,1168.5,96.5
"22606","72188","2016",2,2,0,103000,1306.5,74.5
"22607","72189","2016",16,16,0,102621.8,1122.188,92.0625
"22608","72190","2016",6,6,0,108014.8,1215.333,87.66667
"22609","72191","2016",39,39,0,100455.9,1214.41,86.71795
"22610","72193","2016",5,5,0,99300,897.2,109.4
"22611","72194","2016",4,4,0,92500,1141.25,81.25
"22612","72195","2016",31,31,0,117284.5,1278.258,92.32258
"22613","72196","2016",6,6,0,91000,1005,101.5
"22614","72197","2016",7,7,0,112428.6,1184.857,99
"22615","72198","2016",26,26,0,179787.4,1752.115,105.1154
"22616","72199","2016",6,6,0,104583.3,1109.833,94
"22617","72200","2016",33,33,0,158072.5,1681.939,96.93939
"22618","72201","2016",3,3,0,80000,812.6667,103
"22619","72202","2016",2,2,0,78000,974,79
"22620","72204","2016",3,3,0,134566.7,1110.333,117.6667
"22621","72205","2016",32,31,1,168793,1474.312,113
"22622","72208","2016",5,5,0,71600,893.4,77
"22623","72209","2016",9,9,0,86946.67,1051,85.88889
"22624","72210","2016",3,3,0,36666.67,568.6667,69
"22625","72211","2016",3,3,0,48333.33,1024.667,71.66667
"22626","72212","2016",6,6,0,118503.5,1080.833,108.5
"22627","72213","2016",50,50,0,172940.7,1809.46,97.72
"22628","72215","2016",10,10,0,95160,1050.8,91.4
"22629","72216","2016",8,8,0,81437.5,1135.125,71.625
"22630","72217","2016",19,19,0,127059.9,1382.789,90.21053
"22631","72218","2016",4,4,0,65750,560,110
"22632","72219","2016",7,7,0,110876.7,1023.714,111
"22633","72220","2016",13,13,0,110153.8,1130.692,93
"22634","72221","2016",4,4,0,136112.8,1270.5,107.75
"22635","72222","2016",2,2,0,90250,1281.5,72
"22636","72223","2016",23,23,0,96971.74,1220.87,83.26087
"22637","72224","2016",3,3,0,77666.67,852.6667,84.33333
"22638","72225","2016",3,3,0,145000,854,172.6667
"22639","72226","2016",13,13,0,140970.8,1269.538,114.6923
"22640","72227","2016",1,1,0,208000,2039,102
"22641","72228","2016",29,29,0,123689.8,1338.897,88.41379
"22642","72229","2016",4,4,0,115625,989,119.5
"22643","72230","2016",6,6,0,124666.7,1378.667,91.33333
"22644","72231","2016",58,57,1,151597.3,1635.241,92.98276
"22645","72232","2016",9,9,0,140222.2,1282.889,110.6667
"22646","72234","2016",4,4,0,146750,1558.25,94.75
"22647","72235","2016",3,3,0,102590,1170,90.66667
"22648","72237","2016",5,5,0,132000,782,163.6
"22649","72238","2016",1,1,0,70000,897,78
"22650","72239","2016",7,7,0,112428.6,1073.714,104.7143
"22651","72241","2016",29,29,0,134879.3,1319.655,103.7241
"22652","72243","2016",18,18,0,105288.9,1065.111,102.2778
"22653","72244","2016",9,9,0,207611.1,2621.778,96.77778
"22654","72245","2016",3,3,0,128000,1244,105.3333
"22655","72246","2016",5,5,0,62402,933.2,61.8
"22656","72247","2016",14,14,0,169895.7,1529.214,113.3571
"22657","72248","2016",8,8,0,98022.25,1125.375,82.625
"22658","72249","2016",7,7,0,130170.6,1232.429,100.7143
"22659","72250","2016",3,3,0,139666.7,1573.333,91.33333
"22660","72251","2016",2,2,0,67750,527.5,125.5
"22661","72252","2016",18,18,0,108388.9,1159,95.22222
"22662","72253","2016",25,25,0,129860,1376.24,92.24
"22663","72254","2016",1,1,0,114000,1373,83
"22664","72255","2016",13,13,0,90791.77,1076.692,82.69231
"22665","72256","2016",5,5,0,88940,950.2,88.8
"22666","72257","2016",10,10,0,261340,2104.1,123.4
"22667","72259","2016",2,2,0,80000,940.5,82
"22668","72260","2016",33,27,6,162750,1727.333,93.21212
"22669","72261","2016",3,3,0,111333.3,1123.333,96
"22670","72262","2016",17,17,0,102588.2,1038.529,101.9412
"22671","72264","2016",77,62,15,106188.6,1306.364,84.98701
"22672","72265","2016",1,1,0,165000,1269,130
"22673","72266","2016",8,8,0,106125,1303.25,80.125
"22674","72267","2016",11,11,0,95954.55,1088.455,91.81818
"22675","72268","2016",6,5,1,111500,1040.5,102.5
"22676","72269","2016",36,35,1,63500,869.5278,70.11111
"22677","72270","2016",1,1,0,93000,1081,86
"22678","72271","2016",13,13,0,106729.2,1172.692,92
"22679","72272","2016",5,5,0,104280,996.2,108.4
"22680","72273","2016",7,7,0,103428.6,1028.571,92.85714
"22681","72274","2016",5,5,0,86413,989,102.4
"22682","72275","2016",9,9,0,121622.2,1196,103.7778
"22683","72276","2016",16,16,0,113925,1169.188,98.875
"22684","72277","2016",2,2,0,83250,1384.5,52.5
"22685","72278","2016",14,14,0,81033.57,848.4286,92.71429
"22686","72279","2016",4,4,0,107082.5,1057.25,103.5
"22687","72280","2016",19,19,0,177078.4,1678.579,108.4737
"22688","72281","2016",3,3,0,102222.3,971.3333,105.3333
"22689","72282","2016",5,5,0,64400,871.4,72.4
"22690","72283","2016",1,1,0,61000,678,90
"22691","72287","2016",22,22,0,119659.7,1213.818,98.77273
"22692","72289","2016",22,22,0,129964.5,1439.727,89.86364
"22693","72290","2016",20,20,0,123640.4,1237.3,98.7
"22694","72291","2016",10,10,0,106129,1021.9,112.1
"22695","72292","2016",4,4,0,94750,1044.75,96
"22696","72293","2016",2,2,0,177350,1609,110.5
"22697","72294","2016",9,8,1,88477.78,983.3333,88.88889
"22698","72295","2016",9,9,0,122833.3,1156.778,106.4444
"22699","72296","2016",5,5,0,91200,1102.4,85.6
"22700","72297","2016",7,7,0,113857.1,1251,94.57143
"22701","72298","2016",9,9,0,94605.56,1162.778,82.44444
"22702","72299","2016",32,32,0,118980.1,1235.375,102
"22703","72300","2016",19,19,0,97905,1314.421,74.89474
"22704","72302","2016",2,2,0,112850,1278,87
"22705","72303","2016",13,13,0,92538.46,1050.923,89.92308
"22706","72305","2016",7,7,0,119771.4,1207.286,102
"22707","72306","2016",2,2,0,169000,1499.5,114.5
"22708","72307","2016",3,3,0,120033.3,966.6667,124.3333
"22709","72308","2016",18,18,0,125727.5,1355.167,90.27778
"22710","72309","2016",7,7,0,137214.3,1331.429,100.1429
"22711","72310","2016",23,23,0,244501.9,1802.87,135.7826
"22712","72311","2016",3,3,0,124276.7,1319,104.6667
"22713","72312","2016",2,2,0,82500,665.5,130
"22714","72314","2016",5,5,0,129760,1192.8,115.6
"22715","72315","2016",4,4,0,98875,1255.25,77.75
"22716","72316","2016",6,6,0,91833.33,814.8333,109.5
"22717","72317","2016",5,5,0,166180,1504.2,89.4
"22718","72319","2016",7,7,0,125393.1,1484.143,83.42857
"22719","72320","2016",17,17,0,234293,1831.824,130.1176
"22720","72321","2016",10,10,0,88700,869.3,96.6
"22721","72322","2016",8,8,0,84250,1144.125,79
"22722","72323","2016",2,2,0,99000,1184,76
"22723","72324","2016",4,4,0,52800,604.75,79.5
"22724","72325","2016",13,13,0,115153.8,1239.923,92.23077
"22725","72326","2016",3,3,0,121666.7,1061,114
"22726","72327","2016",1,1,0,40000,430,93
"22727","72328","2016",38,38,0,190991.6,1793.658,105.7368
"22728","72329","2016",41,41,0,160144,1555.341,103.9024
"22729","72330","2016",4,4,0,96500,1035.25,92.75
"22730","72331","2016",4,4,0,107750,1172.5,107.75
"22731","72332","2016",4,4,0,90600,845.25,107.25
"22732","72333","2016",2,2,0,102807.5,852.5,101.5
"22733","72334","2016",28,28,0,94277.86,1032.571,92.5
"22734","72335","2016",12,12,0,126130.4,1331.333,99.41667
"22735","72336","2016",11,11,0,136318.2,1480,95.72727
"22736","72337","2016",9,9,0,98049.44,1042.222,93.33333
"22737","72338","2016",6,6,0,150766.7,1546.667,96.16667
"22738","72339","2016",2,2,0,142867.5,1115.5,125
"22739","72340","2016",10,10,0,117940,1010.9,116.8
"22740","72341","2016",7,7,0,123142.9,1368.714,93.14286
"22741","72342","2016",3,3,0,124000,912,144.3333
"22742","72343","2016",2,2,0,135000,1100.5,122
"22743","72344","2016",24,24,0,173594.8,1669.25,105.5417
"22744","72345","2016",4,4,0,110825,1452.5,78.5
"22745","72346","2016",46,44,2,129340.4,1391.935,94.06522
"22746","72347","2016",4,4,0,120750,1185.25,101.25
"22747","72348","2016",1,1,0,138000,1423,97
"22748","72349","2016",7,7,0,102178.6,1358.857,82.42857
"22749","72350","2016",23,23,0,177756.5,1444.826,129.1739
"22750","72351","2016",6,6,0,117333.3,1348,96.16667
"22751","72352","2016",1,1,0,181850,1443,126
"22752","72353","2016",4,4,0,151625,1649.75,94.5
"22753","72354","2016",2,2,0,110000,1120.5,118.5
"22754","72356","2016",4,4,0,67875,1067.75,57.75
"22755","72357","2016",9,9,0,97210.78,908,107.2222
"22756","72358","2016",18,18,0,85610.17,1126.611,79.22222
"22757","72359","2016",22,22,0,132863.6,1530.955,87.13636
"22758","72360","2016",3,3,0,144000,1456,98.66667
"22759","72361","2016",6,6,0,97166.67,924.6667,101.6667
"22760","72362","2016",2,2,0,78000,1145,68.5
"22761","72363","2016",22,22,0,106384.3,1144.182,94.27273
"22762","72364","2016",21,21,0,84833.33,846.6667,100.8095
"22763","72366","2016",1,1,0,130000,1313,99
"22764","72367","2016",10,10,0,110908.7,1169.5,96.2
"22765","72368","2016",4,4,0,78428.75,903.75,84.5
"22766","72369","2016",4,4,0,78500,874.5,92.25
"22767","72370","2016",5,5,0,67400,729.4,91.6
"22768","72372","2016",1,1,0,56000,1120,50
"22769","72373","2016",29,29,0,95275.52,1136.448,83.58621
"22770","72374","2016",2,2,0,40750,639,71
"22771","72375","2016",6,6,0,123233.3,1441.5,89.33333
"22772","72376","2016",4,4,0,177392.5,1480.5,123.75
"22773","72377","2016",8,8,0,125812.5,1107.5,121.125
"22774","72378","2016",15,15,0,127013.3,1248.6,103
"22775","72379","2016",4,4,0,83875,913.25,100.5
"22776","72380","2016",10,10,0,83580,1001.1,85.8
"22777","72381","2016",7,7,0,193928.6,1519.571,135.4286
"22778","72382","2016",16,16,0,124259.4,1282.938,100
"22779","72383","2016",1,1,0,83500,746,112
"22780","72385","2016",20,20,0,114447,1459.65,84.85
"22781","72386","2016",35,35,0,194229.1,1620.486,123.4286
"22782","73001","2016",5,2,3,173140,2295.2,65.6
"22783","73003","2016",42,15,27,156639.5,2310.714,71.95238
"22784","73004","2016",16,6,10,96204.69,2162.5,45.75
"22785","73005","2016",4,4,0,231675,2620.75,95
"22786","73006","2016",116,13,103,128218.1,2697.034,50.94828
"22787","73007","2016",19,14,5,169963.2,1860.053,100.4211
"22788","73008","2016",555,89,466,178952.5,2909.969,64.11892
"22789","73010","2016",69,44,25,230528.8,2527.145,95.23188
"22790","73011","2016",232,46,186,130213.6,1789.772,74.69397
"22791","73012","2016",1,1,0,15000,1250,12
"22792","73013","2016",7,1,6,101421.4,2613.857,39
"22793","73014","2016",3,3,0,158666.7,1927.667,83.33333
"22794","73015","2016",128,10,118,338469.6,6762.773,48.36719
"22795","73017","2016",8,7,1,238283.5,2959.75,97.125
"22796","73018","2016",9,4,5,159522.2,1881.333,85.22222
"22797","73019","2016",8,7,1,130599.4,1541,85.25
"22798","73020","2016",1,1,0,210000,2234,94
"22799","73021","2016",8,7,1,140150,1671.75,84
"22800","73022","2016",5,5,0,184620,1978.4,110.8
"22801","73023","2016",18,0,18,125638.9,3096.611,41.5
"22802","73024","2016",59,3,56,124076.3,3530.542,38.79661
"22803","73025","2016",5,5,0,171894,1628.8,104.4
"22804","73026","2016",4,1,3,139675,1623.5,78.25
"22805","73027","2016",3,3,0,138666.7,1303.667,106.6667
"22806","73028","2016",3,3,0,173000,1244,148
"22807","73029","2016",41,8,33,197887.8,2540.561,78.5122
"22808","73030","2016",24,5,19,217500.7,2576.375,87.70833
"22809","73031","2016",62,11,51,198496.2,2747.21,74.14516
"22810","73032","2016",16,14,2,157918.8,1364.812,115.4375
"22811","73033","2016",3,3,0,201916.7,1816.333,112.3333
"22812","73034","2016",51,14,37,177275.7,3624.902,50.15686
"22813","73036","2016",3,3,0,279950,1984.667,143.3333
"22814","73039","2016",2,2,0,122500,1437,82.5
"22815","73040","2016",10,2,8,121346.8,3362.7,38.9
"22816","73041","2016",4,4,0,173000,1451.25,132.25
"22817","73042","2016",2,2,0,151250,1592,105
"22818","73043","2016",15,14,1,223578.7,2404.333,95.46667
"22819","73047","2016",9,1,8,185913.9,4348.556,39.22222
"22820","73048","2016",1,1,0,163000,1132,144
"22821","73049","2016",4,4,0,144301,1372.25,112.75
"22822","73050","2016",5,1,4,253560,3609.4,72.4
"22823","73051","2016",44,12,32,231741.6,3080.932,73.70455
"22824","73052","2016",3,3,0,129010,1775,77
"22825","73053","2016",6,6,0,180544.8,2000,92.16667
"22826","73054","2016",303,18,285,142034.1,3520.482,40.55446
"22827","73055","2016",22,10,12,251669.1,3505.091,72.36364
"22828","73057","2016",49,3,46,114220.3,3048.204,38.91837
"22829","73058","2016",15,12,3,148466,1663.267,90
"22830","73059","2016",19,14,5,263859.7,2766.684,99.42105
"22831","73061","2016",3,3,0,236233.3,2002,120.6667
"22832","73063","2016",5,4,1,250140,2639.8,97.2
"22833","73064","2016",68,18,50,204477.8,2631.691,79.54412
"22834","73065","2016",726,105,621,162069.6,2287.702,72.37741
"22835","73067","2016",7,5,2,149608,1506.143,109
"22836","73068","2016",3,3,0,183333.3,1861.333,98.66667
"22837","73069","2016",9,9,0,198722.2,2263.667,98.66667
"22838","73070","2016",9,9,0,176355.9,1741.556,106.6667
"22839","73071","2016",26,7,19,250309.5,4277.615,62.84615
"22840","73073","2016",5,5,0,147594,1728,80.2
"22841","73074","2016",7,7,0,70992.86,908.1429,79
"22842","73075","2016",4,4,0,190450,1863.75,96.5
"22843","73076","2016",3,3,0,246833.3,4794.333,69
"22844","73077","2016",6,6,0,263708.8,3332.5,78
"22845","73079","2016",6,6,0,198500,1498.333,124.3333
"22846","73081","2016",4,3,1,140975,1432,95.5
"22847","73082","2016",8,6,2,193147.5,1928.5,107.125
"22848","73083","2016",1,1,0,130000,1193,109
"22849","73084","2016",8,8,0,222446.9,2305.5,100.375
"22850","73085","2016",29,20,9,192288.8,1990.483,98.62069
"22851","73086","2016",2,2,0,133500,1872,65.5
"22852","73087","2016",58,11,47,170366.2,2310.931,75.7931
"22853","73088","2016",14,0,14,158443.6,3756.071,39.35714
"22854","73089","2016",13,12,1,291967.7,2252.462,128.9231
"22855","73091","2016",1,1,0,148700,2478,60
"22856","73092","2016",2,2,0,139000,1415.5,102
"22857","73094","2016",23,9,14,344515.7,4332.957,72.91304
"22858","73096","2016",18,17,1,199072.1,2312.5,89.94444
"22859","73097","2016",4,3,1,233970,1934.5,132.75
"22860","73098","2016",14,10,4,151831.9,2346,79
"22861","73099","2016",5,5,0,177148,1842,102.8
"22862","73100","2016",19,17,2,160922.1,1526.211,105.6842
"22863","73103","2016",21,11,10,273063.8,2889.619,96.47619
"22864","73104","2016",2,2,0,212000,2537.5,83.5
"22865","73105","2016",10,6,4,150135,1787.8,88.3
"22866","73106","2016",3,3,0,92266.67,1643,57
"22867","73107","2016",8,7,1,146342.4,2097.25,79.5
"22868","73109","2016",4,3,1,174125,1564.5,113.25
"22869","73110","2016",9,9,0,151088.9,1853.778,81.33333
"22870","73114","2016",11,3,8,140137.8,3131.727,45.45455
"22871","73116","2016",50,7,43,98930.9,2713.58,37.34
"22872","73117","2016",9,0,9,62247.33,875,73.77778
"22873","73120","2016",6,6,0,121333.3,1767.5,71.66667
"22874","73121","2016",10,6,4,173420,1936.9,93.3
"22875","73122","2016",3,3,0,208983.3,1912,117.3333
"22876","73123","2016",16,5,11,189237.3,2704.625,62.5
"22877","73124","2016",32,21,11,180512.2,1886.469,97.8125
"22878","73128","2016",38,20,18,278454.8,3001.289,93.42105
"22879","73129","2016",17,14,3,170703.2,1835.882,89.88235
"22880","73130","2016",8,6,2,160412.5,1797.625,84.125
"22881","73132","2016",60,7,53,200200.2,5347.75,39
"22882","73133","2016",2,2,0,242765.5,2313.5,105
"22883","73135","2016",5,5,0,134973,1358.4,100.2
"22884","73137","2016",42,6,36,180378.6,2750.738,69.02381
"22885","73138","2016",12,11,1,160582.6,2662.333,61.41667
"22886","73139","2016",4,4,0,67500,1297.75,72.75
"22887","73140","2016",3,3,0,242726.7,2076.667,114.6667
"22888","73141","2016",4,4,0,173125,1917.5,90.5
"22889","73142","2016",27,9,18,269869.6,4315.852,59.77778
"22890","73145","2016",4,3,1,138203.8,1874,77.25
"22891","73146","2016",2,2,0,178750,1930.5,91.5
"22892","73147","2016",1,1,0,239500,2495,96
"22893","73149","2016",3,3,0,141266.7,1499.333,89.66667
"22894","73150","2016",280,29,251,135786.2,3542.339,38.55
"22895","73151","2016",19,14,5,235890.9,2303.526,104.2105
"22896","73152","2016",3,3,0,195000,1786.667,111.6667
"22897","73153","2016",5,5,0,198780,1873.4,118.8
"22898","73154","2016",31,19,12,192382.3,2038,96.09677
"22899","73155","2016",14,10,4,287932.5,3027.857,96.35714
"22900","73156","2016",2,2,0,191250,1936,103.5
"22901","73157","2016",58,4,54,78229.84,1617.448,52.08621
"22902","73159","2016",6,6,0,217748.7,2449,90.16667
"22903","73160","2016",6,5,1,236040,2533.5,95.33333
"22904","73161","2016",4,4,0,173437.5,1859.75,92.75
"22905","73162","2016",5,5,0,236532,2425.2,97.6
"22906","73164","2016",8,8,0,263212.5,2479.625,109.875
"22907","73166","2016",1,1,0,123500,1123,110
"22908","73168","2016",1,1,0,106400,1744,61
"22909","73170","2016",2,2,0,137120,1405,119
"22910","73171","2016",31,11,20,164961.1,1958.032,85.06452
"22911","73173","2016",7,6,1,150807.4,1846.286,77.42857
"22912","73175","2016",1,1,0,111910,1622,69
"22913","73176","2016",48,4,44,201353.1,4169.542,46.4375
"22914","73177","2016",3,2,1,208216.7,1673,117.3333
"22915","73178","2016",1,1,0,334000,4175,80
"22916","73179","2016",119,31,88,206645.4,2690.487,78.41176
"22917","73180","2016",3,3,0,104666.7,1547.667,65.33333
"22918","73181","2016",34,4,30,111004,1402.765,81.58824
"22919","73182","2016",32,22,10,268767.8,2913.531,95.5625
"22920","73183","2016",6,6,0,270194.2,2660.167,101.5
"22921","73184","2016",4,4,0,248030,2341.5,106
"22922","73186","2016",32,4,28,145484.2,3791.844,35.9375
"22923","73187","2016",29,20,9,113085.1,1861.414,64.24138
"22924","73188","2016",6,5,1,134125,1465.333,93.66667
"22925","73189","2016",3,2,1,190183.3,1620.667,113.3333
"22926","73190","2016",4,3,1,110800,1563.25,78.5
"22927","73191","2016",20,15,5,254927,2586.65,123.2
"22928","73192","2016",6,6,0,118583.3,1364.167,84.66667
"22929","73193","2016",1,1,0,194000,3233,60
"22930","73194","2016",8,4,4,86675,1422.625,75.875
"22931","73196","2016",3,2,1,197366.7,2686.667,73
"22932","73197","2016",20,5,15,239047.9,3354.4,76.45
"22933","73200","2016",5,3,2,140340,2149.8,74.6
"22934","73201","2016",2,2,0,81240,2751.5,39
"22935","73202","2016",2,2,0,206200,1485.5,133.5
"22936","73204","2016",18,14,4,174913.9,1623.667,118.2778
"22937","73205","2016",3,3,0,71333.33,1147.333,69.66667
"22938","73206","2016",38,7,31,268186.9,4097.316,66.94737
"22939","73207","2016",4,4,0,144369.2,1584,85.25
"22940","73208","2016",13,12,1,492907.7,3560.231,134.7692
"22941","73210","2016",1,1,0,297000,1811,164
"22942","73211","2016",7,7,0,181301.4,2558.143,73.42857
"22943","73212","2016",24,19,5,143823.3,1899.292,80.95833
"22944","73213","2016",81,30,51,215685.3,2433.605,91.45679
"22945","73214","2016",1,1,0,180000,1800,100
"22946","73215","2016",2,2,0,88000,642,110.5
"22947","73216","2016",2,2,0,199675,2372,84
"22948","73217","2016",2,2,0,205075,1827.5,109
"22949","73218","2016",5,5,0,213410,2215.2,97.2
"22950","73219","2016",3,3,0,264433.3,1881.333,137
"22951","73220","2016",2,2,0,137862.5,2425,61.5
"22952","73221","2016",2,2,0,93166.5,1218.5,85
"22953","73222","2016",64,20,44,213406.4,2782.172,79.54688
"22954","73223","2016",11,9,2,135711.9,1418.727,93.72727
"22955","73224","2016",4,3,1,203025,2298.25,89.25
"22956","73225","2016",22,12,10,240683.6,2641.864,96.72727
"22957","73226","2016",15,15,0,178028.5,1693.867,104.0667
"22958","73227","2016",110,16,94,316296.8,6060.327,50.7
"22959","73228","2016",8,7,1,277637.5,2226.625,132.375
"22960","73229","2016",1,1,0,215200,1571,137
"22961","73230","2016",6,5,1,106240,1489.833,63.16667
"22962","73231","2016",8,7,1,161095,1709.5,94.125
"22963","73232","2016",22,14,8,325336,5073.045,69.59091
"22964","73233","2016",1,1,0,235700,1813,130
"22965","73234","2016",3,3,0,152093.3,2351.667,65
"22966","73235","2016",52,5,47,99575.52,2736.077,36.21154
"22967","73236","2016",43,33,10,152708.8,1618.116,95.2093
"22968","73237","2016",3,3,0,105333.3,1688.333,55.33333
"22969","73240","2016",6,5,1,233208.3,1695.167,124.5
"22970","73241","2016",12,12,0,141645.4,1984.417,83.75
"22971","73242","2016",26,4,22,109763.3,2439.077,45.26923
"22972","73243","2016",18,9,9,217364.7,2473.278,91.61111
"22973","73245","2016",6,5,1,199757.3,2122.833,96.33333
"22974","73246","2016",5,5,0,172459,2081.4,81.8
"22975","73247","2016",7,6,1,177617.1,1737.286,102
"22976","73248","2016",84,9,75,112016.9,1494.952,76.33333
"22977","73249","2016",13,2,11,209355.2,2998.846,74.30769
"22978","73250","2016",16,12,4,222914.4,2468.812,89.5625
"22979","73252","2016",1,1,0,159250,2068,77
"22980","73253","2016",4,1,3,152800,1936.25,78
"22981","73254","2016",1,1,0,315630,2466,128
"22982","73255","2016",4,4,0,200625,2014.75,103.75
"22983","73256","2016",5,4,1,131420,1607.6,85
"22984","73257","2016",350,23,327,158525.7,4279.029,34.50571
"22985","73258","2016",7,7,0,141457.1,1140.286,131.4286
"22986","73259","2016",10,7,3,163960,1616.6,99.9
"22987","73261","2016",27,12,15,96774,1234.815,77.22222
"22988","73262","2016",3,2,1,252366.7,4304.667,58.33333
"22989","73263","2016",9,9,0,372433.3,2930.333,135.4444
"22990","73265","2016",2,1,1,222400,1766.5,126.5
"22991","73267","2016",5,4,1,166400,2594.6,69.6
"22992","73268","2016",5,4,1,115450,1643.8,67.6
"22993","73269","2016",8,8,0,181623.1,2216.5,90.75
"22994","73270","2016",29,21,8,150531.9,2080.759,77.31034
"22995","73271","2016",4,4,0,189910,1946.75,87.5
"22996","73272","2016",1,1,0,175000,1562,112
"22997","73273","2016",3,3,0,96167.33,1147,82.33333
"22998","73274","2016",8,7,1,120511.9,1602.375,76.625
"22999","73275","2016",1,1,0,243000,1736,140
"23000","73276","2016",4,4,0,207220,2603.75,79.5
"23001","73277","2016",2,2,0,166500,998,156.5
"23002","73278","2016",17,15,2,138456.1,1500.471,91.29412
"23003","73280","2016",18,3,15,124344.1,3021,42.61111
"23004","73281","2016",5,5,0,283921,2224.2,129.6
"23005","73282","2016",9,8,1,178733.2,1852.889,96.77778
"23006","73283","2016",3,2,1,183833.3,1850.667,121.6667
"23007","73284","2016",8,4,4,198585.5,1772.625,101
"23008","73285","2016",31,9,22,195500.6,2655.452,76.3871
"23009","73286","2016",14,10,4,195839.5,2081.857,93.07143
"23010","73288","2016",12,9,3,257471.7,2731.833,97.5
"23011","73289","2016",6,6,0,131213.3,1777.167,67.16667
"23012","73290","2016",29,4,25,144691.8,2866.897,52.27586
"23013","73292","2016",3,3,0,104433.3,1783,60
"23014","73293","2016",1,1,0,21000,636,33
"23015","73294","2016",1,0,1,206400,6658,31
"23016","73296","2016",175,3,172,179517,4171.16,41.06286
"23017","73297","2016",2,2,0,238925,1906,125
"23018","73298","2016",8,8,0,165516.2,1938.375,81.875
"23019","73299","2016",1,1,0,30000,857,35
"23020","73300","2016",37,18,19,376433.9,3750.757,94.48649
"23021","73301","2016",8,6,2,320462.5,2986.375,115.5
"23022","73302","2016",1,1,0,132000,737,179
"23023","73303","2016",45,31,14,142470.8,1848.8,78.22222
"23024","73304","2016",104,2,102,316353.8,7520.173,39.59615
"23025","73306","2016",55,0,55,190028,4221.564,45.25455
"23026","73307","2016",45,5,40,107242.9,2681.511,39.46667
"23027","73308","2016",1,1,0,215000,1955,110
"23028","73309","2016",1,1,0,128000,1347,95
"23029","73310","2016",2,2,0,392500,2024,193
"23030","73312","2016",9,8,1,222338.9,2034.333,113.4444
"23031","73314","2016",3,3,0,227333.3,2572,101.3333
"23032","73315","2016",5,4,1,119980,1277.6,100.2
"23033","73316","2016",3,3,0,132600,1552.333,83.66667
"23034","73317","2016",39,7,32,242519.3,4871.462,53.5641
"23035","73318","2016",62,0,62,51602.29,1767.661,27.40323
"23036","73320","2016",11,9,2,232609.1,2683.727,94.36364
"23037","73322","2016",37,1,36,77637.86,2287.784,38.45946
"23038","73323","2016",2,1,1,148450,2719.5,57.5
"23039","73326","2016",27,20,7,260651.1,2329.741,117.5185
"23040","73327","2016",4,4,0,158750,1627.5,90.25
"23041","73328","2016",14,11,3,293633.8,2990.929,101.0714
"23042","73329","2016",9,6,3,260993.3,2871.111,87.66667
"23043","73330","2016",26,19,7,112452.7,1565.385,77.15385
"23044","74001","2016",31,17,14,185172,2771.419,66.22581
"23045","74002","2016",21,15,6,255484.8,2931.667,88.47619
"23046","74003","2016",16,10,6,392040,4037.812,105.875
"23047","74004","2016",3,1,2,187088.3,2364.333,77.66667
"23048","74005","2016",49,37,12,356024,3475.939,103.8571
"23049","74006","2016",41,15,26,274617.9,3427.22,85.82927
"23050","74007","2016",12,3,9,258086.2,3309.667,79.33333
"23051","74008","2016",54,8,46,219265.7,3208.352,67.33333
"23052","74009","2016",8,8,0,393750,3341.25,120
"23053","74010","2016",1708,162,1546,261522.1,3695.988,70.71897
"23054","74012","2016",407,13,394,187598.1,2883.904,65.23096
"23055","74013","2016",28,18,10,394578.9,4138.214,99.35714
"23056","74014","2016",189,21,168,187781.6,3847.265,46.06878
"23057","74015","2016",8,6,2,317135.6,2574.75,119.875
"23058","74016","2016",31,13,18,385931,4084.645,94.93548
"23059","74018","2016",22,16,6,298266.8,2790.5,117.0909
"23060","74019","2016",35,10,25,345607.8,3801.829,85.94286
"23061","74020","2016",7,5,2,346592.9,3085.714,109.8571
"23062","74021","2016",10,8,2,313500,3174.2,110.3
"23063","74024","2016",25,18,7,269615.9,2717.72,101.44
"23064","74025","2016",13,13,0,421877.3,3350.846,133
"23065","74026","2016",59,28,31,279207.8,3291.034,89.37288
"23066","74027","2016",1,1,0,420000,2199,191
"23067","74029","2016",7,7,0,303650,2361.143,122.7143
"23068","74030","2016",5,5,0,283800,2524.8,108.8
"23069","74031","2016",31,23,8,437658.8,4272.355,109.5806
"23070","74032","2016",33,9,24,102621.7,2327.848,48.0303
"23071","74033","2016",43,16,27,160595.9,2899.186,56.37209
"23072","74034","2016",22,12,10,235386.8,2906.773,73.04545
"23073","74035","2016",2,2,0,237900,2468,96.5
"23074","74036","2016",3,2,1,340133.3,4178.667,83.33333
"23075","74037","2016",14,14,0,288514.3,2845.143,109.7143
"23076","74038","2016",21,7,14,105596.1,2487.429,38.71429
"23077","74040","2016",23,16,7,299634.3,3578.348,89
"23078","74041","2016",5,4,1,204884,2313,86.4
"23079","74042","2016",121,29,92,178046.2,2496.628,72.80165
"23080","74043","2016",53,30,23,280562,3345.868,83.79245
"23081","74044","2016",15,8,7,458734.7,4462.933,115.2
"23082","74045","2016",10,10,0,222320,2827,82.1
"23083","74046","2016",3,3,0,350966.7,3198.333,110.3333
"23084","74048","2016",4,4,0,351892.8,3352.25,110.25
"23085","74049","2016",12,12,0,141272.5,2278.583,72
"23086","74050","2016",5,5,0,262460,3174.6,89.6
"23087","74051","2016",6,4,2,303703.3,4205.167,75.83333
"23088","74052","2016",6,6,0,351816.7,2942,121.3333
"23089","74053","2016",9,9,0,370018.4,2929.444,128.5556
"23090","74054","2016",4,4,0,279350,3090.75,98.5
"23091","74055","2016",5,5,0,297590,2492.4,116.4
"23092","74056","2016",354,56,298,362901.1,6158.285,54.81921
"23093","74057","2016",7,7,0,379552.6,3267,115.8571
"23094","74058","2016",50,7,43,194167.1,3473.86,54.14
"23095","74059","2016",1,1,0,253000,2691,94
"23096","74061","2016",9,5,4,280116.6,3229.111,94
"23097","74062","2016",12,8,4,287646.2,3077,91.66667
"23098","74063","2016",84,9,75,207665.1,4292.821,47.55952
"23099","74064","2016",9,8,1,203521.1,2772.556,86.33333
"23100","74065","2016",5,5,0,347300,3005.2,119.4
"23101","74066","2016",1,1,0,407200,3284,124
"23102","74068","2016",2,2,0,185000,1887,100
"23103","74069","2016",9,5,4,342550,3458.222,97.44444
"23104","74070","2016",39,20,19,406969.2,4002.487,104
"23105","74071","2016",1,1,0,301100,2981,101
"23106","74072","2016",1,1,0,379950,2733,139
"23107","74073","2016",10,10,0,185883.4,2268.4,84.9
"23108","74074","2016",2,0,2,212560,3265,65.5
"23109","74075","2016",17,15,2,238631.7,2828.706,86.82353
"23110","74076","2016",12,11,1,373748.3,3224.583,118.5833
"23111","74077","2016",12,12,0,310487.5,2958.917,112.25
"23112","74078","2016",7,6,1,272862.4,3341.571,91.85714
"23113","74079","2016",7,7,0,432390,2828.429,151
"23114","74080","2016",84,17,67,357826.3,7030.5,51.44048
"23115","74081","2016",167,29,138,149972.6,2139.653,70.97006
"23116","74082","2016",69,24,45,349730.7,4097.507,86.2029
"23117","74083","2016",41,13,28,366525.6,5025.317,66.65854
"23118","74085","2016",61,13,48,220532.9,3964.557,53.27869
"23119","74086","2016",7,5,2,273542.9,2635.571,110.7143
"23120","74087","2016",21,18,3,307165.7,3664.762,88.19048
"23121","74088","2016",10,4,6,321454,3479.7,98.8
"23122","74089","2016",26,5,21,262971.2,3913.769,66.26923
"23123","74090","2016",12,6,6,320700.4,2879.667,118.5833
"23124","74091","2016",9,6,3,285511.8,4589.333,62.55556
"23125","74094","2016",68,54,14,370088.2,3665.368,103.8676
"23126","74095","2016",2,2,0,202250,2975,68.5
"23127","74096","2016",48,15,33,258322.1,3363.75,84.22917
"23128","74097","2016",11,11,0,263925.5,2224.455,118.3636
"23129","74098","2016",17,11,6,314320,3067.882,104.0588
"23130","74099","2016",27,5,22,429816.3,5750.667,52.96296
"23131","74100","2016",6,5,1,286258.3,2170.833,139.8333
"23132","74101","2016",5,5,0,299164,3036.8,89.2
"23133","74102","2016",13,13,0,394462.3,3654.846,120.2308
"23134","74103","2016",11,6,5,240868.2,2660.273,99.18182
"23135","74104","2016",39,16,23,228125.2,3139.333,77.15385
"23136","74105","2016",64,33,31,288858.4,3416.828,84.82812
"23137","74106","2016",7,6,1,305042.9,3397.429,89.85714
"23138","74107","2016",1,1,0,280000,2456,114
"23139","74108","2016",18,5,13,312994.7,5357.722,71.38889
"23140","74109","2016",13,11,2,255000,2373.923,109.3846
"23141","74112","2016",89,33,56,307878.9,3482.775,91.21348
"23142","74114","2016",11,6,5,520895.9,5623.818,91.81818
"23143","74116","2016",22,15,7,320754.5,2741.318,120.7727
"23144","74117","2016",1,0,1,273877,2227,123
"23145","74118","2016",27,11,16,260991.5,3616.63,72.7037
"23146","74119","2016",193,29,164,244169.5,3587.446,68.41969
"23147","74121","2016",19,15,4,323890.3,3694.211,84.68421
"23148","74122","2016",3,3,0,251218.3,2306,100
"23149","74123","2016",80,36,44,173032.7,2161.162,80.8
"23150","74124","2016",18,9,9,361986.1,3977.611,92.05556
"23151","74126","2016",13,13,0,292892.3,3228,92.07692
"23152","74127","2016",12,8,4,232970.4,2609.5,92.33333
"23153","74128","2016",45,32,13,338544.5,3146.067,102.4889
"23154","74129","2016",3,2,1,159066.7,2226.333,84.33333
"23155","74130","2016",1,1,0,397280,2530,157
"23156","74131","2016",17,14,3,214571.5,2307.588,95.35294
"23157","74133","2016",114,18,96,185925.4,3170.719,55.86842
"23158","74134","2016",89,19,70,344489,5976.921,56.64045
"23159","74135","2016",8,2,6,143850.9,2068.75,71.75
"23160","74136","2016",110,18,92,267370.4,4767.236,53.81818
"23161","74137","2016",44,20,24,250247.9,3149.25,84.81818
"23162","74138","2016",24,11,13,230862.9,2809.833,87.125
"23163","74139","2016",9,8,1,248717.1,2467.111,103.6667
"23164","74140","2016",42,17,25,153056.2,2387.167,61.71429
"23165","74141","2016",10,5,5,209585.7,3188.3,69.9
"23166","74142","2016",6,4,2,213283.3,2154.333,101.6667
"23167","74143","2016",117,39,78,329366.3,5434.06,60.04274
"23168","74144","2016",9,8,1,307485.4,2399.444,128.3333
"23169","74145","2016",5,4,1,291700,3048,84.4
"23170","74146","2016",9,6,3,267478.4,2712.333,101.8889
"23171","74147","2016",8,7,1,293002.5,3583.875,120.625
"23172","74148","2016",4,1,3,241627.2,3355,66.25
"23173","74150","2016",21,20,1,411142.8,3465.524,121.6667
"23174","74151","2016",5,5,0,276290,2657.2,110.4
"23175","74152","2016",13,10,3,356693.8,3054.154,127.5385
"23176","74153","2016",28,22,6,395900,3859.786,105.2857
"23177","74154","2016",24,14,10,356763.8,3792.75,98.375
"23178","74155","2016",11,10,1,219470.9,2857.364,82.72727
"23179","74156","2016",5,5,0,302341.8,2798.4,106.4
"23180","74157","2016",14,13,1,327721.4,3375,108
"23181","74158","2016",13,10,3,320010,4208.231,77
"23182","74159","2016",27,13,14,152902.2,2566.815,68.37037
"23183","74160","2016",61,18,43,259017.5,4534.705,51.27869
"23184","74161","2016",7,7,0,397569.1,2898.429,138.5714
"23185","74162","2016",8,7,1,378237.5,3389.875,111.375
"23186","74163","2016",17,16,1,347497.2,3131.353,109.4706
"23187","74164","2016",48,26,22,204320.7,2476.396,81.0625
"23188","74165","2016",4,2,2,187850,1935,133.5
"23189","74166","2016",15,14,1,348973.3,3046.333,111.4
"23190","74167","2016",14,12,2,204980.4,2269.071,92.71429
"23191","74168","2016",14,9,5,287820.7,2833.214,102.2143
"23192","74169","2016",61,26,35,202088.3,2381.59,87.93443
"23193","74170","2016",3,3,0,273300,2412.333,114.3333
"23194","74171","2016",21,20,1,374788.6,3149.048,121
"23195","74172","2016",22,18,4,327340.2,3774.773,95.90909
"23196","74173","2016",177,19,158,521851,7435.446,65.16949
"23197","74174","2016",7,6,1,224264.3,2560.143,92.14286
"23198","74175","2016",11,3,8,170441.9,2808.455,64.09091
"23199","74176","2016",28,14,14,477218.2,4621.679,98.67857
"23200","74177","2016",13,10,3,301446.8,2946.538,115.6154
"23201","74178","2016",4,4,0,127250,1175,116.5
"23202","74179","2016",11,10,1,254310,2481.909,110.5455
"23203","74180","2016",25,19,6,491135.2,3996.16,117.76
"23204","74183","2016",33,14,19,210062.1,3037.909,73.0303
"23205","74184","2016",6,4,2,303413.7,3021.667,102
"23206","74185","2016",18,14,4,290427.5,3313.333,89.94444
"23207","74186","2016",1,1,0,295800,3698,80
"23208","74188","2016",22,3,19,138609.5,3910.955,34.59091
"23209","74189","2016",50,19,31,115554.8,2187.28,50.12
"23210","74190","2016",49,7,42,138036.5,3383.551,39.5102
"23211","74191","2016",257,24,233,262380.2,5504.062,43.78988
"23212","74192","2016",7,7,0,292433.4,2206.429,129.2857
"23213","74193","2016",7,6,1,352314.3,2612.143,129.5714
"23214","74194","2016",12,12,0,315055.7,2793.333,114.8333
"23215","74196","2016",6,6,0,237158.3,2745.333,85.33333
"23216","74197","2016",19,12,7,299182.2,3210.684,90.57895
"23217","74198","2016",10,8,2,422369,2961.8,144.9
"23218","74199","2016",5,2,3,239816.8,3576,66.2
"23219","74200","2016",44,32,12,347103.7,3594.091,99.65909
"23220","74201","2016",19,11,8,419564.4,3994,103.0526
"23221","74202","2016",6,3,3,276700.8,2451,116.5
"23222","74203","2016",1,1,0,4e+05,5714,70
"23223","74205","2016",20,6,14,108724.5,2458.55,41.2
"23224","74206","2016",5,5,0,321730,3934.6,93
"23225","74208","2016",133,48,85,217147.3,2953.722,75.41353
"23226","74209","2016",7,7,0,349950,3241,119.7143
"23227","74210","2016",17,13,4,253257.4,3027,82.47059
"23228","74211","2016",26,22,4,277987.2,2644.269,109.4231
"23229","74212","2016",29,26,3,181827.8,2334.31,81.37931
"23230","74213","2016",90,32,58,311993.6,3654.622,87.26667
"23231","74215","2016",79,6,73,202288.3,3902.595,49.25316
"23232","74216","2016",8,5,3,393728.8,3751.875,129.25
"23233","74218","2016",79,46,33,329159.7,3805.342,85.41772
"23234","74219","2016",20,17,3,417353.2,3530.8,122.95
"23235","74220","2016",84,29,55,299545.1,3272.381,92.4881
"23236","74221","2016",8,7,1,152752.6,2943.25,55.75
"23237","74222","2016",4,2,2,196460.8,2392.5,81
"23238","74223","2016",8,8,0,356143.8,4495.375,85.625
"23239","74224","2016",145,40,105,235178.3,3001.724,80.02759
"23240","74225","2016",205,53,152,164788.4,2251.532,75.04878
"23241","74226","2016",2,2,0,431275,2502.5,188.5
"23242","74228","2016",4,3,1,364167.5,3502.75,108.75
"23243","74229","2016",37,27,10,311497.1,3343.514,95.32432
"23244","74231","2016",8,8,0,206174.1,2689.625,85
"23245","74232","2016",7,5,2,289580,2531.857,112.4286
"23246","74233","2016",24,16,8,214639.8,2664.167,80.5
"23247","74234","2016",9,8,1,221490,2685.889,93.88889
"23248","74235","2016",10,9,1,226642.1,2583.1,97.5
"23249","74236","2016",217,50,167,236566.6,3896.843,59.90323
"23250","74237","2016",18,6,12,214798.6,2790.556,79
"23251","74238","2016",52,16,36,206446,3355.846,60.94231
"23252","74239","2016",21,5,16,203507.8,3835.571,55.33333
"23253","74240","2016",12,11,1,218042,2700.917,86.83333
"23254","74241","2016",33,11,22,119799.8,2007.909,55.39394
"23255","74242","2016",88,46,42,406259.9,4090.58,99.81818
"23256","74243","2016",177,24,153,289371,3558.503,79.66667
"23257","74244","2016",5,4,1,194414,2412,84.2
"23258","74249","2016",29,22,7,244466.7,3089.241,81.2069
"23259","74250","2016",61,27,34,239614,2853.689,84.44262
"23260","74252","2016",4,4,0,256500,3654,88.25
"23261","74253","2016",11,11,0,360980.5,2886.273,132.2727
"23262","74254","2016",6,5,1,275793.3,2642.667,129
"23263","74255","2016",20,14,6,260720.2,2562.4,101.9
"23264","74256","2016",231,34,197,188685.8,2806.009,67.77489
"23265","74257","2016",3,2,1,202433.3,3011.333,69.66667
"23266","74258","2016",106,25,81,244438.7,3827.66,62.25472
"23267","74259","2016",6,6,0,312600.8,3078.333,105.6667
"23268","74260","2016",13,13,0,305730.8,2834.231,112.9231
"23269","74261","2016",7,5,2,240638.6,3749.286,70
"23270","74262","2016",10,7,3,312802.1,3076.3,106.5
"23271","74263","2016",64,48,16,348513.6,3781.578,95.90625
"23272","74264","2016",84,46,38,191844.8,2237.917,86.94048
"23273","74265","2016",8,6,2,275382.5,3097,98.875
"23274","74266","2016",21,13,8,257852.2,4513.143,61
"23275","74267","2016",60,21,39,394464.8,4359.033,88.61667
"23276","74269","2016",25,13,12,170431.3,2217.88,79.12
"23277","74271","2016",5,5,0,355730,3739,92.8
"23278","74272","2016",46,25,21,266841.2,3093.174,88.52174
"23279","74273","2016",11,8,3,215681.8,2268.091,94.54545
"23280","74275","2016",39,14,25,390918.5,4228.179,90.82051
"23281","74276","2016",100,27,73,139946.1,2719.28,51.1
"23282","74278","2016",55,26,29,216356.4,2587.927,84.89091
"23283","74279","2016",70,19,51,135157.5,2656.014,49.97143
"23284","74280","2016",79,22,57,228497.5,3278.127,71.73418
"23285","74281","2016",461,82,379,209434,2998.469,70.42082
"23286","74282","2016",82,58,24,294271.6,3158.28,97.09756
"23287","74283","2016",16,14,2,221594.4,2395.875,99.3125
"23288","74284","2016",12,7,5,195492.5,2651.917,73.58333
"23289","74285","2016",3,3,0,262333.3,1719.333,149.6667
"23290","74286","2016",13,11,2,200796.2,2589,85.38462
"23291","74287","2016",8,4,4,206831.9,2355.75,87.625
"23292","74288","2016",48,28,20,296074.3,3351.062,87.0625
"23293","74289","2016",11,8,3,216086.9,2169.455,101.6364
"23294","74290","2016",6,5,1,360050,3374.667,109.5
"23295","74291","2016",3,3,0,132733.3,2531.333,57.66667
"23296","74292","2016",4,4,0,258553.8,3654,138.5
"23297","74293","2016",58,32,26,395874.6,3705.914,104.3276
"23298","74294","2016",13,10,3,372463.8,4669.769,80.15385
"23299","74295","2016",2,2,0,383250,2948,130
"23300","74296","2016",4,1,3,214457.5,2886.5,79.25
"23301","74297","2016",5,4,1,240014.4,2596,104.4
"23302","74298","2016",94,33,61,313211.6,3588.894,82.18085
"23303","74299","2016",34,26,8,851052.1,6565.853,128.0882
"23304","74301","2016",9,6,3,216034.8,2206.111,106.1111
"23305","74302","2016",9,7,2,246005.6,3337.556,79.44444
"23306","74303","2016",28,19,9,368251.9,3334.179,116.8214
"23307","74304","2016",5,3,2,232809.2,3488.8,80.6
"23308","74305","2016",75,25,50,278188.1,3631.493,76.08
"23309","74306","2016",5,4,1,284808,3541.4,78.8
"23310","74307","2016",9,5,4,329728.2,3445.778,91.11111
"23311","74308","2016",11,11,0,335172.7,2955.455,121.9091
"23312","74309","2016",84,38,46,322556.2,3648.548,90.40476
"23313","74310","2016",7,4,3,333978.6,3124.714,106.7143
"23314","74311","2016",50,35,15,242733.7,3221.3,82.14
"23315","74312","2016",10,9,1,289695,2833.6,101
"23316","74313","2016",8,6,2,278517.4,2954.875,101.25
"23317","74314","2016",17,13,4,335528.2,3166.176,109.1176
"23318","74315","2016",17,15,2,409811.5,4302.588,102.7059
"23319","75056","2016",28144,118,28026,441105.7,8244.506,52.86903
"23320","76001","2016",7,7,0,162857.1,1533.857,104.1429
"23321","76002","2016",5,5,0,174440,1651.2,107.4
"23322","76004","2016",4,4,0,97250,1153.5,86
"23323","76005","2016",27,27,0,137684.4,1676.704,86.37037
"23324","76006","2016",2,2,0,182000,1447.5,127
"23325","76007","2016",5,5,0,154420,1604.4,90.4
"23326","76008","2016",7,7,0,169957.1,1640.857,107.8571
"23327","76009","2016",3,3,0,151666.7,1650,90.33333
"23328","76010","2016",3,3,0,211966.7,1408.667,154
"23329","76011","2016",5,5,0,136818,1371.4,101.8
"23330","76012","2016",2,2,0,101000,979.5,100.5
"23331","76013","2016",7,7,0,112542.9,1322.571,82.28571
"23332","76014","2016",9,9,0,173101.7,1802.111,100.5556
"23333","76016","2016",1,1,0,60000,857,70
"23334","76017","2016",6,6,0,197863.5,2702.5,94.33333
"23335","76018","2016",13,13,0,137859.4,1423.231,98.15385
"23336","76019","2016",4,4,0,126250,1558.75,92
"23337","76020","2016",10,10,0,147620,1379.2,107.2
"23338","76021","2016",10,10,0,199420.8,1828.6,112.1
"23339","76022","2016",4,4,0,101375,1213.25,83.5
"23340","76023","2016",3,3,0,167333.3,1517,114.3333
"23341","76024","2016",2,2,0,86250,877,97
"23342","76025","2016",3,3,0,75000,1092.333,72.33333
"23343","76026","2016",24,23,1,113764.6,1497.875,79.25
"23344","76028","2016",2,2,0,92500,1107.5,89.5
"23345","76029","2016",2,2,0,104000,1815.5,64.5
"23346","76030","2016",5,5,0,163110,1595.8,101.4
"23347","76032","2016",6,6,0,166196.8,1596.5,104.6667
"23348","76033","2016",7,7,0,144071.4,1595.857,101.1429
"23349","76034","2016",15,14,1,150233.3,1475.067,102.3333
"23350","76035","2016",14,13,1,127483,1341.286,92.42857
"23351","76036","2016",10,10,0,163492.3,1727.8,98.7
"23352","76038","2016",8,8,0,188893.8,1692.5,118.625
"23353","76039","2016",13,13,0,257555.4,1990.923,135.6154
"23354","76040","2016",2,2,0,197400,1597.5,129.5
"23355","76041","2016",11,11,0,147709.1,1493,104.5455
"23356","76043","2016",6,6,0,172000,1620,103.6667
"23357","76045","2016",4,4,0,182575,1354.25,134.75
"23358","76046","2016",5,5,0,200584,2149.4,97.2
"23359","76047","2016",2,2,0,85436,1193.5,69
"23360","76048","2016",1,1,0,180000,1579,114
"23361","76049","2016",3,3,0,94333.33,1286.333,76.66667
"23362","76050","2016",8,8,0,146925,1428.125,109.75
"23363","76051","2016",10,10,0,135869,1367.2,103
"23364","76053","2016",1,1,0,90000,968,93
"23365","76054","2016",4,4,0,86000,996.5,87
"23366","76055","2016",2,2,0,178250,1772,100
"23367","76056","2016",10,10,0,142000,1587.2,99.2
"23368","76057","2016",98,95,3,152351.7,1711.531,89.37755
"23369","76058","2016",1,1,0,73500,1838,40
"23370","76060","2016",5,5,0,150600,1496.6,105.8
"23371","76062","2016",3,3,0,160333.3,2174,77.33333
"23372","76063","2016",4,4,0,114625,1212,98
"23373","76064","2016",7,7,0,234857.1,2127.143,113
"23374","76065","2016",5,5,0,87760,1063.2,83
"23375","76067","2016",15,15,0,108922.7,1283.8,87.33333
"23376","76068","2016",6,6,0,143325,1578.167,91.33333
"23377","76069","2016",29,29,0,253364.1,2231.759,114.4483
"23378","76070","2016",3,3,0,45333.33,711,65
"23379","76072","2016",8,8,0,148662.5,1565.25,106
"23380","76074","2016",2,2,0,248985,2339,113
"23381","76075","2016",1,1,0,77500,605,128
"23382","76076","2016",5,5,0,102400,1122.4,94.8
"23383","76077","2016",5,5,0,263400,1655.4,164.8
"23384","76079","2016",8,8,0,171762.5,1793.875,104.25
"23385","76082","2016",5,5,0,162760,1255.8,127
"23386","76083","2016",1,1,0,116000,1055,110
"23387","76084","2016",1,1,0,76000,1226,62
"23388","76085","2016",2,2,0,110500,1507.5,78.5
"23389","76086","2016",3,3,0,191000,1531.333,136.6667
"23390","76087","2016",8,8,0,155562.5,1598,99.875
"23391","76088","2016",4,4,0,129787.5,1599.5,82.25
"23392","76090","2016",12,12,0,217908.3,2179.417,107.8333
"23393","76091","2016",2,2,0,140500,3566,63.5
"23394","76092","2016",2,2,0,76395,1091.5,70
"23395","76093","2016",6,6,0,97187,1091.167,94.16667
"23396","76094","2016",7,7,0,181950,1805.571,104
"23397","76095","2016",94,53,41,206983.1,1979.17,99.21277
"23398","76096","2016",9,9,0,128644.4,1296.778,100.8889
"23399","76099","2016",9,9,0,188611.1,1522.111,128.5556
"23400","76100","2016",10,10,0,169850,1572.9,108.4
"23401","76101","2016",16,14,2,135343.8,1705.875,88.3125
"23402","76103","2016",107,50,57,177122.2,2093.841,85.18692
"23403","76104","2016",3,3,0,141338,1320.667,92
"23404","76105","2016",3,3,0,105666.7,1518,67.66667
"23405","76106","2016",6,6,0,235066.7,1902.667,128
"23406","76107","2016",1,1,0,60000,682,88
"23407","76108","2016",211,128,83,262490.9,2495.166,104.6351
"23408","76109","2016",2,2,0,260500,2047,140
"23409","76112","2016",3,3,0,104833.3,1071,97.66667
"23410","76113","2016",2,2,0,98100,1086,92
"23411","76114","2016",142,122,20,93357.56,1350.317,72.43662
"23412","76115","2016",8,8,0,148006.2,1487.875,97.875
"23413","76116","2016",38,38,0,196292,1874.658,108.7632
"23414","76117","2016",9,9,0,223153.3,1886,118.8889
"23415","76118","2016",1,1,0,180000,3600,50
"23416","76119","2016",1,1,0,250000,2500,100
"23417","76120","2016",4,4,0,123500,1062.75,120.75
"23418","76121","2016",6,6,0,141958.3,1630.667,88.5
"23419","76122","2016",3,3,0,115000,1297.667,86.33333
"23420","76123","2016",8,8,0,278390,2121.875,131.125
"23421","76124","2016",5,5,0,125000,1301.8,104.2
"23422","76125","2016",10,10,0,134200,1398.2,88.5
"23423","76126","2016",2,2,0,155000,1276.5,128.5
"23424","76128","2016",6,6,0,220250,1945.833,112.3333
"23425","76129","2016",1,1,0,117912,1965,60
"23426","76130","2016",2,2,0,98250,1491,65.5
"23427","76131","2016",6,5,1,150008.3,1600.5,97.66667
"23428","76132","2016",8,8,0,140946.5,1523.875,91
"23429","76133","2016",6,6,0,101666.7,1900.5,74.66667
"23430","76134","2016",3,3,0,177056.7,2010.333,99
"23431","76135","2016",9,9,0,172718,1623.778,116.6667
"23432","76136","2016",6,6,0,118823,1382,85.33333
"23433","76138","2016",5,5,0,199680,1887.2,107
"23434","76141","2016",16,16,0,141367.5,1566.438,93.125
"23435","76142","2016",9,9,0,149857,1691.111,101.7778
"23436","76143","2016",10,10,0,175000,1726,106.5
"23437","76144","2016",1,1,0,205000,1577,130
"23438","76146","2016",26,25,1,146026.9,1671.231,93.92308
"23439","76147","2016",7,7,0,146521.4,1150.143,129
"23440","76148","2016",4,4,0,98917.5,1217.25,79.75
"23441","76149","2016",2,2,0,104500,949.5,124
"23442","76151","2016",3,3,0,83000,978.6667,84
"23443","76152","2016",5,5,0,130040,1692.4,85.2
"23444","76153","2016",2,2,0,171840,1372.5,124.5
"23445","76154","2016",2,2,0,65000,1170,57
"23446","76155","2016",2,2,0,323500,2023,149.5
"23447","76156","2016",3,3,0,139933.3,1793,79
"23448","76157","2016",83,61,22,152314.5,1713.506,88.75904
"23449","76158","2016",5,5,0,129200,1448.8,88.8
"23450","76159","2016",15,15,0,130921.7,1441.133,93.46667
"23451","76160","2016",4,4,0,135000,1643.25,82.5
"23452","76161","2016",2,2,0,189625,2186,94
"23453","76162","2016",3,3,0,167500,1034.667,159.6667
"23454","76163","2016",5,5,0,191040,1604,120.4
"23455","76164","2016",37,33,4,135159.5,1481.405,91.32432
"23456","76165","2016",81,63,18,128739.8,1465.654,88.34568
"23457","76166","2016",4,4,0,78250,955.75,82.75
"23458","76167","2016",15,15,0,216253.3,2312.4,100.7333
"23459","76169","2016",13,13,0,256300,2026.769,127.6154
"23460","76171","2016",4,4,0,200050,1531.5,130.5
"23461","76172","2016",2,2,0,60581,453,134.5
"23462","76173","2016",2,2,0,156100,1527,105
"23463","76174","2016",3,3,0,155800,1242.333,124.3333
"23464","76175","2016",1,1,0,157375,1590,99
"23465","76176","2016",2,2,0,165600,1288,167.5
"23466","76177","2016",1,1,0,74100,1176,63
"23467","76178","2016",18,18,0,160921.7,1592,103.7222
"23468","76179","2016",20,18,2,176935,1841.2,101.25
"23469","76181","2016",1,1,0,139000,1264,110
"23470","76182","2016",1,1,0,1e+05,909,110
"23471","76183","2016",6,6,0,136025,1702.167,86.66667
"23472","76184","2016",4,4,0,185500,1554.75,125.5
"23473","76185","2016",2,2,0,131500,1280.5,103
"23474","76186","2016",5,5,0,125600,1416,81
"23475","76187","2016",2,2,0,245000,1643.5,151
"23476","76188","2016",3,3,0,149516.7,1467.333,100
"23477","76189","2016",2,2,0,198250,1733,116
"23478","76190","2016",2,2,0,117000,2165.5,77
"23479","76192","2016",87,72,15,116847.7,1715.885,70.58621
"23480","76193","2016",6,6,0,146958.3,1557.333,104.8333
"23481","76194","2016",4,4,0,162829.8,1824.75,89.25
"23482","76196","2016",19,18,1,176123.2,1818.737,99.89474
"23483","76197","2016",5,5,0,147660,1414.8,105.8
"23484","76198","2016",5,5,0,149120,2240.2,87.8
"23485","76199","2016",6,6,0,165166.7,2087.333,93.83333
"23486","76200","2016",4,4,0,165000,1777,92.25
"23487","76201","2016",2,2,0,146975,1676.5,90.5
"23488","76202","2016",2,2,0,120500,1035,133.5
"23489","76203","2016",8,8,0,166541.8,1490.625,113.125
"23490","76204","2016",2,2,0,135000,1300,105
"23491","76205","2016",2,2,0,178000,1366,143
"23492","76206","2016",7,7,0,175285.7,1584.857,109.4286
"23493","76207","2016",3,3,0,104266.7,1898,64.33333
"23494","76208","2016",5,5,0,141518,1645.4,88.8
"23495","76209","2016",5,5,0,202400,1541.2,127
"23496","76210","2016",5,5,0,112000,1337.2,82.2
"23497","76211","2016",4,4,0,59843,931,61.25
"23498","76212","2016",83,63,20,142299,1735.506,83.10843
"23499","76213","2016",4,4,0,131250,1634,81.25
"23500","76214","2016",2,2,0,126000,1280,98
"23501","76216","2016",110,60,50,131577,1779.718,74.62727
"23502","76217","2016",359,155,204,116337,1722.228,69.10864
"23503","76219","2016",23,22,1,124723,1334.826,100.3478
"23504","76220","2016",4,4,0,123625,2099.25,63.25
"23505","76221","2016",3,3,0,132783.3,1756.333,76.33333
"23506","76222","2016",41,37,4,147547.3,1697.707,88.73171
"23507","76223","2016",2,2,0,170650,2138,82.5
"23508","76224","2016",9,9,0,196838.9,2283.111,95.66667
"23509","76225","2016",6,6,0,205133.3,2376,103
"23510","76226","2016",1,1,0,189500,1739,109
"23511","76227","2016",7,7,0,188235.7,1525.143,123.5714
"23512","76228","2016",3,3,0,126000,1570,83
"23513","76229","2016",6,6,0,196266.7,1863.833,105
"23514","76230","2016",2,2,0,133000,1898,72.5
"23515","76231","2016",118,64,54,105794.1,1367.364,78.11017
"23516","76232","2016",4,4,0,140850,1624.5,86.75
"23517","76233","2016",1,1,0,37000,544,68
"23518","76234","2016",11,11,0,189109.1,1839.273,110.9091
"23519","76235","2016",11,9,2,127454.5,1488.364,87.18182
"23520","76236","2016",3,3,0,136266.7,1347,100.6667
"23521","76237","2016",2,2,0,188750,2307.5,84.5
"23522","76238","2016",22,22,0,205721.8,2215.5,97.5
"23523","76239","2016",5,5,0,176600,1600.2,120.6
"23524","76240","2016",15,14,1,147613.3,1631.933,92.6
"23525","76242","2016",2,2,0,96750,1380,64.5
"23526","76243","2016",3,3,0,174500,2018.667,98.33333
"23527","76244","2016",3,3,0,136900,1282.333,103
"23528","76245","2016",13,13,0,185675.8,1763.615,106.5385
"23529","76247","2016",4,4,0,163800,1640.25,102.5
"23530","76249","2016",7,7,0,131057.1,1549.571,87.14286
"23531","76250","2016",7,7,0,166714.3,1495.143,132.5714
"23532","76251","2016",1,1,0,132000,1347,98
"23533","76252","2016",10,10,0,154990,1583.9,99.9
"23534","76253","2016",5,5,0,183000,1694.6,108.6
"23535","76254","2016",36,23,13,172661.6,2424.278,76.72222
"23536","76255","2016",92,68,24,112326.6,1347.707,85.51087
"23537","76257","2016",2,2,0,54500,925.5,57.5
"23538","76258","2016",31,28,3,128495,1429.323,91.16129
"23539","76259","2016",222,162,60,121019.5,1589.086,78.27928
"23540","76260","2016",17,17,0,122735.3,1572.529,81.11765
"23541","76261","2016",5,5,0,122240,1488.8,84.8
"23542","76262","2016",1,1,0,153000,1759,87
"23543","76263","2016",12,11,1,173695.8,1898.583,112.6667
"23544","76264","2016",3,3,0,137000,1435.333,97
"23545","76265","2016",1,1,0,110000,1486,74
"23546","76266","2016",4,4,0,94157,1322,70.75
"23547","76268","2016",1,1,0,45000,2250,20
"23548","76269","2016",1,1,0,182100,1182,154
"23549","76270","2016",30,30,0,281353.3,2412.933,119.1333
"23550","76271","2016",17,17,0,153582.4,1673.588,91.58824
"23551","76272","2016",4,4,0,122287.5,1453,83.5
"23552","76273","2016",5,5,0,183746.4,1417,133.2
"23553","76275","2016",11,11,0,237227.3,2044.727,118
"23554","76276","2016",48,44,4,112766.5,1326.062,89.20833
"23555","76278","2016",8,8,0,88625,726.875,122
"23556","76279","2016",5,5,0,158900,1545.4,103.6
"23557","76281","2016",13,13,0,189709.8,1821.308,107.6154
"23558","76282","2016",8,8,0,150812.5,1416.25,102
"23559","76283","2016",3,3,0,198600,1635.667,133
"23560","76285","2016",5,5,0,194600,1634.2,122.6
"23561","76286","2016",5,5,0,119200,995.2,122.6
"23562","76287","2016",11,11,0,193781.8,1821.818,107
"23563","76288","2016",3,3,0,76833.33,1128.667,70
"23564","76289","2016",17,17,0,133764.3,1343.824,101.2941
"23565","76290","2016",1,1,0,239000,1882,127
"23566","76291","2016",14,14,0,147239.5,1626.429,100.6429
"23567","76292","2016",4,4,0,140250,2301,63.75
"23568","76293","2016",4,4,0,95750,1314,77
"23569","76295","2016",7,7,0,179142.9,1346.571,121.7143
"23570","76296","2016",25,25,0,203860,2106.96,102.64
"23571","76297","2016",3,3,0,135833.3,1459.667,93
"23572","76298","2016",5,4,1,151500,1655.8,93.4
"23573","76300","2016",5,5,0,144000,1757.8,89.8
"23574","76302","2016",25,19,6,157176,1963.8,84.56
"23575","76303","2016",12,12,0,183395.8,2004.083,90.5
"23576","76304","2016",4,4,0,173750,1707.25,100
"23577","76305","2016",40,40,0,147753.6,1938.15,80.5
"23578","76306","2016",5,5,0,169780,1240.2,144.4
"23579","76307","2016",14,14,0,187735.7,2007.643,99.35714
"23580","76308","2016",3,3,0,181400,1322.667,169
"23581","76309","2016",2,2,0,142500,1521.5,92.5
"23582","76311","2016",5,5,0,153010,1809.2,87.2
"23583","76312","2016",37,31,6,117459.7,1524.541,81.24324
"23584","76313","2016",6,5,1,177080,1745.333,96.83333
"23585","76314","2016",8,8,0,181425,1817.875,99.25
"23586","76315","2016",11,11,0,130100,1282.909,101.5455
"23587","76316","2016",8,8,0,177387.5,1654.875,109.25
"23588","76317","2016",1,1,0,239000,1457,164
"23589","76318","2016",7,7,0,152795.6,1626,91
"23590","76319","2016",79,79,0,159678.3,1792.038,92.81013
"23591","76320","2016",4,4,0,49062.5,1055.25,58.5
"23592","76321","2016",14,13,1,111339.3,1320.929,87.28571
"23593","76322","2016",127,77,50,159106.4,2065.039,78
"23594","76323","2016",2,2,0,114000,1218.5,96.5
"23595","76324","2016",6,6,0,154583.3,1347,121.3333
"23596","76325","2016",7,7,0,144928.6,1134.571,133.8571
"23597","76327","2016",5,5,0,163170,1388.4,112
"23598","76329","2016",33,30,3,140962.1,1534.758,92.57576
"23599","76330","2016",6,6,0,201069.5,1506.667,136.3333
"23600","76331","2016",2,2,0,156050,2485,63
"23601","76332","2016",7,7,0,162785.7,1435.143,129.8571
"23602","76333","2016",8,8,0,79822.62,1143.875,72
"23603","76334","2016",3,3,0,81877.67,883.3333,94.33333
"23604","76335","2016",3,3,0,209500,2625,82.33333
"23605","76336","2016",4,4,0,204750,2206,90.25
"23606","76338","2016",6,6,0,125333.3,1722.833,77.16667
"23607","76339","2016",2,2,0,186365,1563,127
"23608","76340","2016",5,5,0,122200,1432.8,84.6
"23609","76341","2016",87,65,22,135749.2,1866.195,76.50575
"23610","76342","2016",6,6,0,120658.3,995.6667,120.1667
"23611","76343","2016",2,2,0,196350,1861,105
"23612","76344","2016",2,2,0,85954.5,1189,76.5
"23613","76345","2016",10,10,0,111710,1208.5,92.7
"23614","76346","2016",3,3,0,126266.7,952,135.6667
"23615","76347","2016",3,3,0,116000,1569.333,73
"23616","76348","2016",5,5,0,147580,1418.8,102.2
"23617","76349","2016",23,22,1,209393.5,2132,99.08696
"23618","76350","2016",2,1,1,154500,2079.5,71
"23619","76351","2016",1918,774,1144,136879,1890.545,72.16788
"23620","76352","2016",3,3,0,109733.3,988.6667,111
"23621","76353","2016",2,2,0,141000,1428,104
"23622","76354","2016",16,16,0,203693.8,1748.062,110.5625
"23623","76355","2016",1,1,0,275000,1809,152
"23624","76357","2016",5,5,0,170672,1817.2,94
"23625","76358","2016",1,1,0,127500,1992,64
"23626","76359","2016",1,1,0,329000,1645,200
"23627","76360","2016",9,9,0,102783.3,1277.889,84.44444
"23628","76361","2016",7,7,0,201032.9,1955.571,105.5714
"23629","76362","2016",3,3,0,110600,1519.667,67.66667
"23630","76363","2016",4,4,0,101750,1402.25,76.25
"23631","76364","2016",6,6,0,164166.7,1367.667,121.5
"23632","76366","2016",35,34,1,137852.9,1626.543,88.71429
"23633","76367","2016",29,28,1,229377.6,2076.69,113.8276
"23634","76368","2016",1,1,0,170000,1429,119
"23635","76369","2016",8,8,0,165062.5,1609.375,103.875
"23636","76370","2016",3,3,0,186500,1480,130.6667
"23637","76371","2016",1,1,0,90000,600,150
"23638","76372","2016",2,2,0,69000,1063,65
"23639","76373","2016",3,3,0,144833.3,2012,71.33333
"23640","76374","2016",21,21,0,91235.71,1282.952,73.85714
"23641","76375","2016",4,4,0,355500,2011,188.75
"23642","76377","2016",28,24,4,294530.3,2363.679,125.8929
"23643","76378","2016",11,11,0,150522.7,1801.455,87.27273
"23644","76380","2016",4,4,0,127000,1330,112.75
"23645","76381","2016",2,2,0,80000,1395,63.5
"23646","76382","2016",8,8,0,125325,1532.625,81.875
"23647","76383","2016",1,1,0,140500,1756,80
"23648","76384","2016",78,67,11,108013.6,1562.474,73
"23649","76385","2016",17,17,0,160594.1,1556.471,104.7647
"23650","76386","2016",3,3,0,120150,1396.667,87
"23651","76387","2016",2,2,0,196000,924,218
"23652","76388","2016",5,5,0,152380,1211.6,132
"23653","76389","2016",1,1,0,1e+05,952,105
"23654","76390","2016",12,12,0,159374.8,1718.083,92.58333
"23655","76391","2016",20,20,0,171573,1690.7,106.65
"23656","76392","2016",10,10,0,113590,1393.6,85.1
"23657","76394","2016",6,6,0,82666.67,1328,63
"23658","76395","2016",4,4,0,152750,1215.25,119.25
"23659","76396","2016",3,3,0,139333.3,2155.667,67.33333
"23660","76397","2016",9,9,0,116833.3,1163.222,100.5556
"23661","76398","2016",7,7,0,172428.6,1614.857,109.1429
"23662","76399","2016",3,3,0,102433.3,1113.667,92.33333
"23663","76400","2016",19,16,3,178812.2,1770.474,113.4211
"23664","76401","2016",21,21,0,151647.6,1637.476,96.52381
"23665","76402","2016",59,58,1,153430.5,1793.831,88.98305
"23666","76403","2016",1,1,0,83000,568,146
"23667","76404","2016",15,15,0,200340,1972,104.4
"23668","76405","2016",3,3,0,92966.67,965.6667,96.66667
"23669","76406","2016",4,4,0,166750,1878,91
"23670","76407","2016",8,8,0,144959.9,1363.5,107.5
"23671","76408","2016",7,7,0,140600,1528.714,90.71429
"23672","76409","2016",4,4,0,193000,1856.5,118.75
"23673","76410","2016",102,54,48,113873.2,1491.039,77.7451
"23674","76412","2016",6,6,0,176083.3,1736.167,104.5
"23675","76413","2016",3,3,0,119038.3,1490.333,77.33333
"23676","76414","2016",16,14,2,167775,1771.375,98.375
"23677","76415","2016",4,4,0,143412.5,1048.75,140
"23678","76416","2016",4,4,0,142125,1405.25,104
"23679","76417","2016",2,2,0,145000,1182,129
"23680","76418","2016",12,12,0,140933.3,1538.333,92.25
"23681","76420","2016",6,6,0,143833.3,1299,112
"23682","76421","2016",5,5,0,172700,1606.2,109.4
"23683","76422","2016",5,5,0,80100,1128.8,87.2
"23684","76423","2016",4,4,0,99000,1325.75,90.25
"23685","76424","2016",1,1,0,147000,1670,88
"23686","76425","2016",3,3,0,196913.3,1632.667,119
"23687","76426","2016",1,1,0,128000,2286,56
"23688","76427","2016",5,5,0,142242.2,1532.6,89.6
"23689","76429","2016",75,66,9,227523.3,2187.68,106.3333
"23690","76430","2016",1,1,0,36000,766,47
"23691","76431","2016",1,1,0,180000,1579,114
"23692","76432","2016",1,1,0,129000,884,146
"23693","76433","2016",3,3,0,173166.7,1921,90.66667
"23694","76434","2016",12,12,0,170755.8,1570.25,109.8333
"23695","76435","2016",2,2,0,176012.5,1344.5,133.5
"23696","76437","2016",7,7,0,129671.4,1379.286,103.4286
"23697","76438","2016",3,3,0,118769,930.6667,130.6667
"23698","76439","2016",3,3,0,216000,2499.667,80.33333
"23699","76441","2016",2,2,0,70000,928.5,68.5
"23700","76443","2016",5,5,0,191214,1820,112.8
"23701","76445","2016",7,7,0,141256.3,1887,82
"23702","76446","2016",8,8,0,288568.8,2184.625,140.375
"23703","76447","2016",174,129,45,182400.8,2180.54,87.79885
"23704","76448","2016",13,13,0,202801.5,1986.538,103.9231
"23705","76449","2016",6,6,0,162525,1417.833,125.8333
"23706","76450","2016",4,4,0,147000,1336,110
"23707","76451","2016",261,107,154,221519.1,2194.87,96.93487
"23708","76452","2016",41,40,1,160091.5,1879.585,86.63415
"23709","76453","2016",15,15,0,170190,1700.933,106.2667
"23710","76454","2016",1,1,0,90000,1286,70
"23711","76455","2016",4,4,0,110607.5,1347.5,95.75
"23712","76456","2016",3,2,1,125835.7,1378,93.66667
"23713","76457","2016",5,5,0,150600,1546.4,103.2
"23714","76458","2016",2,2,0,107750,1373.5,104.5
"23715","76459","2016",3,3,0,205000,2016,103
"23716","76460","2016",3,3,0,31166.33,579,56.66667
"23717","76461","2016",5,5,0,138650,1613.8,88
"23718","76462","2016",43,36,7,126009.1,1566.674,86.81395
"23719","76463","2016",6,6,0,150716.7,1810.667,86.16667
"23720","76464","2016",19,19,0,177015.2,1603.158,120.2105
"23721","76465","2016",3,3,0,113333.3,1212.667,94.33333
"23722","76467","2016",14,14,0,174726.4,1569.857,111.5
"23723","76468","2016",12,12,0,160558.3,1827.667,96.91667
"23724","76469","2016",3,3,0,83250,1083.333,80.66667
"23725","76470","2016",7,7,0,176200,1376.429,129.5714
"23726","76471","2016",8,8,0,139250,1946,77
"23727","76472","2016",2,2,0,74000,1258,58
"23728","76473","2016",10,10,0,141715,1537.9,94.6
"23729","76474","2016",78,74,4,148302.1,1698.872,90.67949
"23730","76475","2016",77,72,5,249097.9,2319.364,108.9221
"23731","76476","2016",98,90,8,141525,1597.224,92.42857
"23732","76477","2016",4,4,0,278375,2006.75,136.75
"23733","76478","2016",1,1,0,162200,1690,96
"23734","76479","2016",2,2,0,146750,1311,112.5
"23735","76480","2016",7,7,0,142051.4,1614.143,88.57143
"23736","76481","2016",57,57,0,273634.6,2188.509,128.4912
"23737","76482","2016",25,25,0,160566.8,1678.8,99
"23738","76483","2016",4,4,0,202250,1821,113.5
"23739","76484","2016",99,96,3,153973.2,1810.424,89.26263
"23740","76486","2016",9,9,0,139377.9,1451.556,98.33333
"23741","76487","2016",9,9,0,110477.8,1187.556,100.6667
"23742","76488","2016",5,5,0,142260,1268.4,117
"23743","76489","2016",7,7,0,199771.4,1531.429,123
"23744","76490","2016",14,12,2,95228.57,1058.286,89.14286
"23745","76491","2016",8,8,0,109346.5,1433,77.5
"23746","76492","2016",7,7,0,179921.4,1548.714,123.1429
"23747","76493","2016",7,7,0,139857.4,1972,74
"23748","76494","2016",2,2,0,140095,1529.5,99
"23749","76495","2016",46,44,2,130905.4,1579.87,83.36957
"23750","76497","2016",77,59,18,169796.1,1878.961,85.5974
"23751","76498","2016",250,168,82,115198.1,1659.62,70.952
"23752","76499","2016",12,12,0,171708.3,1645.583,117.5833
"23753","76500","2016",5,5,0,118100,1388.4,91.8
"23754","76501","2016",1,1,0,170000,2615,65
"23755","76502","2016",6,6,0,171250,1968.833,92.66667
"23756","76503","2016",8,8,0,240687.5,1779,144.25
"23757","76504","2016",2,2,0,153000,1565,97
"23758","76505","2016",1,1,0,120000,1263,95
"23759","76506","2016",7,7,0,111785.7,1395.429,88
"23760","76507","2016",6,6,0,105050,1234.167,94.33333
"23761","76508","2016",10,10,0,172100,2136.9,91.9
"23762","76509","2016",23,23,0,198966.3,2025.957,103.6522
"23763","76510","2016",2,2,0,126000,1638,85
"23764","76511","2016",4,4,0,115925,1081.25,113.5
"23765","76512","2016",1,1,0,1e+05,1429,70
"23766","76513","2016",7,7,0,239785.7,2230.714,115.7143
"23767","76514","2016",10,10,0,217580,2056.6,107.4
"23768","76515","2016",10,9,1,174905,1754.5,107.8
"23769","76516","2016",2,1,1,164250,1719.5,95
"23770","76517","2016",25,25,0,239666.8,1996.96,129.4
"23771","76518","2016",6,6,0,158916.7,1357,127
"23772","76520","2016",8,8,0,112818.8,1571.875,77.375
"23773","76522","2016",25,25,0,189140,1783.12,115.28
"23774","76523","2016",2,2,0,115750,1350.5,97.5
"23775","76527","2016",1,1,0,52000,400,130
"23776","76528","2016",5,5,0,130500,1647,83.2
"23777","76529","2016",5,5,0,148890,1652.8,93.6
"23778","76531","2016",2,2,0,131500,2037.5,64.5
"23779","76532","2016",5,5,0,154200,1975.2,83
"23780","76533","2016",9,9,0,214888.9,2263.333,98.66667
"23781","76534","2016",11,9,2,171258.2,2236.818,79.27273
"23782","76535","2016",5,5,0,122600,1753.2,86.6
"23783","76536","2016",9,9,0,167900,1750.111,99.22222
"23784","76537","2016",4,4,0,113125,1353.5,95.5
"23785","76538","2016",2,2,0,197000,1479,134.5
"23786","76540","2016",1856,358,1498,138711.7,2234.119,63.43588
"23787","76541","2016",13,13,0,236280.8,1851.308,130.8462
"23788","76542","2016",1,1,0,142000,1527,93
"23789","76543","2016",7,7,0,146975.7,1413.571,111
"23790","76544","2016",3,3,0,152333.3,1272.333,119.3333
"23791","76545","2016",22,20,2,151252.3,1490.818,99.54545
"23792","76546","2016",3,3,0,142333.3,1475.667,99.33333
"23793","76547","2016",14,14,0,195689.3,1844.5,107.2857
"23794","76548","2016",2,2,0,222650,1878.5,118.5
"23795","76549","2016",2,2,0,140450,1449.5,97
"23796","76550","2016",9,9,0,189777.8,1650.667,122.4444
"23797","76551","2016",13,13,0,231846.2,2309.692,100.1538
"23798","76552","2016",124,58,66,268780.6,2657.508,98.29032
"23799","76553","2016",1,1,0,80000,615,130
"23800","76554","2016",8,8,0,138512.5,1575.875,86.75
"23801","76555","2016",9,9,0,198077.8,1731.222,120.5556
"23802","76556","2016",16,16,0,148518.1,1695.062,90.75
"23803","76557","2016",12,12,0,128675,1688.25,83.58333
"23804","76558","2016",20,20,0,183197.5,1699.45,111.05
"23805","76559","2016",7,7,0,135657.1,1336,108.8571
"23806","76560","2016",11,11,0,197468.2,2455.818,93.27273
"23807","76561","2016",73,54,19,118664.8,1509.589,80.9863
"23808","76562","2016",7,7,0,138228.6,1386.286,100.1429
"23809","76563","2016",13,13,0,221576.9,2034.769,108.8462
"23810","76564","2016",4,4,0,181425,2437.25,104.25
"23811","76565","2016",8,8,0,150250,1550,95.75
"23812","76566","2016",8,8,0,154350,1542.5,99.75
"23813","76567","2016",3,3,0,123666.7,1534,84
"23814","76568","2016",7,7,0,191000,1704.143,115.8571
"23815","76569","2016",2,2,0,143500,1545,91
"23816","76570","2016",2,2,0,1e+05,1269.5,84.5
"23817","76571","2016",4,4,0,138025,1367.5,107
"23818","76573","2016",3,3,0,159500,1349.667,106.6667
"23819","76574","2016",7,7,0,130742.9,1787.286,81.14286
"23820","76575","2016",214,189,25,143491,1739.715,83.61215
"23821","76576","2016",10,10,0,102517.5,1300.6,80.2
"23822","76577","2016",10,10,0,133076,1465.9,92.7
"23823","76578","2016",1,1,0,60000,625,96
"23824","76580","2016",3,3,0,178416.7,1422,127.3333
"23825","76581","2016",4,4,0,123037.5,1802.5,68.75
"23826","76582","2016",5,5,0,116400,1405.2,79
"23827","76583","2016",2,2,0,252375,1628.5,168.5
"23828","76584","2016",2,2,0,78750,979.5,80.5
"23829","76585","2016",2,2,0,154750,1473,105.5
"23830","76586","2016",3,3,0,154000,1707.333,88
"23831","76587","2016",4,4,0,138367.5,1783.5,90.75
"23832","76588","2016",7,7,0,182059.7,1515.857,126
"23833","76589","2016",3,3,0,98950,938,102.6667
"23834","76590","2016",3,3,0,150033.3,1496,100
"23835","76591","2016",23,23,0,205393.5,1849.565,112.913
"23836","76592","2016",9,9,0,115555.6,1916.111,76.55556
"23837","76593","2016",8,8,0,199912.5,1656.875,129.5
"23838","76594","2016",11,11,0,228656.8,1841.273,126.2727
"23839","76595","2016",28,25,3,199014.3,1894.571,108.3929
"23840","76596","2016",10,10,0,172850,1920.8,97.1
"23841","76597","2016",8,8,0,95000,1246.875,80
"23842","76598","2016",2,2,0,151000,1789.5,84.5
"23843","76599","2016",29,28,1,195929.3,1994.69,101.5172
"23844","76600","2016",15,15,0,157994,1659.4,97.86667
"23845","76602","2016",5,5,0,142343,1570.6,95
"23846","76603","2016",6,6,0,124050,1375,92.33333
"23847","76604","2016",2,2,0,449200,3603,142
"23848","76605","2016",10,10,0,130450,1498.2,89.3
"23849","76606","2016",1,1,0,159000,2065,77
"23850","76608","2016",17,17,0,170233.1,1759.765,98.41176
"23851","76609","2016",6,6,0,145916.7,1579.167,88.83333
"23852","76610","2016",21,21,0,165323.8,1625.667,102.7619
"23853","76611","2016",2,2,0,144500,1306.5,114
"23854","76612","2016",2,2,0,79000,821,92.5
"23855","76613","2016",20,19,1,144406.8,1718.85,84.45
"23856","76614","2016",7,7,0,249714.3,1851.714,131.8571
"23857","76615","2016",5,5,0,166600,2269.4,82.2
"23858","76616","2016",17,16,1,211094.6,1966.176,109.9412
"23859","76617","2016",14,14,0,379539.3,2178.214,175.6429
"23860","76618","2016",98,98,0,129383.6,1544.908,88.10204
"23861","76619","2016",2,2,0,120000,1178,136
"23862","76620","2016",2,2,0,158000,1438,120.5
"23863","76621","2016",8,8,0,116350,1178.875,100
"23864","76623","2016",4,4,0,170000,1444.5,140.75
"23865","76624","2016",20,20,0,122782.5,1516.7,83.9
"23866","76626","2016",5,5,0,161050,1550.4,103.4
"23867","76627","2016",11,11,0,147318.2,1697.545,92.09091
"23868","76628","2016",9,9,0,165056.1,1603.667,105.6667
"23869","76629","2016",1,1,0,58000,716,81
"23870","76630","2016",1,1,0,118000,2565,46
"23871","76631","2016",15,15,0,173018.1,1444.467,121.9333
"23872","76632","2016",3,3,0,101166.7,1446,67
"23873","76634","2016",8,8,0,171637.5,1697.75,105.5
"23874","76636","2016",15,15,0,176434.3,1552,113.9333
"23875","76637","2016",12,10,2,113633.3,1740.833,71.83333
"23876","76638","2016",9,9,0,141533.3,1864.111,81.77778
"23877","76640","2016",58,50,8,134688.5,1533.379,94.31034
"23878","76644","2016",7,7,0,93442.86,1228.429,71.42857
"23879","76646","2016",3,3,0,172816.7,1437,119.6667
"23880","76647","2016",43,34,9,168911.6,1977.372,88.69767
"23881","76648","2016",15,15,0,115571.3,1528.4,86.2
"23882","76649","2016",4,4,0,183750,1501.5,125.5
"23883","76650","2016",8,8,0,208937.5,1794.375,121
"23884","76651","2016",1,1,0,376000,1047,359
"23885","76652","2016",8,8,0,94290.88,1185.125,84.625
"23886","76653","2016",1,1,0,116000,1634,71
"23887","76654","2016",4,4,0,172875,1685.75,106.5
"23888","76655","2016",40,24,16,149349.2,1841.45,82.925
"23889","76656","2016",7,7,0,170400,1504.429,112.2857
"23890","76657","2016",12,12,0,214100,2068.417,107.75
"23891","76658","2016",8,8,0,210012.5,1925.625,112.75
"23892","76660","2016",8,8,0,196850,1733.5,117.625
"23893","76662","2016",1,1,0,126700,2437,52
"23894","76663","2016",17,17,0,134206.1,1496.529,92.29412
"23895","76664","2016",2,2,0,160000,1187,128
"23896","76665","2016",4,4,0,158375,1151.75,137
"23897","76666","2016",7,7,0,171428.6,1711.571,113.7143
"23898","76667","2016",6,6,0,139833.3,1265,113.5
"23899","76668","2016",6,6,0,188566.7,1617.333,120
"23900","76669","2016",3,3,0,117733.3,1334.667,82.33333
"23901","76670","2016",8,8,0,160650,1646.5,98.5
"23902","76672","2016",5,5,0,78700,1198.4,62.6
"23903","76673","2016",7,7,0,202357.1,1926.714,105.8571
"23904","76675","2016",10,10,0,174300,1758.2,107.2
"23905","76676","2016",5,5,0,159860,1093.8,146.8
"23906","76677","2016",3,3,0,56666.67,1089.667,58.66667
"23907","76678","2016",9,9,0,115833.3,1499.889,89.33333
"23908","76680","2016",3,3,0,118966.7,1629.333,87.33333
"23909","76681","2016",371,280,91,134880,1918.933,71.18059
"23910","76682","2016",5,5,0,213570,1623,131.2
"23911","76683","2016",7,7,0,138335.7,1987.429,82.28571
"23912","76684","2016",17,15,2,157735.3,1614.588,98.05882
"23913","76685","2016",5,5,0,100800,1111.4,94.4
"23914","76686","2016",6,6,0,173550,1658.667,107.3333
"23915","76688","2016",3,3,0,138733.3,1321.667,112.3333
"23916","76689","2016",2,2,0,130000,1146,110
"23917","76690","2016",4,4,0,119586,1047.25,115
"23918","76692","2016",3,3,0,143666.7,1432.667,101
"23919","76693","2016",9,9,0,149422.2,1752.444,97.55556
"23920","76694","2016",2,2,0,155445,1682.5,92
"23921","76695","2016",1,1,0,170000,1753,97
"23922","76697","2016",6,6,0,130666.7,1478.5,87
"23923","76698","2016",3,3,0,89333.33,891.3333,104
"23924","76699","2016",6,6,0,143800,1447.333,100.1667
"23925","76700","2016",10,9,1,119409.8,1232.1,96.9
"23926","76702","2016",8,8,0,194000,1798.125,120.75
"23927","76703","2016",1,1,0,49400,549,90
"23928","76705","2016",10,10,0,169200,1800.4,96.3
"23929","76706","2016",6,6,0,200833.3,2020.333,96.33333
"23930","76707","2016",7,7,0,147828.6,1433,102.7143
"23931","76708","2016",5,5,0,94020,1257.6,87.2
"23932","76709","2016",49,47,2,115414.4,1520.755,78.16327
"23933","76710","2016",1,1,0,134000,1218,110
"23934","76711","2016",98,48,50,88736.33,1479.276,61.96939
"23935","76712","2016",9,9,0,156833.3,1587.556,107.1111
"23936","76714","2016",6,6,0,201050,2348.333,87.66667
"23937","76715","2016",2,2,0,163500,1545,106.5
"23938","76716","2016",15,15,0,207000,1879.6,110.3333
"23939","76717","2016",7,7,0,180514.3,1499.857,124.7143
"23940","76718","2016",13,13,0,165115.4,1650.615,103.0769
"23941","76719","2016",3,3,0,155666.7,1775.333,89.33333
"23942","76720","2016",12,9,3,181591.7,2087.667,85.83333
"23943","76721","2016",3,3,0,139666.7,1472.667,94.66667
"23944","76723","2016",5,5,0,156400,2165,94.6
"23945","76725","2016",10,10,0,161325,2071.2,83.8
"23946","76726","2016",4,4,0,149000,2079.5,92.75
"23947","76727","2016",7,7,0,108600,1497.857,71
"23948","76728","2016",4,4,0,176375,1513.5,115.75
"23949","76730","2016",2,2,0,123500,1140.5,107
"23950","76731","2016",1,1,0,60000,1500,40
"23951","76732","2016",2,2,0,155470,1282.5,122
"23952","76733","2016",1,1,0,98000,1508,65
"23953","76734","2016",5,5,0,215960,1580.2,134.2
"23954","76735","2016",13,9,4,159704.6,2002.538,86
"23955","76736","2016",11,10,1,129660.9,2020,75.63636
"23956","76737","2016",4,4,0,168500,1664.75,106.5
"23957","76738","2016",7,7,0,208142.9,2112,112.2857
"23958","76739","2016",8,8,0,87050,1004.625,100.25
"23959","76740","2016",5,5,0,218140,1690,129.8
"23960","76741","2016",4,4,0,222875,2303.25,112.25
"23961","76743","2016",16,16,0,154781.2,1622.562,98
"23962","76745","2016",2,2,0,127750,917,157.5
"23963","76747","2016",3,3,0,203583.3,1903,107
"23964","76748","2016",7,7,0,130792.9,1321.429,108.1429
"23965","76749","2016",3,3,0,81566.67,890,95.66667
"23966","76750","2016",11,11,0,157372.7,1415,107.2727
"23967","76751","2016",9,9,0,146817.8,1419,104
"23968","76752","2016",18,16,2,151861.1,1564,102.8889
"23969","76753","2016",4,4,0,229862.5,1908.25,119.25
"23970","76754","2016",19,17,2,154788.2,2537.684,70.63158
"23971","76755","2016",3,3,0,160333.3,1169,141.6667
"23972","76756","2016",2,2,0,215700,1817,120
"23973","76757","2016",5,5,0,126057.6,1365.6,89.8
"23974","76758","2016",121,88,33,160576.9,1903.314,87.95041
"23975","76759","2016",2,2,0,146050,1309,113
"23976","77001","2016",20,20,0,300308,2269.45,138.55
"23977","77002","2016",10,10,0,191404.5,2323.6,93.3
"23978","77003","2016",2,2,0,202500,1394.5,152
"23979","77004","2016",7,6,1,253214.3,2148.571,120.4286
"23980","77005","2016",32,24,8,285957.6,3042.688,98.46875
"23981","77006","2016",21,17,4,306081,2920.667,114.381
"23982","77007","2016",8,8,0,241700,2845.25,93.625
"23983","77008","2016",15,15,0,236896.7,2395.867,101.9333
"23984","77009","2016",4,4,0,135750,1290.25,95.75
"23985","77010","2016",9,9,0,223522.2,2073,120.4444
"23986","77011","2016",8,8,0,188000,1988.75,100
"23987","77012","2016",6,6,0,214216.7,1291.333,165.3333
"23988","77013","2016",5,5,0,202500,1700.8,135.8
"23989","77014","2016",229,35,194,164595.2,2389.437,69.55459
"23990","77015","2016",1,1,0,116000,1318,88
"23991","77016","2016",7,7,0,153571.4,1579,104.4286
"23992","77018","2016",102,56,46,295448.2,3383.608,88.46078
"23993","77019","2016",5,5,0,123500,1500,89
"23994","77020","2016",11,11,0,231147.7,1511.909,158.0909
"23995","77021","2016",1,1,0,85000,1977,43
"23996","77022","2016",30,24,6,411153.7,3429.3,119.4
"23997","77023","2016",5,5,0,258400,2629.8,99.4
"23998","77024","2016",4,3,1,198000,1995,148.75
"23999","77025","2016",11,11,0,131737.7,1511.091,87.81818
"24000","77026","2016",2,2,0,168450,1168,159.5
"24001","77027","2016",14,14,0,152385.7,1244.429,126.2143
"24002","77029","2016",7,7,0,189925,2621.571,99.71429
"24003","77030","2016",20,20,0,164202,1644.25,102.95
"24004","77031","2016",7,7,0,224928.6,2589.714,88
"24005","77032","2016",12,11,1,191983.3,1806.583,100.8333
"24006","77033","2016",2,2,0,207100,1403,149.5
"24007","77034","2016",16,14,2,238062.5,2773.938,89.5625
"24008","77035","2016",8,8,0,157020.9,1804.5,103.625
"24009","77036","2016",4,4,0,157582.5,1619.25,102.25
"24010","77037","2016",81,64,17,313377.2,3363.358,101.8642
"24011","77038","2016",3,3,0,336016.7,3217.333,118.3333
"24012","77039","2016",10,10,0,343450,2740.2,124.3
"24013","77040","2016",35,33,2,258026,2400.914,110.4571
"24014","77041","2016",4,4,0,256300,2243.5,119.75
"24015","77042","2016",37,36,1,173576.6,1992.486,93.67568
"24016","77043","2016",5,5,0,181000,1638.4,122.2
"24017","77044","2016",10,9,1,187500,2097.4,91.8
"24018","77045","2016",8,8,0,152881.2,1483.25,102.25
"24019","77046","2016",7,7,0,174285.7,2326.857,80.71429
"24020","77047","2016",25,21,4,251916,2641.64,99.8
"24021","77048","2016",52,49,3,311040.7,2748.481,114.25
"24022","77049","2016",12,12,0,244623,2302.5,108.6667
"24023","77050","2016",6,6,0,134000,1430.667,108
"24024","77051","2016",30,30,0,131509,1465.9,94.23333
"24025","77052","2016",3,3,0,211000,2427.667,114.3333
"24026","77053","2016",189,84,105,207015.7,2990.312,73.06349
"24027","77054","2016",12,12,0,153877.1,1632.25,104.8333
"24028","77055","2016",49,17,32,214995.1,2868.694,75.12245
"24029","77056","2016",4,4,0,204000,1591.25,135.75
"24030","77057","2016",2,1,1,135000,1545.5,91
"24031","77058","2016",415,105,310,243899.2,3401.533,74.81446
"24032","77059","2016",10,10,0,369104.5,3276.8,117.6
"24033","77060","2016",7,7,0,150857.1,2509.429,60.71429
"24034","77061","2016",20,18,2,159147.9,1978.35,84.55
"24035","77062","2016",6,2,4,182416.7,2874.833,65.33333
"24036","77063","2016",22,22,0,207532.7,2113.136,110.8636
"24037","77065","2016",18,18,0,300277.2,3149.778,105.3889
"24038","77066","2016",3,3,0,107333.3,1116.333,115.3333
"24039","77067","2016",136,124,12,237087.5,2659.904,91.53676
"24040","77068","2016",6,6,0,180833.3,1552,132.6667
"24041","77069","2016",26,21,5,302209.6,2612.462,120.9231
"24042","77070","2016",16,16,0,162468.8,1907.25,96.5
"24043","77071","2016",4,4,0,169962.5,1424.5,122.75
"24044","77072","2016",6,6,0,135833.3,1318.5,102.8333
"24045","77073","2016",9,9,0,186888.9,1896.222,101.6667
"24046","77075","2016",16,13,3,256092.6,2954.938,88.125
"24047","77076","2016",15,15,0,141466.7,1474.8,93.66667
"24048","77077","2016",15,15,0,213046.7,2595.133,96
"24049","77078","2016",17,17,0,191011.2,2334.647,88.35294
"24050","77079","2016",57,47,10,155039.6,2219.263,73.96491
"24051","77080","2016",6,6,0,224000,1420.167,170.5
"24052","77081","2016",5,5,0,246600,2802.2,91.4
"24053","77082","2016",13,10,3,194555.6,2420.615,84.38462
"24054","77083","2016",237,63,174,219673.1,2941.751,77.29958
"24055","77084","2016",16,13,3,189951.9,2236.625,89.9375
"24056","77085","2016",39,29,10,301551.1,3414.538,91.15385
"24057","77086","2016",17,16,1,199366.5,1888.588,112.3529
"24058","77087","2016",1,1,0,145000,1933,75
"24059","77088","2016",25,21,4,176764,1922.56,96.52
"24060","77089","2016",13,13,0,221307.7,2161.154,111.0769
"24061","77090","2016",2,2,0,161550,1414,115.5
"24062","77091","2016",4,4,0,282375,2653.25,110.75
"24063","77093","2016",3,3,0,123000,1672.333,78.33333
"24064","77094","2016",3,3,0,325366.7,3950.667,82.33333
"24065","77095","2016",16,15,1,301579.1,2750.062,110.25
"24066","77096","2016",30,22,8,244250.7,2975.867,85.76667
"24067","77097","2016",4,4,0,178815,1951.5,91.75
"24068","77098","2016",2,2,0,208030,1792,116
"24069","77099","2016",34,34,0,124573.4,1648.882,79.02941
"24070","77100","2016",52,49,3,220991.2,2524.596,92.96154
"24071","77101","2016",19,19,0,146315.8,1608.105,93.94737
"24072","77102","2016",1,1,0,220000,2000,110
"24073","77103","2016",5,5,0,185515.2,1468.4,136
"24074","77104","2016",7,7,0,321898.6,3124,110.7143
"24075","77106","2016",17,17,0,186194.1,2051.471,102.5882
"24076","77107","2016",44,29,15,193359.5,2391.682,88.15909
"24077","77108","2016",702,306,396,213304.1,3013.292,73.07123
"24078","77109","2016",14,14,0,170491.1,1920.286,92.92857
"24079","77111","2016",82,32,50,263691.5,3745.561,77.9878
"24080","77112","2016",6,6,0,242908.3,1810.833,133.1667
"24081","77113","2016",11,11,0,188271.8,1867.545,110.0909
"24082","77114","2016",41,29,12,276591.5,3393.512,88.02439
"24083","77115","2016",8,8,0,106725,1060.625,99.25
"24084","77116","2016",17,17,0,223398.8,1748.471,139.7647
"24085","77117","2016",17,16,1,156411.8,1751.824,103.5882
"24086","77118","2016",159,89,70,244437.1,3242.226,79.2327
"24087","77119","2016",2,2,0,222490,2130.5,107
"24088","77120","2016",6,6,0,160000,1949,86.33333
"24089","77121","2016",26,13,13,254975,3273.731,79.84615
"24090","77122","2016",288,173,115,212796.6,2715.302,79.97222
"24091","77123","2016",4,4,0,202500,2635,79.5
"24092","77124","2016",16,16,0,341687.5,3253.812,113.6875
"24093","77125","2016",19,17,2,232530.3,2856.632,84.63158
"24094","77126","2016",32,30,2,218139.8,2336.062,97.21875
"24095","77127","2016",26,19,7,214478.7,2942.192,77.5
"24096","77128","2016",32,29,3,237759.4,2878.5,92.0625
"24097","77129","2016",3,3,0,145000,2137.667,67.66667
"24098","77130","2016",9,9,0,210344.4,2146.778,102
"24099","77131","2016",175,102,73,181766.9,2407.217,82.18286
"24100","77132","2016",34,31,3,296982.4,3026.324,102.2941
"24101","77133","2016",2,2,0,160500,1653,96.5
"24102","77134","2016",1,1,0,140000,1069,131
"24103","77135","2016",26,26,0,194379.2,2081.5,103.6923
"24104","77137","2016",3,3,0,190666.7,1838.667,111
"24105","77138","2016",9,9,0,207276.7,2601.222,80.77778
"24106","77139","2016",54,46,8,261372.7,2957.87,90.59259
"24107","77140","2016",8,8,0,185856.2,1482.75,130.5
"24108","77141","2016",13,10,3,292177.7,2748.923,110.5385
"24109","77142","2016",51,39,12,230664.3,2682.51,93.7451
"24110","77143","2016",53,40,13,203794.5,2645.075,79.28302
"24111","77144","2016",6,6,0,252186.7,2519.5,101.1667
"24112","77145","2016",7,7,0,193664,1970.286,96.57143
"24113","77146","2016",27,17,10,275657,3532.593,82.62963
"24114","77147","2016",7,7,0,139171.4,1503.143,97.14286
"24115","77148","2016",16,15,1,168662.5,1913.75,91.25
"24116","77150","2016",6,6,0,222333.3,2234.167,104.3333
"24117","77151","2016",6,6,0,195996.7,1761.5,118.6667
"24118","77152","2016",167,78,89,171789.7,2472.713,71.69461
"24119","77153","2016",132,86,46,222141.3,2835.621,83.15909
"24120","77154","2016",21,20,1,216088.1,2369.333,92.2381
"24121","77155","2016",36,31,5,276016.4,2798.333,99.63889
"24122","77156","2016",6,6,0,159750,1983.5,82.83333
"24123","77157","2016",6,6,0,153166.7,1777.5,92.33333
"24124","77158","2016",8,8,0,159000,1898.25,91.25
"24125","77159","2016",30,28,2,140583,1803.3,90.93333
"24126","77161","2016",10,10,0,192074,1780.4,125
"24127","77162","2016",12,12,0,164608.3,1594.917,111.25
"24128","77163","2016",2,2,0,201250,2930.5,96
"24129","77164","2016",5,5,0,224710,1888,131.6
"24130","77165","2016",7,6,1,195377.1,2191.143,95.14286
"24131","77167","2016",4,4,0,182638.8,1854.75,110.25
"24132","77168","2016",22,20,2,139106.8,1609.864,91.22727
"24133","77169","2016",109,47,62,257334.5,3063.587,87.10092
"24134","77171","2016",118,87,31,238830.9,3130.602,82.29661
"24135","77172","2016",7,7,0,124928.6,1769,72.14286
"24136","77173","2016",8,8,0,207750,2017.625,107.125
"24137","77174","2016",5,5,0,124200,1462.2,91.4
"24138","77175","2016",24,21,3,263646,2762,101.7083
"24139","77176","2016",50,42,8,187558.7,2165.52,90.14
"24140","77177","2016",11,11,0,251131.5,2639,102.1818
"24141","77178","2016",5,5,0,215620,1732.2,128
"24142","77179","2016",11,11,0,252704.5,2179.909,120.9091
"24143","77180","2016",10,8,2,375640,2994.4,122.2
"24144","77181","2016",28,18,10,274292.8,3430.107,82.82143
"24145","77182","2016",46,35,11,149709.5,1914.087,83.41304
"24146","77183","2016",116,73,43,172103.6,2275.414,81.07759
"24147","77184","2016",4,4,0,146500,1481,92.75
"24148","77185","2016",9,9,0,428820.3,3313,154
"24149","77186","2016",300,87,213,274464.6,3543.29,78.18667
"24150","77187","2016",14,14,0,147628.6,1477.214,109.2857
"24151","77188","2016",11,8,3,292145.5,2731.091,121.5455
"24152","77190","2016",2,2,0,214000,2077.5,106.5
"24153","77191","2016",18,18,0,219244.4,2092.778,110.2222
"24154","77192","2016",78,53,25,201641.3,2516.808,83.47436
"24155","77193","2016",1,1,0,275000,3438,80
"24156","77194","2016",2,2,0,199500,1863.5,109.5
"24157","77195","2016",11,11,0,234914.5,2518,97.36364
"24158","77196","2016",15,13,2,271200,2447.467,113.6667
"24159","77197","2016",3,3,0,164000,2294.667,74
"24160","77198","2016",5,5,0,195700,1690,131
"24161","77199","2016",26,25,1,238360.8,2963.615,98.11538
"24162","77201","2016",7,6,1,169951.4,2037.429,87.42857
"24163","77202","2016",12,12,0,206195,2139.25,105.6667
"24164","77203","2016",23,23,0,273798.7,2606.348,109.1304
"24165","77204","2016",5,5,0,167270,1815.2,94
"24166","77205","2016",2,2,0,251000,3178.5,79.5
"24167","77206","2016",1,1,0,370000,1850,200
"24168","77207","2016",2,2,0,126400,1892,66.5
"24169","77208","2016",16,15,1,170750,1581.125,110.0625
"24170","77209","2016",19,18,1,346667.5,3167.684,115.3158
"24171","77210","2016",34,32,2,175250.3,1939.853,95.32353
"24172","77211","2016",14,14,0,180137.9,1936.143,97.85714
"24173","77212","2016",1,1,0,260000,2149,121
"24174","77214","2016",12,11,1,355000,2728.417,138
"24175","77215","2016",68,43,25,234462.7,2988.029,82.61765
"24176","77216","2016",19,19,0,226407.9,2332.895,100.8421
"24177","77217","2016",44,27,17,210671.5,2586.909,85.93182
"24178","77218","2016",4,4,0,98500,1427.75,70.25
"24179","77219","2016",38,38,0,216078.2,2321.553,97.13158
"24180","77220","2016",4,4,0,168650,1496.5,111.5
"24181","77221","2016",19,16,3,420028.4,3293.316,129.3158
"24182","77222","2016",56,27,29,177364.5,2496.018,72.03571
"24183","77223","2016",8,8,0,160706.2,1700,96
"24184","77224","2016",3,3,0,374333.3,2798,167.3333
"24185","77225","2016",6,6,0,188333.3,1916,94.16667
"24186","77226","2016",40,37,3,262845.5,2663,104.2
"24187","77227","2016",8,8,0,199509.2,1319.125,152.125
"24188","77228","2016",5,5,0,169193.8,1403.8,128
"24189","77229","2016",17,14,3,229097.1,2247.353,109.3529
"24190","77230","2016",4,4,0,128750,1021.5,127.5
"24191","77231","2016",8,8,0,224625,2452.25,93.125
"24192","77232","2016",22,16,6,203264.6,2520.5,83.63636
"24193","77233","2016",7,6,1,204714.3,2810.429,72.85714
"24194","77234","2016",9,9,0,343723.4,2807.222,133.5556
"24195","77235","2016",6,6,0,193833.3,1805.667,106.5
"24196","77237","2016",6,6,0,249375.5,2539.667,91.5
"24197","77238","2016",34,34,0,177551.4,1939.324,97.38235
"24198","77239","2016",22,22,0,205742,2054.091,107.8636
"24199","77240","2016",35,33,2,154116.7,1767.514,95.91429
"24200","77241","2016",13,13,0,249500,2606.385,96.15385
"24201","77242","2016",10,10,0,136375,1381.6,103.1
"24202","77243","2016",279,127,152,252760.5,3403.011,77.32975
"24203","77244","2016",15,15,0,205786.7,1803.133,113.2667
"24204","77245","2016",10,10,0,159050,1514.1,108.8
"24205","77246","2016",10,10,0,146500,1500.1,100.1
"24206","77247","2016",9,9,0,180000,1685.111,107.7778
"24207","77248","2016",6,6,0,232700,2099.167,116
"24208","77249","2016",107,100,7,315441.8,3024.701,107.1402
"24209","77250","2016",3,3,0,213033.3,2180.333,104.3333
"24210","77251","2016",132,58,74,190249.8,2701.591,72.94697
"24211","77252","2016",5,5,0,300500,2422.6,125.2
"24212","77253","2016",3,3,0,249000,2422.333,115.3333
"24213","77254","2016",14,12,2,330156.1,2902.429,127.8571
"24214","77255","2016",14,14,0,246909.3,2715.357,93.28571
"24215","77256","2016",2,2,0,128000,1233,105
"24216","77257","2016",27,22,5,172405.6,1926.593,97.07407
"24217","77258","2016",156,18,138,183988.1,2945.308,64.52564
"24218","77259","2016",25,17,8,222752.4,2808.8,83.08
"24219","77260","2016",7,7,0,131942.9,1635.143,79.28571
"24220","77261","2016",18,16,2,172919.4,1744.833,99.55556
"24221","77262","2016",11,11,0,126600,1388.091,98.45455
"24222","77263","2016",1,1,0,155000,1192,130
"24223","77264","2016",12,12,0,252033.3,2108.5,123.75
"24224","77265","2016",7,6,1,169571.4,1851,92.42857
"24225","77266","2016",15,14,1,249394.3,2404.2,108.6667
"24226","77267","2016",6,6,0,157633.3,1711.333,92.66667
"24227","77268","2016",326,70,256,235574.2,5954.929,51.38037
"24228","77269","2016",22,19,3,171028.8,2421.364,73
"24229","77270","2016",10,10,0,292830,2559.5,124.3
"24230","77272","2016",10,9,1,148375,1705.6,88.3
"24231","77273","2016",3,3,0,223000,2100.333,107.3333
"24232","77274","2016",4,4,0,252750,2709.5,93
"24233","77276","2016",29,25,4,265874.1,2576.31,108.3793
"24234","77277","2016",18,16,2,228116.7,2279.278,103
"24235","77278","2016",1,1,0,216000,1543,140
"24236","77279","2016",20,20,0,154217.5,1775.35,92.6
"24237","77280","2016",12,12,0,179892.7,2144.5,88
"24238","77281","2016",5,5,0,198800,1690,125
"24239","77282","2016",4,4,0,239750,2995.5,81.5
"24240","77283","2016",11,10,1,149181.8,1618.636,90.63636
"24241","77284","2016",484,129,355,173500.9,2618.275,69.41736
"24242","77285","2016",141,59,82,149576,2041,75.25532
"24243","77286","2016",5,5,0,213370,1856,116
"24244","77287","2016",4,4,0,141750,1569.5,91
"24245","77288","2016",412,63,349,141971.7,2523.49,60.21359
"24246","77289","2016",7,7,0,138428.6,1242.857,120.5714
"24247","77290","2016",9,9,0,155888.9,1542.778,100.7778
"24248","77291","2016",6,6,0,147666.7,2837.5,59.16667
"24249","77292","2016",12,11,1,268962.9,2753.583,100.6667
"24250","77293","2016",18,18,0,145194.4,2252.889,78.77778
"24251","77294","2016",198,139,59,206023.7,2969.667,73.55051
"24252","77295","2016",15,15,0,275073.3,2404.733,122
"24253","77296","2016",202,103,99,190811.7,2647.99,74.12376
"24254","77297","2016",4,4,0,119650,1309.75,93
"24255","77298","2016",3,3,0,123000,1317.333,88.33333
"24256","77300","2016",2,2,0,251000,1666,156.5
"24257","77301","2016",5,5,0,102500,1226.2,90.6
"24258","77302","2016",27,26,1,195856.7,1848.185,108.2222
"24259","77303","2016",2,2,0,92500,1112,82.5
"24260","77305","2016",162,63,99,116323.7,1666.241,73.19753
"24261","77306","2016",3,3,0,230666.7,2218.667,103
"24262","77307","2016",189,40,149,226575.7,3673.921,64.31746
"24263","77308","2016",8,8,0,237706.2,2265.625,114.375
"24264","77309","2016",11,10,1,174863.6,2197,80.09091
"24265","77310","2016",5,5,0,137000,1673,85.6
"24266","77311","2016",25,24,1,189695.8,1892.52,107.76
"24267","77312","2016",44,38,6,203847.1,2236.091,91.06818
"24268","77313","2016",5,5,0,154970,1752.6,93.6
"24269","77314","2016",2,2,0,114000,1267.5,92.5
"24270","77315","2016",44,36,8,233387.7,3057.818,86.27273
"24271","77316","2016",165,136,29,206956.6,2427.303,89.75152
"24272","77317","2016",23,17,6,177572.6,1899,94.91304
"24273","77318","2016",15,15,0,245030.3,2344.333,109.4667
"24274","77319","2016",1,1,0,220200,2097,105
"24275","77320","2016",79,68,11,202785.4,2294.873,93.87342
"24276","77321","2016",12,12,0,163458.3,1600.333,116.5
"24277","77322","2016",34,29,5,248507.1,2828.5,92.38235
"24278","77323","2016",17,12,5,236762.4,2817.294,86.35294
"24279","77325","2016",6,6,0,133833.3,1480.333,94.5
"24280","77326","2016",43,33,10,221770.6,2480.047,92.02326
"24281","77327","2016",61,49,12,173810.7,2094.492,91.52459
"24282","77328","2016",10,10,0,192050,1973.2,98.9
"24283","77329","2016",5,5,0,209660,1804.6,127.2
"24284","77330","2016",73,62,11,217644.2,2609.671,87.34247
"24285","77331","2016",5,5,0,185000,2322.8,86.6
"24286","77332","2016",5,4,1,160200,2039,90
"24287","77333","2016",121,84,37,166515.3,2074.744,84.75207
"24288","77335","2016",26,24,2,239615.4,2345.308,105.0385
"24289","77336","2016",11,6,5,235583.6,3053.636,93.81818
"24290","77337","2016",119,45,74,206208.1,2814.193,75.77311
"24291","77338","2016",4,4,0,131250,1616.5,79.25
"24292","77339","2016",36,34,2,247092.2,2142.583,127.5278
"24293","77340","2016",9,9,0,197173.8,1754.222,122.4444
"24294","77341","2016",3,3,0,148666.7,1617.333,103.3333
"24295","77343","2016",1,1,0,47000,904,52
"24296","77344","2016",23,23,0,236693.3,2480.217,97.69565
"24297","77345","2016",6,6,0,195695,1499.667,145.5
"24298","77347","2016",9,9,0,152189.2,1519.111,104.3333
"24299","77348","2016",3,3,0,161200,1671.667,93
"24300","77349","2016",80,70,10,241105.6,2595.887,97.8625
"24301","77350","2016",253,183,70,272791.9,3159.798,91.04743
"24302","77352","2016",30,28,2,223904.6,2272.633,106.7
"24303","77353","2016",3,3,0,720189.3,2696.667,173
"24304","77354","2016",13,13,0,234507.7,2588.692,100.2308
"24305","77355","2016",3,3,0,123166.7,1545.667,91
"24306","77356","2016",2,2,0,133800,1799.5,74.5
"24307","77357","2016",7,7,0,236857.1,2206.429,110
"24308","77358","2016",13,13,0,234279.2,2096.154,112.6923
"24309","77359","2016",18,15,3,264391.7,2548.667,112.0556
"24310","77360","2016",4,4,0,273650,2227.5,151.25
"24311","77361","2016",7,7,0,185071.4,2215.429,85.57143
"24312","77363","2016",21,15,6,246728.6,3232.286,86.04762
"24313","77364","2016",1,1,0,230000,2771,83
"24314","77365","2016",8,8,0,249125,2479.125,111
"24315","77366","2016",5,5,0,205032,1924.8,121
"24316","77367","2016",2,2,0,169500,1940,85.5
"24317","77368","2016",1,1,0,160000,1600,100
"24318","77369","2016",7,7,0,272642.9,2492.857,111.7143
"24319","77370","2016",13,13,0,151423.1,1593.923,97.15385
"24320","77371","2016",45,45,0,218774.7,2766.489,94.04444
"24321","77372","2016",41,29,12,330911.1,3681.22,100.6098
"24322","77373","2016",437,256,181,245938.5,3430.618,75.83066
"24323","77374","2016",25,18,7,259195.2,2839.12,98.84
"24324","77376","2016",15,14,1,260746.7,2586.133,104.3333
"24325","77377","2016",25,24,1,272860,2950,96
"24326","77378","2016",38,19,19,224506.7,2922.132,79.21053
"24327","77379","2016",127,65,62,153180.2,1924.85,87.50394
"24328","77380","2016",1,1,0,230000,2421,95
"24329","77381","2016",4,4,0,261250,1846.25,180
"24330","77382","2016",74,68,6,241499.5,2667.878,94.27027
"24331","77383","2016",11,11,0,225231.8,1808.636,141.7273
"24332","77384","2016",13,13,0,223926.9,3127.308,75.23077
"24333","77385","2016",26,24,2,156411.2,1654.692,101.0769
"24334","77386","2016",13,13,0,223307.7,1968.692,109.4615
"24335","77387","2016",9,9,0,185000,2241.444,109.2222
"24336","77388","2016",13,13,0,189769.2,1679.077,114.6923
"24337","77389","2016",52,24,28,218320.4,2679.885,82.13462
"24338","77390","2016",217,138,79,228875.2,2940.926,80.51152
"24339","77391","2016",8,8,0,140882.5,1448.125,98.125
"24340","77392","2016",7,7,0,273228.6,2702.143,103.4286
"24341","77393","2016",38,33,5,217062.9,2134.974,109.8421
"24342","77394","2016",24,24,0,265883.3,2639.333,108.6667
"24343","77395","2016",3,3,0,213000,2574.333,79
"24344","77396","2016",1,1,0,90000,1364,66
"24345","77397","2016",19,19,0,175202.6,1682.526,105.5263
"24346","77398","2016",11,11,0,173077.3,1600.727,113
"24347","77400","2016",30,28,2,210013.4,2413.533,99.46667
"24348","77401","2016",6,6,0,99416.67,1273.667,78.66667
"24349","77402","2016",4,4,0,147151,1655,91
"24350","77403","2016",5,5,0,228400,2110,109.2
"24351","77404","2016",18,18,0,153611.1,1900.111,86.72222
"24352","77405","2016",24,24,0,166762.5,1727.708,98.375
"24353","77406","2016",16,16,0,160750,2141.5,82.25
"24354","77407","2016",166,111,55,239976,2598.633,95.22289
"24355","77408","2016",11,11,0,234454.5,2470.727,99.72727
"24356","77409","2016",29,29,0,165357.7,1811.759,94.27586
"24357","77410","2016",5,4,1,240940,1876,134.2
"24358","77411","2016",6,6,0,170770,1877.667,95.66667
"24359","77412","2016",1,1,0,276000,1903,145
"24360","77413","2016",39,33,6,290478.5,2866.231,102.9744
"24361","77414","2016",6,6,0,137833.3,1636.833,88.5
"24362","77415","2016",12,12,0,236862.5,2351.5,104
"24363","77416","2016",3,3,0,176000,1727,104
"24364","77417","2016",2,2,0,2e+05,1963.5,102
"24365","77418","2016",7,7,0,152857.1,1390.571,111.7143
"24366","77419","2016",47,36,11,180599.3,2203.511,85.14894
"24367","77420","2016",44,36,8,237930.5,2773.932,91.70455
"24368","77421","2016",3,3,0,199000,1754.333,126.6667
"24369","77423","2016",9,9,0,137285.6,1569.667,89.44444
"24370","77424","2016",5,5,0,133400,1831.4,79.4
"24371","77425","2016",6,6,0,510803.8,3222.167,168.8333
"24372","77426","2016",4,4,0,261147.5,3509.5,85
"24373","77427","2016",3,3,0,267000,2277.333,118.3333
"24374","77428","2016",13,13,0,225439.2,2160.154,107.4615
"24375","77429","2016",4,4,0,214250,1781,124
"24376","77430","2016",70,62,8,232300.1,2611.529,92.41429
"24377","77431","2016",62,49,13,194970.8,2144.613,102.3065
"24378","77432","2016",10,10,0,146300,1526.9,95.4
"24379","77433","2016",18,17,1,220777.2,2160.167,108.0556
"24380","77434","2016",9,9,0,144788.9,2020,85.11111
"24381","77435","2016",9,9,0,332199.2,2841.556,123.5556
"24382","77436","2016",10,10,0,177031,1749.3,105.6
"24383","77437","2016",18,17,1,218150,2345.556,97.22222
"24384","77438","2016",62,41,21,261445.5,3236.5,85.83871
"24385","77439","2016",11,10,1,160181.8,1907.182,85.54545
"24386","77440","2016",13,11,2,149730.8,1785.154,87.30769
"24387","77441","2016",32,31,1,295939.8,2661.781,120.9062
"24388","77442","2016",30,28,2,277041.1,2491.367,114.6
"24389","77443","2016",6,6,0,234625,2317.667,106.3333
"24390","77444","2016",1,1,0,165000,1618,102
"24391","77445","2016",278,160,118,193538.8,2399.291,83.21223
"24392","77446","2016",13,13,0,130943.1,1376.692,95.46154
"24393","77447","2016",16,14,2,272346.9,3231.562,91.9375
"24394","77448","2016",6,5,1,164741.7,1848,88.16667
"24395","77449","2016",100,17,83,241611.6,3673.46,67.24
"24396","77450","2016",38,33,5,306175,3078.474,109.0263
"24397","77451","2016",10,10,0,166400,1915.3,95.5
"24398","77452","2016",1,1,0,140000,1045,134
"24399","77453","2016",11,10,1,222981.8,2820.727,87.27273
"24400","77454","2016",6,6,0,176216.7,1810.5,115.6667
"24401","77455","2016",28,22,6,197837.3,2838.929,81.28571
"24402","77456","2016",8,8,0,155937.5,1557.5,105.75
"24403","77457","2016",7,5,2,184394.3,2490.857,83.57143
"24404","77458","2016",50,47,3,142659.6,1775.98,83.94
"24405","77459","2016",14,14,0,139178.6,1457,102.4286
"24406","77460","2016",3,3,0,178783.3,1335.333,131
"24407","77461","2016",5,5,0,117900,1319.6,95
"24408","77462","2016",7,5,2,179357.1,2531.571,74
"24409","77463","2016",52,48,4,234447.2,2658.788,93.96154
"24410","77464","2016",129,70,59,236073.2,3075.953,79.48062
"24411","77465","2016",11,11,0,204809.1,1923.455,121.3636
"24412","77466","2016",7,7,0,170014.3,2316.714,76.71429
"24413","77467","2016",4,4,0,136250,1205.75,122.5
"24414","77468","2016",255,74,181,204926.2,2855.204,74.98039
"24415","77469","2016",17,14,3,228525.3,2333.706,103.3529
"24416","77470","2016",77,51,26,227301,2825.039,84.96104
"24417","77471","2016",3,3,0,134833.3,1534.333,89
"24418","77472","2016",5,5,0,128000,1329.6,90.6
"24419","77473","2016",1,1,0,250000,1603,156
"24420","77474","2016",10,9,1,216570,2884.2,76.5
"24421","77475","2016",57,47,10,208227.8,2424.684,89.63158
"24422","77476","2016",3,3,0,220250,1584,143.6667
"24423","77477","2016",15,14,1,205482.7,1973.733,113.5333
"24424","77478","2016",12,11,1,165500,1827.25,92.16667
"24425","77479","2016",131,78,53,252955.1,3409.359,79.19847
"24426","77480","2016",8,8,0,192625,2255,86.75
"24427","77481","2016",2,2,0,182100,1541,120
"24428","77482","2016",35,34,1,159488,2170.829,75.6
"24429","77483","2016",29,26,3,211793.1,2277.069,98.58621
"24430","77484","2016",2,2,0,218500,3064.5,70.5
"24431","77485","2016",15,15,0,321460,2375.667,149.8
"24432","77486","2016",9,9,0,258333.3,2042.222,132.2222
"24433","77487","2016",112,59,53,205573,2418.08,88.29464
"24434","77489","2016",3,3,0,153500,1882.333,86.66667
"24435","77490","2016",10,10,0,183425,1978.9,99
"24436","77492","2016",8,8,0,153127.5,1619.375,104.5
"24437","77493","2016",37,34,3,244266.1,2571.027,99.91892
"24438","77494","2016",29,29,0,176205.9,1829.621,100.5172
"24439","77495","2016",79,72,7,231525.3,2540.342,94.26582
"24440","77496","2016",2,2,0,204750,1885.5,108.5
"24441","77498","2016",7,7,0,364000,2468.143,150.8571
"24442","77500","2016",4,4,0,168125,1813.75,82.5
"24443","77501","2016",12,12,0,158625,2053.75,93.25
"24444","77504","2016",13,13,0,196824.5,1717.462,121.5385
"24445","77505","2016",9,9,0,227288.9,2151.556,109.7778
"24446","77506","2016",13,13,0,135000,1683.231,84.92308
"24447","77507","2016",7,7,0,126785.7,1517.857,95.42857
"24448","77508","2016",22,18,4,263800,2805.318,96
"24449","77509","2016",13,13,0,176552.3,1762.615,101.1538
"24450","77510","2016",13,12,1,290153.8,3017.615,101.3846
"24451","77511","2016",4,3,1,135250,2299,60
"24452","77512","2016",19,19,0,156102.6,1510.579,111.6842
"24453","77513","2016",58,30,28,192150.2,2912.741,69.55172
"24454","77514","2016",317,138,179,187000.6,2897.83,69.64669
"24455","77515","2016",8,8,0,186968.5,3211.5,65.375
"24456","77516","2016",5,5,0,180000,2622.2,79.2
"24457","77517","2016",23,22,1,273062,2567.043,109.6087
"24458","77519","2016",14,13,1,118897.1,1243.286,97.07143
"24459","77520","2016",18,18,0,225383.3,2222.889,105.1111
"24460","77521","2016",15,14,1,208483.3,2371.133,106.1333
"24461","77522","2016",5,5,0,130400,1499,86.6
"24462","77523","2016",6,6,0,148308.3,1215,140.1667
"24463","77524","2016",8,8,0,158387.5,1430.125,121.25
"24464","77526","2016",1,1,0,1e+05,1429,70
"24465","77527","2016",10,10,0,219959,2225.6,101.3
"24466","77528","2016",8,8,0,263678.8,3844.375,82.375
"24467","77529","2016",15,15,0,288583.3,2468.333,129.4
"24468","77530","2016",1,1,0,185000,1412,131
"24469","77531","2016",19,19,0,134110.5,1622.474,93.47368
"24470","77533","2016",38,37,1,267096.7,2580.947,110.3421
"24471","77534","2016",9,9,0,250864.3,2405.778,139.8889
"24472","78003","2016",39,30,9,194882.3,2410.41,83.64103
"24473","78005","2016",147,77,70,249906.3,3293.361,78.45578
"24474","78006","2016",11,11,0,354277.3,2792.273,132.4545
"24475","78007","2016",12,10,2,498138.3,3835.5,127
"24476","78009","2016",5,5,0,227408,2331.4,99.4
"24477","78010","2016",9,9,0,431555.6,3050.333,155.3333
"24478","78013","2016",3,3,0,320633.3,2248,128
"24479","78015","2016",245,115,130,274441.5,3289.376,84.74286
"24480","78020","2016",11,9,2,289240.9,2109.182,143.9091
"24481","78029","2016",84,41,43,188692.3,2436.536,79.80952
"24482","78030","2016",18,17,1,301222.2,2863.056,112.3889
"24483","78031","2016",7,7,0,222437.1,2828.286,96
"24484","78033","2016",14,10,4,209714.3,2884.929,70.42857
"24485","78034","2016",5,5,0,253920,3074.2,84.8
"24486","78036","2016",4,4,0,372750,3124.5,123.25
"24487","78043","2016",60,30,30,416206.7,4098.133,100.9667
"24488","78048","2016",17,16,1,289627.6,2871,112.4706
"24489","78049","2016",22,19,3,268254,2699.273,103.6818
"24490","78050","2016",10,10,0,425400,2971.8,148.9
"24491","78053","2016",6,6,0,256000,2528.333,109
"24492","78057","2016",27,26,1,189670.5,2009.815,99.62963
"24493","78062","2016",94,59,35,257557.2,3063.043,86.8617
"24494","78068","2016",5,5,0,233100,2035.2,115.6
"24495","78070","2016",5,5,0,244368,2458.6,100.4
"24496","78071","2016",9,9,0,208500,2011.889,108.3333
"24497","78072","2016",3,3,0,239666.7,3030,85.66667
"24498","78073","2016",214,54,160,228430.5,3164.724,72.30374
"24499","78076","2016",6,6,0,248733.3,2127,117.6667
"24500","78077","2016",9,9,0,360638.9,2631.667,137.3333
"24501","78082","2016",3,3,0,204200,2094,100
"24502","78084","2016",4,4,0,279615,3144,91.25
"24503","78087","2016",31,26,5,261469.5,2813.323,96.41935
"24504","78089","2016",31,20,11,168148.7,2439.806,71.3871
"24505","78090","2016",1,1,0,260000,1970,132
"24506","78092","2016",105,29,76,406742.1,4249.171,90.41905
"24507","78096","2016",8,8,0,284112.5,3034.25,113
"24508","78104","2016",5,5,0,203087.4,2047.6,111.2
"24509","78107","2016",22,21,1,218761.4,2157.364,105.3182
"24510","78108","2016",9,6,3,414844.4,2720.778,150
"24511","78113","2016",12,12,0,236195.8,2401.75,100.1667
"24512","78117","2016",67,29,38,366183.5,4402.224,83.04478
"24513","78118","2016",12,9,3,203686.7,2476.5,86.83333
"24514","78120","2016",25,24,1,323472.6,2977.36,118.76
"24515","78123","2016",154,74,80,223399.7,3144.071,73.79221
"24516","78124","2016",191,82,109,352487.5,4685.267,75.73298
"24517","78125","2016",11,11,0,372904.5,2895.545,136.0909
"24518","78126","2016",225,74,151,419329.2,4310.289,94.29778
"24519","78128","2016",21,20,1,312721.4,3487.19,95.57143
"24520","78133","2016",92,44,48,444141.8,3934.761,111.4239
"24521","78138","2016",77,54,23,223245.8,2659.364,88.15584
"24522","78140","2016",18,18,0,332922.8,3056.611,119
"24523","78143","2016",16,16,0,508260.6,4138.438,137.875
"24524","78146","2016",415,129,286,392403.7,4637.101,82.63855
"24525","78147","2016",9,9,0,227611.1,2029.778,113.5556
"24526","78152","2016",13,12,1,532022.2,3950.615,139.9231
"24527","78158","2016",207,47,160,438270.1,5085.71,84.83092
"24528","78160","2016",58,40,18,367694,3554.379,109.0345
"24529","78162","2016",6,6,0,489550,3512.667,144.6667
"24530","78164","2016",6,5,1,428892.8,2917.167,147.3333
"24531","78165","2016",227,92,135,238595.6,3050.899,80.34361
"24532","78168","2016",39,28,11,240433.9,3195.564,78.61538
"24533","78171","2016",21,18,3,258139.2,2764.571,104.5238
"24534","78172","2016",471,262,209,251394.2,3473.677,75.12102
"24535","78185","2016",1,1,0,305000,1151,265
"24536","78188","2016",8,7,1,256037.5,2075.625,126.375
"24537","78189","2016",22,22,0,434802.5,3544.045,127.4545
"24538","78190","2016",121,50,71,540130.9,5415.793,97.90083
"24539","78192","2016",14,12,2,231328.6,2322.5,106.5
"24540","78193","2016",12,6,6,288312.5,3682.667,82.66667
"24541","78194","2016",1,1,0,324730,2874,113
"24542","78196","2016",2,2,0,808650,4891.5,169
"24543","78202","2016",8,8,0,253500,2165.125,117.125
"24544","78208","2016",417,139,278,216951.7,2748.36,81.72182
"24545","78209","2016",14,14,0,270026.3,2287.214,118.7857
"24546","78217","2016",57,48,9,240547.4,2593.035,97.64912
"24547","78220","2016",85,60,25,272403.9,2927.247,97.91765
"24548","78224","2016",64,39,25,459258.9,4334.953,107.2812
"24549","78227","2016",12,11,1,320779.2,3096.833,109.75
"24550","78230","2016",5,5,0,254857.6,2580,112.6
"24551","78231","2016",1,1,0,130000,2167,60
"24552","78233","2016",32,31,1,556820.7,4019.719,142.875
"24553","78234","2016",3,3,0,267666.7,2588.333,104.6667
"24554","78236","2016",5,5,0,252290.2,2161.8,121.2
"24555","78237","2016",1,1,0,205000,2303,89
"24556","78238","2016",1,1,0,30000,577,52
"24557","78239","2016",20,17,3,187796.5,2577.65,82.75
"24558","78242","2016",93,21,72,217900.9,3308.398,66.93548
"24559","78245","2016",3,3,0,181666.7,1651.667,123.3333
"24560","78246","2016",13,10,3,219580.8,2466.769,99
"24561","78255","2016",37,36,1,196861.4,2025.595,101.7297
"24562","78261","2016",10,8,2,236330,2341.4,104.7
"24563","78262","2016",16,14,2,290243.8,3009.562,96.1875
"24564","78263","2016",30,29,1,347900.5,3075.533,121.5667
"24565","78264","2016",2,2,0,756675,2626.5,293.5
"24566","78265","2016",31,29,2,290863.2,2804.032,112
"24567","78267","2016",60,51,9,213702.1,2451.3,93.61667
"24568","78269","2016",18,17,1,303588.9,2877.556,111
"24569","78276","2016",5,5,0,205400,1819.6,115.2
"24570","78278","2016",10,10,0,309618,2212.9,142.3
"24571","78281","2016",5,4,1,302709,2246.8,145.2
"24572","78283","2016",2,2,0,365000,3054.5,100
"24573","78285","2016",7,6,1,309070.7,2570,126.7143
"24574","78289","2016",18,18,0,560352.8,2980.278,193.7778
"24575","78290","2016",17,15,2,197705.9,2115,98.58824
"24576","78291","2016",28,26,2,231433.1,2467.679,96.92857
"24577","78296","2016",4,3,1,260000,2451.75,106.5
"24578","78297","2016",259,89,170,279314.1,3528.618,80.57529
"24579","78299","2016",28,23,5,237487.5,2616.929,96.28571
"24580","78300","2016",6,5,1,262658.3,2617.667,108.1667
"24581","78302","2016",2,2,0,155195.5,1209.5,125
"24582","78305","2016",3,3,0,215380,2184.333,102
"24583","78307","2016",13,13,0,248661.5,2223.385,121.0769
"24584","78310","2016",51,26,25,192369.9,2678.941,78.96078
"24585","78311","2016",468,238,230,312912.3,4510.199,71.20513
"24586","78314","2016",53,49,4,219384.9,2404.623,93.07547
"24587","78317","2016",7,7,0,243381.4,2423,111.1429
"24588","78320","2016",5,5,0,214800,1696.2,138.2
"24589","78321","2016",82,70,12,304818.3,3028.195,104.9878
"24590","78322","2016",75,37,38,433315.8,4340.307,100.8667
"24591","78324","2016",2,2,0,436500,2741.5,153
"24592","78325","2016",8,8,0,175975,2017.5,87.75
"24593","78327","2016",44,40,4,236798.8,2467.318,102.7273
"24594","78329","2016",7,7,0,257285.7,2205.286,116.1429
"24595","78334","2016",18,17,1,330072.2,2989.056,115.5
"24596","78335","2016",123,88,35,185164.8,2367.098,80.66667
"24597","78337","2016",27,27,0,213945.1,2085.111,106.8148
"24598","78343","2016",10,9,1,521240.8,4952.3,107.7
"24599","78344","2016",7,7,0,205560,1904.571,124.4286
"24600","78346","2016",18,18,0,261312.9,2355.278,111.3889
"24601","78349","2016",3,3,0,440000,2312.667,178
"24602","78350","2016",78,17,61,399474.9,4331.5,89.80769
"24603","78354","2016",53,34,19,209041.5,2507.151,86.71698
"24604","78356","2016",86,54,32,290285.4,3381.837,89.37209
"24605","78358","2016",401,107,294,432792.9,4892.631,86.78803
"24606","78361","2016",267,90,177,165892.5,2525.393,70.42697
"24607","78362","2016",178,118,60,185761.1,2360.112,81.02247
"24608","78364","2016",8,8,0,281887.5,2992.375,104.125
"24609","78366","2016",5,5,0,407710,3204.8,148.4
"24610","78367","2016",55,39,16,530668.1,4461.782,120.0545
"24611","78368","2016",16,16,0,332580.6,2656.688,127.75
"24612","78372","2016",245,52,193,336095,3946.335,83.44898
"24613","78380","2016",68,61,7,311757.8,3067.397,109.4559
"24614","78381","2016",5,4,1,296700,2983.6,110
"24615","78382","2016",48,33,15,286559.2,3406.5,86.58333
"24616","78383","2016",263,107,156,219648.9,2829.559,79.6616
"24617","78384","2016",15,15,0,455057.7,3813.6,128.1333
"24618","78385","2016",2,2,0,265150,3216.5,89
"24619","78389","2016",21,19,2,336564,2751.095,127.2857
"24620","78391","2016",2,2,0,188500,1674.5,115
"24621","78396","2016",69,41,28,507340.4,4472.116,111.6377
"24622","78397","2016",118,90,28,311781.7,3114.381,104.2119
"24623","78398","2016",11,11,0,358955.5,2710.455,157.5455
"24624","78401","2016",94,40,54,153053.5,2461.5,64.84043
"24625","78402","2016",40,32,8,264242.5,2774,101.025
"24626","78403","2016",28,26,2,226669.2,2828.857,94.75
"24627","78404","2016",2,2,0,311000,2174,144
"24628","78406","2016",2,1,1,332000,4610.5,70.5
"24629","78407","2016",6,6,0,230916.7,2560.833,108.5
"24630","78410","2016",14,14,0,210642.9,2205.5,102.2857
"24631","78413","2016",7,7,0,226347.1,2294,101.2857
"24632","78415","2016",5,5,0,276400,2708.8,116.2
"24633","78416","2016",5,5,0,242460,2721.6,88
"24634","78417","2016",4,4,0,299250,3579,86.5
"24635","78418","2016",179,90,89,367789.6,4246.469,87.94972
"24636","78420","2016",39,24,15,364674,3678.231,100.4615
"24637","78423","2016",451,131,320,280416.4,3552.293,80.20843
"24638","78431","2016",31,28,3,395092.3,3113.935,130.871
"24639","78437","2016",7,7,0,220760,2234.714,101
"24640","78439","2016",2,2,0,188750,2141,88.5
"24641","78440","2016",150,76,74,156666.5,2178.407,74.96
"24642","78442","2016",54,23,31,245854.4,3181.556,81.2963
"24643","78444","2016",6,6,0,218313,1714,131.5
"24644","78451","2016",12,9,3,246125,2578.917,102.1667
"24645","78455","2016",78,57,21,530093.6,4441.282,120.5513
"24646","78460","2016",15,15,0,273930.7,2541.933,105.5333
"24647","78464","2016",5,5,0,289219,2648.8,115.4
"24648","78465","2016",34,28,6,252745,2929.059,89.02941
"24649","78466","2016",91,78,13,446971.6,3704.187,125.0769
"24650","78470","2016",5,5,0,302400,2365.8,137.2
"24651","78472","2016",4,4,0,194225,2676,83.25
"24652","78474","2016",12,12,0,242140.3,2474.75,99.58333
"24653","78475","2016",8,8,0,287375,2827.5,108.375
"24654","78478","2016",5,5,0,234040,2089,112.8
"24655","78481","2016",217,48,169,327503.6,4323.926,73.93088
"24656","78484","2016",7,7,0,278857.1,2210.714,130.2857
"24657","78486","2016",78,52,26,233122.4,3087.487,82.85897
"24658","78490","2016",359,158,201,232770.9,2843.563,83.88579
"24659","78497","2016",13,13,0,413342.3,3106.231,147.5385
"24660","78498","2016",392,93,299,244772.8,3516.561,70
"24661","78499","2016",8,8,0,268875,2522.625,110.5
"24662","78501","2016",26,26,0,213976.9,2367.885,93.03846
"24663","78502","2016",67,8,59,229585.8,3522.284,66.9403
"24664","78505","2016",5,5,0,244113,2657,94.8
"24665","78506","2016",8,8,0,305187.5,2693.625,120.25
"24666","78513","2016",21,10,11,228555.8,3216.619,75.19048
"24667","78516","2016",14,14,0,292996.4,3064.857,116.6429
"24668","78517","2016",371,154,217,262041.9,3303.863,81.86523
"24669","78518","2016",3,1,2,252333.3,2576,96.66667
"24670","78520","2016",17,17,0,236050,2550.353,97
"24671","78522","2016",13,9,4,267912.3,2525,114.3077
"24672","78528","2016",7,7,0,176857.1,2263.286,89
"24673","78530","2016",9,9,0,302215.6,2872.333,113
"24674","78531","2016",53,48,5,226801.9,2233.472,103.0566
"24675","78536","2016",7,6,1,221400,2630.571,89.14286
"24676","78537","2016",73,57,16,251973.8,2688.384,101.1507
"24677","78545","2016",232,54,178,261790,3739.47,70.01293
"24678","78548","2016",3,3,0,652666.7,3378,190.3333
"24679","78550","2016",18,17,1,341989.4,3017.444,116.7778
"24680","78551","2016",573,137,436,449532.8,5350.674,83.94066
"24681","78557","2016",12,12,0,253041.7,2513.833,113.4167
"24682","78558","2016",1,1,0,342900,1633,210
"24683","78559","2016",4,4,0,253500,2781.5,96.25
"24684","78561","2016",8,8,0,390812.5,3326.125,122.5
"24685","78562","2016",17,12,5,343865.9,3102.412,116.8235
"24686","78564","2016",13,13,0,290760.5,2211.462,136.5385
"24687","78565","2016",2,2,0,470000,3066.5,150
"24688","78567","2016",7,6,1,233671.4,2590.429,100.4286
"24689","78569","2016",12,9,3,239618,2900,93.58333
"24690","78571","2016",54,50,4,676591.7,3955.815,172.0556
"24691","78575","2016",85,65,20,364748.4,3880.612,98.11765
"24692","78576","2016",22,16,6,402414.9,3448.182,129.6818
"24693","78586","2016",569,241,328,256178.9,3828.787,70.93146
"24694","78588","2016",6,6,0,375050,3080.333,135.6667
"24695","78590","2016",9,9,0,335055.4,3234.111,107.4444
"24696","78591","2016",32,29,3,226541.7,2411.719,100.625
"24697","78597","2016",9,9,0,334277.8,2566.333,139.3333
"24698","78601","2016",14,13,1,270857.1,2430.929,121.6429
"24699","78605","2016",7,7,0,228907.9,2230.286,106
"24700","78606","2016",1,1,0,557550,2859,195
"24701","78609","2016",12,12,0,240662.8,2747.25,93.33333
"24702","78615","2016",7,6,1,303340,4290,77.57143
"24703","78616","2016",14,12,2,298535.7,2823,109.0714
"24704","78618","2016",6,6,0,206211.7,2264.333,93.83333
"24705","78620","2016",9,8,1,526557.6,3918.667,133.4444
"24706","78621","2016",155,48,107,191557.5,2841.974,70.06452
"24707","78624","2016",172,120,52,261828.1,3037.64,89.53488
"24708","78638","2016",54,47,7,281693.7,3222.852,98.53704
"24709","78640","2016",211,45,166,318852.1,4095.569,76.69668
"24710","78642","2016",187,95,92,271091,2992.203,90.80749
"24711","78643","2016",110,80,30,311371.2,3239.636,101.1727
"24712","78644","2016",59,32,27,200510.5,3232.441,67.49153
"24713","78646","2016",1059,128,931,426661.4,5633.75,74.6204
"24714","78647","2016",5,5,0,143000,1909.8,83
"24715","78650","2016",236,112,124,668872.3,5888.669,107.6483
"24716","78653","2016",2,2,0,282500,1443,212
"24717","78655","2016",9,9,0,328730,2892.556,119.5556
"24718","78668","2016",8,8,0,182868.8,1852.625,101.75
"24719","78672","2016",64,49,15,455817.4,4145.078,111.9062
"24720","78674","2016",124,95,29,279368.8,3374.323,83.47581
"24721","78677","2016",5,5,0,190620,1767.6,106.6
"24722","78681","2016",15,15,0,309138,2873.667,117.4667
"24723","78686","2016",241,72,169,422318.6,5285.714,77.17427
"24724","78688","2016",134,90,44,371868.7,3914.433,97.31343
"24725","79001","2016",12,12,0,74350,885.9167,84.66667
"24726","79003","2016",35,35,0,177475.7,1668.771,105.0286
"24727","79005","2016",17,17,0,92433.94,883.5294,106.4706
"24728","79007","2016",5,5,0,116000,889.6,129.6
"24729","79008","2016",5,5,0,128830,1067.6,120.4
"24730","79009","2016",5,5,0,84140,858.2,99.4
"24731","79010","2016",12,12,0,113083.3,1566,71.66667
"24732","79012","2016",12,12,0,121906.5,1221.167,98.66667
"24733","79013","2016",30,30,0,92404.37,955.5,101.4333
"24734","79014","2016",21,21,0,115909.2,1020.619,114.7619
"24735","79015","2016",1,1,0,85000,966,88
"24736","79016","2016",8,8,0,81737.5,903,96
"24737","79018","2016",1,1,0,18000,500,36
"24738","79019","2016",4,4,0,110750,977.75,107.5
"24739","79020","2016",5,5,0,169140,1228.2,114.2
"24740","79022","2016",1,1,0,59024,557,106
"24741","79023","2016",1,1,0,198000,990,200
"24742","79024","2016",15,15,0,155396.7,1307.267,121.8667
"24743","79025","2016",16,16,0,92568.75,1037.5,94.0625
"24744","79029","2016",7,7,0,92071.43,867.8571,96.28571
"24745","79030","2016",3,3,0,261333.3,1087,196.6667
"24746","79031","2016",17,16,1,106470.6,1138.882,96.88235
"24747","79032","2016",6,6,0,127866.7,1411,108.3333
"24748","79034","2016",20,20,0,162425,1492.75,107.85
"24749","79038","2016",7,7,0,80015.71,774,102.1429
"24750","79040","2016",3,3,0,113833.3,1655.667,88.66667
"24751","79042","2016",3,3,0,93400,846,115
"24752","79046","2016",9,9,0,152333.3,1240.889,119.5556
"24753","79047","2016",6,6,0,69916.67,811,103
"24754","79048","2016",61,60,1,123953.9,1333.885,96.04918
"24755","79049","2016",187,169,18,120257.6,1292.059,98.24064
"24756","79050","2016",7,7,0,75500,766,113.2857
"24757","79056","2016",4,4,0,108875,1046,109
"24758","79057","2016",12,12,0,107791.7,973.9167,113.1667
"24759","79058","2016",10,10,0,130620,1166.7,118
"24760","79059","2016",6,6,0,134483.3,984.8333,132.8333
"24761","79060","2016",6,6,0,163496.7,944.8333,152.3333
"24762","79061","2016",32,32,0,112114.1,1087.688,104.75
"24763","79062","2016",26,26,0,102461.5,1008.5,103
"24764","79063","2016",19,19,0,84815.79,886.7895,99.31579
"24765","79064","2016",3,3,0,119833.3,930.3333,132.6667
"24766","79066","2016",19,18,1,115934.5,1101.895,105.6316
"24767","79069","2016",9,9,0,109277.8,1122.444,96
"24768","79070","2016",4,4,0,101085,874.25,123.5
"24769","79071","2016",1,1,0,17000,386,44
"24770","79074","2016",2,2,0,79950,874.5,90
"24771","79076","2016",13,13,0,95934.62,905.2308,111.4615
"24772","79077","2016",8,8,0,101481.2,905.375,112.125
"24773","79078","2016",17,17,0,104323.5,1000.882,110.5294
"24774","79079","2016",82,82,0,128568.3,1147.073,111.5488
"24775","79080","2016",22,22,0,99357.82,1083.273,92.27273
"24776","79081","2016",61,60,1,178805.4,1635.508,110.8033
"24777","79083","2016",26,23,3,107535.7,1095.654,103.4231
"24778","79084","2016",5,5,0,120987,777.8,135.8
"24779","79085","2016",1,1,0,114500,603,190
"24780","79086","2016",18,18,0,143222.2,1255.611,122.5
"24781","79087","2016",5,5,0,118140,1022.8,116
"24782","79088","2016",7,7,0,105500,759.5714,144.1429
"24783","79089","2016",1,1,0,146200,1044,140
"24784","79090","2016",8,8,0,68062.5,757.375,96
"24785","79091","2016",10,10,0,107287.5,800.2,134.4
"24786","79092","2016",8,8,0,54844.62,692.125,78.125
"24787","79094","2016",13,13,0,89738.31,920.9231,94.84615
"24788","79095","2016",6,6,0,148258.3,965,152.8333
"24789","79096","2016",14,14,0,95136.43,915.0714,98.78571
"24790","79100","2016",26,26,0,166411.5,1496.038,109.5385
"24791","79101","2016",32,32,0,107596.9,1129.344,93.6875
"24792","79102","2016",5,5,0,74320,795,100
"24793","79103","2016",18,18,0,88083.33,893.0556,94.61111
"24794","79104","2016",1,1,0,73000,664,110
"24795","79105","2016",5,5,0,101280,803.8,129.8
"24796","79106","2016",2,2,0,79250,724,109
"24797","79109","2016",31,31,0,154264.5,1366.419,114.6774
"24798","79111","2016",1,1,0,85000,810,105
"24799","79112","2016",7,6,1,128297.1,1297.286,99.42857
"24800","79114","2016",8,8,0,155412.4,1235.5,131.875
"24801","79115","2016",6,6,0,90525,783.5,113.3333
"24802","79116","2016",11,11,0,82909.09,948.4545,87.27273
"24803","79117","2016",7,7,0,126482.9,1086.286,129.5714
"24804","79118","2016",2,2,0,64500,837,79.5
"24805","79119","2016",3,3,0,98666.67,1187,83
"24806","79120","2016",4,4,0,118257.5,904,116
"24807","79121","2016",6,6,0,75300,716.5,103
"24808","79122","2016",4,4,0,88925,658.75,138.25
"24809","79123","2016",22,22,0,93336.36,857.1818,111.5
"24810","79124","2016",9,6,3,101381.6,1132.111,86.33333
"24811","79125","2016",18,18,0,122277.8,1147.167,105.8333
"24812","79126","2016",1,1,0,110000,1196,92
"24813","79127","2016",7,7,0,135000,1269.286,110.5714
"24814","79128","2016",8,8,0,174954.4,1418.5,121.125
"24815","79129","2016",17,17,0,167506.5,1475.882,116.8824
"24816","79130","2016",40,40,0,130336.7,1252.55,106.3
"24817","79131","2016",3,3,0,91000,792.3333,144
"24818","79132","2016",3,3,0,105766.7,1019,106
"24819","79133","2016",11,11,0,161995.5,1257.636,116.8182
"24820","79135","2016",9,9,0,99944.44,934,110
"24821","79136","2016",3,3,0,174100,1516.667,113.6667
"24822","79137","2016",11,11,0,142636.4,1219.091,119
"24823","79140","2016",4,4,0,85615.75,729.75,117
"24824","79141","2016",2,2,0,115990,1062.5,109
"24825","79142","2016",1,1,0,120000,1071,112
"24826","79144","2016",2,2,0,126500,848.5,201.5
"24827","79145","2016",4,4,0,60550,540.25,113.75
"24828","79147","2016",13,13,0,72307.69,836.3077,92.76923
"24829","79148","2016",27,27,0,100626.9,936.7407,109.4815
"24830","79150","2016",15,15,0,114278.1,993.5333,114.8
"24831","79152","2016",5,5,0,68200,596,112.4
"24832","79154","2016",5,5,0,100600,825,121.4
"24833","79156","2016",10,10,0,73101,742.6,98.8
"24834","79157","2016",9,9,0,124706.3,1114.889,118.5556
"24835","79158","2016",1,1,0,140000,814,172
"24836","79159","2016",5,5,0,98800,1103.2,92.4
"24837","79161","2016",5,5,0,107370,1039.4,97.8
"24838","79162","2016",27,27,0,172005.9,1624.963,108.9259
"24839","79163","2016",7,7,0,71071.43,791,93.42857
"24840","79164","2016",2,2,0,95500,672.5,126
"24841","79165","2016",2,2,0,290132.5,1014,274
"24842","79166","2016",10,10,0,128367,1030.7,125.8
"24843","79167","2016",2,2,0,28000,545,52
"24844","79170","2016",36,34,2,113739.8,1261.194,92.75
"24845","79172","2016",8,8,0,81887.5,935.125,84.375
"24846","79174","2016",37,37,0,108978.4,1037.027,111.7838
"24847","79175","2016",11,11,0,118464.5,871.2727,139.4545
"24848","79176","2016",10,10,0,78645,816.2,95.4
"24849","79177","2016",5,5,0,132488.4,785.8,171.8
"24850","79179","2016",50,50,0,93160.2,896.84,105.8
"24851","79180","2016",2,2,0,53000,630,87.5
"24852","79183","2016",1,1,0,120000,1304,92
"24853","79184","2016",15,15,0,94800,954.4,100
"24854","79185","2016",42,42,0,120878.8,1108.095,109.8095
"24855","79189","2016",14,14,0,116450,1209.786,95.64286
"24856","79190","2016",4,4,0,108375,787.5,121.75
"24857","79191","2016",886,643,243,118718.4,1432.626,82.97968
"24858","79195","2016",30,30,0,105858,943.0333,114.5333
"24859","79196","2016",16,16,0,85343.75,779.5,111.5
"24860","79197","2016",1,1,0,110000,1111,99
"24861","79198","2016",4,4,0,133750,909,136
"24862","79200","2016",3,3,0,90266.67,978,94.33333
"24863","79201","2016",13,13,0,87100,978.2308,87.92308
"24864","79202","2016",151,128,23,98092.3,1064.272,91.86093
"24865","79203","2016",3,3,0,84000,937,110.3333
"24866","79204","2016",7,7,0,132642.9,1199.857,122.4286
"24867","79205","2016",1,1,0,93000,715,130
"24868","79207","2016",3,3,0,129333.3,1114,107.6667
"24869","79208","2016",4,4,0,168125,1162.5,137
"24870","79209","2016",2,2,0,134750,1449,99
"24871","79210","2016",6,6,0,134171.2,1137.667,119.8333
"24872","79212","2016",3,3,0,60370,532.3333,120
"24873","79213","2016",18,18,0,103808.3,1058.722,96.33333
"24874","79215","2016",4,4,0,65412.5,571.75,117.75
"24875","79216","2016",19,19,0,136577.6,1233.842,112
"24876","79217","2016",7,7,0,179807.1,1233.571,149.2857
"24877","79218","2016",1,1,0,136400,1240,110
"24878","79220","2016",6,6,0,125758.5,1316.333,96.83333
"24879","79223","2016",1,1,0,145000,815,178
"24880","79225","2016",2,2,0,101500,1149,88
"24881","79226","2016",2,2,0,213500,990.5,188.5
"24882","79229","2016",7,7,0,117114.3,1155,101.8571
"24883","79230","2016",9,9,0,120339.4,1179.667,102.6667
"24884","79231","2016",5,5,0,128000,1185,109
"24885","79235","2016",10,10,0,109400,1227.5,87.2
"24886","79236","2016",5,5,0,78263,813.4,95.6
"24887","79238","2016",6,6,0,89666.67,858,96.83333
"24888","79239","2016",15,15,0,84280,879.5333,93.93333
"24889","79241","2016",10,10,0,86762.9,833.3,110.6
"24890","79242","2016",5,5,0,87600,913,97.2
"24891","79243","2016",6,6,0,102033.3,1033.167,94.5
"24892","79244","2016",1,1,0,134000,1675,80
"24893","79246","2016",3,3,0,64000,834.3333,64.66667
"24894","79249","2016",29,28,1,166291,1429.862,121.1724
"24895","79250","2016",4,4,0,119000,928.25,130.75
"24896","79251","2016",1,1,0,60000,800,75
"24897","79252","2016",5,5,0,63300,886.4,77
"24898","79253","2016",5,5,0,99300,899.8,106
"24899","79254","2016",3,3,0,95333.33,1009,91.33333
"24900","79255","2016",3,3,0,54166.67,820.3333,66.66667
"24901","79256","2016",3,3,0,21666.67,396.6667,54.66667
"24902","79257","2016",17,17,0,104157.6,1098.824,86.17647
"24903","79258","2016",3,3,0,76833.33,705.6667,103.6667
"24904","79259","2016",9,9,0,126300,1244.667,98.88889
"24905","79263","2016",7,7,0,98100,872.5714,119.7143
"24906","79265","2016",8,8,0,161000,1271.875,137.375
"24907","79267","2016",3,3,0,83833.33,647,119.6667
"24908","79268","2016",10,10,0,96033.1,938.6,105.1
"24909","79269","2016",7,7,0,116221.4,928.8571,127.2857
"24910","79270","2016",68,54,14,99095.81,1014.941,100.2647
"24911","79271","2016",5,5,0,86950,956.6,84.2
"24912","79273","2016",7,7,0,147642.9,1454.571,107.7143
"24913","79276","2016",13,13,0,123615.4,1340.154,94.76923
"24914","79277","2016",13,13,0,118488.5,1241.077,104.3846
"24915","79278","2016",6,6,0,88052.67,1416.167,94.33333
"24916","79280","2016",11,11,0,62300,680.0909,88.18182
"24917","79281","2016",17,17,0,151794.2,1219.824,131
"24918","79283","2016",5,5,0,178400,1377,145.4
"24919","79284","2016",5,5,0,175400,1389.6,126.6
"24920","79285","2016",14,14,0,113449.3,1085,100.7143
"24921","79286","2016",3,3,0,106333.3,1167,93.33333
"24922","79289","2016",13,13,0,117569.2,1049.385,111.2308
"24923","79290","2016",8,8,0,110437.5,901.125,118.375
"24924","79293","2016",5,5,0,158822,1672.2,96
"24925","79294","2016",2,2,0,54500,589.5,93.5
"24926","79295","2016",10,10,0,123138.4,988.2,127
"24927","79297","2016",6,6,0,173225,1188.667,137.1667
"24928","79298","2016",11,11,0,189745.5,1374.455,146.0909
"24929","79299","2016",22,22,0,81227.27,936.9545,88.54545
"24930","79300","2016",12,12,0,100708.3,971.4167,101.1667
"24931","79301","2016",5,5,0,86600,941.2,102.4
"24932","79302","2016",18,17,1,136336.7,1128.222,119.2778
"24933","79303","2016",4,4,0,131900,1330,99.25
"24934","79304","2016",5,5,0,158200,1605,98.6
"24935","79306","2016",3,3,0,124333.3,996.3333,120.3333
"24936","79307","2016",17,17,0,79058.82,828.0588,100.8235
"24937","79308","2016",12,12,0,179791.7,1410,132.9167
"24938","79309","2016",3,3,0,84483.33,1088.333,77.66667
"24939","79310","2016",6,6,0,97333.33,932.8333,110.6667
"24940","79311","2016",15,15,0,88866.67,919.8,102.2
"24941","79312","2016",2,2,0,76500,687.5,115
"24942","79313","2016",2,2,0,43500,399,105
"24943","79316","2016",10,10,0,119685,1050.8,117.4
"24944","79319","2016",7,7,0,120314.3,932.2857,128.8571
"24945","79320","2016",5,5,0,162650,890.2,192.2
"24946","79322","2016",19,19,0,127536.8,1123.211,118.2105
"24947","79326","2016",12,12,0,74958.33,775.3333,93.75
"24948","79329","2016",166,156,10,81688.98,933.9699,86.8494
"24949","79331","2016",4,4,0,92000,733.75,111.5
"24950","79332","2016",2,2,0,212000,1411.5,159
"24951","79334","2016",9,9,0,144400,1396.222,123.5556
"24952","79335","2016",11,11,0,158945.5,1148.818,135.7273
"24953","79336","2016",2,2,0,85552.5,918.5,103
"24954","79337","2016",8,8,0,130125,1058.625,120.25
"24955","79338","2016",1,1,0,140000,1014,138
"24956","79339","2016",17,17,0,92764.71,878.5882,101.5294
"24957","79340","2016",3,3,0,94666.67,763.6667,131.6667
"24958","79341","2016",1,1,0,30000,500,60
"24959","79342","2016",5,5,0,68300,685,101
"24960","79343","2016",2,2,0,90000,956,94
"24961","79345","2016",11,11,0,80109.09,774.8182,93.63636
"24962","79346","2016",1,1,0,106500,755,141
"24963","79347","2016",10,10,0,134150,1252.3,109.7
"24964","79349","2016",3,3,0,93666.67,785.3333,123
"24965","79350","2016",2,2,0,59000,673.5,84.5
"24966","79351","2016",16,16,0,128784,1340.438,101.125
"24967","79352","2016",2,2,0,67500,741,97
"24968","79354","2016",9,9,0,161395.8,1233,127.4444
"24969","79355","2016",45,35,10,148843.2,1958.511,87.02222
"24970","79357","2016",3,3,0,84100,984.3333,95
"24971","80001","2016",206,171,35,118541.8,1413.252,86.2767
"24972","80002","2016",4,4,0,145500,1128.25,132
"24973","80003","2016",6,6,0,101500,992.3333,110.6667
"24974","80004","2016",5,5,0,82550,1135.6,82.8
"24975","80006","2016",5,5,0,144700,1413.4,102.2
"24976","80008","2016",5,5,0,121320,1215.6,95.2
"24977","80009","2016",10,10,0,115830,1358.9,88.6
"24978","80010","2016",36,36,0,128630.8,1311.278,96.66667
"24979","80011","2016",36,36,0,152534.7,1663.889,92.61111
"24980","80013","2016",7,7,0,105870,1177.571,90.14286
"24981","80015","2016",1,1,0,170000,1278,133
"24982","80016","2016",126,115,11,98888.19,1251.421,80.4127
"24983","80017","2016",5,5,0,139800,1186,124.2
"24984","80018","2016",2,2,0,123000,1129.5,109.5
"24985","80019","2016",15,15,0,122645.7,1222.533,100.8
"24986","80020","2016",4,4,0,228350,1661.25,132.5
"24987","80021","2016",1506,873,633,143064.7,2058.422,72.64542
"24988","80022","2016",2,2,0,346912.5,3044,91.5
"24989","80023","2016",4,4,0,92000,1458.75,64.75
"24990","80024","2016",4,4,0,218775,1670.5,128.5
"24991","80025","2016",2,2,0,101775,865.5,121
"24992","80026","2016",1,1,0,16000,500,32
"24993","80027","2016",1,1,0,80000,1333,60
"24994","80028","2016",1,1,0,136000,1417,96
"24995","80029","2016",3,3,0,130333.3,1903,67.66667
"24996","80030","2016",4,4,0,142750,1697,82.25
"24997","80031","2016",12,12,0,127150,1468.417,93.33333
"24998","80032","2016",1,1,0,65000,1625,40
"24999","80033","2016",1,1,0,140650,1005,140
"25000","80034","2016",6,6,0,83250,947.5,92.5
"25001","80035","2016",1,1,0,85000,1214,70
"25002","80036","2016",3,3,0,206500,1796.667,141
"25003","80037","2016",2,2,0,134465,947.5,142
"25004","80039","2016",59,39,20,100905.4,1710.373,62.61017
"25005","80040","2016",1,1,0,75000,1364,55
"25006","80041","2016",1,1,0,162000,953,170
"25007","80042","2016",1,1,0,175000,625,280
"25008","80043","2016",4,4,0,244000,1674.25,131.75
"25009","80044","2016",4,4,0,133650,1243.75,106.25
"25010","80045","2016",1,1,0,78000,1164,67
"25011","80047","2016",2,2,0,130000,976.5,133.5
"25012","80049","2016",2,2,0,161000,1488.5,112.5
"25013","80050","2016",5,5,0,226900,1673.2,135.8
"25014","80052","2016",1,1,0,90000,947,95
"25015","80054","2016",3,3,0,141166.7,1821,76
"25016","80055","2016",1,1,0,153000,1500,102
"25017","80058","2016",4,4,0,140447.8,1715,83.5
"25018","80061","2016",4,4,0,115277.8,1575.75,73
"25019","80062","2016",7,7,0,107267.1,1142,97
"25020","80063","2016",8,8,0,86625,1092,80.375
"25021","80064","2016",2,2,0,159900,1649,101
"25022","80065","2016",1,1,0,110000,1222,90
"25023","80066","2016",2,2,0,222500,2426,91.5
"25024","80067","2016",2,2,0,110200,1089.5,95.5
"25025","80069","2016",2,2,0,87000,1447,58
"25026","80070","2016",8,8,0,116987.5,1196.625,102.875
"25027","80071","2016",18,18,0,94644.44,1107.278,85.44444
"25028","80074","2016",2,2,0,99500,1124.5,84
"25029","80076","2016",3,3,0,166440.3,1424.333,114.3333
"25030","80078","2016",5,5,0,127380,1306.6,98.2
"25031","80079","2016",3,3,0,204166.7,1515,139.6667
"25032","80080","2016",1,1,0,49000,731,67
"25033","80082","2016",8,8,0,151825,1764.5,85.125
"25034","80086","2016",6,6,0,99466.67,1001.833,106.5
"25035","80087","2016",1,1,0,70000,1750,40
"25036","80088","2016",6,6,0,116825,1193.333,96.66667
"25037","80089","2016",3,3,0,132666.7,1450.333,108.3333
"25038","80090","2016",2,2,0,73250,958,92.5
"25039","80092","2016",3,3,0,217500,1781,124
"25040","80093","2016",8,8,0,121750,1230.625,92.875
"25041","80094","2016",7,7,0,168907.1,1662.857,107.7143
"25042","80095","2016",4,4,0,77050,1006.25,74.75
"25043","80096","2016",6,6,0,83600,1053.5,79.33333
"25044","80097","2016",4,4,0,72000,941.75,85.25
"25045","80099","2016",1,1,0,51000,785,65
"25046","80100","2016",7,7,0,77142.86,885.8571,88.14286
"25047","80101","2016",8,8,0,133562.5,1316.25,103.25
"25048","80104","2016",1,1,0,40250,424,95
"25049","80107","2016",11,11,0,151746.9,1915.182,86.18182
"25050","80108","2016",1,1,0,128000,1600,80
"25051","80109","2016",6,6,0,74164.33,897.1667,79.16667
"25052","80110","2016",5,5,0,192500,1795.8,104.8
"25053","80112","2016",2,2,0,154175,1722,90
"25054","80113","2016",1,1,0,128000,3657,35
"25055","80114","2016",3,3,0,160333.3,1501.333,105.6667
"25056","80115","2016",3,3,0,58333.33,570.6667,101
"25057","80116","2016",3,3,0,98333.33,1566.333,59.66667
"25058","80117","2016",1,1,0,221000,1687,131
"25059","80119","2016",2,2,0,92500,949,115.5
"25060","80120","2016",1,1,0,69000,1015,68
"25061","80123","2016",3,3,0,154000,1642.667,96.66667
"25062","80124","2016",7,7,0,116857.1,1218.714,102.5714
"25063","80125","2016",1,1,0,25000,1087,23
"25064","80127","2016",2,2,0,206000,1915.5,111
"25065","80128","2016",1,1,0,118000,1000,118
"25066","80129","2016",5,5,0,99700,1199.8,84
"25067","80130","2016",7,7,0,167800,1495.286,115.2857
"25068","80131","2016",37,37,0,169448.1,1740.946,98.83784
"25069","80132","2016",3,3,0,129700,1420,98
"25070","80134","2016",2,2,0,92500,1355.5,69
"25071","80135","2016",3,3,0,70000,977,71
"25072","80136","2016",18,18,0,93237.22,1102.833,86.88889
"25073","80137","2016",8,8,0,170175,1750.75,101.625
"25074","80138","2016",3,3,0,141333.3,1684.667,81
"25075","80140","2016",3,3,0,116966.7,1073.667,114
"25076","80141","2016",1,1,0,105000,913,115
"25077","80144","2016",8,8,0,78525,1161.625,69.375
"25078","80145","2016",2,2,0,130000,892.5,163
"25079","80146","2016",1,1,0,112000,2383,47
"25080","80147","2016",3,3,0,111333.3,1022.667,114
"25081","80148","2016",4,4,0,110050,932.25,118.75
"25082","80149","2016",2,2,0,102526.5,2010.5,51
"25083","80150","2016",3,3,0,96000,1188.667,77.66667
"25084","80151","2016",2,2,0,80000,1133.5,67.5
"25085","80152","2016",2,2,0,157500,1593,121.5
"25086","80153","2016",1,1,0,70000,707,99
"25087","80154","2016",1,1,0,130000,1646,79
"25088","80155","2016",5,5,0,77848,972.6,84.6
"25089","80156","2016",5,5,0,289300,1736.8,164.8
"25090","80159","2016",1,1,0,269934,1579,171
"25091","80160","2016",14,14,0,185256.4,1845.357,104.2857
"25092","80161","2016",4,4,0,103000,886.25,118
"25093","80162","2016",8,8,0,106400,1198.875,85
"25094","80163","2016",8,8,0,133655,1238.25,113.875
"25095","80164","2016",47,46,1,171101.9,1916.574,90.57447
"25096","80166","2016",6,6,0,155746.7,1690,93.33333
"25097","80167","2016",7,7,0,125757.1,1093.857,118.4286
"25098","80168","2016",7,7,0,120942.9,1336.857,88.85714
"25099","80171","2016",3,3,0,174666.7,1437.667,129.6667
"25100","80172","2016",7,7,0,127071.4,1155.286,113.4286
"25101","80173","2016",1,1,0,285000,2036,140
"25102","80174","2016",1,1,0,230000,1377,167
"25103","80176","2016",2,2,0,175300,1365.5,128.5
"25104","80177","2016",8,8,0,98903.75,900.125,110.375
"25105","80179","2016",3,3,0,114000,1230.333,83
"25106","80181","2016",3,3,0,84333.33,1264,61.33333
"25107","80182","2016",79,68,11,100716.7,1701.139,63.35443
"25108","80183","2016",6,6,0,127399,1079.833,120.5
"25109","80184","2016",5,5,0,133000,1326.8,102.2
"25110","80185","2016",5,5,0,131600,1189.8,111.8
"25111","80186","2016",22,22,0,98363.18,996.3636,95.77273
"25112","80187","2016",8,8,0,155125,1601.5,97.25
"25113","80188","2016",5,5,0,190110,1590.8,126.8
"25114","80189","2016",2,2,0,166625,1572,112
"25115","80190","2016",9,9,0,75000,1017.222,75.44444
"25116","80191","2016",5,5,0,106950,1187.6,90
"25117","80192","2016",1,1,0,15000,682,22
"25118","80193","2016",1,1,0,50000,543,92
"25119","80194","2016",4,4,0,31980.75,586.25,61.75
"25120","80195","2016",1,1,0,130000,956,136
"25121","80196","2016",2,2,0,65000,475,118
"25122","80198","2016",3,3,0,142833.3,1634.333,86.33333
"25123","80199","2016",7,7,0,122428.6,1542.857,85.42857
"25124","80200","2016",5,5,0,71860,1145.8,75.2
"25125","80201","2016",1,1,0,58000,580,100
"25126","80203","2016",1,1,0,140000,778,180
"25127","80204","2016",7,7,0,83142.86,980.2857,82.71429
"25128","80205","2016",12,12,0,111575,1461.833,81.41667
"25129","80207","2016",3,3,0,120117.3,1048.333,112.3333
"25130","80208","2016",2,2,0,78000,1224,69
"25131","80210","2016",3,3,0,195933.3,1598,107.6667
"25132","80211","2016",14,14,0,106678.6,1339.143,84.78571
"25133","80212","2016",59,55,4,119329.1,1472.932,85.38983
"25134","80213","2016",4,4,0,158050.5,1544,121.75
"25135","80214","2016",3,3,0,115333.3,1177.667,104
"25136","80215","2016",1,1,0,130000,1383,94
"25137","80216","2016",3,3,0,81666.67,1076.667,77.66667
"25138","80219","2016",2,2,0,120000,1389,85.5
"25139","80221","2016",1,1,0,96000,1627,59
"25140","80222","2016",11,11,0,103900,1158.545,92.36364
"25141","80223","2016",2,2,0,75000,992.5,75.5
"25142","80224","2016",2,2,0,154000,1269,124.5
"25143","80225","2016",1,1,0,215000,1641,131
"25144","80226","2016",2,2,0,67750,626.5,107
"25145","80227","2016",1,1,0,1e+05,1724,58
"25146","80228","2016",89,65,24,180315.4,3063.135,64.48315
"25147","80229","2016",3,2,1,87333.33,1034,78
"25148","80230","2016",3,3,0,69000,903.3333,80
"25149","80231","2016",3,3,0,117666.7,969,124.3333
"25150","80232","2016",3,3,0,154733.3,896.3333,176
"25151","80233","2016",4,4,0,114575,1608,72.75
"25152","80234","2016",10,10,0,181471,1976,92
"25153","80235","2016",9,9,0,84722.22,1049.222,80.44444
"25154","80236","2016",7,7,0,75414.29,965.2857,89
"25155","80237","2016",3,3,0,159166.7,1706,90
"25156","80238","2016",6,6,0,134166.7,1455.833,91.16667
"25157","80239","2016",1,1,0,60000,484,124
"25158","80240","2016",17,17,0,98882.35,1085.118,89.17647
"25159","80241","2016",7,7,0,118857.1,1157.286,109.7143
"25160","80242","2016",5,5,0,177234,1773.6,101
"25161","80244","2016",2,2,0,55500,1355.5,40.5
"25162","80245","2016",1,1,0,122000,713,171
"25163","80246","2016",6,6,0,138300,1352,100.6667
"25164","80247","2016",8,8,0,90937.5,932.875,99.75
"25165","80248","2016",7,7,0,99857.14,1532.429,87.71429
"25166","80249","2016",7,7,0,89385.71,1109.143,85.14286
"25167","80250","2016",2,1,1,70000,746,98
"25168","80251","2016",2,2,0,157000,1363,115
"25169","80252","2016",1,1,0,142000,2582,55
"25170","80253","2016",56,45,11,96338.66,1248.661,76.85714
"25171","80256","2016",10,9,1,155180,1783,91.5
"25172","80258","2016",2,2,0,94500,958,99
"25173","80259","2016",1,1,0,60000,779,77
"25174","80260","2016",9,9,0,157626.7,1413.444,116.6667
"25175","80261","2016",10,10,0,347684,2170.3,153.4
"25176","80262","2016",1,1,0,155000,1742,89
"25177","80263","2016",1,1,0,90000,938,96
"25178","80264","2016",2,2,0,102500,1194.5,81.5
"25179","80265","2016",3,3,0,91666.67,1183.667,91
"25180","80267","2016",2,2,0,48800,1252.5,39
"25181","80268","2016",1,1,0,148000,1437,103
"25182","80269","2016",2,2,0,83000,809.5,103
"25183","80271","2016",14,14,0,96857.14,994.1429,96.21429
"25184","80272","2016",2,2,0,69000,674,101
"25185","80273","2016",1,1,0,113500,757,150
"25186","80274","2016",20,18,2,85454,1037.55,82.45
"25187","80275","2016",9,9,0,103000.6,1235.889,95.88889
"25188","80276","2016",2,2,0,125000,1128.5,114
"25189","80278","2016",2,2,0,159500,1075.5,149.5
"25190","80279","2016",14,14,0,108714.3,999.7857,111.8571
"25191","80280","2016",3,3,0,118500,1308.333,92.33333
"25192","80281","2016",2,2,0,114725,1197.5,94
"25193","80282","2016",9,9,0,111961.6,1561.444,76.88889
"25194","80284","2016",7,7,0,129071.4,1188.857,113.7143
"25195","80285","2016",1,1,0,151700,1896,80
"25196","80287","2016",3,3,0,196800,1887.333,110
"25197","80288","2016",1,1,0,74000,914,81
"25198","80290","2016",2,2,0,115000,1306,88.5
"25199","80291","2016",2,2,0,180000,1371,131.5
"25200","80294","2016",2,2,0,71250,946.5,75.5
"25201","80295","2016",5,5,0,106180,1302.2,83.6
"25202","80296","2016",19,19,0,97287.58,1162.263,85.05263
"25203","80297","2016",1,1,0,85000,1545,55
"25204","80298","2016",6,6,0,99983.33,893.5,118.8333
"25205","80299","2016",3,3,0,88083.33,1166.667,74.66667
"25206","80300","2016",5,5,0,69000,839.4,83.6
"25207","80301","2016",1,1,0,170000,2237,76
"25208","80302","2016",1,1,0,191000,2247,85
"25209","80303","2016",7,7,0,175971.4,1910.857,100.1429
"25210","80305","2016",6,6,0,216738.3,1741.167,125.5
"25211","80306","2016",2,2,0,82000,1153.5,89
"25212","80307","2016",2,2,0,99350,1096.5,90.5
"25213","80308","2016",15,15,0,112066.7,1297.933,88.06667
"25214","80310","2016",7,7,0,107307.1,1261.714,91.28571
"25215","80312","2016",2,2,0,142625,1052,135
"25216","80313","2016",4,4,0,120225,826,166
"25217","80315","2016",5,4,1,166662,1718.2,96
"25218","80316","2016",16,16,0,159924.9,1371.875,111.625
"25219","80317","2016",1,1,0,207500,1939,107
"25220","80318","2016",36,36,0,106371.3,1253.472,86.52778
"25221","80320","2016",2,2,0,155250,1545.5,119
"25222","80321","2016",2,2,0,151030,1426,105
"25223","80322","2016",4,4,0,94500,1403.75,68.75
"25224","80324","2016",3,3,0,93333.33,1255.667,75
"25225","80326","2016",3,3,0,115000,1412,88.33333
"25226","80327","2016",1,1,0,90000,1304,69
"25227","80328","2016",6,6,0,151716.7,1192.333,126.1667
"25228","80329","2016",1,1,0,84800,848,100
"25229","80330","2016",2,2,0,58500,710.5,84.5
"25230","80331","2016",8,8,0,124100,1117.75,113.125
"25231","80332","2016",6,6,0,137461.7,1416.667,97.5
"25232","80333","2016",119,50,69,138679.8,3018.294,50.78992
"25233","80335","2016",1,1,0,115000,752,153
"25234","80336","2016",1,1,0,132500,1616,82
"25235","80337","2016",4,4,0,136400,1322.75,100
"25236","80338","2016",25,24,1,140244,1660.8,86.08
"25237","80339","2016",1,1,0,93000,1691,55
"25238","80340","2016",1,1,0,78000,975,80
"25239","80342","2016",6,6,0,122521.7,1257,102
"25240","80344","2016",1,1,0,93000,989,94
"25241","80345","2016",4,4,0,82000,1068.75,71
"25242","80346","2016",1,1,0,155000,2013,77
"25243","80347","2016",3,3,0,121000,1673.667,76
"25244","80348","2016",2,2,0,96500,1206,79
"25245","80349","2016",2,2,0,96000,1115.5,86.5
"25246","80350","2016",5,5,0,113200,1243.2,92.4
"25247","80353","2016",3,3,0,40833.33,861,48
"25248","80354","2016",1,1,0,36000,900,40
"25249","80357","2016",3,3,0,152000,1540.333,98.33333
"25250","80359","2016",1,1,0,220200,1412,156
"25251","80360","2016",16,16,0,104346.8,1336.562,83.125
"25252","80361","2016",1,1,0,63000,562,112
"25253","80362","2016",1,1,0,180000,1698,106
"25254","80364","2016",9,9,0,109844.4,1142.444,98.44444
"25255","80365","2016",2,2,0,184100,1667,113.5
"25256","80366","2016",5,5,0,102100,1213,84.8
"25257","80367","2016",2,2,0,77500,783,86
"25258","80368","2016",35,34,1,112863.7,1343.057,83.65714
"25259","80369","2016",1,1,0,110000,1009,109
"25260","80372","2016",1,1,0,50000,556,90
"25261","80373","2016",21,21,0,72590.48,951.0476,76.42857
"25262","80374","2016",2,2,0,114750,1963,54
"25263","80375","2016",5,5,0,100335.4,1250,82.8
"25264","80376","2016",3,3,0,188383.3,1680.667,111.3333
"25265","80377","2016",5,5,0,93000,1195.2,75.6
"25266","80378","2016",1,1,0,119075,2053,58
"25267","80379","2016",4,4,0,173887.5,1914,87.25
"25268","80380","2016",2,2,0,121725,1351,86.5
"25269","80384","2016",4,4,0,107000,1292.25,81
"25270","80385","2016",4,4,0,180228.8,1701.5,105.25
"25271","80386","2016",1,1,0,204150,851,240
"25272","80387","2016",2,2,0,202500,2227.5,90.5
"25273","80388","2016",2,2,0,107500,1321,85
"25274","80390","2016",10,10,0,145545,1390.2,106.8
"25275","80391","2016",2,2,0,62000,673,92.5
"25276","80392","2016",2,2,0,126210,1141.5,118
"25277","80393","2016",1,1,0,135000,1116,121
"25278","80395","2016",4,4,0,77692.25,1031.75,81
"25279","80396","2016",4,4,0,96300,878,108
"25280","80397","2016",1,1,0,90000,1216,74
"25281","80399","2016",1,1,0,298900,1941,154
"25282","80400","2016",6,6,0,114500,1241.5,98.33333
"25283","80401","2016",1,1,0,50000,758,66
"25284","80403","2016",1,1,0,159000,3245,49
"25285","80405","2016",1,1,0,141000,1741,81
"25286","80406","2016",13,13,0,123675.7,1534.462,88.92308
"25287","80407","2016",1,1,0,182000,1167,156
"25288","80408","2016",2,2,0,80000,909,90
"25289","80409","2016",3,3,0,91700,681,157.3333
"25290","80410","2016",43,43,0,76441.86,958.9767,81.23256
"25291","80411","2016",5,5,0,188600,1791.8,102
"25292","80415","2016",8,8,0,111116.2,1140.125,95.125
"25293","80416","2016",7,7,0,101714.3,1312.857,77.28571
"25294","80417","2016",17,17,0,146275.5,1555.471,103.7647
"25295","80418","2016",1,1,0,35000,500,70
"25296","80420","2016",2,2,0,106250,1338.5,87.5
"25297","80421","2016",3,3,0,87666.67,870,113
"25298","80422","2016",4,4,0,152215,1520.75,106
"25299","80424","2016",10,10,0,235833.5,2335.9,106.2
"25300","80425","2016",1,1,0,43600,692,63
"25301","80426","2016",4,4,0,124750,1547.5,85.25
"25302","80427","2016",2,2,0,192500,1397.5,134.5
"25303","80428","2016",3,3,0,97333.33,1274,75.33333
"25304","80429","2016",1,1,0,152000,2054,74
"25305","80430","2016",2,2,0,132250,852.5,155.5
"25306","80432","2016",3,3,0,129000,1190.667,111.6667
"25307","80434","2016",2,2,0,118075,873.5,126.5
"25308","80435","2016",1,1,0,33174,663,50
"25309","80436","2016",7,7,0,116071.4,1404.571,80.57143
"25310","80437","2016",1,1,0,120000,992,121
"25311","80438","2016",9,9,0,63577.78,678.8889,97.88889
"25312","80442","2016",10,9,1,97550,1075.5,103.4
"25313","80443","2016",7,7,0,89285.71,936.2857,91.28571
"25314","80444","2016",6,6,0,150220,1534.167,98.66667
"25315","80445","2016",4,4,0,125625,1001.25,139
"25316","80446","2016",4,4,0,186750,1469,127.75
"25317","80449","2016",1,1,0,27000,771,35
"25318","80450","2016",3,3,0,136666.7,1490.667,92
"25319","80451","2016",1,1,0,80400,935,86
"25320","80452","2016",9,9,0,186147.8,1691,113.2222
"25321","80453","2016",1,1,0,80000,976,82
"25322","80456","2016",7,7,0,86857.14,1395.143,64.14286
"25323","80461","2016",2,2,0,150145,1615.5,94
"25324","80462","2016",5,5,0,151000,1827,86.2
"25325","80463","2016",13,13,0,144200,1612.231,90.92308
"25326","80464","2016",5,5,0,95400,1308.2,71.8
"25327","80465","2016",3,3,0,67666.67,917,75.33333
"25328","80466","2016",2,2,0,147500,1609,112
"25329","80468","2016",1,1,0,130000,1140,114
"25330","80472","2016",1,1,0,72000,1800,40
"25331","80473","2016",3,3,0,110666.7,1248,91
"25332","80474","2016",6,6,0,109583.3,1212.833,103.5
"25333","80475","2016",1,1,0,105000,991,106
"25334","80476","2016",2,2,0,94350,1182.5,78.5
"25335","80477","2016",1,1,0,130000,1625,80
"25336","80478","2016",3,3,0,109333.3,931.3333,124.3333
"25337","80479","2016",3,3,0,93333.33,1054,93.33333
"25338","80481","2016",10,10,0,86100,1034.4,92.9
"25339","80484","2016",3,3,0,62366.67,980.6667,62.33333
"25340","80485","2016",8,8,0,162931.2,1788.625,89.375
"25341","80486","2016",6,6,0,72000,1230.167,63.66667
"25342","80487","2016",1,1,0,75000,688,109
"25343","80488","2016",21,21,0,98280.95,1407.286,72.71429
"25344","80489","2016",40,39,1,165222.7,1904.525,89.225
"25345","80490","2016",2,2,0,62500,724.5,86.5
"25346","80493","2016",4,4,0,108575,1125.25,94.5
"25347","80494","2016",1,1,0,126000,881,143
"25348","80495","2016",3,3,0,112833.3,1169.333,98.33333
"25349","80497","2016",4,4,0,137250,1099.5,117.25
"25350","80498","2016",9,9,0,97511.11,796.2222,122.2222
"25351","80499","2016",1,1,0,156000,1677,93
"25352","80500","2016",6,6,0,95333.33,1068,84.5
"25353","80501","2016",4,4,0,84250,1124.5,73.5
"25354","80503","2016",4,4,0,64000,838.5,70
"25355","80504","2016",1,1,0,160500,1689,95
"25356","80505","2016",1,1,0,92000,662,139
"25357","80507","2016",12,12,0,129308.3,1391.25,91.83333
"25358","80509","2016",5,5,0,97200,892.8,111.8
"25359","80511","2016",4,4,0,176500,1334.25,124.25
"25360","80512","2016",7,7,0,129714.3,1723.714,77.57143
"25361","80513","2016",4,4,0,115625,1358.25,88
"25362","80514","2016",2,2,0,131538,1081.5,112
"25363","80515","2016",1,1,0,50000,758,66
"25364","80516","2016",2,2,0,93500,891.5,104
"25365","80517","2016",4,4,0,135675.5,1274.75,111.75
"25366","80518","2016",4,4,0,120750,1227,100.5
"25367","80519","2016",6,6,0,84086.67,895.1667,101.8333
"25368","80520","2016",4,4,0,92250,1158.75,86.75
"25369","80522","2016",3,3,0,115000,1142,105
"25370","80523","2016",9,9,0,92244.44,964.5556,92.88889
"25371","80524","2016",8,8,0,103500,1148,99.375
"25372","80525","2016",4,4,0,76250,849.25,88.75
"25373","80529","2016",1,1,0,120000,1290,93
"25374","80530","2016",8,8,0,165981.2,1821.875,98.625
"25375","80533","2016",66,29,37,87934.91,1562.53,59.60606
"25376","80536","2016",1,1,0,120000,1026,117
"25377","80537","2016",1,1,0,192000,1488,129
"25378","80538","2016",1,1,0,26000,481,54
"25379","80540","2016",3,3,0,183666.7,1250.667,147
"25380","80541","2016",2,2,0,196875,1622,120.5
"25381","80542","2016",10,10,0,79200,839.3,91.3
"25382","80543","2016",1,1,0,40000,519,77
"25383","80544","2016",2,2,0,48500,869,59
"25384","80545","2016",6,6,0,180021.7,1984.333,92.66667
"25385","80546","2016",6,6,0,111300,1360.167,80.83333
"25386","80547","2016",1,1,0,30000,375,80
"25387","80548","2016",1,1,0,105000,2188,48
"25388","80549","2016",9,9,0,83683.33,882.3333,90.77778
"25389","80552","2016",14,14,0,84143.86,916.0714,92.21429
"25390","80554","2016",14,14,0,121892.9,1158.929,116.5714
"25391","80555","2016",7,7,0,98428.57,936.2857,104.5714
"25392","80556","2016",8,8,0,89687.5,1105,81.5
"25393","80557","2016",2,2,0,24300,461.5,52
"25394","80558","2016",2,2,0,75000,963,89
"25395","80559","2016",2,2,0,119700,1007,118.5
"25396","80560","2016",2,2,0,105000,1063.5,95.5
"25397","80561","2016",86,84,2,112580.7,1327.907,89.37209
"25398","80566","2016",4,4,0,104685,1330.5,75.75
"25399","80568","2016",3,3,0,108566.7,1180.667,92.66667
"25400","80569","2016",3,3,0,141643.3,1395.333,108.3333
"25401","80570","2016",40,40,0,140383.5,1544.925,95.775
"25402","80571","2016",6,6,0,115055,1388.5,77.83333
"25403","80572","2016",5,5,0,133000,1558.2,86.8
"25404","80573","2016",3,3,0,118333.3,1268.667,92.33333
"25405","80576","2016",4,4,0,80625,864.5,97.75
"25406","80577","2016",2,2,0,99500,954.5,97.5
"25407","80578","2016",4,4,0,118750,1237.75,99.25
"25408","80579","2016",11,11,0,96139.64,903.3636,111.3636
"25409","80580","2016",6,6,0,199583.3,1881.333,108.1667
"25410","80582","2016",8,8,0,166928.8,1485.125,120
"25411","80583","2016",3,3,0,214766.7,2377,90.66667
"25412","80584","2016",10,10,0,140802,1185.9,120.9
"25413","80585","2016",25,25,0,83076.88,902.32,90.36
"25414","80586","2016",1,1,0,185000,1321,140
"25415","80588","2016",5,5,0,157100,1476.8,105.4
"25416","80589","2016",2,2,0,140287.5,935,150
"25417","80590","2016",3,3,0,128333.3,1276.333,85
"25418","80591","2016",1,1,0,76000,1086,70
"25419","80592","2016",4,4,0,56335,791,95.5
"25420","80593","2016",4,4,0,114810.8,1306.75,103.25
"25421","80595","2016",4,4,0,115269.5,1240,96.5
"25422","80596","2016",2,2,0,86500,969,89.5
"25423","80598","2016",8,8,0,109250,1347.875,86.75
"25424","80600","2016",13,13,0,127630.8,1415.538,91.15385
"25425","80601","2016",10,10,0,103805,845.2,122.1
"25426","80603","2016",3,3,0,112266.7,1378.333,86.33333
"25427","80605","2016",1,1,0,155000,1211,128
"25428","80606","2016",14,14,0,92660.71,1272.071,89.92857
"25429","80607","2016",1,1,0,120000,1622,74
"25430","80609","2016",3,3,0,115000,882,128
"25431","80611","2016",11,11,0,173709.1,1901.727,93.36364
"25432","80613","2016",6,6,0,109666.7,1413.833,79
"25433","80614","2016",1,1,0,114050,691,165
"25434","80615","2016",4,4,0,134250,1060.75,125.25
"25435","80616","2016",2,2,0,85000,809,110
"25436","80617","2016",3,3,0,144333.3,1087.333,131.6667
"25437","80618","2016",9,9,0,112000,1334.889,85.66667
"25438","80619","2016",6,6,0,103491.7,1085.667,99.16667
"25439","80620","2016",61,58,3,99281.16,1081.492,95.34426
"25440","80621","2016",2,2,0,95000,891,127.5
"25441","80622","2016",17,16,1,125185.3,1827.882,75.29412
"25442","80623","2016",3,3,0,95000,745.3333,119.6667
"25443","80625","2016",17,17,0,124687.1,1420.235,87.52941
"25444","80627","2016",11,11,0,159546.4,1593,102.6364
"25445","80628","2016",7,7,0,87842.86,1049.286,79.42857
"25446","80629","2016",2,2,0,128500,1407,93
"25447","80630","2016",12,12,0,142233.3,1528.917,97.58333
"25448","80631","2016",2,2,0,143500,1416.5,88.5
"25449","80632","2016",35,25,10,200669.6,2373.486,90.68571
"25450","80633","2016",7,7,0,180571.4,1782,95.42857
"25451","80634","2016",8,8,0,152712.5,1618.375,97
"25452","80635","2016",13,13,0,119000,1327.308,92.61538
"25453","80637","2016",4,4,0,137625,1638.25,87
"25454","80638","2016",4,4,0,112500,1113.75,103
"25455","80639","2016",8,8,0,178000,1733.875,99.125
"25456","80642","2016",3,3,0,86666.67,941,91
"25457","80643","2016",3,3,0,208266.7,1653.667,120.6667
"25458","80644","2016",13,13,0,107887.6,1273.923,97.53846
"25459","80645","2016",7,7,0,106071.4,1014.571,107.1429
"25460","80646","2016",2,2,0,66500,1166,56.5
"25461","80648","2016",2,2,0,77000,1091,65.5
"25462","80649","2016",56,39,17,139626.6,2355.911,60.80357
"25463","80650","2016",3,3,0,180966.7,1670,106.3333
"25464","80651","2016",2,2,0,155950,1617,92.5
"25465","80652","2016",10,10,0,133772.5,1472.2,96.3
"25466","80654","2016",2,2,0,137500,1868,75.5
"25467","80655","2016",2,2,0,53850,812,63.5
"25468","80656","2016",12,12,0,145158.3,1362.333,112
"25469","80657","2016",11,11,0,115172.1,1225,94.54545
"25470","80659","2016",4,4,0,118500,1287,97
"25471","80661","2016",7,7,0,185057.1,2085.286,91.42857
"25472","80662","2016",1,1,0,80000,988,81
"25473","80664","2016",1,1,0,19818,360,55
"25474","80665","2016",1,1,0,270000,1929,140
"25475","80666","2016",1,1,0,50000,658,76
"25476","80667","2016",2,2,0,148500,1609.5,95
"25477","80669","2016",3,3,0,67255.67,730.6667,96.33333
"25478","80670","2016",5,5,0,169900,1639.4,117.2
"25479","80671","2016",2,2,0,168750,1433,135.5
"25480","80672","2016",9,9,0,132444.4,1247.111,101.5556
"25481","80673","2016",2,2,0,75000,952.5,77.5
"25482","80674","2016",58,40,18,135917.3,1825.845,76.10345
"25483","80675","2016",1,1,0,45000,1071,42
"25484","80676","2016",2,2,0,108000,1443,91.5
"25485","80677","2016",23,23,0,84675,906.6087,96.91304
"25486","80678","2016",9,9,0,107777.8,1359.333,86.88889
"25487","80679","2016",5,5,0,77400,993.4,80
"25488","80680","2016",38,38,0,105042.1,1122.5,96.36842
"25489","80681","2016",1,1,0,232000,2607,89
"25490","80682","2016",3,3,0,110233.3,1410.333,93.33333
"25491","80685","2016",45,44,1,85681.78,1131.933,75.62222
"25492","80686","2016",9,9,0,122627.8,1390.778,89.66667
"25493","80687","2016",2,2,0,131000,3157.5,41.5
"25494","80688","2016",34,33,1,117697.9,1436.147,85.67647
"25495","80690","2016",4,4,0,141000,1402.5,103.5
"25496","80691","2016",2,2,0,161750,1454,109.5
"25497","80692","2016",7,7,0,115442.9,1252.571,86.71429
"25498","80693","2016",5,5,0,145600,1480.2,106.8
"25499","80694","2016",5,5,0,90400,1105.6,80
"25500","80695","2016",7,7,0,76028.57,964.7143,79.71429
"25501","80696","2016",9,9,0,308866.7,2076.333,156.2222
"25502","80698","2016",2,2,0,50000,681,68.5
"25503","80699","2016",3,3,0,91333.33,692.3333,126
"25504","80700","2016",9,9,0,100802.2,1182.444,84.55556
"25505","80701","2016",4,4,0,111750,1241.25,85.5
"25506","80702","2016",20,20,0,312552.5,1988.45,169.9
"25507","80703","2016",1,1,0,105000,520,202
"25508","80706","2016",13,13,0,106776.9,1327.077,78.53846
"25509","80708","2016",2,2,0,150500,1219.5,134.5
"25510","80709","2016",3,3,0,86666.67,1062,88.33333
"25511","80710","2016",4,4,0,112437.5,790.25,158.25
"25512","80711","2016",22,22,0,87909.09,1100.545,82.04545
"25513","80713","2016",1,1,0,120000,1905,63
"25514","80714","2016",19,19,0,118465.8,1370.053,91.63158
"25515","80716","2016",10,10,0,151600,1449.2,103.2
"25516","80717","2016",11,11,0,155227.3,1514.818,102.2727
"25517","80718","2016",16,16,0,159900.3,1805.062,88.8125
"25518","80721","2016",63,57,6,174075.3,2563.587,73.57143
"25519","80722","2016",2,2,0,117000,1073,112.5
"25520","80724","2016",27,27,0,227318.5,2116.037,103.5185
"25521","80725","2016",21,16,5,213617.1,2237.381,96.7619
"25522","80726","2016",1,1,0,50000,694,72
"25523","80728","2016",2,2,0,114350,1317,86
"25524","80729","2016",1,1,0,97500,1108,88
"25525","80730","2016",8,8,0,206140.5,1887,109.375
"25526","80732","2016",6,6,0,114488.3,1433.333,79.83333
"25527","80733","2016",3,3,0,110500,1269,92.33333
"25528","80736","2016",3,3,0,93333.33,1020.667,95.33333
"25529","80737","2016",2,2,0,60000,1014,65.5
"25530","80740","2016",5,5,0,131400,1411.6,95
"25531","80741","2016",2,2,0,100755,749.5,123
"25532","80742","2016",1,1,0,146000,1802,81
"25533","80743","2016",2,2,0,90000,1526.5,58.5
"25534","80744","2016",3,3,0,125666.7,1080.333,115
"25535","80746","2016",9,9,0,130272.2,1414.111,89.55556
"25536","80747","2016",5,5,0,105500,955.6,122
"25537","80748","2016",4,4,0,44750,565.5,73.5
"25538","80749","2016",3,3,0,108333.3,1185.667,93.33333
"25539","80750","2016",1,1,0,125000,1033,121
"25540","80751","2016",8,8,0,150750,1722.625,86.875
"25541","80752","2016",5,5,0,217500,2056.4,109.6
"25542","80753","2016",1,1,0,32000,516,62
"25543","80754","2016",3,3,0,100833.3,996,116.3333
"25544","80755","2016",1,1,0,104000,1040,100
"25545","80757","2016",2,2,0,137500,1332.5,104
"25546","80758","2016",2,2,0,157200,1512.5,103.5
"25547","80759","2016",5,5,0,117400,1333.4,88.2
"25548","80760","2016",2,2,0,73250,1233.5,61
"25549","80762","2016",3,3,0,108000,960,111
"25550","80763","2016",4,4,0,119600,1282,93
"25551","80764","2016",2,2,0,80500,992,67.5
"25552","80765","2016",8,8,0,108250,1243.875,89.875
"25553","80766","2016",5,5,0,122680,1161.2,105.6
"25554","80767","2016",5,5,0,92100,1157,89.4
"25555","80769","2016",3,3,0,120666.7,847,142.3333
"25556","80770","2016",5,5,0,64070,991.8,68.6
"25557","80773","2016",3,3,0,140743.3,1553.333,91
"25558","80774","2016",1,1,0,154000,1167,132
"25559","80775","2016",7,7,0,119143,1501.429,82
"25560","80776","2016",2,2,0,90000,762.5,108.5
"25561","80777","2016",1,1,0,128000,928,138
"25562","80778","2016",2,2,0,63000,923,73
"25563","80779","2016",6,6,0,151808.3,1810.833,87
"25564","80780","2016",1,1,0,60000,531,113
"25565","80781","2016",2,2,0,142600,1085,131.5
"25566","80782","2016",4,4,0,166537.5,1405.25,116.5
"25567","80784","2016",3,3,0,102516.7,1331.667,84.33333
"25568","80785","2016",3,3,0,148333.3,1328,112.6667
"25569","80786","2016",1,1,0,95000,969,98
"25570","80787","2016",2,2,0,113500,1368,91.5
"25571","80788","2016",4,4,0,118925,1177,100.75
"25572","80789","2016",3,3,0,101466.7,1186.333,82.66667
"25573","80790","2016",1,1,0,80000,1600,50
"25574","80791","2016",6,6,0,232083.3,2609,90.83333
"25575","80792","2016",1,1,0,167000,1856,90
"25576","80793","2016",29,29,0,143670.1,1444.69,99.89655
"25577","80794","2016",1,1,0,124000,1107,112
"25578","80795","2016",3,3,0,101666.7,1349.667,75.33333
"25579","80798","2016",13,13,0,204834.1,1777.385,118.7692
"25580","80799","2016",55,54,1,141776.9,1623.055,88.4
"25581","80800","2016",1,1,0,135000,1534,88
"25582","80801","2016",6,6,0,84993.33,861.5,99.5
"25583","80802","2016",8,8,0,83875,808.5,104.375
"25584","80803","2016",3,3,0,198333.3,1362.333,154.3333
"25585","80805","2016",3,3,0,116000,1301.667,88.33333
"25586","80806","2016",9,9,0,108055.6,1676.111,73.33333
"25587","80807","2016",1,1,0,145000,1179,123
"25588","80808","2016",2,2,0,124250,1417.5,95.5
"25589","80809","2016",2,2,0,89500,973,92
"25590","80811","2016",11,11,0,121763.6,1060.545,117.8182
"25591","80814","2016",5,5,0,145700,1446.6,98.6
"25592","80815","2016",18,18,0,128574.4,1342.222,95.66667
"25593","80820","2016",5,5,0,135770,1833.2,75.6
"25594","80821","2016",4,4,0,128312.5,1309.25,105.5
"25595","80822","2016",3,3,0,107523.3,960,104.3333
"25596","80823","2016",1,1,0,130000,1226,106
"25597","80824","2016",4,4,0,57000,1134.75,70
"25598","80826","2016",10,9,1,109649,2060.7,55
"25599","80827","2016",14,14,0,91628.57,1187,78.5
"25600","80830","2016",2,2,0,158000,2071.5,73
"25601","80832","2016",4,4,0,119900,1216.75,99.75
"25602","80833","2016",1,1,0,204500,1493,137
"25603","80835","2016",5,5,0,128820,1412.6,93.6
"25604","80836","2016",2,2,0,212500,1101,179
"25605","81001","2016",3,3,0,232000,1610.333,133.3333
"25606","81002","2016",24,23,1,108797.1,1100.792,96.16667
"25607","81003","2016",9,9,0,156180,1237.333,126.1111
"25608","81004","2016",684,368,316,143769.4,1794.187,83.26462
"25609","81005","2016",8,8,0,84296.25,968.5,87.375
"25610","81006","2016",2,2,0,157500,1268.5,124
"25611","81008","2016",1,1,0,65000,591,110
"25612","81010","2016",6,6,0,82459.67,979.3333,88.16667
"25613","81011","2016",10,10,0,214342,1786.8,123.8
"25614","81013","2016",1,1,0,195000,1500,130
"25615","81014","2016",5,5,0,131640,1328.8,93.6
"25616","81015","2016",1,1,0,170000,1405,121
"25617","81016","2016",5,5,0,141900,1139.6,115.2
"25618","81017","2016",1,1,0,159900,1599,100
"25619","81018","2016",29,24,5,144887.1,1421.103,100.4828
"25620","81019","2016",2,2,0,78960,1259,70
"25621","81020","2016",3,3,0,196533.3,1634.333,124
"25622","81021","2016",55,53,2,110284.5,1050.909,106.2727
"25623","81022","2016",2,2,0,232000,2450,94
"25624","81023","2016",3,3,0,76666.67,850.6667,80.66667
"25625","81024","2016",3,3,0,93333.33,1031,91.66667
"25626","81025","2016",1,1,0,254000,1910,133
"25627","81026","2016",3,3,0,55333.33,1184.667,62.33333
"25628","81027","2016",1,1,0,170000,1635,104
"25629","81028","2016",1,1,0,37400,416,90
"25630","81029","2016",4,4,0,157500,1543.75,98.75
"25631","81030","2016",3,3,0,213666.7,1743.333,122.6667
"25632","81031","2016",12,12,0,122027.7,1230.417,98.5
"25633","81032","2016",3,3,0,229600,1389.333,162
"25634","81033","2016",30,30,0,103995.3,1061.5,98.33333
"25635","81034","2016",5,5,0,97166,988.4,95
"25636","81035","2016",2,1,1,175864,1665.5,98
"25637","81036","2016",9,9,0,115750,1219.889,93.55556
"25638","81037","2016",17,16,1,62944.12,683.2353,98.52941
"25639","81038","2016",18,18,0,178647.4,1438.778,125.3333
"25640","81039","2016",15,15,0,97854.33,1059.2,89.46667
"25641","81040","2016",7,7,0,152252.9,1191,139
"25642","81041","2016",1,1,0,277200,2166,128
"25643","81042","2016",14,14,0,131442.9,1274.286,105.0714
"25644","81043","2016",8,8,0,179237.5,1478.625,122.5
"25645","81044","2016",1,1,0,125800,1655,76
"25646","81045","2016",4,4,0,94426.25,1147.25,110.5
"25647","81046","2016",8,8,0,208550,1683.125,127.125
"25648","81048","2016",15,15,0,131985.3,1305.667,97.46667
"25649","81049","2016",3,3,0,94150,991,97.66667
"25650","81050","2016",1,1,0,88500,357,248
"25651","81051","2016",14,13,1,148091.3,1249.857,115.4286
"25652","81052","2016",8,8,0,167023.8,1421.375,123.5
"25653","81053","2016",3,3,0,163333.3,1053.333,150.6667
"25654","81054","2016",8,8,0,156285.5,1424,113.5
"25655","81055","2016",7,7,0,104714.3,1005.571,108
"25656","81058","2016",2,2,0,4e+05,2204,171
"25657","81059","2016",7,7,0,198985.7,1754,119.8571
"25658","81060","2016",113,107,6,97877.53,1045.124,98.02655
"25659","81061","2016",3,3,0,161333.3,1131,148.6667
"25660","81062","2016",16,15,1,85914.38,924.3125,93.9375
"25661","81063","2016",11,10,1,167402.7,1509.636,112.9091
"25662","81064","2016",12,11,1,175580,1575,114.6667
"25663","81065","2016",477,334,143,118030.8,1317.264,92.29769
"25664","81066","2016",3,2,1,85306.67,1274.333,68.33333
"25665","81067","2016",3,3,0,110333.3,1292.667,85.66667
"25666","81069","2016",9,9,0,177750,1743.222,101
"25667","81070","2016",32,30,2,173957.1,1697.625,104.8438
"25668","81071","2016",3,3,0,124550,1174.667,94
"25669","81073","2016",2,2,0,71500,1321.5,55
"25670","81074","2016",16,16,0,194502.8,1656.688,118.1875
"25671","81075","2016",3,3,0,132633.3,1128.333,121.3333
"25672","81076","2016",4,4,0,227785,2077.75,108.75
"25673","81077","2016",8,8,0,86487.5,1119.625,91.375
"25674","81078","2016",11,10,1,209750,1939.818,119.5455
"25675","81079","2016",6,6,0,165096.7,1204.667,144.5
"25676","81081","2016",14,13,1,108117.9,1038,100.7857
"25677","81083","2016",3,3,0,73333.33,831.6667,82
"25678","81084","2016",10,10,0,112085,873,132.5
"25679","81085","2016",1,1,0,174000,1243,140
"25680","81086","2016",3,3,0,95208.33,831.6667,87.33333
"25681","81087","2016",3,3,0,367333.3,1963,181.3333
"25682","81088","2016",6,6,0,182466.7,1369.5,133
"25683","81089","2016",1,1,0,90000,1000,90
"25684","81092","2016",15,15,0,154410.4,1567.6,98.26667
"25685","81093","2016",5,5,0,269634,1696,160.2
"25686","81094","2016",2,2,0,46750,773,61.5
"25687","81096","2016",9,9,0,80734.44,994.6667,80
"25688","81097","2016",9,9,0,181238.9,1480.667,123.8889
"25689","81098","2016",5,5,0,168360,1671,100
"25690","81099","2016",194,145,49,133790.9,1535.505,87.2732
"25691","81100","2016",2,2,0,130000,1321,99.5
"25692","81101","2016",13,13,0,134165.4,1333.154,107.3077
"25693","81102","2016",2,2,0,232000,1933.5,119
"25694","81103","2016",4,4,0,65475,1062.5,63.75
"25695","81104","2016",10,10,0,201236,1539.6,142.6
"25696","81105","2016",107,100,7,102251.9,1101.336,94.33645
"25697","81106","2016",6,6,0,203291.3,2206,106.3333
"25698","81108","2016",1,1,0,225921,1765,128
"25699","81109","2016",1,1,0,250000,1689,148
"25700","81110","2016",3,3,0,146666.7,1088.333,137
"25701","81111","2016",2,2,0,180250,1885.5,115
"25702","81112","2016",9,8,1,145727.8,1445.333,106.1111
"25703","81114","2016",4,4,0,131750,1247,110.75
"25704","81115","2016",17,16,1,68764.71,898.0588,77
"25705","81116","2016",21,21,0,180365.2,1760.857,105.5238
"25706","81117","2016",3,3,0,106366.7,1153,89
"25707","81118","2016",1,1,0,85000,934,91
"25708","81119","2016",6,6,0,116866.7,1418,81.83333
"25709","81120","2016",53,50,3,124885.8,1442.17,91.64151
"25710","81121","2016",3,3,0,78000,987,80
"25711","81124","2016",21,19,2,82582.52,1032.571,83.09524
"25712","81125","2016",6,6,0,100765.2,1290.833,86
"25713","81127","2016",1,1,0,228200,951,240
"25714","81128","2016",7,7,0,72357.14,798.5714,87.28571
"25715","81129","2016",5,5,0,138100,1219.2,118
"25716","81130","2016",23,17,6,122163.5,1347.174,88.65217
"25717","81131","2016",19,18,1,166871.6,1784.211,94
"25718","81132","2016",18,18,0,108891.7,1232,89.88889
"25719","81133","2016",3,3,0,198900,1787.667,110
"25720","81134","2016",2,2,0,90150,830,98.5
"25721","81135","2016",3,3,0,165380.7,1084.333,156
"25722","81136","2016",3,3,0,105833.3,811.6667,150
"25723","81138","2016",8,8,0,120675,1300.625,90.75
"25724","81139","2016",5,5,0,167240,1612,108.8
"25725","81140","2016",151,103,48,139398.4,1591.662,87.09272
"25726","81141","2016",4,4,0,106500,745,137.25
"25727","81142","2016",5,5,0,128615.4,1160.8,109.8
"25728","81143","2016",7,7,0,162928.6,1509.857,108.2857
"25729","81144","2016",27,27,0,169955.2,1644.481,109.3333
"25730","81145","2016",36,35,1,158533.5,1471.472,112.3056
"25731","81146","2016",2,2,0,285000,1573,176.5
"25732","81147","2016",8,8,0,137400,1256.75,109.125
"25733","81148","2016",2,2,0,121250,1512.5,81.5
"25734","81149","2016",6,6,0,161941.7,1410.167,124.5
"25735","81150","2016",2,2,0,203450,1899.5,120
"25736","81152","2016",3,3,0,128000,1165,113.6667
"25737","81154","2016",1,1,0,137000,1317,104
"25738","81156","2016",33,33,0,186515,1809.879,103
"25739","81157","2016",2,2,0,276900,1374.5,189
"25740","81158","2016",2,2,0,104750,1367.5,73
"25741","81159","2016",1,0,1,186000,2325,80
"25742","81160","2016",1,1,0,105000,1400,75
"25743","81161","2016",2,2,0,117500,1309,92.5
"25744","81162","2016",1,1,0,173000,4119,42
"25745","81163","2016",122,95,27,97566.93,1021.836,96.05738
"25746","81164","2016",4,4,0,228975,2077.25,110
"25747","81165","2016",4,4,0,159805,1564.75,105.5
"25748","81167","2016",4,4,0,97750,735.75,145.75
"25749","81168","2016",14,14,0,136532.5,1171.571,120.3571
"25750","81169","2016",1,1,0,145000,1859,78
"25751","81170","2016",13,13,0,145842.8,1021.692,135.9231
"25752","81171","2016",8,8,0,155981.2,1279.125,126.875
"25753","81172","2016",1,1,0,143000,960,149
"25754","81173","2016",4,4,0,236825,1896.25,133.5
"25755","81174","2016",4,4,0,104050,1007.75,107.25
"25756","81175","2016",3,3,0,285300,1359,179.6667
"25757","81176","2016",2,2,0,163500,1948,83.5
"25758","81177","2016",2,2,0,143900,882,162.5
"25759","81178","2016",2,2,0,120895,956.5,136
"25760","81179","2016",6,6,0,171725,1296,129.1667
"25761","81180","2016",4,4,0,165997.5,1059.5,128
"25762","81182","2016",21,20,1,106324.1,998.6667,107.4762
"25763","81183","2016",2,2,0,161000,2466.5,65
"25764","81184","2016",1,1,0,76700,1475,52
"25765","81185","2016",4,4,0,149300,1204.5,127.5
"25766","81186","2016",1,1,0,218000,1817,120
"25767","81187","2016",2,2,0,115000,1180.5,99.5
"25768","81188","2016",4,4,0,81500,938.75,86
"25769","81190","2016",5,5,0,143937.2,1297,119.6
"25770","81191","2016",3,3,0,227666.7,2452.333,91.66667
"25771","81192","2016",8,7,1,59118.5,816.25,78.375
"25772","81193","2016",7,7,0,105028.6,1591.714,71.57143
"25773","81195","2016",5,5,0,248600,2212,113.6
"25774","81196","2016",16,16,0,118963.8,1167.562,108.75
"25775","81197","2016",3,3,0,363333.3,1738.667,181.6667
"25776","81198","2016",2,2,0,130000,986.5,169.5
"25777","81199","2016",2,2,0,192500,1435.5,134
"25778","81200","2016",4,4,0,177750,1529.75,118.25
"25779","81201","2016",11,11,0,136289.1,1433.273,123.3636
"25780","81202","2016",12,12,0,142945,1299.917,110.25
"25781","81203","2016",6,6,0,68916.67,874.1667,90.16667
"25782","81204","2016",21,21,0,120669,1211.619,101.7143
"25783","81206","2016",6,4,2,118500,1479.667,85.5
"25784","81207","2016",1,1,0,274300,2032,135
"25785","81208","2016",5,5,0,190800,1632.2,120.2
"25786","81209","2016",31,31,0,139163.4,1199.032,126.0645
"25787","81210","2016",1,1,0,2e+05,1770,113
"25788","81211","2016",5,5,0,151072,1319.4,121.6
"25789","81212","2016",2,2,0,164000,1261.5,122
"25790","81214","2016",1,1,0,179000,1627,110
"25791","81215","2016",5,5,0,200644,1532.8,128.8
"25792","81216","2016",1,1,0,160000,1103,145
"25793","81217","2016",3,3,0,138201.7,1653,89.33333
"25794","81218","2016",22,21,1,227799.9,1839.864,119.5909
"25795","81219","2016",24,24,0,131095.9,1126.083,115.5
"25796","81220","2016",55,53,2,166055.4,1652.527,103.1455
"25797","81221","2016",1,1,0,40000,645,62
"25798","81222","2016",30,30,0,121456,1262.733,99.7
"25799","81223","2016",3,3,0,80333.33,1174.333,67
"25800","81224","2016",2,2,0,84000,841.5,130
"25801","81225","2016",10,9,1,159796.8,1529.4,107.8
"25802","81227","2016",16,16,0,94050,1072.062,86.125
"25803","81228","2016",1,1,0,150150,1687,89
"25804","81229","2016",3,3,0,188666.7,1510.667,131.3333
"25805","81230","2016",1,1,0,84000,1200,70
"25806","81231","2016",2,2,0,89000,1027,83.5
"25807","81232","2016",4,4,0,189925,2122,90.25
"25808","81233","2016",20,20,0,121889,1231.4,101.05
"25809","81235","2016",7,7,0,153628.6,1357.429,113.2857
"25810","81236","2016",4,4,0,178000,1917.25,100.5
"25811","81237","2016",1,1,0,221000,1242,178
"25812","81238","2016",15,14,1,97427,961.2667,99.66667
"25813","81239","2016",8,8,0,99912.5,1060.375,93.5
"25814","81240","2016",2,2,0,180000,1446.5,129.5
"25815","81242","2016",2,2,0,124575,1082,119.5
"25816","81243","2016",2,2,0,219000,1088.5,201.5
"25817","81244","2016",14,14,0,106600,1108.286,102.7857
"25818","81245","2016",3,3,0,95000,1128.667,86
"25819","81246","2016",2,2,0,330900,3192,85
"25820","81248","2016",4,3,1,173475,2015,93.75
"25821","81249","2016",8,8,0,145035,1438.75,102
"25822","81251","2016",4,4,0,110125,888.5,131.25
"25823","81252","2016",2,2,0,272500,1242,220
"25824","81253","2016",5,5,0,93800,988.8,94
"25825","81254","2016",1,1,0,118000,1255,94
"25826","81255","2016",3,3,0,294766.7,1679,176.6667
"25827","81256","2016",1,1,0,133000,1662,80
"25828","81257","2016",55,46,9,135058.2,1467,98.34545
"25829","81258","2016",2,2,0,145000,1397.5,99
"25830","81261","2016",12,12,0,244101.7,1863.417,132.5
"25831","81262","2016",3,3,0,497216.7,2434,190.6667
"25832","81263","2016",4,4,0,176433.8,1588.5,124
"25833","81266","2016",10,10,0,160050,1269.5,125.1
"25834","81267","2016",6,6,0,69640.83,789.5,100.8333
"25835","81269","2016",7,7,0,92267.57,1012.143,93.71429
"25836","81270","2016",5,5,0,207676.8,1484,141.6
"25837","81271","2016",115,95,20,181117.3,1943.313,93.2087
"25838","81272","2016",5,5,0,132529.2,835.4,151.4
"25839","81273","2016",36,35,1,159291.1,1533.778,104.8333
"25840","81274","2016",7,7,0,185232.1,1832.143,101
"25841","81275","2016",3,3,0,57666.67,1035.667,55
"25842","81276","2016",6,6,0,205505.2,1918.5,119.5
"25843","81277","2016",2,2,0,185300,1646,112.5
"25844","81278","2016",2,2,0,71500,972,78.5
"25845","81279","2016",4,4,0,130875,1083.5,119.5
"25846","81280","2016",3,3,0,103500,1228,79.66667
"25847","81281","2016",19,18,1,139385.3,1330.474,108.1579
"25848","81283","2016",13,13,0,200672.2,1621.385,126.6154
"25849","81284","2016",25,20,5,190313.9,2333.2,86.28
"25850","81285","2016",7,7,0,89845.57,1057.286,86.14286
"25851","81286","2016",7,6,1,110500,1055.429,93.14286
"25852","81287","2016",2,2,0,156000,1299.5,140.5
"25853","81288","2016",33,28,5,130066.6,1325.091,99.15152
"25854","81289","2016",16,16,0,137493.8,1262.438,108.5
"25855","81290","2016",1,1,0,216000,2057,105
"25856","81291","2016",3,3,0,148633.3,1724.333,86
"25857","81292","2016",9,9,0,118669.2,1071.778,114
"25858","81293","2016",3,3,0,174683.3,1421,124.6667
"25859","81294","2016",3,3,0,237333.3,1923,123.6667
"25860","81295","2016",2,2,0,71900,963.5,63
"25861","81297","2016",11,11,0,198700,1770.455,111.6364
"25862","81298","2016",6,6,0,302190,2112.667,137.6667
"25863","81300","2016",1,1,0,285000,2262,126
"25864","81302","2016",1,1,0,70500,691,102
"25865","81303","2016",7,5,2,89938.57,1445.286,69.85714
"25866","81304","2016",4,4,0,151830,1559.5,113.75
"25867","81305","2016",8,7,1,65625,705.5,90.25
"25868","81306","2016",7,7,0,150214.3,1163,127
"25869","81307","2016",10,10,0,111482.5,1070.3,112.3
"25870","81308","2016",7,7,0,142000,1079.286,145.5714
"25871","81309","2016",3,3,0,126333.3,1341,94
"25872","81310","2016",2,2,0,242500,1876.5,126
"25873","81311","2016",2,2,0,150000,1292.5,115
"25874","81312","2016",11,11,0,113763.6,1039,124.2727
"25875","81313","2016",4,4,0,258250,1750,148.25
"25876","81314","2016",5,5,0,65600,766.8,87.2
"25877","81315","2016",13,13,0,140907.7,1275.308,115.6154
"25878","81316","2016",3,3,0,234166.7,1803.667,139.3333
"25879","81317","2016",8,8,0,128751.9,1219.625,100.625
"25880","81318","2016",2,2,0,149500,1383,122
"25881","81319","2016",2,2,0,118060,1538,75.5
"25882","81321","2016",2,2,0,113500,1159,96.5
"25883","81322","2016",1,1,0,135000,1298,104
"25884","81324","2016",2,2,0,237500,1687.5,151.5
"25885","81325","2016",11,11,0,161125.2,1398.727,116.5455
"25886","81326","2016",4,4,0,246037.5,1945,121.25
"25887","82001","2016",4,4,0,106800,1232.75,91.75
"25888","82002","2016",37,36,1,153809.5,1623.946,100
"25889","82003","2016",2,2,0,65600,613.5,105.5
"25890","82005","2016",20,19,1,168280.9,2054.85,91.65
"25891","82006","2016",1,1,0,83000,883,94
"25892","82007","2016",1,1,0,196300,1963,100
"25893","82008","2016",14,13,1,109928.6,1042.5,113.6429
"25894","82010","2016",3,3,0,228533.3,1102.667,207.6667
"25895","82011","2016",6,6,0,173815.8,1634.167,112
"25896","82012","2016",3,3,0,112400,1231,93.33333
"25897","82013","2016",48,47,1,99805.27,1021.271,110.3542
"25898","82014","2016",2,2,0,245650,2028,117.5
"25899","82015","2016",2,2,0,143496.5,1470.5,111.5
"25900","82016","2016",2,2,0,294312.5,1709,170
"25901","82017","2016",18,17,1,194598.4,1724.167,115.6111
"25902","82018","2016",9,9,0,123748.9,1248.667,100.5556
"25903","82019","2016",5,5,0,123400,1151.8,100.4
"25904","82020","2016",10,10,0,177200,1562.1,127.3
"25905","82021","2016",1,1,0,180000,1452,124
"25906","82022","2016",5,5,0,137172.2,1530.8,91.6
"25907","82023","2016",6,6,0,169675,1385.167,130.3333
"25908","82024","2016",2,2,0,101500,579.5,175
"25909","82025","2016",39,35,4,157162.5,1570.615,102.6923
"25910","82026","2016",9,9,0,136866.7,1314.333,116.6667
"25911","82027","2016",13,13,0,178264.6,1698.538,106.7692
"25912","82028","2016",10,10,0,183844.5,1799.4,100.9
"25913","82030","2016",2,2,0,127500,1221.5,112
"25914","82031","2016",8,7,1,130656.2,1571.625,89.375
"25915","82032","2016",7,7,0,160871.4,1615,101.4286
"25916","82033","2016",123,109,14,136829.7,1322.561,105.1301
"25917","82034","2016",1,1,0,46000,561,82
"25918","82035","2016",1,1,0,149000,1602,93
"25919","82036","2016",1,1,0,158250,1551,102
"25920","82037","2016",54,45,9,124205.6,1374.167,95.7963
"25921","82038","2016",26,26,0,128427,1395.308,85.57692
"25922","82039","2016",3,3,0,154466.7,1432,114.6667
"25923","82040","2016",2,2,0,76332.5,1040,80.5
"25924","82041","2016",4,4,0,120200,1039.75,110.75
"25925","82042","2016",9,8,1,113216.7,1058.111,116.6667
"25926","82043","2016",3,3,0,146666.7,1228.667,123
"25927","82044","2016",18,15,3,134988.9,1535.889,92.05556
"25928","82045","2016",5,5,0,223408,2042,121.8
"25929","82046","2016",1,1,0,165000,1170,141
"25930","82047","2016",1,1,0,318124,1591,200
"25931","82048","2016",26,22,4,166950.4,1580.808,110.7692
"25932","82049","2016",7,7,0,124466,1055,115.7143
"25933","82050","2016",13,13,0,121819.2,1239.154,101.6154
"25934","82051","2016",4,4,0,143711.2,1271,128.25
"25935","82052","2016",11,11,0,154466,1518.182,105.9091
"25936","82053","2016",3,3,0,112833.3,840,134.6667
"25937","82054","2016",4,4,0,124040.5,1217.25,100.75
"25938","82055","2016",3,3,0,151366.7,1017.333,159
"25939","82056","2016",5,5,0,218237.2,1714,132.6
"25940","82057","2016",5,5,0,192445.2,1791.8,107.4
"25941","82058","2016",1,1,0,160000,2133,75
"25942","82059","2016",5,5,0,229052.6,1381,158
"25943","82061","2016",4,4,0,142650,1869,112.5
"25944","82062","2016",19,18,1,124421.2,1281.632,100.2105
"25945","82063","2016",5,5,0,139600,1177.4,125
"25946","82065","2016",3,3,0,197200,1607.333,134.3333
"25947","82066","2016",5,5,0,209180,1621.2,124.4
"25948","82067","2016",1,1,0,152000,1670,91
"25949","82068","2016",5,5,0,151457.6,1143.6,134.6
"25950","82069","2016",3,3,0,196333.3,1525,121.3333
"25951","82070","2016",1,1,0,115000,1264,91
"25952","82072","2016",2,2,0,121500,1170,109.5
"25953","82073","2016",4,4,0,108775,1219,93.25
"25954","82074","2016",2,2,0,78900,617,133
"25955","82075","2016",42,39,3,182671.5,1714.786,111.5238
"25956","82076","2016",14,14,0,162718,1601.143,103.7143
"25957","82077","2016",6,6,0,138369.8,1581.167,82.83333
"25958","82078","2016",1,1,0,117500,1958,60
"25959","82079","2016",21,20,1,161066.7,1618.667,98.2381
"25960","82080","2016",5,5,0,152820,1568.6,100.6
"25961","82081","2016",2,2,0,63250,605.5,97.5
"25962","82082","2016",3,3,0,140000,1490,80
"25963","82083","2016",2,2,0,295000,1304,189
"25964","82084","2016",2,2,0,300430,2344.5,128.5
"25965","82085","2016",5,5,0,147295,1268.2,123.2
"25966","82086","2016",2,2,0,236345,1004.5,233
"25967","82087","2016",29,28,1,138704.3,1448.483,99.89655
"25968","82088","2016",11,11,0,77745.45,890.3636,92
"25969","82089","2016",17,16,1,114125.3,830.0588,143.7059
"25970","82090","2016",12,12,0,121872,1445.917,86.83333
"25971","82091","2016",2,2,0,131525,1427.5,92
"25972","82093","2016",2,2,0,155000,874,184
"25973","82094","2016",23,23,0,133915.4,1329.957,104.3478
"25974","82095","2016",5,5,0,155660,2058.2,96.4
"25975","82096","2016",30,27,3,137931.7,1502,92.2
"25976","82097","2016",11,10,1,94640.91,883.6364,109.8182
"25977","82098","2016",12,12,0,213637.5,1965.417,107.8333
"25978","82099","2016",8,8,0,136557.5,1172.875,122.875
"25979","82100","2016",2,2,0,62500,843,78
"25980","82101","2016",11,11,0,101390.9,976.5455,107.2727
"25981","82102","2016",2,2,0,45000,506,90
"25982","82103","2016",2,2,0,168500,1713.5,98.5
"25983","82104","2016",3,3,0,239666.7,969.3333,245
"25984","82105","2016",14,13,1,142880.4,1338.357,107.9286
"25985","82106","2016",3,3,0,182150,1876.667,94
"25986","82108","2016",23,22,1,149201.1,1411.913,108.3913
"25987","82110","2016",9,9,0,129665.3,1328.333,101.2222
"25988","82111","2016",3,3,0,101000,886,96.66667
"25989","82112","2016",99,78,21,105789.2,1127.566,91.87879
"25990","82113","2016",8,7,1,131448.5,1292,107.5
"25991","82114","2016",9,9,0,182778.9,1528.667,121.7778
"25992","82115","2016",19,19,0,138792.7,1328.842,105.5263
"25993","82116","2016",3,3,0,387920,1859,193.3333
"25994","82117","2016",15,15,0,190751,1493.333,129.7333
"25995","82118","2016",2,2,0,180040,1933.5,92.5
"25996","82119","2016",3,3,0,160216.7,1469,111.6667
"25997","82120","2016",1,1,0,132500,1815,73
"25998","82121","2016",777,409,368,136281.6,1582.982,85.90862
"25999","82122","2016",2,2,0,176000,2078.5,102.5
"26000","82123","2016",8,8,0,171881.2,1597.25,112.125
"26001","82124","2016",56,33,23,131861.6,1468.071,85.14286
"26002","82125","2016",77,64,13,138780.5,1502.143,92.31169
"26003","82126","2016",6,6,0,163566.7,1548.5,103.1667
"26004","82127","2016",4,4,0,131350,1238.75,123.25
"26005","82129","2016",1,1,0,60000,652,92
"26006","82130","2016",1,1,0,135830,1476,92
"26007","82131","2016",19,16,3,120642.1,1242.158,93.89474
"26008","82132","2016",17,17,0,136527.6,1413.471,103.2941
"26009","82133","2016",3,3,0,137033.3,1963.667,71.66667
"26010","82134","2016",52,44,8,133701.6,1395.885,99.84615
"26011","82135","2016",15,15,0,190404,1864.8,103.4
"26012","82136","2016",18,18,0,182477.2,1726.389,109.4444
"26013","82137","2016",3,3,0,88333.33,942.6667,69.66667
"26014","82140","2016",4,4,0,136875,1075.75,135.5
"26015","82141","2016",3,3,0,131250,1503,87.33333
"26016","82142","2016",12,11,1,179956.7,1746.167,99.58333
"26017","82143","2016",1,1,0,260000,1074,242
"26018","82144","2016",9,9,0,114416.7,1223.778,93.55556
"26019","82145","2016",6,6,0,119933.3,1486.833,81.16667
"26020","82146","2016",2,2,0,96000,855.5,105
"26021","82147","2016",1,1,0,81000,675,120
"26022","82148","2016",12,10,2,105104.2,968.25,110.75
"26023","82149","2016",22,20,2,129179.5,1163.364,120
"26024","82150","2016",3,3,0,198333.3,1346,143.3333
"26025","82151","2016",9,9,0,111302.8,1161.667,108.7778
"26026","82153","2016",3,3,0,193333.3,1356.667,152.3333
"26027","82154","2016",1,1,0,291600,1436,203
"26028","82155","2016",48,46,2,149019,1727.5,91.29167
"26029","82157","2016",2,2,0,153000,1258,122
"26030","82158","2016",5,5,0,122070,1026.8,123.4
"26031","82159","2016",5,5,0,180580,1465,131.2
"26032","82160","2016",2,2,0,130000,979.5,134.5
"26033","82161","2016",47,36,11,157746.7,1630.213,94
"26034","82162","2016",2,2,0,199984,2002.5,99.5
"26035","82163","2016",1,1,0,170000,1910,89
"26036","82164","2016",1,1,0,133000,1279,104
"26037","82165","2016",4,4,0,75237.5,783.75,107.75
"26038","82166","2016",2,2,0,112500,901,124
"26039","82167","2016",8,8,0,165598.8,1508.375,112.5
"26040","82168","2016",3,3,0,56214,854.3333,65.66667
"26041","82169","2016",17,17,0,134379.1,1238.235,108.3529
"26042","82170","2016",3,3,0,109496.7,1266,131.6667
"26043","82171","2016",15,15,0,145216,1444.4,115
"26044","82172","2016",2,2,0,102500,792,127
"26045","82173","2016",4,4,0,152687.5,1735,87.75
"26046","82174","2016",2,2,0,137880,987.5,133.5
"26047","82175","2016",1,1,0,156500,782,200
"26048","82176","2016",5,5,0,196800,1553.4,130.2
"26049","82177","2016",1,1,0,163000,1358,120
"26050","82178","2016",5,5,0,159050,1321,155.8
"26051","82179","2016",25,23,2,114708.8,1247.6,93.56
"26052","82180","2016",7,7,0,113571.4,1160.571,97.85714
"26053","82181","2016",3,3,0,66666.67,812.3333,91.33333
"26054","82182","2016",1,1,0,2e+05,1361,147
"26055","82183","2016",2,2,0,172500,1757,97.5
"26056","82184","2016",7,7,0,179052.9,1660.571,106.4286
"26057","82185","2016",2,2,0,132000,2158,58.5
"26058","82186","2016",58,52,6,94744.48,1131.052,83.56897
"26059","82187","2016",9,9,0,121868.3,1344.111,89.66667
"26060","82188","2016",8,8,0,156962.5,1348.75,121.875
"26061","82189","2016",6,6,0,61066.67,824.3333,80
"26062","82190","2016",81,61,20,147078.9,1584.444,96.22222
"26063","82191","2016",6,6,0,93083.33,1147.667,87.33333
"26064","82192","2016",3,3,0,224600,1491,147.3333
"26065","82193","2016",2,2,0,166650,1768.5,96.5
"26066","82194","2016",11,10,1,157727.3,1518.727,103.6364
"26067","82195","2016",7,7,0,165720.1,1497.429,111.4286
"26068","83001","2016",33,30,3,526319,3479.727,146.5455
"26069","83002","2016",7,6,1,191050,2372.571,83.57143
"26070","83003","2016",16,11,5,168673.2,1950.75,75.6875
"26071","83004","2016",97,61,36,223026.1,2408.897,90.21649
"26072","83005","2016",13,11,2,137680.8,2295.077,72.76923
"26073","83006","2016",1,1,0,270000,2250,120
"26074","83007","2016",38,28,10,205505.1,2332.316,83.31579
"26075","83008","2016",56,45,11,320234.6,2998.071,110.6786
"26076","83009","2016",341,58,283,297960.2,5268.66,57.77126
"26077","83010","2016",4,4,0,123750,1957,70.75
"26078","83011","2016",27,18,9,151897.8,1923.37,75.18519
"26079","83012","2016",43,24,19,159144.1,2060.86,74.46512
"26080","83013","2016",3,3,0,149333.3,2579.333,70
"26081","83014","2016",5,5,0,118000,2064.2,66.4
"26082","83015","2016",7,6,1,229607.9,2441.857,91.85714
"26083","83016","2016",116,58,58,267498,3267.845,81.99138
"26084","83017","2016",29,21,8,231937.2,2812.207,81.55172
"26085","83018","2016",36,32,4,223538.8,2232.639,105.8611
"26086","83019","2016",214,81,133,320859.2,4688.136,63.39252
"26087","83021","2016",50,47,3,204968.2,2620.7,82.48
"26088","83022","2016",1,1,0,293000,1010,290
"26089","83023","2016",174,96,78,169582.3,2087.546,82.60345
"26090","83025","2016",20,16,4,209691,2367.3,86.55
"26091","83026","2016",27,27,0,159180.6,2061.815,77.81481
"26092","83027","2016",44,34,10,527062.5,4484.341,115.3182
"26093","83028","2016",28,20,8,210298.9,2608.786,83.64286
"26094","83029","2016",58,38,20,257365.9,3102.207,87.31034
"26095","83030","2016",26,23,3,241125,2560.192,97.07692
"26096","83031","2016",28,19,9,212412.9,2588.143,81.03571
"26097","83032","2016",50,33,17,184272.8,2084.5,88.76
"26098","83033","2016",46,41,5,179168.1,2397.543,80.86957
"26099","83034","2016",147,55,92,348952.3,4427.265,77.42857
"26100","83035","2016",52,42,10,269464.1,3636.942,72.26923
"26101","83037","2016",16,14,2,205548.8,2567.688,83
"26102","83038","2016",7,7,0,234104.6,2629,93.42857
"26103","83040","2016",2,2,0,114500,2825,45
"26104","83041","2016",11,9,2,280886.4,2670.455,100.7273
"26105","83042","2016",145,54,91,207714.1,3483.717,62.64138
"26106","83043","2016",21,13,8,133505.8,1746.81,79.7619
"26107","83044","2016",3,1,2,97000,1712,50.33333
"26108","83045","2016",20,19,1,158797.5,1838.3,87.25
"26109","83046","2016",41,31,10,286292.8,3055.341,91.4878
"26110","83047","2016",188,126,62,264153.4,3027.489,89.79787
"26111","83048","2016",122,66,56,487458.7,6335.877,74.14754
"26112","83049","2016",123,94,29,248564.3,2891.52,87.65854
"26113","83050","2016",456,170,286,176720.2,2164.263,79.8114
"26114","83051","2016",18,16,2,202602.8,2156.056,97.61111
"26115","83052","2016",2,2,0,108000,1701.5,85
"26116","83053","2016",26,23,3,281125.8,3350.808,83.88462
"26117","83054","2016",78,51,27,265144.4,3180.564,86.30769
"26118","83055","2016",78,62,16,289332.7,3082.218,93.66667
"26119","83056","2016",28,27,1,229684.3,2485.786,95.64286
"26120","83057","2016",38,33,5,218514.7,2297.5,97.55263
"26121","83058","2016",75,64,11,320362.4,2745.88,122.68
"26122","83059","2016",56,38,18,222083.2,2446.768,90.19643
"26123","83060","2016",2,2,0,169740,1712.5,89
"26124","83061","2016",1039,239,800,224872.6,3620.931,63.50048
"26125","83062","2016",279,93,186,217744.2,2940.946,73.9319
"26126","83063","2016",25,20,5,306748.2,3138.68,100.2
"26127","83064","2016",59,57,2,287429.3,2879.492,100.1695
"26128","83065","2016",71,52,19,481239.9,5462.028,80.78873
"26129","83066","2016",27,25,2,186885.6,2246.37,86.77778
"26130","83067","2016",59,45,14,163291.6,2336.525,72
"26131","83068","2016",156,79,77,505681.3,6407.526,78.65385
"26132","83069","2016",905,202,703,219725.3,3553.781,63.9337
"26133","83070","2016",252,51,201,256947.9,4930.27,53.72222
"26134","83071","2016",172,83,89,267098.7,4456.43,63.39535
"26135","83072","2016",134,107,27,273654.9,2936.993,96.32836
"26136","83073","2016",115,92,23,186836.2,2301.365,86.05217
"26137","83074","2016",3,2,1,141333.3,2037.667,76.33333
"26138","83075","2016",10,7,3,171084.5,2107.5,79.4
"26139","83076","2016",10,8,2,164455.6,2196.7,75.1
"26140","83077","2016",30,27,3,253481,2519.6,100.9333
"26141","83078","2016",8,7,1,231975,2244,102.5
"26142","83079","2016",12,10,2,400316.1,3594.167,112.75
"26143","83080","2016",17,16,1,331647.1,2498.588,122.6471
"26144","83081","2016",75,66,9,375953.1,3474.053,109.7733
"26145","83082","2016",4,3,1,326250,3465,88.5
"26146","83083","2016",22,20,2,158322.7,2001.364,76.36364
"26147","83084","2016",13,12,1,129961.5,1730.769,72.92308
"26148","83085","2016",53,45,8,302067.4,3083.151,98.28302
"26149","83086","2016",86,63,23,240948.5,2457.977,95.94186
"26150","83087","2016",49,42,7,267430.8,2755.102,98.65306
"26151","83088","2016",28,25,3,278292.1,2468.464,114.25
"26152","83089","2016",6,6,0,269958.3,3035.333,89.33333
"26153","83090","2016",114,64,50,310106.4,3286.842,86.91228
"26154","83091","2016",60,47,13,252011.5,3020.233,86.33333
"26155","83092","2016",52,44,8,232187.1,2508.558,94.82692
"26156","83093","2016",30,25,5,246468.3,2787.9,94.5
"26157","83094","2016",49,42,7,490485.2,3964.898,112.0816
"26158","83095","2016",7,7,0,210725.7,2319.286,93.28571
"26159","83096","2016",27,20,7,226650.9,2694.704,84.7037
"26160","83097","2016",64,56,8,325417.2,3102.484,106.2344
"26161","83098","2016",153,59,94,275407,3590.301,75.21569
"26162","83099","2016",65,39,26,243460.9,2902.738,85.47692
"26163","83100","2016",66,53,13,229112.5,2726.939,94.16667
"26164","83101","2016",26,20,6,1011074,9372.308,99.61538
"26165","83102","2016",67,59,8,203204.4,2323.224,91
"26166","83103","2016",34,28,6,271867.6,2897.118,95.44118
"26167","83104","2016",55,51,4,207975.8,2268.055,92.76364
"26168","83106","2016",68,60,8,244931.1,2553.265,95.82353
"26169","83107","2016",347,209,138,342602,4032.282,83.75793
"26170","83108","2016",40,38,2,211191.9,2509.45,89.575
"26171","83109","2016",3,2,1,47333.33,1074.667,43.33333
"26172","83110","2016",18,13,5,205413.9,2576.611,81.5
"26173","83111","2016",20,18,2,261275,2894.05,99.4
"26174","83112","2016",230,68,162,282538.7,4514.291,64.12609
"26175","83113","2016",22,21,1,182895,1932,93.81818
"26176","83114","2016",6,6,0,174415,2777.667,72.5
"26177","83115","2016",390,119,271,389555.4,4928.377,70.8359
"26178","83116","2016",217,173,44,254917.8,2929.083,91.14286
"26179","83117","2016",31,25,6,323758.4,2727.613,120.1613
"26180","83118","2016",974,274,700,311953.4,4129.14,74.6807
"26181","83119","2016",97,12,85,469937.9,8025.144,55.51546
"26182","83120","2016",70,47,23,281247.3,3345.271,87.64286
"26183","83121","2016",58,47,11,231785.2,2384.293,97.12069
"26184","83122","2016",4,2,2,115000,1812.5,55.5
"26185","83123","2016",419,123,296,310921.1,4629.122,67.88783
"26186","83124","2016",50,46,4,343982.3,3156.1,112.38
"26187","83125","2016",32,31,1,255306.7,2602.719,100.1875
"26188","83126","2016",891,252,639,194161.8,2916.987,67.27385
"26189","83127","2016",35,27,8,243122.1,2625.829,98.74286
"26190","83128","2016",11,10,1,222213.6,2330.909,97.36364
"26191","83129","2016",714,251,463,252603.1,3892.725,66.55042
"26192","83130","2016",140,83,57,240870.3,2716.707,88.72857
"26193","83131","2016",61,51,10,266685.7,2831.443,94.7541
"26194","83132","2016",19,14,5,324710.2,2982.474,109.0526
"26195","83133","2016",15,9,6,255356,3455.133,76.53333
"26196","83134","2016",25,25,0,262781.4,2688.4,98.68
"26197","83135","2016",11,11,0,200963.6,1826.091,107.6364
"26198","83136","2016",46,40,6,262064.8,2830.848,96.26087
"26199","83137","2016",2468,446,2022,169653.9,2480.829,67.35575
"26200","83138","2016",45,40,5,338499.3,3820.489,87.15556
"26201","83139","2016",17,15,2,371787.9,2806.235,127.4706
"26202","83140","2016",69,61,8,226217.4,2496.188,92.62319
"26203","83141","2016",70,50,20,245886.7,2340.086,102.0571
"26204","83142","2016",1,1,0,177000,1735,102
"26205","83143","2016",47,36,11,200828.3,2963.34,81.06383
"26206","83144","2016",280,66,214,203991.4,2833.993,73.00714
"26207","83145","2016",19,13,6,171102.6,2002.053,87.57895
"26208","83146","2016",20,20,0,217758.5,2489.9,94.95
"26209","83148","2016",165,134,31,225299.5,2544.461,91.86667
"26210","83149","2016",20,16,4,199925,2730.9,76.3
"26211","83150","2016",36,29,7,178363.5,2174.556,84.08333
"26212","83151","2016",7,6,1,169957.1,2243.143,78
"26213","83152","2016",21,9,12,509657.4,6255.905,84.95238
"26214","83154","2016",14,14,0,349781.6,3103.571,111.0714
"26215","84001","2016",18,12,6,275704.7,2629.556,99.44444
"26216","84002","2016",17,15,2,260035.3,3412.647,81
"26217","84003","2016",94,62,32,189573.7,2149.713,84.30851
"26218","84004","2016",72,68,4,226935.1,2243.708,96.44444
"26219","84005","2016",4,4,0,111750,1388.75,77.25
"26220","84007","2016",1319,410,909,139308.2,2096.719,68.06672
"26221","84008","2016",11,11,0,367644.9,3113.727,114.5455
"26222","84009","2016",19,17,2,205153.5,2544.421,81.78947
"26223","84010","2016",7,7,0,207142.9,2558,91.14286
"26224","84011","2016",9,9,0,441011.1,3749.222,119.7778
"26225","84012","2016",23,18,5,229158.4,2240.348,100.5652
"26226","84013","2016",1,1,0,4e+05,1914,209
"26227","84014","2016",17,17,0,135120.6,1740.471,78.17647
"26228","84015","2016",3,3,0,316666.7,2266.333,136.6667
"26229","84016","2016",46,39,7,199255,1919.761,105.8696
"26230","84017","2016",55,51,4,234810.3,2734.836,95.6
"26231","84018","2016",4,4,0,329037.5,3738.25,122.5
"26232","84019","2016",105,83,22,181567.6,1802.438,99.60952
"26233","84020","2016",21,19,2,605928.1,4624.429,124.7143
"26234","84021","2016",1,1,0,165000,2463,67
"26235","84022","2016",5,4,1,297600,2101.2,154.4
"26236","84023","2016",1,1,0,1004000,4016,250
"26237","84024","2016",9,5,4,152724.2,2008.778,76
"26238","84025","2016",22,16,6,440553.1,2953.273,118.2273
"26239","84026","2016",63,46,17,202111.3,2371.159,85.8254
"26240","84027","2016",15,14,1,180666.7,1902.933,98.4
"26241","84028","2016",10,10,0,207299,2088.2,103.6
"26242","84029","2016",37,35,2,216254.7,2110.054,105.1622
"26243","84030","2016",44,39,5,219912.4,2513.341,91.97727
"26244","84031","2016",290,167,123,153320.7,2014.883,77.34828
"26245","84032","2016",2,2,0,270000,3000,90
"26246","84033","2016",1,1,0,74000,841,88
"26247","84034","2016",39,33,6,246266.4,2313.949,102.8462
"26248","84035","2016",249,122,127,156759,1961.884,78.69076
"26249","84036","2016",19,16,3,225752.6,2140.684,103.4211
"26250","84037","2016",13,11,2,169446.2,2004.538,84.38462
"26251","84038","2016",36,34,2,307618.1,2477.667,125.8889
"26252","84039","2016",52,45,7,181451.6,2011.596,89.21154
"26253","84040","2016",6,6,0,376666.7,2846.667,132.3333
"26254","84041","2016",9,9,0,426800.9,3234.667,143.4444
"26255","84042","2016",22,20,2,319583.2,3096.045,107.4545
"26256","84043","2016",91,66,25,207906.3,2350.505,91.24176
"26257","84044","2016",17,16,1,249452.9,2685.235,96.11765
"26258","84045","2016",6,6,0,256083.3,3182.5,93.83333
"26259","84046","2016",4,4,0,130262.5,1932.5,69.25
"26260","84047","2016",25,25,0,248044,2386.72,103.6
"26261","84048","2016",1,1,0,416000,4078,102
"26262","84049","2016",5,5,0,340900,3644,97.6
"26263","84050","2016",26,23,3,644115,4229.615,143.9615
"26264","84051","2016",13,12,1,613250.2,5459,110.8462
"26265","84052","2016",16,15,1,280597.5,2755.625,105.5625
"26266","84053","2016",16,16,0,229928.1,2215.688,105.125
"26267","84054","2016",309,193,116,230582.8,2765.126,84.8123
"26268","84055","2016",9,9,0,304122.2,2684.222,114.6667
"26269","84056","2016",48,39,9,199693.5,2094.271,96.58333
"26270","84057","2016",3,2,1,418533.3,3999.667,105.3333
"26271","84058","2016",9,8,1,628944.7,4683.667,146.1111
"26272","84059","2016",1,1,0,185000,3246,57
"26273","84061","2016",1,1,0,154000,2444,63
"26274","84062","2016",18,16,2,279180,2867.5,99.55556
"26275","84063","2016",3,3,0,137333.3,1919.667,70
"26276","84064","2016",48,40,8,156303.8,1727.062,95.625
"26277","84065","2016",42,36,6,322636.2,2805.548,111.6667
"26278","84066","2016",5,5,0,259545,3291.2,88.8
"26279","84067","2016",19,18,1,219593.9,2516.316,90.26316
"26280","84068","2016",22,12,10,307309.1,4040.864,76.45455
"26281","84069","2016",23,22,1,172077.4,2049.087,83.08696
"26282","84070","2016",13,12,1,237698.5,2371.615,106.2308
"26283","84071","2016",19,17,2,292585.5,2860.947,103.2105
"26284","84072","2016",13,13,0,312351.2,2380.538,128.0769
"26285","84073","2016",13,12,1,595692.3,4252.538,139.8462
"26286","84074","2016",30,25,5,273696,2725.867,95.5
"26287","84075","2016",3,3,0,181000,1704.667,111
"26288","84076","2016",17,13,4,217324.1,2730.941,80.64706
"26289","84077","2016",7,7,0,285000,2500.857,115.8571
"26290","84078","2016",37,32,5,168035.5,1780.676,94.05405
"26291","84079","2016",1,1,0,224000,1965,114
"26292","84080","2016",106,88,18,209238.4,2320.698,90.78302
"26293","84081","2016",92,68,24,206658.7,2299.043,91.86957
"26294","84082","2016",25,23,2,332452.8,2724.28,109.28
"26295","84083","2016",26,23,3,176018.1,1839.231,93.80769
"26296","84084","2016",20,17,3,300856.2,3015.45,103.15
"26297","84085","2016",5,5,0,383800,3276.8,108.8
"26298","84086","2016",21,12,9,291947.1,2886.476,102.6667
"26299","84087","2016",310,187,123,149979.6,1821.081,83.22258
"26300","84088","2016",97,83,14,304026.4,2777.155,106.2577
"26301","84089","2016",256,145,111,211389.4,2755.02,77.16406
"26302","84090","2016",10,7,3,163046,2360.4,67.9
"26303","84091","2016",41,37,4,199789.6,1846.098,104.0976
"26304","84092","2016",150,96,54,153266.8,1778.727,88.02667
"26305","84093","2016",14,14,0,322135,2847.143,114.7857
"26306","84094","2016",4,4,0,282000,3203,109.5
"26307","84095","2016",14,12,2,302890.7,2626.5,112.1429
"26308","84096","2016",8,8,0,185500,1794.75,107.875
"26309","84097","2016",6,6,0,200408.3,1726.833,104.6667
"26310","84098","2016",6,6,0,208000,2510.667,85.5
"26311","84099","2016",45,39,6,256263.7,2558.756,99.44444
"26312","84100","2016",1,1,0,325000,2407,135
"26313","84101","2016",5,5,0,402900,2707.6,146.6
"26314","84102","2016",22,20,2,402877.3,3333.773,122.0455
"26315","84103","2016",10,8,2,153656,2019.4,77.2
"26316","84104","2016",18,15,3,219264.7,2461.833,90.83333
"26317","84105","2016",9,9,0,320055.6,2930.333,108.5556
"26318","84106","2016",26,23,3,168828.6,1774.962,97.15385
"26319","84107","2016",8,8,0,114287.5,1243.75,93.125
"26320","84108","2016",27,27,0,292379.1,2573.259,114.7778
"26321","84111","2016",2,2,0,265720,2810.5,95
"26322","84112","2016",8,7,1,241937.5,2992,93
"26323","84113","2016",9,7,2,166166.7,2206.444,77.33333
"26324","84114","2016",3,3,0,358333.3,3698.667,99.66667
"26325","84115","2016",3,3,0,251510,3017,78.33333
"26326","84116","2016",8,8,0,437312.5,2992.75,141.5
"26327","84117","2016",6,6,0,185422.5,1778.5,96
"26328","84118","2016",46,44,2,309342.9,3149.587,103.913
"26329","84119","2016",44,33,11,244698.4,2461.818,96.47727
"26330","84120","2016",1,1,0,145000,1124,129
"26331","84121","2016",1,1,0,262000,2911,90
"26332","84122","2016",38,34,4,247768.6,2555.132,96.28947
"26333","84123","2016",16,14,2,171681.2,1700.938,98.9375
"26334","84124","2016",16,13,3,398945.3,3596,112.125
"26335","84126","2016",4,4,0,248250,2376.75,105.75
"26336","84127","2016",25,23,2,169923,1858.56,89.96
"26337","84129","2016",200,137,63,154749,1825.28,84.755
"26338","84130","2016",1,1,0,460000,3067,150
"26339","84131","2016",19,18,1,302630.3,3057.684,106.6842
"26340","84132","2016",101,78,23,259906.8,2649.208,98.47525
"26341","84133","2016",40,32,8,240193,2438.975,99.925
"26342","84134","2016",3,2,1,150000,1559,92.33333
"26343","84135","2016",13,13,0,309612.3,2414,129.0769
"26344","84136","2016",6,5,1,221316.7,1999.5,110.1667
"26345","84137","2016",90,57,33,222493.7,2525.433,88.58889
"26346","84138","2016",85,67,18,142370.6,1526.176,89.52941
"26347","84139","2016",4,3,1,255750,2988.75,78
"26348","84140","2016",5,5,0,338608,5493.2,76
"26349","84141","2016",101,86,15,219211.1,2374.139,92.21782
"26350","84142","2016",16,14,2,228766.2,2671.375,84.125
"26351","84143","2016",12,11,1,351510,2809.417,124.5
"26352","84144","2016",9,7,2,246777.8,3002.222,76.44444
"26353","84145","2016",12,11,1,238009.2,2461.417,95.91667
"26354","84146","2016",3,3,0,917333.3,3543.333,196
"26355","84147","2016",42,35,7,254937.5,2865.738,90.80952
"26356","84148","2016",17,17,0,198822.9,2177.118,96.64706
"26357","84149","2016",19,18,1,211306.8,2254.632,102.3158
"26358","84150","2016",19,14,5,214899.3,2170.526,93.78947
"26359","84151","2016",2,2,0,235500,2877.5,82.5
"26360","85001","2016",110,108,2,126355.8,1978.155,71.56364
"26361","85002","2016",23,23,0,179710.7,1752.043,101.6087
"26362","85003","2016",104,96,8,157148.5,1751.615,93.71154
"26363","85004","2016",55,55,0,159709.3,1925.545,84.27273
"26364","85005","2016",8,8,0,100375,1115.75,88.75
"26365","85006","2016",22,22,0,148530.3,1577,98.68182
"26366","85008","2016",62,61,1,170951.1,1641.387,107.129
"26367","85009","2016",4,4,0,142250,1506.75,97.25
"26368","85010","2016",14,14,0,141362.3,1396.214,103.9286
"26369","85011","2016",53,51,2,204863.2,2819.679,75.98113
"26370","85012","2016",62,48,14,138942,2045.629,72.67742
"26371","85013","2016",16,16,0,115603.1,1327.375,87.6875
"26372","85014","2016",15,15,0,114666.7,921.7333,129.3333
"26373","85015","2016",20,20,0,155515,1602.4,102.1
"26374","85016","2016",16,16,0,166093.8,1416.188,114.625
"26375","85017","2016",11,11,0,131845.5,1466.636,88.63636
"26376","85018","2016",59,57,2,138423.3,1654.475,87.20339
"26377","85019","2016",46,46,0,145481.3,1447.913,100.6522
"26378","85020","2016",25,25,0,144088,1237.64,117.52
"26379","85021","2016",11,11,0,150434.5,1814.545,92.36364
"26380","85022","2016",29,29,0,153421.2,1635.172,95.48276
"26381","85023","2016",3,3,0,106666.7,739,164.3333
"26382","85024","2016",32,31,1,122675.5,1461,84.96875
"26383","85025","2016",17,17,0,116129.4,1375.176,83.70588
"26384","85026","2016",18,18,0,129725.6,1412.944,95.33333
"26385","85028","2016",9,9,0,113955.6,949,117.4444
"26386","85029","2016",27,27,0,114540.7,1326.852,88.07407
"26387","85031","2016",21,21,0,120595.2,1145.19,108.9048
"26388","85033","2016",5,5,0,112979.4,1087.6,108.2
"26389","85034","2016",28,28,0,93550,1130.179,84.35714
"26390","85035","2016",172,148,24,168649.7,2784.459,66.9593
"26391","85036","2016",8,8,0,161937.5,1358,124.25
"26392","85037","2016",3,3,0,139500,1447,97.66667
"26393","85038","2016",22,22,0,132137.6,1258.409,110.2273
"26394","85039","2016",44,44,0,118470.6,1304.159,92.81818
"26395","85040","2016",19,19,0,105494.7,1029.421,109.1579
"26396","85041","2016",4,4,0,52875,611,89.25
"26397","85042","2016",21,21,0,120043.5,1299.048,101.1905
"26398","85045","2016",20,20,0,151280,1646,96.25
"26399","85046","2016",41,41,0,136254.1,1383.805,98.80488
"26400","85047","2016",257,207,50,170728.8,1953.724,90.62257
"26401","85049","2016",16,16,0,125750,1314,96.0625
"26402","85050","2016",23,22,1,100043.5,1165.913,90.30435
"26403","85051","2016",106,100,6,113777.3,1211.443,95.64151
"26404","85053","2016",6,6,0,98500,922.1667,111.5
"26405","85054","2016",17,17,0,116237.6,1319.882,91.82353
"26406","85055","2016",1,1,0,142000,1495,95
"26407","85056","2016",6,6,0,84700.17,918.5,86.16667
"26408","85058","2016",5,5,0,164230,1704,93.2
"26409","85059","2016",20,20,0,86600,966.55,88.25
"26410","85061","2016",11,11,0,122545.5,1063.273,115.0909
"26411","85062","2016",4,4,0,133187.8,1581,91
"26412","85064","2016",25,25,0,117096,1262.16,96.28
"26413","85065","2016",33,33,0,128854.5,1293.121,102.4545
"26414","85066","2016",5,5,0,90300,855.8,107
"26415","85067","2016",3,3,0,52683.33,718.3333,79.33333
"26416","85070","2016",38,37,1,122955.3,1618.053,79.68421
"26417","85071","2016",43,41,2,154613.6,1651.023,95.67442
"26418","85072","2016",11,11,0,158403.2,1419.091,111.8182
"26419","85073","2016",14,14,0,136371.4,1212.286,113.5
"26420","85074","2016",1,1,0,127000,1764,72
"26421","85076","2016",36,36,0,147663.9,1603.944,90.05556
"26422","85077","2016",7,7,0,81857.14,1241.714,65.14286
"26423","85078","2016",11,11,0,102909.1,1015.273,97.45455
"26424","85080","2016",18,18,0,118838.9,1114.667,114.3333
"26425","85081","2016",51,51,0,143035.9,1444.157,102.4314
"26426","85082","2016",26,26,0,123475.5,1318.038,100.4615
"26427","85083","2016",27,27,0,240204.4,3486.481,79.62963
"26428","85084","2016",65,64,1,140553.8,1461.108,102.2
"26429","85086","2016",8,8,0,107837.5,1108.25,96.125
"26430","85087","2016",4,4,0,84650,732,111.75
"26431","85088","2016",56,54,2,217390.2,2350.304,92.51786
"26432","85089","2016",39,39,0,128526.5,1544.282,84.46154
"26433","85090","2016",35,35,0,97290.63,1046.771,93.82857
"26434","85092","2016",154,132,22,105254.7,1110.247,94.09091
"26435","85093","2016",10,10,0,107721.5,1403.6,77.7
"26436","85094","2016",16,16,0,112431.2,1012,109.5625
"26437","85095","2016",17,17,0,156405.9,1725.588,95.11765
"26438","85096","2016",58,57,1,153401.4,1602.086,96.37931
"26439","85097","2016",13,13,0,101930.8,1200.077,86.07692
"26440","85098","2016",16,16,0,178981.6,1778.688,100.1875
"26441","85099","2016",10,10,0,143560,1391.7,99.5
"26442","85100","2016",20,20,0,186425.8,2107.1,89.2
"26443","85101","2016",8,8,0,109775,1038.625,109.375
"26444","85102","2016",12,12,0,132121.2,1316.75,102.75
"26445","85103","2016",28,28,0,155473.9,1684.214,97.42857
"26446","85104","2016",27,27,0,133753.6,1624.407,86.2963
"26447","85105","2016",8,8,0,126742.5,1325.25,105.125
"26448","85106","2016",44,44,0,258136.4,3118.773,83.63636
"26449","85108","2016",24,24,0,151197.1,1541.875,99.83333
"26450","85109","2016",154,138,16,143259.3,1673.552,92.74026
"26451","85110","2016",4,4,0,115750,1020.5,133.75
"26452","85111","2016",16,16,0,109004.9,1306.312,91.5625
"26453","85112","2016",35,35,0,181712.3,1986.229,91.8
"26454","85113","2016",112,109,3,336308,3826.92,87.30357
"26455","85114","2016",121,105,16,160014.1,2504.289,67.63636
"26456","85115","2016",8,7,1,78738.62,885.25,90.125
"26457","85116","2016",6,6,0,123433.3,1239.333,100.5
"26458","85117","2016",6,6,0,128583.3,1318.167,106.5
"26459","85118","2016",35,35,0,154456.3,1582.6,98.08571
"26460","85119","2016",16,15,1,117309.6,1190.5,103.25
"26461","85120","2016",23,23,0,142869.6,1598,92.04348
"26462","85121","2016",10,10,0,146900,1221.8,130.4
"26463","85123","2016",3,3,0,135916.7,1319,107.3333
"26464","85125","2016",2,2,0,71372.5,574.5,123
"26465","85126","2016",11,10,1,149909.1,1345.545,116.8182
"26466","85127","2016",93,86,7,152540.5,2153.366,74.53763
"26467","85128","2016",141,127,14,126015.2,1337.376,93.85106
"26468","85129","2016",30,30,0,128696.7,1487.633,85.43333
"26469","85130","2016",19,17,2,142234.5,1546.526,91.10526
"26470","85131","2016",10,10,0,137600,1347.7,104.7
"26471","85132","2016",8,8,0,86025,958.25,106.375
"26472","85133","2016",6,6,0,105166.7,1178.667,84.66667
"26473","85134","2016",5,5,0,93500,993.4,92.6
"26474","85135","2016",27,26,1,129092.4,1401.407,92.59259
"26475","85136","2016",2,2,0,98500,865.5,112
"26476","85137","2016",5,5,0,89100,871.8,97
"26477","85138","2016",13,13,0,139376.9,1403.077,103.7692
"26478","85139","2016",5,5,0,133200,1072.4,132.6
"26479","85140","2016",21,21,0,89671.43,955.0952,93.71429
"26480","85141","2016",6,6,0,116441.7,1222.5,94.66667
"26481","85142","2016",9,9,0,110755.6,1228.444,88.11111
"26482","85143","2016",19,19,0,81763.16,968.7368,85.10526
"26483","85144","2016",12,12,0,113958.3,1280.167,89
"26484","85145","2016",6,6,0,97862,1016.667,96.5
"26485","85146","2016",69,47,22,141392.8,1727.551,83.28986
"26486","85147","2016",19,19,0,96863.16,925.2632,108.7895
"26487","85148","2016",13,13,0,116488.5,1137.154,107.3077
"26488","85149","2016",4,4,0,135125,1378.25,99.5
"26489","85151","2016",49,49,0,135847.6,1280.122,108.9388
"26490","85152","2016",45,45,0,151628.9,1704.267,94.04444
"26491","85153","2016",26,26,0,103157.7,1183.846,83.84615
"26492","85154","2016",11,11,0,101563.6,921.7273,108.3636
"26493","85155","2016",51,51,0,174629.4,1814.804,97.29412
"26494","85156","2016",29,29,0,135184.1,1523.276,91.03448
"26495","85157","2016",6,6,0,77216.67,895.8333,86.16667
"26496","85158","2016",13,13,0,95530.77,969.0769,102.5385
"26497","85159","2016",27,27,0,100462.4,1089.074,92.66667
"26498","85160","2016",28,25,3,142630.8,1365.286,103.1429
"26499","85161","2016",25,25,0,118414,1332.96,87.56
"26500","85162","2016",14,14,0,141049.6,1239.071,119.5714
"26501","85163","2016",159,134,25,284734.1,3360.736,83.56604
"26502","85164","2016",64,41,23,140444.6,2451.25,62.23438
"26503","85167","2016",10,10,0,130800,1051.5,123.7
"26504","85169","2016",13,13,0,98307.69,1165.615,86.92308
"26505","85171","2016",10,10,0,124400,1274.9,96
"26506","85172","2016",20,19,1,148412.5,1940.15,77.75
"26507","85174","2016",4,4,0,126000,1173.5,107.25
"26508","85175","2016",6,6,0,126500,1216,98.5
"26509","85176","2016",17,17,0,139573.8,1242.529,110.1765
"26510","85177","2016",5,5,0,91200,851,96.2
"26511","85178","2016",61,59,2,143950,1501.738,96.5082
"26512","85179","2016",14,14,0,131014.3,1418.5,95.07143
"26513","85181","2016",5,5,0,127009.8,1040.8,131.6
"26514","85182","2016",42,41,1,110926,1156.5,93.07143
"26515","85184","2016",8,8,0,69325,764.5,92.125
"26516","85185","2016",6,6,0,162916.7,1379,128.3333
"26517","85186","2016",4,4,0,1e+05,994.5,97.5
"26518","85187","2016",11,11,0,87709.09,942.3636,93.90909
"26519","85188","2016",12,12,0,77650,926.75,93.91667
"26520","85189","2016",35,35,0,171407.2,1842.514,94.85714
"26521","85190","2016",35,35,0,127996.5,1398.543,93.05714
"26522","85191","2016",758,438,320,128928.7,1642.462,79.75726
"26523","85192","2016",6,5,1,92083.33,1146.333,84.83333
"26524","85193","2016",7,7,0,59621.43,896.2857,74.85714
"26525","85194","2016",742,332,410,206378.6,3250.457,65.94205
"26526","85196","2016",24,24,0,121820.8,1250.792,96.66667
"26527","85197","2016",30,30,0,131038.8,1324.167,96.66667
"26528","85198","2016",12,12,0,156291.7,1467.25,104.1667
"26529","85199","2016",3,3,0,117300,1309.333,89.66667
"26530","85200","2016",16,16,0,129371.9,1537.375,86.8125
"26531","85201","2016",4,4,0,103407.5,1255,85
"26532","85202","2016",8,8,0,106525,1107.25,97.75
"26533","85204","2016",30,30,0,118913.2,1266.033,95.76667
"26534","85205","2016",5,5,0,78051.2,823.8,99.6
"26535","85206","2016",15,15,0,58957.2,935.3333,57.66667
"26536","85207","2016",10,10,0,95140,1221,79.8
"26537","85208","2016",29,29,0,126931,1213.31,102.6552
"26538","85209","2016",5,5,0,57700,565.2,98
"26539","85210","2016",23,23,0,119934.7,1322.609,93.30435
"26540","85211","2016",25,24,1,148938.8,1546.16,94.28
"26541","85213","2016",37,36,1,130729.6,1369.973,99.75676
"26542","85214","2016",26,26,0,224436.8,1990.192,113.6154
"26543","85215","2016",32,31,1,127758.5,1310.625,98.8125
"26544","85216","2016",13,13,0,125692.3,1235.231,109.6154
"26545","85218","2016",24,24,0,135068.1,1465.708,88.91667
"26546","85220","2016",12,12,0,109416.8,1272.917,91.83333
"26547","85221","2016",46,46,0,138908.5,1607.022,88.91304
"26548","85222","2016",256,164,92,196467.3,3081.141,65.82812
"26549","85223","2016",35,34,1,123247.3,1145.686,115.9143
"26550","85226","2016",476,250,226,141465.5,2339.475,61.65546
"26551","85227","2016",18,18,0,134310.9,1262.444,106.3889
"26552","85229","2016",8,8,0,95750,801.125,115.5
"26553","85231","2016",1,1,0,230000,2738,84
"26554","85232","2016",9,9,0,92244.44,957.7778,94.88889
"26555","85233","2016",5,5,0,132990,1022,131.8
"26556","85234","2016",381,186,195,137600.1,2355.441,60.65617
"26557","85235","2016",4,4,0,125750,797.5,147
"26558","85236","2016",25,25,0,156332,1826.08,88.4
"26559","85237","2016",2,2,0,115000,1065,106.5
"26560","85238","2016",29,28,1,134254.3,1306.931,100.6552
"26561","85239","2016",9,9,0,144205.6,1618.333,92.22222
"26562","85240","2016",10,10,0,131950,1248.9,120.8
"26563","85242","2016",6,6,0,116675,1211.167,95.5
"26564","85243","2016",56,56,0,147205.9,2070.411,78.42857
"26565","85244","2016",6,6,0,117916.7,1137.5,103
"26566","85245","2016",3,3,0,79375.33,592,140.6667
"26567","85246","2016",22,22,0,112382.9,1275.227,89.95455
"26568","85247","2016",5,5,0,71400,926.2,75
"26569","85248","2016",3,3,0,89666.67,805.3333,111.3333
"26570","85250","2016",33,33,0,175993,1836.212,96.60606
"26571","85251","2016",7,7,0,111000,982.4286,111.7143
"26572","85252","2016",5,5,0,136800,1382,106.2
"26573","85254","2016",17,17,0,94782.35,1103,95.76471
"26574","85255","2016",36,36,0,134425,1510.667,89.91667
"26575","85256","2016",15,15,0,116773.3,1041.133,119.9333
"26576","85259","2016",14,14,0,143732.1,1586.214,92.64286
"26577","85260","2016",14,14,0,130449.3,1310.5,101
"26578","85261","2016",4,4,0,98500,991.75,96
"26579","85262","2016",36,36,0,146213.9,1596.25,94.05556
"26580","85264","2016",8,8,0,112748.8,991,116.375
"26581","85265","2016",12,12,0,86578.33,784.8333,112
"26582","85266","2016",14,14,0,104500,1134,89.71429
"26583","85267","2016",7,7,0,129642.9,1202.429,114.7143
"26584","85268","2016",17,17,0,155323.9,1645.706,92.76471
"26585","85269","2016",10,10,0,105250,955.7,114.8
"26586","85271","2016",5,5,0,146300,1214.2,139.6
"26587","85273","2016",10,10,0,141600,1820,74.4
"26588","85274","2016",3,3,0,69333.33,713.3333,96
"26589","85276","2016",7,7,0,113371.4,1087.714,107.8571
"26590","85277","2016",18,18,0,141445,1492.944,96.22222
"26591","85278","2016",66,57,9,152583.2,2562.409,68.84848
"26592","85280","2016",26,26,0,174835.4,1626.231,110.1538
"26593","85281","2016",8,8,0,127125,1133.25,116.875
"26594","85282","2016",10,10,0,82150,927.6,86.1
"26595","85284","2016",52,52,0,175880.1,1769.173,103.0577
"26596","85285","2016",3,3,0,196666.7,1455.333,139.3333
"26597","85286","2016",6,6,0,137500,1124.167,130.1667
"26598","85287","2016",6,6,0,63033.33,767.3333,86
"26599","85288","2016",185,143,42,176589.5,2121.103,84.80541
"26600","85289","2016",10,10,0,128885,1148.4,110.1
"26601","85290","2016",8,8,0,128285,909.125,140
"26602","85291","2016",18,18,0,111662.5,1055.722,103.3889
"26603","85292","2016",5,5,0,140800,1253.6,108.4
"26604","85293","2016",13,13,0,100992.3,1163.923,89.76923
"26605","85294","2016",181,162,19,175268.8,2588.006,72.12155
"26606","85295","2016",31,31,0,145995.7,1451.29,102.1613
"26607","85296","2016",4,3,1,98950,1298.75,77.25
"26608","85297","2016",17,17,0,87007.35,1002.765,90.05882
"26609","85298","2016",18,17,1,173687.2,1662.944,102.3333
"26610","85300","2016",44,44,0,161996,1563.5,103.8864
"26611","85301","2016",4,4,0,153125,1882,77.75
"26612","85302","2016",60,60,0,131787.5,1352.517,96.8
"26613","85303","2016",19,19,0,121802.6,1221.842,103.5263
"26614","85304","2016",6,6,0,114750,1194,97
"26615","85305","2016",12,12,0,92745.42,1006.75,88.58333
"26616","85306","2016",5,5,0,130610.6,1051.4,127
"26617","86001","2016",7,7,0,97539.86,888.1429,103.1429
"26618","86002","2016",9,9,0,108888.9,1054.778,98.77778
"26619","86004","2016",5,5,0,86000,1305.8,66.2
"26620","86005","2016",8,8,0,76237.5,855.125,92.875
"26621","86006","2016",12,12,0,74247.5,770,88.5
"26622","86007","2016",11,11,0,136363.6,1386.364,107.5455
"26623","86008","2016",6,6,0,81386.67,707,113.6667
"26624","86009","2016",13,13,0,91150,865.1538,109.6923
"26625","86010","2016",10,10,0,173463.4,1465.6,118.6
"26626","86011","2016",3,3,0,356933.3,1185,180.6667
"26627","86012","2016",3,3,0,111500,2906.667,54.33333
"26628","86014","2016",20,20,0,121675,1382.7,89.85
"26629","86015","2016",24,24,0,70632,810.5833,87.75
"26630","86016","2016",26,26,0,182180.4,1593.538,116.8462
"26631","86017","2016",9,9,0,140222.2,1187.222,125.8889
"26632","86019","2016",34,34,0,131013.1,1293.235,99.47059
"26633","86020","2016",2,2,0,60000,779,77.5
"26634","86022","2016",2,2,0,37000,1033.5,45
"26635","86024","2016",18,18,0,161817.9,1344.778,125.9444
"26636","86025","2016",2,2,0,47500,519.5,92.5
"26637","86026","2016",1,1,0,124000,1292,96
"26638","86027","2016",15,14,1,139576.7,1416.8,103.4667
"26639","86028","2016",9,9,0,145944.4,1513.778,100.6667
"26640","86029","2016",11,11,0,108190.9,1088.636,99.09091
"26641","86031","2016",9,9,0,129930,1297.444,98.44444
"26642","86032","2016",29,29,0,142906.2,1362.241,107.4483
"26643","86034","2016",9,9,0,70222.22,726.3333,97.22222
"26644","86035","2016",2,2,0,45000,442,103
"26645","86036","2016",8,8,0,144457.9,1408.625,100.625
"26646","86037","2016",7,7,0,82950,937.4286,81.71429
"26647","86038","2016",4,4,0,116500,928.5,120
"26648","86039","2016",5,5,0,153580,865.6,157.6
"26649","86040","2016",3,3,0,144000,1400.333,107.6667
"26650","86041","2016",114,84,30,146985.8,1708.316,86.14912
"26651","86042","2016",7,7,0,87271.43,827.1429,113.7143
"26652","86044","2016",6,6,0,149099,951.8333,145.6667
"26653","86045","2016",11,11,0,120208,1099,117.0909
"26654","86046","2016",12,12,0,124102.6,1351.583,91.5
"26655","86047","2016",2,2,0,98000,1272.5,76.5
"26656","86048","2016",8,8,0,155062.5,1182.75,137.25
"26657","86049","2016",1,1,0,113850,1560,73
"26658","86050","2016",10,10,0,108208,1087.1,100
"26659","86051","2016",2,2,0,137500,1294,103.5
"26660","86052","2016",6,6,0,101250,891.6667,117.3333
"26661","86053","2016",6,6,0,144000,1084.833,122.5
"26662","86054","2016",5,5,0,65500,646,96.2
"26663","86055","2016",7,7,0,106300,990,109.1429
"26664","86058","2016",3,3,0,172666.7,2124.667,75
"26665","86059","2016",5,5,0,128000,936.6,141.8
"26666","86061","2016",11,11,0,79518.18,849.8182,92.90909
"26667","86062","2016",53,41,12,139900.7,1700.132,85.32075
"26668","86063","2016",7,7,0,94214.29,1048.571,97.57143
"26669","86064","2016",4,4,0,74450,722.75,97.75
"26670","86065","2016",8,8,0,166727.5,1199.75,139.5
"26671","86066","2016",319,272,47,107735.3,1245.934,89.721
"26672","86068","2016",10,10,0,94040,907.8,100.1
"26673","86069","2016",5,5,0,83095.2,937.6,86.4
"26674","86070","2016",66,66,0,121335.1,1274.333,94.66667
"26675","86072","2016",5,5,0,108867.4,1182.8,91.8
"26676","86073","2016",7,7,0,101892.9,1284.571,83.14286
"26677","86074","2016",3,3,0,97650,966.6667,102.6667
"26678","86075","2016",9,9,0,79555.56,940.8889,83.22222
"26679","86076","2016",26,26,0,186940.1,1447.846,132.5769
"26680","86077","2016",7,7,0,113427.3,1051.857,111.2857
"26681","86078","2016",38,37,1,84421.97,941.8158,97.39474
"26682","86079","2016",5,5,0,115232.6,1142.2,114.6
"26683","86080","2016",3,3,0,151666.7,1480,104
"26684","86081","2016",11,11,0,132542.3,1389.818,97.36364
"26685","86082","2016",50,50,0,112073.6,1132.38,100.96
"26686","86083","2016",9,9,0,122398.1,1270.222,102.8889
"26687","86084","2016",1,1,0,205000,932,220
"26688","86085","2016",2,2,0,69000,866,79.5
"26689","86086","2016",4,4,0,108750,1213.75,82.75
"26690","86087","2016",5,5,0,66100,693,96.8
"26691","86088","2016",13,10,3,152649.2,1558.923,96.23077
"26692","86091","2016",2,2,0,87000,819.5,117.5
"26693","86092","2016",28,28,0,108862.5,1212.607,89.5
"26694","86093","2016",5,5,0,56400,715,76.4
"26695","86094","2016",6,6,0,127108.3,1332.5,96
"26696","86095","2016",27,27,0,145785.9,1629.333,91.2963
"26697","86096","2016",7,7,0,107214.3,1210.286,88
"26698","86097","2016",2,2,0,108000,1314,81
"26699","86098","2016",4,4,0,90375,968,94.75
"26700","86099","2016",9,9,0,104288.9,1140.667,93.66667
"26701","86100","2016",35,29,6,188608.3,1951.6,103.5429
"26702","86102","2016",6,6,0,153416.7,1461.333,105.1667
"26703","86103","2016",17,17,0,102426.5,1122.118,89.94118
"26704","86104","2016",7,7,0,71206.86,685.4286,108.7143
"26705","86105","2016",2,2,0,2e+05,1223.5,163.5
"26706","86107","2016",5,5,0,77100,841.8,94.6
"26707","86108","2016",7,7,0,105285.7,1132.714,91.57143
"26708","86109","2016",1,1,0,62500,718,87
"26709","86110","2016",3,3,0,126733.3,1076,116.6667
"26710","86111","2016",10,10,0,137657,1430.4,94.2
"26711","86112","2016",19,19,0,96669.53,895.3684,104.3158
"26712","86113","2016",29,29,0,155512.4,1523.931,100.1034
"26713","86114","2016",8,8,0,171062.6,1438.125,119
"26714","86115","2016",75,68,7,130047.1,1575.653,85.77333
"26715","86116","2016",8,8,0,114837.5,973.875,121
"26716","86117","2016",3,3,0,50111,600,85
"26717","86118","2016",5,5,0,144000,1020.2,137.6
"26718","86119","2016",4,4,0,91125,882.5,117.25
"26719","86120","2016",11,11,0,101973.8,1150.545,91.63636
"26720","86121","2016",1,1,0,193500,1392,139
"26721","86122","2016",1,1,0,150000,1190,126
"26722","86123","2016",14,14,0,102634.9,1105.929,92.5
"26723","86124","2016",23,23,0,145137.4,1400.652,107.6087
"26724","86125","2016",6,6,0,90700,875.8333,105.6667
"26725","86126","2016",6,6,0,123083.3,1134.5,106.6667
"26726","86127","2016",4,4,0,88750,877.5,107
"26727","86128","2016",17,17,0,94352.94,1031.353,90.76471
"26728","86129","2016",7,7,0,79445,791.7143,99.85714
"26729","86130","2016",1,1,0,107500,1536,70
"26730","86131","2016",7,7,0,117289.1,1148.429,104.4286
"26731","86132","2016",11,11,0,86508.36,825.0909,97.90909
"26732","86133","2016",35,35,0,154449.3,1601.886,98
"26733","86134","2016",2,2,0,36500,784,71
"26734","86135","2016",6,6,0,165500,1654.167,105.3333
"26735","86136","2016",7,7,0,132914.3,1403.429,98.42857
"26736","86137","2016",50,44,6,99401.5,1033.3,98.82
"26737","86138","2016",6,6,0,91683.33,960,99.66667
"26738","86139","2016",30,30,0,95106.67,1048.367,100.2333
"26739","86140","2016",24,24,0,84355,944.0417,95.70833
"26740","86141","2016",10,10,0,92593,1028.7,98.6
"26741","86142","2016",7,7,0,141647.1,1109.714,144.4286
"26742","86143","2016",4,4,0,78750,1204,68
"26743","86144","2016",5,5,0,112328,955.6,119
"26744","86145","2016",11,11,0,133209.1,1331.909,96.45455
"26745","86147","2016",3,3,0,125333.3,1392,86.66667
"26746","86148","2016",10,10,0,89382.3,1026,84.9
"26747","86149","2016",2,2,0,120725,1058.5,109.5
"26748","86150","2016",3,3,0,107333.3,1200,90.66667
"26749","86152","2016",7,7,0,69487.14,903.4286,79
"26750","86153","2016",9,9,0,93105.56,994.3333,89.66667
"26751","86154","2016",1,1,0,50000,658,76
"26752","86156","2016",1,1,0,125000,1420,88
"26753","86157","2016",51,45,6,169469.2,1846.059,92.58824
"26754","86158","2016",71,70,1,169142,1636.521,106.3662
"26755","86159","2016",2,2,0,53500,682.5,79.5
"26756","86160","2016",19,19,0,103757.9,923.1579,111.9474
"26757","86161","2016",5,5,0,79600,913.8,98.6
"26758","86162","2016",3,3,0,199666.7,1332.333,136.3333
"26759","86163","2016",37,37,0,187523,1619.622,118.3243
"26760","86164","2016",8,8,0,115793.8,1211.5,98.125
"26761","86165","2016",50,48,2,91345.82,1022.34,94.58
"26762","86167","2016",4,4,0,102137.5,904.5,131.25
"26763","86169","2016",1,1,0,135000,763,177
"26764","86170","2016",4,4,0,71750,875.25,81
"26765","86171","2016",5,5,0,64076,885.8,73
"26766","86172","2016",3,3,0,75166.67,896.3333,81
"26767","86173","2016",4,4,0,96575,1016.75,94.75
"26768","86174","2016",55,55,0,122743.1,1270.364,97.4
"26769","86175","2016",7,7,0,84214.29,1073.714,81.57143
"26770","86177","2016",77,74,3,156772,1536.494,107.5844
"26771","86178","2016",17,17,0,168867.6,1581.588,106.1176
"26772","86180","2016",17,17,0,189674.7,1771.176,107.9412
"26773","86181","2016",2,2,0,120000,1141,105
"26774","86182","2016",3,3,0,98640.67,1132,100
"26775","86183","2016",16,16,0,99031.25,1039.75,97.0625
"26776","86184","2016",17,17,0,138469.4,1265.412,113.4706
"26777","86186","2016",6,6,0,159541.7,1347.167,119.8333
"26778","86187","2016",2,2,0,153250,1242.5,126
"26779","86189","2016",1,1,0,39000,661,59
"26780","86190","2016",11,11,0,62954.55,807.7273,77.18182
"26781","86191","2016",1,1,0,79000,814,97
"26782","86192","2016",1,1,0,42000,467,90
"26783","86193","2016",13,13,0,80402,885.9231,89.61538
"26784","86194","2016",1289,522,767,113108.4,1632.428,70.44996
"26785","86195","2016",6,6,0,91333.33,921.5,97.5
"26786","86196","2016",1,1,0,75000,962,78
"26787","86197","2016",2,2,0,78750,848.5,86
"26788","86198","2016",7,7,0,150628.6,1396.429,108
"26789","86200","2016",6,6,0,83283.33,733.1667,108.6667
"26790","86201","2016",3,3,0,70800,610.3333,117.6667
"26791","86202","2016",6,6,0,110000,1161.167,117.3333
"26792","86203","2016",14,14,0,93000,994.9286,92.71429
"26793","86204","2016",25,25,0,177749,1462,121.92
"26794","86205","2016",2,2,0,42500,795,55
"26795","86207","2016",22,18,4,115908.6,1338.182,90.95455
"26796","86209","2016",17,17,0,143123.5,1326.588,106.8235
"26797","86210","2016",5,5,0,110560,1136.8,98.8
"26798","86211","2016",12,12,0,81043.75,815.0833,101.6667
"26799","86213","2016",22,22,0,96924.09,1119.773,84.04545
"26800","86214","2016",78,59,19,158801.9,1705.321,97.73077
"26801","86217","2016",2,2,0,77500,820,82
"26802","86218","2016",4,4,0,79500,1279.75,73.5
"26803","86220","2016",1,1,0,108000,777,139
"26804","86221","2016",10,10,0,108950,922.7,117.8
"26805","86222","2016",38,36,2,144508.9,1603.974,96.68421
"26806","86223","2016",9,9,0,67335.56,880.4444,84.77778
"26807","86224","2016",15,15,0,76464.93,897.0667,85.13333
"26808","86225","2016",15,15,0,77924.13,859.8667,102.5333
"26809","86226","2016",28,28,0,162480.4,1495.179,109.2857
"26810","86227","2016",2,2,0,96000,1073.5,88
"26811","86228","2016",1,1,0,245000,1303,188
"26812","86229","2016",3,3,0,76666.67,720.3333,107
"26813","86230","2016",1,1,0,83000,922,90
"26814","86231","2016",5,5,0,142404,1014.8,142.6
"26815","86233","2016",23,23,0,118368.6,1179.261,103.6087
"26816","86234","2016",4,4,0,79573.75,909.75,97.25
"26817","86235","2016",13,13,0,96502.15,1068.077,88.84615
"26818","86236","2016",6,6,0,111000,963.5,120.3333
"26819","86237","2016",9,9,0,84800,970.5556,92.88889
"26820","86242","2016",4,4,0,68975,686.75,101.75
"26821","86244","2016",21,21,0,112539.6,1009.571,121.2381
"26822","86245","2016",14,14,0,154452.1,1491.5,104.7143
"26823","86246","2016",17,17,0,96073.53,1059,101.1176
"26824","86247","2016",5,5,0,88600,842.2,102.6
"26825","86248","2016",3,3,0,123783.3,788.3333,146
"26826","86249","2016",3,3,0,71500,812.3333,93.66667
"26827","86250","2016",2,2,0,136750,1235.5,119
"26828","86252","2016",5,5,0,103900,1086.4,90
"26829","86253","2016",2,2,0,113300,1466.5,77.5
"26830","86254","2016",8,8,0,91312.5,772.375,116.625
"26831","86255","2016",13,13,0,93012.31,1199.846,85.53846
"26832","86256","2016",13,13,0,165320,1643.769,104.7692
"26833","86257","2016",4,4,0,81000,1163.5,85.25
"26834","86258","2016",14,14,0,88964.29,1058.857,90.14286
"26835","86260","2016",5,5,0,48400,763.6,62
"26836","86261","2016",15,14,1,173654.7,1653.467,108.1333
"26837","86262","2016",1,1,0,80000,755,106
"26838","86263","2016",26,26,0,130591.3,1429.385,93.42308
"26839","86264","2016",9,9,0,99134,1265.778,87.22222
"26840","86265","2016",4,4,0,109500,1164.75,93
"26841","86266","2016",2,2,0,76500,1109,69
"26842","86268","2016",16,16,0,151900.6,1645.625,91.6875
"26843","86269","2016",1,1,0,140000,2029,69
"26844","86270","2016",1,1,0,29000,527,55
"26845","86271","2016",8,8,0,165218.8,1138.25,145.375
"26846","86272","2016",23,23,0,120161.3,1237.174,97.86957
"26847","86273","2016",13,12,1,59701.92,824.0769,72.07692
"26848","86274","2016",10,10,0,137035,1134.8,126.1
"26849","86275","2016",3,3,0,121500,1008.667,117
"26850","86276","2016",14,14,0,83723.57,975.2857,95.85714
"26851","86279","2016",2,2,0,121000,1276.5,95
"26852","86280","2016",6,6,0,82483.33,1011.167,76.83333
"26853","86281","2016",42,42,0,135658,1303.857,107.5952
"26854","86284","2016",5,5,0,173900,1440.6,120.6
"26855","86285","2016",6,6,0,123861.7,1097.667,116.3333
"26856","86286","2016",5,5,0,73600,694.6,107.4
"26857","86287","2016",1,1,0,110000,1000,110
"26858","86288","2016",17,17,0,60995.88,762.5294,78.17647
"26859","86289","2016",13,13,0,191230.8,2012.846,107.7692
"26860","86290","2016",13,12,1,125369.2,1519.385,81.84615
"26861","86291","2016",1,1,0,55000,545,101
"26862","86292","2016",11,11,0,167046.4,1483.909,118.1818
"26863","86293","2016",43,42,1,138778.3,1607.767,93.97674
"26864","86294","2016",47,47,0,151988.5,1415.234,108.0426
"26865","86295","2016",4,4,0,106925,556.25,176
"26866","86296","2016",5,5,0,101210,1167.4,88
"26867","86297","2016",55,55,0,179687.7,1692.873,108.1818
"26868","86298","2016",24,23,1,113626.2,1262.792,103.75
"26869","86299","2016",8,8,0,101625,1133.75,98.125
"26870","86300","2016",4,4,0,135875,1441.5,101.75
"26871","87001","2016",58,48,10,101985.7,1134.483,88.48276
"26872","87002","2016",53,53,0,138697.3,1417.906,103.3585
"26873","87003","2016",3,3,0,145833.3,1203.667,129.3333
"26874","87004","2016",1,1,0,143000,757,189
"26875","87005","2016",12,12,0,142578.3,1311,110.9167
"26876","87006","2016",3,3,0,41666.67,625,69.66667
"26877","87007","2016",2,2,0,83500,1129.5,75.5
"26878","87008","2016",3,2,1,96666.67,1011,139.3333
"26879","87009","2016",7,7,0,106190.1,1246.714,100.5714
"26880","87011","2016",31,30,1,89440.32,903.4194,100.5484
"26881","87012","2016",4,4,0,74750,766.25,93.75
"26882","87013","2016",5,5,0,78811,811.6,100.4
"26883","87014","2016",24,23,1,92729.17,1087.333,87.33333
"26884","87015","2016",7,7,0,147000,1424.286,101.2857
"26885","87016","2016",1,1,0,67500,614,110
"26886","87017","2016",5,5,0,84600,680.2,113.2
"26887","87018","2016",10,10,0,78798,1029.8,82.8
"26888","87019","2016",20,20,0,174497.5,1680.85,107.2
"26889","87020","2016",7,7,0,116242.9,1252.286,90.14286
"26890","87021","2016",19,19,0,127884.2,1299.895,95.73684
"26891","87022","2016",3,3,0,49100,624,82
"26892","87023","2016",4,4,0,101750,952.5,114.25
"26893","87024","2016",10,10,0,76350,932.3,84.6
"26894","87025","2016",6,5,1,132300,1178,115.3333
"26895","87027","2016",9,9,0,97961.11,888.6667,100.3333
"26896","87028","2016",15,15,0,63900,764.3333,90.4
"26897","87029","2016",6,6,0,148916.7,1075.333,141.3333
"26898","87030","2016",7,7,0,115285.7,1068.857,100.5714
"26899","87031","2016",7,7,0,112500,1194.714,89.71429
"26900","87032","2016",19,19,0,66485.79,906.4737,77.47368
"26901","87033","2016",10,10,0,96320,1155.4,91.5
"26902","87034","2016",10,10,0,130527.9,1259.8,115.4
"26903","87035","2016",4,4,0,133500,1607.5,88.75
"26904","87036","2016",14,14,0,97328.57,994.5714,94.14286
"26905","87037","2016",2,2,0,133399.5,1532.5,96.5
"26906","87038","2016",19,19,0,153271.4,1608.368,99.05263
"26907","87039","2016",12,12,0,104376.7,1264.75,85.91667
"26908","87040","2016",22,22,0,81821.5,982,83.04545
"26909","87041","2016",23,23,0,91232.09,1021.348,93.82609
"26910","87042","2016",3,3,0,113000,981.3333,107.6667
"26911","87043","2016",2,2,0,2e+05,3585.5,75.5
"26912","87044","2016",7,7,0,102785.7,1062.286,104.5714
"26913","87045","2016",9,9,0,105456.6,1178.556,89.55556
"26914","87046","2016",13,13,0,104953,873.5385,111.6923
"26915","87047","2016",30,30,0,120773.3,1241.7,103.6
"26916","87048","2016",52,49,3,162116.7,1598.481,104.0385
"26917","87049","2016",24,24,0,106139.6,1176.792,93.25
"26918","87050","2016",80,74,6,167502.3,1665.475,102.0375
"26919","87051","2016",8,8,0,92218.75,1122.625,80.875
"26920","87052","2016",1,1,0,43050,897,48
"26921","87053","2016",5,5,0,52347.4,699.6,73.2
"26922","87054","2016",13,13,0,86884.62,1037.923,77.38462
"26923","87056","2016",3,3,0,79000,1080.333,73
"26924","87057","2016",1,1,0,45000,469,96
"26925","87058","2016",2,2,0,54000,900,52.5
"26926","87059","2016",14,14,0,76471.43,850.3571,100.3571
"26927","87060","2016",10,10,0,81268,985.7,92.7
"26928","87061","2016",5,5,0,66200,771.2,91.4
"26929","87062","2016",4,4,0,112125,1250.75,96
"26930","87063","2016",13,13,0,146015.4,1508.462,97.15385
"26931","87064","2016",27,25,2,69037.04,920.7037,74.22222
"26932","87065","2016",52,50,2,181966.9,1693.712,108.7115
"26933","87066","2016",9,9,0,132994.4,1282.556,104.5556
"26934","87067","2016",3,3,0,63166.67,776,75.66667
"26935","87068","2016",4,4,0,80000,878.5,90
"26936","87069","2016",2,2,0,81450,1032.5,75
"26937","87070","2016",12,12,0,166575,1104.667,146.4167
"26938","87071","2016",7,7,0,137185.7,1536,97.85714
"26939","87072","2016",2,2,0,78500,971.5,75.5
"26940","87073","2016",8,8,0,78062.5,876.75,92
"26941","87074","2016",5,5,0,106500,834.6,128.2
"26942","87075","2016",71,62,9,142575.1,1503.606,95.87324
"26943","87076","2016",3,3,0,82200,700.6667,117.6667
"26944","87077","2016",6,6,0,122750,911.5,126.5
"26945","87078","2016",2,2,0,1e+05,1312.5,75.5
"26946","87079","2016",11,11,0,109121.8,817.1818,136.3636
"26947","87080","2016",2,2,0,59060,683,81
"26948","87081","2016",12,12,0,128666.7,1289.667,99.58333
"26949","87082","2016",19,19,0,95331.32,1068.316,92.52632
"26950","87083","2016",7,7,0,72295.71,928.7143,83.57143
"26951","87085","2016",1633,570,1063,100721.8,1369.9,72.87446
"26952","87086","2016",14,14,0,70321.43,993.1429,79.07143
"26953","87087","2016",8,8,0,57180.75,783.5,79.375
"26954","87088","2016",12,12,0,85273.17,1016.917,87.58333
"26955","87089","2016",21,21,0,80180.95,932.6667,99.71429
"26956","87090","2016",2,2,0,155500,1986.5,71.5
"26957","87091","2016",5,5,0,96200,931.4,104.8
"26958","87092","2016",9,9,0,107812.2,1659.333,56.44444
"26959","87093","2016",3,3,0,89333.33,732.3333,119
"26960","87094","2016",5,5,0,131817.8,1370,93.4
"26961","87095","2016",13,13,0,81461.54,1075.308,79.23077
"26962","87096","2016",8,8,0,148437.5,1401.75,96.625
"26963","87097","2016",10,10,0,98017,1137.2,83.9
"26964","87099","2016",4,4,0,75300,774.75,101
"26965","87100","2016",3,3,0,65000,978.3333,71
"26966","87101","2016",2,2,0,63000,690,109.5
"26967","87103","2016",18,18,0,85638.89,936.5556,92.27778
"26968","87104","2016",7,7,0,70171.43,1127.143,72.28571
"26969","87105","2016",14,14,0,92021.43,854.5,107.7857
"26970","87106","2016",23,22,1,115737,1219.739,98.78261
"26971","87107","2016",14,14,0,150428.6,1530.143,100
"26972","87108","2016",9,9,0,90811.11,886.1111,106
"26973","87109","2016",12,12,0,119179.2,1237.75,92
"26974","87110","2016",24,22,2,95995.42,1138.417,85.125
"26975","87111","2016",18,18,0,114344.7,1136.056,99.77778
"26976","87112","2016",10,10,0,105690,1127.5,100.5
"26977","87113","2016",60,60,0,127599.2,1418.567,92.78333
"26978","87114","2016",95,84,11,145307.9,1544,94.69474
"26979","87116","2016",12,12,0,104280,1094.167,94.66667
"26980","87117","2016",18,18,0,48436.11,843.9444,60.27778
"26981","87118","2016",14,14,0,97421.43,1057.857,94.71429
"26982","87119","2016",14,14,0,126142.9,1309.786,98.85714
"26983","87120","2016",13,13,0,88769.23,1222.385,77.76923
"26984","87121","2016",4,4,0,69511,844.5,82
"26985","87122","2016",14,14,0,93107.14,1032,90.71429
"26986","87123","2016",4,4,0,112775,974.5,116.75
"26987","87124","2016",4,4,0,125125,1475.5,92.25
"26988","87125","2016",26,26,0,145991.3,1501.385,98
"26989","87126","2016",50,50,0,96190.2,1042.48,93.56
"26990","87127","2016",11,11,0,149700,1576.364,97.36364
"26991","87128","2016",19,19,0,104526.3,1091.684,97.42105
"26992","87129","2016",14,13,1,120802.4,1248.714,103.7857
"26993","87130","2016",3,3,0,72500,843,86
"26994","87131","2016",7,7,0,101535.7,937.7143,104.8571
"26995","87132","2016",2,2,0,244900,2932,94
"26996","87133","2016",3,3,0,112600,879.3333,100
"26997","87134","2016",1,1,0,60500,766,79
"26998","87135","2016",15,15,0,91236.67,856.6,118.7333
"26999","87137","2016",1,1,0,142000,1614,88
"27000","87138","2016",8,8,0,131368.8,1164.5,113.375
"27001","87139","2016",11,11,0,104272.7,1178.636,89.63636
"27002","87140","2016",16,16,0,111250,1185.75,103.9375
"27003","87141","2016",11,10,1,116500,1320.091,94.27273
"27004","87142","2016",3,3,0,80000,1088,72
"27005","87143","2016",21,21,0,138792.9,1515.143,100.2857
"27006","87144","2016",2,2,0,128250,2092.5,60.5
"27007","87145","2016",1,1,0,30000,375,80
"27008","87146","2016",5,5,0,71700,955.6,80.4
"27009","87147","2016",1,1,0,23240,968,24
"27010","87148","2016",6,6,0,134815.3,1359.167,95.16667
"27011","87149","2016",5,5,0,44680,553.4,81.4
"27012","87150","2016",4,4,0,135125,1459,93
"27013","87151","2016",6,6,0,146216.7,1063.167,144
"27014","87152","2016",11,11,0,135427.3,1308.455,106.8182
"27015","87153","2016",4,4,0,65000,1158,69.75
"27016","87154","2016",112,100,12,118365.6,1292.339,92.48214
"27017","87156","2016",24,22,2,167305.3,1578,109.5833
"27018","87157","2016",7,7,0,145771.4,1359.286,110.1429
"27019","87158","2016",19,19,0,86594.21,1033.263,84.42105
"27020","87159","2016",11,11,0,107468.2,1156.273,103
"27021","87160","2016",4,4,0,85375,779.5,111
"27022","87161","2016",40,36,4,117788.6,1231.725,99
"27023","87162","2016",1,1,0,75000,1389,54
"27024","87163","2016",1,1,0,118000,1967,60
"27025","87164","2016",8,8,0,118312.5,1213.375,93.25
"27026","87165","2016",2,2,0,53625,810,66.5
"27027","87166","2016",6,6,0,146925,1317.5,103
"27028","87167","2016",8,8,0,117262.5,1229.875,91.625
"27029","87168","2016",20,20,0,76670,1011.2,77.8
"27030","87170","2016",3,3,0,94333.33,843,107.6667
"27031","87172","2016",3,3,0,75333.33,933,72.33333
"27032","87174","2016",17,17,0,100261.8,1218.176,82.47059
"27033","87176","2016",5,5,0,102054,1211.6,81.8
"27034","87177","2016",13,13,0,99992.31,1079.923,93.69231
"27035","87178","2016",26,26,0,116666.9,1267,97.23077
"27036","87179","2016",3,3,0,156006.7,1276,129
"27037","87180","2016",2,2,0,51500,838,65
"27038","87181","2016",16,16,0,96603.12,1039.25,92.3125
"27039","87182","2016",10,9,1,80096.6,971.2,87.7
"27040","87183","2016",11,11,0,118668.2,1162.545,100
"27041","87185","2016",27,27,0,124215.9,1192.185,102.7037
"27042","87186","2016",2,2,0,133000,1511.5,89.5
"27043","87187","2016",69,56,13,88010.64,1121.275,80.42029
"27044","87188","2016",3,3,0,150000,1385,109
"27045","87189","2016",3,3,0,98700,671.3333,148.6667
"27046","87190","2016",13,13,0,78314.15,1046.769,85.23077
"27047","87191","2016",16,16,0,114118.8,1189.875,94.75
"27048","87192","2016",7,7,0,132650,1109.714,113.5714
"27049","87194","2016",4,4,0,96137.5,1158.75,91.5
"27050","87195","2016",3,3,0,82500,935.3333,77.33333
"27051","87197","2016",5,5,0,81160,1468.8,79.4
"27052","87198","2016",7,7,0,68578.57,809.2857,85.14286
"27053","87199","2016",3,3,0,132333.3,1266.667,107.3333
"27054","87200","2016",2,2,0,55000,727.5,73
"27055","87201","2016",45,45,0,155818.3,1466.422,107.8889
"27056","87202","2016",24,24,0,138302.9,1167.375,120.7917
"27057","87203","2016",19,19,0,110889.5,1324.211,88.31579
"27058","87204","2016",2,2,0,112295,1378,92
"27059","87205","2016",23,23,0,168093.5,1500,114.1739
"27060","87206","2016",4,4,0,66125,831.75,84.25
"27061","88003","2016",1,1,0,94000,1469,64
"27062","88004","2016",2,2,0,62250,590.5,100
"27063","88005","2016",1,1,0,110000,1111,99
"27064","88006","2016",3,3,0,87666.67,721.3333,130
"27065","88009","2016",34,33,1,112616.8,1235.5,94.64706
"27066","88010","2016",1,1,0,155400,893,174
"27067","88011","2016",16,14,2,126342.2,1262.25,105.75
"27068","88012","2016",10,9,1,128270,1148.6,110.7
"27069","88013","2016",3,3,0,89200,1231.667,73.66667
"27070","88015","2016",2,1,1,66900,584.5,114
"27071","88020","2016",1,1,0,171000,1710,100
"27072","88021","2016",4,4,0,87100,658,127.5
"27073","88022","2016",2,2,0,111500,716.5,163
"27074","88023","2016",1,1,0,138000,1150,120
"27075","88024","2016",2,2,0,45000,1598,35.5
"27076","88026","2016",8,7,1,147468.8,1319.25,113.25
"27077","88027","2016",1,1,0,117000,1073,109
"27078","88028","2016",4,4,0,112700,1044,108.5
"27079","88029","2016",20,19,1,83709.7,832.1,97.85
"27080","88030","2016",2,2,0,144500,1341,116
"27081","88032","2016",14,13,1,103316.7,1243.143,85.28571
"27082","88033","2016",3,3,0,115866.7,1231,99
"27083","88035","2016",2,2,0,58500,778,87
"27084","88037","2016",12,12,0,117308.3,1835.25,67.66667
"27085","88039","2016",2,2,0,92000,695.5,128
"27086","88040","2016",2,2,0,140750,1355.5,101.5
"27087","88042","2016",1,1,0,75000,595,126
"27088","88043","2016",1,1,0,128000,1580,81
"27089","88044","2016",4,4,0,175000,1324.75,133.5
"27090","88045","2016",3,3,0,118583.3,1049.333,123.3333
"27091","88047","2016",1,1,0,36220,541,67
"27092","88048","2016",8,8,0,152281.2,1567.75,111.125
"27093","88049","2016",1,1,0,38000,507,75
"27094","88050","2016",3,3,0,89500,901.3333,103.6667
"27095","88051","2016",1,1,0,90000,511,176
"27096","88052","2016",1,1,0,38500,381,101
"27097","88053","2016",1,1,0,1e+05,909,110
"27098","88054","2016",4,3,1,122150,1303.25,92
"27099","88058","2016",1,1,0,55000,466,118
"27100","88059","2016",6,6,0,97275,1500.333,80.5
"27101","88061","2016",4,4,0,71750,676.5,111.5
"27102","88063","2016",1,1,0,88500,763,116
"27103","88064","2016",2,2,0,147085,1765.5,62.5
"27104","88066","2016",1,1,0,245000,1008,243
"27105","88068","2016",7,7,0,112742.9,1066.571,104.4286
"27106","88069","2016",1,1,0,52000,416,125
"27107","88070","2016",2,2,0,71850,744.5,90
"27108","88073","2016",1,1,0,125000,1042,120
"27109","88074","2016",1,1,0,40000,331,121
"27110","88075","2016",99,34,65,118593.5,1931.091,65.83838
"27111","88076","2016",6,6,0,108000,1086.167,102.3333
"27112","88077","2016",5,5,0,79600,963.2,81.2
"27113","88078","2016",23,19,4,88965.22,880.8696,109.6522
"27114","88079","2016",14,14,0,125296.4,1140.929,117.0714
"27115","88081","2016",14,12,2,108136.8,1263.643,89.57143
"27116","88082","2016",9,9,0,101611.1,905.1111,109.1111
"27117","88083","2016",2,2,0,110000,1060.5,103.5
"27118","88084","2016",3,3,0,116423.3,1025.667,114.3333
"27119","88085","2016",2,2,0,47500,1207.5,41.5
"27120","88086","2016",5,5,0,147140,1305.8,113
"27121","88087","2016",36,19,17,127905.6,1216.806,100.4722
"27122","88088","2016",6,6,0,84533.33,874.1667,100.3333
"27123","88089","2016",9,9,0,89844.44,939,93.22222
"27124","88090","2016",23,20,3,120470.2,1172.696,107.2609
"27125","88091","2016",5,5,0,99000,1249.8,83.8
"27126","88092","2016",5,5,0,92200,898.6,95.2
"27127","88094","2016",9,5,4,90152.22,1033.667,83.44444
"27128","88095","2016",12,11,1,69554.17,680.8333,93.25
"27129","88097","2016",1,1,0,75000,938,80
"27130","88098","2016",4,4,0,100662.5,1770.25,62
"27131","88099","2016",12,7,5,91366.67,1069.5,84.75
"27132","88101","2016",11,8,3,118336.4,1091.455,111.2727
"27133","88103","2016",1,1,0,130000,802,162
"27134","88104","2016",2,2,0,48250,762,59
"27135","88105","2016",5,5,0,43200,450.8,98.8
"27136","88106","2016",18,18,0,129318.9,1634.722,85.11111
"27137","88108","2016",6,6,0,76416.67,758.8333,99
"27138","88109","2016",2,2,0,126500,977.5,117.5
"27139","88110","2016",2,2,0,46350,505.5,92.5
"27140","88111","2016",2,2,0,103500,1043.5,99.5
"27141","88113","2016",1,1,0,95000,625,152
"27142","88114","2016",23,16,7,99482.61,976.2609,98.13043
"27143","88115","2016",18,16,2,122221.6,1450.222,92.61111
"27144","88116","2016",32,26,6,94848.53,1128.844,94.0625
"27145","88117","2016",2,2,0,87000,780,109.5
"27146","88118","2016",6,6,0,115266.7,940.8333,126.8333
"27147","88119","2016",1,1,0,35000,412,85
"27148","88120","2016",7,7,0,47142.86,484.5714,92.85714
"27149","88121","2016",1,1,0,35000,461,76
"27150","88122","2016",2,2,0,67500,625,110
"27151","88123","2016",2,2,0,143750,2749,56.5
"27152","88124","2016",3,2,1,72531.67,808.6667,91.33333
"27153","88126","2016",14,12,2,138782.1,1409.143,97.64286
"27154","88128","2016",3,3,0,112966.7,1248.333,88
"27155","88130","2016",1,1,0,126000,1299,97
"27156","88131","2016",2,2,0,127000,2605,68
"27157","88132","2016",12,12,0,151695.8,1559.667,98.58333
"27158","88133","2016",2,2,0,134000,1137.5,133.5
"27159","88134","2016",4,4,0,164850,1562,107
"27160","88135","2016",8,7,1,146525,1145.625,130.875
"27161","88136","2016",9,8,1,124888.9,1256.444,99.22222
"27162","88137","2016",1,1,0,105000,700,150
"27163","88138","2016",1,1,0,69100,576,120
"27164","88139","2016",3,3,0,87931.67,1062.667,79.33333
"27165","88140","2016",4,4,0,104500,1065.75,96.5
"27166","88143","2016",3,3,0,120633.3,1032,114.3333
"27167","88145","2016",2,2,0,44000,970,48.5
"27168","88146","2016",1,1,0,118750,1089,109
"27169","88147","2016",4,4,0,133000,960.75,133.5
"27170","88148","2016",18,17,1,139361.1,1237.889,110.5
"27171","88151","2016",5,5,0,88440,989.2,85.8
"27172","88152","2016",3,3,0,125666.7,1101,104
"27173","88154","2016",3,3,0,87653.33,566.3333,151
"27174","88156","2016",1,1,0,115000,975,118
"27175","88157","2016",3,3,0,81916.67,1053.333,82
"27176","88158","2016",22,14,8,123305.7,1283.227,100.7273
"27177","88159","2016",3,3,0,97900,997.6667,98
"27178","88160","2016",367,157,210,99516.8,1162.371,85.23433
"27179","88161","2016",4,4,0,33275,431.5,78
"27180","88163","2016",10,10,0,169495,1335.1,124.7
"27181","88164","2016",1,1,0,89700,4485,20
"27182","88165","2016",27,22,5,100004.5,1117.074,90.33333
"27183","88166","2016",5,5,0,164734,1431.6,120
"27184","88167","2016",1,1,0,184000,1260,146
"27185","88169","2016",3,3,0,184066.7,1512.333,124
"27186","88170","2016",4,4,0,108500,1269,108.75
"27187","88172","2016",3,3,0,108000,1047.333,107.3333
"27188","88173","2016",2,2,0,197840,1678.5,112.5
"27189","88175","2016",3,3,0,152850,1519,98
"27190","88176","2016",8,8,0,77156.88,752.125,106.375
"27191","88177","2016",2,2,0,172500,1706,101
"27192","88178","2016",20,19,1,152202.8,1365,110.7
"27193","88181","2016",32,24,8,100029.4,1163.75,85.96875
"27194","88183","2016",2,2,0,224900,1355.5,168
"27195","88184","2016",4,4,0,129500,1104.5,115.75
"27196","88185","2016",1,1,0,98000,676,145
"27197","88188","2016",18,17,1,110740,1284.944,103.8333
"27198","88189","2016",1,1,0,60000,458,131
"27199","88193","2016",1,1,0,117000,2250,52
"27200","88195","2016",2,2,0,58500,449.5,156
"27201","88196","2016",200,82,118,147883.3,1989.325,78.135
"27202","88197","2016",2,2,0,180500,1388.5,133.5
"27203","88198","2016",7,6,1,149817.1,1639.714,96.14286
"27204","88201","2016",7,7,0,125357.1,961,120.1429
"27205","88202","2016",1,1,0,65000,1000,65
"27206","88205","2016",2,2,0,95500,804,115
"27207","88206","2016",9,9,0,89944.44,780.2222,126.2222
"27208","88209","2016",67,45,22,123333.4,1347.239,93.89552
"27209","88210","2016",3,3,0,123700,807.6667,132
"27210","88212","2016",3,3,0,50300,484,101.3333
"27211","88213","2016",2,2,0,53500,894.5,60.5
"27212","88214","2016",2,2,0,62750,851,71.5
"27213","88216","2016",5,5,0,99960,1267.2,94
"27214","88218","2016",24,21,3,111412.5,1002.625,112.0833
"27215","88220","2016",1,1,0,30000,375,80
"27216","88221","2016",4,4,0,43358.75,683,70.25
"27217","88223","2016",1,1,0,50000,417,120
"27218","88224","2016",2,2,0,191600,1104,174.5
"27219","88225","2016",15,14,1,142195.5,1244,114.4
"27220","88226","2016",1,1,0,112000,1556,72
"27221","88231","2016",3,3,0,145273.3,1435,108.6667
"27222","88233","2016",3,3,0,112666.7,1295,85.66667
"27223","88238","2016",1,1,0,107000,738,145
"27224","88240","2016",2,1,1,115500,874,132.5
"27225","88243","2016",3,3,0,74733.33,920.3333,70.33333
"27226","88244","2016",2,2,0,154375,1376,114.5
"27227","88245","2016",4,3,1,101616.2,1068.25,94
"27228","88246","2016",3,2,1,113233.3,957.3333,114.3333
"27229","88247","2016",9,9,0,103338.9,1085.778,96.44444
"27230","88248","2016",1,1,0,275000,1964,140
"27231","88250","2016",3,3,0,134200,1165.667,122.6667
"27232","88251","2016",9,9,0,115011.1,1140.333,105
"27233","88253","2016",10,8,2,114090,1301.5,97.7
"27234","88256","2016",3,3,0,107166.7,1329.667,81
"27235","88257","2016",2,2,0,72500,750,80
"27236","88258","2016",5,4,1,71221,715,105.8
"27237","88259","2016",3,3,0,42666.67,535,80.33333
"27238","88261","2016",5,5,0,111430,1216.8,94.6
"27239","88262","2016",6,4,2,83975,838.1667,100.8333
"27240","88263","2016",1,1,0,115800,1930,60
"27241","88264","2016",2,2,0,68250,898,76
"27242","88266","2016",5,4,1,59800,768,79.2
"27243","88267","2016",4,4,0,65325,703.25,90.75
"27244","88269","2016",5,3,2,156600,2380,68.6
"27245","88270","2016",10,9,1,78390,770.5,105.4
"27246","88271","2016",3,2,1,112166.7,1299.333,95.66667
"27247","88272","2016",2,2,0,90700,825,135
"27248","88273","2016",2,2,0,190425,1174,159
"27249","88274","2016",1,1,0,60000,638,94
"27250","88275","2016",3,3,0,84533.33,933,95
"27251","88276","2016",7,6,1,114535.7,1330.714,96.28571
"27252","88277","2016",1,1,0,61700,709,87
"27253","88280","2016",1,1,0,90000,818,110
"27254","88281","2016",5,5,0,112408,1035.6,104.8
"27255","88283","2016",1,1,0,53000,461,115
"27256","88284","2016",3,3,0,123000,926,122
"27257","88285","2016",1,1,0,186000,2000,93
"27258","88288","2016",1,1,0,42000,506,83
"27259","88289","2016",5,5,0,77180,696,113.2
"27260","88291","2016",1,1,0,85000,702,121
"27261","88292","2016",3,3,0,60860,697,88.66667
"27262","88294","2016",1,1,0,185250,1799,103
"27263","88301","2016",5,5,0,84136,631.4,131
"27264","88302","2016",15,14,1,116100,1451.8,91.8
"27265","88304","2016",25,19,6,88452,1120.4,83.44
"27266","88305","2016",1,1,0,50000,500,100
"27267","88306","2016",1,1,0,114800,3827,30
"27268","88307","2016",2,2,0,25750,466,55
"27269","88308","2016",4,4,0,77000,670.75,115.25
"27270","88309","2016",2,2,0,122375,971,119
"27271","88310","2016",12,12,0,61166.67,645.0833,96
"27272","88313","2016",2,2,0,158000,1070,146.5
"27273","88315","2016",5,5,0,82802,802.2,98.8
"27274","88317","2016",6,4,2,68625,873.3333,73.66667
"27275","88318","2016",2,2,0,82765,810.5,106
"27276","88319","2016",29,26,3,96040,1060.759,88.72414
"27277","88320","2016",11,11,0,166886.2,1339.636,129.1818
"27278","88321","2016",42,36,6,111790.2,942.7143,122.8333
"27279","88322","2016",2,2,0,70500,993,74.5
"27280","88324","2016",2,2,0,71000,1187.5,68
"27281","88325","2016",1,1,0,139000,1178,118
"27282","88326","2016",1,1,0,60000,833,72
"27283","88327","2016",9,9,0,95205.56,1003,98.22222
"27284","88328","2016",3,2,1,119483.3,1614,93
"27285","88331","2016",1,1,0,47000,522,90
"27286","88332","2016",1,1,0,70000,778,90
"27287","88334","2016",1,1,0,40000,513,78
"27288","88335","2016",1,1,0,39000,1083,36
"27289","88340","2016",3,3,0,129166.7,1568.667,79
"27290","88341","2016",9,9,0,101605.6,935.1111,111
"27291","88342","2016",2,2,0,106500,870,127
"27292","88346","2016",4,4,0,107775,1137.75,97.5
"27293","88347","2016",3,3,0,56666.67,590.6667,96.33333
"27294","88348","2016",1,1,0,135000,964,140
"27295","88349","2016",26,20,6,73819.27,1107.846,70.92308
"27296","88351","2016",14,12,2,101107.1,1155.5,103.0714
"27297","88353","2016",1,1,0,70000,761,92
"27298","88354","2016",1,1,0,141000,1195,118
"27299","88355","2016",10,10,0,91590,962,92.9
"27300","88356","2016",6,6,0,89189.67,982.8333,96
"27301","88357","2016",5,4,1,116560,1051.6,111
"27302","88358","2016",16,14,2,120312.5,1112.5,114.8125
"27303","88359","2016",1,1,0,160000,994,161
"27304","88360","2016",1,1,0,40000,519,77
"27305","88361","2016",13,13,0,93983.08,1064.385,95.84615
"27306","88362","2016",1,1,0,85000,1308,65
"27307","88363","2016",2,2,0,89000,1086,87.5
"27308","88364","2016",3,3,0,47940,634.6667,76.66667
"27309","88365","2016",1,1,0,104500,1866,56
"27310","88366","2016",1,1,0,55000,514,107
"27311","88367","2016",44,42,2,99254.93,868.6136,112.1591
"27312","88369","2016",16,15,1,96563.12,996.9375,101.8125
"27313","88371","2016",11,11,0,134909.1,1327.273,120.5455
"27314","88372","2016",59,49,10,86304.97,945.8475,89.86441
"27315","88373","2016",3,3,0,65833.33,672.3333,108
"27316","88376","2016",2,2,0,128365,984.5,115
"27317","88377","2016",1,1,0,55000,611,90
"27318","88378","2016",1,1,0,93595,704,133
"27319","88379","2016",4,4,0,97212.5,771.75,148
"27320","88380","2016",5,5,0,103400,1118.8,98.2
"27321","88381","2016",4,3,1,59875,668.25,87.75
"27322","88383","2016",78,28,50,101013.4,1165.013,86.96154
"27323","88385","2016",5,5,0,86600,713,113.8
"27324","88387","2016",3,3,0,46333.33,437.3333,110
"27325","88389","2016",1,1,0,60000,750,80
"27326","88391","2016",8,7,1,118305,1418.5,107.625
"27327","88393","2016",4,4,0,126500,1117,115
"27328","88395","2016",2,2,0,63700,787.5,81.5
"27329","88398","2016",2,2,0,1e+05,1632.5,81
"27330","88399","2016",1,1,0,91500,810,113
"27331","88400","2016",2,2,0,90150,751.5,131.5
"27332","88401","2016",3,3,0,104000,1015.667,100.6667
"27333","88402","2016",1,1,0,75000,714,105
"27334","88407","2016",3,3,0,32666.67,433,71.66667
"27335","88408","2016",32,28,4,111728.3,1096.5,106.9062
"27336","88409","2016",16,14,2,110812.5,1045.188,111.75
"27337","88410","2016",2,2,0,46359.5,418.5,109.5
"27338","88412","2016",2,2,0,91875,1000.5,75.5
"27339","88413","2016",174,83,91,98417.19,1022.632,96.41954
"27340","88415","2016",26,18,8,103602.7,1134.769,92.23077
"27341","88417","2016",2,2,0,60000,653.5,92
"27342","88418","2016",2,2,0,40500,691,58.5
"27343","88423","2016",18,15,3,111453.9,1196,97.05556
"27344","88424","2016",21,20,1,129252.4,1299,100.7619
"27345","88425","2016",2,2,0,65000,519.5,124
"27346","88426","2016",11,11,0,127222.7,1266.909,110.1818
"27347","88428","2016",19,17,2,116013.8,1223.316,98.47368
"27348","88429","2016",29,24,5,133494.1,1326.724,102.4828
"27349","88430","2016",1,1,0,48000,676,71
"27350","88431","2016",3,3,0,77756.67,606.3333,141
"27351","88433","2016",1,1,0,45400,378,120
"27352","88434","2016",1,1,0,50000,450,111
"27353","88435","2016",3,3,0,112933.3,1157,86
"27354","88437","2016",1,1,0,88000,800,110
"27355","88438","2016",3,3,0,148166.7,1319.667,109.6667
"27356","88439","2016",11,11,0,116763.6,1562,87.72727
"27357","88440","2016",2,2,0,80250,828,95
"27358","88442","2016",10,6,4,99741.5,1234.4,80.4
"27359","88444","2016",5,5,0,92080,1170.2,85.2
"27360","88445","2016",15,12,3,107123.3,1176.467,91.4
"27361","88446","2016",3,3,0,118611,1218,91.33333
"27362","88447","2016",30,21,9,93291.67,1025.9,95
"27363","88449","2016",2,2,0,128885,711.5,178
"27364","88450","2016",2,2,0,74050,470.5,145
"27365","88451","2016",21,13,8,76771.43,929.9524,80.7619
"27366","88452","2016",4,4,0,80750,892,112
"27367","88456","2016",1,1,0,25000,362,69
"27368","88457","2016",1,1,0,70000,467,150
"27369","88460","2016",4,4,0,174487.5,892.25,189
"27370","88461","2016",2,2,0,151750,1118.5,134.5
"27371","88462","2016",22,17,5,134262.4,1398.773,104.2727
"27372","88463","2016",13,13,0,125562.3,1245.231,108.2308
"27373","88464","2016",6,5,1,144500,1534,98
"27374","88465","2016",107,77,30,99523.55,1145.916,86.84112
"27375","88466","2016",1,1,0,160000,1778,90
"27376","88467","2016",4,3,1,167500,2079.25,85
"27377","88468","2016",25,21,4,88324.4,938.2,95.68
"27378","88469","2016",1,1,0,93400,1004,93
"27379","88470","2016",24,16,8,118216.7,1867.583,71.25
"27380","88472","2016",2,2,0,196500,1705.5,115
"27381","88473","2016",2,2,0,36800,433.5,85.5
"27382","88475","2016",2,2,0,125460,585,219
"27383","88476","2016",1,1,0,40000,444,90
"27384","88477","2016",1,1,0,60293,407,148
"27385","88478","2016",1,1,0,90000,874,103
"27386","88479","2016",3,3,0,56330,630,90
"27387","88481","2016",8,7,1,140118.8,1219.125,116.625
"27388","88482","2016",1,1,0,28500,339,84
"27389","88483","2016",16,16,0,150136.9,1499.375,102.4375
"27390","88484","2016",12,12,0,104173.6,922.8333,115.4167
"27391","88486","2016",19,13,6,113957.9,1355.421,85.42105
"27392","88487","2016",28,27,1,100064.8,1092.321,95.39286
"27393","88488","2016",3,3,0,85000,597.3333,139.6667
"27394","88490","2016",1,1,0,157000,1402,112
"27395","88491","2016",1,1,0,30000,429,70
"27396","88493","2016",1,1,0,115000,1085,106
"27397","88494","2016",1,1,0,55000,705,78
"27398","88495","2016",1,1,0,174000,1596,109
"27399","88496","2016",5,5,0,110400,785,140.8
"27400","88497","2016",7,7,0,103500,830.5714,112.4286
"27401","88498","2016",4,2,2,79525,851.75,106
"27402","88499","2016",1,1,0,108420,834,130
"27403","88500","2016",20,15,5,132117,1698.7,88.2
"27404","88501","2016",2,2,0,169500,1638,101.5
"27405","88503","2016",1,1,0,48000,814,59
"27406","88504","2016",2,2,0,57500,433.5,134.5
"27407","88505","2016",2,2,0,82000,1538.5,72.5
"27408","88506","2016",1,1,0,108000,1161,93
"27409","88508","2016",6,6,0,95850,926.3333,106.1667
"27410","88509","2016",1,1,0,194400,1296,150
"27411","88512","2016",1,1,0,79000,1317,60
"27412","88513","2016",19,17,2,100457.9,1198.211,82.47368
"27413","88514","2016",1,1,0,77000,885,87
"27414","88515","2016",4,4,0,75510,642.75,119
"27415","88516","2016",72,47,25,104650.8,1112.861,96.94444
"27416","88519","2016",6,6,0,93250,1041.5,90.66667
"27417","88521","2016",2,2,0,70400,878,73
"27418","88524","2016",3,3,0,103000,807,125.3333
"27419","88525","2016",2,2,0,114000,1418,79.5
"27420","88526","2016",6,6,0,79833.33,764.5,104.6667
"27421","88527","2016",2,2,0,107500,606,177.5
"27422","88528","2016",4,3,1,152187.5,871.25,156.25
"27423","88529","2016",2,2,0,60000,633,83
"27424","88530","2016",19,19,0,108378.9,1037.789,115.1053
"27425","88531","2016",41,22,19,121780,1748.22,70.60976
"27426","88532","2016",1,1,0,50000,595,84
"27427","89002","2016",1,1,0,165000,1542,107
"27428","89003","2016",36,35,1,130240,1291.167,102.8611
"27429","89004","2016",2,2,0,66667,791.5,83.5
"27430","89005","2016",11,11,0,62145.55,761,85.90909
"27431","89007","2016",9,9,0,81555.56,785.6667,101.4444
"27432","89008","2016",3,3,0,86333.33,888,88.66667
"27433","89009","2016",2,2,0,149000,1273.5,113.5
"27434","89010","2016",1,1,0,45000,1071,42
"27435","89011","2016",1,1,0,80000,3077,26
"27436","89012","2016",1,1,0,68000,680,100
"27437","89013","2016",38,37,1,128863.3,1362.526,97.31579
"27438","89014","2016",11,11,0,110981.9,1173.818,94.81818
"27439","89015","2016",14,13,1,64668.57,917.7857,73.92857
"27440","89017","2016",5,5,0,78300,901.8,81.8
"27441","89018","2016",17,17,0,114582.6,1144.118,106.3529
"27442","89019","2016",2,2,0,45500,557.5,82.5
"27443","89020","2016",3,3,0,57333.33,785.6667,79
"27444","89021","2016",3,3,0,83166.67,783.6667,118.3333
"27445","89023","2016",8,7,1,128712.5,1463.875,86.625
"27446","89024","2016",426,198,228,119637.2,1517.075,79.78169
"27447","89025","2016",62,44,18,105629.6,1251.194,84.83871
"27448","89027","2016",6,6,0,104333.3,992,108.8333
"27449","89028","2016",2,2,0,154500,1153.5,138.5
"27450","89029","2016",9,9,0,120105.6,1170.111,104.1111
"27451","89030","2016",6,5,1,114133.3,985.8333,101.6667
"27452","89031","2016",5,4,1,81400,1017.2,85.8
"27453","89033","2016",3,3,0,136666.7,1270,108.3333
"27454","89034","2016",2,2,0,152700,974,152.5
"27455","89035","2016",4,4,0,120450,1267,100
"27456","89036","2016",3,3,0,108333.3,1422,76
"27457","89037","2016",8,8,0,113425,1186.125,108.125
"27458","89040","2016",2,2,0,47500,902.5,46.5
"27459","89041","2016",4,4,0,106625,1245.25,83.75
"27460","89042","2016",1,1,0,75000,1087,69
"27461","89043","2016",1,1,0,122000,865,141
"27462","89045","2016",6,6,0,119718.8,1116.833,118
"27463","89046","2016",18,18,0,98330.56,1095.833,91.33333
"27464","89048","2016",9,9,0,125644.4,991.3333,133.5556
"27465","89050","2016",10,10,0,113054.5,1320.3,89.4
"27466","89051","2016",5,5,0,125400,2263.8,59.6
"27467","89053","2016",6,6,0,138750,1077.667,131.1667
"27468","89054","2016",13,13,0,144877.5,1570.846,97.38462
"27469","89055","2016",20,19,1,82675,1093.75,78.3
"27470","89056","2016",4,4,0,110500,1505.5,74.25
"27471","89057","2016",3,3,0,105333.3,1083.667,88.66667
"27472","89058","2016",1,1,0,205000,4100,50
"27473","89059","2016",6,6,0,126584.5,1514.167,89.83333
"27474","89060","2016",2,2,0,133050,1570.5,84.5
"27475","89061","2016",6,6,0,127308.3,983,129
"27476","89062","2016",3,3,0,78333.33,897.3333,93
"27477","89063","2016",17,17,0,109471.8,1167.941,97.82353
"27478","89064","2016",2,2,0,51500,715,72
"27479","89065","2016",1,1,0,170000,1393,122
"27480","89066","2016",13,13,0,104738.5,1098.462,96.07692
"27481","89067","2016",13,13,0,86076.92,1303.462,76.23077
"27482","89068","2016",23,23,0,121158.7,1503.565,86.91304
"27483","89069","2016",6,6,0,89666.67,1359.833,84.5
"27484","89072","2016",4,4,0,93750,880,105
"27485","89073","2016",15,15,0,98080,1262.267,81.33333
"27486","89074","2016",20,20,0,133018,1608.9,86.4
"27487","89075","2016",2,2,0,120200,1608.5,74
"27488","89076","2016",6,6,0,110500,1515,88.83333
"27489","89077","2016",12,12,0,153104.4,1555.333,97.75
"27490","89079","2016",4,4,0,111750,913.25,131
"27491","89080","2016",8,8,0,131000,1258.5,105.5
"27492","89081","2016",1,1,0,65000,929,70
"27493","89083","2016",15,14,1,150348.7,1599.067,98.13333
"27494","89084","2016",4,4,0,88375,801.5,108.75
"27495","89085","2016",9,9,0,129055.6,1527.111,77.55556
"27496","89086","2016",68,67,1,101221.3,1105,94.64706
"27497","89087","2016",2,2,0,45000,846,61
"27498","89088","2016",8,8,0,138343.8,1894.625,78
"27499","89089","2016",1,1,0,63500,488,130
"27500","89091","2016",8,6,2,75750,1001.375,76.375
"27501","89093","2016",9,9,0,109322.2,1548.444,76.88889
"27502","89094","2016",13,13,0,129258.5,1381.308,101.8462
"27503","89095","2016",7,7,0,86857.14,1166,67.28571
"27504","89096","2016",6,6,0,143833.3,1443,105
"27505","89098","2016",1,1,0,50000,685,73
"27506","89099","2016",18,18,0,102298.3,1339.833,78.88889
"27507","89100","2016",28,26,2,139450,1539.071,96.64286
"27508","89101","2016",6,6,0,89266.67,887.6667,97.33333
"27509","89102","2016",31,31,0,152643.7,1417,107.1935
"27510","89104","2016",7,7,0,79728.57,1028.714,92
"27511","89105","2016",1,1,0,105000,905,116
"27512","89108","2016",9,9,0,120194.4,1066.111,111.3333
"27513","89111","2016",3,3,0,129333.3,1243.667,108
"27514","89112","2016",3,3,0,105780,1097.667,98.66667
"27515","89113","2016",8,8,0,131162.5,1525.375,91.375
"27516","89115","2016",2,2,0,145000,1405.5,107.5
"27517","89116","2016",7,7,0,110513.7,1057.571,111.5714
"27518","89117","2016",2,2,0,147500,1071,136
"27519","89118","2016",10,10,0,128950,1246.2,96.1
"27520","89119","2016",6,6,0,123833.3,919.8333,124.5
"27521","89120","2016",2,2,0,65000,710,88
"27522","89122","2016",4,4,0,114000,870,142.75
"27523","89123","2016",2,2,0,62500,702.5,89
"27524","89124","2016",19,19,0,163965.8,1645.895,109.7368
"27525","89125","2016",13,13,0,79384.62,852.2308,99.38462
"27526","89127","2016",12,12,0,151758.3,1295.25,116.6667
"27527","89128","2016",3,3,0,73666.67,1139.333,62
"27528","89129","2016",5,5,0,65340,916.6,76.2
"27529","89130","2016",13,13,0,106626.9,1083.385,104.6154
"27530","89131","2016",6,6,0,79183.33,834.6667,85.66667
"27531","89132","2016",1,1,0,83000,1025,81
"27532","89133","2016",5,5,0,97000,1323.6,76.6
"27533","89134","2016",6,6,0,109166.7,1095.333,103.3333
"27534","89136","2016",7,7,0,180000,1575.429,120.7143
"27535","89137","2016",6,6,0,129966.7,1004.667,139.8333
"27536","89139","2016",10,10,0,147605.8,1334.7,110.7
"27537","89141","2016",2,2,0,66435,926,69
"27538","89142","2016",13,13,0,105610.5,1655.462,76
"27539","89143","2016",5,5,0,137600,1256,110.2
"27540","89144","2016",13,12,1,133557.7,1146.538,120.5385
"27541","89145","2016",4,4,0,34700,720.5,47.5
"27542","89146","2016",1,1,0,25000,439,57
"27543","89147","2016",1,1,0,35000,461,76
"27544","89148","2016",7,7,0,92428.57,899.5714,106.8571
"27545","89149","2016",1,1,0,32000,533,60
"27546","89150","2016",4,4,0,138500,1115,124.25
"27547","89151","2016",9,9,0,132666.7,1114.222,118.5556
"27548","89152","2016",13,13,0,101230.8,1431.154,72.53846
"27549","89153","2016",4,4,0,132641.8,1290.5,103.75
"27550","89154","2016",14,14,0,127733.6,1309.643,95.85714
"27551","89155","2016",11,11,0,165712.6,1609.909,104.1818
"27552","89156","2016",3,3,0,88666.67,1065.333,83
"27553","89158","2016",12,12,0,93166.67,1090.333,94.08333
"27554","89159","2016",5,5,0,97600,1039.4,99.2
"27555","89160","2016",6,6,0,139166.7,1429.167,96.16667
"27556","89161","2016",3,3,0,105200,1087,101
"27557","89162","2016",4,4,0,99000,1088.25,95.25
"27558","89163","2016",7,7,0,125857.1,1189.143,111
"27559","89167","2016",7,7,0,124994.3,1210,113.7143
"27560","89168","2016",1,1,0,55000,598,92
"27561","89169","2016",7,7,0,134428.6,978.7143,129.8571
"27562","89170","2016",2,2,0,107700,1024.5,103.5
"27563","89172","2016",6,6,0,195166.7,1686.667,120.8333
"27564","89173","2016",12,12,0,105278.3,1078.5,104.5833
"27565","89176","2016",1,1,0,215000,1748,123
"27566","89177","2016",1,1,0,47000,681,69
"27567","89179","2016",4,4,0,71000,951.5,78.5
"27568","89180","2016",5,5,0,166000,1421.8,116.4
"27569","89181","2016",1,1,0,117500,955,123
"27570","89182","2016",4,4,0,49500,581.25,83.75
"27571","89184","2016",1,1,0,30000,411,73
"27572","89186","2016",3,3,0,98333.33,986,100
"27573","89187","2016",4,4,0,75875,849,107
"27574","89188","2016",4,4,0,81875,1057,78.75
"27575","89189","2016",6,6,0,153216.7,1929.333,86.83333
"27576","89190","2016",1,1,0,77000,1167,66
"27577","89191","2016",2,2,0,102350,945.5,112.5
"27578","89194","2016",1,1,0,60000,1000,60
"27579","89195","2016",6,6,0,128852.5,1539.333,88.83333
"27580","89196","2016",12,12,0,101519.6,1053.833,99.25
"27581","89197","2016",6,6,0,84220,941.1667,96.16667
"27582","89198","2016",20,20,0,132449,1530.15,86.4
"27583","89199","2016",3,3,0,106333.3,1241.333,87.66667
"27584","89200","2016",5,5,0,119600,1069.4,122
"27585","89201","2016",27,27,0,120146.7,1388.222,86.96296
"27586","89202","2016",4,4,0,106250,1156.5,92.75
"27587","89203","2016",2,2,0,1e+05,1451.5,66
"27588","89204","2016",10,10,0,97100,1088.4,91.8
"27589","89205","2016",4,4,0,91250,1050.5,87.25
"27590","89206","2016",78,67,11,106803.8,1341.077,84.73077
"27591","89208","2016",5,5,0,87284,1030,73.2
"27592","89209","2016",6,6,0,123333.3,1411.5,88.16667
"27593","89210","2016",1,1,0,50000,595,84
"27594","89212","2016",5,5,0,117400,1113.2,103.6
"27595","89214","2016",2,2,0,77000,1049.5,73
"27596","89215","2016",1,1,0,66500,747,89
"27597","89216","2016",2,2,0,46850,997,47
"27598","89217","2016",2,2,0,89000,1508.5,59.5
"27599","89218","2016",17,15,2,78204.71,1123,72.29412
"27600","89219","2016",1,1,0,80000,1026,78
"27601","89220","2016",4,4,0,50750,795.75,73
"27602","89221","2016",7,7,0,115642.9,1082,122.7143
"27603","89222","2016",1,1,0,127000,992,128
"27604","89223","2016",5,5,0,71700,745.4,97.8
"27605","89224","2016",1,1,0,130000,929,140
"27606","89225","2016",1,1,0,84000,1200,70
"27607","89226","2016",1,1,0,36100,420,86
"27608","89227","2016",13,13,0,154165.5,1574.154,84.53846
"27609","89228","2016",21,21,0,165580.2,1418.524,124.7143
"27610","89229","2016",7,7,0,106000,1745,62
"27611","89230","2016",3,3,0,116333.3,1263.667,103.6667
"27612","89232","2016",4,4,0,73250,974.75,65.25
"27613","89233","2016",2,2,0,40000,861,47.5
"27614","89234","2016",3,3,0,77000,1094.333,68.66667
"27615","89235","2016",9,9,0,81230,1197.111,71.88889
"27616","89236","2016",3,3,0,138720,1419.333,97.33333
"27617","89237","2016",7,7,0,100785.7,1280.571,79.57143
"27618","89238","2016",6,6,0,76169,919.8333,88
"27619","89239","2016",15,15,0,135354,1380.133,101.4
"27620","89240","2016",6,6,0,116616,1182.333,95.83333
"27621","89242","2016",2,2,0,46500,886.5,53
"27622","89244","2016",2,2,0,117000,1212,99.5
"27623","89245","2016",9,9,0,106083.3,1080.444,103.6667
"27624","89246","2016",2,2,0,46000,648.5,71
"27625","89247","2016",3,3,0,70650,477.6667,144
"27626","89249","2016",2,2,0,117032.5,948,122.5
"27627","89250","2016",3,3,0,102666.7,1077,105.6667
"27628","89251","2016",7,7,0,131061.4,1185.571,116
"27629","89252","2016",3,3,0,96004.67,1242.333,75.33333
"27630","89253","2016",2,2,0,95250,952,77
"27631","89254","2016",10,10,0,76615,982.9,77.2
"27632","89255","2016",21,21,0,136794.5,1377.857,101.7143
"27633","89256","2016",7,7,0,107607.1,1153.857,86.71429
"27634","89257","2016",56,44,12,85395,1235.589,74.41071
"27635","89259","2016",1,1,0,75000,466,161
"27636","89261","2016",1,1,0,115000,1983,58
"27637","89262","2016",1,1,0,155200,784,198
"27638","89263","2016",39,39,0,173836.1,1663.923,103.4103
"27639","89264","2016",15,15,0,142166.7,1265.533,116.2
"27640","89265","2016",9,9,0,164894.4,1879.222,117.8889
"27641","89266","2016",2,2,0,46500,792.5,52
"27642","89267","2016",1,1,0,54000,730,74
"27643","89268","2016",8,8,0,104950,1072.5,103
"27644","89271","2016",1,1,0,122000,1052,116
"27645","89272","2016",3,3,0,112233.3,1302,85.33333
"27646","89273","2016",5,5,0,103400,867.8,124.6
"27647","89274","2016",18,18,0,164461.9,1482.333,114.7222
"27648","89276","2016",3,3,0,107333.3,1117.667,95
"27649","89277","2016",5,5,0,116200,2906.4,54
"27650","89278","2016",7,6,1,126642.9,1409.714,96.57143
"27651","89279","2016",5,5,0,81400,877.4,106.6
"27652","89280","2016",3,3,0,63333.33,835.6667,72.66667
"27653","89281","2016",5,5,0,134880,1212.8,101.4
"27654","89282","2016",10,10,0,125385,1579.4,82.2
"27655","89283","2016",7,6,1,115571.4,1142.286,114.5714
"27656","89285","2016",3,3,0,106000,1653.333,67
"27657","89286","2016",16,16,0,108452.1,1101.062,107.25
"27658","89287","2016",45,38,7,134483,1586.556,84.44444
"27659","89288","2016",2,2,0,81500,1054,66
"27660","89289","2016",3,3,0,118140.3,1291.667,101.3333
"27661","89291","2016",1,1,0,22500,336,67
"27662","89292","2016",2,2,0,162500,1397.5,116
"27663","89295","2016",8,8,0,152991.9,1484,103.75
"27664","89296","2016",2,2,0,86000,1225,69
"27665","89297","2016",1,1,0,110000,1058,104
"27666","89298","2016",6,6,0,110539.8,1160.667,97.5
"27667","89300","2016",2,2,0,61000,700.5,88
"27668","89302","2016",2,2,0,151950,1086,128.5
"27669","89303","2016",3,3,0,87059.33,1148.333,78
"27670","89304","2016",11,11,0,113997.6,1567.545,86.72727
"27671","89306","2016",1,1,0,40000,500,80
"27672","89307","2016",4,4,0,91500,1228.5,74
"27673","89308","2016",1,1,0,152000,1178,129
"27674","89309","2016",32,31,1,109109.4,1449.281,77.21875
"27675","89310","2016",3,3,0,122333.3,1427.333,91.33333
"27676","89311","2016",13,13,0,136634.8,1342.308,103.3077
"27677","89312","2016",3,3,0,102666.7,824,123
"27678","89313","2016",4,4,0,135290,1256.25,110
"27679","89314","2016",3,3,0,99666.67,1356.667,81.33333
"27680","89318","2016",3,3,0,114416.7,969,116.6667
"27681","89319","2016",2,2,0,177210,1630,109
"27682","89321","2016",3,3,0,61833.33,716,83.33333
"27683","89323","2016",2,2,0,144800,1665.5,86.5
"27684","89324","2016",11,11,0,91818.18,1233.636,73.09091
"27685","89325","2016",3,3,0,69000,1102.333,72.66667
"27686","89326","2016",13,13,0,149934.6,1651.077,99.38462
"27687","89327","2016",3,3,0,104633.3,1048.667,100
"27688","89328","2016",3,3,0,397669.7,1775.667,197.6667
"27689","89331","2016",4,4,0,115795,1081,114.75
"27690","89332","2016",8,8,0,154164.5,1589.125,96.875
"27691","89334","2016",9,9,0,123263.6,1353.444,95.44444
"27692","89335","2016",5,5,0,73708,1017.4,77
"27693","89336","2016",3,3,0,110000,957,115.6667
"27694","89337","2016",11,11,0,120320,1286.091,94.27273
"27695","89338","2016",30,25,5,145516.7,1792.433,82.46667
"27696","89339","2016",2,2,0,123500,910.5,125
"27697","89341","2016",5,5,0,97880,1222.6,87
"27698","89342","2016",7,6,1,129328.6,1480.429,87.85714
"27699","89344","2016",10,10,0,75600,881.8,87.3
"27700","89345","2016",37,30,7,80729.73,969.2432,82.35135
"27701","89346","2016",46,39,7,154107.7,1670.543,91.80435
"27702","89347","2016",1,1,0,1e+05,1250,80
"27703","89348","2016",29,29,0,112322.4,1241.241,94.27586
"27704","89349","2016",5,5,0,97000,1070,89.4
"27705","89350","2016",2,2,0,126000,1020,128
"27706","89351","2016",6,6,0,84466.67,882.1667,93.33333
"27707","89352","2016",4,4,0,101500,742,131.5
"27708","89353","2016",3,3,0,125166.7,1079,131.6667
"27709","89354","2016",17,17,0,121061.1,1555.294,77.82353
"27710","89355","2016",1,1,0,87000,791,110
"27711","89359","2016",3,3,0,120000,881.3333,135.3333
"27712","89360","2016",4,4,0,129500,1690.75,92.75
"27713","89361","2016",3,3,0,105333.3,1221.667,95.33333
"27714","89362","2016",7,7,0,75095.29,892,90.28571
"27715","89363","2016",3,3,0,89866.67,914,94
"27716","89364","2016",6,6,0,74583.33,961.5,87.33333
"27717","89365","2016",6,6,0,125416.7,1150.667,117.8333
"27718","89367","2016",10,10,0,97250,1170.4,94.7
"27719","89368","2016",13,12,1,76615.38,891.3077,89
"27720","89369","2016",7,7,0,145928.6,1257.286,119.8571
"27721","89370","2016",22,19,3,109977.3,1311.091,87.72727
"27722","89371","2016",2,2,0,47500,514.5,93.5
"27723","89373","2016",7,7,0,141100,1502.286,99.85714
"27724","89374","2016",1,1,0,150000,1531,98
"27725","89376","2016",2,2,0,65250,790.5,82.5
"27726","89378","2016",7,7,0,113338.9,1185,94
"27727","89380","2016",22,10,12,145522,2654.864,56.59091
"27728","89382","2016",19,19,0,123318.4,1279.789,93.21053
"27729","89384","2016",6,6,0,108904.7,1160,103.1667
"27730","89385","2016",1,1,0,460000,8364,55
"27731","89386","2016",2,2,0,20000,416.5,48
"27732","89387","2016",279,129,150,117942.8,1531.194,78.50896
"27733","89388","2016",3,3,0,85000,1088.667,83
"27734","89390","2016",6,6,0,195400,1635.333,139.1667
"27735","89391","2016",13,13,0,124269.2,1455.231,88.38462
"27736","89392","2016",4,4,0,65000,714,95
"27737","89393","2016",2,2,0,36700,774.5,67
"27738","89394","2016",3,3,0,69500,970.3333,73.66667
"27739","89395","2016",5,5,0,100900,740.4,133.2
"27740","89397","2016",7,7,0,70700,1032.286,75
"27741","89398","2016",6,6,0,75333.33,1151.167,77
"27742","89399","2016",9,9,0,190431.1,1728.333,111.8889
"27743","89400","2016",3,3,0,99653.33,833.6667,118.3333
"27744","89404","2016",4,4,0,125805,1298.25,94.5
"27745","89405","2016",5,5,0,121000,947.4,121.2
"27746","89407","2016",11,11,0,91495.45,1040.273,89.18182
"27747","89408","2016",4,4,0,86000,1102.75,91.25
"27748","89409","2016",2,2,0,104875,972,119
"27749","89410","2016",2,2,0,125500,1276,98
"27750","89411","2016",10,10,0,137830,1445,97.6
"27751","89414","2016",24,20,4,102171.7,1254.958,80.54167
"27752","89415","2016",1,1,0,119000,626,190
"27753","89416","2016",5,5,0,107600,815.4,135.8
"27754","89418","2016",38,33,5,98029.21,1131.684,86.39474
"27755","89419","2016",22,22,0,117929.2,1361.955,96.54545
"27756","89420","2016",24,23,1,94837.71,1262.292,85.54167
"27757","89422","2016",1,1,0,47000,392,120
"27758","89423","2016",3,3,0,119120,996.3333,118.6667
"27759","89424","2016",2,2,0,110420,1280.5,88.5
"27760","89425","2016",9,9,0,92252.22,1270.556,70.88889
"27761","89426","2016",3,3,0,114666.7,1240.667,92.66667
"27762","89427","2016",7,7,0,162636.7,1495,112
"27763","89428","2016",7,7,0,100500,1359.429,73.42857
"27764","89430","2016",2,2,0,75000,634.5,125.5
"27765","89432","2016",8,8,0,123927.9,1398.125,92.125
"27766","89433","2016",1,1,0,237000,1261,188
"27767","89436","2016",6,6,0,81583.33,966.5,87.16667
"27768","89437","2016",2,2,0,150000,1578,97.5
"27769","89438","2016",11,11,0,125890.9,1281.091,103.6364
"27770","89439","2016",11,11,0,91659.09,1035.182,88.18182
"27771","89440","2016",10,10,0,111000,1275.6,102.3
"27772","89441","2016",17,17,0,91929.41,936.7059,97
"27773","89442","2016",2,2,0,125000,1355.5,90
"27774","89443","2016",17,16,1,134643.2,1622.294,85.41176
"27775","89445","2016",2,2,0,57000,787.5,66.5
"27776","89446","2016",6,5,1,251166.7,1976.667,110.5
"27777","89447","2016",2,2,0,48250,705,70
"27778","89449","2016",21,21,0,147332.3,1679.476,95
"27779","89450","2016",6,6,0,146500,1490.5,106.8333
"27780","89451","2016",3,3,0,112000,653.6667,178
"27781","89452","2016",5,5,0,98720,1068.2,88
"27782","89453","2016",9,9,0,146630.7,1244,115
"27783","89456","2016",9,9,0,152733.3,1634.111,110.8889
"27784","89458","2016",1,1,0,75000,1974,38
"27785","89459","2016",5,5,0,113200,1109.2,105.2
"27786","89460","2016",40,39,1,144244.4,1651.075,93.575
"27787","89461","2016",9,9,0,79335.56,995.4444,79.88889
"27788","89462","2016",3,3,0,124333.3,1025.333,111.6667
"27789","89463","2016",1,1,0,105000,1117,94
"27790","89464","2016",47,43,4,108025.3,1332.383,84.89362
"27791","89465","2016",4,4,0,70500,1200.75,67.5
"27792","89466","2016",4,4,0,100750,1013,102.75
"27793","89467","2016",11,11,0,100509.1,1126.455,90.09091
"27794","89468","2016",4,4,0,74250,1014,72.25
"27795","89469","2016",17,17,0,121737.1,1125.529,111.5882
"27796","89471","2016",3,3,0,131666.7,1298.333,105.6667
"27797","89472","2016",4,4,0,121250,1384,101.25
"27798","89475","2016",1,1,0,40000,500,80
"27799","89478","2016",10,9,1,104950,1308.4,79.4
"27800","89479","2016",3,3,0,160833.3,1109.667,144.6667
"27801","89480","2016",13,13,0,161538.5,1702.923,107.1538
"27802","89481","2016",2,2,0,45000,694.5,71
"27803","89482","2016",1,1,0,70000,972,72
"27804","89483","2016",11,11,0,171636.4,1695,120.0909
"27805","89485","2016",5,5,0,88200,1510.4,66.4
"27806","89486","2016",1,1,0,135000,860,157
"27807","90001","2016",8,7,1,143118.8,1781.75,87.125
"27808","90002","2016",3,3,0,175000,1261,148.6667
"27809","90003","2016",4,3,1,126800,1168,100
"27810","90004","2016",2,1,1,160000,1566,100
"27811","90005","2016",4,4,0,124250,1413.75,83.75
"27812","90006","2016",7,7,0,80285.71,1014,78
"27813","90008","2016",26,19,7,184807,1833.269,105.1538
"27814","90009","2016",41,23,18,114443.7,1127.976,98.80488
"27815","90010","2016",430,74,356,92266.62,1215.914,74.54419
"27816","90011","2016",2,2,0,161500,1338.5,105
"27817","90012","2016",11,11,0,191245.5,1752.455,110.7273
"27818","90013","2016",2,2,0,180000,1637,111
"27819","90014","2016",7,7,0,185276,1798.143,100.4286
"27820","90015","2016",1,1,0,75000,1136,66
"27821","90017","2016",13,10,3,173900,1528.154,114.3077
"27822","90018","2016",3,3,0,240900,1368,173.6667
"27823","90020","2016",1,1,0,130000,1327,98
"27824","90021","2016",4,4,0,221787.5,1788.25,125.75
"27825","90022","2016",27,20,7,114622.2,1285.111,89.85185
"27826","90023","2016",15,12,3,156323.3,1584.933,104.6667
"27827","90024","2016",1,1,0,208500,1256,166
"27828","90025","2016",2,2,0,164500,1375.5,118
"27829","90026","2016",17,13,4,205703.5,1733.588,119.6471
"27830","90028","2016",3,3,0,152326.7,1286.333,124
"27831","90029","2016",13,7,6,175034.6,1598.462,105.9231
"27832","90030","2016",3,3,0,178233.3,1525.333,113
"27833","90032","2016",29,13,16,126017.2,1343.552,93.68966
"27834","90033","2016",40,24,16,121054.5,1341.45,90.95
"27835","90034","2016",7,6,1,155925.7,1571.429,103.4286
"27836","90035","2016",4,3,1,144100,1436.75,102.5
"27837","90037","2016",6,5,1,164100,1650,100
"27838","90039","2016",35,23,12,161454.3,1694.8,98.11429
"27839","90041","2016",21,18,3,148786.2,1528.667,97.04762
"27840","90042","2016",9,9,0,195811.1,1676.667,118.6667
"27841","90043","2016",1,0,1,123500,1328,93
"27842","90044","2016",1,1,0,165000,1179,140
"27843","90045","2016",7,7,0,166885.7,1732.857,95.57143
"27844","90047","2016",2,2,0,219250,1861,120
"27845","90049","2016",10,8,2,183064.6,1580.8,117.1
"27846","90050","2016",5,5,0,164210,1411.2,115.6
"27847","90051","2016",9,6,3,115372.2,1357.444,99.77778
"27848","90052","2016",26,11,15,88682.88,1109.231,85.88462
"27849","90053","2016",21,16,5,149167.1,1368.81,108.0952
"27850","90054","2016",4,4,0,125419,1158.5,105.25
"27851","90055","2016",2,2,0,263500,1591.5,165
"27852","90056","2016",14,13,1,151100,1602.429,97.42857
"27853","90057","2016",8,7,1,192242.4,1723.125,135.125
"27854","90058","2016",6,6,0,153433.3,1275.167,117.5
"27855","90059","2016",1,1,0,278000,1878,148
"27856","90060","2016",1,1,0,155500,1205,129
"27857","90061","2016",1,1,0,175200,1752,100
"27858","90062","2016",5,5,0,164375,1371.6,122.6
"27859","90063","2016",2,1,1,138650,1200,121.5
"27860","90064","2016",5,5,0,180261,1491.2,120.6
"27861","90065","2016",6,6,0,144796.3,1518.5,94.16667
"27862","90066","2016",3,3,0,163666.7,1284,125
"27863","90067","2016",3,3,0,170050,2505.333,84
"27864","90068","2016",6,4,2,171658.3,1909.333,86
"27865","90069","2016",11,8,3,133990.9,1232.091,106.0909
"27866","90071","2016",9,7,2,105722.2,1143.556,93.22222
"27867","90072","2016",5,3,2,128640,1425,87.8
"27868","90074","2016",3,3,0,243400,1649.333,147.6667
"27869","90075","2016",31,23,8,191297,1729.516,110.129
"27870","90076","2016",9,8,1,157133.3,1546,108.6667
"27871","90077","2016",2,2,0,180000,1029,175
"27872","90079","2016",4,4,0,164250,1756,96.75
"27873","90080","2016",4,4,0,141850,1373.75,106
"27874","90081","2016",7,6,1,161927.9,1448.143,109.7143
"27875","90082","2016",2,2,0,147500,1252.5,118
"27876","90083","2016",1,1,0,205000,2135,96
"27877","90084","2016",2,2,0,95750,1278,74
"27878","90085","2016",1,1,0,230000,1456,158
"27879","90087","2016",4,4,0,176125,1766.75,100.75
"27880","90088","2016",6,6,0,126416.7,1425.833,88.16667
"27881","90089","2016",14,10,4,142129.6,1425.571,101.1429
"27882","90090","2016",8,8,0,147439.2,1540,103
"27883","90091","2016",1,1,0,51000,850,60
"27884","90093","2016",5,3,2,132860,1550,88.8
"27885","90094","2016",7,4,3,137407.1,2034.143,74.28571
"27886","90095","2016",7,7,0,167109.3,1458.571,115.2857
"27887","90096","2016",1,1,0,195000,1560,125
"27888","90097","2016",9,5,4,166438.9,1539.778,108.2222
"27889","90099","2016",41,14,27,106151.2,1428.268,73.56098
"27890","90100","2016",1,1,0,80000,615,130
"27891","90101","2016",2,2,0,202500,2034.5,100.5
"27892","90102","2016",4,4,0,107550,1127.25,88.25
"27893","90103","2016",4,2,2,157250,1732,90.75
"27894","90104","2016",4,0,4,96575,1183,86
"27895","91001","2016",3,3,0,221666.7,1536,151
"27896","91017","2016",20,16,4,259270.5,2793,97.55
"27897","91021","2016",125,41,84,188285,3019.328,65.6
"27898","91022","2016",1,1,0,138000,1890,73
"27899","91027","2016",335,138,197,216086.1,3190.501,70.1791
"27900","91035","2016",4,4,0,162000,2271.75,71.5
"27901","91037","2016",2,2,0,343150,2095.5,170.5
"27902","91038","2016",11,11,0,295131.8,2901.182,109.1818
"27903","91041","2016",2,2,0,289430,3139.5,93.5
"27904","91044","2016",37,25,12,320745.9,3534.568,95.10811
"27905","91045","2016",65,57,8,233581.2,2650.969,92.69231
"27906","91047","2016",12,8,4,229291.7,2482.917,100
"27907","91064","2016",40,29,11,467474,4481.25,105.475
"27908","91067","2016",2,2,0,157500,2223.5,75.5
"27909","91069","2016",5,5,0,247640,2357,123.6
"27910","91079","2016",5,5,0,237530,2500.6,102.4
"27911","91080","2016",17,14,3,210941.2,2179.941,100.1176
"27912","91081","2016",5,5,0,196140,1698.8,124.4
"27913","91085","2016",37,35,2,249270.8,2825.324,91.45946
"27914","91086","2016",139,98,41,251970.7,2732.137,93.54676
"27915","91093","2016",3,3,0,277666.7,1511.667,181
"27916","91095","2016",26,21,5,218843.1,2548.231,89
"27917","91097","2016",100,38,62,173880.9,2537.68,73.65
"27918","91098","2016",4,4,0,249750,2129.75,119
"27919","91099","2016",42,36,6,190755.7,2746.833,76.40476
"27920","91100","2016",6,6,0,247959.8,2198.667,115.5
"27921","91103","2016",249,118,131,200772.3,2818.229,73.16064
"27922","91105","2016",60,57,3,247614.7,2689.25,95.93333
"27923","91106","2016",12,12,0,230509.2,2683,88.5
"27924","91109","2016",10,10,0,220367.5,2277.1,98.6
"27925","91111","2016",37,31,6,291691.9,2997.838,100.8378
"27926","91112","2016",2,2,0,241500,1641.5,142
"27927","91114","2016",319,174,145,247143.5,3179.853,82.11285
"27928","91115","2016",37,26,11,229790.4,2811.216,86.59459
"27929","91121","2016",12,12,0,291128.3,2576.583,116.5
"27930","91122","2016",74,46,28,334757.7,3945.622,89.47297
"27931","91129","2016",41,34,7,241746.3,2793.293,90.02439
"27932","91130","2016",5,4,1,220000,2151.2,111.6
"27933","91131","2016",11,11,0,189746.8,1908.636,103.5455
"27934","91132","2016",17,14,3,202793.7,2553.765,85.23529
"27935","91135","2016",27,27,0,252642.2,2748.481,94.48148
"27936","91136","2016",6,6,0,292666.7,3770,94.5
"27937","91137","2016",4,4,0,257750,1920.75,133
"27938","91156","2016",24,21,3,247704,2965.625,90.91667
"27939","91159","2016",24,20,4,249295.2,2904.917,91.33333
"27940","91161","2016",275,49,226,179128.6,2573.913,73.04364
"27941","91174","2016",566,154,412,143950.6,2410.435,62.31272
"27942","91175","2016",14,12,2,196121.4,2295.286,87.5
"27943","91179","2016",46,24,22,214213.7,2572.087,90.19565
"27944","91180","2016",3,3,0,294333.3,2200.667,145
"27945","91184","2016",5,5,0,204200,2267.6,98.4
"27946","91186","2016",8,8,0,295875,2840.125,109.25
"27947","91191","2016",124,50,74,218636.3,2825.161,79.66129
"27948","91195","2016",13,10,3,246438.5,2922.231,94
"27949","91198","2016",12,10,2,215362.5,2680.25,84.66667
"27950","91200","2016",95,50,45,218391.6,2695.242,84.10526
"27951","91201","2016",301,190,111,241110.3,3011.179,83.34219
"27952","91207","2016",38,27,11,233449.1,2694.316,89.81579
"27953","91215","2016",96,35,61,154869.4,2079.656,74.85417
"27954","91216","2016",148,90,58,252826.3,3370.25,76.84459
"27955","91223","2016",272,118,154,149992.9,2224,70.18015
"27956","91225","2016",44,25,19,327358.5,3062.227,111.4773
"27957","91226","2016",69,45,24,196044.1,2739.043,75.91304
"27958","91228","2016",576,120,456,147999.4,2078.814,72.4809
"27959","91232","2016",46,33,13,200354.6,2341.413,91.58696
"27960","91235","2016",21,16,5,233403.5,2768.619,85.95238
"27961","91240","2016",1,1,0,153000,1254,122
"27962","91243","2016",23,19,4,255813.5,2652.261,101
"27963","91244","2016",14,12,2,273295.7,2976.714,93
"27964","91247","2016",7,7,0,203600,2010.286,109
"27965","91248","2016",1,1,0,270000,2389,113
"27966","91249","2016",47,38,9,273523.2,2571.213,107.9149
"27967","91272","2016",241,125,116,341370.9,3628.631,100.4938
"27968","91273","2016",18,17,1,192419.4,2177.167,90
"27969","91274","2016",14,7,7,273185.7,3278.357,89.85714
"27970","91275","2016",26,22,4,341986.3,3229.962,113.3846
"27971","91284","2016",12,12,0,243541.7,2629.833,98.41667
"27972","91286","2016",34,24,10,172599.1,2370.029,78.88235
"27973","91292","2016",5,5,0,304200,3171.8,96.8
"27974","91293","2016",5,4,1,381220,2660.8,141.2
"27975","91294","2016",12,8,4,163934.2,1996.25,90.66667
"27976","91312","2016",144,87,57,335546.3,4092.708,85.55556
"27977","91315","2016",73,65,8,228949.2,2880.274,84.80822
"27978","91318","2016",20,19,1,247935,2801.85,96.6
"27979","91319","2016",6,6,0,426027.5,2769.167,158.6667
"27980","91326","2016",199,60,139,192669.9,3090.186,64.25628
"27981","91330","2016",63,57,6,242688.6,2820.127,91.60317
"27982","91332","2016",16,14,2,284221.9,2615.188,112.625
"27983","91333","2016",63,55,8,237272.4,2864.968,87.31746
"27984","91338","2016",76,59,17,275587.5,3002.868,95.60526
"27985","91339","2016",79,55,24,244355.4,2965.468,85.74684
"27986","91340","2016",84,73,11,238796.6,2742.048,89.47619
"27987","91345","2016",252,96,156,209811.9,2772.532,76.3254
"27988","91347","2016",91,68,23,273594.5,2987.341,94.86813
"27989","91359","2016",34,25,9,170506.3,2334.676,77.64706
"27990","91363","2016",72,54,18,270993.6,2969.903,97.33333
"27991","91374","2016",4,4,0,247500,1758,152.25
"27992","91376","2016",63,51,12,249013,2865.603,91.80952
"27993","91377","2016",500,75,425,220887.1,3199.56,70.67
"27994","91378","2016",2,2,0,389000,4759.5,98.5
"27995","91386","2016",193,130,63,247738.9,2575.073,100.0777
"27996","91390","2016",38,37,1,185112,1764.368,107.4474
"27997","91393","2016",9,9,0,193853.9,2165.778,99.44444
"27998","91399","2016",7,7,0,143714.3,2626,64.85714
"27999","91405","2016",71,58,13,220889.4,2563.535,89.15493
"28000","91408","2016",7,6,1,210714.3,3068.429,68.85714
"28001","91411","2016",19,18,1,330592.1,3486.947,96.42105
"28002","91412","2016",14,13,1,234293.6,2334.357,105.0714
"28003","91414","2016",3,3,0,226950,2930,92.33333
"28004","91421","2016",295,186,109,261901.1,3358.651,81.40678
"28005","91425","2016",75,41,34,240136.3,3286.627,75.04
"28006","91432","2016",138,101,37,258968,3284.717,82.48551
"28007","91433","2016",47,44,3,248169.8,2514.596,101.7234
"28008","91434","2016",255,164,91,230376.7,3124.384,77.43529
"28009","91435","2016",7,7,0,566071.4,3730.571,175.4286
"28010","91441","2016",2,2,0,276223.5,2325,123.5
"28011","91457","2016",33,25,8,249247,2799.303,98.18182
"28012","91458","2016",32,21,11,266975.9,3278.156,86
"28013","91461","2016",42,35,7,247121.6,2722.071,93.90476
"28014","91463","2016",13,13,0,246502.2,2432.385,107.0769
"28015","91468","2016",19,16,3,237984.2,2805.842,90
"28016","91469","2016",8,7,1,157125,2323.25,76.875
"28017","91471","2016",194,110,84,314497.5,3811.711,87.94845
"28018","91473","2016",2,2,0,262289,2944,89
"28019","91477","2016",416,132,284,250689,3234.995,78.84135
"28020","91479","2016",58,46,12,265176.4,3947.828,70.27586
"28021","91482","2016",2,1,1,256670,2644.5,101
"28022","91494","2016",41,34,7,270440.2,3205.951,89.29268
"28023","91495","2016",6,6,0,143950,1751.833,86.16667
"28024","91507","2016",1,1,0,244600,2446,100
"28025","91511","2016",32,22,10,134970.3,1855.719,76.09375
"28026","91514","2016",98,69,29,234371.4,2800.694,87.13265
"28027","91519","2016",6,6,0,242416.7,2010.667,120.6667
"28028","91521","2016",284,100,184,164780,2299.461,73.33451
"28029","91525","2016",18,15,3,224574.9,2722.222,89
"28030","91526","2016",1,1,0,366800,1048,350
"28031","91533","2016",21,19,2,201229.1,2170.524,97.42857
"28032","91534","2016",39,31,8,415486.5,4194.026,103.4359
"28033","91538","2016",2,2,0,372500,3785.5,98.5
"28034","91540","2016",58,41,17,227441.6,2842.397,84.60345
"28035","91544","2016",3,3,0,220833.3,2245.667,112
"28036","91546","2016",11,11,0,250043.2,2610.727,101.2727
"28037","91547","2016",5,5,0,188400,1573.8,134.2
"28038","91549","2016",342,201,141,233096.9,3195.459,76.1345
"28039","91552","2016",109,80,29,236509,2833.982,86.29358
"28040","91553","2016",131,101,30,280467.7,2921.992,100.5267
"28041","91556","2016",6,5,1,188833.3,1893.667,102.8333
"28042","91560","2016",1,1,0,299000,2670,112
"28043","91568","2016",12,12,0,283528.5,2649.167,108.6667
"28044","91570","2016",191,85,106,200993.8,2548.084,80.05759
"28045","91573","2016",95,67,28,247844.1,2881.674,87.89474
"28046","91577","2016",85,68,17,258865.5,2665.129,100.3647
"28047","91578","2016",3,3,0,244500,2113.667,114.6667
"28048","91579","2016",30,20,10,201946.1,2720.9,75.6
"28049","91581","2016",11,11,0,288453,2765.091,108.5455
"28050","91587","2016",76,46,30,254691.4,2879.408,89.22368
"28051","91589","2016",438,244,194,218526.8,3051.58,73.621
"28052","91593","2016",14,12,2,257600.3,2315.786,114
"28053","91599","2016",10,9,1,257175,3319.3,83.8
"28054","91600","2016",88,56,32,280671.5,3032.432,95.27273
"28055","91602","2016",3,3,0,290166.7,2774,116.6667
"28056","91613","2016",2,2,0,157500,1871.5,84.5
"28057","91617","2016",49,34,15,266357.8,3057.755,91.42857
"28058","91619","2016",2,2,0,277000,2655.5,106
"28059","91629","2016",8,8,0,182241.2,2106,90.375
"28060","91630","2016",14,12,2,282582.1,2665.357,119.9286
"28061","91631","2016",23,22,1,371106.9,2905.435,131.2609
"28062","91634","2016",22,14,8,228822.3,2286.727,104.2273
"28063","91635","2016",24,23,1,467265.2,4634.458,104.7083
"28064","91639","2016",10,8,2,207585,2318.4,97.4
"28065","91645","2016",186,112,74,444840.4,4388.253,103.2634
"28066","91648","2016",29,21,8,267977.8,2765.655,98.2069
"28067","91649","2016",28,20,8,205745,2496.143,85.32143
"28068","91654","2016",5,5,0,258900,2369.8,108.4
"28069","91657","2016",232,150,82,214648.4,3147.203,71.58621
"28070","91659","2016",57,40,17,223179.1,2809.351,81.05263
"28071","91661","2016",95,45,50,260709.8,3216.158,81.52632
"28072","91662","2016",8,8,0,225237.5,3050.875,87
"28073","91665","2016",75,62,13,269346.3,2946.613,93.88
"28074","91666","2016",32,27,5,293610.7,3330.906,92.4375
"28075","91667","2016",77,59,18,283658.1,3537.416,82.79221
"28076","91671","2016",8,8,0,256387.5,2336.375,117.375
"28077","91679","2016",9,6,3,350905.6,3840.667,93.77778
"28078","91685","2016",42,35,7,276110.3,3092.381,92.57143
"28079","91687","2016",301,129,172,200845.7,2851.654,74.07641
"28080","91689","2016",84,33,51,284100.1,4023.81,75.7619
"28081","91691","2016",355,179,176,253083.8,3204.699,82.04789
"28082","91692","2016",186,18,168,160551.2,2208.726,73.18817
"28083","92002","2016",619,219,400,375233.2,4833.754,76.81422
"28084","92004","2016",1391,128,1263,323583.8,5190.841,60.91804
"28085","92007","2016",217,47,170,280023.5,4238.995,66.23502
"28086","92009","2016",518,85,433,335288.1,5267.946,62.05985
"28087","92012","2016",1889,39,1850,438112.1,7162.957,59.94971
"28088","92014","2016",241,42,199,356268.5,5038.477,70.24066
"28089","92019","2016",373,67,306,328686.7,4221.169,77.67828
"28090","92020","2016",410,72,338,344783,5268.924,65.85122
"28091","92022","2016",253,74,179,372432.8,5083.051,72.00791
"28092","92023","2016",580,189,391,382059.5,5250.46,71.70517
"28093","92024","2016",626,12,614,227840,5083.629,45.52716
"28094","92025","2016",962,311,651,316075.9,4637.839,66.3316
"28095","92026","2016",1201,44,1157,344555.9,5782.371,59.5179
"28096","92032","2016",243,57,186,316807.5,4318.741,73.86831
"28097","92033","2016",239,48,191,521242.7,5507.992,90.6569
"28098","92035","2016",430,48,382,354418.4,5433.2,63.44884
"28099","92036","2016",189,41,148,219829.1,3594.794,61.55026
"28100","92040","2016",808,45,763,391122.1,6525.611,59.3453
"28101","92044","2016",994,4,990,432638.5,7602.116,55.95171
"28102","92046","2016",270,51,219,301328.3,5688.874,52.83704
"28103","92047","2016",21,18,3,1093451,7315.81,149.4762
"28104","92048","2016",589,77,512,373531.6,5013.311,70.89983
"28105","92049","2016",626,19,607,344129,6006.826,57.24121
"28106","92050","2016",555,138,417,309902.5,4732.223,66.17838
"28107","92051","2016",965,22,943,742953.7,8742.812,83.36477
"28108","92060","2016",353,48,305,344451.5,4883.96,70.75921
"28109","92062","2016",512,18,494,327551.8,5846.779,56.46875
"28110","92063","2016",1007,258,749,421214.1,5439.36,74.9146
"28111","92064","2016",427,46,381,492093.4,5915.761,81.05621
"28112","92071","2016",187,38,149,460537.9,5734.027,80.23529
"28113","92072","2016",286,64,222,433681.8,5421.619,77.34965
"28114","92073","2016",594,86,508,401341.5,5837.318,67.75421
"28115","92075","2016",320,21,299,326318.1,5633.538,56.575
"28116","92076","2016",151,50,101,541607.7,5204.185,101.3245
"28117","92077","2016",92,18,74,535029.5,5276.359,100.8804
"28118","92078","2016",113,18,95,221544,3020.602,71.42478
"28119","93001","2016",478,52,426,158910.9,3080.835,53.23431
"28120","93005","2016",549,319,230,203554.4,3022.279,70.36248
"28121","93006","2016",283,49,234,251850.3,4342.558,58.94346
"28122","93007","2016",326,208,118,213088.5,3148.773,70.96012
"28123","93008","2016",196,86,110,180297.1,2962.138,63.42857
"28124","93010","2016",368,171,197,189533.8,2926.924,67.65217
"28125","93013","2016",159,30,129,165934.6,3016.547,57.71069
"28126","93014","2016",154,45,109,118861,1695.487,69.57143
"28127","93015","2016",64,48,16,245960.5,3005.953,85.32812
"28128","93027","2016",128,38,90,170723.8,2985.867,59.72656
"28129","93029","2016",503,253,250,193211.3,3227.316,63.22863
"28130","93030","2016",20,1,19,140653,2541.85,56.85
"28131","93031","2016",359,97,262,163280.8,2628.045,64.30919
"28132","93032","2016",433,255,178,221006.5,3087.06,73.81755
"28133","93033","2016",93,63,30,318651,3882.731,85.83871
"28134","93039","2016",42,5,37,183953.4,3079.857,60.21429
"28135","93045","2016",307,30,277,289133.5,5325.456,55.01629
"28136","93046","2016",550,245,305,192883.5,2861.956,70.13636
"28137","93047","2016",247,197,50,227531,2917.291,81.51822
"28138","93048","2016",1099,210,889,268320.8,4697.234,57.92994
"28139","93049","2016",258,114,144,258474.7,3667.822,71.42636
"28140","93050","2016",333,105,228,215319.4,3136.048,70.31532
"28141","93051","2016",695,182,513,223438.8,3510.102,66.14532
"28142","93053","2016",313,117,196,217329.1,3261.233,66.70927
"28143","93055","2016",559,25,534,212623.8,4374.903,49.16279
"28144","93057","2016",308,133,175,192988.5,3020.019,65.75649
"28145","93059","2016",146,85,61,182337.7,2806.89,68.5137
"28146","93061","2016",220,20,200,270327.1,4829.105,55.84545
"28147","93062","2016",290,88,202,282271.8,3787.724,76.96552
"28148","93063","2016",212,79,133,283309.5,4330.995,67.48585
"28149","93064","2016",456,88,368,195428,3224.537,62.5307
"28150","93066","2016",716,69,647,174219.1,3201.553,55.33659
"28151","93070","2016",466,37,429,210667,4448.369,47.53219
"28152","93071","2016",330,191,139,182662.5,2511.373,74.34242
"28153","93072","2016",143,73,70,169039.7,2754.951,64
"28154","93073","2016",294,204,90,217038.5,2964.337,77.79592
"28155","93074","2016",69,31,38,195679.3,2922.203,72.17391
"28156","93077","2016",361,167,194,239793.3,3447.842,71.11634
"28157","93078","2016",242,159,83,192760,2634.186,77.36364
"28158","93079","2016",25,14,11,181364,3159.6,61.92
"28159","94001","2016",87,26,61,197687.7,3015.54,70.90805
"28160","94002","2016",456,59,397,233206.1,4177.02,57.33991
"28161","94003","2016",162,54,108,284607.4,4796.685,61.27778
"28162","94004","2016",144,42,102,199360.4,3057.035,69.73611
"28163","94011","2016",93,38,55,234650.1,3488.71,68.4086
"28164","94015","2016",246,85,161,340276.3,4379.988,78.03252
"28165","94016","2016",282,76,206,270878.5,4326.624,66.98582
"28166","94017","2016",666,273,393,240643,3515.426,70.82432
"28167","94018","2016",393,9,384,368556.5,6244.249,58.65394
"28168","94019","2016",247,83,164,234259.1,3244.47,74.65992
"28169","94021","2016",167,42,125,236437.7,3312.731,74.76048
"28170","94022","2016",507,81,426,199173.3,3352.345,61.22288
"28171","94028","2016",628,69,559,222928.4,3333.572,67.76115
"28172","94033","2016",576,172,404,337028.3,5006.705,67.64931
"28173","94034","2016",263,48,215,222460.6,3190.103,70.58935
"28174","94037","2016",123,18,105,264496.8,5060.041,53.79675
"28175","94038","2016",310,94,216,280207.4,3812.071,73.42903
"28176","94041","2016",553,33,520,218067,4190.277,52.70705
"28177","94042","2016",258,65,193,312494.9,4958.415,63.12791
"28178","94043","2016",199,19,180,256548.6,4915.276,53.75879
"28179","94044","2016",308,100,208,200866,3039.672,69.6039
"28180","94046","2016",648,122,526,283482.5,4688.373,61.28395
"28181","94047","2016",55,44,11,272562.5,3043.382,94
"28182","94048","2016",53,49,4,341642.3,3053.019,122.4906
"28183","94052","2016",532,72,460,386773.4,5424.789,69.94173
"28184","94053","2016",51,28,23,277687.3,3189.176,90.60784
"28185","94054","2016",121,53,68,229295,3194.645,74.28926
"28186","94055","2016",115,113,2,338772.3,3921.417,94.66957
"28187","94056","2016",27,23,4,261302.6,2914.111,92.51852
"28188","94058","2016",551,158,393,333219.1,4853.392,68.21234
"28189","94059","2016",274,73,201,246519.4,3276.573,76.99635
"28190","94060","2016",122,105,17,276973,2922.107,100.4344
"28191","94065","2016",56,15,41,284325.5,4045.411,71.58929
"28192","94067","2016",359,14,345,481070.6,7186.819,66.39276
"28193","94068","2016",1290,410,880,356735.6,4995.905,71.37054
"28194","94069","2016",194,5,189,294240.5,5240.057,55.58763
"28195","94070","2016",45,34,11,318428.3,3033.311,114.9778
"28196","94071","2016",279,157,122,293311.6,3494.853,86.7491
"28197","94073","2016",332,77,255,222479,3320.262,68.54217
"28198","94074","2016",64,29,35,224446,3221.062,73.03125
"28199","94075","2016",101,67,34,268794.8,3168.624,88.36634
"28200","94076","2016",490,117,373,242519.4,4136.198,59.6
"28201","94077","2016",177,115,62,213313,3449.593,66.32768
"28202","94078","2016",199,96,103,170861.4,2787.724,64.24623
"28203","94079","2016",294,131,163,271612.3,3650.68,76.37415
"28204","94080","2016",827,38,789,402076.3,7051.479,56.52479
"28205","94081","2016",627,151,476,223801.8,3623.51,63.20255
"28206","95002","2016",8,8,0,199671.4,2180.75,90.125
"28207","95008","2016",18,16,2,216672.2,2174.222,102.8889
"28208","95011","2016",4,4,0,266750,1991.25,133.75
"28209","95012","2016",3,3,0,221169.7,1973.667,100
"28210","95014","2016",38,31,7,326104.1,3532.658,99.97368
"28211","95018","2016",882,408,474,199588.7,3113.755,67.66553
"28212","95019","2016",127,96,31,219251.1,2776.654,83.7874
"28213","95023","2016",7,7,0,293228.6,2384.429,123.4286
"28214","95024","2016",2,2,0,182500,2105,85.5
"28215","95026","2016",40,34,6,238939,2766.55,90.9
"28216","95028","2016",24,19,5,256015.4,2868.708,92.41667
"28217","95039","2016",117,98,19,253230.6,3256.513,84.06838
"28218","95040","2016",7,7,0,317201.4,2454.429,137.4286
"28219","95042","2016",36,32,4,260698.8,2868.889,94.94444
"28220","95046","2016",2,2,0,254500,2751,92.5
"28221","95051","2016",119,90,29,312367,3781.773,85.03361
"28222","95052","2016",116,45,71,164176,2709.284,63.94828
"28223","95054","2016",2,2,0,154825,1780.5,82
"28224","95055","2016",4,3,1,343500,3652.75,91
"28225","95056","2016",34,29,5,224818.4,2960.647,90.11765
"28226","95058","2016",16,16,0,229334.4,2633.312,89.0625
"28227","95059","2016",3,3,0,191166.7,2014,96.66667
"28228","95060","2016",65,60,5,300485,3378.538,94.84615
"28229","95061","2016",7,7,0,262714.3,2684.429,95.71429
"28230","95063","2016",241,123,118,250722.7,3832.216,67.57261
"28231","95074","2016",6,6,0,437025,2693.833,164.5
"28232","95078","2016",21,17,4,288334.5,3124.048,107.8571
"28233","95088","2016",10,4,6,151000,2274.4,64.4
"28234","95091","2016",65,56,9,275022.4,2833.923,98.67692
"28235","95094","2016",2,2,0,220654,2862,77.5
"28236","95101","2016",9,9,0,147444.4,1814.111,85.33333
"28237","95102","2016",2,2,0,322465,2291,140.5
"28238","95110","2016",1,1,0,170000,1589,107
"28239","95116","2016",45,44,1,222142.7,2654.022,86.13333
"28240","95119","2016",4,4,0,215656.2,1823,148.5
"28241","95120","2016",30,29,1,277209.1,3279.533,95.96667
"28242","95127","2016",586,147,439,179686,2873.403,67.93003
"28243","95134","2016",62,55,7,268614.1,2878.323,98.08065
"28244","95139","2016",2,2,0,206000,2575,80
"28245","95142","2016",30,22,8,178163,2668.367,72.33333
"28246","95149","2016",39,37,2,268884.9,2971.077,96.76923
"28247","95150","2016",6,6,0,195230,3248.5,79.5
"28248","95151","2016",6,6,0,270833.3,2887.167,98.33333
"28249","95154","2016",1,1,0,140000,1728,81
"28250","95157","2016",2,2,0,381755,3113,142.5
"28251","95166","2016",4,4,0,205737.5,2178.75,109.25
"28252","95169","2016",3,3,0,197333.3,2417,89
"28253","95170","2016",5,3,2,195200,2522.6,78.4
"28254","95176","2016",306,177,129,281866.4,3601.961,80.89542
"28255","95177","2016",17,16,1,270532.4,2555.765,105.4118
"28256","95181","2016",1,1,0,166000,922,180
"28257","95183","2016",101,55,46,232459.2,2880.04,82.69307
"28258","95197","2016",329,107,222,223468.4,3115.526,73.26444
"28259","95199","2016",189,98,91,223750.2,2952.169,77.6455
"28260","95203","2016",327,173,154,275715.9,3551.153,79.18349
"28261","95205","2016",71,37,34,226646.6,2852.042,83.49296
"28262","95210","2016",188,47,141,342892.6,4600.096,73
"28263","95211","2016",27,24,3,280443.7,2924.519,101
"28264","95212","2016",1,1,0,170000,1700,100
"28265","95213","2016",5,5,0,292600,2444.6,117.6
"28266","95214","2016",1,1,0,325000,2167,150
"28267","95218","2016",205,118,87,236901.6,2789.99,86.99024
"28268","95219","2016",296,115,181,256286,3398.199,77.4223
"28269","95229","2016",136,64,72,223260.2,2858.993,79.28676
"28270","95241","2016",27,19,8,189705.9,2846.111,69.81481
"28271","95250","2016",122,111,11,208431.2,2578.467,86.01639
"28272","95252","2016",430,112,318,199406.7,2822.784,71.02326
"28273","95253","2016",5,5,0,203700,2098.4,109.4
"28274","95254","2016",9,9,0,262794.4,2808.778,100.4444
"28275","95256","2016",35,23,12,234059.6,2970.229,83.54286
"28276","95257","2016",64,47,17,279499.2,3754.516,78.23438
"28277","95258","2016",6,6,0,265535.8,3097,89.66667
"28278","95268","2016",177,56,121,154383,2375.333,65.82486
"28279","95270","2016",7,5,2,137000,3103.857,55
"28280","95271","2016",5,5,0,200780.2,2319.6,89.6
"28281","95277","2016",181,84,97,179476.7,2552.116,72.27624
"28282","95280","2016",190,162,28,200569.5,3059,71.08947
"28283","95282","2016",1,1,0,246000,2703,91
"28284","95287","2016",9,9,0,285533.3,2261.111,128.3333
"28285","95288","2016",123,75,48,260000.6,3023.114,88.78862
"28286","95295","2016",3,3,0,259450,2406.333,107.3333
"28287","95298","2016",4,4,0,267550,2238.25,125.5
"28288","95301","2016",4,3,1,120875,2187.75,59
"28289","95303","2016",4,3,1,183062.5,1993.5,94
"28290","95304","2016",2,2,0,267726.5,3063.5,107.5
"28291","95306","2016",345,203,142,270797,3469.052,80.86087
"28292","95308","2016",5,3,2,411780,2994.6,124.4
"28293","95309","2016",1,1,0,190500,1780,107
"28294","95313","2016",182,88,94,290231.3,3560.654,84.8956
"28295","95316","2016",4,4,0,316937.5,2563.5,148.25
"28296","95323","2016",158,135,23,240663.3,2700.987,91.12025
"28297","95328","2016",11,8,3,226679.2,2508.545,91.90909
"28298","95331","2016",2,2,0,450875,2854.5,155
"28299","95341","2016",4,4,0,217875,2727.25,87.25
"28300","95348","2016",6,5,1,247000,3528.333,77.33333
"28301","95351","2016",112,74,38,202844.8,2633.527,79.25
"28302","95352","2016",55,39,16,250690.2,3122.382,84.92727
"28303","95353","2016",22,19,3,261527.3,2714.273,98.77273
"28304","95355","2016",50,39,11,193616.3,2403.62,82.92
"28305","95365","2016",7,7,0,315457.1,3015.571,108.1429
"28306","95369","2016",32,15,17,293625.6,3351.562,91.65625
"28307","95370","2016",36,29,7,252686.7,2461.778,108.9444
"28308","95371","2016",65,59,6,232254.6,2744.123,89.30769
"28309","95379","2016",6,6,0,218116.7,2530.667,92.66667
"28310","95388","2016",75,65,10,231126,2669.707,88.36
"28311","95392","2016",61,55,6,259917.8,3082.459,88.31148
"28312","95394","2016",89,62,27,241958.9,3083.674,83.19101
"28313","95395","2016",7,5,2,198782.9,2531.429,81.71429
"28314","95409","2016",18,8,10,212672.8,2905.778,79.33333
"28315","95422","2016",3,3,0,284333.3,1863.667,150.3333
"28316","95424","2016",220,130,90,228166.5,2876.85,81.67273
"28317","95426","2016",38,32,6,328642.1,3348.474,107.2368
"28318","95427","2016",150,70,80,188389.7,2699.567,73.88667
"28319","95428","2016",339,109,230,288961.7,3538.693,84.03245
"28320","95429","2016",3,3,0,227460,2389.667,95.33333
"28321","95430","2016",43,37,6,245332,2784.233,96.09302
"28322","95436","2016",15,11,4,242398.7,2832.667,91.86667
"28323","95438","2016",1,1,0,365000,2310,158
"28324","95445","2016",4,4,0,302512.5,3430.75,90.75
"28325","95446","2016",31,29,2,329197.7,3433.355,101.4839
"28326","95447","2016",3,3,0,207333.3,1667,136.6667
"28327","95450","2016",20,19,1,318365,3095,104.4
"28328","95452","2016",8,4,4,210875,2664.25,85.25
"28329","95456","2016",2,2,0,295500,2827.5,113.5
"28330","95459","2016",7,6,1,217232.1,2486.714,88
"28331","95462","2016",3,3,0,242000,2272,114.6667
"28332","95476","2016",147,105,42,245741.3,2820.837,92.5102
"28333","95480","2016",77,62,15,287381.2,3050.506,98.57143
"28334","95483","2016",8,8,0,271828.1,2360.125,117.375
"28335","95487","2016",106,50,56,169903.8,2696.925,66.31132
"28336","95488","2016",74,52,22,243698.7,3358.486,80.63514
"28337","95489","2016",7,7,0,299606.6,2693.857,111.8571
"28338","95491","2016",120,60,60,258960.5,3179.008,83.60833
"28339","95492","2016",1,1,0,320000,3902,82
"28340","95493","2016",2,2,0,193500,2746.5,70.5
"28341","95500","2016",359,116,243,198804.4,2816.685,73.89415
"28342","95504","2016",45,37,8,262218.2,3137.4,89.06667
"28343","95509","2016",38,34,4,234675.8,2645.816,89.81579
"28344","95510","2016",6,1,5,190283.3,2566.167,76.16667
"28345","95523","2016",3,3,0,211666.7,2146.667,112.6667
"28346","95527","2016",21,7,14,246597.6,3744.619,66.71429
"28347","95529","2016",16,16,0,262406.2,2486.375,112.5625
"28348","95535","2016",14,12,2,263291.4,3633.643,85
"28349","95539","2016",168,80,88,236721.5,3051.167,81.19048
"28350","95541","2016",8,8,0,194768.8,1931.375,111.125
"28351","95543","2016",3,3,0,156000,2211.333,73
"28352","95554","2016",12,12,0,222160,2071.75,108.1667
"28353","95555","2016",241,72,169,254522.1,3446.568,73.54357
"28354","95563","2016",253,153,100,284752.7,3468.32,86.36364
"28355","95566","2016",29,27,2,226371.7,2471.483,91.93103
"28356","95572","2016",252,102,150,200385.3,2825.151,74.27778
"28357","95574","2016",74,61,13,399770.1,3477.459,118.6081
"28358","95580","2016",39,33,6,361981.9,3057.462,123.9744
"28359","95582","2016",317,113,204,228334.6,3231.382,72.32492
"28360","95584","2016",7,7,0,258379,3222.571,87.85714
"28361","95585","2016",257,99,158,162471.8,2252.113,75.75097
"28362","95592","2016",8,8,0,248187.5,2685.125,103.25
"28363","95594","2016",19,12,7,211784.2,2846.316,78.52632
"28364","95598","2016",195,87,108,267441.4,3414.062,79.8359
"28365","95604","2016",47,17,30,167629.8,2281.064,76.23404
"28366","95607","2016",362,188,174,233133.3,2931.191,80.66851
"28367","95612","2016",34,26,8,197720.6,2525,82.17647
"28368","95625","2016",17,15,2,264019.9,2866.706,99.70588
"28369","95627","2016",11,9,2,242758.5,2849.273,93.90909
"28370","95628","2016",31,21,10,216271,3188.839,75.80645
"28371","95633","2016",1,0,1,80000,519,154
"28372","95637","2016",140,96,44,240787.1,3013.121,82.34286
"28373","95641","2016",36,26,10,245715.2,2953.083,85.38889
"28374","95651","2016",10,10,0,245500,2131.7,109.5
"28375","95652","2016",61,51,10,242066.4,3089.197,86.93443
"28376","95656","2016",10,10,0,235555,2419.8,110
"28377","95658","2016",20,20,0,308385.8,2894.6,111.15
"28378","95660","2016",14,13,1,281900,2842.571,116.7857
"28379","95675","2016",3,1,2,294000,3747.667,79
"28380","95676","2016",8,8,0,233731.2,2164.875,114.625
"28381","95678","2016",12,11,1,308910.8,3604.667,90.58333
"28382","95680","2016",145,66,79,161543.9,2300.559,73.1931
"28383","95682","2016",2,2,0,262500,3340.5,85.5
"28384","95690","2016",4,4,0,261500,2505.25,116.25
"28385",NA,"2016",7158,NA,NA,180734.8,2453.674,75.58256
