"","INSEE_COM","Annee","Nb_mutations","NbMaisons","NbApparts","PrixMoyen","Prixm2Moyen","SurfaceMoy"
"1","01001","2018",9,9,0,236438.888888889,1906.22222222222,125.777777777778
"2","01002","2018",4,4,0,158409.75,1397.5,111.75
"3","01004","2018",197,113,84,159540.065989848,1934.95431472081,84.3553299492386
"4","01005","2018",27,18,9,199006.962962963,1939.18518518519,104.925925925926
"5","01006","2018",2,2,0,162890,1383,109
"6","01007","2018",28,27,1,171578.214285714,1712.60714285714,102.785714285714
"7","01008","2018",10,10,0,182480,1728,98.8
"8","01009","2018",3,3,0,258310,2234.33333333333,118.666666666667
"9","01010","2018",13,13,0,219753.615384615,2383,91.7692307692308
"10","01011","2018",3,3,0,165000,1772.33333333333,102.333333333333
"11","01012","2018",2,2,0,47500,646,73.5
"12","01013","2018",3,3,0,93683.3333333333,807.333333333333,114
"13","01014","2018",27,22,5,151785.62962963,1635.96296296296,94.6296296296296
"14","01015","2018",4,4,0,142100,1168,113.25
"15","01016","2018",2,2,0,143210,2121.5,62.5
"16","01017","2018",5,4,1,104720,1174.2,87.4
"17","01021","2018",8,8,0,210068.75,2180.125,103.125
"18","01022","2018",18,15,3,119029.777777778,1330.33333333333,94.5
"19","01024","2018",39,32,7,181478.974358974,1807.10256410256,100.051282051282
"20","01025","2018",40,40,0,214145.6,1805.375,119.825
"21","01026","2018",5,5,0,148615.8,1452,102.4
"22","01027","2018",18,14,4,234615.333333333,2256.72222222222,106.666666666667
"23","01028","2018",8,8,0,199275,2005,107.125
"24","01029","2018",9,9,0,130666.666666667,1304.11111111111,108.111111111111
"25","01030","2018",13,10,3,174719.461538462,2002.92307692308,86.7692307692308
"26","01031","2018",26,6,20,89500.5769230769,1218.15384615385,67.9615384615385
"27","01032","2018",33,28,5,235527.575757576,2208.81818181818,110.121212121212
"28","01033","2018",194,57,137,168088.350515464,2139.8969072165,77.0567010309278
"29","01034","2018",105,63,42,155983.285714286,1707.49523809524,92
"30","01035","2018",4,4,0,158250,1547.25,98.25
"31","01036","2018",20,20,0,141516.5,1332.05,107.75
"32","01037","2018",6,6,0,124500,1108.83333333333,110
"33","01038","2018",9,9,0,162935.555555556,1657,102.222222222222
"34","01039","2018",5,5,0,137120,1993,91.6
"35","01040","2018",3,3,0,90500,788,113.333333333333
"36","01041","2018",14,14,0,98583.5714285714,1435.21428571429,74.3571428571429
"37","01043","2018",55,40,15,305542.363636364,3004.16363636364,103.654545454545
"38","01044","2018",6,6,0,288158.333333333,2148,140.666666666667
"39","01045","2018",2,2,0,366000,2382.5,154.5
"40","01046","2018",9,9,0,179140,1702,107.444444444444
"41","01047","2018",9,9,0,248072.222222222,2296.55555555556,114.111111111111
"42","01049","2018",36,32,4,280393.861111111,2728.30555555556,103.75
"43","01050","2018",2,2,0,80000,1200.5,74
"44","01052","2018",5,5,0,216060,2047.8,106
"45","01053","2018",523,115,408,120959.803059273,1545.63288718929,78.3154875717017
"46","01054","2018",11,11,0,225366.363636364,2310.81818181818,104.636363636364
"47","01056","2018",3,3,0,36500,545,71.3333333333333
"48","01057","2018",5,5,0,120967,1415.6,84.4
"49","01058","2018",9,9,0,170152.222222222,1613.55555555556,106.444444444444
"50","01060","2018",5,4,1,119848,1070.8,116
"51","01061","2018",6,6,0,189716.666666667,1753.5,107
"52","01062","2018",12,12,0,287505.416666667,2175.5,135.666666666667
"53","01063","2018",3,3,0,160383.333333333,1535.66666666667,108.666666666667
"54","01064","2018",16,14,2,168105.9375,1610.5625,106.5
"55","01065","2018",17,14,3,191794.352941176,2071.70588235294,95.0588235294118
"56","01066","2018",1,1,0,53000,396,134
"57","01068","2018",7,6,1,102071.428571429,1033.71428571429,93
"58","01069","2018",14,11,3,162130,1680.71428571429,96.9285714285714
"59","01071","2018",73,38,35,441721.616438356,4271,101.287671232877
"60","01072","2018",23,21,2,204578.695652174,1866.08695652174,109.521739130435
"61","01073","2018",7,6,1,125129.142857143,1518,86
"62","01074","2018",38,24,14,171751,1967.60526315789,88.6315789473684
"63","01075","2018",23,13,10,175487.695652174,1945.95652173913,88.6521739130435
"64","01076","2018",4,4,0,62350,703.5,83.75
"65","01077","2018",4,4,0,108467.5,972.75,106.5
"66","01078","2018",18,16,2,413301.111111111,3925.05555555556,109.333333333333
"67","01079","2018",9,7,2,150778.888888889,1517.44444444444,102.222222222222
"68","01080","2018",7,7,0,130450,1346,96.2857142857143
"69","01081","2018",10,6,4,206890,2033.5,102.1
"70","01082","2018",3,2,1,150666.666666667,1745,87
"71","01083","2018",8,8,0,204258.625,2045,97.625
"72","01084","2018",8,8,0,213560,1924.125,111.75
"73","01085","2018",4,4,0,195770,1776,110.5
"74","01087","2018",2,2,0,52500,810.5,79
"75","01088","2018",13,13,0,257453.846153846,2288.92307692308,113.230769230769
"76","01089","2018",29,28,1,188101.379310345,2000.89655172414,93.1724137931034
"77","01090","2018",5,5,0,182920,1758.8,105.2
"78","01092","2018",22,22,0,218685.909090909,2264.18181818182,102.272727272727
"79","01093","2018",78,32,46,177215.717948718,2146.91025641026,83.3846153846154
"80","01094","2018",4,4,0,125087.5,1534.25,91.75
"81","01095","2018",10,10,0,112644.2,1266.9,88.9
"82","01096","2018",8,7,1,165067.25,2049.25,82.875
"83","01098","2018",14,13,1,166771.428571429,1733.21428571429,99.8571428571429
"84","01099","2018",16,16,0,240593.125,2097.5625,118.4375
"85","01100","2018",3,3,0,84383.3333333333,974.333333333333,86
"86","01101","2018",2,2,0,158850,1675.5,94.5
"87","01102","2018",9,9,0,148083.888888889,1329.33333333333,114.888888888889
"88","01103","2018",22,12,10,452431.181818182,3991.09090909091,112.181818181818
"89","01104","2018",5,5,0,143900,1470.4,99.2
"90","01105","2018",18,16,2,264999,2584,108.944444444444
"91","01106","2018",3,3,0,156510,1107.33333333333,145
"92","01107","2018",3,3,0,127570,1492.66666666667,86
"93","01108","2018",16,15,1,125499.375,1332.3125,106.5
"94","01109","2018",35,30,5,347230.2,3573.77142857143,100.142857142857
"95","01110","2018",3,3,0,65000,883.333333333333,76.3333333333333
"96","01111","2018",2,2,0,124600,1208.5,92.5
"97","01112","2018",6,5,1,169275,1685.33333333333,97.1666666666667
"98","01113","2018",11,11,0,192900,1762.09090909091,107.454545454545
"99","01114","2018",3,3,0,298990,3039.66666666667,97
"100","01115","2018",15,13,2,200825.333333333,1837.4,117.733333333333
"101","01116","2018",5,5,0,135176,1320.2,101.8
"102","01117","2018",2,2,0,136500,990,133.5
"103","01118","2018",18,14,4,185782.055555556,2058.27777777778,91.0555555555556
"104","01123","2018",8,8,0,181533.75,1754.375,104
"105","01124","2018",8,8,0,135218,1311.375,98
"106","01125","2018",9,9,0,124264.444444444,1196.77777777778,104.222222222222
"107","01127","2018",5,5,0,103424,1296.4,88.4
"108","01128","2018",4,3,1,162435,1462.75,116
"109","01129","2018",4,4,0,234015,1799.5,139.25
"110","01130","2018",18,18,0,211838.277777778,1923.83333333333,111.222222222222
"111","01133","2018",6,6,0,158825.666666667,1635.66666666667,96.1666666666667
"112","01134","2018",2,1,1,151835,1136.5,142.5
"113","01135","2018",23,19,4,505199.608695652,4029.91304347826,131.173913043478
"114","01136","2018",4,4,0,237165,2203.25,109.75
"115","01138","2018",37,28,9,132563.108108108,1525.91891891892,89.4324324324324
"116","01139","2018",9,9,0,123704.444444444,1249.33333333333,100.666666666667
"117","01140","2018",11,11,0,181336.363636364,1492.36363636364,139
"118","01141","2018",5,5,0,165010,1421,112.8
"119","01142","2018",45,27,18,224943.888888889,2395.37777777778,96.8
"120","01143","2018",198,70,128,561722.671717172,5264.09595959596,105.782828282828
"121","01145","2018",20,19,1,190219.85,1691.85,115.45
"122","01146","2018",4,4,0,211150,1818.75,118
"123","01147","2018",6,6,0,146575,1168,133.833333333333
"124","01148","2018",15,14,1,174669.4,1790.06666666667,97.4
"125","01149","2018",9,8,1,235950.777777778,2251.44444444444,105
"126","01150","2018",1,1,0,191355,1181,162
"127","01151","2018",19,19,0,202447.894736842,1594.31578947368,131.947368421053
"128","01152","2018",14,14,0,161825,1780.64285714286,92.2857142857143
"129","01153","2018",35,31,4,462406.571428571,4365.71428571429,106.371428571429
"130","01155","2018",1,1,0,83400,684,122
"131","01156","2018",3,3,0,269700,2575,105.666666666667
"132","01157","2018",25,22,3,299741.68,2585.64,115.68
"133","01158","2018",13,8,5,405189.230769231,3709.46153846154,111.538461538462
"134","01159","2018",23,23,0,173505.391304348,1556.17391304348,111.869565217391
"135","01160","2018",159,14,145,326003.459119497,4147.53459119497,76.6666666666667
"136","01162","2018",1,1,0,172000,1147,150
"137","01163","2018",21,21,0,158498.761904762,1676.38095238095,99.0476190476191
"138","01165","2018",21,21,0,242751.666666667,2281.42857142857,110.095238095238
"139","01166","2018",41,29,12,256576.87804878,2597.70731707317,100.439024390244
"140","01167","2018",3,3,0,319100,2431.33333333333,135.666666666667
"141","01169","2018",10,10,0,244719.5,2236.2,107.1
"142","01170","2018",5,5,0,210450,1636.6,131.2
"143","01171","2018",8,8,0,185130,1579.625,129.125
"144","01173","2018",167,48,119,310779.736526946,3918.79640718563,78.2155688622754
"145","01174","2018",6,6,0,172766.666666667,2509.83333333333,95.6666666666667
"146","01175","2018",1,1,0,130000,1368,95
"147","01179","2018",22,22,0,201136.636363636,1831.31818181818,115.772727272727
"148","01180","2018",8,6,2,615662.5,4195.375,153.375
"149","01181","2018",3,3,0,205000,1635,153.333333333333
"150","01183","2018",23,22,1,222255.217391304,2067.4347826087,108
"151","01184","2018",11,11,0,108461.363636364,1471,80.7272727272727
"152","01185","2018",47,35,12,109552.340425532,1349.42553191489,89.8085106382979
"153","01187","2018",5,4,1,119300,1690.4,85.4
"154","01188","2018",3,3,0,277916.666666667,2174.33333333333,133
"155","01189","2018",8,8,0,209625,2309.125,91.875
"156","01190","2018",1,1,0,45000,556,81
"157","01192","2018",10,8,2,173524.6,1865.2,93.2
"158","01194","2018",71,50,21,220527.61971831,2353.33802816901,95.9154929577465
"159","01195","2018",12,9,3,137200,1490.41666666667,93.75
"160","01196","2018",12,11,1,124795.833333333,1310.83333333333,98.5
"161","01197","2018",5,5,0,254512,2035.4,143.8
"162","01199","2018",23,21,2,144017.260869565,1558.13043478261,99.304347826087
"163","01200","2018",3,3,0,78000,842,103.333333333333
"164","01202","2018",92,64,28,170024.847826087,1794.38043478261,96.1304347826087
"165","01203","2018",12,11,1,202109.416666667,1875.33333333333,108.833333333333
"166","01204","2018",9,7,2,145087.222222222,1602.55555555556,93.3333333333333
"167","01206","2018",2,2,0,73500,724.5,120.5
"168","01207","2018",2,2,0,231775,1745,136.5
"169","01209","2018",10,10,0,303215,3126.9,98.4
"170","01210","2018",15,2,13,93216.8,2267.53333333333,40.5333333333333
"171","01211","2018",22,21,1,170065.318181818,1632.90909090909,106.681818181818
"172","01212","2018",15,14,1,145590,1395.4,111.466666666667
"173","01213","2018",18,18,0,198651.111111111,2073.88888888889,96.3888888888889
"174","01214","2018",2,2,0,71750,978,84
"175","01215","2018",2,2,0,366500,2262.5,161.5
"176","01216","2018",6,6,0,137725,1170.16666666667,139
"177","01219","2018",5,5,0,129740,1282.6,106.4
"178","01224","2018",44,35,9,204891.340909091,2293.65909090909,96.6136363636364
"179","01225","2018",3,3,0,311280.666666667,2593.66666666667,124.333333333333
"180","01227","2018",6,6,0,180333.333333333,1735.5,103.166666666667
"181","01228","2018",7,6,1,148800,1439.28571428571,105.285714285714
"182","01229","2018",14,10,4,156957.428571429,1849.57142857143,89.1428571428571
"183","01230","2018",8,8,0,143070,1200.875,121.75
"184","01231","2018",14,14,0,176606,1749.57142857143,104.5
"185","01232","2018",37,36,1,192819.054054054,1870.27027027027,116.972972972973
"186","01233","2018",3,3,0,133166.666666667,1270.66666666667,107.333333333333
"187","01234","2018",2,2,0,177425,1107.5,155
"188","01235","2018",19,15,4,195714,1886.31578947368,112.315789473684
"189","01236","2018",8,8,0,175464.75,1722.5,102.625
"190","01237","2018",12,12,0,171022.75,1523,113.416666666667
"191","01238","2018",44,32,12,285936.409090909,3014.27272727273,97.4318181818182
"192","01239","2018",6,6,0,150000,1571,93.3333333333333
"193","01240","2018",10,10,0,131159.4,1534.8,85.7
"194","01241","2018",18,18,0,204149.166666667,1698.72222222222,126
"195","01242","2018",3,2,1,135183.333333333,1159.66666666667,115.666666666667
"196","01243","2018",16,16,0,279778.125,2654.25,105.25
"197","01244","2018",92,61,31,202771.032608696,2064.1847826087,100.119565217391
"198","01245","2018",10,10,0,170637.5,1531.1,117.9
"199","01246","2018",26,24,2,178485.769230769,1688.69230769231,107.615384615385
"200","01247","2018",11,3,8,121307.545454545,2452.27272727273,41.0909090909091
"201","01248","2018",32,21,11,286863.4375,3031.90625,97.75
"202","01249","2018",114,71,43,253555.447368421,2712.32456140351,94.7719298245614
"203","01250","2018",24,24,0,307001.458333333,2607.04166666667,117.541666666667
"204","01252","2018",14,13,1,205901.142857143,1767.21428571429,114.857142857143
"205","01254","2018",27,27,0,263021.296296296,2473.33333333333,116.62962962963
"206","01255","2018",14,14,0,126586.428571429,1537.5,83.6428571428571
"207","01257","2018",4,4,0,265500,2640,102.5
"208","01258","2018",19,19,0,227450.157894737,1997.63157894737,111.578947368421
"209","01259","2018",9,9,0,205661.111111111,1862.33333333333,117.111111111111
"210","01260","2018",4,4,0,294895,1464.75,195.75
"211","01261","2018",10,10,0,389484,2483.1,153.2
"212","01262","2018",93,32,61,162234.838709677,2150.52688172043,75.8279569892473
"213","01263","2018",40,36,4,246493,2480.025,102.3
"214","01264","2018",8,7,1,199281.25,1658.75,117.25
"215","01265","2018",24,16,8,143576.291666667,1559.45833333333,93.2083333333333
"216","01266","2018",40,28,12,159184.975,1649.15,97.025
"217","01267","2018",7,7,0,113592.857142857,1135.28571428571,104.142857142857
"218","01268","2018",3,3,0,147816.666666667,1674,87.3333333333333
"219","01269","2018",27,8,19,106567.555555556,1176.62962962963,88.7037037037037
"220","01272","2018",25,24,1,166017.2,1544,108.24
"221","01273","2018",28,28,0,151540.535714286,1644.71428571429,101.214285714286
"222","01274","2018",5,4,1,159090,1293.2,133
"223","01275","2018",41,28,13,346399.756097561,2899.56097560976,118.731707317073
"224","01276","2018",15,14,1,314690,2875.6,113.266666666667
"225","01277","2018",2,2,0,80000,870,104.5
"226","01279","2018",2,2,0,142400,1811,95
"227","01280","2018",3,3,0,131000,1059,127.333333333333
"228","01281","2018",38,14,24,432188.184210526,4574.8947368421,96.5789473684211
"229","01282","2018",2,2,0,189800,1890.5,100.5
"230","01283","2018",194,80,114,115936.927835052,1323.4793814433,86.3505154639175
"231","01284","2018",9,9,0,188723.111111111,1771.22222222222,112.111111111111
"232","01285","2018",11,11,0,337197.454545455,2591.18181818182,132.545454545455
"233","01286","2018",8,8,0,182070,2064.875,89
"234","01288","2018",28,16,12,328541.428571429,3571.78571428571,95.75
"235","01289","2018",60,38,22,174008.55,1828.73333333333,95.8166666666667
"236","01290","2018",16,12,4,251171.875,2180.625,117.1875
"237","01291","2018",6,6,0,169804.666666667,1616.83333333333,107.333333333333
"238","01293","2018",1,1,0,148800,1071,139
"239","01294","2018",3,3,0,158333.333333333,1663.33333333333,94
"240","01295","2018",8,8,0,218380.625,1965.375,120.5
"241","01296","2018",4,4,0,142312.5,1567.5,91
"242","01297","2018",12,12,0,229800.416666667,2385.75,96.75
"243","01299","2018",8,8,0,221658.75,2235.5,98.5
"244","01301","2018",23,23,0,205349.434782609,1813.95652173913,115.521739130435
"245","01302","2018",1,1,0,193000,2098,92
"246","01303","2018",31,30,1,131928.709677419,1325.29032258065,99.2258064516129
"247","01304","2018",32,27,5,154795.84375,1797.09375,89.65625
"248","01305","2018",26,15,11,122522.692307692,1424.92307692308,89.4230769230769
"249","01306","2018",18,13,5,125035.555555556,1346.33333333333,94.2777777777778
"250","01307","2018",4,1,3,126050,1412.75,88.5
"251","01308","2018",6,5,1,462716.333333333,4741.16666666667,110
"252","01310","2018",1,1,0,40000,333,120
"253","01311","2018",1,1,0,158400,1523,104
"254","01313","2018",117,58,59,457529.777777778,4624.64102564103,98.3333333333333
"255","01314","2018",31,29,2,162412.903225806,1772.61290322581,91.258064516129
"256","01317","2018",1,1,0,84000,832,101
"257","01318","2018",10,10,0,304111,2573.7,119.1
"258","01319","2018",9,9,0,224487.777777778,1959.22222222222,118.888888888889
"259","01320","2018",6,6,0,181391.666666667,1921.66666666667,96.1666666666667
"260","01321","2018",7,7,0,187118.571428571,1721.14285714286,108.857142857143
"261","01322","2018",49,49,0,352894.755102041,2798.18367346939,127
"262","01323","2018",16,16,0,147075,1434.25,101.9375
"263","01325","2018",8,8,0,265598.75,2411.125,118.625
"264","01328","2018",4,4,0,266782.5,2188.5,125.75
"265","01329","2018",3,3,0,92550,1313.33333333333,75.3333333333333
"266","01330","2018",1,1,0,60000,1053,57
"267","01331","2018",1,1,0,120000,1558,77
"268","01332","2018",3,3,0,244333.333333333,2217.33333333333,110
"269","01333","2018",45,30,15,235100.888888889,2683.73333333333,89.9111111111111
"270","01334","2018",4,4,0,175235,1811.75,93.75
"271","01336","2018",9,9,0,125100,1211.77777777778,100.333333333333
"272","01337","2018",11,11,0,145797.272727273,1552.18181818182,102
"273","01338","2018",14,14,0,181357.142857143,1656.92857142857,110.285714285714
"274","01339","2018",18,18,0,314876.666666667,2740.27777777778,115.055555555556
"275","01342","2018",7,7,0,311407.142857143,3069.14285714286,100.857142857143
"276","01343","2018",18,18,0,196835.777777778,1691.5,120.722222222222
"277","01344","2018",59,43,16,181651.559322034,1952.49152542373,94.6949152542373
"278","01345","2018",31,18,13,140405.322580645,1582.67741935484,93.1612903225806
"279","01346","2018",17,16,1,159610.882352941,1354.11764705882,117.529411764706
"280","01347","2018",20,20,0,349942,3094.65,116
"281","01348","2018",31,26,5,181976.064516129,1702.61290322581,109.612903225806
"282","01349","2018",7,7,0,275458.571428571,1913.28571428571,141.857142857143
"283","01350","2018",33,27,6,157388.333333333,1650.78787878788,95.030303030303
"284","01351","2018",20,19,1,200491.25,1781.85,114.9
"285","01352","2018",5,5,0,135060,1434.8,94
"286","01353","2018",26,24,2,239680.961538462,2284.38461538462,108.269230769231
"287","01354","2018",145,30,115,357573.110344828,3788.59310344828,94.6551724137931
"288","01355","2018",3,3,0,128533.333333333,951.666666666667,130.333333333333
"289","01356","2018",5,5,0,107240,1733,69.4
"290","01357","2018",4,3,1,143250,1265.25,121.75
"291","01358","2018",7,7,0,182142.857142857,1534.14285714286,125.714285714286
"292","01359","2018",3,3,0,200583.333333333,2397.66666666667,86.6666666666667
"293","01360","2018",25,19,6,414048.04,4018.12,108
"294","01361","2018",18,18,0,298922.833333333,2463.94444444444,127.277777777778
"295","01362","2018",15,15,0,322236.333333333,2693.93333333333,121.866666666667
"296","01363","2018",22,20,2,161118.181818182,1660.09090909091,100.136363636364
"297","01364","2018",10,10,0,162675,1569.8,106.3
"298","01365","2018",11,11,0,156697.272727273,1448.09090909091,115.545454545455
"299","01366","2018",11,11,0,201113.636363636,1991.27272727273,101.363636363636
"300","01367","2018",9,9,0,120571.111111111,1161.44444444444,110.222222222222
"301","01368","2018",14,14,0,202525,1861.21428571429,118.642857142857
"302","01369","2018",5,4,1,203964,1724.6,128.8
"303","01370","2018",38,3,35,98236.8421052632,1489.84210526316,66.6842105263158
"304","01371","2018",15,10,5,201234.666666667,2394.26666666667,85.8
"305","01372","2018",5,5,0,145400,1418.4,103.4
"306","01373","2018",4,3,1,171900,1903.75,90.25
"307","01374","2018",21,21,0,228943.380952381,1771.52380952381,133.47619047619
"308","01375","2018",5,5,0,172223,1685.8,103.6
"309","01376","2018",54,21,33,203465.092592593,2208.90740740741,89.4074074074074
"310","01378","2018",34,28,6,209673.235294118,2192.85294117647,99.1176470588235
"311","01379","2018",11,11,0,173076.363636364,1690.81818181818,107
"312","01380","2018",4,4,0,122875,1130.5,108.75
"313","01381","2018",20,20,0,220047.5,1779.85,124.25
"314","01382","2018",2,2,0,324335,2467,132.5
"315","01383","2018",21,18,3,201918.571428571,1897.47619047619,107.142857142857
"316","01384","2018",24,22,2,102419.166666667,1196.91666666667,91.875
"317","01385","2018",6,6,0,204746.666666667,1684.5,120.333333333333
"318","01386","2018",14,11,3,140720,1575.71428571429,86.2142857142857
"319","01387","2018",4,4,0,175532.5,1917,92.75
"320","01388","2018",14,14,0,106560.714285714,1198.35714285714,93.0714285714286
"321","01389","2018",23,20,3,228997.652173913,2090.82608695652,113.217391304348
"322","01390","2018",16,14,2,274710.3125,2333.625,117.25
"323","01391","2018",2,2,0,100900,1113.5,106
"324","01392","2018",8,8,0,172612.5,1553.25,117.625
"325","01393","2018",7,7,0,247461.428571429,1974.85714285714,127.714285714286
"326","01396","2018",14,11,3,135297.357142857,1655.14285714286,84.5714285714286
"327","01397","2018",5,4,1,618842,4002.4,148.6
"328","01398","2018",15,13,2,284078,2396.93333333333,119
"329","01399","2018",32,20,12,447842,4620.9375,99.5625
"330","01400","2018",1,1,0,285000,1100,259
"331","01401","2018",26,15,11,461732.884615385,4124.19230769231,115.153846153846
"332","01402","2018",8,8,0,142752.5,1392,105.75
"333","01403","2018",12,11,1,122994.583333333,1276.91666666667,104.583333333333
"334","01404","2018",7,7,0,182962.857142857,2369.28571428571,80.8571428571429
"335","01405","2018",11,11,0,231627.272727273,1859.09090909091,127.090909090909
"336","01406","2018",4,4,0,191500,1666,109.75
"337","01407","2018",19,7,12,130524.210526316,1968,72.3157894736842
"338","01408","2018",4,4,0,172000,1208,148
"339","01410","2018",5,5,0,187100,1384.6,135.6
"340","01411","2018",6,6,0,122100,1363.16666666667,95
"341","01412","2018",8,8,0,231171.875,2223.375,107.75
"342","01415","2018",3,3,0,213333.333333333,1883.33333333333,132
"343","01416","2018",17,15,2,99837.8823529412,1109.94117647059,90.5882352941177
"344","01418","2018",7,6,1,311436.857142857,2584.85714285714,126.142857142857
"345","01419","2018",74,40,34,418982.972972973,4127.43243243243,103.256756756757
"346","01420","2018",21,6,15,121527.380952381,1471.90476190476,89.7619047619048
"347","01421","2018",12,11,1,148922.083333333,1642.41666666667,92.5833333333333
"348","01422","2018",21,20,1,200652.380952381,1849.19047619048,105.952380952381
"349","01423","2018",21,21,0,314030.952380952,2728.04761904762,121.904761904762
"350","01424","2018",25,19,6,306832.4,2832.48,113.04
"351","01425","2018",1,1,0,150000,1220,123
"352","01426","2018",32,32,0,164084.34375,1581.4375,107.5625
"353","01427","2018",123,67,56,223913.658536585,2533.14634146341,88.6991869918699
"354","01428","2018",2,2,0,171800,2537.5,81.5
"355","01429","2018",3,3,0,189180,1914,99.6666666666667
"356","01430","2018",7,7,0,230757.285714286,2065.42857142857,107.428571428571
"357","01431","2018",11,11,0,172619.090909091,1763.90909090909,98.8181818181818
"358","01432","2018",5,5,0,163350,1301.8,131.4
"359","01433","2018",1,1,0,164000,1505,109
"360","01434","2018",6,6,0,223137.5,1829.33333333333,121.5
"361","01435","2018",26,22,4,520909.153846154,4567.57692307692,117.423076923077
"362","01436","2018",7,3,4,413393.571428571,4347.57142857143,87.4285714285714
"363","01437","2018",2,2,0,107680,947,112.5
"364","01441","2018",4,4,0,185232.5,1498.75,127.5
"365","01443","2018",65,39,26,188636.292307692,2161.16923076923,89.7538461538462
"366","01444","2018",24,24,0,144054.166666667,1396.875,113.041666666667
"367","01445","2018",4,4,0,154017.5,1370.5,114.5
"368","01446","2018",19,18,1,284932.947368421,2351.78947368421,124.736842105263
"369","01447","2018",15,15,0,166303.666666667,1321.86666666667,134.4
"370","01448","2018",2,2,0,297050,2014,156.5
"371","01449","2018",8,8,0,175964,1896.375,100
"372","01450","2018",44,42,2,222216.590909091,2377.90909090909,97.0681818181818
"373","01451","2018",46,40,6,203795.565217391,1884.41304347826,107.565217391304
"374","01452","2018",12,9,3,108616.666666667,1435.58333333333,81.0833333333333
"375","01453","2018",8,8,0,171310,1883.625,97.875
"376","01454","2018",13,10,3,163599.769230769,1636,99.7692307692308
"377","01457","2018",30,28,2,191522.633333333,1643.06666666667,117.833333333333
"378","02001","2018",6,6,0,124000,1322.66666666667,99.8333333333333
"379","02002","2018",6,6,0,93650,971.166666666667,94.6666666666667
"380","02003","2018",10,10,0,119982.5,1248.7,98.1
"381","02004","2018",4,4,0,80412.5,734.25,107.5
"382","02005","2018",2,2,0,263975,1490,178.5
"383","02006","2018",1,1,0,385000,2278,169
"384","02008","2018",1,1,0,79000,648,122
"385","02009","2018",8,8,0,108775,1156.75,94.375
"386","02010","2018",3,3,0,179666.666666667,1352.33333333333,131.333333333333
"387","02011","2018",11,11,0,144454.545454545,1297.36363636364,119.090909090909
"388","02013","2018",3,3,0,138333.333333333,941.666666666667,153
"389","02014","2018",8,8,0,109637.5,1192.875,93.25
"390","02015","2018",2,2,0,200750,2183,95
"391","02016","2018",1,1,0,135000,1570,86
"392","02017","2018",4,4,0,101750,987.25,94.75
"393","02018","2018",27,27,0,110962.962962963,1305.55555555556,87.0740740740741
"394","02019","2018",3,3,0,69666.6666666667,766.333333333333,96
"395","02020","2018",4,4,0,132250,1027,130.5
"396","02022","2018",11,11,0,94604.5454545455,1087.36363636364,95.3636363636364
"397","02025","2018",5,5,0,120400,1248.2,100.2
"398","02027","2018",1,1,0,158000,1436,110
"399","02028","2018",27,27,0,144340.740740741,1223.77777777778,118.703703703704
"400","02029","2018",6,6,0,131500,1210.5,105.166666666667
"401","02030","2018",1,1,0,60000,632,95
"402","02031","2018",6,6,0,68950,702.833333333333,104
"403","02032","2018",2,2,0,77500,861,90
"404","02033","2018",1,1,0,110000,932,118
"405","02035","2018",1,1,0,147500,1283,115
"406","02036","2018",2,2,0,60000,1028.5,60
"407","02037","2018",14,14,0,129914.285714286,1469.21428571429,90
"408","02039","2018",2,2,0,83350,954,81
"409","02040","2018",2,2,0,66000,653,100
"410","02041","2018",8,8,0,96375,872.5,110.625
"411","02042","2018",4,4,0,130375,1395.25,93.25
"412","02044","2018",2,2,0,209000,1340,145
"413","02046","2018",1,1,0,80000,889,90
"414","02048","2018",2,2,0,96000,986.5,100
"415","02049","2018",9,9,0,105097.222222222,1100,101.333333333333
"416","02050","2018",2,2,0,115500,1552.5,76.5
"417","02051","2018",4,4,0,125750,1732.75,73.25
"418","02053","2018",8,8,0,165928.75,1358.75,119.25
"419","02054","2018",5,5,0,143300,1104.6,135.2
"420","02056","2018",5,5,0,98800,861.2,118.8
"421","02057","2018",7,7,0,114126,1023,115.714285714286
"422","02058","2018",11,10,1,124636.363636364,1236.36363636364,103
"423","02059","2018",17,17,0,82809.4117647059,970.176470588235,86.8823529411765
"424","02061","2018",1,1,0,53000,530,100
"425","02062","2018",2,2,0,152500,1350,157.5
"426","02063","2018",7,7,0,98214.2857142857,1008.57142857143,96.4285714285714
"427","02064","2018",32,32,0,124235.46875,1462.9375,85.6875
"428","02065","2018",7,7,0,118242.857142857,1182.14285714286,102.571428571429
"429","02066","2018",1,1,0,120000,1132,106
"430","02067","2018",5,5,0,101000,968.4,112
"431","02068","2018",1,1,0,105000,1117,94
"432","02069","2018",1,1,0,98000,961,102
"433","02070","2018",6,6,0,78833.3333333333,845.166666666667,98.6666666666667
"434","02071","2018",7,7,0,101571.571428571,1189.85714285714,90.7142857142857
"435","02073","2018",4,4,0,115743.75,1041.75,114.25
"436","02074","2018",8,8,0,85125,998.375,84.25
"437","02075","2018",2,2,0,107500,1076,87
"438","02076","2018",3,3,0,165400,1526.33333333333,109
"439","02077","2018",4,4,0,130725,1491.5,86.25
"440","02078","2018",3,3,0,113333.333333333,1089.66666666667,105.333333333333
"441","02079","2018",5,5,0,73980,825.8,98.6
"442","02080","2018",5,5,0,153940,1306.4,116.8
"443","02081","2018",5,5,0,128800,1120.6,112.2
"444","02082","2018",1,1,0,120000,1000,120
"445","02083","2018",12,12,0,143933.333333333,1357.16666666667,113
"446","02084","2018",4,4,0,143500,1517,111
"447","02085","2018",14,14,0,152953.142857143,1584.14285714286,98.0714285714286
"448","02086","2018",14,14,0,113692.857142857,1295.57142857143,86.3571428571429
"449","02089","2018",17,17,0,148352.941176471,1462.05882352941,95.5294117647059
"450","02090","2018",1,1,0,105000,875,120
"451","02091","2018",1,1,0,207000,1408,147
"452","02093","2018",13,13,0,96798.4615384615,1269.38461538462,84.1538461538462
"453","02094","2018",4,4,0,195900,1447.75,136.5
"454","02095","2018",56,55,1,61483.9285714286,790.589285714286,83.2142857142857
"455","02096","2018",1,1,0,54400,837,65
"456","02097","2018",2,2,0,66450,817.5,78.5
"457","02098","2018",5,5,0,128200,1259.2,106.6
"458","02099","2018",4,4,0,122312.5,1196.5,102.5
"459","02100","2018",1,1,0,123500,1420,87
"460","02101","2018",2,2,0,109000,962,122
"461","02102","2018",2,2,0,145000,955,159
"462","02103","2018",14,14,0,79082.1428571429,805.857142857143,97.2857142857143
"463","02105","2018",2,2,0,127500,1201,107
"464","02106","2018",11,11,0,107625.454545455,1344.45454545455,80.0909090909091
"465","02107","2018",2,2,0,91750,826,104
"466","02108","2018",3,3,0,130633.333333333,1211.33333333333,105
"467","02109","2018",2,2,0,77500,557.5,133.5
"468","02110","2018",16,16,0,155111.25,1314.5,115.5
"469","02111","2018",12,12,0,127708.333333333,1225.58333333333,103.833333333333
"470","02112","2018",6,6,0,94716.6666666667,778,126.666666666667
"471","02114","2018",15,14,1,132633.333333333,1716.93333333333,83.1333333333333
"472","02115","2018",2,2,0,103750,1078.5,95
"473","02116","2018",1,1,0,48750,443,110
"474","02117","2018",4,4,0,129750,1330.25,105
"475","02118","2018",2,2,0,61500,1110.5,56
"476","02119","2018",6,6,0,84166.6666666667,726.666666666667,121.666666666667
"477","02120","2018",1,1,0,60000,1132,53
"478","02121","2018",1,1,0,72500,518,140
"479","02123","2018",5,5,0,117190,1025.2,114.4
"480","02124","2018",8,8,0,127919.5,1072.75,122.625
"481","02125","2018",2,2,0,159000,1410.5,124.5
"482","02126","2018",7,7,0,98142.8571428571,996.428571428571,98.2857142857143
"483","02127","2018",2,2,0,148750,1187.5,106.5
"484","02128","2018",17,17,0,140664.705882353,1581.82352941176,96.3529411764706
"485","02130","2018",3,3,0,89466.6666666667,854.333333333333,95.6666666666667
"486","02131","2018",21,21,0,146150,1292.66666666667,114.047619047619
"487","02132","2018",2,2,0,193950,1315,143
"488","02133","2018",5,5,0,78140,1012.2,77.2
"489","02134","2018",7,7,0,102328.571428571,1124.71428571429,84.2857142857143
"490","02135","2018",19,19,0,97393.8421052632,875.947368421053,115.631578947368
"491","02136","2018",3,3,0,126460,1236,107.666666666667
"492","02137","2018",2,2,0,172500,1517.5,128
"493","02138","2018",2,2,0,116500,1568,83.5
"494","02139","2018",3,3,0,132666.666666667,1515.66666666667,89.6666666666667
"495","02140","2018",5,5,0,103000,1032,101.6
"496","02141","2018",9,9,0,98947.2222222222,976.222222222222,103
"497","02142","2018",1,1,0,70000,2258,31
"498","02144","2018",1,1,0,55000,859,64
"499","02145","2018",3,3,0,180166.666666667,1951,95.3333333333333
"500","02146","2018",4,4,0,140833.25,1309.75,108
"501","02148","2018",2,2,0,108000,1406.5,76
"502","02150","2018",1,1,0,19990,444,45
"503","02151","2018",1,1,0,295000,1821,162
"504","02152","2018",1,1,0,123000,1025,120
"505","02153","2018",6,6,0,117916.666666667,1465.83333333333,84.5
"506","02154","2018",3,3,0,142333.333333333,1783,85.3333333333333
"507","02155","2018",5,5,0,105860,1146.2,89
"508","02156","2018",1,1,0,180000,1895,95
"509","02157","2018",8,8,0,124175,1291.375,99.25
"510","02158","2018",3,3,0,132333.333333333,1665.33333333333,81
"511","02159","2018",2,2,0,97500,816,121
"512","02160","2018",2,2,0,135000,1211.5,109.5
"513","02162","2018",1,1,0,210000,1438,146
"514","02163","2018",19,17,2,134536.842105263,1439.26315789474,97.3157894736842
"515","02164","2018",5,5,0,124100,1289.6,90.4
"516","02165","2018",12,12,0,85283.3333333333,992.083333333333,86.8333333333333
"517","02166","2018",5,5,0,137860,1555.4,87
"518","02167","2018",10,10,0,122300,1431.4,86.5
"519","02168","2018",142,89,53,141604.23943662,1727.43661971831,83.6830985915493
"520","02169","2018",2,2,0,68450,879,78
"521","02170","2018",2,2,0,130000,1536.5,90.5
"522","02171","2018",1,1,0,160800,1914,84
"523","02172","2018",2,2,0,124100,1395,90
"524","02173","2018",143,127,16,108817.188811189,1252.67132867133,89.979020979021
"525","02174","2018",9,9,0,141277.777777778,1360.33333333333,106.666666666667
"526","02176","2018",4,4,0,104875,1481.75,72.25
"527","02177","2018",1,1,0,33700,733,46
"528","02178","2018",1,1,0,82400,777,106
"529","02179","2018",4,4,0,99875,891.5,125.75
"530","02180","2018",8,8,0,113657,1133.625,102.125
"531","02181","2018",1,1,0,28000,350,80
"532","02182","2018",1,1,0,138240,1162,119
"533","02183","2018",2,2,0,150500,962,158.5
"534","02184","2018",4,4,0,85300,968.25,92
"535","02185","2018",7,7,0,122238.571428571,1364.42857142857,85.2857142857143
"536","02186","2018",17,17,0,131623.941176471,1667.47058823529,86.8823529411765
"537","02187","2018",12,9,3,136083.333333333,1573.08333333333,87.0833333333333
"538","02188","2018",4,4,0,99375,933.75,106.25
"539","02190","2018",2,2,0,127525,1044.5,120.5
"540","02191","2018",8,8,0,136562.5,1202.5,115.25
"541","02192","2018",4,4,0,117625,859.75,134.5
"542","02194","2018",2,2,0,78000,565,130
"543","02195","2018",8,8,0,135375,1377,101.625
"544","02196","2018",4,4,0,110982,1187.5,101
"545","02197","2018",7,7,0,105142.857142857,943.857142857143,120.571428571429
"546","02199","2018",5,5,0,201780,1511.8,129.4
"547","02200","2018",1,1,0,1e+05,885,113
"548","02201","2018",5,5,0,155450,1362,125.4
"549","02203","2018",10,10,0,137575,1232.6,130
"550","02204","2018",1,1,0,46100,809,57
"551","02205","2018",2,2,0,180000,1353.5,132.5
"552","02207","2018",3,3,0,135333.333333333,1223,115.333333333333
"553","02208","2018",4,4,0,121350,1340.25,89
"554","02209","2018",10,9,1,91837.5,1245.7,79.9
"555","02210","2018",9,8,1,147222.222222222,1460.33333333333,115.666666666667
"556","02211","2018",2,2,0,173200,1521.5,115
"557","02212","2018",3,3,0,74768.6666666667,901,83.6666666666667
"558","02213","2018",10,10,0,140070,1513.7,94.8
"559","02215","2018",2,2,0,150000,862,194.5
"560","02216","2018",8,8,0,135437.5,1339.625,102.125
"561","02217","2018",14,14,0,115125.357142857,1056.92857142857,109.642857142857
"562","02218","2018",6,6,0,102270,1049.33333333333,99.5
"563","02219","2018",1,1,0,160000,1538,104
"564","02220","2018",8,8,0,163276.25,1327.125,136.75
"565","02223","2018",4,4,0,104500,1087.5,96.75
"566","02224","2018",6,6,0,128666.666666667,1695,79.6666666666667
"567","02225","2018",2,2,0,152500,1238.5,122.5
"568","02226","2018",20,19,1,129436.7,1423.35,90.05
"569","02227","2018",4,4,0,105000,730.75,152
"570","02228","2018",2,2,0,165500,1886.5,88
"571","02229","2018",1,1,0,90000,900,100
"572","02230","2018",4,4,0,200571.25,1337.5,170
"573","02231","2018",4,4,0,106125,1076.75,98
"574","02234","2018",1,1,0,57000,731,78
"575","02235","2018",1,1,0,170000,2742,62
"576","02236","2018",2,2,0,110000,1382,73.5
"577","02237","2018",15,15,0,90486.6666666667,1085.53333333333,90
"578","02238","2018",20,19,1,118980,1197.65,102.7
"579","02239","2018",18,16,2,121469.444444444,1593.38888888889,76.3333333333333
"580","02240","2018",1,1,0,137500,1058,130
"581","02241","2018",1,1,0,55000,679,81
"582","02242","2018",4,4,0,164000,2091.75,112.5
"583","02243","2018",36,34,2,126773.25,1442.16666666667,89.6388888888889
"584","02245","2018",21,21,0,127453.095238095,1504.66666666667,91.2857142857143
"585","02246","2018",5,5,0,99600,946.4,105.8
"586","02248","2018",2,2,0,123500,809.5,149.5
"587","02249","2018",4,4,0,108750,1354.75,75.75
"588","02250","2018",3,3,0,139833.333333333,1584.33333333333,86
"589","02251","2018",1,1,0,60000,536,112
"590","02252","2018",1,1,0,111000,1037,107
"591","02253","2018",5,5,0,188100,1559.4,120.6
"592","02254","2018",4,4,0,139250,1271,108
"593","02255","2018",1,1,0,63000,529,119
"594","02256","2018",2,2,0,79125,771,93
"595","02257","2018",4,4,0,173000,1563.75,110.5
"596","02258","2018",4,4,0,144487.5,1781.25,82.5
"597","02259","2018",3,3,0,87000,1436,53
"598","02260","2018",3,3,0,114466.666666667,1614.66666666667,75
"599","02262","2018",2,2,0,160110,1617.5,103
"600","02264","2018",9,9,0,72577.7777777778,883.555555555556,85.7777777777778
"601","02267","2018",2,2,0,169085,1594.5,106
"602","02268","2018",10,10,0,124300,1457.4,86.4
"603","02269","2018",3,3,0,55000,574.333333333333,92.3333333333333
"604","02270","2018",2,2,0,154000,1229.5,125
"605","02271","2018",4,4,0,145250,1286.75,119.5
"606","02273","2018",7,7,0,126428.571428571,1157.71428571429,131
"607","02274","2018",1,1,0,115000,846,136
"608","02275","2018",2,2,0,67350,703.5,96.5
"609","02277","2018",5,5,0,148400,1213.6,131.6
"610","02278","2018",1,1,0,145000,797,182
"611","02279","2018",7,7,0,152421.428571429,1682.14285714286,90.1428571428571
"612","02280","2018",6,6,0,113891.666666667,1069.83333333333,122
"613","02281","2018",7,7,0,123954.285714286,1025.14285714286,128.571428571429
"614","02282","2018",6,6,0,116916.666666667,1136,105.166666666667
"615","02283","2018",3,3,0,156000,1109.66666666667,165.333333333333
"616","02284","2018",2,2,0,39500,462.5,81.5
"617","02286","2018",7,7,0,63928.5714285714,924.714285714286,70
"618","02287","2018",10,10,0,124530,1358.5,99.8
"619","02288","2018",3,3,0,114166.666666667,1072.66666666667,110.333333333333
"620","02289","2018",4,4,0,159250,1600,100.75
"621","02290","2018",21,21,0,159733.333333333,1715.42857142857,93.7619047619048
"622","02291","2018",4,4,0,73875,661.5,99.75
"623","02292","2018",10,10,0,128180,1514.3,83.2
"624","02293","2018",3,3,0,68436,635,118
"625","02294","2018",1,1,0,154000,1124,137
"626","02295","2018",8,8,0,112753.75,1009.375,110.875
"627","02296","2018",7,7,0,125154.857142857,1155.28571428571,113.142857142857
"628","02298","2018",10,10,0,85950,903.3,89.5
"629","02299","2018",3,3,0,172166.666666667,1512,121
"630","02302","2018",4,4,0,144500,1705.25,88.75
"631","02303","2018",10,10,0,231950,1551.3,152.4
"632","02304","2018",11,9,2,65045.4545454545,756.909090909091,88.0909090909091
"633","02305","2018",36,34,2,106923.611111111,1144.58333333333,100
"634","02306","2018",9,9,0,81500,812.333333333333,101.333333333333
"635","02307","2018",34,30,4,158608.529411765,1935.82352941176,85.6764705882353
"636","02308","2018",5,5,0,62980,819,81.2
"637","02309","2018",8,8,0,115375,1084.125,112.75
"638","02310","2018",3,3,0,147166.666666667,1096.33333333333,144.333333333333
"639","02311","2018",2,2,0,106747.5,988.5,103.5
"640","02312","2018",8,8,0,166550,1519.5,109
"641","02313","2018",5,5,0,88400,709.8,116.2
"642","02315","2018",21,21,0,122863.333333333,1179.28571428571,109.285714285714
"643","02316","2018",1,1,0,95000,1759,54
"644","02318","2018",17,17,0,83982.3529411765,1111.35294117647,77.6470588235294
"645","02319","2018",5,5,0,167900,1205,140.4
"646","02320","2018",4,4,0,134250,1751.5,78.5
"647","02321","2018",5,5,0,144000,970.4,136.2
"648","02322","2018",4,4,0,80725,968.25,76.5
"649","02324","2018",5,5,0,94200,894.4,101.2
"650","02326","2018",12,12,0,149443.333333333,1724.83333333333,97.9166666666667
"651","02327","2018",2,2,0,106500,1284,81.5
"652","02328","2018",10,10,0,120755,1340.4,85.3
"653","02329","2018",3,3,0,237633.333333333,1503.33333333333,150
"654","02330","2018",5,5,0,128000,1186.6,107.4
"655","02331","2018",1,1,0,150000,750,200
"656","02332","2018",4,4,0,89875,1059.75,80.5
"657","02333","2018",3,3,0,50000,800,62.3333333333333
"658","02334","2018",24,24,0,85406.25,882.125,92.8333333333333
"659","02335","2018",1,1,0,188000,1315,143
"660","02336","2018",11,11,0,110363.636363636,1080.09090909091,100.636363636364
"661","02337","2018",3,3,0,92603.3333333333,825,114.666666666667
"662","02339","2018",10,10,0,105800,1344.2,78.8
"663","02340","2018",68,68,0,106672.823529412,1221.86764705882,87.9705882352941
"664","02341","2018",1,1,0,130000,1140,114
"665","02342","2018",1,1,0,45000,672,67
"666","02343","2018",3,3,0,76633.3333333333,977.666666666667,88.6666666666667
"667","02346","2018",8,8,0,128687.5,993.75,133.375
"668","02347","2018",6,6,0,166000,1637.16666666667,103
"669","02351","2018",2,2,0,205500,1751,123
"670","02352","2018",5,5,0,100250,777,130
"671","02355","2018",16,16,0,114490.1875,1226.5,90.625
"672","02356","2018",3,3,0,189666.666666667,1620.66666666667,127.666666666667
"673","02358","2018",4,4,0,135625,1120.5,118.75
"674","02359","2018",13,13,0,134248.461538462,1408.92307692308,98.3076923076923
"675","02360","2018",29,29,0,161637.24137931,1819.10344827586,90.0689655172414
"676","02361","2018",28,28,0,75519.6428571429,895.035714285714,82.8928571428571
"677","02362","2018",2,2,0,175000,1601,111
"678","02363","2018",3,3,0,63333.3333333333,655.333333333333,104.666666666667
"679","02364","2018",5,5,0,207562,1535.2,135.8
"680","02366","2018",2,2,0,87500,608.5,144.5
"681","02367","2018",2,2,0,133000,1093,122.5
"682","02368","2018",6,6,0,146833.333333333,1780.16666666667,79.3333333333333
"683","02369","2018",5,5,0,90876,902.6,115.6
"684","02370","2018",4,4,0,156300,1138.25,132.75
"685","02371","2018",21,21,0,100262.238095238,1167.47619047619,88.5714285714286
"686","02372","2018",9,9,0,117000,1188.66666666667,108.333333333333
"687","02373","2018",2,2,0,88000,957,94.5
"688","02374","2018",12,11,1,95080.8333333333,1151.5,83.5833333333333
"689","02376","2018",2,2,0,77500,522.5,160
"690","02377","2018",2,2,0,55009,1066,54
"691","02379","2018",1,1,0,170000,1848,92
"692","02381","2018",72,69,3,68814.6527777778,825.444444444444,84.3472222222222
"693","02382","2018",3,3,0,149633.333333333,1058,145.666666666667
"694","02383","2018",13,13,0,123353.846153846,1225.38461538462,99.6153846153846
"695","02384","2018",1,1,0,45000,549,82
"696","02385","2018",1,1,0,44500,494,90
"697","02386","2018",1,1,0,146500,694,211
"698","02387","2018",6,6,0,144561.666666667,1433.5,97.3333333333333
"699","02388","2018",4,4,0,79375,799.25,101.75
"700","02389","2018",9,9,0,106411.111111111,1381.55555555556,81.7777777777778
"701","02390","2018",2,2,0,161800,1425,114
"702","02391","2018",4,4,0,113750,799.25,144.25
"703","02392","2018",4,4,0,76475,739.75,98
"704","02393","2018",2,2,0,132500,893,161
"705","02395","2018",1,1,0,128000,985,130
"706","02397","2018",11,11,0,104972.727272727,1016,99.3636363636364
"707","02398","2018",1,1,0,140000,1148,122
"708","02399","2018",5,5,0,153480,1684.6,92.6
"709","02404","2018",1,1,0,116500,1404,83
"710","02405","2018",3,3,0,108806.666666667,1050.33333333333,130.666666666667
"711","02408","2018",212,140,72,84478.608490566,1129.74528301887,77.4528301886792
"712","02409","2018",1,1,0,70000,1707,41
"713","02410","2018",1,1,0,163000,1052,155
"714","02414","2018",1,1,0,27000,519,52
"715","02415","2018",3,3,0,212333.333333333,2032,101.666666666667
"716","02416","2018",3,3,0,89600,768.666666666667,122.333333333333
"717","02417","2018",1,1,0,68000,654,104
"718","02418","2018",3,3,0,135000,1399,91.3333333333333
"719","02419","2018",2,2,0,64000,532.5,123
"720","02420","2018",5,5,0,109260,1406.4,79.4
"721","02422","2018",8,8,0,81250,865.875,90.875
"722","02423","2018",4,4,0,73059.25,1164,65.5
"723","02425","2018",1,1,0,50000,388,129
"724","02426","2018",8,8,0,105123.75,1154.25,103.75
"725","02427","2018",2,2,0,143500,1188,158
"726","02429","2018",1,1,0,143500,1148,125
"727","02430","2018",14,14,0,97900,992.5,99.3571428571429
"728","02431","2018",5,5,0,80800,1078.2,81.4
"729","02433","2018",2,2,0,119600,988,133.5
"730","02438","2018",4,4,0,150525,1198.25,140.75
"731","02439","2018",15,15,0,122552.133333333,1112.46666666667,122.666666666667
"732","02440","2018",1,1,0,173600,2226,78
"733","02441","2018",3,3,0,246666.666666667,1883.33333333333,131.666666666667
"734","02443","2018",1,1,0,86148,783,110
"735","02444","2018",2,2,0,76000,642.5,117.5
"736","02445","2018",3,3,0,94333.3333333333,1006.66666666667,104.333333333333
"737","02448","2018",2,2,0,128250,1370,94.5
"738","02449","2018",1,1,0,110000,2115,52
"739","02450","2018",4,4,0,112000,948.5,118.25
"740","02451","2018",1,1,0,35000,854,41
"741","02452","2018",2,2,0,224000,1483.5,152
"742","02453","2018",7,7,0,144364.285714286,1392.28571428571,104.142857142857
"743","02454","2018",5,5,0,150480,998,156.2
"744","02456","2018",1,1,0,175000,1882,93
"745","02457","2018",6,6,0,117650,1281,95.3333333333333
"746","02458","2018",11,11,0,130863.636363636,1373.36363636364,96.6363636363636
"747","02460","2018",1,1,0,95000,1056,90
"748","02462","2018",4,4,0,135587.5,1190.5,115.25
"749","02464","2018",4,4,0,87250,975.25,107.25
"750","02465","2018",5,5,0,177460,1592.6,113.2
"751","02466","2018",4,4,0,132000,1474.5,88.25
"752","02468","2018",25,24,1,103741.2,985.48,98.76
"753","02469","2018",1,1,0,1e+05,1389,72
"754","02472","2018",3,3,0,79216.6666666667,777.666666666667,104.666666666667
"755","02473","2018",1,1,0,140000,1443,97
"756","02474","2018",13,13,0,93023.0769230769,1082.69230769231,83.4615384615385
"757","02476","2018",9,9,0,82955.5555555556,947.555555555556,100.666666666667
"758","02477","2018",7,7,0,260000,1344.71428571429,205.285714285714
"759","02478","2018",2,2,0,101935,938,113
"760","02480","2018",4,4,0,80550,863,105
"761","02481","2018",7,7,0,245114.285714286,1375.28571428571,169.857142857143
"762","02483","2018",5,5,0,79020,911,79.2
"763","02484","2018",3,3,0,92833.3333333333,1459.33333333333,64.3333333333333
"764","02487","2018",8,8,0,128668.75,1390.625,93.5
"765","02488","2018",1,1,0,73000,1000,73
"766","02489","2018",3,3,0,131666.666666667,1272,119
"767","02490","2018",2,2,0,135900,798,144.5
"768","02491","2018",6,6,0,80014.3333333333,837.333333333333,104.5
"769","02492","2018",5,5,0,93000,1051.8,89.6
"770","02493","2018",5,5,0,243000,3635.4,76.2
"771","02494","2018",2,2,0,81000,672.5,123
"772","02495","2018",14,14,0,121571.428571429,1065.64285714286,107
"773","02497","2018",14,14,0,159718.571428571,1574.92857142857,103.428571428571
"774","02498","2018",3,3,0,194258.666666667,1215.33333333333,184.666666666667
"775","02500","2018",4,4,0,74975,662.75,109.25
"776","02502","2018",7,7,0,75085.7142857143,692.428571428571,111
"777","02503","2018",6,6,0,61012.5,669.166666666667,102.333333333333
"778","02504","2018",16,16,0,104568.75,1131.8125,90.125
"779","02505","2018",1,1,0,280000,1647,170
"780","02506","2018",3,3,0,180766.666666667,2136.66666666667,91
"781","02508","2018",1,1,0,133000,1462,91
"782","02509","2018",2,2,0,139115,1359.5,97
"783","02511","2018",4,4,0,129250,1140,110.75
"784","02512","2018",5,5,0,164720,1922.2,88.2
"785","02513","2018",2,2,0,97000,740.5,130
"786","02514","2018",9,9,0,173444.444444444,1397.55555555556,146.888888888889
"787","02515","2018",1,1,0,152000,1267,120
"788","02516","2018",1,1,0,47900,798,60
"789","02517","2018",4,4,0,107250,877.75,119
"790","02518","2018",3,3,0,133666.666666667,1153,115
"791","02519","2018",2,2,0,124000,767,160
"792","02520","2018",4,4,0,131230.25,1501.75,85.25
"793","02521","2018",21,21,0,167491.666666667,1703.47619047619,104.952380952381
"794","02522","2018",1,1,0,80000,584,137
"795","02524","2018",6,6,0,108280,1099,105.833333333333
"796","02525","2018",4,4,0,116250,1316.75,101.25
"797","02527","2018",5,5,0,117400,1609.6,85.6
"798","02528","2018",1,1,0,162400,1185,137
"799","02529","2018",6,6,0,102650,835,140
"800","02530","2018",2,2,0,102500,791.5,125
"801","02531","2018",1,1,0,155700,741,210
"802","02532","2018",9,9,0,97177.7777777778,922.777777777778,106.333333333333
"803","02533","2018",1,1,0,110000,1467,75
"804","02535","2018",2,2,0,63300,833.5,75
"805","02536","2018",1,1,0,86000,729,118
"806","02537","2018",1,1,0,205000,1165,176
"807","02538","2018",2,2,0,206400,2058.5,99
"808","02539","2018",4,4,0,123375,1124.75,100
"809","02540","2018",9,9,0,168211.111111111,1557.55555555556,109.333333333333
"810","02541","2018",5,5,0,223166,1809,122
"811","02542","2018",1,1,0,130000,1161,112
"812","02543","2018",11,11,0,110800,988.090909090909,118.818181818182
"813","02546","2018",3,3,0,113833.333333333,1488,78.6666666666667
"814","02548","2018",1,1,0,119000,992,120
"815","02549","2018",6,6,0,107650,1399.83333333333,76.3333333333333
"816","02550","2018",1,1,0,141000,1584,89
"817","02551","2018",1,1,0,180000,1324,136
"818","02553","2018",2,2,0,133500,1332.5,104.5
"819","02554","2018",6,6,0,150583.333333333,1663.16666666667,97.3333333333333
"820","02555","2018",35,31,4,139528.285714286,1628.02857142857,88.6
"821","02558","2018",17,17,0,76073.5294117647,774.058823529412,95
"822","02559","2018",2,2,0,127100,1518.5,80
"823","02560","2018",5,5,0,145846,1324.8,120.6
"824","02561","2018",2,2,0,130000,1859.5,80
"825","02562","2018",2,2,0,136500,1298,109
"826","02563","2018",2,2,0,72000,866.5,84
"827","02564","2018",3,3,0,77595,982,85.6666666666667
"828","02565","2018",3,3,0,130000,1315.66666666667,98.3333333333333
"829","02566","2018",16,16,0,111343.75,1158,95.5625
"830","02567","2018",4,4,0,78875,930.25,87
"831","02568","2018",3,3,0,296666.666666667,2197.33333333333,123.333333333333
"832","02569","2018",4,4,0,102275,996,100
"833","02570","2018",2,2,0,168500,1599.5,105
"834","02571","2018",5,5,0,109800,1213.6,89.8
"835","02572","2018",8,8,0,196326.25,1775.625,115
"836","02574","2018",9,9,0,82683.3333333333,990.777777777778,88.5555555555556
"837","02575","2018",10,10,0,64394,746.8,90.5
"838","02576","2018",2,2,0,140250,1465,94
"839","02578","2018",2,2,0,174425,1261.5,136.5
"840","02579","2018",2,2,0,133500,1501.5,92.5
"841","02580","2018",12,12,0,93804.1666666667,1207.08333333333,80.9166666666667
"842","02581","2018",4,4,0,99750,1243,85.75
"843","02582","2018",1,1,0,2e+05,1031,194
"844","02583","2018",1,1,0,320000,3107,103
"845","02584","2018",2,2,0,108500,959.5,115
"846","02585","2018",1,1,0,160000,1111,144
"847","02586","2018",4,4,0,52375,679.25,77.5
"848","02587","2018",4,4,0,165510,1610.25,105.75
"849","02588","2018",2,2,0,143000,984.5,128
"850","02589","2018",6,6,0,142800,1445.66666666667,100.5
"851","02590","2018",6,6,0,145583.333333333,1371.5,101.833333333333
"852","02591","2018",1,1,0,50000,641,78
"853","02592","2018",3,3,0,1e+05,1150,86.3333333333333
"854","02593","2018",15,15,0,140140,1655.4,85.2666666666667
"855","02594","2018",3,3,0,134166.666666667,1438,95
"856","02595","2018",1,1,0,69000,821,84
"857","02596","2018",7,7,0,125842.857142857,1327.71428571429,94.1428571428571
"858","02598","2018",7,7,0,167285.714285714,1330.42857142857,129.714285714286
"859","02599","2018",3,3,0,150083.333333333,1419.66666666667,104.666666666667
"860","02600","2018",3,3,0,112833.333333333,1369,105.333333333333
"861","02601","2018",1,1,0,95000,1484,64
"862","02602","2018",14,14,0,154173.428571429,1837.42857142857,80.5714285714286
"863","02605","2018",1,1,0,95000,969,98
"864","02606","2018",1,1,0,150000,1546,97
"865","02607","2018",3,3,0,135110.666666667,1292.66666666667,103.333333333333
"866","02608","2018",5,5,0,65840,599.2,107.2
"867","02610","2018",9,9,0,166570.555555556,1940.44444444444,91.3333333333333
"868","02612","2018",2,2,0,122500,1606,76.5
"869","02613","2018",8,8,0,152687.5,1397.625,110.625
"870","02614","2018",4,4,0,176750,1293.75,136.75
"871","02615","2018",6,6,0,124145,1073.16666666667,112.5
"872","02616","2018",1,1,0,185000,1504,123
"873","02617","2018",2,2,0,57855,664.5,87.5
"874","02618","2018",2,2,0,35000,400,91
"875","02619","2018",4,4,0,107000,1038.25,116.5
"876","02620","2018",2,2,0,87500,487,175.5
"877","02621","2018",3,3,0,143666.666666667,911.333333333333,160
"878","02624","2018",4,4,0,91000,1365.75,77.75
"879","02625","2018",2,2,0,84000,1165.5,74
"880","02626","2018",4,4,0,116800,1205.5,95.25
"881","02628","2018",6,5,1,165166.666666667,1481.66666666667,129.833333333333
"882","02629","2018",2,2,0,62500,543,120
"883","02631","2018",8,8,0,119750,1356,95.625
"884","02632","2018",1,1,0,43000,406,106
"885","02634","2018",1,1,0,84000,627,134
"886","02636","2018",1,1,0,55000,948,58
"887","02637","2018",2,2,0,82500,865.5,95
"888","02638","2018",2,2,0,64750,959,69.5
"889","02639","2018",2,2,0,110000,1559.5,88
"890","02640","2018",2,2,0,144500,1388.5,123
"891","02641","2018",1,1,0,330000,1269,260
"892","02643","2018",10,10,0,151250,1367.9,110.8
"893","02644","2018",10,10,0,142594.4,1467.5,109.9
"894","02645","2018",1,1,0,50000,633,79
"895","02647","2018",1,1,0,48000,600,80
"896","02648","2018",22,22,0,69572.7272727273,888.681818181818,84.1363636363636
"897","02649","2018",2,2,0,175800,966.5,185
"898","02650","2018",1,1,0,1e+05,730,137
"899","02652","2018",1,1,0,48000,649,74
"900","02653","2018",5,5,0,104000,1467.2,73
"901","02655","2018",1,1,0,150000,1250,120
"902","02656","2018",5,5,0,146400,1524,105
"903","02657","2018",2,2,0,62500,718,81
"904","02658","2018",2,2,0,74000,846.5,83.5
"905","02659","2018",3,3,0,172833.333333333,1393,113
"906","02661","2018",1,1,0,190000,1652,115
"907","02662","2018",7,7,0,105714.285714286,1192.14285714286,98.7142857142857
"908","02664","2018",1,1,0,129000,1843,70
"909","02665","2018",3,3,0,121000,1216.33333333333,93
"910","02666","2018",9,9,0,79555.5555555556,652.777777777778,124.444444444444
"911","02668","2018",9,9,0,67055.5555555556,625.333333333333,107.888888888889
"912","02671","2018",5,5,0,77600,724.4,109.2
"913","02672","2018",3,3,0,122166.666666667,1199.33333333333,92.3333333333333
"914","02675","2018",1,1,0,91900,875,105
"915","02676","2018",17,17,0,122411.764705882,1130.47058823529,117.588235294118
"916","02677","2018",4,4,0,134750,1623.5,98.75
"917","02679","2018",2,2,0,185825,1827,99.5
"918","02680","2018",28,28,0,111557.142857143,1170.78571428571,94.75
"919","02681","2018",3,3,0,79333.3333333333,534.666666666667,137.666666666667
"920","02682","2018",2,2,0,112500,1163.5,104.5
"921","02683","2018",2,2,0,131000,1278,97.5
"922","02684","2018",24,24,0,89070.8333333333,1007.33333333333,91.4166666666667
"923","02685","2018",1,1,0,123900,1549,80
"924","02686","2018",5,5,0,131498.2,1407.4,106.4
"925","02687","2018",8,8,0,208450,1599.875,141
"926","02691","2018",575,484,91,100260.648695652,1098.73739130435,90.9634782608696
"927","02693","2018",4,4,0,143319,1421.5,120
"928","02694","2018",5,5,0,91200,886.2,95.6
"929","02697","2018",2,2,0,153500,1330.5,117
"930","02698","2018",1,1,0,150000,867,173
"931","02699","2018",3,3,0,59333.3333333333,867.666666666667,61.3333333333333
"932","02701","2018",9,9,0,123444.444444444,1453.66666666667,86.5555555555556
"933","02702","2018",7,7,0,147861.428571429,1202.42857142857,115
"934","02703","2018",7,7,0,69540,738.571428571429,90
"935","02704","2018",2,2,0,84000,721,116.5
"936","02705","2018",4,4,0,60750,727.5,84.75
"937","02706","2018",6,6,0,223666.666666667,1835.33333333333,127.333333333333
"938","02707","2018",1,1,0,212000,1098,193
"939","02708","2018",2,2,0,118500,1082,104.5
"940","02709","2018",3,3,0,145358.333333333,826.333333333333,162
"941","02710","2018",7,7,0,158000,1301.14285714286,120.714285714286
"942","02711","2018",3,3,0,139016.666666667,1328.33333333333,110
"943","02712","2018",1,1,0,39500,1519,26
"944","02713","2018",1,1,0,97000,1293,75
"945","02714","2018",2,2,0,141000,1301,108.5
"946","02715","2018",2,2,0,183675,1593,112
"947","02716","2018",5,5,0,125000,1287.6,96.4
"948","02717","2018",5,5,0,147500,1262.2,133.4
"949","02718","2018",1,1,0,210000,1364,154
"950","02719","2018",21,21,0,94889.6190476191,1159.7619047619,83.4285714285714
"951","02720","2018",20,19,1,94927,888.65,103.05
"952","02721","2018",6,6,0,143333.333333333,1001.16666666667,152.833333333333
"953","02722","2018",254,133,121,141789.763779528,1632.15354330709,85.7283464566929
"954","02723","2018",1,1,0,80000,1127,71
"955","02725","2018",1,1,0,135000,397,340
"956","02726","2018",3,3,0,81666.6666666667,754.666666666667,110.666666666667
"957","02727","2018",2,2,0,72500,993,87.5
"958","02728","2018",8,8,0,77375,813.75,95
"959","02729","2018",1,1,0,132000,2000,66
"960","02730","2018",3,2,1,91666.6666666667,781,102
"961","02731","2018",1,1,0,52500,750,70
"962","02732","2018",1,1,0,120000,952,126
"963","02734","2018",3,3,0,165666.666666667,1368,118.666666666667
"964","02736","2018",2,2,0,149600,1146,131
"965","02738","2018",132,128,4,87291.6666666667,1046.27272727273,86.5378787878788
"966","02739","2018",2,2,0,108500,942.5,112
"967","02740","2018",2,2,0,36900,1286.5,30
"968","02741","2018",6,6,0,57102.1666666667,821.666666666667,74.5
"969","02743","2018",4,4,0,96000,692.75,139.25
"970","02744","2018",1,1,0,249000,1606,155
"971","02745","2018",1,1,0,55000,948,58
"972","02746","2018",7,7,0,115192.857142857,1285.71428571429,89
"973","02748","2018",16,16,0,86593.75,1041.25,91.5625
"974","02749","2018",3,3,0,123833.333333333,1671.33333333333,80.6666666666667
"975","02750","2018",2,2,0,119000,1238,101
"976","02751","2018",1,1,0,68000,2267,30
"977","02752","2018",3,3,0,71333.3333333333,1066.66666666667,66.3333333333333
"978","02753","2018",2,2,0,82000,653,126.5
"979","02754","2018",2,2,0,117420,1338,87.5
"980","02755","2018",15,15,0,120861,1037.2,127.066666666667
"981","02756","2018",3,3,0,97666.6666666667,1276.33333333333,70
"982","02757","2018",2,2,0,35000,464,77
"983","02758","2018",18,18,0,119555.555555556,1148.94444444444,104.166666666667
"984","02759","2018",3,3,0,63333.3333333333,534.666666666667,117
"985","02760","2018",1,1,0,72500,1036,70
"986","02761","2018",9,9,0,163609.333333333,1507.33333333333,112.555555555556
"987","02762","2018",4,4,0,96375,1443.25,65.5
"988","02763","2018",2,2,0,131995,1102,118
"989","02764","2018",2,2,0,112000,1024,112.5
"990","02765","2018",2,2,0,142400,1593.5,94.5
"991","02766","2018",2,2,0,80500,1045.5,61
"992","02767","2018",2,2,0,166500,2334.5,91
"993","02768","2018",5,5,0,110880,1373.2,86.6
"994","02769","2018",10,8,2,93635.3,1627.8,97.7
"995","02770","2018",6,6,0,158833.333333333,1733,94.6666666666667
"996","02774","2018",1,1,0,156000,1200,130
"997","02775","2018",9,9,0,76140.3333333333,1000.55555555556,81.8888888888889
"998","02776","2018",6,6,0,106933.333333333,1149.33333333333,98.1666666666667
"999","02777","2018",3,3,0,150333.333333333,1000,159
"1000","02778","2018",1,1,0,120000,952,126
"1001","02779","2018",2,2,0,43500,672.5,73
"1002","02780","2018",12,11,1,116500,1391.5,86.0833333333333
"1003","02781","2018",4,4,0,146175,1424.75,98.5
"1004","02782","2018",2,2,0,174250,1208,110.5
"1005","02783","2018",2,2,0,39000,434,93.5
"1006","02784","2018",3,3,0,75500,927.666666666667,81
"1007","02785","2018",13,13,0,106673.076923077,1158.46153846154,98.9230769230769
"1008","02787","2018",2,2,0,63000,497,120
"1009","02788","2018",6,6,0,102666.666666667,942.833333333333,103.5
"1010","02789","2018",12,12,0,91100.8333333333,920.333333333333,107.25
"1011","02790","2018",4,4,0,175737.5,1220.5,162.75
"1012","02791","2018",1,1,0,279300,1209,231
"1013","02792","2018",1,1,0,350000,1620,216
"1014","02794","2018",8,8,0,185225,1312.5,141.75
"1015","02795","2018",11,11,0,141186.363636364,1296.09090909091,109.363636363636
"1016","02796","2018",3,3,0,199833.333333333,1436.33333333333,139.333333333333
"1017","02798","2018",30,29,1,130914.733333333,1336.3,105.166666666667
"1018","02799","2018",6,6,0,125000,1297,101.5
"1019","02800","2018",2,2,0,180150,2116,89
"1020","02801","2018",4,4,0,105875,884.75,113.75
"1021","02802","2018",3,3,0,79833.3333333333,826.333333333333,109
"1022","02803","2018",4,4,0,167140,1624.75,106.5
"1023","02804","2018",2,2,0,105875,1377.5,74
"1024","02805","2018",33,28,5,142635.454545455,1818.27272727273,79
"1025","02806","2018",4,4,0,104000,1375,85.75
"1026","02807","2018",12,12,0,146480.833333333,1235.41666666667,134.083333333333
"1027","02808","2018",3,3,0,80666.6666666667,925,75.6666666666667
"1028","02810","2018",92,71,21,150832.826086957,1716.84782608696,89.3695652173913
"1029","02812","2018",6,6,0,150615,1654.33333333333,90.6666666666667
"1030","02813","2018",2,2,0,85650,890.5,96.5
"1031","02815","2018",4,4,0,115500,1294,89
"1032","02816","2018",7,7,0,93642.8571428571,1094.71428571429,95.8571428571429
"1033","02817","2018",1,1,0,180000,1513,119
"1034","02818","2018",6,6,0,126666.666666667,1752.16666666667,80.1666666666667
"1035","02819","2018",1,1,0,315280,1899,166
"1036","02820","2018",27,27,0,117473.703703704,1168.07407407407,103.555555555556
"1037","02821","2018",12,12,0,120487.5,1269.5,101.333333333333
"1038","02822","2018",2,2,0,299480,1274,240.5
"1039","02824","2018",6,6,0,138800,1271.5,111
"1040","02826","2018",2,2,0,107485,770.5,147
"1041","02827","2018",4,4,0,124500,1079.5,116.5
"1042","02828","2018",3,3,0,161333.333333333,1733.33333333333,106.333333333333
"1043","02830","2018",5,5,0,104009.6,1046,95.2
"1044","02831","2018",3,3,0,123333.333333333,1190,102
"1045","02832","2018",1,1,0,75000,781,96
"1046","02833","2018",3,3,0,126666.666666667,1221.33333333333,101
"1047","03001","2018",31,31,0,125009.677419355,1185.8064516129,105.741935483871
"1048","03002","2018",5,5,0,259200,2306,111.8
"1049","03003","2018",17,17,0,80717.6470588235,778.529411764706,111.058823529412
"1050","03004","2018",2,2,0,92500,708.5,124.5
"1051","03005","2018",1,1,0,35000,700,50
"1052","03006","2018",12,12,0,85513.75,949.416666666667,91.25
"1053","03007","2018",3,3,0,147666.666666667,1196,133
"1054","03008","2018",8,8,0,108381.25,1278,93
"1055","03009","2018",1,1,0,153000,1244,123
"1056","03010","2018",4,4,0,49750,759,64.5
"1057","03011","2018",1,1,0,2e+05,1852,108
"1058","03012","2018",3,3,0,132066.666666667,995,133
"1059","03013","2018",39,38,1,161864.025641026,1579.87179487179,102.666666666667
"1060","03014","2018",3,3,0,137766.666666667,1368.33333333333,102
"1061","03015","2018",1,1,0,73250,704,104
"1062","03018","2018",6,6,0,113516.666666667,1043.33333333333,106
"1063","03019","2018",14,14,0,73180,905.642857142857,76.6428571428571
"1064","03020","2018",4,4,0,116000,1040,94.25
"1065","03021","2018",3,3,0,35600,1016.33333333333,41.3333333333333
"1066","03022","2018",14,14,0,75907.8571428571,1063.92857142857,79
"1067","03023","2018",140,110,30,138511.378571429,1486.3,92.6785714285714
"1068","03024","2018",4,3,1,89000,837.5,102.75
"1069","03025","2018",8,8,0,268743.75,2920.125,96
"1070","03026","2018",10,9,1,125186,1414.4,98.6
"1071","03027","2018",8,8,0,71925,737.125,91.625
"1072","03028","2018",4,4,0,102250,783.75,134.75
"1073","03029","2018",8,8,0,86237.5,890,96.75
"1074","03030","2018",13,13,0,138304.538461538,1366.61538461538,100.615384615385
"1075","03031","2018",3,3,0,112000,1183.33333333333,96.6666666666667
"1076","03032","2018",1,1,0,146000,1197,122
"1077","03033","2018",2,2,0,78950,680.5,108.5
"1078","03034","2018",6,6,0,195083.333333333,1630,112
"1079","03035","2018",7,7,0,65521.4285714286,642.285714285714,102.857142857143
"1080","03036","2018",16,16,0,92920.9375,1141.6875,81.375
"1081","03037","2018",5,5,0,99020,1340,83.6
"1082","03038","2018",9,9,0,147500,1167.33333333333,119.111111111111
"1083","03039","2018",5,5,0,83400,809.8,109.8
"1084","03040","2018",10,10,0,134073,1281.8,112.5
"1085","03041","2018",3,3,0,70833.3333333333,1581,68.6666666666667
"1086","03042","2018",8,8,0,81250,1084.25,76.25
"1087","03043","2018",8,8,0,70490.125,865.75,79.625
"1088","03044","2018",20,20,0,139314.5,1334.35,105.55
"1089","03045","2018",12,12,0,156375,1262.41666666667,111.166666666667
"1090","03046","2018",18,18,0,79142.5,876.277777777778,91.6666666666667
"1091","03047","2018",3,3,0,59333.3333333333,643.333333333333,89.3333333333333
"1092","03048","2018",16,15,1,97170,967.75,104.9375
"1093","03049","2018",5,5,0,82400,771.2,105.4
"1094","03050","2018",3,3,0,65000,1300,66.3333333333333
"1095","03051","2018",3,3,0,48500,909.666666666667,51
"1096","03052","2018",6,6,0,109166.666666667,1246,84.3333333333333
"1097","03053","2018",11,11,0,80000,747.545454545455,95.7272727272727
"1098","03054","2018",5,5,0,87800,879.2,101
"1099","03055","2018",13,13,0,86589.2307692308,1018.53846153846,82.6923076923077
"1100","03056","2018",8,8,0,65178.125,1132.25,83.125
"1101","03057","2018",2,2,0,71500,729,98
"1102","03058","2018",1,1,0,71000,763,93
"1103","03059","2018",3,3,0,144000,820.333333333333,183
"1104","03060","2018",13,13,0,165246.923076923,1567.07692307692,104.153846153846
"1105","03061","2018",6,6,0,124258.333333333,1199.16666666667,101.666666666667
"1106","03062","2018",9,9,0,142355.555555556,1468.44444444444,103.111111111111
"1107","03063","2018",8,8,0,110099.375,1084.375,106.875
"1108","03064","2018",1,1,0,90000,1084,83
"1109","03065","2018",12,12,0,101908.333333333,967.083333333333,109.166666666667
"1110","03066","2018",17,17,0,83548.2352941177,866.529411764706,92.4117647058823
"1111","03067","2018",1,1,0,57000,826,69
"1112","03068","2018",3,3,0,51863.3333333333,774,66
"1113","03069","2018",4,4,0,128750,1401.25,115.75
"1114","03070","2018",2,2,0,79525.5,789,98.5
"1115","03071","2018",3,3,0,109926.666666667,1190,90
"1116","03072","2018",5,5,0,88935.4,838.4,110.6
"1117","03073","2018",7,7,0,118350,1186.28571428571,100.285714285714
"1118","03074","2018",5,5,0,108900,1228.4,89.4
"1119","03075","2018",3,3,0,108333.333333333,1201.66666666667,101
"1120","03076","2018",3,3,0,138666.666666667,1172.33333333333,125.333333333333
"1121","03077","2018",2,2,0,31850,479,65.5
"1122","03078","2018",4,4,0,70137.5,751.5,89.25
"1123","03079","2018",2,2,0,84000,834,83
"1124","03080","2018",5,5,0,178950,1347.6,133.8
"1125","03081","2018",7,7,0,69428.5714285714,765.857142857143,90.8571428571429
"1126","03082","2018",49,47,2,76653.3469387755,865.102040816327,89.1632653061225
"1127","03083","2018",8,8,0,96208.75,1097.5,86.75
"1128","03084","2018",25,25,0,70554,895.04,82.6
"1129","03085","2018",6,6,0,133250,1223.5,116.666666666667
"1130","03086","2018",2,2,0,64000,657.5,96.5
"1131","03087","2018",8,8,0,78632.5,799.375,93.625
"1132","03088","2018",3,3,0,110833.333333333,1557.66666666667,73.6666666666667
"1133","03089","2018",4,4,0,40112.5,635.5,71.25
"1134","03090","2018",3,3,0,113666.666666667,1360.33333333333,112.666666666667
"1135","03091","2018",6,6,0,85116.6666666667,890.666666666667,99.6666666666667
"1136","03092","2018",8,8,0,85275,890.25,96.125
"1137","03093","2018",12,12,0,158165.916666667,1393.66666666667,110
"1138","03094","2018",33,33,0,143707.060606061,1440.60606060606,104.333333333333
"1139","03095","2018",145,90,55,101446.206896552,1201.58620689655,85.2137931034483
"1140","03096","2018",1,1,0,57500,719,80
"1141","03097","2018",1,1,0,2e+05,1333,150
"1142","03098","2018",56,51,5,83563.9107142857,996.160714285714,84.1607142857143
"1143","03099","2018",2,2,0,107500,960,105.5
"1144","03100","2018",6,5,1,57333.3333333333,867.833333333333,69.6666666666667
"1145","03101","2018",94,92,2,107731.287234043,1210.95744680851,89.1382978723404
"1146","03102","2018",22,20,2,103656.363636364,1011.63636363636,101.5
"1147","03103","2018",10,10,0,68200,755.2,86.5
"1148","03104","2018",9,8,1,79111.1111111111,820.888888888889,87
"1149","03105","2018",5,5,0,134396,1079.6,130.8
"1150","03106","2018",13,13,0,116601.923076923,1147.76923076923,104.461538461538
"1151","03107","2018",6,6,0,81750,1156.5,76.5
"1152","03108","2018",4,4,0,69525,1025.25,72.5
"1153","03109","2018",4,4,0,81500,1035.25,73.25
"1154","03110","2018",15,15,0,148476,1275.2,119.866666666667
"1155","03111","2018",10,10,0,104980,998.8,100.7
"1156","03112","2018",9,9,0,85666.6666666667,880,101.333333333333
"1157","03113","2018",3,3,0,44300,712.666666666667,62.3333333333333
"1158","03114","2018",3,3,0,87666.6666666667,898.666666666667,102
"1159","03115","2018",4,4,0,119750,1366.5,88.5
"1160","03116","2018",1,1,0,195700,1087,180
"1161","03117","2018",4,4,0,81625,699,109
"1162","03118","2018",71,70,1,112375.154929577,1293.98591549296,89.6478873239437
"1163","03119","2018",3,3,0,372536.666666667,2648,106.333333333333
"1164","03120","2018",7,7,0,49542.8571428571,713.285714285714,71.4285714285714
"1165","03121","2018",7,7,0,156821.428571429,1323.14285714286,113.857142857143
"1166","03122","2018",6,6,0,118295,1079.66666666667,119.5
"1167","03124","2018",2,2,0,174500,932.5,204
"1168","03125","2018",2,2,0,45350,522,87.5
"1169","03126","2018",18,18,0,110334.444444444,1145.77777777778,99.1666666666667
"1170","03127","2018",15,15,0,62950,830.533333333333,79.6
"1171","03128","2018",23,23,0,93647.8260869565,975.391304347826,91.4782608695652
"1172","03129","2018",1,1,0,35000,422,83
"1173","03130","2018",2,2,0,69750,739.5,98
"1174","03131","2018",3,3,0,105296.666666667,956.666666666667,117
"1175","03132","2018",7,7,0,80057.1428571429,955.857142857143,93.8571428571429
"1176","03133","2018",7,7,0,155820.714285714,1385.71428571429,113.285714285714
"1177","03134","2018",3,3,0,85666.6666666667,754,109.666666666667
"1178","03135","2018",3,3,0,81000,767.666666666667,101.333333333333
"1179","03136","2018",4,4,0,76187.5,1034.75,78.75
"1180","03137","2018",1,1,0,55000,585,94
"1181","03138","2018",37,33,4,76159.8648648649,938.837837837838,85.972972972973
"1182","03139","2018",2,2,0,177675,1082.5,160.5
"1183","03140","2018",13,13,0,134920,1359.53846153846,102.615384615385
"1184","03142","2018",6,6,0,89403.3333333333,974.666666666667,94.5
"1185","03143","2018",2,2,0,90375,644,115
"1186","03144","2018",2,2,0,91000,654,141
"1187","03145","2018",9,9,0,99166.6666666667,952.222222222222,100.666666666667
"1188","03146","2018",4,4,0,54875,932.5,61.75
"1189","03147","2018",2,2,0,44750,515.5,85
"1190","03148","2018",2,2,0,126750,1140,115
"1191","03149","2018",2,2,0,122300,1522,80
"1192","03150","2018",3,3,0,46816.6666666667,543.666666666667,79.6666666666667
"1193","03151","2018",3,3,0,122000,1087.33333333333,116.666666666667
"1194","03152","2018",5,5,0,75560,958.2,93.8
"1195","03154","2018",4,4,0,124000,1199.25,105.25
"1196","03155","2018",25,25,0,68908,899.2,83.4
"1197","03156","2018",13,13,0,120034.615384615,1276,94.3846153846154
"1198","03157","2018",14,14,0,119151.428571429,1149.5,103.571428571429
"1199","03158","2018",7,7,0,90800,963.142857142857,90.7142857142857
"1200","03159","2018",6,6,0,95083.3333333333,1098.5,80.3333333333333
"1201","03160","2018",2,2,0,174400,1032,178
"1202","03161","2018",12,12,0,81141.6666666667,788.25,106.833333333333
"1203","03162","2018",1,1,0,1e+05,1667,60
"1204","03163","2018",9,9,0,126494.444444444,1148.11111111111,107.666666666667
"1205","03164","2018",5,5,0,136000,1266.2,105.4
"1206","03165","2018",14,14,0,83176.7857142857,800.785714285714,102.928571428571
"1207","03166","2018",5,5,0,151871,1505.8,99.4
"1208","03167","2018",3,3,0,39666.6666666667,662,58.3333333333333
"1209","03168","2018",10,10,0,83100,941.5,88.9
"1210","03169","2018",2,2,0,273025,1845,142.5
"1211","03170","2018",5,5,0,94660,965.2,83.2
"1212","03171","2018",1,1,0,140000,979,143
"1213","03172","2018",1,1,0,20000,357,56
"1214","03173","2018",7,7,0,113805,1112,95.5714285714286
"1215","03174","2018",16,16,0,99271.875,1099.4375,92.75
"1216","03175","2018",6,6,0,98041.6666666667,1024.33333333333,96.8333333333333
"1217","03176","2018",5,5,0,109400,1161.8,85.6
"1218","03177","2018",3,3,0,50666.6666666667,657.333333333333,75.6666666666667
"1219","03178","2018",1,1,0,45000,398,113
"1220","03179","2018",2,2,0,32250,446.5,76.5
"1221","03180","2018",8,8,0,115641.625,1475,82.375
"1222","03181","2018",4,4,0,142506.75,1733.25,85.75
"1223","03182","2018",1,1,0,205000,1281,160
"1224","03183","2018",3,3,0,92333.3333333333,1203.33333333333,74.3333333333333
"1225","03184","2018",6,6,0,121691.666666667,1085.83333333333,122.833333333333
"1226","03185","2018",441,252,189,76578.3696145125,963.981859410431,79.0861678004535
"1227","03186","2018",11,11,0,80078.1818181818,788.909090909091,106.363636363636
"1228","03187","2018",4,4,0,113802.5,1007.25,114.75
"1229","03188","2018",1,1,0,90000,1000,90
"1230","03189","2018",10,10,0,81762,739.3,113.7
"1231","03190","2018",206,98,108,104597.281553398,1268.7427184466,85.8932038834951
"1232","03191","2018",1,1,0,148500,874,170
"1233","03192","2018",1,1,0,119900,902,133
"1234","03193","2018",1,1,0,1e+05,1471,68
"1235","03194","2018",1,1,0,28300,422,67
"1236","03195","2018",39,33,6,94831.9230769231,1026.4358974359,93.1025641025641
"1237","03196","2018",2,2,0,60000,881.5,70
"1238","03197","2018",11,11,0,98590.9090909091,1083.54545454545,91.4545454545455
"1239","03198","2018",3,3,0,60500,686,85
"1240","03200","2018",15,15,0,160713.333333333,1668.33333333333,99.6666666666667
"1241","03201","2018",3,3,0,28333.3333333333,370.333333333333,77.3333333333333
"1242","03202","2018",10,10,0,81658.5,854.1,84.3
"1243","03203","2018",2,2,0,113500,1134.5,101
"1244","03204","2018",2,2,0,102500,1079,94.5
"1245","03205","2018",6,6,0,126250,1156.66666666667,117.166666666667
"1246","03206","2018",1,1,0,116200,775,150
"1247","03207","2018",5,5,0,87856,832.2,104.4
"1248","03208","2018",2,2,0,72500,676.5,110.5
"1249","03209","2018",1,1,0,190000,1583,120
"1250","03210","2018",7,7,0,84328.5714285714,957.142857142857,82.5714285714286
"1251","03211","2018",14,14,0,120357.142857143,1318.07142857143,88.8571428571429
"1252","03212","2018",10,10,0,129335,1285,99.5
"1253","03213","2018",2,2,0,114250,1340.5,87.5
"1254","03214","2018",1,1,0,122900,1059,116
"1255","03215","2018",2,2,0,57000,611,90.5
"1256","03216","2018",3,3,0,95666.6666666667,1014.33333333333,83.3333333333333
"1257","03217","2018",3,3,0,95000,1202.33333333333,81
"1258","03218","2018",4,4,0,205803.75,1115.75,179.25
"1259","03219","2018",3,3,0,80000,822.666666666667,98
"1260","03220","2018",11,11,0,121609.090909091,1134.36363636364,101.454545454545
"1261","03221","2018",4,4,0,94567.25,1032.75,96.75
"1262","03223","2018",7,7,0,95285.7142857143,1103,86
"1263","03224","2018",3,3,0,51666.6666666667,647,79.6666666666667
"1264","03225","2018",9,9,0,189152.777777778,1457.66666666667,131.333333333333
"1265","03226","2018",3,3,0,66833.3333333333,766,85.3333333333333
"1266","03227","2018",3,3,0,74966.6666666667,1500,64.3333333333333
"1267","03229","2018",2,2,0,145692.5,1241.5,125
"1268","03230","2018",7,7,0,86400,978.428571428571,91.8571428571429
"1269","03231","2018",3,3,0,54000,681,80.6666666666667
"1270","03232","2018",4,4,0,139000,1314.5,106.5
"1271","03233","2018",6,6,0,89435,905.166666666667,93.1666666666667
"1272","03234","2018",6,6,0,103750,864,127.333333333333
"1273","03235","2018",9,9,0,118403.333333333,1068.11111111111,123.111111111111
"1274","03236","2018",39,39,0,108469.384615385,1234.33333333333,88.5384615384615
"1275","03237","2018",8,8,0,172550,1251.75,121.75
"1276","03238","2018",4,4,0,106250,974.75,113.5
"1277","03239","2018",3,3,0,87200,1351.66666666667,62.6666666666667
"1278","03240","2018",8,8,0,117506.25,960.5,112
"1279","03241","2018",4,4,0,92800,655.5,169.5
"1280","03242","2018",3,3,0,103966.666666667,1076.33333333333,97.3333333333333
"1281","03243","2018",1,1,0,170000,1560,109
"1282","03244","2018",3,3,0,42833.3333333333,785.333333333333,54
"1283","03245","2018",1,1,0,55000,430,128
"1284","03246","2018",4,4,0,53895,793.75,71.25
"1285","03247","2018",21,21,0,110505,1087.57142857143,102.238095238095
"1286","03248","2018",4,4,0,79300,1260.5,67.5
"1287","03249","2018",4,4,0,62892.5,797.25,80.25
"1288","03251","2018",9,9,0,168913.888888889,1469.33333333333,109.888888888889
"1289","03252","2018",5,5,0,127158,1113.4,112.4
"1290","03253","2018",2,2,0,91500,2021,44
"1291","03254","2018",49,41,8,104192.653061224,1195.55102040816,87.0816326530612
"1292","03255","2018",3,3,0,105000,1019.33333333333,100.333333333333
"1293","03256","2018",1,1,0,245000,2500,98
"1294","03257","2018",7,6,1,97928.5714285714,1054.71428571429,98.4285714285714
"1295","03258","2018",17,17,0,138514.117647059,1327.17647058824,109.294117647059
"1296","03259","2018",6,6,0,90916.6666666667,1528.83333333333,64.5
"1297","03260","2018",4,4,0,47250,558.25,83.25
"1298","03261","2018",2,2,0,118000,885.5,133
"1299","03262","2018",11,11,0,147674.454545455,1288.81818181818,113
"1300","03263","2018",3,3,0,143666.666666667,1004.33333333333,134.666666666667
"1301","03264","2018",37,35,2,104248.945945946,1163.83783783784,89.4054054054054
"1302","03265","2018",8,8,0,67212.5,825.625,80.625
"1303","03267","2018",6,6,0,90516.6666666667,1121.66666666667,78.1666666666667
"1304","03268","2018",3,3,0,105650,1046.33333333333,97.6666666666667
"1305","03269","2018",2,2,0,1e+05,974,103.5
"1306","03271","2018",11,11,0,142524.545454545,1187.72727272727,126.727272727273
"1307","03272","2018",4,4,0,88000,1488.75,64.75
"1308","03273","2018",3,3,0,157433.333333333,1372,114
"1309","03274","2018",2,2,0,73500,973,74.5
"1310","03275","2018",18,18,0,94084.4444444444,996.555555555556,98.2222222222222
"1311","03276","2018",3,3,0,79100,888.333333333333,83.6666666666667
"1312","03277","2018",1,1,0,60000,706,85
"1313","03278","2018",2,2,0,222550,2180.5,161
"1314","03279","2018",6,6,0,65308.3333333333,863,72.5
"1315","03280","2018",3,3,0,37000,520.333333333333,72.6666666666667
"1316","03281","2018",3,3,0,62000,1035,60
"1317","03282","2018",4,4,0,186125,1422.75,108.25
"1318","03283","2018",12,12,0,101775,1059.25,96.1666666666667
"1319","03284","2018",3,3,0,104666.666666667,767.666666666667,147.666666666667
"1320","03285","2018",3,3,0,129666.666666667,1196.66666666667,116.333333333333
"1321","03286","2018",19,19,0,129301.578947368,1277.68421052632,102.263157894737
"1322","03287","2018",6,6,0,73333.3333333333,835.333333333333,88
"1323","03288","2018",5,5,0,52178,710.6,73.8
"1324","03289","2018",8,8,0,76755,911.75,85.375
"1325","03290","2018",12,12,0,136645.833333333,1388.16666666667,96.25
"1326","03291","2018",2,2,0,116000,1800.5,64.5
"1327","03292","2018",12,11,1,68725,881,77.0833333333333
"1328","03293","2018",5,5,0,84420,981,88.6
"1329","03294","2018",1,1,0,30000,375,80
"1330","03295","2018",3,3,0,81066.6666666667,873.333333333333,95
"1331","03296","2018",10,10,0,76150,1120.5,86.2
"1332","03297","2018",17,17,0,80623.5294117647,880.411764705882,91.4705882352941
"1333","03298","2018",33,28,5,84174.5454545455,1007.60606060606,85.0909090909091
"1334","03299","2018",2,2,0,74000,716,102.5
"1335","03300","2018",4,4,0,75375,956.5,79.5
"1336","03301","2018",8,8,0,108962.5,979,105.125
"1337","03303","2018",1,1,0,155000,775,200
"1338","03304","2018",32,32,0,152523.96875,1331.375,115.53125
"1339","03305","2018",3,3,0,96666.6666666667,1170.33333333333,85.3333333333333
"1340","03306","2018",11,11,0,173404.545454545,1577.45454545455,111.909090909091
"1341","03307","2018",4,4,0,104775,919.25,103.25
"1342","03308","2018",1,1,0,95000,688,138
"1343","03309","2018",10,10,0,61590,672.1,88.9
"1344","03310","2018",672,189,483,103600.907738095,1348.84375,74.5505952380952
"1345","03311","2018",5,5,0,143846,992.4,164.8
"1346","03312","2018",3,3,0,44333.3333333333,924.333333333333,50
"1347","03313","2018",2,2,0,81400,835.5,106.5
"1348","03314","2018",15,15,0,144129.333333333,1262.4,117.933333333333
"1349","03315","2018",11,10,1,86681.8181818182,1053.09090909091,85.9090909090909
"1350","03316","2018",7,7,0,99900,1172.85714285714,87.2857142857143
"1351","03317","2018",3,3,0,24498,654.666666666667,41
"1352","03319","2018",5,5,0,98400,1322.8,89.4
"1353","03320","2018",4,4,0,84386.25,1003.25,84
"1354","03321","2018",121,104,17,119826.950413223,1348.88429752066,89.198347107438
"1355","04001","2018",4,4,0,273250,2299,119.25
"1356","04004","2018",10,10,0,163204,2194.8,79.4
"1357","04006","2018",133,11,122,76813.8120300752,2066.54135338346,36.1503759398496
"1358","04007","2018",1,1,0,45000,592,76
"1359","04008","2018",14,9,5,113347.714285714,1777.28571428571,64.8571428571429
"1360","04013","2018",8,8,0,200037.5,2381.75,83
"1361","04016","2018",2,2,0,45500,1187,49.5
"1362","04017","2018",1,0,1,20000,800,25
"1363","04018","2018",12,12,0,148280,1724.83333333333,90.3333333333333
"1364","04019","2018",73,17,56,116316.684931507,1899.01369863014,61.027397260274
"1365","04020","2018",2,2,0,155000,2162.5,71
"1366","04021","2018",1,1,0,120000,1846,65
"1367","04022","2018",9,8,1,117477.777777778,1333.77777777778,87.5555555555556
"1368","04023","2018",3,3,0,66533.6666666667,1120.66666666667,76.6666666666667
"1369","04024","2018",1,1,0,55000,1618,34
"1370","04025","2018",14,10,4,92993.5714285714,1689.71428571429,56.9285714285714
"1371","04026","2018",1,1,0,52300,707,74
"1372","04027","2018",3,3,0,225966.666666667,2290.66666666667,103.333333333333
"1373","04028","2018",1,1,0,140000,2154,65
"1374","04030","2018",1,1,0,70000,1429,49
"1375","04031","2018",7,6,1,119219.285714286,1672.71428571429,75.8571428571429
"1376","04032","2018",5,4,1,59459.6,1857.6,36.6
"1377","04033","2018",11,3,8,166413.636363636,5638.18181818182,51.3636363636364
"1378","04034","2018",8,6,2,179026.375,1875.75,94.625
"1379","04035","2018",2,1,1,132500,1643.5,78.5
"1380","04036","2018",7,7,0,236962.857142857,2108.85714285714,118
"1381","04037","2018",3,3,0,93906.6666666667,1216,83.6666666666667
"1382","04039","2018",22,17,5,159475,1940.54545454545,90.2727272727273
"1383","04041","2018",5,5,0,221020,1983.4,121.2
"1384","04042","2018",1,1,0,129000,1433,90
"1385","04043","2018",3,3,0,266250,3338,75
"1386","04045","2018",25,23,2,192268,2301.84,89.64
"1387","04046","2018",2,2,0,135700,1931,65
"1388","04047","2018",3,2,1,136666.666666667,1512,86.3333333333333
"1389","04049","2018",52,21,31,141471.961538462,1901.92307692308,78.0576923076923
"1390","04050","2018",1,1,0,57000,1357,42
"1391","04051","2018",1,1,0,199300,3322,60
"1392","04053","2018",7,7,0,203238.571428571,1814.85714285714,130.142857142857
"1393","04054","2018",1,1,0,199900,2104,95
"1394","04055","2018",5,5,0,208966.2,1915,114.4
"1395","04057","2018",1,1,0,194092,1764,110
"1396","04058","2018",3,3,0,147333.333333333,1821.66666666667,81
"1397","04059","2018",4,4,0,94125,1438.25,63
"1398","04061","2018",9,6,3,127096.666666667,2143.88888888889,70.2222222222222
"1399","04062","2018",2,0,2,24500,711,34
"1400","04063","2018",10,10,0,274670,2588.7,102.9
"1401","04065","2018",5,5,0,213400,1694.2,116.8
"1402","04066","2018",6,6,0,340240.833333333,2717.5,130
"1403","04067","2018",1,1,0,80000,1143,70
"1404","04068","2018",9,7,2,212683.333333333,2596.11111111111,84
"1405","04069","2018",1,0,1,20000,645,31
"1406","04070","2018",211,68,143,110726.066350711,1569.03791469194,68.7345971563981
"1407","04072","2018",2,2,0,89000,1660.5,66.5
"1408","04073","2018",41,4,37,96218.3414634146,2356.53658536585,38.1707317073171
"1409","04074","2018",3,1,2,100966.666666667,1169,79.6666666666667
"1410","04075","2018",2,2,0,224170,1960,109
"1411","04076","2018",6,2,4,74666.6666666667,1609.66666666667,46.5
"1412","04077","2018",3,2,1,136633.333333333,1456.66666666667,90.3333333333333
"1413","04079","2018",11,8,3,169645.454545455,2250.63636363636,73.6363636363636
"1414","04081","2018",11,8,3,154986.272727273,2172.27272727273,74.6363636363636
"1415","04084","2018",11,10,1,103300,1449.72727272727,69.0909090909091
"1416","04086","2018",2,1,1,249700,1937,107.5
"1417","04087","2018",1,1,0,236950,4388,54
"1418","04088","2018",61,44,17,203768.032786885,2420.90163934426,82.0983606557377
"1419","04090","2018",3,3,0,105333.333333333,1368.66666666667,74.3333333333333
"1420","04091","2018",3,3,0,161133.333333333,2385,68
"1421","04092","2018",3,2,1,36000,972.666666666667,41.3333333333333
"1422","04094","2018",105,31,74,126346.371428571,2706.6,49.3619047619048
"1423","04095","2018",2,2,0,114950,1997,63
"1424","04096","2018",24,8,16,132484.166666667,1736.08333333333,79.2083333333333
"1425","04097","2018",3,3,0,132150,1585.66666666667,87.6666666666667
"1426","04099","2018",3,3,0,84333.3333333333,1141,68.6666666666667
"1427","04101","2018",1,1,0,150045,1272,118
"1428","04102","2018",1,1,0,269769,2248,120
"1429","04104","2018",3,3,0,358333.333333333,2821.33333333333,146.666666666667
"1430","04106","2018",4,4,0,324362.5,2912.75,107
"1431","04108","2018",17,17,0,171860.058823529,1751.41176470588,100.882352941176
"1432","04109","2018",8,8,0,193318.75,2750,92.375
"1433","04110","2018",10,10,0,177060,1905.9,96
"1434","04111","2018",11,11,0,276787.272727273,2461.63636363636,106.636363636364
"1435","04112","2018",263,120,143,162456.844106464,1986.35741444867,78.6235741444867
"1436","04113","2018",5,5,0,232530,1927,126.8
"1437","04115","2018",4,3,1,53500,1161.25,50
"1438","04116","2018",27,21,6,132589.259259259,1754.66666666667,82.0740740740741
"1439","04118","2018",1,1,0,126000,940,134
"1440","04121","2018",8,7,1,101557.625,1136.25,80.5
"1441","04122","2018",7,7,0,152200,1653.57142857143,91.2857142857143
"1442","04123","2018",10,9,1,183849,1680.7,107.2
"1443","04124","2018",7,7,0,70642.8571428571,1408.14285714286,57.8571428571429
"1444","04126","2018",19,6,13,74069.2105263158,1683.26315789474,46.6842105263158
"1445","04127","2018",2,0,2,97500,2100,45
"1446","04128","2018",2,2,0,273500,2682.5,102.5
"1447","04132","2018",1,1,0,330000,2619,126
"1448","04133","2018",4,4,0,81895,1451.5,53
"1449","04134","2018",8,8,0,131807.5,1326,107.25
"1450","04135","2018",9,6,3,206276,2125.55555555556,87.3333333333333
"1451","04136","2018",6,6,0,128483.333333333,1528.33333333333,84.6666666666667
"1452","04137","2018",2,2,0,194957,1953.5,98
"1453","04139","2018",3,3,0,130000,2505.33333333333,52.6666666666667
"1454","04140","2018",2,2,0,123750,1254,82
"1455","04141","2018",5,5,0,147550,1948.4,70.6
"1456","04142","2018",1,1,0,70000,1000,70
"1457","04143","2018",74,59,15,191474.621621622,2291.28378378378,84.527027027027
"1458","04144","2018",1,1,0,230000,3239,71
"1459","04145","2018",12,12,0,135893.833333333,1705.75,87.9166666666667
"1460","04148","2018",4,3,1,111000,1262.25,86.75
"1461","04149","2018",27,26,1,201310.814814815,2000.22222222222,98.5555555555556
"1462","04150","2018",2,2,0,114025,2176,45
"1463","04151","2018",6,6,0,196183.333333333,2340.5,104.833333333333
"1464","04152","2018",39,36,3,256316.41025641,2563.33333333333,99.0512820512821
"1465","04154","2018",1,1,0,152000,1949,78
"1466","04155","2018",4,4,0,110750,1274.5,88.5
"1467","04156","2018",3,3,0,170666.666666667,1760,96
"1468","04157","2018",11,10,1,92440.9090909091,1234.81818181818,75.0909090909091
"1469","04158","2018",12,7,5,97210.8333333333,1317.5,68.1666666666667
"1470","04159","2018",1,1,0,118000,2360,50
"1471","04160","2018",20,19,1,183967,2095.2,92.15
"1472","04161","2018",7,5,2,214571.428571429,2353,91
"1473","04162","2018",2,2,0,85000,1191,72
"1474","04163","2018",10,10,0,160150,1854.6,91.8
"1475","04164","2018",2,2,0,170000,2327.5,76.5
"1476","04166","2018",12,7,5,102641.666666667,1427.58333333333,68.1666666666667
"1477","04167","2018",1,1,0,156500,1423,110
"1478","04169","2018",2,2,0,98200,1461.5,67.5
"1479","04171","2018",3,3,0,227833.333333333,2324,90.6666666666667
"1480","04172","2018",8,8,0,167023.75,1805.125,87.75
"1481","04173","2018",16,10,6,134263.75,1656.4375,78.875
"1482","04174","2018",1,1,0,360000,3673,98
"1483","04175","2018",1,1,0,232000,1079,215
"1484","04176","2018",6,3,3,128847.166666667,2581.83333333333,50.6666666666667
"1485","04178","2018",17,16,1,173297.058823529,1821.05882352941,95.1764705882353
"1486","04179","2018",3,3,0,102333.333333333,1460.66666666667,73.3333333333333
"1487","04180","2018",1,1,0,29000,1208,24
"1488","04181","2018",2,2,0,156000,1585,102.5
"1489","04182","2018",2,2,0,167025,2596.5,64.5
"1490","04183","2018",4,3,1,115600,1857.75,60.75
"1491","04184","2018",2,2,0,154960,1288.5,115.5
"1492","04186","2018",3,2,1,87833.3333333333,1458.66666666667,72
"1493","04187","2018",1,1,0,175000,2652,66
"1494","04188","2018",15,13,2,230768,2608.4,80.1333333333333
"1495","04189","2018",10,8,2,109871.5,1749.2,67.2
"1496","04192","2018",10,9,1,164357,2142.9,80.6
"1497","04193","2018",3,2,1,179633.333333333,2213.66666666667,112.666666666667
"1498","04194","2018",2,2,0,120000,3563.5,40.5
"1499","04195","2018",7,4,3,197151.142857143,2289.42857142857,105.428571428571
"1500","04197","2018",40,28,12,159252.25,2152.7,71.4
"1501","04199","2018",1,1,0,315000,1780,177
"1502","04200","2018",3,3,0,198333.333333333,1677,122
"1503","04201","2018",3,3,0,272000,1946.66666666667,147.333333333333
"1504","04202","2018",1,1,0,274000,2740,100
"1505","04203","2018",13,5,8,94929.2307692308,1641.76923076923,61.6153846153846
"1506","04204","2018",1,1,0,32000,356,90
"1507","04205","2018",50,18,32,86934.6,1443.76,60.68
"1508","04206","2018",5,5,0,157360,1593.6,97
"1509","04207","2018",1,1,0,122000,1627,75
"1510","04208","2018",7,5,2,267185.714285714,2794.42857142857,85.8571428571429
"1511","04209","2018",82,35,47,122325.170731707,1530.10975609756,76.6585365853659
"1512","04214","2018",2,2,0,127200,1431,93
"1513","04216","2018",3,3,0,212000,1893,114.666666666667
"1514","04217","2018",10,8,2,104940,1061.2,112.2
"1515","04218","2018",4,4,0,95500,1274.75,82.5
"1516","04219","2018",5,4,1,99000,1132.2,87.6
"1517","04220","2018",7,4,3,115003.428571429,1940,54.1428571428571
"1518","04222","2018",2,2,0,116500,1516,82.5
"1519","04224","2018",2,2,0,167500,1855.5,95
"1520","04226","2018",93,4,89,80809.6666666667,2130.97849462366,35.5376344086022
"1521","04227","2018",6,6,0,179458.333333333,2308.5,82.8333333333333
"1522","04228","2018",1,1,0,175325,2192,80
"1523","04229","2018",1,1,0,140000,1022,137
"1524","04230","2018",42,36,6,168540.285714286,2052.7619047619,82.0238095238095
"1525","04233","2018",2,2,0,194025,1746.5,111
"1526","04234","2018",3,3,0,67433.3333333333,1682.33333333333,39.6666666666667
"1527","04235","2018",3,2,1,103146.666666667,2210.33333333333,54.3333333333333
"1528","04236","2018",3,1,2,122433.333333333,1282.33333333333,83.3333333333333
"1529","04237","2018",9,7,2,102981.111111111,1342.77777777778,73.2222222222222
"1530","04240","2018",9,7,2,144153.333333333,1687.66666666667,96.2222222222222
"1531","04241","2018",3,3,0,382266.666666667,2702.33333333333,139.333333333333
"1532","04242","2018",32,31,1,239118.125,2430.75,99.875
"1533","04244","2018",14,9,5,120060,1601.21428571429,75.7142857142857
"1534","04245","2018",29,22,7,184948.689655172,2141.58620689655,86.7586206896552
"1535","05001","2018",10,2,8,147453.5,2046.6,80.5
"1536","05003","2018",12,4,8,130247.583333333,1566.58333333333,64.1666666666667
"1537","05004","2018",51,11,40,131395.882352941,2308.62745098039,55.0588235294118
"1538","05006","2018",24,15,9,168166.666666667,1809.08333333333,97.1666666666667
"1539","05007","2018",14,6,8,158522.142857143,2219.14285714286,73.7142857142857
"1540","05008","2018",6,6,0,97750,1137.5,85
"1541","05009","2018",2,2,0,250250,2366,118
"1542","05010","2018",20,20,0,166370.8,1844,97.05
"1543","05011","2018",2,2,0,151178.5,2055.5,79
"1544","05012","2018",7,2,5,141176,2616.71428571429,59.1428571428571
"1545","05013","2018",4,4,0,262377.5,2013.25,135.75
"1546","05014","2018",3,3,0,90000,962.666666666667,91
"1547","05016","2018",3,3,0,203166.666666667,1972,105
"1548","05017","2018",30,23,7,190912.133333333,2259.4,86.1333333333333
"1549","05018","2018",5,5,0,335390,2807.2,124.4
"1550","05019","2018",2,2,0,96165,1903.5,50
"1551","05021","2018",1,1,0,106000,1060,100
"1552","05022","2018",3,3,0,135000,1247.33333333333,108
"1553","05023","2018",242,34,208,145281.049586777,2185.72727272727,65.595041322314
"1554","05024","2018",2,2,0,162220,2456.5,59
"1555","05025","2018",1,1,0,297000,1650,180
"1556","05026","2018",7,0,7,130985.714285714,2638.71428571429,47.1428571428571
"1557","05027","2018",2,2,0,90250,1166,77.5
"1558","05029","2018",9,5,4,123700,1692.66666666667,69
"1559","05031","2018",1,1,0,145000,2014,72
"1560","05032","2018",1,1,0,110000,1078,102
"1561","05033","2018",1,1,0,150000,1339,112
"1562","05035","2018",1,1,0,155000,2039,76
"1563","05036","2018",9,7,2,209268.888888889,2341.22222222222,84.5555555555556
"1564","05037","2018",1,1,0,360000,1791,201
"1565","05038","2018",8,5,3,137555.375,2147.375,62
"1566","05039","2018",6,5,1,160020,1933.66666666667,80.8333333333333
"1567","05040","2018",44,30,14,189494.886363636,2255.90909090909,86.4090909090909
"1568","05044","2018",3,0,3,131006.666666667,2879.66666666667,47
"1569","05045","2018",13,10,3,208220,2570,75.0769230769231
"1570","05046","2018",154,30,124,148235.311688312,2395.18831168831,62.6558441558442
"1571","05047","2018",2,1,1,162500,2661.5,61
"1572","05048","2018",5,3,2,144560,1120.6,129
"1573","05050","2018",6,5,1,144750,1963.83333333333,71
"1574","05051","2018",1,1,0,50000,794,63
"1575","05052","2018",8,5,3,204802.5,2224.125,94.5
"1576","05053","2018",4,4,0,151920,1634.25,93.75
"1577","05054","2018",8,7,1,161874,1916.875,83.5
"1578","05055","2018",3,2,1,73340,992.666666666667,79.3333333333333
"1579","05057","2018",1,1,0,377000,2313,163
"1580","05058","2018",2,2,0,237500,2889,74
"1581","05059","2018",4,4,0,217894,2178.75,97.5
"1582","05061","2018",504,143,361,165253.422619048,2184.10119047619,76.9742063492064
"1583","05062","2018",1,1,0,103400,862,120
"1584","05063","2018",11,7,4,126942.727272727,2526.27272727273,54.5454545454545
"1585","05064","2018",4,3,1,143585,1954.75,70
"1586","05065","2018",33,10,23,179888.636363636,2437.12121212121,72.5454545454545
"1587","05068","2018",4,4,0,235500,2441,99.25
"1588","05070","2018",41,29,12,144663.804878049,1601.14634146341,89.8780487804878
"1589","05071","2018",2,2,0,183755,1242.5,137.5
"1590","05072","2018",11,1,10,59098.1818181818,1558.72727272727,40.7272727272727
"1591","05073","2018",3,3,0,258666.666666667,2171.66666666667,118.333333333333
"1592","05074","2018",3,3,0,274140,2190.66666666667,128.333333333333
"1593","05075","2018",6,6,0,183865.333333333,3358.66666666667,63.3333333333333
"1594","05076","2018",2,2,0,160000,2083.5,81
"1595","05077","2018",17,2,15,122443.823529412,1866.76470588235,67.1764705882353
"1596","05078","2018",3,3,0,95333.3333333333,1266.33333333333,71.3333333333333
"1597","05079","2018",40,9,31,257435.1,3649.65,70.925
"1598","05080","2018",2,2,0,149000,1454.5,106
"1599","05084","2018",3,3,0,218443.333333333,2412.66666666667,87.3333333333333
"1600","05085","2018",59,9,50,184469.016949153,3737.33898305085,53.2203389830508
"1601","05086","2018",1,1,0,78000,1114,70
"1602","05087","2018",2,2,0,124800,1347.5,91
"1603","05089","2018",2,2,0,116000,1381,85
"1604","05090","2018",1,1,0,55000,2115,26
"1605","05092","2018",5,5,0,188342,2290.2,86.8
"1606","05093","2018",11,4,7,135641.272727273,3149.27272727273,48
"1607","05095","2018",2,2,0,138000,1360.5,101
"1608","05096","2018",110,9,101,84308.9727272727,1759.53636363636,48.9363636363636
"1609","05097","2018",4,4,0,120080,1886.5,63
"1610","05098","2018",87,4,83,87852.2183908046,2415.26436781609,35.0804597701149
"1611","05099","2018",1,1,0,110000,1146,96
"1612","05100","2018",1,1,0,353900,2359,150
"1613","05101","2018",37,20,17,164481.081081081,2630.32432432432,65.3513513513514
"1614","05102","2018",1,1,0,95000,1397,68
"1615","05103","2018",9,9,0,132447,1643.11111111111,80.4444444444444
"1616","05104","2018",3,3,0,135000,1985,73.3333333333333
"1617","05106","2018",6,5,1,262350,3262.5,80.5
"1618","05107","2018",3,3,0,157333.333333333,1735.33333333333,91.3333333333333
"1619","05108","2018",2,2,0,209025,3225.5,65
"1620","05109","2018",1,1,0,310000,3263,95
"1621","05110","2018",77,5,72,80023.2597402597,2288.76623376623,33.2207792207792
"1622","05111","2018",5,4,1,286140,2871.2,107.2
"1623","05113","2018",3,2,1,226810,3571,65.6666666666667
"1624","05114","2018",9,3,6,97589.3333333333,2192.77777777778,42.7777777777778
"1625","05115","2018",10,9,1,125585,1423.4,87.7
"1626","05116","2018",4,3,1,117975,1747.5,66
"1627","05117","2018",2,2,0,67750,1091,61.5
"1628","05118","2018",14,13,1,173236.714285714,1787.28571428571,95.7142857142857
"1629","05119","2018",135,10,125,102516.948148148,2931.45925925926,34.6444444444444
"1630","05121","2018",5,4,1,142700,1831.4,83.4
"1631","05122","2018",10,10,0,159830,1700.3,95.7
"1632","05123","2018",18,14,4,218505,2030.11111111111,108.666666666667
"1633","05124","2018",6,3,3,123866.666666667,2168.83333333333,65.5
"1634","05126","2018",9,7,2,103938.333333333,1068.55555555556,93.1111111111111
"1635","05127","2018",3,1,2,65443.3333333333,1119.66666666667,69.6666666666667
"1636","05128","2018",6,6,0,176166.666666667,2518.66666666667,67.5
"1637","05129","2018",3,3,0,171033.333333333,2543,91.6666666666667
"1638","05130","2018",1,1,0,809250,3764,215
"1639","05132","2018",31,15,16,116451.612903226,1799.06451612903,72
"1640","05133","2018",72,12,60,169950.625,3232.06944444444,51.3611111111111
"1641","05134","2018",5,3,2,89200,1276.8,72.4
"1642","05135","2018",2,2,0,67500,1150.5,58
"1643","05136","2018",11,7,4,123007.272727273,1428.63636363636,78.0909090909091
"1644","05139","2018",214,14,200,64519.1962616822,1723.84112149533,32.2897196261682
"1645","05140","2018",1,1,0,161836,1587,102
"1646","05142","2018",9,9,0,126380,1834.44444444444,67.7777777777778
"1647","05144","2018",3,3,0,91600,1242.66666666667,72.6666666666667
"1648","05145","2018",22,14,8,154403.090909091,1997.77272727273,81.2727272727273
"1649","05146","2018",2,2,0,73750,1402,55
"1650","05147","2018",3,3,0,114000,1478.33333333333,71.6666666666667
"1651","05148","2018",2,2,0,168935,2080.5,80
"1652","05149","2018",32,8,24,62860.03125,1567.09375,38.03125
"1653","05151","2018",19,17,2,230055.263157895,2525.94736842105,104.210526315789
"1654","05152","2018",2,2,0,45000,983.5,42.5
"1655","05153","2018",14,4,10,115374.285714286,2323.14285714286,50.2142857142857
"1656","05154","2018",4,3,1,90000,1027.25,84.25
"1657","05156","2018",5,4,1,230482,2372,92.2
"1658","05157","2018",7,1,6,109068,2279.42857142857,56
"1659","05159","2018",1,1,0,195000,1364,143
"1660","05161","2018",94,10,84,212808.021276596,3725.40425531915,52.7765957446809
"1661","05162","2018",30,16,14,137667,1635.8,82.8333333333333
"1662","05163","2018",4,4,0,148865,2125.25,66.5
"1663","05164","2018",24,11,13,201912.708333333,2739.04166666667,73.0416666666667
"1664","05165","2018",1,1,0,35000,972,36
"1665","05166","2018",12,8,4,91416.6666666667,1332.91666666667,75.3333333333333
"1666","05167","2018",1,1,0,132000,2276,58
"1667","05168","2018",3,3,0,302216.666666667,2473,122.333333333333
"1668","05169","2018",1,1,0,85000,1133,75
"1669","05170","2018",23,16,7,153739.130434783,1885.47826086957,80.3478260869565
"1670","05171","2018",2,1,1,147500,2787,54
"1671","05172","2018",6,6,0,151783.333333333,1774.33333333333,77.6666666666667
"1672","05173","2018",5,5,0,192200,2700,88.4
"1673","05174","2018",6,1,5,128003.333333333,1916.83333333333,70.1666666666667
"1674","05176","2018",2,2,0,71666.5,1307.5,57.5
"1675","05177","2018",77,7,70,144446.38961039,3146.19480519481,41.7402597402597
"1676","05178","2018",7,7,0,146077.142857143,1934.28571428571,72
"1677","05179","2018",32,19,13,111750.9375,1355.90625,78.84375
"1678","05180","2018",6,4,2,208025,2435.83333333333,74
"1679","05181","2018",2,1,1,168000,1178,121.5
"1680","05182","2018",1,1,0,20000,625,32
"1681","05183","2018",5,5,0,187662,2584.4,69
"1682","05184","2018",4,4,0,203932.5,2140.75,108.25
"1683","06003","2018",22,8,14,98904.5454545455,1622.13636363636,57.8181818181818
"1684","06004","2018",1908,177,1731,272341.975890985,4427.96855345912,60.624213836478
"1685","06005","2018",5,4,1,172000,1584.6,101.6
"1686","06006","2018",24,18,6,460693.375,4318.70833333333,108.416666666667
"1687","06007","2018",50,39,11,334772.36,4168.42,83.32
"1688","06009","2018",1,1,0,20000,769,26
"1689","06010","2018",50,21,29,268356.1,3192.96,81.5
"1690","06011","2018",110,1,109,437002.445454545,6378.33636363636,64.2909090909091
"1691","06012","2018",300,13,287,294192.123333333,5869.54666666667,50.76
"1692","06013","2018",21,10,11,92435.4285714286,1872.7619047619,51
"1693","06014","2018",11,5,6,194052.181818182,2934,68.8181818181818
"1694","06015","2018",22,9,13,206430,2555.45454545455,81.2272727272727
"1695","06016","2018",17,5,12,85362.3529411765,2672.47058823529,32.3529411764706
"1696","06017","2018",8,7,1,200187.5,2124.75,96
"1697","06018","2018",152,101,51,497497.032894737,4956.43421052632,101.223684210526
"1698","06019","2018",11,8,3,254303,3115,84.1818181818182
"1699","06020","2018",7,4,3,141428.571428571,2352.85714285714,54.7142857142857
"1700","06021","2018",6,6,0,274833.333333333,2859.66666666667,93
"1701","06022","2018",9,6,3,153777.777777778,2870.33333333333,54.7777777777778
"1702","06023","2018",35,16,19,87000,1480.42857142857,58.8285714285714
"1703","06024","2018",2,2,0,107500,2082.5,52
"1704","06025","2018",15,6,9,177366.666666667,2700.46666666667,68.5333333333333
"1705","06026","2018",21,18,3,459534.285714286,3994.66666666667,116.904761904762
"1706","06027","2018",1088,141,947,254515.688419118,4060.88511029412,61.8483455882353
"1707","06028","2018",18,17,1,165972.222222222,2433.61111111111,78.2222222222222
"1708","06029","2018",2388,111,2277,307653.399497487,4904.72948073702,60.2671691792295
"1709","06030","2018",926,64,862,225025.646868251,3480.58315334773,62.0302375809935
"1710","06031","2018",12,11,1,327416.666666667,3537.25,93.8333333333333
"1711","06032","2018",60,1,59,456891.066666667,7245.68333333333,60.9166666666667
"1712","06033","2018",78,21,57,233840.58974359,2828.29487179487,81.4102564102564
"1713","06034","2018",3,3,0,388783.333333333,3090.66666666667,126.666666666667
"1714","06035","2018",18,9,9,331729.666666667,3715.16666666667,86.5555555555556
"1715","06036","2018",1,1,0,310000,2583,120
"1716","06037","2018",2,2,0,170000,4185,41
"1717","06038","2018",53,38,15,591373.169811321,4459.41509433962,125.641509433962
"1718","06039","2018",8,8,0,422996.25,3540.5,123.375
"1719","06040","2018",1,1,0,150000,1402,107
"1720","06041","2018",5,4,1,257560,2552.2,104.4
"1721","06042","2018",7,4,3,126857.142857143,2113.57142857143,63.5714285714286
"1722","06043","2018",12,10,2,231758.333333333,3116.91666666667,77.1666666666667
"1723","06044","2018",104,78,26,508548.692307692,4691.63461538462,107.288461538462
"1724","06045","2018",1,1,0,120000,1935,62
"1725","06046","2018",27,18,9,369555.555555556,4063.2962962963,96.3703703703704
"1726","06048","2018",66,42,24,278109.545454545,3277.24242424242,92.1363636363636
"1727","06049","2018",1,1,0,380000,3519,108
"1728","06050","2018",12,9,3,189075,2747.41666666667,72.4166666666667
"1729","06051","2018",1,0,1,48000,1600,30
"1730","06052","2018",3,2,1,180666.666666667,1698.66666666667,101.333333333333
"1731","06054","2018",34,12,22,255667.970588235,2865.88235294118,87.2058823529412
"1732","06055","2018",1,0,1,130000,4483,29
"1733","06056","2018",3,0,3,34000,909,35.6666666666667
"1734","06057","2018",29,5,24,154690.862068966,2347.93103448276,67.8275862068966
"1735","06058","2018",3,1,2,88333.3333333333,1214.33333333333,61.6666666666667
"1736","06059","2018",48,22,26,773764.583333333,7616.27083333333,93.6458333333333
"1737","06060","2018",21,17,4,616363.857142857,5374.09523809524,126.761904761905
"1738","06062","2018",3,0,3,45000,872.333333333333,51.6666666666667
"1739","06063","2018",1,1,0,70000,1014,69
"1740","06064","2018",54,43,11,377446.314814815,3708.90740740741,101.796296296296
"1741","06065","2018",64,51,13,362030.03125,4242.609375,89.265625
"1742","06066","2018",13,10,3,246115.384615385,2643.69230769231,91.6153846153846
"1743","06067","2018",22,7,15,256332.272727273,4271.31818181818,60.5909090909091
"1744","06068","2018",2,2,0,418000,3615.5,119
"1745","06069","2018",885,238,647,223169.470056497,2804.71751412429,74.5050847457627
"1746","06070","2018",25,3,22,72009,1529,45.2
"1747","06071","2018",19,4,15,99152.1052631579,2159.57894736842,52.3684210526316
"1748","06073","2018",117,2,115,116303.162393162,3443.59829059829,34.6068376068376
"1749","06074","2018",16,12,4,154909.375,2377.625,71.5
"1750","06075","2018",63,43,20,265228.80952381,3370.38095238095,81.2539682539683
"1751","06077","2018",12,4,8,86833.3333333333,1929.08333333333,44.8333333333333
"1752","06078","2018",6,5,1,214316.666666667,2585.33333333333,82.1666666666667
"1753","06079","2018",747,88,659,265686.761713521,4203.34805890228,61.144578313253
"1754","06081","2018",6,6,0,145166.666666667,2030.16666666667,76.3333333333333
"1755","06082","2018",1,0,1,47000,1343,35
"1756","06083","2018",829,57,772,235449.324487334,4217.52472858866,55.6284680337756
"1757","06084","2018",126,73,53,462321.198412698,4212.42857142857,106.253968253968
"1758","06085","2018",346,163,183,531567.260115607,4719.26011560694,103.92774566474
"1759","06086","2018",1,0,1,22000,1375,16
"1760","06088","2018",7697,297,7400,235721.69962323,4000.1488891776,58.6602572430817
"1761","06090","2018",94,53,41,304722.35106383,3932.57446808511,78.8297872340426
"1762","06091","2018",23,20,3,342078.260869565,4029.60869565217,92.8260869565217
"1763","06092","2018",11,9,2,262772.727272727,3691.18181818182,71.7272727272727
"1764","06093","2018",9,9,0,198988.888888889,2334.11111111111,92.5555555555556
"1765","06094","2018",55,8,47,151167.363636364,3210.58181818182,46.9454545454545
"1766","06095","2018",132,86,46,327485.954545455,3481.83333333333,93.1439393939394
"1767","06097","2018",9,9,0,219055.555555556,2510.77777777778,96.5555555555556
"1768","06098","2018",1,1,0,115000,2091,55
"1769","06099","2018",27,12,15,142730.740740741,2292.07407407407,68.2592592592593
"1770","06100","2018",1,1,0,255000,3228,79
"1771","06101","2018",2,2,0,121000,994,107
"1772","06102","2018",2,1,1,116790,1197.5,95
"1773","06103","2018",23,8,15,123349.173913043,2051.5652173913,64.1739130434783
"1774","06104","2018",401,30,371,332949.586034913,5615.5885286783,57.2344139650873
"1775","06105","2018",81,75,6,691430.888888889,4774.85185185185,144.296296296296
"1776","06106","2018",5,5,0,96300,1526.8,65.8
"1777","06108","2018",66,48,18,457604.924242424,4324.04545454545,105.151515151515
"1778","06109","2018",4,4,0,302875,4961,66
"1779","06110","2018",6,6,0,111083.333333333,2049.66666666667,53
"1780","06111","2018",1,1,0,125000,2155,58
"1781","06112","2018",16,13,3,574284.375,4637.5,122.75
"1782","06113","2018",19,5,14,246763.157894737,3760.78947368421,72.5789473684211
"1783","06114","2018",42,11,31,234453.5,3619.7380952381,64.2619047619048
"1784","06116","2018",6,6,0,127798.333333333,1671.83333333333,74.3333333333333
"1785","06117","2018",7,7,0,428000,3350.85714285714,136
"1786","06118","2018",47,40,7,353299.14893617,3292.74468085106,112
"1787","06119","2018",1,1,0,150000,2679,56
"1788","06120","2018",121,5,116,196352.909090909,4042.48760330579,43.3636363636364
"1789","06121","2018",19,5,14,1020867.36842105,10601.2631578947,94.0526315789474
"1790","06122","2018",51,43,8,393802.745098039,4224.94117647059,97.0588235294118
"1791","06123","2018",570,58,512,244107.577192982,4020.81578947368,62.140350877193
"1792","06125","2018",1,1,0,73000,1521,48
"1793","06126","2018",28,12,16,225031.535714286,3271.39285714286,70.1785714285714
"1794","06127","2018",39,12,27,124632.307692308,2480.71794871795,52.0512820512821
"1795","06128","2018",50,39,11,819673.2,5843.04,132.8
"1796","06129","2018",1,1,0,20000,408,49
"1797","06130","2018",73,58,15,222143.835616438,3439.04109589041,72.2602739726027
"1798","06131","2018",4,4,0,69050,958.25,72.75
"1799","06132","2018",8,3,5,95100,1543.875,53.875
"1800","06133","2018",3,1,2,143000,1253,98.3333333333333
"1801","06134","2018",12,6,6,118416.666666667,1635.58333333333,69.4166666666667
"1802","06135","2018",5,1,4,51400,976.4,51.6
"1803","06136","2018",74,36,38,200067.027027027,2708.28378378378,72.6891891891892
"1804","06137","2018",29,24,5,386420.517241379,3855.34482758621,101.758620689655
"1805","06138","2018",100,25,75,487346.11,6016.84,72.67
"1806","06140","2018",61,57,4,391457.967213115,4185.70491803279,99.5573770491803
"1807","06141","2018",8,5,3,90625,2393.625,43.875
"1808","06142","2018",3,3,0,120000,2243.33333333333,52.3333333333333
"1809","06143","2018",14,8,6,159785.714285714,2102.78571428571,75.2857142857143
"1810","06144","2018",7,4,3,180714.285714286,2436.71428571429,72.4285714285714
"1811","06145","2018",4,4,0,217500,2609,92.5
"1812","06146","2018",3,2,1,233633.333333333,1803.33333333333,114.333333333333
"1813","06147","2018",54,35,19,341896.851851852,3743.98148148148,94.462962962963
"1814","06148","2018",63,53,10,576968.984126984,4556.79365079365,120.730158730159
"1815","06149","2018",108,43,65,232787.324074074,3347.40740740741,70.1296296296296
"1816","06150","2018",44,24,20,513889.431818182,5485.45454545455,93.5454545454545
"1817","06151","2018",8,3,5,144625,2059.375,65.75
"1818","06152","2018",187,97,90,409749.79144385,4382.54545454545,89.5828877005348
"1819","06153","2018",36,14,22,98848.0555555556,1965.63888888889,53.1944444444444
"1820","06154","2018",14,12,2,131125,1626.21428571429,80.2142857142857
"1821","06155","2018",675,106,569,250976.302222222,3805.90074074074,61.082962962963
"1822","06156","2018",5,3,2,187000,2419.4,74.4
"1823","06157","2018",343,112,231,310260.702623907,3958.9416909621,75.9096209912536
"1824","06158","2018",11,10,1,176363.636363636,2312.45454545455,83.1818181818182
"1825","06159","2018",126,26,100,656162.079365079,7015.62698412698,85.2936507936508
"1826","06160","2018",1,1,0,52000,2080,25
"1827","06161","2018",495,103,392,323348.17979798,5051.29090909091,62.840404040404
"1828","06162","2018",20,9,11,86525,1503.5,58.75
"1829","06163","2018",24,6,18,95808.3333333333,1475.16666666667,62.2916666666667
"1830","07001","2018",2,2,0,113500,2380,59.5
"1831","07002","2018",5,5,0,188890,1406.2,138.6
"1832","07003","2018",1,1,0,197000,1913,103
"1833","07005","2018",17,16,1,189051.764705882,1862.70588235294,98.4705882352941
"1834","07006","2018",3,2,1,99750,1815.33333333333,71
"1835","07007","2018",19,18,1,151674.736842105,1450.26315789474,99.1052631578947
"1836","07008","2018",11,11,0,228438,1825.90909090909,123.818181818182
"1837","07009","2018",17,15,2,122183.823529412,1321.52941176471,91.8823529411765
"1838","07010","2018",186,74,112,101632.774193548,1138.10752688172,84.0698924731183
"1839","07011","2018",10,8,2,88185.6,1066.5,84.1
"1840","07012","2018",4,3,1,52567.5,840.25,60.75
"1841","07013","2018",3,3,0,242333.333333333,1981.33333333333,124.666666666667
"1842","07014","2018",5,5,0,122000,1224.4,111.4
"1843","07015","2018",8,8,0,148175,1730.625,85.75
"1844","07017","2018",6,5,1,144950,1987.83333333333,76.8333333333333
"1845","07018","2018",2,2,0,40250,460,87.5
"1846","07019","2018",161,63,98,132357.714285714,1614.16149068323,81.0807453416149
"1847","07020","2018",5,5,0,223000.6,2593.6,87
"1848","07022","2018",13,12,1,170461.538461538,1932.92307692308,93.8461538461538
"1849","07023","2018",6,5,1,141416.666666667,1890.33333333333,78
"1850","07024","2018",5,5,0,223224,1802.6,118.8
"1851","07025","2018",2,1,1,142015.5,1462,87
"1852","07026","2018",3,2,1,68333.3333333333,1188.33333333333,62
"1853","07027","2018",17,15,2,141097.058823529,1651.29411764706,84.7647058823529
"1854","07028","2018",7,7,0,164371.428571429,1701,103.857142857143
"1855","07029","2018",5,5,0,230078,2107.2,88
"1856","07030","2018",9,7,2,108277.777777778,1318,76.4444444444444
"1857","07031","2018",16,14,2,194145.625,2197.25,94.25
"1858","07032","2018",1,1,0,85000,429,198
"1859","07033","2018",6,5,1,122858.333333333,1405.83333333333,79.6666666666667
"1860","07034","2018",1,1,0,478000,2598,184
"1861","07035","2018",13,13,0,154534.615384615,1593.92307692308,95.3846153846154
"1862","07036","2018",3,3,0,90461.6666666667,934.666666666667,92
"1863","07037","2018",4,4,0,150330,2187.25,67.25
"1864","07039","2018",5,5,0,86000,1306.8,66
"1865","07040","2018",5,5,0,163570,1507,109.4
"1866","07041","2018",11,10,1,182502.272727273,1751.09090909091,106.636363636364
"1867","07042","2018",95,56,39,129885.421052632,1419.23157894737,88.3473684210526
"1868","07044","2018",7,7,0,193585.714285714,1874.28571428571,102.857142857143
"1869","07045","2018",9,7,2,112699,1634.44444444444,72.8888888888889
"1870","07048","2018",7,6,1,70928.5714285714,1052.85714285714,56.7142857142857
"1871","07050","2018",12,12,0,239776.25,2713.5,103.166666666667
"1872","07051","2018",6,6,0,162126.166666667,1757.33333333333,97.5
"1873","07052","2018",4,4,0,216380,2141.75,103.25
"1874","07053","2018",12,12,0,170062.5,1705.75,102.25
"1875","07054","2018",7,2,5,75628.5714285714,679.714285714286,82
"1876","07055","2018",27,25,2,237235.185185185,2018.03703703704,115.259259259259
"1877","07056","2018",9,9,0,183416.666666667,1910.77777777778,95.8888888888889
"1878","07058","2018",11,11,0,131956.454545455,1510.36363636364,82.9090909090909
"1879","07059","2018",2,2,0,152000,1000,136
"1880","07060","2018",4,4,0,156443.75,1321.75,110
"1881","07061","2018",8,8,0,134496.875,1911.875,82.625
"1882","07062","2018",3,2,1,168417,2286.66666666667,75.6666666666667
"1883","07063","2018",4,4,0,192500,1803,110.25
"1884","07064","2018",21,15,6,144568.761904762,1571.71428571429,95.6190476190476
"1885","07065","2018",4,4,0,183287.5,1332.75,133.5
"1886","07066","2018",32,28,4,179597.96875,1960.59375,96.46875
"1887","07067","2018",4,4,0,171012.5,1604,109.75
"1888","07068","2018",3,3,0,166666.666666667,1411.33333333333,118.666666666667
"1889","07069","2018",3,3,0,186663.333333333,1919.66666666667,102
"1890","07070","2018",30,30,0,228035.766666667,2432.56666666667,97.4333333333333
"1891","07071","2018",12,10,2,100616.666666667,1205.5,83.25
"1892","07072","2018",7,7,0,198585.714285714,1793.42857142857,116.142857142857
"1893","07073","2018",7,7,0,97500,1577.71428571429,65.5714285714286
"1894","07075","2018",4,4,0,122525,1758.5,69.25
"1895","07076","2018",25,24,1,148028.12,1518.76,94.4
"1896","07077","2018",7,7,0,148440.714285714,1792.85714285714,82
"1897","07078","2018",23,19,4,232487.565217391,2215.08695652174,96.1739130434783
"1898","07079","2018",19,18,1,118781.578947368,1487.73684210526,88.7368421052632
"1899","07080","2018",6,6,0,130841.666666667,1299.5,120.333333333333
"1900","07081","2018",2,2,0,159990,2200,80
"1901","07082","2018",4,4,0,68250,970.75,69.5
"1902","07083","2018",4,4,0,116500,1340.75,78.5
"1903","07084","2018",9,9,0,205694.444444444,2101,102.333333333333
"1904","07085","2018",10,9,1,162170,1768,84.8
"1905","07086","2018",5,5,0,165700,1732,94
"1906","07087","2018",5,5,0,178562,2258.6,83.2
"1907","07088","2018",1,1,0,258000,3440,75
"1908","07089","2018",17,17,0,191241.176470588,1902.52941176471,98.8235294117647
"1909","07090","2018",17,15,2,126277.647058824,1719.58823529412,75.5882352941177
"1910","07091","2018",1,1,0,65000,644,101
"1911","07092","2018",1,1,0,125000,1562,80
"1912","07094","2018",3,3,0,92333.3333333333,1119.33333333333,71.3333333333333
"1913","07095","2018",7,7,0,155478.571428571,1781.42857142857,83.1428571428571
"1914","07096","2018",6,6,0,153686.333333333,1430,107.5
"1915","07097","2018",2,2,0,212750,2558.5,84
"1916","07098","2018",2,2,0,131650,1471,83
"1917","07099","2018",7,7,0,142242.857142857,1517,89.5714285714286
"1918","07100","2018",7,7,0,219357.142857143,2905.85714285714,78.8571428571429
"1919","07101","2018",10,10,0,223878,1962.6,111.2
"1920","07102","2018",183,55,128,160602.737704918,1975.28415300546,80.2841530054645
"1921","07103","2018",3,3,0,170316.666666667,1545.66666666667,127.666666666667
"1922","07104","2018",1,1,0,130000,1529,85
"1923","07105","2018",1,1,0,26000,743,35
"1924","07106","2018",3,3,0,53666.6666666667,864.333333333333,64.6666666666667
"1925","07107","2018",17,15,2,151837.647058824,1689.76470588235,91.0588235294118
"1926","07108","2018",2,2,0,90000,1405,59.5
"1927","07109","2018",9,9,0,144066.666666667,2000.66666666667,79.7777777777778
"1928","07110","2018",32,20,12,119141.40625,1582.6875,74.40625
"1929","07111","2018",5,5,0,113460,1599.4,83.6
"1930","07112","2018",5,5,0,86280,1342.6,65.8
"1931","07113","2018",8,8,0,126943.75,1807.5,72.125
"1932","07114","2018",4,4,0,122650,1015.75,108.5
"1933","07115","2018",12,12,0,273649.666666667,2108.08333333333,136
"1934","07116","2018",21,16,5,111866.666666667,1171.09523809524,92.6190476190476
"1935","07117","2018",24,22,2,207213.541666667,1829.375,113.125
"1936","07118","2018",1,1,0,137000,1489,92
"1937","07119","2018",7,4,3,150050,2045.14285714286,67.7142857142857
"1938","07120","2018",3,3,0,66156.6666666667,879.666666666667,76.6666666666667
"1939","07121","2018",2,2,0,101250,1781,70
"1940","07122","2018",18,17,1,191636.111111111,1661.27777777778,114.555555555556
"1941","07123","2018",2,2,0,86000,839.5,100.5
"1942","07126","2018",9,9,0,230744.444444444,2444,96.8888888888889
"1943","07127","2018",11,8,3,99318.1818181818,1216,80
"1944","07128","2018",8,6,2,82088.75,875.625,92.75
"1945","07129","2018",23,19,4,111815.217391304,1217.08695652174,88.9565217391304
"1946","07130","2018",3,3,0,164143.333333333,1445,112
"1947","07131","2018",3,3,0,116366.666666667,1436,85
"1948","07132","2018",19,15,4,157531.842105263,1815.42105263158,77.5263157894737
"1949","07133","2018",4,4,0,240425,2370,105.25
"1950","07134","2018",7,6,1,126285.714285714,1875.57142857143,78
"1951","07136","2018",3,2,1,53380,579.333333333333,93.6666666666667
"1952","07138","2018",20,20,0,246823.3,2409.65,100.9
"1953","07139","2018",2,2,0,60500,816.5,84
"1954","07140","2018",7,7,0,159185.714285714,1594.42857142857,101.571428571429
"1955","07141","2018",3,3,0,261666.666666667,2319.33333333333,111.333333333333
"1956","07142","2018",5,5,0,57252,1008,58.6
"1957","07143","2018",7,7,0,129128.571428571,1622,79.4285714285714
"1958","07145","2018",11,11,0,191454.545454545,1819.18181818182,106.454545454545
"1959","07146","2018",9,7,2,133988.888888889,1828.66666666667,78.5555555555556
"1960","07147","2018",7,7,0,125642.857142857,2026.57142857143,69
"1961","07148","2018",6,6,0,187166.666666667,2102.66666666667,85.5
"1962","07149","2018",4,4,0,129250,1329,108.5
"1963","07150","2018",6,6,0,79000,705.666666666667,89.3333333333333
"1964","07151","2018",2,2,0,108000,733,145
"1965","07152","2018",14,13,1,168763.571428571,2147.28571428571,81.3571428571429
"1966","07153","2018",9,9,0,67400,943.222222222222,76.7777777777778
"1967","07155","2018",13,12,1,213565.384615385,2150.76923076923,104
"1968","07156","2018",10,10,0,178383,1589.8,109.7
"1969","07157","2018",9,7,2,126230,1685.22222222222,76.2222222222222
"1970","07158","2018",4,4,0,88000,1070.5,86.5
"1971","07159","2018",7,7,0,151185.714285714,1791.42857142857,79.4285714285714
"1972","07161","2018",11,9,2,124810.545454545,1322.63636363636,91.6363636363636
"1973","07162","2018",2,2,0,172000,1347.5,122
"1974","07165","2018",10,9,1,141917.4,2752.7,54.5
"1975","07166","2018",4,4,0,185375,2030.5,108.5
"1976","07167","2018",9,9,0,146277.777777778,1579.66666666667,88.5555555555556
"1977","07168","2018",6,6,0,188433.333333333,2037.16666666667,99.1666666666667
"1978","07169","2018",3,3,0,176000,1622.33333333333,109.666666666667
"1979","07170","2018",4,4,0,118625,1593.25,73.5
"1980","07171","2018",1,1,0,227500,2275,100
"1981","07172","2018",10,10,0,240398,2006.6,123
"1982","07174","2018",10,8,2,120520,1381.1,86.2
"1983","07176","2018",1,1,0,4e+05,3200,125
"1984","07177","2018",10,10,0,210798,1866.7,109
"1985","07178","2018",7,6,1,85114.2857142857,1213.42857142857,73
"1986","07179","2018",3,2,1,168033.333333333,1793,104.666666666667
"1987","07181","2018",26,19,7,146480.769230769,1755.19230769231,83.6153846153846
"1988","07182","2018",4,4,0,184580,2436,81.25
"1989","07183","2018",8,7,1,142437.5,2353.25,63.125
"1990","07184","2018",5,5,0,159200,2202,93.8
"1991","07185","2018",6,6,0,183760,1798.16666666667,112.166666666667
"1992","07186","2018",119,37,82,104278.663865546,1376.14285714286,74.9579831932773
"1993","07187","2018",3,3,0,137333.333333333,3635,75
"1994","07188","2018",8,8,0,129506.25,1487.625,79.75
"1995","07189","2018",5,5,0,161600,2509.2,73.2
"1996","07190","2018",3,3,0,370880,2938,107.333333333333
"1997","07191","2018",23,23,0,198170.652173913,1973.86956521739,102.217391304348
"1998","07192","2018",5,5,0,148996,1337.4,101
"1999","07193","2018",2,2,0,223000,1689.5,131.5
"2000","07194","2018",5,5,0,170460,1796.6,93.8
"2001","07195","2018",3,3,0,139066.666666667,2193.33333333333,63.3333333333333
"2002","07196","2018",7,6,1,193983.571428571,1561,140.857142857143
"2003","07197","2018",19,19,0,174543.210526316,1818.21052631579,100.947368421053
"2004","07198","2018",9,9,0,227976.666666667,2051.77777777778,112
"2005","07199","2018",16,15,1,156887.5,1956.25,84.625
"2006","07200","2018",1,1,0,170000,1932,88
"2007","07201","2018",39,25,14,150418.717948718,2373.69230769231,69.6153846153846
"2008","07202","2018",5,5,0,126560,1865.6,80.6
"2009","07203","2018",2,2,0,230000,2920,83.5
"2010","07204","2018",17,11,6,117013.235294118,1499.94117647059,75.8823529411765
"2011","07205","2018",6,6,0,137566.666666667,1424,92.3333333333333
"2012","07206","2018",2,2,0,125535,1436.5,85
"2013","07207","2018",16,16,0,226085.625,2065.375,109.3125
"2014","07208","2018",2,2,0,300250,2234,134.5
"2015","07209","2018",1,1,0,50000,1667,30
"2016","07210","2018",10,10,0,111791,1557.4,69.6
"2017","07211","2018",4,4,0,93210,1565.75,58.5
"2018","07213","2018",6,6,0,244000,2100.16666666667,126.166666666667
"2019","07214","2018",6,6,0,202490.833333333,2325.66666666667,83.8333333333333
"2020","07215","2018",4,4,0,60911.25,1695,51.5
"2021","07216","2018",9,9,0,148344.444444444,1869.77777777778,88.6666666666667
"2022","07217","2018",7,7,0,144321.428571429,1761.71428571429,80
"2023","07218","2018",2,2,0,228675,1757,131
"2024","07219","2018",2,2,0,43428.5,836,52.5
"2025","07220","2018",1,1,0,110000,1667,66
"2026","07221","2018",4,4,0,116500,1443.75,83.75
"2027","07223","2018",2,2,0,129500,1461,98.5
"2028","07224","2018",1,1,0,107000,1126,95
"2029","07225","2018",13,13,0,216347.692307692,1776.30769230769,122.769230769231
"2030","07226","2018",2,2,0,105350,1367.5,65.5
"2031","07227","2018",14,14,0,181988.928571429,1937.14285714286,92.5
"2032","07228","2018",7,7,0,164614.285714286,1589.28571428571,101.857142857143
"2033","07229","2018",3,3,0,194333.333333333,1866.66666666667,105.666666666667
"2034","07230","2018",7,7,0,150285.714285714,1665.57142857143,82.7142857142857
"2035","07231","2018",25,24,1,185595.12,1879.28,98.04
"2036","07232","2018",3,3,0,74333.3333333333,963.333333333333,81.6666666666667
"2037","07233","2018",2,2,0,132500,1788,76.5
"2038","07234","2018",1,1,0,238000,2479,96
"2039","07235","2018",3,3,0,150520,2061.66666666667,74.3333333333333
"2040","07236","2018",12,8,4,104833.333333333,1032.91666666667,101
"2041","07237","2018",5,5,0,179280,1705,108.2
"2042","07238","2018",2,2,0,190500,1632.5,110.5
"2043","07239","2018",1,1,0,250000,2273,110
"2044","07240","2018",23,22,1,234511.304347826,2238.69565217391,104.695652173913
"2045","07241","2018",3,2,1,119333.333333333,2035.66666666667,58.3333333333333
"2046","07243","2018",3,3,0,173600,1203,134.666666666667
"2047","07244","2018",1,1,0,133000,1662,80
"2048","07245","2018",22,18,4,179516.363636364,1814.63636363636,100.818181818182
"2049","07247","2018",12,11,1,178476.416666667,1714.66666666667,98.0833333333333
"2050","07248","2018",5,5,0,108480,1533.6,84.2
"2051","07249","2018",3,3,0,95833.3333333333,1637,64
"2052","07250","2018",3,3,0,53266.6666666667,871.666666666667,60
"2053","07251","2018",1,1,0,50000,532,94
"2054","07253","2018",2,2,0,92500,1166.5,90
"2055","07254","2018",6,6,0,178986.666666667,1783.33333333333,105.666666666667
"2056","07255","2018",13,11,2,174415.384615385,1630.15384615385,92.6153846153846
"2057","07257","2018",2,2,0,180000,1762.5,115
"2058","07258","2018",3,3,0,136666.666666667,1291.66666666667,126.333333333333
"2059","07259","2018",17,16,1,171396.470588235,1936.29411764706,92.4117647058823
"2060","07260","2018",5,5,0,205721.4,2129.2,101.4
"2061","07261","2018",21,20,1,172397.619047619,1772.28571428571,94.1428571428571
"2062","07262","2018",1,1,0,65000,867,75
"2063","07263","2018",1,1,0,185000,1370,135
"2064","07264","2018",20,19,1,209616.25,2092.6,99.6
"2065","07265","2018",5,5,0,119794,1472.4,82.4
"2066","07266","2018",2,2,0,148270,5955,76.5
"2067","07267","2018",6,6,0,141985,1261.83333333333,122.666666666667
"2068","07268","2018",19,14,5,168018.526315789,2824.94736842105,63.2105263157895
"2069","07269","2018",6,5,1,68333.3333333333,1168.83333333333,56.1666666666667
"2070","07270","2018",5,5,0,116602,1390.6,89.2
"2071","07272","2018",4,4,0,241000,1560,150
"2072","07275","2018",4,4,0,126250,1745.75,74.25
"2073","07277","2018",2,2,0,220150,2517.5,89
"2074","07278","2018",4,4,0,178915,1605.25,133.75
"2075","07279","2018",18,17,1,171421.666666667,1682.44444444444,97.1111111111111
"2076","07280","2018",10,10,0,201664,1730.6,121.4
"2077","07281","2018",80,65,15,255849.15,2366.7375,107.1375
"2078","07282","2018",6,6,0,143333.333333333,1308.5,105.5
"2079","07284","2018",6,6,0,89333.3333333333,1618.66666666667,65.3333333333333
"2080","07285","2018",3,3,0,103333.333333333,1313.33333333333,84.6666666666667
"2081","07287","2018",3,3,0,113333.333333333,1005.66666666667,114
"2082","07288","2018",13,13,0,187493.461538462,1855.30769230769,105.769230769231
"2083","07289","2018",12,12,0,156520.833333333,1870.08333333333,86.9166666666667
"2084","07290","2018",5,5,0,149200,1908.8,84.6
"2085","07291","2018",15,14,1,156488.866666667,1761.6,92.4666666666667
"2086","07292","2018",5,5,0,134369.6,1571.6,85.4
"2087","07293","2018",9,9,0,258863.333333333,2198.33333333333,129.555555555556
"2088","07294","2018",4,4,0,107400,1644.75,64.75
"2089","07295","2018",13,13,0,154797.692307692,1949.23076923077,82.5384615384615
"2090","07296","2018",12,12,0,148083.333333333,1783.33333333333,87.1666666666667
"2091","07297","2018",6,6,0,155183.333333333,1690,90.6666666666667
"2092","07298","2018",7,7,0,204174.285714286,1878.57142857143,116
"2093","07299","2018",3,3,0,164803.333333333,1802.66666666667,96.6666666666667
"2094","07300","2018",7,7,0,165140.428571429,1674.14285714286,109.857142857143
"2095","07301","2018",15,15,0,134023.333333333,1400.06666666667,98.8666666666667
"2096","07303","2018",7,7,0,168428.571428571,1757.71428571429,96.8571428571429
"2097","07304","2018",19,9,10,115446.368421053,2074.78947368421,55.7368421052632
"2098","07305","2018",2,2,0,214875,2045,104
"2099","07306","2018",8,8,0,206375,2019.5,98.625
"2100","07307","2018",7,7,0,200128.571428571,1922.28571428571,101
"2101","07308","2018",12,11,1,136437.5,1218,109.416666666667
"2102","07309","2018",13,12,1,143946.923076923,1650.53846153846,85.6153846153846
"2103","07310","2018",1,1,0,228500,2136,107
"2104","07311","2018",1,1,0,170000,1889,90
"2105","07312","2018",5,5,0,139400,1655.2,88.8
"2106","07313","2018",14,14,0,106292.857142857,1397.57142857143,77.2142857142857
"2107","07314","2018",6,6,0,153508.333333333,1519.83333333333,102
"2108","07315","2018",12,12,0,118733.333333333,1783,76.3333333333333
"2109","07316","2018",22,19,3,255525.681818182,2553.18181818182,99.7727272727273
"2110","07317","2018",7,7,0,174109,1935,87.8571428571429
"2111","07318","2018",3,3,0,166666.666666667,1637.66666666667,90.3333333333333
"2112","07319","2018",99,69,30,135028.434343434,1532.37373737374,87.6262626262626
"2113","07321","2018",2,2,0,199000,1888.5,104
"2114","07322","2018",9,9,0,145277.777777778,1630.22222222222,89.5555555555556
"2115","07323","2018",15,15,0,220093,2070.86666666667,108.8
"2116","07324","2018",141,69,72,161354.028368794,1774.90070921986,91.0709219858156
"2117","07325","2018",15,15,0,196016.666666667,2116.93333333333,90.2666666666667
"2118","07326","2018",1,1,0,76000,543,140
"2119","07327","2018",5,4,1,193400,1869,94
"2120","07328","2018",5,4,1,256145,2876.6,87.4
"2121","07329","2018",7,7,0,107857.142857143,1792.42857142857,69.7142857142857
"2122","07330","2018",37,33,4,156921.432432432,2230.7027027027,76.3513513513514
"2123","07331","2018",54,21,33,107774.462962963,1620.44444444444,73.0925925925926
"2124","07332","2018",3,3,0,174000,2008.66666666667,88
"2125","07333","2018",4,4,0,175362,1753,106
"2126","07334","2018",35,22,13,175554.828571429,2234.17142857143,81.2
"2127","07335","2018",2,2,0,118000,1140.5,100
"2128","07336","2018",2,2,0,49000,1821.5,69
"2129","07337","2018",9,9,0,163000,1803,95.6666666666667
"2130","07338","2018",20,20,0,126209.75,1415.3,93.65
"2131","07339","2018",13,12,1,162687.846153846,1666,94.0769230769231
"2132","07340","2018",18,16,2,175642.222222222,1824.83333333333,94.3888888888889
"2133","07341","2018",31,28,3,172558.064516129,1937.35483870968,89.9354838709677
"2134","07342","2018",5,5,0,147244,1558.8,98.4
"2135","07343","2018",15,14,1,200665.333333333,2106.73333333333,100.4
"2136","07344","2018",2,2,0,168950,2158,77
"2137","07345","2018",5,5,0,181956,1600,115.6
"2138","07346","2018",36,30,6,172118.055555556,1688.11111111111,103.083333333333
"2139","07347","2018",9,8,1,165427.777777778,1953.66666666667,89.4444444444444
"2140","07348","2018",7,6,1,92000,1582.42857142857,61.7142857142857
"2141","07349","2018",52,34,18,127507.5,1561.03846153846,83.9423076923077
"2142","08001","2018",2,2,0,174950,1443,96
"2143","08003","2018",23,22,1,152023.913043478,1555.04347826087,99.7826086956522
"2144","08006","2018",3,3,0,91466.6666666667,1075.66666666667,88
"2145","08008","2018",8,8,0,73250,1062.875,81
"2146","08010","2018",1,1,0,155000,994,156
"2147","08011","2018",1,1,0,52000,867,60
"2148","08013","2018",7,7,0,125532.142857143,1349.42857142857,92.8571428571429
"2149","08014","2018",1,1,0,165000,1341,123
"2150","08015","2018",3,3,0,158000,883.666666666667,163.333333333333
"2151","08016","2018",1,1,0,45000,429,105
"2152","08017","2018",1,1,0,55000,579,95
"2153","08018","2018",1,1,0,164500,1295,127
"2154","08020","2018",1,1,0,90000,789,114
"2155","08021","2018",1,1,0,70000,1458,48
"2156","08022","2018",6,6,0,162750,1371.33333333333,111.833333333333
"2157","08024","2018",18,18,0,168600,1562.55555555556,115.777777777778
"2158","08025","2018",13,13,0,89346.1538461538,1037.23076923077,97
"2159","08026","2018",3,3,0,70000,603.666666666667,117.333333333333
"2160","08028","2018",9,9,0,124611.111111111,1252.66666666667,95.1111111111111
"2161","08029","2018",2,2,0,117500,732.5,137.5
"2162","08031","2018",1,1,0,103000,557,185
"2163","08032","2018",3,3,0,188700,1377.66666666667,137
"2164","08034","2018",2,2,0,206250,2469.5,119.5
"2165","08035","2018",2,2,0,96150,989,97.5
"2166","08037","2018",7,7,0,117514.285714286,1173.71428571429,99.8571428571429
"2167","08038","2018",2,2,0,193500,1470.5,131.5
"2168","08039","2018",9,9,0,91444.4444444444,1127.33333333333,82.7777777777778
"2169","08040","2018",6,6,0,139916.666666667,1389.83333333333,102.333333333333
"2170","08041","2018",4,4,0,91250,1006.5,99
"2171","08043","2018",17,13,4,131158.823529412,1537.58823529412,86.7058823529412
"2172","08044","2018",5,5,0,132000,1724,92.6
"2173","08046","2018",1,1,0,1e+05,613,163
"2174","08047","2018",1,1,0,174000,1289,135
"2175","08048","2018",4,4,0,154975,1343.25,114.25
"2176","08052","2018",3,3,0,72166.6666666667,563.333333333333,128
"2177","08053","2018",26,26,0,99633.4615384615,978.653846153846,108.269230769231
"2178","08055","2018",5,5,0,77040,897.6,88.6
"2179","08056","2018",2,2,0,70000,1091,60.5
"2180","08058","2018",2,2,0,218750,1693.5,136
"2181","08060","2018",5,5,0,197600,1729.6,113.8
"2182","08062","2018",1,1,0,90000,750,120
"2183","08064","2018",7,7,0,139702.857142857,1263.57142857143,108.714285714286
"2184","08065","2018",1,1,0,61766,370,167
"2185","08066","2018",1,1,0,112000,830,135
"2186","08067","2018",16,16,0,87606.25,1060.0625,83.9375
"2187","08069","2018",1,1,0,255000,2318,110
"2188","08070","2018",6,6,0,113200,1349.5,85.8333333333333
"2189","08071","2018",3,3,0,141333.333333333,1292.33333333333,107.666666666667
"2190","08073","2018",4,4,0,129920.25,923.5,144.25
"2191","08074","2018",1,1,0,80000,630,127
"2192","08075","2018",2,2,0,60000,809,72.5
"2193","08076","2018",7,7,0,139842.857142857,1233.85714285714,105.142857142857
"2194","08077","2018",3,3,0,97833.3333333333,919.666666666667,102
"2195","08078","2018",7,7,0,88142.8571428571,931.857142857143,95.4285714285714
"2196","08081","2018",43,43,0,79890.6279069767,852.93023255814,91.7209302325581
"2197","08082","2018",3,3,0,57666.6666666667,872.333333333333,65
"2198","08083","2018",2,2,0,97450,756.5,128
"2199","08084","2018",2,2,0,115000,1215,86
"2200","08087","2018",5,5,0,167511,1491.8,116.8
"2201","08088","2018",1,1,0,116000,644,180
"2202","08089","2018",3,2,1,80000,868.333333333333,95.3333333333333
"2203","08090","2018",29,25,4,93841.3793103448,1046.44827586207,89.9655172413793
"2204","08092","2018",2,2,0,191000,1420,134
"2205","08095","2018",2,2,0,99800,988,84
"2206","08096","2018",8,8,0,160568.75,1512,111.125
"2207","08097","2018",7,7,0,98378.8571428571,1060.42857142857,96.4285714285714
"2208","08098","2018",1,1,0,52000,743,70
"2209","08099","2018",4,4,0,169825,1545.25,111.75
"2210","08101","2018",3,3,0,144333.333333333,1174,126.666666666667
"2211","08103","2018",5,5,0,113400,823.4,134
"2212","08104","2018",1,1,0,50000,1111,45
"2213","08105","2018",498,254,244,104262.75502008,1207.47389558233,86.3534136546185
"2214","08107","2018",10,10,0,126193.2,1233.9,109.6
"2215","08110","2018",1,1,0,45000,429,105
"2216","08111","2018",10,10,0,185165,1631.9,115.9
"2217","08115","2018",5,5,0,97800,917.4,103.8
"2218","08119","2018",8,8,0,133000,1103.625,122.625
"2219","08121","2018",1,1,0,63000,656,96
"2220","08122","2018",7,7,0,65285.7142857143,956.142857142857,75.2857142857143
"2221","08124","2018",2,2,0,176500,1264.5,141.5
"2222","08125","2018",4,3,1,138250,1400.75,94.25
"2223","08126","2018",4,4,0,102420,1063.25,105.25
"2224","08128","2018",1,1,0,55000,447,123
"2225","08130","2018",1,1,0,60000,390,154
"2226","08131","2018",2,2,0,44000,507.5,84.5
"2227","08133","2018",6,6,0,116676,908.5,128.666666666667
"2228","08134","2018",2,2,0,108000,1601,74
"2229","08135","2018",5,5,0,55560,543.4,115.8
"2230","08136","2018",4,4,0,163825,1486.25,112.75
"2231","08137","2018",2,2,0,120000,1398,84.5
"2232","08138","2018",4,4,0,65000,574.5,113.25
"2233","08139","2018",4,4,0,145827.5,1326,111.5
"2234","08140","2018",9,9,0,142800,1081.11111111111,132.111111111111
"2235","08141","2018",1,1,0,102000,1030,99
"2236","08142","2018",17,15,2,138135.294117647,1419.29411764706,97.9411764705882
"2237","08144","2018",1,1,0,115000,1009,114
"2238","08145","2018",15,15,0,77493.3333333333,835.6,94.1333333333333
"2239","08147","2018",2,2,0,143500,1253.5,126.5
"2240","08148","2018",2,2,0,150650,1576.5,96.5
"2241","08150","2018",2,2,0,119000,1002,115
"2242","08151","2018",1,1,0,140000,875,160
"2243","08153","2018",2,2,0,73500,826,94
"2244","08154","2018",1,1,0,140000,778,180
"2245","08156","2018",7,7,0,90000,853.714285714286,103.714285714286
"2246","08158","2018",3,3,0,188666.666666667,1428.66666666667,138
"2247","08159","2018",4,4,0,128150,1424.5,90
"2248","08160","2018",2,2,0,68200,1023.5,71
"2249","08162","2018",6,6,0,170633.333333333,1542.83333333333,109.5
"2250","08164","2018",2,2,0,149675,1192.5,132.5
"2251","08166","2018",1,1,0,140000,1489,94
"2252","08167","2018",1,1,0,35000,389,90
"2253","08170","2018",2,2,0,50000,538.5,92.5
"2254","08172","2018",1,1,0,56000,361,155
"2255","08173","2018",13,12,1,150938.461538462,1669.46153846154,96.1538461538462
"2256","08174","2018",29,28,1,112236.206896552,1267.58620689655,92.4827586206897
"2257","08179","2018",3,3,0,166166.666666667,2271,70
"2258","08180","2018",22,20,2,141727.272727273,1687,84.9545454545455
"2259","08183","2018",13,13,0,115461.538461538,1169.61538461538,100.076923076923
"2260","08184","2018",3,3,0,74000,817,99.6666666666667
"2261","08185","2018",30,29,1,83986,968.166666666667,93.4
"2262","08186","2018",1,1,0,273035,10501,26
"2263","08187","2018",1,1,0,163000,1199,136
"2264","08188","2018",12,11,1,102711.25,1134.16666666667,94.6666666666667
"2265","08189","2018",1,1,0,88000,682,129
"2266","08190","2018",49,41,8,126560.204081633,1209.89795918367,105.020408163265
"2267","08191","2018",14,14,0,140852.142857143,1260.57142857143,118.142857142857
"2268","08192","2018",1,1,0,30000,789,38
"2269","08193","2018",2,2,0,120750,1075.5,121
"2270","08194","2018",10,10,0,131470,1247.8,106.7
"2271","08195","2018",1,1,0,22400,373,60
"2272","08199","2018",10,9,1,106250,917.7,116.8
"2273","08200","2018",3,3,0,94833.3333333333,811.666666666667,116.333333333333
"2274","08201","2018",1,1,0,95000,754,126
"2275","08202","2018",4,4,0,53750,769.5,73.25
"2276","08203","2018",4,4,0,135550,1306,116
"2277","08206","2018",5,5,0,188560,1565.4,121.4
"2278","08207","2018",2,2,0,66000,859,77.5
"2279","08209","2018",5,5,0,129200,1552,84.2
"2280","08210","2018",2,2,0,97500,962,98.5
"2281","08211","2018",8,8,0,112125,1069.25,106.75
"2282","08214","2018",2,2,0,137500,1277.5,111
"2283","08216","2018",3,3,0,204400,1254.66666666667,173
"2284","08217","2018",2,2,0,48500,569.5,87.5
"2285","08218","2018",9,9,0,96641.1111111111,1029.88888888889,99
"2286","08219","2018",3,3,0,88433.3333333333,969.333333333333,94.3333333333333
"2287","08220","2018",4,4,0,132000,1676,79.75
"2288","08222","2018",16,16,0,118937.5,1110.75,105.1875
"2289","08223","2018",1,1,0,50000,391,128
"2290","08225","2018",6,6,0,169791.666666667,1489.66666666667,115.833333333333
"2291","08226","2018",2,2,0,153150,918,165.5
"2292","08228","2018",3,3,0,85500,1097,81.3333333333333
"2293","08229","2018",1,1,0,115000,1438,80
"2294","08230","2018",5,5,0,174464,1436.2,119.8
"2295","08232","2018",6,6,0,105333.333333333,969.833333333333,116
"2296","08234","2018",6,6,0,129761.666666667,1308.83333333333,105.833333333333
"2297","08236","2018",2,2,0,149000,1097,139.5
"2298","08237","2018",6,6,0,102250,1121,93.5
"2299","08239","2018",11,11,0,145281.818181818,1326.18181818182,113.545454545455
"2300","08242","2018",6,6,0,87150,1076.83333333333,80
"2301","08243","2018",2,2,0,80000,733.5,112.5
"2302","08246","2018",1,1,0,40000,526,76
"2303","08247","2018",1,1,0,145000,1160,125
"2304","08248","2018",6,6,0,109300,921,112.833333333333
"2305","08251","2018",1,1,0,162000,1397,116
"2306","08252","2018",3,3,0,81666.6666666667,899.333333333333,85.6666666666667
"2307","08254","2018",2,2,0,91250,894.5,99.5
"2308","08255","2018",1,1,0,110000,917,120
"2309","08257","2018",3,3,0,78066.6666666667,908,86.3333333333333
"2310","08259","2018",1,1,0,45000,750,60
"2311","08260","2018",4,4,0,112200,1115,97.5
"2312","08262","2018",8,8,0,131750,1411.625,96
"2313","08263","2018",16,14,2,130676.3125,1470.8125,89.4375
"2314","08264","2018",6,6,0,143283.333333333,1264.16666666667,117.166666666667
"2315","08272","2018",1,1,0,74800,639,117
"2316","08274","2018",2,2,0,39500,431,90
"2317","08275","2018",4,4,0,94100,1090,100.75
"2318","08276","2018",4,4,0,118425,1002.75,143.5
"2319","08277","2018",1,1,0,41000,661,62
"2320","08279","2018",2,2,0,106000,883,162
"2321","08281","2018",5,5,0,92800,940,105.4
"2322","08282","2018",10,10,0,80000,774.5,103.8
"2323","08284","2018",5,5,0,99400,1385.4,87.6
"2324","08289","2018",7,7,0,103000,806.857142857143,124.714285714286
"2325","08291","2018",2,2,0,73500,979,69.5
"2326","08293","2018",3,3,0,66666.6666666667,655.666666666667,93.3333333333333
"2327","08294","2018",1,1,0,174015,1813,96
"2328","08296","2018",2,2,0,65000,644.5,112.5
"2329","08297","2018",5,5,0,191800,1392.2,133.4
"2330","08298","2018",23,23,0,154369.565217391,1319.47826086957,112.652173913043
"2331","08302","2018",22,22,0,93683.1818181818,978.909090909091,96.1818181818182
"2332","08303","2018",3,3,0,91666.6666666667,1193.66666666667,68.3333333333333
"2333","08304","2018",1,1,0,23000,365,63
"2334","08305","2018",1,1,0,125000,1250,100
"2335","08306","2018",1,1,0,135000,1324,102
"2336","08311","2018",14,14,0,107353.571428571,1197.78571428571,90.8571428571429
"2337","08312","2018",1,1,0,135000,758,178
"2338","08313","2018",2,2,0,168250,1484.5,117
"2339","08314","2018",6,6,0,148319.666666667,1717.66666666667,90.8333333333333
"2340","08315","2018",1,1,0,154500,1288,120
"2341","08316","2018",15,15,0,65596.6666666667,774.4,85.6666666666667
"2342","08318","2018",8,8,0,126625,1358.875,98
"2343","08319","2018",2,2,0,168000,923.5,179
"2344","08320","2018",6,6,0,185641.666666667,1384.33333333333,134.333333333333
"2345","08322","2018",4,4,0,118525,1446,82.5
"2346","08327","2018",13,13,0,146769.230769231,1597.69230769231,94.6153846153846
"2347","08328","2018",53,48,5,95821.2264150943,1031.60377358491,92.7547169811321
"2348","08330","2018",5,5,0,126900,1517.4,83.2
"2349","08331","2018",10,10,0,114993,1065.8,107.9
"2350","08333","2018",1,1,0,80000,792,101
"2351","08336","2018",3,3,0,154625,820,186.666666666667
"2352","08338","2018",1,1,0,61000,622,98
"2353","08339","2018",4,4,0,176760,1356.75,146.5
"2354","08340","2018",1,1,0,190700,1851,103
"2355","08341","2018",8,8,0,188462.5,1795.75,101.5
"2356","08342","2018",5,5,0,87780,1050,78
"2357","08343","2018",6,6,0,104786.666666667,1041.33333333333,102.5
"2358","08344","2018",2,2,0,62000,605.5,102.5
"2359","08346","2018",15,15,0,159386.333333333,1640.93333333333,100.066666666667
"2360","08347","2018",2,2,0,67200,758,88.5
"2361","08349","2018",3,3,0,76666.6666666667,814.666666666667,91.6666666666667
"2362","08350","2018",2,2,0,128950,1064,121.5
"2363","08352","2018",1,1,0,75000,798,94
"2364","08353","2018",9,9,0,153322.222222222,1430.22222222222,112.777777777778
"2365","08354","2018",4,4,0,73250,1173,75
"2366","08355","2018",3,3,0,185000,1514,121.666666666667
"2367","08356","2018",2,2,0,95000,994.5,100.5
"2368","08357","2018",9,9,0,96127.7777777778,1164.55555555556,92
"2369","08358","2018",4,4,0,156000,1084,150.5
"2370","08361","2018",19,19,0,129104.578947368,1208.84210526316,109.157894736842
"2371","08362","2018",70,46,24,110323.328571429,1401.34285714286,81.2714285714286
"2372","08363","2018",59,59,0,66720.3389830509,828.542372881356,79.7627118644068
"2373","08364","2018",3,3,0,116666.666666667,993,118.666666666667
"2374","08365","2018",11,11,0,110068.181818182,898.363636363636,131
"2375","08366","2018",11,11,0,66727.1818181818,705.636363636364,101.818181818182
"2376","08367","2018",20,20,0,131775,1293,100.2
"2377","08368","2018",6,6,0,142306.666666667,1613.83333333333,93
"2378","08370","2018",4,4,0,85000,1143.5,74.75
"2379","08373","2018",4,4,0,75000,768.5,113
"2380","08374","2018",2,2,0,86750,1057.5,71.5
"2381","08376","2018",1,1,0,275000,772,356
"2382","08377","2018",1,1,0,68000,630,108
"2383","08378","2018",1,1,0,160000,1013,158
"2384","08379","2018",2,2,0,91700,1012.5,90
"2385","08380","2018",2,2,0,139000,1528.5,90.5
"2386","08381","2018",11,11,0,121763.636363636,1263.36363636364,97.5454545454545
"2387","08383","2018",2,2,0,49250,426,119
"2388","08384","2018",1,1,0,143000,1625,88
"2389","08385","2018",8,7,1,139550,1392.875,97.5
"2390","08386","2018",4,4,0,112975,1245.5,97
"2391","08388","2018",4,4,0,213500,1674.5,128.5
"2392","08389","2018",1,1,0,225000,953,236
"2393","08391","2018",11,11,0,91231.8181818182,1073.27272727273,93
"2394","08392","2018",2,2,0,290250,1819.5,159
"2395","08393","2018",1,1,0,73000,521,140
"2396","08395","2018",2,2,0,40000,696,57
"2397","08396","2018",1,1,0,139200,1160,120
"2398","08399","2018",1,1,0,150000,1304,115
"2399","08400","2018",4,4,0,89750,933.5,100
"2400","08402","2018",10,10,0,114420.1,1297.3,90.8
"2401","08403","2018",17,16,1,154023.529411765,1430.47058823529,109
"2402","08404","2018",2,2,0,112400,1614,70.5
"2403","08405","2018",2,2,0,101000,842,118
"2404","08406","2018",1,1,0,25000,439,57
"2405","08408","2018",4,4,0,139250,1157.75,116.75
"2406","08409","2018",146,64,82,79956.5136986301,923.047945205479,86.458904109589
"2407","08410","2018",3,3,0,78333.3333333333,513,143.666666666667
"2408","08413","2018",3,3,0,61333.3333333333,886.333333333333,75.3333333333333
"2409","08415","2018",5,5,0,90600,974.8,101.6
"2410","08416","2018",3,3,0,115666.666666667,1144,124.333333333333
"2411","08417","2018",1,1,0,150000,1250,120
"2412","08418","2018",3,3,0,113333.333333333,760,147
"2413","08419","2018",8,8,0,118625,1378.125,94.125
"2414","08420","2018",7,7,0,89000,886,100.714285714286
"2415","08421","2018",2,2,0,81000,743.5,110
"2416","08422","2018",1,1,0,38000,380,100
"2417","08427","2018",3,3,0,93533.3333333333,1241.66666666667,86.3333333333333
"2418","08428","2018",2,2,0,100500,1314,76.5
"2419","08429","2018",3,3,0,111666.666666667,924,119.333333333333
"2420","08431","2018",2,2,0,105500,1302,92.5
"2421","08435","2018",10,10,0,152330,1589.5,100.9
"2422","08436","2018",1,1,0,240000,1333,180
"2423","08438","2018",3,3,0,128166.666666667,1152.33333333333,112
"2424","08439","2018",1,1,0,210000,644,326
"2425","08440","2018",1,1,0,60000,857,70
"2426","08445","2018",2,2,0,155000,1138,139.5
"2427","08448","2018",15,15,0,69700,894.133333333333,83.8666666666667
"2428","08449","2018",9,9,0,90720,818.777777777778,100.333333333333
"2429","08450","2018",3,3,0,155633.333333333,1651.33333333333,99
"2430","08451","2018",1,1,0,2e+05,1818,110
"2431","08452","2018",2,2,0,220450,1627.5,134
"2432","08453","2018",2,2,0,114000,1141.5,96.5
"2433","08455","2018",1,1,0,36000,800,45
"2434","08457","2018",15,14,1,143991.333333333,1396.06666666667,108.933333333333
"2435","08458","2018",1,1,0,65000,478,136
"2436","08459","2018",1,1,0,39500,637,62
"2437","08460","2018",2,2,0,102500,1157.5,85.5
"2438","08461","2018",1,1,0,55000,545,101
"2439","08464","2018",1,1,0,32000,667,48
"2440","08465","2018",2,2,0,125000,1138.5,116
"2441","08468","2018",1,1,0,220000,1618,136
"2442","08469","2018",7,7,0,148571.428571429,1116.57142857143,139.142857142857
"2443","08470","2018",1,1,0,70000,583,120
"2444","08473","2018",2,2,0,172900,1336,137
"2445","08476","2018",5,5,0,128600,1551.2,91.4
"2446","08477","2018",1,1,0,170000,1056,161
"2447","08478","2018",1,1,0,54000,540,100
"2448","08480","2018",32,32,0,140184.375,1407.5625,104.84375
"2449","08481","2018",1,1,0,75000,833,90
"2450","08482","2018",1,1,0,55000,573,96
"2451","08483","2018",4,4,0,168950,1720.25,100.75
"2452","08485","2018",2,2,0,164000,1160,154.5
"2453","08486","2018",14,14,0,99153.5714285714,989.357142857143,102.357142857143
"2454","08487","2018",17,17,0,114485.294117647,1167.41176470588,96.7058823529412
"2455","08488","2018",22,21,1,120831.818181818,1254.04545454545,96.5
"2456","08490","2018",39,35,4,100519.487179487,1052.74358974359,98.2820512820513
"2457","08491","2018",32,31,1,115758.4375,1295.4375,94.1875
"2458","08492","2018",2,2,0,88250,667,139
"2459","08494","2018",3,3,0,141333.333333333,1436.66666666667,99.3333333333333
"2460","08497","2018",14,13,1,126850,1313.92857142857,97
"2461","08498","2018",3,3,0,141424.666666667,1233.33333333333,125.333333333333
"2462","08501","2018",3,3,0,116000,1355,91.3333333333333
"2463","08502","2018",1,1,0,473594,3508,135
"2464","08503","2018",3,3,0,144333.333333333,1050.66666666667,134.333333333333
"2465","09002","2018",6,6,0,151000,1581.16666666667,101.666666666667
"2466","09003","2018",6,6,0,103334.166666667,1003.33333333333,104.666666666667
"2467","09004","2018",4,4,0,93125,1209.25,83.25
"2468","09005","2018",3,3,0,67796.6666666667,1007,78.3333333333333
"2469","09006","2018",2,2,0,154735,2416.5,73.5
"2470","09007","2018",1,1,0,640000,12800,50
"2471","09008","2018",4,4,0,90000,1231.5,88
"2472","09009","2018",1,1,0,65000,929,70
"2473","09012","2018",1,1,0,114000,1629,70
"2474","09013","2018",1,1,0,145000,1436,101
"2475","09014","2018",3,3,0,60033.3333333333,1379,48
"2476","09015","2018",8,8,0,128081.25,1309.375,89.625
"2477","09018","2018",2,2,0,130000,1139.5,108
"2478","09019","2018",2,2,0,76500,1061.5,69
"2479","09020","2018",2,2,0,87660,1112,79
"2480","09021","2018",2,2,0,92500,896.5,103.5
"2481","09022","2018",3,3,0,146000,1296.66666666667,112
"2482","09023","2018",5,4,1,88795.6,1283,90.4
"2483","09024","2018",4,4,0,101460,1162.5,83
"2484","09025","2018",1,1,0,70000,1892,37
"2485","09026","2018",1,1,0,66502,1255,53
"2486","09027","2018",1,1,0,35000,372,94
"2487","09029","2018",14,3,11,45809.6428571429,1004.14285714286,44.3571428571429
"2488","09030","2018",13,12,1,106732.692307692,1571.76923076923,67.1538461538462
"2489","09031","2018",1,1,0,45000,978,46
"2490","09032","2018",68,14,54,81469.2647058823,2017.48529411765,43.4852941176471
"2491","09035","2018",7,7,0,64385.7142857143,973.857142857143,66.1428571428571
"2492","09038","2018",2,2,0,105900,1007.5,93
"2493","09039","2018",4,4,0,79225,1154.5,69.25
"2494","09040","2018",7,7,0,120235.714285714,1334.85714285714,88.4285714285714
"2495","09041","2018",3,3,0,93733.3333333333,1162.66666666667,84.6666666666667
"2496","09042","2018",9,9,0,238217.777777778,2483.66666666667,117
"2497","09043","2018",10,10,0,73580,1021.5,80.9
"2498","09044","2018",1,1,0,156650,1478,106
"2499","09045","2018",5,5,0,113800,1242,101.2
"2500","09047","2018",16,16,0,87096.875,1058.25,85.5
"2501","09049","2018",1,1,0,85000,3864,22
"2502","09050","2018",7,7,0,154685.714285714,1408.71428571429,107
"2503","09051","2018",2,2,0,75500,1331.5,64
"2504","09052","2018",1,1,0,144000,1099,131
"2505","09053","2018",2,2,0,64355,610.5,108.5
"2506","09054","2018",5,5,0,91740,1025.6,88.6
"2507","09055","2018",4,4,0,71000,1286,55
"2508","09057","2018",7,7,0,111214.285714286,1282.71428571429,101.714285714286
"2509","09058","2018",2,2,0,180750,1703.5,105.5
"2510","09059","2018",2,2,0,78325,1128.5,67
"2511","09060","2018",15,15,0,121430,1261.8,98.1333333333333
"2512","09061","2018",3,3,0,123000,1118.33333333333,113.666666666667
"2513","09062","2018",10,10,0,75425,1450.3,57
"2514","09063","2018",4,4,0,64250,1067.75,59.75
"2515","09064","2018",1,1,0,86800,1447,60
"2516","09065","2018",14,14,0,66150,1223.14285714286,58.1428571428571
"2517","09066","2018",2,2,0,124000,1475,81.5
"2518","09067","2018",3,3,0,48333.3333333333,674.666666666667,67.3333333333333
"2519","09068","2018",1,1,0,110000,2000,55
"2520","09069","2018",3,3,0,159983.333333333,1493.66666666667,105
"2521","09070","2018",2,2,0,60000,851,64.5
"2522","09071","2018",1,1,0,84000,1050,80
"2523","09073","2018",1,1,0,95000,1105,86
"2524","09074","2018",4,4,0,171886.75,1233.25,139.5
"2525","09075","2018",6,6,0,101333.333333333,993.666666666667,119
"2526","09076","2018",2,2,0,132500,1124,104.5
"2527","09077","2018",2,2,0,56250,891.5,60.5
"2528","09079","2018",5,5,0,166600,1700,111.4
"2529","09080","2018",3,3,0,75000,688,106
"2530","09081","2018",1,1,0,358700,1507,238
"2531","09082","2018",4,4,0,74750,893.25,77.25
"2532","09083","2018",1,1,0,23231,465,50
"2533","09085","2018",10,9,1,83717,1112.1,73.6
"2534","09086","2018",3,3,0,157333.333333333,1078.66666666667,164.666666666667
"2535","09087","2018",1,1,0,150075,778,193
"2536","09089","2018",3,3,0,201600,1191.66666666667,177.333333333333
"2537","09091","2018",2,2,0,116500,1124,98.5
"2538","09093","2018",1,1,0,206900,1533,135
"2539","09094","2018",1,1,0,97000,1492,65
"2540","09095","2018",6,6,0,69300,1224,62.6666666666667
"2541","09098","2018",1,1,0,85000,1133,75
"2542","09099","2018",3,3,0,220500,1842.33333333333,115.333333333333
"2543","09100","2018",6,3,3,36506.6666666667,490.333333333333,76.6666666666667
"2544","09101","2018",4,4,0,208000,2026.75,108
"2545","09102","2018",1,1,0,240000,2087,115
"2546","09103","2018",7,7,0,147428.571428571,1381.28571428571,101.571428571429
"2547","09104","2018",7,6,1,160292.857142857,1581.85714285714,97.1428571428571
"2548","09105","2018",10,10,0,89200,1150.2,78.3
"2549","09106","2018",3,3,0,96966.6666666667,982,93
"2550","09107","2018",8,8,0,108256.25,923.75,129.25
"2551","09108","2018",4,4,0,57200,674,98
"2552","09109","2018",1,1,0,135000,1227,110
"2553","09110","2018",2,2,0,92500,1131,83.5
"2554","09111","2018",8,7,1,74600,840.375,80.875
"2555","09113","2018",11,11,0,58805.4545454545,1158.63636363636,59.5454545454545
"2556","09114","2018",3,3,0,139850,1907.66666666667,78.6666666666667
"2557","09115","2018",1,1,0,211400,1719,123
"2558","09116","2018",3,3,0,88500,1201,74
"2559","09117","2018",2,2,0,135000,1291.5,80
"2560","09118","2018",3,3,0,139833.333333333,952.666666666667,162.666666666667
"2561","09119","2018",10,10,0,95600,1071.1,90
"2562","09120","2018",4,4,0,139737.5,1587.25,91
"2563","09121","2018",4,4,0,125462.5,1847.25,71
"2564","09122","2018",137,80,57,111218.941605839,1315.16058394161,86.1605839416058
"2565","09123","2018",1,1,0,1e+05,909,110
"2566","09124","2018",14,12,2,127961.428571429,1489.64285714286,89.2857142857143
"2567","09125","2018",6,6,0,93266.6666666667,843.5,113
"2568","09126","2018",2,2,0,28850,428,67.5
"2569","09127","2018",2,2,0,167500,1814,92.5
"2570","09128","2018",2,2,0,120573.5,1147,111
"2571","09129","2018",7,7,0,156892.142857143,2203.71428571429,80.5714285714286
"2572","09130","2018",7,7,0,88314.2857142857,1265.71428571429,73.5714285714286
"2573","09131","2018",1,1,0,87570,1042,84
"2574","09134","2018",1,1,0,120280,1191,101
"2575","09137","2018",2,2,0,316000,2609.5,122
"2576","09138","2018",3,3,0,128166.666666667,1717.33333333333,76.6666666666667
"2577","09139","2018",1,0,1,95000,1900,50
"2578","09140","2018",5,5,0,218162,2033.2,107
"2579","09141","2018",2,2,0,87025,1638,54
"2580","09142","2018",2,2,0,79500,748.5,87
"2581","09143","2018",2,2,0,49500,903.5,52.5
"2582","09145","2018",1,1,0,89000,761,117
"2583","09146","2018",1,1,0,147000,2722,54
"2584","09147","2018",2,2,0,161700,1265,131
"2585","09148","2018",3,3,0,78000,851,94
"2586","09149","2018",8,8,0,84187.5,1205.75,83.5
"2587","09150","2018",2,2,0,138250,1388,116
"2588","09153","2018",1,1,0,4e+05,1681,238
"2589","09155","2018",4,4,0,106937.5,1423.75,83
"2590","09156","2018",1,1,0,104500,1451,72
"2591","09157","2018",22,20,2,89253.6363636364,992.863636363636,89.6363636363636
"2592","09159","2018",2,2,0,158580,1537,104
"2593","09160","2018",76,70,6,81532.7631578947,925.276315789474,92.3815789473684
"2594","09161","2018",10,10,0,86102,972.3,89.6
"2595","09162","2018",3,3,0,83210,1272.33333333333,66.3333333333333
"2596","09163","2018",1,1,0,140000,909,154
"2597","09164","2018",4,4,0,219325,1687,159.25
"2598","09165","2018",5,5,0,96176,832.4,116.4
"2599","09166","2018",1,1,0,117500,1958,60
"2600","09167","2018",23,23,0,174048.47826087,1379,130.130434782609
"2601","09169","2018",3,3,0,203500,2247.33333333333,88
"2602","09170","2018",2,2,0,114000,1337.5,87.5
"2603","09173","2018",3,3,0,161000,1333,130.666666666667
"2604","09174","2018",2,2,0,116000,1583,73.5
"2605","09176","2018",4,4,0,94497.5,1045.5,108.5
"2606","09177","2018",3,3,0,85166.6666666667,847.666666666667,97.3333333333333
"2607","09180","2018",6,6,0,162708.333333333,1483,126
"2608","09181","2018",17,17,0,109447.058823529,1250.70588235294,86.1176470588235
"2609","09182","2018",20,20,0,67298.75,1105.35,61.85
"2610","09185","2018",43,39,4,138359.418604651,1305.86046511628,102.883720930233
"2611","09186","2018",2,2,0,108500,1401,77.5
"2612","09187","2018",4,4,0,156000,1235.25,150.75
"2613","09188","2018",13,13,0,118455.384615385,1109,103.076923076923
"2614","09189","2018",2,2,0,93550,1532.5,83.5
"2615","09190","2018",1,1,0,30000,492,61
"2616","09192","2018",6,6,0,80425,975.666666666667,76.8333333333333
"2617","09193","2018",3,3,0,99038.3333333333,1076,98
"2618","09194","2018",52,48,4,155383.076923077,1605,101.865384615385
"2619","09198","2018",2,2,0,65000,968.5,62.5
"2620","09199","2018",4,4,0,233602.5,1725.5,134.25
"2621","09200","2018",1,1,0,2e+05,1282,156
"2622","09202","2018",4,4,0,219750,2034.75,93.25
"2623","09203","2018",1,1,0,259400,1526,170
"2624","09204","2018",1,1,0,295100,1513,195
"2625","09206","2018",15,13,2,80913.7333333333,1509.2,69.8666666666667
"2626","09207","2018",13,13,0,139365.692307692,1439.07692307692,92.7692307692308
"2627","09208","2018",1,1,0,72330,1572,46
"2628","09209","2018",16,16,0,117383.125,1439,82
"2629","09210","2018",4,4,0,155137.5,1269.25,142
"2630","09211","2018",2,1,1,97995,2003.5,50.5
"2631","09212","2018",1,1,0,104000,1040,100
"2632","09213","2018",2,2,0,114625,1476,80.5
"2633","09214","2018",10,10,0,75900,1207.9,70.2
"2634","09215","2018",2,2,0,76500,965,84
"2635","09217","2018",5,5,0,93800,1146.6,86
"2636","09218","2018",3,3,0,88166.6666666667,1331.33333333333,74
"2637","09219","2018",2,2,0,54637.5,743.5,74
"2638","09221","2018",3,3,0,115333.333333333,965,145.333333333333
"2639","09222","2018",2,2,0,67500,1532,43.5
"2640","09223","2018",10,10,0,108910,1513.2,77.3
"2641","09224","2018",6,6,0,134166.666666667,1454.33333333333,89.1666666666667
"2642","09225","2018",220,147,73,103129.577272727,1228.21818181818,85.0681818181818
"2643","09226","2018",1,1,0,84000,792,106
"2644","09228","2018",4,4,0,124902.5,1410.5,88
"2645","09229","2018",9,9,0,78283.3333333333,1069.44444444444,77.3333333333333
"2646","09230","2018",2,2,0,73800,442,167
"2647","09231","2018",8,8,0,82287.5,1891.25,48.5
"2648","09232","2018",2,2,0,71200,928.5,93.5
"2649","09233","2018",2,2,0,101500,1074,93
"2650","09234","2018",1,1,0,115000,2347,49
"2651","09235","2018",10,10,0,155772,1342.3,113.1
"2652","09236","2018",2,2,0,91675,989,84.5
"2653","09238","2018",15,15,0,200746.666666667,1383.4,151
"2654","09239","2018",1,1,0,109000,1112,98
"2655","09240","2018",1,1,0,112000,1600,70
"2656","09241","2018",5,5,0,101800,780,122
"2657","09244","2018",7,6,1,143714.285714286,1292.42857142857,101.714285714286
"2658","09245","2018",15,15,0,168233,1364.86666666667,117.466666666667
"2659","09246","2018",5,5,0,130900,1464.6,106
"2660","09247","2018",2,2,0,48775,501,96
"2661","09249","2018",2,2,0,136750,1645.5,77
"2662","09250","2018",4,4,0,171740,1658.25,104.75
"2663","09251","2018",2,2,0,142500,1132.5,118
"2664","09252","2018",1,1,0,72500,1115,65
"2665","09253","2018",3,3,0,75666.6666666667,1037.66666666667,79.3333333333333
"2666","09254","2018",4,4,0,134425,1246,105.25
"2667","09257","2018",9,9,0,107638.888888889,1412.33333333333,79
"2668","09258","2018",4,4,0,150450,1558,98.75
"2669","09259","2018",1,1,0,30000,545,55
"2670","09261","2018",88,60,28,106843.420454545,1355.17045454545,83.25
"2671","09262","2018",1,1,0,105000,1141,92
"2672","09263","2018",3,3,0,70000,1098.33333333333,77.6666666666667
"2673","09264","2018",20,20,0,166060,1575.9,105.8
"2674","09265","2018",34,29,5,131707.735294118,1493.26470588235,90.7058823529412
"2675","09267","2018",11,10,1,68545.4545454545,1005.36363636364,66.8181818181818
"2676","09268","2018",12,10,2,144295.833333333,1575.25,93
"2677","09269","2018",2,2,0,129705,946.5,138
"2678","09270","2018",3,3,0,159000,2016,85
"2679","09272","2018",23,23,0,114808.304347826,1317.4347826087,90.9130434782609
"2680","09273","2018",5,5,0,92800,1109,81.4
"2681","09274","2018",1,1,0,424500,1887,225
"2682","09275","2018",5,5,0,185200,1841.2,102.6
"2683","09276","2018",1,1,0,250000,1689,148
"2684","09277","2018",3,3,0,109166.666666667,1441.33333333333,75
"2685","09279","2018",2,2,0,102500,1107,91
"2686","09280","2018",14,13,1,93450,1253.5,87.8571428571429
"2687","09281","2018",1,1,0,135000,1195,113
"2688","09282","2018",58,49,9,135060.172413793,1425.48275862069,95.8448275862069
"2689","09283","2018",11,5,6,90538.3636363636,1570.81818181818,58.6363636363636
"2690","09284","2018",2,2,0,108500,1186,91
"2691","09285","2018",12,12,0,80037.5,1379.08333333333,72.4166666666667
"2692","09289","2018",11,11,0,130667.545454545,1188.45454545455,120.363636363636
"2693","09290","2018",7,7,0,65357.1428571429,967.857142857143,78.5714285714286
"2694","09291","2018",2,2,0,76655,1188,54
"2695","09292","2018",1,1,0,83500,1285,65
"2696","09293","2018",12,12,0,88650,996.666666666667,90.8333333333333
"2697","09294","2018",1,1,0,80000,1569,51
"2698","09295","2018",5,5,0,108050,1063.8,102.4
"2699","09296","2018",3,3,0,50333.3333333333,976.666666666667,55.6666666666667
"2700","09298","2018",2,2,0,148000,1879.5,77.5
"2701","09299","2018",3,3,0,194166.666666667,1977.33333333333,96
"2702","09300","2018",4,4,0,86500,1448,63
"2703","09301","2018",7,7,0,90428.5714285714,1297.85714285714,67.2857142857143
"2704","09303","2018",4,4,0,141388.75,1386.25,107
"2705","09305","2018",2,2,0,149365,1445.5,103
"2706","09306","2018",24,22,2,118907.5,1165.125,99.25
"2707","09307","2018",1,1,0,47000,979,48
"2708","09309","2018",4,4,0,181250,929.75,201.5
"2709","09310","2018",1,1,0,232600,1922,121
"2710","09312","2018",37,37,0,161857.324324324,1584.2972972973,102.162162162162
"2711","09313","2018",3,3,0,106833.333333333,875,121
"2712","09314","2018",2,2,0,130200,1041,126.5
"2713","09315","2018",2,2,0,211622,1304.5,170
"2714","09316","2018",2,2,0,113975,1002.5,118.5
"2715","09318","2018",1,1,0,181000,1496,121
"2716","09321","2018",4,3,1,80625,1049.25,66.75
"2717","09322","2018",41,25,16,67598.7804878049,1622.0487804878,41.9756097560976
"2718","09324","2018",38,36,2,150109.657894737,1583.55263157895,97.4736842105263
"2719","09326","2018",2,2,0,67500,891,72.5
"2720","09327","2018",2,2,0,233500,1900.5,122.5
"2721","09328","2018",2,2,0,33000,714.5,54
"2722","09329","2018",7,7,0,108667.142857143,962.857142857143,112.428571428571
"2723","09330","2018",1,1,0,126000,1465,86
"2724","09331","2018",8,8,0,107400,1206.125,93.5
"2725","09332","2018",26,25,1,148603.538461538,1543,99.1538461538462
"2726","09334","2018",20,18,2,65127.5,860.05,78.1
"2727","09336","2018",7,7,0,81558.5714285714,858.428571428571,98.2857142857143
"2728","09338","2018",1,1,0,178000,1816,98
"2729","09339","2018",5,5,0,103500,980.8,107.4
"2730","09340","2018",2,2,0,115150,1344.5,85.5
"2731","09341","2018",1,1,0,99000,811,122
"2732","09342","2018",3,3,0,157233.333333333,1843.66666666667,84.3333333333333
"2733","10002","2018",1,1,0,58500,1462,40
"2734","10003","2018",52,51,1,101958.096153846,1096.82692307692,95.1923076923077
"2735","10004","2018",1,1,0,35730,496,72
"2736","10005","2018",4,4,0,178625,1294,138
"2737","10006","2018",39,36,3,104689.743589744,1113.51282051282,97.1025641025641
"2738","10008","2018",2,2,0,78500,993,78.5
"2739","10011","2018",5,5,0,73717.4,1457.2,63.8
"2740","10012","2018",2,2,0,87500,690,132.5
"2741","10015","2018",6,6,0,151233.333333333,1513,101.166666666667
"2742","10017","2018",1,1,0,50000,521,96
"2743","10018","2018",9,9,0,136571.555555556,1211,105.888888888889
"2744","10019","2018",5,5,0,110000,989.6,109.4
"2745","10020","2018",3,3,0,91666.6666666667,844.666666666667,110.666666666667
"2746","10022","2018",5,5,0,71400,908.8,90.4
"2747","10023","2018",5,5,0,130600,1087.6,119.2
"2748","10024","2018",2,2,0,72500,557.5,130
"2749","10025","2018",3,3,0,68333.3333333333,963.333333333333,71
"2750","10027","2018",1,1,0,83000,1169,71
"2751","10028","2018",1,1,0,40000,444,90
"2752","10029","2018",1,1,0,62000,539,115
"2753","10030","2018",7,6,1,163785.714285714,1758.14285714286,91.4285714285714
"2754","10031","2018",5,5,0,127470,1278,99.6
"2755","10032","2018",1,1,0,160000,1818,88
"2756","10033","2018",39,31,8,82525.641025641,973.948717948718,85.3076923076923
"2757","10034","2018",18,14,4,91100,968.944444444444,88.9444444444444
"2758","10035","2018",4,4,0,68750,744.5,85
"2759","10037","2018",8,8,0,135687.5,1382.125,124.625
"2760","10040","2018",2,2,0,58500,690,74
"2761","10042","2018",6,6,0,91000,1220.83333333333,75.5
"2762","10043","2018",1,1,0,75000,610,123
"2763","10044","2018",1,1,0,75000,1415,53
"2764","10045","2018",3,3,0,129666.666666667,932,141
"2765","10046","2018",1,1,0,146000,1431,102
"2766","10048","2018",2,2,0,72500,1052,68.5
"2767","10049","2018",6,6,0,226553.833333333,1840.33333333333,134.5
"2768","10050","2018",4,4,0,77375,1330.75,57.25
"2769","10051","2018",7,7,0,163414.285714286,1523.71428571429,108.714285714286
"2770","10052","2018",3,3,0,98166.6666666667,1197.33333333333,78.3333333333333
"2771","10053","2018",3,3,0,181333.333333333,1800.66666666667,100.333333333333
"2772","10054","2018",3,3,0,96833.3333333333,1286.33333333333,76.3333333333333
"2773","10055","2018",2,2,0,81858,750,107
"2774","10057","2018",1,1,0,65000,1512,43
"2775","10058","2018",3,3,0,84766.6666666667,984.666666666667,90.3333333333333
"2776","10060","2018",30,26,4,158692.033333333,1822.5,86.3333333333333
"2777","10061","2018",1,1,0,442000,3226,137
"2778","10062","2018",3,3,0,168903.333333333,1382,121
"2779","10063","2018",6,6,0,52150,613.5,86.6666666666667
"2780","10064","2018",1,1,0,110000,1294,85
"2781","10065","2018",3,3,0,96261.3333333333,967,95.6666666666667
"2782","10066","2018",4,4,0,146000,1168.75,125.5
"2783","10067","2018",22,16,6,170776.590909091,1587.90909090909,109.818181818182
"2784","10069","2018",1,1,0,2e+05,833,240
"2785","10070","2018",6,6,0,91616.6666666667,1180.66666666667,73
"2786","10073","2018",1,1,0,70000,1167,60
"2787","10074","2018",5,5,0,154800,1168.8,134
"2788","10075","2018",1,1,0,85000,773,110
"2789","10076","2018",4,3,1,65750,754.75,94.75
"2790","10077","2018",3,3,0,213166.666666667,1274,166.666666666667
"2791","10079","2018",1,1,0,60000,667,90
"2792","10080","2018",11,11,0,167454.545454545,1231.45454545455,139.545454545455
"2793","10081","2018",94,53,41,112001.595744681,1353.28723404255,81.2553191489362
"2794","10082","2018",1,1,0,170000,1789,95
"2795","10083","2018",3,3,0,118166.666666667,1425,80.3333333333333
"2796","10084","2018",11,11,0,145883.636363636,1372.63636363636,108.818181818182
"2797","10085","2018",1,1,0,35000,389,90
"2798","10089","2018",8,8,0,135487.5,1176.25,114.125
"2799","10090","2018",2,2,0,146750,1353,113.5
"2800","10091","2018",2,2,0,77500,822,95
"2801","10094","2018",1,1,0,16000,400,40
"2802","10095","2018",4,4,0,96012.5,1049,91.5
"2803","10096","2018",10,10,0,133390,1158.3,118.2
"2804","10097","2018",3,3,0,77333.3333333333,720.333333333333,96.3333333333333
"2805","10098","2018",3,3,0,105833.333333333,1104.33333333333,119.666666666667
"2806","10099","2018",7,7,0,106142.857142857,1066.85714285714,101.571428571429
"2807","10100","2018",16,16,0,145966.875,1413.6875,101.5
"2808","10101","2018",2,2,0,90000,731,131
"2809","10102","2018",1,1,0,193490,1152,168
"2810","10103","2018",2,2,0,33500,372,90
"2811","10104","2018",4,4,0,154000,1692.5,91.25
"2812","10107","2018",1,1,0,35500,514,69
"2813","10108","2018",1,1,0,61000,1052,58
"2814","10109","2018",3,3,0,81333.3333333333,947,91.3333333333333
"2815","10110","2018",11,10,1,158545.454545455,1749.90909090909,91.1818181818182
"2816","10111","2018",2,2,0,36500,396.5,91
"2817","10112","2018",2,2,0,55000,614.5,95
"2818","10113","2018",3,3,0,141950,1589,86
"2819","10114","2018",6,6,0,75083.3333333333,959.333333333333,89
"2820","10115","2018",12,11,1,184541.666666667,1921.41666666667,95.5
"2821","10116","2018",3,3,0,125666.666666667,1160,111.666666666667
"2822","10117","2018",2,2,0,52005,652,91.5
"2823","10118","2018",3,3,0,62666.6666666667,797.333333333333,80.3333333333333
"2824","10119","2018",3,3,0,60666.6666666667,537,121
"2825","10120","2018",3,3,0,105400,875.333333333333,117
"2826","10121","2018",3,3,0,95333.3333333333,1013.66666666667,89.6666666666667
"2827","10122","2018",2,2,0,51780,629,83
"2828","10123","2018",12,11,1,139693.333333333,1328.75,101.75
"2829","10124","2018",3,3,0,143000,1395.33333333333,106.333333333333
"2830","10125","2018",5,5,0,227980,1389.8,168.4
"2831","10126","2018",2,2,0,114000,1139.5,102
"2832","10127","2018",1,1,0,130000,1040,125
"2833","10128","2018",2,2,0,91000,1290,74
"2834","10129","2018",3,3,0,119333.333333333,1392.66666666667,86.6666666666667
"2835","10131","2018",4,4,0,142100,1094,134.25
"2836","10132","2018",3,3,0,91666.6666666667,1175.66666666667,73.3333333333333
"2837","10133","2018",7,7,0,139720.428571429,1312.42857142857,123.714285714286
"2838","10135","2018",2,2,0,143000,883.5,162.5
"2839","10139","2018",4,4,0,130950,1199.75,113.25
"2840","10140","2018",6,6,0,59783.3333333333,572.833333333333,102.166666666667
"2841","10141","2018",7,7,0,82530,964,87
"2842","10142","2018",15,15,0,107120,992,106.666666666667
"2843","10143","2018",1,1,0,120000,723,166
"2844","10144","2018",1,1,0,210000,1944,108
"2845","10145","2018",2,2,0,143500,1094,130.5
"2846","10147","2018",1,1,0,127000,1144,111
"2847","10148","2018",3,3,0,1e+05,899,111
"2848","10149","2018",5,5,0,175260,1279.6,155.2
"2849","10150","2018",3,3,0,68883.3333333333,998.666666666667,65
"2850","10151","2018",9,7,2,111644.444444444,1312.66666666667,98
"2851","10153","2018",15,15,0,150534.666666667,1403.06666666667,106.4
"2852","10156","2018",9,8,1,134722.222222222,1390.44444444444,101.111111111111
"2853","10157","2018",1,1,0,130000,1193,109
"2854","10158","2018",4,4,0,117450,1409.5,84.5
"2855","10164","2018",7,7,0,101657.142857143,1195.71428571429,99.1428571428571
"2856","10165","2018",4,4,0,195350,2154.5,104.5
"2857","10166","2018",3,3,0,88333.3333333333,832.333333333333,105.666666666667
"2858","10169","2018",3,3,0,116226.666666667,1672.33333333333,70.6666666666667
"2859","10170","2018",6,6,0,130500,1228.66666666667,124.333333333333
"2860","10171","2018",3,3,0,110333.333333333,954.666666666667,135
"2861","10172","2018",4,4,0,64250,728.5,97.25
"2862","10173","2018",3,3,0,211000,1821.33333333333,114.666666666667
"2863","10175","2018",3,3,0,105000,1229.33333333333,84
"2864","10177","2018",1,1,0,174250,1936,90
"2865","10178","2018",1,1,0,45000,776,58
"2866","10179","2018",5,5,0,282900,2787,128
"2867","10181","2018",3,3,0,111833.333333333,1213,90
"2868","10182","2018",3,3,0,105000,674.666666666667,147
"2869","10184","2018",2,2,0,105000,1242,85
"2870","10185","2018",2,2,0,97500,998,94
"2871","10186","2018",6,6,0,265808.333333333,1934.16666666667,137.5
"2872","10187","2018",5,5,0,117800,953.2,126.2
"2873","10188","2018",4,4,0,139275,1362.25,102
"2874","10190","2018",1,1,0,165000,1650,100
"2875","10191","2018",11,11,0,191027.272727273,1889.09090909091,101.272727272727
"2876","10193","2018",4,4,0,77375,660,115.5
"2877","10196","2018",2,2,0,159500,1314,140.5
"2878","10197","2018",4,4,0,81750,814.25,117.25
"2879","10198","2018",3,3,0,178783.333333333,1394.66666666667,128.666666666667
"2880","10199","2018",4,4,0,128750,1311.5,101.25
"2881","10200","2018",2,2,0,118000,1034,115
"2882","10203","2018",1,1,0,69000,1045,66
"2883","10205","2018",1,1,0,120500,768,157
"2884","10207","2018",1,1,0,97000,808,120
"2885","10208","2018",8,8,0,104000,1541.125,77
"2886","10209","2018",21,20,1,159097.619047619,1480.42857142857,106.619047619048
"2887","10210","2018",3,3,0,176713.333333333,1618.33333333333,105.666666666667
"2888","10211","2018",9,9,0,162272.222222222,1838.33333333333,97.8888888888889
"2889","10212","2018",3,3,0,142333.333333333,1163.33333333333,122.666666666667
"2890","10213","2018",3,3,0,167000,1164.66666666667,138.333333333333
"2891","10214","2018",1,1,0,105000,1364,77
"2892","10215","2018",6,6,0,116952,1022.66666666667,137.5
"2893","10216","2018",6,5,1,98166.6666666667,1153.66666666667,87
"2894","10218","2018",1,1,0,99000,900,110
"2895","10220","2018",11,11,0,131509.090909091,1300.18181818182,98.0909090909091
"2896","10222","2018",8,8,0,79000,779.5,105.875
"2897","10223","2018",5,5,0,158900,1342.2,119.4
"2898","10224","2018",17,17,0,130067.705882353,1155.94117647059,114.294117647059
"2899","10225","2018",7,7,0,86714.2857142857,899.285714285714,95.2857142857143
"2900","10226","2018",1,1,0,113000,1097,103
"2901","10227","2018",3,3,0,102333.333333333,1081,94
"2902","10228","2018",4,4,0,46250,535.5,86.75
"2903","10229","2018",1,1,0,85000,1076,79
"2904","10230","2018",7,7,0,177142.857142857,1631,118.285714285714
"2905","10231","2018",6,6,0,140333.333333333,1720.33333333333,82.1666666666667
"2906","10232","2018",5,5,0,100400,1195.4,86.2
"2907","10233","2018",17,16,1,117794.117647059,1303.76470588235,91.0588235294118
"2908","10234","2018",1,1,0,35000,486,72
"2909","10236","2018",1,1,0,98000,852,115
"2910","10237","2018",5,5,0,134100,1150.8,124.2
"2911","10238","2018",7,7,0,138242.857142857,1846.42857142857,84.4285714285714
"2912","10239","2018",2,2,0,132500,1183.5,109.5
"2913","10240","2018",8,8,0,205733.75,1439.75,141.375
"2914","10241","2018",1,1,0,87000,888,98
"2915","10242","2018",2,2,0,85500,927,97
"2916","10243","2018",2,2,0,151250,1157.5,132
"2917","10245","2018",5,4,1,131230,1262.4,95.8
"2918","10246","2018",1,1,0,215000,1075,200
"2919","10247","2018",3,3,0,131666.666666667,792,157
"2920","10248","2018",1,1,0,293145,2506,117
"2921","10249","2018",6,6,0,157416.666666667,1267.33333333333,124.333333333333
"2922","10251","2018",7,7,0,106892.857142857,883.571428571429,125.428571428571
"2923","10253","2018",1,1,0,165500,784,211
"2924","10254","2018",2,2,0,141000,707,175
"2925","10255","2018",3,3,0,168333.333333333,1140.33333333333,151.666666666667
"2926","10256","2018",4,4,0,114250,1258.25,89.5
"2927","10257","2018",3,3,0,145330,1154.66666666667,129.666666666667
"2928","10258","2018",5,5,0,80000,873,88
"2929","10259","2018",4,4,0,119750,1103.25,108
"2930","10260","2018",6,6,0,176416.666666667,1895.83333333333,93.8333333333333
"2931","10261","2018",7,7,0,89714.2857142857,964.285714285714,102.571428571429
"2932","10262","2018",5,5,0,137400,1222.6,119.2
"2933","10263","2018",9,9,0,100122.222222222,1175.66666666667,85.5555555555556
"2934","10265","2018",17,16,1,154746.470588235,1912.29411764706,83.3529411764706
"2935","10267","2018",6,6,0,91816.6666666667,857.666666666667,114.333333333333
"2936","10268","2018",67,61,6,143869.552238806,1613.5671641791,89.4477611940299
"2937","10270","2018",2,2,0,167500,1098.5,149.5
"2938","10271","2018",8,8,0,106398.75,1033.5,107
"2939","10272","2018",3,3,0,147500,1290.66666666667,119.333333333333
"2940","10274","2018",1,1,0,150000,1240,121
"2941","10275","2018",4,4,0,130000,1097.75,126.25
"2942","10276","2018",9,9,0,100055.555555556,1089.44444444444,99.6666666666667
"2943","10278","2018",1,1,0,120000,1379,87
"2944","10279","2018",1,1,0,81559,868,94
"2945","10280","2018",3,3,0,103333.333333333,1449.66666666667,74.3333333333333
"2946","10281","2018",3,3,0,163666.666666667,1079.66666666667,166.666666666667
"2947","10282","2018",16,15,1,190725,1861.8125,105.3125
"2948","10286","2018",1,1,0,188000,1288,146
"2949","10287","2018",12,12,0,135711.25,1151.83333333333,121.083333333333
"2950","10288","2018",3,3,0,65000,879,79.6666666666667
"2951","10289","2018",10,10,0,100350,1069.2,95.8
"2952","10290","2018",8,8,0,111875,1032.25,111
"2953","10293","2018",3,3,0,135000,1521.66666666667,88.6666666666667
"2954","10295","2018",1,1,0,80000,1143,70
"2955","10297","2018",43,36,7,154204.558139535,1849.67441860465,84.8372093023256
"2956","10299","2018",3,3,0,64000,803.333333333333,84.3333333333333
"2957","10300","2018",3,3,0,111000,738.666666666667,148
"2958","10301","2018",5,5,0,109000,1142,104.2
"2959","10302","2018",1,1,0,160000,1067,150
"2960","10304","2018",4,4,0,129800,1083.5,126
"2961","10305","2018",1,1,0,100950,1216,83
"2962","10306","2018",6,6,0,90923.3333333333,1156.83333333333,98.3333333333333
"2963","10307","2018",10,10,0,161929,1738.7,94.7
"2964","10308","2018",1,1,0,75000,743,101
"2965","10309","2018",1,1,0,40000,816,49
"2966","10310","2018",3,3,0,122000,1011.66666666667,115
"2967","10312","2018",3,3,0,109666.666666667,1096,98.6666666666667
"2968","10313","2018",2,2,0,84500,769.5,108.5
"2969","10314","2018",7,7,0,99528.5714285714,867.428571428571,116
"2970","10316","2018",1,1,0,90000,978,92
"2971","10317","2018",15,15,0,121400,1033.66666666667,106.666666666667
"2972","10318","2018",5,5,0,82550,948.2,86
"2973","10319","2018",6,6,0,71750,806,91.6666666666667
"2974","10320","2018",3,3,0,126386.666666667,1192.66666666667,109.333333333333
"2975","10321","2018",38,38,0,224034.157894737,1820.76315789474,124.289473684211
"2976","10323","2018",171,151,20,81311.0526315789,1043.6783625731,78.8421052631579
"2977","10324","2018",3,3,0,198666.666666667,2155,92.6666666666667
"2978","10325","2018",33,31,2,182206.060606061,1805.06060606061,104.969696969697
"2979","10326","2018",1,1,0,180000,2609,69
"2980","10327","2018",3,3,0,66750.3333333333,1443.66666666667,46.6666666666667
"2981","10328","2018",3,3,0,114500,953.666666666667,129.333333333333
"2982","10329","2018",4,4,0,172250,1743.25,115.25
"2983","10331","2018",8,8,0,125704.375,1299.125,127.75
"2984","10332","2018",2,2,0,187500,1964,95.5
"2985","10333","2018",187,88,99,121973.77540107,1558.99465240642,78.8877005347594
"2986","10334","2018",7,7,0,140571.428571429,1372.57142857143,101.571428571429
"2987","10336","2018",4,4,0,133000,1424.25,90.25
"2988","10337","2018",1,1,0,178900,1118,160
"2989","10338","2018",1,1,0,184750,1680,110
"2990","10339","2018",2,2,0,118500,1931.5,61
"2991","10340","2018",25,24,1,178589.6,1718.64,105.08
"2992","10341","2018",4,4,0,94225,972.25,96.5
"2993","10342","2018",3,3,0,128427,1240.33333333333,107.333333333333
"2994","10343","2018",91,56,35,148517,1644.92307692308,89.6373626373626
"2995","10344","2018",11,11,0,181880.454545455,1605.27272727273,115.636363636364
"2996","10345","2018",2,2,0,107000,1088.5,97.5
"2997","10348","2018",1,1,0,190000,1284,148
"2998","10349","2018",33,33,0,156633.333333333,1610.48484848485,97.2727272727273
"2999","10350","2018",13,13,0,103453.384615385,1134.61538461538,100.769230769231
"3000","10351","2018",5,5,0,98400,1048.6,99.2
"3001","10352","2018",19,19,0,164533.684210526,1489.31578947368,113.052631578947
"3002","10353","2018",13,13,0,140323.076923077,1591.30769230769,87.6923076923077
"3003","10354","2018",2,2,0,40500,409,99
"3004","10355","2018",2,2,0,119500,928.5,129
"3005","10356","2018",1,1,0,90000,1385,65
"3006","10357","2018",35,32,3,167131.428571429,1610.2,107.714285714286
"3007","10358","2018",1,1,0,29000,1812,16
"3008","10359","2018",5,5,0,69117,950.6,83.6
"3009","10360","2018",4,4,0,175375,1617.75,110.25
"3010","10361","2018",4,4,0,198000,1640.25,121.75
"3011","10362","2018",217,95,122,113710.714285714,1710.17050691244,66.9861751152074
"3012","10364","2018",1,1,0,62000,525,118
"3013","10365","2018",2,2,0,55000,784,73.5
"3014","10367","2018",11,11,0,126627.272727273,1495.27272727273,86.0909090909091
"3015","10368","2018",9,8,1,127111.222222222,1333.22222222222,99.8888888888889
"3016","10369","2018",3,3,0,102333.333333333,886.333333333333,121.666666666667
"3017","10370","2018",4,4,0,115950,1105.5,100.75
"3018","10371","2018",2,2,0,157500,1533,111.5
"3019","10372","2018",4,4,0,74500,789,89.25
"3020","10373","2018",4,4,0,134000,1674.25,82.5
"3021","10374","2018",3,3,0,95950,990,107.333333333333
"3022","10375","2018",6,6,0,165550,1497.83333333333,112
"3023","10376","2018",2,2,0,96500,970,101
"3024","10377","2018",1,1,0,32000,340,94
"3025","10378","2018",1,1,0,18000,486,37
"3026","10379","2018",4,4,0,112000,1232.25,92
"3027","10381","2018",8,8,0,282112.5,1808.5,155.25
"3028","10382","2018",16,16,0,123131.25,1267.125,99.8125
"3029","10383","2018",5,5,0,140200,925,158.8
"3030","10384","2018",1,1,0,238000,1013,235
"3031","10386","2018",3,3,0,39833.3333333333,751,63.6666666666667
"3032","10387","2018",967,199,768,104003.847983454,1502.32161323681,69.8304033092037
"3033","10389","2018",1,1,0,25000,417,60
"3034","10390","2018",1,1,0,40000,465,86
"3035","10391","2018",2,2,0,206500,1879,111
"3036","10392","2018",4,4,0,110250,1417.75,76.75
"3037","10393","2018",3,3,0,120516.666666667,1039.66666666667,118
"3038","10394","2018",1,1,0,195000,965,202
"3039","10395","2018",1,1,0,92000,1704,54
"3040","10396","2018",4,4,0,153300,1581.5,97
"3041","10397","2018",3,3,0,79333.3333333333,1080,70.6666666666667
"3042","10399","2018",8,8,0,141571.875,1405.75,100.125
"3043","10400","2018",1,1,0,188000,1253,150
"3044","10401","2018",18,17,1,103386.111111111,992.777777777778,103.222222222222
"3045","10402","2018",4,4,0,192537.5,1392,130.25
"3046","10403","2018",2,2,0,32750,431,76
"3047","10404","2018",1,1,0,83000,806,103
"3048","10405","2018",1,1,0,136000,1447,94
"3049","10406","2018",15,15,0,174338.933333333,1766.13333333333,99.1333333333333
"3050","10408","2018",1,1,0,65000,903,72
"3051","10409","2018",6,6,0,145500,1397.5,103.166666666667
"3052","10412","2018",8,8,0,228475,1734.125,124
"3053","10414","2018",1,1,0,49000,1043,47
"3054","10416","2018",1,1,0,190000,2021,94
"3055","10417","2018",2,2,0,68500,542.5,120
"3056","10418","2018",2,2,0,170750,1120,137
"3057","10419","2018",2,2,0,121000,1555.5,78.5
"3058","10420","2018",28,25,3,123357.142857143,1267.64285714286,99.25
"3059","10422","2018",2,2,0,77500,608.5,135.5
"3060","10423","2018",4,4,0,98375,1099.75,91
"3061","10424","2018",1,1,0,55000,705,78
"3062","10425","2018",5,5,0,158300,1448.6,112
"3063","10426","2018",5,5,0,76510,917.8,89.4
"3064","10429","2018",2,2,0,123750,1202,102
"3065","10430","2018",1,1,0,160000,1333,120
"3066","10433","2018",2,2,0,102500,884,114
"3067","10434","2018",1,1,0,185000,1457,127
"3068","10435","2018",3,3,0,128466.666666667,1122,117
"3069","10436","2018",2,2,0,168100,1522.5,110
"3070","10437","2018",8,8,0,111476,1154.625,95.625
"3071","10439","2018",1,1,0,104000,717,145
"3072","10440","2018",2,2,0,105000,990,146
"3073","10441","2018",3,3,0,59666.6666666667,715.666666666667,78.3333333333333
"3074","10442","2018",7,7,0,140920.142857143,1225.42857142857,121
"3075","10443","2018",1,1,0,83000,748,111
"3076","10444","2018",6,6,0,57883.3333333333,640.5,97.6666666666667
"3077","11001","2018",4,4,0,156152.5,1263.75,123.5
"3078","11002","2018",4,4,0,133700,1123.75,129.5
"3079","11003","2018",2,2,0,86765,691,125.5
"3080","11004","2018",5,5,0,189460,1839,106.2
"3081","11005","2018",13,13,0,143106.307692308,1419.69230769231,97.5384615384615
"3082","11006","2018",1,1,0,94000,1343,70
"3083","11007","2018",2,2,0,53000,659.5,88.5
"3084","11008","2018",6,6,0,113662.5,1042.33333333333,100.333333333333
"3085","11009","2018",17,16,1,95807.9411764706,1078.88235294118,90.3529411764706
"3086","11010","2018",3,3,0,166666.666666667,1621.33333333333,113.333333333333
"3087","11011","2018",3,3,0,93866.6666666667,1147,92.6666666666667
"3088","11012","2018",41,41,0,173240.951219512,1729,98.1463414634146
"3089","11013","2018",3,3,0,221333.333333333,1844.33333333333,113
"3090","11014","2018",13,13,0,221824.615384615,2260.46153846154,96.9230769230769
"3091","11015","2018",4,4,0,95669.75,1069.5,80.25
"3092","11016","2018",1,1,0,99000,1100,90
"3093","11017","2018",1,1,0,220000,2115,104
"3094","11018","2018",18,18,0,152325.555555556,1517.27777777778,97.1111111111111
"3095","11019","2018",1,1,0,47000,448,105
"3096","11021","2018",3,3,0,54000,693.666666666667,87
"3097","11022","2018",21,20,1,102292.571428571,1179.85714285714,87
"3098","11023","2018",11,10,1,131530,1270.27272727273,99.9090909090909
"3099","11024","2018",10,10,0,215457.8,2122.1,103.4
"3100","11025","2018",4,4,0,145920.75,1492.25,98.5
"3101","11026","2018",2,2,0,147450,1930,78.5
"3102","11027","2018",12,12,0,137553.916666667,1294.58333333333,111.583333333333
"3103","11028","2018",9,9,0,84660,977.777777777778,90.6666666666667
"3104","11029","2018",1,1,0,58000,879,66
"3105","11031","2018",1,1,0,120000,1395,86
"3106","11032","2018",7,7,0,166142.857142857,1355,115.857142857143
"3107","11033","2018",13,13,0,115386.153846154,1201.15384615385,99.9230769230769
"3108","11034","2018",7,7,0,113634.285714286,1327.71428571429,98.1428571428571
"3109","11035","2018",3,3,0,62333.3333333333,1127,58
"3110","11036","2018",4,4,0,42000,558.75,90.25
"3111","11037","2018",17,6,11,64338.2352941177,954.529411764706,62.0588235294118
"3112","11038","2018",4,4,0,48000,719.75,63.5
"3113","11040","2018",27,26,1,158434.259259259,1793.07407407407,86.9259259259259
"3114","11041","2018",27,27,0,144043.703703704,1575.66666666667,102.925925925926
"3115","11042","2018",5,5,0,75600,919.2,80.8
"3116","11043","2018",1,1,0,255000,2277,112
"3117","11045","2018",4,4,0,107000,1221.25,99.25
"3118","11046","2018",1,1,0,254000,2540,100
"3119","11047","2018",1,1,0,58700,652,90
"3120","11048","2018",6,6,0,141000,1129.33333333333,127.666666666667
"3121","11049","2018",33,30,3,137375.212121212,1407.33333333333,97.3636363636364
"3122","11051","2018",1,1,0,36000,480,75
"3123","11052","2018",6,6,0,133250,1392,102.666666666667
"3124","11053","2018",3,3,0,327000,2632.33333333333,125
"3125","11054","2018",6,6,0,150786.666666667,1398.33333333333,101.5
"3126","11055","2018",1,1,0,153000,1234,124
"3127","11056","2018",4,4,0,100625,812.25,115
"3128","11058","2018",4,4,0,221531.25,1920,122.5
"3129","11059","2018",3,3,0,209400,1517.66666666667,128.666666666667
"3130","11061","2018",9,9,0,183012.222222222,1479.11111111111,122.666666666667
"3131","11063","2018",6,6,0,134166.666666667,1591.66666666667,87.5
"3132","11064","2018",9,9,0,116668.333333333,1410,77.5555555555556
"3133","11065","2018",2,2,0,58250,937.5,57.5
"3134","11066","2018",10,10,0,86008.5,1170.3,78.2
"3135","11067","2018",27,26,1,160828.37037037,1706.25925925926,93.4814814814815
"3136","11068","2018",16,15,1,87591.25,1073.0625,78
"3137","11069","2018",740,448,292,108619.008108108,1261.37702702703,83.827027027027
"3138","11070","2018",4,4,0,130000,1259.75,94.75
"3139","11071","2018",4,4,0,86887.5,649.75,122.5
"3140","11072","2018",2,2,0,68000,890.5,76.5
"3141","11074","2018",4,4,0,275800,1759,165.25
"3142","11075","2018",6,6,0,94666.6666666667,1596.66666666667,76.1666666666667
"3143","11076","2018",111,90,21,121974.225225225,1431.32432432432,88.1801801801802
"3144","11077","2018",5,5,0,131800,1488.6,95.6
"3145","11078","2018",2,2,0,103500,1021,103.5
"3146","11079","2018",2,2,0,163500,1405,116
"3147","11080","2018",4,4,0,142500,1548,95.5
"3148","11081","2018",28,27,1,134708.928571429,1108.14285714286,118.428571428571
"3149","11084","2018",10,10,0,184610,1662.8,108.4
"3150","11085","2018",13,13,0,142052.615384615,1476.15384615385,98.7692307692308
"3151","11086","2018",15,15,0,166586.666666667,1771.4,91.2666666666667
"3152","11087","2018",1,1,0,105000,938,112
"3153","11088","2018",16,16,0,147423.6875,1600.6875,92
"3154","11089","2018",3,3,0,35906.6666666667,731.666666666667,52.6666666666667
"3155","11090","2018",2,2,0,55000,610,87.5
"3156","11091","2018",24,23,1,95229.1666666667,974.708333333333,105.708333333333
"3157","11092","2018",2,2,0,57500,669,93.5
"3158","11093","2018",1,1,0,34000,523,65
"3159","11095","2018",6,6,0,148166.666666667,1310,112.333333333333
"3160","11096","2018",4,4,0,47611,794,58.5
"3161","11098","2018",13,13,0,172307.307692308,1440.53846153846,109.846153846154
"3162","11099","2018",42,41,1,115576.666666667,1286.02380952381,92.4761904761905
"3163","11102","2018",6,6,0,235500,1624,133.333333333333
"3164","11103","2018",12,12,0,101595.833333333,1115,88.9166666666667
"3165","11104","2018",1,1,0,140000,1818,77
"3166","11105","2018",16,16,0,144162.5625,1439.125,98.4375
"3167","11106","2018",86,71,15,140384.011627907,1499.66279069767,93.8837209302326
"3168","11107","2018",1,1,0,64185,879,73
"3169","11108","2018",1,1,0,1e+05,1429,70
"3170","11109","2018",2,2,0,61000,824,74.5
"3171","11110","2018",3,3,0,163316.666666667,1646,99.3333333333333
"3172","11111","2018",13,13,0,174464.846153846,1691.84615384615,104.230769230769
"3173","11113","2018",4,4,0,95000,1524.25,56.75
"3174","11115","2018",6,6,0,113075,1220.5,101.666666666667
"3175","11116","2018",64,61,3,176623.359375,1727.03125,100.375
"3176","11118","2018",4,4,0,90600,1169.25,83.25
"3177","11119","2018",3,3,0,158350,1166.33333333333,112.333333333333
"3178","11120","2018",6,6,0,100866.666666667,1163.83333333333,100.333333333333
"3179","11121","2018",1,1,0,72000,480,150
"3180","11122","2018",14,14,0,89014.6428571429,876.285714285714,98.5714285714286
"3181","11124","2018",7,7,0,97988.5714285714,1206.71428571429,87.8571428571429
"3182","11125","2018",4,4,0,123843,1414,90.25
"3183","11126","2018",6,6,0,96833.3333333333,1055.5,86.5
"3184","11127","2018",3,3,0,52800,725.333333333333,72.6666666666667
"3185","11128","2018",3,3,0,109466.666666667,1636,74
"3186","11129","2018",36,36,0,96647.7777777778,1009.72222222222,103.805555555556
"3187","11130","2018",3,3,0,126000,992,124
"3188","11131","2018",12,12,0,101671.666666667,1009,99.5
"3189","11132","2018",22,22,0,184362.363636364,1662.59090909091,101.318181818182
"3190","11133","2018",2,2,0,1e+05,1835.5,67.5
"3191","11135","2018",2,2,0,43500,468,93
"3192","11136","2018",7,7,0,137835.714285714,1042.57142857143,133.571428571429
"3193","11137","2018",2,2,0,108750,1158,92
"3194","11138","2018",8,8,0,133552.125,1398.5,97
"3195","11139","2018",2,2,0,65750,728,90
"3196","11140","2018",17,16,1,134329.647058824,1412.52941176471,99.8235294117647
"3197","11141","2018",3,3,0,182333.333333333,1025.33333333333,133.333333333333
"3198","11142","2018",4,4,0,75875,698.75,113
"3199","11144","2018",45,33,12,150640.933333333,1832.88888888889,81.8666666666667
"3200","11145","2018",272,172,100,119329.433823529,2708.80147058824,48.8602941176471
"3201","11146","2018",7,7,0,95257.1428571429,1018.28571428571,97
"3202","11148","2018",9,9,0,160466.666666667,1183,130
"3203","11150","2018",11,11,0,131310.909090909,1383.36363636364,96.2727272727273
"3204","11151","2018",3,3,0,87724.6666666667,959,90.6666666666667
"3205","11152","2018",4,4,0,121984.75,1629.75,77
"3206","11153","2018",5,5,0,214713,1808.8,119
"3207","11154","2018",2,2,0,39150,656,71
"3208","11156","2018",2,2,0,149000,1598,95
"3209","11157","2018",3,3,0,120466.666666667,1329.66666666667,87.6666666666667
"3210","11158","2018",4,4,0,211250,2092,101
"3211","11159","2018",3,3,0,136000,1483.33333333333,90
"3212","11160","2018",1,1,0,20000,417,48
"3213","11164","2018",26,26,0,178057.692307692,1690.76923076923,103.615384615385
"3214","11165","2018",6,6,0,155166.666666667,1402,112.166666666667
"3215","11168","2018",1,1,0,273600,1159,236
"3216","11169","2018",1,1,0,2e+05,1379,145
"3217","11170","2018",390,143,247,117985.246153846,2964.11538461538,39.9589743589744
"3218","11172","2018",2,2,0,133775,1709,75
"3219","11173","2018",2,2,0,208125,1424,128
"3220","11174","2018",2,2,0,73000,687.5,125
"3221","11175","2018",7,7,0,162614.285714286,1163.42857142857,140.571428571429
"3222","11176","2018",1,1,0,28000,389,72
"3223","11178","2018",14,14,0,150130.071428571,1461.5,102.857142857143
"3224","11179","2018",1,1,0,19000,365,52
"3225","11180","2018",1,1,0,30000,556,54
"3226","11181","2018",3,3,0,98766.6666666667,1225,76.3333333333333
"3227","11182","2018",3,3,0,106333.333333333,1055,92.6666666666667
"3228","11183","2018",3,3,0,229000,1440.33333333333,170.333333333333
"3229","11184","2018",1,1,0,2e+05,2667,75
"3230","11185","2018",13,11,2,156578.461538462,1974.84615384615,83.3846153846154
"3231","11187","2018",3,3,0,140633.333333333,1562.33333333333,93.6666666666667
"3232","11188","2018",31,31,0,197958.451612903,1862.45161290323,108.612903225806
"3233","11189","2018",6,6,0,85583.3333333333,1337.33333333333,61.8333333333333
"3234","11190","2018",20,19,1,149527.25,1436.2,104
"3235","11191","2018",3,2,1,111333.333333333,958.666666666667,110
"3236","11192","2018",4,4,0,122625,1140.25,113.75
"3237","11193","2018",3,3,0,217033.333333333,1831.33333333333,119
"3238","11194","2018",1,1,0,77000,1100,70
"3239","11195","2018",3,3,0,230666.666666667,1189.66666666667,209
"3240","11196","2018",2,2,0,32500,890,45
"3241","11197","2018",7,7,0,176862,1437.85714285714,123.142857142857
"3242","11198","2018",17,17,0,105032.352941176,1079.05882352941,101.411764705882
"3243","11199","2018",24,24,0,158973.333333333,1550.33333333333,104.708333333333
"3244","11200","2018",3,3,0,67483.3333333333,1083,60.6666666666667
"3245","11201","2018",7,7,0,115571.428571429,1056,96.2857142857143
"3246","11202","2018",487,207,280,98325.7433264887,2680.55030800821,36.917864476386
"3247","11203","2018",142,129,13,135459.35915493,1478.94366197183,94.4225352112676
"3248","11205","2018",2,2,0,198275,2793,74.5
"3249","11206","2018",132,106,26,110939.825757576,1243.93181818182,88.7878787878788
"3250","11207","2018",3,3,0,221666.333333333,1283.66666666667,173
"3251","11208","2018",1,1,0,237830,915,260
"3252","11209","2018",3,3,0,128791.333333333,1131.66666666667,100.333333333333
"3253","11210","2018",20,20,0,157424.75,1520.2,106.7
"3254","11211","2018",6,6,0,130050,1329.5,91.1666666666667
"3255","11212","2018",7,7,0,148052.857142857,1830.14285714286,82.2857142857143
"3256","11213","2018",2,2,0,143773,1619,87
"3257","11214","2018",7,7,0,177458.571428571,1445.28571428571,123.714285714286
"3258","11215","2018",12,12,0,160021.25,1457.66666666667,104
"3259","11216","2018",5,5,0,149800,1480.6,103.2
"3260","11217","2018",19,18,1,184817.368421053,1821.52631578947,100.894736842105
"3261","11218","2018",2,2,0,395925,2248,196.5
"3262","11220","2018",13,11,2,101149.769230769,1202.38461538462,85.6153846153846
"3263","11221","2018",6,6,0,106666.666666667,1049.66666666667,95.6666666666667
"3264","11222","2018",1,1,0,35000,500,70
"3265","11225","2018",7,7,0,137530,1362,128
"3266","11226","2018",2,1,1,83500,834,108
"3267","11228","2018",1,1,0,125000,714,175
"3268","11229","2018",1,1,0,37000,462,80
"3269","11230","2018",1,1,0,90000,1000,90
"3270","11231","2018",1,1,0,250000,1404,178
"3271","11232","2018",2,2,0,127500,1048.5,111
"3272","11233","2018",11,11,0,151980.909090909,1600,95.7272727272727
"3273","11234","2018",1,1,0,210000,1400,150
"3274","11235","2018",1,1,0,40000,625,64
"3275","11236","2018",7,7,0,127786.714285714,1617.14285714286,85.1428571428571
"3276","11238","2018",1,1,0,94000,913,103
"3277","11240","2018",5,5,0,127000,1276.6,100
"3278","11241","2018",10,9,1,149604,1396.4,111.8
"3279","11242","2018",2,2,0,119450,1088.5,109.5
"3280","11243","2018",8,8,0,212411.25,2433.625,94.375
"3281","11244","2018",3,3,0,47533.3333333333,650,73.3333333333333
"3282","11245","2018",2,2,0,93450,856.5,105
"3283","11246","2018",2,2,0,88500,833.5,106
"3284","11247","2018",1,1,0,231108,4532,51
"3285","11248","2018",3,3,0,150836.666666667,1466.66666666667,95.6666666666667
"3286","11249","2018",1,1,0,370000,5362,69
"3287","11250","2018",2,2,0,125825,1850.5,63.5
"3288","11251","2018",11,11,0,69445.4545454545,714,110.545454545455
"3289","11252","2018",8,5,3,152284.75,1210.375,127.125
"3290","11253","2018",18,18,0,176380.555555556,1725.94444444444,103.333333333333
"3291","11254","2018",24,24,0,123191.25,1305.70833333333,93.7916666666667
"3292","11255","2018",16,16,0,198656.25,2006.4375,98.0625
"3293","11256","2018",15,15,0,216859.4,1969.8,125.466666666667
"3294","11257","2018",1,1,0,137000,1734,79
"3295","11258","2018",30,29,1,169873.666666667,1720.5,100.9
"3296","11259","2018",13,13,0,136170.769230769,1534.69230769231,88.6153846153846
"3297","11260","2018",2,2,0,177000,1454,145
"3298","11261","2018",11,11,0,140640.909090909,1428.63636363636,104.545454545455
"3299","11262","2018",1031,436,595,144243.679922405,2076.98254122211,70.6343355965083
"3300","11263","2018",4,4,0,110100,1407.75,81.25
"3301","11264","2018",14,10,4,172894.642857143,1800.07142857143,98.9285714285714
"3302","11265","2018",3,2,1,48333.3333333333,452.666666666667,103
"3303","11266","2018",204,97,107,109336.509803922,2254.91176470588,50.5588235294118
"3304","11267","2018",12,10,2,130595.833333333,1533.75,92
"3305","11269","2018",53,51,2,122548.603773585,1304.90566037736,96.4716981132076
"3306","11270","2018",3,3,0,76376.6666666667,935.666666666667,75
"3307","11271","2018",2,2,0,234212.5,1963,124
"3308","11272","2018",40,40,0,218252.5,1875.3,114.55
"3309","11273","2018",12,11,1,145695.833333333,1621.25,94.1666666666667
"3310","11274","2018",6,6,0,177666.666666667,1429.5,117.166666666667
"3311","11275","2018",1,1,0,70000,593,118
"3312","11276","2018",9,9,0,68963.3333333333,761.111111111111,94.5555555555556
"3313","11277","2018",1,1,0,424000,1643,258
"3314","11278","2018",6,6,0,130116.666666667,1312.66666666667,105.666666666667
"3315","11279","2018",25,25,0,120042,1373.08,87.2
"3316","11280","2018",13,13,0,128388.461538462,1143.69230769231,121.615384615385
"3317","11281","2018",11,11,0,113732.727272727,1036.81818181818,109.181818181818
"3318","11284","2018",5,5,0,156644,1633.8,97
"3319","11285","2018",18,16,2,205361.111111111,2024.88888888889,105.388888888889
"3320","11286","2018",9,9,0,85554.4444444444,958,96.1111111111111
"3321","11287","2018",1,1,0,90805,1009,90
"3322","11288","2018",20,20,0,123785.55,1416.6,85.9
"3323","11289","2018",18,18,0,118863.222222222,1288.44444444444,86.7222222222222
"3324","11290","2018",1,1,0,145000,929,156
"3325","11291","2018",2,2,0,171625,1896.5,90.5
"3326","11292","2018",3,3,0,125211.666666667,1196.66666666667,90.3333333333333
"3327","11293","2018",12,12,0,174366.666666667,1596.08333333333,105.916666666667
"3328","11295","2018",16,14,2,131395.0625,1370.3125,97.8125
"3329","11296","2018",15,15,0,142521.333333333,1842.66666666667,75.8666666666667
"3330","11297","2018",4,4,0,56455,1207.25,47.25
"3331","11299","2018",5,5,0,213427.4,1680,122.4
"3332","11300","2018",6,6,0,119833.333333333,1198.16666666667,102.666666666667
"3333","11301","2018",12,12,0,104155.833333333,1204.83333333333,83.9166666666667
"3334","11302","2018",9,9,0,107717.777777778,944.555555555556,106
"3335","11303","2018",10,10,0,133880,1011.5,121.6
"3336","11304","2018",58,53,5,97305,1135.91379310345,88.4655172413793
"3337","11306","2018",1,1,0,79000,1097,72
"3338","11307","2018",7,7,0,92557.8571428571,1087,99.5714285714286
"3339","11308","2018",8,8,0,151937.5,1619.25,94.625
"3340","11309","2018",2,2,0,184072.5,2270.5,76
"3341","11310","2018",8,5,3,120036.875,1677.375,64.625
"3342","11311","2018",2,2,0,82500,993,96
"3343","11312","2018",1,1,0,25000,417,60
"3344","11313","2018",4,4,0,161000,1357.5,132.75
"3345","11314","2018",2,2,0,69000,1047.5,70
"3346","11315","2018",29,29,0,96055.1724137931,1092.68965517241,93.0689655172414
"3347","11316","2018",2,2,0,66000,706,85
"3348","11317","2018",2,2,0,121000,794,152.5
"3349","11318","2018",6,6,0,204481.166666667,1844.5,112.666666666667
"3350","11319","2018",1,1,0,102000,756,135
"3351","11320","2018",4,4,0,101115,1139,85.75
"3352","11321","2018",5,5,0,53400,945.6,62.2
"3353","11322","2018",20,20,0,181634.5,1711.1,104.8
"3354","11323","2018",6,6,0,220380,1772.33333333333,120.333333333333
"3355","11324","2018",7,7,0,175007.142857143,1868.57142857143,95.7142857142857
"3356","11325","2018",2,2,0,272500,2313.5,129.5
"3357","11326","2018",4,4,0,116925,2085.75,82.75
"3358","11327","2018",7,7,0,146642.857142857,1650.28571428571,98.4285714285714
"3359","11328","2018",6,6,0,196075,1290.16666666667,153.333333333333
"3360","11330","2018",5,5,0,190420,1554.4,112.4
"3361","11332","2018",23,23,0,148561.086956522,1619.30434782609,89
"3362","11333","2018",1,1,0,125000,2273,55
"3363","11334","2018",2,2,0,212850,1810,116.5
"3364","11335","2018",3,3,0,53200,678,72.3333333333333
"3365","11336","2018",7,7,0,116217.142857143,916.714285714286,132
"3366","11337","2018",8,8,0,117926.25,1014.625,120.625
"3367","11338","2018",1,1,0,120000,1000,120
"3368","11339","2018",7,7,0,125451.428571429,1212.85714285714,115
"3369","11340","2018",5,5,0,131560.8,1141.4,110.8
"3370","11341","2018",1,1,0,210000,1257,167
"3371","11342","2018",1,1,0,44000,564,78
"3372","11344","2018",12,12,0,105450.833333333,968.25,114.666666666667
"3373","11345","2018",7,6,1,68955.7142857143,810.857142857143,92.4285714285714
"3374","11347","2018",2,2,0,57000,651,87.5
"3375","11351","2018",14,14,0,103683.357142857,1174.92857142857,92.6428571428571
"3376","11352","2018",2,2,0,61500,733,82
"3377","11353","2018",42,42,0,183575.476190476,1773.7619047619,105.428571428571
"3378","11355","2018",3,3,0,151133.333333333,1524.33333333333,95
"3379","11356","2018",9,9,0,141943.444444444,1505,95
"3380","11357","2018",4,4,0,121562.5,974.75,128.75
"3381","11358","2018",1,1,0,85000,885,96
"3382","11359","2018",7,7,0,256953.142857143,2179,124.142857142857
"3383","11360","2018",29,29,0,178280.724137931,1807.44827586207,100.48275862069
"3384","11361","2018",11,11,0,181950,1606.18181818182,113.454545454545
"3385","11362","2018",3,3,0,188380,1727,98.3333333333333
"3386","11363","2018",3,3,0,213783.333333333,1454,150.666666666667
"3387","11364","2018",2,2,0,196000,1988,99
"3388","11366","2018",10,10,0,125359.6,1253,106.4
"3389","11367","2018",16,16,0,99675,1314.3125,87.75
"3390","11368","2018",1,1,0,33000,440,75
"3391","11369","2018",50,48,2,160837.94,1723.3,95.82
"3392","11370","2018",50,48,2,190973.64,1997.54,98.54
"3393","11371","2018",14,14,0,154813.571428571,1501.21428571429,102.5
"3394","11372","2018",4,4,0,71750,1040.75,68.75
"3395","11373","2018",1,1,0,48500,630,77
"3396","11375","2018",1,1,0,80000,800,100
"3397","11376","2018",4,4,0,97055,1173.75,88.75
"3398","11377","2018",1,1,0,81000,540,150
"3399","11378","2018",2,2,0,124887.5,805.5,170.5
"3400","11379","2018",77,72,5,170510.38961039,1737.63636363636,104.350649350649
"3401","11380","2018",1,1,0,235000,1291,182
"3402","11381","2018",1,1,0,35000,1207,29
"3403","11382","2018",5,5,0,146401,1146,123.2
"3404","11383","2018",2,2,0,188500,1551,122
"3405","11384","2018",1,1,0,20000,444,45
"3406","11385","2018",2,2,0,300525,2366.5,124
"3407","11386","2018",10,10,0,117300,1318.1,93
"3408","11387","2018",1,1,0,66000,733,90
"3409","11388","2018",1,1,0,80000,952,84
"3410","11390","2018",8,8,0,127377.5,1203.5,117.125
"3411","11392","2018",6,6,0,180890,1705.5,119
"3412","11393","2018",2,2,0,182500,1706.5,87.5
"3413","11394","2018",2,2,0,133000,1312.5,94.5
"3414","11396","2018",10,10,0,129735,1236.3,101.9
"3415","11397","2018",61,54,7,112059.213114754,1209.2131147541,88.7540983606557
"3416","11398","2018",5,4,1,121880,1512.2,81.8
"3417","11399","2018",1,1,0,160000,1404,114
"3418","11401","2018",12,12,0,109158.333333333,919.25,105.916666666667
"3419","11402","2018",1,1,0,81000,463,175
"3420","11404","2018",13,13,0,149792.307692308,1367.92307692308,106.923076923077
"3421","11405","2018",14,14,0,139155.071428571,1357.14285714286,96.9285714285714
"3422","11407","2018",6,6,0,157243.833333333,1422.33333333333,119.5
"3423","11408","2018",5,5,0,171829,1081,151
"3424","11409","2018",2,2,0,64250,671,95
"3425","11410","2018",13,13,0,129859.230769231,1371.46153846154,84.8461538461538
"3426","11411","2018",5,5,0,95200,1002.6,102.8
"3427","11412","2018",2,2,0,58750,562.5,105
"3428","11413","2018",7,7,0,115785.714285714,1320.42857142857,91.7142857142857
"3429","11415","2018",4,4,0,92100,971.5,104.25
"3430","11416","2018",2,2,0,158625,1485.5,108
"3431","11418","2018",12,12,0,143400.416666667,1274.08333333333,118.25
"3432","11420","2018",5,5,0,256840,1857.6,131
"3433","11421","2018",4,4,0,129500,1169.5,115.5
"3434","11422","2018",5,5,0,166828,1467,111.6
"3435","11423","2018",2,2,0,132500,1723,77
"3436","11425","2018",18,18,0,155461.111111111,1585.22222222222,101.777777777778
"3437","11426","2018",13,10,3,179572.307692308,1923.07692307692,90.9230769230769
"3438","11427","2018",7,7,0,119614.285714286,1694.57142857143,83.7142857142857
"3439","11428","2018",6,6,0,111350,1245.5,104.833333333333
"3440","11429","2018",55,53,2,163226.145454545,1546.58181818182,103.563636363636
"3441","11430","2018",11,11,0,157450.909090909,1365.90909090909,124.545454545455
"3442","11431","2018",3,3,0,104666.666666667,949.333333333333,109
"3443","11432","2018",2,2,0,103500,1269,81.5
"3444","11433","2018",13,13,0,89911.5384615385,1149.07692307692,79.4615384615385
"3445","11434","2018",14,14,0,121950,1246.35714285714,97.2857142857143
"3446","11435","2018",2,2,0,50000,734.5,65.5
"3447","11436","2018",4,4,0,84995,899.75,108
"3448","11437","2018",9,9,0,153640,1484.88888888889,103.888888888889
"3449","11438","2018",7,7,0,85998.5714285714,1093.28571428571,80.2857142857143
"3450","11439","2018",5,5,0,88400,915,98.2
"3451","11441","2018",45,41,4,189601.377777778,2041.82222222222,94.8444444444444
"3452","12001","2018",10,10,0,143624.5,1493.9,109.7
"3453","12002","2018",11,11,0,153824.545454545,1458.36363636364,112.363636363636
"3454","12003","2018",3,3,0,181283.333333333,1373.66666666667,126.333333333333
"3455","12004","2018",2,2,0,92625,1029.5,91
"3456","12006","2018",1,1,0,30000,698,43
"3457","12007","2018",4,4,0,155847.5,1476,101.5
"3458","12008","2018",9,9,0,111222.222222222,1115.66666666667,100.333333333333
"3459","12010","2018",1,1,0,206000,2040,101
"3460","12011","2018",6,6,0,108940.833333333,1355.66666666667,96.1666666666667
"3461","12012","2018",9,9,0,114461.111111111,1207.77777777778,97.3333333333333
"3462","12013","2018",34,33,1,82733.2352941177,957.411764705882,83.7647058823529
"3463","12015","2018",6,6,0,80033.3333333333,1012.5,83
"3464","12016","2018",6,5,1,120556.666666667,1306.83333333333,96.3333333333333
"3465","12017","2018",5,5,0,97400,1202.4,81.2
"3466","12018","2018",1,1,0,70000,946,74
"3467","12019","2018",1,1,0,50000,714,70
"3468","12021","2018",15,14,1,121997.533333333,1314.53333333333,95.8
"3469","12022","2018",2,2,0,103250,943.5,122.5
"3470","12023","2018",1,1,0,40000,1481,27
"3471","12025","2018",7,7,0,106500,979,101.857142857143
"3472","12026","2018",8,8,0,132062.5,1483.75,84.625
"3473","12027","2018",2,2,0,163500,1201.5,153
"3474","12028","2018",2,2,0,80750,1084.5,67.5
"3475","12029","2018",3,3,0,99250,1615.33333333333,66.6666666666667
"3476","12030","2018",10,10,0,82325.5,941.1,89
"3477","12031","2018",3,3,0,61000,870.666666666667,64
"3478","12032","2018",2,2,0,244200,1944,126
"3479","12033","2018",27,20,7,150789.444444444,1609.62962962963,93.4814814814815
"3480","12034","2018",3,3,0,160333.333333333,1206,144.666666666667
"3481","12036","2018",6,6,0,91208.3333333333,1500.16666666667,80
"3482","12037","2018",7,7,0,85497.1428571429,1426.28571428571,77.7142857142857
"3483","12038","2018",1,1,0,265000,1325,200
"3484","12039","2018",1,1,0,74960,999,75
"3485","12041","2018",3,3,0,165316.666666667,2097,134.333333333333
"3486","12043","2018",11,11,0,205650,1488.27272727273,158.272727272727
"3487","12044","2018",8,6,2,119000,1501.125,92.25
"3488","12045","2018",1,1,0,53750,1194,45
"3489","12046","2018",7,7,0,107671.428571429,1213.57142857143,87.7142857142857
"3490","12047","2018",5,5,0,51150,751.6,77.2
"3491","12048","2018",1,1,0,80000,1067,75
"3492","12049","2018",7,7,0,119528.571428571,1099.71428571429,116.428571428571
"3493","12050","2018",5,5,0,76880,1184.4,65
"3494","12051","2018",3,3,0,141666.666666667,1010.66666666667,120.333333333333
"3495","12052","2018",38,34,4,99367.1052631579,1256.89473684211,85.2105263157895
"3496","12053","2018",1,1,0,155000,1667,93
"3497","12054","2018",7,7,0,145340,1245.85714285714,110.142857142857
"3498","12055","2018",2,2,0,35250,474,69
"3499","12056","2018",21,16,5,152648.80952381,1605.95238095238,99
"3500","12057","2018",10,10,0,123502,1429.1,99.5
"3501","12059","2018",6,6,0,119083.333333333,1075.16666666667,102.833333333333
"3502","12060","2018",1,1,0,90000,720,125
"3503","12061","2018",7,7,0,67571.4285714286,1012.28571428571,84.4285714285714
"3504","12062","2018",3,3,0,74333.3333333333,797,95
"3505","12063","2018",13,12,1,126923.076923077,1411.07692307692,88.2307692307692
"3506","12064","2018",2,2,0,116250,1215.5,99
"3507","12065","2018",9,9,0,112708.888888889,1322.33333333333,96.7777777777778
"3508","12066","2018",15,15,0,122965,1212.33333333333,98.5333333333333
"3509","12067","2018",3,3,0,72000,933,81
"3510","12068","2018",5,5,0,127680,1389.4,95.2
"3511","12069","2018",3,3,0,169333.333333333,1103.33333333333,161
"3512","12070","2018",7,6,1,174800,1300.14285714286,141.571428571429
"3513","12071","2018",3,3,0,79150,654.666666666667,101.666666666667
"3514","12072","2018",3,3,0,80000,728.666666666667,107.666666666667
"3515","12073","2018",7,7,0,96278.5714285714,1149.71428571429,85.8571428571429
"3516","12074","2018",2,2,0,89000,998,78
"3517","12075","2018",4,4,0,100012.5,1192.25,96.25
"3518","12076","2018",14,14,0,135299.428571429,1645.21428571429,90.1428571428571
"3519","12077","2018",6,5,1,78866.1666666667,938,80.5
"3520","12078","2018",1,1,0,250000,1838,136
"3521","12079","2018",5,5,0,132800,1532.6,87
"3522","12080","2018",2,2,0,110000,2114.5,53
"3523","12082","2018",6,6,0,134608.333333333,1435.33333333333,117.5
"3524","12083","2018",21,19,2,75185.9523809524,1052.09523809524,74.0952380952381
"3525","12084","2018",16,13,3,123854.5,1319.5,94
"3526","12085","2018",3,3,0,76666.6666666667,1341.66666666667,58.6666666666667
"3527","12086","2018",1,1,0,214000,1861,115
"3528","12088","2018",1,1,0,55000,688,80
"3529","12089","2018",45,32,13,73929.9555555556,877.066666666667,85.4
"3530","12090","2018",29,29,0,198050.517241379,1944.44827586207,102.689655172414
"3531","12091","2018",5,5,0,92800,986.6,99
"3532","12092","2018",8,8,0,66526.25,658.875,102.25
"3533","12093","2018",2,1,1,86250,1526,70.5
"3534","12094","2018",12,12,0,129630,1505.91666666667,89
"3535","12095","2018",2,2,0,144000,1117,135
"3536","12096","2018",60,34,26,134129.5,1489.75,91.3166666666667
"3537","12097","2018",2,2,0,106005,1364,77.5
"3538","12098","2018",6,5,1,116841.666666667,2632.83333333333,89.3333333333333
"3539","12099","2018",7,7,0,87035.7142857143,1049.85714285714,82.4285714285714
"3540","12100","2018",20,17,3,92545,1113.4,80.85
"3541","12101","2018",6,6,0,123820,1406.5,79
"3542","12102","2018",23,20,3,170394.130434783,1752,97.9565217391304
"3543","12104","2018",4,4,0,96837.5,1202,81.25
"3544","12105","2018",9,9,0,170915,1408.77777777778,131.555555555556
"3545","12106","2018",10,10,0,141135,1576.6,96.7
"3546","12107","2018",2,2,0,174200,1447,118.5
"3547","12108","2018",2,2,0,144500,1639,90
"3548","12109","2018",2,2,0,85000,1054,81.5
"3549","12110","2018",5,5,0,105000,1249.8,89
"3550","12111","2018",7,7,0,136807.142857143,1295,111.857142857143
"3551","12113","2018",1,1,0,82300,675,122
"3552","12115","2018",4,4,0,110500,943.75,103.25
"3553","12118","2018",3,3,0,117587,1113,102.666666666667
"3554","12119","2018",23,14,9,70010,1373.65217391304,52.1739130434783
"3555","12120","2018",12,10,2,136901.25,1333.58333333333,101.333333333333
"3556","12121","2018",7,7,0,129700,1640.28571428571,84.7142857142857
"3557","12122","2018",1,1,0,55000,846,65
"3558","12124","2018",6,6,0,137650,822.5,132.666666666667
"3559","12125","2018",8,8,0,64837.5,765,90.375
"3560","12127","2018",17,17,0,81183.8235294118,924.176470588235,92.2352941176471
"3561","12128","2018",6,6,0,209839.666666667,1674.5,130.166666666667
"3562","12129","2018",4,4,0,92911.75,1284.25,71
"3563","12130","2018",10,8,2,57130,758,78.8
"3564","12131","2018",8,8,0,207987.5,1829.875,118.125
"3565","12133","2018",56,38,18,154373.214285714,1816.98214285714,86.75
"3566","12134","2018",1,1,0,104000,860,121
"3567","12135","2018",2,2,0,132500,1097.5,118
"3568","12136","2018",8,8,0,152268.25,1453.25,104.875
"3569","12137","2018",4,4,0,191525,1655.75,121.25
"3570","12138","2018",18,16,2,145591.666666667,1651.44444444444,88.8888888888889
"3571","12139","2018",2,2,0,141000,1183.5,111.5
"3572","12140","2018",10,9,1,104965,1577.3,73.8
"3573","12141","2018",1,1,0,78500,2181,36
"3574","12142","2018",3,3,0,116733.333333333,1236,94.3333333333333
"3575","12143","2018",1,1,0,30000,380,79
"3576","12144","2018",1,1,0,74000,925,80
"3577","12145","2018",296,123,173,112826.560810811,1550.60472972973,73.6418918918919
"3578","12146","2018",35,22,13,168514.285714286,1852.08571428571,89.0857142857143
"3579","12147","2018",1,1,0,60000,698,86
"3580","12148","2018",7,5,2,163071.428571429,2039.57142857143,84
"3581","12149","2018",2,2,0,57500,1157.5,50.5
"3582","12150","2018",5,5,0,156064.4,1199.4,128.8
"3583","12151","2018",1,1,0,31000,1000,31
"3584","12153","2018",4,4,0,57437.5,651,92.5
"3585","12154","2018",5,5,0,101300,1285.2,87.4
"3586","12155","2018",4,4,0,118400,1203.75,105.5
"3587","12156","2018",2,2,0,79244,869,92
"3588","12157","2018",14,14,0,146610.714285714,1654,94.2857142857143
"3589","12158","2018",5,5,0,113700,1086.6,106.8
"3590","12159","2018",1,1,0,295700,1056,280
"3591","12160","2018",4,3,1,101875,1434.5,75.25
"3592","12161","2018",5,5,0,244440,1880.8,131
"3593","12162","2018",5,5,0,116320,1137.8,98.4
"3594","12163","2018",4,4,0,37500,711,51.25
"3595","12164","2018",6,5,1,107356.666666667,998.666666666667,113.333333333333
"3596","12165","2018",1,1,0,167000,1653,101
"3597","12167","2018",9,9,0,124019.666666667,1055.55555555556,117.555555555556
"3598","12168","2018",14,13,1,143575.714285714,1642.42857142857,93
"3599","12169","2018",19,18,1,87434.7894736842,1060.10526315789,87.5263157894737
"3600","12170","2018",5,5,0,114000,1529.2,70.6
"3601","12171","2018",2,2,0,106500,870.5,125
"3602","12172","2018",6,6,0,132416.666666667,1335.66666666667,102.333333333333
"3603","12174","2018",47,32,15,172917.744680851,1928.82978723404,90.936170212766
"3604","12176","2018",209,79,130,131648.167464115,1826.09090909091,71.6363636363636
"3605","12177","2018",12,12,0,103205,1330.66666666667,81.3333333333333
"3606","12178","2018",3,2,1,77180,967.666666666667,80.6666666666667
"3607","12179","2018",3,3,0,45930,658,78.3333333333333
"3608","12180","2018",2,2,0,115000,1498.5,63.5
"3609","12181","2018",4,4,0,104626.75,1118.25,95.25
"3610","12182","2018",6,6,0,161083.333333333,1217.16666666667,122.666666666667
"3611","12183","2018",4,4,0,63695,899.75,71
"3612","12184","2018",1,1,0,42000,389,108
"3613","12185","2018",11,10,1,118424.545454545,1452.45454545455,85.1818181818182
"3614","12186","2018",3,3,0,61333.3333333333,786.666666666667,77
"3615","12187","2018",3,2,1,63333.3333333333,784.666666666667,87.3333333333333
"3616","12188","2018",4,4,0,136837.5,1177.75,111
"3617","12189","2018",2,2,0,106700,904,118
"3618","12190","2018",1,1,0,141400,1230,115
"3619","12191","2018",4,4,0,182162.5,1555.5,117.75
"3620","12192","2018",1,1,0,59100,1231,48
"3621","12193","2018",5,5,0,79800,845.2,102
"3622","12194","2018",7,7,0,126274.285714286,1169.28571428571,100.714285714286
"3623","12197","2018",24,23,1,122032.5,1341.58333333333,98.4583333333333
"3624","12198","2018",11,9,2,77077.2727272727,926.818181818182,79.6363636363636
"3625","12199","2018",34,17,17,109066.941176471,1538.38235294118,75
"3626","12200","2018",9,9,0,127866.666666667,1673.44444444444,81.4444444444444
"3627","12201","2018",8,8,0,160500,1741.125,93.125
"3628","12202","2018",489,71,418,105566.488752556,1625.39672801636,65.3660531697342
"3629","12203","2018",3,2,1,156583.333333333,1627.33333333333,102
"3630","12204","2018",3,3,0,147000,1705,71.6666666666667
"3631","12205","2018",6,6,0,88571.6666666667,953.166666666667,96.8333333333333
"3632","12206","2018",6,6,0,139980,1442.33333333333,96.1666666666667
"3633","12207","2018",4,4,0,66913.75,757.75,88
"3634","12208","2018",111,67,44,112865.585585586,1317.03603603604,86.4864864864865
"3635","12209","2018",3,3,0,136333.333333333,968.666666666667,140
"3636","12210","2018",4,4,0,118980,892.75,126.5
"3637","12211","2018",7,6,1,103142.857142857,1250.42857142857,88.7142857142857
"3638","12212","2018",1,1,0,26000,667,39
"3639","12213","2018",4,4,0,106375,1375.75,77.75
"3640","12214","2018",5,4,1,69800,723,94.2
"3641","12215","2018",7,6,1,111114.285714286,1438,81.7142857142857
"3642","12216","2018",17,16,1,144976.470588235,1568.11764705882,95.5882352941177
"3643","12217","2018",6,6,0,151644.166666667,1366.66666666667,110
"3644","12219","2018",6,6,0,124075,1217.33333333333,91
"3645","12220","2018",4,3,1,89250,1138,79.5
"3646","12221","2018",2,2,0,94750,940.5,108
"3647","12222","2018",5,5,0,79344,1097.6,77
"3648","12223","2018",16,16,0,110548.1875,1006.125,108.875
"3649","12224","2018",32,20,12,86031.59375,1210.3125,74.875
"3650","12225","2018",14,14,0,207296.357142857,2015.78571428571,101.357142857143
"3651","12226","2018",4,4,0,119750,1367.25,87
"3652","12227","2018",5,5,0,75486,1056.6,69.8
"3653","12228","2018",6,6,0,106714.333333333,923.166666666667,111
"3654","12229","2018",2,2,0,200250,1301.5,155.5
"3655","12230","2018",1,1,0,174000,1426,122
"3656","12231","2018",14,14,0,107422.142857143,1569.42857142857,77.9285714285714
"3657","12232","2018",1,1,0,82350,686,120
"3658","12233","2018",2,2,0,85400,849.5,92
"3659","12234","2018",4,4,0,102500,1096.5,90
"3660","12235","2018",4,4,0,101375,1190.75,82.25
"3661","12236","2018",2,2,0,135000,994,108
"3662","12237","2018",7,6,1,59571.4285714286,750,78.7142857142857
"3663","12238","2018",1,1,0,225000,1731,130
"3664","12239","2018",3,3,0,108000,1270.66666666667,84.3333333333333
"3665","12240","2018",1,1,0,165000,1051,157
"3666","12241","2018",13,12,1,225169.230769231,1981.61538461538,114.692307692308
"3667","12242","2018",4,4,0,103750,1028.75,99.5
"3668","12243","2018",13,13,0,131433.076923077,1642.92307692308,79.3076923076923
"3669","12244","2018",8,7,1,86400,1125.25,84.125
"3670","12246","2018",5,5,0,160820,1358.6,115
"3671","12247","2018",4,4,0,93000,868.75,125
"3672","12248","2018",5,4,1,99100,980.8,108.8
"3673","12249","2018",5,4,1,73650,1276.8,87.4
"3674","12250","2018",3,3,0,156533.333333333,1277,112.333333333333
"3675","12251","2018",4,4,0,115850,1614.75,77.25
"3676","12252","2018",4,4,0,183025,1179.5,150.25
"3677","12253","2018",11,10,1,138886.363636364,1940.72727272727,75.6363636363636
"3678","12254","2018",18,17,1,210297.222222222,1707.83333333333,127.166666666667
"3679","12255","2018",7,5,2,64092.8571428571,970.285714285714,67.4285714285714
"3680","12256","2018",7,7,0,162142.857142857,1483.57142857143,122.714285714286
"3681","12257","2018",2,2,0,82500,1041.5,80
"3682","12258","2018",9,9,0,80818.2222222222,942.111111111111,84.2222222222222
"3683","12259","2018",9,9,0,127305.555555556,1292,101.666666666667
"3684","12260","2018",4,3,1,84337.5,1066,77.25
"3685","12261","2018",2,2,0,83400,808,103
"3686","12262","2018",15,14,1,102378.266666667,1068.86666666667,93.4666666666667
"3687","12263","2018",5,5,0,163000,1174.6,137.2
"3688","12264","2018",29,24,5,189447.862068966,1959.68965517241,97.6206896551724
"3689","12265","2018",1,1,0,30000,411,73
"3690","12266","2018",3,3,0,82050,801.666666666667,100.666666666667
"3691","12267","2018",4,4,0,82000,820,99.5
"3692","12268","2018",1,1,0,134375,1768,76
"3693","12270","2018",49,45,4,95016.4285714286,1091.28571428571,89.0408163265306
"3694","12272","2018",5,5,0,121320,1178.4,99.2
"3695","12273","2018",2,2,0,157175,1397,124.5
"3696","12275","2018",1,1,0,184800,1232,150
"3697","12276","2018",1,1,0,265000,2087,127
"3698","12277","2018",5,5,0,133212,1402.2,101.6
"3699","12278","2018",2,2,0,91000,525,171
"3700","12280","2018",4,4,0,90000,949.75,87
"3701","12281","2018",3,3,0,145090,1552.66666666667,93.6666666666667
"3702","12282","2018",9,9,0,127488.888888889,1468.55555555556,89.2222222222222
"3703","12283","2018",3,3,0,116533.333333333,1368.33333333333,86.3333333333333
"3704","12284","2018",7,7,0,105414.285714286,1341.85714285714,75.2857142857143
"3705","12286","2018",11,11,0,153346.818181818,1795.09090909091,83.9090909090909
"3706","12287","2018",9,9,0,132566.666666667,1439.88888888889,100.222222222222
"3707","12288","2018",17,17,0,156232.176470588,1880,94.7058823529412
"3708","12289","2018",3,3,0,36666.6666666667,574.333333333333,61
"3709","12290","2018",5,5,0,145070,1573.2,93.6
"3710","12291","2018",7,5,2,117342.857142857,1040.85714285714,112.571428571429
"3711","12292","2018",1,1,0,24500,345,71
"3712","12294","2018",3,3,0,109333.333333333,998,97.3333333333333
"3713","12295","2018",1,1,0,85000,895,95
"3714","12296","2018",10,10,0,95625,1126.6,89.1
"3715","12297","2018",6,6,0,104200,1379.83333333333,84.3333333333333
"3716","12298","2018",8,8,0,97156.25,1216.25,100.375
"3717","12299","2018",8,7,1,74812.5,798.25,103
"3718","12300","2018",123,93,30,121974.715447154,1452.80487804878,90.3658536585366
"3719","12301","2018",15,15,0,153118.266666667,1395.33333333333,114.933333333333
"3720","12303","2018",2,2,0,85000,2065.5,41
"3721","12305","2018",13,13,0,60807.6923076923,759.230769230769,82.1538461538462
"3722","12307","2018",2,2,0,72500,806,90
"3723","13001","2018",2068,314,1754,285589.971470019,4278.45164410058,66.431334622824
"3724","13002","2018",228,159,69,322827.039473684,3786.5,87.9342105263158
"3725","13003","2018",35,33,2,259739.914285714,2831.65714285714,92.3428571428571
"3726","13004","2018",619,386,233,184801.256865913,2375.39741518578,78.5363489499192
"3727","13005","2018",472,141,331,221821.593220339,2924.51271186441,74.8135593220339
"3728","13006","2018",12,11,1,277047.5,3165.16666666667,93.25
"3729","13007","2018",129,94,35,314151.542635659,3475.86046511628,89.6356589147287
"3730","13008","2018",5,5,0,241000,2630.6,90.6
"3731","13009","2018",6,6,0,323583.333333333,3244.33333333333,101.833333333333
"3732","13010","2018",43,40,3,251017.488372093,2565.39534883721,99.4651162790698
"3733","13011","2018",2,2,0,598775,7097.5,86.5
"3734","13012","2018",3,3,0,1143733.33333333,6590.66666666667,171.333333333333
"3735","13013","2018",17,16,1,383557.411764706,4024.76470588235,97.7058823529412
"3736","13014","2018",85,45,40,195242.352941176,2510.47058823529,76.4470588235294
"3737","13015","2018",131,98,33,384086.007633588,4259.01526717557,92.2213740458015
"3738","13016","2018",66,55,11,327657.075757576,3399.62121212121,97.969696969697
"3739","13017","2018",13,13,0,220249.461538462,2336.61538461538,93.0769230769231
"3740","13018","2018",41,38,3,217866.585365854,2289.73170731707,97.7560975609756
"3741","13019","2018",97,87,10,453595.010309278,4313.75257731959,109
"3742","13020","2018",27,14,13,225057.185185185,3039.14814814815,71.8518518518518
"3743","13021","2018",78,32,46,419127.256410256,5112.34615384615,84.2820512820513
"3744","13022","2018",158,42,116,488761.158227848,6287.48734177215,77.2594936708861
"3745","13023","2018",47,37,10,436005.191489362,4251.1914893617,103.531914893617
"3746","13024","2018",37,28,9,249792.702702703,2702.32432432432,94.2972972972973
"3747","13025","2018",20,16,4,526272,4131.8,125.1
"3748","13026","2018",182,127,55,236958.401098901,3088.29120879121,78.1868131868132
"3749","13027","2018",177,116,61,214066.740112994,2450.49717514124,85.5028248587571
"3750","13028","2018",699,152,547,259691.422031474,4142.47496423462,63.1545064377682
"3751","13029","2018",13,13,0,428840.692307692,3446.07692307692,129.230769230769
"3752","13030","2018",52,42,10,289150.384615385,3135.05769230769,92.6923076923077
"3753","13031","2018",41,26,15,283206.414634146,3234,89.0487804878049
"3754","13032","2018",97,71,26,480553.329896907,4475.61855670103,104.051546391753
"3755","13033","2018",62,47,15,432301.935483871,5346.29032258064,82.758064516129
"3756","13034","2018",31,30,1,854712.064516129,4933.67741935484,168.774193548387
"3757","13035","2018",97,74,23,232418.958762887,3452.69072164948,74.0412371134021
"3758","13036","2018",48,44,4,281577.1875,3100.8125,91.7083333333333
"3759","13037","2018",114,97,17,299979.771929825,3177.44736842105,97
"3760","13038","2018",48,41,7,316484.583333333,3173.45833333333,97.9791666666667
"3761","13039","2018",170,123,47,223039.323529412,2772.71176470588,82.1
"3762","13040","2018",116,88,28,317836.818965517,3630.37068965517,88.3879310344828
"3763","13041","2018",214,105,109,251190.289719626,3242.72429906542,77.1261682242991
"3764","13042","2018",67,34,33,391719.970149254,4090,93.6567164179104
"3765","13043","2018",97,79,18,273345.010309278,3145.12371134021,88.2371134020619
"3766","13044","2018",61,51,10,280862.131147541,3201.39344262295,88.5409836065574
"3767","13045","2018",45,43,2,260684.066666667,2552.57777777778,101.933333333333
"3768","13046","2018",35,30,5,297950.057142857,3727.77142857143,84.1428571428571
"3769","13047","2018",465,281,184,220097.197849462,2714.89247311828,81.3290322580645
"3770","13048","2018",54,43,11,287449.351851852,2832.55555555556,101.388888888889
"3771","13049","2018",20,18,2,285957.5,2844.9,105.55
"3772","13050","2018",132,94,38,305422.310606061,3357.7803030303,92.219696969697
"3773","13051","2018",102,82,20,274414.852941176,3108.58823529412,90.2254901960784
"3774","13052","2018",27,23,4,241655.185185185,2617.37037037037,97.2222222222222
"3775","13053","2018",110,78,32,248703.863636364,2986.48181818182,82.5727272727273
"3776","13054","2018",422,165,257,203998.91943128,2588.20616113744,77.4218009478673
"3777","13055","2018",12258,1682,10576,188655.173927231,2740.63003752651,66.3441833904389
"3778","13056","2018",440,142,298,198984.797727273,2719.87727272727,74.6295454545455
"3779","13057","2018",5,5,0,316997.4,3109,100.6
"3780","13058","2018",35,33,2,573964.685714286,5043.88571428571,109.228571428571
"3781","13059","2018",37,24,13,297142.162162162,3021.75675675676,99
"3782","13060","2018",47,35,12,423188.765957447,4033.17021276596,104.234042553191
"3783","13061","2018",4,4,0,252950,2311.5,108
"3784","13062","2018",33,31,2,378645.575757576,4371.18181818182,90.6969696969697
"3785","13063","2018",232,137,95,190450.650862069,2418.40948275862,79.125
"3786","13064","2018",24,23,1,297623.75,2827.66666666667,105.666666666667
"3787","13065","2018",54,49,5,248265.574074074,2880.40740740741,87.9074074074074
"3788","13066","2018",43,37,6,305088.023255814,2902.27906976744,106.976744186047
"3789","13067","2018",33,32,1,232458.151515152,2331.54545454545,97.030303030303
"3790","13068","2018",41,37,4,387428.243902439,3671.36585365854,101.219512195122
"3791","13069","2018",135,112,23,298325.807407407,3074.08888888889,95.6074074074074
"3792","13070","2018",70,39,31,252681.171428571,3362.74285714286,76.3428571428571
"3793","13071","2018",206,144,62,294823.572815534,3418.38834951456,85.2961165048544
"3794","13072","2018",49,40,9,372282.693877551,3551.97959183673,103.122448979592
"3795","13073","2018",59,47,12,299684.06779661,3665.8813559322,85.8305084745763
"3796","13074","2018",53,36,17,264537.094339623,2879.71698113208,92.3396226415094
"3797","13075","2018",152,56,96,263817.006578947,3556.27631578947,76.0328947368421
"3798","13076","2018",49,45,4,264653.367346939,2545.51020408163,103.632653061224
"3799","13077","2018",136,71,65,185035.75,2403.33088235294,75.9558823529412
"3800","13078","2018",56,33,23,143493.785714286,2000.83928571429,73.8035714285714
"3801","13079","2018",17,16,1,373152.941176471,3340.52941176471,114
"3802","13080","2018",59,47,12,355978.050847458,3509.37288135593,100.745762711864
"3803","13081","2018",141,95,46,262861.921985816,3230.80141843972,85.0425531914894
"3804","13082","2018",51,43,8,425588.470588235,3811.98039215686,112.529411764706
"3805","13083","2018",24,24,0,295630.541666667,2853.08333333333,108.625
"3806","13084","2018",50,42,8,241402.1,2729.74,91.98
"3807","13085","2018",54,32,22,351073.648148148,3679.11111111111,94.4074074074074
"3808","13086","2018",74,50,24,314968.851351351,3416.5,92.8918918918919
"3809","13087","2018",60,35,25,263831.583333333,3374.25,79.9333333333333
"3810","13088","2018",47,30,17,279125.404255319,3979.87234042553,78.0851063829787
"3811","13089","2018",34,23,11,168307.647058824,2179.44117647059,79.6176470588235
"3812","13090","2018",1,1,0,30000,455,66
"3813","13091","2018",70,60,10,415938.442857143,3672.54285714286,118.014285714286
"3814","13092","2018",116,60,56,206523.413793103,2621.50862068966,78.3793103448276
"3815","13093","2018",12,12,0,334975,3136.25,109.416666666667
"3816","13094","2018",21,18,3,305803.333333333,2888.71428571429,105.47619047619
"3817","13095","2018",16,16,0,797430,5051.3125,161.5
"3818","13096","2018",83,22,61,165866.86746988,3178.3734939759,55.2771084337349
"3819","13097","2018",117,99,18,255112.803418803,2664.83760683761,96.5470085470085
"3820","13098","2018",69,57,12,282461.333333333,3195.47826086957,91.231884057971
"3821","13099","2018",20,13,7,157542.3,2354.5,71.25
"3822","13100","2018",152,107,45,509689.493421053,4344.92763157895,109.631578947368
"3823","13101","2018",39,23,16,297322.487179487,3525.25641025641,86.7948717948718
"3824","13102","2018",54,38,16,248146.203703704,3205.87037037037,77.962962962963
"3825","13103","2018",617,217,400,198047.259319287,2673.27714748784,73.9967585089141
"3826","13104","2018",142,71,71,307587.316901408,5493.70422535211,60.9154929577465
"3827","13105","2018",65,53,12,217123.507692308,2591.76923076923,87.7692307692308
"3828","13106","2018",152,75,77,225369.078947368,2930.72368421053,77.6973684210526
"3829","13107","2018",59,53,6,408677.508474576,4247.96610169491,99.8813559322034
"3830","13108","2018",141,88,53,142599.943262411,1707.60992907801,84.2269503546099
"3831","13109","2018",37,25,12,511092.72972973,4475.75675675676,116.243243243243
"3832","13110","2018",140,108,32,268596.557142857,3148.05714285714,84.8571428571429
"3833","13111","2018",10,9,1,494497.5,4435.5,118.8
"3834","13112","2018",88,69,19,337900.920454545,3656.75,93
"3835","13113","2018",107,77,30,338784.588785047,3905.84112149533,90.7757009345794
"3836","13114","2018",43,41,2,513191,3793.67441860465,133.395348837209
"3837","13115","2018",20,15,5,252232.5,2981.45,83.2
"3838","13116","2018",10,10,0,220532,2521.3,89.3
"3839","13117","2018",363,197,166,225539.438016529,2913.20385674931,79.4462809917355
"3840","13118","2018",48,43,5,323666.541666667,3497.60416666667,96
"3841","13119","2018",79,44,35,337258.835443038,3814,88.1392405063291
"3842","14001","2018",19,19,0,205263.157894737,1991.15789473684,109.157894736842
"3843","14003","2018",3,3,0,122333.333333333,1316.66666666667,89
"3844","14005","2018",20,19,1,173338.25,1556.85,114.5
"3845","14006","2018",12,12,0,222450,1817.83333333333,122.833333333333
"3846","14007","2018",2,2,0,77030,561.5,127.5
"3847","14009","2018",18,18,0,206408.333333333,2289.88888888889,95.1666666666667
"3848","14011","2018",33,33,0,130735.454545455,1228.66666666667,112.484848484848
"3849","14012","2018",3,3,0,124666.666666667,964.666666666667,130
"3850","14014","2018",21,21,0,206438.095238095,1827.2380952381,111.619047619048
"3851","14015","2018",7,7,0,381161.428571429,2087.85714285714,172.142857142857
"3852","14016","2018",5,5,0,205570,2360.2,89
"3853","14020","2018",38,37,1,175569.473684211,1822.65789473684,98.7894736842105
"3854","14021","2018",9,6,3,163000,2133.88888888889,75.8888888888889
"3855","14022","2018",18,18,0,160061.111111111,2362.77777777778,74.4444444444444
"3856","14023","2018",4,4,0,207125,1582.25,137.25
"3857","14024","2018",13,12,1,267400,2413.53846153846,112.384615384615
"3858","14025","2018",5,5,0,111000,1081.6,115.6
"3859","14026","2018",11,11,0,186197.272727273,1719.27272727273,114.454545454545
"3860","14027","2018",62,59,3,142790,1334.70967741935,110.532258064516
"3861","14030","2018",15,15,0,304225.333333333,2375.53333333333,130.666666666667
"3862","14032","2018",3,3,0,239816.666666667,1657.66666666667,143.333333333333
"3863","14033","2018",6,6,0,265745,2261,117.833333333333
"3864","14034","2018",4,4,0,199250,1529.5,134
"3865","14035","2018",18,18,0,105754.444444444,1109.44444444444,94.2777777777778
"3866","14036","2018",3,3,0,198700,1884.33333333333,96.3333333333333
"3867","14037","2018",8,8,0,206167,1722.75,122.25
"3868","14038","2018",8,8,0,193425,1883.75,102
"3869","14039","2018",12,12,0,174325,1400.83333333333,125.75
"3870","14040","2018",1,1,0,52700,599,88
"3871","14041","2018",2,2,0,475250,2453.5,195.5
"3872","14042","2018",15,15,0,149356.666666667,1313.66666666667,111
"3873","14044","2018",19,19,0,276647.368421053,2063.68421052632,134.263157894737
"3874","14045","2018",2,2,0,121250,1114,136
"3875","14046","2018",21,21,0,203449.047619048,1926.33333333333,114.666666666667
"3876","14047","2018",199,105,94,168619.32160804,1897.98492462312,86.9396984924623
"3877","14049","2018",2,2,0,140000,1495,94
"3878","14050","2018",4,4,0,109975,1270.5,89.5
"3879","14053","2018",1,1,0,71000,845,84
"3880","14054","2018",1,1,0,151000,1258,120
"3881","14055","2018",10,9,1,224753.5,2418,93.5
"3882","14057","2018",12,12,0,177370,1987.5,96.0833333333333
"3883","14059","2018",43,11,32,290574.418604651,4061.3023255814,64.3023255813954
"3884","14060","2018",22,21,1,254558.181818182,2461.18181818182,110.045454545455
"3885","14061","2018",109,108,1,112688.229357798,1094.4128440367,105.862385321101
"3886","14062","2018",8,8,0,192950,1925.625,99.625
"3887","14063","2018",3,3,0,135333.333333333,1316.33333333333,104.333333333333
"3888","14064","2018",6,6,0,143162.5,1606.5,94.6666666666667
"3889","14066","2018",57,36,21,157162.368421053,2358.75438596491,69
"3890","14068","2018",34,31,3,275259.411764706,2620.85294117647,115.176470588235
"3891","14069","2018",19,14,5,109268.421052632,1417.42105263158,75.3157894736842
"3892","14070","2018",2,2,0,377500,2695.5,135.5
"3893","14076","2018",71,39,32,168417.394366197,2001.53521126761,83.6619718309859
"3894","14077","2018",15,15,0,247602,2314.4,117.266666666667
"3895","14078","2018",3,3,0,110490,1219.33333333333,92
"3896","14079","2018",101,38,63,185242.851485149,3027.9603960396,61.2772277227723
"3897","14080","2018",2,2,0,142250,1158.5,120
"3898","14083","2018",13,13,0,202235,1743,108.384615384615
"3899","14084","2018",3,3,0,126995.333333333,1134,107.333333333333
"3900","14085","2018",15,15,0,181803.333333333,1837,100.866666666667
"3901","14086","2018",5,5,0,357400,2478.6,136.6
"3902","14087","2018",1,1,0,65000,556,117
"3903","14088","2018",5,5,0,112300,1242.4,87.6
"3904","14089","2018",5,5,0,190400,1750,110.2
"3905","14090","2018",6,6,0,158575,1896.16666666667,93.5
"3906","14091","2018",3,3,0,275116.666666667,2972.66666666667,92.3333333333333
"3907","14092","2018",22,19,3,191245.545454545,1878.09090909091,103.545454545455
"3908","14093","2018",2,2,0,100100,1055.5,96
"3909","14096","2018",4,4,0,145500,1574.75,98.75
"3910","14097","2018",2,2,0,190000,1674.5,113
"3911","14098","2018",94,93,1,204610.138297872,2068.79787234043,101.489361702128
"3912","14100","2018",9,9,0,160958.333333333,1503.44444444444,108.666666666667
"3913","14101","2018",56,52,4,238455.285714286,2401.44642857143,99.9285714285714
"3914","14102","2018",15,15,0,271947.666666667,2147.33333333333,116
"3915","14103","2018",7,7,0,132142.857142857,1182.57142857143,128.714285714286
"3916","14104","2018",1,1,0,294148,2263,130
"3917","14106","2018",12,12,0,253566.666666667,2559.5,107.5
"3918","14107","2018",4,4,0,117625,1053.75,104
"3919","14111","2018",4,4,0,166125,1355,113.25
"3920","14117","2018",386,81,305,146834.373056995,3213.94300518135,45.5077720207254
"3921","14118","2018",2105,343,1762,144406.804275534,2268.8080760095,64.5220902612827
"3922","14119","2018",21,21,0,102085.714285714,1053.71428571429,98.9047619047619
"3923","14120","2018",16,16,0,126875,1370,100.25
"3924","14121","2018",5,5,0,169900,1569.2,110.4
"3925","14122","2018",1,1,0,190000,2111,90
"3926","14123","2018",16,16,0,246341.3125,2366,110.375
"3927","14124","2018",5,5,0,127660,1284.8,106.6
"3928","14125","2018",19,17,2,310632.631578947,2329.10526315789,134.421052631579
"3929","14126","2018",20,20,0,184047.5,1611.05,118.15
"3930","14127","2018",5,5,0,85940,885.4,97
"3931","14130","2018",3,3,0,134166.666666667,1582,105
"3932","14131","2018",5,5,0,284900,2990.8,93.4
"3933","14132","2018",1,1,0,272000,2473,110
"3934","14134","2018",1,1,0,369000,2050,180
"3935","14135","2018",5,5,0,324100,1997.8,160.6
"3936","14137","2018",19,16,3,178544.736842105,2057.94736842105,88.2105263157895
"3937","14138","2018",6,6,0,162891.666666667,1405.5,115.166666666667
"3938","14140","2018",3,3,0,197083.333333333,1428,138.666666666667
"3939","14143","2018",23,23,0,124264.130434783,1193.04347826087,105.652173913043
"3940","14145","2018",5,5,0,148620,1335.8,110.2
"3941","14146","2018",1,1,0,60000,750,80
"3942","14147","2018",2,2,0,157000,2038,82.5
"3943","14149","2018",11,11,0,168582.818181818,1517.90909090909,109.545454545455
"3944","14150","2018",16,16,0,150500,1464.5,107.8125
"3945","14159","2018",1,1,0,270000,1350,200
"3946","14160","2018",6,6,0,151666.666666667,1462.16666666667,102.5
"3947","14161","2018",5,5,0,368038,3012.2,132.6
"3948","14162","2018",20,20,0,95475,1455,72.9
"3949","14163","2018",4,4,0,160500,1986.75,97.25
"3950","14165","2018",3,3,0,167000,1849.33333333333,93.3333333333333
"3951","14166","2018",29,28,1,200755.379310345,2280.41379310345,91.4827586206897
"3952","14167","2018",38,27,11,166150,2260.71052631579,74.7894736842105
"3953","14168","2018",1,1,0,125000,1374,91
"3954","14169","2018",2,2,0,142523,1123,146
"3955","14171","2018",1,1,0,50400,854,59
"3956","14172","2018",5,5,0,162100,1657.8,98.2
"3957","14173","2018",8,8,0,118115.625,1135.375,100.5
"3958","14174","2018",22,22,0,103570.454545455,1175.63636363636,89.0909090909091
"3959","14175","2018",2,2,0,186835,1215.5,160
"3960","14177","2018",9,9,0,160000,1835.11111111111,88.6666666666667
"3961","14179","2018",1,1,0,152000,1169,130
"3962","14180","2018",1,1,0,172000,1703,101
"3963","14181","2018",62,44,18,172658.85483871,2030.06451612903,87.9677419354839
"3964","14182","2018",8,8,0,135665,1074.25,129
"3965","14183","2018",3,3,0,71666.6666666667,907,71.6666666666667
"3966","14184","2018",1,1,0,172450,1437,120
"3967","14190","2018",2,2,0,89000,906.5,99.5
"3968","14191","2018",221,53,168,113456.877828054,2304.19457013575,48.8190045248869
"3969","14193","2018",4,4,0,106000,1284.5,88.25
"3970","14194","2018",10,10,0,139860,1596.6,94.7
"3971","14195","2018",2,2,0,86000,942,104.5
"3972","14196","2018",1,1,0,240000,2286,105
"3973","14197","2018",16,16,0,292199.375,2664,119.375
"3974","14198","2018",2,2,0,310750,1591.5,197.5
"3975","14200","2018",20,20,0,182020.5,1765.85,103.85
"3976","14202","2018",3,3,0,248482.333333333,2203,122.666666666667
"3977","14203","2018",3,3,0,358333.333333333,2662.66666666667,129
"3978","14204","2018",3,3,0,124133.333333333,1547,79.6666666666667
"3979","14206","2018",3,3,0,150000,1117,146.333333333333
"3980","14207","2018",6,6,0,151614.166666667,1313.33333333333,122.166666666667
"3981","14209","2018",6,6,0,151750,1575.33333333333,95.5
"3982","14211","2018",8,8,0,145812.5,1604.25,97.125
"3983","14214","2018",2,2,0,237000,1460.5,168.5
"3984","14215","2018",21,20,1,201063.80952381,2109.7619047619,101
"3985","14216","2018",2,2,0,165500,1209,137
"3986","14218","2018",8,8,0,196625,1711.125,122
"3987","14220","2018",284,67,217,333498.771126761,4824.39788732394,65.4401408450704
"3988","14221","2018",35,32,3,211981.714285714,2265.62857142857,94.6571428571429
"3989","14223","2018",2,2,0,98881,2064,77
"3990","14224","2018",1,1,0,27500,399,69
"3991","14225","2018",117,77,40,142564.829059829,2574.82051282051,59.0683760683761
"3992","14226","2018",4,4,0,126451.75,1043.75,117
"3993","14227","2018",2,2,0,212500,2478.5,87.5
"3994","14228","2018",73,64,9,198727.808219178,1805.67123287671,109.671232876712
"3995","14229","2018",25,24,1,128108,1619.68,83.48
"3996","14230","2018",2,2,0,120000,1081.5,113
"3997","14231","2018",5,5,0,181340,1889.8,98.4
"3998","14232","2018",4,4,0,163512.5,1503.25,111.75
"3999","14236","2018",3,3,0,198383.333333333,1419.66666666667,151.333333333333
"4000","14237","2018",7,7,0,235742.857142857,2071.71428571429,116.857142857143
"4001","14238","2018",1,1,0,170000,2267,75
"4002","14239","2018",1,1,0,140000,1037,135
"4003","14240","2018",5,5,0,136900,1427.2,99.8
"4004","14241","2018",4,4,0,221125,1567.75,142.25
"4005","14242","2018",24,20,4,224932.916666667,2156.45833333333,107.916666666667
"4006","14243","2018",19,12,7,259130.578947368,2439,111.842105263158
"4007","14244","2018",4,4,0,93750,1138,90
"4008","14245","2018",1,1,0,142000,986,144
"4009","14246","2018",9,9,0,185166.666666667,2040.33333333333,91.6666666666667
"4010","14248","2018",2,2,0,264000,2647.5,100
"4011","14249","2018",20,20,0,190237.5,1921.15,105.55
"4012","14250","2018",4,4,0,142000,1866.25,75.75
"4013","14251","2018",6,6,0,88666.6666666667,1367.83333333333,62.8333333333333
"4014","14252","2018",2,2,0,131000,1445.5,96.5
"4015","14254","2018",14,13,1,242528.571428571,2257.71428571429,109.285714285714
"4016","14256","2018",6,6,0,156410,1546.83333333333,102.666666666667
"4017","14257","2018",26,24,2,178431.153846154,1909.15384615385,101
"4018","14258","2018",90,67,23,125654.111111111,1399.35555555556,93.2555555555556
"4019","14261","2018",2,2,0,221357.5,1805.5,120
"4020","14266","2018",20,20,0,201474.5,2125.4,94.6
"4021","14269","2018",3,3,0,267166.666666667,2657,96.6666666666667
"4022","14270","2018",2,2,0,203850,1413,145.5
"4023","14271","2018",44,40,4,200516.136363636,2210.84090909091,91.6363636363636
"4024","14272","2018",1,1,0,87000,853,102
"4025","14273","2018",4,4,0,122250,1855.5,68.25
"4026","14274","2018",33,31,2,203073.333333333,1859.42424242424,112.545454545455
"4027","14275","2018",14,14,0,141257.142857143,1224.42857142857,113.428571428571
"4028","14276","2018",2,2,0,188300,2407.5,88.5
"4029","14277","2018",31,30,1,153679.838709677,1679.12903225806,95.258064516129
"4030","14278","2018",11,11,0,168027.272727273,1808.36363636364,96.1818181818182
"4031","14280","2018",4,4,0,235160,1809.25,123.5
"4032","14281","2018",15,15,0,205014,1415.13333333333,145.866666666667
"4033","14282","2018",4,4,0,123100,976.75,118.75
"4034","14283","2018",1,1,0,267500,2229,120
"4035","14284","2018",2,2,0,159250,1418.5,111
"4036","14285","2018",1,1,0,169000,1536,110
"4037","14286","2018",7,7,0,219932.857142857,2201.71428571429,95.2857142857143
"4038","14287","2018",18,18,0,166872.222222222,1818.38888888889,96.3333333333333
"4039","14288","2018",5,5,0,234002,2260.4,102
"4040","14289","2018",7,7,0,132357.142857143,1080.57142857143,116.857142857143
"4041","14290","2018",12,12,0,173301.666666667,1445.16666666667,117
"4042","14293","2018",4,4,0,146625,1665.75,87.75
"4043","14297","2018",9,9,0,181344.444444444,1836.66666666667,99.4444444444444
"4044","14298","2018",2,2,0,111000,1615,65.5
"4045","14299","2018",16,15,1,178627.9375,2104.625,89.9375
"4046","14301","2018",40,40,0,197351.825,2379.725,93.875
"4047","14302","2018",3,3,0,439166.666666667,2961.33333333333,169.333333333333
"4048","14303","2018",13,13,0,127692.307692308,1304.76923076923,97.5384615384615
"4049","14304","2018",10,10,0,322940.6,2553.2,116.3
"4050","14305","2018",10,10,0,272980,2376.2,122.2
"4051","14306","2018",4,4,0,231025,2313,101
"4052","14308","2018",4,4,0,170415.25,1507,116.75
"4053","14309","2018",13,11,2,141446.769230769,1721.07692307692,83.6153846153846
"4054","14310","2018",8,8,0,154042.875,1288.875,113.5
"4055","14311","2018",9,9,0,173811.111111111,1915.11111111111,95.7777777777778
"4056","14312","2018",45,31,14,93740.8,1598.51111111111,57.5333333333333
"4057","14316","2018",5,5,0,187940,1861,101.8
"4058","14318","2018",11,11,0,220113.636363636,2108.54545454545,118.909090909091
"4059","14319","2018",8,8,0,208543.75,2109.5,101.875
"4060","14320","2018",1,1,0,135000,2250,60
"4061","14322","2018",5,5,0,296818.8,1551,189.2
"4062","14325","2018",74,69,5,189414.594594595,2118.02702702703,91.1486486486486
"4063","14326","2018",15,15,0,206286.666666667,1835.06666666667,114.866666666667
"4064","14327","2018",254,60,194,113939.24015748,1698.38976377953,66.8070866141732
"4065","14328","2018",22,22,0,165929,2426.77272727273,82.7272727272727
"4066","14329","2018",2,2,0,75290,1093.5,71
"4067","14332","2018",5,5,0,148000,1506.6,99
"4068","14333","2018",7,7,0,488857.142857143,3080.85714285714,160.285714285714
"4069","14334","2018",4,4,0,115725,1110,96.5
"4070","14335","2018",1,1,0,252900,2662,95
"4071","14336","2018",4,4,0,137450,1202.75,111.75
"4072","14337","2018",5,5,0,153580,1353,116.4
"4073","14338","2018",167,44,123,150149.45508982,2747.29341317365,54.4431137724551
"4074","14341","2018",154,99,55,165944.084415584,2000.16883116883,83.2597402597403
"4075","14342","2018",61,57,4,118612.295081967,1296.04918032787,96.9508196721311
"4076","14343","2018",2,2,0,84500,951.5,90
"4077","14344","2018",10,10,0,230448,1990.9,118.8
"4078","14345","2018",5,5,0,86900,1072,77.8
"4079","14346","2018",7,7,0,157439.571428571,1382,114.142857142857
"4080","14347","2018",18,18,0,152838.888888889,1627.83333333333,99.2777777777778
"4081","14348","2018",1,1,0,147000,1838,80
"4082","14349","2018",20,20,0,199496,1934.4,105.75
"4083","14352","2018",12,12,0,86068.3333333333,933.5,97.4166666666667
"4084","14353","2018",7,7,0,182514.285714286,1645.57142857143,117.571428571429
"4085","14354","2018",64,53,11,170236.1875,2260.421875,84.296875
"4086","14355","2018",8,8,0,142912.5,1419.25,97.75
"4087","14357","2018",10,10,0,102900.8,895.1,122.7
"4088","14358","2018",4,4,0,165000,2126.5,98.75
"4089","14360","2018",3,3,0,98833.3333333333,1257.33333333333,78
"4090","14364","2018",6,6,0,110500,1225.66666666667,100.333333333333
"4091","14365","2018",65,51,14,179081.6,2497.66153846154,71.8307692307692
"4092","14366","2018",259,102,157,106305.930501931,1385.63706563707,76.4247104247104
"4093","14367","2018",7,7,0,109514.285714286,1166.42857142857,94.2857142857143
"4094","14368","2018",5,5,0,119400,1162.4,103.6
"4095","14369","2018",6,6,0,138185.833333333,1200.5,120.333333333333
"4096","14370","2018",47,47,0,117023.489361702,1385.6170212766,87.7021276595745
"4097","14371","2018",77,77,0,145626.311688312,1380.4025974026,104.38961038961
"4098","14374","2018",2,2,0,96000,925.5,120.5
"4099","14377","2018",7,7,0,156500,1567.28571428571,101
"4100","14378","2018",11,11,0,118919.090909091,1059.18181818182,117.454545454545
"4101","14379","2018",4,4,0,120500,1525.75,82.5
"4102","14380","2018",2,2,0,158250,1606.5,104
"4103","14383","2018",27,22,5,225258.148148148,2370.48148148148,97.8888888888889
"4104","14384","2018",72,50,22,192718.611111111,2436.05555555556,79.875
"4105","14385","2018",2,2,0,222400,1686.5,130.5
"4106","14389","2018",2,2,0,165915,1254.5,116
"4107","14390","2018",2,2,0,137500,1083.5,126
"4108","14391","2018",3,3,0,164666.666666667,1443,118.333333333333
"4109","14393","2018",2,2,0,156000,1935.5,80.5
"4110","14394","2018",5,5,0,128520,1457.4,88.8
"4111","14396","2018",17,17,0,215207.764705882,2197.64705882353,98.9411764705882
"4112","14397","2018",8,8,0,206012.5,1577.625,139.875
"4113","14398","2018",8,8,0,253431.25,2268.625,104.25
"4114","14399","2018",4,4,0,248525,1629.75,144
"4115","14400","2018",4,4,0,235225,1522.75,150.5
"4116","14401","2018",1,1,0,149000,1602,93
"4117","14403","2018",11,11,0,235250,1823.90909090909,120.090909090909
"4118","14404","2018",1,1,0,49000,1089,45
"4119","14405","2018",5,5,0,194560,2001.8,102.4
"4120","14406","2018",17,17,0,213932.941176471,2112.64705882353,110.058823529412
"4121","14407","2018",34,29,5,278911.911764706,2601.44117647059,108.382352941176
"4122","14408","2018",20,19,1,182697.5,2048.4,91.4
"4123","14409","2018",92,50,42,180217.934782609,2535.40217391304,74.5
"4124","14410","2018",15,15,0,140976.666666667,1379.6,101.333333333333
"4125","14411","2018",5,5,0,96420,1188.6,80.4
"4126","14419","2018",4,4,0,157633,1589.75,99.5
"4127","14421","2018",4,4,0,236375,1663.75,135
"4128","14424","2018",1,1,0,73800,922,80
"4129","14425","2018",1,1,0,144000,1297,111
"4130","14426","2018",6,6,0,224166.666666667,2236.83333333333,97.3333333333333
"4131","14427","2018",2,1,1,55000,696,79
"4132","14430","2018",2,2,0,214000,2043.5,107
"4133","14431","2018",124,124,0,147394.032258065,1549.95967741935,95.5806451612903
"4134","14436","2018",8,8,0,235175,1756.375,129.25
"4135","14437","2018",134,76,58,153092.768656716,2102.05223880597,72.1567164179104
"4136","14438","2018",7,7,0,206655.714285714,1933.85714285714,110.142857142857
"4137","14439","2018",2,2,0,132500,1896,73
"4138","14445","2018",1,1,0,90000,957,94
"4139","14449","2018",1,1,0,217000,2411,90
"4140","14452","2018",7,7,0,92585.7142857143,1084.28571428571,84.2857142857143
"4141","14453","2018",10,10,0,135900,1359.6,97.3
"4142","14454","2018",21,21,0,173469.047619048,1959.57142857143,90.8095238095238
"4143","14455","2018",1,1,0,152500,1045,146
"4144","14456","2018",31,30,1,176736.35483871,1968.83870967742,108.064516129032
"4145","14457","2018",1,1,0,80000,800,100
"4146","14458","2018",7,7,0,113922,1116.14285714286,103.142857142857
"4147","14460","2018",19,19,0,150615.789473684,1801,83.9473684210526
"4148","14461","2018",8,8,0,184150,1533.5,122.875
"4149","14465","2018",11,11,0,238927.272727273,1716.54545454545,144.818181818182
"4150","14466","2018",4,4,0,171110.75,1817,95
"4151","14467","2018",1,1,0,167750,1224,137
"4152","14468","2018",3,3,0,149333.333333333,1726,87.6666666666667
"4153","14469","2018",2,2,0,95675,1250,79
"4154","14473","2018",1,1,0,117000,1064,110
"4155","14474","2018",2,2,0,168000,1800,100
"4156","14475","2018",20,20,0,172116.5,1675.05,106.15
"4157","14476","2018",6,6,0,170783.333333333,1843.83333333333,109.833333333333
"4158","14478","2018",23,21,2,85739.1304347826,1030,89.0869565217391
"4159","14480","2018",4,4,0,130412.5,1378.25,93
"4160","14482","2018",1,1,0,152000,2203,69
"4161","14484","2018",4,4,0,257250,4566,73.25
"4162","14486","2018",7,7,0,142000,1250.14285714286,115.857142857143
"4163","14487","2018",6,6,0,160495,1680.83333333333,93.6666666666667
"4164","14488","2018",200,114,86,188632.41,2639.71,74.275
"4165","14492","2018",5,5,0,277600,2184.6,140.2
"4166","14494","2018",2,2,0,220000,1599,153.5
"4167","14495","2018",11,11,0,346114.909090909,2493.90909090909,138.818181818182
"4168","14496","2018",1,1,0,97500,894,109
"4169","14497","2018",2,2,0,82500,1375,85.5
"4170","14498","2018",4,4,0,181250,1254.25,151
"4171","14499","2018",3,3,0,251986.666666667,3295.66666666667,76
"4172","14500","2018",3,3,0,210000,1794.66666666667,123.666666666667
"4173","14501","2018",6,6,0,102467.5,1654.33333333333,81
"4174","14502","2018",2,2,0,84500,1463,57
"4175","14504","2018",11,11,0,237930.363636364,1617.54545454545,138.181818181818
"4176","14506","2018",5,5,0,114720,1042.4,110.6
"4177","14509","2018",5,5,0,147200,1793.2,79
"4178","14510","2018",4,4,0,107625,917.5,131.25
"4179","14511","2018",1,1,0,32300,609,53
"4180","14512","2018",3,3,0,56000,716.333333333333,85.6666666666667
"4181","14514","2018",50,37,13,176318.6,2138,85.12
"4182","14515","2018",39,27,12,161131.282051282,2016.58974358974,80.1025641025641
"4183","14516","2018",22,21,1,111487.772727273,1573.95454545455,74.8181818181818
"4184","14519","2018",1,1,0,248000,1240,200
"4185","14520","2018",6,6,0,171166.666666667,1181.16666666667,143.833333333333
"4186","14522","2018",3,3,0,146333.333333333,1146,124.333333333333
"4187","14524","2018",8,8,0,153875,1387.75,108.625
"4188","14527","2018",6,6,0,194625,1692.5,113.333333333333
"4189","14528","2018",9,9,0,215555.555555556,1958.77777777778,109.222222222222
"4190","14529","2018",1,1,0,75000,852,88
"4191","14530","2018",27,27,0,183627.814814815,1859.48148148148,99.7777777777778
"4192","14534","2018",4,4,0,326375,3075.25,125.25
"4193","14535","2018",9,9,0,191022.222222222,1915,100.777777777778
"4194","14536","2018",29,22,7,214120.344827586,2275.51724137931,94.1724137931034
"4195","14538","2018",25,25,0,210743.2,1944.52,109.96
"4196","14541","2018",1,1,0,165000,2062,80
"4197","14542","2018",6,6,0,326277,1960.16666666667,165.166666666667
"4198","14543","2018",26,26,0,244373.115384615,2067.46153846154,120.153846153846
"4199","14546","2018",1,1,0,115000,1438,80
"4200","14547","2018",3,3,0,243483.333333333,1701.66666666667,134
"4201","14550","2018",3,3,0,314000,2337.66666666667,120
"4202","14552","2018",5,5,0,235700,1961.4,121.8
"4203","14554","2018",13,13,0,200284.615384615,2325.07692307692,91.7692307692308
"4204","14555","2018",10,10,0,217210,1995,118.8
"4205","14556","2018",16,16,0,200359.0625,2213.8125,90.25
"4206","14557","2018",25,16,9,212536.84,2715.16,81
"4207","14558","2018",10,10,0,165360,1880.9,92.3
"4208","14559","2018",3,3,0,118333.333333333,1621.66666666667,82.6666666666667
"4209","14562","2018",57,35,22,182082.964912281,2568.82456140351,72.9298245614035
"4210","14563","2018",9,9,0,180566.666666667,1832.33333333333,105.555555555556
"4211","14565","2018",6,6,0,165983.333333333,2341.5,76.8333333333333
"4212","14566","2018",31,31,0,221316.548387097,2043.1935483871,106.774193548387
"4213","14569","2018",2,2,0,230750,2132,108.5
"4214","14570","2018",39,39,0,131633.487179487,1326.69230769231,103.282051282051
"4215","14571","2018",6,6,0,128833.333333333,1313.66666666667,97.5
"4216","14572","2018",10,10,0,75292,915.6,87.2
"4217","14574","2018",23,23,0,196748.391304348,1704.34782608696,113.478260869565
"4218","14575","2018",9,9,0,243652.222222222,3130.11111111111,91.3333333333333
"4219","14576","2018",5,5,0,119700,1047.2,111.8
"4220","14578","2018",18,18,0,232669.055555556,2408.16666666667,99.5
"4221","14579","2018",13,13,0,200480,1462.30769230769,127.615384615385
"4222","14582","2018",9,9,0,181808.888888889,1603.88888888889,114.555555555556
"4223","14587","2018",18,17,1,199727.777777778,2174,93.3888888888889
"4224","14588","2018",2,2,0,164050,2466.5,66.5
"4225","14589","2018",15,15,0,137226.666666667,1594.86666666667,89.4666666666667
"4226","14590","2018",5,5,0,123860,1066.2,116
"4227","14591","2018",15,15,0,202386.666666667,1677.06666666667,121
"4228","14592","2018",11,11,0,241626.363636364,1773.54545454545,138.727272727273
"4229","14593","2018",6,6,0,232725,2465.5,101
"4230","14595","2018",4,4,0,189000,1872.75,101.5
"4231","14598","2018",1,1,0,240000,1304,184
"4232","14601","2018",2,2,0,262500,1769,164
"4233","14602","2018",4,4,0,127500,1369.5,99.75
"4234","14603","2018",9,9,0,178721.555555556,1661.77777777778,110.222222222222
"4235","14605","2018",5,5,0,226040,2017.4,109.4
"4236","14606","2018",1,1,0,514100,2337,220
"4237","14609","2018",6,6,0,358833.333333333,1871.5,203.666666666667
"4238","14610","2018",25,25,0,216463.04,2044.48,105.76
"4239","14613","2018",2,2,0,149350,1134.5,129.5
"4240","14614","2018",9,9,0,130544.444444444,1148.22222222222,107.444444444444
"4241","14619","2018",1,1,0,148000,1254,118
"4242","14620","2018",3,3,0,156417.333333333,2093,86.6666666666667
"4243","14621","2018",7,7,0,101728.571428571,1064.42857142857,102.857142857143
"4244","14623","2018",25,25,0,198886,2091.08,97.72
"4245","14625","2018",9,9,0,196894.333333333,1866.22222222222,106.888888888889
"4246","14626","2018",13,13,0,139646.153846154,1308.07692307692,112.230769230769
"4247","14627","2018",6,6,0,116517,1630.16666666667,92
"4248","14630","2018",8,8,0,186025,1675.75,108.75
"4249","14637","2018",6,6,0,180383.333333333,1557.83333333333,116.833333333333
"4250","14639","2018",2,2,0,149250,1787,84
"4251","14640","2018",4,4,0,229100,2270,107.5
"4252","14643","2018",13,13,0,121422.461538462,1334.76923076923,90.4615384615385
"4253","14644","2018",5,5,0,206000,1919.2,109.2
"4254","14645","2018",1,1,0,497000,2746,181
"4255","14646","2018",3,3,0,130000,1722,78
"4256","14648","2018",5,5,0,165600,1691.4,101.8
"4257","14649","2018",6,6,0,111083.333333333,977.666666666667,112.333333333333
"4258","14650","2018",3,3,0,138500,1139,125.333333333333
"4259","14651","2018",3,3,0,371133.333333333,2413,154.666666666667
"4260","14652","2018",2,2,0,101800,1144.5,85.5
"4261","14654","2018",91,89,2,133190.153846154,1320.94505494505,106.571428571429
"4262","14656","2018",14,14,0,93053.5714285714,1210.21428571429,76.3571428571429
"4263","14657","2018",5,4,1,179400,2225.2,101.4
"4264","14658","2018",57,55,2,103209.298245614,927.894736842105,111.228070175439
"4265","14659","2018",12,12,0,154525,1482.66666666667,109.583333333333
"4266","14660","2018",1,1,0,530000,1785,297
"4267","14661","2018",4,4,0,116775,1501.75,74
"4268","14663","2018",38,38,0,194173.684210526,1790.47368421053,111
"4269","14664","2018",4,4,0,87125,1117.25,79
"4270","14665","2018",8,8,0,153751.25,1637.5,90.75
"4271","14666","2018",7,7,0,222428.571428571,1944.14285714286,115.714285714286
"4272","14667","2018",7,7,0,110501.428571429,1194.71428571429,84.5714285714286
"4273","14668","2018",4,4,0,179500,1200,136
"4274","14669","2018",3,3,0,53333.3333333333,813.333333333333,66
"4275","14672","2018",4,4,0,115125,1651.25,87.75
"4276","14674","2018",4,4,0,154750,1478.5,109.75
"4277","14675","2018",24,22,2,140118.75,1502.08333333333,101.708333333333
"4278","14676","2018",12,12,0,203976.083333333,2018.83333333333,108.083333333333
"4279","14677","2018",4,4,0,211000,1844.25,117.75
"4280","14678","2018",4,4,0,66000,785,88
"4281","14679","2018",7,7,0,146685.714285714,1712,91.2857142857143
"4282","14680","2018",2,2,0,171000,1072,159.5
"4283","14682","2018",5,5,0,369020,2924.6,131.4
"4284","14684","2018",4,4,0,203075,1686.25,119.25
"4285","14685","2018",38,38,0,171670.526315789,1600.21052631579,107.263157894737
"4286","14687","2018",4,4,0,202225,2296,90
"4287","14689","2018",35,32,3,119875.714285714,1460.8,93.0571428571429
"4288","14692","2018",23,23,0,150206.086956522,1440.60869565217,100.695652173913
"4289","14694","2018",7,7,0,223407.142857143,1951.28571428571,113.142857142857
"4290","14698","2018",1,1,0,310500,2445,127
"4291","14699","2018",120,61,59,187824.575,2528.20833333333,73.1833333333333
"4292","14700","2018",4,4,0,180312.5,1345,133.5
"4293","14701","2018",74,16,58,268285.081081081,3728.02702702703,71.9054054054054
"4294","14706","2018",3,3,0,301246.666666667,2165.66666666667,137.333333333333
"4295","14707","2018",10,10,0,226187,1995,120.9
"4296","14708","2018",3,3,0,169880,1497.66666666667,109.333333333333
"4297","14709","2018",6,6,0,220304.166666667,1755,141.5
"4298","14711","2018",9,9,0,115444.444444444,956,117
"4299","14712","2018",33,30,3,184209.090909091,2056.0303030303,96.6060606060606
"4300","14713","2018",7,7,0,167527.428571429,1642.42857142857,109.285714285714
"4301","14714","2018",10,10,0,156630,1525.2,102.6
"4302","14715","2018",317,102,215,222145.32807571,4031.73501577287,55.7728706624606
"4303","14716","2018",1,1,0,166000,1509,110
"4304","14719","2018",11,11,0,181490.909090909,1422.81818181818,132.090909090909
"4305","14720","2018",15,15,0,138346.666666667,1297.8,105.8
"4306","14721","2018",12,12,0,199358.333333333,1585.16666666667,130
"4307","14723","2018",3,3,0,235413.333333333,2406,114.666666666667
"4308","14724","2018",28,22,6,297985.357142857,3086.28571428571,92.4285714285714
"4309","14726","2018",57,57,0,90541.1754385965,949.982456140351,99.9824561403509
"4310","14728","2018",6,6,0,256800,1757.33333333333,154.5
"4311","14731","2018",4,4,0,281000,2497.5,113.25
"4312","14732","2018",5,5,0,262520,1720,160.8
"4313","14733","2018",3,3,0,177266.666666667,1742.33333333333,94
"4314","14734","2018",5,5,0,215619,1578,149.4
"4315","14735","2018",10,10,0,128650,1209.2,111.5
"4316","14737","2018",2,2,0,150000,1398,109
"4317","14738","2018",35,33,2,220648,2346.02857142857,97.3428571428571
"4318","14739","2018",36,35,1,222686.388888889,2300.19444444444,103.805555555556
"4319","14740","2018",15,15,0,153388.6,1335.46666666667,115.066666666667
"4320","14741","2018",1,1,0,235000,1399,168
"4321","14742","2018",1,1,0,125000,926,135
"4322","14744","2018",4,4,0,167893.75,1684.75,105.75
"4323","14745","2018",7,6,1,139791.428571429,1613.14285714286,85.8571428571429
"4324","14747","2018",6,6,0,195308.333333333,2145,92
"4325","14748","2018",3,3,0,247853.333333333,2028.66666666667,124.666666666667
"4326","14751","2018",3,2,1,79000,924.666666666667,85
"4327","14752","2018",26,22,4,158787.692307692,1653.57692307692,101.115384615385
"4328","14753","2018",5,5,0,143480,1465.2,96.2
"4329","14754","2018",339,56,283,127319.796460177,2980.13274336283,42.0589970501475
"4330","14755","2018",21,15,6,188702.666666667,2559.71428571429,73.8095238095238
"4331","14756","2018",1,1,0,132000,930,142
"4332","14758","2018",4,4,0,176250,1371,140.25
"4333","14759","2018",2,2,0,142500,1260,123.5
"4334","14760","2018",11,11,0,161272.727272727,1727,96.8181818181818
"4335","14761","2018",5,4,1,187570,1836.2,99
"4336","14762","2018",208,150,58,109612.052884615,1199.62019230769,94.5
"4337","14764","2018",10,9,1,91295,1077.5,86.5
"4338","15001","2018",8,8,0,64712.5,1501.625,80.875
"4339","15002","2018",1,1,0,40000,800,50
"4340","15003","2018",7,6,1,69571.4285714286,924.571428571429,78.2857142857143
"4341","15004","2018",3,3,0,173216.666666667,1654.66666666667,104.333333333333
"4342","15005","2018",4,4,0,152950,1292,113.25
"4343","15006","2018",9,9,0,107333.333333333,1054.66666666667,102
"4344","15008","2018",5,5,0,79572,864,97
"4345","15009","2018",1,1,0,60000,500,120
"4346","15010","2018",2,2,0,73554,503,142.5
"4347","15011","2018",2,2,0,92500,973.5,80
"4348","15012","2018",65,54,11,140013.384615385,1526.66153846154,91.9076923076923
"4349","15013","2018",3,3,0,65500,784.333333333333,88.6666666666667
"4350","15014","2018",466,117,349,96794.8583690987,1223.28540772532,77.7274678111588
"4351","15015","2018",3,3,0,51466.6666666667,468,117
"4352","15016","2018",7,7,0,88693.2857142857,1094.85714285714,81
"4353","15017","2018",1,1,0,75000,1014,74
"4354","15018","2018",1,1,0,25000,385,65
"4355","15019","2018",3,3,0,106800,959.333333333333,110.666666666667
"4356","15020","2018",2,2,0,55000,798,69
"4357","15021","2018",7,7,0,83571.4285714286,973.142857142857,90.7142857142857
"4358","15024","2018",1,1,0,43000,782,55
"4359","15025","2018",1,1,0,142989,1589,90
"4360","15027","2018",4,4,0,105625,1082.25,95.25
"4361","15028","2018",2,2,0,142578.5,1438,99
"4362","15029","2018",3,3,0,122000,1068,120
"4363","15030","2018",4,4,0,99862.5,1057,94.5
"4364","15032","2018",3,3,0,34333.3333333333,628,55.3333333333333
"4365","15033","2018",2,2,0,82500,932.5,94.5
"4366","15034","2018",2,2,0,48500,928.5,59
"4367","15036","2018",7,7,0,65103.8571428571,717.857142857143,86.1428571428571
"4368","15037","2018",9,8,1,61811.1111111111,959.333333333333,70.1111111111111
"4369","15038","2018",16,16,0,68196.875,805.375,91.5625
"4370","15040","2018",2,2,0,116000,1002.5,125
"4371","15041","2018",1,1,0,40000,377,106
"4372","15042","2018",3,3,0,54173.3333333333,647.333333333333,84.3333333333333
"4373","15045","2018",7,7,0,70414.2857142857,817.142857142857,88
"4374","15046","2018",3,3,0,115833.333333333,1059.33333333333,141.333333333333
"4375","15049","2018",3,2,1,77500,1087.33333333333,64.3333333333333
"4376","15050","2018",3,3,0,52500,1105.33333333333,48.6666666666667
"4377","15051","2018",1,1,0,55000,611,90
"4378","15052","2018",2,1,1,94500,1625,51.5
"4379","15053","2018",1,1,0,147250,1636,90
"4380","15054","2018",9,8,1,63641.2222222222,916.111111111111,63.8888888888889
"4381","15055","2018",2,2,0,66000,1008,87.5
"4382","15056","2018",4,4,0,172982.5,2098.5,90
"4383","15057","2018",2,2,0,66000,794,80
"4384","15058","2018",1,1,0,54000,1286,42
"4385","15059","2018",1,1,0,81600,816,100
"4386","15063","2018",3,3,0,97366.6666666667,991.333333333333,96.6666666666667
"4387","15066","2018",4,3,1,88587.5,1205,70.25
"4388","15067","2018",1,1,0,162000,2700,60
"4389","15069","2018",5,5,0,73030,1495.6,55.2
"4390","15070","2018",3,3,0,82923.3333333333,966.333333333333,94
"4391","15073","2018",1,1,0,15000,357,42
"4392","15074","2018",3,3,0,155316.666666667,1655.66666666667,87.3333333333333
"4393","15076","2018",3,3,0,51666.6666666667,944.333333333333,56
"4394","15078","2018",2,2,0,108669,1078,95.5
"4395","15079","2018",3,3,0,69316.6666666667,925,71.6666666666667
"4396","15080","2018",2,2,0,88345,1062.5,82
"4397","15081","2018",2,2,0,188000,926,204.5
"4398","15082","2018",3,3,0,63000,667.666666666667,94.6666666666667
"4399","15083","2018",21,20,1,128098.952380952,1395.47619047619,91.9523809523809
"4400","15084","2018",1,1,0,131500,1445,91
"4401","15085","2018",5,5,0,133400,1247.4,106.4
"4402","15087","2018",3,3,0,69166.6666666667,830.333333333333,96
"4403","15088","2018",8,8,0,105632.5,1183.25,94.5
"4404","15089","2018",7,7,0,79807.4285714286,1105,72.7142857142857
"4405","15090","2018",6,6,0,115958.333333333,1248,97
"4406","15091","2018",1,1,0,77500,1384,56
"4407","15092","2018",15,14,1,137493.333333333,1541.66666666667,97.2
"4408","15094","2018",4,3,1,78375,775.5,100
"4409","15095","2018",5,5,0,108010,1097.8,91.8
"4410","15096","2018",6,4,2,111133.333333333,1255.16666666667,85
"4411","15097","2018",1,1,0,15675,373,42
"4412","15098","2018",1,1,0,45500,1167,39
"4413","15101","2018",51,2,49,72220.7450980392,2388.11764705882,31.2549019607843
"4414","15102","2018",1,1,0,35850,358,100
"4415","15103","2018",2,2,0,87200,1384.5,64.5
"4416","15104","2018",2,2,0,71450,805.5,91
"4417","15106","2018",4,4,0,139000,1924.25,85.25
"4418","15107","2018",1,1,0,17000,340,50
"4419","15108","2018",5,5,0,90762,1083.6,83.4
"4420","15110","2018",3,3,0,39433.3333333333,675.333333333333,62.3333333333333
"4421","15111","2018",4,4,0,73250,852.25,82.75
"4422","15112","2018",2,2,0,99260,1162,90
"4423","15113","2018",2,2,0,92975,1271.5,76
"4424","15114","2018",5,4,1,83170,874.2,100.4
"4425","15116","2018",1,1,0,66500,1023,65
"4426","15117","2018",3,3,0,65466.6666666667,727.333333333333,86.6666666666667
"4427","15118","2018",10,10,0,145455,1220,117.7
"4428","15119","2018",24,23,1,106421,1243.54166666667,84.8333333333333
"4429","15120","2018",29,21,8,82951.724137931,1046.20689655172,82.1724137931034
"4430","15122","2018",17,14,3,90981.7647058823,1000.94117647059,91.1176470588235
"4431","15123","2018",2,2,0,87750,1264.5,69
"4432","15124","2018",5,5,0,66380,731,99.8
"4433","15126","2018",1,1,0,20000,556,36
"4434","15127","2018",2,2,0,62500,708.5,88
"4435","15128","2018",3,3,0,66700,672.333333333333,90.3333333333333
"4436","15129","2018",3,3,0,46333.3333333333,795.666666666667,75
"4437","15130","2018",1,1,0,90000,1429,63
"4438","15131","2018",2,2,0,37875,781,51
"4439","15134","2018",7,7,0,111785.714285714,1162.14285714286,91.8571428571429
"4440","15137","2018",2,2,0,79000,933.5,97.5
"4441","15138","2018",19,14,5,113258.421052632,1067.73684210526,104.684210526316
"4442","15140","2018",14,13,1,176303.214285714,1616.78571428571,109.857142857143
"4443","15141","2018",13,12,1,112616.153846154,1075.46153846154,107.769230769231
"4444","15142","2018",22,22,0,92960,955.727272727273,98.5454545454545
"4445","15144","2018",1,1,0,223700,3196,70
"4446","15146","2018",1,1,0,280000,1931,145
"4447","15147","2018",5,5,0,70000,770,94
"4448","15148","2018",3,3,0,89883.3333333333,927.333333333333,98.3333333333333
"4449","15149","2018",3,3,0,68940,918,81
"4450","15151","2018",2,2,0,50500,556,90
"4451","15153","2018",14,13,1,95583.8571428571,1040.64285714286,91.7142857142857
"4452","15154","2018",11,10,1,116636.363636364,1326.63636363636,94.8181818181818
"4453","15155","2018",2,2,0,46500,773,58.5
"4454","15156","2018",3,3,0,153666.666666667,1526,103.666666666667
"4455","15157","2018",1,1,0,74991,714,105
"4456","15159","2018",4,4,0,60050,744.75,80.25
"4457","15160","2018",8,8,0,107887.25,1224.75,87
"4458","15161","2018",1,1,0,42500,425,100
"4459","15162","2018",24,19,5,84965.4583333333,947.458333333333,90.4583333333333
"4460","15163","2018",6,6,0,162766.666666667,2070.5,85
"4461","15164","2018",3,3,0,122050,1300,98.6666666666667
"4462","15165","2018",2,2,0,121000,1411.5,98
"4463","15167","2018",1,1,0,151000,3356,45
"4464","15168","2018",7,7,0,139205,1382.71428571429,100.714285714286
"4465","15169","2018",7,6,1,90857.1428571429,1035.57142857143,95.5714285714286
"4466","15170","2018",2,1,1,53228,838,64
"4467","15172","2018",2,2,0,71500,982,65.5
"4468","15173","2018",4,4,0,92325,1292,75.5
"4469","15174","2018",2,2,0,60000,699.5,86.5
"4470","15175","2018",10,10,0,84848,828.7,95.4
"4471","15176","2018",1,1,0,105000,583,180
"4472","15178","2018",3,3,0,60000,1085.33333333333,70.3333333333333
"4473","15179","2018",1,1,0,50000,485,103
"4474","15180","2018",1,1,0,124900,1419,88
"4475","15181","2018",5,5,0,129330,1378.2,106.6
"4476","15182","2018",1,1,0,133971,1558,86
"4477","15183","2018",1,1,0,150090,1668,90
"4478","15184","2018",6,6,0,93933.3333333333,1112.83333333333,80.6666666666667
"4479","15185","2018",6,6,0,79556.6666666667,1476.5,63
"4480","15186","2018",4,4,0,100980,902,126.75
"4481","15187","2018",71,45,26,128699.690140845,1480.18309859155,88.7042253521127
"4482","15188","2018",3,2,1,132666.666666667,1759.66666666667,78.6666666666667
"4483","15189","2018",7,7,0,148615.714285714,1526.85714285714,103.285714285714
"4484","15190","2018",1,1,0,93100,665,140
"4485","15191","2018",6,6,0,98781.3333333333,1199,78.6666666666667
"4486","15192","2018",10,7,3,99700,1255.2,75
"4487","15194","2018",1,1,0,218500,1438,152
"4488","15196","2018",13,13,0,144950.153846154,1368.07692307692,112
"4489","15198","2018",2,2,0,54500,780.5,69
"4490","15201","2018",2,2,0,52500,946.5,57
"4491","15202","2018",12,12,0,108862.083333333,1045.66666666667,108.75
"4492","15203","2018",1,1,0,1e+05,746,134
"4493","15204","2018",13,13,0,132596.538461538,1511.07692307692,91.9230769230769
"4494","15206","2018",1,1,0,25000,625,40
"4495","15207","2018",1,1,0,37000,336,110
"4496","15208","2018",4,4,0,59175,1294.5,54.75
"4497","15211","2018",5,5,0,97900,967.8,116.8
"4498","15212","2018",2,2,0,157000,1051,150
"4499","15214","2018",1,1,0,125250,1204,104
"4500","15215","2018",13,13,0,150165.384615385,1476,100.307692307692
"4501","15216","2018",3,3,0,53500,813,61
"4502","15217","2018",2,2,0,245078.5,2317,101
"4503","15218","2018",3,3,0,120638,1140.66666666667,121.666666666667
"4504","15219","2018",5,4,1,89160,1112.4,88
"4505","15220","2018",3,3,0,75093.3333333333,1168.33333333333,66.6666666666667
"4506","15221","2018",13,13,0,132033.846153846,1352.61538461538,97.2307692307692
"4507","15222","2018",1,1,0,1e+05,1515,66
"4508","15224","2018",1,1,0,85000,1518,56
"4509","15225","2018",3,3,0,87280,982.333333333333,86
"4510","15226","2018",5,5,0,61100,992.8,69
"4511","15228","2018",3,3,0,85666.6666666667,852.333333333333,100
"4512","15229","2018",1,1,0,45000,1500,30
"4513","15230","2018",4,4,0,95705,1077.5,94
"4514","15231","2018",5,5,0,99120,906,111.6
"4515","15232","2018",3,3,0,128266.666666667,991.666666666667,131
"4516","15233","2018",2,2,0,111975,1134,107.5
"4517","15234","2018",2,2,0,170500,1547.5,110.5
"4518","15235","2018",5,5,0,133520,1230.8,117.6
"4519","15236","2018",10,10,0,132775,1185.8,109
"4520","15238","2018",4,4,0,116862.5,1128.75,99.5
"4521","15240","2018",1,1,0,52000,1040,50
"4522","15241","2018",1,1,0,113850,1198,95
"4523","15242","2018",2,2,0,178750,1749,102.5
"4524","15243","2018",3,3,0,52166.6666666667,475.333333333333,103.666666666667
"4525","15244","2018",4,4,0,76324,948.25,93.25
"4526","15247","2018",1,1,0,50000,877,57
"4527","15248","2018",11,11,0,131941.909090909,1074,127
"4528","15249","2018",1,1,0,180000,1224,147
"4529","15250","2018",3,3,0,38500,601.666666666667,76.6666666666667
"4530","15252","2018",7,7,0,123801.428571429,1240.28571428571,100.714285714286
"4531","15255","2018",9,8,1,126314.444444444,1365.44444444444,89.8888888888889
"4532","15256","2018",3,3,0,69324,640,115.333333333333
"4533","15257","2018",3,3,0,119333.333333333,1056.33333333333,115
"4534","15258","2018",15,10,5,117252,1137.4,100.466666666667
"4535","15261","2018",8,8,0,74978.5,807.75,91.75
"4536","15262","2018",1,0,1,18000,429,42
"4537","15263","2018",1,1,0,110000,1294,85
"4538","15264","2018",2,2,0,224117.5,1376,164
"4539","15265","2018",12,12,0,79441.6666666667,924.166666666667,91.1666666666667
"4540","15266","2018",4,4,0,145500,1418.75,100.75
"4541","15267","2018",40,38,2,163987.3,1558.3,108.4
"4542","15268","2018",14,13,1,75949.3571428571,954.357142857143,91.2142857142857
"4543","15269","2018",2,2,0,54000,627.5,86.5
"4544","16001","2018",7,7,0,111779.285714286,808.714285714286,136.285714285714
"4545","16002","2018",6,6,0,66933.3333333333,772.5,82.3333333333333
"4546","16003","2018",15,15,0,112251.466666667,1025.4,103.466666666667
"4547","16005","2018",19,19,0,100977.894736842,894.736842105263,113.684210526316
"4548","16007","2018",5,5,0,81118.2,882.4,87.8
"4549","16008","2018",4,4,0,131750,947.25,151.5
"4550","16009","2018",7,7,0,38492.8571428571,481.714285714286,79.8571428571429
"4551","16011","2018",7,7,0,119485.714285714,1224,101
"4552","16012","2018",9,9,0,164529.777777778,1110.77777777778,163.333333333333
"4553","16013","2018",3,3,0,105333.333333333,1708,64.3333333333333
"4554","16015","2018",681,439,242,115977.044052863,1381.27019089574,85.1864904552129
"4555","16016","2018",10,10,0,63295,872.1,78.7
"4556","16018","2018",4,4,0,138800,1115.25,126
"4557","16019","2018",14,14,0,135743.571428571,1238.71428571429,112.285714285714
"4558","16020","2018",8,8,0,180159.75,1385.875,124
"4559","16023","2018",15,15,0,97282.2,976.133333333333,101.333333333333
"4560","16024","2018",4,4,0,114926.75,1035.25,114
"4561","16025","2018",10,9,1,121580,1029.7,129
"4562","16026","2018",19,19,0,131574.210526316,1452.36842105263,92.2105263157895
"4563","16028","2018",51,48,3,106477.37254902,1051.43137254902,104.529411764706
"4564","16029","2018",3,3,0,161333.333333333,1131.33333333333,137.333333333333
"4565","16030","2018",11,11,0,159545.909090909,1159,133.545454545455
"4566","16031","2018",6,6,0,142833.333333333,1477.83333333333,99.6666666666667
"4567","16032","2018",5,5,0,257926,1989.2,137.4
"4568","16034","2018",3,3,0,72833.3333333333,792.333333333333,93.3333333333333
"4569","16035","2018",6,6,0,56683.3333333333,636,85.8333333333333
"4570","16036","2018",2,2,0,114500,1201,96
"4571","16037","2018",5,5,0,198700,1640.8,115.4
"4572","16038","2018",5,5,0,85400,715,110.6
"4573","16039","2018",4,4,0,94925,825,120.25
"4574","16040","2018",4,4,0,186719,976.5,169
"4575","16042","2018",1,1,0,47000,480,98
"4576","16044","2018",2,2,0,48250,588,87
"4577","16045","2018",2,2,0,117400,1151,105.5
"4578","16046","2018",7,7,0,119378.571428571,1056.14285714286,116.857142857143
"4579","16047","2018",2,2,0,118850,1082.5,108
"4580","16048","2018",1,1,0,138000,1278,108
"4581","16049","2018",8,8,0,191891.875,1561,127.375
"4582","16050","2018",1,1,0,155000,1192,130
"4583","16052","2018",3,3,0,45000,553,81.3333333333333
"4584","16055","2018",18,18,0,139533.333333333,1210.16666666667,114.277777777778
"4585","16056","2018",11,11,0,154213.181818182,1368.09090909091,103.454545454545
"4586","16057","2018",1,1,0,123000,879,140
"4587","16058","2018",28,28,0,160673.678571429,1441.78571428571,110.678571428571
"4588","16059","2018",6,6,0,44296.6666666667,536.666666666667,84
"4589","16060","2018",2,2,0,83500,1026.5,73
"4590","16061","2018",30,30,0,145967.466666667,1279.1,121.3
"4591","16062","2018",1,1,0,186000,1398,133
"4592","16063","2018",3,3,0,136500,1190,118.333333333333
"4593","16064","2018",14,14,0,97677.8571428571,1065.21428571429,92.4285714285714
"4594","16065","2018",10,10,0,66880,736.2,92.6
"4595","16066","2018",8,8,0,87465,888.25,102.25
"4596","16067","2018",6,6,0,112933.333333333,1089.5,96.5
"4597","16068","2018",7,7,0,104821.428571429,860.571428571429,124.571428571429
"4598","16069","2018",3,3,0,73666.6666666667,887.333333333333,101.666666666667
"4599","16070","2018",27,26,1,76466.8518518519,963.851851851852,84.4444444444444
"4600","16071","2018",5,5,0,112377,993.8,115.6
"4601","16072","2018",2,2,0,148500,877.5,170
"4602","16073","2018",22,21,1,87305.9090909091,1017.81818181818,85.8181818181818
"4603","16074","2018",3,3,0,187000,1040.33333333333,171
"4604","16076","2018",11,11,0,76343,965.909090909091,82.5454545454545
"4605","16077","2018",3,3,0,152500,1458,114.333333333333
"4606","16078","2018",51,51,0,153244.705882353,1438.78431372549,108.549019607843
"4607","16079","2018",4,4,0,74020,903,99.25
"4608","16081","2018",2,2,0,115750,859,124.5
"4609","16082","2018",3,3,0,167440,1555,107
"4610","16083","2018",5,5,0,79852,818.4,97.2
"4611","16084","2018",9,8,1,124033.333333333,1388.11111111111,95.4444444444444
"4612","16085","2018",38,36,2,93697.8947368421,1022.65789473684,91.2894736842105
"4613","16086","2018",11,11,0,53318.1818181818,652.636363636364,78.5454545454545
"4614","16087","2018",2,2,0,45500,1053.5,55.5
"4615","16088","2018",18,18,0,153471.722222222,1204.88888888889,122.777777777778
"4616","16089","2018",46,45,1,154893.695652174,1563.76086956522,101.586956521739
"4617","16090","2018",45,41,4,118572.511111111,1026.6,117.777777777778
"4618","16091","2018",2,2,0,103555,1002.5,104.5
"4619","16093","2018",23,23,0,123519.130434783,1208.17391304348,102.304347826087
"4620","16095","2018",1,1,0,131479,837,157
"4621","16096","2018",6,6,0,104333.333333333,1793.83333333333,65.3333333333333
"4622","16097","2018",35,34,1,137020.314285714,1219.6,118.371428571429
"4623","16098","2018",1,1,0,39000,1147,34
"4624","16099","2018",2,2,0,102500,1296,79
"4625","16100","2018",7,7,0,126179.285714286,959.428571428571,128.285714285714
"4626","16101","2018",4,4,0,153075,1201,135.75
"4627","16102","2018",316,255,61,124145.158227848,1303.53164556962,93.753164556962
"4628","16103","2018",2,2,0,77500,1016.5,76
"4629","16104","2018",3,3,0,135961.666666667,1062.66666666667,137.666666666667
"4630","16105","2018",7,7,0,152628.571428571,1089.42857142857,131.571428571429
"4631","16106","2018",30,30,0,89013.3333333333,940.966666666667,94
"4632","16107","2018",7,7,0,104695.714285714,913.571428571429,112.142857142857
"4633","16108","2018",1,1,0,95500,796,120
"4634","16109","2018",10,10,0,120193.3,1203.3,105.6
"4635","16110","2018",6,5,1,117133.333333333,1261.5,101.5
"4636","16111","2018",3,3,0,112920.666666667,931,139
"4637","16112","2018",1,1,0,115000,1173,98
"4638","16113","2018",69,66,3,126572.507246377,1401.02898550725,93.231884057971
"4639","16114","2018",2,2,0,66150,440.5,150
"4640","16116","2018",2,2,0,167750,1523.5,101.5
"4641","16117","2018",2,2,0,127250,934,132
"4642","16119","2018",11,11,0,107935,1156.54545454545,92.5454545454545
"4643","16120","2018",7,7,0,139971.428571429,1232,112.714285714286
"4644","16121","2018",4,4,0,111550,1195.25,89
"4645","16122","2018",1,1,0,35000,461,76
"4646","16123","2018",4,4,0,180275,1512.75,123.5
"4647","16124","2018",15,15,0,117678.666666667,1001.13333333333,112.066666666667
"4648","16125","2018",3,3,0,126333.333333333,1021.66666666667,135.666666666667
"4649","16127","2018",1,1,0,50000,543,92
"4650","16128","2018",2,2,0,80500,953,86.5
"4651","16130","2018",4,4,0,145730,1297.5,111.25
"4652","16131","2018",6,6,0,97491.6666666667,1169.83333333333,86
"4653","16132","2018",7,7,0,93713.8571428571,1010.57142857143,94.2857142857143
"4654","16133","2018",1,1,0,262000,1638,160
"4655","16134","2018",10,10,0,104151.1,1082.7,97.2
"4656","16135","2018",2,2,0,69375,738.5,96
"4657","16136","2018",6,6,0,79299.6666666667,686.666666666667,115
"4658","16137","2018",4,4,0,127375,1179.25,124.75
"4659","16138","2018",40,39,1,164408.25,1502.325,110.8
"4660","16139","2018",1,1,0,82000,854,96
"4661","16140","2018",2,2,0,92500,698.5,141.5
"4662","16141","2018",5,5,0,83857,1029.6,90.8
"4663","16142","2018",3,3,0,92966.6666666667,1065.33333333333,93.6666666666667
"4664","16143","2018",6,6,0,125404.166666667,1104.66666666667,113
"4665","16144","2018",6,6,0,97683.3333333333,1148.16666666667,89.3333333333333
"4666","16145","2018",8,8,0,155261.25,1264.625,117.5
"4667","16146","2018",19,19,0,158005.947368421,1564.42105263158,108.631578947368
"4668","16147","2018",1,1,0,64700,1470,44
"4669","16148","2018",10,10,0,114400,919.3,117.9
"4670","16150","2018",24,24,0,160918.125,1434.79166666667,117.375
"4671","16151","2018",6,6,0,150450,1325.16666666667,119.333333333333
"4672","16152","2018",9,9,0,138433.333333333,1170.33333333333,121.888888888889
"4673","16153","2018",16,16,0,146245,1264.125,132.875
"4674","16154","2018",95,80,15,114618.842105263,1289.21052631579,89.6
"4675","16157","2018",3,3,0,91000,990.333333333333,83
"4676","16158","2018",4,4,0,100875,1073.5,93.25
"4677","16160","2018",10,10,0,83215.3,910.7,103.8
"4678","16161","2018",1,1,0,32500,903,36
"4679","16163","2018",13,13,0,125230.769230769,1223.30769230769,110.538461538462
"4680","16164","2018",4,4,0,83987.5,1003.75,80.5
"4681","16165","2018",5,5,0,130985.6,1223,110.8
"4682","16166","2018",62,56,6,120595.564516129,1389.03225806452,88.0967741935484
"4683","16167","2018",77,73,4,123345.454545455,1248.97402597403,98.038961038961
"4684","16168","2018",7,7,0,110257.142857143,948.857142857143,126
"4685","16169","2018",9,9,0,152544.444444444,2062.44444444444,112.333333333333
"4686","16170","2018",1,1,0,128000,1391,92
"4687","16171","2018",12,12,0,154783.333333333,1154.83333333333,127.916666666667
"4688","16173","2018",2,2,0,116750,1086,108
"4689","16174","2018",5,5,0,129614,1252.4,107.8
"4690","16175","2018",8,8,0,166337.5,1427.875,116.5
"4691","16176","2018",3,3,0,100233.333333333,1064.66666666667,95.6666666666667
"4692","16177","2018",3,3,0,94333.3333333333,841.333333333333,114.666666666667
"4693","16178","2018",1,1,0,130000,890,146
"4694","16180","2018",5,5,0,109596.2,1004.6,106.8
"4695","16181","2018",4,4,0,71750,726,106.5
"4696","16182","2018",7,7,0,91803.8571428571,971.571428571429,107.142857142857
"4697","16183","2018",1,1,0,35000,402,87
"4698","16184","2018",1,1,0,47500,731,65
"4699","16185","2018",3,3,0,162700,1227.33333333333,131
"4700","16186","2018",1,1,0,154250,941,164
"4701","16187","2018",24,24,0,137914,1265.66666666667,104.041666666667
"4702","16188","2018",6,6,0,202071.333333333,1538.66666666667,156.833333333333
"4703","16189","2018",4,4,0,112000,799.75,153.5
"4704","16190","2018",5,5,0,126425,1372.2,108.8
"4705","16191","2018",2,2,0,72500,614.5,105
"4706","16192","2018",43,43,0,78880.1860465116,862.046511627907,96.8604651162791
"4707","16193","2018",12,12,0,156841.666666667,1250.5,126
"4708","16194","2018",2,2,0,35000,889.5,39.5
"4709","16195","2018",2,2,0,125000,1300,96
"4710","16196","2018",7,7,0,78594.2857142857,786.428571428571,101.142857142857
"4711","16197","2018",3,3,0,111583.333333333,1327,87.6666666666667
"4712","16199","2018",36,36,0,116342.25,1295.11111111111,88.8333333333333
"4713","16200","2018",4,4,0,141140,1220.75,117.75
"4714","16203","2018",3,3,0,94076.6666666667,1018.66666666667,98
"4715","16204","2018",10,10,0,126660,1021.7,131.2
"4716","16205","2018",7,7,0,101938.571428571,769.571428571429,123.428571428571
"4717","16206","2018",18,17,1,100654.166666667,951.611111111111,107.777777777778
"4718","16207","2018",5,5,0,88300,1005.8,96.4
"4719","16208","2018",3,3,0,124100,971.666666666667,128
"4720","16209","2018",6,6,0,117835,1114.83333333333,115.5
"4721","16210","2018",6,6,0,115750,1031.66666666667,122.5
"4722","16211","2018",6,6,0,124133.333333333,1311.5,102.833333333333
"4723","16212","2018",3,3,0,123033.333333333,1213.66666666667,103
"4724","16213","2018",3,3,0,81666.6666666667,825,91.6666666666667
"4725","16215","2018",1,1,0,20000,444,45
"4726","16216","2018",3,3,0,159833.333333333,1253.66666666667,136.666666666667
"4727","16217","2018",15,15,0,164005.733333333,1421.53333333333,122.8
"4728","16218","2018",3,3,0,143666.666666667,1485.33333333333,98
"4729","16220","2018",11,11,0,201172.727272727,1254.45454545455,153.363636363636
"4730","16221","2018",2,2,0,114965,1144,102
"4731","16222","2018",3,3,0,69317.3333333333,723,94.6666666666667
"4732","16223","2018",27,27,0,92548.1481481481,939.666666666667,101.62962962963
"4733","16224","2018",4,4,0,164650,1317.25,131.25
"4734","16225","2018",7,7,0,116671.428571429,1127.85714285714,109.285714285714
"4735","16226","2018",7,7,0,143018.285714286,1185.42857142857,122.142857142857
"4736","16227","2018",3,3,0,153746,1081.33333333333,156
"4737","16229","2018",6,6,0,112508.333333333,815,133.166666666667
"4738","16230","2018",18,18,0,104791.666666667,956,110.111111111111
"4739","16232","2018",14,14,0,146933.571428571,1429.71428571429,103.214285714286
"4740","16233","2018",4,4,0,140637.5,1278,117.25
"4741","16234","2018",2,2,0,83000,924,93.5
"4742","16236","2018",15,15,0,151173,1216.26666666667,119.066666666667
"4743","16237","2018",2,2,0,281000,868,243
"4744","16239","2018",3,3,0,64666.6666666667,669.666666666667,96.3333333333333
"4745","16240","2018",1,1,0,740533,1964,377
"4746","16241","2018",6,6,0,160800,1273.66666666667,136.166666666667
"4747","16242","2018",23,23,0,91790.3913043478,848.130434782609,107.304347826087
"4748","16243","2018",8,8,0,158275,1293.375,127.875
"4749","16244","2018",23,20,3,109380.391304348,1213.30434782609,88.5217391304348
"4750","16245","2018",6,6,0,87999.8333333333,865.666666666667,109
"4751","16246","2018",1,1,0,41284,379,109
"4752","16248","2018",2,2,0,99500,618,162.5
"4753","16249","2018",3,3,0,135192,1219.33333333333,111.666666666667
"4754","16250","2018",1,1,0,68500,685,100
"4755","16251","2018",3,3,0,97666.6666666667,879,105
"4756","16252","2018",1,1,0,2e+05,3390,59
"4757","16253","2018",4,4,0,104325,928.25,108.25
"4758","16254","2018",3,3,0,122333.333333333,967.333333333333,128
"4759","16255","2018",2,2,0,112000,1227,90
"4760","16256","2018",4,4,0,137250,1159,115.25
"4761","16258","2018",5,5,0,144056,1157,122.6
"4762","16260","2018",3,3,0,156666.666666667,1436.33333333333,110.333333333333
"4763","16261","2018",4,4,0,129150,1180,124.5
"4764","16263","2018",4,4,0,120250,1317.5,91.5
"4765","16264","2018",5,5,0,82000,872.4,89.2
"4766","16269","2018",5,5,0,142000,1207.2,118.4
"4767","16270","2018",5,5,0,68050,1011,70.2
"4768","16271","2018",25,25,0,172812.88,1621.24,105.48
"4769","16272","2018",9,9,0,127828.888888889,1205.88888888889,108.333333333333
"4770","16275","2018",7,7,0,86267.1428571429,947.714285714286,95.2857142857143
"4771","16276","2018",4,4,0,114412.5,1039,107.75
"4772","16277","2018",4,4,0,106250,937.5,111.5
"4773","16279","2018",4,4,0,103882.5,1230.5,86.25
"4774","16280","2018",13,13,0,101071.153846154,1064.53846153846,97
"4775","16281","2018",52,47,5,111484.865384615,1317.98076923077,97.0576923076923
"4776","16282","2018",2,2,0,99750,945,106
"4777","16283","2018",4,4,0,95982,1003,98.5
"4778","16284","2018",5,5,0,226355,1176,201.2
"4779","16285","2018",7,7,0,105857.142857143,1104.57142857143,97.4285714285714
"4780","16286","2018",36,35,1,117039.583333333,1005.83333333333,119.861111111111
"4781","16287","2018",50,50,0,149855.78,1468.32,104.24
"4782","16289","2018",7,7,0,110000,939.714285714286,118.857142857143
"4783","16290","2018",6,6,0,154980,1092.33333333333,145
"4784","16291","2018",126,123,3,114097.166666667,1300.65079365079,87.1587301587302
"4785","16292","2018",43,42,1,88365.1162790698,1017.51162790698,89.6511627906977
"4786","16293","2018",8,8,0,128862.5,1194,110.875
"4787","16295","2018",12,12,0,131438.333333333,1035.66666666667,121.583333333333
"4788","16297","2018",1,1,0,164083,1657,99
"4789","16298","2018",9,9,0,160455.555555556,1252.44444444444,131.444444444444
"4790","16300","2018",22,22,0,106386.136363636,995.136363636364,112.454545454545
"4791","16301","2018",1,1,0,30000,361,83
"4792","16302","2018",3,3,0,143333.333333333,994.333333333333,143
"4793","16303","2018",6,6,0,134466.666666667,1299.16666666667,103.833333333333
"4794","16304","2018",12,12,0,200020.833333333,1686.75,122.916666666667
"4795","16306","2018",3,3,0,53150,967.333333333333,57.6666666666667
"4796","16307","2018",3,3,0,155016.666666667,1444.66666666667,98
"4797","16308","2018",11,11,0,103771.363636364,881.272727272727,117.363636363636
"4798","16310","2018",1,1,0,62000,1127,55
"4799","16312","2018",5,5,0,112119,1203.2,109.8
"4800","16315","2018",2,2,0,67500,1270.5,51
"4801","16316","2018",5,5,0,122400,1095.4,102.6
"4802","16317","2018",5,5,0,77400,866.2,90.4
"4803","16318","2018",2,2,0,91425,1328,84
"4804","16320","2018",11,11,0,112542.727272727,928.454545454545,126.090909090909
"4805","16321","2018",1,1,0,45000,489,92
"4806","16323","2018",3,3,0,85666.6666666667,868.333333333333,95.6666666666667
"4807","16325","2018",4,4,0,47547.5,498,83.5
"4808","16326","2018",1,1,0,72369,439,165
"4809","16329","2018",8,8,0,103783.5,1013.375,109.875
"4810","16330","2018",10,10,0,166996.4,1457.9,119.1
"4811","16331","2018",1,1,0,179000,1543,116
"4812","16334","2018",1,1,0,122000,931,131
"4813","16335","2018",3,3,0,69333.3333333333,675.333333333333,101
"4814","16336","2018",2,2,0,107025,820.5,129.5
"4815","16337","2018",11,11,0,58363.6363636364,718.272727272727,91.4545454545455
"4816","16338","2018",2,2,0,66500,754.5,73.5
"4817","16339","2018",6,6,0,109966.166666667,842.166666666667,132
"4818","16340","2018",20,20,0,170856,1357.65,133.4
"4819","16341","2018",46,37,9,109789.130434783,1306.97826086957,86.5434782608696
"4820","16342","2018",3,3,0,131266.666666667,1574,84.3333333333333
"4821","16345","2018",3,3,0,61833.3333333333,1047.66666666667,88.3333333333333
"4822","16346","2018",3,3,0,167600,1430,116.333333333333
"4823","16347","2018",6,6,0,118914.333333333,1115.66666666667,109.666666666667
"4824","16348","2018",11,11,0,162567.636363636,1432.63636363636,115.545454545455
"4825","16349","2018",4,4,0,143668.75,1128,115.75
"4826","16350","2018",13,13,0,133082.384615385,1202.07692307692,113.153846153846
"4827","16352","2018",4,4,0,74625,855.25,89.5
"4828","16353","2018",8,8,0,97312.5,1002.375,103.875
"4829","16355","2018",11,11,0,147338,1181.72727272727,126.727272727273
"4830","16358","2018",76,76,0,145633.776315789,1470.43421052632,98.2631578947368
"4831","16359","2018",13,13,0,137064.230769231,1124.38461538462,123.615384615385
"4832","16360","2018",3,3,0,96950,1359,72.3333333333333
"4833","16361","2018",3,3,0,154000,1042,154.333333333333
"4834","16362","2018",3,3,0,33283.3333333333,561.666666666667,60.3333333333333
"4835","16363","2018",7,7,0,102085.714285714,1064.57142857143,95.2857142857143
"4836","16366","2018",20,20,0,135258.25,1197.85,119.2
"4837","16368","2018",6,6,0,111481.666666667,1482.66666666667,77.5
"4838","16369","2018",13,13,0,142280.538461538,1077.23076923077,136.692307692308
"4839","16370","2018",12,12,0,131008.333333333,1214.5,113.5
"4840","16372","2018",2,2,0,103760.5,750.5,121.5
"4841","16374","2018",87,79,8,132922.816091954,1320.08045977011,97.0344827586207
"4842","16375","2018",4,4,0,139400,1036,125
"4843","16378","2018",8,7,1,97687.5,1226.625,86.125
"4844","16379","2018",22,22,0,98931.8181818182,1001.63636363636,96.3181818181818
"4845","16380","2018",5,5,0,128040,1125.8,130
"4846","16381","2018",3,3,0,166000,1296,143.333333333333
"4847","16382","2018",7,7,0,145314.285714286,1334.57142857143,104.142857142857
"4848","16383","2018",10,10,0,118359,1138.5,107.3
"4849","16384","2018",10,10,0,111422.5,1093.7,106.9
"4850","16385","2018",12,12,0,140011.166666667,1352.33333333333,102.666666666667
"4851","16387","2018",4,4,0,120788.75,1248.75,96
"4852","16388","2018",8,8,0,146734.375,1544.75,96.25
"4853","16389","2018",1,1,0,70000,1148,61
"4854","16390","2018",1,1,0,195000,1773,110
"4855","16392","2018",3,3,0,49000,830.666666666667,65.3333333333333
"4856","16393","2018",19,19,0,134155,1273.78947368421,110.105263157895
"4857","16394","2018",1,1,0,181500,1452,125
"4858","16396","2018",5,5,0,161300,984.6,153.6
"4859","16397","2018",4,4,0,38000,601,56.25
"4860","16398","2018",2,2,0,66250,984,68
"4861","16399","2018",1,1,0,278000,1324,210
"4862","16400","2018",12,12,0,99622.9166666667,999.25,105.333333333333
"4863","16401","2018",2,2,0,116000,1148.5,101
"4864","16402","2018",8,8,0,115531.25,1194.5,99.625
"4865","16403","2018",5,5,0,89604,811,108.2
"4866","16405","2018",2,2,0,50000,489.5,104.5
"4867","16406","2018",8,8,0,104839.75,1163.25,96.625
"4868","16408","2018",10,10,0,132690,1096.7,135
"4869","16409","2018",8,8,0,95700,735.625,127.875
"4870","16412","2018",6,6,0,148691.666666667,1127,138.833333333333
"4871","16413","2018",3,3,0,91000,667.666666666667,139.666666666667
"4872","16414","2018",3,3,0,89000,1022.33333333333,91
"4873","16415","2018",10,10,0,171155,1410.4,126.6
"4874","16416","2018",6,6,0,101951.833333333,928.666666666667,107.5
"4875","16418","2018",12,12,0,187411.666666667,1434.5,135.25
"4876","16419","2018",1,1,0,15000,500,30
"4877","16420","2018",4,4,0,134500,1241,111.25
"4878","16421","2018",2,2,0,122000,1101.5,115
"4879","16422","2018",13,13,0,127639.615384615,1152.61538461538,109.769230769231
"4880","16423","2018",4,4,0,98977.5,1272,85.25
"4881","16424","2018",4,4,0,128250,966.75,119.25
"4882","16425","2018",6,6,0,135333.333333333,1319.16666666667,109.833333333333
"4883","17002","2018",1,1,0,118720,950,125
"4884","17003","2018",61,61,0,190718.360655738,1936.2131147541,97.8524590163934
"4885","17004","2018",3,3,0,425333.333333333,6577,63.3333333333333
"4886","17005","2018",1,1,0,140000,1239,113
"4887","17006","2018",2,2,0,132500,994,130
"4888","17007","2018",6,6,0,190475,1363.5,141
"4889","17008","2018",28,28,0,233301.428571429,2094.17857142857,113.642857142857
"4890","17009","2018",21,21,0,202055.095238095,1933,105.095238095238
"4891","17010","2018",64,63,1,310095.65625,3000.953125,102.484375
"4892","17011","2018",4,4,0,107375,1051,99.5
"4893","17012","2018",2,2,0,158685,1297.5,120
"4894","17013","2018",3,3,0,109008,965.666666666667,124.666666666667
"4895","17015","2018",15,15,0,161862.666666667,1305.46666666667,118.466666666667
"4896","17016","2018",8,8,0,98437.5,1154.625,89.25
"4897","17017","2018",14,14,0,107432.142857143,1092,98.2142857142857
"4898","17018","2018",16,16,0,179466.25,1544.9375,122.125
"4899","17019","2018",41,40,1,466352.926829268,5498,87.8536585365854
"4900","17020","2018",3,3,0,100338.333333333,855,125.333333333333
"4901","17021","2018",57,50,7,178729.789473684,1896.71929824561,95.7894736842105
"4902","17022","2018",14,14,0,113382.142857143,1212.71428571429,96.9285714285714
"4903","17023","2018",2,2,0,102500,946.5,107.5
"4904","17024","2018",24,21,3,120850.5,1332.70833333333,110.25
"4905","17025","2018",7,7,0,124042.857142857,938,126.571428571429
"4906","17026","2018",5,5,0,135374.6,934.4,152
"4907","17027","2018",9,9,0,147166.666666667,1245.66666666667,135.777777777778
"4908","17028","2018",185,94,91,186294.972972973,2801.67027027027,69.8918918918919
"4909","17029","2018",4,4,0,188424.25,1461,127.25
"4910","17030","2018",5,5,0,112000,1231.6,95.6
"4911","17031","2018",1,1,0,85000,810,105
"4912","17032","2018",10,10,0,185015,1650.7,107
"4913","17033","2018",6,6,0,141166.666666667,1264.66666666667,122
"4914","17034","2018",13,13,0,132150,1957.30769230769,70.1538461538462
"4915","17035","2018",1,1,0,74000,771,96
"4916","17036","2018",8,8,0,195216.875,1375.875,148.5
"4917","17037","2018",8,8,0,95125,899.125,107.25
"4918","17038","2018",2,2,0,86500,874.5,106
"4919","17039","2018",1,1,0,170000,1318,129
"4920","17041","2018",23,23,0,157740.869565217,1541.34782608696,102.260869565217
"4921","17042","2018",6,6,0,163566.833333333,1987.83333333333,95
"4922","17043","2018",14,14,0,111564.285714286,991.071428571429,104.928571428571
"4923","17044","2018",16,16,0,156011.9375,1438.1875,112.875
"4924","17045","2018",9,9,0,164091.111111111,1246.55555555556,135.333333333333
"4925","17046","2018",5,5,0,120410,954.4,126.4
"4926","17047","2018",1,1,0,1e+05,1235,81
"4927","17048","2018",4,4,0,162000,1013.75,170.25
"4928","17049","2018",1,1,0,67000,392,171
"4929","17050","2018",2,2,0,90000,804,113
"4930","17051","2018",76,74,2,646454.407894737,5940.30263157895,110.921052631579
"4931","17052","2018",16,16,0,163543.75,1250.125,140.125
"4932","17053","2018",19,19,0,140342.368421053,1304.10526315789,109.526315789474
"4933","17054","2018",3,3,0,77500,901,86.3333333333333
"4934","17055","2018",1,1,0,46000,411,112
"4935","17056","2018",8,8,0,120325,1146,104.625
"4936","17057","2018",7,7,0,164535,1346.14285714286,123.571428571429
"4937","17058","2018",60,60,0,183291.75,2137.03333333333,88.5333333333333
"4938","17059","2018",20,20,0,267128.2,2058.1,135.2
"4939","17060","2018",4,4,0,144952.5,1138,142.5
"4940","17061","2018",5,5,0,114540,1087.2,103.6
"4941","17063","2018",7,7,0,143704.857142857,1025.42857142857,149.857142857143
"4942","17064","2018",52,52,0,290277.346153846,2665.11538461538,109.076923076923
"4943","17065","2018",27,27,0,221778.888888889,2073.62962962963,109.259259259259
"4944","17066","2018",2,2,0,73250,1041.5,70.5
"4945","17067","2018",3,3,0,61833.3333333333,853.333333333333,82
"4946","17068","2018",4,4,0,82611,934,91
"4947","17069","2018",4,4,0,116875,1125.5,101.5
"4948","17070","2018",13,13,0,139133.307692308,1391.84615384615,98.2307692307692
"4949","17071","2018",3,3,0,155733.333333333,1526,116.666666666667
"4950","17072","2018",13,13,0,103949.615384615,1048.69230769231,106.923076923077
"4951","17073","2018",11,11,0,202427.272727273,1590.54545454545,128
"4952","17074","2018",12,11,1,144755.416666667,1439.83333333333,103.333333333333
"4953","17075","2018",18,18,0,209641.666666667,1785.16666666667,121.222222222222
"4954","17076","2018",5,5,0,120528,1149.2,103
"4955","17077","2018",9,9,0,138111.111111111,1375.44444444444,96.5555555555556
"4956","17078","2018",2,2,0,219250,1417,156
"4957","17079","2018",21,21,0,170890,1780.28571428571,98.3809523809524
"4958","17080","2018",14,14,0,157996.428571429,1406.5,114.714285714286
"4959","17081","2018",2,2,0,55500,776.5,68.5
"4960","17082","2018",4,4,0,113000,1337.5,88
"4961","17083","2018",5,5,0,122200,1027.6,127.6
"4962","17084","2018",5,5,0,91100,982.2,90.4
"4963","17085","2018",7,7,0,119970,1309.28571428571,90.1428571428571
"4964","17086","2018",54,54,0,160832.851851852,1454.85185185185,111.481481481481
"4965","17089","2018",12,12,0,144430,1426.25,102.666666666667
"4966","17091","2018",31,31,0,182562.903225806,1743.29032258065,107.677419354839
"4967","17092","2018",3,3,0,107120,972.333333333333,106
"4968","17093","2018",82,78,4,194770.365853659,2594.68292682927,79.9268292682927
"4969","17094","2018",170,118,52,285349.688235294,3750.7,80.3294117647059
"4970","17095","2018",3,3,0,116583.666666667,967,113
"4971","17096","2018",1,1,0,226420,1204,188
"4972","17097","2018",11,11,0,192536.363636364,1709.63636363636,109.818181818182
"4973","17098","2018",10,10,0,164471,1730.3,105.2
"4974","17099","2018",9,9,0,120429,1034.88888888889,113.888888888889
"4975","17100","2018",9,9,0,142681.111111111,1394.66666666667,102.111111111111
"4976","17101","2018",8,8,0,89258.75,1032.375,97.625
"4977","17102","2018",14,14,0,154805.571428571,1518.35714285714,103.714285714286
"4978","17104","2018",9,9,0,101494.444444444,831,127
"4979","17105","2018",8,8,0,71031,804.375,88.375
"4980","17106","2018",2,2,0,85500,873,98.5
"4981","17107","2018",26,26,0,167823.076923077,1577.30769230769,112.653846153846
"4982","17108","2018",2,2,0,211916,1858.5,113
"4983","17109","2018",41,37,4,211250.243902439,2324.34146341463,92.2926829268293
"4984","17110","2018",5,5,0,130280,1108.8,121.4
"4985","17111","2018",7,7,0,96214.2857142857,960.571428571429,98.1428571428571
"4986","17112","2018",5,5,0,137090,1335.4,112.6
"4987","17113","2018",9,9,0,163555.555555556,1436.33333333333,114.111111111111
"4988","17114","2018",1,1,0,50000,500,100
"4989","17115","2018",5,5,0,86620,950.4,91.2
"4990","17117","2018",2,2,0,94750,703.5,130
"4991","17118","2018",4,4,0,131362.5,1323.75,102.5
"4992","17119","2018",21,21,0,176350.285714286,1603.28571428571,113.380952380952
"4993","17120","2018",21,21,0,167222.047619048,1550.09523809524,110.238095238095
"4994","17121","2018",59,53,6,548623.13559322,5836.89830508475,96.728813559322
"4995","17124","2018",6,6,0,73166.6666666667,833.666666666667,82
"4996","17125","2018",7,7,0,172732.142857143,1181.28571428571,144.428571428571
"4997","17126","2018",5,5,0,106713.6,926.6,117.6
"4998","17127","2018",30,29,1,164652.666666667,1558.36666666667,109.5
"4999","17128","2018",14,14,0,169205.714285714,1333,126.285714285714
"5000","17129","2018",4,4,0,168125,1218.5,138.25
"5001","17130","2018",2,2,0,149500,1479,100
"5002","17131","2018",31,30,1,160563.903225806,1617.45161290323,104.193548387097
"5003","17132","2018",10,10,0,138620,1198.3,124.8
"5004","17133","2018",10,10,0,166808.5,1535.4,109.5
"5005","17134","2018",8,8,0,186861.875,1258.125,141.625
"5006","17135","2018",4,4,0,50002.5,1024,53.25
"5007","17136","2018",23,23,0,241721.304347826,2069.26086956522,119.478260869565
"5008","17137","2018",2,2,0,155500,846,179
"5009","17138","2018",4,4,0,78125,672.5,117.25
"5010","17139","2018",5,5,0,93200,1209.4,79.4
"5011","17140","2018",100,89,11,198659.96,2976.69,72.37
"5012","17141","2018",6,6,0,216200,1469.83333333333,158.833333333333
"5013","17142","2018",70,64,6,274961.5,2475.87142857143,112.228571428571
"5014","17143","2018",11,6,5,122700,1185.36363636364,99.4545454545455
"5015","17145","2018",7,7,0,155314.285714286,1171.14285714286,137
"5016","17146","2018",77,67,10,155684.558441558,1627.87012987013,96.948051948052
"5017","17147","2018",17,17,0,124768.823529412,1248.82352941176,111.117647058824
"5018","17148","2018",5,5,0,195450,1710,113.6
"5019","17150","2018",8,8,0,96750,769.625,126.375
"5020","17151","2018",14,13,1,139962.928571429,1644.07142857143,83.5
"5021","17152","2018",10,10,0,152917,1757.7,90.4
"5022","17153","2018",42,42,0,220407.357142857,2168.90476190476,102.833333333333
"5023","17154","2018",11,11,0,146873.636363636,1187.90909090909,125.090909090909
"5024","17155","2018",56,55,1,192248.678571429,1874.26785714286,102.678571428571
"5025","17156","2018",1,1,0,105000,1312,80
"5026","17157","2018",2,2,0,153150,1668.5,90
"5027","17158","2018",8,8,0,186062.5,1593,120.25
"5028","17159","2018",7,7,0,173056.285714286,1096.14285714286,138
"5029","17160","2018",6,6,0,230230.333333333,1519.33333333333,158.166666666667
"5030","17161","2018",69,61,8,606244.536231884,6001.07246376812,99.2753623188406
"5031","17162","2018",6,6,0,98147.5,872.166666666667,116.333333333333
"5032","17163","2018",5,5,0,137000,1215.2,115.6
"5033","17164","2018",24,24,0,175314,1479.20833333333,121.958333333333
"5034","17165","2018",2,2,0,153000,1383.5,103.5
"5035","17166","2018",16,16,0,153459.375,1523.4375,103.1875
"5036","17167","2018",11,11,0,110576.454545455,1085.63636363636,109.545454545455
"5037","17168","2018",124,107,17,237073.959677419,3328.45161290323,77.0645161290323
"5038","17171","2018",14,14,0,218910.714285714,1412.35714285714,146.5
"5039","17172","2018",40,40,0,129120.75,1323.125,104.3
"5040","17174","2018",9,9,0,127375,1231.22222222222,105.888888888889
"5041","17175","2018",9,9,0,124104.444444444,1165.66666666667,119.444444444444
"5042","17176","2018",2,2,0,118750,1621.5,84
"5043","17177","2018",3,3,0,36000,656.333333333333,68.3333333333333
"5044","17179","2018",19,18,1,128197.473684211,1269.42105263158,109.789473684211
"5045","17180","2018",2,2,0,74750,805,88
"5046","17181","2018",4,4,0,129625,1559.25,85.25
"5047","17182","2018",9,9,0,150888.888888889,1563.33333333333,97.5555555555556
"5048","17183","2018",12,12,0,212541.666666667,1668.41666666667,132.916666666667
"5049","17184","2018",11,11,0,143613.636363636,1392.63636363636,111.090909090909
"5050","17185","2018",30,29,1,154468.333333333,1578.86666666667,97.6333333333333
"5051","17186","2018",17,17,0,142054.117647059,1388,105
"5052","17187","2018",6,6,0,182883.333333333,1762,108.166666666667
"5053","17188","2018",11,11,0,87445.4545454545,1174.45454545455,75.4545454545455
"5054","17190","2018",36,36,0,352755.555555556,3004.33333333333,118.777777777778
"5055","17191","2018",11,11,0,142272.818181818,1331.81818181818,103.818181818182
"5056","17192","2018",5,4,1,127343,1220.4,101.2
"5057","17193","2018",53,52,1,219978.679245283,2256.41509433962,98.3584905660377
"5058","17194","2018",63,63,0,230677.349206349,2196.06349206349,103.825396825397
"5059","17195","2018",5,5,0,109680,983.2,118.2
"5060","17196","2018",9,9,0,142514.444444444,1229.11111111111,123.111111111111
"5061","17197","2018",56,47,9,125158.482142857,1401.17857142857,96.3035714285714
"5062","17198","2018",3,3,0,109000,1688,65.3333333333333
"5063","17199","2018",1,1,0,68000,523,130
"5064","17200","2018",130,122,8,299412.269230769,2817.4,106.753846153846
"5065","17201","2018",3,3,0,172500,1595,114.333333333333
"5066","17202","2018",6,6,0,112250,1147.5,98.5
"5067","17203","2018",14,14,0,178125,1471.28571428571,124.642857142857
"5068","17204","2018",1,1,0,170000,1478,115
"5069","17205","2018",2,2,0,143500,1211,114
"5070","17206","2018",3,3,0,60833.3333333333,700.333333333333,86.6666666666667
"5071","17207","2018",26,25,1,473021.538461538,5501.73076923077,98.3846153846154
"5072","17208","2018",20,20,0,177449,1742.85,101.5
"5073","17209","2018",2,2,0,78836.5,771.5,108.5
"5074","17210","2018",5,5,0,128683.8,1121.6,103.6
"5075","17211","2018",9,9,0,86500,840.777777777778,115
"5076","17212","2018",2,2,0,108750,1224.5,87
"5077","17213","2018",2,2,0,115000,1078.5,109.5
"5078","17214","2018",4,4,0,213125,1634.5,129.75
"5079","17216","2018",16,16,0,160630.1875,1477.0625,107.4375
"5080","17217","2018",2,2,0,47500,840,76
"5081","17218","2018",66,61,5,142764.090909091,1497,97.1818181818182
"5082","17219","2018",121,113,8,174782.247933884,1981.85950413223,92.8099173553719
"5083","17220","2018",5,5,0,110870.4,1042,109.8
"5084","17221","2018",16,16,0,142986.375,1047.25,135.6875
"5085","17222","2018",51,50,1,294664.882352941,2668.58823529412,110.21568627451
"5086","17223","2018",1,1,0,98500,1187,83
"5087","17224","2018",27,27,0,104851.851851852,1089.07407407407,97.4444444444444
"5088","17225","2018",135,123,12,195119.162962963,3201.72592592593,68.2518518518519
"5089","17226","2018",13,13,0,106147.230769231,1029.07692307692,100.538461538462
"5090","17227","2018",4,4,0,134016.25,1177.5,120
"5091","17228","2018",47,46,1,201556.404255319,1965.21276595745,104.021276595745
"5092","17229","2018",1,1,0,1e+05,806,124
"5093","17230","2018",121,106,15,202911.256198347,2710.01652892562,77.5206611570248
"5094","17231","2018",2,2,0,124000,1030.5,135
"5095","17232","2018",23,21,2,129545.652173913,1348.30434782609,96.0869565217391
"5096","17233","2018",4,4,0,166664.5,1152,136.5
"5097","17234","2018",2,2,0,66150,761.5,111.5
"5098","17235","2018",10,10,0,110955,1130.7,105.4
"5099","17236","2018",14,11,3,73405.7142857143,892.785714285714,82.5
"5100","17237","2018",12,12,0,143783.333333333,1507.75,96
"5101","17239","2018",5,5,0,308190.2,2030.6,140.8
"5102","17240","2018",34,31,3,102860.882352941,1249.05882352941,88.4705882352941
"5103","17241","2018",15,15,0,109981.6,1105.53333333333,94.6666666666667
"5104","17242","2018",8,8,0,182622.625,1120.25,160
"5105","17243","2018",10,10,0,118978.5,973.9,122.6
"5106","17244","2018",10,10,0,209697.5,1548.9,150.2
"5107","17245","2018",16,16,0,216705,2190.5,97.5
"5108","17246","2018",7,7,0,158742.857142857,1576,103.714285714286
"5109","17247","2018",26,24,2,201150,1875.03846153846,111.846153846154
"5110","17248","2018",18,17,1,107757,1317.61111111111,89.1666666666667
"5111","17249","2018",1,1,0,280000,2414,116
"5112","17250","2018",4,4,0,109338,902,122.5
"5113","17252","2018",5,5,0,151600,1109.6,141.8
"5114","17253","2018",19,17,2,143775.789473684,1290.05263157895,111.578947368421
"5115","17254","2018",4,4,0,86750,1145.75,72.75
"5116","17255","2018",7,7,0,182128.571428571,1626,109.857142857143
"5117","17256","2018",4,4,0,115000,1071,110
"5118","17257","2018",14,14,0,109846.142857143,941.857142857143,114.714285714286
"5119","17258","2018",3,3,0,132766.666666667,964,140
"5120","17259","2018",3,3,0,138835,1335.33333333333,102
"5121","17260","2018",3,3,0,196905,1800.33333333333,104.333333333333
"5122","17261","2018",1,1,0,90000,596,151
"5123","17262","2018",13,13,0,183276.153846154,1547.69230769231,118.538461538462
"5124","17263","2018",7,7,0,85714.2857142857,1006.71428571429,84.7142857142857
"5125","17264","2018",78,77,1,280484.641025641,2736.96153846154,104.602564102564
"5126","17265","2018",26,26,0,163010.769230769,1441.88461538462,118.076923076923
"5127","17266","2018",9,9,0,137522.222222222,1482.22222222222,109
"5128","17267","2018",27,27,0,195305.333333333,1958.07407407407,104.185185185185
"5129","17268","2018",1,1,0,205800,1083,190
"5130","17269","2018",5,5,0,96440,1241,76.8
"5131","17270","2018",11,11,0,153457.363636364,1812.18181818182,93
"5132","17271","2018",9,9,0,125395.555555556,1040.66666666667,136.888888888889
"5133","17273","2018",9,9,0,167230.444444444,1201.88888888889,142.777777777778
"5134","17274","2018",128,100,28,282297.21875,2954.21875,96.65625
"5135","17275","2018",7,7,0,217008.285714286,1685.85714285714,133.142857142857
"5136","17276","2018",2,2,0,110000,1111.5,96
"5137","17277","2018",9,9,0,114888.888888889,1069.11111111111,109
"5138","17278","2018",13,13,0,143447.615384615,1489.15384615385,98.6153846153846
"5139","17279","2018",5,5,0,178400,1291.8,150
"5140","17280","2018",9,9,0,157277.777777778,1358.66666666667,118.444444444444
"5141","17281","2018",2,2,0,112550,905,123
"5142","17283","2018",48,47,1,122924.1875,1245.91666666667,101.083333333333
"5143","17284","2018",23,23,0,161402.608695652,1577.91304347826,128.086956521739
"5144","17285","2018",15,15,0,160639.533333333,1480.06666666667,106.2
"5145","17286","2018",32,32,0,662528.90625,6471.375,105.03125
"5146","17287","2018",2,2,0,98500,753.5,115.5
"5147","17288","2018",2,2,0,115000,1148.5,105.5
"5148","17289","2018",8,8,0,239193.75,1711.75,137.875
"5149","17290","2018",4,4,0,94375,1070.75,85.5
"5150","17291","2018",79,62,17,230480.025316456,2424.75949367089,94.4050632911392
"5151","17292","2018",6,6,0,211016.666666667,2714.33333333333,89
"5152","17293","2018",12,12,0,119083.416666667,1038.83333333333,115.75
"5153","17295","2018",9,9,0,158140.444444444,1245.66666666667,125.222222222222
"5154","17296","2018",16,16,0,178475.6875,1446.25,120.3125
"5155","17297","2018",62,59,3,455186.693548387,4990.16129032258,97.3548387096774
"5156","17298","2018",7,7,0,203057.142857143,1650.42857142857,128.714285714286
"5157","17299","2018",529,280,249,135831.504725898,1743.16257088847,80.4045368620038
"5158","17300","2018",1827,691,1136,229474.737821565,3500.08264915161,68.9824849480022
"5159","17301","2018",2,2,0,81509.5,816.5,117.5
"5160","17302","2018",5,5,0,158300,1403.6,107.6
"5161","17303","2018",19,19,0,150431.052631579,1421.31578947368,106.947368421053
"5162","17304","2018",6,6,0,141459.5,1186.83333333333,119.5
"5163","17305","2018",5,5,0,113355,1301.2,92.4
"5164","17306","2018",813,330,483,218656.35301353,3031.36162361624,73
"5165","17307","2018",16,16,0,162460.625,1556.6875,106.0625
"5166","17308","2018",53,53,0,165093.018867925,1533.54716981132,107.320754716981
"5167","17309","2018",18,18,0,80438.8888888889,939.111111111111,93.2777777777778
"5168","17310","2018",18,18,0,175903.277777778,1552.27777777778,120.611111111111
"5169","17311","2018",31,30,1,189667.129032258,2157.06451612903,93.258064516129
"5170","17312","2018",4,4,0,116250,1222.25,107.5
"5171","17313","2018",3,3,0,93333.3333333333,1185,73.3333333333333
"5172","17314","2018",12,12,0,134933.333333333,1414.66666666667,101.416666666667
"5173","17315","2018",28,28,0,222289.428571429,2201.96428571429,100.642857142857
"5174","17316","2018",3,3,0,147000,1276.33333333333,126.333333333333
"5175","17317","2018",5,5,0,52400,654.6,79.2
"5176","17318","2018",29,29,0,353614.137931034,3921.8275862069,95.5862068965517
"5177","17319","2018",1,1,0,55000,567,97
"5178","17320","2018",5,5,0,149720,1442.4,108.4
"5179","17321","2018",3,3,0,95000,1116.33333333333,83
"5180","17322","2018",6,6,0,128166.666666667,1248.83333333333,98.6666666666667
"5181","17323","2018",64,61,3,225830.21875,2898.59375,82.4375
"5182","17324","2018",1,1,0,45000,500,90
"5183","17325","2018",12,12,0,106691.833333333,1109.33333333333,85.3333333333333
"5184","17326","2018",1,1,0,120000,1519,79
"5185","17327","2018",6,6,0,112833.333333333,1127.83333333333,99.8333333333333
"5186","17328","2018",14,14,0,129371.785714286,1272.14285714286,103.142857142857
"5187","17329","2018",9,9,0,121555.555555556,1507.77777777778,80.2222222222222
"5188","17330","2018",22,22,0,120084.363636364,1326.86363636364,92.1363636363636
"5189","17331","2018",10,10,0,140615,1247.7,113.3
"5190","17332","2018",7,7,0,151025.285714286,1218.71428571429,128.285714285714
"5191","17333","2018",260,156,104,212166.4,3176.13846153846,69.5884615384615
"5192","17334","2018",4,4,0,120750,841.5,144.75
"5193","17335","2018",3,3,0,176666.666666667,2049.66666666667,90
"5194","17336","2018",31,30,1,183829.677419355,1831.96774193548,108.806451612903
"5195","17337","2018",165,161,4,188236.248484848,2774.18787878788,71.6909090909091
"5196","17338","2018",24,24,0,167053.333333333,1255.5,131.416666666667
"5197","17339","2018",10,10,0,133229.9,1261.8,105.5
"5198","17340","2018",18,18,0,136750,1271.22222222222,110
"5199","17341","2018",5,5,0,123759.2,792.8,152.2
"5200","17342","2018",8,8,0,113912.5,1087.875,106.625
"5201","17343","2018",1,1,0,205000,2135,96
"5202","17344","2018",17,17,0,110320.823529412,1148,94.5882352941177
"5203","17345","2018",4,4,0,96450,827.5,114.75
"5204","17346","2018",18,18,0,169025,1578.44444444444,107.111111111111
"5205","17347","2018",141,127,14,99214.8936170213,1041.3475177305,96.0070921985816
"5206","17348","2018",11,11,0,161078.181818182,1490.63636363636,108.090909090909
"5207","17349","2018",47,47,0,166410.893617021,1630.91489361702,108.127659574468
"5208","17350","2018",11,11,0,103107.272727273,1078.63636363636,107.727272727273
"5209","17351","2018",34,34,0,157688.588235294,1673.76470588235,101.823529411765
"5210","17353","2018",30,30,0,182570,2196.3,87.3666666666667
"5211","17354","2018",6,6,0,176858.333333333,1213.16666666667,137.833333333333
"5212","17355","2018",4,4,0,129437.5,1368.25,99.25
"5213","17356","2018",4,4,0,71125,743.25,103.25
"5214","17357","2018",2,2,0,89124.5,903,104
"5215","17358","2018",4,4,0,81818.25,892.75,91.25
"5216","17359","2018",15,15,0,118633.333333333,1129.73333333333,115.266666666667
"5217","17360","2018",86,83,3,564704.662790698,5045.36046511628,113.453488372093
"5218","17361","2018",4,4,0,100750,1000,99.5
"5219","17362","2018",5,5,0,94600,1438.2,69
"5220","17363","2018",8,8,0,151687.5,1898.25,87.75
"5221","17364","2018",4,4,0,118876.5,1293.5,103.5
"5222","17365","2018",9,9,0,110150,1077.77777777778,104.444444444444
"5223","17366","2018",2,2,0,65000,805,81.5
"5224","17367","2018",2,2,0,125000,1224.5,99
"5225","17369","2018",90,50,40,454207.888888889,5690.61111111111,82.5888888888889
"5226","17372","2018",1,1,0,130000,1074,121
"5227","17373","2018",9,9,0,225727.777777778,2336.55555555556,98.7777777777778
"5228","17374","2018",6,6,0,100833.333333333,941.333333333333,109.166666666667
"5229","17375","2018",13,13,0,150000,1848.23076923077,82
"5230","17376","2018",21,20,1,212643.80952381,2344.38095238095,97.0952380952381
"5231","17377","2018",4,4,0,108375,949.75,115.5
"5232","17378","2018",6,6,0,90283.3333333333,1007.66666666667,92.1666666666667
"5233","17379","2018",5,5,0,118900,894.8,134.4
"5234","17380","2018",167,124,43,296840.221556886,3617.05389221557,86.688622754491
"5235","17381","2018",1,1,0,177100,2214,80
"5236","17382","2018",8,8,0,104487.5,1141.625,100.875
"5237","17383","2018",6,6,0,93483.3333333333,864,114.833333333333
"5238","17384","2018",3,3,0,93650,906,111.666666666667
"5239","17385","2018",207,193,14,216311.888888889,2932.36231884058,78.8115942028985
"5240","17386","2018",7,7,0,142177.142857143,1188.28571428571,110.857142857143
"5241","17387","2018",31,30,1,162819.35483871,1501.87096774194,113.064516129032
"5242","17388","2018",4,4,0,108000,950.75,113.25
"5243","17389","2018",10,10,0,208619.2,1752.8,119.7
"5244","17390","2018",1,1,0,182500,1185,154
"5245","17391","2018",28,28,0,338271.214285714,2618.85714285714,127.607142857143
"5246","17393","2018",19,19,0,173218.947368421,2013.42105263158,90.4210526315789
"5247","17394","2018",11,11,0,161559.090909091,1113.54545454545,143.090909090909
"5248","17395","2018",6,6,0,107166.666666667,1353,93.8333333333333
"5249","17396","2018",36,36,0,168857.555555556,1546.58333333333,114.111111111111
"5250","17397","2018",45,44,1,122918.711111111,1203.84444444444,108.8
"5251","17398","2018",4,4,0,144547.5,1401.5,105.75
"5252","17400","2018",9,9,0,133611.111111111,1259,109.555555555556
"5253","17402","2018",1,1,0,55000,611,90
"5254","17403","2018",8,8,0,157467.5,1585.875,105.25
"5255","17404","2018",3,3,0,80666.6666666667,1119,73.6666666666667
"5256","17405","2018",4,4,0,123367.5,1353.75,93.25
"5257","17406","2018",9,9,0,188597.777777778,1953.22222222222,103.222222222222
"5258","17407","2018",69,67,2,266084.855072464,2427.26086956522,109.95652173913
"5259","17408","2018",11,11,0,127067.909090909,1364.27272727273,92.0909090909091
"5260","17409","2018",47,46,1,239141.276595745,2291.63829787234,109.234042553191
"5261","17410","2018",8,8,0,184023.125,1252.375,135.75
"5262","17411","2018",50,49,1,242621.98,2976.74,86.6
"5263","17412","2018",13,13,0,163907.692307692,1452.92307692308,108.230769230769
"5264","17413","2018",24,24,0,266139.291666667,2445.20833333333,112.791666666667
"5265","17414","2018",67,64,3,254864.373134328,2555.17910447761,99.8955223880597
"5266","17415","2018",481,348,133,147741.767151767,1660.14760914761,89.9230769230769
"5267","17418","2018",8,8,0,129150,1072,129.625
"5268","17420","2018",37,36,1,256334.108108108,2474.75675675676,112
"5269","17421","2018",156,135,21,178123.967948718,2017.03846153846,92.0128205128205
"5270","17422","2018",1,1,0,154820,1407,110
"5271","17424","2018",5,5,0,115000,1092.6,103.8
"5272","17425","2018",34,34,0,181049.764705882,1922.44117647059,98.3235294117647
"5273","17426","2018",4,4,0,62625,858.25,75
"5274","17428","2018",5,5,0,128000,1148.8,117.4
"5275","17429","2018",30,30,0,159973.333333333,1593.8,103.433333333333
"5276","17430","2018",5,5,0,131443,1311.2,102
"5277","17431","2018",7,7,0,166555.714285714,1585.85714285714,102.571428571429
"5278","17432","2018",5,5,0,184000,1643.8,110.4
"5279","17433","2018",3,3,0,125083.333333333,942,123.333333333333
"5280","17434","2018",116,106,10,136993.724137931,1554.33620689655,91.1293103448276
"5281","17435","2018",6,6,0,106671.666666667,818.166666666667,125.166666666667
"5282","17436","2018",13,13,0,116376.769230769,1323.69230769231,90.6153846153846
"5283","17437","2018",3,3,0,140506.666666667,5371.66666666667,29.6666666666667
"5284","17438","2018",1,1,0,145000,806,180
"5285","17439","2018",21,21,0,110040.476190476,1540.80952380952,80.4285714285714
"5286","17440","2018",10,6,4,85595,1276.4,68.3
"5287","17441","2018",18,18,0,163332.166666667,1531.33333333333,109.166666666667
"5288","17442","2018",3,3,0,110670,1010,121.333333333333
"5289","17443","2018",29,29,0,200889.75862069,1837.34482758621,109.862068965517
"5290","17444","2018",26,23,3,163542.884615385,1893.11538461538,96.1538461538462
"5291","17445","2018",3,3,0,157833.333333333,1354.33333333333,110.666666666667
"5292","17446","2018",7,7,0,73757.1428571429,955.857142857143,82.4285714285714
"5293","17447","2018",38,38,0,188457.894736842,1751.18421052632,107.578947368421
"5294","17448","2018",15,14,1,158520,1306.33333333333,127.466666666667
"5295","17449","2018",136,112,24,143527.375,1569.03676470588,94.1029411764706
"5296","17450","2018",1,1,0,235000,940,250
"5297","17451","2018",4,4,0,72100,767.5,108.25
"5298","17452","2018",134,119,15,205627.455223881,2481.76119402985,86.4850746268657
"5299","17453","2018",15,15,0,192933.133333333,1547.6,128.6
"5300","17454","2018",5,5,0,90663,835.6,107
"5301","17455","2018",13,13,0,180425.307692308,1511.23076923077,121.538461538462
"5302","17457","2018",36,36,0,113191.027777778,1243.52777777778,89.6944444444444
"5303","17458","2018",3,3,0,89666.6666666667,1043,90.3333333333333
"5304","17459","2018",9,9,0,93111.1111111111,866.888888888889,105.333333333333
"5305","17460","2018",12,12,0,160385.5,1425.83333333333,113.333333333333
"5306","17461","2018",214,115,99,226670.76635514,3586.10280373832,66.2429906542056
"5307","17462","2018",15,15,0,167352.2,1536.73333333333,109.866666666667
"5308","17463","2018",25,24,1,201196.96,2287.24,99.32
"5309","17464","2018",2,2,0,145000,1023,140
"5310","17465","2018",5,5,0,129800,1089.8,116.8
"5311","17466","2018",32,32,0,222927.4375,1912.625,119.59375
"5312","17467","2018",2,2,0,53800,463.5,115.5
"5313","17468","2018",2,2,0,52000,488,105
"5314","17469","2018",7,7,0,171311.428571429,1213.85714285714,148.285714285714
"5315","17470","2018",1,1,0,230600,1073,215
"5316","17471","2018",1,1,0,35400,442,80
"5317","17472","2018",29,29,0,216684.689655172,2099.55172413793,104.689655172414
"5318","17473","2018",6,6,0,128666.666666667,965.333333333333,144.666666666667
"5319","17474","2018",8,8,0,128078.75,1040.75,126.125
"5320","17477","2018",2,2,0,158099.5,802.5,199
"5321","17478","2018",1,1,0,240000,1231,195
"5322","17479","2018",2,2,0,171367.5,1129.5,143.5
"5323","17480","2018",6,6,0,237483.333333333,2055.16666666667,115.166666666667
"5324","17481","2018",3,3,0,127333.333333333,1262.33333333333,102.666666666667
"5325","17482","2018",11,11,0,151440.909090909,1352.36363636364,108.545454545455
"5326","17483","2018",35,35,0,225030.285714286,2592.2,94.3428571428571
"5327","17484","2018",56,52,4,159193.75,1858.26785714286,87.125
"5328","17485","2018",31,29,2,193345.161290323,2942.54838709677,70.1612903225806
"5329","17486","2018",37,36,1,228841.918918919,3485.62162162162,69.1621621621622
"5330","18001","2018",3,3,0,81000,595.666666666667,129.666666666667
"5331","18002","2018",6,6,0,81750,1158.33333333333,76.5
"5332","18003","2018",18,18,0,108222.222222222,1087.38888888889,97.5
"5333","18004","2018",6,6,0,206250,1589.16666666667,113.833333333333
"5334","18005","2018",12,12,0,125791.166666667,1206.33333333333,105.583333333333
"5335","18006","2018",3,3,0,110500,1081.66666666667,103.333333333333
"5336","18008","2018",4,4,0,129500,1325.25,112.75
"5337","18009","2018",1,1,0,75000,1210,62
"5338","18010","2018",2,2,0,85000,1240.5,70.5
"5339","18011","2018",30,30,0,91812.0666666667,1210.2,76.1333333333333
"5340","18012","2018",5,5,0,84000,871.4,95
"5341","18013","2018",1,1,0,112000,1333,84
"5342","18014","2018",1,1,0,75000,1250,60
"5343","18015","2018",67,65,2,105055.791044776,1318.26865671642,81.1492537313433
"5344","18016","2018",6,6,0,123666.833333333,1006,119
"5345","18017","2018",1,1,0,40000,400,100
"5346","18018","2018",22,22,0,114168.636363636,1205.81818181818,92.9090909090909
"5347","18019","2018",3,3,0,72000,919.666666666667,76.3333333333333
"5348","18020","2018",10,10,0,118089.4,1145.8,96
"5349","18021","2018",2,2,0,90000,951.5,91
"5350","18022","2018",2,2,0,135965,1299.5,95
"5351","18023","2018",22,21,1,115966.409090909,1201,96.0909090909091
"5352","18024","2018",2,2,0,97925,990,100.5
"5353","18025","2018",6,6,0,84250,905,94
"5354","18026","2018",11,11,0,122500,1135.45454545455,107
"5355","18027","2018",4,4,0,273249,3406.5,84.25
"5356","18028","2018",11,11,0,138026.181818182,1290,104.181818181818
"5357","18029","2018",3,3,0,47333.3333333333,597,80
"5358","18030","2018",12,12,0,136012.5,1568.25,92.1666666666667
"5359","18031","2018",5,5,0,75000,812.8,92.4
"5360","18032","2018",23,22,1,94843.3043478261,1069.78260869565,91.9565217391304
"5361","18033","2018",915,475,440,117385.691803279,1453.14972677596,80.5661202185792
"5362","18034","2018",1,1,0,150000,1154,130
"5363","18035","2018",18,18,0,140906.222222222,1401.94444444444,109.555555555556
"5364","18036","2018",1,1,0,110000,1089,101
"5365","18037","2018",11,11,0,68818.1818181818,993.363636363636,78
"5366","18038","2018",8,8,0,82028,1174.5,76
"5367","18039","2018",5,5,0,124100,1382.8,87.2
"5368","18040","2018",4,4,0,73250,751,98.25
"5369","18041","2018",3,3,0,74000,765.666666666667,105.666666666667
"5370","18042","2018",1,1,0,1e+05,877,114
"5371","18043","2018",4,4,0,62250,1062.5,61.25
"5372","18044","2018",2,2,0,115000,1269,106
"5373","18045","2018",6,6,0,82916.6666666667,854.166666666667,98.6666666666667
"5374","18047","2018",3,3,0,69666.6666666667,783.333333333333,93
"5375","18048","2018",4,4,0,71250,889,82.25
"5376","18049","2018",8,8,0,94143.5,939.5,103.5
"5377","18050","2018",25,25,0,169361.88,1718.24,101.48
"5378","18051","2018",2,2,0,23750,437.5,57.5
"5379","18052","2018",8,7,1,78937.5,689.5,105.125
"5380","18053","2018",1,1,0,140000,1037,135
"5381","18054","2018",4,4,0,62000,706,91.75
"5382","18055","2018",14,14,0,90057.1428571429,998.642857142857,90.3571428571429
"5383","18056","2018",2,2,0,41000,466.5,87.5
"5384","18057","2018",24,24,0,74223.3333333333,965.75,80.4166666666667
"5385","18058","2018",18,18,0,94785.2777777778,954.388888888889,99.3888888888889
"5386","18059","2018",3,3,0,65333.3333333333,914,71.6666666666667
"5387","18061","2018",1,1,0,110000,1048,105
"5388","18063","2018",1,1,0,95000,1080,88
"5389","18064","2018",1,1,0,137000,945,145
"5390","18065","2018",5,5,0,56337.6,1023.8,57
"5391","18066","2018",11,11,0,115294.545454545,1263.72727272727,96.2727272727273
"5392","18067","2018",5,5,0,82900,1017.6,85.6
"5393","18068","2018",1,1,0,37500,625,60
"5394","18069","2018",3,3,0,78166.6666666667,1052.33333333333,74.6666666666667
"5395","18070","2018",1,1,0,47500,432,110
"5396","18071","2018",1,1,0,130000,591,220
"5397","18072","2018",2,2,0,101000,950.5,105.5
"5398","18073","2018",3,3,0,96833.3333333333,1201,83
"5399","18074","2018",2,2,0,80000,867,95
"5400","18075","2018",22,22,0,128556.818181818,1115.22727272727,113.318181818182
"5401","18076","2018",2,2,0,65000,1554,53
"5402","18077","2018",3,3,0,86333.3333333333,1192.66666666667,111.666666666667
"5403","18079","2018",4,4,0,91750,1206.75,78.5
"5404","18080","2018",2,2,0,40500,529,74
"5405","18081","2018",7,7,0,106857.142857143,1218.28571428571,90.2857142857143
"5406","18082","2018",17,17,0,96742.2941176471,943.411764705882,95.9411764705882
"5407","18083","2018",9,9,0,69411.1111111111,898.444444444444,76.1111111111111
"5408","18084","2018",1,1,0,55000,1571,35
"5409","18085","2018",1,1,0,105000,1193,88
"5410","18086","2018",4,4,0,109500,1229.25,89.75
"5411","18087","2018",39,36,3,90112.8205128205,974.538461538462,91.5897435897436
"5412","18088","2018",4,4,0,61750,684,92.75
"5413","18089","2018",14,14,0,68659.2857142857,930.071428571429,76.7142857142857
"5414","18090","2018",3,3,0,65333.3333333333,827.333333333333,80.3333333333333
"5415","18091","2018",2,2,0,597295,5111,89
"5416","18092","2018",10,10,0,133800,1274.9,108.9
"5417","18093","2018",5,5,0,91400,1776,73.6
"5418","18094","2018",10,10,0,81000,841.9,95.6
"5419","18095","2018",1,1,0,69000,726,95
"5420","18096","2018",19,19,0,90181.5789473684,1007.42105263158,91.2105263157895
"5421","18097","2018",20,20,0,148994,1537.5,98.85
"5422","18098","2018",2,2,0,37500,613,61
"5423","18099","2018",2,2,0,35000,634.5,56.5
"5424","18100","2018",10,10,0,70300,908,87.2
"5425","18101","2018",2,2,0,60000,1583.5,42.5
"5426","18102","2018",11,11,0,55690.9090909091,548.272727272727,105.636363636364
"5427","18103","2018",13,13,0,62769.2307692308,749.153846153846,89.0769230769231
"5428","18104","2018",5,5,0,59485.6,669.8,92.8
"5429","18105","2018",9,9,0,132322.222222222,1479.44444444444,108.444444444444
"5430","18106","2018",6,6,0,101666.666666667,988.166666666667,101
"5431","18107","2018",1,1,0,45000,643,70
"5432","18108","2018",56,53,3,88155.1785714286,886.982142857143,98.1428571428571
"5433","18109","2018",19,18,1,84144.7368421053,875.736842105263,106
"5434","18110","2018",15,15,0,79088.5333333333,984.733333333333,75.9333333333333
"5435","18111","2018",1,1,0,36000,571,63
"5436","18112","2018",4,4,0,112875,1199.25,90.75
"5437","18114","2018",4,4,0,96000,977.25,100
"5438","18115","2018",12,12,0,71341.6666666667,897.083333333333,93.25
"5439","18116","2018",2,2,0,56500,772,68.5
"5440","18117","2018",8,8,0,78875,969.875,83.5
"5441","18118","2018",15,14,1,74333.3333333333,1064.93333333333,69.4666666666667
"5442","18119","2018",2,2,0,90000,1034.5,86.5
"5443","18120","2018",6,6,0,92500,959.666666666667,95
"5444","18124","2018",4,4,0,57691.25,780.5,72
"5445","18125","2018",21,21,0,75504.2857142857,931.428571428571,81.0952380952381
"5446","18126","2018",18,18,0,129291.666666667,1298.77777777778,101
"5447","18127","2018",23,23,0,62989.1304347826,764.695652173913,84.9565217391304
"5448","18128","2018",2,2,0,91500,918.5,99.5
"5449","18129","2018",1,1,0,107000,535,200
"5450","18130","2018",2,2,0,201000,2452,90.5
"5451","18131","2018",1,1,0,115000,1322,87
"5452","18133","2018",13,13,0,105076.923076923,1196,95.4615384615385
"5453","18134","2018",5,5,0,68600,680,94.6
"5454","18135","2018",3,3,0,80000,1127.66666666667,69.6666666666667
"5455","18136","2018",4,4,0,92800,1163.5,83
"5456","18137","2018",5,5,0,71400,992,71.4
"5457","18138","2018",22,22,0,152678.636363636,1547.04545454545,106.636363636364
"5458","18139","2018",5,5,0,67500,765,89
"5459","18140","2018",12,12,0,71833.3333333333,962.166666666667,75
"5460","18141","2018",66,66,0,100703.015151515,1175.60606060606,91.7878787878788
"5461","18142","2018",8,8,0,45245.5,675.5,77.625
"5462","18143","2018",4,4,0,74500,641.5,114.5
"5463","18144","2018",4,4,0,68250,739.5,89.25
"5464","18145","2018",12,12,0,94362.9166666667,1103,89.4166666666667
"5465","18146","2018",6,6,0,82884.6666666667,1191.66666666667,74.1666666666667
"5466","18147","2018",1,1,0,75000,815,92
"5467","18148","2018",16,16,0,106650,1102.375,101.125
"5468","18149","2018",6,6,0,165666.666666667,1205.66666666667,116.5
"5469","18150","2018",8,8,0,108857.375,1109,103.5
"5470","18151","2018",1,1,0,85000,1700,50
"5471","18152","2018",2,2,0,125000,1149.5,111.5
"5472","18153","2018",1,1,0,79500,803,99
"5473","18155","2018",10,9,1,77350,893.1,83.8
"5474","18156","2018",4,4,0,80750,824,89.25
"5475","18157","2018",11,11,0,153994.545454545,1556.72727272727,100.090909090909
"5476","18158","2018",12,12,0,169966.666666667,1657.25,102.333333333333
"5477","18159","2018",14,14,0,126621.428571429,1593.78571428571,94.9285714285714
"5478","18160","2018",13,13,0,86076.9230769231,968.230769230769,93.5384615384615
"5479","18161","2018",5,5,0,70500,924.8,72.2
"5480","18162","2018",6,6,0,65333.3333333333,791.333333333333,83
"5481","18163","2018",4,4,0,107250,895.5,101.25
"5482","18164","2018",3,3,0,84000,792.333333333333,108.333333333333
"5483","18165","2018",13,12,1,54953.8461538462,813.615384615385,68.7692307692308
"5484","18166","2018",4,4,0,155125,1501.5,103
"5485","18167","2018",4,4,0,93375,888.25,103
"5486","18168","2018",2,2,0,97750,666.5,162
"5487","18169","2018",4,4,0,70337,729.5,93
"5488","18170","2018",5,5,0,127200,987.6,128.2
"5489","18172","2018",21,20,1,81218.2380952381,970.333333333333,87.6190476190476
"5490","18173","2018",1,1,0,63000,759,83
"5491","18175","2018",10,10,0,79855,865.1,91
"5492","18176","2018",5,5,0,108560,1067,108
"5493","18177","2018",1,1,0,45000,542,83
"5494","18178","2018",1,1,0,34000,472,72
"5495","18179","2018",9,9,0,164405.555555556,1391.66666666667,122.555555555556
"5496","18180","2018",16,16,0,180659.375,2035.875,91.9375
"5497","18181","2018",6,6,0,134000,1032.5,124
"5498","18182","2018",3,3,0,140000,1138.33333333333,109
"5499","18184","2018",6,6,0,78000,989.5,86
"5500","18186","2018",7,7,0,111428.571428571,954.571428571429,124
"5501","18187","2018",12,12,0,77875,1094,71.5
"5502","18188","2018",2,2,0,180500,2090.5,94
"5503","18189","2018",7,7,0,105410.285714286,955.714285714286,113.857142857143
"5504","18190","2018",12,12,0,141618.333333333,1360.83333333333,102.25
"5505","18191","2018",1,1,0,87000,1012,86
"5506","18192","2018",2,2,0,40750,525.5,74
"5507","18193","2018",3,3,0,75500,937.666666666667,68
"5508","18194","2018",12,12,0,91179.75,964.833333333333,97.5833333333333
"5509","18195","2018",3,3,0,109833.333333333,706,139.666666666667
"5510","18196","2018",1,1,0,51150,355,144
"5511","18197","2018",118,104,14,90419.8983050847,1014.03389830508,92.3559322033898
"5512","18198","2018",3,3,0,115666.666666667,780,150.333333333333
"5513","18199","2018",10,10,0,81500,874,100.3
"5514","18200","2018",6,6,0,62583.3333333333,836.333333333333,77.6666666666667
"5515","18201","2018",10,10,0,149870,1303.6,122.4
"5516","18203","2018",2,2,0,102500,735.5,133
"5517","18204","2018",2,2,0,86000,844,105
"5518","18205","2018",75,73,2,150854.666666667,1522.44,102.08
"5519","18206","2018",16,16,0,212843.75,1769.3125,128.3125
"5520","18207","2018",75,68,7,98015.7866666667,1140.49333333333,87.4933333333333
"5521","18208","2018",3,3,0,128833.333333333,1040,119.666666666667
"5522","18209","2018",1,1,0,65000,663,98
"5523","18210","2018",9,9,0,106555.555555556,1233,89.5555555555556
"5524","18211","2018",9,9,0,137744.444444444,1249.33333333333,115
"5525","18212","2018",7,7,0,119500,1076.14285714286,116.714285714286
"5526","18213","2018",48,48,0,125739.583333333,1299.39583333333,98.25
"5527","18214","2018",7,7,0,79071.4285714286,1040.14285714286,74.2857142857143
"5528","18215","2018",2,2,0,106630,1206.5,94
"5529","18216","2018",4,4,0,76160,787.5,90.5
"5530","18217","2018",2,2,0,189500,1676.5,97.5
"5531","18218","2018",14,14,0,132536.428571429,1431.57142857143,94.5714285714286
"5532","18219","2018",5,5,0,177540,1315,136.6
"5533","18220","2018",7,7,0,93278.5714285714,899.857142857143,102.142857142857
"5534","18221","2018",6,6,0,178166.666666667,1585.5,86.6666666666667
"5535","18223","2018",27,27,0,114365.555555556,1116,102.037037037037
"5536","18224","2018",5,5,0,218600,2025.6,111.2
"5537","18225","2018",1,1,0,110000,1222,90
"5538","18226","2018",3,3,0,193233.333333333,1838.66666666667,105.333333333333
"5539","18227","2018",4,4,0,378375,1987.5,178
"5540","18228","2018",3,3,0,57500,962.666666666667,59.3333333333333
"5541","18229","2018",7,7,0,105571.428571429,1146,95
"5542","18231","2018",12,12,0,118248.833333333,973,124.75
"5543","18233","2018",15,14,1,102373.666666667,1109.6,95.1333333333333
"5544","18234","2018",7,7,0,82120.5714285714,951.142857142857,87
"5545","18235","2018",11,11,0,109022.272727273,1111.72727272727,98.8181818181818
"5546","18236","2018",1,1,0,210776,1673,126
"5547","18237","2018",5,5,0,96760,1028,87.2
"5548","18238","2018",3,3,0,70000,1071.66666666667,66.3333333333333
"5549","18240","2018",17,17,0,76529.4117647059,813.764705882353,95
"5550","18241","2018",13,12,1,134230.769230769,1372.38461538462,101
"5551","18242","2018",35,34,1,70457,843.571428571429,88.8571428571429
"5552","18243","2018",6,6,0,91583.3333333333,923,102.833333333333
"5553","18245","2018",1,1,0,135000,1406,96
"5554","18246","2018",14,14,0,117885,1033.14285714286,114.071428571429
"5555","18247","2018",12,12,0,117225.666666667,1331.25,93.75
"5556","18248","2018",3,3,0,145333.333333333,1636.66666666667,97.6666666666667
"5557","18249","2018",9,9,0,75365,1071,68.6666666666667
"5558","18252","2018",7,7,0,56428.5714285714,916.714285714286,59
"5559","18253","2018",3,2,1,126076.666666667,1071.66666666667,117
"5560","18254","2018",5,5,0,140800,1386.8,104
"5561","18255","2018",9,9,0,154058.333333333,1191.66666666667,129.666666666667
"5562","18256","2018",4,4,0,88250,936.75,95.25
"5563","18257","2018",10,10,0,89685,1018.4,84.9
"5564","18258","2018",8,8,0,67375,1028.625,63.125
"5565","18259","2018",3,3,0,61333.3333333333,673,89.6666666666667
"5566","18261","2018",6,6,0,339504.5,2452.5,104.333333333333
"5567","18262","2018",4,4,0,66750,1023,65.25
"5568","18263","2018",9,9,0,99333.3333333333,993.333333333333,99
"5569","18264","2018",3,3,0,126500,1131.33333333333,119
"5570","18265","2018",9,9,0,69000,910.888888888889,77.2222222222222
"5571","18266","2018",3,3,0,108666.666666667,1048.33333333333,99.6666666666667
"5572","18267","2018",42,42,0,162045.023809524,1643.35714285714,97.5952380952381
"5573","18268","2018",1,1,0,127000,1789,71
"5574","18269","2018",8,8,0,120156.25,1100,100.375
"5575","18271","2018",15,15,0,177792.733333333,1819.66666666667,99.8666666666667
"5576","18272","2018",6,6,0,119450,923.833333333333,125.333333333333
"5577","18273","2018",6,6,0,81083.3333333333,954.5,86
"5578","18274","2018",1,1,0,32000,582,55
"5579","18275","2018",1,1,0,82000,713,115
"5580","18276","2018",4,4,0,107225,1485.5,93.5
"5581","18277","2018",1,1,0,147000,1225,120
"5582","18278","2018",10,10,0,89630,1078.1,82.6
"5583","18279","2018",285,242,43,73420.3789473684,883.077192982456,82.6140350877193
"5584","18280","2018",6,6,0,142512.5,1149.66666666667,126.833333333333
"5585","18281","2018",36,36,0,114818.75,1186.33333333333,98.4444444444444
"5586","18282","2018",8,8,0,126663.75,1189,109.875
"5587","18283","2018",2,2,0,74250,708,100
"5588","18284","2018",4,4,0,187000,1327.25,128.75
"5589","18285","2018",1,1,0,114000,1583,72
"5590","18286","2018",5,5,0,72200,817.6,89.6
"5591","18287","2018",4,4,0,187500,1302,125.25
"5592","18288","2018",4,4,0,116250,1157,97.75
"5593","18289","2018",2,2,0,160000,1237.5,130
"5594","18290","2018",6,6,0,85916.6666666667,1250.66666666667,69.5
"5595","19001","2018",4,4,0,153187.5,1670.75,89.5
"5596","19002","2018",2,2,0,101500,1435,69.5
"5597","19003","2018",1,1,0,20000,571,35
"5598","19004","2018",6,6,0,68251.6666666667,944.166666666667,72
"5599","19005","2018",54,52,2,122106.740740741,1349.09259259259,93.2037037037037
"5600","19007","2018",8,8,0,121163.25,1302.875,87.125
"5601","19008","2018",5,5,0,82600,1229.6,83.2
"5602","19009","2018",4,4,0,172750,1974.75,89.75
"5603","19010","2018",37,31,6,93200.027027027,1160.59459459459,83.8378378378378
"5604","19011","2018",14,12,2,75126.4285714286,1008,79.2142857142857
"5605","19012","2018",5,5,0,121836.6,1263,94
"5606","19013","2018",15,15,0,153090,1485.8,102.066666666667
"5607","19014","2018",7,7,0,136214.285714286,1078.57142857143,123.142857142857
"5608","19015","2018",5,5,0,109000,1115.2,102.8
"5609","19016","2018",1,1,0,42000,467,90
"5610","19017","2018",5,5,0,58600,890.2,63.2
"5611","19018","2018",7,7,0,143207.142857143,1177,140.285714285714
"5612","19019","2018",16,16,0,100856.875,1494.5,85.6875
"5613","19020","2018",4,4,0,85125,856.25,101.25
"5614","19021","2018",1,1,0,48000,774,62
"5615","19022","2018",3,3,0,85400,972.333333333333,102.666666666667
"5616","19023","2018",14,14,0,103106.5,1381,83.8571428571429
"5617","19024","2018",4,4,0,141375,1063.25,137.25
"5618","19026","2018",2,2,0,176000,1063,164.5
"5619","19027","2018",1,1,0,155000,660,235
"5620","19028","2018",21,17,4,74038.0952380952,1096.42857142857,77.5714285714286
"5621","19029","2018",5,5,0,168800,1829.2,102
"5622","19030","2018",7,7,0,156663.428571429,1464.42857142857,108
"5623","19031","2018",772,415,357,125269.966321244,1538.75647668394,81.1658031088083
"5624","19033","2018",7,7,0,52464.2857142857,739.571428571429,77.2857142857143
"5625","19034","2018",1,1,0,55000,724,76
"5626","19035","2018",9,9,0,86222.2222222222,1039.22222222222,84.7777777777778
"5627","19036","2018",18,18,0,81900.4444444444,1082.83333333333,85.1111111111111
"5628","19037","2018",17,17,0,110115.294117647,946.294117647059,115.176470588235
"5629","19038","2018",6,6,0,126250,1320.33333333333,93.3333333333333
"5630","19039","2018",5,5,0,70068,1134.8,64.8
"5631","19040","2018",4,4,0,120625,1161.75,117.5
"5632","19041","2018",5,5,0,115400,1095,100.8
"5633","19042","2018",8,8,0,92400,960,94.875
"5634","19043","2018",1,1,0,181800,1998,91
"5635","19045","2018",1,1,0,163500,1220,134
"5636","19046","2018",2,2,0,72500,717.5,98.5
"5637","19047","2018",3,3,0,97666.6666666667,986.333333333333,100.666666666667
"5638","19049","2018",8,8,0,126282.5,1582.5,81
"5639","19050","2018",3,3,0,182000,1268.66666666667,145
"5640","19051","2018",3,3,0,68333.3333333333,710,93
"5641","19053","2018",2,2,0,197240,1747,114.5
"5642","19054","2018",4,4,0,77450,849.5,90.75
"5643","19055","2018",3,3,0,187326.666666667,1823.33333333333,102
"5644","19056","2018",6,6,0,80916.6666666667,990.5,84.3333333333333
"5645","19057","2018",5,5,0,199572,2199,95.4
"5646","19058","2018",5,5,0,171200,1673.8,106.6
"5647","19059","2018",5,5,0,69700,944.8,75
"5648","19060","2018",6,6,0,112489.166666667,1301.66666666667,84.8333333333333
"5649","19061","2018",6,6,0,110083.333333333,1332,88
"5650","19062","2018",9,8,1,65000,855.222222222222,86.5555555555556
"5651","19063","2018",31,28,3,192484.225806452,1997.06451612903,114.677419354839
"5652","19065","2018",1,1,0,130000,2241,58
"5653","19066","2018",18,18,0,171568.333333333,1545.16666666667,114.277777777778
"5654","19067","2018",4,4,0,97500,960.25,101.75
"5655","19068","2018",4,4,0,123500,1195,102.75
"5656","19069","2018",1,1,0,60000,833,72
"5657","19070","2018",2,2,0,41250,663,67
"5658","19071","2018",3,3,0,49000,592.333333333333,86
"5659","19072","2018",36,35,1,135651.583333333,1508.08333333333,94.3611111111111
"5660","19073","2018",37,31,6,113042.432432432,1259.02702702703,95.0810810810811
"5661","19074","2018",1,0,1,74640,1696,44
"5662","19075","2018",4,4,0,98500,1413.5,76.5
"5663","19076","2018",2,2,0,52500,827,63.5
"5664","19078","2018",5,5,0,127000,1529.2,88.6
"5665","19079","2018",3,3,0,98933.3333333333,1083.33333333333,79.6666666666667
"5666","19080","2018",6,6,0,91741.6666666667,964.166666666667,94.1666666666667
"5667","19081","2018",1,1,0,250000,1250,200
"5668","19082","2018",11,11,0,154328.818181818,1295,119.818181818182
"5669","19083","2018",1,1,0,134000,1396,96
"5670","19084","2018",3,3,0,142083.333333333,1009.33333333333,129
"5671","19085","2018",6,6,0,120808,1141.66666666667,110.333333333333
"5672","19086","2018",4,4,0,70650,978,80.5
"5673","19087","2018",4,4,0,87625,739.5,115.75
"5674","19088","2018",1,1,0,66000,600,110
"5675","19089","2018",1,1,0,61730,772,80
"5676","19091","2018",1,1,0,140400,1433,98
"5677","19093","2018",13,13,0,165884.615384615,1512.76923076923,106.538461538462
"5678","19094","2018",12,11,1,75041.6666666667,847.25,91
"5679","19095","2018",3,3,0,149000,1690.33333333333,84.6666666666667
"5680","19096","2018",3,3,0,97500,1189,74.6666666666667
"5681","19097","2018",3,3,0,59000,986.333333333333,66
"5682","19098","2018",12,12,0,114650,1167.41666666667,98
"5683","19099","2018",4,4,0,104617.5,1542.25,77.5
"5684","19100","2018",14,14,0,111468.928571429,1234,95
"5685","19101","2018",16,15,1,83781.25,1134.5,74.125
"5686","19102","2018",2,2,0,60500,607,97
"5687","19103","2018",2,2,0,144400,1306.5,92.5
"5688","19104","2018",2,2,0,79000,1115,75
"5689","19105","2018",4,4,0,96500,1187.25,78.75
"5690","19106","2018",2,2,0,70500,1029,70.5
"5691","19107","2018",20,15,5,110072.05,1325.55,84.65
"5692","19110","2018",3,3,0,103333.333333333,1919,63
"5693","19111","2018",5,5,0,92056,821,128.4
"5694","19113","2018",15,14,1,114860,1249.2,95.6666666666667
"5695","19115","2018",1,1,0,260000,2600,100
"5696","19117","2018",11,11,0,234372.727272727,1696.27272727273,140.090909090909
"5697","19118","2018",17,16,1,86814.7058823529,958.470588235294,90.5882352941177
"5698","19119","2018",1,1,0,85000,850,100
"5699","19120","2018",2,2,0,147450,1182.5,125
"5700","19121","2018",23,23,0,102280.434782609,1206.95652173913,87.1739130434783
"5701","19122","2018",7,7,0,93662.8571428571,791.714285714286,118.428571428571
"5702","19123","2018",87,72,15,145647.574712644,1540.12643678161,95.9885057471264
"5703","19124","2018",17,17,0,115888.235294118,1347.76470588235,87.8235294117647
"5704","19125","2018",16,16,0,108877.5,1597.9375,86.25
"5705","19126","2018",2,2,0,96000,1507.5,61
"5706","19128","2018",3,2,1,76516.6666666667,1026.66666666667,84.3333333333333
"5707","19129","2018",10,10,0,76600,994.3,75.1
"5708","19130","2018",1,1,0,162000,1820,89
"5709","19131","2018",10,10,0,87750,1011.1,89.9
"5710","19132","2018",1,1,0,128000,1049,122
"5711","19133","2018",1,1,0,80000,1143,70
"5712","19134","2018",8,8,0,70613.75,926,75.375
"5713","19135","2018",4,4,0,131250,1245,95.25
"5714","19136","2018",23,22,1,84542.6086956522,932,92.6086956521739
"5715","19137","2018",1,1,0,156000,975,160
"5716","19138","2018",13,13,0,135620.769230769,1482.92307692308,94.3846153846154
"5717","19139","2018",3,3,0,67333.3333333333,653,106.666666666667
"5718","19140","2018",5,5,0,115000,920,123.6
"5719","19142","2018",1,1,0,131500,2391,55
"5720","19143","2018",5,5,0,78260,855.2,91.6
"5721","19144","2018",1,1,0,170000,1030,165
"5722","19145","2018",3,3,0,52333.3333333333,809.666666666667,71
"5723","19146","2018",12,12,0,130725,1179.25,113.583333333333
"5724","19147","2018",9,9,0,213624.111111111,1684.33333333333,129
"5725","19148","2018",17,17,0,85540,809.588235294118,113.411764705882
"5726","19149","2018",4,4,0,113750,1576,72
"5727","19150","2018",2,2,0,155420,2768,72.5
"5728","19151","2018",13,13,0,190954.615384615,1494.46153846154,128.076923076923
"5729","19152","2018",6,6,0,145752,2077.16666666667,103.666666666667
"5730","19153","2018",41,37,4,121771.951219512,1315.14634146341,92.3414634146341
"5731","19154","2018",4,4,0,77750,817,85.25
"5732","19155","2018",2,2,0,74000,875,92
"5733","19156","2018",2,2,0,170900,1633,113
"5734","19157","2018",2,2,0,77000,1140.5,65
"5735","19158","2018",1,1,0,48500,970,50
"5736","19159","2018",1,1,0,126000,1235,102
"5737","19160","2018",5,5,0,56900,637.8,88.8
"5738","19161","2018",2,2,0,110000,1939,59.5
"5739","19162","2018",15,15,0,130580,1376.6,96.9333333333333
"5740","19163","2018",2,2,0,116095,2336,44
"5741","19164","2018",10,10,0,77060,900.8,86.9
"5742","19165","2018",4,4,0,100500,1173,79
"5743","19166","2018",3,3,0,83177.3333333333,988,106.666666666667
"5744","19168","2018",4,4,0,50000,548,103.75
"5745","19169","2018",2,2,0,138207.5,1127,129.5
"5746","19170","2018",2,2,0,183000,1503.5,128
"5747","19172","2018",2,2,0,89000,981.5,93.5
"5748","19173","2018",3,3,0,55666.6666666667,729.666666666667,92.3333333333333
"5749","19174","2018",5,5,0,79200,891.2,99
"5750","19175","2018",2,2,0,112500,1213.5,93
"5751","19176","2018",14,14,0,89310.7142857143,886.428571428571,99.7142857142857
"5752","19178","2018",8,8,0,122443.75,1463,83.75
"5753","19179","2018",2,2,0,113750,1496.5,74.5
"5754","19180","2018",5,5,0,94270,789.4,112.2
"5755","19181","2018",6,6,0,62500,720,83.3333333333333
"5756","19182","2018",5,4,1,108660,1134.6,89.4
"5757","19184","2018",1,1,0,150000,1250,120
"5758","19186","2018",2,2,0,133500,992,131
"5759","19187","2018",3,3,0,137666.666666667,1074,130
"5760","19188","2018",3,3,0,133333.333333333,1202.66666666667,110
"5761","19189","2018",1,1,0,129000,827,156
"5762","19190","2018",1,1,0,85000,944,90
"5763","19191","2018",7,7,0,124735.714285714,1355.85714285714,96.8571428571429
"5764","19192","2018",3,3,0,67333.3333333333,841.666666666667,87.6666666666667
"5765","19193","2018",2,2,0,92250,1448.5,66.5
"5766","19194","2018",10,9,1,152762.7,1233.3,122.7
"5767","19195","2018",4,4,0,163250,1580,105.5
"5768","19196","2018",4,4,0,113750,1133.5,104.25
"5769","19198","2018",5,5,0,103623.8,1086.2,95.2
"5770","19199","2018",2,2,0,132670,1138,111
"5771","19200","2018",3,3,0,91666.6666666667,1079.66666666667,91.6666666666667
"5772","19201","2018",4,4,0,109375.25,1187.25,97
"5773","19202","2018",18,17,1,166931,1570.83333333333,102.5
"5774","19203","2018",14,13,1,123530,1119.85714285714,111.785714285714
"5775","19205","2018",1,1,0,152000,1382,110
"5776","19206","2018",2,2,0,122500,894,137.5
"5777","19207","2018",6,5,1,171374.333333333,1710,105
"5778","19208","2018",2,2,0,55000,621,108
"5779","19209","2018",1,1,0,60000,769,78
"5780","19211","2018",7,7,0,164686.428571429,1381.71428571429,121.857142857143
"5781","19212","2018",1,1,0,40000,1000,40
"5782","19213","2018",7,7,0,98958.5714285714,1171.85714285714,91.2857142857143
"5783","19214","2018",4,4,0,69875,736,89.5
"5784","19215","2018",1,1,0,230000,1060,217
"5785","19216","2018",4,4,0,84187.5,1156.25,74.25
"5786","19220","2018",4,4,0,74725,915.5,85.5
"5787","19221","2018",1,1,0,197000,1180,167
"5788","19222","2018",2,2,0,222500,1676,135.5
"5789","19223","2018",4,4,0,163750,1060.5,166.75
"5790","19225","2018",5,5,0,82144,1064,79.2
"5791","19226","2018",5,5,0,98000,871.6,108.8
"5792","19227","2018",11,11,0,152113.909090909,1550.36363636364,103.727272727273
"5793","19228","2018",1,1,0,80500,789,102
"5794","19229","2018",58,54,4,146979.25862069,1590.08620689655,93.1551724137931
"5795","19230","2018",5,5,0,123190,1512.6,82.6
"5796","19231","2018",6,6,0,52488.3333333333,719.666666666667,71.1666666666667
"5797","19232","2018",1,1,0,73000,689,106
"5798","19233","2018",2,2,0,151250,1271.5,127.5
"5799","19234","2018",8,8,0,103846.375,1189.125,88.25
"5800","19235","2018",4,4,0,119000,1653.5,74
"5801","19236","2018",6,6,0,92083.3333333333,920.333333333333,98
"5802","19237","2018",13,13,0,109688.076923077,1327.30769230769,86.8461538461538
"5803","19238","2018",2,2,0,92630,961,97.5
"5804","19239","2018",4,3,1,173810.25,1374.5,119.75
"5805","19240","2018",5,5,0,48450,765,67
"5806","19241","2018",4,4,0,68250,745.5,93
"5807","19242","2018",6,6,0,126280,1130.5,115.333333333333
"5808","19243","2018",15,14,1,138253.333333333,1585.93333333333,92.5333333333333
"5809","19244","2018",1,1,0,75000,1071,70
"5810","19245","2018",2,2,0,60860,761.5,81
"5811","19246","2018",15,15,0,145333.333333333,1331.93333333333,110.8
"5812","19247","2018",4,4,0,152712.5,1111.75,125.25
"5813","19248","2018",9,9,0,106622.222222222,1150,92.1111111111111
"5814","19249","2018",3,3,0,78000,1090.33333333333,68.3333333333333
"5815","19250","2018",8,8,0,105512.5,1388.5,80.25
"5816","19251","2018",1,1,0,35000,625,56
"5817","19252","2018",11,11,0,105995.454545455,1068.81818181818,98.3636363636364
"5818","19253","2018",2,2,0,91100,1523,81
"5819","19254","2018",4,4,0,147000,1398,144.75
"5820","19255","2018",18,17,1,118344.444444444,1216.38888888889,100.555555555556
"5821","19256","2018",5,5,0,62600,690.2,88.6
"5822","19257","2018",2,2,0,85000,1018,83
"5823","19258","2018",8,8,0,91256.25,924,95.5
"5824","19259","2018",3,3,0,109066.666666667,860.333333333333,128.666666666667
"5825","19260","2018",2,2,0,78500,835,94
"5826","19261","2018",7,7,0,67860,1063.85714285714,66.4285714285714
"5827","19262","2018",4,4,0,158000,1544.75,130.75
"5828","19263","2018",4,4,0,74500,708.5,99
"5829","19264","2018",8,8,0,53627.5,825.125,69
"5830","19265","2018",6,6,0,75166.6666666667,860.166666666667,90.5
"5831","19266","2018",1,1,0,37700,1077,35
"5832","19268","2018",1,1,0,45000,662,68
"5833","19269","2018",27,25,2,86255.5555555556,787.074074074074,107.592592592593
"5834","19270","2018",7,7,0,123085.714285714,1256,96.1428571428571
"5835","19271","2018",7,7,0,162802.857142857,1796.28571428571,102.714285714286
"5836","19272","2018",162,78,84,76024.5740740741,919.364197530864,82.9506172839506
"5837","19273","2018",9,9,0,198072.222222222,1529.44444444444,137.222222222222
"5838","19274","2018",33,31,2,191053.939393939,1733.15151515152,110.30303030303
"5839","19275","2018",63,50,13,106355.111111111,1213.61904761905,91.7142857142857
"5840","19276","2018",35,29,6,100705.857142857,965.057142857143,105.2
"5841","19278","2018",14,14,0,166678.571428571,1615,106.928571428571
"5842","19280","2018",2,2,0,154795,2854,58
"5843","19281","2018",2,2,0,86500,860,100
"5844","19283","2018",1,1,0,18500,617,30
"5845","19284","2018",1,1,0,69000,958,72
"5846","19285","2018",12,12,0,91195.0833333333,979.25,93.3333333333333
"5847","19286","2018",5,5,0,73100,771.8,89.4
"5848","19287","2018",5,5,0,113203,1142.6,104.4
"5849","19288","2018",11,11,0,135104.545454545,1304.09090909091,104.636363636364
"5850","19289","2018",4,4,0,91575,1093.25,77.75
"5851","21001","2018",3,3,0,179666.666666667,1848.66666666667,98.3333333333333
"5852","21002","2018",3,3,0,204941.666666667,2210,93.3333333333333
"5853","21003","2018",15,11,4,312546.866666667,2447.13333333333,121.466666666667
"5854","21004","2018",4,4,0,74625,560.75,126.5
"5855","21005","2018",27,26,1,181884.62962963,1760.44444444444,105.62962962963
"5856","21006","2018",6,6,0,79333.3333333333,788,99
"5857","21007","2018",3,3,0,140666.666666667,935.333333333333,139
"5858","21008","2018",4,4,0,87625,1160.75,73.75
"5859","21009","2018",2,2,0,121000,1003.5,120
"5860","21010","2018",1,1,0,134000,2481,54
"5861","21011","2018",2,2,0,83500,926.5,88
"5862","21012","2018",2,2,0,101858.5,700,150
"5863","21013","2018",5,4,1,149467.6,1914,81.2
"5864","21014","2018",2,2,0,92000,681.5,133
"5865","21016","2018",9,9,0,263705.555555556,2185,122.777777777778
"5866","21017","2018",10,10,0,194816.5,1889.7,108.2
"5867","21020","2018",4,4,0,107750,1203.75,85.75
"5868","21021","2018",32,31,1,235352.6875,2211.59375,106.71875
"5869","21022","2018",8,8,0,208480,2022.5,105
"5870","21023","2018",13,11,2,97750.1538461538,1021,98.1538461538462
"5871","21024","2018",1,1,0,166250,2188,76
"5872","21025","2018",1,1,0,91600,804,114
"5873","21027","2018",13,10,3,338430.769230769,2584.07692307692,129.307692307692
"5874","21028","2018",9,9,0,152777.777777778,1477,106.777777777778
"5875","21030","2018",1,1,0,85000,850,100
"5876","21031","2018",7,7,0,166595.285714286,1443.57142857143,113.714285714286
"5877","21032","2018",1,1,0,126850,1738,73
"5878","21033","2018",3,3,0,86881.3333333333,902.333333333333,89.6666666666667
"5879","21034","2018",2,2,0,52020.5,714.5,74.5
"5880","21035","2018",8,8,0,95411.875,1209.875,79.125
"5881","21036","2018",1,1,0,65000,867,75
"5882","21037","2018",4,4,0,94258.75,1622.75,56.75
"5883","21038","2018",76,53,23,125599.802631579,1318.13157894737,95.5
"5884","21040","2018",1,1,0,26950,402,67
"5885","21041","2018",3,3,0,117500,1051,114
"5886","21042","2018",2,2,0,109000,1184.5,84.5
"5887","21043","2018",1,1,0,211000,1388,152
"5888","21044","2018",2,2,0,172500,1320,134.5
"5889","21045","2018",4,4,0,92150,1099.25,93
"5890","21046","2018",2,2,0,26500,560,57.5
"5891","21050","2018",4,4,0,141087.5,1136.75,138.5
"5892","21051","2018",2,2,0,210825,1344.5,155.5
"5893","21052","2018",1,1,0,48750,393,124
"5894","21053","2018",4,4,0,149875,1261.25,158.75
"5895","21054","2018",338,146,192,177016.053254438,2140.47633136095,81.7721893491124
"5896","21056","2018",12,10,2,205464.833333333,1745.16666666667,120.75
"5897","21057","2018",2,2,0,160500,2281,79
"5898","21058","2018",2,2,0,42583.5,561.5,71.5
"5899","21059","2018",14,14,0,334849.642857143,2659.21428571429,130.928571428571
"5900","21060","2018",12,12,0,170027.916666667,1858.33333333333,96.4166666666667
"5901","21061","2018",3,3,0,52466.6666666667,515.333333333333,104
"5902","21062","2018",2,2,0,72750,1257,60.5
"5903","21064","2018",3,3,0,107833.333333333,1355.33333333333,73.6666666666667
"5904","21066","2018",1,1,0,55000,611,90
"5905","21067","2018",9,9,0,150761.111111111,1613.22222222222,93.6666666666667
"5906","21069","2018",2,2,0,41750,676,56.5
"5907","21070","2018",2,2,0,132800,1591.5,106.5
"5908","21071","2018",13,12,1,144953.846153846,1564.76923076923,92.5384615384615
"5909","21072","2018",1,1,0,225500,1311,172
"5910","21074","2018",1,1,0,220000,1571,140
"5911","21076","2018",8,8,0,212837.5,1898.875,114.375
"5912","21077","2018",3,3,0,125333.333333333,1054,132
"5913","21079","2018",3,3,0,97391.6666666667,1497.33333333333,65
"5914","21080","2018",6,6,0,103191.666666667,842.666666666667,133.833333333333
"5915","21083","2018",3,3,0,80000,750,111
"5916","21085","2018",1,1,0,110000,733,150
"5917","21086","2018",12,12,0,203079.166666667,1793.25,114.75
"5918","21087","2018",9,9,0,150491.666666667,1475.22222222222,102.666666666667
"5919","21088","2018",3,3,0,230000,1830.66666666667,122
"5920","21089","2018",7,7,0,157035.714285714,1507.57142857143,107.428571428571
"5921","21090","2018",2,2,0,27000,443.5,61
"5922","21091","2018",1,1,0,46000,902,51
"5923","21092","2018",3,3,0,116300,1204.33333333333,85.3333333333333
"5924","21093","2018",3,3,0,125500,1010,120.333333333333
"5925","21094","2018",2,2,0,180500,1551,119
"5926","21095","2018",2,2,0,55000,1038.5,54
"5927","21096","2018",3,3,0,109270,1068.33333333333,105.333333333333
"5928","21098","2018",1,1,0,45000,469,96
"5929","21099","2018",6,6,0,134173.666666667,1619.83333333333,79.6666666666667
"5930","21101","2018",2,2,0,114000,1790,72.5
"5931","21103","2018",25,25,0,158826,1825.04,92.84
"5932","21104","2018",1,1,0,35000,636,55
"5933","21105","2018",10,10,0,243180,2297.8,108.9
"5934","21106","2018",6,6,0,220121.833333333,1729.16666666667,127.666666666667
"5935","21107","2018",16,15,1,332575,2624.3125,122.9375
"5936","21108","2018",1,1,0,146000,1074,136
"5937","21109","2018",4,4,0,41500,670.75,57.75
"5938","21110","2018",3,1,2,165840,1570.66666666667,106
"5939","21111","2018",6,6,0,180833.333333333,1994.33333333333,93.3333333333333
"5940","21112","2018",4,4,0,124175,1337.25,90.5
"5941","21113","2018",2,2,0,252000,1505.5,170
"5942","21114","2018",2,2,0,61500,867,68
"5943","21115","2018",5,5,0,91000,1056.4,92.2
"5944","21116","2018",1,1,0,32000,390,82
"5945","21117","2018",1,1,0,1e+05,943,106
"5946","21119","2018",1,1,0,60000,462,130
"5947","21120","2018",2,2,0,368987.5,1804.5,210
"5948","21121","2018",4,4,0,122500,1079.75,110
"5949","21122","2018",3,3,0,381666.666666667,2559.33333333333,135
"5950","21125","2018",2,2,0,94585.5,934,104
"5951","21126","2018",7,7,0,155842.857142857,1492.85714285714,105.571428571429
"5952","21127","2018",4,4,0,254362.5,1865.5,142.5
"5953","21128","2018",4,4,0,69375,642,98
"5954","21129","2018",1,1,0,85000,1062,80
"5955","21130","2018",9,9,0,160822.222222222,1649.33333333333,98.3333333333333
"5956","21131","2018",8,8,0,108375,938,112
"5957","21132","2018",4,4,0,226250,1932.5,116.75
"5958","21133","2018",4,4,0,170525,1977,98.75
"5959","21134","2018",3,3,0,62333.3333333333,661,95.3333333333333
"5960","21135","2018",1,1,0,130000,793,164
"5961","21137","2018",2,2,0,111850,885,125
"5962","21138","2018",5,5,0,164220,1393.4,133.6
"5963","21139","2018",6,6,0,94806.6666666667,1125,105.666666666667
"5964","21140","2018",2,2,0,50250,869.5,54
"5965","21142","2018",3,3,0,78170,740.666666666667,97
"5966","21143","2018",3,3,0,95500,944.666666666667,100.333333333333
"5967","21145","2018",1,1,0,70000,1556,45
"5968","21146","2018",1,1,0,2e+05,1667,120
"5969","21147","2018",1,1,0,76000,679,112
"5970","21148","2018",6,6,0,178666.666666667,1284.5,134.333333333333
"5971","21150","2018",2,2,0,62500,1131,50
"5972","21151","2018",2,2,0,97000,1119.5,86
"5973","21152","2018",2,2,0,105000,876,111
"5974","21153","2018",2,2,0,62500,887.5,75
"5975","21154","2018",60,28,32,86680.0666666667,1025.26666666667,83.5
"5976","21155","2018",1,1,0,58000,734,79
"5977","21158","2018",2,2,0,101627.5,1076.5,93.5
"5978","21159","2018",1,1,0,48000,403,119
"5979","21160","2018",2,2,0,151500,1050.5,135
"5980","21162","2018",4,4,0,164500,1866.75,88.75
"5981","21163","2018",3,3,0,177333.333333333,1192,161.333333333333
"5982","21164","2018",2,2,0,93710,1104.5,80
"5983","21166","2018",145,63,82,137434.586206897,1619.67586206897,81.8137931034483
"5984","21167","2018",3,3,0,139850,1792,79.6666666666667
"5985","21168","2018",1,1,0,70000,854,82
"5986","21169","2018",4,3,1,157250,1671,82
"5987","21170","2018",3,3,0,214966.666666667,1904.33333333333,117
"5988","21171","2018",162,54,108,169781.419753086,2035.76543209877,84.4012345679012
"5989","21172","2018",4,4,0,163750,1253.25,136.75
"5990","21173","2018",5,5,0,206270,1964.2,106.4
"5991","21175","2018",7,7,0,142687.285714286,1547.14285714286,94.2857142857143
"5992","21176","2018",3,3,0,101166.666666667,1239.33333333333,78
"5993","21177","2018",3,3,0,86100,879.666666666667,113.666666666667
"5994","21178","2018",3,3,0,129666.666666667,2408.33333333333,85.6666666666667
"5995","21179","2018",6,6,0,291176.666666667,2322.83333333333,125.166666666667
"5996","21180","2018",6,6,0,124575,1117.83333333333,114.333333333333
"5997","21181","2018",3,3,0,178073.333333333,1192.33333333333,121.333333333333
"5998","21182","2018",2,2,0,226500,1858,150
"5999","21183","2018",10,10,0,190250,1980.3,97
"6000","21184","2018",1,1,0,50000,446,112
"6001","21185","2018",4,4,0,289237.75,1752,175
"6002","21186","2018",15,15,0,124148.666666667,1457.6,87.4666666666667
"6003","21187","2018",1,1,0,1e+05,581,172
"6004","21189","2018",5,5,0,230900,2140.2,139.4
"6005","21190","2018",3,3,0,191633.333333333,1853.33333333333,101.333333333333
"6006","21191","2018",14,14,0,202013.571428571,1803.85714285714,112.857142857143
"6007","21192","2018",13,12,1,254323.076923077,2046.76923076923,127.923076923077
"6008","21193","2018",4,4,0,212007.5,1517.25,141.25
"6009","21194","2018",12,11,1,141781.666666667,1478.33333333333,95.0833333333333
"6010","21195","2018",2,2,0,202550,1523,132
"6011","21196","2018",10,10,0,180645,1595.5,115.3
"6012","21198","2018",2,2,0,169000,1269.5,132.5
"6013","21200","2018",14,13,1,191867.142857143,2134.14285714286,90
"6014","21201","2018",2,2,0,158500,1203,130
"6015","21202","2018",1,1,0,15000,750,20
"6016","21203","2018",3,3,0,56916.6666666667,655.333333333333,87
"6017","21204","2018",1,1,0,220000,1803,122
"6018","21205","2018",2,2,0,79000,1068,75
"6019","21207","2018",1,1,0,75900,1380,55
"6020","21208","2018",3,3,0,153200,1800.33333333333,85.6666666666667
"6021","21209","2018",31,28,3,291808.548387097,2565.35483870968,118.838709677419
"6022","21210","2018",6,6,0,144841.666666667,1440.66666666667,110.333333333333
"6023","21211","2018",1,1,0,142000,2152,66
"6024","21212","2018",4,4,0,81500,851.75,94
"6025","21214","2018",3,3,0,103333.333333333,916,110
"6026","21215","2018",3,3,0,185466.666666667,1692.33333333333,117.333333333333
"6027","21216","2018",2,2,0,185700,1296.5,155
"6028","21218","2018",3,3,0,142666.666666667,1132.66666666667,122.333333333333
"6029","21219","2018",1,1,0,340000,1283,265
"6030","21220","2018",1,1,0,57960,644,90
"6031","21222","2018",1,1,0,20000,392,51
"6032","21223","2018",17,17,0,392701.470588235,2678.47058823529,144.941176470588
"6033","21224","2018",1,1,0,92000,541,170
"6034","21226","2018",1,1,0,176000,1676,105
"6035","21227","2018",2,2,0,354988,2082,176
"6036","21228","2018",1,1,0,210050,2020,104
"6037","21230","2018",4,4,0,218650,1964.75,116
"6038","21231","2018",3168,459,2709,141224.65625,2210.15025252525,64.0795454545455
"6039","21232","2018",1,1,0,85500,611,140
"6040","21233","2018",2,2,0,139400,1388,105
"6041","21234","2018",2,2,0,88600,1583,55.5
"6042","21235","2018",1,1,0,61600,474,130
"6043","21236","2018",1,1,0,119000,1240,96
"6044","21237","2018",1,1,0,109000,690,158
"6045","21239","2018",11,11,0,130636.363636364,1395.36363636364,92.3636363636364
"6046","21240","2018",7,5,2,143633.571428571,1276.85714285714,121.857142857143
"6047","21241","2018",4,4,0,338675,2483.5,138.75
"6048","21242","2018",2,2,0,70750,790,105
"6049","21245","2018",3,3,0,260320,2107.66666666667,120.666666666667
"6050","21246","2018",2,2,0,273750,2191.5,120
"6051","21247","2018",14,13,1,97821.4285714286,1138.21428571429,87.0714285714286
"6052","21248","2018",1,1,0,70000,897,78
"6053","21249","2018",10,10,0,105590,1059.5,101
"6054","21250","2018",1,1,0,34000,507,67
"6055","21251","2018",5,5,0,158470.2,1158.8,140.8
"6056","21252","2018",1,1,0,310000,1902,163
"6057","21253","2018",1,1,0,52000,634,82
"6058","21254","2018",2,2,0,231120,1792,132
"6059","21255","2018",4,4,0,106625,848,127.5
"6060","21256","2018",1,1,0,257670,1610,160
"6061","21257","2018",2,2,0,82500,862.5,110.5
"6062","21258","2018",2,2,0,111375,1005,111.5
"6063","21259","2018",6,6,0,114433.333333333,1147.66666666667,100.333333333333
"6064","21260","2018",1,1,0,78000,951,82
"6065","21261","2018",4,4,0,347287.5,2435,139.75
"6066","21263","2018",26,26,0,274794.423076923,2299.5,120.538461538462
"6067","21264","2018",1,1,0,115000,1000,115
"6068","21265","2018",9,9,0,296000,2292,124.444444444444
"6069","21266","2018",2,2,0,229500,1345,183.5
"6070","21267","2018",4,4,0,154500,1895,85.5
"6071","21268","2018",5,5,0,141617.2,1037.4,155
"6072","21269","2018",8,8,0,143812.5,1303.25,110.375
"6073","21270","2018",6,6,0,196500,1658.33333333333,115.666666666667
"6074","21271","2018",7,7,0,147142.857142857,1539.57142857143,116.857142857143
"6075","21272","2018",5,5,0,133040,1107,114.8
"6076","21273","2018",12,12,0,210796,1854.91666666667,114.666666666667
"6077","21274","2018",3,3,0,109758.333333333,776.333333333333,143.333333333333
"6078","21275","2018",4,4,0,168050,1434.25,121.75
"6079","21277","2018",17,17,0,126969.117647059,1318.35294117647,105.647058823529
"6080","21278","2018",180,82,98,222117.788888889,2413.21666666667,89.7166666666667
"6081","21281","2018",1,1,0,176700,1210,146
"6082","21282","2018",2,2,0,57500,1057.5,57.5
"6083","21284","2018",2,2,0,2e+05,2035.5,102
"6084","21285","2018",8,8,0,150646.5,1645.75,99.625
"6085","21286","2018",4,4,0,240307.5,1380.5,161
"6086","21287","2018",1,1,0,53400,763,70
"6087","21288","2018",4,4,0,146425,1201.75,136
"6088","21289","2018",1,1,0,133000,2558,52
"6089","21290","2018",9,8,1,216727.777777778,1945.33333333333,112
"6090","21291","2018",1,1,0,150000,1829,82
"6091","21292","2018",66,48,18,144233.333333333,1698.63636363636,89.3484848484848
"6092","21293","2018",1,1,0,197000,1894,104
"6093","21294","2018",3,3,0,350366.666666667,1914,177
"6094","21295","2018",15,7,8,181833.333333333,1838.26666666667,98.9333333333333
"6095","21296","2018",1,1,0,64500,371,174
"6096","21297","2018",6,6,0,150903.333333333,1683.33333333333,87.5
"6097","21299","2018",2,2,0,70000,872.5,81
"6098","21300","2018",4,4,0,169750,1462,119.75
"6099","21301","2018",5,5,0,135521,1157,105.4
"6100","21305","2018",2,2,0,170000,1210.5,138.5
"6101","21306","2018",2,2,0,51325,560.5,91.5
"6102","21307","2018",1,1,0,63300,688,92
"6103","21308","2018",2,2,0,98000,570,172
"6104","21309","2018",1,1,0,120000,469,256
"6105","21310","2018",4,4,0,122850,917,129
"6106","21311","2018",2,2,0,116950,1188.5,99
"6107","21312","2018",1,1,0,85500,534,160
"6108","21315","2018",10,10,0,429709,2666.1,157.2
"6109","21316","2018",3,3,0,97666.6666666667,1460,63.3333333333333
"6110","21317","2018",35,33,2,169799.485714286,1715.74285714286,104.428571428571
"6111","21319","2018",12,12,0,198831.75,1806.33333333333,110.75
"6112","21320","2018",6,6,0,200416.666666667,2028,106.333333333333
"6113","21321","2018",5,5,0,65100,1007.6,64
"6114","21322","2018",3,3,0,165833.333333333,1960.66666666667,108.333333333333
"6115","21323","2018",1,1,0,80000,635,126
"6116","21324","2018",2,2,0,199930,1562,140.5
"6117","21325","2018",2,2,0,40488.5,653,61
"6118","21326","2018",1,1,0,58000,725,80
"6119","21327","2018",3,3,0,150666.666666667,974,130
"6120","21330","2018",3,3,0,189266.666666667,1742,123.666666666667
"6121","21331","2018",4,4,0,102500,1406.5,78
"6122","21332","2018",18,17,1,132455.555555556,1652.38888888889,103.055555555556
"6123","21333","2018",2,2,0,126250,1042,112.5
"6124","21334","2018",1,1,0,83500,870,96
"6125","21335","2018",1,1,0,129240,1144,113
"6126","21336","2018",5,5,0,77400,751.8,106.8
"6127","21337","2018",17,17,0,136429.411764706,1418,95.8235294117647
"6128","21338","2018",1,1,0,60000,455,132
"6129","21339","2018",8,8,0,225456.25,1803.625,130.625
"6130","21340","2018",5,5,0,126700,1203.8,109.2
"6131","21341","2018",1,1,0,223650,1818,123
"6132","21342","2018",5,5,0,126400,1247.6,97.8
"6133","21343","2018",1,1,0,80000,533,150
"6134","21344","2018",5,5,0,115400,1877.2,62.8
"6135","21345","2018",4,4,0,100375,946.5,117.75
"6136","21346","2018",3,3,0,91166.6666666667,954.666666666667,99
"6137","21347","2018",9,8,1,310374.444444444,2369.55555555556,132
"6138","21349","2018",5,5,0,74780,1031.8,73.4
"6139","21351","2018",13,12,1,151209.230769231,1530.61538461538,106.230769230769
"6140","21352","2018",7,6,1,135471.428571429,1367,102.571428571429
"6141","21353","2018",8,7,1,176081.875,1834.375,94.875
"6142","21355","2018",90,43,47,162390.522222222,1958.68888888889,80.0222222222222
"6143","21356","2018",25,24,1,139662.8,1425.92,100.56
"6144","21357","2018",1,1,0,26000,361,72
"6145","21358","2018",2,2,0,146000,601.5,210.5
"6146","21360","2018",2,2,0,99975,1262,77.5
"6147","21361","2018",4,4,0,107925,1150.25,104.25
"6148","21362","2018",3,3,0,112333.333333333,1202,102.666666666667
"6149","21363","2018",6,6,0,109388.333333333,1228.16666666667,94
"6150","21364","2018",1,1,0,64600,587,110
"6151","21366","2018",5,5,0,193800,1916,95.8
"6152","21368","2018",2,2,0,450000,4833.5,80
"6153","21369","2018",1,1,0,147550,1553,95
"6154","21370","2018",13,13,0,228586.153846154,2095.38461538462,110.307692307692
"6155","21371","2018",8,8,0,99900,1255.25,80
"6156","21372","2018",1,1,0,190000,1180,161
"6157","21373","2018",10,8,2,186753,1548.3,117.5
"6158","21374","2018",3,3,0,81433.3333333333,867.666666666667,88.6666666666667
"6159","21375","2018",2,2,0,70000,1074,71.5
"6160","21376","2018",3,3,0,233333.333333333,1836.33333333333,130.666666666667
"6161","21377","2018",1,1,0,50000,442,113
"6162","21379","2018",5,5,0,69850,862.4,89.4
"6163","21380","2018",1,1,0,142000,1392,102
"6164","21382","2018",1,1,0,166000,1612,103
"6165","21383","2018",20,20,0,177151.3,1628.7,110.85
"6166","21384","2018",4,4,0,286562.5,3873.25,84.25
"6167","21385","2018",3,3,0,132566.666666667,1250.33333333333,98.6666666666667
"6168","21386","2018",2,2,0,122000,1118.5,106
"6169","21387","2018",4,4,0,240405,1685.5,158.25
"6170","21388","2018",3,3,0,189583.333333333,1870.66666666667,101
"6171","21389","2018",2,2,0,99485,1117,96.5
"6172","21390","2018",73,68,5,188935.616438356,2186.24657534247,88.1095890410959
"6173","21391","2018",14,14,0,266461.785714286,2104.5,137.571428571429
"6174","21392","2018",2,2,0,79610,1017.5,73
"6175","21393","2018",1,1,0,125000,1712,73
"6176","21394","2018",3,3,0,84333.3333333333,1099.66666666667,73
"6177","21395","2018",1,1,0,85500,1402,61
"6178","21397","2018",2,1,1,141000,1622,92.5
"6179","21398","2018",4,4,0,113500,1189.75,89.5
"6180","21399","2018",2,2,0,100256,1282.5,92
"6181","21401","2018",3,3,0,243533.333333333,1966.33333333333,123
"6182","21403","2018",1,1,0,80000,964,83
"6183","21404","2018",2,2,0,79500,976,98
"6184","21406","2018",1,1,0,181800,1151,158
"6185","21407","2018",3,3,0,173000,1798.33333333333,94.6666666666667
"6186","21408","2018",22,19,3,319042.954545455,2385.95454545455,138.545454545455
"6187","21409","2018",8,8,0,140897.875,1708,86.25
"6188","21411","2018",10,10,0,189310,1681.1,111.8
"6189","21412","2018",13,13,0,254801.923076923,2465.76923076923,107.076923076923
"6190","21413","2018",1,1,0,140000,864,162
"6191","21414","2018",4,4,0,145700,1115.5,129.5
"6192","21415","2018",1,1,0,59640,1355,44
"6193","21416","2018",19,14,5,169995.105263158,1821.63157894737,96.7368421052632
"6194","21417","2018",2,2,0,236825,1416.5,165
"6195","21418","2018",1,1,0,90000,581,155
"6196","21419","2018",1,1,0,106025,1414,75
"6197","21420","2018",3,3,0,112716.666666667,1265.33333333333,87
"6198","21422","2018",2,2,0,101000,953,105.5
"6199","21423","2018",9,9,0,212255.555555556,1815.33333333333,119.222222222222
"6200","21425","2018",40,31,9,96152.2,1116.15,84.375
"6201","21426","2018",2,2,0,127000,1581,80.5
"6202","21427","2018",4,4,0,202975,1386,149.5
"6203","21428","2018",1,1,0,845125,3073,275
"6204","21429","2018",1,1,0,125000,1404,89
"6205","21432","2018",1,1,0,122000,663,184
"6206","21433","2018",5,5,0,114135,671.2,174.6
"6207","21434","2018",3,3,0,128506.666666667,885,145.666666666667
"6208","21435","2018",4,4,0,147500,1420,103.5
"6209","21436","2018",1,1,0,212450,1221,174
"6210","21437","2018",2,2,0,106700,1748,61
"6211","21438","2018",1,1,0,30000,448,67
"6212","21439","2018",2,2,0,211500,1542.5,137
"6213","21440","2018",4,4,0,174975,1723.75,103.5
"6214","21441","2018",5,5,0,98400,1047.2,92.2
"6215","21442","2018",14,13,1,192221.928571429,1874.14285714286,101.357142857143
"6216","21444","2018",1,1,0,80000,656,122
"6217","21445","2018",3,3,0,106483.333333333,1074,103.333333333333
"6218","21446","2018",2,2,0,115000,1207,97
"6219","21450","2018",1,1,0,141000,1410,100
"6220","21451","2018",2,2,0,111700,1163.5,105
"6221","21452","2018",21,20,1,191169.047619048,2085.09523809524,95.1904761904762
"6222","21454","2018",4,4,0,62112.5,850.75,74.5
"6223","21455","2018",1,1,0,80000,1000,80
"6224","21456","2018",3,3,0,55000,765.666666666667,64.6666666666667
"6225","21457","2018",2,2,0,38500,822.5,43.5
"6226","21458","2018",13,13,0,208592.307692308,1857.38461538462,118.923076923077
"6227","21459","2018",2,2,0,129200,1490,83.5
"6228","21460","2018",1,1,0,60000,909,66
"6229","21461","2018",18,18,0,108419.444444444,1073.33333333333,92.5
"6230","21462","2018",14,13,1,247984.214285714,2372.64285714286,107.928571428571
"6231","21464","2018",82,45,37,154223.353658537,1771.69512195122,88.0487804878049
"6232","21465","2018",1,1,0,50000,714,70
"6233","21469","2018",1,1,0,149900,1020,147
"6234","21473","2018",5,5,0,343100,3784.4,80.4
"6235","21474","2018",4,4,0,110700,1159,113.75
"6236","21475","2018",7,7,0,122214.285714286,1260.28571428571,98
"6237","21476","2018",2,2,0,143275,879.5,160
"6238","21477","2018",1,1,0,249200,3461,72
"6239","21478","2018",6,6,0,223906.666666667,1658.66666666667,134.666666666667
"6240","21480","2018",5,5,0,220050,2323.4,93.2
"6241","21481","2018",12,9,3,256587.916666667,2410.58333333333,110.416666666667
"6242","21482","2018",12,12,0,112763.75,1115.08333333333,105.833333333333
"6243","21483","2018",1,1,0,168400,1981,85
"6244","21485","2018",37,22,15,172450.810810811,2112.08108108108,83.8378378378378
"6245","21487","2018",2,2,0,114000,1601,71.5
"6246","21488","2018",1,1,0,82000,404,203
"6247","21490","2018",1,1,0,90000,900,100
"6248","21492","2018",4,4,0,324662.5,2098.5,129.5
"6249","21493","2018",7,7,0,130642.857142857,1393.85714285714,95.7142857142857
"6250","21494","2018",3,3,0,67733.3333333333,1003.33333333333,73.3333333333333
"6251","21496","2018",18,16,2,104700.833333333,1272.94444444444,90.6666666666667
"6252","21497","2018",1,1,0,75000,987,76
"6253","21499","2018",3,3,0,96666.6666666667,1001,99.6666666666667
"6254","21500","2018",9,9,0,125066.666666667,1365.22222222222,93.7777777777778
"6255","21501","2018",10,8,2,137200,1647.5,93.3
"6256","21502","2018",11,11,0,110063.636363636,1202.90909090909,95.9090909090909
"6257","21503","2018",1,1,0,110000,815,135
"6258","21505","2018",7,7,0,148642.857142857,1345.57142857143,107.428571428571
"6259","21506","2018",8,8,0,147437.5,1610.5,97.375
"6260","21508","2018",7,7,0,267822.857142857,1990.28571428571,143.428571428571
"6261","21510","2018",2,2,0,56500,731,68.5
"6262","21511","2018",1,1,0,107000,656,163
"6263","21512","2018",4,4,0,284125,2422.5,115.5
"6264","21515","2018",78,30,48,156569.320512821,1941.32051282051,79.3717948717949
"6265","21516","2018",1,1,0,224000,1333,168
"6266","21517","2018",10,8,2,175071.5,2071.2,84.1
"6267","21518","2018",3,3,0,143633.333333333,979.333333333333,138.333333333333
"6268","21519","2018",5,5,0,77860,860.6,108.2
"6269","21521","2018",13,13,0,256311.538461538,2010.53846153846,130.230769230769
"6270","21522","2018",8,8,0,113505.625,1169.625,107.375
"6271","21523","2018",1,1,0,207000,2179,95
"6272","21524","2018",2,2,0,42500,549.5,71.5
"6273","21525","2018",17,16,1,93082.3529411765,1009.35294117647,93.6470588235294
"6274","21526","2018",1,1,0,57300,597,96
"6275","21527","2018",3,3,0,81666.6666666667,1256.66666666667,65.3333333333333
"6276","21528","2018",1,1,0,155000,2348,66
"6277","21530","2018",3,3,0,98666.6666666667,890.666666666667,111.333333333333
"6278","21531","2018",8,8,0,83767.5,930,92.875
"6279","21532","2018",8,8,0,294125,2313,132.25
"6280","21534","2018",7,7,0,201328.857142857,1783.71428571429,102.428571428571
"6281","21535","2018",15,15,0,252405.666666667,2262.73333333333,120.733333333333
"6282","21537","2018",1,1,0,75000,1339,56
"6283","21538","2018",3,3,0,76666.6666666667,701,90.6666666666667
"6284","21539","2018",1,1,0,110000,1146,96
"6285","21540","2018",94,58,36,206580.319148936,2412.82978723404,86.8191489361702
"6286","21541","2018",2,2,0,102500,1416,74.5
"6287","21542","2018",11,11,0,223120,1962.54545454545,118.272727272727
"6288","21543","2018",2,2,0,78500,1037.5,74
"6289","21545","2018",11,11,0,75138.6363636364,781.545454545455,100.909090909091
"6290","21546","2018",4,4,0,64250,1018.5,70
"6291","21547","2018",5,5,0,97520,1147,80.2
"6292","21548","2018",3,2,1,114666.666666667,1275,92.3333333333333
"6293","21550","2018",2,2,0,120000,1393.5,84
"6294","21553","2018",2,2,0,81250,1540.5,60
"6295","21554","2018",16,8,8,87012.5,843.125,99.8125
"6296","21555","2018",12,11,1,249087.5,2726.16666666667,105.583333333333
"6297","21556","2018",2,2,0,121725,1173,101
"6298","21557","2018",1,1,0,83800,453,185
"6299","21558","2018",8,8,0,261106.25,2700.875,114.25
"6300","21559","2018",3,1,2,88666.6666666667,1343.66666666667,66.6666666666667
"6301","21560","2018",1,1,0,103000,920,112
"6302","21561","2018",3,3,0,158325.666666667,1355.33333333333,115.666666666667
"6303","21562","2018",4,4,0,124375,677.5,176.25
"6304","21563","2018",4,4,0,117250,1137,108.5
"6305","21564","2018",5,5,0,212600,1859,104.4
"6306","21565","2018",6,6,0,233583.333333333,2033.16666666667,116.666666666667
"6307","21566","2018",1,1,0,65000,890,73
"6308","21567","2018",2,2,0,151825,1461,90
"6309","21568","2018",9,9,0,102888.888888889,1200.11111111111,85.8888888888889
"6310","21569","2018",1,1,0,220000,1760,125
"6311","21570","2018",1,1,0,163000,1304,125
"6312","21571","2018",2,2,0,82500,1075,73
"6313","21572","2018",3,3,0,165300,1675.33333333333,103.666666666667
"6314","21573","2018",6,6,0,113896.666666667,1066.83333333333,106.333333333333
"6315","21574","2018",5,5,0,99530,1039.2,104.6
"6316","21575","2018",3,3,0,127500,1415.33333333333,120.333333333333
"6317","21576","2018",2,2,0,85600,893,82
"6318","21577","2018",24,23,1,148893.75,1500,103.291666666667
"6319","21578","2018",7,7,0,193707.142857143,1671,112.142857142857
"6320","21579","2018",1,1,0,146445,989,148
"6321","21580","2018",2,2,0,76000,1128.5,79.5
"6322","21581","2018",6,6,0,102250,1207,87.6666666666667
"6323","21582","2018",11,11,0,168512.545454545,1415.90909090909,104.363636363636
"6324","21584","2018",22,21,1,99425,1036.59090909091,101.045454545455
"6325","21585","2018",6,5,1,201450,2016,106
"6326","21586","2018",6,6,0,225633.333333333,1798.83333333333,129.166666666667
"6327","21587","2018",2,2,0,125340,1338,89
"6328","21588","2018",1,1,0,83000,741,112
"6329","21590","2018",17,15,2,176457.058823529,2179.35294117647,89.2941176470588
"6330","21591","2018",12,12,0,308604.166666667,2301.25,141.166666666667
"6331","21592","2018",2,2,0,185000,1381.5,134
"6332","21593","2018",2,2,0,88500,1008.5,92.5
"6333","21594","2018",1,1,0,182950,1143,160
"6334","21596","2018",7,7,0,204342.857142857,1694,119.571428571429
"6335","21598","2018",2,2,0,97000,875.5,107
"6336","21599","2018",30,29,1,129681.166666667,1332.8,96.4666666666667
"6337","21600","2018",2,2,0,159715,1188,132
"6338","21601","2018",1,1,0,211600,2035,104
"6339","21603","2018",34,26,8,160376.588235294,1576.14705882353,106.676470588235
"6340","21604","2018",2,2,0,139200,1084,150
"6341","21605","2018",17,17,0,205332.352941176,2092.64705882353,97.8235294117647
"6342","21606","2018",23,22,1,223184.565217391,2072,113.695652173913
"6343","21607","2018",27,25,2,116074.074074074,1258.81481481481,95.6296296296296
"6344","21609","2018",6,6,0,179916.666666667,1811.83333333333,100
"6345","21610","2018",6,6,0,130012.166666667,1054.5,132.5
"6346","21611","2018",12,12,0,140391.666666667,1465.75,100.833333333333
"6347","21613","2018",3,3,0,117566.666666667,1410.66666666667,99.3333333333333
"6348","21614","2018",1,1,0,162000,2025,80
"6349","21615","2018",3,3,0,137333.333333333,1019.66666666667,120.333333333333
"6350","21616","2018",1,1,0,413000,2065,200
"6351","21617","2018",156,56,100,187901.756410256,2093.5641025641,87.0769230769231
"6352","21618","2018",6,6,0,126250,1241.66666666667,109.833333333333
"6353","21619","2018",1,1,0,292500,1784,164
"6354","21620","2018",3,3,0,103000,996,108.333333333333
"6355","21623","2018",20,20,0,176242.35,1963.35,90.35
"6356","21624","2018",3,3,0,147666.666666667,1495.66666666667,103.333333333333
"6357","21625","2018",2,2,0,169650,1387.5,116
"6358","21627","2018",1,1,0,75000,600,125
"6359","21629","2018",5,5,0,112779.6,1066.6,108.4
"6360","21630","2018",2,2,0,88500,740,119
"6361","21632","2018",10,9,1,209275,2206.6,97.5
"6362","21633","2018",3,3,0,138333.333333333,1273.33333333333,119.666666666667
"6363","21634","2018",2,2,0,326155,1672,190.5
"6364","21635","2018",3,3,0,109816.666666667,1042.33333333333,106.333333333333
"6365","21636","2018",4,3,1,145250,1962.25,54.25
"6366","21637","2018",2,2,0,149500,939,159
"6367","21638","2018",13,13,0,180827.307692308,1671.38461538462,121.230769230769
"6368","21639","2018",8,7,1,134401.25,1585.5,96
"6369","21640","2018",1,1,0,84650,973,87
"6370","21641","2018",3,3,0,181533.333333333,1367,147
"6371","21642","2018",8,8,0,88875,909.5,97.125
"6372","21643","2018",9,9,0,162955.555555556,1587,108
"6373","21644","2018",4,4,0,216750,1768.25,128.5
"6374","21645","2018",9,9,0,138005.555555556,1252.66666666667,111.222222222222
"6375","21647","2018",2,2,0,101500,1243,82
"6376","21648","2018",4,4,0,167100,1145.5,153.5
"6377","21651","2018",3,3,0,193346.666666667,1137.33333333333,166.666666666667
"6378","21652","2018",4,4,0,92337.5,1226.75,71
"6379","21655","2018",1,1,0,1e+05,813,123
"6380","21656","2018",8,6,2,135906.25,1503.875,89.5
"6381","21657","2018",20,19,1,297469.3,2613.7,114.7
"6382","21659","2018",1,1,0,215000,1361,158
"6383","21661","2018",27,19,8,211268.888888889,2125.85185185185,101.851851851852
"6384","21662","2018",1,1,0,83000,1383,60
"6385","21663","2018",22,19,3,130688.181818182,1402.90909090909,96.9545454545455
"6386","21664","2018",1,1,0,25000,333,75
"6387","21665","2018",3,3,0,131000,1197.66666666667,116
"6388","21666","2018",1,1,0,236720,1589,149
"6389","21669","2018",4,4,0,122250,1558.75,79.75
"6390","21670","2018",3,3,0,136666.666666667,1147,118
"6391","21671","2018",1,1,0,30000,375,80
"6392","21672","2018",1,1,0,33400,375,89
"6393","21673","2018",4,4,0,148675,1411.75,111.75
"6394","21674","2018",3,3,0,79766.6666666667,781,98
"6395","21675","2018",1,1,0,96900,1227,79
"6396","21676","2018",3,3,0,189000,1221.66666666667,154.333333333333
"6397","21677","2018",2,2,0,90000,1342,73.5
"6398","21678","2018",1,0,1,157000,3489,45
"6399","21679","2018",1,1,0,43000,672,64
"6400","21680","2018",6,6,0,112100,1084,102.5
"6401","21681","2018",2,2,0,50500,536,96
"6402","21682","2018",3,3,0,111000,1303,95
"6403","21683","2018",8,8,0,81543.75,842.625,99.25
"6404","21684","2018",5,5,0,207520,2181.4,95.4
"6405","21685","2018",1,1,0,2e+05,613,326
"6406","21687","2018",3,3,0,91166.6666666667,922.666666666667,93.3333333333333
"6407","21688","2018",2,2,0,294150,2650.5,115.5
"6408","21690","2018",2,2,0,189575,2514,77
"6409","21691","2018",1,1,0,155000,1782,87
"6410","21692","2018",2,2,0,247025,1645.5,150.5
"6411","21693","2018",4,4,0,27375,1472.5,25
"6412","21698","2018",2,2,0,174050,1728,100.5
"6413","21699","2018",15,15,0,136386.4,1410.26666666667,106.266666666667
"6414","21700","2018",1,1,0,106000,711,149
"6415","21701","2018",4,4,0,90625,1037,85
"6416","21702","2018",5,5,0,161878,1354.6,118.2
"6417","21703","2018",1,1,0,75000,758,99
"6418","21706","2018",4,4,0,130190,1093.75,120.75
"6419","21707","2018",3,3,0,111300,1121.66666666667,92.3333333333333
"6420","21708","2018",3,3,0,249233.333333333,2064.33333333333,144
"6421","21709","2018",2,2,0,62500,617.5,107.5
"6422","21710","2018",8,8,0,79137.5,663,109.625
"6423","21712","2018",3,3,0,265150,1696.33333333333,143.333333333333
"6424","21713","2018",5,5,0,175608,1371.4,135
"6425","21714","2018",3,3,0,196333.333333333,2235,89
"6426","21715","2018",5,5,0,94000,836.8,110.8
"6427","21716","2018",5,4,1,188370,1901.4,110.2
"6428","21717","2018",1,1,0,193000,2098,92
"6429","22001","2018",3,3,0,80966.6666666667,650.333333333333,123.333333333333
"6430","22002","2018",15,15,0,162488,1856.6,96.5333333333333
"6431","22003","2018",10,10,0,203500,1742,115.2
"6432","22004","2018",71,70,1,105038.366197183,1185.46478873239,92.8028169014084
"6433","22005","2018",20,20,0,88159,840.25,100.5
"6434","22006","2018",4,4,0,103625,960.25,106.75
"6435","22008","2018",11,11,0,197006.363636364,1630.27272727273,118.090909090909
"6436","22009","2018",3,3,0,60000,743.333333333333,87.3333333333333
"6437","22011","2018",7,7,0,163657.142857143,1212.71428571429,120
"6438","22012","2018",13,13,0,167456.153846154,1646.76923076923,105.538461538462
"6439","22013","2018",22,22,0,81585.3181818182,866.454545454545,93.1818181818182
"6440","22014","2018",17,17,0,138470.588235294,1323.05882352941,106.941176470588
"6441","22015","2018",12,12,0,175233.333333333,1714,102.833333333333
"6442","22016","2018",8,7,1,288075,4014.75,75.375
"6443","22018","2018",11,11,0,101704.727272727,1106.36363636364,97.0909090909091
"6444","22019","2018",7,7,0,150355.857142857,1078.71428571429,132.285714285714
"6445","22020","2018",22,21,1,96101.7272727273,1143.22727272727,90.4090909090909
"6446","22021","2018",16,16,0,125948.125,1423,88.3125
"6447","22023","2018",12,12,0,54542.5,578.75,95.4166666666667
"6448","22024","2018",4,4,0,64450,760,91.75
"6449","22025","2018",32,32,0,67776.28125,807.59375,87.4375
"6450","22026","2018",8,8,0,128850,1427.5,90.75
"6451","22027","2018",1,1,0,130000,828,157
"6452","22028","2018",12,12,0,173402.5,1435.75,126.416666666667
"6453","22029","2018",2,2,0,144750,1305,112
"6454","22030","2018",6,6,0,142475,1079.16666666667,126.166666666667
"6455","22031","2018",16,16,0,53481.25,668,80.125
"6456","22032","2018",33,33,0,103625.212121212,1267.57575757576,87.969696969697
"6457","22033","2018",11,11,0,75384.0909090909,860,100.363636363636
"6458","22034","2018",12,12,0,112041.666666667,1098.91666666667,102.5
"6459","22035","2018",14,14,0,142021.642857143,1352.64285714286,102.285714285714
"6460","22036","2018",3,3,0,129333.333333333,1320.33333333333,102.666666666667
"6461","22037","2018",7,7,0,61700,874.285714285714,70.2857142857143
"6462","22039","2018",7,7,0,81000,810,101.285714285714
"6463","22040","2018",4,4,0,150000,1119.75,136.25
"6464","22041","2018",3,3,0,181333.333333333,1192.66666666667,151
"6465","22042","2018",9,9,0,124927.777777778,1270.44444444444,96.3333333333333
"6466","22043","2018",3,3,0,81333.3333333333,814,98.3333333333333
"6467","22044","2018",21,21,0,170838.095238095,1564.2380952381,108.380952380952
"6468","22045","2018",5,5,0,95620,1087.4,82.6
"6469","22046","2018",101,101,0,93320.5940594059,974.663366336634,96.3663366336634
"6470","22047","2018",10,10,0,73810,833.4,91.1
"6471","22048","2018",33,33,0,150692.151515152,1433.72727272727,109.909090909091
"6472","22049","2018",19,19,0,167584.210526316,1576.68421052632,110.842105263158
"6473","22050","2018",260,126,134,168069.45,1975.28846153846,84.2192307692308
"6474","22052","2018",15,15,0,69653.3333333333,943.933333333333,82.3333333333333
"6475","22053","2018",9,9,0,76007.2222222222,951.444444444444,80.8888888888889
"6476","22054","2018",97,62,35,200927.216494845,2328.92783505155,88.3814432989691
"6477","22055","2018",131,104,27,185308.79389313,2183.9465648855,91.1221374045802
"6478","22056","2018",20,20,0,133410,1295.75,103.4
"6479","22057","2018",7,7,0,92242.8571428571,1159.42857142857,82.1428571428571
"6480","22059","2018",12,12,0,158552.5,1374.33333333333,118.5
"6481","22060","2018",4,4,0,68625,817.75,79
"6482","22061","2018",22,22,0,100454.318181818,1181.31818181818,89.6818181818182
"6483","22062","2018",7,7,0,89285.7142857143,1007.57142857143,92.8571428571429
"6484","22063","2018",5,5,0,125717.2,1088.4,113.2
"6485","22064","2018",6,5,1,89500,1061.66666666667,108.333333333333
"6486","22065","2018",15,15,0,123202.933333333,1111.06666666667,105.266666666667
"6487","22067","2018",39,39,0,120400.256410256,1219.17948717949,99.5897435897436
"6488","22068","2018",1,1,0,93000,1177,79
"6489","22069","2018",5,5,0,130700,1116.2,113
"6490","22070","2018",102,73,29,96261.1960784314,1156.23529411765,87.6862745098039
"6491","22071","2018",14,14,0,107658.571428571,1295.28571428571,81.6428571428571
"6492","22072","2018",6,6,0,86087.8333333333,1053.33333333333,79
"6493","22073","2018",4,4,0,109837.5,1174,95
"6494","22074","2018",8,8,0,108047.5,1119,111
"6495","22075","2018",4,4,0,82440,931.5,88
"6496","22076","2018",21,21,0,134769.047619048,1392.09523809524,101.285714285714
"6497","22077","2018",8,8,0,134562.5,1665.25,96
"6498","22079","2018",5,5,0,115720,1106.8,96.2
"6499","22081","2018",39,38,1,123504.358974359,1433.51282051282,87.8974358974359
"6500","22082","2018",10,10,0,174500,1784.4,102.1
"6501","22083","2018",5,5,0,102000,800,130.8
"6502","22084","2018",22,19,3,126593.181818182,1234.77272727273,115.772727272727
"6503","22085","2018",5,5,0,228760,1994,99.4
"6504","22086","2018",2,2,0,116500,1312,135
"6505","22087","2018",6,6,0,85847.5,951,97.8333333333333
"6506","22088","2018",4,4,0,69950,694.75,94
"6507","22090","2018",15,15,0,160904.333333333,1553.73333333333,105.6
"6508","22091","2018",4,4,0,136500,1471.25,96
"6509","22092","2018",4,4,0,74000,897.75,96.75
"6510","22093","2018",208,166,42,161688.615384615,1740.1875,95.8605769230769
"6511","22094","2018",40,34,6,295208.75,3224.4,96.775
"6512","22095","2018",1,1,0,1e+05,909,110
"6513","22096","2018",6,6,0,130508.333333333,1344.83333333333,97.1666666666667
"6514","22097","2018",4,4,0,116400,1148.25,98.5
"6515","22098","2018",14,14,0,138905,1369.07142857143,103.214285714286
"6516","22099","2018",12,12,0,137400.833333333,1375,100.166666666667
"6517","22101","2018",15,15,0,137436.2,1261,106.466666666667
"6518","22103","2018",17,17,0,217661.764705882,1968.58823529412,110.529411764706
"6519","22104","2018",7,7,0,86771.4285714286,996.428571428571,90.4285714285714
"6520","22105","2018",12,12,0,141361.25,1610.33333333333,85
"6521","22106","2018",88,75,13,157214.443181818,1682.69318181818,95.9659090909091
"6522","22107","2018",28,28,0,78291.7857142857,895.178571428571,90.5714285714286
"6523","22108","2018",1,1,0,90000,3600,25
"6524","22109","2018",10,10,0,181758.9,1607.1,112
"6525","22110","2018",3,3,0,185144.666666667,1770.66666666667,104
"6526","22111","2018",8,8,0,173375,1694.25,97.875
"6527","22112","2018",5,5,0,100200,921.4,104
"6528","22113","2018",306,216,90,131683.016339869,1522.40196078431,88.9738562091503
"6529","22114","2018",11,11,0,101974.636363636,1393.63636363636,84.3636363636364
"6530","22115","2018",8,8,0,64625,665,99.625
"6531","22116","2018",7,7,0,149285.714285714,1435,101.857142857143
"6532","22117","2018",7,7,0,176714.285714286,1579.42857142857,116.285714285714
"6533","22118","2018",64,57,7,171896.109375,1878.109375,98.203125
"6534","22119","2018",4,4,0,142250,1205.25,117
"6535","22121","2018",33,31,2,97530.4848484848,1110.24242424242,89.9393939393939
"6536","22122","2018",13,13,0,85693.8461538462,794.461538461538,109
"6537","22124","2018",2,2,0,111750,977,102.5
"6538","22126","2018",2,2,0,47750,969,48
"6539","22127","2018",34,32,2,154182.5,1814.64705882353,89.8823529411765
"6540","22128","2018",6,6,0,102666.666666667,903.5,106.833333333333
"6541","22129","2018",2,2,0,34500,552.5,71
"6542","22131","2018",13,13,0,81423.8461538462,1243,78.2307692307692
"6543","22132","2018",2,2,0,61650,728,105
"6544","22133","2018",10,10,0,116600,1311.2,88.6
"6545","22134","2018",44,42,2,205424,1881.09090909091,109.75
"6546","22135","2018",27,27,0,109807.407407407,1088.22222222222,104.296296296296
"6547","22136","2018",94,76,18,114349.989361702,1238.77659574468,96
"6548","22137","2018",27,27,0,109922.407407407,1039.07407407407,100.962962962963
"6549","22138","2018",9,9,0,58660.8888888889,715.222222222222,90.7777777777778
"6550","22139","2018",1,1,0,77000,1925,40
"6551","22140","2018",6,5,1,128183.333333333,1624.33333333333,81.6666666666667
"6552","22141","2018",1,1,0,135000,1378,98
"6553","22143","2018",31,25,6,139789.35483871,1702.83870967742,84.4838709677419
"6554","22144","2018",8,7,1,149606.25,1672,89.875
"6555","22145","2018",18,18,0,120768.888888889,1057.5,114.777777777778
"6556","22146","2018",7,7,0,48142.8571428571,652.857142857143,75
"6557","22147","2018",40,35,5,81531.25,930.225,88.475
"6558","22148","2018",3,3,0,74058.3333333333,1496.66666666667,73
"6559","22149","2018",7,7,0,77657.1428571429,853.285714285714,99.8571428571429
"6560","22150","2018",9,9,0,142166.666666667,1631.77777777778,90.8888888888889
"6561","22152","2018",17,17,0,174851.529411765,1689.82352941176,106.882352941176
"6562","22153","2018",5,5,0,136443.6,1284.4,104.8
"6563","22155","2018",21,21,0,121040.476190476,1213.14285714286,110.714285714286
"6564","22156","2018",4,4,0,111125,1027.5,109.75
"6565","22157","2018",9,9,0,97460,1087.77777777778,95.6666666666667
"6566","22158","2018",34,34,0,94341.0588235294,923.029411764706,103.529411764706
"6567","22160","2018",7,7,0,159768.571428571,1386.28571428571,114
"6568","22161","2018",33,33,0,120578.787878788,1262.57575757576,98.7575757575758
"6569","22162","2018",153,107,46,175141.875816993,2088.04575163399,87.921568627451
"6570","22163","2018",6,6,0,78416.6666666667,755.333333333333,113.166666666667
"6571","22164","2018",20,20,0,115350,1234.85,94.05
"6572","22165","2018",8,8,0,130250,1157.875,120.25
"6573","22166","2018",45,45,0,172182.955555556,2031.15555555556,87.4666666666667
"6574","22168","2018",191,122,69,187869.146596859,2174.4502617801,85.6125654450262
"6575","22169","2018",2,2,0,60500,654,92
"6576","22170","2018",6,6,0,147741.666666667,1434.16666666667,106.5
"6577","22171","2018",38,38,0,134908.210526316,1397.78947368421,98.7105263157895
"6578","22172","2018",34,26,8,118651.470588235,1415.02941176471,89.0588235294118
"6579","22174","2018",11,11,0,147155.909090909,1447.18181818182,103.727272727273
"6580","22175","2018",11,11,0,121254.545454545,1415.18181818182,93.4545454545455
"6581","22176","2018",72,70,2,138449.097222222,1469.625,97.9305555555556
"6582","22177","2018",26,26,0,135214.653846154,1473.73076923077,98.7692307692308
"6583","22178","2018",11,11,0,115423.636363636,1206.72727272727,93.6363636363636
"6584","22179","2018",62,49,13,194091.467741935,2398.53225806452,85.4354838709677
"6585","22180","2018",24,20,4,130852.916666667,1351.16666666667,94.5
"6586","22181","2018",14,14,0,89022.1428571429,918.928571428571,88.1428571428571
"6587","22182","2018",30,30,0,149726.666666667,1392.83333333333,108.533333333333
"6588","22183","2018",49,48,1,74814.2857142857,862.714285714286,87.5714285714286
"6589","22184","2018",13,13,0,119684.615384615,1191.07692307692,99.9230769230769
"6590","22185","2018",35,33,2,118380.142857143,1246.51428571429,98.0857142857143
"6591","22186","2018",147,95,52,223888.469387755,2975.22448979592,82.1360544217687
"6592","22187","2018",199,167,32,171989.537688442,1861.52261306533,94.7035175879397
"6593","22188","2018",16,15,1,150173.125,1501.5625,100.125
"6594","22189","2018",9,9,0,84333.3333333333,993.222222222222,89.7777777777778
"6595","22190","2018",64,62,2,159162.703125,1595.609375,102.046875
"6596","22193","2018",16,14,2,93806.25,1240.3125,75.3125
"6597","22194","2018",53,52,1,142218.566037736,1539.15094339623,94.5094339622642
"6598","22195","2018",48,48,0,158643.854166667,1682.52083333333,98.125
"6599","22196","2018",11,11,0,106031.818181818,1256.09090909091,81.6363636363636
"6600","22197","2018",34,34,0,180081.176470588,1931.44117647059,97.9411764705882
"6601","22198","2018",52,50,2,219572.807692308,1989.13461538462,111.423076923077
"6602","22199","2018",16,16,0,112687.5,1117.25,102.5
"6603","22200","2018",10,10,0,115498.3,1137.4,103.1
"6604","22201","2018",12,12,0,192500,2136,95.8333333333333
"6605","22202","2018",12,12,0,89758.3333333333,885.833333333333,100.75
"6606","22203","2018",52,52,0,104638.461538462,1123.82692307692,96.3076923076923
"6607","22204","2018",20,20,0,111549.5,947.1,112.8
"6608","22205","2018",9,9,0,291888.888888889,2242.88888888889,110.777777777778
"6609","22206","2018",41,39,2,116222.292682927,1240,94.609756097561
"6610","22207","2018",32,32,0,102202.1875,1090.21875,93.28125
"6611","22208","2018",20,20,0,110062.5,1353.4,89.85
"6612","22209","2018",51,37,14,169454.352941176,1960.19607843137,92.2549019607843
"6613","22210","2018",63,63,0,192389.238095238,2163.53968253968,96.8888888888889
"6614","22211","2018",33,33,0,178172.727272727,1643.45454545455,108.636363636364
"6615","22212","2018",18,18,0,98760,1011.22222222222,98.1666666666667
"6616","22213","2018",38,37,1,226588.184210526,2088.78947368421,117.421052631579
"6617","22214","2018",65,65,0,150334.538461538,1649.10769230769,94.5846153846154
"6618","22215","2018",110,105,5,137169.8,1386.00909090909,99.7454545454545
"6619","22216","2018",13,13,0,72884.6153846154,851.153846153846,91.3076923076923
"6620","22217","2018",4,4,0,84125,835.75,105.75
"6621","22218","2018",31,31,0,201359.35483871,2293.77419354839,90.9032258064516
"6622","22219","2018",21,21,0,119838.095238095,1022.33333333333,115.52380952381
"6623","22220","2018",23,23,0,95304.6086956522,895.652173913043,104.304347826087
"6624","22221","2018",29,29,0,105705.310344828,1285.27586206897,82.6551724137931
"6625","22222","2018",128,116,12,149249.3984375,1674.8515625,94.453125
"6626","22223","2018",21,21,0,100880.952380952,1213.85714285714,83.8095238095238
"6627","22224","2018",21,21,0,172450,1559.90476190476,111.238095238095
"6628","22225","2018",63,59,4,115255.73015873,1217.57142857143,96.6984126984127
"6629","22226","2018",42,42,0,143336.952380952,1597.21428571429,94.9047619047619
"6630","22227","2018",8,8,0,141622.5,1152.125,118.375
"6631","22228","2018",18,18,0,74028.3888888889,903.5,86.7222222222222
"6632","22229","2018",11,11,0,71500,892.090909090909,92
"6633","22231","2018",10,10,0,74400,885.3,82.4
"6634","22232","2018",30,30,0,160636,1560.93333333333,107.033333333333
"6635","22233","2018",34,34,0,140261.764705882,1330.41176470588,103.647058823529
"6636","22234","2018",8,8,0,125265,1229.25,99.125
"6637","22235","2018",3,3,0,114333.333333333,1261.33333333333,91.6666666666667
"6638","22236","2018",12,12,0,157791.666666667,1432.83333333333,103.416666666667
"6639","22237","2018",22,22,0,148186.363636364,1509.63636363636,101.272727272727
"6640","22238","2018",6,6,0,130475,1247.16666666667,113.333333333333
"6641","22239","2018",14,14,0,106962.928571429,1048.64285714286,101.714285714286
"6642","22240","2018",9,9,0,132607.444444444,1027.22222222222,117
"6643","22241","2018",14,14,0,102723.928571429,1068.78571428571,94
"6644","22242","2018",19,19,0,153315.789473684,1665.73684210526,95.7368421052632
"6645","22243","2018",6,6,0,84200,903.833333333333,93.8333333333333
"6646","22244","2018",7,6,1,85071.4285714286,865.428571428571,95.1428571428571
"6647","22245","2018",23,23,0,103455.565217391,1091.34782608696,93.7391304347826
"6648","22246","2018",7,7,0,92495.7142857143,1130.57142857143,90.5714285714286
"6649","22248","2018",27,27,0,115433.481481481,1075.18518518519,107.703703703704
"6650","22249","2018",12,12,0,68945.8333333333,792.5,87.5833333333333
"6651","22250","2018",18,16,2,103721.666666667,912.277777777778,112
"6652","22251","2018",100,88,12,198208.58,1845.58,109.84
"6653","22254","2018",12,12,0,116147.083333333,1077.33333333333,105.75
"6654","22255","2018",13,13,0,76780.7692307692,879.153846153846,85.7692307692308
"6655","22256","2018",6,6,0,97333.3333333333,1127.33333333333,85.3333333333333
"6656","22257","2018",2,2,0,104000,692,153
"6657","22258","2018",40,40,0,140338.25,1476.475,94.35
"6658","22259","2018",45,45,0,164871.133333333,1588.84444444444,105.511111111111
"6659","22260","2018",7,7,0,73571.4285714286,959.428571428571,80
"6660","22261","2018",4,4,0,202000,1729,122
"6661","22262","2018",33,32,1,103255.515151515,1091.21212121212,96.0909090909091
"6662","22263","2018",4,4,0,71500,911.25,85.5
"6663","22264","2018",44,43,1,118325.681818182,1229.34090909091,95.2272727272727
"6664","22265","2018",25,25,0,143266,1325,111.32
"6665","22266","2018",50,48,2,79645.8,758.24,100.76
"6666","22267","2018",2,2,0,41500,600.5,68.5
"6667","22268","2018",5,5,0,165800,1571.4,105.8
"6668","22269","2018",4,4,0,93750,844.5,99.25
"6669","22271","2018",4,4,0,105250,1076.5,96.75
"6670","22272","2018",21,18,3,151776.19047619,1423.38095238095,113
"6671","22273","2018",28,28,0,170683.25,1799.21428571429,92.1071428571429
"6672","22274","2018",7,7,0,186084.857142857,1668.14285714286,110.571428571429
"6673","22275","2018",15,15,0,119333.333333333,1164.46666666667,112.4
"6674","22276","2018",2,2,0,128000,936.5,142
"6675","22277","2018",23,23,0,153426.869565217,1605.17391304348,94.7826086956522
"6676","22278","2018",825,378,447,105932.253333333,1321.26909090909,78.7793939393939
"6677","22279","2018",17,17,0,96250.3529411765,948.647058823529,109.294117647059
"6678","22280","2018",13,13,0,146423.076923077,1493.84615384615,97.9230769230769
"6679","22281","2018",16,16,0,118313.75,1133.1875,109.4375
"6680","22282","2018",110,69,41,228647.436363636,2814.43636363636,78.8545454545455
"6681","22283","2018",9,9,0,103104.444444444,1021.77777777778,101.222222222222
"6682","22284","2018",6,6,0,49678.3333333333,688.666666666667,68.6666666666667
"6683","22285","2018",6,6,0,81492.6666666667,1061.83333333333,87.5
"6684","22286","2018",4,4,0,126675,1388.25,90.25
"6685","22287","2018",12,12,0,146605,1259.5,116.666666666667
"6686","22288","2018",4,4,0,47600,634,72.25
"6687","22289","2018",2,2,0,50000,1146,42.5
"6688","22291","2018",1,1,0,69000,885,78
"6689","22293","2018",6,6,0,101950,1056.83333333333,94.1666666666667
"6690","22294","2018",6,6,0,56841.6666666667,663.166666666667,88.1666666666667
"6691","22295","2018",5,5,0,110027,864,132.6
"6692","22296","2018",5,5,0,128618.8,1316.8,97.6
"6693","22299","2018",22,22,0,173380.909090909,1584.18181818182,112.318181818182
"6694","22300","2018",1,1,0,93400,1315,71
"6695","22302","2018",29,25,4,248820.689655172,3364.03448275862,79.7931034482759
"6696","22304","2018",4,4,0,141925,1295.5,109.75
"6697","22305","2018",5,5,0,118973.6,1050.6,119.2
"6698","22306","2018",4,4,0,148550,1491.5,100.5
"6699","22307","2018",13,13,0,138880.769230769,1380,100.461538461538
"6700","22308","2018",6,6,0,138000,1311.5,109
"6701","22309","2018",3,3,0,125243.333333333,1160.33333333333,119.666666666667
"6702","22310","2018",4,4,0,130750,1422.5,91.25
"6703","22311","2018",12,12,0,157533.333333333,1560.58333333333,98.75
"6704","22312","2018",3,3,0,106950,904.333333333333,117.333333333333
"6705","22313","2018",5,5,0,69256,738.6,88
"6706","22314","2018",8,8,0,92086.75,1120.375,81
"6707","22315","2018",3,3,0,128333.333333333,1367,96
"6708","22316","2018",8,8,0,58517.5,622.5,100.75
"6709","22317","2018",5,5,0,132000,1243,108.4
"6710","22318","2018",5,5,0,100200,948,107.4
"6711","22319","2018",9,8,1,185000,1886.66666666667,91.6666666666667
"6712","22320","2018",2,2,0,25000,472,53
"6713","22321","2018",29,29,0,77362.0689655172,879.379310344828,86.3448275862069
"6714","22322","2018",5,5,0,101100,1180.6,93.8
"6715","22323","2018",15,15,0,131113.333333333,1306.86666666667,98.9333333333333
"6716","22324","2018",21,21,0,204301.428571429,1848.2380952381,108.238095238095
"6717","22325","2018",124,70,54,163971.467741935,2352.51612903226,73.3225806451613
"6718","22326","2018",7,7,0,151802.857142857,1362.42857142857,108.857142857143
"6719","22327","2018",19,19,0,203124.210526316,1781.26315789474,114.263157894737
"6720","22328","2018",11,11,0,75100.9090909091,1061,72.9090909090909
"6721","22330","2018",3,3,0,70633.3333333333,594.333333333333,118.666666666667
"6722","22331","2018",3,3,0,104066.666666667,1088.33333333333,98
"6723","22332","2018",5,5,0,92850,1135.2,76.8
"6724","22333","2018",12,12,0,102344.166666667,1089.25,99.4166666666667
"6725","22334","2018",2,2,0,128200,1253.5,90
"6726","22335","2018",7,7,0,97214.2857142857,829.571428571429,125.571428571429
"6727","22337","2018",17,17,0,81100,928.352941176471,96
"6728","22338","2018",3,3,0,118500,1103,107
"6729","22339","2018",46,39,7,154358.913043478,1562.73913043478,96.5869565217391
"6730","22340","2018",16,16,0,130964.0625,1206.6875,112.75
"6731","22341","2018",5,5,0,114445,1458,85
"6732","22342","2018",6,6,0,119800,1411.83333333333,90
"6733","22343","2018",81,55,26,197039.506172839,2099.0987654321,97.2345679012346
"6734","22344","2018",10,10,0,74740,881.5,84.6
"6735","22345","2018",9,9,0,130498.222222222,1342.88888888889,101.333333333333
"6736","22346","2018",8,8,0,122112.5,1181.125,112.75
"6737","22347","2018",15,14,1,95834.0666666667,1108.06666666667,85.9333333333333
"6738","22348","2018",7,7,0,106721.428571429,957.857142857143,105.142857142857
"6739","22349","2018",32,32,0,173563.125,1799,99.40625
"6740","22350","2018",2,2,0,145400,1580.5,92
"6741","22351","2018",11,11,0,105636.363636364,1029,101.636363636364
"6742","22352","2018",5,5,0,112800,1188.6,93.4
"6743","22353","2018",56,39,17,218603.857142857,2561.01785714286,90.0714285714286
"6744","22354","2018",8,8,0,120556.25,1238.625,103.125
"6745","22356","2018",4,4,0,142825,994.25,136
"6746","22358","2018",4,4,0,95375,984.5,100
"6747","22359","2018",3,3,0,105966.666666667,1266.33333333333,85
"6748","22360","2018",93,80,13,156222.903225806,1691.24731182796,93.6344086021505
"6749","22361","2018",14,14,0,124243.285714286,1331.71428571429,94.8571428571429
"6750","22362","2018",41,28,13,126735.487804878,1449.80487804878,83.0487804878049
"6751","22363","2018",24,23,1,199587.083333333,2065.20833333333,108.541666666667
"6752","22364","2018",32,30,2,164702.34375,1719.375,96.5
"6753","22365","2018",1,1,0,40000,408,98
"6754","22366","2018",5,4,1,93040.4,891,104.6
"6755","22368","2018",10,10,0,239575,1962.7,120.3
"6756","22369","2018",5,5,0,133200,1109.6,115
"6757","22370","2018",6,6,0,107833.333333333,1397.66666666667,84.8333333333333
"6758","22371","2018",16,16,0,106109.375,996.25,117.3125
"6759","22372","2018",18,16,2,141192.222222222,1520.77777777778,91.3333333333333
"6760","22375","2018",7,7,0,121142.857142857,1376.85714285714,101
"6761","22376","2018",18,18,0,97816.6666666667,1015.27777777778,96
"6762","22377","2018",15,15,0,150450,1756,87
"6763","22378","2018",2,2,0,181500,1463.5,125
"6764","22379","2018",31,24,7,166060.967741935,2478.74193548387,78.0322580645161
"6765","22380","2018",7,7,0,123785.714285714,946.142857142857,122.142857142857
"6766","22381","2018",5,5,0,114500,1307.2,81.6
"6767","22383","2018",5,4,1,53716,627.8,89.2
"6768","22384","2018",13,13,0,106078.461538462,1200.23076923077,95.5384615384615
"6769","22385","2018",15,15,0,187780,1925.2,101.866666666667
"6770","22386","2018",4,4,0,151000,1318.75,121.25
"6771","22387","2018",19,19,0,124531.578947368,1129.05263157895,108.631578947368
"6772","22388","2018",8,8,0,131312.5,1255,103.125
"6773","22389","2018",59,48,11,138048.898305085,1541,91.0677966101695
"6774","22390","2018",9,9,0,122702.555555556,1143.22222222222,101.888888888889
"6775","22391","2018",15,15,0,118090,1004.66666666667,114.6
"6776","23001","2018",16,16,0,72502,812.375,89.1875
"6777","23002","2018",5,5,0,72360,593.8,136.4
"6778","23003","2018",2,2,0,57950,687.5,85.5
"6779","23004","2018",4,4,0,130050,1248.5,114.25
"6780","23005","2018",2,2,0,57500,598.5,86
"6781","23006","2018",5,5,0,74238,869,88.8
"6782","23007","2018",4,4,0,54875,660.25,89
"6783","23008","2018",30,24,6,69285.3333333333,896.033333333333,77.7333333333333
"6784","23009","2018",1,1,0,80000,615,130
"6785","23011","2018",1,1,0,51500,505,102
"6786","23012","2018",2,2,0,66500,863.5,78
"6787","23013","2018",7,7,0,79642.8571428571,844.857142857143,92.1428571428571
"6788","23014","2018",1,1,0,47000,588,80
"6789","23015","2018",15,15,0,74342.4,1186.86666666667,77.5333333333333
"6790","23017","2018",4,4,0,108037.5,1090.25,103.75
"6791","23018","2018",2,2,0,58500,708.5,75
"6792","23020","2018",4,4,0,62750,804.75,72
"6793","23021","2018",13,13,0,63838.4615384615,743.384615384615,87.2307692307692
"6794","23022","2018",7,7,0,85910,979.714285714286,87
"6795","23023","2018",1,1,0,32000,400,80
"6796","23024","2018",5,5,0,119330,1142.2,110.2
"6797","23025","2018",19,19,0,77747.3684210526,888.578947368421,85.3684210526316
"6798","23026","2018",8,8,0,57181.75,713.5,77.25
"6799","23027","2018",2,2,0,54000,702,78.5
"6800","23028","2018",1,1,0,67000,882,76
"6801","23029","2018",4,4,0,53950,732.75,77
"6802","23030","2018",26,22,4,77483.1538461538,790.923076923077,102.269230769231
"6803","23031","2018",15,15,0,65760,687.266666666667,100.533333333333
"6804","23032","2018",9,9,0,69643.3333333333,689.555555555556,100.444444444444
"6805","23033","2018",7,7,0,91361.4285714286,1189.71428571429,75.8571428571429
"6806","23035","2018",6,6,0,66858.3333333333,825.5,80.1666666666667
"6807","23036","2018",9,9,0,66922.2222222222,794.777777777778,90
"6808","23037","2018",1,1,0,45000,450,100
"6809","23038","2018",3,3,0,92666.6666666667,737,129.666666666667
"6810","23039","2018",5,5,0,40000,891.6,53
"6811","23040","2018",3,3,0,54933.3333333333,911,77.3333333333333
"6812","23041","2018",4,4,0,47692.5,393.25,122.5
"6813","23044","2018",2,2,0,55875,497,106
"6814","23045","2018",11,11,0,76727.2727272727,777.636363636364,95.1818181818182
"6815","23046","2018",2,2,0,51000,482,122.5
"6816","23047","2018",3,3,0,63500,709.333333333333,95
"6817","23048","2018",3,3,0,100666.666666667,1046,97
"6818","23049","2018",7,7,0,58413,679.428571428571,94.1428571428571
"6819","23050","2018",5,5,0,76594,1555.4,54.8
"6820","23051","2018",2,2,0,389000,2535,143.5
"6821","23052","2018",5,5,0,92700,1104.6,84.8
"6822","23053","2018",3,3,0,92660,1347,96.6666666666667
"6823","23054","2018",7,7,0,88914.2857142857,934.285714285714,89.2857142857143
"6824","23056","2018",8,8,0,90750,1066.125,85.5
"6825","23057","2018",7,7,0,72342.8571428571,687.142857142857,110
"6826","23060","2018",1,1,0,85500,658,130
"6827","23061","2018",2,2,0,49100,497.5,101
"6828","23062","2018",17,17,0,75701.8823529412,998.588235294118,90.5294117647059
"6829","23064","2018",14,14,0,86260.7142857143,776.214285714286,111.785714285714
"6830","23065","2018",1,1,0,37500,357,105
"6831","23066","2018",2,2,0,38000,474.5,80
"6832","23067","2018",1,1,0,135000,1047,129
"6833","23068","2018",7,7,0,88900,787,110.285714285714
"6834","23069","2018",1,1,0,110000,2037,54
"6835","23070","2018",14,14,0,59292.8571428571,787.642857142857,77.5714285714286
"6836","23071","2018",2,2,0,108525,1325,86.5
"6837","23072","2018",2,2,0,84575,728.5,114
"6838","23073","2018",2,2,0,50300,618,85
"6839","23074","2018",2,2,0,71250,894.5,83
"6840","23075","2018",8,8,0,80312.5,822,102.125
"6841","23076","2018",15,14,1,82260,822.466666666667,110.266666666667
"6842","23077","2018",8,8,0,54750,743.875,80.125
"6843","23078","2018",1,1,0,55000,948,58
"6844","23079","2018",16,16,0,110409.75,1080.375,98.25
"6845","23080","2018",1,1,0,45000,346,130
"6846","23082","2018",2,2,0,53325,1523.5,35
"6847","23083","2018",2,2,0,82000,916,85
"6848","23084","2018",3,3,0,77166.6666666667,787.333333333333,104.333333333333
"6849","23086","2018",3,3,0,43900,532.333333333333,78.3333333333333
"6850","23087","2018",7,7,0,95785.7142857143,915.428571428571,107
"6851","23088","2018",3,3,0,187333.333333333,2030,91.3333333333333
"6852","23089","2018",14,14,0,79450,860.357142857143,93.4285714285714
"6853","23090","2018",7,7,0,66400,814.714285714286,84.2857142857143
"6854","23092","2018",8,8,0,90775,824.125,105.5
"6855","23093","2018",14,14,0,106564.428571429,1144.35714285714,107.571428571429
"6856","23095","2018",13,13,0,72924.4615384615,788.153846153846,87.8461538461538
"6857","23096","2018",147,103,44,87109.5442176871,1031.7619047619,85.5714285714286
"6858","23097","2018",2,2,0,61500,845,94
"6859","23098","2018",1,1,0,78000,377,207
"6860","23099","2018",2,2,0,54500,469,116.5
"6861","23100","2018",6,6,0,52408.6666666667,680.666666666667,74.5
"6862","23101","2018",5,5,0,83240,744.2,119
"6863","23102","2018",6,6,0,97671.6666666667,932,108.666666666667
"6864","23103","2018",5,5,0,48800,613.2,82.8
"6865","23104","2018",4,4,0,70350,746,90.25
"6866","23105","2018",8,8,0,52003.75,634,86.5
"6867","23106","2018",4,4,0,66215.5,623.75,98.25
"6868","23107","2018",4,4,0,59875,603.25,103.25
"6869","23108","2018",2,2,0,96000,926,120.5
"6870","23111","2018",4,4,0,72470,740.25,111.25
"6871","23112","2018",9,9,0,60555.5555555556,673.777777777778,100.555555555556
"6872","23113","2018",1,1,0,165000,1031,160
"6873","23114","2018",3,3,0,81966.6666666667,910.666666666667,86.3333333333333
"6874","23115","2018",1,1,0,95000,2262,42
"6875","23116","2018",2,2,0,57750,680.5,83
"6876","23117","2018",1,1,0,30000,476,63
"6877","23118","2018",3,3,0,47666.6666666667,622.666666666667,73.6666666666667
"6878","23120","2018",3,3,0,61466.6666666667,836.666666666667,80.3333333333333
"6879","23123","2018",4,4,0,149475,1888,91
"6880","23124","2018",8,8,0,59325,613.5,100.625
"6881","23125","2018",1,1,0,18000,1200,15
"6882","23127","2018",3,3,0,186800,1434.33333333333,111
"6883","23128","2018",2,2,0,70000,736.5,88
"6884","23129","2018",1,1,0,90000,833,108
"6885","23130","2018",6,6,0,76814.8333333333,961,84.6666666666667
"6886","23131","2018",1,0,1,22000,379,58
"6887","23132","2018",3,3,0,41333.3333333333,788.333333333333,61
"6888","23133","2018",4,4,0,73625,870.75,86.5
"6889","23134","2018",3,3,0,32333.3333333333,524.666666666667,60
"6890","23136","2018",3,2,1,83000,877.666666666667,100.333333333333
"6891","23137","2018",8,8,0,72635,841,94.125
"6892","23138","2018",3,3,0,83500,1021,86.3333333333333
"6893","23139","2018",8,8,0,81187.5,916.375,94.875
"6894","23140","2018",11,11,0,82772.7272727273,798.454545454545,96.1818181818182
"6895","23141","2018",7,7,0,74078.5714285714,1370.57142857143,68.5714285714286
"6896","23142","2018",1,1,0,23000,383,60
"6897","23143","2018",6,6,0,73750,855.666666666667,83.3333333333333
"6898","23144","2018",2,2,0,58000,858,63.5
"6899","23145","2018",2,2,0,95000,807,111
"6900","23146","2018",1,1,0,188000,1567,120
"6901","23147","2018",1,1,0,142000,1464,97
"6902","23148","2018",4,4,0,43500,628.5,68.25
"6903","23149","2018",5,5,0,58200,736.8,88.2
"6904","23150","2018",2,2,0,72435.5,488.5,152.5
"6905","23151","2018",8,8,0,58250,763.5,90.875
"6906","23152","2018",1,1,0,80800,735,110
"6907","23154","2018",12,12,0,84600,811.083333333333,104.083333333333
"6908","23155","2018",7,7,0,73476.4285714286,907,80.2857142857143
"6909","23156","2018",1,1,0,103700,741,140
"6910","23157","2018",4,4,0,79700,850.75,88.5
"6911","23158","2018",1,1,0,47500,440,108
"6912","23159","2018",2,2,0,125770,978.5,139
"6913","23160","2018",2,2,0,38512.5,774.5,61
"6914","23162","2018",5,5,0,80260,852.4,83.4
"6915","23164","2018",4,4,0,53125,1154.5,79
"6916","23165","2018",13,13,0,95960.3846153846,1554.84615384615,73.3076923076923
"6917","23166","2018",4,4,0,56875,615.25,88.75
"6918","23167","2018",3,3,0,65666.6666666667,684,97
"6919","23168","2018",8,8,0,71750,843.125,98
"6920","23169","2018",5,4,1,103000,945,115.2
"6921","23170","2018",2,2,0,42500,606.5,71
"6922","23172","2018",2,2,0,185000,1452,179.5
"6923","23173","2018",1,1,0,93000,1788,52
"6924","23174","2018",6,6,0,75666.6666666667,1084.66666666667,78.6666666666667
"6925","23175","2018",3,3,0,58166.6666666667,802,72.6666666666667
"6926","23176","2018",52,43,9,96613.4615384615,1072.88461538462,95.5
"6927","23177","2018",11,11,0,92527.2727272727,857,112
"6928","23178","2018",2,2,0,78750,816,95.5
"6929","23179","2018",1,1,0,180000,1184,152
"6930","23180","2018",3,3,0,94666.6666666667,831.666666666667,111
"6931","23182","2018",4,4,0,38100,433.75,88.25
"6932","23185","2018",6,6,0,76347.1666666667,670.833333333333,107.166666666667
"6933","23186","2018",2,2,0,95500,734,135
"6934","23187","2018",1,1,0,67500,466,145
"6935","23188","2018",2,2,0,80750,1160.5,83
"6936","23189","2018",8,8,0,70681.5,713.375,103.625
"6937","23190","2018",6,6,0,87048.8333333333,1041.83333333333,82
"6938","23191","2018",4,4,0,98500,2163,68.75
"6939","23192","2018",17,17,0,71603.8823529412,794.117647058824,92.8823529411765
"6940","23193","2018",22,21,1,118018.545454545,1128.68181818182,101.727272727273
"6941","23194","2018",2,2,0,67100,975,81
"6942","23195","2018",8,8,0,113856.25,1185.375,99.25
"6943","23196","2018",2,2,0,100150,1008.5,84.5
"6944","23197","2018",6,6,0,72041.6666666667,628,112.333333333333
"6945","23199","2018",3,2,1,69666.6666666667,771.666666666667,80
"6946","23200","2018",2,2,0,52750,478,108.5
"6947","23201","2018",2,2,0,81500,1219,64
"6948","23202","2018",3,3,0,70800,867,82.3333333333333
"6949","23203","2018",5,5,0,122400,1041.8,148.4
"6950","23204","2018",2,2,0,52100,725,84.5
"6951","23205","2018",3,3,0,42666.6666666667,448,92.3333333333333
"6952","23206","2018",5,5,0,82930,875.2,101.4
"6953","23207","2018",1,1,0,65000,464,140
"6954","23208","2018",5,5,0,84480,1004.4,83.6
"6955","23209","2018",1,1,0,130000,1161,112
"6956","23210","2018",2,2,0,167000,1276.5,128
"6957","23211","2018",3,3,0,58666.6666666667,727,86
"6958","23212","2018",4,4,0,99002.5,791.5,125.75
"6959","23213","2018",4,4,0,46500,1085.75,47.5
"6960","23214","2018",1,1,0,110000,604,182
"6961","23215","2018",2,2,0,33000,397.5,84.5
"6962","23216","2018",2,2,0,67500,793,85
"6963","23217","2018",4,4,0,61250,754.5,79
"6964","23218","2018",1,1,0,208000,1169,178
"6965","23219","2018",6,6,0,68333.3333333333,802.333333333333,79.8333333333333
"6966","23220","2018",6,6,0,83833.3333333333,904.666666666667,86.1666666666667
"6967","23221","2018",2,2,0,121250,793.5,138
"6968","23222","2018",2,2,0,45000,676.5,67
"6969","23223","2018",7,7,0,100807.142857143,756,120
"6970","23224","2018",1,1,0,69000,862,80
"6971","23225","2018",1,1,0,80412,759,106
"6972","23226","2018",2,2,0,67000,693,98.5
"6973","23227","2018",4,4,0,62500,1227.75,61.5
"6974","23228","2018",2,2,0,74500,769,98
"6975","23229","2018",4,4,0,63750,775.75,86
"6976","23232","2018",2,2,0,99000,1221,95
"6977","23233","2018",2,2,0,57500,749,72
"6978","23234","2018",1,1,0,45000,703,64
"6979","23235","2018",7,7,0,111487.857142857,1033.42857142857,111
"6980","23236","2018",4,4,0,92414,834.25,120
"6981","23238","2018",6,6,0,69083.3333333333,912,82.1666666666667
"6982","23239","2018",10,10,0,57300,743.3,85.2
"6983","23240","2018",8,8,0,92218.75,1139.375,76.625
"6984","23241","2018",1,1,0,35000,389,90
"6985","23242","2018",2,2,0,34000,478,75
"6986","23243","2018",1,1,0,43000,538,80
"6987","23244","2018",4,4,0,98231.25,825.5,116.25
"6988","23245","2018",17,17,0,150958.529411765,1169.64705882353,126.647058823529
"6989","23246","2018",3,3,0,68566.6666666667,722.666666666667,98.3333333333333
"6990","23247","2018",13,12,1,99603.8461538462,930.307692307692,105.769230769231
"6991","23248","2018",4,4,0,89212.75,1181.75,75.25
"6992","23249","2018",4,4,0,58875,599,90
"6993","23250","2018",3,3,0,62000,783,81.3333333333333
"6994","23251","2018",1,1,0,58000,716,81
"6995","23252","2018",2,2,0,68500,892.5,78
"6996","23254","2018",4,4,0,44500,644.75,71
"6997","23255","2018",1,1,0,29650,362,82
"6998","23257","2018",9,9,0,77554.4444444444,815.444444444444,106.666666666667
"6999","23258","2018",4,4,0,86499.75,626,115.25
"7000","23259","2018",1,1,0,119000,862,138
"7001","23260","2018",3,3,0,137000,1580,100
"7002","23261","2018",1,0,1,21500,632,34
"7003","23263","2018",4,4,0,83837.5,1101.75,75.75
"7004","23266","2018",3,3,0,110500,906.666666666667,112.666666666667
"7005","24001","2018",18,18,0,99947.8333333333,1016.33333333333,104.888888888889
"7006","24002","2018",16,16,0,163191.875,1451.75,115.5625
"7007","24004","2018",2,2,0,103000,1500,61
"7008","24005","2018",6,6,0,283529,2327.33333333333,126
"7009","24006","2018",5,5,0,96880,1282.2,76.2
"7010","24007","2018",8,8,0,144075,1373,113.125
"7011","24008","2018",9,9,0,80807.5555555556,974.555555555556,79.7777777777778
"7012","24009","2018",3,3,0,153000,1412.33333333333,106.666666666667
"7013","24010","2018",18,17,1,110291.277777778,1319.27777777778,86.2222222222222
"7014","24011","2018",9,9,0,151111.111111111,1256.22222222222,128.555555555556
"7015","24012","2018",2,2,0,187500,1711.5,126
"7016","24014","2018",7,7,0,188571.428571429,1681.57142857143,119.142857142857
"7017","24015","2018",3,3,0,146528.666666667,1714,85.6666666666667
"7018","24016","2018",10,10,0,112933,1045.4,108.8
"7019","24018","2018",4,4,0,140050,1526.5,111.25
"7020","24019","2018",4,4,0,108000,964.25,106.25
"7021","24020","2018",8,8,0,126256.875,1092.125,126.875
"7022","24021","2018",1,1,0,110000,1467,75
"7023","24022","2018",5,5,0,171900,1370.2,121.2
"7024","24023","2018",4,4,0,113150,1538.5,67.75
"7025","24025","2018",3,3,0,305400,2329,128.666666666667
"7026","24026","2018",35,35,0,141181.657142857,1404.74285714286,101.085714285714
"7027","24027","2018",2,2,0,82647.5,794.5,105.5
"7028","24028","2018",14,14,0,171237.5,1547.07142857143,111.5
"7029","24029","2018",2,2,0,86500,670.5,106
"7030","24030","2018",5,5,0,108728,1168,93.2
"7031","24031","2018",1,1,0,4e+05,2469,162
"7032","24032","2018",3,3,0,94166.6666666667,923.666666666667,97.3333333333333
"7033","24034","2018",5,5,0,156302,1451.8,110
"7034","24035","2018",20,19,1,109923.5,1157.05,91.35
"7035","24036","2018",7,7,0,193057.857142857,1862.85714285714,110.571428571429
"7036","24037","2018",439,344,95,128986.514806378,1441.18906605923,89.7334851936219
"7037","24038","2018",7,7,0,152322.714285714,1353.57142857143,131.857142857143
"7038","24039","2018",1,1,0,125000,1042,120
"7039","24040","2018",12,12,0,238380.083333333,2242.91666666667,106.25
"7040","24042","2018",9,9,0,137024.888888889,1364.33333333333,102.444444444444
"7041","24043","2018",1,1,0,85000,1118,76
"7042","24045","2018",4,4,0,223000,1758,125.25
"7043","24046","2018",3,3,0,104833.333333333,1082,101.666666666667
"7044","24048","2018",3,3,0,211171.666666667,1701.33333333333,119.666666666667
"7045","24050","2018",2,2,0,219700,1610,125.5
"7046","24051","2018",1,1,0,50000,556,90
"7047","24052","2018",1,1,0,611072,4968,123
"7048","24053","2018",87,65,22,136803.057471264,1608.51724137931,83.6551724137931
"7049","24054","2018",5,5,0,134600,1458.2,104.2
"7050","24055","2018",9,9,0,176970,1521.22222222222,110.444444444444
"7051","24056","2018",5,5,0,95600,1044.4,87.6
"7052","24057","2018",1,1,0,311321,916,340
"7053","24058","2018",3,3,0,74316.6666666667,743.666666666667,101.666666666667
"7054","24059","2018",4,4,0,106125,996,103.5
"7055","24061","2018",2,2,0,110000,1160.5,93
"7056","24062","2018",3,3,0,144685.333333333,1348.33333333333,116
"7057","24063","2018",6,6,0,136221.666666667,1331.16666666667,112
"7058","24064","2018",30,30,0,129590.833333333,1513.43333333333,97.9
"7059","24066","2018",4,4,0,126875,1767.25,71.75
"7060","24067","2018",36,34,2,151476.722222222,1362,105.111111111111
"7061","24068","2018",28,27,1,140349.678571429,1466.32142857143,97.25
"7062","24069","2018",6,6,0,105900,1094.5,117.166666666667
"7063","24070","2018",4,4,0,67776.25,712.5,107.25
"7064","24071","2018",5,5,0,51600,633.6,81.4
"7065","24073","2018",8,8,0,160775,1864.625,94.5
"7066","24074","2018",5,5,0,195400,1982,101.6
"7067","24075","2018",5,5,0,151489.4,1512.8,103.4
"7068","24076","2018",6,6,0,362803,3015.66666666667,129.666666666667
"7069","24077","2018",2,2,0,112500,1183.5,91.5
"7070","24080","2018",5,5,0,113040,1163.4,94.2
"7071","24081","2018",5,5,0,129710,1253.6,107.4
"7072","24082","2018",23,23,0,186163.695652174,1791.08695652174,107.95652173913
"7073","24083","2018",3,3,0,111433.333333333,838,137.666666666667
"7074","24084","2018",3,3,0,314166.666666667,2023.66666666667,147.666666666667
"7075","24085","2018",2,2,0,252792,1787,143
"7076","24086","2018",5,5,0,115341.2,1579.4,86
"7077","24087","2018",15,15,0,135254.666666667,1551.8,89.9333333333333
"7078","24088","2018",3,3,0,230000,1484.33333333333,128.333333333333
"7079","24090","2018",3,3,0,105000,879,121.333333333333
"7080","24091","2018",19,18,1,172932.368421053,1631.78947368421,106.631578947368
"7081","24094","2018",3,3,0,105333.333333333,1189,105
"7082","24095","2018",7,7,0,135978.571428571,1766.42857142857,89.5714285714286
"7083","24096","2018",6,6,0,141208.333333333,1297.5,111.5
"7084","24097","2018",6,6,0,107058.333333333,932.5,111.166666666667
"7085","24098","2018",36,28,8,161301.416666667,1650.86111111111,96.5277777777778
"7086","24100","2018",8,8,0,111562.5,1012.625,123.375
"7087","24101","2018",5,5,0,45400,964.6,46.4
"7088","24102","2018",53,46,7,148444.849056604,1585.09433962264,93.2830188679245
"7089","24104","2018",3,3,0,108466.666666667,1118.66666666667,94.6666666666667
"7090","24105","2018",2,2,0,82000,1065,77
"7091","24106","2018",9,9,0,231257.777777778,1856,117.222222222222
"7092","24107","2018",1,1,0,46000,383,120
"7093","24108","2018",13,13,0,197226.615384615,1732.30769230769,111.769230769231
"7094","24109","2018",1,1,0,42000,467,90
"7095","24110","2018",1,1,0,85000,714,119
"7096","24111","2018",3,3,0,72000,508,134.666666666667
"7097","24113","2018",2,2,0,105900,1264,84.5
"7098","24114","2018",2,2,0,420283,3001.5,162.5
"7099","24115","2018",13,13,0,133161.538461538,1250.15384615385,108.153846153846
"7100","24116","2018",2,2,0,162500,1459.5,113.5
"7101","24117","2018",1,1,0,230000,1870,123
"7102","24119","2018",2,2,0,124821.5,958.5,121.5
"7103","24120","2018",6,6,0,93333.3333333333,999,93
"7104","24121","2018",2,2,0,105000,692,162
"7105","24122","2018",2,2,0,48250,872,56.5
"7106","24123","2018",1,1,0,120000,1091,110
"7107","24124","2018",4,4,0,115412.5,1269,86.5
"7108","24126","2018",2,2,0,245839,1873.5,131.5
"7109","24128","2018",2,2,0,47500,647.5,69
"7110","24129","2018",4,4,0,225341.25,1227.5,168
"7111","24130","2018",10,10,0,103576,1055.7,105.1
"7112","24132","2018",4,4,0,155284.25,1287.5,126.75
"7113","24133","2018",16,16,0,88889,1372.4375,93.875
"7114","24134","2018",12,12,0,125273.333333333,1663.75,84
"7115","24135","2018",7,7,0,161428.571428571,1662,97
"7116","24136","2018",2,2,0,70000,1346,49.5
"7117","24137","2018",4,4,0,125750,1484.75,83.75
"7118","24138","2018",110,87,23,120899.545454545,1416.10909090909,85.3545454545455
"7119","24139","2018",16,16,0,156528.125,1533.8125,101.6875
"7120","24140","2018",14,14,0,171515,1716.14285714286,102.071428571429
"7121","24141","2018",2,2,0,167500,968.5,171
"7122","24142","2018",20,20,0,198697,1743.7,122.25
"7123","24143","2018",8,8,0,115739.375,986,109
"7124","24144","2018",1,1,0,197000,1015,194
"7125","24145","2018",17,17,0,110757.058823529,1366.35294117647,77.7058823529412
"7126","24146","2018",3,3,0,117666.666666667,2009.33333333333,61.6666666666667
"7127","24147","2018",11,11,0,218541.818181818,1903.36363636364,117.454545454545
"7128","24148","2018",2,2,0,203500,1514,134.5
"7129","24150","2018",15,15,0,130966.666666667,1632.46666666667,90.0666666666667
"7130","24152","2018",17,17,0,185635.294117647,1860.23529411765,106
"7131","24153","2018",3,3,0,109666.666666667,1343.33333333333,84
"7132","24154","2018",2,2,0,108500,1236.5,79
"7133","24155","2018",4,4,0,218400,1412.5,145
"7134","24156","2018",12,11,1,137724.166666667,1316.75,104.25
"7135","24157","2018",5,5,0,178399.8,1075.8,178.6
"7136","24158","2018",1,1,0,245000,1976,124
"7137","24159","2018",6,6,0,99683.3333333333,1227,80.8333333333333
"7138","24160","2018",6,6,0,156425,1405.5,111.5
"7139","24161","2018",1,1,0,60000,508,118
"7140","24162","2018",6,6,0,138583.333333333,1205.33333333333,115.166666666667
"7141","24163","2018",3,3,0,105233.333333333,878.333333333333,126
"7142","24164","2018",10,10,0,138100,1091,126.7
"7143","24165","2018",6,6,0,132353.166666667,1296.83333333333,106.833333333333
"7144","24167","2018",63,62,1,153696.142857143,1499.55555555556,102.873015873016
"7145","24168","2018",6,6,0,236498.333333333,2058.16666666667,117.333333333333
"7146","24171","2018",4,4,0,94750,893,96.5
"7147","24172","2018",17,17,0,175828.823529412,1386,129
"7148","24174","2018",3,3,0,186666.666666667,2909.66666666667,70.3333333333333
"7149","24175","2018",2,2,0,62275.5,579.5,109
"7150","24177","2018",8,8,0,166750,1973.625,87.125
"7151","24179","2018",3,3,0,83500,1239.66666666667,79
"7152","24180","2018",3,3,0,44500,710.333333333333,65.3333333333333
"7153","24182","2018",23,23,0,123225.086956522,1247.82608695652,99.8260869565217
"7154","24183","2018",4,4,0,239200,3276.75,87.75
"7155","24184","2018",3,3,0,86666.6666666667,1227,75.3333333333333
"7156","24186","2018",7,7,0,119285.714285714,963,118.857142857143
"7157","24188","2018",4,4,0,92500,1023.25,99
"7158","24189","2018",8,8,0,164625,1476.375,111.125
"7159","24190","2018",1,1,0,150000,909,165
"7160","24191","2018",2,2,0,53000,791.5,64
"7161","24192","2018",1,1,0,150000,1667,90
"7162","24193","2018",5,5,0,148054,1100,139.8
"7163","24194","2018",15,15,0,125585.333333333,1307.86666666667,97.2
"7164","24195","2018",1,1,0,172000,2150,80
"7165","24196","2018",2,2,0,51490,616.5,82.5
"7166","24197","2018",18,18,0,191027.777777778,1418.33333333333,131.111111111111
"7167","24199","2018",2,2,0,166000,2038.5,81
"7168","24200","2018",6,6,0,133915.5,1200,139.666666666667
"7169","24202","2018",2,2,0,50250,1052.5,46.5
"7170","24205","2018",11,11,0,125301.818181818,1596,78.9090909090909
"7171","24207","2018",10,10,0,150227.7,1720,117.6
"7172","24208","2018",4,4,0,150000,1074.25,136.5
"7173","24210","2018",8,8,0,102875,1143.75,97.625
"7174","24211","2018",4,4,0,57636,683.5,80
"7175","24212","2018",15,15,0,96841,1056.6,92.0666666666667
"7176","24213","2018",4,4,0,73750,1013.5,67.5
"7177","24214","2018",11,10,1,54075.4545454545,647.363636363636,85.4545454545455
"7178","24216","2018",1,1,0,77423,387,200
"7179","24217","2018",4,4,0,339070,2077.25,122
"7180","24218","2018",18,18,0,104937.5,1210.55555555556,90.7222222222222
"7181","24220","2018",7,7,0,176114.285714286,1619.85714285714,116
"7182","24221","2018",3,3,0,148000,1154,133
"7183","24222","2018",32,32,0,150475.53125,1475.78125,108.8125
"7184","24223","2018",46,45,1,161776.086956522,1518.76086956522,103.978260869565
"7185","24224","2018",12,12,0,203204.166666667,1539.5,136.916666666667
"7186","24225","2018",26,26,0,154131,1519.19230769231,104.461538461538
"7187","24226","2018",19,19,0,121682.631578947,1422.15789473684,93.1578947368421
"7188","24227","2018",9,9,0,91454.4444444444,1616.66666666667,76.1111111111111
"7189","24228","2018",10,10,0,158233.2,1470.1,108.4
"7190","24229","2018",12,12,0,74846.8333333333,1150.08333333333,67.9166666666667
"7191","24231","2018",1,1,0,315700,5092,62
"7192","24232","2018",1,1,0,332400,2324,143
"7193","24234","2018",6,6,0,163240,1708.16666666667,101
"7194","24236","2018",5,5,0,130374,1332,101.6
"7195","24237","2018",18,18,0,161594.666666667,1784.66666666667,107
"7196","24238","2018",2,2,0,158500,2045.5,85
"7197","24240","2018",5,5,0,139354.6,1556.6,102.4
"7198","24241","2018",2,2,0,69833.5,1043,97
"7199","24242","2018",3,3,0,229350,1508,143.666666666667
"7200","24243","2018",17,17,0,100715.882352941,1079.29411764706,93.2941176470588
"7201","24246","2018",11,11,0,173512.727272727,1530.81818181818,109
"7202","24247","2018",4,4,0,181833.5,1415.25,136.5
"7203","24248","2018",2,2,0,248500,1681.5,134.5
"7204","24251","2018",6,6,0,192796.666666667,1521.5,116.666666666667
"7205","24252","2018",5,5,0,151700,1600.8,98.2
"7206","24253","2018",28,28,0,113219.071428571,1119.46428571429,103.821428571429
"7207","24255","2018",7,7,0,240700,2440.14285714286,114.714285714286
"7208","24256","2018",31,26,5,145801.935483871,1455.58064516129,101.870967741935
"7209","24257","2018",3,3,0,107666.666666667,1471.33333333333,72.3333333333333
"7210","24259","2018",24,24,0,168166.666666667,1375.29166666667,124.125
"7211","24260","2018",7,7,0,98515.5714285714,1247.71428571429,75.4285714285714
"7212","24261","2018",3,3,0,297000,2149.66666666667,159.666666666667
"7213","24262","2018",3,3,0,109333.333333333,950,112.666666666667
"7214","24263","2018",2,2,0,129000,1936.5,61
"7215","24264","2018",29,29,0,131757.24137931,1230.10344827586,107.103448275862
"7216","24266","2018",6,6,0,94750,1181,82.3333333333333
"7217","24268","2018",6,6,0,206883.333333333,1833.33333333333,115.166666666667
"7218","24269","2018",12,12,0,90395.8333333333,1059.66666666667,94.0833333333333
"7219","24271","2018",9,9,0,118555.555555556,1177.66666666667,101.222222222222
"7220","24272","2018",5,5,0,175720,1444.8,122.4
"7221","24273","2018",8,8,0,151482.5,1725.125,96.75
"7222","24274","2018",9,9,0,264437.777777778,2219.11111111111,109.555555555556
"7223","24276","2018",5,5,0,238000,1720.2,119
"7224","24277","2018",4,4,0,116923,1180.5,109.75
"7225","24278","2018",1,1,0,160000,1524,105
"7226","24280","2018",8,8,0,179996.25,1460.125,127.625
"7227","24281","2018",4,4,0,207500,2060,113.75
"7228","24284","2018",2,2,0,129000,1070.5,121
"7229","24285","2018",3,3,0,179293,1341.66666666667,138.333333333333
"7230","24286","2018",11,11,0,123818.090909091,1095.90909090909,105.454545454545
"7231","24287","2018",1,1,0,168500,1982,85
"7232","24288","2018",4,4,0,153750,1028.75,144.25
"7233","24289","2018",21,21,0,153173.952380952,1370.66666666667,117.238095238095
"7234","24290","2018",2,2,0,217770,1689.5,149.5
"7235","24291","2018",44,37,7,159924.181818182,1820.70454545455,87.3863636363636
"7236","24292","2018",4,4,0,193250,1394.75,137
"7237","24293","2018",2,2,0,65000,904.5,96
"7238","24294","2018",79,78,1,129313.873417722,1476.39240506329,98.5443037974684
"7239","24295","2018",16,16,0,111588.4375,1101.75,100.25
"7240","24296","2018",15,15,0,117857.333333333,1113.06666666667,102.466666666667
"7241","24297","2018",14,13,1,110289.285714286,981.214285714286,118.571428571429
"7242","24299","2018",37,36,1,103289.459459459,1100.75675675676,94.1351351351351
"7243","24300","2018",2,2,0,122650,1634,74.5
"7244","24301","2018",3,3,0,98213.3333333333,1124,84.6666666666667
"7245","24302","2018",5,5,0,120330,1157.4,109.2
"7246","24303","2018",3,3,0,203420.333333333,1886.33333333333,100.666666666667
"7247","24304","2018",9,9,0,124455.555555556,1177.88888888889,106.888888888889
"7248","24305","2018",5,5,0,163200,1514.2,109.8
"7249","24306","2018",1,1,0,367850,1957,188
"7250","24307","2018",3,3,0,267403.333333333,1673.33333333333,170.666666666667
"7251","24308","2018",6,6,0,128041.666666667,1307.16666666667,98.6666666666667
"7252","24309","2018",44,44,0,121867.431818182,1213.93181818182,98.2045454545455
"7253","24311","2018",30,29,1,95715.6666666667,981.066666666667,99.2
"7254","24312","2018",51,44,7,156426,1396.37254901961,105.921568627451
"7255","24313","2018",1,1,0,338500,2318,146
"7256","24316","2018",9,9,0,96500,972.555555555556,108.777777777778
"7257","24317","2018",1,1,0,108000,2700,40
"7258","24318","2018",6,6,0,303266.666666667,2500,128.166666666667
"7259","24319","2018",7,7,0,131392.857142857,1125.28571428571,113.857142857143
"7260","24320","2018",18,18,0,95978.0555555556,1045.83333333333,100.833333333333
"7261","24321","2018",7,6,1,88750,1195.42857142857,74.8571428571429
"7262","24322","2018",519,217,302,122840.965317919,1565.12909441233,78.3391136801541
"7263","24323","2018",1,1,0,110000,982,112
"7264","24324","2018",7,7,0,150680,1391,116.571428571429
"7265","24325","2018",5,5,0,143600,1103.4,133.6
"7266","24326","2018",3,3,0,192499.666666667,1938.33333333333,99.3333333333333
"7267","24327","2018",3,3,0,279000,2036.33333333333,177.666666666667
"7268","24328","2018",8,8,0,83312.5,1183.875,89.25
"7269","24329","2018",17,17,0,126514.705882353,1125.11764705882,113
"7270","24330","2018",11,11,0,187453.181818182,1482.63636363636,129.636363636364
"7271","24331","2018",10,10,0,182461.5,1437,131.2
"7272","24334","2018",3,3,0,183814.666666667,1707,109
"7273","24335","2018",33,32,1,132234.242424242,1272.09090909091,109.272727272727
"7274","24336","2018",3,3,0,188900,1528.33333333333,132.666666666667
"7275","24337","2018",6,6,0,125166.666666667,1442.33333333333,88.3333333333333
"7276","24338","2018",4,4,0,108600,1012.75,112.5
"7277","24339","2018",2,2,0,152500,1964,82
"7278","24340","2018",42,42,0,144004.761904762,1416.14285714286,104.571428571429
"7279","24341","2018",10,10,0,231466.8,2096.5,116.3
"7280","24345","2018",4,4,0,198702.5,1464,128.5
"7281","24346","2018",3,3,0,108450,848.666666666667,130.666666666667
"7282","24347","2018",2,2,0,145300,1128,132.5
"7283","24348","2018",4,4,0,137575,1406.5,99
"7284","24349","2018",7,7,0,173228.571428571,1236.57142857143,137.571428571429
"7285","24350","2018",24,24,0,124020.833333333,1467.83333333333,86.2083333333333
"7286","24351","2018",3,3,0,109500,1207.33333333333,93
"7287","24352","2018",53,52,1,114076.245283019,1061.22641509434,111.679245283019
"7288","24353","2018",2,2,0,106000,1179.5,96
"7289","24354","2018",38,37,1,101463.684210526,1054.65789473684,98.2105263157895
"7290","24355","2018",6,6,0,277333.333333333,2247.66666666667,118.166666666667
"7291","24356","2018",20,20,0,140667,1375.4,103.15
"7292","24357","2018",5,5,0,128350,1226.8,101.6
"7293","24359","2018",1,1,0,410000,2278,180
"7294","24360","2018",4,4,0,216026.25,1820.25,115
"7295","24361","2018",5,5,0,182139,1631,112.2
"7296","24362","2018",33,31,2,161470,1764.9696969697,104.818181818182
"7297","24364","2018",9,9,0,190687.222222222,1880.22222222222,112.555555555556
"7298","24365","2018",3,3,0,278183.333333333,1670.33333333333,151
"7299","24366","2018",11,11,0,166752.272727273,1767.36363636364,95.4545454545455
"7300","24367","2018",2,2,0,395000,3647.5,105.5
"7301","24370","2018",15,15,0,118293.333333333,1136.06666666667,101.333333333333
"7302","24371","2018",3,3,0,126000,969,127.666666666667
"7303","24372","2018",76,69,7,106766.078947368,1220.34210526316,90.1578947368421
"7304","24373","2018",5,5,0,142410,1075.2,132.4
"7305","24374","2018",1,1,0,357000,2231,160
"7306","24375","2018",2,2,0,112750,1298.5,85
"7307","24376","2018",24,24,0,101222.333333333,1056.66666666667,99.7083333333333
"7308","24379","2018",10,10,0,138350,1273.6,111.3
"7309","24380","2018",7,7,0,103357.142857143,1172.71428571429,84.8571428571429
"7310","24381","2018",5,5,0,76126,1043.2,76
"7311","24382","2018",9,9,0,166714.444444444,1566.22222222222,105.333333333333
"7312","24383","2018",1,1,0,280000,1556,180
"7313","24385","2018",1,1,0,230000,1917,120
"7314","24388","2018",10,10,0,157750.9,1703.7,100.6
"7315","24390","2018",4,4,0,129750,1338.5,97
"7316","24392","2018",4,4,0,186620,2800,64.5
"7317","24393","2018",1,1,0,112200,774,145
"7318","24394","2018",1,1,0,207000,1630,127
"7319","24395","2018",8,8,0,158250,1638.125,98.875
"7320","24396","2018",22,19,3,174921.727272727,2018.27272727273,103.363636363636
"7321","24397","2018",2,2,0,101990,1443,71.5
"7322","24398","2018",16,16,0,132085.3125,1291.9375,102.625
"7323","24399","2018",2,2,0,81750,844,97
"7324","24401","2018",6,6,0,73100,858.166666666667,84
"7325","24403","2018",1,1,0,48000,632,76
"7326","24404","2018",3,3,0,236965,2189.33333333333,119
"7327","24405","2018",5,5,0,132400,1104,122.6
"7328","24407","2018",3,3,0,167333.333333333,1798,94
"7329","24409","2018",12,12,0,106833.333333333,1286.16666666667,84.5833333333333
"7330","24410","2018",5,5,0,155357,1267.8,129.8
"7331","24411","2018",2,2,0,221000,1023,195
"7332","24412","2018",11,11,0,179351.909090909,1775.72727272727,96.1818181818182
"7333","24413","2018",2,2,0,137500,1369.5,107
"7334","24414","2018",6,6,0,235983.333333333,1587.16666666667,169
"7335","24416","2018",1,1,0,331500,1275,260
"7336","24417","2018",4,4,0,147000,1513,100.75
"7337","24418","2018",11,11,0,97016.0909090909,1126.54545454545,86.5454545454545
"7338","24419","2018",7,7,0,157285.714285714,1167.14285714286,124.142857142857
"7339","24420","2018",1,1,0,271300,2170,125
"7340","24421","2018",1,1,0,59000,843,70
"7341","24422","2018",2,2,0,160000,1624.5,100.5
"7342","24423","2018",6,6,0,164732.333333333,1164.33333333333,145.333333333333
"7343","24424","2018",1,1,0,128000,1143,112
"7344","24425","2018",10,10,0,79500,906,87.9
"7345","24428","2018",16,16,0,94679.25,1186.8125,79.0625
"7346","24429","2018",4,4,0,108600,1165.25,93.25
"7347","24432","2018",6,6,0,204330,1579.33333333333,116.166666666667
"7348","24434","2018",1,1,0,240400,2185,110
"7349","24436","2018",14,14,0,133267.857142857,1204,101.857142857143
"7350","24437","2018",6,6,0,158358.333333333,1588,100.166666666667
"7351","24438","2018",2,2,0,155000,1152.5,135
"7352","24442","2018",18,18,0,101723,1091.5,95.3333333333333
"7353","24443","2018",10,10,0,199500,1975.3,116.8
"7354","24444","2018",2,2,0,135500,1264.5,105.5
"7355","24445","2018",3,3,0,415133.333333333,1925.66666666667,223.333333333333
"7356","24446","2018",1,1,0,588450,2432,242
"7357","24448","2018",5,5,0,152685,1295.4,112
"7358","24449","2018",9,9,0,124833.333333333,1302.88888888889,104.555555555556
"7359","24450","2018",19,19,0,187581.578947368,1687.68421052632,111.684210526316
"7360","24451","2018",10,10,0,103200,1093.5,121.9
"7361","24452","2018",3,3,0,278811.666666667,1479.66666666667,191
"7362","24453","2018",4,4,0,131750,1219,107
"7363","24454","2018",11,11,0,166120,1196.54545454545,138.363636363636
"7364","24455","2018",11,11,0,99387.9090909091,951.545454545455,100.181818181818
"7365","24456","2018",3,3,0,217233.333333333,1872.66666666667,118
"7366","24457","2018",3,3,0,131666.666666667,1232.33333333333,115.666666666667
"7367","24458","2018",6,6,0,112750,1054.83333333333,110.333333333333
"7368","24459","2018",2,2,0,207500,1980,108
"7369","24460","2018",6,6,0,101500,1185,84.3333333333333
"7370","24461","2018",13,13,0,126613.076923077,1353.07692307692,94
"7371","24462","2018",17,16,1,108974.117647059,1087.11764705882,96.7058823529412
"7372","24463","2018",8,8,0,86211.875,1139.75,75.375
"7373","24464","2018",5,5,0,83600,918.4,86.4
"7374","24465","2018",3,3,0,176500,1753.66666666667,102.333333333333
"7375","24466","2018",6,6,0,230350.5,1789,133.5
"7376","24468","2018",2,2,0,84250,885,103.5
"7377","24470","2018",3,3,0,148666.666666667,1443.66666666667,89.3333333333333
"7378","24471","2018",6,6,0,224586.666666667,1935.83333333333,110.5
"7379","24472","2018",12,12,0,154515,1517.91666666667,103.5
"7380","24473","2018",7,7,0,132485.714285714,1298.42857142857,102.285714285714
"7381","24474","2018",1,1,0,60000,400,150
"7382","24476","2018",2,2,0,127500,1107,115.5
"7383","24477","2018",3,3,0,75530,791.666666666667,91.3333333333333
"7384","24478","2018",1,1,0,60000,638,94
"7385","24479","2018",17,17,0,100423.529411765,958.176470588235,112.058823529412
"7386","24480","2018",6,6,0,203296.666666667,1376,154
"7387","24481","2018",8,8,0,102875,1341.125,81
"7388","24482","2018",2,1,1,101363.5,976,104
"7389","24483","2018",2,2,0,260845,1557,161
"7390","24484","2018",15,14,1,140379.066666667,1301.2,105.4
"7391","24485","2018",6,6,0,107153.333333333,1041.33333333333,118.833333333333
"7392","24486","2018",8,8,0,110675,1285.875,81.5
"7393","24487","2018",22,22,0,151692.5,1485.40909090909,106.136363636364
"7394","24488","2018",1,1,0,260000,3250,80
"7395","24489","2018",2,2,0,85732.5,837.5,110
"7396","24490","2018",19,19,0,100313.842105263,1047.05263157895,99.1578947368421
"7397","24491","2018",3,3,0,178614.666666667,1587.66666666667,110
"7398","24492","2018",1,1,0,250000,951,263
"7399","24494","2018",5,5,0,134140,1167.6,96.8
"7400","24496","2018",5,5,0,115400,1416.6,89.8
"7401","24498","2018",13,13,0,94115.3846153846,1014.53846153846,96.6923076923077
"7402","24499","2018",12,12,0,166364.333333333,1700.5,100.5
"7403","24500","2018",1,1,0,165800,1764,94
"7404","24501","2018",6,6,0,90416.6666666667,775.5,113.166666666667
"7405","24502","2018",1,1,0,197500,1234,160
"7406","24504","2018",5,5,0,181700,1151.4,159
"7407","24505","2018",7,7,0,73071.4285714286,1166.57142857143,68.8571428571429
"7408","24507","2018",1,1,0,98000,1167,84
"7409","24508","2018",1,1,0,82205,1041,79
"7410","24509","2018",6,6,0,109791.666666667,1074.83333333333,113
"7411","24510","2018",7,7,0,169794.571428571,1512.85714285714,109.571428571429
"7412","24511","2018",4,4,0,121750,988.75,116.5
"7413","24512","2018",6,5,1,284605,1752,164.333333333333
"7414","24513","2018",1,1,0,157000,1389,113
"7415","24514","2018",1,1,0,144500,1403,103
"7416","24515","2018",6,6,0,92371.6666666667,957.166666666667,92.8333333333333
"7417","24516","2018",17,17,0,194474.470588235,1816.88235294118,109
"7418","24517","2018",1,1,0,70000,1400,50
"7419","24518","2018",4,4,0,113060,1351,89
"7420","24519","2018",5,5,0,100200,1248.8,74.4
"7421","24520","2018",155,106,49,168862.35483871,1916.23225806452,91.2064516129032
"7422","24521","2018",5,5,0,138380,1452.4,95
"7423","24522","2018",4,4,0,112875,1184.25,100.75
"7424","24523","2018",7,7,0,164942.857142857,1504.42857142857,113.571428571429
"7425","24524","2018",1,1,0,306000,1700,180
"7426","24525","2018",5,5,0,114596,1278,101.8
"7427","24526","2018",9,9,0,77055.5555555556,1348.55555555556,69.4444444444444
"7428","24527","2018",7,7,0,180571.428571429,1373.85714285714,129.857142857143
"7429","24529","2018",2,2,0,146144,1237.5,104.5
"7430","24531","2018",1,1,0,1e+05,2326,43
"7431","24532","2018",5,5,0,138953.4,1332.4,108.8
"7432","24534","2018",20,20,0,134025,1270.15,105.55
"7433","24535","2018",1,1,0,175000,1346,130
"7434","24536","2018",5,5,0,145500,1494,98.4
"7435","24537","2018",6,6,0,141767.833333333,1587.33333333333,99.5
"7436","24538","2018",12,12,0,124091.666666667,1324.41666666667,100.333333333333
"7437","24540","2018",24,24,0,134381.25,1523.83333333333,93.2083333333333
"7438","24541","2018",3,3,0,54400,1086.66666666667,50.6666666666667
"7439","24543","2018",15,15,0,134268.866666667,1619.66666666667,83.8
"7440","24544","2018",5,5,0,180000,2021.8,86.8
"7441","24547","2018",64,49,15,94301.296875,1118.671875,80.828125
"7442","24548","2018",4,4,0,108250,931.75,135
"7443","24549","2018",6,6,0,105377.5,1162.5,108
"7444","24550","2018",11,11,0,85818.1818181818,1166.45454545455,70
"7445","24551","2018",26,25,1,112725.269230769,1145.19230769231,101.384615384615
"7446","24552","2018",4,4,0,111000,1225.5,89.75
"7447","24553","2018",18,18,0,143352.777777778,1184.72222222222,126.611111111111
"7448","24554","2018",3,3,0,101659.666666667,934.666666666667,110.333333333333
"7449","24555","2018",11,11,0,78400,968.363636363636,81.4545454545455
"7450","24557","2018",109,80,29,145386.220183486,1593.03669724771,94.4036697247706
"7451","24558","2018",9,9,0,138340,1391.33333333333,100.111111111111
"7452","24559","2018",6,6,0,209500,1518,131.666666666667
"7453","24562","2018",3,3,0,58333.3333333333,884,58.3333333333333
"7454","24563","2018",7,7,0,210354.285714286,2080.85714285714,118.857142857143
"7455","24564","2018",10,10,0,153907.9,1541.2,101.7
"7456","24565","2018",8,8,0,72662.5,810.75,93.875
"7457","24566","2018",5,5,0,120700,1139.8,108
"7458","24567","2018",2,2,0,82750,1486.5,71
"7459","24568","2018",5,5,0,92832.4,867.4,106
"7460","24569","2018",2,2,0,103550,1117.5,95.5
"7461","24571","2018",24,21,3,134385.5,1531,90.75
"7462","24572","2018",4,4,0,153750,1791.75,91.75
"7463","24573","2018",9,9,0,137735.666666667,1193.88888888889,111.111111111111
"7464","24574","2018",7,7,0,157352.857142857,1394.14285714286,107.714285714286
"7465","24575","2018",2,2,0,197500,1787.5,138
"7466","24576","2018",2,2,0,135500,1854,95
"7467","24577","2018",12,12,0,227896.833333333,2071.75,109.75
"7468","24580","2018",5,5,0,112560,1334.8,82.8
"7469","24581","2018",7,7,0,146454.285714286,1377.42857142857,107.428571428571
"7470","24582","2018",7,7,0,195861.285714286,1643.57142857143,144.142857142857
"7471","24584","2018",11,11,0,122308.181818182,1340.90909090909,90.5454545454545
"7472","24585","2018",12,12,0,139902.083333333,1402.75,109.333333333333
"7473","24586","2018",10,10,0,163441.9,1340.7,122.3
"7474","24587","2018",12,12,0,302747.75,2155.75,139.5
"7475","25001","2018",2,2,0,159350,1066.5,157.5
"7476","25002","2018",2,2,0,297900,1822,165.5
"7477","25003","2018",1,1,0,40000,400,100
"7478","25004","2018",8,6,2,169012.5,1778.25,93
"7479","25005","2018",4,4,0,158747.5,1288.25,121.25
"7480","25006","2018",2,2,0,239625,1316.5,202.5
"7481","25008","2018",4,3,1,123750,1317,96.25
"7482","25009","2018",1,1,0,100800,1072,94
"7483","25011","2018",8,6,2,147187.5,1428.875,100.75
"7484","25013","2018",1,1,0,110000,1746,63
"7485","25014","2018",8,7,1,142760.625,1792.625,80.875
"7486","25015","2018",4,3,1,143687.5,1256.5,122.25
"7487","25016","2018",2,2,0,135750,965,140.5
"7488","25017","2018",3,2,1,247500,2371.33333333333,99.6666666666667
"7489","25018","2018",9,9,0,99838.8888888889,1074.88888888889,100.666666666667
"7490","25019","2018",7,7,0,136392.857142857,1175.14285714286,115.571428571429
"7491","25020","2018",16,9,7,279393.75,2249.6875,85.75
"7492","25021","2018",14,14,0,129997.642857143,1107.85714285714,121.214285714286
"7493","25022","2018",10,8,2,135641,1245,113.6
"7494","25024","2018",4,2,2,198750,2259,91.75
"7495","25025","2018",6,6,0,192228.333333333,1912.16666666667,106.666666666667
"7496","25026","2018",4,4,0,187512.5,1595.5,122.25
"7497","25030","2018",2,1,1,177300,1568,115
"7498","25031","2018",127,77,50,109170.409448819,1260.37007874016,87.2834645669291
"7499","25032","2018",4,4,0,145375,1342.25,108.25
"7500","25033","2018",3,3,0,103833.333333333,1400.66666666667,72.6666666666667
"7501","25035","2018",25,23,2,263279.2,2269.76,117.92
"7502","25036","2018",17,13,4,188916.352941176,1811.05882352941,105.647058823529
"7503","25038","2018",2,2,0,140500,834,153.5
"7504","25039","2018",8,8,0,119981.25,1512.75,84
"7505","25040","2018",3,3,0,113666.666666667,1013,110.333333333333
"7506","25041","2018",6,4,2,282239.166666667,2166.33333333333,134.5
"7507","25042","2018",2,2,0,228050,2049.5,132
"7508","25043","2018",15,13,2,141152.2,1281,102.466666666667
"7509","25046","2018",2,2,0,220500,1551,154.5
"7510","25047","2018",65,38,27,127296.615384615,1431.69230769231,93.2
"7511","25048","2018",34,27,7,141321.470588235,1393.70588235294,103.352941176471
"7512","25049","2018",1,1,0,265000,1853,143
"7513","25050","2018",2,1,1,254500,2471.5,105
"7514","25051","2018",8,8,0,166606.25,1208.125,134.125
"7515","25052","2018",1,1,0,1e+05,1000,100
"7516","25054","2018",6,6,0,219191.666666667,1401,155.166666666667
"7517","25055","2018",3,3,0,300466.666666667,2080.66666666667,141.666666666667
"7518","25056","2018",1824,219,1605,126175.33004386,1867.18092105263,68.7423245614035
"7519","25057","2018",34,26,8,107782.911764706,1182.73529411765,94.6470588235294
"7520","25058","2018",18,8,10,137133.888888889,1651.33333333333,81.0555555555556
"7521","25059","2018",2,2,0,155250,1430,111.5
"7522","25060","2018",13,7,6,144036.153846154,1707.61538461538,81.4615384615385
"7523","25061","2018",1,1,0,45500,464,98
"7524","25062","2018",5,5,0,232260,1774.6,138.2
"7525","25063","2018",9,6,3,138603.555555556,1764,79.4444444444444
"7526","25066","2018",1,1,0,178800,1233,145
"7527","25067","2018",3,3,0,137900,1816.33333333333,76
"7528","25070","2018",2,2,0,114497.5,587,184.5
"7529","25071","2018",9,6,3,141030.555555556,1551.66666666667,99.4444444444444
"7530","25072","2018",1,1,0,280000,1273,220
"7531","25073","2018",4,3,1,194275,1726.25,112.5
"7532","25074","2018",5,5,0,179816,1485.8,139.2
"7533","25075","2018",2,2,0,417700,2835.5,154.5
"7534","25078","2018",13,12,1,153511.538461538,1487,109.538461538462
"7535","25079","2018",7,5,2,139850.857142857,1202.57142857143,125.142857142857
"7536","25082","2018",3,3,0,99726.6666666667,1279.66666666667,79
"7537","25083","2018",1,1,0,75000,750,100
"7538","25084","2018",22,16,6,175957.090909091,1747.22727272727,98.0909090909091
"7539","25085","2018",3,1,2,182826,1744.66666666667,109.333333333333
"7540","25086","2018",1,1,0,174500,2424,72
"7541","25087","2018",2,2,0,119500,949,128.5
"7542","25091","2018",7,6,1,214428.571428571,1996.28571428571,107
"7543","25092","2018",1,1,0,148500,1238,120
"7544","25094","2018",1,1,0,67000,728,92
"7545","25095","2018",2,2,0,106970,2011.5,57.5
"7546","25096","2018",3,3,0,264346.666666667,2775.33333333333,92.6666666666667
"7547","25097","2018",3,3,0,135266.666666667,1833.33333333333,70.3333333333333
"7548","25098","2018",6,6,0,106413.333333333,1016.16666666667,126.333333333333
"7549","25099","2018",2,2,0,287095,2482,120
"7550","25100","2018",4,2,2,229862.5,1999.25,117
"7551","25101","2018",9,9,0,164710,1447.77777777778,117.666666666667
"7552","25103","2018",15,15,0,202000,1668.6,118.133333333333
"7553","25104","2018",1,1,0,1e+05,746,134
"7554","25105","2018",10,8,2,208114.9,3364.6,93.6
"7555","25106","2018",1,1,0,148000,2176,68
"7556","25107","2018",2,2,0,159650,1084.5,228
"7557","25108","2018",1,1,0,306390,1868,164
"7558","25109","2018",6,4,2,110800,1183.83333333333,103.166666666667
"7559","25110","2018",12,10,2,253455.833333333,2412,112.75
"7560","25111","2018",4,4,0,175750,1520,120
"7561","25112","2018",12,5,7,142194.166666667,2116.91666666667,65.75
"7562","25114","2018",10,10,0,118507,1121.9,104.4
"7563","25115","2018",1,1,0,320000,2936,109
"7564","25116","2018",1,1,0,164000,1519,108
"7565","25119","2018",2,2,0,314500,1949.5,144
"7566","25120","2018",5,5,0,133420,1252.6,118.8
"7567","25121","2018",1,1,0,360700,2753,131
"7568","25122","2018",4,4,0,243250,2413.5,106.75
"7569","25124","2018",4,4,0,143875,2407.5,58.5
"7570","25125","2018",2,2,0,165795,1488,114.5
"7571","25126","2018",4,4,0,245410.25,2222.75,110
"7572","25127","2018",40,19,21,165200.35,1791.15,91.775
"7573","25129","2018",3,3,0,132766.666666667,1627.33333333333,89
"7574","25131","2018",1,1,0,161450,1552,104
"7575","25133","2018",26,25,1,283227.615384615,2479.73076923077,116.615384615385
"7576","25136","2018",8,8,0,182556.25,1369.125,133.875
"7577","25138","2018",3,3,0,155000,1701,104.333333333333
"7578","25139","2018",2,2,0,263000,1925,136
"7579","25142","2018",5,4,1,237100,2020.4,114.2
"7580","25143","2018",1,1,0,70000,625,112
"7581","25147","2018",32,26,6,156671.375,1529.71875,104.8125
"7582","25148","2018",6,6,0,299750,2406.16666666667,127.666666666667
"7583","25149","2018",5,4,1,137020,1442.4,110.4
"7584","25150","2018",2,2,0,184000,1649,113.5
"7585","25151","2018",1,1,0,72000,585,123
"7586","25154","2018",2,2,0,77000,1165,69
"7587","25155","2018",1,1,0,213878,1927,111
"7588","25156","2018",6,6,0,124416.666666667,2357.5,87.8333333333333
"7589","25157","2018",21,5,16,199261.904761905,2192.19047619048,93.7619047619048
"7590","25159","2018",12,9,3,107720.833333333,1222.25,93.75
"7591","25160","2018",4,4,0,189958,1838.75,101.25
"7592","25162","2018",3,3,0,261366.666666667,2432.33333333333,111.666666666667
"7593","25170","2018",12,12,0,153285,1471.08333333333,104.416666666667
"7594","25171","2018",1,1,0,157550,1313,120
"7595","25172","2018",4,3,1,115081.5,1476.25,76.75
"7596","25173","2018",1,1,0,77000,1400,55
"7597","25174","2018",1,1,0,175000,1786,98
"7598","25175","2018",2,2,0,185917,720.5,268.5
"7599","25176","2018",1,1,0,126496,3162,40
"7600","25177","2018",3,3,0,130666.666666667,1051,126.666666666667
"7601","25180","2018",2,2,0,217725,1865.5,116.5
"7602","25182","2018",2,2,0,134000,757,194
"7603","25184","2018",1,1,0,271200,1043,260
"7604","25185","2018",1,1,0,189289,1305,145
"7605","25186","2018",12,9,3,167883.333333333,1717.58333333333,102.166666666667
"7606","25187","2018",3,2,1,133033.333333333,1454.66666666667,93.3333333333333
"7607","25188","2018",10,9,1,189876,1632.8,118
"7608","25189","2018",2,2,0,129125,1603,88
"7609","25190","2018",20,18,2,132147.5,1376.4,93.7
"7610","25191","2018",3,2,1,108611.333333333,1123.33333333333,105.666666666667
"7611","25193","2018",21,14,7,160166.619047619,1660.66666666667,99
"7612","25194","2018",1,1,0,138490,1574,88
"7613","25195","2018",21,19,2,189818.714285714,1668.80952380952,116.333333333333
"7614","25196","2018",21,15,6,137622.952380952,1441.04761904762,97.9523809523809
"7615","25197","2018",8,6,2,104625,1201.625,89.625
"7616","25198","2018",4,4,0,170260,1659.5,104.5
"7617","25199","2018",4,3,1,92548.75,1164,96
"7618","25200","2018",12,9,3,171960,1748.5,99.9166666666667
"7619","25201","2018",16,4,12,180481,1945.9375,92.9375
"7620","25202","2018",7,3,4,170971.428571429,1673.28571428571,103.285714285714
"7621","25203","2018",1,1,0,295000,1621,182
"7622","25204","2018",49,26,23,250007.87755102,2501.9387755102,103.428571428571
"7623","25207","2018",11,11,0,203796.545454545,1478.18181818182,152.545454545455
"7624","25208","2018",5,3,2,197590,1692,124.2
"7625","25210","2018",2,2,0,292750,2085.5,140.5
"7626","25212","2018",23,17,6,209241.608695652,1969.04347826087,106.739130434783
"7627","25213","2018",7,7,0,206100,1906.71428571429,107.142857142857
"7628","25214","2018",3,2,1,175250,1411.33333333333,119
"7629","25216","2018",5,5,0,139400,1547.2,91.6
"7630","25217","2018",14,12,2,137042.142857143,1276.21428571429,111.428571428571
"7631","25219","2018",3,3,0,170000,1896.66666666667,92.6666666666667
"7632","25220","2018",5,5,0,158900,1816,86.4
"7633","25222","2018",11,11,0,153239.181818182,1463.18181818182,104.727272727273
"7634","25223","2018",3,3,0,137333.333333333,838.333333333333,163.666666666667
"7635","25224","2018",8,7,1,118161.25,1277.125,90.125
"7636","25225","2018",2,2,0,115500,863.5,142.5
"7637","25226","2018",4,4,0,147750,1620,97.5
"7638","25227","2018",2,2,0,186910,1459.5,145.5
"7639","25228","2018",37,27,10,141061.216216216,1577.59459459459,88.5135135135135
"7640","25229","2018",3,3,0,173666.666666667,1612,112.333333333333
"7641","25230","2018",47,42,5,133669.893617021,1421.1914893617,94.3829787234042
"7642","25231","2018",1,1,0,194750,1755,111
"7643","25232","2018",1,1,0,161000,2236,72
"7644","25233","2018",2,2,0,174000,1620,110
"7645","25234","2018",1,1,0,171000,1598,107
"7646","25235","2018",12,9,3,152486.666666667,1412.08333333333,112.416666666667
"7647","25236","2018",3,3,0,194583.333333333,1170.33333333333,183
"7648","25237","2018",17,13,4,98356.2352941177,1282.41176470588,78.5882352941177
"7649","25238","2018",1,1,0,62500,1136,55
"7650","25239","2018",2,2,0,145000,1226,135
"7651","25240","2018",33,21,12,256248.787878788,2667.36363636364,98.9393939393939
"7652","25242","2018",2,2,0,148150,1512,98
"7653","25243","2018",7,7,0,196871.428571429,1979.28571428571,104.571428571429
"7654","25245","2018",4,4,0,210000,1715.5,118.25
"7655","25246","2018",6,6,0,100216.666666667,944.166666666667,99.5
"7656","25247","2018",2,2,0,51500,566.5,101.5
"7657","25248","2018",5,5,0,168136,1648,98.2
"7658","25249","2018",2,2,0,64500,736,90
"7659","25251","2018",3,3,0,112743.333333333,1087.66666666667,94.3333333333333
"7660","25252","2018",1,1,0,272000,1177,231
"7661","25253","2018",3,2,1,131666.666666667,1370.66666666667,93
"7662","25254","2018",23,9,14,191540.434782609,2290.4347826087,84.0869565217391
"7663","25255","2018",3,1,2,143833.333333333,1637,88.3333333333333
"7664","25256","2018",11,9,2,246009.090909091,2139.45454545455,116.818181818182
"7665","25257","2018",1,1,0,198000,2041,97
"7666","25258","2018",17,15,2,213718.823529412,1914.17647058824,110.882352941176
"7667","25259","2018",30,14,16,175430.6,1731.83333333333,103.4
"7668","25262","2018",1,1,0,295100,2659,111
"7669","25264","2018",1,1,0,130000,963,135
"7670","25265","2018",14,8,6,163218.571428571,1657.57142857143,97.2142857142857
"7671","25266","2018",1,1,0,115000,1292,89
"7672","25267","2018",3,3,0,130833.333333333,1118.33333333333,136.333333333333
"7673","25268","2018",2,2,0,107500,1231,90
"7674","25270","2018",1,1,0,2e+05,1905,105
"7675","25271","2018",18,8,10,179957.777777778,2110.77777777778,87.2222222222222
"7676","25273","2018",4,4,0,118172.5,989.75,114.5
"7677","25274","2018",2,1,1,121000,1359.5,93
"7678","25275","2018",5,5,0,80084,1621,49.6
"7679","25276","2018",2,2,0,116000,1064,114
"7680","25277","2018",4,4,0,101387.5,690.75,137.75
"7681","25278","2018",7,6,1,176328.571428571,1492.42857142857,122.142857142857
"7682","25279","2018",1,1,0,116900,1135,103
"7683","25280","2018",4,4,0,201250,2024.5,110.25
"7684","25281","2018",2,2,0,147000,1471,100
"7685","25282","2018",6,5,1,166367.333333333,1550.66666666667,120.833333333333
"7686","25284","2018",49,29,20,118582.87755102,1401.67346938776,83.8163265306122
"7687","25285","2018",11,10,1,261231.818181818,2399,112.181818181818
"7688","25286","2018",1,1,0,283000,2721,104
"7689","25287","2018",21,21,0,224682.142857143,1760.85714285714,128.571428571429
"7690","25288","2018",7,5,2,200048,1899,104.285714285714
"7691","25289","2018",1,1,0,80000,593,135
"7692","25293","2018",16,12,4,306195.125,2945.5625,103.9375
"7693","25296","2018",8,5,3,211287.5,1819.625,119.25
"7694","25297","2018",1,1,0,2e+05,1527,131
"7695","25298","2018",2,2,0,371708.5,2577.5,132.5
"7696","25299","2018",1,1,0,83356,1516,55
"7697","25300","2018",1,1,0,245000,3141,78
"7698","25301","2018",2,2,0,226600,1865,122
"7699","25303","2018",2,2,0,259500,2146,120.5
"7700","25304","2018",33,17,16,103799.515151515,1144.9696969697,88.6060606060606
"7701","25305","2018",3,2,1,139000,1233.66666666667,116.666666666667
"7702","25306","2018",1,1,0,150000,1210,124
"7703","25307","2018",29,11,18,184914.413793103,2973.68965517241,61.2758620689655
"7704","25308","2018",5,3,2,209323,3704.6,65.2
"7705","25309","2018",18,11,7,237385.666666667,2648.72222222222,93.2222222222222
"7706","25311","2018",5,5,0,148500,1503.2,101.8
"7707","25312","2018",3,3,0,47483.3333333333,872.333333333333,58.3333333333333
"7708","25313","2018",3,2,1,55811.3333333333,657.666666666667,90
"7709","25314","2018",5,4,1,129914,1268.8,107.4
"7710","25315","2018",22,17,5,102028.181818182,1101.40909090909,90.6818181818182
"7711","25316","2018",1,1,0,185925,2066,90
"7712","25317","2018",3,3,0,206750,1323.66666666667,177.333333333333
"7713","25318","2018",33,18,15,227863.363636364,2768.39393939394,89.8787878787879
"7714","25320","2018",11,6,5,273025.454545455,2692.18181818182,107.181818181818
"7715","25321","2018",90,44,46,208352.7,2375.41111111111,87
"7716","25322","2018",1,1,0,272400,1974,138
"7717","25323","2018",7,7,0,136570,1364.14285714286,103.428571428571
"7718","25324","2018",2,2,0,63000,627.5,101.5
"7719","25325","2018",3,3,0,110333.333333333,1016.33333333333,103.666666666667
"7720","25326","2018",9,9,0,154844.444444444,1359.77777777778,113.444444444444
"7721","25328","2018",9,6,3,197292.222222222,1810.44444444444,110.333333333333
"7722","25329","2018",1,1,0,230000,4182,55
"7723","25330","2018",2,2,0,178700,1739.5,102.5
"7724","25331","2018",3,3,0,178000,1504.66666666667,111.666666666667
"7725","25332","2018",4,3,1,176742.5,1670.5,108
"7726","25333","2018",1,1,0,72000,529,136
"7727","25334","2018",25,18,7,150358.4,1530.24,99.44
"7728","25335","2018",2,1,1,144250,2730,55
"7729","25336","2018",4,4,0,140150,1134.25,129.25
"7730","25339","2018",6,5,1,88530,1183.66666666667,84.8333333333333
"7731","25340","2018",1,1,0,435000,1334,326
"7732","25341","2018",2,2,0,175000,806,216
"7733","25343","2018",1,1,0,139500,1468,95
"7734","25345","2018",2,2,0,111700,1767,82
"7735","25347","2018",4,4,0,345250,4497.25,88.5
"7736","25348","2018",11,9,2,247265.454545455,2861.54545454545,93.4545454545455
"7737","25349","2018",7,6,1,196281.428571429,2140,94.1428571428571
"7738","25350","2018",7,7,0,112614.285714286,1181.85714285714,97.1428571428571
"7739","25351","2018",5,4,1,215522.2,2387.2,94.4
"7740","25354","2018",3,3,0,123000,971.666666666667,128
"7741","25356","2018",53,32,21,170425.566037736,1933.39622641509,90.6037735849057
"7742","25357","2018",6,5,1,218250,2309.66666666667,93.1666666666667
"7743","25359","2018",1,1,0,160000,1441,111
"7744","25361","2018",21,5,16,173919.761904762,3032.47619047619,69.4761904761905
"7745","25362","2018",4,3,1,192710,2744,75.5
"7746","25364","2018",14,13,1,156342.857142857,1511.07142857143,105.714285714286
"7747","25365","2018",4,4,0,123780.5,1132,114.75
"7748","25366","2018",2,2,0,309447,2072.5,171
"7749","25367","2018",53,37,16,95677.7358490566,1134.09433962264,83.1132075471698
"7750","25368","2018",15,15,0,158745.333333333,1467.4,109
"7751","25370","2018",16,9,7,138774.625,1805.8125,79.1875
"7752","25371","2018",1,1,0,120000,774,155
"7753","25372","2018",3,3,0,108558,873,123.666666666667
"7754","25375","2018",5,5,0,131030,1169.6,103.8
"7755","25376","2018",1,1,0,147000,1441,102
"7756","25377","2018",1,1,0,137700,1377,100
"7757","25378","2018",3,3,0,204666.666666667,1458.33333333333,168
"7758","25379","2018",2,2,0,66000,1026,73
"7759","25380","2018",101,35,66,124275.00990099,3021.15841584158,41.0594059405941
"7760","25381","2018",29,25,4,219049.310344828,1819.58620689655,117.689655172414
"7761","25382","2018",7,6,1,149628.571428571,1658.71428571429,86.8571428571429
"7762","25383","2018",4,4,0,252000,1734,154
"7763","25384","2018",1,1,0,116000,928,125
"7764","25387","2018",2,2,0,208947.5,1752,122.5
"7765","25388","2018",236,64,172,92430.2966101695,1134.46186440678,79.3135593220339
"7766","25389","2018",2,2,0,170750,2063.5,81.5
"7767","25390","2018",5,3,2,194100,2079.8,89.4
"7768","25391","2018",1,1,0,155000,1550,100
"7769","25392","2018",1,1,0,40000,435,92
"7770","25393","2018",3,3,0,64350,589,100.666666666667
"7771","25394","2018",8,8,0,137429.375,1463.125,91.875
"7772","25395","2018",22,18,4,265207.727272727,2212.45454545455,120.681818181818
"7773","25397","2018",34,26,8,196097.941176471,1993.79411764706,100.058823529412
"7774","25398","2018",2,2,0,332475,3140,107
"7775","25400","2018",4,4,0,143825,1339.75,125
"7776","25402","2018",2,2,0,145000,1259.5,110
"7777","25403","2018",25,9,16,227948.96,2598.72,88.16
"7778","25404","2018",2,2,0,195500,1397.5,145
"7779","25405","2018",20,15,5,319532.25,2618.55,117.75
"7780","25406","2018",3,3,0,174953.333333333,1303,134.666666666667
"7781","25410","2018",20,20,0,202471.5,1872.1,108.5
"7782","25411","2018",111,25,86,170491.27027027,2360.18018018018,73.3333333333333
"7783","25413","2018",23,12,11,185357.043478261,2133.91304347826,82.8260869565217
"7784","25414","2018",1,1,0,313500,2023,155
"7785","25415","2018",4,4,0,194250,2136.25,93.75
"7786","25416","2018",1,1,0,40000,667,60
"7787","25417","2018",5,5,0,151476,1446.6,101.8
"7788","25418","2018",15,14,1,185643.666666667,1443.8,123.533333333333
"7789","25419","2018",1,1,0,80000,1000,80
"7790","25420","2018",4,3,1,122445,1453.75,111
"7791","25422","2018",1,1,0,160000,1280,125
"7792","25424","2018",13,13,0,185973.076923077,1741.15384615385,108.307692307692
"7793","25425","2018",11,11,0,304655.454545455,2757,112.545454545455
"7794","25426","2018",4,3,1,153425,1605.5,96
"7795","25428","2018",16,12,4,157043.75,1600.4375,95.6875
"7796","25429","2018",14,13,1,162764.285714286,1754.71428571429,92.8571428571429
"7797","25431","2018",4,4,0,129125,1193,106.25
"7798","25432","2018",16,13,3,180160,2095.5625,92
"7799","25433","2018",1,1,0,124000,2431,51
"7800","25434","2018",60,39,21,136234.316666667,1405.33333333333,93.1666666666667
"7801","25436","2018",3,3,0,164900,1241,138.333333333333
"7802","25437","2018",6,6,0,113527.833333333,1298.5,92.5
"7803","25438","2018",12,12,0,170840.333333333,1665.75,107
"7804","25439","2018",2,2,0,127250,823.5,135
"7805","25440","2018",7,5,2,165758.571428571,1995.57142857143,81.7142857142857
"7806","25442","2018",13,4,9,164646.538461538,1937.69230769231,92.3076923076923
"7807","25443","2018",1,1,0,178000,2373,75
"7808","25445","2018",1,1,0,102000,944,108
"7809","25446","2018",2,2,0,120000,1237,97
"7810","25447","2018",4,4,0,206250,1438.25,150.25
"7811","25448","2018",21,20,1,210460.952380952,1780.61904761905,118.666666666667
"7812","25450","2018",2,2,0,211000,1394.5,178
"7813","25451","2018",5,5,0,238840,1926,122.6
"7814","25453","2018",7,5,2,144000,1527.71428571429,95.4285714285714
"7815","25454","2018",18,13,5,234272.444444444,2544.61111111111,96
"7816","25455","2018",1,1,0,215000,2654,81
"7817","25456","2018",2,2,0,181650,1399.5,126.5
"7818","25457","2018",1,1,0,169000,1707,99
"7819","25458","2018",1,1,0,220000,2000,110
"7820","25460","2018",2,2,0,90700,749,125.5
"7821","25461","2018",3,3,0,109650,1040.33333333333,133
"7822","25462","2018",299,53,246,171306.324414716,2271.28093645485,75.0535117056856
"7823","25463","2018",37,20,17,112301.891891892,1311.21621621622,84.0810810810811
"7824","25464","2018",1,1,0,168000,2049,82
"7825","25465","2018",5,5,0,174762.8,1245.2,129.2
"7826","25466","2018",12,11,1,220586.666666667,2112.41666666667,105.083333333333
"7827","25467","2018",25,21,4,206590,1943.2,104.32
"7828","25468","2018",5,5,0,191912,1490.4,126.8
"7829","25469","2018",7,7,0,118795,1141,103.142857142857
"7830","25473","2018",3,3,0,204300,1954.33333333333,105.333333333333
"7831","25474","2018",1,1,0,208300,1262,165
"7832","25475","2018",12,9,3,158535.916666667,1545.83333333333,110.5
"7833","25477","2018",3,3,0,197000,1555,126
"7834","25478","2018",1,1,0,91500,436,210
"7835","25479","2018",5,5,0,108100,805.4,145.2
"7836","25481","2018",1,1,0,92000,911,101
"7837","25486","2018",4,3,1,273137.5,2346.5,116.25
"7838","25489","2018",1,0,1,75000,682,110
"7839","25490","2018",3,2,1,97833.3333333333,865.666666666667,120.666666666667
"7840","25493","2018",9,8,1,278720,2745.55555555556,103.444444444444
"7841","25494","2018",11,8,3,184509.090909091,2664.72727272727,69.9090909090909
"7842","25495","2018",25,19,6,174454.56,1794.52,97.04
"7843","25496","2018",4,4,0,106245,816,128
"7844","25497","2018",7,7,0,172597.857142857,1509.85714285714,108
"7845","25498","2018",1,1,0,218000,1802,121
"7846","25500","2018",2,2,0,158350,1577.5,110
"7847","25502","2018",4,4,0,142600,1277.5,121.5
"7848","25504","2018",3,2,1,81666.6666666667,1530.33333333333,55
"7849","25505","2018",10,10,0,90515,839,104.4
"7850","25506","2018",1,1,0,80000,1067,75
"7851","25508","2018",9,9,0,184656.666666667,1793.11111111111,107.888888888889
"7852","25510","2018",5,5,0,141000,1286.2,105.8
"7853","25511","2018",2,2,0,154500,1220.5,125
"7854","25512","2018",27,19,8,188141.296296296,1856.55555555556,101.259259259259
"7855","25513","2018",2,2,0,205000,2189.5,85
"7856","25515","2018",5,2,3,184210,2331.8,82
"7857","25516","2018",1,1,0,125000,1582,79
"7858","25517","2018",3,1,2,123226.666666667,1290.66666666667,99
"7859","25518","2018",2,2,0,175000,1731.5,109
"7860","25519","2018",9,9,0,159318,1230.44444444444,129.222222222222
"7861","25520","2018",2,2,0,138550,1564.5,126
"7862","25521","2018",2,2,0,189500,1634,157
"7863","25522","2018",3,3,0,280026.666666667,2351.33333333333,124.333333333333
"7864","25523","2018",3,3,0,135016.666666667,1454,92.3333333333333
"7865","25524","2018",6,6,0,157873.333333333,1180.83333333333,135.166666666667
"7866","25525","2018",5,2,3,215432,3393,72.8
"7867","25526","2018",16,5,11,96599.25,1280.125,76.6875
"7868","25527","2018",51,43,8,174706.549019608,1804.17647058824,99.2156862745098
"7869","25528","2018",1,1,0,187500,1705,110
"7870","25529","2018",10,10,0,152885,1531.7,99.8
"7871","25532","2018",39,26,13,183491.641025641,1923.05128205128,98.5641025641026
"7872","25533","2018",1,1,0,124000,1378,90
"7873","25534","2018",4,4,0,286097.5,2403,123
"7874","25535","2018",4,4,0,219481.25,1581.5,149.25
"7875","25537","2018",2,2,0,149500.5,1499,100.5
"7876","25538","2018",1,1,0,149500,885,169
"7877","25539","2018",57,36,21,132526.350877193,1409.22807017544,92.9824561403509
"7878","25540","2018",3,3,0,158166.666666667,1117.66666666667,141.666666666667
"7879","25541","2018",4,4,0,151804.5,1232.75,119.25
"7880","25542","2018",19,14,5,219818.263157895,2035.78947368421,105.368421052632
"7881","25544","2018",1,1,0,150000,1562,96
"7882","25545","2018",1,1,0,248000,1664,149
"7883","25547","2018",28,9,19,89385.6071428571,1038.25,83.4642857142857
"7884","25548","2018",2,2,0,127000,1259.5,100.5
"7885","25549","2018",2,2,0,189500,2068.5,85
"7886","25550","2018",2,2,0,264550,1638,162.5
"7887","25551","2018",3,3,0,190333.333333333,1665.33333333333,109.666666666667
"7888","25552","2018",1,1,0,96000,980,98
"7889","25553","2018",3,3,0,122666.666666667,911.333333333333,134.333333333333
"7890","25554","2018",1,1,0,50000,625,80
"7891","25555","2018",7,5,2,155685.714285714,1534.71428571429,101
"7892","25557","2018",1,1,0,283000,2246,126
"7893","25558","2018",12,10,2,182001.416666667,1582.91666666667,122.5
"7894","25559","2018",1,1,0,214500,2438,88
"7895","25560","2018",32,25,7,184871.5625,1808.5625,102.75
"7896","25561","2018",4,2,2,169085,1949,84.75
"7897","25562","2018",1,1,0,180000,1395,129
"7898","25564","2018",11,8,3,186508.181818182,1632,115.454545454545
"7899","25565","2018",6,4,2,287478.333333333,2757.83333333333,99.8333333333333
"7900","25566","2018",5,5,0,172600,1796,95.4
"7901","25569","2018",3,3,0,105666.666666667,764.333333333333,137
"7902","25570","2018",2,2,0,106500,732,138.5
"7903","25571","2018",7,5,2,174164.285714286,1585.28571428571,115.857142857143
"7904","25573","2018",1,1,0,240000,1200,200
"7905","25574","2018",2,2,0,157000,1401,114
"7906","25575","2018",7,6,1,166421.428571429,1708.57142857143,90.8571428571429
"7907","25578","2018",55,35,20,170707.163636364,1932.6,97.2181818181818
"7908","25579","2018",1,1,0,85000,1214,70
"7909","25580","2018",91,64,27,122659.252747253,1347.48351648352,91.1098901098901
"7910","25582","2018",1,1,0,70000,824,85
"7911","25586","2018",7,7,0,157220.142857143,1490.71428571429,106.857142857143
"7912","25588","2018",1,1,0,115000,1769,65
"7913","25589","2018",1,1,0,102000,962,106
"7914","25590","2018",2,2,0,124050,1148.5,107
"7915","25591","2018",6,6,0,69171.1666666667,1014.83333333333,87
"7916","25592","2018",11,6,5,145904.363636364,1729.81818181818,91.6363636363636
"7917","25594","2018",4,4,0,149100,1658.25,103.25
"7918","25595","2018",2,2,0,90500,924.5,99
"7919","25597","2018",1,1,0,157390,1606,98
"7920","25598","2018",6,6,0,193933.333333333,1965.5,101.333333333333
"7921","25599","2018",3,3,0,179235.666666667,1192,139.333333333333
"7922","25600","2018",1,1,0,57950,460,126
"7923","25601","2018",7,6,1,147824.285714286,1508.85714285714,108.714285714286
"7924","25602","2018",1,1,0,75000,789,95
"7925","25604","2018",1,1,0,115000,1211,95
"7926","25605","2018",2,2,0,120500,938.5,126
"7927","25607","2018",1,1,0,141000,1156,122
"7928","25608","2018",2,2,0,164750,1766.5,94.5
"7929","25609","2018",8,8,0,286590,2699.875,110.375
"7930","25611","2018",3,1,2,188166.666666667,1950,98.3333333333333
"7931","25612","2018",6,4,2,189177.833333333,1821.66666666667,96.6666666666667
"7932","25613","2018",2,2,0,52000,620,87.5
"7933","25614","2018",26,16,10,114946.538461538,1320.5,91.1923076923077
"7934","25615","2018",3,3,0,97000,998,96
"7935","25616","2018",3,3,0,158083.333333333,1677.66666666667,88
"7936","25617","2018",3,3,0,143333.333333333,1105,169.333333333333
"7937","25618","2018",2,2,0,121750,1205.5,105.5
"7938","25619","2018",3,2,1,215550,3163,62.3333333333333
"7939","25620","2018",1,1,0,320000,3441,93
"7940","25621","2018",2,2,0,121325,1308,100
"7941","25622","2018",2,2,0,116750,1440,91.5
"7942","25623","2018",1,1,0,98000,1126,87
"7943","25625","2018",1,1,0,67500,1144,59
"7944","25627","2018",4,4,0,174300,1325.5,137.5
"7945","25629","2018",3,3,0,125200,1365.66666666667,92.6666666666667
"7946","25631","2018",4,4,0,169775,1657.5,102.75
"7947","25632","2018",38,24,14,130423.421052632,1483.76315789474,88.3421052631579
"7948","25633","2018",13,13,0,127596.307692308,1202.76923076923,106
"7949","25634","2018",3,2,1,189500,1997.66666666667,92.6666666666667
"7950","25635","2018",1,1,0,174000,1225,142
"7951","26002","2018",11,9,2,164295.454545455,1581.18181818182,110.727272727273
"7952","26003","2018",1,1,0,243650,1846,132
"7953","26004","2018",32,30,2,204424.71875,1806.09375,113.21875
"7954","26005","2018",22,22,0,310526.363636364,2285.54545454545,140.409090909091
"7955","26006","2018",27,24,3,193229.814814815,1805.37037037037,110.592592592593
"7956","26007","2018",1,1,0,367223,3060,120
"7957","26008","2018",17,16,1,166197.058823529,1821.70588235294,90.1764705882353
"7958","26009","2018",13,13,0,165665.384615385,1793.15384615385,94
"7959","26010","2018",41,33,8,154363.975609756,1755.19512195122,98
"7960","26011","2018",31,29,2,187502.419354839,2069.38709677419,92.9677419354839
"7961","26013","2018",1,1,0,135000,2647,51
"7962","26016","2018",3,3,0,192783.666666667,2131.33333333333,90.6666666666667
"7963","26019","2018",4,3,1,207470,1850.25,105.5
"7964","26020","2018",4,4,0,200250,1881.75,127.5
"7965","26021","2018",1,1,0,330000,2444,135
"7966","26023","2018",17,17,0,131319.705882353,1378.82352941176,93.0588235294118
"7967","26024","2018",2,2,0,170000,2087,81
"7968","26025","2018",6,6,0,133538.333333333,1282.16666666667,82.5
"7969","26026","2018",2,2,0,254750,1837.5,131.5
"7970","26028","2018",1,1,0,177000,1883,94
"7971","26031","2018",12,11,1,254421.166666667,2098.16666666667,129.75
"7972","26032","2018",3,3,0,371733.333333333,3663.66666666667,101.666666666667
"7973","26033","2018",9,9,0,210116.111111111,1683.22222222222,124
"7974","26034","2018",7,6,1,160000,1436.57142857143,109.857142857143
"7975","26035","2018",6,6,0,155083.333333333,1793.66666666667,93.5
"7976","26036","2018",4,4,0,114000,1149,100
"7977","26037","2018",53,53,0,236613.981132075,2269.84905660377,105.660377358491
"7978","26038","2018",8,8,0,230041.5,2126.375,110.875
"7979","26039","2018",14,13,1,215680.714285714,1986.07142857143,114.285714285714
"7980","26040","2018",2,2,0,68500,926.5,74
"7981","26041","2018",14,14,0,203187.428571429,1881.35714285714,107.857142857143
"7982","26042","2018",11,10,1,224576.727272727,2163.45454545455,101.454545454545
"7983","26043","2018",1,1,0,350000,2147,163
"7984","26045","2018",19,17,2,276476.210526316,2106.63157894737,142.789473684211
"7985","26046","2018",2,2,0,105000,2447,44.5
"7986","26048","2018",1,1,0,250000,1250,200
"7987","26049","2018",13,13,0,193273.076923077,1982.38461538462,102.923076923077
"7988","26050","2018",2,2,0,273450,2262.5,129
"7989","26052","2018",7,7,0,194180,2106.85714285714,92.7142857142857
"7990","26054","2018",15,13,2,263830.666666667,2167.86666666667,120.533333333333
"7991","26055","2018",2,1,1,44750,509,87
"7992","26056","2018",2,2,0,232875,923,217.5
"7993","26057","2018",143,78,65,142174.706293706,1715.76923076923,83.3496503496503
"7994","26058","2018",306,116,190,142559.532679739,1754.39869281046,80.8104575163399
"7995","26059","2018",4,4,0,117482.5,2432.75,58.75
"7996","26060","2018",3,3,0,142333.333333333,1094.66666666667,130
"7997","26061","2018",2,2,0,147200,1461.5,101
"7998","26063","2018",40,37,3,181595.75,2109.8,84.7
"7999","26064","2018",81,70,11,221291.172839506,2404.79012345679,96.320987654321
"8000","26065","2018",6,6,0,257664.166666667,2292.33333333333,110
"8001","26066","2018",2,2,0,149500,1661,90
"8002","26067","2018",1,1,0,565000,2825,200
"8003","26068","2018",1,1,0,379150,2154,176
"8004","26069","2018",3,3,0,162366.666666667,1534,104.333333333333
"8005","26070","2018",6,6,0,101145,1593.83333333333,91.8333333333333
"8006","26071","2018",10,10,0,208107,2142.6,89.8
"8007","26072","2018",16,16,0,188290.625,1757.25,105.3125
"8008","26073","2018",10,7,3,236450,1909.5,117.7
"8009","26074","2018",7,5,2,127978.571428571,1409.14285714286,92.4285714285714
"8010","26077","2018",14,14,0,219398.571428571,1661.71428571429,132.571428571429
"8011","26078","2018",12,12,0,242409.333333333,1856.75,136.166666666667
"8012","26079","2018",13,13,0,234016.153846154,1776.46153846154,132.538461538462
"8013","26081","2018",3,3,0,214166.666666667,2071,138.333333333333
"8014","26082","2018",2,2,0,100312.5,1332,104
"8015","26083","2018",17,14,3,204661.352941176,1929.94117647059,102.705882352941
"8016","26084","2018",44,40,4,210165,2222.15909090909,113.227272727273
"8017","26085","2018",24,21,3,210645.875,1778.625,110.125
"8018","26086","2018",11,10,1,120330.272727273,1500.63636363636,82.9090909090909
"8019","26087","2018",10,9,1,164585,1871.8,93.8
"8020","26088","2018",75,70,5,177094.386666667,1689.13333333333,105.8
"8021","26089","2018",2,2,0,200250,2186.5,86.5
"8022","26090","2018",1,1,0,35000,1000,35
"8023","26092","2018",5,5,0,231600,1662.4,135.4
"8024","26094","2018",7,7,0,205978.428571429,1892.71428571429,108.857142857143
"8025","26095","2018",11,10,1,183157.272727273,2040.90909090909,95.2727272727273
"8026","26096","2018",24,22,2,194422.25,1865.70833333333,101.75
"8027","26097","2018",8,8,0,299234.625,2762.125,113.375
"8028","26098","2018",2,2,0,380325,2542.5,158
"8029","26099","2018",6,6,0,324231.666666667,2453.83333333333,128.5
"8030","26100","2018",7,7,0,209295.428571429,2078,99.7142857142857
"8031","26101","2018",2,2,0,331500,1763.5,170
"8032","26103","2018",7,7,0,199714.285714286,2147.85714285714,93.2857142857143
"8033","26105","2018",1,0,1,90000,1385,65
"8034","26106","2018",19,17,2,166033.684210526,1579.84210526316,104.789473684211
"8035","26107","2018",4,4,0,214475,1740.25,121
"8036","26108","2018",94,54,40,166915.021276596,1882.8829787234,87.8085106382979
"8037","26110","2018",6,6,0,217516.666666667,2135.33333333333,104.166666666667
"8038","26112","2018",2,2,0,60250,1234,50
"8039","26113","2018",65,48,17,183927.815384615,1948.66153846154,94.1692307692308
"8040","26114","2018",55,43,12,202017.4,2154.65454545455,96.0727272727273
"8041","26115","2018",3,3,0,267453.333333333,2394.66666666667,131.333333333333
"8042","26116","2018",68,56,12,152684.117647059,1802.58823529412,85.7205882352941
"8043","26118","2018",17,17,0,179264.176470588,1374.35294117647,134.764705882353
"8044","26119","2018",9,8,1,125638.888888889,1234.11111111111,104
"8045","26121","2018",9,8,1,254297.777777778,2047.77777777778,123.444444444444
"8046","26122","2018",2,2,0,162575,2932,90
"8047","26123","2018",2,2,0,165550,2256,75
"8048","26124","2018",45,40,5,220688.955555556,2280.77777777778,98.6
"8049","26125","2018",16,16,0,279408.75,2180.625,123.9375
"8050","26127","2018",2,2,0,183700,2248,82
"8051","26128","2018",2,2,0,277625,1637.5,179
"8052","26129","2018",16,16,0,197847.25,1580.875,125.875
"8053","26131","2018",8,8,0,190925,1791.875,108.625
"8054","26133","2018",4,4,0,181250,1204.75,150.25
"8055","26134","2018",2,2,0,327425,1409,237
"8056","26135","2018",2,2,0,103500,1283,81
"8057","26137","2018",4,4,0,168062.5,3131,66.25
"8058","26138","2018",12,11,1,224433.833333333,2192.16666666667,104.416666666667
"8059","26139","2018",27,23,4,212689.222222222,1992.14814814815,106.703703703704
"8060","26140","2018",2,2,0,175000,1520.5,111.5
"8061","26141","2018",3,3,0,223333.333333333,1450.33333333333,153.333333333333
"8062","26142","2018",1,1,0,122000,762,160
"8063","26143","2018",3,3,0,185521,1546,132.333333333333
"8064","26144","2018",24,21,3,196945.416666667,2043.70833333333,105.166666666667
"8065","26145","2018",6,6,0,241750,1898.16666666667,126.166666666667
"8066","26146","2018",26,24,2,308508.269230769,3119.03846153846,95.7307692307692
"8067","26148","2018",20,20,0,186101.7,1767.3,113.4
"8068","26149","2018",8,7,1,202548.75,2069.5,103.875
"8069","26150","2018",1,1,0,65000,1444,45
"8070","26153","2018",1,1,0,180000,2308,78
"8071","26154","2018",3,3,0,1e+05,886.333333333333,135
"8072","26155","2018",18,14,4,164658.333333333,1609.5,103.444444444444
"8073","26156","2018",11,9,2,166095.454545455,2276,92.2727272727273
"8074","26157","2018",7,7,0,217014.285714286,1844.14285714286,121.714285714286
"8075","26159","2018",3,3,0,128800,1845.66666666667,60
"8076","26160","2018",16,11,5,133156.25,1414.5625,95
"8077","26161","2018",2,1,1,72500,1751,46.5
"8078","26162","2018",11,11,0,144909.090909091,1553.18181818182,100.818181818182
"8079","26163","2018",1,1,0,4e+05,3200,125
"8080","26164","2018",1,1,0,1e+05,800,125
"8081","26165","2018",108,79,29,163855.648148148,1895.76851851852,87.1481481481482
"8082","26166","2018",63,56,7,181829.206349206,1818.88888888889,101.111111111111
"8083","26167","2018",10,10,0,166925,1395.2,115.1
"8084","26168","2018",16,13,3,139465.625,1838.625,76.5625
"8085","26169","2018",18,18,0,217524.222222222,2134.44444444444,103.055555555556
"8086","26170","2018",25,23,2,260566.8,2268.48,117.72
"8087","26171","2018",7,7,0,181511.428571429,1842.85714285714,96.8571428571429
"8088","26172","2018",8,8,0,160425,1564.125,106.5
"8089","26173","2018",10,10,0,213697.2,1909.9,117.6
"8090","26174","2018",9,9,0,194219.555555556,2006,96.7777777777778
"8091","26175","2018",1,1,0,309850,2245,138
"8092","26176","2018",18,17,1,299985.055555556,2615.72222222222,117.333333333333
"8093","26177","2018",10,10,0,287485,2508.3,114.9
"8094","26178","2018",9,9,0,190588.888888889,2078.11111111111,96
"8095","26179","2018",22,22,0,229868.636363636,1813.59090909091,135.772727272727
"8096","26180","2018",2,2,0,294100,2630,107
"8097","26181","2018",3,3,0,91666.6666666667,1882.66666666667,51.6666666666667
"8098","26182","2018",24,22,2,197493.75,2403.41666666667,88.375
"8099","26183","2018",15,15,0,266200,2290.26666666667,117.466666666667
"8100","26185","2018",8,8,0,359778.75,2864.25,129.875
"8101","26188","2018",21,18,3,231820,2427.33333333333,99.6190476190476
"8102","26191","2018",36,30,6,267277.083333333,2335.33333333333,112.805555555556
"8103","26192","2018",1,1,0,365000,6083,60
"8104","26193","2018",16,8,8,177285.4375,2131.0625,77.875
"8105","26194","2018",7,7,0,193914.285714286,1793.14285714286,105.857142857143
"8106","26195","2018",3,3,0,335166.666666667,3069.66666666667,107.333333333333
"8107","26196","2018",10,9,1,252465,2184.2,113.7
"8108","26197","2018",49,45,4,264831.326530612,2698.83673469388,105.938775510204
"8109","26198","2018",620,295,325,156840.272580645,1780.91774193548,85.7032258064516
"8110","26199","2018",1,1,0,130000,1275,102
"8111","26200","2018",1,1,0,145370,1991,73
"8112","26201","2018",1,1,0,225000,3082,73
"8113","26202","2018",4,4,0,189750,1664.75,103.25
"8114","26203","2018",2,2,0,256435,2205,119
"8115","26204","2018",2,2,0,232500,1533.5,158.5
"8116","26206","2018",20,19,1,208510,1884.5,110.5
"8117","26207","2018",4,4,0,148850,1297,117.5
"8118","26208","2018",24,23,1,262853.333333333,2510.5,104.833333333333
"8119","26210","2018",15,14,1,176906.666666667,1758.73333333333,105
"8120","26211","2018",18,13,5,241111.111111111,2050.33333333333,113.611111111111
"8121","26212","2018",10,7,3,163830,1760.6,93
"8122","26213","2018",10,10,0,147072.8,1583.4,104.5
"8123","26215","2018",7,7,0,144642.857142857,1548.28571428571,85
"8124","26216","2018",11,10,1,167254.545454545,1605.90909090909,106.181818181818
"8125","26217","2018",4,4,0,328725,2061.5,150.5
"8126","26218","2018",27,24,3,209306.333333333,1962.22222222222,108.333333333333
"8127","26220","2018",111,51,60,177510.342342342,2219.45945945946,78.8378378378378
"8128","26221","2018",1,1,0,110000,2000,55
"8129","26222","2018",2,2,0,123100,1906.5,65.5
"8130","26223","2018",2,2,0,156075,1326.5,116
"8131","26224","2018",1,1,0,160000,2388,67
"8132","26225","2018",4,4,0,192500,2203.25,93.75
"8133","26226","2018",5,5,0,145700,2159.4,71
"8134","26229","2018",1,1,0,110000,1375,80
"8135","26231","2018",34,33,1,237334.264705882,2028.91176470588,121.029411764706
"8136","26232","2018",2,2,0,208000,2226.5,93
"8137","26233","2018",1,1,0,640000,6400,100
"8138","26234","2018",9,8,1,216574.444444444,2023.55555555556,108.444444444444
"8139","26235","2018",148,109,39,154481.743243243,1706.32432432432,91.9324324324324
"8140","26236","2018",1,1,0,2e+05,2247,89
"8141","26238","2018",10,9,1,151668,1510.8,99
"8142","26239","2018",8,8,0,400450,3187.375,135
"8143","26240","2018",2,2,0,179029.5,1226,158.5
"8144","26241","2018",3,3,0,358900.666666667,1844.66666666667,167.666666666667
"8145","26243","2018",16,13,3,223069.0625,2173.6875,95.125
"8146","26244","2018",3,3,0,142666.666666667,1461,95.3333333333333
"8147","26246","2018",1,1,0,440200,1667,264
"8148","26247","2018",7,6,1,190114.285714286,2006.28571428571,94
"8149","26248","2018",2,2,0,172500,1894.5,76.5
"8150","26249","2018",9,8,1,196538.888888889,2018.33333333333,98.7777777777778
"8151","26250","2018",46,39,7,187006,2002.65217391304,95.2608695652174
"8152","26251","2018",7,7,0,194428.571428571,2111.57142857143,101.714285714286
"8153","26252","2018",149,87,62,167925.845637584,1998.77181208054,84.8187919463087
"8154","26253","2018",5,5,0,173210,2388.4,70.2
"8155","26254","2018",1,1,0,42000,553,76
"8156","26256","2018",2,2,0,92500,1057.5,88
"8157","26257","2018",3,3,0,279263.333333333,2340.33333333333,111.333333333333
"8158","26258","2018",18,16,2,224137.777777778,1964.27777777778,110.833333333333
"8159","26259","2018",3,3,0,349638.666666667,2323,158.666666666667
"8160","26261","2018",11,11,0,226033.636363636,2230.81818181818,105.454545454545
"8161","26262","2018",2,2,0,175740,1438.5,115
"8162","26263","2018",6,4,2,170273.333333333,2712.66666666667,59.8333333333333
"8163","26264","2018",2,2,0,109000,1119,95
"8164","26266","2018",1,1,0,58000,1055,55
"8165","26267","2018",1,1,0,350000,7292,48
"8166","26268","2018",1,1,0,145000,1812,80
"8167","26269","2018",1,1,0,188000,2212,85
"8168","26270","2018",1,1,0,310000,2650,117
"8169","26271","2018",23,22,1,211681.47826087,2224,96.695652173913
"8170","26272","2018",6,6,0,280833.333333333,1810.66666666667,166
"8171","26273","2018",5,5,0,184356,1832.2,106.4
"8172","26275","2018",26,25,1,256801.153846154,2309.84615384615,116.346153846154
"8173","26276","2018",8,8,0,237275,1617,142
"8174","26277","2018",1,1,0,230700,1876,123
"8175","26278","2018",4,4,0,242950,2242.75,103.5
"8176","26279","2018",1,1,0,194200,1962,99
"8177","26281","2018",503,208,295,129659.441351889,1556.29622266402,81.8290258449304
"8178","26282","2018",4,3,1,134125,1456.75,87.25
"8179","26284","2018",6,6,0,202950,2382.66666666667,91.8333333333333
"8180","26285","2018",4,4,0,239187.5,1782.25,120.25
"8181","26287","2018",4,4,0,177262.5,2154.25,83.25
"8182","26288","2018",2,2,0,169000,2544,66.5
"8183","26289","2018",23,22,1,171149.086956522,2060.17391304348,81.9565217391304
"8184","26290","2018",16,10,6,120463.75,1756.3125,67.4375
"8185","26291","2018",3,2,1,98100,1411.66666666667,70.3333333333333
"8186","26292","2018",1,1,0,128430,1566,82
"8187","26293","2018",2,2,0,171350,1268,126.5
"8188","26294","2018",9,9,0,234500,1926.44444444444,115.111111111111
"8189","26295","2018",21,21,0,164823.428571429,1708.90476190476,100
"8190","26296","2018",1,1,0,346600,3984,87
"8191","26298","2018",4,4,0,74487.5,766,99.5
"8192","26299","2018",2,2,0,85000,941,97
"8193","26300","2018",2,2,0,81000,884,91.5
"8194","26301","2018",45,36,9,156732.666666667,1708.15555555556,94
"8195","26302","2018",5,4,1,171930,1398,115.4
"8196","26303","2018",1,1,0,57000,1326,43
"8197","26305","2018",9,9,0,197666.666666667,1598,132
"8198","26306","2018",3,3,0,333116.666666667,2317.33333333333,144
"8199","26307","2018",32,28,4,166558.25,1599.25,100.8125
"8200","26309","2018",3,3,0,192666.666666667,1678.33333333333,108.666666666667
"8201","26310","2018",3,3,0,245816.666666667,1758.33333333333,139.666666666667
"8202","26311","2018",13,11,2,167084.615384615,1470.84615384615,113.692307692308
"8203","26312","2018",15,15,0,240336.266666667,2220.33333333333,108.2
"8204","26313","2018",51,46,5,232641.941176471,2129,111.058823529412
"8205","26314","2018",3,3,0,291380,2472.66666666667,119.333333333333
"8206","26315","2018",4,3,1,167825,2118.25,100.75
"8207","26316","2018",4,4,0,137850,1527.75,91.75
"8208","26317","2018",6,6,0,157166.666666667,1809,87.8333333333333
"8209","26319","2018",5,4,1,154530,1570.8,101.4
"8210","26320","2018",9,7,2,152124.444444444,1536.33333333333,99.5555555555556
"8211","26321","2018",5,5,0,69350,1052.2,75.2
"8212","26322","2018",9,6,3,170666.666666667,2050,83.1111111111111
"8213","26323","2018",22,20,2,222394.772727273,2052.09090909091,113.636363636364
"8214","26324","2018",101,61,40,169976.643564356,1886.79207920792,90.6930693069307
"8215","26325","2018",74,67,7,153491.216216216,1658.78378378378,94.1891891891892
"8216","26326","2018",12,12,0,358298.333333333,2732.75,130.583333333333
"8217","26327","2018",5,5,0,141100,1766.8,77.2
"8218","26329","2018",2,2,0,180000,2206,77.5
"8219","26330","2018",26,26,0,189721.153846154,1820.73076923077,110.038461538462
"8220","26331","2018",1,1,0,265000,1853,143
"8221","26332","2018",29,27,2,151704.310344828,1600.27586206897,95.1034482758621
"8222","26333","2018",56,20,36,86566.875,1124.14285714286,79.0714285714286
"8223","26334","2018",3,3,0,397616.666666667,2659,150.333333333333
"8224","26335","2018",5,5,0,163100,2539.4,62.8
"8225","26336","2018",10,9,1,246014,2164.6,110.4
"8226","26337","2018",19,14,5,153691.052631579,1882.63157894737,80.0526315789474
"8227","26338","2018",20,19,1,257995.4,2359.6,110.2
"8228","26339","2018",14,14,0,251211.642857143,2026.07142857143,123.857142857143
"8229","26340","2018",2,2,0,125950,1554,83
"8230","26341","2018",9,8,1,136138.888888889,1382.88888888889,99.2222222222222
"8231","26342","2018",3,3,0,375733.333333333,2492.33333333333,147.333333333333
"8232","26343","2018",2,2,0,157000,1981.5,79.5
"8233","26344","2018",5,5,0,267020,3723.8,78.8
"8234","26345","2018",27,24,3,222372.555555556,2091.25925925926,102.851851851852
"8235","26346","2018",4,1,3,162500,1256,131.25
"8236","26347","2018",67,25,42,140166.865671642,1746.61194029851,80.089552238806
"8237","26348","2018",22,21,1,228376.454545455,2103.27272727273,98.4090909090909
"8238","26349","2018",4,4,0,158912.5,1589,99.25
"8239","26350","2018",1,1,0,78000,1040,75
"8240","26351","2018",1,1,0,335000,3722,90
"8241","26352","2018",2,2,0,233500,2504.5,105
"8242","26353","2018",19,17,2,152097.894736842,1734.42105263158,89.3684210526316
"8243","26355","2018",1,1,0,264100,2201,120
"8244","26356","2018",2,2,0,189500,2004.5,100
"8245","26357","2018",15,13,2,205416.666666667,1988.53333333333,101.466666666667
"8246","26358","2018",13,13,0,231673.846153846,2101.46153846154,116.153846153846
"8247","26360","2018",8,8,0,250625,2535.75,113.75
"8248","26362","2018",1054,229,825,136786.882352941,1866.93738140417,73.4829222011385
"8249","26364","2018",6,4,2,146753.166666667,1683.33333333333,105.5
"8250","26365","2018",7,7,0,219205.714285714,2031.28571428571,107.857142857143
"8251","26367","2018",7,7,0,306207.142857143,2664.28571428571,117
"8252","26368","2018",3,3,0,165456.666666667,2318,112.333333333333
"8253","26370","2018",4,4,0,231250,3117,79
"8254","26371","2018",2,2,0,202085,1634,133.5
"8255","26373","2018",6,5,1,130772.5,1713,87
"8256","26374","2018",1,1,0,110000,1222,90
"8257","26376","2018",2,2,0,106500,2535,49.5
"8258","26377","2018",17,16,1,261461.882352941,2594.70588235294,100.588235294118
"8259","26379","2018",7,6,1,200045.714285714,2417,84.4285714285714
"8260","26380","2018",3,3,0,151666.666666667,1740,84.3333333333333
"8261","26381","2018",11,11,0,223427.272727273,1842.81818181818,120.818181818182
"8262","26382","2018",4,4,0,242000,2608.5,95
"8263","27001","2018",1,1,0,174000,1450,120
"8264","27002","2018",6,6,0,133675,1445,103.666666666667
"8265","27003","2018",17,17,0,186463.529411765,1751.11764705882,110.588235294118
"8266","27004","2018",3,3,0,160333.333333333,1695.66666666667,96
"8267","27005","2018",13,13,0,139076.923076923,1597.61538461538,92.8461538461538
"8268","27006","2018",1,1,0,677000,5015,135
"8269","27008","2018",10,10,0,179823.2,1885.8,95.8
"8270","27009","2018",5,5,0,147933.4,1175.4,123
"8271","27010","2018",1,1,0,163000,916,178
"8272","27011","2018",19,19,0,154777.894736842,1677.52631578947,94.2105263157895
"8273","27012","2018",5,5,0,143370,1508,101.2
"8274","27013","2018",5,5,0,128100,1405.8,101.4
"8275","27014","2018",10,10,0,183242.3,1773.7,107.5
"8276","27015","2018",24,24,0,151031.458333333,1548.58333333333,99.625
"8277","27016","2018",75,66,9,134691.666666667,1696.26666666667,82.0533333333333
"8278","27017","2018",9,9,0,155174.444444444,1627.88888888889,95
"8279","27018","2018",8,8,0,152160,1614.125,96.625
"8280","27019","2018",5,5,0,116800,1543,97
"8281","27020","2018",14,14,0,158111.785714286,1402,111.642857142857
"8282","27021","2018",2,2,0,141000,1454,98.5
"8283","27022","2018",50,49,1,169967.06,1665.54,106.28
"8284","27023","2018",10,10,0,150500,1771.9,89.9
"8285","27025","2018",11,11,0,172754.363636364,1720.72727272727,100
"8286","27026","2018",3,2,1,165546.666666667,2084,90
"8287","27027","2018",4,4,0,233850,3266.25,85
"8288","27028","2018",4,4,0,128237.5,1229.75,109
"8289","27031","2018",15,15,0,175886.933333333,1903.86666666667,95.4666666666667
"8290","27032","2018",16,16,0,157796.875,1717.4375,94.5
"8291","27033","2018",5,5,0,132300,1542.2,88.6
"8292","27034","2018",8,8,0,127489.5,1529.75,87.375
"8293","27035","2018",4,4,0,221250,1726.75,122.5
"8294","27036","2018",4,4,0,129000,1402,89.5
"8295","27037","2018",13,13,0,140665.384615385,1399.76923076923,99.1538461538462
"8296","27038","2018",4,4,0,224750,2367.5,102.5
"8297","27039","2018",6,6,0,99083.3333333333,1278.66666666667,84.8333333333333
"8298","27040","2018",7,7,0,127785.714285714,1246.71428571429,102.428571428571
"8299","27042","2018",1,1,0,184500,1337,138
"8300","27043","2018",17,17,0,121705.882352941,1399.05882352941,86.4117647058823
"8301","27044","2018",7,7,0,180714.285714286,1521,118.857142857143
"8302","27045","2018",13,13,0,187461.538461538,1699.46153846154,113.307692307692
"8303","27047","2018",2,2,0,150000,1387,112.5
"8304","27048","2018",4,4,0,152500,2230.25,75
"8305","27049","2018",80,80,0,123486.725,1305.9375,97.3875
"8306","27050","2018",9,9,0,130278.333333333,1329.77777777778,113.333333333333
"8307","27051","2018",32,32,0,116634.375,1407.71875,88.0625
"8308","27052","2018",9,9,0,157580,1324.66666666667,125.666666666667
"8309","27053","2018",2,2,0,151000,1553,96.5
"8310","27054","2018",4,4,0,146250,1635.5,98.25
"8311","27055","2018",3,3,0,132333.333333333,1745.33333333333,80.6666666666667
"8312","27056","2018",126,99,27,139685.325396825,1604.21428571429,87.3888888888889
"8313","27057","2018",2,2,0,159500,2103,75.5
"8314","27058","2018",25,24,1,176748.6,1706.4,109.68
"8315","27059","2018",3,3,0,102833.333333333,1426.33333333333,72.3333333333333
"8316","27061","2018",4,4,0,176125,1326.25,132.5
"8317","27062","2018",12,12,0,203175,1910.75,111
"8318","27063","2018",4,4,0,119675,1599.5,77.25
"8319","27064","2018",12,12,0,152777.5,1797.5,90.8333333333333
"8320","27065","2018",61,44,17,156772.950819672,1782.81967213115,88.3770491803279
"8321","27066","2018",6,6,0,132333.333333333,1622.33333333333,90.3333333333333
"8322","27067","2018",17,16,1,185024.705882353,1962.88235294118,97.8823529411765
"8323","27068","2018",2,2,0,117500,1132.5,104
"8324","27069","2018",12,12,0,121041.666666667,1300.41666666667,92.9166666666667
"8325","27070","2018",21,21,0,161380.476190476,1722.14285714286,97.9523809523809
"8326","27071","2018",3,3,0,178696.666666667,1537,124.333333333333
"8327","27072","2018",4,4,0,259541.5,1865.5,150.75
"8328","27073","2018",24,24,0,191150,2057.5,96.6666666666667
"8329","27074","2018",2,2,0,191250,1326.5,144
"8330","27075","2018",3,3,0,111710,1383.66666666667,91.6666666666667
"8331","27076","2018",1,1,0,281000,2007,140
"8332","27077","2018",11,11,0,157590.909090909,1643,97.6363636363636
"8333","27078","2018",4,4,0,163200,1652,109.75
"8334","27079","2018",4,4,0,128250,1214.75,106.75
"8335","27081","2018",1,1,0,179000,2057,87
"8336","27082","2018",26,25,1,133219.230769231,1675.46153846154,82.2692307692308
"8337","27083","2018",4,4,0,169875,1405.25,128.25
"8338","27085","2018",17,17,0,173138.823529412,1797.70588235294,105.588235294118
"8339","27089","2018",18,18,0,183234.444444444,1979.72222222222,97.3888888888889
"8340","27090","2018",36,36,0,174256.944444444,2012.58333333333,99.9444444444444
"8341","27091","2018",13,13,0,195703.846153846,1874.76923076923,105.769230769231
"8342","27095","2018",7,7,0,137000,1513.57142857143,90.5714285714286
"8343","27096","2018",5,5,0,126400,1304,105.4
"8344","27097","2018",4,4,0,163125,1791.25,94.5
"8345","27099","2018",6,6,0,195328.833333333,1712.66666666667,114.5
"8346","27100","2018",17,10,7,188552.294117647,1936.29411764706,95.3529411764706
"8347","27101","2018",7,7,0,159817.142857143,1643.14285714286,94
"8348","27102","2018",12,12,0,212612.5,1800.75,121.583333333333
"8349","27103","2018",41,41,0,180791.951219512,1795.43902439024,102.390243902439
"8350","27104","2018",8,8,0,172081.25,1496.625,117.75
"8351","27105","2018",34,33,1,176053.088235294,1697.55882352941,103.5
"8352","27106","2018",5,5,0,127000,1638.8,88.4
"8353","27107","2018",7,7,0,163228.571428571,1614,100.857142857143
"8354","27108","2018",18,18,0,113744.333333333,1377.66666666667,92
"8355","27109","2018",4,4,0,115125,1190.75,89.25
"8356","27110","2018",9,9,0,138727.777777778,1611.77777777778,93
"8357","27111","2018",2,2,0,312500,1496,187.5
"8358","27112","2018",50,50,0,113769.2,1387.54,88.94
"8359","27113","2018",1,1,0,137000,993,138
"8360","27114","2018",19,19,0,218216.315789474,1763.78947368421,125.421052631579
"8361","27115","2018",3,3,0,204666.666666667,1779,123
"8362","27116","2018",51,48,3,124210.843137255,1487.82352941176,85.9019607843137
"8363","27117","2018",17,17,0,137627.882352941,1251.76470588235,116
"8364","27118","2018",11,11,0,144836.363636364,1634.54545454545,90.4545454545455
"8365","27119","2018",16,16,0,185062.5,1892.875,103.5
"8366","27120","2018",3,3,0,115500,1325.33333333333,87.3333333333333
"8367","27123","2018",3,3,0,200666.666666667,2097,98.3333333333333
"8368","27124","2018",1,1,0,120000,1935,62
"8369","27125","2018",7,7,0,120471.428571429,1328.57142857143,89.7142857142857
"8370","27126","2018",16,16,0,151756.25,1534.3125,105.1875
"8371","27127","2018",6,6,0,171750,1852.83333333333,100.5
"8372","27129","2018",8,8,0,108425,1345.875,82.875
"8373","27130","2018",5,5,0,152800,1360.4,114.6
"8374","27132","2018",8,8,0,159100,1498.375,103.375
"8375","27133","2018",15,15,0,172812.666666667,1704.4,107.066666666667
"8376","27134","2018",2,2,0,101000,1250.5,77.5
"8377","27135","2018",5,5,0,139000,1251.8,110.2
"8378","27136","2018",2,2,0,276975,1804.5,152
"8379","27137","2018",2,2,0,174000,2262.5,78
"8380","27138","2018",7,7,0,128500,1196.71428571429,104.571428571429
"8381","27139","2018",1,1,0,105500,1172,90
"8382","27140","2018",7,7,0,209214.285714286,2085.28571428571,96.8571428571429
"8383","27141","2018",2,2,0,128900,1439.5,91
"8384","27142","2018",1,1,0,155000,1890,82
"8385","27144","2018",3,3,0,142000,2382,68.3333333333333
"8386","27146","2018",3,3,0,163933.333333333,1496.66666666667,109.333333333333
"8387","27147","2018",6,6,0,195913.333333333,2031.5,101.666666666667
"8388","27148","2018",5,5,0,105696.8,1286.6,88
"8389","27149","2018",4,4,0,156250,1685.75,99
"8390","27151","2018",16,16,0,133564.9375,1473.75,90.125
"8391","27152","2018",9,4,5,128347.222222222,1597.11111111111,87.2222222222222
"8392","27153","2018",3,3,0,119000,1654.33333333333,71
"8393","27154","2018",8,8,0,142850,1839.5,77.625
"8394","27155","2018",1,1,0,40000,889,45
"8395","27156","2018",3,3,0,142333.333333333,1468,86.6666666666667
"8396","27157","2018",18,18,0,146773.333333333,1503.72222222222,105.111111111111
"8397","27158","2018",3,3,0,203000,1915,105.333333333333
"8398","27161","2018",9,9,0,194274.111111111,2132.11111111111,101
"8399","27162","2018",2,2,0,103750,1031,96.5
"8400","27163","2018",1,1,0,215000,2150,100
"8401","27164","2018",15,15,0,133315.066666667,1333.66666666667,100.866666666667
"8402","27165","2018",38,36,2,121522.815789474,1589.34210526316,82.1052631578947
"8403","27167","2018",7,7,0,173725.714285714,2293.14285714286,79.5714285714286
"8404","27168","2018",2,2,0,194750,2473.5,91.5
"8405","27169","2018",15,15,0,157026.666666667,1695.73333333333,94.1333333333333
"8406","27170","2018",23,22,1,135745.217391304,1464.04347826087,89.4347826086957
"8407","27171","2018",7,7,0,211828.571428571,2004.14285714286,110
"8408","27173","2018",2,2,0,139000,1669,82.5
"8409","27174","2018",14,14,0,141550,1646,87.2857142857143
"8410","27176","2018",1,1,0,210000,2333,90
"8411","27177","2018",11,11,0,146014.545454545,1418.63636363636,107.727272727273
"8412","27179","2018",10,10,0,181950,1504.8,120
"8413","27180","2018",18,17,1,160177.5,1771.55555555556,92.4444444444444
"8414","27181","2018",8,8,0,151057.5,1646.875,91.625
"8415","27182","2018",1,1,0,325000,2407,135
"8416","27183","2018",37,36,1,185021.351351351,1928.2972972973,101.108108108108
"8417","27184","2018",2,2,0,231500,1913,118.5
"8418","27185","2018",5,5,0,160935,1707.4,91.8
"8419","27187","2018",3,3,0,158000,1254.33333333333,127.333333333333
"8420","27188","2018",12,12,0,165016.166666667,1675.08333333333,101.25
"8421","27189","2018",4,4,0,173500,1573.75,110.5
"8422","27190","2018",2,2,0,103500,1275,75
"8423","27191","2018",27,26,1,164309.444444444,1906.14814814815,92.3703703703704
"8424","27192","2018",6,6,0,173000,1865.66666666667,93.5
"8425","27193","2018",20,20,0,169594.8,1791.45,98.35
"8426","27194","2018",1,1,0,17000,425,40
"8427","27196","2018",10,10,0,174993,2018.3,84.4
"8428","27198","2018",52,51,1,139249.038461538,1479.26923076923,100.615384615385
"8429","27199","2018",11,11,0,169489.090909091,1589.09090909091,111.181818181818
"8430","27200","2018",3,3,0,182666.666666667,1713.33333333333,109
"8431","27201","2018",3,3,0,151216.666666667,1661.33333333333,92
"8432","27202","2018",4,4,0,104375,1159,96.5
"8433","27203","2018",8,8,0,189528.125,1829.25,106.625
"8434","27204","2018",1,1,0,166250,1750,95
"8435","27205","2018",4,4,0,77550,868.25,93.5
"8436","27206","2018",5,5,0,136432.4,1499.6,85.6
"8437","27207","2018",9,9,0,136366.666666667,1522.33333333333,104.777777777778
"8438","27208","2018",1,1,0,2e+05,1183,169
"8439","27209","2018",7,7,0,173978.571428571,1679.28571428571,104.285714285714
"8440","27210","2018",4,4,0,146750,1483,108.5
"8441","27212","2018",2,2,0,178900,2305,80
"8442","27213","2018",81,79,2,184459.802469136,1839.45679012346,102.938271604938
"8443","27214","2018",14,14,0,131163.928571429,1591.85714285714,84.3571428571429
"8444","27215","2018",4,4,0,101985,1284.5,83.5
"8445","27216","2018",4,4,0,175375,2077.25,86.75
"8446","27217","2018",4,4,0,138200,1491.5,94
"8447","27218","2018",24,23,1,163168.75,1726.08333333333,93.625
"8448","27219","2018",7,7,0,140321.428571429,1356.85714285714,105
"8449","27220","2018",8,8,0,260323.75,2293.5,106.375
"8450","27222","2018",2,2,0,474500,3052.5,153
"8451","27224","2018",6,6,0,177883.333333333,1510,119.833333333333
"8452","27226","2018",37,33,4,157118.378378378,1890.64864864865,85.8918918918919
"8453","27227","2018",6,6,0,153716.666666667,1481.16666666667,112.833333333333
"8454","27228","2018",3,3,0,173433.333333333,1422,130.666666666667
"8455","27229","2018",498,217,281,125312.861445783,1680.75301204819,75.1465863453815
"8456","27230","2018",74,61,13,165137.027027027,2015.74324324324,89.1621621621622
"8457","27231","2018",3,3,0,257208.333333333,2411,106.333333333333
"8458","27232","2018",8,8,0,180232.5,1851.625,113.75
"8459","27233","2018",16,16,0,161198.5625,1689.1875,95.8125
"8460","27234","2018",3,3,0,148333.333333333,1639.66666666667,91.6666666666667
"8461","27235","2018",1,1,0,155000,2422,64
"8462","27237","2018",2,2,0,187500,2380,105
"8463","27238","2018",6,6,0,165383.333333333,1853.33333333333,90.6666666666667
"8464","27239","2018",8,8,0,153200,1667.625,109.125
"8465","27240","2018",9,9,0,106361.111111111,1863.11111111111,70.4444444444444
"8466","27242","2018",11,11,0,132954.545454545,1281.54545454545,105.454545454545
"8467","27243","2018",16,16,0,197354.375,2044.3125,102.5625
"8468","27245","2018",4,4,0,101000,1273.25,90.75
"8469","27246","2018",20,20,0,119400,1742.45,75.3
"8470","27247","2018",9,9,0,165515,1241.66666666667,132.555555555556
"8471","27248","2018",1,1,0,133300,1465,91
"8472","27249","2018",17,17,0,215232.941176471,2014.11764705882,110.235294117647
"8473","27251","2018",8,8,0,145093.75,1557.375,99.25
"8474","27252","2018",4,4,0,128500,1145,113.75
"8475","27254","2018",18,18,0,227177.777777778,2169.05555555556,109.555555555556
"8476","27256","2018",4,4,0,130502.5,1408.5,92.75
"8477","27258","2018",13,13,0,164387.615384615,2130.76923076923,82.4615384615385
"8478","27259","2018",3,3,0,213166.666666667,1766,124.333333333333
"8479","27260","2018",12,12,0,183485,1744.75,114.916666666667
"8480","27261","2018",4,4,0,144187.5,1589.75,93
"8481","27263","2018",7,7,0,176214.285714286,1676.42857142857,111.142857142857
"8482","27266","2018",4,4,0,83825,1011.75,86.25
"8483","27267","2018",5,5,0,197718,1534.8,122.6
"8484","27269","2018",3,3,0,265841.666666667,1860.66666666667,143.333333333333
"8485","27271","2018",3,3,0,163833.333333333,1951.33333333333,90
"8486","27273","2018",5,5,0,185400,1884.2,104
"8487","27275","2018",75,35,40,114034.933333333,1586.33333333333,73.1733333333333
"8488","27276","2018",7,7,0,141642.857142857,1585.85714285714,87.8571428571429
"8489","27277","2018",5,5,0,196700,1358.2,144
"8490","27278","2018",32,30,2,168058.125,1937.53125,89.09375
"8491","27279","2018",27,21,6,162002.962962963,2171.66666666667,80.8518518518518
"8492","27280","2018",3,3,0,127366.666666667,1279.33333333333,102.666666666667
"8493","27281","2018",1,1,0,170000,1371,124
"8494","27282","2018",6,6,0,233733.333333333,1815.83333333333,126.5
"8495","27284","2018",144,89,55,161670.270833333,2125.64583333333,80.5902777777778
"8496","27285","2018",7,7,0,261671.428571429,2770.42857142857,92.5714285714286
"8497","27286","2018",8,8,0,131887.5,1235.875,110.375
"8498","27287","2018",13,13,0,134409.307692308,1868.15384615385,76.1538461538462
"8499","27288","2018",7,7,0,163000,1455.85714285714,116.571428571429
"8500","27289","2018",3,3,0,77666.6666666667,1047,81.6666666666667
"8501","27290","2018",13,13,0,151211.538461538,1415.07692307692,111.384615384615
"8502","27291","2018",6,6,0,130833.333333333,1323,102.166666666667
"8503","27294","2018",12,12,0,136872.916666667,1384.16666666667,108.916666666667
"8504","27295","2018",8,8,0,186700,1517.125,123.125
"8505","27298","2018",1,1,0,129500,1321,98
"8506","27299","2018",36,16,20,119090.277777778,1573.11111111111,78.1388888888889
"8507","27300","2018",7,7,0,115021.428571429,1456.14285714286,81.2857142857143
"8508","27301","2018",7,7,0,151685.714285714,1799.71428571429,93
"8509","27302","2018",13,13,0,145823.076923077,1659.15384615385,86.4615384615385
"8510","27304","2018",3,3,0,192878.333333333,2532,86.6666666666667
"8511","27306","2018",28,28,0,183652.392857143,1946.60714285714,97.8928571428571
"8512","27307","2018",10,10,0,153700,1219,136.9
"8513","27309","2018",1,1,0,189000,2148,88
"8514","27310","2018",5,5,0,171220,1650.4,103.6
"8515","27311","2018",13,13,0,156809.230769231,1546.30769230769,100.461538461538
"8516","27312","2018",5,5,0,291610,2248.4,126.6
"8517","27313","2018",6,6,0,161491.666666667,1917.66666666667,90.1666666666667
"8518","27315","2018",2,2,0,195000,1692.5,116
"8519","27316","2018",15,15,0,145431.333333333,1623.26666666667,95.2666666666667
"8520","27317","2018",4,4,0,162075,1446.5,115
"8521","27318","2018",1,1,0,257000,2142,120
"8522","27320","2018",1,1,0,25000,521,48
"8523","27322","2018",11,11,0,169636.363636364,1566.36363636364,110.181818181818
"8524","27323","2018",5,5,0,103600,1138.2,90
"8525","27324","2018",4,4,0,162550,1516.75,112.75
"8526","27325","2018",3,3,0,95166.6666666667,1143.33333333333,79.3333333333333
"8527","27326","2018",7,7,0,209035.714285714,1576.28571428571,143.428571428571
"8528","27327","2018",6,6,0,149108.333333333,1638.66666666667,92.6666666666667
"8529","27329","2018",9,9,0,173255.555555556,1677.77777777778,117.111111111111
"8530","27330","2018",2,2,0,133750,2192.5,61
"8531","27331","2018",5,5,0,185700,1854,102.6
"8532","27332","2018",11,11,0,136018.181818182,1283.54545454545,113.545454545455
"8533","27333","2018",10,10,0,168579,1837.2,90.2
"8534","27334","2018",2,2,0,177500,1826.5,96
"8535","27335","2018",9,9,0,225270.777777778,1668.88888888889,135.444444444444
"8536","27336","2018",4,4,0,206650,2077.75,99.75
"8537","27337","2018",4,4,0,128000,1113.5,113.75
"8538","27338","2018",10,10,0,170603.8,1698.2,104.1
"8539","27339","2018",14,14,0,170140.714285714,1728.21428571429,105.357142857143
"8540","27340","2018",7,7,0,186857.142857143,1684,114.571428571429
"8541","27342","2018",4,4,0,147250,1715.25,92.25
"8542","27343","2018",16,16,0,259828.125,2024.5625,140.125
"8543","27345","2018",4,4,0,117748,1634.75,81.25
"8544","27346","2018",3,3,0,201816.666666667,1397.66666666667,151.333333333333
"8545","27347","2018",9,9,0,165561.111111111,1651.55555555556,103
"8546","27348","2018",16,15,1,157986.9375,1804.9375,86.125
"8547","27349","2018",19,19,0,174910.526315789,1645.57894736842,108.052631578947
"8548","27350","2018",12,12,0,152529.583333333,1821.16666666667,84.6666666666667
"8549","27351","2018",8,7,1,146250,1738.25,84.75
"8550","27353","2018",5,5,0,190855,2281.8,89
"8551","27354","2018",4,4,0,155845,1923.75,82.75
"8552","27355","2018",43,34,9,144772.093023256,1806.6976744186,82.3953488372093
"8553","27358","2018",8,8,0,234875,2187.75,110
"8554","27359","2018",2,2,0,175500,1347.5,124.5
"8555","27360","2018",5,5,0,215764,1720.8,127
"8556","27361","2018",1,1,0,260000,2000,130
"8557","27363","2018",4,4,0,196625,1461.5,133.75
"8558","27364","2018",3,3,0,178000,1592,116.666666666667
"8559","27365","2018",15,12,3,159620,1553.8,102.733333333333
"8560","27366","2018",4,4,0,136604.25,1423.25,93
"8561","27367","2018",21,21,0,154880,1508.66666666667,106.095238095238
"8562","27368","2018",5,5,0,182324.6,1883.4,105.4
"8563","27369","2018",1,1,0,180000,1208,149
"8564","27370","2018",4,4,0,110500,1336.25,81.75
"8565","27371","2018",2,2,0,140000,1313,104.5
"8566","27372","2018",5,5,0,138410,1563.4,89.6
"8567","27373","2018",3,3,0,145666.666666667,1426.66666666667,110
"8568","27374","2018",5,5,0,117000,1646.2,78.4
"8569","27375","2018",180,130,50,134786.183333333,1655.56111111111,82.2111111111111
"8570","27376","2018",2,2,0,158500,1259.5,127.5
"8571","27377","2018",13,13,0,209893.846153846,1802.07692307692,127
"8572","27378","2018",6,6,0,171666.666666667,2114.16666666667,82
"8573","27379","2018",8,8,0,176625,1483.5,127.625
"8574","27380","2018",5,5,0,186920,1552.6,121.2
"8575","27381","2018",1,1,0,145000,1629,89
"8576","27382","2018",2,2,0,192475,1862,103.5
"8577","27383","2018",3,3,0,142666.666666667,2396.33333333333,69.3333333333333
"8578","27384","2018",5,5,0,184100,2116.6,85.6
"8579","27385","2018",24,22,2,147043.916666667,1525.70833333333,95.8333333333333
"8580","27386","2018",13,13,0,150600,1846.92307692308,82.5384615384615
"8581","27388","2018",8,8,0,130493.75,1351.25,97.5
"8582","27389","2018",5,5,0,185200,1939.6,94.4
"8583","27390","2018",7,7,0,141142.857142857,1336.28571428571,126.714285714286
"8584","27391","2018",22,22,0,173187.090909091,1908.81818181818,98.4545454545455
"8585","27392","2018",4,4,0,189200,1927,99.5
"8586","27393","2018",5,5,0,146840,1753.2,84.8
"8587","27394","2018",2,2,0,178063.5,2199.5,84.5
"8588","27396","2018",2,2,0,170500,1141,160
"8589","27397","2018",25,25,0,189936.8,1930.92,101.52
"8590","27398","2018",25,25,0,160028,1662.96,98.96
"8591","27400","2018",7,7,0,170528.428571429,1511.14285714286,116.142857142857
"8592","27401","2018",1,1,0,125000,1374,91
"8593","27403","2018",6,6,0,148683.333333333,1723.5,92.5
"8594","27404","2018",2,2,0,72500,997,81
"8595","27405","2018",2,2,0,231900,1477,157
"8596","27406","2018",9,8,1,171067.777777778,1896.44444444444,93.8888888888889
"8597","27407","2018",5,5,0,191600,1688.6,119.2
"8598","27408","2018",8,8,0,145275,1885.375,85.75
"8599","27410","2018",7,7,0,168446.428571429,1627.85714285714,115
"8600","27411","2018",2,2,0,103000,1262,82
"8601","27412","2018",16,16,0,170706.875,1653.6875,106.4375
"8602","27413","2018",11,11,0,115066.181818182,1328.54545454545,95.7272727272727
"8603","27414","2018",10,10,0,162150,1301.6,118.9
"8604","27415","2018",5,5,0,172494,1786,94
"8605","27417","2018",5,5,0,159000,1452.2,110.8
"8606","27418","2018",1,1,0,68800,1323,52
"8607","27419","2018",10,10,0,146190,1447.7,108.8
"8608","27420","2018",3,3,0,105000,1619.33333333333,63.6666666666667
"8609","27421","2018",13,13,0,158756.846153846,1912.69230769231,88.3846153846154
"8610","27422","2018",10,9,1,174900,1759.5,100.8
"8611","27423","2018",9,9,0,206500,1816.88888888889,116
"8612","27424","2018",3,3,0,137000,1821,75
"8613","27425","2018",20,20,0,133841.5,1220.1,108.9
"8614","27426","2018",21,21,0,200450,1963.80952380952,105.142857142857
"8615","27427","2018",14,14,0,151064.285714286,1354.57142857143,118.571428571429
"8616","27428","2018",49,41,8,156954.897959184,1827.91836734694,87.2040816326531
"8617","27429","2018",3,3,0,236233.333333333,2019.66666666667,116.333333333333
"8618","27430","2018",7,7,0,151975.714285714,2053.71428571429,87.1428571428571
"8619","27431","2018",5,4,1,60200,868.4,70.6
"8620","27432","2018",5,5,0,168200,1870.2,93.2
"8621","27433","2018",2,2,0,122500,2006,63
"8622","27435","2018",3,3,0,116000,1270,100
"8623","27436","2018",1,1,0,140000,1138,123
"8624","27437","2018",4,4,0,182462.5,2089.25,84.75
"8625","27438","2018",23,21,2,136483.043478261,1603,87.6521739130435
"8626","27439","2018",15,15,0,205573.333333333,1734,119.733333333333
"8627","27440","2018",6,6,0,185750,1839.5,112.5
"8628","27442","2018",6,6,0,124913.333333333,1189.5,108.666666666667
"8629","27444","2018",6,6,0,150083.333333333,1283.16666666667,123.333333333333
"8630","27445","2018",1,1,0,212000,1669,127
"8631","27446","2018",4,4,0,155000,1767.5,90.25
"8632","27447","2018",12,12,0,145916.666666667,1663.16666666667,89.3333333333333
"8633","27448","2018",69,62,7,191242.028985507,2146.46376811594,94.2028985507246
"8634","27451","2018",4,4,0,151500,2184.25,67.25
"8635","27453","2018",20,20,0,149126.5,1753,89.25
"8636","27454","2018",9,9,0,210016.666666667,1706.66666666667,138.777777777778
"8637","27455","2018",8,8,0,176297,1758.625,108.125
"8638","27456","2018",4,4,0,171026,1527.75,113.25
"8639","27457","2018",8,8,0,130564.625,1408,105.75
"8640","27458","2018",23,23,0,152604.347826087,1653.5652173913,94.9130434782609
"8641","27459","2018",1,1,0,125000,1157,108
"8642","27460","2018",3,3,0,132500,1545,88
"8643","27462","2018",3,3,0,93333.3333333333,1753,51.6666666666667
"8644","27463","2018",10,10,0,165950,1812.7,92.6
"8645","27464","2018",14,14,0,177732.857142857,1724.85714285714,107.642857142857
"8646","27465","2018",3,3,0,200666.666666667,1470,173.666666666667
"8647","27466","2018",5,5,0,137800,1512.8,91.6
"8648","27467","2018",118,79,39,123084.889830508,1600.59322033898,79.1610169491525
"8649","27468","2018",7,7,0,110500,1314.85714285714,85.8571428571429
"8650","27469","2018",36,33,3,178717.055555556,1950.47222222222,96.7777777777778
"8651","27470","2018",10,10,0,105954,1324.5,80.9
"8652","27472","2018",2,2,0,131000,1529.5,86
"8653","27473","2018",9,9,0,208111.111111111,1868,117.444444444444
"8654","27474","2018",16,16,0,182549.375,2231.4375,88.3125
"8655","27476","2018",3,3,0,232000,1720,128
"8656","27477","2018",2,2,0,146825,1524,98
"8657","27478","2018",3,3,0,159400,1713.66666666667,96.3333333333333
"8658","27480","2018",6,6,0,142545,1377.16666666667,105.666666666667
"8659","27481","2018",5,5,0,165000,1532.4,106.6
"8660","27482","2018",1,1,0,186000,1329,140
"8661","27483","2018",5,5,0,106047.4,1308.6,73.8
"8662","27485","2018",13,13,0,115486.153846154,1193.38461538462,99
"8663","27486","2018",3,3,0,209000,1836.66666666667,114.666666666667
"8664","27487","2018",7,7,0,161571.428571429,1579.28571428571,100.142857142857
"8665","27488","2018",6,6,0,194800,1805.66666666667,107.166666666667
"8666","27489","2018",5,5,0,136000,1508,95.8
"8667","27490","2018",6,6,0,144813.5,1670.5,89.5
"8668","27492","2018",4,4,0,110750,1693.5,68
"8669","27493","2018",52,52,0,147916.961538462,1663.57692307692,92.6730769230769
"8670","27495","2018",2,2,0,82000,2718,33
"8671","27496","2018",7,7,0,172585.714285714,1630.57142857143,108.714285714286
"8672","27497","2018",4,4,0,185775,1549.75,138
"8673","27498","2018",1,1,0,131000,1424,92
"8674","27500","2018",21,21,0,161420,1553.2380952381,106.190476190476
"8675","27501","2018",2,2,0,247500,3153,79.5
"8676","27502","2018",35,32,3,87314.2857142857,1053.88571428571,81.4
"8677","27504","2018",6,6,0,176102.166666667,1654.16666666667,106.5
"8678","27505","2018",2,2,0,104500,1494.5,73.5
"8679","27507","2018",33,29,4,153363.363636364,2114.39393939394,86.1212121212121
"8680","27508","2018",2,2,0,128500,1130.5,111.5
"8681","27511","2018",3,3,0,247000,1819.33333333333,131
"8682","27512","2018",6,6,0,157433.333333333,1622.5,95.3333333333333
"8683","27514","2018",3,3,0,149833.333333333,1272.66666666667,116
"8684","27516","2018",8,8,0,173562.5,1488.125,114.25
"8685","27517","2018",19,19,0,188218.157894737,1974.31578947368,104.473684210526
"8686","27518","2018",7,7,0,132855,1359.14285714286,98.8571428571429
"8687","27520","2018",3,3,0,201583.333333333,1916.66666666667,99.6666666666667
"8688","27522","2018",9,9,0,123027.777777778,1523.77777777778,78
"8689","27524","2018",6,6,0,137250,1563.66666666667,97.3333333333333
"8690","27525","2018",3,3,0,222300,2011,110.333333333333
"8691","27527","2018",5,5,0,139527.8,1634,81.4
"8692","27528","2018",48,42,6,185063.75,2059.16666666667,91.1875
"8693","27529","2018",5,5,0,227000,1940.6,119.2
"8694","27531","2018",4,4,0,185750,1399,138.5
"8695","27533","2018",12,11,1,202999.416666667,1931,104.833333333333
"8696","27534","2018",7,7,0,169442.571428571,1760,101.571428571429
"8697","27535","2018",3,3,0,179666.666666667,2001,91.3333333333333
"8698","27536","2018",5,5,0,234400,1680.6,145.2
"8699","27537","2018",10,10,0,167480,1663.2,103.6
"8700","27538","2018",9,9,0,161123.111111111,1705.88888888889,97.3333333333333
"8701","27539","2018",3,3,0,183300,1389,129.666666666667
"8702","27540","2018",6,6,0,209833.333333333,2067.33333333333,102
"8703","27541","2018",3,3,0,114209.333333333,1723,69
"8704","27542","2018",8,7,1,135827.5,1310.75,106.75
"8705","27543","2018",8,8,0,175025,1979.875,94.375
"8706","27544","2018",3,3,0,138666.666666667,2659.33333333333,61.6666666666667
"8707","27546","2018",1,1,0,312000,2889,108
"8708","27547","2018",7,7,0,126000,1430.85714285714,89.7142857142857
"8709","27548","2018",13,13,0,176890.769230769,1930.30769230769,100.538461538462
"8710","27550","2018",6,6,0,111506,1272.5,87.1666666666667
"8711","27552","2018",1,1,0,163000,1663,98
"8712","27553","2018",4,4,0,91250,1034.75,70.75
"8713","27554","2018",33,32,1,214278.666666667,2130.75757575758,104.69696969697
"8714","27555","2018",6,6,0,190066.666666667,1884.66666666667,106.666666666667
"8715","27557","2018",1,1,0,211000,1563,135
"8716","27558","2018",1,1,0,170000,1735,98
"8717","27560","2018",4,4,0,184500,1985.5,97
"8718","27561","2018",13,13,0,215692.307692308,2121.46153846154,106.923076923077
"8719","27562","2018",48,36,12,170734.791666667,2137.1875,80.8125
"8720","27563","2018",7,7,0,136835.714285714,1735,79.4285714285714
"8721","27564","2018",5,5,0,122195.8,1357.2,91
"8722","27565","2018",2,2,0,170950,1415,124.5
"8723","27567","2018",1,1,0,162000,2051,79
"8724","27568","2018",9,9,0,138857.444444444,1346.88888888889,105.777777777778
"8725","27569","2018",1,1,0,280000,2000,140
"8726","27571","2018",4,4,0,187170,1576.25,121
"8727","27572","2018",7,7,0,211292.857142857,1483.57142857143,144.428571428571
"8728","27576","2018",10,10,0,182850,1515.2,129.3
"8729","27577","2018",7,7,0,87000,1324.42857142857,63.7142857142857
"8730","27578","2018",10,10,0,127610,1375,98.9
"8731","27579","2018",2,2,0,69175,758,107
"8732","27580","2018",23,23,0,191976.956521739,1913.17391304348,101
"8733","27582","2018",16,16,0,166478.125,1841.75,91.625
"8734","27584","2018",8,8,0,142187.5,1402,103.875
"8735","27586","2018",2,2,0,155000,1470,106
"8736","27587","2018",11,11,0,163745.454545455,1515.27272727273,95.8181818181818
"8737","27589","2018",16,16,0,223661.875,2082.625,109.6875
"8738","27590","2018",5,5,0,88000,1004.6,87.2
"8739","27591","2018",17,17,0,188777.058823529,1949.82352941176,99.3529411764706
"8740","27592","2018",3,3,0,138666.666666667,1618.33333333333,87.3333333333333
"8741","27593","2018",27,27,0,177257.407407407,1837.48148148148,99.4074074074074
"8742","27594","2018",4,4,0,91827.5,1341.25,73.75
"8743","27595","2018",6,6,0,182432.166666667,1484.5,123.666666666667
"8744","27597","2018",11,11,0,208963.636363636,1916.72727272727,116.909090909091
"8745","27598","2018",10,10,0,165904,1653.4,98.4
"8746","27599","2018",13,13,0,166103.846153846,1872.92307692308,94.6153846153846
"8747","27601","2018",5,5,0,264800,2204.2,102.4
"8748","27602","2018",47,46,1,166873.191489362,1714.70212765957,97.6808510638298
"8749","27603","2018",4,4,0,179200,1734.25,106
"8750","27604","2018",1,1,0,155000,1742,89
"8751","27605","2018",4,4,0,139750,1535.5,95.25
"8752","27606","2018",4,4,0,162750,1655.5,100
"8753","27608","2018",2,2,0,150000,1248,125.5
"8754","27609","2018",5,5,0,147580,1924,90.4
"8755","27610","2018",1,1,0,80000,500,160
"8756","27611","2018",3,3,0,227666.666666667,1911,118
"8757","27612","2018",3,3,0,132881,1282,103.333333333333
"8758","27613","2018",3,3,0,175000,2070.33333333333,87
"8759","27614","2018",3,3,0,141533.333333333,1358.66666666667,103.666666666667
"8760","27615","2018",2,2,0,218000,2260.5,101.5
"8761","27616","2018",23,23,0,198145.652173913,1854.04347826087,114.217391304348
"8762","27617","2018",6,6,0,165733.333333333,1734,99.1666666666667
"8763","27618","2018",5,5,0,156800,1495.6,106
"8764","27620","2018",4,4,0,181858.75,1512,117
"8765","27621","2018",1,1,0,258000,3686,70
"8766","27622","2018",14,14,0,118178.571428571,1513.71428571429,84
"8767","27623","2018",4,4,0,209875,1881.5,116.5
"8768","27624","2018",9,9,0,191222.222222222,1904.77777777778,105.333333333333
"8769","27625","2018",3,3,0,172516.666666667,1755.33333333333,101.666666666667
"8770","27627","2018",6,6,0,113066.666666667,1248,82.5
"8771","27629","2018",25,24,1,121112,1378.28,92.92
"8772","27630","2018",2,2,0,135500,1159,118.5
"8773","27631","2018",2,2,0,181975,1756.5,105
"8774","27632","2018",7,7,0,156411.428571429,1711.57142857143,90.7142857142857
"8775","27633","2018",4,4,0,186750,1644.5,125.5
"8776","27635","2018",1,1,0,210000,1654,127
"8777","27638","2018",37,37,0,199699.108108108,1869.05405405405,110
"8778","27640","2018",1,1,0,142000,2328,61
"8779","27643","2018",5,5,0,170518,1118,151
"8780","27644","2018",6,6,0,173236.666666667,1890.66666666667,96.8333333333333
"8781","27646","2018",5,5,0,157090,2628.2,77.2
"8782","27649","2018",4,4,0,157937.5,1637.25,101
"8783","27650","2018",2,2,0,153150,1721,89
"8784","27652","2018",9,9,0,150170,1628,90.7777777777778
"8785","27654","2018",14,14,0,177685.714285714,1527.21428571429,120.357142857143
"8786","27655","2018",10,10,0,192852,1594.4,114.8
"8787","27656","2018",9,9,0,129744.444444444,1552.33333333333,89.5555555555556
"8788","27658","2018",1,1,0,70000,1167,60
"8789","27660","2018",6,6,0,90366.6666666667,990.833333333333,94.6666666666667
"8790","27661","2018",9,9,0,236083.333333333,1798.55555555556,132
"8791","27662","2018",7,7,0,209071.428571429,2113.85714285714,105.428571428571
"8792","27663","2018",2,2,0,91000,1172.5,89.5
"8793","27664","2018",11,11,0,180489.090909091,1772.72727272727,111.181818181818
"8794","27665","2018",8,8,0,151375,1418.5,108.125
"8795","27666","2018",5,5,0,178400,1453,128.8
"8796","27667","2018",9,9,0,136420.555555556,1280.33333333333,105.333333333333
"8797","27668","2018",6,6,0,207200,1801,119
"8798","27669","2018",1,1,0,105500,1551,68
"8799","27670","2018",9,9,0,164561.111111111,1518.55555555556,102.555555555556
"8800","27671","2018",2,2,0,130000,1174.5,111.5
"8801","27672","2018",6,6,0,154241.666666667,1738.83333333333,86
"8802","27673","2018",4,4,0,167250,1685.75,99
"8803","27674","2018",3,3,0,329000,2018.33333333333,164.666666666667
"8804","27677","2018",2,2,0,192500,1671.5,116
"8805","27678","2018",3,3,0,165000,1569.33333333333,104
"8806","27679","2018",79,59,20,122206.430379747,1552.13924050633,82.5063291139241
"8807","27680","2018",5,5,0,73200,1040.2,66.8
"8808","27681","2018",271,146,125,168496.612546125,2134.29520295203,79.0405904059041
"8809","27682","2018",5,5,0,223360,1751.2,133.8
"8810","27683","2018",1,1,0,59990,1304,46
"8811","27684","2018",12,12,0,181960.833333333,1772.83333333333,106.916666666667
"8812","27685","2018",9,9,0,132347,1407.44444444444,97.1111111111111
"8813","27686","2018",2,2,0,129250,2081.5,78.5
"8814","27689","2018",8,8,0,164300,1860.875,92.25
"8815","27690","2018",6,6,0,151033.333333333,2012.83333333333,75
"8816","27691","2018",10,10,0,158955.9,2141.2,81.6
"8817","27692","2018",4,4,0,150937.5,1977.75,80.25
"8818","27693","2018",18,18,0,199492.222222222,1685.22222222222,122.166666666667
"8819","27694","2018",4,4,0,233750,1614.5,142.5
"8820","27695","2018",2,2,0,140750,1641,87.5
"8821","27696","2018",12,12,0,252312.5,1831.5,132.666666666667
"8822","27697","2018",2,2,0,258125,1580,165
"8823","27698","2018",3,3,0,124266.666666667,1389,90.6666666666667
"8824","27699","2018",2,2,0,147500,1648,94.5
"8825","27700","2018",10,10,0,183755,1679.5,112.1
"8826","27701","2018",51,49,2,130709.803921569,1511.01960784314,89.3529411764706
"8827","28001","2018",39,38,1,229575.948717949,2013.74358974359,117.487179487179
"8828","28003","2018",3,3,0,200233.333333333,1395.66666666667,131
"8829","28004","2018",3,3,0,180666.666666667,1401.66666666667,130
"8830","28005","2018",10,10,0,119360,1215.6,114.3
"8831","28006","2018",16,16,0,174135,2105.75,84.9375
"8832","28007","2018",42,38,4,178141.714285714,2040.92857142857,88.9285714285714
"8833","28008","2018",1,1,0,68000,1193,57
"8834","28012","2018",72,72,0,87601.4027777778,1084.55555555556,83.4305555555556
"8835","28013","2018",27,27,0,165294.444444444,1918.7037037037,91.962962962963
"8836","28014","2018",6,6,0,160658.333333333,1639.33333333333,113.5
"8837","28015","2018",74,61,13,170232.432432432,1925.04054054054,89.472972972973
"8838","28016","2018",5,5,0,127000,1465.2,85.4
"8839","28018","2018",20,20,0,76070,988.5,74.9
"8840","28019","2018",1,1,0,165000,1650,100
"8841","28021","2018",20,20,0,141905,1494.85,102.35
"8842","28022","2018",11,11,0,202147.272727273,1748.63636363636,120.727272727273
"8843","28023","2018",19,18,1,193918.421052632,1988.84210526316,110.210526315789
"8844","28024","2018",10,10,0,228568.2,1971.4,116.8
"8845","28026","2018",5,5,0,161200,2022.8,81.4
"8846","28027","2018",20,20,0,79025,1024.35,90.35
"8847","28028","2018",7,7,0,167131.428571429,1393.14285714286,109
"8848","28029","2018",7,7,0,113142.857142857,1375,83.1428571428571
"8849","28030","2018",4,4,0,107500,1077.5,103.5
"8850","28031","2018",11,11,0,118681.818181818,870.545454545455,132.090909090909
"8851","28032","2018",8,8,0,159232.5,1162.5,133.375
"8852","28033","2018",14,14,0,138294.285714286,1155.14285714286,119.285714285714
"8853","28034","2018",8,8,0,191625,2135.625,90.75
"8854","28035","2018",12,12,0,151208.333333333,1857.75,85.8333333333333
"8855","28036","2018",14,11,3,373703.571428571,2807.21428571429,116.857142857143
"8856","28037","2018",13,13,0,130307.692307692,1368.69230769231,102.692307692308
"8857","28038","2018",2,2,0,220000,1894,142
"8858","28039","2018",18,17,1,191044.444444444,2043.94444444444,107.166666666667
"8859","28040","2018",4,4,0,175090,1488.75,118.75
"8860","28041","2018",4,4,0,108812.5,1012.5,120
"8861","28045","2018",4,4,0,150300,1697,87.25
"8862","28046","2018",6,6,0,99583.3333333333,1230.5,75.8333333333333
"8863","28047","2018",16,16,0,125460.625,1545.875,85.25
"8864","28048","2018",9,9,0,137741.111111111,1584.66666666667,88.2222222222222
"8865","28049","2018",1,1,0,135000,1298,104
"8866","28050","2018",2,2,0,226225,2226.5,102
"8867","28051","2018",54,52,2,137828.425925926,1538.11111111111,94.6666666666667
"8868","28052","2018",20,20,0,197785.7,1904.05,103.5
"8869","28053","2018",4,4,0,108647.5,1404.25,78.25
"8870","28054","2018",7,7,0,195117.857142857,1671,120.428571428571
"8871","28055","2018",7,7,0,135964.285714286,1198.71428571429,111.428571428571
"8872","28056","2018",27,27,0,235267.592592593,2096.85185185185,112.851851851852
"8873","28057","2018",4,4,0,113400,1088.5,114
"8874","28058","2018",4,4,0,176500,2012.25,91
"8875","28059","2018",14,13,1,105137.857142857,1178.5,90.9285714285714
"8876","28060","2018",2,2,0,164175,1556.5,105
"8877","28061","2018",51,48,3,108082.764705882,1237.6862745098,89.078431372549
"8878","28062","2018",12,12,0,196500,2186.5,93.1666666666667
"8879","28064","2018",25,25,0,218642,2258.8,100.56
"8880","28065","2018",1,1,0,105000,1082,97
"8881","28067","2018",3,3,0,88080.3333333333,934.666666666667,88.6666666666667
"8882","28068","2018",6,6,0,156868.333333333,1677.16666666667,91.8333333333333
"8883","28070","2018",34,34,0,236293.264705882,2126.38235294118,112.117647058824
"8884","28071","2018",6,5,1,68111.6666666667,975.833333333333,78
"8885","28072","2018",6,6,0,137485,1394.5,105.166666666667
"8886","28073","2018",6,6,0,196982.5,1887.83333333333,105.333333333333
"8887","28074","2018",5,5,0,166880,1691,101.4
"8888","28075","2018",7,7,0,100552.142857143,1364,77.4285714285714
"8889","28076","2018",1,1,0,220000,2000,110
"8890","28077","2018",3,3,0,170116.666666667,2044,89.6666666666667
"8891","28078","2018",2,2,0,76000,1190.5,64
"8892","28079","2018",6,6,0,76450,999.833333333333,71.8333333333333
"8893","28080","2018",10,10,0,121950,1008.2,120.2
"8894","28081","2018",2,2,0,58500,690,94.5
"8895","28082","2018",5,5,0,188461,1804.2,105
"8896","28084","2018",12,11,1,194512.5,2123.58333333333,94.25
"8897","28085","2018",587,226,361,170683.405451448,2235.57921635434,77.2231686541738
"8898","28086","2018",7,7,0,76000,1028.28571428571,83.4285714285714
"8899","28087","2018",4,4,0,739588.75,4714.5,108.5
"8900","28088","2018",141,108,33,95989.0780141844,1066.12765957447,89.2127659574468
"8901","28089","2018",20,18,2,138865,1511.3,92.6
"8902","28090","2018",2,2,0,158500,1054.5,146
"8903","28091","2018",1,1,0,134000,1276,105
"8904","28092","2018",4,4,0,138250,1480.25,96.25
"8905","28094","2018",22,22,0,212866.5,2028.90909090909,115.772727272727
"8906","28095","2018",7,7,0,128428.571428571,1522.57142857143,97.5714285714286
"8907","28096","2018",17,17,0,177448.823529412,2192.94117647059,83.8823529411765
"8908","28098","2018",24,24,0,179585.416666667,1782.75,107.416666666667
"8909","28099","2018",11,11,0,154595.454545455,1406.90909090909,107
"8910","28100","2018",5,5,0,192612,2145.8,91.4
"8911","28102","2018",10,9,1,140499,1519.5,92.6
"8912","28103","2018",70,69,1,111073.171428571,1179.64285714286,97.3571428571429
"8913","28104","2018",8,8,0,174025.625,2032.375,89
"8914","28105","2018",8,8,0,130400,1260.375,99.5
"8915","28106","2018",5,5,0,84200,1235.2,71.2
"8916","28107","2018",7,7,0,183828.571428571,2290.14285714286,94.8571428571429
"8917","28108","2018",7,7,0,103285.714285714,1211,86.4285714285714
"8918","28109","2018",4,4,0,148325,1417,107
"8919","28110","2018",31,19,12,224020.419354839,2504.35483870968,93.2903225806452
"8920","28111","2018",6,6,0,139323.333333333,954.833333333333,131.5
"8921","28113","2018",17,16,1,171246.470588235,1935.47058823529,94.8823529411765
"8922","28114","2018",2,2,0,329875,2925,129
"8923","28116","2018",37,36,1,158813.513513514,1920.7027027027,88.054054054054
"8924","28117","2018",5,5,0,141310,1461.2,113.6
"8925","28118","2018",7,7,0,206075.714285714,1907.42857142857,112.428571428571
"8926","28119","2018",5,5,0,79930,1083.8,79
"8927","28120","2018",4,4,0,255725,1355.25,159
"8928","28121","2018",2,2,0,87500,965,91
"8929","28122","2018",13,12,1,156229.230769231,1644.76923076923,99.6923076923077
"8930","28123","2018",3,3,0,102833.333333333,1282,79.6666666666667
"8931","28124","2018",10,10,0,132230,1256.9,117.3
"8932","28126","2018",6,6,0,71533.3333333333,920.666666666667,84.1666666666667
"8933","28127","2018",16,16,0,91437.5,1184.5,79.75
"8934","28128","2018",2,2,0,191500,1754,108
"8935","28129","2018",15,15,0,183969.2,1791.46666666667,105.266666666667
"8936","28130","2018",15,15,0,94412,1032.2,91.3333333333333
"8937","28132","2018",7,7,0,160846.428571429,1257.85714285714,119.714285714286
"8938","28134","2018",303,161,142,126629.689768977,1642.80528052805,77.5577557755776
"8939","28135","2018",13,13,0,236073.076923077,2432.84615384615,106.692307692308
"8940","28136","2018",2,2,0,160000,1426,115
"8941","28137","2018",14,14,0,194105.5,2315.42857142857,91.6428571428571
"8942","28139","2018",5,5,0,118000,1197.8,101.2
"8943","28140","2018",69,23,46,148937.028985507,2380.26086956522,66.5072463768116
"8944","28141","2018",4,4,0,153875,1628.5,92.5
"8945","28142","2018",2,2,0,193000,1345,141.5
"8946","28143","2018",4,4,0,162250,1618.75,127
"8947","28144","2018",3,3,0,166000,1372,116.333333333333
"8948","28146","2018",21,19,2,275125.428571429,2232.90476190476,116.047619047619
"8949","28147","2018",11,11,0,149100,1406.81818181818,106.272727272727
"8950","28148","2018",5,5,0,314697,1836.6,152
"8951","28149","2018",10,10,0,114120.5,1203.8,100.1
"8952","28151","2018",1,1,0,80000,2000,40
"8953","28153","2018",2,2,0,127500,1450.5,87
"8954","28154","2018",8,8,0,155295,1618,97
"8955","28155","2018",2,2,0,88000,622.5,135
"8956","28156","2018",10,10,0,71115,1056,68.8
"8957","28157","2018",5,5,0,78600,876.2,83.6
"8958","28158","2018",10,10,0,225932,2060.9,119.2
"8959","28159","2018",6,6,0,101156.166666667,1257,81
"8960","28160","2018",12,12,0,178110,2099.83333333333,94.75
"8961","28161","2018",8,8,0,118225,1287.75,95.5
"8962","28162","2018",5,5,0,116840,1613.6,74
"8963","28163","2018",3,3,0,142466.666666667,1650.33333333333,83.6666666666667
"8964","28164","2018",8,8,0,130843.75,1535,85.5
"8965","28166","2018",1,1,0,148000,2114,70
"8966","28167","2018",5,5,0,144200,1195.2,121.4
"8967","28168","2018",37,29,8,169123.756756757,2181.67567567568,78.972972972973
"8968","28169","2018",3,3,0,170166.666666667,2002.66666666667,92.6666666666667
"8969","28170","2018",2,2,0,120000,1595,75.5
"8970","28171","2018",11,11,0,151363.636363636,1560.63636363636,97.5454545454545
"8971","28172","2018",10,10,0,212624,2062.4,104
"8972","28173","2018",20,20,0,189803.75,1725.45,110.25
"8973","28175","2018",1,1,0,157000,1670,94
"8974","28176","2018",8,8,0,153945.375,1552.5,101.25
"8975","28177","2018",5,5,0,198634,1978,98.2
"8976","28178","2018",4,4,0,192217.5,1751.25,119.25
"8977","28180","2018",7,7,0,247271.428571429,1844.42857142857,136.857142857143
"8978","28182","2018",5,5,0,130044.6,1191,117.2
"8979","28183","2018",7,7,0,150521.714285714,1605.42857142857,97.5714285714286
"8980","28184","2018",5,5,0,160530,1522.2,99.8
"8981","28185","2018",11,10,1,204522.727272727,2499.45454545455,86.0909090909091
"8982","28187","2018",5,5,0,219740,1907.2,118.4
"8983","28188","2018",13,13,0,194356.076923077,1808.69230769231,117.076923076923
"8984","28189","2018",5,5,0,99100,1232.8,83.6
"8985","28190","2018",5,5,0,87482,965.8,99.2
"8986","28191","2018",37,32,5,224568.513513514,2302.24324324324,101.081081081081
"8987","28192","2018",9,9,0,138821.222222222,1437.11111111111,101.888888888889
"8988","28193","2018",1,1,0,345300,1973,175
"8989","28194","2018",4,4,0,194432.5,1743.5,114.5
"8990","28195","2018",6,6,0,156666.666666667,1796,92.3333333333333
"8991","28196","2018",27,27,0,117287.814814815,1355.44444444444,86.8888888888889
"8992","28197","2018",2,2,0,105000,1746.5,61.5
"8993","28198","2018",10,10,0,100150,1161.3,88.2
"8994","28199","2018",41,38,3,143059.268292683,1437.53658536585,101
"8995","28200","2018",7,7,0,125921.428571429,1089.42857142857,109.714285714286
"8996","28201","2018",20,19,1,196825.75,1859.9,111.05
"8997","28202","2018",2,2,0,74000,576,136
"8998","28203","2018",4,4,0,160750,1661.75,97.75
"8999","28206","2018",12,12,0,120677.916666667,1312.41666666667,104.083333333333
"9000","28207","2018",5,5,0,186440,1284.8,154.8
"9001","28208","2018",5,5,0,280340,2074.8,132.2
"9002","28209","2018",57,41,16,186785.3,2187.439,88.63158
"9003","28210","2018",2,2,0,118500,861.5,135.5
"9004","28211","2018",9,9,0,95150,1151.333,87.66667
"9005","28212","2018",4,4,0,158112.5,1410.75,111.5
"9006","28213","2018",9,9,0,241058.9,1799,140.5556
"9007","28214","2018",47,46,1,89950,1152.447,79.97872
"9008","28216","2018",2,2,0,225009.5,4724.5,71
"9009","28217","2018",6,6,0,94166.67,953.5,99.83333
"9010","28218","2018",116,62,54,144194.2,2004.138,75.43966
"9011","28219","2018",6,6,0,106000,1342.833,85
"9012","28220","2018",70,50,20,208688.2,2184.343,95.87143
"9013","28221","2018",4,4,0,92590,869.25,111.25
"9014","28222","2018",6,6,0,133968.3,1323,104.1667
"9015","28223","2018",11,11,0,166236.4,1782.273,94.09091
"9016","28225","2018",6,6,0,117500,1367.5,86.33333
"9017","28226","2018",14,14,0,127914.3,1294.071,99.35714
"9018","28227","2018",68,51,17,197537.6,2388.5,86.07353
"9019","28229","2018",106,54,52,143469.5,1979.349,74.33019
"9020","28230","2018",2,2,0,228000,1370.5,143
"9021","28231","2018",4,4,0,116475,1045.25,109.5
"9022","28232","2018",8,8,0,101681.2,994.5,112.125
"9023","28233","2018",11,11,0,118259.1,1300.636,91.36364
"9024","28234","2018",6,6,0,107883.3,1035,107.8333
"9025","28235","2018",7,7,0,200150,2138,95.14286
"9026","28236","2018",29,27,2,117117.2,1340.172,90.2069
"9027","28237","2018",1,1,0,42000,792,53
"9028","28239","2018",12,12,0,190000,1548.917,134.1667
"9029","28240","2018",5,5,0,99300,1186.4,104
"9030","28243","2018",4,4,0,150860,2205.25,69.25
"9031","28245","2018",7,7,0,195442.9,1599,126.8571
"9032","28246","2018",5,5,0,181114,1505.4,123.6
"9033","28247","2018",7,7,0,222200,1768.429,130.5714
"9034","28248","2018",5,5,0,167900,1365.4,116.8
"9035","28249","2018",4,4,0,171500,1913.75,90.75
"9036","28251","2018",13,13,0,168358.5,1683.385,105
"9037","28252","2018",2,2,0,165135,1182.5,135.5
"9038","28253","2018",7,6,1,284314.3,1625.429,180.1429
"9039","28254","2018",10,10,0,151955,1631.4,95.4
"9040","28255","2018",1,1,0,165640,1820,91
"9041","28256","2018",3,3,0,102666.7,1085.333,96.33333
"9042","28257","2018",2,2,0,186840,1598,117
"9043","28259","2018",9,9,0,114355.6,1320.667,89.88889
"9044","28261","2018",6,6,0,115966.7,1253.833,94.83333
"9045","28263","2018",4,4,0,135900,1442,91.5
"9046","28264","2018",1,1,0,857238,2820,304
"9047","28265","2018",2,2,0,75000,868.5,86
"9048","28267","2018",7,7,0,201814.3,1805.429,113.2857
"9049","28269","2018",13,13,0,282700,2259.231,127.8462
"9050","28270","2018",6,6,0,85000,680.5,125.8333
"9051","28271","2018",3,3,0,84000,1044,80.66667
"9052","28272","2018",1,1,0,108100,1228,88
"9053","28273","2018",2,2,0,114465,1887,71.5
"9054","28274","2018",2,2,0,125000,1572,85
"9055","28275","2018",7,7,0,201142.9,2149.857,94.85714
"9056","28276","2018",7,7,0,129557.1,1265.429,103.4286
"9057","28277","2018",2,2,0,120835,1014.5,119
"9058","28278","2018",12,9,3,208312.3,2710.333,104.5
"9059","28279","2018",41,32,9,159471.7,1971.927,83.97561
"9060","28280","2018",127,91,36,94815.09,1136.449,80.76378
"9061","28281","2018",11,11,0,167336.4,1566.636,109.2727
"9062","28282","2018",6,6,0,113583.3,1364.667,82.5
"9063","28283","2018",4,4,0,111462.5,1387,80.25
"9064","28284","2018",5,5,0,149580,2183.8,76
"9065","28285","2018",2,2,0,188350,2136.5,96.5
"9066","28286","2018",7,7,0,128100,1213.429,108.7143
"9067","28287","2018",12,12,0,113068.3,1319.25,87.66667
"9068","28289","2018",2,2,0,245000,2241.5,116
"9069","28290","2018",5,5,0,211490,1722.2,124.2
"9070","28291","2018",9,9,0,121333.3,1427.333,91.88889
"9071","28292","2018",11,11,0,201029.9,1849.182,110.3636
"9072","28293","2018",13,13,0,212534.6,1863.692,124.4615
"9073","28294","2018",6,6,0,173833.3,1602,108.6667
"9074","28296","2018",7,7,0,106471.4,978.1429,108.7143
"9075","28298","2018",34,32,2,190795.3,2044.441,96.91176
"9076","28299","2018",1,1,0,215333,2111,102
"9077","28300","2018",4,4,0,167815.5,1431.5,118.75
"9078","28301","2018",2,2,0,199100,1796,112
"9079","28302","2018",13,13,0,133461.5,1351.462,97.84615
"9080","28304","2018",6,6,0,174175,1336.333,149.1667
"9081","28305","2018",3,3,0,60330,791.3333,79.33333
"9082","28306","2018",2,2,0,112000,968.5,116.5
"9083","28308","2018",3,3,0,129135,1218.667,108.6667
"9084","28309","2018",18,18,0,171758.3,1632.222,108.7778
"9085","28310","2018",5,5,0,92700,1137.6,92.6
"9086","28312","2018",2,2,0,85700,771.5,120
"9087","28313","2018",1,1,0,138000,1078,128
"9088","28314","2018",5,5,0,84600,1165.2,76.4
"9089","28315","2018",1,1,0,154000,1167,132
"9090","28316","2018",4,4,0,176932.5,1367.5,111
"9091","28317","2018",4,4,0,127788.8,2516.75,52.75
"9092","28319","2018",5,5,0,135000,1498.4,105.2
"9093","28321","2018",13,13,0,231203.8,2299.538,107.3077
"9094","28322","2018",8,8,0,121062.5,1228.5,99
"9095","28323","2018",4,4,0,135050,1465,94.5
"9096","28324","2018",10,10,0,126390,1535.9,86.1
"9097","28325","2018",12,12,0,181672.5,2060.25,108
"9098","28326","2018",8,8,0,137737.5,1491.5,98.625
"9099","28327","2018",1,1,0,125000,1033,121
"9100","28329","2018",1,1,0,230500,2134,108
"9101","28330","2018",18,18,0,116743.3,1112.667,111.3333
"9102","28331","2018",13,13,0,79553.85,1094.077,74.84615
"9103","28332","2018",12,12,0,192789.7,1831.917,112.4167
"9104","28333","2018",1,1,0,142000,1671,85
"9105","28334","2018",21,21,0,125778.1,1381.238,93.14286
"9106","28335","2018",6,6,0,111950,1187.333,95.33333
"9107","28337","2018",28,28,0,204133.2,2029.036,108.1429
"9108","28339","2018",3,3,0,149366.7,1286.667,119.6667
"9109","28341","2018",1,1,0,125000,2315,54
"9110","28342","2018",3,3,0,84666.67,797,92
"9111","28343","2018",5,5,0,270500,2432.8,110.2
"9112","28344","2018",4,4,0,174812.5,2179.75,81.5
"9113","28346","2018",1,1,0,146000,1090,134
"9114","28347","2018",17,16,1,265150.6,2502.118,118.3529
"9115","28348","2018",39,39,0,143675.9,1561.462,93.87179
"9116","28349","2018",10,10,0,223011,1910.7,123
"9117","28350","2018",9,9,0,144200,1368.111,105.5556
"9118","28351","2018",8,8,0,113153.8,1243.875,97.625
"9119","28352","2018",20,20,0,232413.5,2251,106.35
"9120","28353","2018",6,6,0,95666.67,1483.833,69.5
"9121","28354","2018",6,6,0,114983.3,1256.833,93.5
"9122","28355","2018",5,5,0,251700,2217.4,111.4
"9123","28357","2018",13,13,0,230975.4,1963.923,126.9231
"9124","28358","2018",21,18,3,193233.3,2040.857,95.85714
"9125","28359","2018",41,41,0,129691.3,1493.073,89.26829
"9126","28360","2018",4,4,0,123787.5,1423.75,88
"9127","28362","2018",4,4,0,99750,1002.75,93.5
"9128","28363","2018",14,13,1,177036.9,1956.857,91.85714
"9129","28364","2018",19,19,0,99861.58,1217,85
"9130","28365","2018",6,6,0,154946.7,1485.833,112.1667
"9131","28366","2018",7,7,0,177014.3,1559.571,114.4286
"9132","28367","2018",6,6,0,96835,1196.833,81.33333
"9133","28368","2018",3,3,0,132766.7,1392.333,100.6667
"9134","28369","2018",13,13,0,120032.5,1317.077,94.46154
"9135","28370","2018",5,5,0,108000,1599.4,73.2
"9136","28371","2018",13,12,1,178403.8,1814.231,102.2308
"9137","28372","2018",8,8,0,274985.2,1697.75,160.625
"9138","28373","2018",40,40,0,109101.7,1106,99.325
"9139","28374","2018",8,8,0,173604.4,1353.875,141.875
"9140","28375","2018",1,1,0,141000,2014,70
"9141","28377","2018",23,23,0,191634.4,1951,100.7391
"9142","28378","2018",7,7,0,104057.1,1323.714,85.14286
"9143","28379","2018",3,3,0,141613.3,2014.333,64
"9144","28380","2018",25,25,0,208074,1782.36,120.08
"9145","28382","2018",9,9,0,129245.6,1507.778,93.77778
"9146","28383","2018",10,10,0,153645,1532.6,102.6
"9147","28385","2018",8,8,0,90345.62,1000.25,86.25
"9148","28386","2018",16,16,0,149023.1,1367.938,113.1875
"9149","28387","2018",6,5,1,126358.3,1729,108.8333
"9150","28388","2018",21,21,0,197090.5,2041.762,101.381
"9151","28389","2018",5,5,0,97200,1120.6,83.4
"9152","28390","2018",3,3,0,116166.7,1267.333,99.33333
"9153","28391","2018",41,37,4,131454.1,1472.195,94
"9154","28392","2018",4,4,0,162803.2,1437,112.25
"9155","28393","2018",28,28,0,157203.9,1611.107,103.5
"9156","28394","2018",16,16,0,155920.6,1517.625,110.4375
"9157","28395","2018",5,5,0,114360,1299,93.6
"9158","28396","2018",1,1,0,162855,1147,142
"9159","28397","2018",9,9,0,209630.6,1897.556,117.6667
"9160","28398","2018",26,26,0,124350.5,1434.808,94.46154
"9161","28400","2018",2,2,0,190237.5,951,217
"9162","28401","2018",4,4,0,110750,1323.25,82.25
"9163","28403","2018",5,5,0,245950,1770.8,147.6
"9164","28404","2018",92,76,16,153225,1777.783,87.61957
"9165","28405","2018",15,15,0,160172.9,1444.467,114.2
"9166","28406","2018",19,19,0,93916.32,1067.579,91.47368
"9167","28407","2018",4,4,0,116975,1114,107.75
"9168","28408","2018",3,3,0,160000,1199,146.3333
"9169","28409","2018",2,2,0,153000,1572,102.5
"9170","28410","2018",4,4,0,85175,963,80
"9171","28411","2018",4,4,0,148657.5,1365.75,102.5
"9172","28415","2018",24,24,0,167532.1,1655.208,103.25
"9173","28417","2018",19,19,0,204354.5,1968,115.2105
"9174","28418","2018",1,1,0,130000,743,175
"9175","28419","2018",5,5,0,126080,1632,94.8
"9176","28421","2018",3,3,0,178000,1840,98.66667
"9177","28422","2018",55,51,4,123257.3,1405.782,91.18182
"9178","28423","2018",7,7,0,167685.7,2206,82.28571
"9179","28424","2018",27,27,0,111642.2,1149.926,93.55556
"9180","28425","2018",6,6,0,212000,1985.667,115
"9181","28426","2018",4,4,0,142125,959.25,133.25
"9182","29001","2018",17,17,0,120193.7,1255.882,101.7059
"9183","29002","2018",13,13,0,136215.4,1296.385,101.9231
"9184","29003","2018",79,62,17,131845.1,1701.924,82.6962
"9185","29004","2018",85,83,2,125348.6,1287.424,99.74118
"9186","29005","2018",20,20,0,178599,1681.65,110
"9187","29006","2018",115,49,66,195523,2694.765,71.6
"9188","29007","2018",14,14,0,73666.57,1233.714,66.5
"9189","29008","2018",10,10,0,113980,1329,95.7
"9190","29010","2018",8,8,0,98312.5,1081,86.75
"9191","29011","2018",24,24,0,225019.7,1835.833,121.9583
"9192","29012","2018",8,8,0,47475.5,582.375,84.5
"9193","29013","2018",3,3,0,47000,647.3333,83.66667
"9194","29014","2018",5,5,0,81216,850.8,104.8
"9195","29015","2018",28,28,0,180782.5,1767.036,104.5357
"9196","29016","2018",5,5,0,111241.4,1071.6,102.8
"9197","29017","2018",18,18,0,150481.7,1533.778,100.2778
"9198","29018","2018",3,3,0,46906.67,599,81
"9199","29019","2018",2862,726,2136,110456.9,1495.928,72.75961
"9200","29020","2018",57,57,0,139328.8,1253.035,112.6491
"9201","29021","2018",28,26,2,144432,1607.25,90.21429
"9202","29022","2018",60,53,7,147047.3,1745.967,90.51667
"9203","29023","2018",68,58,10,232774.8,2267.5,103.1618
"9204","29024","2018",78,68,10,87819.88,976.4359,89.47436
"9205","29025","2018",29,28,1,119226,1208.517,106.9655
"9206","29026","2018",51,37,14,92770.27,1301.843,82.17647
"9207","29027","2018",44,42,2,89555.75,901.1364,96.61364
"9208","29028","2018",11,11,0,114941.9,1297.909,91
"9209","29029","2018",14,14,0,103559.9,992,101.6429
"9210","29030","2018",46,46,0,134030,1391.283,100.2609
"9211","29031","2018",108,94,14,258087.3,2600.565,102.8519
"9212","29032","2018",21,21,0,232776.2,2066.857,112
"9213","29033","2018",3,3,0,59333.33,815,82
"9214","29034","2018",3,3,0,36833.33,754.3333,51
"9215","29035","2018",13,13,0,149721.1,1518.154,100.9231
"9216","29036","2018",12,12,0,72358.33,728.3333,102.9167
"9217","29037","2018",63,46,17,216583.5,2092.397,102
"9218","29038","2018",12,12,0,77810,710.3333,115
"9219","29039","2018",388,220,168,176703.7,2171.874,82.74227
"9220","29040","2018",53,43,10,219118.1,2064.434,108.7736
"9221","29041","2018",21,21,0,143058.6,1445,98.52381
"9222","29042","2018",135,116,19,162657.9,1977.037,85.98519
"9223","29043","2018",22,22,0,169462.7,1712.636,100.8182
"9224","29044","2018",13,13,0,108867.1,1193.615,101.4615
"9225","29045","2018",20,20,0,163205.6,1823.25,90.7
"9226","29046","2018",254,178,76,122044.2,1416.85,88.92913
"9227","29047","2018",13,13,0,152951.7,1390.692,111.4615
"9228","29048","2018",16,16,0,118993.8,1227.5,94.875
"9229","29049","2018",33,33,0,141845.2,1249.121,118.6364
"9230","29051","2018",81,78,3,169964.8,1643.025,107.037
"9231","29053","2018",27,27,0,128028.1,1331.741,97.14815
"9232","29054","2018",12,12,0,51750,806.25,63
"9233","29055","2018",47,44,3,149269.1,1443.957,105.0851
"9234","29056","2018",20,20,0,186202.5,1905.25,101
"9235","29057","2018",68,56,12,227644.3,2331.059,99.45588
"9236","29058","2018",168,121,47,230718.9,2375.839,100.6131
"9237","29059","2018",7,7,0,117692.9,1273.286,90.28571
"9238","29060","2018",38,38,0,206759.7,1836.763,113.3421
"9239","29061","2018",43,40,3,203331.2,1955.209,107.814
"9240","29062","2018",15,14,1,98138.47,1014,89.86667
"9241","29063","2018",8,8,0,92125,1046.375,88.5
"9242","29064","2018",3,3,0,84333.33,1296,57.33333
"9243","29065","2018",13,13,0,120576.9,1328.538,95.69231
"9244","29066","2018",21,21,0,170123.8,1428.286,118.619
"9245","29067","2018",26,25,1,95868.31,979.3846,100.8077
"9246","29068","2018",26,26,0,116808.7,1218.923,98.26923
"9247","29069","2018",76,71,5,177650.6,1730.934,105.1711
"9248","29070","2018",2,2,0,77500,938.5,82.5
"9249","29071","2018",10,10,0,161300,1466.8,106.1
"9250","29072","2018",76,61,15,120073.3,1586.211,82.34211
"9251","29073","2018",11,11,0,154000,1348.818,110.3636
"9252","29074","2018",11,11,0,95581.82,1014.727,94.81818
"9253","29075","2018",137,109,28,199509.1,1970.241,103.0876
"9254","29076","2018",46,46,0,188867.3,1687.739,112.5652
"9255","29077","2018",32,32,0,132590,1433.531,91.78125
"9256","29078","2018",26,26,0,121223.3,1314.115,92.34615
"9257","29079","2018",17,17,0,127695.9,1315.176,93.47059
"9258","29080","2018",26,26,0,149661.5,1635.269,94.34615
"9259","29081","2018",42,38,4,89408.1,979.1667,88.64286
"9260","29082","2018",9,8,1,298666.7,3296.444,85.11111
"9261","29085","2018",27,21,6,240875,3017.296,76.92593
"9262","29086","2018",9,9,0,135583.3,1397.556,97.22222
"9263","29087","2018",11,11,0,119586.4,1116.727,107.6364
"9264","29089","2018",10,10,0,96621.3,1689.9,83
"9265","29090","2018",9,9,0,180186.7,1587.333,114.1111
"9266","29091","2018",29,29,0,120835.5,1374.483,95.65517
"9267","29093","2018",7,7,0,149000,1414.429,114.4286
"9268","29094","2018",10,9,1,137028,1346.4,102.6
"9269","29095","2018",18,18,0,172300.1,1727.889,102.0556
"9270","29097","2018",23,23,0,104258.7,1000.826,109
"9271","29098","2018",41,38,3,164958.5,1717.366,99.82927
"9272","29099","2018",14,14,0,149826.9,1311,111.8571
"9273","29100","2018",3,3,0,139553.3,1206.667,108.6667
"9274","29101","2018",51,50,1,175657.8,1996.412,91.5098
"9275","29102","2018",11,11,0,68804.55,772.1818,89
"9276","29103","2018",243,155,88,133949,1535.078,87.55967
"9277","29104","2018",6,6,0,132583.3,1366.833,90.83333
"9278","29105","2018",119,100,19,120250,1201.513,100.4622
"9279","29106","2018",21,21,0,127511.4,1226.333,103.381
"9280","29107","2018",8,8,0,122000,1318.25,93.25
"9281","29108","2018",9,9,0,177741.1,1547.667,118.5556
"9282","29109","2018",24,24,0,207032.5,1911.5,106.2917
"9283","29110","2018",17,17,0,141702.9,1235.588,116.5294
"9284","29111","2018",11,10,1,130000,1193.636,107.5455
"9285","29112","2018",17,17,0,138411.8,1697.588,84.64706
"9286","29113","2018",32,32,0,115887.5,1302.969,90.53125
"9287","29114","2018",3,3,0,69000,938.6667,72.66667
"9288","29115","2018",6,6,0,95816.67,897.1667,108.5
"9289","29116","2018",1,1,0,45100,673,67
"9290","29117","2018",72,67,5,134595.8,1421.903,95.16667
"9291","29119","2018",14,14,0,142535.7,1326.643,107.0714
"9292","29120","2018",29,18,11,102807.7,1058.207,92.86207
"9293","29122","2018",11,11,0,101209.2,1004.364,100
"9294","29123","2018",10,10,0,107180,871,120.1
"9295","29124","2018",100,81,19,116312,1269.8,91.01
"9296","29125","2018",12,12,0,62903.33,887.3333,76.5
"9297","29126","2018",3,3,0,147666.7,1115,129.6667
"9298","29128","2018",2,2,0,88880,944,98
"9299","29130","2018",57,53,4,224000.9,1992.07,111.0877
"9300","29131","2018",3,3,0,131666.7,1242,105.6667
"9301","29132","2018",16,16,0,149843.8,1537.562,101.3125
"9302","29133","2018",36,32,4,259256.1,2784.194,100.6667
"9303","29134","2018",17,17,0,121735.3,1453.647,82
"9304","29135","2018",88,76,12,190724.2,2085.386,98.18182
"9305","29136","2018",16,15,1,130056.2,1138.25,112.125
"9306","29137","2018",42,41,1,155410.8,1596.619,99.16667
"9307","29139","2018",11,11,0,110651.9,1138.091,97
"9308","29140","2018",40,40,0,186968,1745.325,107.625
"9309","29141","2018",10,10,0,66020,735.3,90.1
"9310","29142","2018",6,6,0,122416.7,1180.667,101.8333
"9311","29143","2018",12,12,0,160191.7,1379.667,119.3333
"9312","29144","2018",11,11,0,112681.8,1150.273,101
"9313","29145","2018",9,9,0,135888.9,1403.111,98.22222
"9314","29146","2018",33,33,0,157054.8,1497.333,107.7879
"9315","29147","2018",36,33,3,175165.4,2017.75,92.38889
"9316","29148","2018",9,9,0,91722.22,935.2222,100.4444
"9317","29150","2018",112,99,13,167384.4,1973.634,89.26786
"9318","29151","2018",278,158,120,97314.81,1162.558,82.02518
"9319","29152","2018",7,7,0,102271.4,1128.429,86.85714
"9320","29153","2018",49,44,5,202453.1,2089.327,103.0612
"9321","29155","2018",11,10,1,168818.2,2263.636,79.90909
"9322","29156","2018",18,18,0,167565.4,1545.556,111.7222
"9323","29158","2018",117,110,7,146995.5,1707.017,88.34188
"9324","29159","2018",12,12,0,86625,1015.167,90.5
"9325","29160","2018",94,85,9,168109.4,1706.702,101.0851
"9326","29161","2018",37,34,3,205033.9,2071.865,103.027
"9327","29162","2018",46,45,1,103456.5,1178.196,89.84783
"9328","29163","2018",37,37,0,87704.59,976.3514,90.48649
"9329","29165","2018",62,54,8,166011.8,1876.79,95.56452
"9330","29166","2018",6,6,0,135666.7,1245.667,108.8333
"9331","29167","2018",28,27,1,113399.3,1176.714,98.07143
"9332","29168","2018",19,19,0,131378.9,1739.842,81.68421
"9333","29169","2018",32,32,0,131575.5,1266.188,106.4375
"9334","29170","2018",32,29,3,165717.4,1646.156,102.1562
"9335","29171","2018",40,39,1,163261.5,1639.15,102.925
"9336","29172","2018",29,27,2,144751,1347.724,114.3103
"9337","29173","2018",21,21,0,167744.2,1549.095,111.381
"9338","29174","2018",74,72,2,159992.5,1620.568,102.0405
"9339","29175","2018",34,33,1,59208.82,749.5588,80.29412
"9340","29176","2018",20,20,0,140472,1530.3,101.45
"9341","29177","2018",46,45,1,174700.2,1755.152,101.1304
"9342","29178","2018",85,81,4,163360.5,1639.671,101.0471
"9343","29179","2018",34,34,0,153811.8,1452.088,107.2941
"9344","29180","2018",7,7,0,116857.1,1366.857,109.8571
"9345","29181","2018",38,38,0,152914.3,1396.237,111
"9346","29182","2018",13,13,0,103688.5,1090.154,93.53846
"9347","29183","2018",13,13,0,124163.3,1262.538,101.1538
"9348","29184","2018",33,33,0,100893.9,1090.485,93.84848
"9349","29185","2018",65,62,3,133060.9,1451.185,96.49231
"9350","29186","2018",17,17,0,157823.5,1595.353,106.4706
"9351","29187","2018",9,9,0,111602.7,905.5556,131.2222
"9352","29188","2018",73,69,4,196613.7,1946.945,103.3973
"9353","29189","2018",136,121,15,202943.3,1972.978,103
"9354","29190","2018",83,61,22,196409,2171.916,91.51807
"9355","29191","2018",42,42,0,107264.5,1077.881,102.4286
"9356","29192","2018",24,24,0,163500,1353.542,115.0833
"9357","29193","2018",16,16,0,119674.3,1204.938,101.4375
"9358","29195","2018",94,93,1,148567.8,1687.872,96.03191
"9359","29196","2018",19,19,0,128716.3,1372.684,96.10526
"9360","29197","2018",82,78,4,128345.3,1409.841,92.47561
"9361","29198","2018",33,33,0,127552.1,1187.636,110.6061
"9362","29199","2018",32,32,0,120405.5,1301.281,94.25
"9363","29201","2018",21,21,0,189595.9,1820.19,103.2381
"9364","29202","2018",16,16,0,88418.75,971.75,90.0625
"9365","29204","2018",22,22,0,139212.8,1265.136,111.2727
"9366","29205","2018",14,14,0,102979,1046.071,100.2143
"9367","29206","2018",27,27,0,119428.1,1216.63,102.7037
"9368","29207","2018",37,37,0,116425.9,1224.297,99.72973
"9369","29208","2018",14,14,0,129254,1154.857,119.8571
"9370","29209","2018",48,48,0,155012.1,1508.271,105.6667
"9371","29210","2018",29,29,0,112117.9,1177.276,106.1724
"9372","29211","2018",9,9,0,101242.2,1014.333,93.88889
"9373","29212","2018",121,117,4,194201.4,1851.537,109.7851
"9374","29213","2018",13,13,0,123551.6,1119.769,116.4615
"9375","29214","2018",10,10,0,182810,1705.3,106.3
"9376","29215","2018",48,48,0,159300.6,1716.688,96.6875
"9377","29216","2018",37,37,0,159678.9,1559.514,105.7838
"9378","29217","2018",41,36,5,153684.4,1677.39,88.70732
"9379","29218","2018",25,23,2,107780,1168.52,94.64
"9380","29220","2018",150,113,37,138574.5,1585.74,89.72667
"9381","29221","2018",36,36,0,194591.9,2091.361,102.1667
"9382","29222","2018",10,7,3,83400,926.3,92.8
"9383","29224","2018",15,15,0,121174.7,1190.133,102.4667
"9384","29225","2018",24,24,0,125750,1361.958,97.29167
"9385","29226","2018",18,17,1,122331.6,1440.278,97.66667
"9386","29227","2018",27,27,0,84107.93,931.4815,92.92593
"9387","29228","2018",10,9,1,114570,1061.3,104.1
"9388","29229","2018",11,11,0,83466.36,1043.364,89.36364
"9389","29230","2018",16,16,0,123575,1019.625,121.125
"9390","29232","2018",1264,559,705,120366.8,1538.675,77.04589
"9391","29233","2018",181,132,49,129086.5,1430.785,88.92265
"9392","29234","2018",22,22,0,178690.7,1627.364,110.7273
"9393","29235","2018",162,120,42,193693.6,2045.914,93.85802
"9394","29236","2018",56,55,1,171580.4,1824.911,101.5
"9395","29237","2018",18,18,0,140972.2,1388.667,106
"9396","29238","2018",25,25,0,165586,2016.72,89.92
"9397","29239","2018",55,27,28,150638.3,2101.6,70.98182
"9398","29240","2018",16,16,0,150496.9,1387.5,109.5625
"9399","29241","2018",139,122,17,104627.2,1239.561,85.86331
"9400","29243","2018",6,6,0,104866.7,985.8333,98.83333
"9401","29244","2018",8,8,0,113062.5,995,111.625
"9402","29245","2018",15,15,0,175800,1572.667,111.5333
"9403","29246","2018",5,5,0,130820,1448.2,88.8
"9404","29247","2018",50,49,1,176308.9,1755.9,101.92
"9405","29248","2018",9,9,0,115733.3,1078.667,111
"9406","29249","2018",9,9,0,77655.56,893.1111,85.33333
"9407","29250","2018",12,12,0,88840,1123.583,83.16667
"9408","29251","2018",10,10,0,140656.6,1709.6,93.6
"9409","29252","2018",26,26,0,157846.2,1589.385,103.3077
"9410","29254","2018",78,71,7,105233.7,1151.359,92.12821
"9411","29255","2018",8,8,0,157137.5,1667.875,96.125
"9412","29256","2018",23,11,12,91953.61,1770.348,65.86957
"9413","29257","2018",26,25,1,169469.6,1695.577,98.76923
"9414","29259","2018",104,87,17,132651.5,1415.817,99.44231
"9415","29260","2018",104,86,18,171301.5,1811.99,98.21154
"9416","29261","2018",1,1,0,40674,542,75
"9417","29262","2018",8,8,0,120616,1032.625,116.625
"9418","29263","2018",11,10,1,100063.6,1050.818,96.54545
"9419","29264","2018",4,4,0,109875,1305.25,83.25
"9420","29265","2018",5,5,0,146500,1238,120.4
"9421","29266","2018",21,21,0,90865.48,1068.714,87.42857
"9422","29267","2018",10,9,1,55970,876.2,67.1
"9423","29268","2018",18,18,0,185711.6,1780.833,105.2222
"9424","29269","2018",15,15,0,100486.7,1202.2,81.53333
"9425","29270","2018",11,11,0,201000,2061.273,106.1818
"9426","29271","2018",11,11,0,128091.9,1197.182,106.3636
"9427","29272","2018",29,29,0,151994.8,1598.966,102.6552
"9428","29273","2018",28,28,0,196799.1,1839.036,108.8214
"9429","29274","2018",63,63,0,91447.7,1044.365,90.36508
"9430","29275","2018",22,22,0,67704.55,919.6818,76.63636
"9431","29276","2018",11,11,0,123513.6,1385.727,87.09091
"9432","29277","2018",34,34,0,103376.5,1047.265,96.26471
"9433","29278","2018",22,22,0,73847.18,1014.136,76.81818
"9434","29279","2018",31,31,0,118574.2,1182.258,101.129
"9435","29280","2018",38,36,2,154239.1,1471.395,104.6316
"9436","29281","2018",12,12,0,95083.33,997.9167,94
"9437","29282","2018",1,1,0,222000,1930,115
"9438","29284","2018",47,47,0,160852.6,1599.574,103.4681
"9439","29285","2018",2,2,0,55750,771,71.5
"9440","29286","2018",4,4,0,130750,1451.5,91.75
"9441","29287","2018",17,17,0,123320.5,1270.176,99.41176
"9442","29288","2018",4,4,0,143750,1114.25,131
"9443","29289","2018",2,2,0,134000,1611,82.5
"9444","29290","2018",7,7,0,129400,1452.571,87.71429
"9445","29291","2018",14,14,0,99200.71,973.9286,102.9286
"9446","29292","2018",7,7,0,181714.3,2456.143,89
"9447","29293","2018",114,102,12,183473.9,1892.298,99.13158
"9448","29294","2018",6,6,0,166498.5,1194.667,135.5
"9449","29295","2018",9,9,0,145470.1,1227.889,126.1111
"9450","29296","2018",15,15,0,186937.5,1582.667,117
"9451","29297","2018",28,28,0,151271.4,1446.286,106.3214
"9452","29298","2018",4,4,0,154750,2180.5,74.25
"9453","29299","2018",1,1,0,209800,1116,188
"9454","29300","2018",19,19,0,120710.5,1303.842,92.73684
"9455","29301","2018",3,3,0,135000,1268.667,108.3333
"9456","29302","2018",55,54,1,103537.3,1021.309,98.87273
"9457","2A001","2018",13,11,2,374187.7,3259,118.3077
"9458","2A004","2018",822,46,776,217939.3,3150.406,69.70681
"9459","2A006","2018",25,24,1,393130.7,3374.24,112.12
"9460","2A008","2018",42,18,24,366480.1,4669.381,78
"9461","2A011","2018",1,0,1,195000,1893,103
"9462","2A017","2018",13,11,2,259434.6,3322.692,86.69231
"9463","2A019","2018",4,2,2,60250,1008.5,59.5
"9464","2A021","2018",2,0,2,65000,2160.5,47
"9465","2A024","2018",5,2,3,75800,966.2,83.6
"9466","2A026","2018",2,2,0,284900,3137,91
"9467","2A028","2018",3,2,1,143833.3,1406.667,93
"9468","2A031","2018",7,6,1,135671.4,2113.857,79
"9469","2A032","2018",28,23,5,322186.1,3445.464,98.39286
"9470","2A035","2018",4,2,2,501783,7009,60
"9471","2A040","2018",5,3,2,127800,2001.4,63.8
"9472","2A041","2018",45,13,32,257512.5,3969.267,67.6
"9473","2A048","2018",26,8,18,197497.3,3719.269,59.80769
"9474","2A061","2018",1,0,1,137600,1404,98
"9475","2A062","2018",2,1,1,93500,2681.5,33.5
"9476","2A065","2018",17,11,6,295841.8,4202.588,63.35294
"9477","2A070","2018",7,0,7,160930.3,4308.714,37.71429
"9478","2A071","2018",2,2,0,148455,2354.5,62.5
"9479","2A085","2018",18,13,5,348642.2,3612.722,102.4444
"9480","2A089","2018",4,2,2,44733.5,901.5,46.75
"9481","2A090","2018",12,5,7,218955.6,3536.333,62.25
"9482","2A091","2018",1,0,1,40000,1667,24
"9483","2A092","2018",17,9,8,284017.2,4027.706,66.41176
"9484","2A098","2018",17,13,4,793688.2,5516.647,129.5294
"9485","2A099","2018",2,2,0,87500,1254,79
"9486","2A103","2018",5,4,1,249965.8,3189,92.2
"9487","2A104","2018",5,5,0,244267,1679.4,145
"9488","2A108","2018",3,2,1,59972,1163,57.33333
"9489","2A114","2018",8,5,3,195537.5,2902.625,59.375
"9490","2A115","2018",1,1,0,378500,3154,120
"9491","2A119","2018",4,3,1,107500,1246,85
"9492","2A128","2018",2,1,1,104000,990.5,95.5
"9493","2A129","2018",2,1,1,357500,1819,195
"9494","2A130","2018",53,23,30,324375.4,3979.038,76.71698
"9495","2A131","2018",1,1,0,130000,1477,88
"9496","2A132","2018",1,1,0,140000,2456,57
"9497","2A133","2018",1,0,1,30000,462,65
"9498","2A139","2018",36,26,10,627077.1,5954.389,94.80556
"9499","2A141","2018",1,0,1,15000,938,16
"9500","2A142","2018",4,3,1,102965,1503.75,72.25
"9501","2A154","2018",1,0,1,38100,1058,36
"9502","2A160","2018",2,2,0,115685,1483.5,73.5
"9503","2A163","2018",2,2,0,265571,2797,95.5
"9504","2A174","2018",2,2,0,181750,2175,81.5
"9505","2A181","2018",1,1,0,284000,2367,120
"9506","2A186","2018",2,2,0,47500,1065.5,48
"9507","2A189","2018",7,2,5,189248.6,3570.143,58.28571
"9508","2A196","2018",2,1,1,96500,2370.5,39
"9509","2A197","2018",1,1,0,252000,2520,100
"9510","2A198","2018",6,2,4,247016.7,3690.5,62.83333
"9511","2A200","2018",1,0,1,30000,612,49
"9512","2A209","2018",11,10,1,259389.2,2375.545,109.8182
"9513","2A211","2018",4,4,0,132900,3332.75,50.75
"9514","2A215","2018",3,3,0,580400,3781.667,144.6667
"9515","2A228","2018",30,18,12,453159.2,5203.233,84.26667
"9516","2A232","2018",2,2,0,380000,3115,125
"9517","2A240","2018",1,1,0,115000,2875,40
"9518","2A247","2018",190,96,94,417196.9,4588.042,88.51053
"9519","2A249","2018",54,9,45,234156.3,3538.907,67.2963
"9520","2A254","2018",4,4,0,90226.25,1602.25,47.5
"9521","2A258","2018",2,1,1,61000,1972,33
"9522","2A259","2018",1,1,0,63026,863,73
"9523","2A262","2018",2,2,0,93500,1107.5,84.5
"9524","2A268","2018",1,0,1,30000,375,80
"9525","2A269","2018",29,10,19,255884.7,3019.862,81.55172
"9526","2A270","2018",2,1,1,186572.5,2691.5,75
"9527","2A271","2018",32,8,24,237220.4,3334.25,71.96875
"9528","2A272","2018",34,12,22,220696.5,3023.853,70.67647
"9529","2A276","2018",8,5,3,317560.2,3941.75,95.75
"9530","2A278","2018",1,0,1,48500,1386,35
"9531","2A282","2018",1,1,0,1e+05,1176,85
"9532","2A284","2018",4,2,2,202500,1758.5,92
"9533","2A285","2018",1,1,0,142000,1420,100
"9534","2A288","2018",10,9,1,319560.5,2406,112
"9535","2A295","2018",1,1,0,93860,911,103
"9536","2A300","2018",8,6,2,411505.2,3906.75,78.875
"9537","2A308","2018",2,1,1,23750,497,47
"9538","2A312","2018",4,3,1,171950,2065.75,79.75
"9539","2A323","2018",3,3,0,273050,3018.667,94.66667
"9540","2A324","2018",5,3,2,182000,1689.6,102.4
"9541","2A326","2018",2,1,1,112500,3411.5,34
"9542","2A330","2018",5,5,0,176652.8,2156.2,79.2
"9543","2A336","2018",1,1,0,340000,3953,86
"9544","2A345","2018",2,2,0,150000,1493.5,109.5
"9545","2A348","2018",17,6,11,296309.3,4058.294,74
"9546","2A349","2018",10,8,2,344787,4796.3,88.3
"9547","2A351","2018",3,3,0,339743.3,3173,105.3333
"9548","2A357","2018",2,1,1,87350,2988,29.5
"9549","2A359","2018",2,1,1,107500,1419.5,74
"9550","2A360","2018",1,1,0,150000,1705,88
"9551","2A362","2018",54,42,12,548351,4364.222,108.0741
"9552","2B002","2018",1,1,0,60000,652,92
"9553","2B007","2018",1,0,1,20000,1176,17
"9554","2B009","2018",6,5,1,165241.7,1820.333,93.16667
"9555","2B010","2018",11,3,8,209930.7,4580,58.18182
"9556","2B012","2018",1,1,0,17500,875,20
"9557","2B016","2018",3,1,2,109333.3,965,88.33333
"9558","2B020","2018",5,1,4,127800,3017,43
"9559","2B029","2018",6,3,3,178625,2421.167,75.5
"9560","2B033","2018",380,18,362,164774.7,2381.887,69.64474
"9561","2B034","2018",28,6,22,132680.9,3348.429,41.21429
"9562","2B036","2018",1,1,0,220000,1630,135
"9563","2B037","2018",63,25,38,211044.3,2790.175,80.22222
"9564","2B039","2018",2,2,0,119500,1577.5,63
"9565","2B042","2018",139,60,79,171107.5,2573.022,68.64029
"9566","2B043","2018",18,8,10,283460.3,3256,78.44444
"9567","2B046","2018",2,2,0,130000,2293,51.5
"9568","2B047","2018",2,1,1,50750,665,75
"9569","2B049","2018",28,20,8,228393.6,2828.357,81.03571
"9570","2B050","2018",136,9,127,185377.6,3790.132,51.36765
"9571","2B051","2018",2,2,0,86000,1461.5,78
"9572","2B054","2018",3,2,1,108666.7,1503,72.66667
"9573","2B057","2018",6,3,3,169887.2,2828.667,64.16667
"9574","2B058","2018",6,5,1,170660,2336,72.33333
"9575","2B069","2018",2,2,0,84375,1141.5,63
"9576","2B074","2018",1,1,0,150000,1456,103
"9577","2B077","2018",5,4,1,171600,1685.8,103.4
"9578","2B079","2018",3,2,1,186350,1898.333,103.3333
"9579","2B080","2018",4,3,1,170000,1861.25,97
"9580","2B082","2018",1,0,1,230000,3067,75
"9581","2B083","2018",1,1,0,142500,1583,90
"9582","2B084","2018",2,0,2,231000,2326,92
"9583","2B086","2018",2,2,0,201500,3109,55
"9584","2B087","2018",17,4,13,150120,1639.118,81.70588
"9585","2B088","2018",3,3,0,150666.7,1709.667,74.33333
"9586","2B093","2018",13,11,2,716520.8,5737.769,116.4615
"9587","2B095","2018",2,1,1,104000,1210,72.5
"9588","2B096","2018",53,1,52,116168.9,2269.792,54.66038
"9589","2B097","2018",1,1,0,130000,2167,60
"9590","2B107","2018",6,5,1,257833.3,3968.833,61.5
"9591","2B109","2018",4,4,0,176950,2318,67.5
"9592","2B112","2018",2,0,2,85000,1059.5,92.5
"9593","2B120","2018",31,19,12,263271.7,3018.194,91.87097
"9594","2B121","2018",1,1,0,115000,1055,109
"9595","2B123","2018",24,16,8,210929.9,2221.792,95
"9596","2B124","2018",2,1,1,61245,1482.5,47
"9597","2B134","2018",54,5,49,214639.6,3730.259,60.7037
"9598","2B135","2018",2,1,1,140255,1761.5,76
"9599","2B136","2018",2,1,1,73500,1939,37.5
"9600","2B138","2018",1,1,0,340000,3820,89
"9601","2B140","2018",1,1,0,130000,2167,60
"9602","2B143","2018",12,8,4,130611.7,2004.417,61.33333
"9603","2B145","2018",1,0,1,30000,625,48
"9604","2B148","2018",60,34,26,203338,2474.167,87.91667
"9605","2B149","2018",1,1,0,80000,645,124
"9606","2B150","2018",50,12,38,292588.6,4770.66,67.92
"9607","2B152","2018",10,3,7,168000,2427.1,65.7
"9608","2B153","2018",1,0,1,82400,2747,30
"9609","2B159","2018",1,1,0,33250,605,55
"9610","2B162","2018",2,2,0,89000,649,144
"9611","2B164","2018",2,2,0,50000,745.5,68
"9612","2B165","2018",1,1,0,112500,2885,39
"9613","2B166","2018",3,2,1,140000,1545,74.33333
"9614","2B167","2018",5,3,2,133812,1822.2,72.4
"9615","2B168","2018",20,10,10,367079.5,4251.85,82.05
"9616","2B169","2018",4,3,1,146250,1620.5,101.25
"9617","2B170","2018",1,1,0,70000,2917,24
"9618","2B172","2018",5,3,2,290400,2567.4,93
"9619","2B173","2018",5,3,2,188100,3164.6,66
"9620","2B175","2018",2,1,1,116000,2551.5,48.5
"9621","2B178","2018",3,1,2,169000,3752.333,61.66667
"9622","2B180","2018",2,1,1,160000,1820,70
"9623","2B182","2018",2,2,0,204000,1846.5,106
"9624","2B183","2018",2,0,2,66250,2458.5,29
"9625","2B184","2018",1,0,1,120000,1846,65
"9626","2B185","2018",21,10,11,278072.3,2916.429,93.61905
"9627","2B188","2018",6,3,3,144931.7,2328.667,64
"9628","2B190","2018",1,0,1,1e+05,952,105
"9629","2B193","2018",1,1,0,68500,1087,63
"9630","2B195","2018",2,2,0,138000,1939.5,69
"9631","2B199","2018",2,2,0,72500,1399,55.5
"9632","2B205","2018",9,4,5,141000,2972,53.55556
"9633","2B207","2018",32,15,17,170532.8,2299,74.375
"9634","2B210","2018",1,1,0,1e+05,1190,84
"9635","2B223","2018",3,2,1,72000,1242,61.33333
"9636","2B224","2018",9,8,1,244755.8,2985.667,91.11111
"9637","2B225","2018",3,1,2,105133.3,1818,53
"9638","2B226","2018",1,0,1,158000,1097,144
"9639","2B229","2018",1,1,0,220000,2075,106
"9640","2B230","2018",3,3,0,219773.3,2472.333,80
"9641","2B231","2018",1,0,1,271430,9048,30
"9642","2B233","2018",3,3,0,402636.7,4312.333,89.66667
"9643","2B235","2018",2,1,1,139000,1855.5,72.5
"9644","2B236","2018",2,1,1,90000,1509,58
"9645","2B238","2018",2,1,1,145850,1243,102.5
"9646","2B241","2018",1,1,0,225000,2616,86
"9647","2B242","2018",17,17,0,127101.5,2593.706,52
"9648","2B246","2018",2,2,0,53500,686,77.5
"9649","2B250","2018",2,2,0,179800,1461.5,123
"9650","2B251","2018",37,29,8,213290.4,2331.649,98.83784
"9651","2B257","2018",2,1,1,165000,3777,40.5
"9652","2B261","2018",12,8,4,204870,2895,83
"9653","2B263","2018",1,0,1,83600,1858,45
"9654","2B265","2018",4,4,0,124178.8,1712.25,81.5
"9655","2B274","2018",1,0,1,110000,2340,47
"9656","2B275","2018",1,0,1,50000,1111,45
"9657","2B277","2018",3,3,0,187876.7,1754.333,104
"9658","2B281","2018",12,10,2,270973.9,3406.583,94.58333
"9659","2B283","2018",7,5,2,205285.7,2934.857,77.85714
"9660","2B286","2018",4,4,0,193525,3445.75,75
"9661","2B287","2018",1,1,0,150000,1875,80
"9662","2B290","2018",2,0,2,149000,4531.5,43.5
"9663","2B292","2018",2,2,0,36950,604.5,66.5
"9664","2B293","2018",2,1,1,83500,1639.5,49
"9665","2B297","2018",1,1,0,262000,3493,75
"9666","2B298","2018",20,6,14,483839.6,5210.85,84.45
"9667","2B301","2018",1,1,0,135000,1452,93
"9668","2B303","2018",4,4,0,120000,1616,69.5
"9669","2B304","2018",1,1,0,70000,680,103
"9670","2B305","2018",19,1,18,244290.1,3024.158,77.73684
"9671","2B306","2018",1,0,1,40000,667,60
"9672","2B307","2018",23,11,12,154185.4,2601.783,63.13043
"9673","2B309","2018",21,11,10,346264,2952.714,100.4286
"9674","2B311","2018",12,11,1,171337.5,2733,74.33333
"9675","2B313","2018",60,14,46,122086.6,2355.183,55.41667
"9676","2B314","2018",5,5,0,181000,1798.2,77
"9677","2B316","2018",6,4,2,312725.8,3731.167,81.83333
"9678","2B318","2018",6,4,2,222839.8,3314.167,74
"9679","2B319","2018",4,3,1,229581.5,2270.75,101.75
"9680","2B327","2018",4,3,1,211450,3010.5,75.5
"9681","2B332","2018",1,1,0,76000,2375,32
"9682","2B333","2018",2,1,1,150000,2275.5,60.5
"9683","2B335","2018",1,1,0,315000,3500,90
"9684","2B337","2018",1,1,0,410132,2182,188
"9685","2B341","2018",7,2,5,98009,1209.143,82.14286
"9686","2B342","2018",13,12,1,228350.8,2371.769,97.07692
"9687","2B343","2018",13,11,2,187692.3,2274.385,86.23077
"9688","2B346","2018",18,11,7,190891.7,2208.444,85.55556
"9689","2B347","2018",3,2,1,118666.7,982.6667,102.3333
"9690","2B350","2018",2,1,1,52500,763.5,65.5
"9691","2B352","2018",3,2,1,210048.3,2328.667,86.33333
"9692","2B353","2018",49,8,41,240586.7,2790.592,85.85714
"9693","2B355","2018",4,3,1,113750,1704.5,59.75
"9694","2B356","2018",2,1,1,72500,2000,45
"9695","2B361","2018",3,3,0,255000,3513,70.66667
"9696","2B366","2018",1,1,0,17400,527,33
"9697","30001","2018",8,8,0,455525.6,3338.375,136.25
"9698","30002","2018",5,5,0,230030,2063.8,108.4
"9699","30003","2018",168,136,32,301099.4,3309.607,89.875
"9700","30004","2018",14,12,2,212198.6,2138.071,101.1429
"9701","30005","2018",1,0,1,145000,1295,112
"9702","30006","2018",101,84,17,200182.7,2296.812,88.40594
"9703","30007","2018",513,256,257,123159.3,1533.312,79.93177
"9704","30008","2018",15,14,1,179672.6,1692.8,104.0667
"9705","30009","2018",2,2,0,105000,926,123.5
"9706","30010","2018",32,23,9,168142.2,1977.469,85.46875
"9707","30011","2018",142,81,61,219253.2,2671.979,82.59155
"9708","30012","2018",46,36,10,223120.2,2377.239,89.36957
"9709","30013","2018",5,5,0,373026,3048.4,125.8
"9710","30014","2018",12,12,0,197270.8,2691.75,79.91667
"9711","30015","2018",3,3,0,67500,1015.667,71.33333
"9712","30016","2018",3,3,0,86726.67,920.3333,96.66667
"9713","30017","2018",3,3,0,87000,1551.667,79
"9714","30018","2018",6,5,1,279753.3,2074,130.6667
"9715","30019","2018",33,33,0,298097.5,2631.485,119.3636
"9716","30020","2018",27,24,3,243899.6,2295.259,107.8519
"9717","30021","2018",7,7,0,462946.4,3130,158.4286
"9718","30022","2018",6,5,1,215208.3,1758.333,126.3333
"9719","30023","2018",16,16,0,247460.6,2358.375,104.375
"9720","30024","2018",4,4,0,134831.2,1110.25,111
"9721","30025","2018",5,4,1,92060,1759.4,56.2
"9722","30026","2018",13,8,5,112647.7,1406.769,76.38462
"9723","30027","2018",17,17,0,234098.2,2169.059,107
"9724","30028","2018",234,126,108,137133.8,1660.769,81.40598
"9725","30029","2018",22,20,2,205334.1,2047.045,106.8636
"9726","30030","2018",8,8,0,274159.4,2177.5,131.5
"9727","30031","2018",5,5,0,398132,3662.4,111.8
"9728","30032","2018",156,107,49,149948.4,1586.526,91.69231
"9729","30033","2018",69,67,2,202633.6,2095.493,96.02899
"9730","30034","2018",75,71,4,206411.5,2199.853,94.45333
"9731","30035","2018",6,6,0,280033.2,3298.833,104.6667
"9732","30036","2018",46,36,10,212780.8,2276.152,98.67391
"9733","30037","2018",19,13,6,81578.95,1013.842,80.05263
"9734","30038","2018",4,3,1,102500,1651,67.75
"9735","30039","2018",21,19,2,183818.6,1831.81,99.61905
"9736","30040","2018",4,4,0,110545.8,1347.5,86.75
"9737","30041","2018",17,17,0,305580,2845.824,107.7059
"9738","30042","2018",20,19,1,229593.5,2247,103.5
"9739","30043","2018",7,6,1,292732.9,2134.143,131
"9740","30044","2018",2,2,0,73625,1339.5,67.5
"9741","30045","2018",3,3,0,168266.7,2194,79.66667
"9742","30046","2018",8,8,0,146984.5,1772.75,81.875
"9743","30047","2018",62,55,7,231252.2,2289.339,97.80645
"9744","30048","2018",4,4,0,335337.5,2504.25,140.5
"9745","30049","2018",4,4,0,283362.5,2315.25,115
"9746","30050","2018",2,2,0,268500,2319.5,116
"9747","30051","2018",17,12,5,120267.9,1368.412,92.05882
"9748","30052","2018",12,11,1,119692.9,1417.5,80.91667
"9749","30053","2018",13,13,0,192948.1,1824.154,100.5385
"9750","30054","2018",3,3,0,312981.7,2624.333,119
"9751","30055","2018",6,5,1,149166.7,2070.833,80.5
"9752","30056","2018",4,4,0,261900,2207,108.25
"9753","30057","2018",18,16,2,206411.1,1914.278,101.7222
"9754","30058","2018",2,2,0,390000,1733,217.5
"9755","30059","2018",34,33,1,198535.1,2057.618,98.26471
"9756","30060","2018",28,27,1,213592.5,2127.821,99.85714
"9757","30061","2018",26,21,5,195346.2,1959.308,100.0385
"9758","30062","2018",92,66,26,183423.3,2424.511,77.32609
"9759","30064","2018",1,1,0,90000,1286,70
"9760","30065","2018",3,3,0,154633.3,1855,82
"9761","30066","2018",8,8,0,169140.2,1820.375,89.5
"9762","30067","2018",3,3,0,340333.3,2877,112.3333
"9763","30068","2018",9,9,0,167355.6,1503.333,104.4444
"9764","30069","2018",8,8,0,199635,1951.625,113
"9765","30070","2018",6,6,0,312583.3,2528.833,124.8333
"9766","30071","2018",4,3,1,167207.5,1445.5,115.75
"9767","30072","2018",4,4,0,214850,1719,132.75
"9768","30073","2018",26,25,1,289997.2,2677.923,106.5
"9769","30075","2018",43,40,3,246528.8,2536.674,96.86047
"9770","30076","2018",9,9,0,196197.1,2230.222,91.11111
"9771","30077","2018",8,7,1,123313.8,1847,71.875
"9772","30079","2018",6,5,1,92333.33,1605.333,57.5
"9773","30080","2018",13,11,2,73071.15,1097.154,72.38462
"9774","30081","2018",9,9,0,182905.6,2064.333,91
"9775","30082","2018",51,46,5,218742.4,2418.059,91.11765
"9776","30083","2018",37,33,4,216251.9,2244.351,97.97297
"9777","30084","2018",6,6,0,109946.7,1477.5,75
"9778","30085","2018",15,14,1,359209.8,3199.267,114.0667
"9779","30086","2018",10,9,1,246853,2506.9,97.7
"9780","30087","2018",5,5,0,157800,2143.4,67.6
"9781","30088","2018",4,4,0,260268.8,2229.75,125.25
"9782","30089","2018",20,18,2,198102.4,2094.1,94.4
"9783","30090","2018",4,4,0,105407.5,1302.75,73
"9784","30091","2018",21,18,3,215664.8,2239.571,96.47619
"9785","30092","2018",24,19,5,182177.7,2080.208,91.83333
"9786","30094","2018",3,3,0,261066.7,2220,119.6667
"9787","30095","2018",9,9,0,198827.8,1915.667,103.1111
"9788","30096","2018",9,9,0,270137.8,2740.889,100.2222
"9789","30097","2018",3,3,0,243150.3,2912,72.66667
"9790","30098","2018",3,3,0,233116.7,1952,116.6667
"9791","30099","2018",2,2,0,231500,2097,123
"9792","30100","2018",5,5,0,163600,2339.6,75.2
"9793","30101","2018",3,3,0,322526.7,2508,133.3333
"9794","30102","2018",11,10,1,183300,1775.909,98.36364
"9795","30103","2018",10,9,1,340275,2531,131.3
"9796","30104","2018",5,5,0,198668,2148,91.2
"9797","30105","2018",7,7,0,88903.57,1447.857,61.42857
"9798","30106","2018",16,16,0,163449,1814.75,90.75
"9799","30107","2018",3,3,0,172683.3,2596.333,72.33333
"9800","30108","2018",2,2,0,220000,1338.5,152.5
"9801","30109","2018",3,3,0,217633.3,2253,102.3333
"9802","30110","2018",3,3,0,370933.3,2760.333,125
"9803","30111","2018",4,4,0,219892.5,2109.5,99
"9804","30112","2018",15,15,0,177903,1959.933,90.8
"9805","30113","2018",3,3,0,128333.3,1225.333,95.33333
"9806","30114","2018",7,7,0,272192.9,2555.143,109.1429
"9807","30115","2018",7,7,0,342747.1,3254.143,108.8571
"9808","30116","2018",14,10,4,151449.6,1754.857,89.57143
"9809","30117","2018",29,21,8,173423.1,2124.793,79.51724
"9810","30120","2018",10,8,2,115950,1485.6,70.3
"9811","30121","2018",2,1,1,504250,5021.5,119
"9812","30122","2018",4,4,0,208450,1870.75,112.5
"9813","30123","2018",41,35,6,215015.6,2376.463,95.26829
"9814","30124","2018",5,5,0,152063,1896.2,85.4
"9815","30125","2018",54,44,10,193235,2035.796,95.92593
"9816","30126","2018",7,7,0,347552.9,2437.857,139
"9817","30127","2018",10,10,0,230989,2145.6,106.5
"9818","30128","2018",57,49,8,184501.9,2001.053,92.33333
"9819","30129","2018",6,6,0,150436.7,1787,92
"9820","30130","2018",13,10,3,84790.77,1216.231,69.92308
"9821","30131","2018",16,13,3,217313.2,2190.438,108.375
"9822","30132","2018",22,14,8,69148.18,769.3182,85.18182
"9823","30133","2018",796,60,736,155020.4,4057.569,38.47739
"9824","30134","2018",4,4,0,247925,2135.5,113.25
"9825","30135","2018",38,34,4,162036.1,1952.868,87.65789
"9826","30136","2018",19,18,1,219215.5,2518.895,88.68421
"9827","30137","2018",1,1,0,40000,526,76
"9828","30138","2018",38,38,0,303357.8,2568.105,116.6842
"9829","30139","2018",2,2,0,103500,1284.5,76
"9830","30140","2018",10,8,2,176380,2116.8,84.7
"9831","30141","2018",54,51,3,220317.9,2270.778,95.18519
"9832","30142","2018",13,12,1,153192.3,1838.615,89.69231
"9833","30143","2018",1,1,0,290800,2967,98
"9834","30144","2018",7,7,0,212435.7,2133.429,99.71429
"9835","30145","2018",24,24,0,197993.3,2315.167,93.375
"9836","30146","2018",10,9,1,149730,1639.3,90.4
"9837","30147","2018",22,21,1,180124,1804.545,103.6364
"9838","30148","2018",5,5,0,232032.4,1907.4,131
"9839","30149","2018",15,15,0,200910,1922.2,107.2667
"9840","30150","2018",4,4,0,177475,1566.5,108
"9841","30151","2018",10,10,0,474285.1,3029.4,153.1
"9842","30152","2018",15,14,1,183466.7,1661.267,111.5333
"9843","30153","2018",4,3,1,67082.5,1479.25,60.25
"9844","30154","2018",7,6,1,128842.9,1374.857,101.4286
"9845","30155","2018",64,64,0,220659.8,2216.328,101.1719
"9846","30156","2018",101,88,13,194320.9,2221.822,89.06931
"9847","30158","2018",8,8,0,211931.2,2055.375,113.5
"9848","30159","2018",8,6,2,118337.5,1209.375,93.625
"9849","30160","2018",1,1,0,157000,1764,89
"9850","30161","2018",2,2,0,212250,1478,145
"9851","30162","2018",6,6,0,164250,1561.167,103.8333
"9852","30163","2018",2,2,0,50500,2354.5,22
"9853","30164","2018",22,20,2,145301.4,1664.364,81.72727
"9854","30165","2018",9,7,2,251333.3,1990.889,130.5556
"9855","30166","2018",21,20,1,201912.9,1899.571,111.2381
"9856","30167","2018",4,4,0,168500,1698.75,104.25
"9857","30168","2018",8,7,1,231025,2572,84.125
"9858","30169","2018",54,47,7,174847.1,1905.167,92.90741
"9859","30170","2018",10,10,0,118350,1263.1,93.2
"9860","30171","2018",20,15,5,110518.2,1316.2,87.15
"9861","30172","2018",8,7,1,143689.6,1936.5,89.25
"9862","30173","2018",16,16,0,212078.1,2026.625,109.6875
"9863","30174","2018",20,20,0,265245,2700.6,98.75
"9864","30175","2018",2,2,0,110950,1590,69.5
"9865","30176","2018",4,4,0,78636.75,1373.75,56.25
"9866","30177","2018",8,8,0,237506.5,2231.25,109.375
"9867","30178","2018",17,15,2,198595.6,2104,95.88235
"9868","30179","2018",40,37,3,177991.5,2227.2,88.975
"9869","30180","2018",5,5,0,189916,2113,90.4
"9870","30181","2018",5,5,0,189666.8,1541.6,129
"9871","30182","2018",18,17,1,234216.7,2364.222,98.44444
"9872","30183","2018",10,8,2,178310,1920.5,88.6
"9873","30184","2018",20,19,1,220861,1972.9,109.7
"9874","30185","2018",18,16,2,223203.1,2180.556,109
"9875","30186","2018",22,19,3,276767.3,2300.5,121.7273
"9876","30187","2018",1,1,0,161000,1713,94
"9877","30188","2018",2,2,0,264090,2272.5,114
"9878","30189","2018",2283,656,1627,141920.3,1998.205,70.66272
"9879","30191","2018",11,10,1,216637.4,2047,99.36364
"9880","30192","2018",4,4,0,170580,2526.5,64.5
"9881","30193","2018",6,5,1,228800,3731.667,83.16667
"9882","30194","2018",9,7,2,105555.6,1226.444,84.88889
"9883","30196","2018",6,6,0,250508.3,1977.167,124.1667
"9884","30197","2018",1,1,0,179000,1598,112
"9885","30198","2018",7,6,1,160857.1,1570.571,114.1429
"9886","30200","2018",9,9,0,184401.1,1551.556,135.4444
"9887","30201","2018",1,1,0,56000,966,58
"9888","30202","2018",113,79,34,144543.6,1659,85.82301
"9889","30203","2018",6,5,1,147220.8,1983.333,75.66667
"9890","30204","2018",3,2,1,268946.7,2705.333,112
"9891","30205","2018",5,5,0,172279,1938.4,90.4
"9892","30206","2018",41,40,1,271047.4,2376.951,112.122
"9893","30209","2018",46,39,7,283997.7,2601.239,107.8913
"9894","30210","2018",36,34,2,173260.6,1881.25,92.83333
"9895","30211","2018",23,22,1,225135.8,2215.391,102.7826
"9896","30212","2018",22,13,9,140250.8,1779.182,83.72727
"9897","30214","2018",23,23,0,173946.3,1716,103.087
"9898","30215","2018",2,2,0,152000,2234.5,66.5
"9899","30216","2018",11,11,0,107204.5,1419.727,80.36364
"9900","30217","2018",75,73,2,253042.6,2536.733,102.92
"9901","30218","2018",6,6,0,254166.7,2590.833,93.83333
"9902","30219","2018",2,2,0,133425,2756,52.5
"9903","30220","2018",3,3,0,212166.7,1521.333,125
"9904","30221","2018",69,57,12,162267.5,1898.174,86.26087
"9905","30222","2018",2,1,1,1074140,6334,200
"9906","30223","2018",35,35,0,169946.4,1757.971,97.85714
"9907","30224","2018",4,4,0,197312.5,1867,106.75
"9908","30225","2018",17,17,0,233158.2,2126.471,108.5882
"9909","30226","2018",7,7,0,214024.1,2348.571,99
"9910","30227","2018",55,40,15,129917.3,1633.764,82.69091
"9911","30228","2018",28,25,3,269129.3,2370.143,110.3214
"9912","30229","2018",9,9,0,135544.4,1736.778,86.44444
"9913","30230","2018",10,10,0,165125,1711.6,97.5
"9914","30231","2018",9,9,0,68333.89,1255.333,63.66667
"9915","30232","2018",4,4,0,158250,1344.5,120.25
"9916","30233","2018",8,7,1,178037.5,2088.125,90.625
"9917","30234","2018",2,2,0,58000,887.5,69
"9918","30235","2018",10,10,0,185836,2014.5,91.2
"9919","30237","2018",10,10,0,118900,1421.9,85.2
"9920","30238","2018",1,1,0,120000,2500,48
"9921","30239","2018",3,2,1,105000,1501,79.33333
"9922","30240","2018",1,1,0,243740,1614,151
"9923","30241","2018",12,11,1,205368.3,1741.25,116.4167
"9924","30242","2018",1,1,0,347100,3370,103
"9925","30243","2018",76,64,12,170474.6,1731.921,98.72368
"9926","30244","2018",6,6,0,293433.3,2220,136.5
"9927","30245","2018",4,3,1,150877.5,1651.5,87.75
"9928","30247","2018",2,1,1,137500,1902,73.5
"9929","30248","2018",10,9,1,231281.5,2058.8,111.6
"9930","30249","2018",17,17,0,290003.9,2566.706,118.0588
"9931","30250","2018",5,5,0,186200,1834.6,102.8
"9932","30251","2018",3,3,0,159600,1646.667,98.66667
"9933","30252","2018",5,5,0,218992.2,2213.2,102.8
"9934","30253","2018",19,18,1,131582.1,1916.632,73.73684
"9935","30254","2018",13,13,0,173251.7,2094.538,84.61538
"9936","30255","2018",26,25,1,154671,1624.923,97.46154
"9937","30256","2018",4,4,0,265045,2247,116.75
"9938","30257","2018",24,21,3,215366.7,1973.75,108.5417
"9939","30258","2018",146,105,41,141315.5,1670.212,82.79452
"9940","30259","2018",36,35,1,191657.2,1745.917,110.5556
"9941","30260","2018",9,9,0,206377.8,2281.111,91.22222
"9942","30261","2018",2,2,0,254200,2834,97
"9943","30262","2018",4,4,0,233000,2069.5,119.25
"9944","30263","2018",33,30,3,179904.2,1850.636,96.75758
"9945","30264","2018",2,2,0,231500,1533.5,131
"9946","30265","2018",5,5,0,144540,1540.2,95.4
"9947","30266","2018",11,10,1,155347.3,1642.636,96.18182
"9948","30267","2018",5,5,0,160832,1505.8,108.2
"9949","30268","2018",11,10,1,123958.2,1204.364,100.6364
"9950","30269","2018",20,14,6,168156.9,2242.35,87.8
"9951","30270","2018",9,8,1,172022.2,1822.333,90.55556
"9952","30271","2018",7,7,0,159928.6,1351.571,120.8571
"9953","30272","2018",1,1,0,172700,1677,103
"9954","30273","2018",16,14,2,190615.7,2029.812,96
"9955","30274","2018",19,17,2,172811.7,1746.737,96.36842
"9956","30275","2018",2,1,1,180000,1136.5,150
"9957","30276","2018",59,54,5,202370.3,2522.492,84.76271
"9958","30277","2018",9,9,0,225062.8,2034.222,112.4444
"9959","30278","2018",33,31,2,219132.5,2227.182,98.30303
"9960","30279","2018",11,11,0,188504.5,2221.091,96.18182
"9961","30280","2018",4,3,1,127500,1494.5,79.25
"9962","30281","2018",18,18,0,211075.6,2099.333,99.88889
"9963","30282","2018",4,4,0,174425,2262.25,73.25
"9964","30283","2018",2,2,0,85500,2410.5,38
"9965","30284","2018",35,32,3,144323.7,1580.714,93.68571
"9966","30285","2018",4,4,0,216312.5,1888.25,115.25
"9967","30286","2018",11,11,0,263006.8,2663.091,102
"9968","30287","2018",8,7,1,202637.5,1991.625,94.125
"9969","30288","2018",15,10,5,142526.7,1665,78.73333
"9970","30290","2018",13,12,1,232663.1,2350.462,100.0769
"9971","30291","2018",2,2,0,152500,2395.5,66
"9972","30292","2018",7,7,0,196642.9,2153.286,90.85714
"9973","30293","2018",4,4,0,233500,2376.25,91
"9974","30294","2018",37,23,14,150995.6,1808.676,83.64865
"9975","30295","2018",60,55,5,274913.9,2565.7,103.8833
"9976","30297","2018",9,9,0,125642.2,1838.889,77.88889
"9977","30298","2018",4,4,0,127875,1136.5,119.75
"9978","30299","2018",31,31,0,345069.6,2687.419,131.2903
"9979","30300","2018",7,6,1,202210,1815.571,110.4286
"9980","30301","2018",8,8,0,432436.2,3233,133.25
"9981","30302","2018",19,19,0,255985,2362.737,109.4737
"9982","30303","2018",14,14,0,132213.7,1460.071,87.57143
"9983","30304","2018",8,8,0,183258.8,2313.375,84.875
"9984","30305","2018",33,22,11,138747,1635.333,86.93939
"9985","30306","2018",6,6,0,227250,2393.167,96.16667
"9986","30307","2018",26,20,6,116056.9,1355.269,87.73077
"9987","30308","2018",9,9,0,275235,2822,95.22222
"9988","30309","2018",2,2,0,182500,2438,78
"9989","30310","2018",4,4,0,155505,2477.75,70.5
"9990","30311","2018",34,26,8,208474.9,2112.412,100.2647
"9991","30312","2018",19,19,0,320436.9,2749.263,112.2105
"9992","30313","2018",4,3,1,144287.5,1785.75,76
"9993","30314","2018",1,1,0,269860,2998,90
"9994","30315","2018",30,28,2,283524.5,2574.8,110.7333
"9995","30316","2018",2,2,0,200675,2295,85.5
"9996","30317","2018",27,21,6,163463,1840.63,89.85185
"9997","30318","2018",1,1,0,190000,1900,100
"9998","30319","2018",9,9,0,247800,2138.444,110.4444
"9999","30320","2018",2,2,0,359050,2197.5,153
"10000","30321","2018",47,37,10,223981.1,2363.277,96.93617
"10001","30322","2018",2,2,0,165000,1490.5,109.5
"10002","30323","2018",1,1,0,168000,2211,76
"10003","30324","2018",8,8,0,187693.8,2761.25,73.125
"10004","30325","2018",20,16,4,158333,1780.4,85.35
"10005","30326","2018",21,20,1,223114.2,2373.619,95.33333
"10006","30328","2018",16,15,1,165696.2,1652.562,103.6875
"10007","30329","2018",8,8,0,202083.8,2067,93.625
"10008","30330","2018",9,8,1,211383.3,1985.111,109.1111
"10009","30331","2018",16,16,0,237203.6,2303.438,107.1875
"10010","30332","2018",2,2,0,96000,1114.5,87
"10011","30333","2018",56,46,10,225106.4,2178.607,101.2679
"10012","30334","2018",178,79,99,231794.3,2926.68,78.77528
"10013","30335","2018",2,2,0,227500,1601,138
"10014","30336","2018",14,12,2,133914.3,1713.286,79.28571
"10015","30337","2018",9,9,0,416603.8,2785.778,118.5556
"10016","30338","2018",1,1,0,504150,4542,111
"10017","30339","2018",21,16,5,110421.2,1812.381,62.85714
"10018","30340","2018",5,5,0,158370,2705,92
"10019","30341","2018",164,134,30,172360.9,1995.902,87.20732
"10020","30342","2018",21,20,1,233131.4,2379.571,106.9524
"10021","30343","2018",11,11,0,304422.7,2312.909,123
"10022","30344","2018",77,71,6,242525.1,2584.883,99.87013
"10023","30345","2018",12,10,2,106765,1248.833,82.41667
"10024","30346","2018",24,22,2,220022.6,2244.875,97
"10025","30347","2018",26,23,3,217013.8,2332.692,94.46154
"10026","30348","2018",24,20,4,220170.2,1884.333,118.625
"10027","30349","2018",1,1,0,138000,1747,79
"10028","30350","2018",48,22,26,101059,1287.083,78.375
"10029","30351","2018",184,118,66,278085.6,2892.484,94.02174
"10030","30352","2018",22,20,2,287332.3,2787.5,108.4091
"10031","30353","2018",1,1,0,87000,967,90
"10032","30354","2018",2,2,0,161855,1388,127
"10033","30355","2018",5,4,1,234060,2124,110
"10034","30356","2018",21,18,3,195590.5,2096.381,93.61905
"10035","31002","2018",4,4,0,171125,1847.5,102.25
"10036","31003","2018",16,12,4,349057.2,3101.438,111.875
"10037","31004","2018",1,1,0,455000,1507,302
"10038","31005","2018",4,4,0,106475,785.75,135.5
"10039","31008","2018",5,5,0,182860,1602,123.8
"10040","31010","2018",2,2,0,55250,770.5,74.5
"10041","31011","2018",4,4,0,106812.5,1118.25,97.5
"10042","31013","2018",4,4,0,100125,1164.5,86
"10043","31014","2018",1,1,0,83000,1038,80
"10044","31015","2018",3,3,0,170000,1903.667,96.33333
"10045","31017","2018",1,1,0,60000,706,85
"10046","31018","2018",1,1,0,205160,1603,128
"10047","31020","2018",18,16,2,83808.89,1021.5,84.38889
"10048","31021","2018",3,3,0,140333.3,1353.333,95.66667
"10049","31022","2018",181,64,117,160832.9,2352.448,66.85635
"10050","31023","2018",7,7,0,108428.6,954.5714,124.1429
"10051","31024","2018",7,7,0,229132.9,1671.429,143.8571
"10052","31025","2018",7,7,0,473570,3069.571,167.7143
"10053","31026","2018",10,10,0,244335,1888.3,141.6
"10054","31027","2018",1,1,0,330000,1737,190
"10055","31028","2018",13,12,1,99118.62,1258.923,93.30769
"10056","31029","2018",5,5,0,228482,1642,132.4
"10057","31030","2018",2,2,0,46500,534,88.5
"10058","31031","2018",4,4,0,96250,1193.75,84.75
"10059","31032","2018",79,47,32,211531.7,2362.152,90.22785
"10060","31033","2018",125,94,31,159598.7,1807.392,87.76
"10061","31034","2018",2,2,0,122500,1383,88.5
"10062","31035","2018",38,20,18,328169.3,3116.947,105.2895
"10063","31036","2018",8,7,1,256882.2,2748.5,94.875
"10064","31037","2018",15,15,0,222783.7,1869.8,123.5333
"10065","31038","2018",9,9,0,182450,1510.222,116.8889
"10066","31042","2018",149,25,124,93336.48,1785.389,55.46309
"10067","31043","2018",5,5,0,126780,959,139.4
"10068","31044","2018",226,109,117,309931,3299.894,93.52212
"10069","31045","2018",8,7,1,106943.8,907.75,127.375
"10070","31047","2018",3,3,0,174666.7,1126.333,137.3333
"10071","31048","2018",29,26,3,181944.9,2111.069,87.31034
"10072","31049","2018",5,5,0,202406,1715,121
"10073","31050","2018",5,5,0,103724,862,108.6
"10074","31052","2018",13,13,0,227169.2,1790.923,132.3846
"10075","31053","2018",7,7,0,257141,2455.429,102.8571
"10076","31054","2018",2,2,0,185500,1150,173
"10077","31055","2018",3,3,0,253666.7,1948.667,124
"10078","31056","2018",68,44,24,245172.2,2791.074,89.69118
"10079","31057","2018",15,13,2,258625.5,2689.333,98.06667
"10080","31058","2018",1,1,0,442000,2210,200
"10081","31059","2018",1,1,0,33500,558,60
"10082","31060","2018",2,2,0,140500,1868,137
"10083","31062","2018",1,1,0,191000,1929,99
"10084","31063","2018",2,2,0,193250,1328.5,147
"10085","31064","2018",1,1,0,197383,3796,52
"10086","31065","2018",27,24,3,195987.6,1938.407,98.77778
"10087","31066","2018",56,39,17,164963.8,1796.518,91.21429
"10088","31067","2018",1,1,0,85000,1149,74
"10089","31069","2018",336,126,210,218196,2919.125,73.4494
"10090","31070","2018",5,5,0,121000,936.6,135.4
"10091","31071","2018",1,1,0,352500,2003,176
"10092","31073","2018",6,6,0,209645,1941.833,111.6667
"10093","31074","2018",2,2,0,571250,4236.5,133
"10094","31075","2018",12,12,0,311737.9,2502.417,125.8333
"10095","31076","2018",2,2,0,245500,1781,137.5
"10096","31077","2018",6,6,0,195656.7,1807,109.6667
"10097","31078","2018",2,2,0,80000,546,158.5
"10098","31079","2018",6,6,0,277025,2322,119.6667
"10099","31080","2018",18,17,1,111576.1,1033.556,110.3889
"10100","31082","2018",11,11,0,196315.2,1914.364,115
"10101","31083","2018",4,4,0,125000,917,147.25
"10102","31084","2018",15,15,0,139020,1518.133,95.33333
"10103","31085","2018",16,14,2,90891.88,1328.062,72
"10104","31087","2018",4,4,0,218885,1592.25,137.5
"10105","31088","2018",19,17,2,289279.5,2459.211,121.2632
"10106","31089","2018",7,7,0,232240.9,2075.714,109.8571
"10107","31090","2018",6,6,0,156250,1914.333,81.16667
"10108","31091","2018",31,17,14,199720.1,2156,91.48387
"10109","31092","2018",1,1,0,74000,1088,68
"10110","31093","2018",8,7,1,192925,1788,109.625
"10111","31094","2018",51,42,9,199628,2124.765,100.2157
"10112","31095","2018",1,1,0,30000,588,51
"10113","31096","2018",2,2,0,490200,7908,122.5
"10114","31097","2018",3,3,0,194533.3,1850.667,109.6667
"10115","31098","2018",16,16,0,183127.5,1797.688,111
"10116","31099","2018",1,1,0,332500,1759,189
"10117","31100","2018",37,37,0,163599.7,1738.946,96.83784
"10118","31101","2018",5,5,0,264978,2289.4,115.8
"10119","31102","2018",1,1,0,120000,1176,102
"10120","31104","2018",12,12,0,212697.5,2184.917,98.66667
"10121","31105","2018",1,1,0,450000,4839,93
"10122","31106","2018",25,24,1,200811.6,1897.2,107.4
"10123","31107","2018",73,65,8,182811.4,1864.658,98.9589
"10124","31108","2018",2,2,0,190057.5,1442.5,122.5
"10125","31109","2018",2,2,0,207100,1330.5,182
"10126","31110","2018",14,14,0,110046.4,1049.5,102.5
"10127","31111","2018",5,5,0,202104,1660.8,126.8
"10128","31113","2018",191,82,109,257338.5,2933.23,85.74346
"10129","31114","2018",3,3,0,81633.33,1013.333,76.33333
"10130","31116","2018",174,97,77,201700.4,2410.184,82.98276
"10131","31117","2018",46,46,0,327043.6,2683.804,122.8913
"10132","31118","2018",135,84,51,198987.8,2147.526,90.66667
"10133","31120","2018",7,7,0,358985.7,2881.571,141.4286
"10134","31121","2018",1,1,0,70000,1029,68
"10135","31122","2018",1,1,0,165000,1701,97
"10136","31124","2018",2,2,0,118940,1373.5,93
"10137","31125","2018",1,1,0,67530,500,135
"10138","31126","2018",3,3,0,204250,1863.667,110
"10139","31128","2018",10,10,0,162221,1546,113.3
"10140","31129","2018",1,1,0,232000,3135,74
"10141","31130","2018",2,2,0,116210,1108.5,97
"10142","31131","2018",2,2,0,168000,1161.5,144
"10143","31135","2018",67,52,15,133775.1,1553.075,94.34328
"10144","31136","2018",11,8,3,230598.6,2209.273,106.2727
"10145","31137","2018",1,1,0,170000,1478,115
"10146","31138","2018",3,3,0,66666.67,780,94.66667
"10147","31139","2018",1,1,0,69000,841,82
"10148","31140","2018",3,3,0,88833.33,1307.333,69.66667
"10149","31141","2018",4,4,0,155937.5,1065.75,134
"10150","31142","2018",4,4,0,90312.5,1249.5,64.25
"10151","31143","2018",3,3,0,108333.3,1617.667,74
"10152","31144","2018",10,10,0,111040,1410.4,82.8
"10153","31145","2018",29,27,2,166553.7,1608.241,105.931
"10154","31147","2018",11,11,0,140756.4,1331.909,103.9091
"10155","31148","2018",5,5,0,304686,2449.2,119.2
"10156","31149","2018",472,210,262,203618.6,2380.172,83.29449
"10157","31150","2018",63,47,16,237267.7,2519.587,91
"10158","31151","2018",8,6,2,332648.2,2792.625,117.625
"10159","31152","2018",2,2,0,193300,1277,151
"10160","31153","2018",9,9,0,155636.1,1434.556,108.3333
"10161","31156","2018",6,6,0,88258.33,910.3333,100.1667
"10162","31157","2018",277,143,134,197803.1,2350.773,82.47653
"10163","31158","2018",1,0,1,91000,798,114
"10164","31159","2018",4,4,0,103875,741.75,127.25
"10165","31160","2018",25,24,1,239741.4,2386.48,101.88
"10166","31161","2018",16,14,2,266521.9,2690.875,98.6875
"10167","31162","2018",15,15,0,288539.7,2426.467,122.8667
"10168","31163","2018",23,19,4,316586.7,2951.348,111.6522
"10169","31164","2018",1,1,0,210000,1680,125
"10170","31165","2018",75,52,23,193349.9,2097.36,90.93333
"10171","31166","2018",1,1,0,252600,2552,99
"10172","31167","2018",10,10,0,138863,1207.8,120.4
"10173","31168","2018",1,1,0,121650,1281,95
"10174","31169","2018",81,43,38,242044.5,2629.383,90.25926
"10175","31170","2018",1,1,0,47500,505,94
"10176","31171","2018",3,3,0,350833.3,2689.667,132.3333
"10177","31173","2018",1,1,0,133000,905,147
"10178","31174","2018",8,8,0,108306.2,971.75,106.5
"10179","31175","2018",5,5,0,137400,1123.8,117
"10180","31176","2018",3,3,0,112166.7,1134.667,98.66667
"10181","31178","2018",1,1,0,274000,1815,151
"10182","31179","2018",3,3,0,232366.7,1775.667,135.6667
"10183","31180","2018",1,1,0,309000,1104,280
"10184","31181","2018",14,14,0,256893.9,2386.5,112.2857
"10185","31182","2018",67,41,26,211915.2,2426.657,86.37313
"10186","31184","2018",14,13,1,310662,2624.857,109.8571
"10187","31186","2018",74,30,44,172277.1,2291.122,72.16216
"10188","31187","2018",182,122,60,207770.7,2299.104,88.9011
"10189","31188","2018",2,2,0,340525,2510.5,136.5
"10190","31189","2018",4,4,0,177000,1938.25,93
"10191","31190","2018",9,9,0,89130,1042.667,97.44444
"10192","31191","2018",3,3,0,77283.33,1320.667,60.66667
"10193","31192","2018",5,5,0,288070,1994.6,146.2
"10194","31193","2018",32,31,1,151354.4,1411.312,110.7188
"10195","31194","2018",5,5,0,213670,1694.2,132.4
"10196","31196","2018",2,2,0,152400,1308,113
"10197","31197","2018",3,3,0,101022,1291.333,77
"10198","31199","2018",3,3,0,116333.3,1564,75
"10199","31200","2018",2,2,0,42500,526,76
"10200","31201","2018",1,1,0,70000,583,120
"10201","31202","2018",75,67,8,216969.4,2163.933,103.08
"10202","31203","2018",96,62,34,216505,2671.917,83.82292
"10203","31205","2018",71,23,48,178144.8,2260.521,75.67606
"10204","31206","2018",8,7,1,231175,1599.75,138.125
"10205","31207","2018",2,2,0,90632.5,726.5,126.5
"10206","31208","2018",4,4,0,125300,1647.5,110.5
"10207","31210","2018",10,9,1,170790,2003.4,85.4
"10208","31211","2018",7,7,0,220216.4,1704.143,128.7143
"10209","31212","2018",28,18,10,192542.9,2103.607,93.17857
"10210","31213","2018",8,8,0,106352.4,1664.125,81.625
"10211","31215","2018",6,6,0,448705,2905.167,133.6667
"10212","31216","2018",6,6,0,193555,2476,82
"10213","31217","2018",3,3,0,65466.67,1225.667,56.33333
"10214","31219","2018",5,5,0,149800,1418,112.6
"10215","31220","2018",5,5,0,238600,1736.8,140
"10216","31221","2018",8,1,7,138156.2,3252.875,52.875
"10217","31224","2018",10,9,1,86140.1,1128.3,81.5
"10218","31225","2018",3,3,0,199566.7,1784.667,119.3333
"10219","31226","2018",1,1,0,95000,1092,87
"10220","31227","2018",7,7,0,466089.3,2677.286,176
"10221","31228","2018",15,11,4,228963.5,2350.6,102
"10222","31229","2018",7,7,0,175457.1,1499,113.4286
"10223","31231","2018",13,13,0,149753.5,1560.846,100
"10224","31232","2018",134,100,34,182017,2097.261,86.78358
"10225","31233","2018",13,13,0,185586.5,1843.154,102.6154
"10226","31234","2018",8,8,0,235376.2,2097.125,116
"10227","31235","2018",1,1,0,40000,1429,28
"10228","31237","2018",3,3,0,117000,1062,109.6667
"10229","31238","2018",5,5,0,104700,1193.2,93.4
"10230","31239","2018",27,27,0,110258.1,1039,115.6667
"10231","31240","2018",3,3,0,172500,1754.333,110.6667
"10232","31241","2018",4,4,0,75400,947.5,82
"10233","31243","2018",1,1,0,148000,1480,100
"10234","31244","2018",1,1,0,145000,1169,124
"10235","31245","2018",3,3,0,117333.3,1019.667,120
"10236","31246","2018",9,9,0,131907.7,1312.667,101.6667
"10237","31247","2018",12,12,0,92803.92,1039,94.16667
"10238","31248","2018",45,42,3,252183.7,2487.267,102.5778
"10239","31249","2018",11,10,1,193445.5,1931.818,103.1818
"10240","31250","2018",4,4,0,209905,2038.75,117.25
"10241","31251","2018",2,2,0,105000,1054.5,108.5
"10242","31252","2018",22,18,4,238383.2,2431,98
"10243","31253","2018",29,25,4,201823.9,2007.759,102.7931
"10244","31254","2018",30,24,6,310299.1,2926.467,110.9333
"10245","31255","2018",5,5,0,220926,1514,147.2
"10246","31256","2018",3,3,0,304866.7,2027.667,150.3333
"10247","31258","2018",1,1,0,617000,1668,370
"10248","31259","2018",20,16,4,288126.8,2353.55,124.45
"10249","31261","2018",7,7,0,203648.6,1822.571,114.8571
"10250","31262","2018",6,6,0,185143.3,1940.333,96.83333
"10251","31263","2018",27,27,0,202369.3,2184.222,93.25926
"10252","31264","2018",8,8,0,247397.5,2062.125,119.25
"10253","31265","2018",6,6,0,255650,2175,112.8333
"10254","31266","2018",1,1,0,1e+05,1786,56
"10255","31269","2018",26,26,0,257157.7,2023.692,128
"10256","31270","2018",12,12,0,193370.8,1536.667,131.9167
"10257","31271","2018",27,18,9,272356.7,2583.815,107.0741
"10258","31273","2018",21,21,0,370653.5,2531.238,147.2381
"10259","31274","2018",3,3,0,161633.3,1306.667,116.6667
"10260","31276","2018",2,2,0,257500,1445.5,177
"10261","31277","2018",10,10,0,231078.5,2213.6,107
"10262","31278","2018",2,2,0,117500,1134,99.5
"10263","31279","2018",1,1,0,302220,1349,224
"10264","31280","2018",6,6,0,170755,1282.5,124.6667
"10265","31281","2018",11,11,0,205709.1,1895.636,114.3636
"10266","31282","2018",83,62,21,235213,2556.542,91.48193
"10267","31283","2018",3,3,0,212166.7,2137.667,100
"10268","31284","2018",11,11,0,386336.4,3014.182,125.4545
"10269","31285","2018",6,5,1,495336.7,3070.667,160.3333
"10270","31286","2018",3,3,0,108333.3,1389.667,75
"10271","31287","2018",38,32,6,161815.2,1922.789,83.55263
"10272","31288","2018",4,4,0,178398.8,1699.25,113.25
"10273","31289","2018",1,1,0,158500,1321,120
"10274","31291","2018",146,93,53,206320.4,2397.24,86.33562
"10275","31292","2018",1,1,0,34000,479,71
"10276","31293","2018",35,25,10,194726,2237.429,86.68571
"10277","31295","2018",2,2,0,119800,1151,105
"10278","31296","2018",1,1,0,40000,400,100
"10279","31297","2018",36,30,6,235897.9,2106.861,114.3611
"10280","31299","2018",42,36,6,197414.7,2014.976,101.7619
"10281","31301","2018",3,3,0,95000,942.6667,102
"10282","31302","2018",1,1,0,176500,1217,145
"10283","31303","2018",37,33,4,194079.6,1840.784,105.8649
"10284","31304","2018",8,6,2,145243.8,1558.25,93.25
"10285","31306","2018",2,2,0,103500,1050.5,96.5
"10286","31308","2018",1,1,0,50000,943,53
"10287","31309","2018",3,3,0,155000,1434,132.6667
"10288","31310","2018",2,2,0,209500,2234,93.5
"10289","31311","2018",7,7,0,207592.9,2108,99.85714
"10290","31312","2018",1,1,0,195790,1070,183
"10291","31313","2018",2,2,0,114500,941.5,119.5
"10292","31314","2018",7,7,0,154942.9,1579.143,99.42857
"10293","31315","2018",11,10,1,108050.4,1076.909,108.6364
"10294","31316","2018",5,5,0,49600,621.4,84
"10295","31317","2018",3,3,0,137316.7,1385.333,88
"10296","31318","2018",2,2,0,153250,1170.5,124
"10297","31319","2018",1,1,0,183500,1638,112
"10298","31320","2018",11,11,0,214977.3,1994.091,116.2727
"10299","31321","2018",2,2,0,163500,1565.5,106
"10300","31322","2018",1,1,0,122000,1821,67
"10301","31324","2018",27,25,2,132563,1315.556,112.7407
"10302","31325","2018",1,1,0,272520,2571,106
"10303","31326","2018",1,1,0,178000,1092,163
"10304","31327","2018",1,1,0,150000,938,160
"10305","31328","2018",2,2,0,167000,1667,102.5
"10306","31329","2018",1,1,0,265500,2436,109
"10307","31330","2018",8,8,0,199062.5,1395.625,144.125
"10308","31331","2018",3,3,0,231129.3,1890,123.3333
"10309","31332","2018",1,1,0,175000,1577,111
"10310","31333","2018",1,1,0,120000,1200,100
"10311","31334","2018",9,9,0,256850.1,2090.222,122.2222
"10312","31335","2018",2,2,0,106000,1875.5,50.5
"10313","31336","2018",7,7,0,127871.4,1212.286,110
"10314","31337","2018",6,5,1,74983.33,1301.167,58.83333
"10315","31338","2018",9,9,0,203627.8,2130.889,96.33333
"10316","31339","2018",1,1,0,322550,3043,106
"10317","31340","2018",1,1,0,616770,3426,180
"10318","31341","2018",87,51,36,202025.8,2071.379,95.97701
"10319","31342","2018",6,6,0,70420,933,74.33333
"10320","31344","2018",12,12,0,81930,925,95.33333
"10321","31345","2018",25,22,3,174518.8,1825.32,99.04
"10322","31346","2018",12,12,0,257353.3,2335.083,121.5833
"10323","31347","2018",4,4,0,103712.5,878,125.75
"10324","31348","2018",3,3,0,46000,879.6667,44.66667
"10325","31349","2018",4,4,0,221500,1892.25,122.25
"10326","31350","2018",3,3,0,140665,1738.333,81.33333
"10327","31351","2018",78,44,34,215310.3,2689.538,79.07692
"10328","31355","2018",16,16,0,401607.9,3075.625,132.375
"10329","31356","2018",18,17,1,264790.4,2431.944,110
"10330","31357","2018",3,3,0,122433.3,1497,84
"10331","31358","2018",34,28,6,248608.9,2566.5,95.85294
"10332","31360","2018",6,6,0,154898.3,1242.333,122.6667
"10333","31361","2018",9,9,0,224000.3,1876.667,117.6667
"10334","31362","2018",1,1,0,32000,427,75
"10335","31363","2018",3,3,0,200666.7,1322.667,174.6667
"10336","31364","2018",25,22,3,227488.4,2522.28,97.96
"10337","31365","2018",4,4,0,89250,1220,76.75
"10338","31366","2018",6,6,0,428953.3,2613.333,168
"10339","31368","2018",1,1,0,148150,2352,63
"10340","31370","2018",1,1,0,190000,1195,159
"10341","31371","2018",1,1,0,115730,815,142
"10342","31372","2018",3,3,0,79333.33,1113.333,73
"10343","31373","2018",2,2,0,185000,2331.5,78
"10344","31374","2018",7,7,0,288800,2084.429,144
"10345","31375","2018",38,38,0,112919.5,1320.395,97.78947
"10346","31376","2018",2,2,0,150000,769.5,210
"10347","31377","2018",7,6,1,183121.9,1637.857,108.1429
"10348","31380","2018",4,4,0,202100,2126.25,98.25
"10349","31381","2018",24,21,3,244902.5,2238.458,112.3333
"10350","31383","2018",9,9,0,322970.1,2183.667,151.1111
"10351","31384","2018",24,23,1,281406.2,2712.875,101.9167
"10352","31385","2018",4,4,0,110575,1390.75,74.25
"10353","31387","2018",1,1,0,188900,1628,116
"10354","31388","2018",5,4,1,190950,2082.8,99.6
"10355","31389","2018",43,33,10,295308.4,2924.465,99.30233
"10356","31390","2018",30,18,12,79417.87,963.1667,86.13333
"10357","31391","2018",4,4,0,149250,1172,140.75
"10358","31394","2018",2,2,0,204000,2136,94
"10359","31395","2018",273,163,110,171549.7,2084.084,82.99267
"10360","31396","2018",55,37,18,160441.6,1642.473,94.03636
"10361","31398","2018",1,1,0,102000,680,150
"10362","31399","2018",26,24,2,178818.8,1864.308,99.26923
"10363","31402","2018",9,9,0,229293.3,2344.444,101.3333
"10364","31403","2018",8,8,0,230681.2,2025.75,117.375
"10365","31405","2018",1,1,0,110000,1325,83
"10366","31406","2018",8,6,2,111696.2,1362.625,82.125
"10367","31407","2018",10,8,2,220850,2074.1,108.3
"10368","31408","2018",1,1,0,202850,1352,150
"10369","31409","2018",30,20,10,224419.8,2573.667,89.2
"10370","31410","2018",41,37,4,254595.2,2512.244,102.8537
"10371","31411","2018",5,5,0,485730,3005.4,161.6
"10372","31412","2018",5,5,0,290624,1760.8,138.8
"10373","31413","2018",4,4,0,179162.5,2012.25,93
"10374","31414","2018",2,2,0,218000,1950,113
"10375","31415","2018",1,1,0,80000,769,104
"10376","31416","2018",5,5,0,239996,1938.8,123.4
"10377","31417","2018",110,79,31,293469.6,2724.309,106.0273
"10378","31418","2018",1,0,1,299750,3189,94
"10379","31419","2018",3,3,0,186666.7,1838,100
"10380","31420","2018",26,22,4,215936.9,2241.308,99.42308
"10381","31421","2018",54,41,13,212988.8,2238.333,93.2037
"10382","31423","2018",3,3,0,204370,1933,110.3333
"10383","31424","2018",191,153,38,253360.6,2576.806,98.76963
"10384","31425","2018",5,5,0,170070,1852,103.2
"10385","31426","2018",6,5,1,139833.3,1307,108.5
"10386","31427","2018",7,7,0,112964.3,1033,111
"10387","31428","2018",1,1,0,110000,1222,90
"10388","31429","2018",30,17,13,226912.3,2536.7,88.73333
"10389","31430","2018",7,7,0,159977.1,1414.714,119.7143
"10390","31431","2018",4,4,0,61800,951.25,63.25
"10391","31433","2018",101,73,28,216898.4,2394.782,90.0099
"10392","31434","2018",3,3,0,164213.3,2557.333,67.66667
"10393","31435","2018",8,8,0,226125,1686.25,130.625
"10394","31436","2018",3,3,0,119000,1169.333,114.6667
"10395","31437","2018",1,1,0,161110,2685,60
"10396","31439","2018",4,4,0,327050,2632.25,125.25
"10397","31440","2018",1,1,0,195000,1455,134
"10398","31441","2018",3,3,0,303790,2438.333,123.6667
"10399","31442","2018",5,5,0,221260,1993.2,111.4
"10400","31443","2018",5,5,0,159360,1293.8,115.6
"10401","31444","2018",1,1,0,210000,3000,70
"10402","31445","2018",44,30,14,276002.9,3188.636,88.86364
"10403","31446","2018",226,52,174,199477.7,2691.544,74.66372
"10404","31448","2018",5,5,0,304411.4,2614.2,121.2
"10405","31449","2018",1,1,0,75000,949,79
"10406","31450","2018",8,8,0,227548.1,2089.625,108.25
"10407","31451","2018",108,86,22,156802.3,1625.824,98.53704
"10408","31453","2018",1,1,0,280000,1379,203
"10409","31454","2018",39,35,4,167158.4,1777.949,100.0513
"10410","31455","2018",33,33,0,180280.9,1895.758,95.9697
"10411","31457","2018",11,11,0,101072.7,1231.636,88.45455
"10412","31458","2018",41,38,3,226012.6,2453.902,94.82927
"10413","31459","2018",6,6,0,273946.3,2167.5,122.1667
"10414","31460","2018",37,34,3,292060.1,2671.432,108.027
"10415","31461","2018",3,3,0,120500,1827,75.66667
"10416","31462","2018",30,14,16,287386.3,2611.633,101.5
"10417","31464","2018",2,2,0,221700,1377.5,133
"10418","31466","2018",7,7,0,235252.9,2042.571,115.5714
"10419","31467","2018",44,26,18,192118.4,2322.932,80
"10420","31468","2018",4,4,0,91000,985.5,89.25
"10421","31469","2018",5,5,0,180500,2051.2,108.6
"10422","31470","2018",18,3,15,58748.89,1529.444,36.55556
"10423","31471","2018",11,11,0,105862.5,1213.182,80.90909
"10424","31472","2018",5,5,0,108525,1151.8,97.4
"10425","31473","2018",3,3,0,165305.7,2079,71.66667
"10426","31474","2018",4,4,0,144500,1493,102.25
"10427","31475","2018",15,11,4,201612,1899.533,110.2667
"10428","31476","2018",11,11,0,159770,1715.364,98.90909
"10429","31478","2018",13,13,0,184183.5,1618.923,113.6154
"10430","31480","2018",11,11,0,338538.2,2756.455,127.9091
"10431","31481","2018",17,14,3,180637.1,2202.412,82.64706
"10432","31482","2018",2,2,0,74370,945.5,94.5
"10433","31483","2018",144,80,64,83347.28,1076.91,78.61806
"10434","31484","2018",22,22,0,301477.6,2587.727,116.2273
"10435","31485","2018",1,1,0,210000,1400,150
"10436","31486","2018",15,12,3,193184.8,2089,88.86667
"10437","31487","2018",1,1,0,130000,929,140
"10438","31488","2018",176,97,79,215560.8,2699.648,80.46591
"10439","31489","2018",1,1,0,846700,3024,280
"10440","31490","2018",59,51,8,241134.3,2467.864,97.69492
"10441","31491","2018",5,5,0,194940,1089.8,168.4
"10442","31492","2018",10,10,0,135114.5,1298.2,97.6
"10443","31493","2018",2,2,0,153500,659,232
"10444","31494","2018",3,3,0,105333.3,1164,91.66667
"10445","31495","2018",15,15,0,239652.7,2142.4,114.6
"10446","31496","2018",1,1,0,137000,901,152
"10447","31497","2018",19,17,2,313319.6,2675.105,120.1579
"10448","31499","2018",130,93,37,188614.9,2085.423,89.86154
"10449","31500","2018",21,9,12,128335.7,2086.19,61.90476
"10450","31501","2018",3,3,0,256566.7,2074,124.3333
"10451","31502","2018",5,5,0,129400,1118.2,113
"10452","31503","2018",8,8,0,92752.5,701.5,118.625
"10453","31504","2018",3,3,0,126666.7,1662.333,76
"10454","31505","2018",3,3,0,106666.7,1068.333,114
"10455","31506","2018",197,121,76,250058.9,2756.457,88.80203
"10456","31507","2018",27,21,6,175522.1,2071.63,81.51852
"10457","31509","2018",3,3,0,128773.3,1061,126.6667
"10458","31510","2018",3,3,0,113333.3,1027.333,116.6667
"10459","31511","2018",1,1,0,321100,2294,140
"10460","31512","2018",6,6,0,380920,2714,139.8333
"10461","31513","2018",7,7,0,93018.57,1125.429,90.57143
"10462","31514","2018",1,1,0,69000,862,80
"10463","31515","2018",5,5,0,204670,1695.2,116
"10464","31516","2018",15,15,0,254426.7,2558.467,100.2
"10465","31517","2018",26,26,0,156815.6,1659.808,99.26923
"10466","31518","2018",4,4,0,269325,2127.75,127.75
"10467","31519","2018",3,3,0,268183.3,2331.333,137.3333
"10468","31520","2018",2,2,0,163827.5,1873.5,87.5
"10469","31521","2018",6,6,0,81203.67,686.6667,117.8333
"10470","31523","2018",24,18,6,109743,1248.958,101.875
"10471","31524","2018",1,1,0,155000,1372,113
"10472","31525","2018",7,7,0,212121.4,2329.571,100.7143
"10473","31526","2018",93,72,21,243882.7,2569.957,95.22581
"10474","31529","2018",1,1,0,149555,2719,55
"10475","31533","2018",16,16,0,321190,2518.125,135.875
"10476","31534","2018",2,2,0,347362.5,1924.5,140
"10477","31535","2018",8,8,0,116916.2,1469.5,82
"10478","31536","2018",2,2,0,194500,1934.5,103.5
"10479","31538","2018",3,3,0,187166.7,1601,116
"10480","31539","2018",1,1,0,130000,1182,110
"10481","31540","2018",5,5,0,267122.8,1977,136.6
"10482","31541","2018",72,35,37,293881.8,2949.222,97.36111
"10483","31542","2018",1,1,0,70000,875,80
"10484","31543","2018",1,1,0,202805,1308,155
"10485","31544","2018",7,7,0,68564.29,899,84.85714
"10486","31545","2018",3,3,0,92666.67,723,125.6667
"10487","31547","2018",88,75,13,235129.6,2253.5,107.3977
"10488","31548","2018",1,1,0,75000,1230,61
"10489","31549","2018",1,1,0,42000,442,95
"10490","31550","2018",8,8,0,118325,1256.125,96
"10491","31551","2018",4,4,0,275957.5,2529.25,108.5
"10492","31552","2018",3,3,0,414053.3,2231.667,169.6667
"10493","31553","2018",17,12,5,217798.5,1985.353,105.4706
"10494","31554","2018",1,1,0,115000,1597,72
"10495","31555","2018",8108,1241,6867,193425.6,3070.738,63.29008
"10496","31556","2018",4,4,0,154050,1379,116
"10497","31557","2018",323,205,118,283395.8,2949.892,93.91331
"10498","31558","2018",1,1,0,202471,2250,90
"10499","31560","2018",3,3,0,275565,2318.667,110.6667
"10500","31561","2018",160,126,34,272600.8,2935.463,93.9625
"10501","31563","2018",11,11,0,219650.9,1935.364,118
"10502","31565","2018",7,7,0,104100.9,987.2857,110.8571
"10503","31566","2018",6,6,0,233383.3,2089.667,112.3333
"10504","31567","2018",3,3,0,286516.7,2068,125
"10505","31568","2018",1,1,0,454650,2030,224
"10506","31569","2018",2,2,0,231500,1735,133.5
"10507","31570","2018",3,3,0,298580,2487,119
"10508","31571","2018",2,2,0,240650,2497,99.5
"10509","31572","2018",35,34,1,253453.7,2123.943,115.2286
"10510","31573","2018",48,42,6,235376.5,2204.208,106.1042
"10511","31574","2018",23,22,1,219859,2388,93.52174
"10512","31575","2018",13,13,0,655571.5,3285.462,202.4615
"10513","31578","2018",4,4,0,541100,2923.5,189.5
"10514","31579","2018",11,11,0,248779.1,2224.909,111.6364
"10515","31580","2018",7,6,1,292224.3,2338.571,125.5714
"10516","31581","2018",17,17,0,222175.9,2387.647,95.41176
"10517","31582","2018",55,49,6,209828.7,2129.018,103.0364
"10518","31583","2018",11,10,1,248461.8,1980.364,125
"10519","31584","2018",94,76,18,148495.1,1712.011,90.96809
"10520","31585","2018",16,16,0,157759.3,1283.688,123.1875
"10521","31587","2018",12,12,0,272905.6,2349.5,122.3333
"10522","31588","2018",112,74,38,199149.6,2411.92,83.79464
"10523","31589","2018",20,19,1,211347.5,2010.85,106.65
"10524","31592","2018",13,13,0,284917.1,2461.846,121.6923
"10525","31593","2018",1,1,0,110000,1000,110
"10526","32001","2018",8,8,0,133082.5,1240.75,118.125
"10527","32002","2018",1,1,0,242000,1704,142
"10528","32004","2018",1,1,0,86000,1075,80
"10529","32005","2018",4,4,0,153332.5,1334.25,119
"10530","32007","2018",1,1,0,240610,1910,126
"10531","32008","2018",1,1,0,365750,1407,260
"10532","32009","2018",1,1,0,154988,861,180
"10533","32010","2018",1,1,0,182500,1601,114
"10534","32012","2018",10,10,0,165933,1368.4,118.9
"10535","32013","2018",295,166,129,119328.4,1489.878,81.76949
"10536","32014","2018",1,1,0,121000,1131,107
"10537","32015","2018",1,1,0,180000,1800,100
"10538","32016","2018",6,6,0,284158.3,2236.167,129.8333
"10539","32017","2018",2,2,0,590154,2856,162
"10540","32018","2018",4,4,0,143122.5,1789.75,79.75
"10541","32020","2018",3,3,0,63514.33,644,98.66667
"10542","32021","2018",4,4,0,219625,1339.25,147.25
"10543","32022","2018",1,1,0,102000,1569,65
"10544","32023","2018",1,1,0,158000,2079,76
"10545","32024","2018",1,1,0,250000,2451,102
"10546","32025","2018",1,1,0,60000,566,106
"10547","32026","2018",1,1,0,117500,744,158
"10548","32027","2018",15,15,0,104090,1108.4,97.4
"10549","32028","2018",3,3,0,78666.67,1056.667,82.33333
"10550","32029","2018",6,6,0,146916.7,1600,95.5
"10551","32031","2018",5,5,0,93924,994.4,92.4
"10552","32032","2018",2,2,0,65600,584,131
"10553","32034","2018",2,2,0,169198,837,191
"10554","32035","2018",8,8,0,109262.5,1016.375,111.125
"10555","32036","2018",3,3,0,140000,1400,107.6667
"10556","32037","2018",1,1,0,160000,1067,150
"10557","32038","2018",1,1,0,90000,2250,40
"10558","32040","2018",3,3,0,160383.3,1454.333,120
"10559","32041","2018",3,3,0,128333.3,1079.333,144.3333
"10560","32043","2018",1,1,0,96000,873,110
"10561","32044","2018",1,1,0,184900,1340,138
"10562","32045","2018",7,7,0,154900,1285.714,125.8571
"10563","32046","2018",3,3,0,142833.3,1457.667,96.66667
"10564","32047","2018",2,2,0,202500,1632.5,126
"10565","32049","2018",1,1,0,1e+05,500,200
"10566","32050","2018",2,2,0,139000,1296.5,112.5
"10567","32052","2018",3,3,0,172333.3,1315.333,128.6667
"10568","32053","2018",2,2,0,87500,827,99
"10569","32054","2018",2,2,0,133000,1507.5,86
"10570","32055","2018",1,1,0,326000,988,330
"10571","32060","2018",2,2,0,227750,1911.5,119.5
"10572","32063","2018",2,2,0,84715,976.5,88
"10573","32064","2018",6,5,1,157216.7,1668.5,95.33333
"10574","32065","2018",1,1,0,68000,971,70
"10575","32066","2018",4,4,0,228465,1630.75,140.75
"10576","32068","2018",1,1,0,102350,1013,101
"10577","32069","2018",3,3,0,139125,1628.333,86
"10578","32070","2018",1,1,0,105000,1193,88
"10579","32071","2018",1,1,0,218650,1682,130
"10580","32073","2018",2,2,0,124500,1126,105
"10581","32075","2018",5,5,0,157030,1356,109
"10582","32076","2018",4,4,0,190400,1924,110.75
"10583","32077","2018",1,1,0,90000,833,108
"10584","32078","2018",1,1,0,598000,1785,335
"10585","32079","2018",20,19,1,143545,1286.85,116
"10586","32082","2018",3,3,0,179666.7,1369.333,147.3333
"10587","32083","2018",9,7,2,110668.9,2585.444,77.55556
"10588","32084","2018",1,1,0,78000,565,138
"10589","32085","2018",1,1,0,240000,1667,144
"10590","32086","2018",4,4,0,115450,1160.25,121
"10591","32087","2018",4,4,0,92825,673.25,130.75
"10592","32088","2018",3,3,0,168333.3,1612,87.33333
"10593","32090","2018",4,4,0,194000,1716.25,113.25
"10594","32091","2018",2,2,0,221925,1504.5,151.5
"10595","32092","2018",1,1,0,204100,2083,98
"10596","32093","2018",1,1,0,38000,1583,24
"10597","32094","2018",4,4,0,109250,1182,90
"10598","32095","2018",7,7,0,158052.9,1373.857,112.1429
"10599","32096","2018",46,13,33,63484.5,1232.783,50.34783
"10600","32098","2018",6,6,0,217385,2063,102.5
"10601","32099","2018",1,1,0,204000,1074,190
"10602","32100","2018",2,2,0,117500,1394.5,84
"10603","32102","2018",4,4,0,161000,1275.5,126.5
"10604","32103","2018",3,3,0,129850,1202,100.6667
"10605","32104","2018",2,2,0,132557.5,877.5,159.5
"10606","32105","2018",4,4,0,262162.5,2052,122.25
"10607","32106","2018",9,9,0,147307.8,1454.667,105
"10608","32107","2018",89,84,5,129021.8,1137.562,110.9888
"10609","32109","2018",2,2,0,365000,2388,136
"10610","32110","2018",2,2,0,100710,776,145
"10611","32111","2018",1,1,0,138000,1200,115
"10612","32112","2018",3,3,0,186000,1625.667,113.6667
"10613","32114","2018",1,1,0,355500,1373,259
"10614","32115","2018",3,3,0,117773.3,1067,103
"10615","32116","2018",1,1,0,176280,1102,160
"10616","32117","2018",4,4,0,129900,1284.5,104.25
"10617","32118","2018",1,1,0,84000,646,130
"10618","32119","2018",56,55,1,116792.8,1188.411,102.8393
"10619","32120","2018",2,2,0,157500,1375,110
"10620","32121","2018",8,8,0,316554.8,2253.125,160.25
"10621","32122","2018",2,2,0,109500,2571.5,61
"10622","32123","2018",7,7,0,208517.4,1614.571,137.7143
"10623","32124","2018",1,1,0,175000,1944,90
"10624","32125","2018",2,2,0,330000,1910,157
"10625","32126","2018",2,2,0,215165,1050.5,214
"10626","32127","2018",10,10,0,125175,1366.6,99.6
"10627","32130","2018",2,2,0,93000,935.5,92.5
"10628","32131","2018",3,3,0,143333.3,861.6667,159.6667
"10629","32132","2018",66,62,4,121937.3,1170.561,109.9697
"10630","32133","2018",1,1,0,42666,474,90
"10631","32134","2018",2,2,0,241350,1987,121.5
"10632","32136","2018",4,4,0,117000,1082.75,113
"10633","32138","2018",2,2,0,115950,1349,83.5
"10634","32139","2018",2,2,0,166900,1139,174.5
"10635","32140","2018",1,1,0,215400,1644,131
"10636","32141","2018",2,2,0,183500,1384,140.5
"10637","32142","2018",3,3,0,121666.7,1131.667,109
"10638","32143","2018",1,1,0,80000,471,170
"10639","32146","2018",3,3,0,139200,1306,104.3333
"10640","32147","2018",33,33,0,132202.4,1417.091,95.9697
"10641","32149","2018",19,18,1,150849.5,1470.053,116.4737
"10642","32150","2018",1,1,0,340520,1622,210
"10643","32152","2018",1,1,0,180000,1250,144
"10644","32153","2018",4,4,0,168418.8,1584.25,106.5
"10645","32155","2018",10,9,1,119210,1196.2,124
"10646","32156","2018",2,2,0,147946,1047.5,145
"10647","32157","2018",2,2,0,161600,2087,83
"10648","32158","2018",1,1,0,191700,1369,140
"10649","32159","2018",7,7,0,106608.3,870.2857,127.5714
"10650","32160","2018",133,90,43,185947.4,2077.256,89.47368
"10651","32161","2018",1,1,0,113400,961,118
"10652","32162","2018",10,10,0,148790,1607.3,86.8
"10653","32163","2018",4,4,0,146525,1443.5,99.5
"10654","32167","2018",1,1,0,245000,1361,180
"10655","32170","2018",2,2,0,125000,738,185.5
"10656","32171","2018",4,4,0,165650,1551.5,135
"10657","32172","2018",3,3,0,236668,1354.333,173.3333
"10658","32173","2018",2,2,0,195835,1804,111
"10659","32174","2018",3,3,0,101878.3,986.6667,100
"10660","32175","2018",3,3,0,222233.3,1760.667,121.3333
"10661","32180","2018",2,2,0,78000,915.5,85
"10662","32181","2018",3,3,0,119089,1231,94.66667
"10663","32182","2018",1,1,0,183700,1312,140
"10664","32183","2018",4,4,0,211625,1903.75,111.25
"10665","32185","2018",2,2,0,264900,2916.5,111.5
"10666","32186","2018",1,1,0,98000,1361,72
"10667","32187","2018",1,1,0,685615,4009,171
"10668","32189","2018",1,1,0,20000,364,55
"10669","32190","2018",4,4,0,168000,1540.75,106.75
"10670","32191","2018",6,6,0,130216.7,1010,121.1667
"10671","32192","2018",5,5,0,165704.8,1560,116.8
"10672","32193","2018",5,5,0,104200,1327.4,85.4
"10673","32194","2018",1,1,0,141900,1014,140
"10674","32195","2018",1,1,0,60000,536,112
"10675","32196","2018",1,1,0,143650,991,145
"10676","32197","2018",1,1,0,526740,2290,230
"10677","32198","2018",2,2,0,143500,1337.5,108
"10678","32199","2018",3,3,0,154333.3,1424.667,112
"10679","32200","2018",2,2,0,202825,1515,136
"10680","32201","2018",2,2,0,112500,1041.5,104
"10681","32202","2018",1,1,0,45000,600,75
"10682","32203","2018",1,1,0,141780,1772,80
"10683","32204","2018",5,5,0,173350,1757.8,117.8
"10684","32205","2018",2,2,0,223000,1881,135
"10685","32206","2018",4,4,0,93000,914.5,92.5
"10686","32207","2018",5,5,0,204059,1775.2,118.6
"10687","32208","2018",53,47,6,132343.2,1287.038,100.3585
"10688","32209","2018",5,5,0,136100,1208,112.6
"10689","32211","2018",3,3,0,91333.33,804.6667,127.3333
"10690","32212","2018",2,2,0,99000,959.5,99
"10691","32213","2018",55,51,4,155150.5,1478.273,109.4545
"10692","32214","2018",1,1,0,70000,700,100
"10693","32215","2018",2,2,0,312750,1678.5,179
"10694","32216","2018",1,1,0,150000,1181,127
"10695","32219","2018",5,5,0,92500,896.2,113.6
"10696","32220","2018",1,1,0,145580,1040,140
"10697","32221","2018",2,2,0,132918,1569.5,84.5
"10698","32222","2018",1,1,0,65000,890,73
"10699","32223","2018",1,1,0,160000,1111,144
"10700","32224","2018",2,2,0,161535,1383,124
"10701","32225","2018",2,2,0,188250,928.5,191.5
"10702","32227","2018",5,5,0,67400,1121.4,82.8
"10703","32228","2018",2,2,0,152500,953,154
"10704","32229","2018",1,1,0,86000,717,120
"10705","32233","2018",24,22,2,145581.6,1204.208,123.7083
"10706","32234","2018",1,1,0,92000,1533,60
"10707","32237","2018",5,5,0,74300,750.8,94.6
"10708","32239","2018",1,1,0,200100,2042,98
"10709","32241","2018",5,5,0,178600,1331.8,143.8
"10710","32242","2018",14,13,1,104370,1123.643,91.57143
"10711","32243","2018",1,1,0,102000,680,150
"10712","32246","2018",2,2,0,54000,941,53.5
"10713","32247","2018",2,2,0,309000,1819.5,171
"10714","32248","2018",2,2,0,122000,1231.5,100
"10715","32249","2018",18,17,1,121875.8,1261.667,98.22222
"10716","32251","2018",1,1,0,172995,961,180
"10717","32252","2018",23,22,1,122522.7,1262.174,104.9565
"10718","32253","2018",8,8,0,235107.5,2085.375,126.875
"10719","32254","2018",2,2,0,257150,1583,183.5
"10720","32255","2018",3,3,0,131858.3,1109,137.3333
"10721","32256","2018",30,25,5,105426.2,1062.967,103.6
"10722","32258","2018",3,3,0,151500,1173.667,128
"10723","32260","2018",2,2,0,212590,1872,112.5
"10724","32261","2018",3,3,0,174940,1606.667,113.3333
"10725","32262","2018",3,3,0,211633.3,1452,141.6667
"10726","32263","2018",1,1,0,275000,2750,100
"10727","32264","2018",1,1,0,185000,1468,126
"10728","32266","2018",2,2,0,207000,1744,118
"10729","32267","2018",3,3,0,158866.7,1788.333,86.66667
"10730","32268","2018",5,5,0,205080,3248,87.2
"10731","32269","2018",1,1,0,80000,889,90
"10732","32271","2018",7,7,0,108571.4,1056.286,107.4286
"10733","32272","2018",4,4,0,101788.8,705.5,150.5
"10734","32273","2018",4,4,0,181300,1510.75,122
"10735","32274","2018",2,2,0,134000,1000,140
"10736","32276","2018",2,2,0,176125,1189,136.5
"10737","32278","2018",1,1,0,50000,333,150
"10738","32279","2018",10,10,0,186975.5,1504.5,124.8
"10739","32280","2018",1,1,0,770000,2139,360
"10740","32282","2018",2,2,0,213750,1979,110
"10741","32283","2018",2,2,0,135500,1417,96.5
"10742","32285","2018",7,7,0,153754,1681.429,112.5714
"10743","32286","2018",13,13,0,121807.7,1334.769,92.53846
"10744","32288","2018",3,3,0,127293.3,1147,118.6667
"10745","32289","2018",7,7,0,157355.7,1508.286,110.1429
"10746","32290","2018",18,18,0,151203.9,1314.278,119.6111
"10747","32291","2018",1,1,0,1e+05,1087,92
"10748","32292","2018",3,3,0,101666.7,921.6667,110
"10749","32295","2018",1,1,0,70000,761,92
"10750","32296","2018",16,14,2,116518.8,1394.75,89.5
"10751","32297","2018",4,4,0,257764,1831,135.5
"10752","32298","2018",4,4,0,149975,1190.75,123
"10753","32299","2018",1,1,0,90000,581,155
"10754","32300","2018",2,2,0,125000,1557,81.5
"10755","32301","2018",11,11,0,158067.3,1347.091,114.6364
"10756","32302","2018",1,1,0,75000,1250,60
"10757","32304","2018",4,4,0,140475,933.75,156.25
"10758","32305","2018",2,2,0,142500,804.5,187
"10759","32306","2018",7,7,0,108385.7,1143.857,101
"10760","32307","2018",24,23,1,176653.9,1572.583,116.5417
"10761","32308","2018",1,1,0,220000,1467,150
"10762","32309","2018",1,1,0,489000,1630,300
"10763","32310","2018",1,1,0,120000,1379,87
"10764","32311","2018",1,1,0,95000,633,150
"10765","32312","2018",1,1,0,211000,1407,150
"10766","32313","2018",2,2,0,201500,1195,173
"10767","32314","2018",2,2,0,132500,1281.5,103.5
"10768","32315","2018",2,2,0,476500,2667,172.5
"10769","32317","2018",1,1,0,246100,1538,160
"10770","32318","2018",2,2,0,157000,1011,154.5
"10771","32319","2018",25,25,0,116037.6,1054.28,113.44
"10772","32321","2018",3,3,0,197076.7,1722.333,117.6667
"10773","32322","2018",1,1,0,289000,4817,60
"10774","32323","2018",3,3,0,159016.7,1218.333,121.6667
"10775","32324","2018",4,4,0,143549.2,951,139.25
"10776","32325","2018",3,3,0,222666.7,1185.667,197.3333
"10777","32326","2018",1,1,0,80000,635,126
"10778","32328","2018",1,1,0,1e+05,1515,66
"10779","32330","2018",3,3,0,90333.33,889,99.33333
"10780","32331","2018",24,18,6,117161,1338.375,87.95833
"10781","32334","2018",15,14,1,239977.5,2128.333,110.3333
"10782","32335","2018",1,1,0,160000,556,288
"10783","32336","2018",2,2,0,124000,1240,99
"10784","32338","2018",1,1,0,150000,1190,126
"10785","32340","2018",3,3,0,164340,1599.667,91.33333
"10786","32341","2018",4,4,0,270475,1775.25,151.75
"10787","32342","2018",1,1,0,247200,1766,140
"10788","32344","2018",19,18,1,118892.1,1057.368,117.4737
"10789","32345","2018",6,6,0,309777.5,2147.667,155
"10790","32346","2018",1,1,0,160000,800,200
"10791","32347","2018",3,3,0,218633.3,1409,142.3333
"10792","32348","2018",3,3,0,162866.7,1531.667,102.3333
"10793","32349","2018",3,3,0,279456.7,1794.333,178
"10794","32352","2018",2,2,0,76500,725.5,122.5
"10795","32353","2018",2,2,0,182500,770,200.5
"10796","32354","2018",1,1,0,84600,513,165
"10797","32356","2018",3,3,0,133000,1274.333,105.6667
"10798","32358","2018",1,1,0,85000,625,136
"10799","32360","2018",2,2,0,309825,1428,210
"10800","32361","2018",1,1,0,310000,3163,98
"10801","32362","2018",1,1,0,82000,474,173
"10802","32365","2018",2,2,0,81500,918,89
"10803","32366","2018",1,1,0,219000,1043,210
"10804","32367","2018",2,2,0,183000,1085,166.5
"10805","32368","2018",7,7,0,142214.3,1363.714,112.4286
"10806","32369","2018",4,4,0,91750,833.25,119
"10807","32370","2018",15,14,1,126541.9,1085.667,112.4667
"10808","32371","2018",2,2,0,2e+05,2162,98
"10809","32372","2018",5,5,0,216294,2223.6,97.4
"10810","32373","2018",2,2,0,212250,1544,145
"10811","32375","2018",1,1,0,50000,1000,50
"10812","32377","2018",2,2,0,154500,1346.5,108.5
"10813","32378","2018",5,5,0,68000,594.8,118.2
"10814","32379","2018",4,4,0,222607.5,2137.5,106
"10815","32381","2018",1,1,0,180000,1837,98
"10816","32382","2018",2,2,0,224000,1412,165
"10817","32383","2018",1,1,0,80000,2000,40
"10818","32384","2018",1,1,0,109000,820,133
"10819","32385","2018",1,1,0,275000,2292,120
"10820","32386","2018",2,2,0,133000,823.5,155
"10821","32387","2018",2,2,0,115250,975,130
"10822","32388","2018",1,1,0,447000,2483,180
"10823","32389","2018",2,2,0,101222.5,847,117.5
"10824","32390","2018",1,1,0,58100,894,65
"10825","32391","2018",1,1,0,85000,944,90
"10826","32392","2018",1,1,0,258000,1290,200
"10827","32393","2018",2,2,0,198557.5,1427.5,168.5
"10828","32394","2018",2,2,0,207500,1462,141.5
"10829","32396","2018",5,5,0,145150,1013.8,138.4
"10830","32398","2018",3,3,0,124583.3,1322.667,92.33333
"10831","32400","2018",3,3,0,409176.7,1936,178.3333
"10832","32401","2018",1,1,0,109000,948,115
"10833","32402","2018",1,1,0,265000,1359,195
"10834","32404","2018",10,10,0,152810,1241.1,130
"10835","32406","2018",3,3,0,115000,925,127
"10836","32410","2018",26,23,3,125741.9,1629,85.26923
"10837","32412","2018",16,16,0,111063.9,1286.688,93.0625
"10838","32413","2018",1,1,0,57000,760,75
"10839","32414","2018",5,5,0,85800,807.6,109.4
"10840","32415","2018",3,3,0,121666.7,879,126
"10841","32416","2018",6,6,0,187415,1258.833,139.5
"10842","32417","2018",4,4,0,161875,983.25,166.5
"10843","32418","2018",2,2,0,116000,1309,92.5
"10844","32419","2018",2,2,0,132550,1275,104
"10845","32420","2018",1,1,0,207100,2071,100
"10846","32421","2018",2,2,0,435000,6419.5,102.5
"10847","32423","2018",1,1,0,99000,762,130
"10848","32424","2018",2,2,0,130000,1116,117.5
"10849","32425","2018",6,6,0,190190,1967.5,100.3333
"10850","32426","2018",14,14,0,139665.6,1405.143,106.2857
"10851","32429","2018",1,1,0,129000,1433,90
"10852","32431","2018",1,1,0,66500,633,105
"10853","32432","2018",10,10,0,270765,2107,141.5
"10854","32433","2018",11,11,0,173978.2,1498.364,105.2727
"10855","32435","2018",1,1,0,183500,1835,100
"10856","32436","2018",6,6,0,137000,1386.667,131.6667
"10857","32437","2018",2,2,0,80500,984,80.5
"10858","32439","2018",4,4,0,118750,946.75,120.75
"10859","32440","2018",3,3,0,84500,789,127
"10860","32442","2018",5,5,0,229400,1427.4,146.8
"10861","32443","2018",1,1,0,90000,818,110
"10862","32444","2018",3,3,0,249050,2197.667,119.6667
"10863","32445","2018",5,5,0,102768,1102,92
"10864","32446","2018",5,5,0,76987.6,816.8,102.2
"10865","32448","2018",11,11,0,199185.5,1652.909,122.2727
"10866","32449","2018",2,2,0,97500,1341.5,72
"10867","32450","2018",4,4,0,213700,1283,154
"10868","32451","2018",2,2,0,178500,972,183
"10869","32452","2018",5,5,0,201800,1246.6,148.4
"10870","32453","2018",1,1,0,143500,926,155
"10871","32454","2018",1,1,0,255000,2772,92
"10872","32455","2018",3,3,0,85666.67,1073.667,88.33333
"10873","32457","2018",3,3,0,133333.3,3005,73.66667
"10874","32458","2018",2,2,0,137500,1223.5,113
"10875","32459","2018",18,18,0,120955.1,1093.333,121.0556
"10876","32460","2018",4,4,0,153020,1428.25,106.5
"10877","32461","2018",1,1,0,124500,896,139
"10878","32462","2018",47,45,2,117071.5,1083.745,115.3191
"10879","32463","2018",9,9,0,106216.1,1061.222,103.7778
"10880","32464","2018",15,15,0,119136.7,1188,101.2
"10881","32465","2018",9,9,0,136277.8,1381.333,91.33333
"10882","32466","2018",1,1,0,135000,1125,120
"10883","33001","2018",25,25,0,149278,1426.96,108.4
"10884","33002","2018",7,7,0,160250,1461.429,107.4286
"10885","33003","2018",153,133,20,208769.5,2366.876,91.22876
"10886","33004","2018",49,47,2,166462.4,1900.531,91.46939
"10887","33005","2018",255,210,45,371022.2,4452.192,87.39216
"10888","33006","2018",8,8,0,129037.5,1023.75,133.125
"10889","33007","2018",15,15,0,217206.7,2334.333,96.66667
"10890","33008","2018",3,3,0,119333.3,1029.333,121.3333
"10891","33009","2018",590,143,447,380166.7,5941.486,65.04407
"10892","33010","2018",6,6,0,203450,1900.5,104.1667
"10893","33011","2018",148,111,37,271150.4,3830.25,75.34459
"10894","33012","2018",42,42,0,315070.8,2619.429,123.1429
"10895","33013","2018",85,61,24,261428.3,2979.918,89.54118
"10896","33014","2018",15,15,0,158536,1539.667,109.1333
"10897","33015","2018",24,23,1,280498.9,2577.208,104.4167
"10898","33016","2018",5,5,0,123130,1345,89.2
"10899","33017","2018",7,7,0,162232.1,1565.857,103.5714
"10900","33018","2018",38,34,4,182811.8,1735.053,109.0263
"10901","33019","2018",143,103,40,250233.3,2943.385,86.53846
"10902","33020","2018",3,3,0,116000,1187.667,98.33333
"10903","33021","2018",10,10,0,211483.5,1854,113.9
"10904","33022","2018",44,39,5,224143.2,2371.864,95.88636
"10905","33023","2018",18,18,0,226622.7,2329.778,99.16667
"10906","33024","2018",2,2,0,184000,1479.5,125
"10907","33025","2018",7,7,0,189069.7,1965.571,97
"10908","33026","2018",4,4,0,143125,1217.25,112
"10909","33027","2018",6,6,0,119320,940.8333,128.3333
"10910","33028","2018",9,9,0,267485.7,2426.667,112.4444
"10911","33029","2018",79,61,18,237867.1,2545.165,93.18987
"10912","33030","2018",29,24,5,149165.5,1548.448,97.86207
"10913","33031","2018",1,1,0,270000,985,274
"10914","33032","2018",78,61,17,230976.9,2735.346,87.35897
"10915","33033","2018",10,9,1,183520,1819.3,103.3
"10916","33034","2018",7,7,0,234542.9,1460.286,140.7143
"10917","33035","2018",11,11,0,142590.9,1448.091,100.7273
"10918","33036","2018",64,56,8,175740.7,1662.609,111.0312
"10919","33037","2018",28,27,1,226692.1,2614.75,90.28571
"10920","33038","2018",18,18,0,143492.2,1447,102.1667
"10921","33039","2018",460,241,219,256929.2,3499.23,73.18913
"10922","33040","2018",19,19,0,170251.4,1720.737,103.0526
"10923","33042","2018",79,70,9,225018.2,2138.62,105.2658
"10924","33043","2018",6,6,0,183533.3,1526.5,120.3333
"10925","33044","2018",2,2,0,273240,1379,163.5
"10926","33045","2018",4,4,0,172075,1477.5,124.25
"10927","33046","2018",13,13,0,198146.6,1248.385,166.0769
"10928","33047","2018",10,10,0,128663,1576.3,90.1
"10929","33049","2018",21,21,0,252565.8,2220,114.381
"10930","33050","2018",5,5,0,210700,2128,101.2
"10931","33051","2018",165,125,40,233651,2788.848,87.2
"10932","33052","2018",18,13,5,150638.9,1871.5,82.66667
"10933","33053","2018",2,2,0,242500,2354.5,106
"10934","33054","2018",3,3,0,142166.7,1464.333,98
"10935","33055","2018",12,12,0,171008.1,1687.083,106.3333
"10936","33056","2018",164,97,67,247246.2,2890.366,86.28659
"10937","33057","2018",11,11,0,163187.3,1515.364,110.6364
"10938","33058","2018",103,81,22,113444,1293.039,88.93204
"10939","33059","2018",2,1,1,73500,1287.5,95.5
"10940","33060","2018",7,7,0,233800,1936.286,141.1429
"10941","33061","2018",12,12,0,294508.1,2057.083,160.1667
"10942","33062","2018",12,12,0,248906.6,2326.25,121
"10943","33063","2018",4769,1177,3592,320588.9,4580.048,70.65905
"10944","33064","2018",1,1,0,428000,2038,210
"10945","33065","2018",30,27,3,469352.6,3300.467,129.5667
"10946","33066","2018",1,1,0,93000,809,115
"10947","33067","2018",30,28,2,137503,1260.067,102.8
"10948","33068","2018",3,3,0,150650,1482,101.3333
"10949","33069","2018",382,183,199,359308.4,3978.387,86.25131
"10950","33070","2018",6,6,0,295566.7,2442.667,122
"10951","33071","2018",25,22,3,177383,1788.08,107.48
"10952","33072","2018",1,1,0,148000,1644,90
"10953","33073","2018",11,11,0,114009.5,1202.182,100.2727
"10954","33075","2018",263,106,157,283989.8,3505.665,79.3308
"10955","33076","2018",16,16,0,142265.6,1321.75,106.4375
"10956","33077","2018",36,36,0,214796,2085.806,105.2222
"10957","33078","2018",4,4,0,148456.2,1643.5,99
"10958","33079","2018",5,5,0,355600,2785.2,125.8
"10959","33080","2018",71,58,13,269999.3,2928.169,94.83099
"10960","33081","2018",23,18,5,151787.1,1669.565,103.3913
"10961","33082","2018",17,16,1,211669.2,1823.824,120.8235
"10962","33083","2018",9,9,0,191453.3,1891.778,109.3333
"10963","33084","2018",18,16,2,248250,2774.778,97.44444
"10964","33085","2018",32,28,4,330141,2894.375,114.8125
"10965","33086","2018",7,7,0,237998,2055.143,110.5714
"10966","33087","2018",3,3,0,131666.7,1168.667,118.3333
"10967","33088","2018",8,8,0,117915.2,1332,89
"10968","33089","2018",3,3,0,123900,1071.667,124
"10969","33090","2018",52,44,8,299594.1,3214.212,93.42308
"10970","33093","2018",8,8,0,257390.6,2101.375,127.625
"10971","33094","2018",4,4,0,415166.2,2877.75,154.5
"10972","33095","2018",28,28,0,115076.1,1228.107,89.89286
"10973","33096","2018",128,90,38,234526.1,2551.07,92.73438
"10974","33097","2018",115,70,45,179836.4,2952.07,63.53043
"10975","33098","2018",5,5,0,194893.8,1731.2,112.4
"10976","33099","2018",47,35,12,316108.2,2958.064,105.1915
"10977","33100","2018",12,12,0,155490.8,1522.417,98
"10978","33101","2018",12,12,0,165533.3,1501.417,105.8333
"10979","33102","2018",8,8,0,189875,1393.625,139.25
"10980","33103","2018",1,1,0,245250,1044,235
"10981","33104","2018",73,54,19,185729.2,2210.384,85.65753
"10982","33105","2018",3,3,0,172166.7,1211,135.6667
"10983","33106","2018",16,16,0,161687.5,1372.688,117.4375
"10984","33108","2018",42,36,6,96095.76,1108.405,92.14286
"10985","33109","2018",32,32,0,213421.4,2201.594,100.2188
"10986","33111","2018",19,18,1,142431.6,1154,123.6316
"10987","33112","2018",2,2,0,147500,1133.5,128
"10988","33113","2018",5,5,0,200805,1242.2,159.8
"10989","33114","2018",29,20,9,146156.4,1586.276,99.34483
"10990","33115","2018",3,3,0,166333.3,1054,194.3333
"10991","33116","2018",7,7,0,189324.3,1567.571,122.8571
"10992","33117","2018",1,1,0,231500,2315,100
"10993","33118","2018",26,26,0,297709.7,2734.038,111.4615
"10994","33119","2018",308,127,181,201048.4,2755.731,72.42532
"10995","33120","2018",28,27,1,182241.2,1887.607,96.82143
"10996","33121","2018",1,1,0,149500,1206,124
"10997","33122","2018",147,138,9,356597.9,3421.707,106.1633
"10998","33123","2018",37,35,2,177090.9,1700.405,108.027
"10999","33124","2018",10,10,0,123050,1395.6,87
"11000","33125","2018",28,28,0,167881,1599.393,106.7857
"11001","33126","2018",11,11,0,166195,1436.545,116.6364
"11002","33127","2018",2,1,1,135000,2643.5,76.5
"11003","33128","2018",8,8,0,140675,1452.625,96.125
"11004","33129","2018",3,3,0,287254.3,3492,127.6667
"11005","33130","2018",13,13,0,200484.7,1684,116.3846
"11006","33131","2018",2,2,0,117000,1104.5,101
"11007","33132","2018",5,5,0,138600,1369,104.6
"11008","33133","2018",1,1,0,140000,1489,94
"11009","33134","2018",3,3,0,111353.3,1306,88.33333
"11010","33135","2018",1,1,0,215800,1660,130
"11011","33136","2018",1,1,0,150000,1200,125
"11012","33137","2018",3,3,0,146890,1641.333,90.33333
"11013","33138","2018",123,110,13,130223.5,1482.22,90.49593
"11014","33140","2018",81,67,14,168905.7,2087.494,81.81481
"11015","33141","2018",8,8,0,241016.5,2182.875,111.25
"11016","33142","2018",13,13,0,168203.1,1724.769,100.9231
"11017","33143","2018",31,30,1,208214.1,2013.613,107.9032
"11018","33144","2018",11,11,0,167127.3,1609.182,104.2727
"11019","33145","2018",10,9,1,242498,2203.6,115.8
"11020","33146","2018",27,27,0,160566.5,1657.222,98.18519
"11021","33147","2018",3,3,0,153333.3,2011.667,76
"11022","33149","2018",1,1,0,275151,2069,133
"11023","33150","2018",3,3,0,240215.7,1305,178.6667
"11024","33151","2018",10,10,0,151223.2,1180.4,118.3
"11025","33152","2018",2,2,0,180300,1723.5,105
"11026","33153","2018",6,6,0,143656.7,1481.667,96.33333
"11027","33154","2018",26,23,3,98186.54,1081.962,92.61538
"11028","33155","2018",4,4,0,122250,1261.25,97
"11029","33157","2018",10,10,0,204510.5,1933.2,108.4
"11030","33158","2018",3,3,0,363780,1682.333,199.6667
"11031","33159","2018",26,25,1,107566,1090.654,96.53846
"11032","33160","2018",6,6,0,160257.5,2253.833,109
"11033","33161","2018",11,10,1,92863.64,1023.182,96.45455
"11034","33162","2018",261,171,90,281501.6,3354.847,84.38697
"11035","33163","2018",1,1,0,335070,2234,150
"11036","33164","2018",16,16,0,235055,1939.75,121.0625
"11037","33165","2018",46,27,19,210290.7,2718.5,79.1087
"11038","33166","2018",5,5,0,120200,1377,89
"11039","33167","2018",144,94,50,225899.3,2872.25,80.96528
"11040","33168","2018",7,7,0,208576.1,1392.714,173.1429
"11041","33170","2018",9,9,0,169511.1,1479.333,122.8889
"11042","33171","2018",2,2,0,379554,2151.5,182.5
"11043","33172","2018",3,3,0,97250,1219,78
"11044","33173","2018",2,2,0,192000,1657,130
"11045","33174","2018",12,12,0,212312.5,1592.083,126.25
"11046","33175","2018",11,11,0,153684.5,1569.636,102.3636
"11047","33176","2018",6,6,0,138500,1283.5,118
"11048","33177","2018",25,24,1,149788.4,1559.24,105.64
"11049","33178","2018",6,6,0,171833.3,1807.833,101.3333
"11050","33179","2018",40,37,3,152359,1689.575,93
"11051","33180","2018",1,1,0,399000,1765,226
"11052","33181","2018",6,6,0,159583.3,1413.167,117
"11053","33182","2018",12,12,0,144487.1,1396.25,107.6667
"11054","33183","2018",16,16,0,216558.8,2249.438,103.9375
"11055","33184","2018",7,7,0,161371.3,1289.857,137.2857
"11056","33185","2018",31,20,11,206443.6,2172.484,92.64516
"11057","33186","2018",9,8,1,133039.1,1064.556,122.7778
"11058","33187","2018",14,13,1,110034.4,1014.714,117.2857
"11059","33188","2018",3,3,0,164670,1193.333,141.6667
"11060","33189","2018",5,5,0,144446,1359.8,111.2
"11061","33190","2018",3,3,0,87833.33,1120,81.33333
"11062","33191","2018",5,5,0,221309.6,2488.6,103.6
"11063","33192","2018",302,119,183,239834.2,3236.248,76.25497
"11064","33193","2018",23,23,0,164060,1849.826,89.34783
"11065","33194","2018",7,7,0,193700,1683,117
"11066","33195","2018",14,14,0,146678.6,1099.643,138.4286
"11067","33196","2018",2,2,0,356700,1567,216
"11068","33197","2018",6,6,0,176391.7,1605.833,114.5
"11069","33198","2018",30,30,0,122145.7,1191.233,104.3
"11070","33199","2018",455,359,96,305773.2,3690.42,84.25934
"11071","33200","2018",99,75,24,324749.7,3399.475,96.86869
"11072","33201","2018",17,13,4,158278.8,1522.647,114.5882
"11073","33202","2018",25,23,2,169351.2,1734.92,100.08
"11074","33203","2018",139,100,39,165426.3,2420.353,72.86331
"11075","33204","2018",6,6,0,144573.2,1289.333,128.5
"11076","33205","2018",16,16,0,218593.8,1831.25,130.75
"11077","33206","2018",8,7,1,201940,1920.375,102.125
"11078","33207","2018",79,76,3,232482.3,2279.532,106.2025
"11079","33208","2018",16,16,0,157088.1,1721.875,91
"11080","33209","2018",1,1,0,304550,2648,115
"11081","33210","2018",4,4,0,259380,1873.75,123
"11082","33211","2018",11,11,0,208583.9,2479.455,84.54545
"11083","33212","2018",1,1,0,180000,2647,68
"11084","33213","2018",55,49,6,319274,2832.618,120.4727
"11085","33214","2018",283,198,85,234183.7,3691.788,66.33569
"11086","33216","2018",2,2,0,150000,1298,114
"11087","33218","2018",24,24,0,125685.2,1125.833,111.3333
"11088","33219","2018",36,33,3,213141.5,2141.083,101.1111
"11089","33220","2018",15,15,0,175316,1709.8,106.5333
"11090","33221","2018",14,14,0,136372.1,1155.357,133.5714
"11091","33222","2018",6,6,0,150825,1398.667,105.8333
"11092","33224","2018",2,2,0,466025,2022.5,240
"11093","33225","2018",35,35,0,180790.6,1628.257,116.1714
"11094","33226","2018",29,24,5,160343.4,1764.069,86.34483
"11095","33227","2018",142,75,67,140312.2,1797.648,79.37324
"11096","33228","2018",10,10,0,270745,2002.4,133.9
"11097","33229","2018",156,137,19,304164.5,3708.609,86.23077
"11098","33230","2018",9,9,0,169726.7,1437.444,116.1111
"11099","33231","2018",3,3,0,190633.3,1875,98.66667
"11100","33232","2018",1,1,0,72000,626,115
"11101","33233","2018",34,34,0,228302.8,1842.412,121.5882
"11102","33234","2018",44,41,3,384948.6,3119.568,117.6364
"11103","33235","2018",1,1,0,150000,1531,98
"11104","33236","2018",177,144,33,704365.7,7174.209,97.79096
"11105","33237","2018",18,18,0,189081.7,1684.167,124.1111
"11106","33238","2018",104,98,6,345017.7,3248.048,108.9327
"11107","33239","2018",5,5,0,127400,1007.2,122.4
"11108","33240","2018",82,64,18,121468.2,1413.11,89.7561
"11109","33241","2018",15,13,2,196878,1957.2,101.2
"11110","33242","2018",3,3,0,186514.3,1145,183.6667
"11111","33243","2018",484,299,185,165150,2002.702,84.21281
"11112","33244","2018",6,6,0,176366.7,1926,92.66667
"11113","33245","2018",6,6,0,255958.3,2118.333,103
"11114","33247","2018",1,1,0,308000,2053,150
"11115","33248","2018",39,38,1,191044.4,1820.821,114.9744
"11116","33249","2018",240,96,144,179362.1,2305.088,78.22917
"11117","33250","2018",2,2,0,197500,1414.5,140
"11118","33251","2018",16,16,0,190513.8,1764.25,110.6875
"11119","33252","2018",8,8,0,235773.8,2406.75,100.625
"11120","33253","2018",12,12,0,172060.9,1632.583,103.5833
"11121","33254","2018",5,5,0,113240,980.2,120.6
"11122","33255","2018",3,3,0,225000,1983.667,115
"11123","33256","2018",59,46,13,243158,2720.407,88.44068
"11124","33257","2018",2,2,0,162000,1398.5,120
"11125","33258","2018",9,9,0,151183.3,1556.333,104
"11126","33259","2018",13,13,0,255201.5,2062.462,125.4615
"11127","33260","2018",13,13,0,257776.9,2330.692,119.0769
"11128","33261","2018",9,9,0,158111.1,1750.222,97
"11129","33262","2018",56,53,3,215094.7,2227.411,102.0179
"11130","33263","2018",2,2,0,183960,2048,82.5
"11131","33264","2018",13,13,0,208396.2,1492.615,150.3077
"11132","33266","2018",11,11,0,195318.2,1713.636,112.4545
"11133","33268","2018",40,40,0,210015.8,2124.625,103.9
"11134","33269","2018",1,1,0,146000,1074,136
"11135","33270","2018",3,3,0,245119.3,2260.333,108.6667
"11136","33271","2018",4,4,0,179750,1671.75,117.5
"11137","33272","2018",16,16,0,160432.8,1528.312,108.0625
"11138","33273","2018",76,59,17,321575.6,3199.184,102.5789
"11139","33274","2018",37,34,3,286532.3,2841.189,102.3784
"11140","33275","2018",1,1,0,171000,1900,90
"11141","33276","2018",2,2,0,51000,618,83
"11142","33277","2018",6,6,0,160906.3,1828.833,94.33333
"11143","33279","2018",7,7,0,225571.4,1865.143,122.8571
"11144","33280","2018",1,1,0,183000,1408,130
"11145","33281","2018",1055,388,667,253058.4,3357.195,74.99431
"11146","33282","2018",3,3,0,131900,1169.333,107.3333
"11147","33283","2018",3,3,0,219666.7,1021.667,213.3333
"11148","33284","2018",162,147,15,273785.4,2821.302,101.142
"11149","33285","2018",6,6,0,178315,1298,138.5
"11150","33287","2018",13,13,0,134346.2,1252,115.8462
"11151","33288","2018",2,2,0,160035,1920,83
"11152","33289","2018",24,24,0,119096.2,1204.167,104.875
"11153","33290","2018",21,21,0,174157.9,1795.571,105.381
"11154","33291","2018",1,1,0,157500,1591,99
"11155","33292","2018",1,1,0,220000,1222,180
"11156","33293","2018",28,27,1,266616.1,2679.143,103.9643
"11157","33294","2018",8,8,0,147325,1218.75,118.5
"11158","33295","2018",1,1,0,161000,1533,105
"11159","33296","2018",5,5,0,227018,1741,127.2
"11160","33297","2018",27,27,0,213211.5,1827.296,124
"11161","33298","2018",16,16,0,189297.2,1706.812,125.3125
"11162","33300","2018",20,20,0,166847.2,1830.65,92.25
"11163","33301","2018",3,3,0,236450,2458.333,130
"11164","33302","2018",7,7,0,184542.9,1680.857,109.7143
"11165","33303","2018",5,5,0,305060,2045,150.4
"11166","33304","2018",4,4,0,188862.5,1349.75,133.25
"11167","33305","2018",3,3,0,152670,1683,91
"11168","33306","2018",7,7,0,196114.3,1579.571,153.5714
"11169","33307","2018",29,29,0,188649.3,1540.862,133.1379
"11170","33308","2018",1,1,0,249000,2541,98
"11171","33309","2018",3,3,0,120670,1006.667,129.6667
"11172","33310","2018",3,3,0,236000,1604.667,150.6667
"11173","33311","2018",22,17,5,195704.8,1720.091,111.5909
"11174","33312","2018",92,70,22,239092.3,2860.435,86.66304
"11175","33314","2018",90,81,9,135468.2,1598.6,89.42222
"11176","33315","2018",16,16,0,174125,1573.562,112.1875
"11177","33316","2018",13,13,0,146003.1,1346.538,114.8462
"11178","33317","2018",11,11,0,196233.6,1954.364,120.2727
"11179","33318","2018",753,453,300,303615.5,3562.45,84.65073
"11180","33319","2018",5,5,0,132840,1149.6,146.8
"11181","33320","2018",9,9,0,227122.2,1602.778,137.3333
"11182","33321","2018",22,22,0,182869.6,1759.773,107.1364
"11183","33322","2018",70,67,3,312637.3,2870.943,111.8
"11184","33323","2018",7,7,0,193785.7,1748.143,116.1429
"11185","33324","2018",60,50,10,115397.9,1250.3,92.45
"11186","33325","2018",11,11,0,96887.18,1200,87.72727
"11187","33327","2018",48,42,6,171403.3,1894.062,92.41667
"11188","33328","2018",4,4,0,162375,1878.5,91.25
"11189","33329","2018",4,4,0,168250,1592.75,104.75
"11190","33330","2018",51,43,8,283927.6,2506.765,114.2745
"11191","33331","2018",10,10,0,150530,1369,108.4
"11192","33332","2018",15,15,0,149951.7,1488.533,109.5333
"11193","33333","2018",43,42,1,267454,3041.581,90.90698
"11194","33334","2018",27,25,2,252681.2,2554.444,103.5926
"11195","33335","2018",3,3,0,229666.7,2369.333,100.6667
"11196","33336","2018",14,14,0,162568.6,1364.071,120.5
"11197","33337","2018",29,26,3,149820.7,1446.931,108.3793
"11198","33339","2018",17,17,0,189124.1,1739.588,116.6471
"11199","33341","2018",28,27,1,156382.1,1657,98.5
"11200","33342","2018",8,8,0,413888.4,2368.25,134.75
"11201","33343","2018",7,7,0,168028.6,1303.857,123.5714
"11202","33344","2018",8,8,0,151000,1446.5,100
"11203","33345","2018",2,2,0,258925,1134,227
"11204","33346","2018",5,5,0,203200,971.8,199
"11205","33347","2018",6,5,1,178250,1746,172
"11206","33348","2018",9,9,0,142787.8,1358.556,102.7778
"11207","33349","2018",23,23,0,343573.9,3172.957,117.7391
"11208","33350","2018",19,19,0,144978.9,1396.526,104.8947
"11209","33351","2018",16,16,0,101281.2,1050.438,104.4375
"11210","33352","2018",46,41,5,116343.1,1219.217,103.6087
"11211","33353","2018",4,4,0,143000,1182.25,139
"11212","33355","2018",29,29,0,167160.1,1614.31,102.8966
"11213","33356","2018",3,3,0,235000,1936,155.3333
"11214","33357","2018",24,24,0,229687.8,1940.417,122.2083
"11215","33358","2018",3,3,0,162347.3,1616,100.3333
"11216","33359","2018",4,4,0,218807.2,1127.75,168.25
"11217","33360","2018",5,5,0,94183.8,1158.2,80
"11218","33361","2018",9,9,0,143424.4,1400.556,112.2222
"11219","33362","2018",22,22,0,144334.1,1503,97.95455
"11220","33363","2018",48,48,0,259699.3,2542.771,101.7917
"11221","33364","2018",5,5,0,190982,1512.4,129.2
"11222","33366","2018",165,134,31,179691,2148.533,88.64848
"11223","33367","2018",9,9,0,225983.3,1697.667,142.8889
"11224","33369","2018",12,12,0,196620,1461.417,126.9167
"11225","33370","2018",3,3,0,131833.3,929.6667,141.3333
"11226","33372","2018",2,2,0,506250,2769,160
"11227","33373","2018",8,8,0,169167.4,1463,115.125
"11228","33374","2018",12,12,0,97416.67,1048.083,104.1667
"11229","33375","2018",5,5,0,197000,1561.6,135
"11230","33376","2018",79,72,7,422635.5,3533.937,121.443
"11231","33377","2018",1,1,0,112500,1184,95
"11232","33378","2018",9,9,0,115723.3,1214.111,97.44444
"11233","33379","2018",2,2,0,157500,1032,188
"11234","33380","2018",17,17,0,105223.5,1045,100.1176
"11235","33381","2018",44,42,2,233161.1,2679.182,90.97727
"11236","33382","2018",28,27,1,129026.8,1422.429,98.78571
"11237","33383","2018",6,6,0,173986.7,1397.5,111.8333
"11238","33384","2018",3,3,0,158333.3,1460.667,110.6667
"11239","33385","2018",4,4,0,140737.5,1148.5,123.75
"11240","33386","2018",1,1,0,183500,1668,110
"11241","33387","2018",30,29,1,229265.2,1797.8,124.6667
"11242","33388","2018",11,10,1,144400,1591.909,104.5455
"11243","33389","2018",32,32,0,107946.9,1156.719,95
"11244","33390","2018",4,4,0,133637.5,1428.75,89.5
"11245","33391","2018",3,3,0,136233.3,1125.667,173.6667
"11246","33392","2018",12,12,0,202575.8,1427.833,145.4167
"11247","33393","2018",57,55,2,181349.1,1754.246,104.7368
"11248","33394","2018",17,16,1,236035.3,2343.471,99.88235
"11249","33395","2018",15,15,0,153853.1,1388.2,113.9333
"11250","33396","2018",2,2,0,194750,2028.5,113
"11251","33397","2018",37,34,3,247110.9,2554.514,103.4324
"11252","33398","2018",3,3,0,213000,2075.667,125.6667
"11253","33399","2018",1,1,0,98100,1401,70
"11254","33400","2018",1,1,0,68500,685,100
"11255","33401","2018",1,1,0,328100,2064,159
"11256","33402","2018",37,26,11,94437.46,897.027,111.0541
"11257","33403","2018",2,2,0,209375,1992,105
"11258","33404","2018",3,3,0,142790.7,1207.667,115
"11259","33405","2018",5,5,0,170110,1501.6,111.6
"11260","33406","2018",4,4,0,143143.5,1340.5,101.5
"11261","33407","2018",13,13,0,196349.9,1853.769,108.3077
"11262","33409","2018",2,2,0,101150,1092.5,90
"11263","33411","2018",4,4,0,233375,2486.25,91.5
"11264","33412","2018",13,12,1,171370.8,1973.846,91.61538
"11265","33413","2018",16,15,1,247312.5,2306.188,107.25
"11266","33414","2018",3,3,0,184666.7,1304.333,155
"11267","33415","2018",26,24,2,190305.8,1992.923,95.80769
"11268","33416","2018",1,1,0,196500,1965,100
"11269","33417","2018",34,31,3,274809.4,2556.147,109.2353
"11270","33418","2018",2,2,0,145500,1819,78.5
"11271","33419","2018",1,1,0,128038,1280,100
"11272","33420","2018",1,1,0,5e+05,1923,260
"11273","33421","2018",8,8,0,179062.5,1377.375,128.375
"11274","33422","2018",101,86,15,330905.9,3067.604,111.6436
"11275","33423","2018",6,6,0,146148.3,1428.167,98.16667
"11276","33424","2018",80,68,12,161520,1724.05,93.2625
"11277","33425","2018",18,18,0,177648.3,1836.167,103.5556
"11278","33426","2018",5,5,0,502200,2495.8,187.2
"11279","33427","2018",4,4,0,135250,1439.25,99
"11280","33429","2018",1,1,0,163000,1199,136
"11281","33431","2018",4,4,0,157125,1426.5,114.25
"11282","33432","2018",3,3,0,155666.7,1698,95.66667
"11283","33433","2018",112,102,10,232836.2,2402.125,102.3839
"11284","33434","2018",32,26,6,174395.6,1957.062,94.4375
"11285","33435","2018",40,36,4,156679.1,1631.675,98.75
"11286","33436","2018",16,16,0,203581.9,1898.312,111.125
"11287","33437","2018",22,21,1,181801.3,1746.455,105.4091
"11288","33438","2018",30,29,1,195571.7,1783.367,108.9667
"11289","33439","2018",14,13,1,157685.7,1747.714,91.64286
"11290","33440","2018",4,4,0,166675,1055.5,191.5
"11291","33441","2018",14,12,2,120303.6,1150.429,106.4286
"11292","33442","2018",2,2,0,315615,2308.5,137
"11293","33443","2018",2,2,0,118000,1350.5,85
"11294","33444","2018",7,7,0,168214.3,1401,117.5714
"11295","33445","2018",10,10,0,228850.8,1663.5,130.6
"11296","33446","2018",4,4,0,119000,1075.25,110.25
"11297","33447","2018",40,39,1,126873.8,1288.525,97.4
"11298","33448","2018",29,29,0,281444.5,2860.31,100.2759
"11299","33449","2018",312,261,51,309328.4,3270.821,96.77244
"11300","33450","2018",6,6,0,152409,1598.167,103
"11301","33451","2018",3,3,0,248333.3,2749.667,113.6667
"11302","33452","2018",11,11,0,235040.9,2045.636,119.5455
"11303","33453","2018",2,2,0,126000,1035.5,116.5
"11304","33454","2018",24,24,0,263875.4,2375.542,112.9167
"11305","33456","2018",8,8,0,144250,1121.625,136.875
"11306","33457","2018",6,6,0,216583.3,1826.167,120.5
"11307","33458","2018",10,10,0,105470,1169.3,91.6
"11308","33459","2018",4,4,0,558125,3084.5,173
"11309","33460","2018",10,10,0,132890,1293.5,108.2
"11310","33461","2018",9,9,0,171555.6,1427.667,136.5556
"11311","33462","2018",2,2,0,155000,1336.5,116
"11312","33463","2018",23,23,0,153352.2,1510.913,111.2174
"11313","33464","2018",3,3,0,253116.7,1495.667,163.3333
"11314","33465","2018",10,10,0,199935,1626.9,123.8
"11315","33466","2018",31,24,7,229587.5,2093.355,97.45161
"11316","33467","2018",2,2,0,80000,769,104
"11317","33468","2018",4,4,0,245500,1908.25,157.25
"11318","33470","2018",9,9,0,311936.1,2322.889,146.2222
"11319","33471","2018",15,15,0,158832.7,1550.4,103.8
"11320","33472","2018",4,4,0,114017.5,1355.5,78.75
"11321","33473","2018",37,36,1,150884.8,1508.784,104.4054
"11322","33474","2018",37,37,0,321640.3,2687.162,119.2162
"11323","33475","2018",6,6,0,150108.3,1528.5,100.6667
"11324","33476","2018",12,12,0,133773.8,1174.083,119.0833
"11325","33477","2018",8,8,0,181493.8,1489.5,141
"11326","33478","2018",45,42,3,121305.6,1306.333,91.84444
"11327","33479","2018",2,2,0,142500,1817,79
"11328","33480","2018",17,17,0,155094.2,1710.529,97.70588
"11329","33481","2018",4,4,0,150000,1173.5,124.25
"11330","33482","2018",6,6,0,105250,949.1667,113.5
"11331","33483","2018",61,59,2,275907.7,2404.639,118.4918
"11332","33484","2018",24,23,1,133904.2,1569.167,91.20833
"11333","33485","2018",28,28,0,160110,1530.143,106.6786
"11334","33486","2018",2,2,0,180000,2339.5,79.5
"11335","33487","2018",12,12,0,180167.5,1945.083,96.25
"11336","33488","2018",6,6,0,176941.7,1655.833,113.8333
"11337","33489","2018",6,6,0,132633.3,1065,129
"11338","33490","2018",27,26,1,162692.6,1853.222,85.25926
"11339","33491","2018",1,1,0,96010,873,110
"11340","33492","2018",26,26,0,128040,1483.115,84.80769
"11341","33493","2018",5,5,0,163100,1775.6,93.2
"11342","33494","2018",11,11,0,305830.5,2637.091,116.4545
"11343","33496","2018",34,33,1,254941.4,2618.294,104.5294
"11344","33498","2018",111,104,7,249505.1,2398.09,108.1081
"11345","33499","2018",6,6,0,267591.7,2528.667,111.6667
"11346","33500","2018",6,6,0,126352.5,1250,98.83333
"11347","33501","2018",52,50,2,287087.9,2462.058,120.75
"11348","33502","2018",3,3,0,141833.3,1397.667,104
"11349","33503","2018",9,9,0,303291.1,3096.111,100.5556
"11350","33504","2018",6,6,0,217019.2,1860.667,120.3333
"11351","33505","2018",20,20,0,210916,2224.8,101.7
"11352","33506","2018",29,27,2,133306.1,1342.966,102.8276
"11353","33507","2018",3,3,0,214000,2209,95.33333
"11354","33508","2018",11,11,0,161143.9,1395.636,115.4545
"11355","33509","2018",8,8,0,169562.5,1397.25,130.5
"11356","33511","2018",3,3,0,130833.3,827.3333,151.3333
"11357","33512","2018",7,7,0,141242.9,1175.571,119.8571
"11358","33513","2018",4,4,0,210750,2126.25,100.75
"11359","33514","2018",146,91,55,170919.7,2780.219,65.4863
"11360","33515","2018",5,5,0,110462,1296.6,90.4
"11361","33516","2018",2,2,0,256250,2009.5,128.5
"11362","33517","2018",17,17,0,177933.6,2134.059,89.41176
"11363","33518","2018",13,13,0,221265.4,2866,83.76923
"11364","33519","2018",119,101,18,320331.4,3321.824,98.72269
"11365","33520","2018",5,5,0,194694.6,1049.2,179.4
"11366","33521","2018",14,14,0,192801.4,2045,96.28571
"11367","33522","2018",729,257,472,237269.6,3855.177,63.95748
"11368","33523","2018",15,12,3,164493.3,1575.733,105.6667
"11369","33524","2018",2,2,0,157500,1623,97
"11370","33525","2018",12,12,0,199250.1,1722.833,120.25
"11371","33527","2018",147,102,45,250721.9,3040.68,84.85714
"11372","33528","2018",4,4,0,241750,2319,100.25
"11373","33529","2018",567,411,156,398124.1,4302.441,89.46561
"11374","33530","2018",7,7,0,192232.1,1853.143,102
"11375","33531","2018",7,7,0,222291.4,1913.571,108.8571
"11376","33532","2018",7,7,0,189200,1431.571,131
"11377","33533","2018",48,41,7,171756.6,1701.375,109.0417
"11378","33534","2018",19,18,1,230578.9,2259.842,103.1579
"11379","33535","2018",63,60,3,314320.3,3028.429,104.3651
"11380","33536","2018",1,1,0,164000,1312,125
"11381","33537","2018",3,3,0,105666.7,1159,85.33333
"11382","33538","2018",6,6,0,81416.67,996.6667,77.83333
"11383","33539","2018",55,48,7,208517,2220.818,102.1636
"11384","33540","2018",63,60,3,197153.2,2654.714,83.14286
"11385","33541","2018",11,11,0,150933.5,1592.364,87.27273
"11386","33542","2018",10,10,0,134544,1536.7,87.6
"11387","33543","2018",16,16,0,159806.2,1722.875,97.1875
"11388","33544","2018",61,32,29,114677,1897.918,63.13115
"11389","33545","2018",22,22,0,165456.8,1534.591,110.6364
"11390","33546","2018",8,8,0,208500,2362.75,99.75
"11391","33547","2018",17,17,0,160570.6,1685.412,100.0588
"11392","33548","2018",17,16,1,203392.5,1712.882,123.2353
"11393","33549","2018",4,4,0,163881,1976.25,85.25
"11394","33550","2018",450,293,157,262155.9,3216.682,81.93778
"11395","33551","2018",8,8,0,203862.5,1399.625,136.75
"11396","33552","2018",8,8,0,180875,1845.375,101.375
"11397","33553","2018",12,11,1,212610.8,2121.917,102.8333
"11398","33554","2018",28,28,0,269749.7,2449.286,108.7143
"11399","33555","2018",61,52,9,247782.1,2770.557,89.59016
"11400","34001","2018",27,23,4,143877.5,1726.444,81.74074
"11401","34002","2018",18,17,1,150490,1706.611,84.38889
"11402","34003","2018",1646,422,1224,136717.4,3172.499,46.37728
"11403","34004","2018",2,2,0,71000,802.5,80
"11404","34005","2018",3,3,0,244916.7,1889.333,164
"11405","34006","2018",7,7,0,113642.9,1202.571,109.2857
"11406","34007","2018",2,2,0,114250,1376.5,85.5
"11407","34008","2018",8,7,1,128960,1358.125,95.875
"11408","34009","2018",24,22,2,189810,2047.833,92.58333
"11409","34010","2018",33,30,3,190702.2,2077.303,88.75758
"11410","34011","2018",2,2,0,205225,1933,108
"11411","34012","2018",15,15,0,264503.2,2505.667,109.8
"11412","34013","2018",19,18,1,127370.5,1341.632,93.42105
"11413","34014","2018",13,13,0,518219.8,3331.308,148.3077
"11414","34015","2018",4,4,0,85835.75,1206.5,73.5
"11415","34016","2018",3,3,0,270618.3,2980.333,101.3333
"11416","34017","2018",6,6,0,150125,1384.5,98.83333
"11417","34018","2018",17,16,1,176324.1,1810.059,101.2941
"11418","34019","2018",7,7,0,74214.29,1051.429,68.57143
"11419","34020","2018",8,8,0,128353.8,1317.5,99.625
"11420","34021","2018",6,6,0,164045.8,1674.667,102.5
"11421","34022","2018",101,80,21,335370.2,3194.386,104.2079
"11422","34023","2018",217,60,157,165124.5,3786.157,50.16129
"11423","34024","2018",32,29,3,284217,3097.344,93.375
"11424","34025","2018",29,28,1,191764,1993.586,95.93103
"11425","34026","2018",2,2,0,140000,1325.5,108
"11426","34027","2018",19,19,0,296347.6,2659.158,118.1053
"11427","34028","2018",74,50,24,89736.95,1156.595,76.97297
"11428","34029","2018",12,12,0,217306.7,1993.083,109.75
"11429","34030","2018",2,2,0,116500,828,140.5
"11430","34031","2018",73,66,7,149234.8,1812.411,78.86301
"11431","34032","2018",1164,482,682,121959.1,1553.858,78.44158
"11432","34033","2018",32,25,7,259708.3,2334.375,107.875
"11433","34035","2018",4,4,0,284725,2696.5,112.75
"11434","34036","2018",19,15,4,163976.3,1517.474,105.3684
"11435","34037","2018",41,28,13,184524.1,2007.976,89
"11436","34038","2018",16,15,1,104505.6,1275.438,80.75
"11437","34039","2018",45,33,12,242747.1,2768.422,86.57778
"11438","34041","2018",18,17,1,186244.9,2070.667,88.55556
"11439","34042","2018",5,5,0,120560,2030,61.2
"11440","34043","2018",2,2,0,437800,3215,131
"11441","34044","2018",3,3,0,186666.7,1580.333,105.6667
"11442","34045","2018",9,9,0,102777.8,1071.556,98.11111
"11443","34046","2018",1,1,0,112600,1115,101
"11444","34047","2018",10,10,0,190307,1698.3,110.8
"11445","34048","2018",1,1,0,248000,3307,75
"11446","34049","2018",4,4,0,97750,1128.25,79.5
"11447","34050","2018",20,15,5,207519.6,2513,87.6
"11448","34051","2018",52,52,0,225328.3,2327.192,97.63462
"11449","34052","2018",45,41,4,147907.1,1640.978,89.93333
"11450","34053","2018",4,4,0,227875,1832.25,103.25
"11451","34054","2018",4,4,0,92950,1196,74
"11452","34056","2018",11,11,0,139695.5,1848,76.36364
"11453","34057","2018",306,150,156,302629.4,3352.716,88.7451
"11454","34058","2018",2,2,0,234500,2554.5,76
"11455","34059","2018",5,5,0,105190,969,109
"11456","34060","2018",4,4,0,97250,1336.25,91.75
"11457","34061","2018",14,14,0,165768.2,1612.571,106.0714
"11458","34062","2018",3,3,0,140000,1250.667,103.6667
"11459","34063","2018",31,29,2,168283.9,1702.484,93.45161
"11460","34064","2018",4,3,1,125125,1028.75,112
"11461","34065","2018",8,8,0,245886.2,1827.125,130.875
"11462","34067","2018",7,6,1,143357.1,1535.286,95.14286
"11463","34068","2018",2,2,0,151500,1613.5,83
"11464","34069","2018",82,75,7,129778.9,1493.841,86.2439
"11465","34070","2018",7,7,0,117857.1,1452.286,87.57143
"11466","34071","2018",6,6,0,89533.33,1021.667,86.33333
"11467","34073","2018",18,16,2,183561.3,1903.611,98.61111
"11468","34074","2018",38,35,3,156442.4,1636.579,91.65789
"11469","34075","2018",8,8,0,155155,1747.375,93.75
"11470","34076","2018",18,16,2,197298.3,2050.111,102.5
"11471","34077","2018",51,32,19,262132.7,3016.373,82.45098
"11472","34078","2018",20,20,0,228790.9,2291.9,102.95
"11473","34079","2018",129,76,53,146265.2,1831.016,80.43411
"11474","34080","2018",6,6,0,124400,1334.667,91
"11475","34081","2018",40,37,3,185648.2,1971.9,94.1
"11476","34082","2018",15,13,2,351912.7,2826.267,125.6667
"11477","34083","2018",2,2,0,117500,1709.5,67
"11478","34084","2018",20,20,0,184037.8,1739.4,103.8
"11479","34085","2018",6,6,0,203739.2,1953.833,108
"11480","34086","2018",14,13,1,94250,1166.929,91.5
"11481","34087","2018",27,25,2,253659.3,2475.148,103.6667
"11482","34088","2018",84,57,27,208519.9,2572.607,80.96429
"11483","34089","2018",17,17,0,182043.5,1911.647,91.41176
"11484","34090","2018",111,83,28,316464,3380.838,95.15315
"11485","34092","2018",10,10,0,179607.5,1417.8,135.6
"11486","34093","2018",4,4,0,57575,1452,56
"11487","34094","2018",19,19,0,229891.9,1953.474,120.1579
"11488","34095","2018",81,67,14,240015.7,2642.148,90.7037
"11489","34096","2018",9,9,0,140738.9,1287.222,108.8889
"11490","34097","2018",10,10,0,136535,1375.5,98.8
"11491","34098","2018",4,4,0,76000,2395.5,51.25
"11492","34099","2018",2,2,0,534500,4219.5,130
"11493","34100","2018",5,5,0,132800,1579.2,80.2
"11494","34101","2018",73,65,8,161484.8,1986.068,80.79452
"11495","34102","2018",3,3,0,431816.7,3054.333,144
"11496","34103","2018",9,9,0,185500,2014.333,80.33333
"11497","34104","2018",2,2,0,138750,1686.5,80.5
"11498","34105","2018",8,8,0,180326.2,1860.375,98.25
"11499","34107","2018",4,4,0,57250,673.25,83.25
"11500","34108","2018",415,232,183,188012.6,2868.771,69.36867
"11501","34109","2018",12,12,0,106906.8,1476.333,71.83333
"11502","34110","2018",5,5,0,278234,2615,104.4
"11503","34111","2018",42,18,24,132122.3,1532.452,85.7381
"11504","34112","2018",2,2,0,277612.5,1607,159.5
"11505","34113","2018",96,83,13,237925.4,2673.031,90.28125
"11506","34114","2018",78,66,12,199437.2,2140.718,92.57692
"11507","34115","2018",2,1,1,146257.5,773,220
"11508","34116","2018",138,70,68,227977.4,2667.587,83.63768
"11509","34117","2018",9,3,6,56777.78,723,74.11111
"11510","34118","2018",4,3,1,219958.2,2299.25,95.5
"11511","34119","2018",22,16,6,120785,1352.545,90.36364
"11512","34120","2018",68,54,14,301865.5,3095.441,97.97059
"11513","34121","2018",2,2,0,61000,1264,59
"11514","34122","2018",12,12,0,163537.5,1491.917,121.4167
"11515","34123","2018",120,81,39,268309,2858.842,93.93333
"11516","34124","2018",6,6,0,204166.7,2479.833,89.16667
"11517","34125","2018",2,2,0,378249,3037,126.5
"11518","34126","2018",55,15,40,91736.35,1709.309,56.76364
"11519","34127","2018",38,36,2,273993.3,2719.237,103.6316
"11520","34128","2018",19,19,0,177436.8,1918.526,94.42105
"11521","34129","2018",272,123,149,294574.5,3713.309,80.55147
"11522","34130","2018",43,43,0,163950.2,1728.767,91.69767
"11523","34131","2018",5,4,1,314445,2718.2,125.4
"11524","34132","2018",1,1,0,36000,783,46
"11525","34134","2018",32,20,12,250421.8,3036.562,84.625
"11526","34135","2018",32,32,0,152555.8,1576.656,97.28125
"11527","34136","2018",20,19,1,143556.2,1501.35,95.45
"11528","34137","2018",1,1,0,150000,1705,88
"11529","34138","2018",4,4,0,165425,1412,116.25
"11530","34139","2018",18,18,0,197326.3,1701.944,114.7778
"11531","34140","2018",37,37,0,182457.8,1911.568,100.027
"11532","34141","2018",12,12,0,140266.7,1358.917,109.8333
"11533","34142","2018",87,51,36,141013.1,1522.552,89.08046
"11534","34143","2018",40,37,3,191259.5,2994.075,74.3
"11535","34144","2018",10,9,1,70835.2,882.8,80.5
"11536","34145","2018",383,232,151,167009.8,2060.112,81.23499
"11537","34146","2018",45,41,4,216589.2,2324.378,93.77778
"11538","34147","2018",33,32,1,209558.5,1946.939,105.3636
"11539","34148","2018",53,51,2,182619.8,1685.679,108
"11540","34149","2018",13,13,0,242896.2,2596.077,99.53846
"11541","34150","2018",301,146,155,159940.6,3200.625,55
"11542","34151","2018",102,85,17,182665.4,2198.529,84.84314
"11543","34152","2018",6,6,0,307491.7,2676.167,112.8333
"11544","34153","2018",19,18,1,279778.7,2745.421,101.6842
"11545","34154","2018",375,132,243,224684.3,3634.904,63.152
"11546","34155","2018",25,25,0,205131.6,2049.96,99.32
"11547","34156","2018",1,1,0,380500,1982,192
"11548","34157","2018",207,139,68,214313.6,2737.406,79.99034
"11549","34158","2018",1,1,0,40500,1350,30
"11550","34159","2018",39,30,9,217936.7,2594.462,83.25641
"11551","34160","2018",8,8,0,144753.8,2117.25,73.625
"11552","34161","2018",43,43,0,206305,2042.14,101.3256
"11553","34162","2018",50,46,4,149437.2,1783.34,83.24
"11554","34163","2018",31,24,7,233865,2397.452,97.48387
"11555","34164","2018",13,13,0,307307.7,2828.846,109.1538
"11556","34165","2018",42,37,5,213054.2,2298.905,90.80952
"11557","34166","2018",51,48,3,182989.5,1879.431,98.52941
"11558","34167","2018",1,0,1,195000,1696,115
"11559","34169","2018",38,34,4,517185.4,3526,152.4737
"11560","34170","2018",7,7,0,173341.4,1722.857,102.1429
"11561","34171","2018",1,1,0,450000,1860,242
"11562","34172","2018",4880,574,4306,172072.9,2860.704,61.50635
"11563","34173","2018",12,12,0,184002.1,2206.833,83.75
"11564","34174","2018",7,7,0,194501.4,1900.857,99.42857
"11565","34175","2018",3,2,1,105000,1289.667,83
"11566","34176","2018",34,25,9,219019.1,2526.5,88.29412
"11567","34177","2018",1,1,0,155000,2719,57
"11568","34178","2018",40,38,2,189029.5,2005.625,95.1
"11569","34180","2018",17,17,0,158424.7,2004.412,87
"11570","34181","2018",21,21,0,200467.1,1907.143,105.7619
"11571","34182","2018",24,24,0,203859.1,2156.792,101.7083
"11572","34183","2018",53,50,3,158809.9,1522.283,105.4151
"11573","34184","2018",12,11,1,123848.3,1543.583,80.41667
"11574","34185","2018",3,3,0,269643.3,1993.667,137.3333
"11575","34186","2018",9,8,1,199788.9,2721.667,83.77778
"11576","34187","2018",10,10,0,143688.5,1551.5,89.4
"11577","34188","2018",3,3,0,195083.3,2498.333,92.66667
"11578","34189","2018",20,18,2,161627.6,1710.25,94.4
"11579","34190","2018",3,3,0,40666.67,610.3333,72
"11580","34191","2018",8,8,0,227772.6,1814.5,116.75
"11581","34192","2018",258,39,219,196790.1,4297.543,46.83721
"11582","34193","2018",5,5,0,102902,1465.4,72.6
"11583","34194","2018",74,65,9,164294.3,1922.189,87.12162
"11584","34195","2018",1,1,0,150000,1875,80
"11585","34196","2018",1,1,0,48000,1231,39
"11586","34197","2018",14,14,0,170473.6,1474.786,108
"11587","34198","2018",161,131,30,322503.6,3568.745,92.2236
"11588","34199","2018",104,65,39,185538.1,2111.952,84.75962
"11589","34200","2018",2,2,0,197500,1670.5,115.5
"11590","34201","2018",1,1,0,265000,2345,113
"11591","34202","2018",94,65,29,235023.1,2763.915,87
"11592","34203","2018",26,26,0,189865.4,2146.115,90.38462
"11593","34204","2018",16,16,0,184966.2,2070,86.5625
"11594","34205","2018",4,4,0,168000,1259,122.75
"11595","34206","2018",7,5,2,233874.3,2055.571,122.5714
"11596","34207","2018",40,38,2,146481.2,1832.925,81.25
"11597","34208","2018",8,8,0,183043.1,2366.625,78.75
"11598","34209","2018",107,94,13,178145.6,2908.364,67.74766
"11599","34210","2018",34,32,2,191442.9,2020,96.73529
"11600","34211","2018",11,10,1,98245.45,1184.909,92.45455
"11601","34212","2018",3,3,0,153933.3,1725.333,73.66667
"11602","34213","2018",82,59,23,217069.4,2444.159,87.69512
"11603","34214","2018",18,18,0,189202.8,2187,91.77778
"11604","34215","2018",14,11,3,219725.7,1904.357,108.8571
"11605","34216","2018",6,6,0,191666.7,1684.5,106.1667
"11606","34217","2018",69,52,17,277913.2,2992.826,92.57971
"11607","34218","2018",7,7,0,201428.6,1445.857,139.2857
"11608","34219","2018",9,9,0,166466.7,1434.111,115.4444
"11609","34221","2018",5,5,0,271849,2663.6,127.6
"11610","34222","2018",6,6,0,305665.3,2597.833,116.6667
"11611","34223","2018",20,19,1,157996.6,1595.45,98.15
"11612","34224","2018",19,18,1,238942.1,1874.526,113.2632
"11613","34225","2018",40,36,4,133372.4,1427.75,93.225
"11614","34226","2018",37,36,1,151925.4,1479.081,103.1081
"11615","34227","2018",27,23,4,253911.2,2522.704,103.3333
"11616","34228","2018",1,1,0,40000,741,54
"11617","34229","2018",13,13,0,98347.31,1125.769,99.84615
"11618","34230","2018",3,3,0,116700,1313.333,89
"11619","34232","2018",17,14,3,168530.6,1992.235,86.47059
"11620","34233","2018",1,1,0,40000,702,57
"11621","34234","2018",2,2,0,289500,4269,48.5
"11622","34235","2018",7,5,2,82055.71,877.4286,85.71429
"11623","34236","2018",2,1,1,331060,2236,142
"11624","34237","2018",50,48,2,161957.6,1735.78,95.3
"11625","34238","2018",1,1,0,310000,1824,170
"11626","34239","2018",75,64,11,185983.3,2287.667,81.32
"11627","34240","2018",43,37,6,325442.9,2918.116,112.3953
"11628","34241","2018",12,12,0,163486.2,1948.917,76.5
"11629","34242","2018",19,19,0,398125.4,2693.105,148.2632
"11630","34243","2018",23,23,0,180792.3,1929.348,93.17391
"11631","34244","2018",22,19,3,243577.8,2904.409,84.5
"11632","34245","2018",31,25,6,111528,1345.129,84.87097
"11633","34246","2018",18,15,3,211177.8,2339.333,94.61111
"11634","34247","2018",59,51,8,444029.7,3407.458,130.0847
"11635","34248","2018",6,6,0,322150,2876.333,120
"11636","34249","2018",34,32,2,347821.4,3069.206,116.8235
"11637","34250","2018",5,5,0,79360,1127.8,66.8
"11638","34251","2018",2,2,0,176000,2117.5,86
"11639","34252","2018",6,5,1,85117.5,1149.167,75
"11640","34254","2018",16,16,0,203704.4,2074.25,97.5625
"11641","34255","2018",116,91,25,349160.6,3216.466,105.2328
"11642","34256","2018",22,22,0,343892.4,2804.455,122.6818
"11643","34257","2018",4,4,0,79750,1230.75,72.25
"11644","34258","2018",20,19,1,225430.5,2052.1,110.1
"11645","34259","2018",68,41,27,263160.7,2714.809,96.22059
"11646","34260","2018",16,15,1,95539.12,1098.562,87.625
"11647","34261","2018",5,3,2,136687.4,3168.6,47.2
"11648","34262","2018",4,4,0,250059.8,1797.5,143.5
"11649","34263","2018",5,5,0,346800,3197.8,113.8
"11650","34265","2018",11,11,0,304390.9,2924.364,107
"11651","34266","2018",3,3,0,664060.7,7064.667,121.3333
"11652","34267","2018",20,20,0,214718.1,1994.55,105.6
"11653","34268","2018",11,11,0,138640.9,1515.273,92.27273
"11654","34269","2018",2,2,0,112500,1551,80
"11655","34270","2018",146,97,49,319466.8,3228.863,98.44521
"11656","34271","2018",4,4,0,182750,2318.25,85.25
"11657","34272","2018",30,26,4,275160.8,2725.467,103.9333
"11658","34273","2018",2,2,0,79000,1090.5,72
"11659","34274","2018",29,29,0,273201.5,2689.069,105.3793
"11660","34276","2018",43,37,6,293266.5,2865.442,104.0698
"11661","34277","2018",4,4,0,89882.5,1186,87
"11662","34279","2018",7,7,0,112578.6,1274,85
"11663","34280","2018",3,3,0,429000,3282.667,132.6667
"11664","34281","2018",45,43,2,178003,1785.289,98.48889
"11665","34282","2018",12,8,4,217554.1,2377.25,92.83333
"11666","34283","2018",1,1,0,113000,1430,79
"11667","34284","2018",20,17,3,76322.75,1013.6,70.95
"11668","34285","2018",9,9,0,155533.3,1623.556,84.88889
"11669","34286","2018",9,9,0,134813.7,1492,96.11111
"11670","34287","2018",1,1,0,103780,2118,49
"11671","34288","2018",5,4,1,298366.2,2347.2,123.8
"11672","34289","2018",45,42,3,128746.4,1697.889,81.51111
"11673","34290","2018",4,4,0,528065.2,4090.75,133
"11674","34291","2018",6,6,0,99773.5,1522.333,64.83333
"11675","34292","2018",5,5,0,202142,2180.8,104.6
"11676","34293","2018",41,41,0,80939,1226.146,68.46341
"11677","34294","2018",11,11,0,173255.9,1903.455,94
"11678","34295","2018",17,17,0,294089.4,2545.235,124.1765
"11679","34296","2018",5,5,0,246010,2423.4,105.8
"11680","34297","2018",2,1,1,107000,3693,30.5
"11681","34298","2018",73,71,2,205902.2,2255.493,93.87671
"11682","34299","2018",116,97,19,196631.9,2259.793,81.24138
"11683","34300","2018",77,74,3,187812.9,1862.649,98
"11684","34301","2018",1178,164,1014,159451.7,2587.449,61.92869
"11685","34302","2018",16,16,0,162595.8,1673.375,100.375
"11686","34303","2018",1,1,0,61000,1052,58
"11687","34304","2018",11,11,0,152235.7,1505.364,93.54545
"11688","34305","2018",9,9,0,121000,1518.556,82.55556
"11689","34306","2018",3,3,0,177463.3,1430.333,112.3333
"11690","34307","2018",33,24,9,273768.2,2854.879,100.9697
"11691","34308","2018",8,8,0,89062.5,1175.875,83.125
"11692","34310","2018",33,33,0,156988.6,1672.727,90.57576
"11693","34311","2018",29,28,1,221444.1,2078.31,102.5517
"11694","34312","2018",16,15,1,118200,1315.188,107.4375
"11695","34313","2018",6,6,0,239440,1726.667,139.6667
"11696","34314","2018",8,6,2,360237.5,3228.875,114.625
"11697","34315","2018",4,4,0,223237.5,2139,104.75
"11698","34316","2018",3,3,0,218173.3,2041.333,109.6667
"11699","34317","2018",6,6,0,79500,1059.833,75.83333
"11700","34318","2018",5,5,0,348820,2231.6,151.2
"11701","34319","2018",1,1,0,117925,1203,98
"11702","34320","2018",24,24,0,294563.8,2548.667,113.125
"11703","34321","2018",24,23,1,317012,2979.708,106.5417
"11704","34322","2018",8,8,0,354225,3257.125,108.875
"11705","34323","2018",1,1,0,219950,1833,120
"11706","34324","2018",275,118,157,146455.7,3057.364,49.69091
"11707","34325","2018",20,20,0,176804.5,1709.15,103.7
"11708","34327","2018",72,58,14,300613.3,3296.417,91.61111
"11709","34328","2018",14,13,1,187121.4,2002.786,90.35714
"11710","34329","2018",47,37,10,144260.5,2536.681,62.7234
"11711","34331","2018",1,1,0,25000,500,50
"11712","34332","2018",153,135,18,154236.9,2375.072,67.93464
"11713","34333","2018",79,78,1,171800.5,4209.633,49.63291
"11714","34334","2018",1,1,0,117150,545,215
"11715","34335","2018",5,5,0,81940,1311.4,60.6
"11716","34336","2018",78,61,17,156990,1819.5,84.25641
"11717","34337","2018",90,79,11,300480.3,3026.533,100.4
"11718","34339","2018",1,1,0,61000,508,120
"11719","34340","2018",14,13,1,282979.3,2444.714,121.2857
"11720","34341","2018",43,39,4,198010.4,2007.721,98.09302
"11721","34342","2018",4,3,1,422452.5,2966.25,134.25
"11722","34343","2018",8,8,0,358974.9,2293.5,149.375
"11723","34344","2018",806,57,749,169063.1,4174.331,39.44665
"11724","35001","2018",92,64,28,204349.8,2204.728,93.6087
"11725","35002","2018",21,21,0,200906.7,1954.333,110.8571
"11726","35003","2018",8,8,0,122003.4,1275.25,91.125
"11727","35004","2018",32,31,1,99885.09,1044.375,99.46875
"11728","35005","2018",6,6,0,129816.7,1209.833,105.8333
"11729","35006","2018",47,38,9,147209,1481.447,100
"11730","35007","2018",5,5,0,154815,1524,104.2
"11731","35008","2018",3,3,0,143333.3,1413.333,101.3333
"11732","35009","2018",19,19,0,153136.2,1477.421,104.3684
"11733","35010","2018",24,24,0,130943.5,1412.208,93.95833
"11734","35012","2018",94,81,13,151904.2,1631.255,94.20213
"11735","35013","2018",45,45,0,114112.9,1157.756,99.71111
"11736","35014","2018",35,34,1,137147.7,1431.743,100.2571
"11737","35015","2018",18,18,0,127555.6,1456.444,89.11111
"11738","35016","2018",32,32,0,161167.8,1504.219,104.9688
"11739","35017","2018",7,6,1,162857.1,1553.571,107.4286
"11740","35018","2018",15,15,0,91095.33,1173.267,87.86667
"11741","35019","2018",32,32,0,107341.2,1162.969,95.3125
"11742","35021","2018",12,12,0,137141.7,1476.5,96.91667
"11743","35022","2018",13,12,1,140730.8,1404.462,98.61538
"11744","35023","2018",53,44,9,182185.1,1888.396,98.01887
"11745","35024","2018",165,97,68,228744.7,2523.818,91.63636
"11746","35025","2018",11,11,0,110181.8,1161.364,95.81818
"11747","35026","2018",1,1,0,140000,1197,117
"11748","35027","2018",14,14,0,152600.4,1608.929,95.21429
"11749","35028","2018",6,6,0,95222.33,1130.5,85.66667
"11750","35029","2018",23,23,0,158466.1,1470.478,110.2609
"11751","35030","2018",5,5,0,147000,1782.4,87.4
"11752","35031","2018",45,42,3,176059.5,1845.689,94.62222
"11753","35032","2018",65,47,18,191746,2049.415,94.41538
"11754","35033","2018",56,50,6,176677.8,1686.321,105.1964
"11755","35034","2018",17,17,0,99234.94,1064.176,95.29412
"11756","35035","2018",8,8,0,164673.5,1249.5,126.5
"11757","35037","2018",80,60,20,188570.5,2023.062,95.425
"11758","35038","2018",10,10,0,106795.6,1039.9,105.9
"11759","35039","2018",19,18,1,219052.3,1900.632,113.8947
"11760","35040","2018",40,27,13,170844.8,1783.425,97.475
"11761","35041","2018",12,12,0,169675.4,1879.833,94.16667
"11762","35042","2018",11,11,0,103384.7,1125.545,89.54545
"11763","35044","2018",1,1,0,145000,1208,120
"11764","35045","2018",12,12,0,117858.6,1260.667,87.41667
"11765","35046","2018",5,5,0,96423.2,988.8,90.6
"11766","35047","2018",252,130,122,209693.4,2465.802,87.27381
"11767","35049","2018",112,80,32,202869.2,2910.643,79.11607
"11768","35050","2018",6,6,0,172775,1740.667,96.5
"11769","35051","2018",217,126,91,319203.4,3097.327,103.8341
"11770","35052","2018",8,8,0,169340,1561.5,108.875
"11771","35054","2018",21,21,0,182097.4,1884.571,103.1429
"11772","35055","2018",154,51,103,193518.3,2418.052,80.12987
"11773","35056","2018",8,8,0,145891.8,1578.25,93.625
"11774","35057","2018",24,21,3,120950,1293.083,95.5
"11775","35058","2018",18,18,0,186772.2,1751.389,105.6667
"11776","35059","2018",55,42,13,225606.5,2389.545,94.16364
"11777","35060","2018",14,14,0,140045.9,1402.786,95.35714
"11778","35061","2018",5,5,0,106900,1421.6,77.6
"11779","35062","2018",15,15,0,127753.3,1266.867,103.8667
"11780","35063","2018",3,3,0,171633.3,1141,159.3333
"11781","35064","2018",21,21,0,72962.14,975.619,75.2381
"11782","35065","2018",17,17,0,187823.2,2020.765,96.94118
"11783","35066","2018",153,71,82,182340.8,2280.294,79.32026
"11784","35067","2018",17,17,0,200658.8,1733.471,115.8824
"11785","35068","2018",84,58,26,169547,1956.012,88.70238
"11786","35069","2018",130,96,34,218698.1,2192.615,100.1385
"11787","35070","2018",28,23,5,168428.6,1806.179,96.46429
"11788","35071","2018",5,5,0,153560.8,1118.2,138
"11789","35072","2018",15,15,0,145426,1412.2,108.1333
"11790","35075","2018",8,8,0,148069.9,1442.25,101
"11791","35076","2018",54,36,18,182885.6,2046.315,89.62963
"11792","35077","2018",3,3,0,148033.3,1284,119.3333
"11793","35078","2018",6,6,0,196666.7,2618.5,82.5
"11794","35079","2018",24,23,1,221838.6,1864.958,122.9583
"11795","35080","2018",26,25,1,209231.7,1938.269,108.7308
"11796","35081","2018",8,8,0,188062.5,2089.875,90.875
"11797","35082","2018",17,16,1,120205.9,1206.176,104.3529
"11798","35084","2018",7,7,0,121190,1243.286,96.42857
"11799","35085","2018",51,42,9,141038.2,1581.667,88.27451
"11800","35086","2018",7,7,0,95001.29,968.4286,95.28571
"11801","35087","2018",13,13,0,136508.1,1562.692,89.46154
"11802","35088","2018",25,23,2,162467.5,1807.8,93
"11803","35089","2018",7,7,0,128000,1225.714,101.7143
"11804","35090","2018",33,21,12,149192.4,1762.485,85.42424
"11805","35091","2018",6,6,0,159566.7,1234.167,127.1667
"11806","35092","2018",14,14,0,126567.9,1249.286,101
"11807","35093","2018",352,161,191,285987.5,3905.08,74.36648
"11808","35094","2018",23,23,0,153372.2,1554.739,96.04348
"11809","35095","2018",98,60,38,128676.1,1653.163,79.97959
"11810","35096","2018",32,28,4,160461.8,1676.562,99.1875
"11811","35097","2018",30,30,0,128060,1406.033,87.16667
"11812","35098","2018",16,16,0,134564.7,1306.875,101.0625
"11813","35099","2018",56,46,10,213365.3,2065.786,104.2679
"11814","35101","2018",13,13,0,139241.8,1686.385,85.84615
"11815","35102","2018",3,3,0,105000,1022,95.66667
"11816","35103","2018",6,6,0,74916.67,828.1667,92.66667
"11817","35104","2018",16,16,0,125106.2,1401.312,92.8125
"11818","35105","2018",15,15,0,135926.4,1431.4,99.86667
"11819","35106","2018",13,13,0,98846.15,1061.077,90.30769
"11820","35107","2018",24,23,1,194841.7,1832.083,108.9167
"11821","35108","2018",7,7,0,193697.6,1730.286,116.1429
"11822","35109","2018",15,12,3,116999.3,1476.8,80.86667
"11823","35110","2018",6,6,0,109212.5,1249.667,87.33333
"11824","35111","2018",5,5,0,87820,838,113
"11825","35112","2018",12,11,1,127183.3,1445.25,95.33333
"11826","35114","2018",3,3,0,75676,835.6667,96.33333
"11827","35115","2018",295,152,143,118817,1355.749,86.28475
"11828","35116","2018",32,32,0,158109.4,1656.969,99.90625
"11829","35117","2018",20,18,2,103623.5,1012.4,105.65
"11830","35118","2018",22,21,1,155489.1,1474.318,103.4091
"11831","35119","2018",5,5,0,177786,1199.8,140.6
"11832","35120","2018",78,61,17,205777.1,2161.346,96.42308
"11833","35121","2018",15,13,2,177794,1836,96.86667
"11834","35122","2018",23,19,4,165087,2031.87,84.30435
"11835","35123","2018",54,45,9,197876.5,1859.815,107.6296
"11836","35124","2018",29,29,0,110466.8,1133.241,101.2069
"11837","35125","2018",43,32,11,94550.91,1121.767,83.06977
"11838","35126","2018",103,87,16,194984.8,1864.66,105.5437
"11839","35127","2018",37,36,1,155233.1,1655.865,97.78378
"11840","35128","2018",19,19,0,129557.1,1634.105,84.57895
"11841","35130","2018",17,14,3,166178.8,1690.235,93.41176
"11842","35131","2018",63,35,28,186833.8,2091.825,90.7619
"11843","35132","2018",19,19,0,194182.6,1955.211,104.5789
"11844","35133","2018",35,34,1,143877.2,1551.086,94.34286
"11845","35134","2018",3,3,0,245886.7,1452.333,166
"11846","35135","2018",29,22,7,138738.3,1507,94.41379
"11847","35136","2018",108,65,43,147760.8,1699.028,90.25926
"11848","35137","2018",19,19,0,169351.1,1608.474,114.6316
"11849","35138","2018",5,5,0,169119.4,1656.6,101.8
"11850","35139","2018",53,46,7,255798.1,2236.679,121.1698
"11851","35140","2018",8,8,0,134951.2,1458,92.875
"11852","35141","2018",6,6,0,203100,1596.333,132.6667
"11853","35142","2018",11,10,1,127614.6,1057.818,124
"11854","35143","2018",7,7,0,125450,1209.286,104
"11855","35144","2018",8,8,0,178175,1791.25,101.5
"11856","35145","2018",21,21,0,93007.71,1047.905,88.38095
"11857","35146","2018",10,10,0,217450,1952.9,110.4
"11858","35148","2018",1,1,0,160000,1019,157
"11859","35149","2018",16,16,0,193284.3,1770.438,113.4375
"11860","35150","2018",32,32,0,187287,1772.969,106.1562
"11861","35151","2018",6,6,0,104165,1170.333,86.66667
"11862","35152","2018",99,75,24,197597.8,2136.848,92.43434
"11863","35153","2018",3,3,0,156666.7,1672.333,95.66667
"11864","35154","2018",14,14,0,143562.5,1515.857,91.5
"11865","35155","2018",6,6,0,78083.33,976.1667,80.5
"11866","35156","2018",3,3,0,177666.7,1181,154.3333
"11867","35157","2018",7,7,0,121557.1,903.2857,128.5714
"11868","35159","2018",1,1,0,150000,1172,128
"11869","35160","2018",4,4,0,82500,942,82.5
"11870","35161","2018",28,27,1,130091.5,1405.679,95.82143
"11871","35162","2018",22,21,1,111948,1042.182,105.9545
"11872","35163","2018",14,14,0,124479.7,1236.714,105.1429
"11873","35164","2018",9,9,0,111677,1093.889,100.8889
"11874","35165","2018",11,11,0,132400,1304.455,96.72727
"11875","35166","2018",9,9,0,152766.7,1534.222,103.8889
"11876","35167","2018",33,31,2,97569.7,1032.879,100
"11877","35168","2018",43,42,1,114467.9,1232.302,92.25581
"11878","35169","2018",17,17,0,143076.5,1423.824,109.2941
"11879","35170","2018",10,10,0,127100,1182.7,108.5
"11880","35171","2018",22,22,0,157692.7,1364.182,121.0455
"11881","35172","2018",29,28,1,119597.5,1438.31,90.93103
"11882","35173","2018",78,62,16,245717.5,2517.128,103.8462
"11883","35174","2018",6,6,0,100490.8,1124.667,89.83333
"11884","35175","2018",8,8,0,158849.5,1255.375,125.375
"11885","35176","2018",87,85,2,122229.8,1380.862,90.98851
"11886","35177","2018",74,40,34,209205.4,2337.919,89.66216
"11887","35178","2018",18,18,0,142146.3,1554.722,91.77778
"11888","35179","2018",51,49,2,156690.2,1700.941,94.47059
"11889","35180","2018",5,5,0,149200,1358.8,110.8
"11890","35181","2018",19,19,0,309894.7,2458.842,125.6316
"11891","35183","2018",8,8,0,127233.8,1531.125,90.875
"11892","35184","2018",62,53,9,163284.9,1550.145,105.9032
"11893","35185","2018",6,5,1,112496.7,946.8333,113.5
"11894","35186","2018",19,19,0,144060.5,1537.526,100.3684
"11895","35187","2018",17,17,0,166361.8,1482.059,120.3529
"11896","35188","2018",86,61,25,170624.4,1842.372,95.36047
"11897","35189","2018",58,37,21,227396.6,2433.966,92.91379
"11898","35190","2018",6,6,0,101408.3,901.1667,112.8333
"11899","35191","2018",26,26,0,111811.5,1006.885,107.2692
"11900","35193","2018",30,29,1,198875.2,1997,101.8667
"11901","35194","2018",11,11,0,145183.2,1417.455,102.9091
"11902","35195","2018",23,21,2,128954.3,1521.478,84.56522
"11903","35196","2018",110,48,62,182667.2,2212.245,83.48182
"11904","35197","2018",17,17,0,211353.9,1985.706,108.1765
"11905","35198","2018",6,5,1,86833.33,1177.333,70.5
"11906","35199","2018",5,5,0,125940,1305.2,96.4
"11907","35200","2018",6,6,0,105916.7,1282.5,83.16667
"11908","35201","2018",11,11,0,100209.1,992.8182,101.6364
"11909","35202","2018",12,12,0,76661.5,1006.333,71.16667
"11910","35203","2018",3,3,0,216243.3,1829,122.3333
"11911","35204","2018",34,26,8,195203.7,1932.5,100
"11912","35205","2018",5,5,0,132756.4,1585.4,86.6
"11913","35206","2018",96,63,33,204355.8,2227.104,95.86458
"11914","35207","2018",48,27,21,201059.3,2188.542,92.125
"11915","35208","2018",85,58,27,179957.5,2059.847,87.35294
"11916","35210","2018",117,68,49,252239.4,2429.35,104.9402
"11917","35211","2018",29,29,0,154996.2,1368.897,114.6207
"11918","35212","2018",13,13,0,141713.2,1414.077,99.84615
"11919","35214","2018",10,10,0,133420,1822.5,94.7
"11920","35215","2018",9,9,0,133000,1235.667,111.5556
"11921","35216","2018",21,16,5,222307.9,1851.762,113.7143
"11922","35217","2018",12,12,0,99458.33,1112.667,89
"11923","35218","2018",12,12,0,155541.7,1519.833,103.8333
"11924","35219","2018",29,28,1,119454.9,1288.207,92.72414
"11925","35220","2018",44,42,2,172388.5,1657.5,107.8409
"11926","35221","2018",36,36,0,130560.1,1419.972,92.08333
"11927","35222","2018",30,29,1,130216.7,1296.433,102.7333
"11928","35223","2018",37,29,8,121164.9,1504.541,85.40541
"11929","35224","2018",47,47,0,146474.3,1645.404,92.38298
"11930","35225","2018",10,9,1,129023,1334.4,99.5
"11931","35226","2018",16,16,0,118594.6,1178.188,109.375
"11932","35227","2018",29,24,5,208770.7,2106.586,100.5172
"11933","35228","2018",115,67,48,178519.2,1982.843,87.06957
"11934","35229","2018",10,10,0,169920,1622.8,106.1
"11935","35230","2018",4,4,0,206000,1601.5,135.25
"11936","35231","2018",12,12,0,156002.5,1395.167,123.4167
"11937","35232","2018",5,5,0,95240,1141,92.2
"11938","35233","2018",26,26,0,180113.6,1811.5,107.7692
"11939","35234","2018",10,10,0,96625,1203.9,81.1
"11940","35235","2018",11,11,0,104581.8,893.0909,116.1818
"11941","35236","2018",157,92,65,115245.6,1379.287,86.06369
"11942","35237","2018",12,12,0,83366.25,1081,75.08333
"11943","35238","2018",3912,505,3407,186452.9,2887.78,65.13829
"11944","35239","2018",54,50,4,131286.9,1399.019,95.01852
"11945","35240","2018",109,48,61,201203.2,2282.945,88.94495
"11946","35241","2018",29,27,2,278736.6,2615.586,109.5172
"11947","35242","2018",4,4,0,74737.5,966.25,76
"11948","35243","2018",20,20,0,171673.2,1646,108.85
"11949","35244","2018",4,4,0,139250,1077.75,140.25
"11950","35245","2018",43,38,5,191065.9,1764.837,111.9767
"11951","35246","2018",12,12,0,132911.3,1335.75,96.25
"11952","35247","2018",16,16,0,139156.2,1199.438,112.0625
"11953","35248","2018",12,12,0,105625.4,1499.917,79.75
"11954","35249","2018",21,21,0,88952.38,1083.381,79.09524
"11955","35250","2018",46,22,24,160284.7,1967.565,83.69565
"11956","35251","2018",53,42,11,187856.3,1901.057,103.0943
"11957","35252","2018",10,10,0,144650,1264.7,114.5
"11958","35253","2018",10,10,0,151969,1624,101.5
"11959","35255","2018",9,8,1,138884.4,1966,71.33333
"11960","35256","2018",51,43,8,379783.5,3716.039,101.9412
"11961","35257","2018",40,39,1,131143,1269.325,104.175
"11962","35258","2018",2,2,0,214250,1636.5,123
"11963","35259","2018",16,14,2,130422.5,1295.75,109.8125
"11964","35260","2018",9,9,0,84193.44,1171.444,70.77778
"11965","35262","2018",3,3,0,149950,1349.667,111.3333
"11966","35263","2018",26,24,2,363670.5,3229.192,106.5385
"11967","35264","2018",8,7,1,207125,2188,110.75
"11968","35265","2018",30,26,4,165507,1659.2,100.6333
"11969","35266","2018",54,28,26,188881.9,2058.852,94.2037
"11970","35268","2018",4,4,0,66099.75,734.5,93.5
"11971","35270","2018",5,5,0,156300,1754.4,115.6
"11972","35271","2018",22,22,0,92958.18,963.5909,96.27273
"11973","35272","2018",12,12,0,140212.1,1434.667,100.5
"11974","35273","2018",18,18,0,141497.2,1384.889,99.11111
"11975","35274","2018",12,12,0,197605.8,1846.333,108.4167
"11976","35275","2018",74,49,25,206378.1,2268.824,93.43243
"11977","35276","2018",11,11,0,178872.7,1782.091,105.7273
"11978","35277","2018",6,6,0,128916.7,1484.833,90.16667
"11979","35278","2018",120,72,48,336586.1,2944.192,114.025
"11980","35279","2018",10,10,0,152735,1707.8,87.9
"11981","35280","2018",9,9,0,144348.3,1365.889,107.6667
"11982","35281","2018",274,88,186,162744,2237.142,72.83212
"11983","35282","2018",37,37,0,129843.7,1388.676,93.72973
"11984","35283","2018",13,12,1,206153.9,1897.923,112
"11985","35284","2018",34,28,6,205162.4,2373.294,91.14706
"11986","35285","2018",13,13,0,80928.08,911.4615,89.92308
"11987","35286","2018",1,1,0,128000,1208,106
"11988","35287","2018",63,49,14,340111.1,3400.27,95.73016
"11989","35288","2018",1013,382,631,242316.2,3370.914,73.64956
"11990","35289","2018",12,12,0,127790.4,1363.417,95.66667
"11991","35290","2018",5,5,0,141650,1190.8,105.8
"11992","35291","2018",8,8,0,78185,815.25,97.625
"11993","35292","2018",14,14,0,105700,1098.786,92.85714
"11994","35294","2018",23,23,0,138058.7,1464.261,94.82609
"11995","35295","2018",3,3,0,132633.3,1151.667,114.3333
"11996","35296","2018",12,12,0,202011.7,2001.833,106.1667
"11997","35297","2018",60,46,14,108523,1274.8,85.4
"11998","35299","2018",77,69,8,215177.4,2138.896,100.3766
"11999","35300","2018",12,12,0,175458.3,1715.417,109.5
"12000","35302","2018",10,10,0,140606,1376.7,98.8
"12001","35304","2018",16,16,0,135793.8,1237.75,102.9375
"12002","35305","2018",7,7,0,147057.1,1505.571,94.71429
"12003","35306","2018",27,26,1,219853.7,2111.037,109.2222
"12004","35307","2018",8,8,0,141986.2,1220.5,113.75
"12005","35308","2018",72,71,1,133894.9,1365.847,96.26389
"12006","35309","2018",9,9,0,120355.1,1143.889,102.4444
"12007","35310","2018",8,8,0,148418.8,1462,105.75
"12008","35311","2018",4,4,0,108504.5,1112,92.5
"12009","35312","2018",20,20,0,172790,1717.35,99
"12010","35314","2018",16,16,0,285827.2,3621.312,77.8125
"12011","35315","2018",9,9,0,249954.7,2229.667,109.3333
"12012","35316","2018",12,12,0,100424.7,1118.667,93.16667
"12013","35317","2018",5,5,0,189600,1762,110.4
"12014","35318","2018",14,14,0,152000,1630.286,99.64286
"12015","35319","2018",28,23,5,153360.7,1629.464,95.5
"12016","35320","2018",10,10,0,144350,1414.4,111.5
"12017","35321","2018",10,10,0,140975.6,1554,91.6
"12018","35322","2018",16,16,0,177686.9,1453.75,122.0625
"12019","35324","2018",4,4,0,125925,1041.5,119.5
"12020","35325","2018",1,1,0,130000,1806,72
"12021","35326","2018",27,26,1,164207.4,1615.185,105.5926
"12022","35327","2018",30,24,6,193929.7,2098.667,95.6
"12023","35328","2018",40,40,0,112549,1127.925,99.6
"12024","35329","2018",9,9,0,77505.33,1076.556,71.77778
"12025","35330","2018",11,11,0,149689,1283.273,120.6364
"12026","35331","2018",22,22,0,168293.5,1829.273,92.5
"12027","35332","2018",24,24,0,83912.25,937.25,91.16667
"12028","35333","2018",20,20,0,155232.6,1496.7,106.1
"12029","35334","2018",106,64,42,229211.1,2509.123,92.99057
"12030","35335","2018",7,7,0,150142.9,1245.857,128.1429
"12031","35336","2018",1,1,0,65000,1066,61
"12032","35337","2018",46,39,7,174906.4,1893.543,95.86957
"12033","35338","2018",13,13,0,133199.3,1379.692,98.92308
"12034","35339","2018",11,11,0,82130.73,1008,81.27273
"12035","35340","2018",1,1,0,125000,2273,55
"12036","35342","2018",3,3,0,153003.3,1688.667,87
"12037","35343","2018",17,17,0,113379.6,1205.647,91.11765
"12038","35345","2018",5,5,0,85290.8,1215.8,73.6
"12039","35346","2018",2,2,0,145000,977,146.5
"12040","35347","2018",24,23,1,152401.4,1433.667,109.8333
"12041","35350","2018",3,3,0,89133.33,998.6667,90
"12042","35351","2018",17,17,0,179518.5,1697.294,109.0588
"12043","35352","2018",91,71,20,249622.6,2248.077,112.2747
"12044","35353","2018",65,39,26,236904.9,2452.092,98.36923
"12045","35354","2018",2,2,0,99900,989.5,100
"12046","35355","2018",13,13,0,134948.7,1559.154,89.07692
"12047","35356","2018",19,18,1,214018.3,1954.053,113.6316
"12048","35358","2018",23,23,0,194331.7,1863.696,102.6522
"12049","35359","2018",3,3,0,206300,1289.333,154.6667
"12050","35360","2018",206,137,69,191357.8,2008.743,96.25728
"12051","35361","2018",24,24,0,164618.8,1692.292,104.25
"12052","35362","2018",20,18,2,127260,1556.25,88.9
"12053","35363","2018",49,31,18,197600.9,2117.449,93.67347
"12054","36001","2018",17,17,0,60647.06,922.2353,74.94118
"12055","36002","2018",1,1,0,60000,750,80
"12056","36003","2018",9,9,0,106322.2,1046.222,109.2222
"12057","36004","2018",5,5,0,232424,2043,127.2
"12058","36005","2018",43,43,0,113818.6,1255.326,91.88372
"12059","36006","2018",59,54,5,90844.63,1102.508,85.77966
"12060","36007","2018",9,9,0,234923.8,2012.778,96.55556
"12061","36008","2018",3,3,0,91695,785.3333,115.6667
"12062","36009","2018",7,7,0,149686.3,1336.714,116.1429
"12063","36010","2018",6,6,0,65210.17,838.1667,76
"12064","36012","2018",2,2,0,74500,783.5,95
"12065","36013","2018",5,5,0,68139.6,959.8,89.6
"12066","36014","2018",3,3,0,111500,1267,83.33333
"12067","36015","2018",1,0,1,120000,1017,118
"12068","36016","2018",16,16,0,96412.5,950.875,110
"12069","36017","2018",6,6,0,76866.67,950.5,77.5
"12070","36018","2018",45,43,2,95852.6,1103.978,84.53333
"12071","36019","2018",4,4,0,147425,1027.5,145.25
"12072","36021","2018",3,3,0,142333.3,1253,113.3333
"12073","36022","2018",5,5,0,80600,1089.6,75.2
"12074","36023","2018",2,2,0,41000,595,70.5
"12075","36024","2018",2,2,0,99000,986.5,105
"12076","36025","2018",2,2,0,57500,672.5,93
"12077","36026","2018",7,7,0,126985.7,1255,101
"12078","36027","2018",3,3,0,99000,830.6667,108
"12079","36028","2018",3,3,0,66833.33,635.3333,97.66667
"12080","36029","2018",3,3,0,76833.33,1105.667,73.66667
"12081","36030","2018",5,5,0,78300,758.8,112.8
"12082","36031","2018",43,42,1,75051.02,960.186,75.65116
"12083","36032","2018",8,8,0,118893.8,884.875,130.625
"12084","36033","2018",4,4,0,74040.5,689.5,106.25
"12085","36034","2018",26,26,0,76242.35,1009.769,80.26923
"12086","36035","2018",12,12,0,86991.67,1110.917,85.08333
"12087","36036","2018",3,3,0,51000,653.6667,81.66667
"12088","36037","2018",3,3,0,120000,723.6667,164.6667
"12089","36038","2018",1,1,0,24000,480,50
"12090","36040","2018",2,2,0,106500,999.5,107
"12091","36042","2018",4,4,0,87375,929.75,96.75
"12092","36043","2018",6,6,0,71641.5,756.6667,97.5
"12093","36044","2018",544,353,191,101102.1,1223.803,82.82169
"12094","36045","2018",18,15,3,62625,864,79.05556
"12095","36046","2018",50,45,5,97332.38,976.6,102.02
"12096","36047","2018",7,7,0,62042.86,637.2857,105.2857
"12097","36048","2018",4,4,0,109075,1073.25,100.75
"12098","36049","2018",1,1,0,24000,429,56
"12099","36050","2018",8,8,0,82712.5,998,87.375
"12100","36051","2018",2,2,0,67750,1045.5,67.5
"12101","36052","2018",1,1,0,115300,774,149
"12102","36053","2018",4,4,0,188750,1952.25,88
"12103","36054","2018",1,1,0,37000,685,54
"12104","36055","2018",16,16,0,110399.4,1166.188,97.4375
"12105","36056","2018",10,10,0,71410.8,690.4,104.2
"12106","36057","2018",5,5,0,139400,1225.4,125.8
"12107","36058","2018",7,7,0,104300,984.4286,114.1429
"12108","36060","2018",7,7,0,115885.7,930.7143,116.4286
"12109","36061","2018",9,9,0,102947.4,878.3333,129.1111
"12110","36062","2018",6,6,0,54833.33,692.6667,81.66667
"12111","36063","2018",86,83,3,113837.3,1248.442,92.77907
"12112","36064","2018",3,3,0,108166.7,1275.667,85.66667
"12113","36065","2018",4,4,0,110875,902,122.5
"12114","36066","2018",5,5,0,74420,661.4,114.4
"12115","36067","2018",2,2,0,64250,675,93.5
"12116","36068","2018",7,7,0,75385.71,819,96.57143
"12117","36069","2018",16,16,0,66064.56,779,84.1875
"12118","36070","2018",11,11,0,92543.82,1073.909,88
"12119","36071","2018",9,9,0,124505.6,1257.222,98.44444
"12120","36073","2018",2,2,0,87917.5,782.5,129
"12121","36074","2018",6,6,0,82898.83,809.6667,104.5
"12122","36075","2018",2,2,0,127500,1375.5,78.5
"12123","36076","2018",4,4,0,135665,1021,134
"12124","36077","2018",3,3,0,107693.3,1160.667,100
"12125","36078","2018",6,6,0,53075,774.5,72.66667
"12126","36080","2018",1,1,0,53000,815,65
"12127","36081","2018",6,6,0,83900,1088.333,73.33333
"12128","36082","2018",4,4,0,84250,740,107.75
"12129","36083","2018",1,1,0,250000,1761,142
"12130","36085","2018",4,4,0,97100,855,107.75
"12131","36086","2018",4,4,0,87250,984.75,95.25
"12132","36087","2018",3,3,0,55019.67,724,75.33333
"12133","36088","2018",127,117,10,90340.67,1008.157,88.05512
"12134","36089","2018",6,6,0,193176.5,2187.333,107
"12135","36090","2018",2,2,0,31000,545,56.5
"12136","36091","2018",4,4,0,70700,920,73.25
"12137","36092","2018",1,1,0,52093,620,84
"12138","36093","2018",29,29,0,92826.31,959.5517,104.931
"12139","36094","2018",5,5,0,86200,907.8,84.2
"12140","36096","2018",2,2,0,198700,2497,80.5
"12141","36097","2018",3,3,0,978372.7,4881.667,143
"12142","36098","2018",1,1,0,162650,904,180
"12143","36099","2018",4,4,0,54250,718.75,76.25
"12144","36100","2018",2,2,0,37000,464.5,78
"12145","36101","2018",18,18,0,119788.9,1202.778,98.11111
"12146","36102","2018",2,2,0,102500,1117,92
"12147","36103","2018",13,13,0,97709.23,873.5385,98.84615
"12148","36104","2018",5,5,0,91600,1025.2,96.8
"12149","36105","2018",2,2,0,77000,1178,61.5
"12150","36106","2018",2,2,0,38000,587.5,61.5
"12151","36107","2018",7,7,0,81585.71,1040.857,87.71429
"12152","36108","2018",5,5,0,76264,846.2,103.4
"12153","36109","2018",10,10,0,117337.3,983.7,111.7
"12154","36110","2018",5,5,0,75376,779.4,93.8
"12155","36111","2018",3,3,0,130000,1420,108
"12156","36112","2018",7,7,0,69071.43,912.1429,76.42857
"12157","36113","2018",13,13,0,79814.62,804.8462,97.84615
"12158","36114","2018",6,6,0,147466.7,1408.5,99.5
"12159","36115","2018",2,2,0,66261.5,626,97
"12160","36117","2018",4,4,0,109150,1011.25,107.5
"12161","36118","2018",5,5,0,41440,1081.6,42.6
"12162","36119","2018",8,8,0,99011.25,978.625,108.875
"12163","36120","2018",6,6,0,72794.17,1169.667,74.16667
"12164","36121","2018",1,1,0,65000,929,70
"12165","36122","2018",1,1,0,57000,2280,25
"12166","36123","2018",10,10,0,88896.5,1116.9,73.3
"12167","36124","2018",5,5,0,90350,1449.8,74.4
"12168","36125","2018",1,1,0,125000,1344,93
"12169","36126","2018",6,6,0,41500,689.3333,58.83333
"12170","36127","2018",17,17,0,75567.24,819.9412,95
"12171","36128","2018",16,16,0,133404.1,1299.125,101.0625
"12172","36129","2018",12,12,0,101595.5,864.25,110
"12173","36130","2018",2,2,0,147500,1818.5,58.5
"12174","36131","2018",3,3,0,77000,882,88.66667
"12175","36132","2018",1,1,0,70600,619,114
"12176","36134","2018",4,4,0,40622.5,634,62.25
"12177","36135","2018",1,1,0,40000,571,70
"12178","36137","2018",4,4,0,102250,902.25,113
"12179","36138","2018",2,2,0,50000,1256,47
"12180","36139","2018",9,9,0,77833.33,1007.333,75.11111
"12181","36140","2018",10,10,0,101820,1107.7,90.3
"12182","36141","2018",14,14,0,75397.14,883,87.35714
"12183","36142","2018",20,20,0,110730,1183.25,94.35
"12184","36143","2018",5,5,0,67799,904.4,81
"12185","36144","2018",3,3,0,46019.67,569.6667,83
"12186","36145","2018",2,2,0,81500,877,79
"12187","36146","2018",7,7,0,65785.71,775,87
"12188","36147","2018",1,1,0,105000,1500,70
"12189","36148","2018",4,4,0,60300,671.25,83.5
"12190","36149","2018",10,10,0,78100,855.6,93.6
"12191","36150","2018",4,4,0,53700,707,85
"12192","36152","2018",7,7,0,63753.43,801,84.57143
"12193","36153","2018",4,4,0,134125,1200,122.5
"12194","36154","2018",12,12,0,84851.33,1157.167,77.58333
"12195","36155","2018",6,6,0,90083.33,1058.667,82.33333
"12196","36156","2018",6,6,0,70900,769.1667,99.33333
"12197","36157","2018",5,5,0,118200,1252.2,90.4
"12198","36158","2018",8,8,0,107250,1052.5,98.25
"12199","36159","2018",51,50,1,156516,1478.49,105.549
"12200","36160","2018",1,1,0,54000,871,62
"12201","36161","2018",5,5,0,66978,989.2,66.6
"12202","36162","2018",10,10,0,60850,594.9,102.7
"12203","36163","2018",9,9,0,69627.78,865.2222,78.33333
"12204","36164","2018",1,1,0,80000,635,126
"12205","36165","2018",8,8,0,60893.75,765.875,76.75
"12206","36166","2018",2,2,0,307000,1845,153
"12207","36167","2018",1,1,0,107500,1265,85
"12208","36168","2018",7,7,0,107071.4,1144.286,91.71429
"12209","36169","2018",4,4,0,82500,1079.25,84
"12210","36171","2018",27,27,0,85714.81,959.8519,90.03704
"12211","36172","2018",4,4,0,129455,762.5,167
"12212","36173","2018",10,10,0,69900,792.8,85.8
"12213","36174","2018",4,4,0,57175,653.5,85.75
"12214","36175","2018",5,5,0,71444,1298.8,72.6
"12215","36176","2018",5,5,0,65320,769.8,85
"12216","36177","2018",2,2,0,110000,778,142
"12217","36178","2018",2,2,0,162250,1406.5,115.5
"12218","36180","2018",8,8,0,98287.5,1140.625,90.125
"12219","36181","2018",1,1,0,40000,364,110
"12220","36182","2018",9,9,0,72411.11,800.1111,95.55556
"12221","36184","2018",7,6,1,173428.6,1987.571,81.14286
"12222","36185","2018",3,3,0,102000,1074,96.33333
"12223","36186","2018",3,3,0,165833.3,1147,139.6667
"12224","36187","2018",1,1,0,28000,444,63
"12225","36189","2018",9,9,0,61243.11,991.1111,68.55556
"12226","36190","2018",3,3,0,101715,942.3333,96.33333
"12227","36191","2018",9,9,0,80888.89,1049.333,77.33333
"12228","36192","2018",21,20,1,73947.62,924.3333,78.09524
"12229","36193","2018",3,3,0,78491.67,704.3333,105
"12230","36194","2018",8,8,0,90568.75,835.875,118.375
"12231","36195","2018",5,5,0,88000,965.2,99.4
"12232","36197","2018",2,2,0,57500,1197.5,40.5
"12233","36198","2018",4,4,0,90500,910,103
"12234","36199","2018",9,9,0,114166.7,1006.889,113.7778
"12235","36200","2018",16,16,0,76106.25,970.125,77.375
"12236","36202","2018",25,25,0,155526.8,1392.8,113.2
"12237","36203","2018",1,1,0,140000,2029,69
"12238","36204","2018",3,3,0,163900,919.3333,154.3333
"12239","36205","2018",2,2,0,128500,1179.5,118
"12240","36207","2018",8,8,0,85250,990.875,95.625
"12241","36208","2018",9,9,0,97655.56,1010.556,103.4444
"12242","36209","2018",1,1,0,143300,1592,90
"12243","36210","2018",3,3,0,118333.3,852,128
"12244","36211","2018",7,7,0,213735.1,2255.286,114.5714
"12245","36212","2018",3,3,0,88100,955,90.66667
"12246","36214","2018",2,2,0,148327.5,1744,73.5
"12247","36215","2018",1,1,0,53500,775,69
"12248","36216","2018",2,2,0,78000,768.5,99.5
"12249","36218","2018",2,2,0,43500,549,80
"12250","36219","2018",6,6,0,91498.33,995.3333,91.33333
"12251","36220","2018",4,4,0,73075,913.5,83
"12252","36221","2018",6,6,0,129750,877,117.8333
"12253","36223","2018",1,1,0,32000,427,75
"12254","36224","2018",13,13,0,65623.08,816.0769,79.38462
"12255","36225","2018",1,1,0,55500,816,68
"12256","36226","2018",5,5,0,81800,685.6,119.4
"12257","36227","2018",3,3,0,86926.67,861,94.33333
"12258","36228","2018",26,26,0,92677.54,1079.231,83.57692
"12259","36229","2018",14,14,0,62464.29,821.5714,70.35714
"12260","36230","2018",24,22,2,75983.33,841.375,91.75
"12261","36231","2018",7,7,0,154071.4,1960.571,76.28571
"12262","36232","2018",15,14,1,91422.67,975.7333,90.53333
"12263","36233","2018",8,8,0,89312.62,1210,75.125
"12264","36234","2018",6,6,0,77733.33,971.1667,75.83333
"12265","36235","2018",3,3,0,70000,778.3333,92.33333
"12266","36236","2018",7,7,0,48857.14,725.4286,69.28571
"12267","36237","2018",11,11,0,60176.45,774.9091,76.27273
"12268","36238","2018",2,2,0,60500,785.5,101
"12269","36239","2018",4,4,0,134500,1112.25,110.25
"12270","36240","2018",13,13,0,60894.92,868.6154,72.61538
"12271","36241","2018",31,31,0,94301.94,1033,91.41935
"12272","36242","2018",3,3,0,106500,1044.333,99.33333
"12273","36243","2018",4,4,0,53750,824.5,69.75
"12274","36244","2018",12,12,0,106574.6,1098.833,95.83333
"12275","36246","2018",2,2,0,43500,385,113
"12276","36247","2018",12,12,0,118712.5,1288.75,92.91667
"12277","36248","2018",4,4,0,84750,872.5,95.5
"12278","37001","2018",15,15,0,82393.33,1102.667,82.73333
"12279","37002","2018",20,20,0,183387.5,1607.2,113.5
"12280","37003","2018",182,127,55,183318.1,2006.462,93.1978
"12281","37004","2018",4,4,0,110675,1716.75,64.75
"12282","37005","2018",5,5,0,67000,777.8,84.6
"12283","37006","2018",31,30,1,185975.8,1931.194,102.5161
"12284","37007","2018",2,2,0,123000,1592.5,99.5
"12285","37008","2018",36,36,0,177725.6,1801.889,106.3889
"12286","37009","2018",1,1,0,145000,1208,120
"12287","37010","2018",27,27,0,159896.3,1742.481,97.59259
"12288","37011","2018",22,12,10,111159.1,1390.182,77.31818
"12289","37012","2018",1,1,0,159000,1514,105
"12290","37013","2018",7,7,0,171657.1,1643.857,112
"12291","37014","2018",42,40,2,166688.3,1820.762,101.9048
"12292","37015","2018",40,40,0,205345.6,1916.625,109.55
"12293","37016","2018",7,7,0,141571.4,1406.429,107.2857
"12294","37018","2018",86,60,26,218480.3,2391.686,96.22093
"12295","37019","2018",7,7,0,114850,1158.143,104
"12296","37020","2018",17,17,0,126426.5,1410.765,86.52941
"12297","37021","2018",21,21,0,149657.6,1447.714,104.5238
"12298","37022","2018",24,24,0,148881.2,1451.417,100.2917
"12299","37024","2018",13,13,0,153169.2,1290.385,120.8462
"12300","37025","2018",6,6,0,211975,1763.667,119.1667
"12301","37026","2018",8,8,0,124328.8,1089.875,109
"12302","37027","2018",63,58,5,166389.1,1685.238,101.2063
"12303","37028","2018",11,11,0,89087.36,975.4545,83.72727
"12304","37029","2018",2,2,0,133000,1138.5,117
"12305","37030","2018",7,7,0,138714.3,1274.857,108.5714
"12306","37031","2018",59,54,5,131088.7,1337.78,98.11864
"12307","37032","2018",3,3,0,84566.67,1085.333,84.66667
"12308","37033","2018",5,5,0,93955,1075.8,84
"12309","37035","2018",2,2,0,83675,1347,85
"12310","37036","2018",4,4,0,90125,718.75,142.5
"12311","37037","2018",4,4,0,102250,1357.5,77.75
"12312","37038","2018",13,13,0,143419.8,1664.692,93
"12313","37039","2018",5,5,0,81900,941.8,89.4
"12314","37040","2018",3,3,0,114833.3,1172.333,104.3333
"12315","37041","2018",2,2,0,133500,1126.5,119
"12316","37042","2018",4,4,0,229500,1715.25,126.25
"12317","37043","2018",17,17,0,170159.8,1658.529,105.1765
"12318","37044","2018",3,3,0,126000,987,125
"12319","37045","2018",16,16,0,116778.2,1349.625,83.3125
"12320","37046","2018",6,6,0,125900,1075.5,107.8333
"12321","37047","2018",13,13,0,240769.2,2084.154,116
"12322","37048","2018",5,5,0,88400,1064.8,86.6
"12323","37049","2018",13,13,0,114153.8,1232.538,101.3077
"12324","37050","2018",172,94,78,169012.5,2084.849,80.97674
"12325","37051","2018",11,11,0,95090.91,1061.364,87
"12326","37052","2018",11,11,0,191900,1760.818,111.8182
"12327","37053","2018",1,1,0,257000,1932,133
"12328","37054","2018",30,30,0,201086.7,1986.233,105.8667
"12329","37055","2018",5,5,0,120000,1206.6,102.2
"12330","37056","2018",5,5,0,147410,1889.2,86.4
"12331","37057","2018",7,7,0,130777.1,1411.857,99.71429
"12332","37058","2018",22,22,0,149235.5,1226,127.4091
"12333","37059","2018",17,16,1,268536.4,2153.059,130.8235
"12334","37060","2018",9,9,0,182461.1,1617.889,114.5556
"12335","37061","2018",11,11,0,94427.27,1024,114.5455
"12336","37062","2018",17,17,0,90647.06,1052.176,95.35294
"12337","37063","2018",43,39,4,113030.2,1191.953,100.2093
"12338","37064","2018",5,5,0,156738,1390.6,119.4
"12339","37065","2018",8,8,0,103937.5,975.5,102.875
"12340","37066","2018",9,8,1,77091.67,1327.778,55.77778
"12341","37067","2018",18,18,0,156091.7,1832.722,85.38889
"12342","37068","2018",7,7,0,155428.6,1849.714,83.14286
"12343","37069","2018",5,5,0,161060,1562,102.2
"12344","37070","2018",6,6,0,135361.7,1700.5,83.16667
"12345","37071","2018",1,1,0,52000,867,60
"12346","37072","2018",97,73,24,129220.9,1485.66,87.51546
"12347","37073","2018",6,6,0,115575,1062.667,108.3333
"12348","37074","2018",37,37,0,127819.2,1370.486,102.8108
"12349","37075","2018",6,6,0,171750,1695,102.3333
"12350","37076","2018",2,2,0,120000,1348,89
"12351","37077","2018",38,37,1,164625.3,1687.316,99.07895
"12352","37078","2018",2,2,0,112425,1186,94.5
"12353","37079","2018",23,23,0,168690.3,1631.609,106.6957
"12354","37080","2018",4,3,1,130000,1098.25,122.5
"12355","37081","2018",16,16,0,134955.3,1354.438,102.5625
"12356","37082","2018",7,7,0,135642.9,1553.429,102.7143
"12357","37083","2018",34,33,1,144662.9,1570.147,92.58824
"12358","37084","2018",5,5,0,52380,600.6,78.8
"12359","37085","2018",15,15,0,159770,1951.333,90.8
"12360","37086","2018",7,7,0,154857.1,1475.714,105.2857
"12361","37087","2018",2,2,0,157500,1362,116.5
"12362","37088","2018",1,1,0,1e+05,1515,66
"12363","37089","2018",8,8,0,126187.5,1328.375,91.5
"12364","37090","2018",4,4,0,83500,1011.25,70.5
"12365","37091","2018",22,21,1,149981.8,1736.636,91.90909
"12366","37092","2018",11,11,0,197159.1,1698.273,120.6364
"12367","37093","2018",6,6,0,109450,1198.5,88.33333
"12368","37094","2018",8,8,0,112500,1106.125,103.625
"12369","37095","2018",5,5,0,131900,1113,120.4
"12370","37096","2018",9,9,0,145500,1381.444,106.5556
"12371","37097","2018",7,7,0,149571.4,1430.571,105.2857
"12372","37098","2018",5,5,0,137460,1291.8,107.6
"12373","37099","2018",8,8,0,208415.1,1948.25,116.125
"12374","37100","2018",7,7,0,125271.4,1265.714,105.8571
"12375","37101","2018",1,1,0,75000,1875,40
"12376","37103","2018",2,2,0,81000,843.5,99
"12377","37104","2018",68,67,1,226310.5,2187.338,109.1471
"12378","37105","2018",4,4,0,140000,1203,126.5
"12379","37106","2018",7,7,0,133771.4,1134.571,123.4286
"12380","37107","2018",6,6,0,68708.33,850.8333,83
"12381","37108","2018",6,6,0,146166.7,1480.667,101.8333
"12382","37109","2018",125,115,10,279952.6,2383.152,120.2
"12383","37110","2018",15,15,0,149826.7,1407.4,106.7333
"12384","37111","2018",20,20,0,130495.1,1320.05,103.45
"12385","37112","2018",3,3,0,96666.67,915.6667,114.6667
"12386","37113","2018",9,9,0,72777.78,811.3333,88.11111
"12387","37114","2018",1,1,0,15000,429,35
"12388","37115","2018",49,44,5,76855.59,907.102,82.12245
"12389","37116","2018",6,6,0,77679.17,1149.167,71.33333
"12390","37117","2018",7,7,0,90609.14,969.2857,95.57143
"12391","37118","2018",14,14,0,115691.2,1206.214,96
"12392","37119","2018",23,22,1,101731.6,1042.13,100.1304
"12393","37122","2018",494,240,254,149507.3,1950.16,76.46356
"12394","37123","2018",53,51,2,148969.1,1515.094,101
"12395","37124","2018",26,26,0,209876.7,2081.423,102.3846
"12396","37125","2018",7,7,0,95027.86,964.4286,100.2857
"12397","37126","2018",3,3,0,106000,1226.667,101
"12398","37127","2018",2,2,0,87455,755.5,110.5
"12399","37128","2018",19,19,0,144066.6,1660,88.47368
"12400","37129","2018",10,10,0,150935,1358.4,108.4
"12401","37130","2018",23,22,1,99564.35,1157.565,89.52174
"12402","37131","2018",14,14,0,112377.1,1211,95.07143
"12403","37132","2018",81,75,6,150676.4,1586.642,95.8642
"12404","37133","2018",4,4,0,62079.5,678.5,98.75
"12405","37134","2018",10,10,0,158300,1728.4,102.6
"12406","37136","2018",7,7,0,178542.9,1373.571,130.7143
"12407","37138","2018",8,8,0,169708.6,1658.125,106.125
"12408","37139","2018",60,58,2,221123.7,2216.167,105.6167
"12409","37140","2018",2,2,0,165010,1214,143.5
"12410","37141","2018",13,13,0,114970,1327.692,88.69231
"12411","37142","2018",8,8,0,134921.2,1188.5,118.125
"12412","37143","2018",20,20,0,124433,1371.85,95.45
"12413","37144","2018",3,3,0,133210,1362,140.6667
"12414","37145","2018",1,1,0,138000,1314,105
"12415","37147","2018",8,8,0,91213.75,1059,89.875
"12416","37148","2018",10,10,0,116922.4,1220.9,99.2
"12417","37149","2018",8,8,0,145806.2,1701.5,89.125
"12418","37150","2018",11,11,0,183791.8,1949.727,94.54545
"12419","37151","2018",26,25,1,242620.6,2301.846,114.4231
"12420","37152","2018",23,23,0,307173.9,2337,136.6522
"12421","37153","2018",56,55,1,195726.7,1963.554,101.2679
"12422","37154","2018",65,63,2,191528.4,2098.354,92.72308
"12423","37155","2018",12,12,0,221000,1761.75,130.6667
"12424","37156","2018",157,146,11,195216.2,2192.796,94.32484
"12425","37157","2018",5,4,1,100400,1198,93.8
"12426","37158","2018",3,3,0,141226.7,2354.667,66.66667
"12427","37159","2018",83,76,7,200072.2,2050.145,98.98795
"12428","37160","2018",3,3,0,143580,1514,105.6667
"12429","37161","2018",10,10,0,155944.9,1456.2,118.2
"12430","37162","2018",7,7,0,138857.1,1568.714,91.42857
"12431","37163","2018",52,51,1,158231.3,1748.442,93.34615
"12432","37165","2018",9,9,0,208500,1566.667,136.3333
"12433","37166","2018",8,8,0,170025,1436.375,132.75
"12434","37167","2018",21,20,1,156323.3,1686.762,93.90476
"12435","37168","2018",3,3,0,66000,1085.333,52.33333
"12436","37169","2018",8,8,0,145675,1431.125,108.875
"12437","37170","2018",10,10,0,112210,1421.8,82.8
"12438","37171","2018",12,12,0,138558.3,1738.167,90.33333
"12439","37172","2018",40,34,6,202019.2,2122.025,97.1
"12440","37173","2018",6,6,0,87900,909.3333,95.83333
"12441","37174","2018",11,11,0,106042.7,1432.091,81.27273
"12442","37175","2018",11,11,0,148663.2,1589.636,90.54545
"12443","37176","2018",12,12,0,162439.2,1538.75,103.75
"12444","37177","2018",16,16,0,84523.94,854.9375,92
"12445","37178","2018",9,9,0,120722.2,1165.444,100.6667
"12446","37179","2018",20,20,0,238872.5,2305.6,113.7
"12447","37180","2018",7,7,0,95642.86,1005,93.14286
"12448","37181","2018",7,7,0,88771.43,1136.571,79.14286
"12449","37182","2018",21,21,0,173821.5,1651.571,105.8571
"12450","37183","2018",7,7,0,143328.6,1692.571,94.14286
"12451","37184","2018",8,8,0,104082,846.25,109.375
"12452","37185","2018",20,19,1,154425,2004.85,80.85
"12453","37186","2018",19,19,0,174011,1848.158,97.26316
"12454","37187","2018",5,5,0,67282.8,713.6,102.4
"12455","37188","2018",11,11,0,140003.6,1387.727,105.7273
"12456","37189","2018",14,14,0,58014.29,666.7143,86.85714
"12457","37190","2018",1,1,0,32500,406,80
"12458","37191","2018",1,1,0,95000,1080,88
"12459","37192","2018",13,13,0,152360.8,1488.923,102.3077
"12460","37193","2018",9,9,0,148811.1,1312.111,113.6667
"12461","37194","2018",24,24,0,183777.1,1666.958,112.5
"12462","37195","2018",183,50,133,148289.9,2212.601,67.80328
"12463","37196","2018",18,15,3,108378.9,1025.056,97.22222
"12464","37197","2018",8,8,0,106943.8,1301.375,80.5
"12465","37198","2018",8,8,0,90950,1291.75,77.25
"12466","37199","2018",8,8,0,93425,1050.75,93.875
"12467","37200","2018",13,13,0,150156.2,1686.231,95.15385
"12468","37201","2018",4,4,0,160987.5,1307.75,117.75
"12469","37202","2018",4,4,0,145500,1226.75,116.75
"12470","37203","2018",40,38,2,320586,2468.85,126.45
"12471","37204","2018",7,7,0,169407.9,1446.857,118.1429
"12472","37205","2018",15,15,0,196108,1745.933,108.5333
"12473","37206","2018",15,15,0,229631.6,2025.6,120.2
"12474","37207","2018",3,3,0,108691.7,830.6667,123.3333
"12475","37208","2018",189,146,43,237125.6,2388.608,100.4392
"12476","37210","2018",7,7,0,167642.9,1503.286,113.4286
"12477","37211","2018",27,27,0,185784,1879.704,113.2222
"12478","37212","2018",7,7,0,193571.4,1598.571,143.4286
"12479","37213","2018",12,12,0,94290,1009,95.33333
"12480","37214","2018",280,109,171,229583,2608.571,85.22857
"12481","37216","2018",15,15,0,114339.3,1376.933,83.33333
"12482","37217","2018",19,18,1,175343.2,1723.368,106.6316
"12483","37218","2018",9,9,0,80838.89,1107.333,70.55556
"12484","37219","2018",9,9,0,177305.6,2005.444,92.22222
"12485","37220","2018",6,6,0,74333.33,1244.167,66.66667
"12486","37221","2018",11,11,0,99636.36,1217.091,86.18182
"12487","37222","2018",8,8,0,103187.5,1120.125,90.875
"12488","37223","2018",5,5,0,95200.6,1231.2,79.4
"12489","37224","2018",14,14,0,168007.1,1646.429,109.8571
"12490","37225","2018",34,34,0,190942.6,2074.176,94.41176
"12491","37226","2018",46,43,3,121254.3,1237.63,96.6087
"12492","37228","2018",8,8,0,160918.8,1385.375,118.5
"12493","37229","2018",1,1,0,80000,976,82
"12494","37230","2018",13,13,0,187730.8,1599.692,118.3846
"12495","37231","2018",23,21,2,130926.1,1280.522,102.1739
"12496","37232","2018",16,16,0,148928.8,1231.562,125.75
"12497","37233","2018",174,104,70,145444.2,1964.132,77.25862
"12498","37234","2018",6,6,0,136000,1413.667,95.33333
"12499","37236","2018",6,6,0,205166.7,1770,134.3333
"12500","37237","2018",13,12,1,208488.4,2419.231,84.30769
"12501","37238","2018",5,5,0,136640,1379.4,102.8
"12502","37240","2018",7,7,0,147485.7,1299.571,111
"12503","37241","2018",13,13,0,103161.5,1256.923,80.38462
"12504","37242","2018",9,9,0,162974.4,1566.222,105.4444
"12505","37243","2018",29,29,0,249881.2,2156.586,125.1379
"12506","37244","2018",3,3,0,113916.7,1047.667,111.6667
"12507","37245","2018",19,19,0,206286.3,1977.895,109.9474
"12508","37246","2018",3,3,0,64333.33,788,82.66667
"12509","37247","2018",4,4,0,120875,983.75,122.5
"12510","37248","2018",3,3,0,148333.3,1412.333,94.33333
"12511","37249","2018",20,20,0,153211.3,1444.7,108.4
"12512","37250","2018",24,24,0,173256.2,1776.833,105.1667
"12513","37251","2018",12,12,0,157137.5,1626.333,105.9167
"12514","37252","2018",4,4,0,113500,1312,90.75
"12515","37253","2018",1,1,0,135500,1426,95
"12516","37254","2018",16,16,0,152670.6,1415.25,109.625
"12517","37255","2018",7,7,0,109142.9,1146,85.14286
"12518","37256","2018",3,3,0,91666.67,1121.667,86.66667
"12519","37257","2018",15,15,0,197153.3,1789.867,111.4
"12520","37258","2018",5,5,0,76900,1896.4,62
"12521","37259","2018",4,4,0,80380,1032.5,84.25
"12522","37260","2018",5,5,0,163850,1662.8,104.6
"12523","37261","2018",2293,527,1766,162510.4,2482.848,65.42826
"12524","37262","2018",2,2,0,107000,1056,101
"12525","37263","2018",36,35,1,156651.1,1861.861,87.94444
"12526","37264","2018",17,17,0,209295.1,2237.353,107.6471
"12527","37265","2018",1,1,0,95000,1080,88
"12528","37266","2018",74,72,2,222983.7,2172.851,107.7027
"12529","37267","2018",45,45,0,205611.8,1938.133,109.1111
"12530","37268","2018",2,2,0,112500,1032,109
"12531","37269","2018",2,2,0,95500,1677.5,56
"12532","37270","2018",27,27,0,227507.4,2010,118.8148
"12533","37271","2018",20,20,0,129601.4,1448.8,88.95
"12534","37272","2018",18,18,0,210898.9,2344.111,92.72222
"12535","37273","2018",78,67,11,180330.5,2251.333,83.12821
"12536","37274","2018",4,4,0,150750,1276.25,114
"12537","37276","2018",9,9,0,157032.9,1936.667,82.22222
"12538","37277","2018",9,9,0,208176.8,1324.222,115.6667
"12539","37278","2018",7,7,0,135457.1,1655.571,85.57143
"12540","37279","2018",11,11,0,146263.6,1360.818,109.9091
"12541","37280","2018",2,2,0,49000,782.5,65.5
"12542","37281","2018",39,37,2,191568.1,2140.821,94.05128
"12543","37282","2018",19,19,0,114548.6,1185.579,109.9474
"12544","38001","2018",100,70,30,142112.8,1700.75,86
"12545","38002","2018",45,4,41,84615.8,2240.044,35.08889
"12546","38003","2018",25,24,1,144664.1,1269.48,112.2
"12547","38004","2018",12,12,0,166326.7,1868.083,87.41667
"12548","38005","2018",20,7,13,118287.4,2662.85,42.05
"12549","38006","2018",68,27,41,129184.2,1865.382,68.63235
"12550","38008","2018",1,1,0,150000,1079,139
"12551","38009","2018",12,12,0,249979.2,2006.333,125.9167
"12552","38010","2018",12,12,0,261287.5,2507.417,108.0833
"12553","38011","2018",13,11,2,261023,2580.154,102.6154
"12554","38012","2018",37,29,8,147577.8,1813.405,88.37838
"12555","38013","2018",44,38,6,213648,1987.705,110
"12556","38015","2018",14,13,1,198748.2,1932.357,105.8571
"12557","38017","2018",22,22,0,217842.3,2059.091,108.5909
"12558","38018","2018",1,1,0,157900,1794,88
"12559","38019","2018",20,14,6,168699,1842,87.55
"12560","38020","2018",35,2,33,77115.71,2325.686,32.34286
"12561","38022","2018",122,106,16,170322.8,1752.426,101.3361
"12562","38023","2018",4,4,0,287595,2279.25,149.5
"12563","38026","2018",15,15,0,166129.3,1699.8,106.6667
"12564","38027","2018",25,22,3,220390.4,2412.88,92.52
"12565","38029","2018",27,25,2,198833.6,1845.667,114.8519
"12566","38030","2018",16,14,2,192840.6,1896.25,107.3125
"12567","38031","2018",1,1,0,120000,2308,52
"12568","38032","2018",4,4,0,171387.5,1789.25,96
"12569","38033","2018",7,7,0,229757,1788.714,131.1429
"12570","38034","2018",71,57,14,128806.2,1404.634,94.39437
"12571","38035","2018",10,10,0,222792,2083,107.6
"12572","38036","2018",1,1,0,194000,1426,136
"12573","38037","2018",10,10,0,157877,1831.8,85.2
"12574","38038","2018",2,2,0,221500,2000.5,110.5
"12575","38039","2018",27,23,4,355402.5,3204.778,117.3333
"12576","38040","2018",2,2,0,172500,1741,110
"12577","38041","2018",2,1,1,226750,1505,151.5
"12578","38042","2018",13,12,1,184545.4,1616.923,117.7692
"12579","38043","2018",10,10,0,259560,2355.3,111
"12580","38044","2018",17,12,5,128183.9,1398.824,90.82353
"12581","38045","2018",21,18,3,454780.9,4137.381,114.1429
"12582","38046","2018",10,10,0,168587,1642.1,104.5
"12583","38047","2018",1,1,0,42730,657,65
"12584","38048","2018",12,9,3,224463.5,2328.5,96.5
"12585","38049","2018",3,3,0,187100,1714,113.3333
"12586","38050","2018",10,9,1,171870.2,1345.9,126
"12587","38051","2018",13,13,0,224324.6,1981.385,119.8462
"12588","38052","2018",50,25,25,154133.4,2108.26,79.16
"12589","38053","2018",427,135,292,157579,2058.621,77.25059
"12590","38054","2018",21,21,0,163643.3,1687.476,100.4286
"12591","38055","2018",8,8,0,166440,1518.875,113.375
"12592","38057","2018",5,4,1,370400,3317.8,117.2
"12593","38058","2018",25,25,0,186440.1,1755.04,109.8
"12594","38059","2018",20,7,13,296172.7,3292.85,88.8
"12595","38061","2018",51,38,13,271927.1,2567.824,111.1961
"12596","38062","2018",9,7,2,186085,2355.556,80.66667
"12597","38063","2018",4,4,0,222125,2279,102.5
"12598","38064","2018",44,39,5,196237.5,2034.614,96.70455
"12599","38065","2018",26,25,1,174165.5,1657.538,103.7692
"12600","38066","2018",1,1,0,368000,1696,217
"12601","38067","2018",18,17,1,279224.8,2647,109.2778
"12602","38068","2018",6,6,0,504966.7,4065.667,127.1667
"12603","38069","2018",23,19,4,143589.2,1613.957,96.21739
"12604","38070","2018",12,5,7,184518.3,2146.167,90.75
"12605","38071","2018",30,14,16,186919.8,2434.567,78.23333
"12606","38072","2018",39,38,1,178002.3,1971.564,96.87179
"12607","38073","2018",2,2,0,106250,1980.5,69
"12608","38074","2018",4,4,0,220191.2,2377.5,93.25
"12609","38075","2018",24,21,3,220941,2278.792,97.58333
"12610","38076","2018",27,24,3,217606.2,2026.148,112.5556
"12611","38077","2018",9,9,0,229317.2,2040.444,115.5556
"12612","38078","2018",7,7,0,186127.1,1684,119.7143
"12613","38080","2018",4,4,0,166995,1816.75,95
"12614","38081","2018",26,24,2,205441.9,1906.308,106.9615
"12615","38082","2018",17,17,0,183816.5,2118.941,95.76471
"12616","38083","2018",6,6,0,155374.8,1379.667,112.8333
"12617","38084","2018",13,13,0,283230.8,2233.846,130.6923
"12618","38085","2018",111,86,25,218594.4,2423.802,90.15315
"12619","38086","2018",4,4,0,283250,2299.25,123
"12620","38087","2018",58,37,21,190055.5,2172.345,87.72414
"12621","38089","2018",2,2,0,136000,1485.5,93
"12622","38090","2018",7,7,0,123714.3,1657.286,84.85714
"12623","38091","2018",7,7,0,250610,2259.714,113.4286
"12624","38093","2018",5,5,0,126400,1068.2,112.8
"12625","38094","2018",33,32,1,176882.4,1895.848,94.12121
"12626","38095","2018",23,22,1,180619.1,1779.696,102.7391
"12627","38097","2018",31,25,6,227822.8,2445.935,92.19355
"12628","38098","2018",11,11,0,194109.1,1851.818,113.3636
"12629","38099","2018",8,7,1,286481.2,1834.125,151.25
"12630","38100","2018",20,16,4,255118.1,2628,95.3
"12631","38101","2018",11,10,1,175959.1,1590.727,110.7273
"12632","38102","2018",3,3,0,189833.3,1658.667,107.6667
"12633","38103","2018",6,5,1,147816.7,2559.5,62.83333
"12634","38104","2018",14,14,0,192545,2445,84.28571
"12635","38105","2018",30,27,3,202257.5,1946.033,105.0667
"12636","38106","2018",1,1,0,199000,4146,48
"12637","38107","2018",18,13,5,223121,2122.111,106.9444
"12638","38109","2018",5,5,0,262840,2104,124.8
"12639","38110","2018",23,22,1,317439.1,2663.739,128.6087
"12640","38111","2018",73,44,29,299473.5,3102.219,98.73973
"12641","38112","2018",1,0,1,84500,1385,61
"12642","38113","2018",8,7,1,166179.4,2130.875,83
"12643","38114","2018",15,15,0,245354.7,2459.933,100.3333
"12644","38115","2018",5,5,0,273790,2337,117.8
"12645","38116","2018",1,1,0,42750,356,120
"12646","38117","2018",8,8,0,196676,2175.375,91.625
"12647","38118","2018",17,16,1,222133.8,2213.059,105.8824
"12648","38120","2018",8,8,0,381198.9,3119.875,125.375
"12649","38124","2018",35,33,2,180516.7,1596.914,114.3429
"12650","38126","2018",33,22,11,527309.2,3843.515,144.1212
"12651","38127","2018",2,2,0,92000,950,104
"12652","38128","2018",8,7,1,154106.2,2466,57.5
"12653","38129","2018",23,5,18,134853.4,2368,53.52174
"12654","38130","2018",67,42,25,149058.4,1573.746,96.67164
"12655","38131","2018",26,17,9,254217.1,2175.692,114.0769
"12656","38132","2018",2,2,0,270000,1934.5,140.5
"12657","38133","2018",58,47,11,269522.9,2720.448,100.3966
"12658","38134","2018",8,7,1,210646.9,1853.75,116.5
"12659","38135","2018",19,19,0,176772.6,1731.053,105.2632
"12660","38136","2018",8,8,0,195611.2,1850.625,108.25
"12661","38137","2018",5,5,0,306873,2581.2,119.8
"12662","38138","2018",57,18,39,165029.5,2221.193,74.89474
"12663","38139","2018",20,17,3,164784.6,1700.9,95.35
"12664","38140","2018",67,48,19,304132.9,3022.403,100.4179
"12665","38141","2018",3,3,0,184466.7,2130.667,86
"12666","38144","2018",21,19,2,279209.2,2682.857,110.6667
"12667","38146","2018",15,14,1,250844,2569.467,105.2
"12668","38147","2018",8,7,1,163646.5,1643.875,100.375
"12669","38148","2018",43,40,3,182213.9,1826.814,102.907
"12670","38149","2018",17,16,1,255306.8,2268.824,113
"12671","38150","2018",77,27,50,205767.6,2668.286,74.46753
"12672","38151","2018",301,40,261,151593.2,2043.767,75.35216
"12673","38152","2018",21,20,1,200974.8,1960.952,101
"12674","38153","2018",7,7,0,254564.3,2574.286,96.71429
"12675","38154","2018",6,6,0,128083.3,1317,92.66667
"12676","38155","2018",17,14,3,156235.3,1798.824,89.76471
"12677","38156","2018",15,14,1,174831.3,1961.8,93.86667
"12678","38157","2018",42,36,6,214320,2335.262,94.5
"12679","38158","2018",123,31,92,211329.2,2793.13,75.73171
"12680","38159","2018",3,3,0,184870,1562.667,127.6667
"12681","38160","2018",15,14,1,216211.3,2112.2,104.6667
"12682","38161","2018",14,14,0,204839.3,1535,128.5714
"12683","38162","2018",12,12,0,213210.8,1676.75,126.8333
"12684","38163","2018",26,11,15,80618.65,1787.615,44.11538
"12685","38166","2018",5,5,0,275740,2468.6,130.6
"12686","38167","2018",7,7,0,140107.4,1461.857,99.42857
"12687","38169","2018",280,37,243,128730.8,1893.354,66.44643
"12688","38170","2018",32,6,26,212746.9,2850.75,74.03125
"12689","38171","2018",4,4,0,167875,1496.25,117.5
"12690","38172","2018",16,9,7,176858.8,2519.75,74.125
"12691","38173","2018",7,7,0,223204.3,1926.143,130.5714
"12692","38174","2018",10,10,0,191762.4,1896.2,117.1
"12693","38175","2018",29,18,11,244891.4,2634.828,94.93103
"12694","38176","2018",11,11,0,287009.1,2558.727,116.4545
"12695","38177","2018",2,2,0,77500,1702,45.5
"12696","38179","2018",90,17,73,193767.4,2992.1,63.52222
"12697","38180","2018",12,11,1,199390.8,1733.583,120.5
"12698","38181","2018",30,19,11,207839.2,2500.267,83.3
"12699","38182","2018",38,34,4,164661.9,1686.947,95.86842
"12700","38183","2018",2,2,0,203075,2150,97
"12701","38184","2018",30,25,5,283519.7,2540.2,113.5333
"12702","38185","2018",2806,76,2730,146324.1,2345.136,63.46721
"12703","38186","2018",23,8,15,86373.26,1938.174,47.47826
"12704","38187","2018",30,23,7,205348.3,2136.433,91.46667
"12705","38188","2018",18,12,6,349998.9,3012.056,113.9444
"12706","38189","2018",80,47,33,226577.5,2706.875,85.125
"12707","38190","2018",13,12,1,206885.8,1909.154,112.6923
"12708","38191","2018",210,5,205,182185.4,4619.357,35.62381
"12709","38193","2018",211,133,78,173082.7,2094.242,83.93365
"12710","38194","2018",26,21,5,172808,1731.769,100.6538
"12711","38195","2018",9,9,0,201770,1933.333,107.7778
"12712","38197","2018",25,18,7,275277.1,2972.12,97.04
"12713","38198","2018",15,15,0,150787.3,1524.8,100.7333
"12714","38199","2018",22,21,1,302994.5,2583.864,120.3636
"12715","38200","2018",28,16,12,287230.4,2772.786,109.5
"12716","38203","2018",4,1,3,58000,1024.5,64.25
"12717","38204","2018",6,5,1,80575,962,84.33333
"12718","38205","2018",37,24,13,229964.3,3474.757,71.13514
"12719","38206","2018",9,8,1,194529.8,3010.889,88.88889
"12720","38207","2018",1,0,1,148000,1480,100
"12721","38208","2018",1,1,0,165000,1269,130
"12722","38209","2018",3,3,0,235866.7,1900.667,128.6667
"12723","38210","2018",10,10,0,238097.7,2314,106.3
"12724","38211","2018",5,5,0,164542.6,2063.6,83.4
"12725","38212","2018",15,12,3,91316.67,1160.333,81.6
"12726","38213","2018",7,7,0,147057.1,1258.714,121.4286
"12727","38214","2018",2,2,0,381500,3779.5,101.5
"12728","38215","2018",20,18,2,278429.7,2541.6,113.3
"12729","38218","2018",19,19,0,179542.4,1553.842,119.4211
"12730","38219","2018",10,10,0,166785,1474.1,113.6
"12731","38222","2018",11,10,1,163880,1596.455,104.7273
"12732","38223","2018",26,17,9,237201.4,2406.962,99.92308
"12733","38224","2018",1,1,0,177500,2017,88
"12734","38225","2018",66,29,37,169540.4,2696.121,63.56061
"12735","38226","2018",20,18,2,138470,1379.95,95.3
"12736","38228","2018",5,5,0,153760,1644.6,107
"12737","38229","2018",209,50,159,277368.7,3186.33,85.33971
"12738","38230","2018",9,8,1,247979.4,2251.333,109.4444
"12739","38231","2018",11,11,0,217004.5,2109,104.3636
"12740","38232","2018",3,3,0,230733.3,1821,126.6667
"12741","38235","2018",6,6,0,221505,2202.333,103
"12742","38236","2018",20,16,4,166811,1798.05,99.2
"12743","38237","2018",1,1,0,230000,2706,85
"12744","38238","2018",16,15,1,211175,2028.312,104.3125
"12745","38239","2018",78,49,29,204407.8,2207.731,94.24359
"12746","38240","2018",7,7,0,178936,1560.429,117.1429
"12747","38241","2018",2,2,0,157500,2065.5,68.5
"12748","38242","2018",17,16,1,163429.4,1789.529,97.70588
"12749","38243","2018",1,1,0,110000,1467,75
"12750","38244","2018",7,7,0,222714.3,1948.429,111.2857
"12751","38246","2018",7,6,1,229299.3,1994.571,118.4286
"12752","38247","2018",55,41,14,150631.4,1776.891,90.52727
"12753","38248","2018",6,6,0,186068.3,2094,92.16667
"12754","38249","2018",63,22,41,340857.8,3694.873,90.2381
"12755","38250","2018",8,8,0,201332.5,1565,126
"12756","38252","2018",4,4,0,408692.5,3122,128.5
"12757","38253","2018",288,13,275,119691.2,3226.358,36.21875
"12758","38254","2018",6,6,0,221791.7,2101.333,110.8333
"12759","38255","2018",3,3,0,135000,1630.333,87.66667
"12760","38256","2018",24,22,2,213689.6,2090.083,105.4167
"12761","38257","2018",6,6,0,202770.2,1593,135
"12762","38258","2018",1,1,0,230000,2150,107
"12763","38259","2018",5,5,0,214960,1671.2,135.2
"12764","38260","2018",3,3,0,163666.7,2319,70
"12765","38261","2018",52,35,17,168681.2,1872.827,89.25
"12766","38263","2018",8,8,0,229473.8,2027.125,111.125
"12767","38264","2018",24,5,19,73882.5,1919.958,39.79167
"12768","38265","2018",28,21,7,133219.6,1513.964,85.96429
"12769","38266","2018",8,8,0,137125,1616.125,92.875
"12770","38267","2018",8,8,0,169886.2,1537.25,119.75
"12771","38268","2018",2,2,0,167500,1817.5,127
"12772","38269","2018",51,31,20,131234.9,1624.961,80.15686
"12773","38270","2018",26,24,2,241701.2,2362.269,104.3462
"12774","38271","2018",9,9,0,362016.7,3268.111,115.2222
"12775","38272","2018",6,6,0,180612.5,1489.5,125
"12776","38273","2018",4,4,0,212500,1949.75,112.5
"12777","38275","2018",2,2,0,146500,1241,116
"12778","38276","2018",39,29,10,193832.1,2001.41,97.74359
"12779","38277","2018",9,9,0,257088.9,2443.333,108.2222
"12780","38278","2018",3,3,0,102266.7,1195.333,97.66667
"12781","38279","2018",20,16,4,233490.9,2482.3,94.55
"12782","38280","2018",2,2,0,157500,1520,101
"12783","38281","2018",30,15,15,175666.7,2005.2,82.93333
"12784","38282","2018",11,11,0,197809.8,2049.818,98
"12785","38284","2018",12,11,1,176129.2,1527.833,116.6667
"12786","38287","2018",6,5,1,191962.3,1793.5,108.3333
"12787","38288","2018",18,15,3,228283.6,2331.111,102.6111
"12788","38289","2018",18,6,12,157662.9,3583.889,47.61111
"12789","38290","2018",8,7,1,164375,1372.875,131.125
"12790","38291","2018",10,10,0,174880,1618.4,111.3
"12791","38292","2018",34,29,5,197786.1,1898.441,107.6471
"12792","38294","2018",4,4,0,289200,2572.75,112
"12793","38295","2018",9,9,0,185922.2,1903.222,100.4444
"12794","38296","2018",11,11,0,217977.3,1788.273,126.0909
"12795","38297","2018",23,21,2,155363.6,1693.348,95.56522
"12796","38298","2018",87,50,37,125882.4,1490.874,83.41379
"12797","38299","2018",5,4,1,129000,1416.8,98.2
"12798","38300","2018",2,2,0,155000,1120,138
"12799","38301","2018",1,1,0,50000,625,80
"12800","38303","2018",4,3,1,266192.5,2476.25,110.5
"12801","38304","2018",15,13,2,140790,1530.6,90.8
"12802","38307","2018",7,7,0,126842.9,1168.571,130.7143
"12803","38308","2018",1,1,0,204500,2176,94
"12804","38309","2018",18,10,8,270145,2750.778,98.94444
"12805","38310","2018",9,9,0,226018.3,2122.889,106.3333
"12806","38311","2018",8,8,0,184210,1827.75,106.875
"12807","38313","2018",1,1,0,212500,1832,116
"12808","38314","2018",76,47,29,200738.2,2265.105,89.42105
"12809","38315","2018",60,30,30,146588.7,1667.717,90.06667
"12810","38316","2018",117,36,81,145153.2,2068.983,71.06838
"12811","38317","2018",114,20,94,136721.5,1868.105,72.36842
"12812","38318","2018",39,14,25,150335.6,1846.154,79.58974
"12813","38319","2018",16,9,7,94714.88,1115.875,85.25
"12814","38320","2018",26,25,1,172739.2,1924.769,96.5
"12815","38321","2018",2,2,0,73750,866.5,81.5
"12816","38323","2018",11,11,0,149181.8,1914.273,82.63636
"12817","38324","2018",9,9,0,195088.9,1868.667,106.8889
"12818","38325","2018",3,2,1,254166.7,2634,101
"12819","38326","2018",1,1,0,228000,1551,147
"12820","38328","2018",5,5,0,283300,3121,91.2
"12821","38330","2018",2,2,0,175000,1488.5,118
"12822","38331","2018",12,11,1,254183.1,2445.083,105.75
"12823","38332","2018",39,30,9,175288.1,2047.846,85.74359
"12824","38333","2018",6,5,1,149631.7,2209.333,76.16667
"12825","38334","2018",16,12,4,307801.9,3185.75,104.75
"12826","38335","2018",5,5,0,122274,1338.6,91.8
"12827","38336","2018",24,23,1,267462.1,2679.083,106.9167
"12828","38337","2018",98,33,65,157397.8,1901.061,85.52041
"12829","38338","2018",7,6,1,163928.6,2001.286,78
"12830","38339","2018",31,31,0,192386.5,1957.097,96.25806
"12831","38340","2018",26,17,9,163751.2,2019.538,86.38462
"12832","38341","2018",13,13,0,199326.4,1887.308,108.2308
"12833","38342","2018",3,2,1,266500,2408.667,110.3333
"12834","38343","2018",10,10,0,163110,1471.2,119.3
"12835","38344","2018",112,85,27,159491.7,1650.268,98.49107
"12836","38345","2018",6,6,0,191583.3,1827.167,105.1667
"12837","38346","2018",4,4,0,183375,2101.5,91.25
"12838","38347","2018",10,6,4,105929,1209.6,90.9
"12839","38348","2018",43,41,2,249122.9,2300.767,108.3256
"12840","38349","2018",30,28,2,175736.7,1843.933,98.1
"12841","38350","2018",7,7,0,273708.6,3221.571,99.71429
"12842","38351","2018",5,5,0,228936,2118.8,108.4
"12843","38352","2018",25,19,6,228400.4,2414.68,96.52
"12844","38353","2018",7,7,0,187457.1,1824.714,103.4286
"12845","38354","2018",3,3,0,235000,2108.667,111.3333
"12846","38355","2018",6,6,0,173675,1906.5,95.66667
"12847","38356","2018",2,2,0,169225,2193,79.5
"12848","38357","2018",26,24,2,164681.2,1661.846,99.73077
"12849","38358","2018",6,6,0,216043.3,1878.167,116.3333
"12850","38359","2018",15,15,0,213577,1754,123.6667
"12851","38361","2018",1,1,0,35000,500,70
"12852","38362","2018",9,8,1,245211.1,1831.667,136.3333
"12853","38363","2018",12,11,1,157005.2,1464.167,113.25
"12854","38364","2018",7,7,0,147000,1678.571,90.14286
"12855","38365","2018",10,10,0,179525.6,1752,112.2
"12856","38366","2018",2,2,0,164827.5,2291,71.5
"12857","38368","2018",4,4,0,199188.5,1306.25,145
"12858","38369","2018",9,9,0,209891.1,2112.778,101.4444
"12859","38370","2018",6,6,0,217311.7,2169.167,114.5
"12860","38372","2018",7,7,0,167632.9,1543.429,113.8571
"12861","38373","2018",9,8,1,247912.2,2595.222,95.55556
"12862","38374","2018",43,39,4,205566.7,2027.07,103.3721
"12863","38375","2018",4,4,0,66625,1277.25,60.5
"12864","38376","2018",12,12,0,130341.7,1080.833,117.8333
"12865","38377","2018",59,44,15,156396.3,1790.831,88.33898
"12866","38378","2018",42,34,8,197494.1,2117.952,93.7381
"12867","38379","2018",6,6,0,171320,1813.5,92.83333
"12868","38380","2018",2,2,0,217300,1971.5,113.5
"12869","38381","2018",19,19,0,186036.1,1736.737,104.6842
"12870","38382","2018",214,68,146,238086,2823.019,80.3972
"12871","38383","2018",27,25,2,253252.6,2167.963,117.3704
"12872","38384","2018",23,15,8,171331.7,2063.435,88.43478
"12873","38386","2018",35,29,6,186543.9,1629.743,113.2
"12874","38387","2018",5,2,3,171380,1622.4,102.6
"12875","38388","2018",25,22,3,265548.5,2853.92,96.12
"12876","38389","2018",36,28,8,222705.6,2225.528,105.7222
"12877","38390","2018",3,3,0,217266.7,1803.333,120.3333
"12878","38391","2018",5,5,0,202624,1751,111.2
"12879","38392","2018",7,7,0,230221.9,3462,94.28571
"12880","38393","2018",21,20,1,177625.5,1766.048,105.8095
"12881","38394","2018",25,23,2,154392.9,1734.08,91.32
"12882","38395","2018",27,22,5,209364.8,2630.37,83.37037
"12883","38396","2018",15,3,12,52840,1258,39.53333
"12884","38397","2018",55,37,18,446956.2,3764.364,118.2364
"12885","38398","2018",7,6,1,155571.4,2003.286,76.14286
"12886","38399","2018",61,45,16,180237.4,1915.23,100.6393
"12887","38400","2018",34,27,7,237846.4,2278.382,105.5882
"12888","38401","2018",16,16,0,207974,1941.562,107.8125
"12889","38402","2018",2,2,0,149250,2007,70
"12890","38403","2018",5,4,1,104400,1257.4,84.2
"12891","38404","2018",2,2,0,365000,2167,168.5
"12892","38405","2018",13,13,0,214665.4,2393.231,93.07692
"12893","38406","2018",2,2,0,171000,1932.5,91.5
"12894","38407","2018",13,11,2,239386.2,2195.385,111.7692
"12895","38408","2018",22,15,7,221629.7,2490.409,92.22727
"12896","38409","2018",16,14,2,179003.8,1649.875,112.5625
"12897","38410","2018",9,9,0,261694.4,1691,147.8889
"12898","38412","2018",52,35,17,145759.6,1710.615,87.23077
"12899","38413","2018",8,7,1,111437.5,1083.5,103.375
"12900","38415","2018",14,14,0,358162.9,2772.643,132.3571
"12901","38416","2018",122,27,95,117392.7,1604.623,72.47541
"12902","38417","2018",8,5,3,256477.1,1852,134.75
"12903","38418","2018",6,5,1,269916.7,2470.667,102.8333
"12904","38419","2018",1,1,0,230000,1966,117
"12905","38420","2018",1,1,0,80000,727,110
"12906","38421","2018",420,45,375,146446.8,2229.245,66.31429
"12907","38422","2018",75,45,30,310684.8,3002.347,106.5733
"12908","38423","2018",51,12,39,185060.4,2487.902,72.78431
"12909","38424","2018",4,4,0,95000,1256.75,81.5
"12910","38425","2018",59,56,3,175452.3,1849.186,97.15254
"12911","38426","2018",4,4,0,305012.5,2757,112.75
"12912","38427","2018",4,4,0,166235,1628.5,102.75
"12913","38429","2018",3,3,0,224800,2130.667,117.3333
"12914","38430","2018",2,2,0,231740,2567,90.5
"12915","38431","2018",33,20,13,400032.3,3629,111.9394
"12916","38432","2018",8,7,1,322656.2,2449.625,130.875
"12917","38433","2018",17,8,9,220373.5,2936.941,76.52941
"12918","38434","2018",6,6,0,202316.7,1774.833,115.8333
"12919","38436","2018",24,20,4,316316.9,2882,113.5417
"12920","38438","2018",1,1,0,320900,2342,137
"12921","38439","2018",39,33,6,196027.6,2087.897,93.94872
"12922","38440","2018",5,5,0,185800,1945.4,100.2
"12923","38442","2018",19,8,11,124882.6,2042.684,59.21053
"12924","38443","2018",5,5,0,168250,2298.2,72.8
"12925","38445","2018",7,5,2,212785.7,2190,100
"12926","38446","2018",13,13,0,144364,1718.077,80.07692
"12927","38448","2018",12,11,1,232825,2183.917,109.8333
"12928","38449","2018",66,56,10,186871,2102.076,91.01515
"12929","38450","2018",14,13,1,197560.3,2080.357,95.78571
"12930","38451","2018",27,26,1,230687,2254.296,106.1852
"12931","38452","2018",8,8,0,167887.5,1660.125,104
"12932","38453","2018",16,15,1,143121.9,1535.938,99.9375
"12933","38454","2018",12,12,0,215442.7,1928,118.1667
"12934","38455","2018",47,45,2,249161.1,2232.745,112
"12935","38456","2018",6,6,0,172116.7,1854.333,112.3333
"12936","38457","2018",41,38,3,157877.7,1578.293,103.7073
"12937","38458","2018",8,8,0,142125,1493,96.25
"12938","38459","2018",11,11,0,252237.6,2599.273,111.8182
"12939","38460","2018",4,4,0,159587.5,1495.5,101.75
"12940","38462","2018",9,7,2,136184,1913.333,75.66667
"12941","38463","2018",21,19,2,230146.2,2028.905,113.0476
"12942","38464","2018",21,20,1,199890.3,1997.381,105.0476
"12943","38465","2018",21,20,1,193370.5,1899.476,104.1429
"12944","38466","2018",12,8,4,229097.2,3134.333,76.66667
"12945","38467","2018",21,21,0,220113.7,2041.952,110.4286
"12946","38468","2018",48,37,11,166106.1,1743.875,95.875
"12947","38470","2018",4,4,0,136007.5,1879.75,82.25
"12948","38471","2018",14,12,2,289281.5,3399.929,89.07143
"12949","38472","2018",3,3,0,336415,2462,143.6667
"12950","38473","2018",12,12,0,198012.5,1574.917,130.1667
"12951","38474","2018",151,36,115,190741.2,2535.728,74.77483
"12952","38475","2018",29,24,5,248733,2472.241,104.2069
"12953","38476","2018",9,9,0,208737.8,2169.778,100.7778
"12954","38478","2018",10,8,2,137644.4,1619.9,84
"12955","38479","2018",16,16,0,170371.9,1271.312,133.5
"12956","38480","2018",33,25,8,218444,2437.818,96.48485
"12957","38481","2018",4,4,0,260857.8,2258,111
"12958","38483","2018",18,16,2,202563.3,2297.889,103.2778
"12959","38484","2018",23,22,1,251637.4,2626.174,99.43478
"12960","38485","2018",178,34,144,176437.3,2413.646,69.60674
"12961","38486","2018",65,26,39,316343.1,3196.215,98.30769
"12962","38487","2018",21,17,4,288680,2535.095,116.1429
"12963","38488","2018",11,11,0,221579.1,2111.818,102.9091
"12964","38490","2018",18,15,3,211241.1,1875.778,115.9444
"12965","38492","2018",8,8,0,278093.8,2405.75,123.25
"12966","38494","2018",9,9,0,185294.4,1792.889,101.4444
"12967","38495","2018",6,6,0,207400,1802.167,112.3333
"12968","38496","2018",12,12,0,242083.5,1861.333,133.25
"12969","38498","2018",8,8,0,179816.2,2169.125,92.5
"12970","38499","2018",10,9,1,132139,1519.1,90.5
"12971","38500","2018",4,4,0,218922.5,2187.25,100.25
"12972","38501","2018",60,25,35,198680.1,2661.067,75.58333
"12973","38503","2018",27,19,8,265227.6,3190.407,89.55556
"12974","38504","2018",15,15,0,249369.3,2635.133,97
"12975","38505","2018",15,15,0,133737.8,1377.2,108.6
"12976","38507","2018",92,79,13,237259.3,2460.891,97.56522
"12977","38508","2018",8,8,0,166192.4,1743.125,96
"12978","38509","2018",95,49,46,136651.9,1612.211,86.36842
"12979","38511","2018",37,17,20,252985,2581.297,95.83784
"12980","38512","2018",10,10,0,208380,2020.6,102.5
"12981","38513","2018",1,1,0,80000,2963,27
"12982","38514","2018",5,5,0,103844,1251.8,95
"12983","38515","2018",24,24,0,213514.6,2425.292,95.625
"12984","38516","2018",80,29,51,322836.4,3506.55,89.5
"12985","38517","2018",83,57,26,187421.8,2114.41,89.89157
"12986","38518","2018",8,7,1,112025,1217.125,93.625
"12987","38519","2018",35,24,11,286832.5,2840.543,102.6286
"12988","38520","2018",4,4,0,169750,1781.25,106.25
"12989","38521","2018",2,2,0,96250,4738.5,60
"12990","38522","2018",2,2,0,51250,1099,44
"12991","38523","2018",11,11,0,178813.6,1747.091,101.5455
"12992","38524","2018",64,38,26,269752.2,2901.703,96.64062
"12993","38525","2018",7,7,0,189357.1,1737.143,106.5714
"12994","38526","2018",1,1,0,233500,2458,95
"12995","38527","2018",17,2,15,322294.1,4909.588,61.64706
"12996","38528","2018",13,11,2,251412.3,2863.385,87.84615
"12997","38529","2018",45,24,21,302361.2,3148.911,95.66667
"12998","38530","2018",34,28,6,247322.1,2429.529,105.2353
"12999","38531","2018",4,4,0,192087.5,2268.75,84.75
"13000","38532","2018",5,4,1,275379.2,2666.2,101
"13001","38533","2018",6,5,1,412646.7,3183.667,132.5
"13002","38535","2018",2,2,0,165000,1919,88.5
"13003","38536","2018",11,11,0,322590.9,2417.636,121.6364
"13004","38537","2018",110,64,46,184357.6,2262.618,84.00909
"13005","38538","2018",57,39,18,272915.8,3003.158,91.84211
"13006","38539","2018",11,11,0,175316.7,1817.545,98.09091
"13007","38540","2018",11,11,0,265402.7,2632.545,101.4545
"13008","38542","2018",5,5,0,267530,2161,124.6
"13009","38543","2018",23,23,0,150264.6,1447.739,106.6522
"13010","38544","2018",406,90,316,159538.3,2009.219,78.87685
"13011","38545","2018",107,58,49,232244.8,2771.673,86.56075
"13012","38546","2018",11,11,0,234059.1,1974.818,121.4545
"13013","38547","2018",84,32,52,184251.5,2518.798,73.70238
"13014","38548","2018",215,25,190,134394.6,2654.312,51.0186
"13015","38549","2018",1,1,0,79000,790,100
"13016","38550","2018",3,1,2,319933.3,3398.333,78
"13017","38551","2018",3,2,1,96500,1852.667,51.66667
"13018","38552","2018",2,2,0,137225,1075.5,97
"13019","38553","2018",127,104,23,188138.1,1999.748,93.40945
"13020","38554","2018",14,13,1,246238.2,2271.286,113.9286
"13021","38555","2018",10,10,0,184636.8,1997.1,95.6
"13022","38556","2018",15,14,1,175174.3,1641.667,117.9333
"13023","38557","2018",83,74,9,297612.9,2727.06,112.4337
"13024","38558","2018",21,19,2,329460,2696.476,129.0476
"13025","38559","2018",35,15,20,148308,1776.286,84.14286
"13026","38560","2018",20,17,3,139439.5,1404.55,98.15
"13027","38561","2018",15,15,0,155608,1736.733,93.06667
"13028","38562","2018",97,27,70,127604.2,1881.196,67.56701
"13029","38563","2018",300,54,246,166504.4,2137.897,76.78
"13030","38565","2018",87,41,46,225792.6,2589.368,87.2069
"13031","38566","2018",19,19,0,282053.1,2559.421,110.3158
"13032","38567","2018",78,4,74,76656.13,2023.603,36.17949
"13033","39001","2018",14,14,0,122321.4,1197.143,99.57143
"13034","39002","2018",1,1,0,40000,667,60
"13035","39006","2018",4,4,0,91212.5,1206.25,77
"13036","39008","2018",1,1,0,178500,992,180
"13037","39009","2018",7,6,1,142848.6,966.1429,155.2857
"13038","39010","2018",4,3,1,87437.5,855.5,96.5
"13039","39011","2018",4,4,0,120637.5,1021.5,112.5
"13040","39013","2018",38,30,8,159100.5,1543.763,94.84211
"13041","39014","2018",1,0,1,89000,832,107
"13042","39015","2018",1,1,0,116200,880,132
"13043","39016","2018",9,9,0,94333.33,1080.889,88.33333
"13044","39017","2018",12,11,1,151783.3,1367.75,118.75
"13045","39018","2018",8,8,0,106100,1126.625,93.75
"13046","39020","2018",2,2,0,60217.5,799,80
"13047","39021","2018",7,7,0,145392.9,1428.143,107.4286
"13048","39022","2018",7,7,0,88571.43,960,91.85714
"13049","39024","2018",7,5,2,116351.7,1241.571,90.57143
"13050","39025","2018",6,6,0,149133.3,1315.833,114.1667
"13051","39026","2018",8,6,2,131208.8,1304.625,97.625
"13052","39028","2018",7,7,0,103648.6,972,108.2857
"13053","39029","2018",5,5,0,128660,1221,104.8
"13054","39030","2018",3,2,1,119083.3,1319.333,88.33333
"13055","39031","2018",2,2,0,138500,1414.5,99
"13056","39032","2018",1,1,0,168000,1697,99
"13057","39034","2018",2,2,0,114500,848.5,130
"13058","39035","2018",4,4,0,94500,1326,75.25
"13059","39038","2018",6,6,0,119008.3,1800.5,62.66667
"13060","39039","2018",2,2,0,175035,1564.5,111.5
"13061","39040","2018",1,1,0,42000,560,75
"13062","39041","2018",1,1,0,80000,696,115
"13063","39042","2018",7,5,2,151042.9,1618,93.14286
"13064","39043","2018",19,18,1,115920.8,1278.579,91.84211
"13065","39045","2018",1,1,0,29000,408,71
"13066","39047","2018",4,1,3,98125,2147.5,48.5
"13067","39049","2018",5,5,0,118480,1233.2,98.4
"13068","39050","2018",3,3,0,93333.33,1125,94
"13069","39051","2018",3,3,0,106333.3,1272.333,84
"13070","39052","2018",1,1,0,70000,609,115
"13071","39055","2018",1,1,0,145530,1223,119
"13072","39056","2018",10,8,2,121180,1258.1,101.3
"13073","39057","2018",1,1,0,78240,387,202
"13074","39058","2018",1,1,0,145000,863,168
"13075","39059","2018",26,8,18,213686.9,2223.346,93.53846
"13076","39060","2018",1,1,0,95000,1188,80
"13077","39061","2018",3,3,0,109466.7,1150.333,92.66667
"13078","39063","2018",6,3,3,89248.33,1453.333,61
"13079","39065","2018",3,3,0,124833.3,1258.667,103.3333
"13080","39066","2018",2,2,0,172500,1038,148.5
"13081","39068","2018",3,3,0,144056.7,2187.667,66.66667
"13082","39070","2018",1,1,0,220300,1644,134
"13083","39072","2018",2,2,0,92500,1018,87
"13084","39073","2018",1,1,0,109000,1185,92
"13085","39076","2018",2,2,0,158600,1449.5,108.5
"13086","39078","2018",5,4,1,148330,1341.2,114
"13087","39079","2018",1,1,0,211850,1422,149
"13088","39081","2018",1,1,0,176000,1467,120
"13089","39083","2018",4,4,0,201937.2,1903.25,106
"13090","39084","2018",1,1,0,1e+05,1449,69
"13091","39086","2018",6,6,0,56395.33,808.5,68.33333
"13092","39088","2018",7,7,0,137792.9,1217.857,101.5714
"13093","39091","2018",1,1,0,309000,1956,158
"13094","39092","2018",3,3,0,97000,770.3333,122.3333
"13095","39093","2018",5,5,0,131868,1139.2,110.2
"13096","39094","2018",1,0,1,58000,829,70
"13097","39095","2018",1,1,0,80000,899,89
"13098","39096","2018",8,8,0,143781.2,1388,104.125
"13099","39097","2018",94,40,54,113988.6,1323.064,86.11702
"13100","39099","2018",1,1,0,140000,1458,96
"13101","39100","2018",1,1,0,95500,995,96
"13102","39101","2018",19,16,3,146802.6,1327.947,116.4211
"13103","39102","2018",2,2,0,175250,1596,116
"13104","39103","2018",4,4,0,152825,1591,98.25
"13105","39104","2018",8,8,0,136562.5,1276.5,113.125
"13106","39105","2018",4,4,0,141770,1677,94.5
"13107","39106","2018",4,4,0,210625,1863.75,125.5
"13108","39107","2018",2,2,0,94950,1004,95
"13109","39109","2018",1,1,0,130000,1182,110
"13110","39110","2018",1,1,0,198850,1004,198
"13111","39112","2018",2,2,0,74500,940.5,77
"13112","39114","2018",1,1,0,117000,718,163
"13113","39116","2018",1,1,0,60000,923,65
"13114","39117","2018",1,1,0,158940,1622,98
"13115","39119","2018",1,1,0,85000,810,105
"13116","39120","2018",4,4,0,85125,894.75,118.75
"13117","39121","2018",2,2,0,168750,1478.5,116.5
"13118","39122","2018",2,2,0,117000,1421.5,81.5
"13119","39124","2018",5,5,0,128102,1366.8,89.8
"13120","39126","2018",3,3,0,146000,1612,89.33333
"13121","39128","2018",17,17,0,115638.2,1049.471,109.4706
"13122","39129","2018",5,5,0,176264,1673.8,111
"13123","39130","2018",7,7,0,181754.9,1298.143,147.5714
"13124","39131","2018",7,7,0,155815.7,1296.286,118.2857
"13125","39133","2018",1,1,0,45000,556,81
"13126","39134","2018",1,1,0,160000,1119,143
"13127","39136","2018",1,1,0,197100,2011,98
"13128","39137","2018",4,4,0,161242.5,1347.5,120.75
"13129","39138","2018",3,3,0,90166.67,984,101.6667
"13130","39140","2018",1,1,0,260000,1733,150
"13131","39141","2018",1,1,0,48000,750,64
"13132","39142","2018",4,4,0,109000,1158,103
"13133","39143","2018",1,0,1,79420,892,89
"13134","39146","2018",9,9,0,185362.8,1420.889,132.8889
"13135","39147","2018",1,1,0,227500,1487,153
"13136","39149","2018",1,1,0,89500,376,238
"13137","39150","2018",13,11,2,129692.7,1449.231,91.23077
"13138","39151","2018",2,2,0,191500,1829.5,114.5
"13139","39153","2018",5,5,0,198998.2,1767.6,112.2
"13140","39154","2018",12,10,2,137270,1441.25,104.0833
"13141","39155","2018",1,1,0,60000,488,123
"13142","39156","2018",1,1,0,225300,2476,91
"13143","39159","2018",1,1,0,80000,889,90
"13144","39160","2018",9,9,0,109538.9,1146.111,94.88889
"13145","39162","2018",5,5,0,136310,1272.6,107.6
"13146","39163","2018",2,2,0,173000,1369,143
"13147","39164","2018",7,6,1,110892.9,1316.286,83.42857
"13148","39166","2018",2,2,0,117500,961.5,121.5
"13149","39167","2018",3,3,0,150333.3,1310.333,121.3333
"13150","39169","2018",4,4,0,70375,940.25,79.5
"13151","39170","2018",8,8,0,180240.6,1499.375,127.125
"13152","39171","2018",13,13,0,123769.2,1215,107.5385
"13153","39172","2018",6,6,0,175316.7,1788.833,97.83333
"13154","39173","2018",13,9,4,90884.62,1029.462,90.38462
"13155","39174","2018",1,1,0,140000,1556,90
"13156","39175","2018",1,1,0,61500,918,67
"13157","39176","2018",2,2,0,144000,1240,120
"13158","39177","2018",8,8,0,135937.5,1239.875,111.125
"13159","39178","2018",2,2,0,167550,1636,109.5
"13160","39179","2018",2,2,0,149100,1254,109.5
"13161","39180","2018",4,4,0,86825,862.5,102.25
"13162","39182","2018",7,6,1,162928.6,1621.286,99.71429
"13163","39183","2018",4,4,0,106037.5,1076.75,101
"13164","39184","2018",1,1,0,114000,838,136
"13165","39185","2018",5,5,0,117600,1117.6,117.2
"13166","39187","2018",2,2,0,257750,1563.5,164.5
"13167","39188","2018",4,4,0,149000,1143.5,124.5
"13168","39189","2018",39,38,1,116527.8,1334.615,92.12821
"13169","39190","2018",18,17,1,149668.3,1469.278,106.3889
"13170","39193","2018",11,11,0,215890.9,2094.091,112.8182
"13171","39194","2018",5,5,0,125420,1149.8,103.8
"13172","39196","2018",1,1,0,134300,1370,98
"13173","39197","2018",2,2,0,139500,1448,97.5
"13174","39198","2018",353,155,198,124830.1,1471.975,85.53541
"13175","39199","2018",15,15,0,161616.7,1494.133,113.1333
"13176","39200","2018",2,2,0,112500,1013,124
"13177","39201","2018",7,7,0,182805.1,1865.286,109.1429
"13178","39202","2018",1,1,0,147000,799,184
"13179","39205","2018",2,2,0,234386.5,1526.5,151.5
"13180","39206","2018",3,2,1,96666.67,1151.333,87.33333
"13181","39207","2018",1,1,0,255000,1301,196
"13182","39208","2018",4,4,0,257223.5,1862.25,140
"13183","39209","2018",8,7,1,124643.8,1002.25,142.125
"13184","39210","2018",4,4,0,196187.5,1495,143.75
"13185","39211","2018",6,6,0,150791.7,2610.833,104.1667
"13186","39214","2018",1,1,0,203000,1952,104
"13187","39216","2018",2,2,0,144375,1371.5,106.5
"13188","39217","2018",2,2,0,125000,1172.5,104.5
"13189","39218","2018",2,2,0,136635,1533,87.5
"13190","39219","2018",6,6,0,183979.2,1894,100.3333
"13191","39220","2018",3,3,0,189083.3,1679.667,121
"13192","39221","2018",2,2,0,157050,1499.5,117
"13193","39223","2018",2,2,0,41750,423.5,95
"13194","39225","2018",1,1,0,172800,1662,104
"13195","39227","2018",2,2,0,229350,1364.5,171.5
"13196","39228","2018",8,5,3,179200,1742.75,97.75
"13197","39229","2018",4,4,0,150767.5,1676.5,94.5
"13198","39230","2018",1,1,0,30000,435,69
"13199","39232","2018",4,4,0,174425,1865.75,83.75
"13200","39233","2018",18,15,3,150597.2,1653.833,94.16667
"13201","39234","2018",1,1,0,158000,963,164
"13202","39235","2018",16,10,6,159010,1422.375,115.625
"13203","39236","2018",1,1,0,40000,678,59
"13204","39238","2018",1,1,0,85000,787,108
"13205","39239","2018",1,1,0,301150,2214,136
"13206","39240","2018",2,2,0,198595,1713,119
"13207","39241","2018",2,2,0,93500,1144.5,83
"13208","39245","2018",3,3,0,95333.33,1407,72.33333
"13209","39246","2018",2,2,0,133550,1410,93
"13210","39247","2018",2,2,0,59500,811.5,73
"13211","39248","2018",2,2,0,105000,606,160.5
"13212","39249","2018",2,2,0,104850,1328,79
"13213","39251","2018",4,4,0,125000,1012.75,123.75
"13214","39252","2018",9,8,1,146467.2,1347.778,115.2222
"13215","39253","2018",1,1,0,66000,528,125
"13216","39255","2018",3,3,0,120333.3,1198,98.33333
"13217","39258","2018",6,6,0,159416.7,1811.5,103.3333
"13218","39259","2018",1,1,0,339750,1148,296
"13219","39261","2018",2,2,0,63500,753,85
"13220","39262","2018",1,1,0,133000,1773,75
"13221","39263","2018",3,3,0,145233.3,1033.333,127.3333
"13222","39265","2018",2,2,0,158500,1411.5,116
"13223","39266","2018",7,7,0,102168.6,903,112
"13224","39268","2018",2,2,0,151500,1291.5,100.5
"13225","39269","2018",4,1,3,111000,1354.5,99.25
"13226","39270","2018",6,6,0,93775,1011.5,96.83333
"13227","39271","2018",2,2,0,205025,1993.5,106.5
"13228","39272","2018",2,2,0,115000,1559.5,75
"13229","39273","2018",2,2,0,80400,655,106
"13230","39274","2018",4,3,1,241499.2,2596.75,91
"13231","39275","2018",17,11,6,161420.6,2418.118,65.23529
"13232","39277","2018",1,0,1,133000,950,140
"13233","39279","2018",5,5,0,182300,1591,103.2
"13234","39280","2018",2,2,0,160175,1237,129
"13235","39281","2018",1,1,0,241750,2467,98
"13236","39282","2018",1,1,0,161000,2477,65
"13237","39283","2018",4,4,0,150350,1487,101
"13238","39284","2018",2,2,0,174500,1410.5,123.5
"13239","39285","2018",7,6,1,102928.6,1160.429,83.57143
"13240","39286","2018",16,12,4,142912.5,1544.938,94.6875
"13241","39288","2018",5,5,0,110650,1277,94
"13242","39289","2018",3,3,0,84333.33,822.6667,102
"13243","39290","2018",5,5,0,80600,842.6,94.6
"13244","39291","2018",2,2,0,127500,881,142.5
"13245","39293","2018",6,6,0,143496.7,1168.833,119.6667
"13246","39295","2018",3,3,0,65000,736,86.66667
"13247","39296","2018",4,4,0,160875,1181,147.5
"13248","39297","2018",12,12,0,185383.9,2086.25,93.66667
"13249","39298","2018",1,1,0,55000,688,80
"13250","39299","2018",3,3,0,142666.7,1054.667,121
"13251","39300","2018",214,55,159,110449.8,1422.953,79.08879
"13252","39301","2018",1,1,0,133000,1773,75
"13253","39305","2018",7,7,0,141035.7,1342.571,110.8571
"13254","39306","2018",14,14,0,129085.7,1424,92.5
"13255","39307","2018",4,4,0,163925,3019.25,63.25
"13256","39310","2018",4,4,0,135176.2,1330.75,95
"13257","39312","2018",1,1,0,120000,1333,90
"13258","39313","2018",3,2,1,127333.3,1118.333,111.6667
"13259","39315","2018",4,4,0,139750,1247,124.75
"13260","39317","2018",4,4,0,72625,641,122.75
"13261","39318","2018",1,1,0,90000,508,177
"13262","39320","2018",7,7,0,101414.3,1288.286,86.28571
"13263","39322","2018",1,1,0,140000,833,168
"13264","39323","2018",5,5,0,130744,1420.8,93
"13265","39325","2018",4,4,0,119875,816.25,133.25
"13266","39327","2018",11,9,2,132681.8,1471.636,90.09091
"13267","39328","2018",2,2,0,101605,1172,85
"13268","39330","2018",1,1,0,167000,1621,103
"13269","39331","2018",3,2,1,184100,2140,97.66667
"13270","39333","2018",26,19,7,100530.2,1103.5,92.69231
"13271","39334","2018",1,1,0,63500,698,91
"13272","39335","2018",9,8,1,118555.6,1138.111,105.4444
"13273","39336","2018",1,1,0,215000,1680,128
"13274","39337","2018",1,1,0,70000,1167,60
"13275","39338","2018",9,8,1,121900,1357.556,86.44444
"13276","39339","2018",4,4,0,220750,1665,128.75
"13277","39342","2018",2,2,0,183650,1459.5,128.5
"13278","39343","2018",2,2,0,104000,1139.5,88.5
"13279","39344","2018",2,2,0,263585,1490.5,172.5
"13280","39345","2018",5,5,0,171660,1648.2,107.2
"13281","39346","2018",1,1,0,1e+05,971,103
"13282","39348","2018",9,9,0,112722.2,973.2222,115.7778
"13283","39349","2018",3,3,0,196250,1446.667,158
"13284","39350","2018",4,4,0,166375,1580,107
"13285","39351","2018",2,2,0,223450,1786.5,131
"13286","39352","2018",1,1,0,215950,1489,145
"13287","39353","2018",3,3,0,51000,554.6667,92.33333
"13288","39354","2018",7,6,1,164428.6,1338.857,125.5714
"13289","39355","2018",1,1,0,235020,2398,98
"13290","39356","2018",4,4,0,203750,1464.75,117.25
"13291","39360","2018",4,4,0,95000,932.5,100.75
"13292","39362","2018",58,30,28,104981.5,1420,78.06897
"13293","39363","2018",1,1,0,15000,429,35
"13294","39364","2018",4,4,0,121525,1165.75,105
"13295","39365","2018",14,13,1,117664.3,1329.071,88.57143
"13296","39366","2018",4,4,0,162087.5,1546.75,105
"13297","39367","2018",27,17,10,168968.1,1911.259,92.7037
"13298","39368","2018",71,25,46,116457.7,1263.817,88.98592
"13299","39370","2018",10,9,1,128160,1390.6,92.4
"13300","39372","2018",1,1,0,168350,1958,86
"13301","39373","2018",1,1,0,148000,3217,46
"13302","39375","2018",2,2,0,152500,1403,113
"13303","39376","2018",1,1,0,130000,1130,115
"13304","39377","2018",4,3,1,71750,1240.75,70.25
"13305","39378","2018",5,5,0,104428,1097.6,90.2
"13306","39379","2018",3,3,0,194666.7,1326.333,145
"13307","39381","2018",1,1,0,30000,333,90
"13308","39385","2018",10,10,0,91705,1251.5,78.5
"13309","39387","2018",2,2,0,159400,1625,98
"13310","39388","2018",5,5,0,85800,838.8,96
"13311","39389","2018",6,5,1,207333.3,1791.333,120.6667
"13312","39390","2018",3,3,0,194666.7,1747,111.3333
"13313","39391","2018",9,7,2,129461.1,1372.556,93.77778
"13314","39392","2018",1,1,0,85000,639,133
"13315","39393","2018",1,1,0,75000,1442,52
"13316","39396","2018",11,8,3,119440,1125.273,104.2727
"13317","39397","2018",11,11,0,111823.6,1101.636,112
"13318","39398","2018",3,3,0,139333.3,1832.333,85
"13319","39399","2018",4,4,0,58000,546,99.75
"13320","39400","2018",1,1,0,175000,1768,99
"13321","39401","2018",5,5,0,104000,854.4,122.2
"13322","39402","2018",6,6,0,154208.3,1584.833,98.66667
"13323","39403","2018",3,3,0,126000,1361.333,86.66667
"13324","39404","2018",1,1,0,276000,789,350
"13325","39405","2018",6,6,0,130833.3,1347.167,102.1667
"13326","39406","2018",2,2,0,150275,1042,140
"13327","39407","2018",1,1,0,107800,1047,103
"13328","39408","2018",2,2,0,155000,1408.5,109
"13329","39409","2018",1,1,0,80000,571,140
"13330","39411","2018",29,20,9,120666.9,1403.241,87.24138
"13331","39412","2018",5,5,0,121980,1216.2,98.6
"13332","39413","2018",3,3,0,178203.3,1575.333,120
"13333","39415","2018",18,18,0,101523.3,1150.167,86.77778
"13334","39418","2018",1,1,0,117000,1983,59
"13335","39420","2018",2,2,0,102500,851.5,120.5
"13336","39421","2018",2,2,0,217500,2008.5,122
"13337","39422","2018",5,5,0,163080.6,1233.6,122.4
"13338","39423","2018",1,1,0,130000,833,156
"13339","39424","2018",2,2,0,131625,1518,84
"13340","39425","2018",1,1,0,151500,3030,50
"13341","39429","2018",1,1,0,45000,1071,42
"13342","39430","2018",2,2,0,120000,1021,111.5
"13343","39431","2018",2,2,0,188110,1671,112
"13344","39432","2018",3,3,0,145833.3,1194.333,124.3333
"13345","39434","2018",43,30,13,110971.3,1366.744,87.18605
"13346","39435","2018",14,10,4,119313.2,1450.857,85.57143
"13347","39436","2018",1,1,0,138000,1327,104
"13348","39437","2018",4,4,0,94687.5,2060.5,75.5
"13349","39439","2018",9,8,1,139150,1555.556,87.44444
"13350","39441","2018",35,10,25,115080.6,2402.2,47.4
"13351","39443","2018",1,1,0,125000,1190,105
"13352","39445","2018",3,3,0,144666.7,1401,102.6667
"13353","39446","2018",1,1,0,105000,1154,91
"13354","39448","2018",4,4,0,139500,1304.25,108
"13355","39449","2018",2,2,0,259900,1769,143
"13356","39451","2018",5,5,0,147290,1630.2,103
"13357","39452","2018",6,6,0,201250,1557,128.1667
"13358","39453","2018",5,5,0,161902,1290.6,125.4
"13359","39454","2018",4,4,0,79085,1245.75,63.5
"13360","39455","2018",1,1,0,137000,1269,108
"13361","39456","2018",3,3,0,117813.3,1343.667,88.66667
"13362","39457","2018",1,1,0,154000,1453,106
"13363","39458","2018",6,6,0,108166.7,896,122
"13364","39460","2018",2,1,1,140000,1747.5,77.5
"13365","39461","2018",5,5,0,165580,2014.4,90.4
"13366","39462","2018",3,3,0,198000,1763.333,109.6667
"13367","39463","2018",2,2,0,206000,1755.5,120
"13368","39464","2018",3,3,0,189250,1899.667,107.3333
"13369","39465","2018",2,1,1,124000,825.5,144
"13370","39466","2018",1,1,0,75000,1250,60
"13371","39467","2018",1,1,0,205500,2362,87
"13372","39468","2018",2,2,0,138900,1110,135.5
"13373","39469","2018",2,2,0,171100,1491,122.5
"13374","39470","2018",11,7,4,271459.1,2193.091,123.5455
"13375","39471","2018",8,8,0,165975,1955.375,95.125
"13376","39472","2018",4,4,0,124875,1215.5,105.75
"13377","39474","2018",1,1,0,72000,1029,70
"13378","39475","2018",20,18,2,119497.5,1059.7,112.95
"13379","39476","2018",19,18,1,144136.8,1221.895,121.2632
"13380","39477","2018",3,3,0,84666.67,1068.333,79.66667
"13381","39478","2018",57,22,35,84298.39,1062.158,80.45614
"13382","39479","2018",2,2,0,143110,1104,133
"13383","39480","2018",1,1,0,43500,483,90
"13384","39481","2018",3,3,0,144638.7,1020.333,148
"13385","39485","2018",9,9,0,116505.6,1239.889,95.66667
"13386","39486","2018",4,4,0,130700,1420.25,95.75
"13387","39487","2018",23,13,10,166732.2,2108.565,86.08696
"13388","39489","2018",2,2,0,182750,828.5,226.5
"13389","39490","2018",3,3,0,133766.7,1348,97.66667
"13390","39491","2018",16,14,2,131153.1,1209.5,106.625
"13391","39492","2018",2,2,0,138168.5,1403.5,98
"13392","39493","2018",2,2,0,88250,1320.5,67
"13393","39494","2018",4,4,0,128750,1202.75,104.75
"13394","39498","2018",8,8,0,221443.8,1880.625,118.25
"13395","39499","2018",2,2,0,88300,1235.5,72.5
"13396","39500","2018",30,14,16,95479.77,1075.233,94.33333
"13397","39501","2018",14,14,0,224214.3,1772.429,129.8571
"13398","39502","2018",2,2,0,78000,981,93
"13399","39503","2018",8,7,1,183600,1435.125,134.875
"13400","39504","2018",2,2,0,150000,1428,92
"13401","39505","2018",1,1,0,110000,932,118
"13402","39508","2018",8,8,0,80543.75,961,86.75
"13403","39510","2018",16,14,2,189677.6,1865.812,100.0625
"13404","39511","2018",1,1,0,74500,1035,72
"13405","39513","2018",2,2,0,146250,1587.5,92.5
"13406","39514","2018",1,1,0,169500,1730,98
"13407","39517","2018",2,2,0,65000,912.5,71
"13408","39519","2018",1,1,0,156000,1322,118
"13409","39520","2018",6,4,2,149575,1214.667,125.6667
"13410","39522","2018",2,2,0,98750,777,115
"13411","39525","2018",3,3,0,107500,1211.333,86.66667
"13412","39526","2018",39,32,7,117717.4,1393.795,86.15385
"13413","39527","2018",1,1,0,80000,1633,49
"13414","39528","2018",5,5,0,108920,1053.2,110.8
"13415","39530","2018",14,14,0,146143.2,1310.857,114.7143
"13416","39531","2018",2,2,0,246250,3048,76.5
"13417","39533","2018",2,2,0,135390,1175,119
"13418","39534","2018",2,2,0,85000,1812.5,46
"13419","39535","2018",4,4,0,116457.5,984.25,121.75
"13420","39539","2018",1,1,0,70000,875,80
"13421","39545","2018",1,0,1,75000,615,122
"13422","39546","2018",4,4,0,127375,1103,117.5
"13423","39547","2018",11,11,0,144486.4,1175.273,124.2727
"13424","39548","2018",1,1,0,75000,1042,72
"13425","39550","2018",5,5,0,112700,1190.2,97
"13426","39551","2018",1,1,0,96000,800,120
"13427","39552","2018",2,2,0,213500,1189.5,180
"13428","39553","2018",4,4,0,224525,1629.5,146.5
"13429","39554","2018",2,2,0,155570,1145.5,155.5
"13430","39555","2018",1,1,0,108000,1102,98
"13431","39556","2018",2,2,0,43500,746.5,62.5
"13432","39557","2018",3,3,0,106966.7,1249,86.33333
"13433","39558","2018",3,3,0,101333.3,966,105.6667
"13434","39559","2018",2,2,0,177400,1368.5,127.5
"13435","39560","2018",9,5,4,145792.2,1499.556,114
"13436","39561","2018",5,5,0,104305,907.6,102.8
"13437","39565","2018",1,1,0,30000,417,72
"13438","39567","2018",7,7,0,193210.1,1846.857,102
"13439","39569","2018",5,5,0,132713.4,1256,108
"13440","39570","2018",3,3,0,136470,1144,125
"13441","39571","2018",1,1,0,160000,1720,93
"13442","39572","2018",4,4,0,121517.5,1225.75,97.5
"13443","39573","2018",4,3,1,99600,1378.25,71
"13444","39574","2018",2,2,0,157500,1550,101
"13445","39576","2018",14,14,0,113039.9,1225.714,93.35714
"13446","39577","2018",2,2,0,128500,1234,101
"13447","39579","2018",3,3,0,195066.7,2316,87.33333
"13448","39581","2018",7,4,3,153350,1463.143,108.5714
"13449","39582","2018",5,5,0,106000,1026.8,103
"13450","39583","2018",3,3,0,130833.3,866.3333,151.3333
"13451","39584","2018",1,1,0,214000,1281,167
"13452","39585","2018",1,1,0,49950,617,81
"13453","40001","2018",105,85,20,114452.6,1268.724,95.02857
"13454","40002","2018",14,14,0,123836.3,1203.857,106.1429
"13455","40004","2018",20,14,6,277439.3,3098.3,91.6
"13456","40005","2018",1,1,0,164400,1536,107
"13457","40006","2018",7,6,1,126932.4,1401.143,89.71429
"13458","40007","2018",2,2,0,113250,1002.5,117
"13459","40008","2018",1,1,0,190000,1418,134
"13460","40011","2018",2,2,0,156250,1807,86.5
"13461","40012","2018",1,1,0,70000,843,83
"13462","40013","2018",1,1,0,70010,824,85
"13463","40015","2018",2,2,0,154650,713,207
"13464","40016","2018",3,3,0,121000,1161.333,104
"13465","40017","2018",7,7,0,158332.9,1389,113.5714
"13466","40018","2018",1,1,0,120000,1967,61
"13467","40019","2018",23,19,4,175749,2027.609,87.78261
"13468","40020","2018",8,8,0,170038.1,1606.625,108.875
"13469","40021","2018",15,15,0,229032.1,2235.533,102.6667
"13470","40022","2018",5,5,0,104570,1084.8,89.4
"13471","40023","2018",5,5,0,204208,1216.6,180.2
"13472","40024","2018",2,2,0,168750,2021.5,84.5
"13473","40025","2018",12,12,0,143487.5,1335.083,109.5
"13474","40026","2018",5,5,0,167100,1945.6,89.4
"13475","40027","2018",1,1,0,205000,1530,134
"13476","40028","2018",3,3,0,202333.3,1627.667,121.6667
"13477","40031","2018",27,27,0,146183.3,1439.963,100.7407
"13478","40032","2018",6,6,0,145333.3,1639.833,93
"13479","40033","2018",3,3,0,199000,1523.333,125
"13480","40034","2018",8,8,0,265937.5,1834.25,140.25
"13481","40035","2018",4,4,0,246712.5,1876,130
"13482","40036","2018",54,38,16,223820.4,2495.296,91.7037
"13483","40037","2018",16,16,0,176182.5,1626.812,109.5
"13484","40038","2018",2,2,0,145154.5,798,179.5
"13485","40039","2018",1,1,0,1e+05,870,115
"13486","40040","2018",4,4,0,122875,1344.25,98.75
"13487","40041","2018",2,2,0,181500,1297.5,141
"13488","40042","2018",2,2,0,280700,2324,135.5
"13489","40043","2018",28,15,13,126702.9,1730.214,73.39286
"13490","40044","2018",16,16,0,321635.9,2491.938,129.8125
"13491","40046","2018",422,251,171,240379.9,2953.04,82.88152
"13492","40047","2018",2,2,0,202500,1423.5,146
"13493","40049","2018",1,1,0,78000,897,87
"13494","40051","2018",6,6,0,199666.7,1629.833,121
"13495","40052","2018",4,4,0,116250,1417,90
"13496","40053","2018",4,4,0,170764.2,1658.25,101.5
"13497","40054","2018",2,2,0,174545.5,1418.5,126.5
"13498","40055","2018",16,16,0,189588.1,1684.688,112.875
"13499","40056","2018",11,10,1,150554.5,1259.909,118
"13500","40057","2018",7,7,0,205814.3,1679.143,120.1429
"13501","40058","2018",2,2,0,117500,1268,105
"13502","40059","2018",5,5,0,226160.8,1765,127.4
"13503","40060","2018",3,3,0,214333.3,1309,173.6667
"13504","40061","2018",13,13,0,129419.2,1196.077,113.6154
"13505","40062","2018",9,9,0,174670,1733.667,104.3333
"13506","40063","2018",15,13,2,172351.3,1758.8,100.8667
"13507","40065","2018",363,161,202,271061.7,4567.259,63.06061
"13508","40066","2018",1,1,0,68000,739,92
"13509","40067","2018",2,2,0,160900,1207,129.5
"13510","40068","2018",9,9,0,188056.7,1791.444,103.5556
"13511","40070","2018",2,2,0,165000,1152,143.5
"13512","40071","2018",6,6,0,139088.3,1502.667,94.66667
"13513","40072","2018",2,2,0,155768,1747.5,90
"13514","40074","2018",5,5,0,134200,1372.4,102
"13515","40075","2018",32,27,5,186267,1887.438,103.9062
"13516","40076","2018",6,6,0,127968.8,1440.5,87.33333
"13517","40077","2018",8,8,0,157897.5,1674.375,93.5
"13518","40078","2018",4,4,0,106250,1447.75,103.5
"13519","40079","2018",1,1,0,141750,1181,120
"13520","40080","2018",26,26,0,129542.5,1455.923,89.53846
"13521","40081","2018",10,10,0,182316,1674.7,114.5
"13522","40082","2018",2,2,0,172750,1685.5,102.5
"13523","40083","2018",1,1,0,135000,1324,102
"13524","40084","2018",5,5,0,237318,1650.6,155.8
"13525","40085","2018",6,6,0,194666.7,1759.667,123.5
"13526","40086","2018",6,6,0,159342.7,1415.833,114.6667
"13527","40087","2018",6,6,0,144436.7,1371.5,107.8333
"13528","40088","2018",553,180,373,122736,1881.237,65.79747
"13529","40089","2018",8,8,0,150925,1293,118.75
"13530","40090","2018",8,8,0,122841.2,1474.5,90
"13531","40091","2018",4,4,0,206125,1328,163
"13532","40092","2018",1,1,0,154000,1571,98
"13533","40093","2018",3,3,0,176771.7,1257,161.6667
"13534","40094","2018",7,7,0,179642.9,2010.143,92.28571
"13535","40095","2018",4,4,0,257525,1691,143.25
"13536","40097","2018",9,4,5,124272.2,2036.889,69.33333
"13537","40098","2018",2,2,0,195650,1459.5,137.5
"13538","40099","2018",2,2,0,305000,2512.5,116
"13539","40100","2018",3,3,0,154666.7,1013.333,145
"13540","40101","2018",4,4,0,224375,1678.25,139.25
"13541","40102","2018",13,11,2,87917.69,1033.846,81.76923
"13542","40103","2018",4,4,0,128250,1465.75,91
"13543","40104","2018",13,13,0,196196.2,1673.231,121.7692
"13544","40105","2018",4,4,0,219350,1774.25,123.5
"13545","40106","2018",2,2,0,91000,1150.5,71.5
"13546","40108","2018",14,14,0,182999.9,2035,91.21429
"13547","40109","2018",3,3,0,163606.7,1647.333,101.6667
"13548","40110","2018",12,12,0,144368.7,1164.583,125.0833
"13549","40111","2018",11,11,0,171963.2,1386.364,120.1818
"13550","40112","2018",2,2,0,163000,1581,102
"13551","40113","2018",5,5,0,253100,1647,161
"13552","40114","2018",2,2,0,262500,2132.5,132.5
"13553","40115","2018",4,4,0,149200,1622.75,90
"13554","40116","2018",2,2,0,177000,1880.5,95
"13555","40117","2018",38,35,3,129931.3,1422.316,95.18421
"13556","40118","2018",18,17,1,144286.7,1329.667,116.6667
"13557","40119","2018",60,51,9,133209.2,1378.167,97.33333
"13558","40120","2018",7,7,0,199681,1691.714,127.2857
"13559","40122","2018",8,8,0,186343.8,1377.125,133.25
"13560","40123","2018",8,8,0,237500,1844.875,123.125
"13561","40124","2018",2,2,0,125000,1265,92.5
"13562","40125","2018",14,14,0,175945.7,1711.786,104.4286
"13563","40126","2018",26,26,0,171265.8,1848.385,94.34615
"13564","40127","2018",2,2,0,131200,1616.5,81
"13565","40128","2018",4,4,0,121825,1187.25,102.75
"13566","40129","2018",10,10,0,238706,2274.4,105.3
"13567","40130","2018",1,1,0,270000,1475,183
"13568","40131","2018",14,14,0,122186.1,1167.929,107.5
"13569","40132","2018",13,13,0,135442.3,1178.154,115.3077
"13570","40133","2018",110,75,35,260920.4,3189.073,85.48182
"13571","40134","2018",32,31,1,138084.4,1272.562,112.25
"13572","40135","2018",13,13,0,153923.1,1412.154,116.8462
"13573","40136","2018",1,1,0,156000,1258,124
"13574","40137","2018",2,2,0,201250,1414,144
"13575","40138","2018",1,1,0,174720,2056,85
"13576","40139","2018",6,6,0,170308.3,1481.333,111.6667
"13577","40141","2018",2,2,0,111593.5,1250,89.5
"13578","40142","2018",9,9,0,197583.3,1856.778,109.5556
"13579","40143","2018",4,4,0,112300,1231.5,90.5
"13580","40144","2018",2,2,0,132750,1772.5,75.5
"13581","40145","2018",5,5,0,137444.8,1208.6,111.4
"13582","40146","2018",1,1,0,197000,1349,146
"13583","40147","2018",7,6,1,114785.7,1285.571,90.14286
"13584","40149","2018",2,2,0,154000,1339.5,126.5
"13585","40150","2018",50,36,14,165553.7,2080.78,76.86
"13586","40151","2018",7,7,0,140873.7,1622,94.14286
"13587","40152","2018",9,9,0,150222.2,2185.333,93.11111
"13588","40153","2018",2,2,0,144500,1016.5,146
"13589","40154","2018",1,1,0,546000,3033,180
"13590","40155","2018",28,26,2,235187.2,2210.929,106.5357
"13591","40156","2018",5,5,0,192080,1581,121.6
"13592","40157","2018",34,20,14,181566.2,2386.441,73.79412
"13593","40158","2018",1,1,0,92000,814,113
"13594","40159","2018",4,3,1,110625,1444.5,73.5
"13595","40160","2018",3,3,0,109683.3,987,119.3333
"13596","40161","2018",2,2,0,112500,1262,89
"13597","40162","2018",13,13,0,159034.6,1682.231,102.7692
"13598","40163","2018",12,12,0,146752.2,1886.917,77
"13599","40164","2018",6,6,0,112508.3,1028.667,117.6667
"13600","40165","2018",10,10,0,136400,1536.7,93.1
"13601","40167","2018",10,10,0,154942,1164.6,134.6
"13602","40168","2018",28,26,2,232757.6,1979.786,124.5
"13603","40170","2018",2,2,0,138950,944.5,126
"13604","40171","2018",1,1,0,150000,1515,99
"13605","40172","2018",4,4,0,138412.5,895,173.5
"13606","40175","2018",2,2,0,129000,1268,103
"13607","40176","2018",1,1,0,178500,1312,136
"13608","40178","2018",4,4,0,257500,1863,138.75
"13609","40179","2018",23,19,4,245213.5,1915.565,132.8696
"13610","40180","2018",19,19,0,136207.1,1509.579,91.73684
"13611","40181","2018",28,28,0,266543.6,3234.143,85.39286
"13612","40182","2018",14,14,0,225789.6,2013.143,116.5
"13613","40183","2018",11,11,0,171604.8,1374,132.8182
"13614","40184","2018",203,129,74,171665.7,2602.857,71.5468
"13615","40185","2018",5,5,0,99000,970.6,101.2
"13616","40186","2018",9,9,0,151616.7,1337.556,112.6667
"13617","40187","2018",145,80,65,186671.9,3312.952,56.6069
"13618","40188","2018",5,5,0,162906,1450.6,119
"13619","40190","2018",1,1,0,102500,932,110
"13620","40191","2018",13,13,0,160634.3,1254.615,129.1538
"13621","40192","2018",505,307,198,137365.5,1753.798,79.84158
"13622","40193","2018",2,2,0,160000,968.5,145
"13623","40194","2018",15,12,3,161193.7,1412.267,122.6667
"13624","40195","2018",6,6,0,279833.3,3182.5,122.6667
"13625","40196","2018",4,4,0,253900,1604.75,157.25
"13626","40197","2018",67,66,1,130307.3,1535.776,88.34328
"13627","40199","2018",2,2,0,168750,1271.5,130.5
"13628","40200","2018",9,8,1,161202.2,1445.444,113.5556
"13629","40201","2018",12,12,0,141863.3,1196.417,125
"13630","40202","2018",31,29,2,202802.8,2007.161,102.7742
"13631","40203","2018",3,3,0,146423.3,1170.333,128.3333
"13632","40204","2018",2,2,0,152100,1267.5,121
"13633","40205","2018",2,2,0,210000,1642,128
"13634","40206","2018",5,3,2,152060,1452,102.2
"13635","40207","2018",14,14,0,232779.3,2152.143,109
"13636","40208","2018",4,4,0,151050,969.75,160.5
"13637","40209","2018",90,56,34,247553.4,3043.022,84.27778
"13638","40210","2018",15,15,0,148212,1364,116.5333
"13639","40211","2018",8,8,0,254718.8,1810,142.125
"13640","40212","2018",12,11,1,160899.9,2133.5,79
"13641","40213","2018",7,7,0,377966.7,2632,146.4286
"13642","40214","2018",3,3,0,186666.7,1794.667,141.3333
"13643","40215","2018",1,1,0,206000,1493,138
"13644","40216","2018",2,2,0,112500,1081,101
"13645","40217","2018",98,82,16,218147.5,2405,95.94898
"13646","40218","2018",6,6,0,139980,909.6667,154.5
"13647","40219","2018",2,2,0,180250,1165,155
"13648","40220","2018",1,1,0,102200,730,140
"13649","40222","2018",8,8,0,229531.2,1829.25,130.25
"13650","40223","2018",2,2,0,122512,1047,117.5
"13651","40224","2018",34,29,5,166800.9,1563.794,114.2353
"13652","40225","2018",3,3,0,115666.7,1017.667,115
"13653","40226","2018",2,2,0,152425,1339,127.5
"13654","40227","2018",19,19,0,173480.5,1360.053,139.5789
"13655","40228","2018",16,15,1,150408.1,1326.5,120.4375
"13656","40229","2018",25,25,0,218173.6,2005.6,111.72
"13657","40230","2018",28,26,2,159405.4,1807.536,90.75
"13658","40231","2018",13,13,0,191780.8,1796.538,115.4615
"13659","40232","2018",2,2,0,118000,1038.5,115
"13660","40233","2018",30,30,0,182074.4,1572.967,125.6333
"13661","40234","2018",15,15,0,163206.7,1401.4,116.6667
"13662","40235","2018",9,9,0,137727.4,1130.444,131.6667
"13663","40236","2018",5,5,0,190900,1674.8,119.4
"13664","40237","2018",10,10,0,145800,1491.1,96.8
"13665","40238","2018",11,11,0,139640.9,1226.091,113.1818
"13666","40240","2018",7,7,0,159614.3,1385.429,118.4286
"13667","40243","2018",31,30,1,149466.1,1576.806,100.3548
"13668","40245","2018",21,21,0,123361.9,1240.81,102.619
"13669","40246","2018",9,8,1,119875,1224,107.4444
"13670","40247","2018",1,1,0,55000,579,95
"13671","40248","2018",15,14,1,230940.7,2540.8,100.9333
"13672","40249","2018",4,4,0,148940.5,1498.25,100.5
"13673","40250","2018",6,6,0,208473,1786.167,121.1667
"13674","40251","2018",4,4,0,343650,2235.25,151.75
"13675","40252","2018",7,7,0,157045.7,1491.429,106.8571
"13676","40253","2018",7,7,0,120315.7,1181,102.1429
"13677","40254","2018",3,3,0,183000,1421,129
"13678","40255","2018",5,5,0,177600,1470,121
"13679","40256","2018",6,6,0,295509.3,1849.5,159.1667
"13680","40257","2018",21,20,1,188199.8,2092.667,94.38095
"13681","40258","2018",3,3,0,148416.7,1399.333,103.3333
"13682","40259","2018",5,5,0,223800,1975.4,113.2
"13683","40260","2018",1,1,0,135000,1517,89
"13684","40261","2018",19,16,3,236241.6,2219.737,101.3158
"13685","40262","2018",4,4,0,129500,1418.75,94
"13686","40263","2018",1,1,0,150000,1705,88
"13687","40264","2018",21,17,4,234783.6,2257.714,105.4762
"13688","40265","2018",1,1,0,132000,1553,85
"13689","40266","2018",38,23,15,182002.5,2632.079,77.39474
"13690","40267","2018",18,18,0,132605.6,1406.222,96.16667
"13691","40268","2018",7,7,0,433257.1,2705,149.7143
"13692","40269","2018",14,14,0,222050,2194.714,111.2857
"13693","40270","2018",5,5,0,140544,1173.4,121.2
"13694","40271","2018",9,8,1,274000,2020.556,134.7778
"13695","40272","2018",29,24,5,253855.8,2226.345,121.2069
"13696","40273","2018",57,35,22,246846.7,2595.649,104.0877
"13697","40274","2018",17,17,0,164991.5,1537.647,111.7647
"13698","40275","2018",5,5,0,161200,1675.4,96.6
"13699","40276","2018",7,6,1,292199.9,2458.286,121
"13700","40277","2018",7,7,0,214418.9,1824.143,119.7143
"13701","40278","2018",16,16,0,185931.2,2248.375,85.125
"13702","40279","2018",275,148,127,154367.3,2026.509,76.63636
"13703","40280","2018",32,19,13,132892.2,1737.5,76.875
"13704","40281","2018",167,106,61,149283.1,1853.808,79.76048
"13705","40282","2018",60,52,8,148336.5,1524.4,99.4
"13706","40283","2018",42,38,4,216156,2053.262,108.2857
"13707","40284","2018",152,96,56,190522.3,2331.026,84.02632
"13708","40285","2018",6,6,0,154489.2,1762.333,99.83333
"13709","40286","2018",14,14,0,143454.1,1066.214,152.0714
"13710","40287","2018",62,54,8,284768.5,2910.435,100
"13711","40288","2018",18,18,0,166632.8,1463.722,105.6111
"13712","40289","2018",4,4,0,140240.8,1386,105.25
"13713","40290","2018",2,2,0,84500,1233,60.5
"13714","40291","2018",22,20,2,318386.1,3045.545,103.5909
"13715","40292","2018",14,14,0,310589.3,2748.357,117.2143
"13716","40293","2018",15,15,0,244369.6,2060.733,122.3333
"13717","40294","2018",22,22,0,173198.2,1713.364,105
"13718","40295","2018",17,17,0,186944.5,2031.176,96
"13719","40296","2018",207,87,120,237562.4,3783.874,63.16908
"13720","40297","2018",2,2,0,230450,2254.5,105.5
"13721","40300","2018",8,8,0,153260.8,1690.5,88.875
"13722","40303","2018",4,4,0,131480,1039.5,130.25
"13723","40304","2018",143,77,66,499468.1,5444.224,88.16084
"13724","40305","2018",1,1,0,201100,1559,129
"13725","40306","2018",6,6,0,116666.7,1256.833,96.5
"13726","40307","2018",16,16,0,157193.8,1631.438,95.375
"13727","40308","2018",10,10,0,243556.6,1999.2,120.7
"13728","40309","2018",10,10,0,144750,1192,130.5
"13729","40310","2018",213,131,82,212926.5,2871.451,78.77934
"13730","40311","2018",5,5,0,198225.6,2138.6,100
"13731","40312","2018",177,95,82,237135.3,2928.333,81.72881
"13732","40314","2018",13,12,1,242685.2,1936.231,130.3846
"13733","40315","2018",6,6,0,161457.7,1377.833,118.6667
"13734","40316","2018",10,10,0,180177.4,1611.6,113.7
"13735","40317","2018",50,43,7,279585.2,2711.96,105.28
"13736","40318","2018",1,1,0,135000,1776,76
"13737","40319","2018",6,6,0,158000,1743.5,106
"13738","40320","2018",6,6,0,184941.7,1566.167,116.8333
"13739","40321","2018",2,2,0,76500,1009.5,75
"13740","40322","2018",2,2,0,231750,2042.5,114
"13741","40323","2018",3,3,0,236400,1445.333,153.6667
"13742","40324","2018",4,4,0,180820.5,1740.25,104
"13743","40325","2018",6,6,0,129650,1193.667,107.8333
"13744","40326","2018",37,32,5,223552.6,2428.811,98.81081
"13745","40327","2018",2,2,0,58000,644,90
"13746","40328","2018",107,34,73,168650.6,3708.009,49.5514
"13747","40329","2018",7,7,0,133214.3,1278,113.8571
"13748","40330","2018",8,8,0,168812.1,1309.125,170.625
"13749","40331","2018",28,27,1,120760.7,1289.107,95.85714
"13750","40332","2018",37,35,2,182164.2,1888.189,100.2432
"13751","40333","2018",20,20,0,161230,1529.55,106.65
"13752","40334","2018",5,5,0,140716,1614.4,88
"13753","41001","2018",1,1,0,27000,435,62
"13754","41002","2018",10,10,0,118600,1324.8,94.1
"13755","41003","2018",2,2,0,184500,1394.5,141.5
"13756","41004","2018",2,2,0,28000,525.5,55.5
"13757","41006","2018",10,10,0,103908,1179.7,88.1
"13758","41007","2018",17,17,0,90705.88,1001.294,91.41176
"13759","41008","2018",12,12,0,144076.7,1215.75,124.75
"13760","41009","2018",11,11,0,191218.2,1544.727,121.2727
"13761","41010","2018",10,9,1,181841.9,1548,106.2
"13762","41012","2018",2,2,0,86500,709.5,124.5
"13763","41013","2018",3,3,0,87500,2520.667,41.66667
"13764","41014","2018",2,2,0,82500,1279.5,63.5
"13765","41016","2018",16,16,0,131569.7,1549.125,104.875
"13766","41017","2018",9,9,0,105166.7,1129.333,103
"13767","41018","2018",624,229,395,113806.9,1527.841,74.92628
"13768","41019","2018",3,3,0,90000,753.3333,134
"13769","41020","2018",7,7,0,86000,1061.143,85.57143
"13770","41022","2018",5,5,0,74200,973.8,71.2
"13771","41024","2018",4,4,0,123825,892.5,130.25
"13772","41025","2018",18,18,0,152603.6,1474.556,106.8333
"13773","41026","2018",2,2,0,48000,535,101
"13774","41027","2018",3,3,0,87666.67,887,96.33333
"13775","41028","2018",1,1,0,220000,1294,170
"13776","41029","2018",9,9,0,168906.7,1437.333,118.1111
"13777","41030","2018",2,2,0,327000,6187.5,65
"13778","41031","2018",20,20,0,166612.5,1544.4,114.1
"13779","41032","2018",27,27,0,151350.4,1546.074,102.4444
"13780","41035","2018",7,7,0,137925.7,1278,104.8571
"13781","41036","2018",7,7,0,115157.1,1366.143,86.71429
"13782","41037","2018",2,2,0,107000,675,160
"13783","41038","2018",5,5,0,129742,973.8,129
"13784","41039","2018",9,9,0,134722.2,1377.778,105.5556
"13785","41040","2018",5,5,0,127306,1668.8,80
"13786","41041","2018",3,3,0,65666.67,668.6667,88.66667
"13787","41042","2018",5,5,0,87888,1115.6,80
"13788","41043","2018",15,15,0,98737.67,1093.533,93.26667
"13789","41044","2018",20,20,0,76350,837.85,92.15
"13790","41045","2018",16,16,0,127785.6,1774.188,86.1875
"13791","41046","2018",13,13,0,143502.2,1349.231,111.6154
"13792","41047","2018",77,43,34,140215.5,1559.662,90.36364
"13793","41048","2018",4,4,0,46250,995.75,66.5
"13794","41049","2018",9,9,0,110011.1,1344.667,82.55556
"13795","41050","2018",13,13,0,262746.2,1896.692,144.6154
"13796","41051","2018",12,12,0,93595.83,1090.083,83.16667
"13797","41052","2018",12,12,0,152800,1430,102.75
"13798","41053","2018",6,6,0,109096.7,1045.667,101.1667
"13799","41054","2018",1,1,0,134500,897,150
"13800","41055","2018",29,29,0,136707.8,1478.207,103.5862
"13801","41057","2018",1,1,0,60000,1579,38
"13802","41058","2018",2,2,0,131000,1182,115
"13803","41059","2018",76,76,0,137147.8,1380.434,98.80263
"13804","41060","2018",11,11,0,56181.82,727.0909,72.63636
"13805","41061","2018",20,20,0,158539,1499.35,111.25
"13806","41062","2018",9,9,0,120069.3,1111.333,106.2222
"13807","41063","2018",6,6,0,63166.67,808.5,78.5
"13808","41065","2018",4,4,0,108750,1047.25,102.25
"13809","41066","2018",4,4,0,131266.2,1818.5,70.5
"13810","41067","2018",34,33,1,176982.2,1738.412,104
"13811","41068","2018",2,2,0,109500,864.5,124.5
"13812","41069","2018",4,4,0,239450,1789,117.75
"13813","41070","2018",6,6,0,133490.8,1070.333,111.5
"13814","41071","2018",7,7,0,145507.1,1684.143,104.5714
"13815","41072","2018",5,5,0,124500,1225,93
"13816","41073","2018",13,13,0,124780.8,1376.923,96.23077
"13817","41074","2018",19,19,0,128614.7,1241.421,101.6842
"13818","41075","2018",11,11,0,68227.27,845,86.27273
"13819","41077","2018",1,1,0,117500,1992,59
"13820","41078","2018",9,9,0,81757.56,980,83.44444
"13821","41080","2018",8,8,0,107848,1208,86.375
"13822","41081","2018",3,3,0,121833.3,1272.667,94.66667
"13823","41083","2018",12,12,0,122641.7,1105.25,107.6667
"13824","41084","2018",19,19,0,87896.84,994.6316,87.94737
"13825","41085","2018",11,11,0,199295.5,1431.364,125.9091
"13826","41086","2018",4,4,0,131300,1279.75,101.25
"13827","41087","2018",7,7,0,100610,1251.714,83.57143
"13828","41088","2018",5,5,0,134200,1367,112.8
"13829","41089","2018",3,3,0,56000,909,61.66667
"13830","41090","2018",2,2,0,120240,1090,111.5
"13831","41091","2018",10,10,0,162550,1562.6,106.6
"13832","41093","2018",2,2,0,99000,1118,95.5
"13833","41094","2018",8,8,0,117637.5,1430.5,97.875
"13834","41095","2018",13,13,0,67853.85,1017.154,64.30769
"13835","41096","2018",5,5,0,105758,965.2,120
"13836","41097","2018",24,24,0,85036.67,1076.917,77.5
"13837","41099","2018",6,6,0,157721.2,1276.833,115.1667
"13838","41100","2018",4,4,0,130500,884.75,143.25
"13839","41101","2018",11,11,0,127190.9,1362.455,92.09091
"13840","41102","2018",2,2,0,117000,1418,84.5
"13841","41103","2018",3,3,0,157600,1232,142
"13842","41104","2018",30,29,1,154960,1670.2,98.23333
"13843","41105","2018",11,11,0,122090.9,1124.727,117.0909
"13844","41106","2018",39,37,2,140678.2,1651.385,91.23077
"13845","41107","2018",6,6,0,157000,1714,95.16667
"13846","41109","2018",6,6,0,153196.8,1365.167,118.6667
"13847","41110","2018",5,5,0,109000,1042.4,104.8
"13848","41112","2018",5,5,0,119280,1048.8,109.8
"13849","41113","2018",4,4,0,300550,1438.5,190.5
"13850","41114","2018",3,3,0,240800,1583.667,161.6667
"13851","41115","2018",10,10,0,102548,864.6,116.4
"13852","41116","2018",3,3,0,105233.3,747.3333,132.6667
"13853","41118","2018",2,2,0,146500,737,206
"13854","41119","2018",2,2,0,90500,920,100.5
"13855","41120","2018",16,15,1,98025,1179.812,83.75
"13856","41121","2018",1,1,0,160000,982,163
"13857","41122","2018",3,3,0,63333.33,635,101.3333
"13858","41123","2018",14,13,1,75938.57,934.5,82.71429
"13859","41124","2018",4,4,0,166250,1223,133.25
"13860","41125","2018",18,17,1,78655.56,900.4444,87.88889
"13861","41126","2018",12,12,0,96825.33,1099.917,88.16667
"13862","41127","2018",8,8,0,105412.5,1811.375,63.5
"13863","41128","2018",6,6,0,108366.7,1792.333,68.66667
"13864","41129","2018",10,10,0,163160,1493.7,114.7
"13865","41130","2018",12,12,0,133380.8,1037.833,129.0833
"13866","41131","2018",7,7,0,124428.6,1164.571,103
"13867","41132","2018",4,4,0,196842.5,2230.5,87
"13868","41134","2018",10,9,1,168375,1401.9,117.8
"13869","41135","2018",18,17,1,70302.78,869.0556,79
"13870","41136","2018",60,55,5,116971.8,1379.583,85.58333
"13871","41137","2018",8,8,0,122518.8,1087.25,134
"13872","41138","2018",5,5,0,152400,1354.4,126
"13873","41139","2018",14,14,0,97321.43,1064.357,92.14286
"13874","41140","2018",4,4,0,220437.5,2039,110.5
"13875","41141","2018",4,4,0,56612.5,790.75,75.25
"13876","41142","2018",38,38,0,174978.2,1379.763,125.1316
"13877","41143","2018",25,22,3,63564,858.92,74.44
"13878","41144","2018",9,9,0,122007.8,1239.889,98.22222
"13879","41145","2018",9,9,0,105666.7,1380.444,82
"13880","41146","2018",4,4,0,120181.2,1569.75,95.25
"13881","41147","2018",19,19,0,163600,1491.421,114
"13882","41148","2018",20,20,0,164287.8,1659.2,100.35
"13883","41149","2018",50,50,0,101792.3,1152.08,91.9
"13884","41150","2018",34,34,0,146901.8,1441.706,100.8235
"13885","41151","2018",49,43,6,110932,1299.02,83.81633
"13886","41152","2018",11,11,0,123740,1339,99.81818
"13887","41154","2018",8,7,1,99364.12,824.125,117.5
"13888","41155","2018",11,11,0,146429.7,1577.455,99.09091
"13889","41156","2018",7,7,0,153085.7,1614.571,96.28571
"13890","41157","2018",13,13,0,107883.1,1306.154,83.15385
"13891","41158","2018",18,17,1,134370,1566.056,93.88889
"13892","41159","2018",19,19,0,145691.6,1416.474,96.63158
"13893","41160","2018",6,6,0,101666.7,1031.833,90.83333
"13894","41161","2018",30,30,0,132680,1438.667,95.7
"13895","41163","2018",2,2,0,93500,995,96
"13896","41167","2018",34,34,0,137364.3,1294.324,103.4118
"13897","41168","2018",3,3,0,89500,1052.333,85.33333
"13898","41171","2018",18,18,0,111273.9,1164.222,89.94444
"13899","41172","2018",2,2,0,62225,801.5,76
"13900","41173","2018",49,49,0,121506.9,1090.347,112.898
"13901","41174","2018",1,1,0,55000,724,76
"13902","41175","2018",19,19,0,94705.26,1091.053,89.42105
"13903","41176","2018",12,12,0,171145.8,1395.667,116
"13904","41177","2018",3,3,0,129518.3,1392.333,96.66667
"13905","41179","2018",1,1,0,66500,1147,58
"13906","41180","2018",2,2,0,214625,1483,128
"13907","41181","2018",10,10,0,135065,1291.2,97.4
"13908","41182","2018",2,2,0,97500,1153.5,87
"13909","41184","2018",3,3,0,136333.3,1051.667,149.6667
"13910","41185","2018",23,23,0,149634.8,1414.957,106.1739
"13911","41187","2018",1,1,0,140000,828,169
"13912","41189","2018",2,2,0,120750,1031,110.5
"13913","41190","2018",2,2,0,89000,1297.5,69
"13914","41192","2018",3,3,0,51300,731.6667,69
"13915","41193","2018",2,2,0,68750,830,82.5
"13916","41194","2018",231,217,14,114917.8,1258.134,91.95671
"13917","41196","2018",2,2,0,106000,1243,88.5
"13918","41198","2018",53,52,1,105934.9,1152.302,91.15094
"13919","41199","2018",14,14,0,163521.4,1501.643,114
"13920","41200","2018",1,1,0,251600,1666,151
"13921","41201","2018",1,1,0,90000,1111,81
"13922","41203","2018",8,8,0,143175,1457.125,100.125
"13923","41204","2018",17,17,0,155717.9,1427.412,107.7059
"13924","41205","2018",1,1,0,199685,2219,90
"13925","41206","2018",10,10,0,187860,1489.5,129.9
"13926","41207","2018",14,14,0,173675,1715.214,106.2143
"13927","41209","2018",9,9,0,123438.9,1139.111,110.1111
"13928","41211","2018",39,39,0,134478.8,1497.692,95.33333
"13929","41212","2018",43,39,4,164092.8,1931.512,90.7907
"13930","41213","2018",3,3,0,108500,1040,119.3333
"13931","41214","2018",7,7,0,86171.43,858.1429,95
"13932","41215","2018",1,1,0,102000,850,120
"13933","41216","2018",2,2,0,45000,792,54.5
"13934","41217","2018",9,9,0,143133.3,1365.667,106.6667
"13935","41218","2018",13,13,0,94333.08,979.8462,96.69231
"13936","41219","2018",3,3,0,122083.3,1208,95
"13937","41220","2018",56,55,1,135984.6,1448.554,98.44643
"13938","41221","2018",14,14,0,100642.9,1089.786,95
"13939","41222","2018",3,3,0,76333.33,1167.667,66.33333
"13940","41223","2018",6,6,0,137638.3,1508,96.33333
"13941","41224","2018",2,2,0,90000,949,97
"13942","41225","2018",7,7,0,79428.57,831.7143,92.28571
"13943","41226","2018",35,34,1,146585.7,1413.2,105.4286
"13944","41228","2018",3,3,0,115416.7,986.3333,120.3333
"13945","41229","2018",8,8,0,166365,1587.25,105.625
"13946","41230","2018",10,10,0,162610,1565.2,104.4
"13947","41231","2018",13,13,0,163176.9,1456.462,102.3077
"13948","41232","2018",52,46,6,92240,1097.596,85.32692
"13949","41233","2018",8,8,0,129375,1334.25,96.5
"13950","41234","2018",5,5,0,115840,1304,96
"13951","41235","2018",8,7,1,140125,1858.25,91.875
"13952","41236","2018",2,2,0,177500,1147,145
"13953","41237","2018",10,10,0,138160.8,1355.1,104.5
"13954","41238","2018",12,12,0,103666.7,1035,99.91667
"13955","41239","2018",15,15,0,95646.67,961.2,95.93333
"13956","41241","2018",12,12,0,110514.2,1176.167,93.08333
"13957","41242","2018",50,50,0,88948.32,1002.18,93.42
"13958","41243","2018",8,7,1,147926.2,1075.625,134.125
"13959","41245","2018",3,3,0,143333.3,1134,146.3333
"13960","41246","2018",3,3,0,175800,2051,86
"13961","41247","2018",16,16,0,124500.9,1165.375,107.8125
"13962","41248","2018",17,17,0,88171.71,904.5294,98.76471
"13963","41249","2018",23,23,0,128580.4,1237.652,95.52174
"13964","41250","2018",11,11,0,75454.55,954.2727,78.36364
"13965","41251","2018",7,7,0,123857.1,1373.143,90.42857
"13966","41252","2018",13,13,0,125777.2,1141.692,118.7692
"13967","41253","2018",2,2,0,157500,2062,96.5
"13968","41254","2018",1,1,0,132000,1200,110
"13969","41255","2018",2,2,0,111000,982,114
"13970","41256","2018",18,18,0,117889.6,1156.556,99.11111
"13971","41258","2018",13,13,0,84846.15,991.7692,90.46154
"13972","41259","2018",8,8,0,132875,1209.625,108.125
"13973","41260","2018",3,3,0,215000,1775.333,120.3333
"13974","41261","2018",2,2,0,135480.5,944,144.5
"13975","41262","2018",17,17,0,131910.3,1321.706,100.0588
"13976","41265","2018",6,6,0,149166.7,1170.667,118.3333
"13977","41266","2018",2,2,0,147450,1156.5,128
"13978","41267","2018",6,6,0,117333.3,1506.5,80
"13979","41268","2018",1,1,0,92000,1095,84
"13980","41269","2018",196,131,65,133151.6,1552.316,87.15816
"13981","41271","2018",4,4,0,110237.5,1303.25,87.25
"13982","41273","2018",5,5,0,77500,895.8,81.8
"13983","41274","2018",5,5,0,75240,1048.6,60.8
"13984","41275","2018",14,14,0,114857.1,926.7857,131.6429
"13985","41276","2018",28,20,8,136890.4,1548.25,90.57143
"13986","41277","2018",3,3,0,95250,926,101
"13987","41278","2018",7,7,0,105535.7,1042.429,116.7143
"13988","41279","2018",6,6,0,127469.3,1135,110.3333
"13989","41280","2018",36,36,0,100482.9,1235.611,91.66667
"13990","41281","2018",7,7,0,144974.3,1323.429,106.8571
"13991","41283","2018",2,2,0,199675,1523.5,131.5
"13992","41284","2018",1,1,0,47000,534,88
"13993","41285","2018",5,5,0,130144,1460.8,97
"13994","41286","2018",4,4,0,100850,787.5,140
"13995","41287","2018",4,4,0,124875,1341,91.5
"13996","41288","2018",10,10,0,109230,1234.8,90.1
"13997","41289","2018",9,9,0,164716.7,1526.333,123
"13998","41291","2018",2,2,0,175750,1392.5,127.5
"13999","41292","2018",4,4,0,108125,1049.75,106.5
"14000","41293","2018",1,1,0,44138,669,66
"14001","41294","2018",14,14,0,127131.4,1145.929,108.5714
"14002","41295","2018",81,72,9,178390.7,1871.741,96.2963
"14003","41296","2018",19,19,0,131736.3,1367.684,111.8947
"14004","41297","2018",6,6,0,124166.7,1302.5,100.6667
"14005","42001","2018",2,2,0,141250,1294.5,100.5
"14006","42003","2018",23,21,2,161177.6,1742.783,114.6087
"14007","42005","2018",97,50,47,144928.2,1705.66,85.50515
"14008","42006","2018",4,4,0,167375,1709.25,95
"14009","42007","2018",6,6,0,161233.3,1317.833,126.6667
"14010","42008","2018",5,5,0,79364.6,1266.4,70.8
"14011","42009","2018",3,3,0,163216.7,1979.333,85
"14012","42010","2018",19,17,2,169520.8,1881.158,92.94737
"14013","42011","2018",12,11,1,141307.1,1302.333,112.25
"14014","42012","2018",8,8,0,169072.5,1596.625,109.625
"14015","42013","2018",14,14,0,159122.1,1707.929,92.42857
"14016","42014","2018",6,6,0,64725,939,78.16667
"14017","42015","2018",14,14,0,116375,1058.5,110.6429
"14018","42016","2018",6,6,0,152122.8,1264.5,110.3333
"14019","42017","2018",9,7,2,117911.1,1819.222,69.22222
"14020","42018","2018",5,5,0,206883.6,2033.8,101.2
"14021","42019","2018",34,30,4,99584.41,1170.5,84.47059
"14022","42020","2018",15,15,0,179413.7,1795.533,103.4667
"14023","42021","2018",16,16,0,191935.6,1592.312,118.25
"14024","42022","2018",41,39,2,174191.9,1931.585,92.02439
"14025","42023","2018",26,18,8,122590.8,1170.885,104.1923
"14026","42026","2018",11,11,0,164286.4,1691.455,107
"14027","42027","2018",2,2,0,128425,1858.5,80
"14028","42028","2018",1,1,0,195000,1773,110
"14029","42029","2018",24,24,0,124589.1,1231.75,103.5833
"14030","42030","2018",4,4,0,143312.5,1315.75,111.25
"14031","42031","2018",1,1,0,50000,943,53
"14032","42032","2018",10,10,0,241330,2370.1,102.5
"14033","42033","2018",5,5,0,220780,1207,174
"14034","42035","2018",7,7,0,109383.6,1125.571,94
"14035","42036","2018",5,5,0,201070,1913.2,98.6
"14036","42037","2018",6,6,0,204716.7,1501.333,140
"14037","42038","2018",5,5,0,116120,1364.8,87.4
"14038","42039","2018",7,7,0,115688.6,1056.714,118
"14039","42040","2018",2,2,0,53750,1172,47
"14040","42041","2018",7,7,0,142834,1531.286,93.42857
"14041","42042","2018",12,12,0,162095.8,1612.917,106.75
"14042","42043","2018",23,23,0,231853.7,2272.391,103
"14043","42044","2018",59,34,25,128331.4,1422.254,85.76271
"14044","42045","2018",1,1,0,68000,442,154
"14045","42046","2018",17,15,2,136159.4,1498.118,90.76471
"14046","42047","2018",3,3,0,108766.7,1378,77.33333
"14047","42048","2018",18,17,1,171245.6,1547.722,123.6111
"14048","42049","2018",9,9,0,95233.33,911.8889,100.4444
"14049","42050","2018",1,1,0,190000,1407,135
"14050","42051","2018",5,5,0,284130,2567.4,114.6
"14051","42052","2018",36,19,17,112703.3,1204.278,94.61111
"14052","42053","2018",14,14,0,185716.4,2158.286,86.71429
"14053","42055","2018",2,2,0,264850,1989,133.5
"14054","42056","2018",39,38,1,167548.3,1761.41,99.48718
"14055","42058","2018",1,1,0,150000,1500,100
"14056","42059","2018",52,44,8,136827,1645.404,84.82692
"14057","42060","2018",8,8,0,134104.4,1504.5,90.5
"14058","42061","2018",9,9,0,85777.78,944.3333,90.33333
"14059","42062","2018",8,8,0,147693.8,1548.625,102.75
"14060","42063","2018",8,7,1,74900,730.5,98.25
"14061","42064","2018",5,5,0,153436,2094.4,80.4
"14062","42065","2018",11,11,0,165513.6,1541.818,108.7273
"14063","42066","2018",6,6,0,184350,1538.833,117
"14064","42067","2018",6,6,0,118335,1473.167,86.33333
"14065","42068","2018",5,5,0,166944.2,1434.2,120.4
"14066","42069","2018",34,34,0,171615,1629,106.7941
"14067","42070","2018",9,9,0,145977.8,1194,124.3333
"14068","42071","2018",89,39,50,116494.4,1229.337,92.58427
"14069","42073","2018",12,12,0,159654.2,1530.167,104.5833
"14070","42074","2018",8,8,0,157512.5,1484.75,104.625
"14071","42075","2018",18,18,0,219159.7,2094.111,107.7222
"14072","42076","2018",9,9,0,126808.9,982.7778,124.7778
"14073","42077","2018",1,1,0,171600,766,224
"14074","42078","2018",3,3,0,103900,824.6667,125
"14075","42079","2018",9,9,0,121624.8,1044.444,121.6667
"14076","42081","2018",16,14,2,188088.8,1904.75,99.5
"14077","42083","2018",9,9,0,265996.7,2386.889,114
"14078","42084","2018",1,1,0,226800,1366,166
"14079","42085","2018",9,9,0,169035,1897.333,89.66667
"14080","42086","2018",6,6,0,78549.33,928,85.83333
"14081","42087","2018",14,14,0,221204.3,1958,114.4286
"14082","42088","2018",4,4,0,202700,1770.25,121.5
"14083","42089","2018",5,5,0,209965,1871.4,111.8
"14084","42090","2018",6,6,0,115233.3,1119,106.3333
"14085","42091","2018",12,12,0,148985,1422,104.3333
"14086","42092","2018",26,17,9,251048.1,2160.423,112.6923
"14087","42093","2018",11,11,0,244190.9,2241.727,110.6364
"14088","42094","2018",103,65,38,147671.4,1615.301,91.5534
"14089","42095","2018",154,58,96,107484,1202.695,87.87013
"14090","42096","2018",7,6,1,164328.6,1870.714,93.85714
"14091","42097","2018",62,45,17,219853.3,1993.226,109.6774
"14092","42098","2018",8,8,0,149181.2,1305.625,122.375
"14093","42099","2018",39,19,20,124368.6,1417.564,85.71795
"14094","42100","2018",2,2,0,240775,1874,129.5
"14095","42101","2018",3,3,0,159333.3,1300,120.6667
"14096","42102","2018",8,7,1,106881.2,1331.875,78.75
"14097","42103","2018",30,16,14,167671.3,1834.7,91.1
"14098","42104","2018",11,11,0,112053.6,1066.545,102.6364
"14099","42105","2018",2,2,0,181500,1554,110.5
"14100","42106","2018",2,2,0,55000,453.5,119
"14101","42107","2018",6,6,0,157483.3,1396.5,125.6667
"14102","42108","2018",6,6,0,214905,1832,111.5
"14103","42109","2018",4,4,0,51725,736.25,73.75
"14104","42110","2018",35,25,10,200162.3,2084.371,101.2286
"14105","42112","2018",3,3,0,86000,973.3333,87.33333
"14106","42113","2018",3,3,0,180233.3,1397.333,131.3333
"14107","42115","2018",14,12,2,169277.9,1283.786,135.6429
"14108","42116","2018",3,3,0,105800,1080.667,99.33333
"14109","42118","2018",7,7,0,165214.3,1531.714,121
"14110","42119","2018",2,2,0,86000,1003,85.5
"14111","42120","2018",14,14,0,166970,1380.714,128.8571
"14112","42121","2018",1,1,0,63000,525,120
"14113","42122","2018",15,15,0,218971,1866.867,116.9333
"14114","42123","2018",42,21,21,140216.4,1662.881,82.38095
"14115","42124","2018",2,2,0,163000,2053.5,80
"14116","42126","2018",12,12,0,177000,1506.083,124
"14117","42127","2018",71,68,3,135027.5,1508.761,90.33803
"14118","42128","2018",5,5,0,103372,1156,87.6
"14119","42129","2018",11,11,0,185741.8,1976,92.72727
"14120","42130","2018",5,5,0,113650,1237,89.6
"14121","42131","2018",2,2,0,111000,1351.5,81.5
"14122","42132","2018",4,4,0,162515,1785.25,98
"14123","42133","2018",7,7,0,147471.4,1525.571,95.71429
"14124","42134","2018",12,9,3,123553.8,1170,115.0833
"14125","42135","2018",5,5,0,177500,1731.6,101.8
"14126","42136","2018",5,5,0,103792,1157.4,90.6
"14127","42137","2018",5,5,0,150750,1380,100.2
"14128","42138","2018",2,2,0,179000,1580.5,112.5
"14129","42139","2018",14,13,1,159246.4,1417,108.7857
"14130","42140","2018",9,9,0,148651.1,1724,86.44444
"14131","42141","2018",7,7,0,168584.3,1289.143,155
"14132","42142","2018",4,4,0,104250,1076.75,94
"14133","42143","2018",3,3,0,195000,1553,128
"14134","42145","2018",10,8,2,111390,1016.4,108.8
"14135","42146","2018",2,1,1,225750,2802.5,119
"14136","42147","2018",218,117,101,138777,1598.872,87.50917
"14137","42148","2018",8,8,0,126753.1,1321.25,108.25
"14138","42149","2018",70,40,30,157798.4,1882.643,83.61429
"14139","42150","2018",16,16,0,148103.1,1266.875,122.9375
"14140","42151","2018",3,3,0,145676.7,1845.667,83.66667
"14141","42152","2018",3,3,0,113666.7,1136.333,104
"14142","42153","2018",4,4,0,110750,956.5,114.25
"14143","42154","2018",6,6,0,159666.7,1392.333,115.6667
"14144","42155","2018",15,15,0,120603.3,1175.067,101.2667
"14145","42156","2018",11,9,2,97559.09,1016.182,96.09091
"14146","42157","2018",8,8,0,127150,1262.125,96.25
"14147","42158","2018",3,3,0,92933.33,723.6667,136.6667
"14148","42159","2018",12,11,1,92420.83,888.5,104.25
"14149","42161","2018",6,6,0,143000,1233.5,114.6667
"14150","42162","2018",13,13,0,181357.7,1649,113.3077
"14151","42163","2018",13,13,0,117057.7,1167.154,99.53846
"14152","42165","2018",30,28,2,125812.7,1072.967,117.3667
"14153","42166","2018",9,9,0,162230,1501.889,106.3333
"14154","42167","2018",3,3,0,173883.3,1446.333,120.6667
"14155","42168","2018",49,40,9,166598.6,1738.694,94.81633
"14156","42169","2018",10,10,0,166785,1669.1,102.4
"14157","42170","2018",19,18,1,146631.6,1341.737,115.5789
"14158","42171","2018",3,3,0,158400,1352,121
"14159","42172","2018",13,12,1,197168,1613.231,119.1538
"14160","42173","2018",3,3,0,105833.3,971.6667,145
"14161","42174","2018",9,9,0,163816.7,1503.222,111.8889
"14162","42175","2018",15,15,0,135880.3,1237.133,109.9333
"14163","42176","2018",25,24,1,177476,1654.6,103.68
"14164","42177","2018",27,27,0,118289.1,1237.926,99.74074
"14165","42178","2018",1,1,0,50000,658,76
"14166","42179","2018",5,5,0,152800,1637.8,91.8
"14167","42180","2018",7,7,0,192112.9,1609,124.5714
"14168","42181","2018",9,8,1,78845.33,958.7778,81.77778
"14169","42182","2018",41,36,5,176645.6,1522,112.8049
"14170","42183","2018",42,19,23,96753.57,1032.976,90.45238
"14171","42184","2018",166,109,57,124314.5,1401.398,86.43373
"14172","42185","2018",9,8,1,261111.1,2166,126.8889
"14173","42186","2018",115,71,44,151880.7,1690.2,89.46087
"14174","42187","2018",530,119,411,88705.07,1100.509,78.33208
"14175","42188","2018",3,3,0,69933.33,1738,64.33333
"14176","42189","2018",97,48,49,148955.4,1800.948,83.03093
"14177","42191","2018",8,7,1,187036.9,1677.125,110.5
"14178","42192","2018",11,11,0,112095.4,1309.909,84.54545
"14179","42193","2018",12,11,1,129870.8,1468.417,94.41667
"14180","42194","2018",2,2,0,124700,1081,117.5
"14181","42195","2018",8,8,0,114625,1273.25,86.125
"14182","42197","2018",14,14,0,154334.8,1877.357,92.35714
"14183","42198","2018",6,5,1,108241.7,928.6667,117.3333
"14184","42199","2018",17,17,0,171853.5,1515.824,111.4118
"14185","42200","2018",17,17,0,197683.7,1928.765,105.0588
"14186","42201","2018",12,12,0,156190.8,1786.583,90.58333
"14187","42202","2018",8,8,0,128625,1120.875,111.5
"14188","42203","2018",4,4,0,100986.2,770,149.5
"14189","42204","2018",10,8,2,126145,1385.3,89
"14190","42205","2018",6,6,0,85050,779.5,109.5
"14191","42206","2018",17,17,0,274657.4,2073.294,143.9412
"14192","42207","2018",313,113,200,132388.5,1508.661,86.79872
"14193","42208","2018",16,11,5,203484.7,2115.5,97.6875
"14194","42209","2018",5,4,1,95600,1767.2,63.8
"14195","42210","2018",1,1,0,2e+05,1111,180
"14196","42211","2018",19,16,3,205818.2,2035.421,102.8947
"14197","42212","2018",14,13,1,139132.1,1331.214,111.2143
"14198","42213","2018",5,5,0,117074,918.8,134.2
"14199","42214","2018",12,12,0,175949.2,1641.583,112.5833
"14200","42215","2018",6,6,0,99291.67,1055.833,98.66667
"14201","42216","2018",5,5,0,201459.2,1991,104.4
"14202","42217","2018",8,8,0,64315.75,794.375,87.625
"14203","42218","2018",2428,265,2163,84823.59,1134.768,73.03213
"14204","42219","2018",8,8,0,214986.2,1726.875,123.125
"14205","42220","2018",8,8,0,134251.4,1393.875,96.625
"14206","42221","2018",2,2,0,225500,1690.5,133.5
"14207","42222","2018",68,56,12,211876.5,1963.235,105.3529
"14208","42223","2018",62,32,30,197211.7,2159.097,94
"14209","42224","2018",33,21,12,147570.6,1489.879,96.48485
"14210","42225","2018",30,27,3,187592.7,1977.733,101.7
"14211","42226","2018",5,5,0,131860,1210.6,118.6
"14212","42227","2018",3,3,0,140166.7,1309,117.6667
"14213","42228","2018",19,19,0,186218.4,1738.895,113.3158
"14214","42229","2018",2,2,0,99900,796,105
"14215","42230","2018",13,13,0,105052.3,1166.769,89.53846
"14216","42231","2018",14,14,0,147605,1470.429,98
"14217","42232","2018",6,6,0,104550,1114.167,95.33333
"14218","42233","2018",10,10,0,158367,1563.6,108.6
"14219","42234","2018",36,27,9,218491.8,1935.028,114.3889
"14220","42235","2018",10,10,0,114920,1040.2,112.6
"14221","42236","2018",2,2,0,162500,1663,98
"14222","42237","2018",53,37,16,169933.2,1852.264,89.62264
"14223","42238","2018",1,1,0,130000,1354,96
"14224","42239","2018",12,11,1,150290.8,1583.667,97.41667
"14225","42240","2018",4,4,0,187022.5,1078.5,167.75
"14226","42241","2018",1,1,0,83300,1515,55
"14227","42242","2018",13,12,1,210415.4,2258.077,96.15385
"14228","42243","2018",3,3,0,119000,908.6667,140
"14229","42245","2018",9,9,0,85346.67,885.1111,104.1111
"14230","42246","2018",10,9,1,102767.2,1263.9,97.8
"14231","42247","2018",1,1,0,48000,400,120
"14232","42248","2018",6,6,0,133645,1139.333,114.5
"14233","42249","2018",18,16,2,81265.56,949,86.11111
"14234","42251","2018",6,6,0,277705.8,2121.333,129.3333
"14235","42252","2018",8,8,0,112921.2,1082.375,112.25
"14236","42253","2018",12,12,0,149375,1551.5,105.5833
"14237","42254","2018",4,4,0,152375,1277,120.25
"14238","42255","2018",3,3,0,59666.67,834.3333,70
"14239","42256","2018",78,71,7,183087.4,2017.513,98.64103
"14240","42257","2018",19,18,1,94947.37,890.6316,102.8947
"14241","42259","2018",37,34,3,205406.9,2052.568,100.4595
"14242","42260","2018",9,9,0,118634.4,1113.889,107.7778
"14243","42261","2018",10,9,1,188102,1944.8,101.1
"14244","42262","2018",22,22,0,138015.9,1371.864,103.2727
"14245","42264","2018",12,12,0,174522.8,1605.333,107.4167
"14246","42265","2018",7,6,1,225250.7,2491.714,89.28571
"14247","42266","2018",6,6,0,102666.7,976.6667,103.8333
"14248","42267","2018",12,12,0,201029.2,1325.667,142.5
"14249","42268","2018",11,11,0,95579.09,964.8182,99.36364
"14250","42269","2018",2,2,0,140500,1904.5,76.5
"14251","42270","2018",19,16,3,198644.7,1952.737,100.7368
"14252","42271","2018",35,25,10,188928.6,1903.743,100.3143
"14253","42272","2018",20,14,6,124938,1582.6,85.05
"14254","42273","2018",2,2,0,151450,1513.5,101.5
"14255","42274","2018",3,3,0,106466.7,1188,78.66667
"14256","42275","2018",113,38,75,169378.8,1966.469,84.77876
"14257","42276","2018",8,8,0,68422.5,1015.25,84.375
"14258","42277","2018",4,4,0,131095,1068,120.5
"14259","42278","2018",3,3,0,111666.7,1544.333,70.66667
"14260","42279","2018",175,121,54,196552.8,2193.171,92.84571
"14261","42280","2018",3,3,0,213200,1911,117.3333
"14262","42282","2018",2,2,0,91250,790,116
"14263","42283","2018",8,8,0,216362.5,1969,111.25
"14264","42284","2018",13,13,0,168696.2,1575.154,111.5385
"14265","42285","2018",43,36,7,172520.8,1874.884,95.81395
"14266","42286","2018",8,8,0,175191,1542.5,118.125
"14267","42287","2018",8,8,0,107178.8,1217.375,95.625
"14268","42288","2018",9,9,0,140616.7,1214.778,117.3333
"14269","42289","2018",13,12,1,122360,1152.231,111
"14270","42290","2018",6,6,0,161675,1839.667,89.83333
"14271","42293","2018",8,8,0,141666.2,1373.875,106.5
"14272","42294","2018",12,12,0,241475,1623.583,152.0833
"14273","42295","2018",5,5,0,131500,1250.4,104.4
"14274","42296","2018",5,5,0,267780,1900.2,159.6
"14275","42297","2018",3,3,0,238666.7,2011.667,122.3333
"14276","42298","2018",3,3,0,73300,636.6667,116.6667
"14277","42299","2018",42,29,13,168231.8,1841.071,92.66667
"14278","42300","2018",6,6,0,139800,1276,111.8333
"14279","42301","2018",10,10,0,149865,1401.3,112.3
"14280","42302","2018",74,51,23,213438.3,2254.973,94.89189
"14281","42303","2018",2,2,0,92000,909.5,105
"14282","42304","2018",78,72,6,154913.7,1743.295,93.87179
"14283","42305","2018",71,27,44,189154.6,2453.915,79.1831
"14284","42306","2018",9,9,0,139961.1,1864.556,75.88889
"14285","42307","2018",13,13,0,183073.8,2119.231,88.23077
"14286","42308","2018",8,6,2,195548.1,1760.125,115.25
"14287","42310","2018",3,3,0,163000,1252.667,117.3333
"14288","42311","2018",11,10,1,278455.5,2174.818,125.3636
"14289","42312","2018",5,5,0,186070,1869.6,114.4
"14290","42313","2018",4,4,0,144500,1280.25,116.25
"14291","42314","2018",4,4,0,89401.25,657,130.25
"14292","42315","2018",3,3,0,162333.3,1666.333,93.66667
"14293","42316","2018",85,60,25,150110.1,1579.812,92.02353
"14294","42317","2018",2,2,0,93000,926,102.5
"14295","42318","2018",13,13,0,124443.8,1172.308,101.9231
"14296","42319","2018",7,7,0,200692.9,1889.857,123.2857
"14297","42320","2018",7,7,0,112742.9,1303.571,90.42857
"14298","42322","2018",11,10,1,189847.2,1778.727,115.1818
"14299","42323","2018",95,72,23,183494.3,2076.726,89.89474
"14300","42324","2018",12,12,0,176333.3,1733.083,104.9167
"14301","42325","2018",3,3,0,206116.7,1795.667,114.3333
"14302","42326","2018",10,10,0,197968,1675.4,120
"14303","42327","2018",13,9,4,161976.9,1924.231,84.69231
"14304","42328","2018",11,11,0,127627.3,1218.545,96.90909
"14305","42329","2018",2,2,0,319000,2737.5,100
"14306","42330","2018",109,43,66,141026,1526.284,88.36697
"14307","42331","2018",6,6,0,117416.7,1322,102.1667
"14308","42332","2018",39,37,2,182283.8,1587.59,119.5641
"14309","42333","2018",5,5,0,116400,1104.8,112.6
"14310","42334","2018",9,8,1,144127.8,1469.556,94.66667
"14311","42335","2018",3,2,1,146933.3,1388.333,101.6667
"14312","42336","2018",5,5,0,146845,1856.4,74
"14313","42337","2018",6,6,0,96416.67,1204.833,81.83333
"14314","42338","2018",11,10,1,159463.6,1547,108
"14315","42339","2018",1,1,0,99200,992,100
"14316","43001","2018",2,2,0,78250,876,88
"14317","43002","2018",19,10,9,132207.3,1428.947,93.21053
"14318","43003","2018",6,6,0,47166.67,761.1667,67.33333
"14319","43004","2018",2,2,0,65050,1212.5,53.5
"14320","43005","2018",4,4,0,152251.2,1490.75,126.5
"14321","43007","2018",10,10,0,129355,1208.4,113.6
"14322","43008","2018",3,3,0,89046.67,763.3333,116.6667
"14323","43009","2018",1,1,0,30000,429,70
"14324","43010","2018",7,7,0,130964.3,1434.286,93.71429
"14325","43011","2018",3,3,0,71500,763.3333,97.33333
"14326","43012","2018",66,49,17,152025.4,1689.742,89.43939
"14327","43013","2018",4,4,0,49800,575.5,84.5
"14328","43014","2018",1,1,0,92000,1314,70
"14329","43016","2018",10,10,0,69490,977.5,82.6
"14330","43017","2018",2,2,0,94500,1050,85
"14331","43018","2018",8,7,1,153356.2,1311.125,119.25
"14332","43019","2018",2,2,0,57500,545,105
"14333","43020","2018",44,42,2,132712.5,1625.273,80.27273
"14334","43021","2018",4,3,1,119025,1115.5,94.75
"14335","43022","2018",4,4,0,93325,721.5,120
"14336","43023","2018",4,4,0,129425,1473,87.25
"14337","43024","2018",4,4,0,100475,923.5,104.75
"14338","43025","2018",42,41,1,121979.5,1295.5,97.14286
"14339","43026","2018",5,4,1,92760,788.8,112.2
"14340","43028","2018",2,2,0,69446,781,89
"14341","43030","2018",2,2,0,160710,1469,108.5
"14342","43031","2018",2,2,0,56500,540,108.5
"14343","43032","2018",7,7,0,135293,1372,102.4286
"14344","43033","2018",2,2,0,67500,612,134.5
"14345","43034","2018",3,3,0,99160,921.3333,107
"14346","43035","2018",1,1,0,35000,583,60
"14347","43036","2018",1,0,1,55000,573,96
"14348","43037","2018",3,3,0,82883.33,916.3333,86.33333
"14349","43038","2018",6,5,1,81866.67,844.8333,94.33333
"14350","43039","2018",9,9,0,115673.3,1117,91.11111
"14351","43040","2018",76,55,21,103540.9,1145.711,89.38158
"14352","43041","2018",41,26,15,146280.5,1649.659,92.70732
"14353","43042","2018",11,11,0,112531.8,1183.727,94.54545
"14354","43043","2018",1,1,0,149325,1244,120
"14355","43044","2018",4,4,0,54250,709.25,76
"14356","43045","2018",3,3,0,182000,1671,107.6667
"14357","43046","2018",26,21,5,144207.2,1534.692,98.03846
"14358","43047","2018",2,2,0,113500,1133,99
"14359","43048","2018",7,7,0,70184.29,766.2857,110.5714
"14360","43049","2018",9,8,1,79983.44,1193.444,65.11111
"14361","43050","2018",1,1,0,24315,838,29
"14362","43051","2018",47,31,16,127898.6,1369.043,97.25532
"14363","43052","2018",1,1,0,55000,423,130
"14364","43053","2018",4,4,0,101423.8,1374.25,78
"14365","43054","2018",1,1,0,187500,1150,163
"14366","43056","2018",5,5,0,94120,856.8,109.6
"14367","43057","2018",3,3,0,66133.33,634,99.33333
"14368","43058","2018",1,1,0,260000,2261,115
"14369","43060","2018",2,2,0,231890,966.5,240
"14370","43061","2018",8,8,0,169367.5,1573.75,108.25
"14371","43062","2018",7,6,1,148942.9,1391.571,113.5714
"14372","43064","2018",1,1,0,60000,896,67
"14373","43065","2018",3,3,0,88000,851.6667,95
"14374","43066","2018",3,3,0,121083.3,1069.333,104.3333
"14375","43067","2018",3,3,0,84733.33,850.6667,113.3333
"14376","43068","2018",1,1,0,55000,430,128
"14377","43069","2018",4,4,0,137875,1358,99.5
"14378","43071","2018",11,11,0,72121.82,694,103
"14379","43072","2018",1,1,0,76000,469,162
"14380","43073","2018",3,3,0,49000,558,96
"14381","43074","2018",5,5,0,100820,864.2,115.2
"14382","43075","2018",1,1,0,194000,1540,126
"14383","43076","2018",2,2,0,84500,579,152.5
"14384","43077","2018",2,2,0,112000,1268.5,87
"14385","43078","2018",25,25,0,173643.6,1610,111.68
"14386","43080","2018",20,18,2,81060,877.3,90.35
"14387","43082","2018",1,1,0,108000,2204,49
"14388","43084","2018",11,11,0,160792.3,1579.364,104
"14389","43086","2018",1,1,0,60000,1200,50
"14390","43087","2018",15,13,2,104466.7,1095.733,106.4667
"14391","43088","2018",1,1,0,2e+05,1449,138
"14392","43089","2018",41,26,15,152429.1,1469.585,103.2927
"14393","43090","2018",1,1,0,30000,429,70
"14394","43091","2018",5,5,0,94500,1657.6,54.2
"14395","43092","2018",7,7,0,119628.6,1190.857,116.5714
"14396","43093","2018",7,7,0,92662.86,991.7143,100.7143
"14397","43095","2018",2,2,0,94300,1394,67
"14398","43096","2018",10,9,1,131636,1404.7,97
"14399","43097","2018",3,3,0,111666.7,1339.667,68
"14400","43098","2018",4,4,0,68573.75,1355.75,56
"14401","43099","2018",7,7,0,93488.29,1003.429,93.14286
"14402","43100","2018",1,1,0,15000,625,24
"14403","43101","2018",3,3,0,100600,621.6667,194.3333
"14404","43102","2018",13,13,0,179386.9,1427.308,123.6154
"14405","43104","2018",3,3,0,129833.3,998.6667,100
"14406","43105","2018",1,1,0,112500,1172,96
"14407","43106","2018",1,1,0,140000,933,150
"14408","43107","2018",3,3,0,69493.33,706.6667,97
"14409","43108","2018",4,4,0,67975,852.25,94.5
"14410","43110","2018",4,4,0,138837.5,1378,103.25
"14411","43111","2018",12,12,0,78707.5,876.1667,99.41667
"14412","43112","2018",50,43,7,86202.2,938.82,92.8
"14413","43113","2018",11,10,1,131190.9,1432.455,90.36364
"14414","43114","2018",15,15,0,133093.1,1298.733,107.9333
"14415","43115","2018",10,10,0,102840,1068.3,93.7
"14416","43116","2018",2,2,0,38950,459.5,87.5
"14417","43117","2018",4,3,1,284910,1882.5,141.25
"14418","43118","2018",2,2,0,92500,745.5,120
"14419","43119","2018",16,16,0,100475,1360.75,67.6875
"14420","43120","2018",11,11,0,131174.2,1362.455,93
"14421","43122","2018",3,3,0,113933.3,1316.333,80
"14422","43123","2018",4,4,0,147840,1487.5,99.5
"14423","43124","2018",9,9,0,107067,960.8889,112.6667
"14424","43126","2018",8,8,0,121200,1210,104.875
"14425","43127","2018",11,11,0,129935.5,1270.091,109.6364
"14426","43128","2018",2,2,0,55811.5,1185.5,53.5
"14427","43129","2018",1,1,0,90000,1385,65
"14428","43130","2018",18,17,1,114900,1202.667,104.1667
"14429","43132","2018",8,8,0,98348.75,933.625,108.75
"14430","43134","2018",2,2,0,137675,1553.5,100.5
"14431","43135","2018",18,18,0,111110,1171.722,93.33333
"14432","43136","2018",6,6,0,94801.67,710.8333,141.5
"14433","43137","2018",74,61,13,177522.3,1893.149,92.47297
"14434","43138","2018",7,7,0,120050,963.4286,137.1429
"14435","43140","2018",3,3,0,94166.67,1065,92.33333
"14436","43141","2018",14,13,1,114148.6,1147.714,99.57143
"14437","43142","2018",7,7,0,113836.4,1041.857,102.7143
"14438","43143","2018",1,1,0,72000,667,108
"14439","43144","2018",2,2,0,97427.5,653.5,147
"14440","43145","2018",1,1,0,50000,667,75
"14441","43147","2018",1,1,0,54500,389,140
"14442","43148","2018",12,12,0,118149.2,1032.167,120.4167
"14443","43149","2018",3,3,0,44333.33,695,66
"14444","43150","2018",5,5,0,116490,1413,83.8
"14445","43151","2018",1,1,0,45100,940,48
"14446","43152","2018",22,22,0,196142,1470.818,136.6818
"14447","43153","2018",17,13,4,119811.2,1350.529,90.11765
"14448","43154","2018",3,3,0,111666.7,1681,89.66667
"14449","43155","2018",3,3,0,99666.67,1297.667,76.66667
"14450","43156","2018",2,2,0,122500,1129.5,106.5
"14451","43157","2018",364,62,302,91343.47,1262.648,74.14835
"14452","43158","2018",5,5,0,64000,709.2,84.2
"14453","43159","2018",9,9,0,133511.1,1280.333,105.8889
"14454","43160","2018",4,4,0,49000,775.5,66.25
"14455","43162","2018",33,33,0,92105.82,1204.333,78.48485
"14456","43163","2018",11,11,0,138577.3,1373,106.3636
"14457","43164","2018",7,7,0,76980.71,785.4286,98.14286
"14458","43165","2018",13,13,0,95961.54,1126.615,85
"14459","43166","2018",9,9,0,153988.9,1370,110.3333
"14460","43167","2018",1,1,0,56000,509,110
"14461","43168","2018",2,2,0,119500,1618.5,73
"14462","43169","2018",1,1,0,72200,802,90
"14463","43172","2018",3,3,0,103666.7,1227,90
"14464","43173","2018",2,2,0,41250,646,65
"14465","43174","2018",8,8,0,122883.8,1228.625,103.125
"14466","43175","2018",1,1,0,63000,1235,51
"14467","43177","2018",32,21,11,118078.1,1372.875,83.8125
"14468","43178","2018",3,3,0,108006.7,887.6667,128.3333
"14469","43180","2018",1,1,0,123671,2061,60
"14470","43181","2018",3,3,0,116500,1196.667,99
"14471","43182","2018",2,2,0,114500,1123,108.5
"14472","43183","2018",3,3,0,71107.33,684,100.3333
"14473","43184","2018",21,18,3,177771.9,1940,95.66667
"14474","43185","2018",47,44,3,102019.6,1117.277,89.17021
"14475","43186","2018",10,10,0,82240,1195.2,80
"14476","43187","2018",2,2,0,112200,1286,85
"14477","43188","2018",4,4,0,117250,1249.5,112
"14478","43189","2018",2,2,0,79500,857.5,95
"14479","43190","2018",16,16,0,168537.5,1556.5,109.125
"14480","43191","2018",2,2,0,174446.5,1599,109
"14481","43193","2018",2,2,0,150000,1520,99.5
"14482","43194","2018",4,4,0,115000,980,106.5
"14483","43195","2018",2,2,0,73050,983,70.5
"14484","43196","2018",3,3,0,109433.3,1215.333,91.66667
"14485","43197","2018",2,2,0,57500,620.5,99.5
"14486","43198","2018",1,1,0,198540,1504,132
"14487","43199","2018",16,14,2,114862.5,1354.438,85.125
"14488","43200","2018",19,17,2,119521.1,1194.105,104.6316
"14489","43201","2018",2,2,0,68200,610,102.5
"14490","43202","2018",1,1,0,65000,619,105
"14491","43203","2018",6,6,0,102425,1324,79.33333
"14492","43204","2018",4,4,0,94125,1071.25,86.75
"14493","43205","2018",31,26,5,133352.6,1444.097,94.16129
"14494","43206","2018",5,5,0,88380,1072,98.2
"14495","43207","2018",3,3,0,100200,1125.333,85.33333
"14496","43210","2018",4,4,0,183856,1796.25,77.5
"14497","43211","2018",17,17,0,162383.4,1386.706,119.5882
"14498","43212","2018",11,10,1,127381.8,979,114.9091
"14499","43213","2018",21,19,2,128753.6,1262.857,109.7143
"14500","43214","2018",1,1,0,58000,580,100
"14501","43215","2018",4,4,0,69612.5,773.75,92
"14502","43216","2018",21,20,1,137768.3,1337.381,105.1429
"14503","43217","2018",7,7,0,102921.4,1068.286,95.85714
"14504","43218","2018",11,11,0,128877.3,1036.273,120.4545
"14505","43220","2018",6,6,0,82750,1160,65.66667
"14506","43221","2018",2,2,0,117945,960.5,135
"14507","43222","2018",1,1,0,78000,804,97
"14508","43223","2018",5,5,0,152558.4,1509.2,106.2
"14509","43224","2018",41,34,7,133166.3,1436.488,90.68293
"14510","43227","2018",3,3,0,147333.3,1376,105.3333
"14511","43228","2018",1,1,0,88000,1158,76
"14512","43229","2018",6,6,0,139301.8,1456.5,91.83333
"14513","43230","2018",10,9,1,112300,1132.4,102.2
"14514","43231","2018",6,6,0,90143.33,1387.833,98.5
"14515","43232","2018",4,4,0,74325,684.75,108.75
"14516","43233","2018",9,8,1,138105.6,1221.444,111.2222
"14517","43234","2018",12,11,1,90766.67,1036.833,91.08333
"14518","43236","2018",17,8,9,108376.5,1149.118,96.23529
"14519","43237","2018",4,4,0,64125,718,101
"14520","43238","2018",2,2,0,54100,826,64
"14521","43239","2018",6,6,0,64176.67,995.3333,66.66667
"14522","43240","2018",4,4,0,143162.8,1040.75,132.5
"14523","43241","2018",10,10,0,158175.4,1645.9,99.3
"14524","43244","2018",28,26,2,101507.4,1296.786,84.46429
"14525","43245","2018",5,5,0,70700,660,101.8
"14526","43246","2018",6,4,2,67716.67,1050.667,69
"14527","43249","2018",5,5,0,125481,1100.8,114.6
"14528","43251","2018",54,29,25,143896.5,1480.056,92.16667
"14529","43252","2018",1,1,0,150000,1667,90
"14530","43253","2018",4,3,1,117960.5,1325.5,95
"14531","43254","2018",4,4,0,142500,1359,105
"14532","43256","2018",3,3,0,88797,1087.333,77.33333
"14533","43257","2018",4,4,0,184637.5,1485.25,126.25
"14534","43258","2018",21,21,0,98310.57,1141.857,86.71429
"14535","43259","2018",2,2,0,32500,573.5,54.5
"14536","43262","2018",19,16,3,96958.21,1019.053,91.31579
"14537","43263","2018",2,2,0,102500,1480.5,68
"14538","43264","2018",6,6,0,75633.33,1075,78.16667
"14539","43265","2018",16,16,0,167678.1,1922.938,97.6875
"14540","43267","2018",12,12,0,91650,1010.083,91.08333
"14541","43268","2018",84,69,15,137774.6,1420.583,99.35714
"14542","44001","2018",26,26,0,134673.1,1411,98.69231
"14543","44002","2018",52,47,5,187013.8,1916.25,100.9423
"14544","44003","2018",84,64,20,168675,1904.31,90.96429
"14545","44005","2018",104,103,1,185709.2,2087.673,93.21154
"14546","44006","2018",34,34,0,182341.8,1993,95.47059
"14547","44007","2018",36,35,1,117438.3,1276.472,95.02778
"14548","44009","2018",98,83,15,298428.5,2778.102,108.2653
"14549","44010","2018",100,75,25,265863.1,3654.68,74.55
"14550","44012","2018",115,93,22,202654.7,2981.33,72.46087
"14551","44013","2018",48,45,3,148583,1625.75,93.5625
"14552","44014","2018",58,56,2,223790.5,2285.224,98.31034
"14553","44015","2018",120,100,20,152706.7,1748.967,90.35833
"14554","44016","2018",13,13,0,184953.8,1730.154,107.3077
"14555","44018","2018",86,73,13,258585.1,2594.012,99.83721
"14556","44019","2018",1,1,0,235000,2765,85
"14557","44020","2018",286,197,89,204440,2552.451,83.16434
"14558","44021","2018",67,65,2,163803.4,1797.97,92.25373
"14559","44022","2018",39,39,0,147170.8,1491.974,102.7949
"14560","44023","2018",34,34,0,154326.5,1663.029,96.11765
"14561","44024","2018",30,30,0,217154.5,2179.5,98.9
"14562","44025","2018",15,15,0,182733.3,1934.333,105.8667
"14563","44026","2018",267,168,99,257514.4,2816.873,91.24719
"14564","44027","2018",23,23,0,200119.6,1801.13,112
"14565","44028","2018",37,37,0,216498.1,2081.811,108.3784
"14566","44029","2018",67,66,1,178838.1,1884.672,93.26866
"14567","44030","2018",62,62,0,143421.8,1603.194,89.91935
"14568","44031","2018",11,11,0,78681.82,1059.273,75.72727
"14569","44032","2018",42,41,1,203340.8,2139.167,100.7619
"14570","44033","2018",34,34,0,185311.2,1827.529,104.0588
"14571","44035","2018",196,131,65,262951.2,2885.954,91.89796
"14572","44036","2018",155,123,32,120223.7,1411.716,89.29032
"14573","44038","2018",45,45,0,184231.3,1958,96.88889
"14574","44039","2018",19,19,0,231247.4,2342.789,103.3684
"14575","44041","2018",75,74,1,217711.5,2220.413,102.1333
"14576","44043","2018",91,77,14,196147.8,2404.912,85.31868
"14577","44044","2018",18,18,0,115152.4,1103.556,97.61111
"14578","44045","2018",38,38,0,199973.7,2008.105,102.5789
"14579","44046","2018",25,25,0,223260.8,1971.32,113.64
"14580","44047","2018",348,267,81,225138.1,2653.175,87.73563
"14581","44048","2018",28,28,0,174035.7,1722.143,102.8214
"14582","44049","2018",168,79,89,222166.6,3177.167,73.94643
"14583","44050","2018",26,26,0,159834.6,1535.923,103.7308
"14584","44051","2018",43,43,0,131296.5,1254.86,108.5581
"14585","44052","2018",84,81,3,152722,1702.44,89.91667
"14586","44053","2018",22,22,0,156535.3,1753.682,90.09091
"14587","44054","2018",32,32,0,133390.6,1294.969,108.875
"14588","44055","2018",752,255,497,331999.1,4536.823,73.14894
"14589","44056","2018",57,57,0,178993.4,1660.474,112.193
"14590","44057","2018",37,37,0,113817.4,1263.568,92.2973
"14591","44058","2018",7,7,0,142428.6,1125.286,129.1429
"14592","44061","2018",43,42,1,169396.3,2017.349,88.44186
"14593","44062","2018",38,38,0,145997.4,1619.605,92.02632
"14594","44063","2018",28,27,1,168975.5,1769.071,95.42857
"14595","44064","2018",46,44,2,198576.8,2044.5,98.82609
"14596","44065","2018",10,10,0,147300,1206.3,125.7
"14597","44066","2018",30,25,5,240475.4,2431.6,99.96667
"14598","44067","2018",72,68,4,109674.3,1158.083,96.02778
"14599","44068","2018",57,57,0,128948.6,1462.175,92.2807
"14600","44069","2018",269,217,52,260193.8,2648.353,101.4164
"14601","44070","2018",57,57,0,240945.1,2618.789,101.0877
"14602","44071","2018",49,48,1,326118.5,2811.816,118.9796
"14603","44072","2018",95,91,4,183254.7,1779.411,103.1474
"14604","44073","2018",74,72,2,213505.4,2213.514,103.7162
"14605","44074","2018",68,48,20,199408.1,2537.544,78.86765
"14606","44075","2018",21,21,0,108478.6,1153,96.95238
"14607","44076","2018",16,16,0,125125,1453.875,88.8125
"14608","44077","2018",33,33,0,139643.2,1918.333,82.21212
"14609","44078","2018",6,6,0,61166.67,725.6667,83.5
"14610","44079","2018",30,30,0,199713.3,2050.3,101.6333
"14611","44080","2018",14,14,0,170546.4,1680.071,101.4286
"14612","44081","2018",75,75,0,139574.7,1419.813,102.4267
"14613","44082","2018",63,63,0,186552,1843.556,102.7778
"14614","44083","2018",25,25,0,164640.1,1761.44,92.16
"14615","44084","2018",100,89,11,221179,2423.44,96.91
"14616","44085","2018",7,7,0,118857.1,1181.286,99.85714
"14617","44086","2018",13,13,0,90942.31,1001.154,92.30769
"14618","44087","2018",95,85,10,165524.4,1859.042,93.34737
"14619","44088","2018",27,27,0,166953.3,1907.963,88.25926
"14620","44089","2018",41,41,0,190848.8,1927.805,104.2683
"14621","44090","2018",12,12,0,134609.2,1297.333,100.3333
"14622","44091","2018",14,14,0,126778.6,1231.429,104.3571
"14623","44092","2018",16,16,0,82984.38,1038.5,78.0625
"14624","44094","2018",44,44,0,263235.2,2277.591,116.5455
"14625","44095","2018",18,18,0,111305.6,1193.722,96.05556
"14626","44096","2018",48,48,0,172568.6,1780.083,101.8958
"14627","44097","2018",54,49,5,342169.2,3219.389,109.4815
"14628","44098","2018",57,56,1,160248.8,1636.404,101.4912
"14629","44099","2018",27,27,0,95592.59,1080.926,89.66667
"14630","44100","2018",28,28,0,187500.9,2079.286,90.71429
"14631","44101","2018",97,87,10,203954.7,2551.639,84.47423
"14632","44102","2018",38,38,0,201050,2092.579,96.13158
"14633","44103","2018",82,72,10,154068.5,1784.537,86.78049
"14634","44104","2018",17,17,0,120970.6,1330.941,92.76471
"14635","44105","2018",2,2,0,137500,1248,109
"14636","44106","2018",44,41,3,213885.4,2630.727,83.61364
"14637","44107","2018",16,16,0,148525,1460.312,103.5
"14638","44108","2018",18,18,0,198928.6,1890.5,106.6111
"14639","44109","2018",5681,1266,4415,217950.1,3153.244,67.98592
"14640","44110","2018",101,94,7,214699.6,2085.119,104.6139
"14641","44111","2018",36,36,0,209777.8,1827.778,118.9444
"14642","44112","2018",3,3,0,116000,1257.667,91.33333
"14643","44113","2018",54,46,8,127601.7,1500.13,90.48148
"14644","44114","2018",438,250,188,257309.3,2683.797,94.23288
"14645","44115","2018",39,38,1,201706.4,1885.564,106.2564
"14646","44116","2018",3,2,1,90333.33,939.3333,98
"14647","44117","2018",44,41,3,172883,1902.591,93.06818
"14648","44118","2018",15,15,0,121000,1343.467,90.66667
"14649","44119","2018",19,19,0,173198.3,1658.158,106.6842
"14650","44120","2018",76,73,3,201665.1,2287.132,91.38158
"14651","44121","2018",6,6,0,80833.33,1021.333,93.66667
"14652","44122","2018",27,27,0,201878.5,1965.481,105.5556
"14653","44123","2018",6,6,0,107166.7,1068.167,99
"14654","44124","2018",11,11,0,95272.73,921.7273,105.9091
"14655","44125","2018",79,68,11,270113.9,3377.013,86.78481
"14656","44126","2018",106,103,3,205201.4,2704.538,80.80189
"14657","44127","2018",26,26,0,153969.2,1594.692,96.80769
"14658","44128","2018",64,64,0,157659.8,1644.875,96.23438
"14659","44129","2018",115,102,13,160058.1,1760.791,94.17391
"14660","44130","2018",78,74,4,236879.7,2515.321,97.52564
"14661","44131","2018",356,289,67,280955.4,3334.494,87.40169
"14662","44132","2018",375,159,216,286047.8,4136.848,72.024
"14663","44133","2018",48,45,3,200876.7,2083.229,97.64583
"14664","44134","2018",14,14,0,153521.4,1449.429,108
"14665","44135","2018",201,106,95,267301.5,3751.443,71.60199
"14666","44136","2018",41,39,2,285148.8,3253.293,90.2439
"14667","44137","2018",37,37,0,187855.4,1905.459,102.5405
"14668","44138","2018",12,12,0,126458.3,1455.25,86.58333
"14669","44139","2018",19,19,0,129868.4,1615.947,90.73684
"14670","44140","2018",23,23,0,175219.6,1804.174,98.47826
"14671","44141","2018",18,18,0,182172.2,1705.611,108.1111
"14672","44142","2018",26,26,0,180821.2,1827.115,104.1923
"14673","44143","2018",794,365,429,192060.2,2560.422,74.57179
"14674","44144","2018",22,22,0,130772.7,1336.227,102.2727
"14675","44145","2018",40,40,0,193831.2,2016.35,101.8
"14676","44146","2018",30,30,0,104520,1064.1,99.53333
"14677","44148","2018",7,7,0,81571.43,855.1429,97.57143
"14678","44149","2018",45,45,0,154152.8,1691.8,95.62222
"14679","44150","2018",27,27,0,234765.9,2300.074,102.8148
"14680","44151","2018",105,98,7,295812.7,2362.876,120.2476
"14681","44152","2018",26,26,0,163728.1,1671.654,101.1538
"14682","44153","2018",24,24,0,107132.9,1031.583,102.7917
"14683","44154","2018",349,240,109,216062.7,3005.052,74.14613
"14684","44155","2018",34,34,0,149714.7,1759.853,89.20588
"14685","44156","2018",42,42,0,156175.1,1669.738,95.19048
"14686","44157","2018",18,18,0,121772.2,1357.722,90.27778
"14687","44158","2018",97,81,16,232094.4,2368.639,100.8041
"14688","44159","2018",15,14,1,244693.3,2272.067,108.8
"14689","44161","2018",33,33,0,141015.2,1413.97,102.9091
"14690","44162","2018",798,328,470,191346.9,2345.563,80.80451
"14691","44163","2018",45,45,0,183893.3,1507.111,123.9778
"14692","44164","2018",27,27,0,198563,2114.481,97.40741
"14693","44165","2018",16,16,0,151075.8,1648.312,88.6875
"14694","44166","2018",19,18,1,240066.4,2514.474,99.21053
"14695","44168","2018",56,56,0,122651.6,1446.536,86.67857
"14696","44169","2018",84,83,1,221273.9,2285.071,97.9881
"14697","44170","2018",5,5,0,103400,828.6,121.6
"14698","44171","2018",18,18,0,237002.8,2193.056,108.9444
"14699","44172","2018",149,113,36,237061,2738.584,88.36242
"14700","44173","2018",24,23,1,167971.8,1944.167,90.25
"14701","44174","2018",21,21,0,144838.1,1723.571,88.52381
"14702","44175","2018",62,62,0,227506.3,2176.452,109.9677
"14703","44176","2018",42,42,0,156006.4,1766.024,89.88095
"14704","44178","2018",35,35,0,188813.4,1928.743,102.5714
"14705","44179","2018",56,56,0,204099.4,2115.571,99.26786
"14706","44180","2018",55,55,0,135987.3,1207.8,114.3273
"14707","44182","2018",159,126,33,194359.5,2957.673,70.31447
"14708","44183","2018",48,48,0,183344.7,2010.583,95.29167
"14709","44184","2018",1169,546,623,163367.4,2147.743,76.37211
"14710","44185","2018",36,32,4,107447.1,1315.722,84.25
"14711","44186","2018",92,90,2,182789.6,2039.543,90.66304
"14712","44187","2018",60,60,0,233955,2003.733,113.7667
"14713","44188","2018",90,85,5,216842.2,2135.744,104.9778
"14714","44189","2018",21,21,0,160047.6,1691.619,97.47619
"14715","44190","2018",465,267,198,224017.9,2840.68,80.05806
"14716","44192","2018",26,25,1,143476.9,1633.808,93.42308
"14717","44193","2018",21,21,0,115866.7,1051,112.7143
"14718","44194","2018",105,85,20,342872.4,3024.59,115.7905
"14719","44195","2018",92,81,11,186944.5,2115.022,92.16304
"14720","44196","2018",19,19,0,97178.95,1228.579,83.84211
"14721","44197","2018",23,23,0,98319.7,955.7826,103.5217
"14722","44198","2018",96,78,18,233815.7,2513.125,92.29167
"14723","44199","2018",22,22,0,105149.5,1068.636,98
"14724","44200","2018",5,4,1,59305.4,838.4,70.6
"14725","44201","2018",22,22,0,360264.5,3068.273,119
"14726","44202","2018",14,14,0,143535.7,1406.357,105
"14727","44203","2018",22,22,0,218500,1964.227,120.9545
"14728","44204","2018",129,98,31,256577.4,2683.047,98.53488
"14729","44205","2018",27,26,1,145198.1,1678.222,89.88889
"14730","44206","2018",17,17,0,121312.3,1409.294,88.35294
"14731","44207","2018",20,20,0,142131.1,1425.95,107.2
"14732","44208","2018",11,11,0,125363.6,1349.727,96.63636
"14733","44209","2018",101,91,10,287102.8,2554.337,115.4356
"14734","44210","2018",106,90,16,141552.2,1760.613,84.81132
"14735","44211","2018",145,101,44,218550,2949.745,78.04138
"14736","44212","2018",108,103,5,202732.3,2062.991,101.537
"14737","44213","2018",83,83,0,130566.3,1365.169,97.45783
"14738","44214","2018",21,21,0,110223.8,1275.571,91.52381
"14739","44215","2018",349,283,66,268719.7,2872.885,94.81375
"14740","44216","2018",52,51,1,155361.5,1794.923,92.23077
"14741","44217","2018",90,90,0,255535.8,2477.089,106.1
"14742","44218","2018",7,7,0,163714.3,1183.429,139.7143
"14743","44220","2018",29,29,0,197808.6,1891.828,105.5172
"14744","44221","2018",18,18,0,186972.2,1745.5,110.2778
"14745","44222","2018",21,21,0,161142.9,1487.048,111.4286
"14746","44223","2018",44,34,10,164290.9,1888.477,87.29545
"14747","44224","2018",12,12,0,164258.3,1762,96.66667
"14748","45001","2018",5,5,0,122935.2,1381,92.4
"14749","45002","2018",8,8,0,80500,1292.5,75.875
"14750","45004","2018",126,120,6,130296.7,1484.476,88.90476
"14751","45005","2018",4,4,0,153500,1383.75,123.5
"14752","45006","2018",17,16,1,331983.4,2213.235,154.4706
"14753","45008","2018",31,29,2,146074.3,1550,97.83871
"14754","45009","2018",12,12,0,136652.6,1401.833,114
"14755","45010","2018",7,6,1,138024.6,1580.571,94.28571
"14756","45011","2018",3,3,0,152666.7,1428.333,108.3333
"14757","45013","2018",6,5,1,219866.8,1885.167,109.8333
"14758","45014","2018",6,6,0,132333.3,1463,92.83333
"14759","45015","2018",14,14,0,174633.9,1864.429,94.35714
"14760","45016","2018",7,7,0,143014.3,1592.286,79.42857
"14761","45017","2018",4,4,0,100250,1654.25,66.25
"14762","45018","2018",12,12,0,126320.8,1432.25,91.08333
"14763","45019","2018",9,9,0,160815.6,1498.222,117
"14764","45020","2018",10,10,0,157960,1695.2,96.5
"14765","45021","2018",3,3,0,98666.67,1093.667,96.33333
"14766","45022","2018",6,6,0,108266.7,1500,80
"14767","45023","2018",2,2,0,1e+05,659.5,148
"14768","45024","2018",27,27,0,177635.6,1480.037,123.4074
"14769","45025","2018",17,16,1,157273.5,1612.059,102.7647
"14770","45026","2018",10,10,0,114323.4,1146.4,110.7
"14771","45027","2018",8,8,0,125959.4,1308.25,95.75
"14772","45028","2018",114,87,27,145779.9,1651.728,91.99123
"14773","45029","2018",27,26,1,88959.26,1130.815,83.37037
"14774","45030","2018",21,21,0,100500,1183.381,91.14286
"14775","45031","2018",16,16,0,125506.2,1215.688,104.8125
"14776","45032","2018",3,3,0,147000,1572.667,91
"14777","45033","2018",9,9,0,131777.8,1496.444,92.11111
"14778","45034","2018",16,16,0,219352.5,2165.375,104.875
"14779","45035","2018",8,8,0,102163.8,1475.875,77
"14780","45036","2018",15,15,0,113800,1316.333,89.13333
"14781","45037","2018",7,7,0,142747.4,1517,97.42857
"14782","45038","2018",3,3,0,171800,1671.667,105.6667
"14783","45039","2018",4,4,0,108250,1526.5,73.5
"14784","45040","2018",21,21,0,126210.2,1233.286,102.8571
"14785","45041","2018",1,1,0,67000,1218,55
"14786","45042","2018",20,19,1,144765.8,1744.8,86.35
"14787","45043","2018",16,15,1,182382.5,1713.812,112.9375
"14788","45044","2018",6,6,0,176416.7,1483.833,121
"14789","45046","2018",2,2,0,166500,1452,115.5
"14790","45047","2018",5,5,0,137160,1475,98.8
"14791","45049","2018",16,16,0,137515.6,1377.812,98.375
"14792","45050","2018",20,20,0,110137.1,1177.25,95.05
"14793","45051","2018",31,31,0,165632.1,1549.226,112.3548
"14794","45052","2018",5,5,0,114825.2,1970.2,61.8
"14795","45053","2018",57,50,7,131921.3,1589.982,87.70175
"14796","45054","2018",12,12,0,148700,1478.167,107.75
"14797","45055","2018",5,5,0,136400,1310.2,108.4
"14798","45056","2018",6,6,0,132733.3,1527.5,87.16667
"14799","45058","2018",4,4,0,142000,1367.25,111.75
"14800","45059","2018",1,1,0,131321,1990,66
"14801","45060","2018",4,4,0,123200,1201.75,105.5
"14802","45061","2018",26,23,3,124088.5,1494.731,86.34615
"14803","45062","2018",12,11,1,206725,1968.667,97.58333
"14804","45063","2018",13,13,0,99423.85,1143.154,92.23077
"14805","45064","2018",3,3,0,84133.33,1026,86.66667
"14806","45065","2018",3,2,1,155666.7,1627.333,96.66667
"14807","45066","2018",16,16,0,105371.9,1366.875,81.625
"14808","45067","2018",43,42,1,191521.7,1909.93,102.5349
"14809","45068","2018",93,85,8,104078.9,1333.022,80.06452
"14810","45069","2018",10,10,0,135200,1740.7,86.5
"14811","45070","2018",1,1,0,39000,867,45
"14812","45072","2018",13,10,3,218731.9,1969.154,111.8462
"14813","45073","2018",5,5,0,86000,1084.6,81.6
"14814","45075","2018",106,68,38,156092,1836.443,86.12264
"14815","45076","2018",2,2,0,97500,862,107.5
"14816","45077","2018",7,7,0,86000,1140.286,75.57143
"14817","45078","2018",2,2,0,153500,1560.5,95
"14818","45080","2018",4,4,0,164500,1985.75,79.5
"14819","45081","2018",6,6,0,108533.3,1110.5,97.83333
"14820","45082","2018",115,95,20,154205.7,1733.783,93.1913
"14821","45083","2018",25,24,1,95147.6,1219.08,79.84
"14822","45084","2018",6,6,0,124290,1505.5,85.83333
"14823","45085","2018",24,24,0,112212.5,1274.167,93.08333
"14824","45087","2018",41,40,1,99417.44,1122.902,91.41463
"14825","45088","2018",1,1,0,112000,933,120
"14826","45089","2018",105,90,15,185108.2,1927.419,98.74286
"14827","45091","2018",2,2,0,239500,1623,155
"14828","45092","2018",14,14,0,143633.8,1439,108.6429
"14829","45093","2018",19,19,0,158321.1,1747.947,92
"14830","45094","2018",6,6,0,111166.7,1303.833,94.33333
"14831","45095","2018",27,26,1,142643.9,1663.852,89.11111
"14832","45096","2018",4,4,0,128525,1026.25,119.5
"14833","45097","2018",18,18,0,118250,1278.389,95.72222
"14834","45098","2018",35,34,1,192921.7,1898.943,100.6
"14835","45099","2018",7,7,0,152108.6,1410.143,108
"14836","45100","2018",9,9,0,298366.9,2263.778,136.4444
"14837","45101","2018",2,2,0,170000,1434.5,118.5
"14838","45102","2018",4,4,0,231875,1577.5,147.5
"14839","45103","2018",12,12,0,94020.83,1325.833,73.83333
"14840","45104","2018",24,23,1,146127.5,1524.5,99.08333
"14841","45105","2018",4,4,0,165162.5,1604.25,95.75
"14842","45107","2018",3,3,0,110750,1498.667,74.33333
"14843","45108","2018",24,23,1,133597.5,1305.792,101.8333
"14844","45109","2018",6,6,0,170083.3,1399.833,127.8333
"14845","45110","2018",8,8,0,128525,1481.125,92.375
"14846","45111","2018",8,8,0,142132.5,1325.125,118.125
"14847","45112","2018",1,1,0,57200,986,58
"14848","45113","2018",6,6,0,106833.3,1074.333,106.8333
"14849","45114","2018",1,1,0,45000,450,100
"14850","45115","2018",61,59,2,117848.8,1317.18,95.7541
"14851","45116","2018",3,3,0,96000,1247.333,81.33333
"14852","45118","2018",4,4,0,170275,2025.5,91
"14853","45119","2018",22,22,0,131359.1,1537.818,90.86364
"14854","45120","2018",3,3,0,98666.67,816.3333,120
"14855","45121","2018",12,12,0,99616.67,1074.75,94.08333
"14856","45122","2018",14,14,0,123304.3,1382.857,91.42857
"14857","45123","2018",1,1,0,240000,1860,129
"14858","45124","2018",2,2,0,172500,1530,112.5
"14859","45125","2018",2,2,0,125000,1623,78
"14860","45126","2018",13,13,0,217563,2136.923,109.9231
"14861","45127","2018",53,52,1,152224.2,1738.245,90.66038
"14862","45129","2018",22,22,0,100840.9,1136.818,93.31818
"14863","45130","2018",17,17,0,175941.2,1788.647,104.9412
"14864","45131","2018",4,4,0,217375,1653.75,127
"14865","45132","2018",8,8,0,112250,1136.5,99.75
"14866","45133","2018",6,6,0,134833.3,1293.833,108.6667
"14867","45134","2018",16,16,0,138674.1,1516.75,92.5625
"14868","45135","2018",2,2,0,105000,1750,60
"14869","45136","2018",9,9,0,91033.33,970.2222,94.77778
"14870","45137","2018",3,3,0,114666.7,1216.667,90.33333
"14871","45138","2018",4,4,0,170000,1569.75,116.75
"14872","45139","2018",9,9,0,183333.3,1479.778,116
"14873","45141","2018",4,4,0,56000,721,81.5
"14874","45142","2018",32,30,2,186332.6,1806.875,107.375
"14875","45143","2018",2,2,0,89002.5,1130.5,78
"14876","45144","2018",11,11,0,161775.6,1657.455,95.45455
"14877","45145","2018",53,53,0,151445.5,1559.302,99.18868
"14878","45146","2018",88,81,7,189137.5,1955.716,98.35227
"14879","45147","2018",240,143,97,143791.3,1835.487,80.92083
"14880","45148","2018",25,24,1,104826,1343.28,78.8
"14881","45149","2018",9,9,0,104666.7,1424.333,77.11111
"14882","45150","2018",1,1,0,167301,2292,73
"14883","45151","2018",1,1,0,168000,1292,130
"14884","45152","2018",2,2,0,163000,1772.5,92.5
"14885","45153","2018",10,10,0,169427.5,1476.6,121
"14886","45154","2018",24,24,0,197440.1,1956.333,101.375
"14887","45155","2018",151,117,34,98593.79,1174.007,87.17219
"14888","45156","2018",4,4,0,122750,1154.25,114.25
"14889","45157","2018",7,7,0,154650,1150.429,133
"14890","45158","2018",5,5,0,70900,1373.6,64.4
"14891","45159","2018",2,2,0,137625,1159.5,120.5
"14892","45160","2018",8,8,0,148281.2,1393.75,112.75
"14893","45161","2018",13,13,0,118046.2,1327.077,93.30769
"14894","45162","2018",2,2,0,95750,1927.5,77
"14895","45164","2018",6,6,0,97909.17,1240.667,78.83333
"14896","45165","2018",3,3,0,154900,1354.333,118
"14897","45166","2018",2,2,0,152053.5,1174.5,133
"14898","45167","2018",15,15,0,171666.7,1474.333,132.4667
"14899","45168","2018",11,11,0,124649.1,1416.273,105.6364
"14900","45169","2018",91,79,12,199070.9,2164.231,93.86813
"14901","45170","2018",3,3,0,126333.3,1741.667,71.66667
"14902","45171","2018",3,3,0,137333.3,1616,84.33333
"14903","45173","2018",64,61,3,182175.9,1828.219,105.9688
"14904","45174","2018",1,1,0,55000,1146,48
"14905","45175","2018",16,16,0,242378.1,2053.625,120.9375
"14906","45176","2018",6,6,0,148333.3,1375.333,111.8333
"14907","45177","2018",5,5,0,137900,1684.8,85.4
"14908","45178","2018",15,15,0,99620,1243.267,94.26667
"14909","45179","2018",43,43,0,162375.5,1549.86,107.7674
"14910","45180","2018",3,3,0,158333.3,1158,142
"14911","45182","2018",15,15,0,177808.3,1697,105.7333
"14912","45183","2018",3,3,0,191666.7,1265.333,161.6667
"14913","45184","2018",3,3,0,80000,1153.667,68
"14914","45185","2018",1,1,0,121500,1012,120
"14915","45186","2018",8,8,0,86125,1302.125,67.625
"14916","45187","2018",40,38,2,128697.2,1328.175,102.65
"14917","45188","2018",25,25,0,176044.4,1569.56,114.64
"14918","45189","2018",4,4,0,140000,1586.25,89.25
"14919","45191","2018",88,70,18,154798.5,1750.443,93.40909
"14920","45193","2018",17,17,0,222270.6,1790.294,131.4118
"14921","45194","2018",29,29,0,215124.1,1903.759,116.7241
"14922","45195","2018",7,7,0,111165,1165,104
"14923","45196","2018",16,15,1,217331.2,1936.375,118.5
"14924","45197","2018",15,14,1,223592.9,1913.533,120.8667
"14925","45198","2018",4,4,0,238000,1514.75,152
"14926","45199","2018",11,11,0,105589.1,1366.182,79.27273
"14927","45200","2018",14,14,0,225822.1,2002.143,120.4286
"14928","45201","2018",4,4,0,105250,998.5,115
"14929","45202","2018",12,11,1,143325,1335,106.5833
"14930","45203","2018",90,75,15,146015.4,1671.856,91.32222
"14931","45204","2018",3,3,0,151883.3,1577.667,97
"14932","45205","2018",3,3,0,91233.33,1133.667,75
"14933","45206","2018",3,3,0,164333.3,1928.333,87
"14934","45207","2018",2,2,0,157000,1165.5,136.5
"14935","45208","2018",190,58,132,92381.27,1427.158,71.36842
"14936","45209","2018",2,2,0,198000,981,200
"14937","45210","2018",12,12,0,131558.3,1042.667,124.9167
"14938","45212","2018",22,22,0,123228.2,1400,103.5909
"14939","45213","2018",8,8,0,144487.5,1748.625,80.75
"14940","45214","2018",3,3,0,116000,1259,95.33333
"14941","45215","2018",4,4,0,152500,1094,149.75
"14942","45216","2018",2,2,0,161950,1443,115
"14943","45217","2018",5,5,0,126600,1782.4,74.8
"14944","45218","2018",4,4,0,120287.5,1052.25,123.75
"14945","45219","2018",1,1,0,65000,855,76
"14946","45220","2018",4,4,0,155000,1998.5,82.5
"14947","45222","2018",17,17,0,152253.5,1326.412,116.9412
"14948","45223","2018",3,3,0,139000,1576,90
"14949","45224","2018",51,46,5,161398.8,1654.412,101.3922
"14950","45225","2018",3,3,0,106666.7,991,107
"14951","45226","2018",14,14,0,165185.7,1715.286,102.8571
"14952","45227","2018",13,13,0,129688.5,1198.769,111.8462
"14953","45228","2018",21,21,0,120249,1335.857,107.619
"14954","45229","2018",39,38,1,107619.7,1278.41,90.46154
"14955","45230","2018",11,11,0,121359.1,1382.909,87.90909
"14956","45231","2018",2,2,0,125000,1492.5,79.5
"14957","45232","2018",301,154,147,181508.3,2105.535,86.75415
"14958","45233","2018",4,4,0,160450,1524.5,107.75
"14959","45234","2018",1866,484,1382,146952.1,2107.858,70.53215
"14960","45235","2018",29,28,1,231295,2153.379,112.2414
"14961","45237","2018",3,3,0,186553.3,2079.333,89.33333
"14962","45238","2018",6,5,1,137621.7,1772.167,80.83333
"14963","45239","2018",5,5,0,194860,1427,137.2
"14964","45240","2018",24,24,0,142153.3,1576.333,93.95833
"14965","45241","2018",5,5,0,194600,1532,142.2
"14966","45242","2018",3,3,0,139800,1396,107.6667
"14967","45243","2018",2,2,0,177000,1254.5,142
"14968","45244","2018",56,56,0,132361.3,1392.661,95.69643
"14969","45245","2018",15,14,1,108572.7,1147.533,99.86667
"14970","45246","2018",2,2,0,160000,1617.5,97.5
"14971","45247","2018",49,49,0,128873.4,1463.224,88.44898
"14972","45248","2018",19,16,3,134364.2,1485.632,96.05263
"14973","45249","2018",12,12,0,151750,1494.75,100.6667
"14974","45250","2018",4,4,0,161750,1309.5,126
"14975","45251","2018",3,3,0,104000,811.3333,136.6667
"14976","45252","2018",68,36,32,117204,1630.75,83.08824
"14977","45253","2018",6,6,0,181470,1713.833,116.1667
"14978","45254","2018",29,29,0,131996.6,1318.897,101.6552
"14979","45255","2018",4,4,0,117125,1380.75,101.5
"14980","45256","2018",7,7,0,131785.7,1211,110.1429
"14981","45257","2018",8,8,0,107000,1226.25,89
"14982","45258","2018",46,45,1,130161.3,1456.5,92.65217
"14983","45259","2018",14,14,0,132119.3,1210.357,117.5
"14984","45260","2018",2,2,0,77388,1205.5,67
"14985","45261","2018",10,10,0,219012.4,1819.4,121.4
"14986","45262","2018",4,4,0,137000,1612,82
"14987","45263","2018",5,4,1,228900,2157.6,100
"14988","45264","2018",3,3,0,195441.7,1484.333,133.3333
"14989","45265","2018",5,5,0,146400,1416.6,112.8
"14990","45266","2018",1,1,0,156400,1612,97
"14991","45268","2018",8,8,0,101887.5,1337.875,75.875
"14992","45269","2018",41,40,1,184236.2,1862.927,101.2439
"14993","45270","2018",21,19,2,132861,1589.952,87.38095
"14994","45271","2018",8,8,0,122275,1329,96.875
"14995","45272","2018",24,23,1,246636.2,2309.792,114.875
"14996","45273","2018",30,26,4,179208.1,1641.4,105.7
"14997","45274","2018",63,60,3,233426.2,2195,109.2857
"14998","45275","2018",6,6,0,84166.67,1071.167,74.16667
"14999","45276","2018",9,9,0,139677.8,1090.556,140.6667
"15000","45277","2018",5,5,0,116220,1478.8,85.6
"15001","45278","2018",12,12,0,121624.2,1364.583,89.16667
"15002","45279","2018",22,22,0,108718.2,1203.636,91.04545
"15003","45280","2018",16,16,0,94489.69,1013.688,96.3125
"15004","45281","2018",17,17,0,106382.4,1410.647,78.23529
"15005","45282","2018",19,17,2,268061,2759.421,106.4211
"15006","45283","2018",2,2,0,108500,1392,75.5
"15007","45284","2018",318,168,150,147700.2,1814.104,82.60377
"15008","45285","2018",161,105,56,141996.8,1823.714,77.40994
"15009","45286","2018",149,83,66,184954.2,2066,88.85235
"15010","45288","2018",3,3,0,112666.7,1887.667,72.66667
"15011","45289","2018",14,14,0,177453.6,1836.643,97.78571
"15012","45290","2018",12,12,0,163870.8,1544.583,107.3333
"15013","45291","2018",12,12,0,135073.3,1473.25,92.91667
"15014","45292","2018",16,16,0,131821.9,1290.875,103.8125
"15015","45293","2018",13,13,0,115236,1251.385,92.53846
"15016","45294","2018",2,2,0,88250,933.5,116
"15017","45296","2018",7,7,0,143014.3,1415.571,102.5714
"15018","45297","2018",10,10,0,101800,1228.5,82.7
"15019","45298","2018",52,40,12,195314.9,2155.058,92.13462
"15020","45299","2018",3,3,0,108333.3,1016.667,112.6667
"15021","45300","2018",30,30,0,226363.8,1950.167,115.3667
"15022","45301","2018",5,5,0,140500,1484,114.4
"15023","45302","2018",163,125,38,160164.9,1896.883,84.7362
"15024","45303","2018",6,6,0,129500,1364,100.5
"15025","45305","2018",1,1,0,135000,1406,96
"15026","45306","2018",11,11,0,136812.8,1049.545,129.8182
"15027","45307","2018",9,9,0,90001.11,1140.556,79.44444
"15028","45308","2018",21,20,1,209214.9,2009.524,106.0476
"15029","45309","2018",9,9,0,190016.7,2005.444,95.55556
"15030","45310","2018",10,10,0,151600,1649.5,97.9
"15031","45311","2018",4,4,0,185275,1376,144.5
"15032","45313","2018",13,13,0,131496.9,1381,97.84615
"15033","45314","2018",6,6,0,177110,2076,103.3333
"15034","45315","2018",63,51,12,118379.9,1398.302,85.36508
"15035","45316","2018",13,13,0,176722.2,1389.769,132.7692
"15036","45317","2018",20,20,0,190982.5,1604.6,121.2
"15037","45320","2018",1,1,0,201545,1539,131
"15038","45321","2018",10,10,0,109496,1085.4,106.6
"15039","45322","2018",2,2,0,117500,885,130
"15040","45323","2018",4,4,0,125250,1019.25,126.75
"15041","45324","2018",32,31,1,147373,1669.094,91.65625
"15042","45325","2018",1,1,0,177600,1480,120
"15043","45326","2018",5,5,0,163500,1480,110
"15044","45327","2018",34,33,1,172842.9,1762.412,101.9412
"15045","45328","2018",4,4,0,110583.5,1485,72.25
"15046","45329","2018",19,18,1,96874.68,1080.684,90.57895
"15047","45330","2018",1,1,0,299176,1644,182
"15048","45331","2018",9,9,0,135322.2,1636.333,86.55556
"15049","45332","2018",20,20,0,145600,1545.95,103.25
"15050","45333","2018",17,17,0,233360.6,1931.941,125.0588
"15051","45334","2018",9,9,0,138350,1323.111,105.2222
"15052","45335","2018",18,17,1,166591.1,1641.556,101.5556
"15053","45336","2018",5,5,0,103600,1241.8,79.8
"15054","45337","2018",6,6,0,91350,1226,90.5
"15055","45338","2018",4,4,0,185524,1429.75,133.5
"15056","45339","2018",3,3,0,113333.3,1274.667,87
"15057","45340","2018",4,4,0,144325,1644,95.5
"15058","45342","2018",4,4,0,170625,1804,97.5
"15059","45343","2018",3,3,0,168666.7,1590.667,106.3333
"15060","45344","2018",11,11,0,151690.9,1647.909,98.81818
"15061","45345","2018",13,13,0,149769.2,1207.769,121.5385
"15062","45346","2018",25,25,0,194773.4,1978.76,110.72
"15063","45347","2018",7,7,0,169675.7,1931.571,88.28571
"15064","45348","2018",5,5,0,110800,1253.8,93
"15065","46001","2018",5,5,0,59200,911.2,76.8
"15066","46003","2018",3,3,0,121666.7,2192.667,104.3333
"15067","46004","2018",3,3,0,77800,614,139.3333
"15068","46005","2018",5,5,0,215400,1760.2,124.4
"15069","46006","2018",3,3,0,144180,1504.333,100.6667
"15070","46007","2018",12,12,0,163673.3,1590.167,108.75
"15071","46008","2018",4,4,0,152139,2195.75,102.25
"15072","46009","2018",2,2,0,80382.5,1077.5,62.5
"15073","46010","2018",4,4,0,172537.5,1524.5,113
"15074","46011","2018",9,9,0,101358.7,1160.556,95
"15075","46012","2018",6,6,0,83816.67,1091,86
"15076","46013","2018",3,3,0,146000,1674.333,85
"15077","46015","2018",10,10,0,86585,926.6,94.5
"15078","46016","2018",5,5,0,259000,1651,153.2
"15079","46017","2018",2,2,0,78069.5,1367,55
"15080","46018","2018",2,2,0,120500,1386.5,84.5
"15081","46020","2018",3,3,0,93883.33,1165.333,82.33333
"15082","46021","2018",10,10,0,153149.1,1335.9,117.9
"15083","46022","2018",4,4,0,76725,1685.5,45.5
"15084","46023","2018",3,3,0,149966.7,1160.667,128
"15085","46024","2018",2,2,0,93630,1141.5,82
"15086","46026","2018",4,4,0,130916.2,910.5,138.5
"15087","46027","2018",1,1,0,75000,652,115
"15088","46028","2018",12,12,0,116816,1453.25,86.33333
"15089","46029","2018",16,16,0,131562.5,1656.688,82.25
"15090","46030","2018",5,5,0,128752,1384.2,87.6
"15091","46031","2018",3,3,0,199033.3,2307.333,87
"15092","46032","2018",5,5,0,147090,1764.8,87.8
"15093","46033","2018",6,5,1,80699.33,910.3333,105
"15094","46035","2018",2,2,0,106750,1208,97
"15095","46036","2018",2,2,0,76500,1086.5,70.5
"15096","46038","2018",14,14,0,114215,1308.714,85.78571
"15097","46039","2018",1,1,0,333000,3505,95
"15098","46040","2018",5,5,0,115960,1134,102.6
"15099","46041","2018",2,2,0,137500,2098,71.5
"15100","46042","2018",327,152,175,117768.8,1485.434,79.82569
"15101","46043","2018",4,4,0,93567.75,804.75,127.5
"15102","46044","2018",2,2,0,179975,1971,91.5
"15103","46045","2018",18,17,1,168598.9,1747.222,107.5
"15104","46046","2018",2,2,0,126675,1136,106
"15105","46047","2018",3,3,0,275991.7,1353.667,189
"15106","46049","2018",1,1,0,120000,1622,74
"15107","46050","2018",4,4,0,156772.5,1537,105.25
"15108","46051","2018",1,1,0,73000,1123,65
"15109","46052","2018",3,3,0,161833.3,1596.333,99
"15110","46053","2018",3,3,0,118161,1139.333,99.66667
"15111","46054","2018",5,5,0,134260,1441.4,99.2
"15112","46055","2018",12,10,2,162398.3,2102.167,92.08333
"15113","46056","2018",1,1,0,33900,471,72
"15114","46057","2018",4,4,0,131600,1848.25,75.75
"15115","46058","2018",10,10,0,158367,1651.3,96.3
"15116","46059","2018",3,3,0,66666.67,1044.333,67.66667
"15117","46060","2018",7,7,0,187237.1,1740.714,96.42857
"15118","46062","2018",12,12,0,149918.3,1900.333,79.66667
"15119","46063","2018",25,24,1,153178,1422.76,108.32
"15120","46064","2018",7,7,0,99884.43,1079.571,96.14286
"15121","46065","2018",6,6,0,87216.67,1055.167,77
"15122","46066","2018",8,8,0,247731.1,1818.375,132.25
"15123","46068","2018",4,4,0,105000,1384.25,74.5
"15124","46069","2018",1,1,0,125000,926,135
"15125","46070","2018",4,4,0,161275,1311.75,128.75
"15126","46072","2018",8,8,0,100800.6,1026.5,91.75
"15127","46073","2018",1,1,0,118000,1073,110
"15128","46074","2018",5,5,0,128000,1378.4,107.2
"15129","46075","2018",3,3,0,130000,1026,110
"15130","46076","2018",3,3,0,120700,1800.667,70.33333
"15131","46078","2018",1,1,0,119000,1322,90
"15132","46080","2018",7,7,0,152071.4,1743.714,92.57143
"15133","46081","2018",1,1,0,170000,642,265
"15134","46082","2018",7,7,0,213041.4,1474.857,130.5714
"15135","46083","2018",12,12,0,120275.8,1530.333,79
"15136","46084","2018",5,5,0,167360.2,1497.4,108.2
"15137","46085","2018",1,1,0,59000,738,80
"15138","46086","2018",3,3,0,138500,1334.667,102
"15139","46087","2018",8,8,0,172212.5,1738.25,97.625
"15140","46088","2018",9,9,0,151870,1285.111,112.5556
"15141","46089","2018",12,12,0,147791.5,1362.667,106.5833
"15142","46090","2018",4,4,0,67922.5,1006.75,78.5
"15143","46091","2018",3,3,0,149666.7,1258.333,108.6667
"15144","46092","2018",2,2,0,156700,1815.5,88.5
"15145","46093","2018",4,4,0,144500,1696.75,93.75
"15146","46094","2018",3,3,0,158000,1546.667,92
"15147","46095","2018",4,4,0,172950,1618.25,105
"15148","46097","2018",1,1,0,45000,500,90
"15149","46098","2018",2,2,0,113500,1845,61
"15150","46100","2018",7,7,0,142357.1,1352.714,100.7143
"15151","46101","2018",2,2,0,287500,954,247
"15152","46102","2018",131,79,52,116208.4,1479.137,79.58015
"15153","46103","2018",5,5,0,137790,1390.6,99
"15154","46104","2018",2,2,0,133000,1094.5,122
"15155","46105","2018",7,7,0,162342.9,1398.571,124.5714
"15156","46106","2018",5,5,0,98400,1708.8,58
"15157","46107","2018",3,3,0,216500,1811,123.6667
"15158","46108","2018",5,5,0,151624,1452.6,103.4
"15159","46109","2018",6,6,0,185000,1366.5,136
"15160","46111","2018",1,1,0,170000,1932,88
"15161","46112","2018",2,2,0,186000,1406.5,132.5
"15162","46113","2018",7,7,0,125978.6,1433.714,92.28571
"15163","46114","2018",3,3,0,104075.3,1033,108.3333
"15164","46116","2018",1,1,0,147000,2100,70
"15165","46117","2018",12,12,0,88106.67,1383.333,83.08333
"15166","46118","2018",11,11,0,144636.4,1344.273,112.7273
"15167","46119","2018",1,1,0,65000,1000,65
"15168","46120","2018",5,5,0,180254,1822.8,100
"15169","46121","2018",1,1,0,167600,2501,67
"15170","46122","2018",3,3,0,59166.67,1335,46.66667
"15171","46123","2018",2,2,0,117500,1429.5,77
"15172","46124","2018",5,5,0,141382,1651.2,83
"15173","46125","2018",6,6,0,153758.3,1503.667,138.1667
"15174","46127","2018",63,56,7,111841.2,1296.302,87.39683
"15175","46128","2018",32,31,1,118549.2,1315.938,90.90625
"15176","46129","2018",1,1,0,95000,1188,80
"15177","46131","2018",2,2,0,147500,1475,100
"15178","46132","2018",6,6,0,135861.7,1239.667,111.5
"15179","46133","2018",1,1,0,60000,968,62
"15180","46134","2018",6,6,0,132166.7,1430.167,94
"15181","46136","2018",5,5,0,112500,1515,83.2
"15182","46137","2018",9,9,0,170416.7,1743,100
"15183","46138","2018",14,14,0,116211.4,1201.143,94.35714
"15184","46139","2018",1,1,0,93000,1310,71
"15185","46140","2018",3,3,0,165366.7,1675,99
"15186","46142","2018",2,2,0,167000,1438.5,121
"15187","46143","2018",10,10,0,107457.7,1224.2,89
"15188","46144","2018",3,3,0,140000,1842,75
"15189","46145","2018",18,18,0,89584.44,1037.333,83.72222
"15190","46146","2018",2,2,0,132000,1105,118
"15191","46147","2018",1,1,0,1e+05,870,115
"15192","46148","2018",22,22,0,200696.4,1579.545,124.7727
"15193","46149","2018",4,4,0,162500,1299.75,139.5
"15194","46152","2018",5,5,0,118000,1494.2,92
"15195","46153","2018",7,6,1,110357.1,1328.143,82
"15196","46154","2018",6,6,0,123311.7,1590.667,78.33333
"15197","46155","2018",1,1,0,190000,2088,91
"15198","46156","2018",15,15,0,156006.7,1328.267,116.6667
"15199","46157","2018",4,4,0,92250,1069,78.25
"15200","46159","2018",4,4,0,70916.25,1393.75,48.5
"15201","46160","2018",8,8,0,82262.5,758.125,118.375
"15202","46161","2018",2,2,0,123000,1490.5,78.5
"15203","46162","2018",1,1,0,51000,477,107
"15204","46163","2018",3,3,0,59723.33,674.3333,92.33333
"15205","46164","2018",1,1,0,22000,344,64
"15206","46165","2018",5,5,0,146000,1310,103.4
"15207","46167","2018",1,1,0,128300,1833,70
"15208","46169","2018",3,3,0,236066.7,1662,132
"15209","46170","2018",11,11,0,114181.8,978.1818,111.7273
"15210","46171","2018",5,5,0,165640,1568.2,123.6
"15211","46172","2018",1,1,0,170000,2297,74
"15212","46173","2018",15,14,1,132503.3,1400.867,97.66667
"15213","46174","2018",2,2,0,187000,1300.5,142
"15214","46175","2018",7,7,0,153050,1272.571,128.5714
"15215","46176","2018",8,8,0,149562.5,1752.875,96.125
"15216","46177","2018",5,5,0,185540,1676.6,115.6
"15217","46178","2018",4,4,0,149665.8,1683.25,98.25
"15218","46179","2018",2,2,0,210967,1377,138
"15219","46180","2018",8,8,0,206762.5,1964.125,106.125
"15220","46181","2018",1,1,0,45500,1517,30
"15221","46182","2018",22,21,1,137490.3,1328.773,102.7273
"15222","46183","2018",3,3,0,109733.3,1304.333,94.33333
"15223","46184","2018",3,3,0,192666.7,1585,107
"15224","46185","2018",25,25,0,154201.6,1402.64,108.16
"15225","46186","2018",3,3,0,137000,1409.333,96.66667
"15226","46187","2018",10,10,0,127621,1155.4,104.8
"15227","46188","2018",2,2,0,187750,1179,157.5
"15228","46189","2018",3,3,0,124886.3,1530,82.66667
"15229","46190","2018",1,1,0,185000,1542,120
"15230","46191","2018",5,5,0,137692,1209.4,106.2
"15231","46192","2018",4,4,0,156525,1262.5,121.75
"15232","46193","2018",4,4,0,176000,1678.75,117.25
"15233","46194","2018",1,1,0,374500,2497,150
"15234","46195","2018",6,6,0,102333.3,1172.667,91.66667
"15235","46196","2018",2,2,0,156000,990,175
"15236","46197","2018",3,3,0,153200,1126.667,128
"15237","46198","2018",1,1,0,123000,1337,92
"15238","46199","2018",1,1,0,122520,875,140
"15239","46200","2018",4,4,0,112871.2,1630.75,78
"15240","46201","2018",32,32,0,157825.7,1670.281,97.4375
"15241","46202","2018",5,5,0,138920,1316,111.2
"15242","46203","2018",2,2,0,173300,2254.5,84.5
"15243","46204","2018",5,5,0,148700,1215.4,120.2
"15244","46205","2018",4,4,0,95500,883,104
"15245","46208","2018",6,6,0,91583.33,1271,79.5
"15246","46209","2018",6,6,0,141625,1537.5,102.6667
"15247","46210","2018",3,3,0,73333.33,870,84
"15248","46211","2018",6,6,0,166356.7,1428.667,127.8333
"15249","46213","2018",3,3,0,116666.7,1052,102.6667
"15250","46214","2018",1,1,0,136000,1511,90
"15251","46215","2018",7,6,1,124683.4,2021.143,84.71429
"15252","46216","2018",12,11,1,220294.5,1692.083,130
"15253","46217","2018",4,4,0,175550.2,1266.25,128.5
"15254","46219","2018",3,3,0,209566.7,1413.333,149.3333
"15255","46220","2018",10,9,1,152335,1590.8,93.8
"15256","46221","2018",5,5,0,216900,2114.4,106
"15257","46223","2018",5,5,0,159800,1778.4,93.8
"15258","46224","2018",47,42,5,147889.8,1655.489,94.87234
"15259","46225","2018",39,39,0,173299.5,1774.897,96.74359
"15260","46226","2018",3,3,0,90000,1139.333,82.33333
"15261","46227","2018",6,6,0,126250,1169.667,106
"15262","46228","2018",6,6,0,162136.7,1348.167,112
"15263","46229","2018",8,7,1,160331.2,1344.125,121.25
"15264","46230","2018",2,2,0,133500,1214,117.5
"15265","46231","2018",30,27,3,117045.7,1300.8,88.06667
"15266","46232","2018",5,5,0,84950,885.8,95
"15267","46233","2018",7,7,0,127871.4,1553.143,83.71429
"15268","46235","2018",1,1,0,50000,1087,46
"15269","46236","2018",2,2,0,192500,1485.5,132.5
"15270","46237","2018",4,4,0,134875,1708.5,79.75
"15271","46238","2018",2,2,0,124625,1491,82.5
"15272","46239","2018",1,1,0,230000,1438,160
"15273","46240","2018",8,7,1,185436.9,2088.5,85.75
"15274","46241","2018",2,2,0,279720,1889.5,153.5
"15275","46242","2018",2,2,0,93400,1127,82.5
"15276","46243","2018",1,1,0,120000,1600,75
"15277","46249","2018",2,2,0,110250,1724.5,67
"15278","46251","2018",39,31,8,128625.9,1397.974,92.82051
"15279","46252","2018",7,7,0,218941.4,1751,127.1429
"15280","46253","2018",4,4,0,85375,2140.25,54.25
"15281","46254","2018",1,1,0,141900,2118,67
"15282","46255","2018",1,1,0,55000,688,80
"15283","46256","2018",3,2,1,194333.3,3095.667,77.33333
"15284","46257","2018",1,1,0,217500,1359,160
"15285","46258","2018",3,3,0,257170.7,1704.667,129.3333
"15286","46259","2018",1,1,0,178500,1384,129
"15287","46262","2018",5,5,0,152460,1755.6,89
"15288","46263","2018",4,4,0,185275,1867,107.75
"15289","46264","2018",3,3,0,166000,1769,96.33333
"15290","46265","2018",5,5,0,125400,1329,94.2
"15291","46266","2018",3,3,0,189683.3,1725,110.6667
"15292","46267","2018",9,9,0,115311.1,1309.222,84.44444
"15293","46268","2018",9,9,0,137080.6,1289.778,101.7778
"15294","46270","2018",5,5,0,82000,1291,56.8
"15295","46271","2018",3,3,0,189500,1293.333,166.3333
"15296","46272","2018",3,3,0,140133.3,1208,114
"15297","46273","2018",8,7,1,197905.6,1833.25,104.75
"15298","46276","2018",3,3,0,116500,1810.667,69.33333
"15299","46277","2018",4,4,0,142000,1582.25,91
"15300","46279","2018",1,1,0,190000,3167,60
"15301","46280","2018",3,3,0,86000,1352.333,72
"15302","46281","2018",2,2,0,104896.5,1194.5,87
"15303","46282","2018",1,1,0,155000,1148,135
"15304","46283","2018",4,4,0,98000,1159.5,86
"15305","46284","2018",2,2,0,185325,1890,98
"15306","46286","2018",1,1,0,120000,1463,82
"15307","46288","2018",2,2,0,1e+05,1278,80.5
"15308","46289","2018",3,3,0,116260,1121.333,110.6667
"15309","46290","2018",4,4,0,98750,1166.25,80.75
"15310","46292","2018",4,4,0,111750,1244.75,91.75
"15311","46293","2018",6,6,0,186541.7,1668.833,120
"15312","46294","2018",1,1,0,114000,1253,91
"15313","46295","2018",4,4,0,107212.5,1371,78.5
"15314","46296","2018",2,2,0,167500,1530.5,118
"15315","46297","2018",11,11,0,149183.6,1521.182,96.27273
"15316","46299","2018",2,2,0,76250,833.5,100
"15317","46301","2018",10,10,0,128650,1482.2,93.6
"15318","46303","2018",3,3,0,108000,1240.333,80
"15319","46304","2018",2,2,0,150000,1718,102.5
"15320","46305","2018",1,1,0,256000,2977,86
"15321","46306","2018",1,1,0,190000,1827,104
"15322","46307","2018",6,6,0,119166.7,1562.833,91.66667
"15323","46308","2018",1,1,0,128250,1603,80
"15324","46309","2018",33,21,12,106452.1,1193.515,89.27273
"15325","46310","2018",3,3,0,112833.3,1144.333,97.33333
"15326","46311","2018",15,15,0,70045.33,815.8667,87.4
"15327","46312","2018",2,2,0,88000,1559.5,54.5
"15328","46313","2018",5,5,0,154965,1707.6,95.6
"15329","46314","2018",1,1,0,125000,446,280
"15330","46315","2018",2,2,0,92500,1458.5,65
"15331","46316","2018",4,4,0,105500,1464.75,80.25
"15332","46317","2018",3,3,0,102666.7,1597.333,69.66667
"15333","46318","2018",3,3,0,101833.3,865,111
"15334","46319","2018",5,5,0,139000,1057.8,134.8
"15335","46320","2018",4,4,0,85828,906.5,96.5
"15336","46321","2018",5,5,0,126210,1245,107.8
"15337","46322","2018",3,3,0,224416.7,1641.667,133.6667
"15338","46323","2018",2,2,0,158700,1717,93
"15339","46324","2018",3,3,0,152150,1523.333,94.33333
"15340","46328","2018",5,5,0,149788,1364.8,113
"15341","46329","2018",4,4,0,188476.5,1602.75,115.25
"15342","46330","2018",15,15,0,102468.8,1352.733,74.53333
"15343","46332","2018",1,1,0,130000,2500,52
"15344","46333","2018",2,2,0,79600,1112.5,71
"15345","46334","2018",18,18,0,166147.2,1683.556,99.16667
"15346","46335","2018",2,2,0,235750,2004.5,118
"15347","46336","2018",4,4,0,117250,1055.5,122.75
"15348","46337","2018",3,3,0,157337,1684,93.66667
"15349","46338","2018",1,1,0,115000,742,155
"15350","46339","2018",4,4,0,98525,1010.25,97.25
"15351","46340","2018",3,3,0,133500,1121.333,124.6667
"15352","47001","2018",662,266,396,99754.12,1352.61,75.02719
"15353","47003","2018",10,10,0,226619.2,1544.5,146.2
"15354","47004","2018",64,61,3,104782.1,987.875,105.5938
"15355","47005","2018",4,4,0,161462.5,1918.25,96.5
"15356","47006","2018",5,5,0,152510,1324.8,121.6
"15357","47007","2018",5,5,0,156250,1508.8,109
"15358","47008","2018",3,3,0,85000,815.6667,105.3333
"15359","47009","2018",1,1,0,105000,465,226
"15360","47011","2018",1,1,0,280000,2393,117
"15361","47012","2018",3,3,0,139700,1286.333,106
"15362","47013","2018",8,8,0,131725,1109,116.875
"15363","47014","2018",4,4,0,208405.2,1477.5,151.25
"15364","47015","2018",16,16,0,140112.5,1271.5,116.25
"15365","47016","2018",12,12,0,168670.8,1441.917,131
"15366","47018","2018",2,2,0,139500,1085.5,128.5
"15367","47019","2018",6,6,0,201583.3,1726,120.8333
"15368","47020","2018",3,3,0,309120,2094.333,130.6667
"15369","47021","2018",18,17,1,118379.4,1117.444,109.5
"15370","47022","2018",9,9,0,140738.9,1143.444,121.6667
"15371","47023","2018",4,4,0,324552.5,2058,177.25
"15372","47024","2018",18,18,0,192555.1,1697.5,114.1667
"15373","47025","2018",5,5,0,184600,1400.4,120
"15374","47026","2018",2,2,0,259325,1544.5,176
"15375","47027","2018",43,43,0,135910.1,1349.233,104.8605
"15376","47028","2018",5,5,0,77100,865.4,76.6
"15377","47029","2018",4,4,0,209875,1891.5,102.75
"15378","47030","2018",3,3,0,123366.7,1533.333,73
"15379","47031","2018",74,63,11,158307.5,1652.743,92.43243
"15380","47032","2018",66,61,5,144427.7,1532.924,96.10606
"15381","47033","2018",2,2,0,156750,1544.5,97.5
"15382","47034","2018",5,5,0,112200,977.2,127.4
"15383","47035","2018",5,5,0,143460,1301,106.6
"15384","47036","2018",3,3,0,289833.3,2420,153.3333
"15385","47038","2018",11,11,0,138786.4,1110.091,133.8182
"15386","47039","2018",1,1,0,90000,750,120
"15387","47040","2018",17,17,0,180091.6,1784.235,102.2941
"15388","47041","2018",6,6,0,145500,1332.667,107.8333
"15389","47042","2018",3,3,0,160666.7,1321.333,129.3333
"15390","47043","2018",22,22,0,98500,1006.182,107.7273
"15391","47044","2018",4,4,0,146029,1136.25,123
"15392","47045","2018",4,4,0,109000,1086,102
"15393","47046","2018",5,5,0,162726,1788.2,101.6
"15394","47047","2018",3,3,0,300666.7,1684,167.3333
"15395","47048","2018",18,17,1,126251.6,1392,92.72222
"15396","47049","2018",24,24,0,87365.29,979.0417,88.125
"15397","47051","2018",21,17,4,168402.4,1915.238,96.71429
"15398","47052","2018",74,58,16,120570.3,1395.338,87.90541
"15399","47053","2018",2,2,0,61857,624.5,88.5
"15400","47054","2018",24,24,0,130528.3,1512.25,94.20833
"15401","47055","2018",9,6,3,75055.56,947.2222,86
"15402","47056","2018",3,3,0,278166.7,1849.333,146.6667
"15403","47057","2018",25,24,1,121453.6,1080.72,117.92
"15404","47058","2018",2,2,0,106000,1629,65
"15405","47059","2018",3,3,0,184333.3,2107.333,87.33333
"15406","47060","2018",13,13,0,140000,1282.538,115.9231
"15407","47061","2018",8,8,0,83787.5,799.125,102.75
"15408","47062","2018",5,5,0,159894,1445.6,109.8
"15409","47063","2018",2,2,0,95500,1046,96
"15410","47064","2018",3,3,0,126347.7,1372.667,106.6667
"15411","47065","2018",34,33,1,110605.9,983.5882,118.8235
"15412","47066","2018",13,13,0,148510,1248.385,123.3846
"15413","47067","2018",7,7,0,121207,1144,111.5714
"15414","47068","2018",11,11,0,137187.6,1212.636,115.8182
"15415","47069","2018",30,29,1,156030,1595.233,99.46667
"15416","47070","2018",13,13,0,95576.92,1029.846,98.46154
"15417","47071","2018",4,4,0,161183.8,1142.25,142.75
"15418","47072","2018",1,1,0,140000,2090,67
"15419","47073","2018",2,2,0,97500,1396,65
"15420","47074","2018",5,5,0,83100,835.2,115.4
"15421","47075","2018",12,12,0,169747.7,1597.667,103.75
"15422","47077","2018",8,8,0,136063.8,1146.5,120.625
"15423","47078","2018",15,13,2,107966.7,1146,97.53333
"15424","47079","2018",9,9,0,124800,1124.556,115.8889
"15425","47080","2018",2,2,0,115500,1282.5,87
"15426","47081","2018",7,7,0,124457.1,1081.143,121.2857
"15427","47082","2018",2,2,0,130000,1174,104
"15428","47083","2018",3,3,0,174000,1102.333,155
"15429","47084","2018",6,6,0,163750,1620.833,103.8333
"15430","47085","2018",5,5,0,98100,821.8,118.6
"15431","47086","2018",18,15,3,161103.4,2313,98.05556
"15432","47087","2018",2,2,0,295000,2976,90
"15433","47088","2018",8,7,1,132162.5,1275.875,102.875
"15434","47089","2018",2,2,0,163591,1348.5,124.5
"15435","47091","2018",25,21,4,152745.6,1667.24,91.64
"15436","47092","2018",6,6,0,202558.3,1743.833,117.8333
"15437","47093","2018",5,5,0,87836.2,1592.2,73.4
"15438","47094","2018",3,3,0,127666.7,1215,104.6667
"15439","47095","2018",11,11,0,161504.6,2053.273,100.2727
"15440","47096","2018",1,1,0,194047,1294,150
"15441","47097","2018",4,4,0,122500,1098.25,116.5
"15442","47098","2018",3,3,0,218020,1146.333,192.3333
"15443","47099","2018",5,5,0,207260,1638.6,122.6
"15444","47100","2018",59,56,3,190947.1,1681.644,115.6949
"15445","47101","2018",16,16,0,157529,1253.062,119.6875
"15446","47102","2018",6,6,0,161219.2,1179.333,135.5
"15447","47103","2018",1,1,0,322000,2385,135
"15448","47104","2018",7,7,0,166957.1,1358.286,121.1429
"15449","47105","2018",3,3,0,126893.3,1438,93.66667
"15450","47106","2018",59,55,4,86938.39,967.9831,91.91525
"15451","47107","2018",3,3,0,89000,1235.667,76.66667
"15452","47108","2018",1,1,0,80000,808,99
"15453","47109","2018",4,4,0,107820,1273.75,84
"15454","47110","2018",17,17,0,93567.65,1053.706,93.58824
"15455","47111","2018",10,10,0,108400,1221.6,92.8
"15456","47112","2018",5,5,0,166632,1877.6,98
"15457","47114","2018",4,4,0,148500,1172.25,123.5
"15458","47115","2018",5,5,0,152233,1735.2,96
"15459","47117","2018",7,7,0,147857.1,1355.714,108.5714
"15460","47118","2018",3,3,0,140666.7,1547.333,91
"15461","47119","2018",9,9,0,89855.56,984.6667,104.3333
"15462","47120","2018",1,1,0,17500,407,43
"15463","47121","2018",3,3,0,173800,1491.333,114.6667
"15464","47122","2018",2,2,0,42083.5,494,86
"15465","47123","2018",7,7,0,102428.6,977.8571,105.2857
"15466","47125","2018",5,5,0,131800,917,145.8
"15467","47127","2018",11,11,0,157318.2,1577.091,108.1818
"15468","47128","2018",22,15,7,117175,1362.318,86.5
"15469","47129","2018",3,3,0,88426.67,929,96
"15470","47130","2018",7,7,0,118984.3,898.8571,127.4286
"15471","47131","2018",5,5,0,161960,1647.8,103.6
"15472","47132","2018",6,6,0,221668.3,1757.167,125.1667
"15473","47133","2018",4,4,0,164850,1405,112
"15474","47134","2018",3,3,0,222000,1484.333,138
"15475","47135","2018",6,6,0,103311.7,1024.833,105.3333
"15476","47136","2018",3,3,0,93333.33,1849.667,66.66667
"15477","47137","2018",16,16,0,202256.9,1844.875,111.75
"15478","47138","2018",18,18,0,174631.7,1666.889,104.8889
"15479","47139","2018",1,1,0,252000,1738,145
"15480","47140","2018",12,12,0,190620.2,1398.167,133
"15481","47141","2018",5,5,0,182154,1876.2,98.6
"15482","47142","2018",16,16,0,148937.5,1143.938,123.4375
"15483","47143","2018",28,28,0,126621.2,1255.286,97.85714
"15484","47144","2018",9,9,0,118049.6,1144.444,98.66667
"15485","47145","2018",37,32,5,146595.9,1433.405,102.1892
"15486","47146","2018",10,10,0,164328,1477.4,114.5
"15487","47147","2018",8,8,0,121783.8,1257.125,98.875
"15488","47148","2018",3,3,0,163666.7,1194.333,149.6667
"15489","47150","2018",1,1,0,165000,786,210
"15490","47151","2018",9,9,0,180944.4,1507.222,114.7778
"15491","47152","2018",5,5,0,92964,1048.4,93.8
"15492","47154","2018",4,4,0,305446.2,1822.75,171.5
"15493","47155","2018",11,11,0,191768.2,1502.091,125
"15494","47156","2018",8,8,0,121500,1199,104.75
"15495","47157","2018",272,204,68,119183.5,1358.081,88.5
"15496","47158","2018",1,1,0,399990,2222,180
"15497","47159","2018",12,12,0,102916.7,1072.583,94.75
"15498","47162","2018",4,4,0,161550,1385.75,117.75
"15499","47163","2018",3,3,0,2e+05,1139.667,174.3333
"15500","47164","2018",1,1,0,350000,2917,120
"15501","47165","2018",15,15,0,169047.5,1150.667,147.7333
"15502","47167","2018",13,13,0,133638.7,1317.923,100.1538
"15503","47168","2018",43,41,2,82352.19,944.6744,87.97674
"15504","47169","2018",9,9,0,176827.8,1669.111,106.7778
"15505","47170","2018",8,8,0,130722.5,1062.625,121.25
"15506","47171","2018",4,4,0,173512.5,1180.5,149.75
"15507","47172","2018",7,7,0,176292.9,1477,128.2857
"15508","47173","2018",8,8,0,100062.5,965.75,111
"15509","47174","2018",12,12,0,186375,1621.833,107
"15510","47175","2018",42,40,2,152114.5,1474.071,100.7857
"15511","47177","2018",1,1,0,36500,545,67
"15512","47178","2018",3,3,0,77566.67,1071.667,73
"15513","47179","2018",24,22,2,92770.83,960.8333,93.625
"15514","47180","2018",8,8,0,139643.8,1300,107
"15515","47181","2018",5,5,0,113600,1454.4,87.4
"15516","47183","2018",4,4,0,160662.5,1117.25,141
"15517","47184","2018",3,3,0,245666.7,2125.667,121.6667
"15518","47185","2018",38,38,0,100729.9,1159.921,90.97368
"15519","47186","2018",8,8,0,252206.2,1736,140.875
"15520","47187","2018",6,6,0,159166.7,1149.167,132.1667
"15521","47188","2018",4,4,0,116296,1033.5,113
"15522","47190","2018",5,5,0,117900,1113,98.4
"15523","47191","2018",7,7,0,197865,1793.714,111.8571
"15524","47194","2018",6,6,0,146231.5,1228.167,116.3333
"15525","47195","2018",95,87,8,133249.3,1284.347,106.1684
"15526","47196","2018",4,4,0,71125,1124,66
"15527","47197","2018",3,3,0,208325.3,1333,165.6667
"15528","47198","2018",2,2,0,206500,2292,89.5
"15529","47199","2018",6,6,0,251641.2,1300.333,172.6667
"15530","47200","2018",2,2,0,307334,1614,188.5
"15531","47201","2018",178,155,23,133528.6,1510.393,89.26966
"15532","47202","2018",6,6,0,292516.7,1917.5,122.5
"15533","47203","2018",35,34,1,141568.6,1257,116.5143
"15534","47204","2018",3,3,0,146833.3,1843,98
"15535","47206","2018",4,4,0,212462.5,1407,153.5
"15536","47207","2018",2,2,0,161325,1815,89
"15537","47208","2018",2,2,0,138300,1583,90.5
"15538","47209","2018",43,41,2,176124.2,1632.721,111.3953
"15539","47210","2018",17,17,0,135451.4,1498.882,101.2941
"15540","47211","2018",1,1,0,43650,469,93
"15541","47212","2018",5,5,0,212000,1837,116
"15542","47213","2018",8,8,0,185300,1418,133.125
"15543","47214","2018",5,5,0,142543.8,1210.4,117
"15544","47215","2018",63,60,3,142518.3,1408.238,102.4127
"15545","47216","2018",9,9,0,136338.9,1029.333,125.6667
"15546","47217","2018",10,9,1,110490,1078.4,102.1
"15547","47218","2018",4,4,0,203912.5,1479,142.25
"15548","47219","2018",2,2,0,154500,1361,134.5
"15549","47220","2018",6,6,0,179250,1271,138.6667
"15550","47221","2018",8,8,0,89875,996.25,88.75
"15551","47222","2018",7,7,0,201598.7,1351.286,141.2857
"15552","47223","2018",1,1,0,80000,1333,60
"15553","47224","2018",3,3,0,81433.33,963.6667,94
"15554","47225","2018",15,15,0,186826,1835.867,105.9333
"15555","47226","2018",7,7,0,149597.1,1403,104.1429
"15556","47228","2018",6,6,0,151920.2,1286.5,122.3333
"15557","47229","2018",1,1,0,146500,1831,80
"15558","47230","2018",4,4,0,164728.8,1391,114.5
"15559","47231","2018",2,2,0,180500,1569.5,115
"15560","47232","2018",6,6,0,143045.8,1347.833,104.5
"15561","47233","2018",42,42,0,144136.8,1404.714,103.6429
"15562","47234","2018",9,8,1,159913,1321.778,110.6667
"15563","47235","2018",8,8,0,143083.2,1395.125,102.375
"15564","47236","2018",1,1,0,252000,2000,126
"15565","47237","2018",4,4,0,186781.2,1589.75,118
"15566","47238","2018",15,15,0,190800,1913.933,111.4667
"15567","47239","2018",6,6,0,121508.3,1040.333,118.1667
"15568","47240","2018",4,4,0,411750,2435.25,137.5
"15569","47241","2018",8,8,0,148631.2,1251,120.25
"15570","47242","2018",5,5,0,76800,929,87.4
"15571","47244","2018",2,2,0,174650,1646.5,108
"15572","47245","2018",1,1,0,112000,1120,100
"15573","47246","2018",15,15,0,151407.7,1318.467,120.6667
"15574","47247","2018",3,3,0,167168.3,1640.667,101.6667
"15575","47248","2018",5,5,0,259850,2258.6,106.6
"15576","47249","2018",8,8,0,91902.5,1034.125,101.75
"15577","47250","2018",1,1,0,152000,1160,131
"15578","47251","2018",4,4,0,153000,1398.25,108.5
"15579","47252","2018",74,72,2,122968.9,1232.77,99.32432
"15580","47253","2018",8,8,0,172706.2,1554.375,112.125
"15581","47254","2018",2,2,0,120500,896,144
"15582","47255","2018",6,6,0,332933.3,2180.333,150.3333
"15583","47256","2018",2,2,0,108000,1349,77.5
"15584","47257","2018",5,5,0,178000,1366.2,138.2
"15585","47258","2018",6,6,0,103200,1096.833,85.5
"15586","47259","2018",2,2,0,135000,1299,104.5
"15587","47260","2018",13,13,0,115890,1231.538,92.53846
"15588","47262","2018",2,2,0,161250,919,172
"15589","47263","2018",6,6,0,125778.3,1200.667,110.6667
"15590","47264","2018",18,18,0,101065.2,1170.667,87.61111
"15591","47265","2018",11,11,0,119857.3,1065,121.8182
"15592","47266","2018",4,4,0,96250,1524,67
"15593","47267","2018",3,3,0,119066.7,993.3333,128.3333
"15594","47269","2018",11,11,0,147516.1,1519.273,100.8182
"15595","47271","2018",4,4,0,123000,1225.25,93
"15596","47272","2018",3,3,0,136000,1095,123
"15597","47273","2018",1,1,0,88500,790,112
"15598","47274","2018",4,4,0,153750,1346.75,131.25
"15599","47275","2018",2,2,0,61750,739,80
"15600","47276","2018",4,4,0,158750,1795.5,98.75
"15601","47277","2018",1,1,0,258500,1783,145
"15602","47278","2018",7,7,0,198482.7,1164,155.4286
"15603","47279","2018",7,7,0,102857.1,1005.571,100
"15604","47280","2018",24,24,0,155883.2,1528.25,100.7917
"15605","47281","2018",2,2,0,252495,982.5,257
"15606","47283","2018",13,13,0,113269.8,1108,102.2308
"15607","47284","2018",3,3,0,217890,1342,144.6667
"15608","47285","2018",3,3,0,177260,1638,109
"15609","47286","2018",1,1,0,165000,1138,145
"15610","47287","2018",2,2,0,127250,954.5,171
"15611","47288","2018",6,6,0,280625,1939,147.8333
"15612","47289","2018",3,3,0,141683.3,1298.333,109
"15613","47290","2018",9,9,0,147627.8,1109,146.7778
"15614","47291","2018",8,8,0,156225,1413.375,117.375
"15615","47292","2018",8,8,0,180175,1618.875,103
"15616","47293","2018",3,3,0,94666.67,1117.333,85.33333
"15617","47295","2018",3,3,0,156666.7,1095.667,140.6667
"15618","47296","2018",4,4,0,107250,1066,105.5
"15619","47297","2018",2,2,0,62500,1256.5,61.5
"15620","47298","2018",1,1,0,201200,1341,150
"15621","47299","2018",3,3,0,127000,1823.333,75.66667
"15622","47300","2018",8,8,0,126166.2,1274.5,102.125
"15623","47301","2018",14,14,0,123232.7,1257.429,97.85714
"15624","47302","2018",7,6,1,64355,711.7143,91.71429
"15625","47303","2018",2,2,0,129000,967,131
"15626","47305","2018",2,2,0,116000,1062,107.5
"15627","47306","2018",7,7,0,95900,1325,72.57143
"15628","47307","2018",5,5,0,240400,2784,117.2
"15629","47309","2018",6,6,0,181823.3,1548.833,119.8333
"15630","47310","2018",102,91,11,106043.6,1173.49,89.17647
"15631","47311","2018",3,3,0,107766.7,1053.667,95.66667
"15632","47312","2018",5,5,0,95218.4,1042.6,89.2
"15633","47313","2018",1,1,0,166000,1495,111
"15634","47314","2018",1,1,0,1e+05,1299,77
"15635","47315","2018",11,11,0,141482.5,1256.909,113.8182
"15636","47316","2018",4,4,0,142175,1329.5,109.25
"15637","47317","2018",6,6,0,62066.67,1086.167,63.33333
"15638","47318","2018",15,14,1,110480,1228.933,92.06667
"15639","47319","2018",4,4,0,133125,1047.75,134.25
"15640","47320","2018",4,4,0,160239.5,1496.5,134.5
"15641","47321","2018",4,4,0,159517.5,1739.75,99.5
"15642","47323","2018",359,301,58,111060,1168.691,95.13928
"15643","47324","2018",37,36,1,107022,1291.676,92.48649
"15644","47325","2018",3,3,0,101666.7,719.3333,137.6667
"15645","47326","2018",19,19,0,211402.5,1744.158,121.4211
"15646","47327","2018",5,5,0,139914,1145.6,107.4
"15647","47328","2018",4,4,0,196699,1424.5,140.75
"15648","48001","2018",2,1,1,80000,966.5,100
"15649","48002","2018",3,3,0,168226.7,1536,111.3333
"15650","48003","2018",4,3,1,70500,1316.5,56.25
"15651","48004","2018",5,4,1,161400,1159.8,121.6
"15652","48005","2018",1,1,0,140000,1609,87
"15653","48008","2018",4,4,0,96887.5,933.5,97.25
"15654","48009","2018",21,18,3,124609.7,1389.429,92.14286
"15655","48012","2018",3,3,0,78300,652,100
"15656","48013","2018",8,4,4,129862.2,1389.25,102.875
"15657","48015","2018",4,4,0,94975,1520.25,72.25
"15658","48016","2018",6,6,0,181205,1901.167,98.83333
"15659","48017","2018",7,7,0,111000,1250.286,86.85714
"15660","48018","2018",8,8,0,124326.8,1272.125,94.875
"15661","48019","2018",2,2,0,97900,998.5,82.5
"15662","48021","2018",1,1,0,81320,1145,71
"15663","48025","2018",3,3,0,146100,1302.333,121.6667
"15664","48027","2018",15,13,2,97636.33,1184.933,88
"15665","48028","2018",2,2,0,50500,1105,45
"15666","48030","2018",4,4,0,203850,1548.25,145.75
"15667","48032","2018",1,1,0,315000,2100,150
"15668","48034","2018",21,17,4,107330.5,1376.333,79.57143
"15669","48036","2018",2,2,0,79400,974,81
"15670","48037","2018",1,1,0,47000,627,75
"15671","48038","2018",7,7,0,60000,807.1429,74.71429
"15672","48039","2018",9,8,1,158361,1699.667,102.7778
"15673","48042","2018",5,2,3,288328,2374.8,109.4
"15674","48043","2018",5,5,0,72720,757.4,109
"15675","48044","2018",1,1,0,158000,1519,104
"15676","48045","2018",5,5,0,100800,1117.4,89.8
"15677","48046","2018",1,1,0,20000,345,58
"15678","48048","2018",2,2,0,71500,937,77.5
"15679","48050","2018",2,2,0,138360,1444,93.5
"15680","48051","2018",2,1,1,77500,1830,41
"15681","48053","2018",3,2,1,42500,669,73
"15682","48055","2018",2,2,0,47500,1171,69.5
"15683","48056","2018",5,5,0,147200,1787.8,85
"15684","48058","2018",1,1,0,145200,1210,120
"15685","48061","2018",22,20,2,120645.5,1356.636,87.68182
"15686","48063","2018",5,5,0,81800,727.6,94.2
"15687","48064","2018",3,3,0,65233.33,836.6667,76.66667
"15688","48065","2018",1,1,0,40000,571,70
"15689","48067","2018",1,1,0,181500,1815,100
"15690","48069","2018",1,1,0,55000,696,79
"15691","48070","2018",6,5,1,58833.33,753.1667,88.33333
"15692","48072","2018",2,2,0,62000,933.5,70
"15693","48073","2018",1,1,0,150000,1429,105
"15694","48074","2018",3,3,0,175730,1659.667,103.6667
"15695","48075","2018",10,8,2,136795,1811.1,78.9
"15696","48079","2018",3,2,1,85500,902.3333,83.33333
"15697","48080","2018",24,15,9,91109.67,1166.333,79.875
"15698","48081","2018",2,2,0,127500,1909,66.5
"15699","48082","2018",1,1,0,238000,1664,143
"15700","48083","2018",6,6,0,65416.67,837.5,89.66667
"15701","48086","2018",3,3,0,47000,773.3333,64.33333
"15702","48087","2018",3,3,0,55000,673.3333,86.66667
"15703","48088","2018",2,2,0,142500,2791.5,50
"15704","48089","2018",3,3,0,61000,675.6667,92.66667
"15705","48090","2018",8,8,0,129968.8,1293.75,104.375
"15706","48092","2018",45,27,18,117412.4,1328.533,86.51111
"15707","48094","2018",9,9,0,406625.6,2983.778,99.22222
"15708","48095","2018",83,38,45,132392.3,1541.398,87.87952
"15709","48096","2018",6,6,0,84828.33,885,92.16667
"15710","48097","2018",4,4,0,131125,1507.75,86.75
"15711","48098","2018",3,3,0,192183.3,1193.667,159.3333
"15712","48099","2018",16,16,0,127578.1,1308.875,102.5625
"15713","48100","2018",1,1,0,82000,1206,68
"15714","48103","2018",9,8,1,143955.6,1304.889,106
"15715","48104","2018",3,3,0,122686.7,1116.667,106.3333
"15716","48105","2018",3,2,1,207166.7,1390,150.3333
"15717","48106","2018",1,1,0,120000,1967,61
"15718","48107","2018",2,2,0,90500,943.5,115
"15719","48111","2018",1,1,0,65550,1425,46
"15720","48112","2018",1,1,0,78500,818,96
"15721","48115","2018",2,2,0,40000,535.5,91
"15722","48116","2018",3,3,0,102783.3,1879.333,50.33333
"15723","48117","2018",4,4,0,118850,1362.75,87.75
"15724","48119","2018",3,3,0,98666.67,853.3333,112.6667
"15725","48121","2018",2,2,0,132775,848,146
"15726","48124","2018",2,2,0,203927,2096.5,94.5
"15727","48126","2018",3,3,0,112900,1164.667,103.3333
"15728","48127","2018",11,10,1,90090.91,1029.364,98.09091
"15729","48128","2018",6,6,0,109883.3,1474.333,74.33333
"15730","48129","2018",4,4,0,125775,1518.75,83
"15731","48130","2018",1,1,0,43000,1075,40
"15732","48131","2018",3,3,0,127373.3,1515.333,85.66667
"15733","48132","2018",16,16,0,92862,972.25,94.125
"15734","48135","2018",1,1,0,70000,875,80
"15735","48136","2018",3,3,0,92398.67,1075.667,99.33333
"15736","48137","2018",2,1,1,154500,3178,63.5
"15737","48139","2018",3,3,0,66600,1095.667,61.66667
"15738","48140","2018",40,31,9,107148.5,1266,87.075
"15739","48141","2018",1,1,0,570000,2740,208
"15740","48144","2018",2,2,0,81500,876,90.5
"15741","48146","2018",11,10,1,92730,1275,88.27273
"15742","48147","2018",6,6,0,86500,1072.333,78.33333
"15743","48148","2018",9,9,0,173626.9,1414.444,112.8889
"15744","48149","2018",1,1,0,20000,333,60
"15745","48150","2018",1,1,0,78450,923,85
"15746","48151","2018",2,2,0,93380,1297,72
"15747","48152","2018",3,3,0,320733.3,2702,119
"15748","48155","2018",8,8,0,149075,1704.5,81.875
"15749","48156","2018",7,7,0,75954.29,1025.857,75.57143
"15750","48158","2018",2,2,0,210000,2035.5,104.5
"15751","48160","2018",5,5,0,94093.8,866.8,104
"15752","48161","2018",1,1,0,1e+05,1163,86
"15753","48163","2018",3,3,0,202815,2268.667,92
"15754","48165","2018",1,1,0,50000,758,66
"15755","48166","2018",2,2,0,58250,741,80
"15756","48168","2018",2,2,0,97500,1125.5,125
"15757","48170","2018",6,6,0,114250,1426.333,92
"15758","48173","2018",2,2,0,68250,1181,57.5
"15759","48174","2018",1,1,0,1e+05,1250,80
"15760","48175","2018",3,3,0,126850,1267.333,99.33333
"15761","48178","2018",1,0,1,120750,1725,70
"15762","48179","2018",1,1,0,223542,1016,220
"15763","48181","2018",1,1,0,86500,1169,74
"15764","48185","2018",3,3,0,169666.7,1817.667,105.6667
"15765","48187","2018",1,1,0,142500,1979,72
"15766","48188","2018",1,0,1,95000,1267,75
"15767","48190","2018",1,1,0,124950,1865,67
"15768","48191","2018",1,1,0,108610,1025,106
"15769","48193","2018",4,4,0,114157.5,1904.75,59
"15770","48194","2018",11,9,2,59754.55,1149.091,54
"15771","48198","2018",6,3,3,51758.33,1116.333,56.66667
"15772","49002","2018",32,32,0,134257.8,1333.688,101.9062
"15773","49003","2018",21,21,0,157169.1,1388.333,113.381
"15774","49007","2018",2615,652,1963,154724.3,2134.385,71.6914
"15775","49008","2018",9,9,0,134555.6,1077.556,122.5556
"15776","49009","2018",1,1,0,130641,1613,81
"15777","49010","2018",1,1,0,144000,1059,136
"15778","49011","2018",4,4,0,156500,1166.5,132.25
"15779","49012","2018",1,1,0,110000,965,114
"15780","49015","2018",188,131,57,238340.3,2212.346,108.234
"15781","49017","2018",9,9,0,148666.7,1351.333,106.4444
"15782","49018","2018",149,147,2,120517.2,1173.054,104.2282
"15783","49020","2018",51,40,11,248519.1,2301.98,108.6471
"15784","49021","2018",84,84,0,143845,1507.94,97.67857
"15785","49022","2018",11,11,0,181363.6,1521.273,118.1818
"15786","49023","2018",226,208,18,126911.9,1292.907,99.19469
"15787","49026","2018",27,27,0,153763,1542.444,103.0741
"15788","49027","2018",10,10,0,132490,1305.1,98.7
"15789","49029","2018",17,17,0,182871.6,1709.176,110.7059
"15790","49030","2018",10,10,0,102100,1077.7,97.1
"15791","49035","2018",68,67,1,311879.7,2339.559,133.6912
"15792","49036","2018",8,8,0,129409.8,842.875,156.875
"15793","49038","2018",3,3,0,50441.33,682.6667,75
"15794","49041","2018",16,16,0,131391.9,1321.688,104.9375
"15795","49045","2018",4,4,0,86250,929.25,99.75
"15796","49048","2018",38,36,2,178929.8,1804.605,100.6316
"15797","49050","2018",112,105,7,175793.1,1640.357,108.3393
"15798","49053","2018",4,4,0,81875,993,78.5
"15799","49054","2018",40,35,5,99650,1046.925,99.325
"15800","49055","2018",18,17,1,207605.6,2023.333,104.8889
"15801","49057","2018",2,2,0,106500,1444.5,74.5
"15802","49058","2018",8,8,0,128437.5,1331.75,99.75
"15803","49060","2018",27,27,0,138596.7,1401.481,99.51852
"15804","49061","2018",8,8,0,118649.1,1118.125,101.5
"15805","49063","2018",77,64,13,160652.7,1718.247,95.01299
"15806","49064","2018",3,3,0,254966.7,1608,144
"15807","49068","2018",17,17,0,142654.4,1446.765,102.4706
"15808","49069","2018",164,162,2,149654.6,1563.939,100.872
"15809","49070","2018",12,12,0,150504.2,1319.083,110
"15810","49076","2018",13,13,0,145730.8,1225.923,126.9231
"15811","49080","2018",82,80,2,137699.9,1304.976,108.6341
"15812","49082","2018",12,12,0,154712.5,1318.583,118.6667
"15813","49086","2018",27,26,1,128735.2,1348.926,99.77778
"15814","49089","2018",15,15,0,141693.5,1331.6,108.1333
"15815","49090","2018",18,18,0,145069.4,1366.722,112.1111
"15816","49092","2018",187,184,3,119090.4,1212.043,99.16043
"15817","49099","2018",770,562,208,141169.5,1558.39,89.9039
"15818","49100","2018",10,10,0,130115.2,1344.1,105.3
"15819","49102","2018",1,1,0,86000,896,96
"15820","49107","2018",6,6,0,185750,1795.667,103.8333
"15821","49109","2018",21,21,0,113449.9,1209.333,99
"15822","49110","2018",21,20,1,191311,1850.19,117
"15823","49112","2018",5,5,0,299000,1332,194
"15824","49113","2018",5,5,0,101080,1048,92
"15825","49120","2018",16,16,0,158775,1688.75,98.6875
"15826","49121","2018",4,4,0,99000,1369.25,78.5
"15827","49123","2018",23,23,0,187090,1737.957,106.9565
"15828","49125","2018",131,130,1,131824.1,1332.809,102.1221
"15829","49127","2018",41,40,1,106652.1,1212.951,89.78049
"15830","49129","2018",56,53,3,216731.5,2051.214,107.9107
"15831","49130","2018",7,7,0,237714.3,1861.571,135
"15832","49131","2018",8,8,0,137531.2,1241.75,108.5
"15833","49132","2018",22,22,0,148127.7,1419.5,108.9545
"15834","49135","2018",5,5,0,246344,1482.8,168.6
"15835","49138","2018",27,27,0,121373.8,1240.222,103.6296
"15836","49140","2018",10,10,0,114700,1222.7,95.6
"15837","49155","2018",11,11,0,167041.3,1566,111.3636
"15838","49160","2018",20,20,0,152175,1557.7,99.3
"15839","49161","2018",5,5,0,128640,1139.2,107
"15840","49163","2018",27,27,0,155648.1,1271.259,124.7778
"15841","49167","2018",51,51,0,243368.3,1918.49,124.4706
"15842","49170","2018",14,14,0,152084,1327.714,118.1429
"15843","49171","2018",4,4,0,101500,1624.75,63.25
"15844","49174","2018",19,19,0,133422.1,1248.053,109
"15845","49176","2018",54,53,1,159004.9,1582.315,100.3519
"15846","49178","2018",6,6,0,114416.7,958.1667,109.5
"15847","49180","2018",59,59,0,116182.8,1216.627,98.49153
"15848","49182","2018",5,5,0,144000,1396,103.4
"15849","49183","2018",44,44,0,134243.2,1330.045,100.7955
"15850","49188","2018",8,8,0,130687.5,1297.75,100.125
"15851","49192","2018",34,34,0,141168.2,1357.794,101.5294
"15852","49193","2018",47,47,0,120020.2,1255.489,95.80851
"15853","49194","2018",56,52,4,161423.3,1717.482,104.4821
"15854","49195","2018",7,7,0,159857.1,1534.429,100.5714
"15855","49200","2018",56,53,3,187874.6,1875.571,102.25
"15856","49201","2018",24,24,0,160721.2,1572.833,107.2083
"15857","49205","2018",10,10,0,164880,1368.6,113.6
"15858","49209","2018",5,5,0,133800,1163.4,128.2
"15859","49211","2018",10,10,0,140850,1210.4,116
"15860","49214","2018",82,72,10,212650.7,2066.988,103.6463
"15861","49215","2018",35,35,0,118645.7,1213.857,99.94286
"15862","49216","2018",5,5,0,154800,1431.6,107.2
"15863","49217","2018",13,13,0,141423.2,1569.769,89.46154
"15864","49218","2018",155,154,1,113588.3,1175.271,95.85161
"15865","49219","2018",10,10,0,152750,1612.4,98.8
"15866","49220","2018",39,39,0,120881.8,1210.974,105.6923
"15867","49221","2018",11,11,0,101272.7,1011.091,94.81818
"15868","49222","2018",17,17,0,205376.5,1781.824,113.7647
"15869","49223","2018",67,49,18,200235.3,2009.806,104.194
"15870","49224","2018",12,12,0,130708.3,1360.333,102.75
"15871","49228","2018",72,72,0,88927.54,991.875,92.79167
"15872","49231","2018",16,16,0,156374.9,1399.188,108.5
"15873","49235","2018",8,8,0,119282.5,1219.5,93.75
"15874","49236","2018",2,2,0,160000,1143,157.5
"15875","49237","2018",3,3,0,115333.3,782,145.3333
"15876","49240","2018",11,11,0,109136.4,1097.636,100.8182
"15877","49241","2018",23,23,0,195956.1,1972.565,99.56522
"15878","49244","2018",176,173,3,125980.1,1334.131,94.47727
"15879","49246","2018",124,107,17,183888.8,1971.605,94.21774
"15880","49247","2018",20,20,0,210480,1769,119
"15881","49248","2018",100,97,3,95407.34,949.45,102.12
"15882","49253","2018",11,11,0,67454.55,874.6364,72.81818
"15883","49257","2018",15,15,0,100900,1137.867,93.93333
"15884","49259","2018",35,34,1,169817.7,1623.886,104.3714
"15885","49260","2018",20,20,0,144656.5,1403.15,106.75
"15886","49261","2018",94,93,1,149079.3,1499.638,102.4468
"15887","49262","2018",7,7,0,247200,1743.571,135.5714
"15888","49266","2018",12,12,0,161416.7,1560.167,104.25
"15889","49267","2018",80,63,17,214795.8,2064.375,103.7125
"15890","49269","2018",19,19,0,154464.7,1569.421,95.31579
"15891","49271","2018",28,28,0,168861,1644.036,106.1071
"15892","49272","2018",14,14,0,111142.9,1333.929,83.28571
"15893","49278","2018",41,33,8,220740.5,2310.561,92.56098
"15894","49283","2018",27,26,1,173302.4,1545.037,117.1481
"15895","49284","2018",18,18,0,157105.6,1498,107
"15896","49288","2018",2,2,0,163750,1474,111
"15897","49291","2018",4,4,0,80375,659.75,119.75
"15898","49292","2018",37,37,0,179854.1,1548.378,120.3514
"15899","49294","2018",25,25,0,222114.3,1993.84,114.04
"15900","49298","2018",35,35,0,238749.2,2155.514,108.0571
"15901","49299","2018",31,31,0,170383.9,1745.613,97.22581
"15902","49301","2018",269,268,1,136810.4,1473.948,93.94052
"15903","49302","2018",9,9,0,156361.1,1141,124
"15904","49306","2018",15,15,0,243181.3,2207.6,109.3333
"15905","49307","2018",185,185,0,189847.6,1721.773,115.1027
"15906","49308","2018",13,11,2,276280.5,1909.769,141.9231
"15907","49310","2018",5,5,0,114100,1047.6,105.6
"15908","49311","2018",17,17,0,132229.4,1133.941,112.5294
"15909","49321","2018",6,6,0,86675,921.5,86.83333
"15910","49323","2018",77,72,5,221008.9,2026.325,110.974
"15911","49326","2018",7,7,0,228364.3,1628.857,139.4286
"15912","49328","2018",391,252,139,127012.4,1370.772,89.56266
"15913","49329","2018",9,9,0,232166.7,2035,110.3333
"15914","49330","2018",17,17,0,209617.6,1676.706,126.2941
"15915","49331","2018",195,179,16,123411.8,1234.723,101.4256
"15916","49332","2018",38,38,0,185421.1,1635.474,115.7105
"15917","49333","2018",35,34,1,150012.3,1419.4,112
"15918","49334","2018",4,4,0,126250,1387.75,94.75
"15919","49336","2018",11,11,0,115160.6,964.1818,119.5455
"15920","49338","2018",13,13,0,198923.1,1800.385,115.2308
"15921","49339","2018",15,15,0,184649.5,1625.867,112.0667
"15922","49341","2018",6,6,0,119256.7,821.6667,138.3333
"15923","49343","2018",35,34,1,150325.7,1531.286,95.22857
"15924","49344","2018",12,12,0,161166.7,1567.75,106.6667
"15925","49345","2018",55,55,0,139901.5,1453.018,104.1091
"15926","49347","2018",16,16,0,190831.2,1637.625,120.5
"15927","49352","2018",14,14,0,166078.6,1651.929,101.2857
"15928","49353","2018",188,157,31,174723,1929.17,90.77128
"15929","49355","2018",28,28,0,137416.1,1517,90.89286
"15930","49358","2018",8,8,0,146375,1522.875,92.875
"15931","49359","2018",6,6,0,96983.33,871.3333,102
"15932","49361","2018",27,27,0,128805.6,1348.333,97.59259
"15933","49362","2018",18,18,0,174981.2,1334.944,129.8889
"15934","49364","2018",10,10,0,113540,1146.9,97.4
"15935","49367","2018",52,51,1,139625.9,1387.288,103.1923
"15936","49368","2018",24,24,0,102106.8,1056.5,99.875
"15937","49369","2018",11,11,0,74090.91,826.1818,92.90909
"15938","49370","2018",8,8,0,157406.2,1453.5,105.5
"15939","49371","2018",17,17,0,161617.6,1446.412,113.7059
"15940","49373","2018",71,71,0,101836.8,1094.451,97.5493
"15941","49374","2018",14,14,0,145035.7,1716.714,91.78571
"15942","49377","2018",48,48,0,175247.9,1757.104,103.7292
"15943","49378","2018",26,26,0,133153.3,1343.577,105.5
"15944","49381","2018",14,14,0,164135.7,1340.929,125.3571
"15945","50002","2018",47,43,4,148728.6,1379.681,112.8511
"15946","50003","2018",78,70,8,289733.3,3118.026,98.46154
"15947","50004","2018",11,11,0,139000,948.5455,136.5455
"15948","50006","2018",3,3,0,165316.7,1283.667,128
"15949","50008","2018",7,5,2,221571.4,2020.714,103.5714
"15950","50013","2018",6,6,0,142266.7,1515.5,97
"15951","50015","2018",10,10,0,168784,1791.4,96.9
"15952","50016","2018",2,2,0,38000,991.5,53.5
"15953","50019","2018",4,4,0,88125,835,110.75
"15954","50021","2018",2,2,0,32500,530,56.5
"15955","50022","2018",4,3,1,100391.2,1380.75,73.5
"15956","50023","2018",8,8,0,137312.5,1260.75,118.5
"15957","50024","2018",1,1,0,60000,625,96
"15958","50025","2018",108,77,31,142238.3,1530.907,97.02778
"15959","50026","2018",4,4,0,89250,882.25,99.5
"15960","50027","2018",17,17,0,174764.7,1562.412,111.7059
"15961","50029","2018",8,8,0,76062.5,1089.625,70.625
"15962","50030","2018",16,11,5,131343.8,2244.562,62.6875
"15963","50031","2018",62,53,9,172585.2,2148.839,80.30645
"15964","50032","2018",12,12,0,180545,1397.75,125.25
"15965","50033","2018",3,3,0,198266.7,1638.667,144
"15966","50034","2018",8,8,0,159287.5,1350,117.75
"15967","50038","2018",5,5,0,109200,982.8,107
"15968","50040","2018",2,2,0,195200,1512,130.5
"15969","50041","2018",109,106,3,165302.9,1663.064,106.7798
"15970","50042","2018",2,2,0,115000,1844,62
"15971","50044","2018",2,2,0,133900,1453,93.5
"15972","50045","2018",4,4,0,194900,1605.5,128.25
"15973","50046","2018",8,8,0,99975,1115.25,99.125
"15974","50048","2018",8,8,0,105000,1244.625,83
"15975","50049","2018",10,10,0,151420,1511,98.2
"15976","50050","2018",2,2,0,111250,1201.5,91.5
"15977","50054","2018",2,2,0,98950,979,110
"15978","50058","2018",28,28,0,186308.9,2039.179,95.28571
"15979","50059","2018",1,1,0,77000,917,84
"15980","50060","2018",5,5,0,103440,1025.4,103
"15981","50062","2018",2,2,0,79500,680.5,99.5
"15982","50064","2018",5,5,0,99534,902.2,107.6
"15983","50066","2018",71,53,18,201838.7,2822.014,80.08451
"15984","50069","2018",1,1,0,1e+05,870,115
"15985","50070","2018",2,2,0,144725,1242,116.5
"15986","50072","2018",3,3,0,166166.7,1467.333,116
"15987","50074","2018",17,17,0,115541.2,1207.882,98.29412
"15988","50076","2018",63,60,3,174029.6,2125.81,90.46032
"15989","50077","2018",18,18,0,173024.4,1890.5,90.44444
"15990","50078","2018",6,6,0,93250,1275.667,99.16667
"15991","50079","2018",3,3,0,224333.3,1526,144.6667
"15992","50081","2018",11,11,0,293390.9,1994.818,141.1818
"15993","50082","2018",56,56,0,134277.7,1383.25,98.07143
"15994","50083","2018",7,7,0,133722,1464.286,96.28571
"15995","50084","2018",2,2,0,160250,1085,123.5
"15996","50085","2018",20,20,0,168650,1748.45,95.65
"15997","50086","2018",4,4,0,1e+05,1319.5,75.75
"15998","50087","2018",29,29,0,136398.2,1588.379,88.82759
"15999","50088","2018",5,5,0,39100,645.8,80.6
"16000","50090","2018",10,10,0,88355,1526.8,76.9
"16001","50092","2018",8,8,0,102875,1063.125,109.625
"16002","50093","2018",8,8,0,99631.75,1059.25,95.375
"16003","50094","2018",2,2,0,126500,1793,72.5
"16004","50095","2018",15,15,0,121814.7,1166.733,102.8667
"16005","50096","2018",2,2,0,195000,3209.5,92
"16006","50097","2018",2,2,0,120375,1587.5,74
"16007","50098","2018",7,7,0,143082.9,1222,122.1429
"16008","50099","2018",117,103,14,119765,1305.291,94.78632
"16009","50101","2018",4,4,0,109000,1823,73
"16010","50102","2018",30,25,5,209199,2474.2,87.43333
"16011","50105","2018",3,3,0,109833.3,1114.667,107.3333
"16012","50106","2018",4,4,0,134375,1354.25,104.75
"16013","50108","2018",7,7,0,143142.9,1258.429,111.1429
"16014","50109","2018",24,24,0,116438.3,1231.542,97.54167
"16015","50110","2018",9,9,0,87930,1051.111,83.44444
"16016","50111","2018",5,5,0,97600,897,105.6
"16017","50112","2018",6,6,0,113666.7,1087.833,107.5
"16018","50115","2018",1,1,0,165000,1213,136
"16019","50117","2018",9,9,0,131322.2,1623.778,74.77778
"16020","50118","2018",2,2,0,91500,1120.5,82
"16021","50120","2018",2,2,0,142000,1277,116
"16022","50121","2018",1,1,0,135000,1038,130
"16023","50124","2018",3,3,0,71666.67,1910,38.33333
"16024","50126","2018",1,1,0,234000,1265,185
"16025","50129","2018",935,651,284,137017.5,1691.209,82.23209
"16026","50130","2018",5,5,0,133400,1461.6,119
"16027","50137","2018",8,8,0,106250,1108.25,96.25
"16028","50138","2018",7,7,0,133500,1457.857,90.14286
"16029","50139","2018",34,34,0,136456.2,1341.706,108.2647
"16030","50142","2018",22,22,0,158202.7,1598.318,99.36364
"16031","50143","2018",8,8,0,157478.1,1541.125,101.625
"16032","50144","2018",9,9,0,82500,1235.444,67.77778
"16033","50145","2018",7,7,0,129071.4,1261,100.8571
"16034","50146","2018",3,3,0,99666.67,1064.667,97
"16035","50147","2018",117,85,32,138816.3,1481.513,95.08547
"16036","50148","2018",4,4,0,131500,1071.25,109.75
"16037","50149","2018",10,10,0,191720,1712.1,117.5
"16038","50150","2018",4,4,0,165900,1472.5,116.25
"16039","50151","2018",22,22,0,119900.9,1177.682,101.1364
"16040","50152","2018",3,3,0,97333.33,1225.667,71.66667
"16041","50155","2018",3,3,0,120266.7,1712,61.66667
"16042","50156","2018",1,1,0,26000,650,40
"16043","50158","2018",4,4,0,135375,1328.25,107.5
"16044","50159","2018",6,6,0,117483.3,1010.5,113
"16045","50161","2018",12,12,0,107968.3,1091.917,101.5833
"16046","50162","2018",12,11,1,192066.7,1629.5,120.0833
"16047","50164","2018",5,5,0,91600,929.6,107.2
"16048","50165","2018",79,48,31,209003.7,2557.101,83.32911
"16049","50166","2018",3,3,0,109333.3,1718.667,80.66667
"16050","50167","2018",9,9,0,126616.7,1549.111,81.33333
"16051","50168","2018",21,21,0,117808.1,1410.714,82.90476
"16052","50169","2018",1,1,0,80000,1231,65
"16053","50172","2018",2,2,0,77500,981,78.5
"16054","50174","2018",2,2,0,165000,1357.5,120.5
"16055","50176","2018",4,4,0,104090.5,1113,94.5
"16056","50177","2018",2,2,0,85000,944.5,90
"16057","50178","2018",19,19,0,140089.5,1685.684,86.15789
"16058","50181","2018",4,4,0,122301,1030.5,112.75
"16059","50182","2018",2,2,0,55000,957,60
"16060","50183","2018",6,6,0,102000,1248.667,87.83333
"16061","50184","2018",15,13,2,142696.7,1704.867,88.33333
"16062","50185","2018",11,11,0,161938.2,1670,110.9091
"16063","50186","2018",1,1,0,160500,1655,97
"16064","50188","2018",9,9,0,101666.7,968.6667,105.4444
"16065","50190","2018",4,4,0,193997.5,1674,123.25
"16066","50192","2018",2,2,0,106500,1044.5,106
"16067","50193","2018",4,4,0,107125,1085.75,100.25
"16068","50194","2018",4,4,0,212750,1726.75,145.25
"16069","50195","2018",6,6,0,103898.3,1561.667,97
"16070","50196","2018",6,6,0,126925,1337,108.6667
"16071","50197","2018",31,31,0,104815.3,1123.258,95.74194
"16072","50198","2018",7,7,0,101314.3,1066,95.14286
"16073","50199","2018",6,6,0,147333.3,2011.167,76.66667
"16074","50200","2018",14,14,0,95938,1091.071,90
"16075","50205","2018",1,1,0,110000,1467,75
"16076","50207","2018",3,3,0,116333.3,1394.667,83.66667
"16077","50208","2018",4,4,0,114521.5,1021.75,113.75
"16078","50209","2018",12,12,0,159458.3,1526.5,110.75
"16079","50210","2018",6,6,0,113361.7,1167.167,100.3333
"16080","50214","2018",1,1,0,85000,559,152
"16081","50215","2018",44,42,2,149010.2,1856.75,87.84091
"16082","50216","2018",9,9,0,103311.1,1125.667,96
"16083","50217","2018",12,12,0,135428.7,1399.75,98.83333
"16084","50218","2018",314,125,189,170730.3,2511.439,70.98408
"16085","50219","2018",3,3,0,195333.3,1332,151.6667
"16086","50221","2018",1,1,0,185000,1595,116
"16087","50222","2018",13,13,0,157442.3,1936.846,93.69231
"16088","50225","2018",3,3,0,160333.3,1072,151.3333
"16089","50227","2018",1,1,0,142000,1136,125
"16090","50228","2018",16,16,0,109893.8,1162.75,94.5625
"16091","50230","2018",10,10,0,167670,1589.3,111.1
"16092","50231","2018",22,21,1,190881.8,2713.864,78.18182
"16093","50232","2018",5,5,0,120600,877.6,135
"16094","50233","2018",1,1,0,125000,1042,120
"16095","50234","2018",1,1,0,90000,479,188
"16096","50235","2018",1,1,0,175000,1944,90
"16097","50236","2018",70,69,1,115850.8,1259.943,95.04286
"16098","50237","2018",15,14,1,104500,1138.867,94
"16099","50239","2018",12,12,0,137745.8,1330.25,102.8333
"16100","50240","2018",1,1,0,221000,2728,81
"16101","50241","2018",4,4,0,206700,1474.5,148
"16102","50243","2018",5,5,0,182856,1971.4,92.2
"16103","50247","2018",2,2,0,194000,1685.5,110
"16104","50251","2018",3,3,0,94216.67,1060.333,97.66667
"16105","50252","2018",19,19,0,126118.4,1902.895,66.94737
"16106","50253","2018",4,4,0,86975,1238.75,79.25
"16107","50256","2018",31,31,0,101010.4,1175.871,92.16129
"16108","50258","2018",1,1,0,174350,1503,116
"16109","50259","2018",8,8,0,119500,1410.5,86.125
"16110","50260","2018",21,21,0,78309.52,1001.238,91.47619
"16111","50261","2018",2,2,0,59400,834.5,95
"16112","50262","2018",4,4,0,158875,1491.25,106.5
"16113","50263","2018",4,4,0,40050,742,56
"16114","50265","2018",2,2,0,89000,1365,64.5
"16115","50266","2018",5,5,0,88240,746.6,134.4
"16116","50267","2018",14,13,1,124535.7,1485.286,87.57143
"16117","50268","2018",4,4,0,142250,1160.75,134.75
"16118","50269","2018",5,5,0,101818,1062.2,91.8
"16119","50270","2018",7,7,0,131285.7,1619.714,83.28571
"16120","50272","2018",18,18,0,158027.8,1979.111,95.66667
"16121","50273","2018",18,18,0,96022.22,1009.944,98.27778
"16122","50274","2018",5,5,0,127158.2,787.6,168.8
"16123","50275","2018",2,2,0,190700,1160.5,163.5
"16124","50276","2018",7,7,0,113357.1,1371.714,84.28571
"16125","50277","2018",13,13,0,201653.8,1633.923,122.8462
"16126","50278","2018",3,3,0,137666.7,1107,128.3333
"16127","50279","2018",6,6,0,108416.7,1067.333,108.3333
"16128","50281","2018",11,11,0,117109.1,1437.273,87.18182
"16129","50282","2018",4,4,0,196150,1469.5,140
"16130","50285","2018",10,10,0,135430,1100.4,132.8
"16131","50288","2018",16,16,0,124906.2,1425.5,89.25
"16132","50289","2018",8,8,0,85887.5,877.5,105.75
"16133","50290","2018",8,8,0,83250,824.5,92.375
"16134","50291","2018",4,4,0,77550,1028.75,76.75
"16135","50292","2018",29,29,0,133048.4,1289.552,107.2069
"16136","50294","2018",7,7,0,200900,1544.143,136.8571
"16137","50295","2018",1,1,0,172500,1568,110
"16138","50296","2018",7,7,0,184142.9,2121.714,98
"16139","50297","2018",15,15,0,105080.1,1136.267,96.33333
"16140","50298","2018",4,4,0,158750,1327.25,129.25
"16141","50299","2018",2,2,0,75500,1846,41
"16142","50300","2018",1,1,0,45500,758,60
"16143","50302","2018",3,3,0,101000,847.6667,115.6667
"16144","50304","2018",1,1,0,193000,1350,143
"16145","50305","2018",7,7,0,188749.7,1646.143,115.1429
"16146","50311","2018",3,3,0,225350,1423.667,174.3333
"16147","50312","2018",1,1,0,120000,1333,90
"16148","50315","2018",6,6,0,91413.33,1087.167,86.16667
"16149","50317","2018",2,2,0,194500,1626,107
"16150","50321","2018",8,8,0,155331.2,1293.75,120.5
"16151","50324","2018",1,1,0,40000,364,110
"16152","50326","2018",7,6,1,105714.3,1517,74.85714
"16153","50327","2018",3,3,0,129333.3,1068.667,136
"16154","50328","2018",5,5,0,111700,1294.6,86.2
"16155","50332","2018",4,4,0,125875,1395.5,94.75
"16156","50334","2018",2,2,0,73750,800.5,88
"16157","50335","2018",8,8,0,136500,1655.125,88.375
"16158","50336","2018",3,3,0,148333.3,1175.333,113.3333
"16159","50338","2018",5,5,0,109400,848.8,148.8
"16160","50340","2018",2,2,0,76500,1274.5,64
"16161","50341","2018",23,21,2,113023.9,1284.391,95.34783
"16162","50342","2018",14,14,0,192490.5,2037.929,96.21429
"16163","50345","2018",6,6,0,131113.3,1406.5,90.33333
"16164","50347","2018",4,4,0,80403.75,957.5,92
"16165","50349","2018",24,22,2,164032.4,1801.75,93.70833
"16166","50350","2018",12,12,0,82491.67,1086.25,80.16667
"16167","50351","2018",1,1,0,72700,790,92
"16168","50352","2018",5,5,0,114406,1096.4,109.6
"16169","50356","2018",7,7,0,100357.1,783.7143,140.7143
"16170","50357","2018",2,2,0,103650,860.5,108
"16171","50359","2018",30,25,5,76059.33,1074.067,77.86667
"16172","50360","2018",3,3,0,203000,1224.667,173
"16173","50361","2018",1,1,0,82000,1139,72
"16174","50362","2018",2,2,0,39000,567.5,71
"16175","50363","2018",20,20,0,120346.6,1190.5,101.45
"16176","50364","2018",12,12,0,72391.67,1097.5,67.25
"16177","50365","2018",7,7,0,119000,1315.571,98.28571
"16178","50368","2018",2,2,0,101000,1173,83.5
"16179","50369","2018",11,11,0,180318.2,1989.909,102.8182
"16180","50370","2018",7,7,0,129935.7,1315.857,97.28571
"16181","50371","2018",11,10,1,81800,914,91.18182
"16182","50372","2018",1,1,0,19000,633,30
"16183","50373","2018",1,1,0,148000,1423,104
"16184","50374","2018",1,1,0,181000,1828,99
"16185","50376","2018",6,6,0,174588.3,1552.667,114.1667
"16186","50378","2018",11,11,0,76716.82,678.0909,109.6364
"16187","50379","2018",1,1,0,38000,623,61
"16188","50382","2018",5,5,0,167400,2554,77
"16189","50384","2018",6,6,0,129866.7,1724.5,84.33333
"16190","50387","2018",4,4,0,88750,1132,78.75
"16191","50388","2018",10,10,0,180300,1600.7,111
"16192","50389","2018",3,3,0,201666.7,1613.667,110.3333
"16193","50390","2018",1,1,0,1e+05,1370,73
"16194","50391","2018",32,32,0,93878.06,945.5312,96.375
"16195","50393","2018",25,25,0,109204,1087.2,105.84
"16196","50394","2018",23,23,0,98471.74,984.3043,101.0435
"16197","50395","2018",4,3,1,138125,1578,89.75
"16198","50397","2018",4,4,0,95100,1428.5,88.5
"16199","50398","2018",3,3,0,96540.67,775.6667,116.6667
"16200","50399","2018",5,5,0,87800,2079.2,66.8
"16201","50400","2018",35,34,1,104934,1345.486,84.17143
"16202","50401","2018",6,6,0,127593.7,1154.5,104.5
"16203","50402","2018",29,28,1,150700.7,1585.862,93.48276
"16204","50403","2018",44,42,2,140786.4,1996.659,76.81818
"16205","50405","2018",8,8,0,131787.5,1631,95.75
"16206","50407","2018",10,10,0,149310,1258,115.4
"16207","50408","2018",7,7,0,94571.43,1261.571,74.42857
"16208","50409","2018",29,27,2,133978.4,1343.345,102.6207
"16209","50410","2018",70,59,11,93433.07,1217.729,81.71429
"16210","50411","2018",6,6,0,173000,1373.667,127.1667
"16211","50412","2018",62,61,1,151761.9,1877.855,87.91935
"16212","50413","2018",2,2,0,195000,1492,131.5
"16213","50417","2018",28,27,1,116696.4,1492.536,77.60714
"16214","50419","2018",36,36,0,129853.3,1286.583,105.0556
"16215","50420","2018",15,15,0,118933.3,1122.067,106.7333
"16216","50421","2018",6,6,0,171333.3,1901.333,95.16667
"16217","50422","2018",6,6,0,104466.7,867.3333,126.5
"16218","50423","2018",4,4,0,139725,1175.25,127.5
"16219","50425","2018",6,6,0,204927.7,1264.333,149.6667
"16220","50426","2018",2,2,0,174500,1805,98.5
"16221","50428","2018",8,8,0,77050,999.875,76.875
"16222","50429","2018",9,9,0,182937.1,1820.333,97.44444
"16223","50431","2018",19,19,0,108857.9,981.7895,112.8947
"16224","50433","2018",18,14,4,250743.1,2559.611,108.1667
"16225","50435","2018",2,2,0,205500,1722,117.5
"16226","50436","2018",11,11,0,106645,1409.636,79.81818
"16227","50437","2018",9,9,0,97888.89,1075.667,106
"16228","50442","2018",3,3,0,129333.3,1577.667,81.33333
"16229","50443","2018",2,2,0,60000,1071,56
"16230","50444","2018",26,26,0,133818.5,1303.615,104.7692
"16231","50445","2018",6,6,0,114583.3,849.6667,145.3333
"16232","50446","2018",3,3,0,103000,1192.333,85
"16233","50447","2018",5,5,0,205700,1665,128.6
"16234","50448","2018",4,4,0,93500,1135,85.25
"16235","50450","2018",1,1,0,38500,1132,34
"16236","50452","2018",5,5,0,79100,855.4,91.4
"16237","50453","2018",8,8,0,118000,1085.125,105.5
"16238","50454","2018",8,8,0,184950,1586,119.25
"16239","50455","2018",1,1,0,150000,955,157
"16240","50456","2018",8,8,0,42858.75,667.875,69.25
"16241","50457","2018",1,1,0,150000,1974,76
"16242","50461","2018",1,1,0,165000,1650,100
"16243","50462","2018",7,7,0,82428.57,1026.857,82.14286
"16244","50463","2018",5,5,0,106900,1838.8,65.6
"16245","50464","2018",8,8,0,125990.9,1812,79.125
"16246","50467","2018",3,3,0,96666.67,1031,96
"16247","50468","2018",7,7,0,88000,861.7143,97.71429
"16248","50469","2018",5,5,0,124100,1549.8,77.2
"16249","50471","2018",8,8,0,128437.5,1587,84.875
"16250","50472","2018",2,2,0,76500,898,88
"16251","50473","2018",2,2,0,159883.5,1503.5,97.5
"16252","50474","2018",9,9,0,59351.89,509,112.1111
"16253","50475","2018",13,13,0,177124.6,1317.692,131.6923
"16254","50476","2018",4,4,0,108250,1259.5,82.5
"16255","50478","2018",3,3,0,125333.3,1216.333,103
"16256","50479","2018",1,1,0,340000,1889,180
"16257","50480","2018",10,10,0,162792,1642.7,103.7
"16258","50481","2018",38,37,1,182826.9,1809.921,97.13158
"16259","50482","2018",2,2,0,60000,810,70
"16260","50483","2018",11,11,0,161149.2,1431.909,113.6364
"16261","50484","2018",57,54,3,92893.86,1061.456,86.24561
"16262","50486","2018",8,8,0,127750,1184.25,116.5
"16263","50487","2018",41,41,0,109237.4,1191.707,93.53659
"16264","50488","2018",7,7,0,110857.1,1011.714,116.7143
"16265","50489","2018",4,4,0,187150,1753,120.25
"16266","50490","2018",5,5,0,187800,1427.6,127.6
"16267","50491","2018",4,4,0,133352.5,1220.5,105
"16268","50492","2018",17,17,0,147125,1289.588,114.8824
"16269","50493","2018",20,20,0,162553.9,1468.8,111.9
"16270","50496","2018",10,7,3,97659.6,1241.9,75.6
"16271","50498","2018",6,6,0,178225.8,2347.667,86.16667
"16272","50499","2018",5,5,0,77500,912.8,78
"16273","50500","2018",7,7,0,111471.4,1049.857,120.8571
"16274","50502","2018",211,122,89,112128.3,1333.682,85.02844
"16275","50504","2018",2,2,0,79500,875,76
"16276","50505","2018",5,5,0,116400,1006.6,102.8
"16277","50506","2018",5,5,0,175200,2831.2,77.4
"16278","50507","2018",7,7,0,144900,1808.857,83.57143
"16279","50509","2018",9,9,0,164011.1,2626.111,87
"16280","50510","2018",11,11,0,176636.4,1357.182,117.6364
"16281","50511","2018",5,5,0,114400,1590,70.2
"16282","50512","2018",5,5,0,123352,1169.2,103
"16283","50513","2018",6,6,0,104250,887.1667,144.3333
"16284","50514","2018",6,6,0,112288.3,1038.5,117.1667
"16285","50517","2018",2,2,0,119500,1480,80.5
"16286","50518","2018",6,6,0,76233.33,922.3333,83.16667
"16287","50519","2018",8,8,0,186500,1728,114.25
"16288","50521","2018",2,2,0,163700,1860.5,90.5
"16289","50522","2018",2,2,0,138200,1438.5,93.5
"16290","50523","2018",39,39,0,125193.6,1460.308,87.38462
"16291","50525","2018",6,6,0,91550,919.8333,105.3333
"16292","50528","2018",4,4,0,72875,1155.5,55.5
"16293","50529","2018",1,1,0,174500,1026,170
"16294","50531","2018",12,12,0,112208.3,1120.5,102.3333
"16295","50532","2018",112,92,20,227086.3,2699.089,85.60714
"16296","50535","2018",12,12,0,121479.2,1180.917,109.25
"16297","50537","2018",2,2,0,145250,1593,93.5
"16298","50538","2018",4,4,0,147375,1323.5,114.25
"16299","50539","2018",20,20,0,125640,1690.2,81.25
"16300","50540","2018",12,12,0,175363.3,1678.167,106.6667
"16301","50541","2018",20,19,1,166229.5,1984.7,90.75
"16302","50542","2018",7,7,0,79314.29,1097.571,88
"16303","50543","2018",15,15,0,105033.3,1281.067,84.53333
"16304","50546","2018",39,39,0,135129.6,1205.026,118.5641
"16305","50548","2018",3,3,0,80000,1119.333,71.33333
"16306","50549","2018",7,7,0,170742.9,1415.286,128
"16307","50550","2018",31,31,0,95167.1,1008.548,98.03226
"16308","50551","2018",27,25,2,107722.2,1127.296,103.1111
"16309","50553","2018",2,2,0,76500,671.5,115.5
"16310","50554","2018",17,17,0,169907.1,1520.529,113.5882
"16311","50556","2018",8,8,0,137819.8,1319.75,101.625
"16312","50562","2018",34,30,4,169206.2,2045.412,91.38235
"16313","50563","2018",5,5,0,82116,938.8,91.6
"16314","50564","2018",20,20,0,122757.5,1157.3,111.75
"16315","50565","2018",29,20,9,146551.8,1597.586,92.96552
"16316","50567","2018",11,11,0,168863.6,1739.273,97.72727
"16317","50568","2018",4,4,0,127125,1170.75,104.25
"16318","50569","2018",3,3,0,83333.33,938,86
"16319","50570","2018",11,11,0,70500,1171.545,66.27273
"16320","50571","2018",2,2,0,160000,1609,100
"16321","50572","2018",1,1,0,90000,1286,70
"16322","50574","2018",4,4,0,110125,1225.75,93
"16323","50575","2018",9,9,0,181522.2,1725.333,106.4444
"16324","50576","2018",19,19,0,196631.6,2231.579,92.94737
"16325","50577","2018",7,7,0,145428.6,1435.286,103
"16326","50578","2018",2,2,0,315525,1867,165
"16327","50579","2018",11,11,0,189615.5,1599.636,124.6364
"16328","50580","2018",1,1,0,293000,1915,153
"16329","50582","2018",45,43,2,105963.9,1192.244,90.26667
"16330","50584","2018",5,5,0,109180,1217.6,108.6
"16331","50585","2018",20,20,0,122565.9,1781.75,72.2
"16332","50588","2018",4,4,0,241500,2152.75,131
"16333","50589","2018",1,1,0,102000,1759,58
"16334","50590","2018",8,8,0,124384.4,1615.125,82.625
"16335","50591","2018",25,25,0,67437.6,1000.8,80.2
"16336","50592","2018",22,21,1,108037.3,1043.818,106.0909
"16337","50593","2018",7,7,0,164857.1,1739.143,111.5714
"16338","50594","2018",11,11,0,187294.5,1848.182,108.7273
"16339","50596","2018",5,5,0,168600,1591,105.8
"16340","50597","2018",9,9,0,121988.9,1558.667,87.33333
"16341","50598","2018",3,3,0,112500,1193.333,97
"16342","50599","2018",17,17,0,163204.2,1575.235,102.4706
"16343","50601","2018",48,46,2,118906.2,1286.688,94.16667
"16344","50603","2018",14,14,0,162321.6,1778.143,93.78571
"16345","50604","2018",6,6,0,137166.7,1496.333,92
"16346","50606","2018",9,9,0,130666.7,1098.444,116.7778
"16347","50607","2018",4,4,0,179540,1624.25,108.75
"16348","50609","2018",3,3,0,127000,1098,109.3333
"16349","50612","2018",9,9,0,141888.9,1503.333,96.66667
"16350","50613","2018",4,4,0,186750,2162.75,95
"16351","50615","2018",83,69,14,167880.1,1819.337,99.15663
"16352","50616","2018",19,19,0,163004.2,1485.526,118
"16353","50617","2018",8,8,0,104500,1026.875,110.375
"16354","50618","2018",2,2,0,105000,991.5,108.5
"16355","50619","2018",4,4,0,74125,1087,69
"16356","50621","2018",1,1,0,109000,1434,76
"16357","50624","2018",3,3,0,118333.3,1102.333,108.6667
"16358","50626","2018",6,6,0,133500,1306.333,103
"16359","50628","2018",1,1,0,75000,915,82
"16360","50629","2018",10,10,0,100200,1071.6,98.2
"16361","50633","2018",3,3,0,143333.3,1084.667,127.6667
"16362","50634","2018",1,1,0,90000,756,119
"16363","50637","2018",1,1,0,137000,1142,120
"16364","50639","2018",44,43,1,97245.2,1125.523,89.02273
"16365","50641","2018",9,9,0,140438.9,1063.556,131.2222
"16366","50643","2018",9,9,0,189700,1416.111,130.8889
"16367","50647","2018",6,6,0,234536,1829.333,138
"16368","50648","2018",4,4,0,184912.8,1794.25,106.25
"16369","51001","2018",2,2,0,142500,1035,146
"16370","51002","2018",11,11,0,210134.2,1739.909,125.9091
"16371","51005","2018",1,1,0,125000,1190,105
"16372","51006","2018",1,1,0,90000,643,140
"16373","51007","2018",6,6,0,163950.8,1896.167,84.66667
"16374","51008","2018",2,2,0,107525,640.5,170
"16375","51009","2018",10,10,0,97600,1067,100.5
"16376","51010","2018",2,2,0,100997.5,1059,96.5
"16377","51013","2018",1,1,0,320000,2667,120
"16378","51014","2018",2,2,0,325000,2936.5,110
"16379","51015","2018",2,2,0,26250,394,70
"16380","51016","2018",2,2,0,90500,663.5,139
"16381","51017","2018",5,5,0,102840,1031.2,95.2
"16382","51018","2018",6,6,0,162500,1400.833,117.1667
"16383","51019","2018",2,2,0,142500,1268.5,113.5
"16384","51022","2018",2,2,0,120000,1152,102.5
"16385","51023","2018",4,4,0,217946.2,1859.75,141
"16386","51025","2018",13,13,0,205404,1835.923,112.3077
"16387","51027","2018",2,2,0,154150,1250,123
"16388","51028","2018",10,9,1,147600.8,1875.9,93.3
"16389","51029","2018",13,13,0,141238.5,1578.846,96
"16390","51030","2018",52,43,9,168682.6,1740.269,100.5769
"16391","51031","2018",2,2,0,162500,1682.5,93.5
"16392","51032","2018",2,2,0,108750,1025,111.5
"16393","51033","2018",2,1,1,121250,1252.5,102
"16394","51036","2018",2,2,0,87495,1034.5,89
"16395","51037","2018",3,3,0,246333.3,1613.667,150.3333
"16396","51038","2018",2,1,1,155250,1133.5,142
"16397","51039","2018",1,1,0,120000,723,166
"16398","51040","2018",1,1,0,180000,1333,135
"16399","51041","2018",1,1,0,186550,1138,164
"16400","51042","2018",3,3,0,58000,554.6667,112.3333
"16401","51043","2018",12,12,0,172154.2,1650.833,109.1667
"16402","51044","2018",6,6,0,255508.3,2318.167,110.5
"16403","51046","2018",7,7,0,230818.6,2170.714,113.8571
"16404","51047","2018",3,3,0,79833.33,736.6667,114.6667
"16405","51048","2018",1,1,0,160000,1356,118
"16406","51049","2018",5,5,0,231920,1683,137.4
"16407","51050","2018",2,2,0,111000,894.5,130
"16408","51051","2018",4,4,0,185406.2,1900,101.5
"16409","51052","2018",7,7,0,209071.4,2178.857,101.1429
"16410","51053","2018",1,1,0,1e+05,787,127
"16411","51054","2018",17,16,1,152158.8,1520.235,103.0588
"16412","51055","2018",65,49,16,196490.7,2163.323,94.67692
"16413","51056","2018",1,1,0,85000,1545,55
"16414","51058","2018",19,17,2,339583.7,2752.421,125.5789
"16415","51059","2018",3,3,0,133273.3,1329.667,94.33333
"16416","51062","2018",2,2,0,81250,875,91.5
"16417","51063","2018",2,2,0,50000,1197.5,46
"16418","51065","2018",10,10,0,143880,1339.2,109.1
"16419","51066","2018",5,5,0,80800,1070.4,74.6
"16420","51069","2018",1,1,0,235075,4521,52
"16421","51070","2018",4,4,0,82712.5,758.75,104.5
"16422","51071","2018",4,4,0,71939.25,736.75,90.5
"16423","51072","2018",4,4,0,159350,1077.5,148
"16424","51073","2018",2,2,0,165422,1479.5,117.5
"16425","51074","2018",14,14,0,174978.6,2116.143,88.42857
"16426","51075","2018",14,14,0,226267.9,1945.929,119.2857
"16427","51076","2018",6,6,0,149858.3,1227.667,118.5
"16428","51077","2018",3,3,0,149000,1577,106.6667
"16429","51078","2018",5,5,0,160800,1532.6,103.2
"16430","51079","2018",12,12,0,199121.8,1762.833,113.5833
"16431","51081","2018",4,4,0,156980,2272,67.75
"16432","51082","2018",1,1,0,170000,1532,111
"16433","51083","2018",1,1,0,80000,1538,52
"16434","51085","2018",11,11,0,97227.27,1162.545,84.72727
"16435","51086","2018",4,4,0,261225,1752.5,160
"16436","51087","2018",1,1,0,216500,1493,145
"16437","51088","2018",4,4,0,252672.2,1877.75,138.25
"16438","51090","2018",3,3,0,95000,1085,91.33333
"16439","51091","2018",1,1,0,156000,1209,129
"16440","51092","2018",4,4,0,82000,1016.75,97.75
"16441","51093","2018",4,4,0,235250,1790,131.5
"16442","51094","2018",1,1,0,145000,1611,90
"16443","51095","2018",1,1,0,154500,1355,114
"16444","51100","2018",1,1,0,316000,2241,141
"16445","51101","2018",6,6,0,283133.3,2178.5,129
"16446","51102","2018",1,1,0,315000,2218,142
"16447","51103","2018",2,2,0,134995,1466,104.5
"16448","51104","2018",2,2,0,115500,1143,105
"16449","51105","2018",11,11,0,344729.5,2484.727,139.7273
"16450","51106","2018",1,1,0,161900,1485,109
"16451","51107","2018",6,6,0,166400,1507.833,122.1667
"16452","51108","2018",489,219,270,122766,1411.119,85.77505
"16453","51109","2018",3,3,0,211233.3,2051,98.66667
"16454","51110","2018",1,1,0,85000,867,98
"16455","51111","2018",2,2,0,204350,1866,109.5
"16456","51112","2018",5,5,0,302200,2518,120.6
"16457","51113","2018",1,1,0,160000,1194,134
"16458","51115","2018",7,7,0,348142.9,2232.857,172.8571
"16459","51116","2018",4,4,0,132500,1394.75,92
"16460","51118","2018",9,9,0,370958.6,2564.444,149
"16461","51119","2018",9,9,0,214644.4,2081.333,104.7778
"16462","51120","2018",4,4,0,121948.8,980.5,119
"16463","51121","2018",5,5,0,74200,911.8,83.4
"16464","51124","2018",2,2,0,114750,1543,75.5
"16465","51127","2018",1,1,0,160000,1301,123
"16466","51129","2018",7,7,0,123270,1513,80.28571
"16467","51133","2018",1,1,0,90000,1059,85
"16468","51134","2018",2,2,0,62500,618.5,102
"16469","51135","2018",3,3,0,114000,1154.333,100.3333
"16470","51136","2018",9,9,0,176118.1,1530.556,105.1111
"16471","51137","2018",2,2,0,81000,904,81
"16472","51138","2018",1,1,0,112200,1145,98
"16473","51139","2018",4,4,0,94250,1123.25,86.5
"16474","51140","2018",5,5,0,131600,989.2,128.8
"16475","51141","2018",9,9,0,161354.4,1441,119.2222
"16476","51142","2018",4,4,0,194500,1642.5,112.25
"16477","51144","2018",8,8,0,85535.25,914.375,96.25
"16478","51145","2018",2,2,0,100500,1005,100
"16479","51147","2018",4,4,0,161360,1341.5,119.5
"16480","51148","2018",2,2,0,159500,1324,128
"16481","51149","2018",5,5,0,157860,1551.8,101.4
"16482","51150","2018",1,1,0,178050,1633,109
"16483","51151","2018",1,1,0,223450,1405,159
"16484","51152","2018",7,6,1,206092.9,1759.143,140.8571
"16485","51153","2018",8,8,0,162437.5,1736.75,93
"16486","51154","2018",2,2,0,143135,1356,108.5
"16487","51155","2018",15,15,0,125800,1064.333,123.8667
"16488","51156","2018",1,1,0,70000,875,80
"16489","51157","2018",2,2,0,123500,1360.5,90.5
"16490","51158","2018",6,6,0,108916.7,1014.5,112.5
"16491","51160","2018",14,14,0,178145.5,1776.071,101.5714
"16492","51161","2018",7,7,0,204811.4,1648.714,123.7143
"16493","51162","2018",13,13,0,91776.92,1112.615,86.46154
"16494","51165","2018",10,10,0,132590,1265.6,107.7
"16495","51168","2018",1,1,0,136000,1511,90
"16496","51171","2018",9,9,0,254292.2,2126.889,124.6667
"16497","51172","2018",73,58,15,231120.9,2442.329,95.08219
"16498","51173","2018",2,2,0,90000,2655.5,43
"16499","51174","2018",2,2,0,245000,1387,179.5
"16500","51175","2018",1,1,0,108000,1543,70
"16501","51177","2018",4,4,0,302300,2283.75,137.75
"16502","51178","2018",2,2,0,119000,1339,89.5
"16503","51179","2018",1,1,0,170000,1700,100
"16504","51181","2018",5,5,0,332160,2096.8,157
"16505","51182","2018",1,1,0,1e+05,877,114
"16506","51183","2018",10,9,1,325540,2227.5,150.9
"16507","51184","2018",4,4,0,92500,1298.75,70.25
"16508","51185","2018",4,4,0,100397,1237.5,78
"16509","51187","2018",6,5,1,140391.7,1589.5,89.66667
"16510","51188","2018",3,3,0,232333.3,1773.667,138.3333
"16511","51191","2018",1,1,0,97500,1219,80
"16512","51192","2018",1,1,0,75000,758,99
"16513","51193","2018",12,12,0,207945.8,1526.083,143.25
"16514","51194","2018",7,7,0,169757.1,1280.429,133.8571
"16515","51195","2018",5,5,0,118440,1286.2,91.6
"16516","51196","2018",5,5,0,322310,1807.2,171.8
"16517","51197","2018",1,1,0,202000,990,204
"16518","51198","2018",5,5,0,135965.4,1557.4,84.8
"16519","51199","2018",4,4,0,176317.5,1428.5,130.25
"16520","51200","2018",6,6,0,193458.3,2673.667,81.16667
"16521","51201","2018",2,2,0,170000,1886,100.5
"16522","51202","2018",9,7,2,131833.3,1531,89.77778
"16523","51203","2018",1,1,0,81500,799,102
"16524","51204","2018",10,9,1,161015,1678.3,97
"16525","51205","2018",3,3,0,203233.3,1805.333,112.6667
"16526","51206","2018",1,1,0,125000,833,150
"16527","51210","2018",22,21,1,171100,1879.5,95.90909
"16528","51211","2018",1,1,0,105000,1265,83
"16529","51212","2018",2,2,0,90000,1025,94.5
"16530","51214","2018",2,2,0,167500,1347,127.5
"16531","51216","2018",3,3,0,166333.3,1587,112.3333
"16532","51217","2018",32,31,1,151310.6,1582.031,97.21875
"16533","51219","2018",7,7,0,125000,1361.286,92.57143
"16534","51220","2018",3,3,0,96833.33,680,136.3333
"16535","51222","2018",2,1,1,112000,1094,100.5
"16536","51223","2018",1,1,0,118000,1146,103
"16537","51224","2018",2,2,0,72500,658,93.5
"16538","51225","2018",4,4,0,146000,1619.75,95
"16539","51226","2018",2,2,0,135000,979.5,140.5
"16540","51227","2018",3,3,0,172333.3,1351.333,127.6667
"16541","51228","2018",1,1,0,38000,447,85
"16542","51229","2018",2,2,0,116000,788.5,146.5
"16543","51230","2018",281,147,134,151368.3,1792.171,84.09609
"16544","51231","2018",6,6,0,151615.2,1482.167,101.1667
"16545","51232","2018",3,3,0,211033.3,1632.667,132.6667
"16546","51234","2018",4,4,0,86125,1196,68.25
"16547","51235","2018",7,7,0,171100,1509,128
"16548","51236","2018",1,1,0,140000,1148,122
"16549","51237","2018",21,21,0,119961,1556.714,83.71429
"16550","51238","2018",10,10,0,134950,1330.8,109.3
"16551","51240","2018",1,1,0,176220,734,240
"16552","51242","2018",45,42,3,171008,1766.956,102.6889
"16553","51243","2018",3,3,0,35333.33,438,81
"16554","51244","2018",1,0,1,89000,1187,75
"16555","51245","2018",6,6,0,223708.3,1762.5,130
"16556","51246","2018",1,1,0,160000,1404,114
"16557","51247","2018",1,1,0,178000,1664,107
"16558","51248","2018",18,16,2,89877.22,1030.778,89.44444
"16559","51249","2018",3,3,0,353276.7,2284,155.6667
"16560","51250","2018",56,52,4,156028.4,1563.696,102.0536
"16561","51252","2018",4,4,0,80160,1091.5,80.25
"16562","51253","2018",3,3,0,95373.33,626.3333,177.6667
"16563","51254","2018",3,3,0,270000,3498,72.66667
"16564","51256","2018",2,2,0,294975,2477.5,120
"16565","51258","2018",4,4,0,104092,1197.5,89.5
"16566","51259","2018",2,2,0,177500,1521,125.5
"16567","51260","2018",1,1,0,160000,1509,106
"16568","51262","2018",12,11,1,115600,1209.25,96.33333
"16569","51263","2018",3,3,0,157666.7,1286.667,119
"16570","51264","2018",7,7,0,93573.86,773.4286,117.4286
"16571","51265","2018",9,9,0,123587.8,1208.222,104.8889
"16572","51266","2018",6,6,0,268390,2086,135.5
"16573","51267","2018",4,4,0,271150,2780.75,100.25
"16574","51268","2018",2,2,0,127500,1349.5,85.5
"16575","51269","2018",7,7,0,99688.57,1422.714,79.57143
"16576","51272","2018",4,4,0,105836,1001,113.75
"16577","51275","2018",2,2,0,64250,657,105.5
"16578","51276","2018",2,2,0,95000,739,127.5
"16579","51277","2018",5,5,0,176800,1682,103.2
"16580","51278","2018",2,2,0,215000,1972,109.5
"16581","51279","2018",5,5,0,102790,1130.6,101
"16582","51280","2018",2,2,0,64000,793,81
"16583","51281","2018",8,8,0,183375,2357.125,96.75
"16584","51282","2018",18,18,0,370030.6,2921.222,132.1111
"16585","51283","2018",2,2,0,44500,703,60
"16586","51284","2018",1,1,0,147100,736,200
"16587","51285","2018",2,2,0,491500,5921.5,83
"16588","51286","2018",2,2,0,138000,1322.5,105.5
"16589","51287","2018",8,7,1,311571.2,2374.5,113.375
"16590","51289","2018",2,2,0,1e+05,788.5,150
"16591","51290","2018",1,1,0,80000,678,118
"16592","51291","2018",22,22,0,320800,2171.045,151.7273
"16593","51293","2018",5,5,0,187920,1691.8,113
"16594","51294","2018",1,1,0,131500,2023,65
"16595","51295","2018",1,1,0,269350,1141,236
"16596","51298","2018",5,5,0,146210,1154.2,143.4
"16597","51299","2018",6,6,0,238783.3,2153,116.6667
"16598","51301","2018",1,1,0,178000,1187,150
"16599","51303","2018",6,6,0,127408.3,1304.833,91.5
"16600","51304","2018",1,1,0,169000,812,208
"16601","51305","2018",1,1,0,582000,2541,229
"16602","51306","2018",1,1,0,211200,899,235
"16603","51307","2018",3,3,0,149000,1634.667,90.66667
"16604","51308","2018",20,20,0,230020.2,2247,102.65
"16605","51310","2018",1,1,0,72000,379,190
"16606","51312","2018",2,2,0,250868,1654,151.5
"16607","51313","2018",5,5,0,158000,1433.4,116.8
"16608","51314","2018",3,3,0,133333.3,866,158
"16609","51315","2018",1,1,0,140000,1120,125
"16610","51316","2018",8,8,0,74400,972.25,82.875
"16611","51317","2018",1,1,0,49000,671,73
"16612","51318","2018",4,4,0,234847.5,2496.75,100
"16613","51319","2018",1,1,0,110000,764,144
"16614","51320","2018",5,5,0,160600,1561.6,108.6
"16615","51321","2018",2,2,0,109000,1042.5,102.5
"16616","51322","2018",1,1,0,117000,1345,87
"16617","51323","2018",1,1,0,144000,1516,95
"16618","51325","2018",2,2,0,127500,783,159.5
"16619","51326","2018",22,22,0,183496.9,1694.091,109.5
"16620","51328","2018",8,8,0,132875,1345.5,98.125
"16621","51329","2018",8,8,0,227300,1981.125,118.75
"16622","51333","2018",6,6,0,185816.7,1736.167,116.5
"16623","51334","2018",1,1,0,1e+05,1205,83
"16624","51337","2018",3,3,0,187033.3,1395,116.3333
"16625","51338","2018",10,10,0,209560,1839.3,116.7
"16626","51339","2018",6,6,0,181166.7,1907.5,100.5
"16627","51340","2018",7,7,0,150177.3,1447.286,111.2857
"16628","51342","2018",4,4,0,188875,1806.75,104.75
"16629","51343","2018",8,8,0,114812.5,1108.625,113.75
"16630","51344","2018",13,13,0,179969.2,2264.462,79.76923
"16631","51345","2018",6,6,0,176025,1657.333,116.8333
"16632","51346","2018",11,11,0,116786.4,1157.909,100.8182
"16633","51349","2018",1,1,0,90000,818,110
"16634","51350","2018",1,1,0,168000,1050,160
"16635","51351","2018",3,3,0,81933.33,786.6667,100
"16636","51352","2018",5,5,0,162480,1473.2,110
"16637","51353","2018",1,1,0,35000,455,77
"16638","51354","2018",2,2,0,128096,883.5,155
"16639","51355","2018",1,1,0,45000,652,69
"16640","51357","2018",8,8,0,167500,1724.625,102.75
"16641","51358","2018",3,3,0,85000,829.3333,116.6667
"16642","51359","2018",4,4,0,121375,1406,87.25
"16643","51360","2018",4,4,0,153200,1437.5,99.25
"16644","51361","2018",4,4,0,99950,905,112.25
"16645","51362","2018",7,6,1,218672.9,1853.571,115.8571
"16646","51363","2018",1,1,0,139000,1188,117
"16647","51365","2018",7,7,0,382575,2278.143,172.8571
"16648","51367","2018",13,13,0,139593.8,1599.308,91.23077
"16649","51370","2018",2,2,0,174050,1736,116
"16650","51372","2018",7,7,0,199281.4,1762.571,113.7143
"16651","51375","2018",1,1,0,160000,1951,82
"16652","51378","2018",3,3,0,167400,1375.667,128.6667
"16653","51379","2018",6,6,0,194000,1565.667,145.5
"16654","51380","2018",42,41,1,115232.6,1360.714,91.11905
"16655","51381","2018",11,11,0,144436.4,1596.182,105.0909
"16656","51382","2018",4,4,0,118750,1324,88.5
"16657","51384","2018",2,2,0,256500,2121.5,128
"16658","51386","2018",1,1,0,183000,1634,112
"16659","51387","2018",4,4,0,145000,1526.25,114.25
"16660","51388","2018",31,28,3,151164,1461.839,107.1613
"16661","51389","2018",9,8,1,147246.7,1456.667,103
"16662","51390","2018",6,6,0,249233.3,1785.333,143.5
"16663","51391","2018",21,20,1,228022.2,2205.524,101.5714
"16664","51392","2018",5,5,0,195804,1718.8,116.2
"16665","51393","2018",5,5,0,186880,2485.4,113.4
"16666","51395","2018",3,3,0,94000,1120.333,75.33333
"16667","51396","2018",2,2,0,50000,1229,41
"16668","51399","2018",5,5,0,83300,782.8,113.2
"16669","51402","2018",2,2,0,103000,1522,70
"16670","51403","2018",4,4,0,181500,1493,135.75
"16671","51407","2018",7,7,0,132142.9,1522.286,90
"16672","51409","2018",2,2,0,176250,1150.5,152.5
"16673","51410","2018",5,5,0,114380,1494.4,75.6
"16674","51413","2018",5,5,0,221000,2276.6,105
"16675","51415","2018",4,4,0,93123,951.25,101.25
"16676","51416","2018",2,2,0,127500,1189,106
"16677","51417","2018",4,4,0,95000,1760.75,69.75
"16678","51418","2018",5,5,0,282900,2695,108.6
"16679","51420","2018",1,1,0,190000,1727,110
"16680","51421","2018",1,1,0,82000,943,87
"16681","51422","2018",5,5,0,280904,2397.6,118.4
"16682","51423","2018",18,17,1,84307.78,815.9444,105.5556
"16683","51424","2018",2,2,0,71000,872,87.5
"16684","51425","2018",4,4,0,109460,1438.5,75
"16685","51426","2018",3,3,0,114893.3,1544.333,74.33333
"16686","51428","2018",6,6,0,236433.3,1867.5,135.3333
"16687","51429","2018",1,1,0,256000,1910,134
"16688","51430","2018",3,3,0,110666.7,990.6667,119.3333
"16689","51431","2018",14,14,0,174742.9,2041.5,86.64286
"16690","51432","2018",3,3,0,141666.7,1003,144.3333
"16691","51433","2018",2,2,0,173650,1381.5,127.5
"16692","51434","2018",5,5,0,139920,1310.2,111.8
"16693","51435","2018",1,1,0,170000,1288,132
"16694","51436","2018",6,6,0,167666.7,1760.167,96.5
"16695","51439","2018",1,1,0,140000,1217,115
"16696","51440","2018",16,15,1,127343.8,1529.312,85.9375
"16697","51441","2018",1,1,0,59000,720,82
"16698","51442","2018",1,1,0,120000,1111,108
"16699","51443","2018",1,1,0,193000,1149,168
"16700","51444","2018",2,2,0,343645,2774,123.5
"16701","51445","2018",2,2,0,236000,1689,147.5
"16702","51446","2018",3,3,0,92666.67,1261.333,72.66667
"16703","51447","2018",6,6,0,250750,1959.5,136.5
"16704","51448","2018",12,11,1,110883,1685.917,72.66667
"16705","51449","2018",14,14,0,215152.9,2149.071,104.5714
"16706","51450","2018",3,3,0,343733.3,2118,159
"16707","51451","2018",1,1,0,66000,524,126
"16708","51453","2018",10,10,0,179886,1771,113.5
"16709","51454","2018",2437,587,1850,158592.7,2257.787,70.21502
"16710","51455","2018",2,2,0,185900,1055,177.5
"16711","51456","2018",1,1,0,117500,1728,68
"16712","51457","2018",2,2,0,92500,983,97.5
"16713","51458","2018",1,1,0,77000,1242,62
"16714","51459","2018",1,1,0,77000,856,90
"16715","51460","2018",2,2,0,161000,1465,127
"16716","51461","2018",12,11,1,258679.2,2226,112.8333
"16717","51463","2018",3,3,0,159666.7,2114,86.66667
"16718","51464","2018",2,2,0,152400,692.5,234
"16719","51468","2018",2,2,0,301500,2370.5,123.5
"16720","51472","2018",7,7,0,129557.1,1105,120.1429
"16721","51473","2018",1,1,0,70000,1167,60
"16722","51474","2018",41,30,11,225994.5,2380.537,96.82927
"16723","51476","2018",6,6,0,179758.3,1787.667,99.16667
"16724","51477","2018",3,3,0,228800,1920,118.6667
"16725","51478","2018",6,6,0,135400,1178.333,112.3333
"16726","51479","2018",2,2,0,149840,1572.5,101
"16727","51482","2018",6,6,0,185583.3,1550.5,123.5
"16728","51483","2018",3,3,0,194666.7,1679.333,122.6667
"16729","51484","2018",2,2,0,186450,1460,132.5
"16730","51485","2018",2,2,0,183500,1755.5,104
"16731","51486","2018",5,5,0,122280,1726,81.2
"16732","51487","2018",6,6,0,143866.7,1299,112.1667
"16733","51488","2018",1,1,0,130000,1182,110
"16734","51490","2018",4,4,0,180587.5,1292.75,146.5
"16735","51491","2018",1,1,0,125000,1667,75
"16736","51492","2018",11,11,0,94909.09,1048.364,88.27273
"16737","51493","2018",2,1,1,156275,1905,86
"16738","51496","2018",9,9,0,97555.56,943.3333,100.6667
"16739","51497","2018",1,1,0,101000,990,102
"16740","51499","2018",2,2,0,183500,2003,91.5
"16741","51500","2018",1,1,0,112000,941,119
"16742","51501","2018",2,2,0,133500,1021.5,136
"16743","51502","2018",1,1,0,134000,1523,88
"16744","51503","2018",3,3,0,171215,1148.667,127.6667
"16745","51504","2018",8,8,0,162260,2032.75,82.125
"16746","51505","2018",8,8,0,185281.2,1714.625,109.375
"16747","51506","2018",49,35,14,144216,1555.878,91.42857
"16748","51507","2018",37,29,8,106317.6,1159.946,97.54054
"16749","51509","2018",5,5,0,135100,1123.6,128.8
"16750","51511","2018",1,1,0,83350,662,126
"16751","51513","2018",7,7,0,124114.3,1021.571,122.8571
"16752","51515","2018",4,4,0,177050,1334.25,134.5
"16753","51517","2018",1,1,0,116500,1421,82
"16754","51518","2018",7,7,0,298168.3,2274.714,120.1429
"16755","51521","2018",2,2,0,63000,861,64.5
"16756","51522","2018",2,2,0,115500,873.5,132.5
"16757","51523","2018",4,4,0,205000,1865.25,111.5
"16758","51524","2018",1,1,0,160000,1951,82
"16759","51525","2018",15,15,0,196080,1831.533,109.7333
"16760","51526","2018",6,6,0,131498.3,1091.667,120.1667
"16761","51527","2018",4,4,0,150050,1592,93.5
"16762","51528","2018",3,3,0,119666.7,1037.667,120.3333
"16763","51529","2018",4,4,0,168625,1781.25,94.5
"16764","51530","2018",9,9,0,186777.8,1986.667,98.66667
"16765","51531","2018",23,23,0,72991.3,776.3913,102.087
"16766","51532","2018",5,5,0,222958,2076,110
"16767","51533","2018",1,1,0,130530,1450,90
"16768","51534","2018",5,5,0,193320,2168.2,91
"16769","51535","2018",55,52,3,128209.9,1392.945,96.12727
"16770","51536","2018",13,8,5,197634.6,2260.462,85.84615
"16771","51537","2018",3,3,0,60166.67,534,111.3333
"16772","51538","2018",1,1,0,132500,1472,90
"16773","51542","2018",1,1,0,210000,1500,140
"16774","51544","2018",6,6,0,102050,1162,84.83333
"16775","51545","2018",6,6,0,126070.8,1242.333,100.1667
"16776","51546","2018",5,5,0,115302,1208.6,98.2
"16777","51548","2018",3,3,0,141333.3,1409.333,111.6667
"16778","51549","2018",2,2,0,76250,643,111.5
"16779","51550","2018",4,4,0,127757.5,988.75,136.75
"16780","51551","2018",3,3,0,85933.33,687.6667,111.6667
"16781","51552","2018",4,4,0,108000,1023,116.75
"16782","51553","2018",5,5,0,158720,1399.2,115.4
"16783","51555","2018",1,1,0,60000,550,109
"16784","51556","2018",5,5,0,157200,1277.8,126.2
"16785","51557","2018",5,5,0,100630,1031,96
"16786","51558","2018",2,2,0,41000,530,73
"16787","51559","2018",20,18,2,119940,1274.5,96.55
"16788","51560","2018",2,2,0,182000,1548.5,108
"16789","51562","2018",32,30,2,259664.1,2392,106.5312
"16790","51564","2018",1,1,0,140000,1867,75
"16791","51566","2018",2,2,0,61254,716,85.5
"16792","51567","2018",5,5,0,161000,1206.4,136.4
"16793","51568","2018",2,2,0,229500,2411.5,95.5
"16794","51569","2018",2,2,0,328125,2442.5,135
"16795","51570","2018",3,3,0,131500,1482,101
"16796","51571","2018",13,13,0,225546.2,1993.462,116.4615
"16797","51573","2018",113,74,39,211583.4,2399.292,91.82301
"16798","51574","2018",1,1,0,169345,1236,137
"16799","51576","2018",9,9,0,146527.8,1666.778,92.33333
"16800","51577","2018",2,2,0,194775,1438.5,133
"16801","51579","2018",1,1,0,92250,1377,67
"16802","51580","2018",3,3,0,142333.3,1352.667,102.6667
"16803","51581","2018",1,1,0,263107,2105,125
"16804","51582","2018",4,4,0,156200,1496.25,97.5
"16805","51584","2018",1,1,0,224720,1605,140
"16806","51585","2018",7,7,0,130621.4,1554.286,89.42857
"16807","51586","2018",1,1,0,258000,1732,149
"16808","51587","2018",2,2,0,123950,768,168
"16809","51588","2018",3,3,0,94833.33,903.6667,104.3333
"16810","51589","2018",1,1,0,136000,1545,88
"16811","51590","2018",1,1,0,90000,957,94
"16812","51591","2018",2,2,0,207072.5,2154,96
"16813","51592","2018",3,3,0,210666.7,1643,130
"16814","51595","2018",4,4,0,143825,1669.25,86.5
"16815","51596","2018",4,4,0,157000,1453.75,111.25
"16816","51597","2018",4,4,0,142017.5,1535.5,94.25
"16817","51598","2018",9,9,0,96444.44,1145.778,80.44444
"16818","51599","2018",1,1,0,201400,2014,100
"16819","51600","2018",1,1,0,410020,1752,234
"16820","51601","2018",2,2,0,162000,1308.5,128
"16821","51603","2018",1,1,0,91000,938,97
"16822","51604","2018",3,3,0,135766.7,1351,101.3333
"16823","51605","2018",6,6,0,125633.3,1401.333,91
"16824","51607","2018",3,3,0,120000,1328.333,99
"16825","51609","2018",6,6,0,134000,1451,92.66667
"16826","51610","2018",4,4,0,114150,916,117
"16827","51611","2018",3,3,0,150500,1396.333,104.6667
"16828","51612","2018",34,33,1,149073.8,1365.147,110
"16829","51613","2018",11,11,0,156100,1827.727,87.72727
"16830","51614","2018",11,11,0,175634.5,1921.273,91.90909
"16831","51616","2018",3,3,0,127350,1368.333,89.33333
"16832","51617","2018",9,9,0,183905.6,1596.556,126.8889
"16833","51618","2018",4,4,0,99250,762.75,165.5
"16834","51619","2018",3,3,0,81500,994,81.66667
"16835","51621","2018",6,6,0,68250,851.6667,81.83333
"16836","51622","2018",2,2,0,221500,1645.5,138.5
"16837","51623","2018",2,2,0,343800,2080,164
"16838","51624","2018",13,13,0,188660.8,1782.231,114.3846
"16839","51625","2018",6,6,0,109500,1517,80.16667
"16840","51626","2018",3,3,0,117275.3,774,161.6667
"16841","51627","2018",3,3,0,110818.3,1365.333,80
"16842","51628","2018",2,2,0,76500,659.5,116
"16843","51629","2018",5,4,1,303142.8,2744,108.8
"16844","51630","2018",2,2,0,85000,1049,78.5
"16845","51631","2018",1,1,0,137000,1712,80
"16846","51632","2018",3,3,0,98333.33,1041.333,95
"16847","51633","2018",5,5,0,228970,1764.4,130
"16848","51634","2018",1,1,0,208000,1981,105
"16849","51635","2018",1,1,0,28000,1037,27
"16850","51636","2018",4,4,0,255750,2398.5,113
"16851","51638","2018",1,1,0,120000,1165,103
"16852","51639","2018",1,1,0,25000,781,32
"16853","51640","2018",2,2,0,151500,910.5,153
"16854","51641","2018",3,3,0,107873.3,1477.333,76.33333
"16855","51642","2018",2,2,0,140000,951.5,163
"16856","51643","2018",7,7,0,175848.7,1880.857,101.1429
"16857","51644","2018",5,5,0,128140,1387.2,91.8
"16858","51645","2018",2,2,0,41500,871.5,47.5
"16859","51647","2018",14,14,0,139167.9,1407.571,109.5
"16860","51648","2018",4,4,0,122575,1335.75,93.25
"16861","51649","2018",96,72,24,90529.17,1032.469,86.60417
"16862","51655","2018",2,2,0,194500,1664,116.5
"16863","51656","2018",5,4,1,204163.6,1682.4,126.8
"16864","51657","2018",2,2,0,473500,2115,219
"16865","51658","2018",1,1,0,47500,651,73
"16866","51660","2018",30,30,0,210304.7,1849.867,117.9667
"16867","51662","2018",46,37,9,224338.8,2297.5,99.69565
"16868","51663","2018",23,18,5,132695.7,1567.739,83.86957
"16869","52001","2018",3,3,0,94473.33,897.3333,103
"16870","52003","2018",2,2,0,68500,902,72.5
"16871","52006","2018",4,4,0,67300,935,72.5
"16872","52008","2018",4,4,0,61850,711.5,89.75
"16873","52011","2018",2,2,0,67500,639.5,105
"16874","52014","2018",3,3,0,184000,1127.333,169
"16875","52017","2018",5,5,0,60200,721.2,81.4
"16876","52021","2018",1,1,0,132000,1467,90
"16877","52022","2018",2,2,0,73000,1013.5,70.5
"16878","52023","2018",1,1,0,60000,353,170
"16879","52027","2018",3,3,0,82833.33,690.6667,122
"16880","52031","2018",6,6,0,232166.7,2864.333,98.16667
"16881","52033","2018",1,1,0,75000,843,89
"16882","52035","2018",1,1,0,48000,516,93
"16883","52037","2018",6,6,0,121880,1220.167,101.8333
"16884","52040","2018",2,2,0,48000,505.5,91.5
"16885","52043","2018",1,1,0,84000,848,99
"16886","52044","2018",7,7,0,80714.29,715.4286,115.2857
"16887","52045","2018",23,22,1,152086.5,1587.783,100.4783
"16888","52047","2018",1,1,0,40000,580,69
"16889","52050","2018",9,9,0,89583.33,1128.111,77.22222
"16890","52053","2018",1,1,0,160000,1103,145
"16891","52056","2018",2,2,0,149500,894,164.5
"16892","52057","2018",2,2,0,116000,1443.5,78.5
"16893","52058","2018",13,13,0,107131.5,1174.462,92.38462
"16894","52060","2018",21,19,2,66433.48,686.5238,94.95238
"16895","52061","2018",3,3,0,62000,661,89.66667
"16896","52062","2018",2,2,0,105500,911.5,104.5
"16897","52063","2018",1,1,0,50000,714,70
"16898","52064","2018",4,3,1,91750,827,111.25
"16899","52067","2018",1,1,0,98000,1000,98
"16900","52070","2018",2,2,0,70500,1035.5,59.5
"16901","52072","2018",3,3,0,108336.7,1152,97
"16902","52074","2018",2,2,0,69500,569,115
"16903","52076","2018",4,4,0,129125,1889.75,91.75
"16904","52079","2018",8,8,0,63383.75,716.5,85.25
"16905","52082","2018",1,1,0,96000,787,122
"16906","52083","2018",8,8,0,102770.6,1060.5,104.5
"16907","52087","2018",1,1,0,218000,1246,175
"16908","52088","2018",7,7,0,117714.3,1402.571,85.57143
"16909","52091","2018",2,2,0,121000,1069.5,117
"16910","52092","2018",2,2,0,81500,557,147
"16911","52093","2018",33,31,2,82223.09,863.0606,99.63636
"16912","52094","2018",2,2,0,51000,644,83
"16913","52095","2018",1,1,0,90000,1233,73
"16914","52097","2018",1,1,0,44000,518,85
"16915","52099","2018",9,8,1,86888.89,947.4444,96
"16916","52102","2018",4,4,0,140875,1083.5,131.25
"16917","52104","2018",8,8,0,131066.8,1354.875,93.625
"16918","52106","2018",2,2,0,95750,1148.5,82.5
"16919","52108","2018",1,1,0,136000,1236,110
"16920","52109","2018",1,1,0,72000,720,100
"16921","52113","2018",5,5,0,82600,686.8,113.2
"16922","52114","2018",18,15,3,94233.33,944.2222,98.11111
"16923","52115","2018",1,1,0,218000,1166,187
"16924","52118","2018",4,4,0,113125,972.5,115.25
"16925","52119","2018",5,3,2,100340,1172.6,84.2
"16926","52121","2018",236,155,81,102609.8,1231.275,83.78814
"16927","52122","2018",1,1,0,156000,1200,130
"16928","52123","2018",13,13,0,77076.92,731.6923,105.6923
"16929","52125","2018",14,14,0,156491.6,1509.857,102.8571
"16930","52127","2018",1,1,0,68500,596,115
"16931","52128","2018",1,1,0,40000,656,61
"16932","52130","2018",2,2,0,132500,1093.5,108
"16933","52131","2018",1,1,0,27000,338,80
"16934","52132","2018",3,3,0,99833.33,691.3333,168.3333
"16935","52134","2018",1,1,0,149900,1249,120
"16936","52137","2018",1,1,0,210000,1419,148
"16937","52140","2018",3,3,0,65000,377,171
"16938","52141","2018",6,6,0,224500,1646.5,136.6667
"16939","52145","2018",1,1,0,55000,534,103
"16940","52146","2018",1,1,0,99000,656,151
"16941","52149","2018",1,1,0,141500,842,168
"16942","52151","2018",1,1,0,81000,988,82
"16943","52155","2018",7,7,0,72785.71,921.5714,77.14286
"16944","52156","2018",5,5,0,102980,782.8,119.8
"16945","52158","2018",3,3,0,100383.3,1109.333,90
"16946","52163","2018",2,2,0,42000,577.5,70
"16947","52165","2018",1,1,0,49500,369,134
"16948","52168","2018",1,1,0,70000,933,75
"16949","52171","2018",2,2,0,52500,697.5,75.5
"16950","52172","2018",3,3,0,87100,1050.667,88.66667
"16951","52175","2018",4,4,0,54293.75,699.25,75.25
"16952","52177","2018",3,3,0,79333.33,813.3333,97.33333
"16953","52178","2018",2,2,0,85000,898,94.5
"16954","52179","2018",1,1,0,110000,853,129
"16955","52182","2018",30,28,2,128573.2,1339.933,96.96667
"16956","52183","2018",1,1,0,68500,890,77
"16957","52184","2018",1,1,0,66000,1320,50
"16958","52187","2018",3,3,0,38850,510.6667,78.33333
"16959","52189","2018",3,3,0,102333.3,579.6667,169
"16960","52190","2018",1,1,0,157000,1481,106
"16961","52193","2018",3,3,0,157666.7,1256,135.6667
"16962","52194","2018",30,30,0,97179.33,1055.5,87.93333
"16963","52203","2018",1,1,0,30000,462,65
"16964","52205","2018",4,4,0,138500,1442.5,98
"16965","52211","2018",18,15,3,72646.33,848.1111,87.5
"16966","52213","2018",2,2,0,55890,529,99.5
"16967","52219","2018",1,1,0,30000,390,77
"16968","52220","2018",1,1,0,74000,507,146
"16969","52221","2018",2,2,0,125750,1540.5,86
"16970","52222","2018",1,1,0,20500,456,45
"16971","52223","2018",1,1,0,58500,373,157
"16972","52227","2018",1,1,0,60000,984,61
"16973","52229","2018",1,1,0,36405,439,83
"16974","52230","2018",1,1,0,126000,1853,68
"16975","52231","2018",1,1,0,120000,1290,93
"16976","52234","2018",1,1,0,52142,381,137
"16977","52235","2018",1,1,0,70000,486,144
"16978","52237","2018",2,2,0,114750,996,109
"16979","52240","2018",1,1,0,88000,830,106
"16980","52243","2018",1,1,0,85000,773,110
"16981","52244","2018",5,5,0,172058,1307.8,149.4
"16982","52246","2018",7,7,0,150857.1,1419.286,104.1429
"16983","52247","2018",1,1,0,146000,948,154
"16984","52248","2018",2,2,0,87000,663,111
"16985","52249","2018",2,2,0,143650,1245,111
"16986","52250","2018",28,23,5,84303.57,889.8214,92.57143
"16987","52251","2018",7,7,0,148428.6,1461.429,110.5714
"16988","52253","2018",1,1,0,1e+05,714,140
"16989","52258","2018",3,3,0,85666.67,873,98
"16990","52260","2018",1,1,0,65000,570,114
"16991","52265","2018",19,19,0,101500,1130.211,91.73684
"16992","52266","2018",3,3,0,77706.67,620.6667,113.3333
"16993","52267","2018",2,2,0,123250,1172,107.5
"16994","52269","2018",57,34,23,112828.5,1231.123,93.61404
"16995","52271","2018",1,1,0,48000,800,60
"16996","52274","2018",4,4,0,77312.5,555,141.25
"16997","52276","2018",4,4,0,99500,1001,107
"16998","52277","2018",1,1,0,19000,365,52
"16999","52278","2018",2,2,0,96500,1020.5,89.5
"17000","52280","2018",2,2,0,126600,1346,94
"17001","52287","2018",1,1,0,140000,933,150
"17002","52288","2018",2,2,0,25000,408.5,62
"17003","52289","2018",2,1,1,58250,665,83.5
"17004","52290","2018",1,1,0,126000,1370,92
"17005","52292","2018",4,4,0,98125,1067.75,104.25
"17006","52297","2018",3,3,0,117966.7,1461.667,79.33333
"17007","52298","2018",1,1,0,80000,491,163
"17008","52300","2018",1,1,0,50000,476,105
"17009","52302","2018",3,3,0,168333.3,1121,152
"17010","52305","2018",6,6,0,158223,1167.667,139.5
"17011","52307","2018",2,2,0,60000,647,88
"17012","52308","2018",7,7,0,119792.9,852.4286,154.1429
"17013","52327","2018",6,6,0,125666.7,1049.5,117.3333
"17014","52331","2018",15,14,1,125366.7,1357.867,91.86667
"17015","52332","2018",12,12,0,86150,983.8333,93.91667
"17016","52341","2018",1,1,0,138000,1278,108
"17017","52346","2018",6,6,0,61750,671.5,103.5
"17018","52348","2018",8,7,1,71881.25,802.75,91.125
"17019","52349","2018",3,3,0,155000,1495,102.6667
"17020","52353","2018",41,38,3,85294.51,1021.829,83
"17021","52354","2018",1,1,0,121270,758,160
"17022","52355","2018",2,2,0,71000,699.5,102.5
"17023","52357","2018",1,1,0,195000,1336,146
"17024","52359","2018",1,1,0,106000,972,109
"17025","52360","2018",1,1,0,216500,1746,124
"17026","52363","2018",1,1,0,94000,989,95
"17027","52365","2018",4,4,0,132450,853.5,156.25
"17028","52366","2018",1,1,0,90000,833,108
"17029","52367","2018",1,1,0,76000,752,101
"17030","52369","2018",2,2,0,50000,867,52.5
"17031","52370","2018",3,3,0,63000,678.3333,97.33333
"17032","52371","2018",2,2,0,89750,630.5,141.5
"17033","52373","2018",1,1,0,45000,375,120
"17034","52374","2018",1,1,0,80000,1067,75
"17035","52380","2018",6,6,0,225116.7,2897.5,73.5
"17036","52383","2018",1,1,0,63000,1167,54
"17037","52386","2018",8,8,0,80062.5,772.75,115
"17038","52391","2018",4,4,0,95250,959.75,100.5
"17039","52398","2018",4,4,0,97976.25,936.5,123
"17040","52399","2018",2,2,0,116500,917,132.5
"17041","52401","2018",5,5,0,68200,839.4,84.2
"17042","52403","2018",1,1,0,55000,604,91
"17043","52405","2018",12,12,0,119952.6,1201.667,101.5
"17044","52407","2018",3,3,0,96666.67,958.6667,101.6667
"17045","52411","2018",12,12,0,106037.4,1377.667,81.41667
"17046","52414","2018",4,4,0,48750,661.25,78.25
"17047","52419","2018",2,2,0,60000,651.5,93.5
"17048","52420","2018",2,2,0,56000,638.5,81
"17049","52421","2018",1,1,0,163000,1918,85
"17050","52422","2018",2,2,0,60000,969,62.5
"17051","52423","2018",1,1,0,155000,1824,85
"17052","52425","2018",1,1,0,33300,617,54
"17053","52426","2018",1,1,0,40000,364,110
"17054","52428","2018",1,1,0,115000,752,153
"17055","52429","2018",10,10,0,111740,1329.3,85.8
"17056","52431","2018",3,3,0,65333.33,543,122.6667
"17057","52432","2018",12,12,0,106366.7,1035,103.4167
"17058","52433","2018",1,1,0,80000,667,120
"17059","52439","2018",2,2,0,56000,503,115.5
"17060","52440","2018",2,2,0,116500,754.5,137.5
"17061","52442","2018",5,5,0,83897.2,854.8,95.8
"17062","52443","2018",1,1,0,60000,2000,30
"17063","52444","2018",1,1,0,38600,495,78
"17064","52446","2018",3,3,0,160333.3,1282,127.3333
"17065","52447","2018",1,1,0,60000,444,135
"17066","52448","2018",223,164,59,96576.81,1179.215,83.35426
"17067","52449","2018",13,13,0,131943.1,1250,109.6154
"17068","52450","2018",1,1,0,60000,465,129
"17069","52452","2018",3,3,0,187666.7,1591.333,153.6667
"17070","52453","2018",2,2,0,115000,1104,105.5
"17071","52455","2018",2,2,0,126550,1086,124.5
"17072","52456","2018",2,2,0,106925,1059,100.5
"17073","52457","2018",2,2,0,99000,661,142.5
"17074","52468","2018",1,1,0,46000,613,75
"17075","52469","2018",5,4,1,141298,1158.6,128.2
"17076","52472","2018",4,4,0,206250,3592.75,100
"17077","52474","2018",1,1,0,50000,355,141
"17078","52475","2018",1,1,0,66800,835,80
"17079","52479","2018",5,5,0,70000,596.8,116.6
"17080","52480","2018",2,2,0,131300,1284.5,88
"17081","52482","2018",1,1,0,70000,583,120
"17082","52484","2018",1,1,0,130000,1512,86
"17083","52486","2018",2,2,0,67500,1126.5,61.5
"17084","52488","2018",2,2,0,49900,599.5,81.5
"17085","52489","2018",2,2,0,61000,517,121
"17086","52490","2018",9,9,0,83255.56,962.2222,90.44444
"17087","52491","2018",2,2,0,69000,714,106
"17088","52492","2018",5,5,0,120000,1214.6,105.6
"17089","52494","2018",3,3,0,163666.7,1538.667,115.6667
"17090","52497","2018",3,3,0,108333.3,913.6667,112.3333
"17091","52500","2018",5,5,0,110070,1129.8,91.6
"17092","52502","2018",1,1,0,110000,1100,100
"17093","52510","2018",2,2,0,75000,670.5,113.5
"17094","52511","2018",1,1,0,70000,875,80
"17095","52512","2018",4,4,0,33750,528,62.25
"17096","52518","2018",4,4,0,115750,1138,105
"17097","52519","2018",1,1,0,59000,378,156
"17098","52520","2018",3,3,0,108666.7,581,185.3333
"17099","52522","2018",5,5,0,157125,1225.6,125.2
"17100","52524","2018",2,2,0,51000,380.5,133
"17101","52525","2018",2,2,0,85000,544,155
"17102","52528","2018",1,1,0,25300,372,68
"17103","52529","2018",13,13,0,91642.31,975,95.92308
"17104","52534","2018",11,11,0,122063.6,1252.636,99.36364
"17105","52535","2018",5,5,0,139460,1361.4,97.8
"17106","52538","2018",4,4,0,100812.5,1138.25,79.25
"17107","52540","2018",1,1,0,25000,333,75
"17108","52547","2018",7,7,0,127714.3,1368.429,98.71429
"17109","52548","2018",1,1,0,52000,800,65
"17110","52550","2018",27,26,1,86897.78,863.2963,107.3333
"17111","53001","2018",14,14,0,151930.4,1503.429,104.3571
"17112","53002","2018",7,7,0,95428.57,921.1429,108.8571
"17113","53003","2018",35,34,1,88339,902.9429,99.57143
"17114","53005","2018",35,34,1,105749.3,1104.6,101.8
"17115","53007","2018",22,22,0,147646.8,1545.318,95.86364
"17116","53008","2018",13,13,0,113446.6,1265.615,88.30769
"17117","53009","2018",6,6,0,127833.3,1184.667,108.6667
"17118","53010","2018",2,2,0,140750,1614.5,87
"17119","53011","2018",8,8,0,186062.5,1609.25,115
"17120","53012","2018",6,6,0,130833.3,957.3333,134.3333
"17121","53013","2018",8,8,0,102562.5,957,107.375
"17122","53015","2018",21,21,0,119317.4,1225.19,92.90476
"17123","53016","2018",16,16,0,72906.25,830,91.625
"17124","53017","2018",8,8,0,108375,758.375,138.625
"17125","53018","2018",13,13,0,115256.9,1264.077,95.38462
"17126","53021","2018",8,8,0,157500,1197.375,139.375
"17127","53022","2018",4,4,0,154687.5,1844,89
"17128","53023","2018",2,2,0,89250,1065.5,82.5
"17129","53025","2018",11,11,0,155488.5,1481.455,100.0909
"17130","53026","2018",8,8,0,122625,1229.75,110.625
"17131","53027","2018",1,1,0,182500,1372,133
"17132","53028","2018",4,4,0,141325,1456.25,98
"17133","53029","2018",16,16,0,104243.8,1099.625,97.0625
"17134","53030","2018",3,3,0,170000,1280.333,131
"17135","53031","2018",9,9,0,139010.9,1231.778,109.5556
"17136","53033","2018",2,2,0,131250,904.5,145.5
"17137","53034","2018",57,57,0,183762.6,1821.333,104.7018
"17138","53035","2018",4,4,0,126750,1373.25,95.5
"17139","53036","2018",7,7,0,106042.9,876.4286,119.1429
"17140","53037","2018",11,11,0,141181.8,1256.455,119.2727
"17141","53038","2018",1,1,0,28000,384,73
"17142","53039","2018",23,23,0,114017.4,1218.087,98.43478
"17143","53040","2018",6,6,0,96400,1318,77.5
"17144","53041","2018",5,5,0,101420,1108.2,85.4
"17145","53042","2018",11,11,0,111181.8,1086,96.81818
"17146","53043","2018",2,2,0,132500,1019.5,145
"17147","53045","2018",5,5,0,168688,1746.6,93.2
"17148","53046","2018",5,5,0,117600,1189.2,95.6
"17149","53047","2018",8,8,0,64412.5,821.5,78.5
"17150","53048","2018",19,19,0,124450,1158.526,107.8421
"17151","53049","2018",7,7,0,95642.86,1253,77.14286
"17152","53051","2018",7,7,0,64321.43,960.4286,69.57143
"17153","53052","2018",3,3,0,89166.67,1588.333,70.66667
"17154","53053","2018",5,5,0,83600,906.4,93.4
"17155","53054","2018",54,54,0,204195.9,1896.037,111.4444
"17156","53055","2018",5,5,0,76480,700.6,115
"17157","53056","2018",10,10,0,187622,1809.1,104
"17158","53057","2018",5,5,0,89200,1199.4,70.6
"17159","53058","2018",3,3,0,139000,1018.667,133.3333
"17160","53059","2018",4,4,0,142250,1670.25,88.25
"17161","53061","2018",4,4,0,74203,865,85.25
"17162","53062","2018",237,212,25,142698,1452.675,97.92405
"17163","53063","2018",6,6,0,100056.7,899.6667,124
"17164","53064","2018",10,10,0,87720,909.9,97.6
"17165","53066","2018",15,15,0,120732.3,1199.2,99.86667
"17166","53067","2018",3,3,0,77666.67,617.3333,128.6667
"17167","53069","2018",9,9,0,66822.22,761.8889,92.11111
"17168","53071","2018",6,6,0,102916.8,932.1667,113.1667
"17169","53072","2018",14,14,0,117685.7,1250,100.4286
"17170","53073","2018",8,8,0,114612.5,1203.75,96
"17171","53074","2018",11,11,0,107327.3,1138.909,96
"17172","53075","2018",6,6,0,153106.8,1318.833,117.1667
"17173","53076","2018",6,6,0,163201.7,1237.333,121.8333
"17174","53077","2018",39,39,0,127966.3,1421.564,91.53846
"17175","53078","2018",5,5,0,150400,1499,101.4
"17176","53079","2018",11,10,1,70056,818.6364,84.54545
"17177","53080","2018",2,2,0,38150,472.5,81
"17178","53082","2018",6,6,0,133231.7,1212.167,111.3333
"17179","53083","2018",10,10,0,84300,849.2,94.2
"17180","53084","2018",47,44,3,116244.1,1198.787,100.8723
"17181","53085","2018",2,2,0,65000,749.5,86
"17182","53086","2018",7,7,0,107328.6,1120,101.8571
"17183","53087","2018",5,5,0,74400,758.6,97.2
"17184","53088","2018",9,9,0,84850,919.8889,88.88889
"17185","53089","2018",11,11,0,108181.8,1151.545,94.63636
"17186","53090","2018",4,4,0,170875,1325,128.5
"17187","53091","2018",4,4,0,83437,1332.5,76.75
"17188","53093","2018",10,10,0,70375,773,88.1
"17189","53094","2018",18,18,0,131920.1,1439.167,95.22222
"17190","53096","2018",61,59,2,101022.2,1062.557,99.88525
"17191","53097","2018",98,84,14,95984.15,1157.408,81.45918
"17192","53098","2018",2,2,0,46060,743,62
"17193","53099","2018",10,10,0,158828.1,1525.8,103.6
"17194","53100","2018",10,10,0,68920.7,823.5,84.9
"17195","53101","2018",12,12,0,127283.3,1221.083,99.58333
"17196","53102","2018",5,5,0,69400,740.4,83.2
"17197","53103","2018",21,21,0,127564.5,1249.333,101.7619
"17198","53104","2018",20,20,0,110310.6,1163.2,97.35
"17199","53105","2018",6,6,0,142666.7,1280.5,109.1667
"17200","53106","2018",9,9,0,90333.33,1361,81.11111
"17201","53107","2018",24,23,1,122524.4,1099.208,109.9167
"17202","53108","2018",8,8,0,117187.5,1187.125,97.875
"17203","53109","2018",3,3,0,186666.7,1274,139.6667
"17204","53110","2018",3,3,0,98106.67,1243,84.66667
"17205","53111","2018",6,6,0,97000,1035.167,91.5
"17206","53112","2018",4,4,0,72625,982.5,69.5
"17207","53113","2018",3,3,0,107666.7,893.3333,115.6667
"17208","53114","2018",2,2,0,59000,780,76.5
"17209","53115","2018",5,5,0,109260,1061.2,103.8
"17210","53116","2018",5,5,0,78400,855.2,90
"17211","53117","2018",13,13,0,142874.2,1273.538,115.5385
"17212","53118","2018",1,1,0,71500,1100,65
"17213","53119","2018",53,53,0,181936.1,1729.019,106.6981
"17214","53120","2018",4,4,0,73000,1017,72.75
"17215","53121","2018",14,14,0,80285.71,840.6429,97.71429
"17216","53122","2018",11,11,0,149077.4,1206.909,135.1818
"17217","53123","2018",12,12,0,114375.8,1383,87.41667
"17218","53124","2018",13,12,1,100407.7,977.0769,101.7692
"17219","53125","2018",13,13,0,72311.54,1160.846,69.53846
"17220","53126","2018",8,8,0,93893.75,982.25,104.5
"17221","53127","2018",27,27,0,100444.8,854.4074,115.5926
"17222","53128","2018",6,6,0,76217.33,835,91.5
"17223","53129","2018",7,7,0,145857.1,1172.571,122.2857
"17224","53130","2018",744,376,368,132218.9,1656.954,78.32661
"17225","53131","2018",4,4,0,64725,833.5,75.25
"17226","53132","2018",3,3,0,123766.7,661.3333,184.6667
"17227","53133","2018",3,3,0,44333.33,576.3333,75
"17228","53134","2018",2,2,0,132000,999,117
"17229","53135","2018",7,7,0,120571.4,998.5714,122.1429
"17230","53136","2018",3,3,0,151000,1355.333,110
"17231","53137","2018",34,34,0,123627.6,1295.088,98.70588
"17232","53139","2018",5,5,0,74199,964.8,75.2
"17233","53140","2018",44,41,3,153623.7,1609.5,98.54545
"17234","53141","2018",10,10,0,131943.1,1319.8,100.9
"17235","53142","2018",8,7,1,44256.38,651.25,67.625
"17236","53143","2018",6,6,0,131750,1580.667,82.83333
"17237","53144","2018",12,12,0,82859.67,932.5,86.16667
"17238","53145","2018",7,7,0,110214.3,1060.429,107.1429
"17239","53146","2018",15,15,0,147773.5,1478,102.3333
"17240","53147","2018",120,100,20,121998.5,1346.775,91.51667
"17241","53148","2018",2,2,0,123000,1319.5,90.5
"17242","53150","2018",11,11,0,155659.1,1234.182,121
"17243","53151","2018",11,11,0,72363.64,760.1818,93.36364
"17244","53152","2018",24,23,1,118295.8,1359.75,87
"17245","53153","2018",8,8,0,132750,1156.5,114.375
"17246","53154","2018",5,5,0,94940.8,1018,93.6
"17247","53155","2018",20,20,0,81029,868.1,96.1
"17248","53156","2018",4,4,0,178675,1774.5,98
"17249","53157","2018",16,16,0,202597.3,1597.938,130.125
"17250","53158","2018",7,7,0,146714.3,1465.714,103.8571
"17251","53160","2018",2,2,0,75000,875.5,86.5
"17252","53161","2018",40,39,1,99881.05,1058.925,89.45
"17253","53162","2018",10,9,1,132031.7,1389.7,94.5
"17254","53163","2018",7,7,0,118899,1369.571,87.14286
"17255","53164","2018",10,9,1,45685,821.2,67.2
"17256","53165","2018",3,3,0,141766.7,1148.333,123.6667
"17257","53168","2018",14,12,2,151303.6,1391.214,107.0714
"17258","53169","2018",1,1,0,63500,722,88
"17259","53170","2018",20,20,0,99651.15,951.2,97.7
"17260","53172","2018",10,10,0,163550,1520.7,114.2
"17261","53173","2018",2,2,0,95000,800.5,163
"17262","53174","2018",5,5,0,145580,1462.4,100.2
"17263","53175","2018",13,13,0,163561.5,1554,105.2308
"17264","53176","2018",6,6,0,82700,742.6667,117.3333
"17265","53177","2018",1,1,0,45000,662,68
"17266","53178","2018",3,3,0,202500,1436.667,124
"17267","53179","2018",7,7,0,79932.71,805.2857,94.57143
"17268","53180","2018",3,3,0,97500,1018,117.6667
"17269","53181","2018",6,6,0,112583.3,921.3333,124.1667
"17270","53182","2018",30,29,1,77721.67,912.4667,84.8
"17271","53185","2018",30,30,0,95932.73,986.5667,103.6333
"17272","53186","2018",27,27,0,101568.5,1183.778,86.66667
"17273","53187","2018",1,1,0,150000,1471,102
"17274","53188","2018",38,38,0,77014.71,836.0789,87.28947
"17275","53189","2018",5,5,0,61200,1280,58.4
"17276","53190","2018",2,2,0,98570,1078.5,95
"17277","53191","2018",3,3,0,130500,1017.333,124.6667
"17278","53192","2018",5,5,0,133899,1163.2,116.8
"17279","53193","2018",7,7,0,91278.57,837,110
"17280","53195","2018",6,6,0,113250,1128.833,98.83333
"17281","53196","2018",5,5,0,83330,923.2,94.4
"17282","53197","2018",14,14,0,82914.29,888.9286,89.64286
"17283","53198","2018",2,2,0,102250,1002.5,102
"17284","53199","2018",3,3,0,116666.7,1118,114.3333
"17285","53200","2018",8,8,0,145354.6,1621.375,92.25
"17286","53201","2018",72,69,3,152856.2,1760.403,88.77778
"17287","53202","2018",3,3,0,126633.3,1329.667,95.66667
"17288","53203","2018",7,7,0,107271.4,1127.714,94.57143
"17289","53204","2018",5,5,0,66644,717.6,86.6
"17290","53206","2018",2,2,0,122750,1114.5,110.5
"17291","53208","2018",3,3,0,107500,943,117.6667
"17292","53209","2018",9,9,0,87111.11,1157.889,78.33333
"17293","53210","2018",12,12,0,108916.7,1173.5,100
"17294","53211","2018",14,14,0,117552.9,1138.714,108.0714
"17295","53212","2018",4,4,0,249625,2426,108
"17296","53213","2018",10,10,0,129425.8,1340.2,106.5
"17297","53214","2018",1,1,0,35300,569,62
"17298","53216","2018",6,6,0,103166.7,1110.5,94.33333
"17299","53218","2018",4,4,0,145000,1716.5,88.25
"17300","53219","2018",11,11,0,126285,1186.273,98.27273
"17301","53220","2018",5,5,0,89200,1198.6,75.6
"17302","53221","2018",4,4,0,88000,828.25,110.5
"17303","53222","2018",6,6,0,95703.83,1013.333,89.66667
"17304","53223","2018",5,5,0,68500,696.2,113.6
"17305","53224","2018",3,3,0,178674.7,1924,95.33333
"17306","53225","2018",8,8,0,87125,1091.875,78.25
"17307","53226","2018",15,14,1,117566.7,1079.467,112.8
"17308","53228","2018",6,6,0,87323.33,1357.5,76.16667
"17309","53229","2018",16,16,0,128821.8,1254.75,105.875
"17310","53230","2018",4,4,0,75900,830.5,93.75
"17311","53232","2018",3,3,0,138000,1357.667,100.6667
"17312","53233","2018",6,6,0,110333.3,1016.667,112.8333
"17313","53234","2018",3,3,0,91666.67,1127.333,83
"17314","53235","2018",5,5,0,62300,704.8,85.2
"17315","53236","2018",6,6,0,63416.67,742,86.83333
"17316","53237","2018",10,10,0,96928.7,1061.6,93.6
"17317","53238","2018",6,6,0,94635,944.3333,101.1667
"17318","53240","2018",3,3,0,188360,1585.333,113
"17319","53242","2018",4,4,0,99000,876.5,117
"17320","53243","2018",13,13,0,148761.5,1504.923,103.1538
"17321","53245","2018",11,11,0,95700,1055.545,89.45455
"17322","53246","2018",17,17,0,87079.41,867.8235,99
"17323","53247","2018",26,26,0,137602.7,1405.423,95.65385
"17324","53248","2018",2,2,0,115750,1260.5,89
"17325","53249","2018",15,15,0,130433.3,1196.267,108.9333
"17326","53250","2018",5,5,0,73700,791.4,94.4
"17327","53251","2018",5,5,0,49557.6,704.8,74.8
"17328","53253","2018",8,8,0,82051.5,929.875,83.125
"17329","53255","2018",20,19,1,121375,1221.15,99.85
"17330","53256","2018",5,5,0,124500,1014,120.2
"17331","53257","2018",5,5,0,82600,1165,76.6
"17332","53258","2018",7,7,0,109571.4,1013,103
"17333","53259","2018",2,2,0,102500,1132,91.5
"17334","53260","2018",2,2,0,95000,920,98
"17335","53261","2018",1,1,0,95000,399,238
"17336","53262","2018",7,7,0,96467.14,1048.143,86.85714
"17337","53263","2018",1,1,0,73300,1163,63
"17338","53264","2018",5,5,0,96420,999.4,94
"17339","53265","2018",7,7,0,117928.6,1117.286,117
"17340","53266","2018",2,2,0,158500,1697,95
"17341","53267","2018",16,16,0,113593.8,1237.062,92.8125
"17342","53269","2018",7,7,0,66600,826.4286,84.71429
"17343","53270","2018",1,1,0,92000,852,108
"17344","53271","2018",23,21,2,98776.91,1050.087,98.56522
"17345","53272","2018",4,4,0,63987.5,1137.25,65.25
"17346","53273","2018",12,12,0,94458.33,1021.667,94.41667
"17347","53276","2018",6,6,0,84916.67,1052.333,78.33333
"17348","54001","2018",4,4,0,160960,1660.25,114.25
"17349","54002","2018",3,3,0,156340,1556.333,101.6667
"17350","54003","2018",1,1,0,120000,1091,110
"17351","54004","2018",2,2,0,87500,783.5,122
"17352","54006","2018",4,4,0,156750,1450.25,95.75
"17353","54007","2018",2,2,0,125000,1157,108
"17354","54008","2018",2,2,0,173000,1106,157.5
"17355","54009","2018",2,2,0,194000,1852.5,105
"17356","54010","2018",6,5,1,114333.3,1042.667,112
"17357","54011","2018",6,5,1,134916.7,1210.833,97.16667
"17358","54012","2018",3,2,1,224333.3,1360,143.6667
"17359","54013","2018",1,1,0,68500,507,135
"17360","54014","2018",1,1,0,84000,420,200
"17361","54015","2018",4,3,1,110635,1211,87.75
"17362","54016","2018",2,2,0,154000,1373.5,125
"17363","54017","2018",1,1,0,160000,1176,136
"17364","54018","2018",4,4,0,80162.5,780.75,102
"17365","54020","2018",3,3,0,199530,1673.333,116.6667
"17366","54022","2018",4,4,0,98031.25,735.5,150.75
"17367","54024","2018",2,2,0,264730,2320.5,111
"17368","54025","2018",29,24,5,207186.9,1842.966,115.8621
"17369","54026","2018",1,1,0,117000,921,127
"17370","54027","2018",6,5,1,209166.7,1772.667,133.3333
"17371","54028","2018",43,21,22,74452.95,941.1628,81.93023
"17372","54029","2018",20,18,2,166267.9,1505.7,105.5
"17373","54031","2018",6,6,0,153825,1726.5,97.16667
"17374","54032","2018",4,4,0,106250,1193.25,82.25
"17375","54033","2018",1,1,0,168900,1289,131
"17376","54034","2018",1,1,0,171700,1137,151
"17377","54035","2018",3,3,0,82833.33,644.6667,135.3333
"17378","54036","2018",10,10,0,218096.7,1854,117.7
"17379","54037","2018",1,1,0,325000,2708,120
"17380","54038","2018",9,9,0,135825.6,1327,103.3333
"17381","54039","2018",44,36,8,108658.9,1097.864,98.5
"17382","54040","2018",15,14,1,75438.67,655.4,129.4667
"17383","54041","2018",1,1,0,64000,430,149
"17384","54042","2018",3,3,0,188750,1630,120
"17385","54043","2018",16,10,6,164038.3,1498.188,104.9375
"17386","54045","2018",9,8,1,154431.1,1406.111,111.5556
"17387","54046","2018",4,4,0,149000,1450.25,110.25
"17388","54047","2018",2,2,0,169500,1394,128.5
"17389","54048","2018",1,1,0,172000,1773,97
"17390","54049","2018",7,6,1,132578,1185.429,105.8571
"17391","54051","2018",17,16,1,164173.1,1766.353,94.41176
"17392","54053","2018",1,1,0,97000,1366,71
"17393","54054","2018",21,17,4,126854.8,1359.667,99.19048
"17394","54055","2018",7,7,0,124230,1458.714,93.28571
"17395","54057","2018",3,3,0,95000,884.6667,109
"17396","54058","2018",1,1,0,115000,742,155
"17397","54059","2018",9,8,1,171105.6,1453.222,118.4444
"17398","54060","2018",7,7,0,135028.6,1408.571,94.57143
"17399","54061","2018",6,5,1,124475,1296.167,98.5
"17400","54062","2018",4,4,0,199212.5,1488.5,129.5
"17401","54063","2018",3,3,0,153733.3,1030.333,185
"17402","54064","2018",4,4,0,68975,947.25,73.75
"17403","54065","2018",23,23,0,114873.5,1145.609,100.087
"17404","54066","2018",2,2,0,126825,1175.5,102.5
"17405","54067","2018",7,6,1,160357.1,1436.429,114
"17406","54069","2018",9,8,1,255117.9,2055.667,121.4444
"17407","54070","2018",4,4,0,162500,1610,103
"17408","54071","2018",1,1,0,1e+05,1000,100
"17409","54073","2018",10,10,0,141320,1381.8,102.4
"17410","54075","2018",2,2,0,138250,1446,98.5
"17411","54076","2018",38,34,4,120517,1366.658,91.18421
"17412","54077","2018",7,5,2,82271.43,639.4286,129
"17413","54078","2018",1,1,0,121000,637,190
"17414","54079","2018",27,21,6,143686.7,1484.852,95.77778
"17415","54080","2018",15,14,1,109856.9,1038.267,110.2
"17416","54081","2018",7,6,1,143164.3,1306,110.8571
"17417","54082","2018",3,3,0,136333.3,945,144.6667
"17418","54083","2018",1,1,0,142000,1543,92
"17419","54084","2018",11,11,0,98963.64,1007.727,95
"17420","54085","2018",3,3,0,115234,1014,114
"17421","54086","2018",4,3,1,88597.5,1080.25,77.75
"17422","54088","2018",3,3,0,143098.3,1016,143.3333
"17423","54089","2018",18,15,3,211130.6,1638.333,131.2222
"17424","54090","2018",54,51,3,176390.4,1938.537,92.01852
"17425","54091","2018",7,7,0,207664.3,1834.857,116.7143
"17426","54095","2018",1,1,0,53500,652,82
"17427","54096","2018",3,3,0,110333.3,2098,46
"17428","54098","2018",4,4,0,80500,612,128.25
"17429","54099","2018",142,79,63,108557.8,1264.944,85.60563
"17430","54100","2018",11,11,0,192412.4,1727.636,121.6364
"17431","54101","2018",2,2,0,193500,1529.5,124
"17432","54102","2018",6,6,0,174166.7,1375.5,133
"17433","54104","2018",2,2,0,129175,1123.5,109
"17434","54105","2018",11,10,1,136498,1198.545,118.6364
"17435","54106","2018",1,1,0,85000,842,101
"17436","54107","2018",1,1,0,180000,1452,124
"17437","54109","2018",12,12,0,162042.1,1590.833,103.5833
"17438","54110","2018",2,2,0,175160,1610.5,110.5
"17439","54111","2018",46,39,7,128647.6,1538.957,81.32609
"17440","54112","2018",9,9,0,166230,1384.778,124.1111
"17441","54113","2018",14,14,0,158079.5,1496.357,106.3571
"17442","54114","2018",5,4,1,104200,1110,94.6
"17443","54115","2018",75,45,30,147710.9,1629.653,89.02667
"17444","54116","2018",26,23,3,164169.6,1532.538,107.9231
"17445","54117","2018",2,2,0,129200,1427.5,92
"17446","54118","2018",9,9,0,79622.22,827.7778,95.88889
"17447","54119","2018",3,3,0,201166.7,1139.667,164.6667
"17448","54120","2018",4,4,0,116012.5,935.75,123.75
"17449","54121","2018",2,2,0,202424,1848.5,109
"17450","54122","2018",7,7,0,167757.1,1827,96.57143
"17451","54123","2018",22,20,2,176432.3,1912.045,94.86364
"17452","54124","2018",1,1,0,142000,826,172
"17453","54125","2018",4,4,0,121500,1417.5,85.5
"17454","54126","2018",1,0,1,38000,633,60
"17455","54127","2018",6,6,0,244966.2,1662.167,157
"17456","54128","2018",8,8,0,106750,1097,108.75
"17457","54129","2018",9,9,0,88110,824.5556,96.55556
"17458","54131","2018",6,6,0,201370,1337.5,147.1667
"17459","54132","2018",3,3,0,172583.3,1523.333,115.6667
"17460","54133","2018",3,3,0,70666.67,783.3333,88.66667
"17461","54134","2018",2,2,0,102500,1386,74
"17462","54135","2018",15,15,0,133717.3,1326.333,102.8667
"17463","54136","2018",17,16,1,138961.8,1564.588,87.82353
"17464","54137","2018",6,5,1,108500,1200.833,94.66667
"17465","54138","2018",33,23,10,247738.4,2320.939,104.8788
"17466","54139","2018",5,5,0,201300,1806.6,113.4
"17467","54140","2018",1,1,0,173190,1019,170
"17468","54141","2018",1,0,1,69430,964,72
"17469","54142","2018",3,3,0,159933.3,1590.333,104.6667
"17470","54143","2018",3,3,0,82666.67,905.3333,93.33333
"17471","54144","2018",2,2,0,137500,1165,120
"17472","54145","2018",5,5,0,158950,1510.4,103
"17473","54146","2018",6,5,1,121658.3,901.5,138
"17474","54148","2018",3,3,0,148500,1199,123.3333
"17475","54149","2018",36,30,6,176060.4,1649.639,106.3889
"17476","54150","2018",33,29,4,151667,1600.03,96.57576
"17477","54151","2018",13,12,1,204426.9,2061.308,100.2308
"17478","54152","2018",33,30,3,139016.2,1485.515,95.27273
"17479","54153","2018",1,1,0,190000,1329,143
"17480","54154","2018",8,8,0,115808.8,1042.875,115.375
"17481","54155","2018",5,5,0,173343,1153.8,151.6
"17482","54156","2018",3,3,0,130500,1082,118
"17483","54157","2018",38,32,6,126918.7,1516.237,84.47368
"17484","54159","2018",95,83,12,147943.2,1530.474,98.04211
"17485","54160","2018",3,3,0,138166.7,1069.333,130.6667
"17486","54161","2018",5,4,1,136370,1173.8,120.8
"17487","54162","2018",12,11,1,164402.5,1433.5,124.8333
"17488","54163","2018",3,3,0,118833.3,622.6667,190.6667
"17489","54165","2018",4,4,0,471625,2574.5,171.75
"17490","54166","2018",2,2,0,128000,1193.5,115
"17491","54167","2018",17,14,3,136879.4,1254.941,116
"17492","54168","2018",2,2,0,268500,1668.5,153.5
"17493","54169","2018",1,1,0,60000,400,150
"17494","54170","2018",1,1,0,85000,1000,85
"17495","54171","2018",7,7,0,175785.7,1385.714,130.7143
"17496","54172","2018",2,2,0,126350,1126.5,101.5
"17497","54173","2018",1,1,0,74900,1189,63
"17498","54174","2018",38,33,5,170697.6,1589.237,107.2368
"17499","54175","2018",6,6,0,153533.3,1129.333,138.6667
"17500","54176","2018",12,11,1,101729.2,981.6667,116.1667
"17501","54177","2018",2,2,0,197500,1211.5,170.5
"17502","54179","2018",1,1,0,263630,2560,103
"17503","54181","2018",7,6,1,136342.9,1415.714,99.28571
"17504","54182","2018",5,5,0,105176,861.4,121.8
"17505","54184","2018",130,49,81,160331.9,1913.069,83.1
"17506","54186","2018",12,12,0,283494.2,2309.917,124.3333
"17507","54188","2018",9,8,1,184173.1,1540.889,117.1111
"17508","54189","2018",8,8,0,98987.5,887.625,111.875
"17509","54191","2018",1,1,0,41000,410,100
"17510","54192","2018",3,3,0,143800,1350.667,108.6667
"17511","54194","2018",5,4,1,155600,1243.8,119.2
"17512","54195","2018",2,2,0,167500,1249,118.5
"17513","54196","2018",23,19,4,155007.2,1449.043,108.7826
"17514","54197","2018",24,21,3,203008.3,2027.5,101
"17515","54198","2018",3,3,0,205636.7,1612.333,128.6667
"17516","54199","2018",3,3,0,171333.3,1258.333,140.3333
"17517","54200","2018",1,1,0,120000,1132,106
"17518","54201","2018",4,4,0,105625,827.5,126.5
"17519","54202","2018",4,3,1,213575,1992.25,108.75
"17520","54203","2018",2,2,0,76000,1041,75
"17521","54205","2018",28,25,3,91214.11,1052.107,85.82143
"17522","54206","2018",4,4,0,111250,1096.25,109.5
"17523","54207","2018",1,1,0,55000,1146,48
"17524","54208","2018",1,1,0,115000,1917,60
"17525","54209","2018",1,1,0,150000,1546,97
"17526","54211","2018",4,4,0,96500,1075.25,94.75
"17527","54212","2018",3,3,0,212233.3,1713.667,124.3333
"17528","54213","2018",5,4,1,166200,1536.8,112.8
"17529","54214","2018",8,8,0,173062.5,1452.25,126.375
"17530","54215","2018",85,61,24,122310.1,1497.353,83.04706
"17531","54217","2018",5,5,0,164888,944.4,167.2
"17532","54221","2018",1,1,0,218000,1225,178
"17533","54222","2018",11,11,0,103464.5,993.6364,107.4545
"17534","54223","2018",1,1,0,89000,1236,72
"17535","54224","2018",2,2,0,144350,1906,76
"17536","54225","2018",6,5,1,172483.3,1242.5,142
"17537","54226","2018",1,1,0,1e+05,556,180
"17538","54227","2018",17,17,0,126068.1,1416.118,87.47059
"17539","54228","2018",1,1,0,20000,364,55
"17540","54229","2018",4,4,0,95225,1070.25,95.25
"17541","54230","2018",1,1,0,120000,667,180
"17542","54231","2018",3,3,0,146666.7,1230.333,112.6667
"17543","54232","2018",24,21,3,193270.8,1699.792,119.0833
"17544","54233","2018",1,1,0,350000,2800,125
"17545","54234","2018",36,30,6,170165.2,1683.556,105.9444
"17546","54235","2018",4,4,0,107875,954.25,110
"17547","54236","2018",4,4,0,136250,1017.25,132.25
"17548","54238","2018",4,4,0,76125,796,98.75
"17549","54239","2018",2,2,0,74463,876,83.5
"17550","54242","2018",4,4,0,90250,1117.5,83.25
"17551","54243","2018",3,3,0,97520,683.6667,138
"17552","54244","2018",4,3,1,209662.5,1502.5,137.75
"17553","54247","2018",2,2,0,181500,1140,164.5
"17554","54248","2018",1,1,0,160000,1391,115
"17555","54249","2018",4,3,1,131300,1129.25,121.75
"17556","54250","2018",9,8,1,161961.1,1461,117.3333
"17557","54251","2018",1,1,0,103430,796,130
"17558","54252","2018",5,5,0,151600,1183.2,135.6
"17559","54253","2018",7,7,0,162646.4,1514.286,112.2857
"17560","54254","2018",31,29,2,181959.5,1902.097,92.77419
"17561","54256","2018",2,2,0,142750,1634,87.5
"17562","54257","2018",39,37,2,235278.9,2222.385,106.1538
"17563","54258","2018",1,1,0,60000,441,136
"17564","54259","2018",2,2,0,127390,837.5,159
"17565","54260","2018",10,10,0,152633.5,1387.7,113.5
"17566","54261","2018",51,39,12,103072.5,1407.647,74.60784
"17567","54262","2018",1,0,1,150000,789,190
"17568","54263","2018",87,74,13,100033.9,1149.943,88.01149
"17569","54264","2018",2,2,0,199000,1752.5,113.5
"17570","54265","2018",21,17,4,243264.9,2244.333,108.0952
"17571","54266","2018",3,3,0,89333.33,762.3333,113.3333
"17572","54269","2018",4,4,0,182237.5,1455.25,137.75
"17573","54270","2018",50,38,12,148110.2,1593.66,91
"17574","54272","2018",4,4,0,160975,1149.25,146
"17575","54273","2018",90,65,25,122412.9,1384.411,86.78889
"17576","54274","2018",99,40,59,130357.1,1659.727,77.69697
"17577","54275","2018",5,5,0,138770,1089.6,134.8
"17578","54276","2018",8,8,0,119875,1106.125,112.375
"17579","54277","2018",2,2,0,177000,1559.5,113.5
"17580","54278","2018",2,2,0,90500,573.5,145
"17581","54279","2018",17,15,2,131170.6,1363.412,109.7647
"17582","54280","2018",85,54,31,68153.93,864.8235,78.69412
"17583","54281","2018",9,9,0,153777.8,1430.111,104.5556
"17584","54283","2018",2,2,0,225125,1242.5,186.5
"17585","54284","2018",19,19,0,85626.32,951.2632,91.42105
"17586","54285","2018",1,1,0,170000,1328,128
"17587","54286","2018",13,11,2,123969.2,1414.692,84.38462
"17588","54287","2018",2,2,0,120000,1231,98.5
"17589","54288","2018",5,5,0,160536,1442.2,121.4
"17590","54289","2018",2,2,0,131000,894.5,147
"17591","54290","2018",3,3,0,109333.3,1104.667,101.6667
"17592","54291","2018",2,2,0,202500,1257,159
"17593","54292","2018",2,2,0,109500,1037.5,105.5
"17594","54294","2018",1,1,0,137000,1370,100
"17595","54295","2018",11,8,3,114436.8,1135.182,95.36364
"17596","54296","2018",2,2,0,257425,1563,169.5
"17597","54297","2018",5,5,0,140600,1204.6,117.2
"17598","54298","2018",2,2,0,108800,576.5,185
"17599","54300","2018",79,54,25,178314.6,1940.633,90.43038
"17600","54301","2018",2,2,0,165750,1678,98.5
"17601","54302","2018",10,10,0,167220,1785.7,93.6
"17602","54303","2018",5,4,1,101000,1337,91.2
"17603","54304","2018",159,35,124,142080.7,1724.956,79.71069
"17604","54305","2018",23,21,2,227823.5,1838.957,123.2609
"17605","54306","2018",2,2,0,95000,932.5,99.5
"17606","54307","2018",3,3,0,204416.7,1331.333,150
"17607","54309","2018",5,5,0,178051,1396.8,120.4
"17608","54311","2018",11,11,0,159665.5,1278.545,124.0909
"17609","54312","2018",4,4,0,130000,1108.75,114.75
"17610","54313","2018",2,2,0,214500,1893,114
"17611","54314","2018",22,21,1,217252.3,2023.045,106.1818
"17612","54315","2018",11,11,0,185456.4,1721.545,109
"17613","54316","2018",2,2,0,109000,1128,99
"17614","54318","2018",80,73,7,149035.4,1503.625,101.7125
"17615","54320","2018",6,5,1,107134.7,1119.667,103.3333
"17616","54321","2018",13,7,6,134446.2,1735.538,82.23077
"17617","54322","2018",55,42,13,100253.6,1122.309,87.4
"17618","54323","2018",163,105,58,128557.4,1413.252,93.25153
"17619","54326","2018",4,4,0,152250,1457,111.25
"17620","54327","2018",10,10,0,168570,1359.3,130.4
"17621","54328","2018",61,46,15,218054.7,2194.23,97.96721
"17622","54329","2018",189,120,69,109025.6,1181.582,93.93651
"17623","54330","2018",7,7,0,268422.9,1791.143,147.8571
"17624","54331","2018",2,2,0,105000,823,117
"17625","54332","2018",17,14,3,166507.6,1905.529,93.29412
"17626","54333","2018",2,2,0,95225,1275,68.5
"17627","54334","2018",7,6,1,121602.9,981.4286,131.4286
"17628","54335","2018",3,3,0,108333.3,1007.667,94.66667
"17629","54336","2018",13,12,1,171704.6,1387.538,123.6923
"17630","54337","2018",3,3,0,161800.7,1260,128.3333
"17631","54338","2018",2,2,0,203500,1553.5,130.5
"17632","54339","2018",126,66,60,151884.1,1722.095,87.36508
"17633","54340","2018",2,2,0,123000,2106,60.5
"17634","54344","2018",2,2,0,103500,997,102.5
"17635","54345","2018",1,1,0,66000,1467,45
"17636","54346","2018",1,1,0,209450,1575,133
"17637","54348","2018",2,2,0,62500,1034,59.5
"17638","54349","2018",1,1,0,105000,833,126
"17639","54350","2018",2,2,0,172000,1283,148.5
"17640","54351","2018",28,24,4,121154.3,1397,90.03571
"17641","54352","2018",11,11,0,165966.4,1351.909,129.4545
"17642","54353","2018",10,10,0,161572.5,1307.4,128.1
"17643","54356","2018",1,1,0,78000,736,106
"17644","54357","2018",99,48,51,131496.8,1680.808,77.49495
"17645","54358","2018",2,2,0,199600,1693,122.5
"17646","54359","2018",5,4,1,144403.6,1182.2,137.4
"17647","54360","2018",3,3,0,141500,1086.667,142.3333
"17648","54362","2018",11,10,1,126612.3,1093.273,111.1818
"17649","54363","2018",3,3,0,163333.3,1036,143
"17650","54364","2018",16,16,0,173043.8,1684.75,107.9375
"17651","54365","2018",4,4,0,51000,743.75,73.75
"17652","54366","2018",26,25,1,191931.9,1879.846,100.8462
"17653","54367","2018",28,25,3,159305.7,1772.786,90.46429
"17654","54369","2018",8,7,1,209660.5,1292,178.25
"17655","54370","2018",1,1,0,140500,1266,111
"17656","54371","2018",10,10,0,142429,1590.3,89.6
"17657","54372","2018",4,4,0,74312.5,728,104
"17658","54373","2018",6,6,0,160816.7,1601,97.66667
"17659","54374","2018",4,4,0,168075,1698.25,97.25
"17660","54375","2018",9,9,0,138933.2,1538.778,100.7778
"17661","54376","2018",6,6,0,152233.3,1381.5,112.5
"17662","54378","2018",1,1,0,72450,906,80
"17663","54379","2018",1,1,0,147000,1531,96
"17664","54380","2018",2,2,0,159500,1247.5,141.5
"17665","54382","2018",60,48,12,114428.6,1333.733,84.03333
"17666","54383","2018",14,14,0,144860.7,1402.929,100.5
"17667","54385","2018",19,19,0,199520,1821.368,109.6316
"17668","54386","2018",1,1,0,33000,541,61
"17669","54389","2018",1,1,0,190870,1631,117
"17670","54390","2018",1,1,0,233000,1835,127
"17671","54391","2018",23,22,1,95638.26,1177.783,82.52174
"17672","54392","2018",3,3,0,98443.33,1132.667,89.33333
"17673","54394","2018",2,2,0,129850,1928.5,73
"17674","54395","2018",1946,208,1738,138882.9,1984.691,69.8186
"17675","54396","2018",2,2,0,248000,2669,146
"17676","54397","2018",72,58,14,133485.8,1551.847,87.58333
"17677","54399","2018",4,4,0,85875,767.25,107.5
"17678","54400","2018",9,9,0,147768.9,1261,117.8889
"17679","54402","2018",4,4,0,132500,1103.25,125.25
"17680","54403","2018",10,8,2,189835,1790.8,106
"17681","54404","2018",3,3,0,184466.7,965.6667,196.3333
"17682","54405","2018",9,9,0,178646.8,1478.667,120.4444
"17683","54406","2018",6,6,0,136583.3,1011,136.5
"17684","54407","2018",2,2,0,73250,1108,66
"17685","54408","2018",3,3,0,89000,795.3333,114
"17686","54410","2018",8,8,0,151206.2,1351.625,125.625
"17687","54411","2018",2,2,0,242000,1755,157.5
"17688","54413","2018",1,1,0,122800,877,140
"17689","54414","2018",8,8,0,143834.5,1381.5,99.875
"17690","54415","2018",39,31,8,155954.5,1678.667,96.41026
"17691","54416","2018",4,4,0,121145,1215.75,104.5
"17692","54417","2018",2,2,0,132500,691.5,192.5
"17693","54420","2018",1,1,0,85000,1181,72
"17694","54421","2018",2,2,0,79250,800,113
"17695","54422","2018",2,2,0,70000,627.5,111
"17696","54423","2018",2,2,0,146500,987,148.5
"17697","54424","2018",1,1,0,210000,1419,148
"17698","54425","2018",36,32,4,96733.33,1079.472,92.02778
"17699","54426","2018",8,7,1,108043.2,1243.125,86.375
"17700","54427","2018",4,4,0,101712.5,891,99.5
"17701","54428","2018",13,9,4,74096.92,871.6154,85.46154
"17702","54429","2018",3,3,0,106333.3,884,117
"17703","54430","2018",56,46,10,113454.5,1475.018,76.76786
"17704","54431","2018",150,90,60,138965.3,1526.567,93.05333
"17705","54432","2018",22,19,3,133977.3,1601.273,85.31818
"17706","54433","2018",1,1,0,118499,987,120
"17707","54434","2018",4,4,0,84250,1130.25,96
"17708","54435","2018",6,6,0,149958.3,1000.667,147.1667
"17709","54436","2018",2,2,0,55000,593.5,91
"17710","54437","2018",12,12,0,126800,1509.083,84.33333
"17711","54438","2018",1,1,0,45000,542,83
"17712","54439","2018",52,40,12,184599.5,1828.885,98.57692
"17713","54440","2018",1,1,0,82638,879,94
"17714","54441","2018",2,2,0,132570,1196.5,104.5
"17715","54442","2018",1,1,0,140000,966,145
"17716","54443","2018",1,1,0,27570,574,48
"17717","54444","2018",4,4,0,128309,1446.5,87.25
"17718","54445","2018",1,1,0,137750,612,225
"17719","54449","2018",12,12,0,158716.7,1352.5,119.75
"17720","54451","2018",36,25,11,124810.6,1383.778,86.19444
"17721","54453","2018",4,4,0,124150,1596,96.25
"17722","54455","2018",1,1,0,159000,1136,140
"17723","54456","2018",2,2,0,195650,1754.5,111.5
"17724","54459","2018",24,23,1,211460.4,2080.75,104.9583
"17725","54460","2018",2,2,0,154800,1258.5,123
"17726","54462","2018",25,18,7,132406,1502.96,89.4
"17727","54463","2018",4,4,0,228232.5,1577.5,148
"17728","54464","2018",2,2,0,142500,1049.5,189
"17729","54465","2018",5,4,1,184140,1500.8,122.2
"17730","54466","2018",2,2,0,157000,1129,136
"17731","54467","2018",2,2,0,176740,1011,183
"17732","54468","2018",2,2,0,188500,1215,146
"17733","54469","2018",4,4,0,196625,1840.25,126.75
"17734","54470","2018",1,1,0,149000,1886,79
"17735","54471","2018",2,2,0,87500,719.5,122.5
"17736","54472","2018",7,6,1,128621.4,1244.571,102
"17737","54473","2018",1,1,0,75000,641,117
"17738","54475","2018",4,4,0,152420,1241.25,125.75
"17739","54476","2018",6,5,1,100750,929,110.1667
"17740","54478","2018",2,1,1,113150,1184.5,101.5
"17741","54479","2018",1,1,0,110000,1222,90
"17742","54481","2018",1,1,0,118000,1204,98
"17743","54482","2018",149,41,108,131468.1,1746.792,75.65772
"17744","54483","2018",83,51,32,125940.3,1432.892,88.27711
"17745","54484","2018",3,3,0,135933.3,1313.333,134
"17746","54485","2018",4,4,0,159762.5,1582.5,104.75
"17747","54486","2018",6,6,0,143391.7,1538.333,90.5
"17748","54488","2018",1,1,0,1e+05,893,112
"17749","54490","2018",13,10,3,143851.5,1191.077,123.6923
"17750","54491","2018",1,1,0,253300,2076,122
"17751","54493","2018",30,23,7,116112.3,1520.867,83.06667
"17752","54495","2018",46,45,1,205027.5,1994.761,105.2174
"17753","54496","2018",1,1,0,46200,462,100
"17754","54497","2018",1,1,0,132500,736,180
"17755","54498","2018",60,58,2,182288.7,1870.3,100.4167
"17756","54500","2018",2,2,0,134500,1760,76
"17757","54501","2018",2,2,0,103250,623.5,160
"17758","54502","2018",2,2,0,156000,872.5,178.5
"17759","54504","2018",9,8,1,216644.4,1898.333,112.5556
"17760","54505","2018",4,4,0,157125,1109.25,137.25
"17761","54508","2018",2,1,1,163400,1546,117
"17762","54509","2018",12,12,0,126527.8,1368.833,83.25
"17763","54510","2018",2,2,0,115500,1006,115
"17764","54511","2018",1,1,0,133000,1304,102
"17765","54512","2018",1,1,0,130000,812,160
"17766","54513","2018",2,2,0,139000,1167.5,118.5
"17767","54514","2018",3,3,0,186266,2149,87.33333
"17768","54515","2018",1,1,0,164700,1267,130
"17769","54517","2018",4,4,0,117012.5,934,118.25
"17770","54518","2018",9,9,0,121568,1155.333,109.7778
"17771","54519","2018",4,4,0,90750,1064,85.75
"17772","54520","2018",4,4,0,102875,1107,91.5
"17773","54521","2018",22,18,4,178871.4,1787.5,98.54545
"17774","54522","2018",2,2,0,99125,882,113
"17775","54523","2018",1,1,0,90500,503,180
"17776","54525","2018",8,6,2,231358.8,2006.375,113.375
"17777","54526","2018",136,95,41,170285.2,1987.051,84.80882
"17778","54527","2018",9,9,0,198508.9,1425.556,138.8889
"17779","54528","2018",166,83,83,120775.7,1432.47,88.37952
"17780","54530","2018",1,1,0,171000,864,198
"17781","54531","2018",1,1,0,71000,497,143
"17782","54533","2018",36,36,0,143371.2,1436.417,99.94444
"17783","54534","2018",3,3,0,104333.3,838,123.6667
"17784","54535","2018",2,2,0,132666.5,1266.5,101.5
"17785","54536","2018",46,42,4,103604.9,1263.174,82.13043
"17786","54537","2018",5,5,0,267030,2011.6,131.2
"17787","54538","2018",4,4,0,120025,903,128.5
"17788","54539","2018",2,2,0,61500,683.5,86
"17789","54540","2018",1,1,0,95000,1056,90
"17790","54541","2018",1,1,0,156905,1353,116
"17791","54542","2018",33,31,2,138993,1403.152,100.5152
"17792","54543","2018",1,1,0,20000,1538,13
"17793","54544","2018",2,2,0,307200,1324,270
"17794","54545","2018",1,1,0,138000,1769,78
"17795","54546","2018",10,10,0,173400,1625.8,106.9
"17796","54547","2018",301,82,219,116189.3,1650.13,71.47508
"17797","54548","2018",5,5,0,107220,1101.6,97.6
"17798","54549","2018",47,39,8,141657.9,1540.468,93.55319
"17799","54550","2018",2,2,0,138200,1334.5,105.5
"17800","54553","2018",1,1,0,120000,1690,71
"17801","54554","2018",1,1,0,144000,2087,69
"17802","54556","2018",1,1,0,166000,1085,153
"17803","54557","2018",24,24,0,260289.3,2156.542,125.125
"17804","54558","2018",1,1,0,213000,2196,97
"17805","54559","2018",5,5,0,178545,1565.4,108
"17806","54563","2018",10,9,1,168130,1190.2,155
"17807","54564","2018",5,5,0,109260,1144.4,96.8
"17808","54565","2018",2,2,0,205000,1294,155
"17809","54567","2018",3,3,0,101000,741.6667,124.3333
"17810","54568","2018",4,4,0,177125,1724,101.5
"17811","54569","2018",3,3,0,200333.3,1385.333,149.3333
"17812","54570","2018",2,2,0,203785,1564,136.5
"17813","54571","2018",9,8,1,197644.4,1639.889,117.1111
"17814","54572","2018",7,7,0,159442.9,1445.857,113.1429
"17815","54573","2018",1,1,0,82500,1500,55
"17816","54574","2018",9,9,0,230938.9,1879.444,129.6667
"17817","54575","2018",14,12,2,192877.1,1937.643,101.5714
"17818","54577","2018",1,1,0,60000,484,124
"17819","54578","2018",203,102,101,166947.4,1974.778,84.67488
"17820","54579","2018",5,5,0,190160,1447.8,134.8
"17821","54580","2018",173,134,39,123306.1,1533.052,81.00578
"17822","54581","2018",1,1,0,68000,944,72
"17823","54582","2018",1,1,0,110000,1000,110
"17824","54583","2018",1,1,0,203000,1880,108
"17825","54584","2018",9,8,1,194774.4,1571.778,129.4444
"17826","54585","2018",4,4,0,140750,1145.5,142.25
"17827","54586","2018",7,7,0,141914.3,1179,129
"17828","54587","2018",1,1,0,135250,2081,65
"17829","54588","2018",1,1,0,177000,843,210
"17830","54590","2018",9,9,0,173444.4,1476.778,118.5556
"17831","54591","2018",4,4,0,184300,1711.25,112.25
"17832","54593","2018",3,3,0,168053.3,1641.333,99.33333
"17833","54594","2018",3,3,0,153756.7,1178.667,130
"17834","54595","2018",3,3,0,112400,1346.333,85.33333
"17835","54596","2018",15,15,0,193695.3,1592,132.2
"17836","54597","2018",8,7,1,129437.5,1241.125,101.5
"17837","54598","2018",1,1,0,131450,1133,116
"17838","54599","2018",1,1,0,35000,412,85
"17839","54600","2018",1,1,0,120000,1429,84
"17840","54602","2018",1,1,0,90000,750,120
"17841","55001","2018",4,4,0,60124.75,641.5,83.75
"17842","55002","2018",1,1,0,79000,494,160
"17843","55004","2018",1,1,0,81250,923,88
"17844","55008","2018",2,2,0,127040,833.5,151
"17845","55009","2018",6,6,0,131300,1046,131
"17846","55010","2018",27,27,0,134683.3,1122.63,120.2222
"17847","55011","2018",1,1,0,1e+05,813,123
"17848","55012","2018",5,5,0,185800,2693.2,89.6
"17849","55013","2018",3,2,1,136200,1345,119
"17850","55014","2018",6,6,0,85666.67,714.5,122.8333
"17851","55015","2018",6,6,0,118661.7,1236.667,95.66667
"17852","55017","2018",1,1,0,50000,556,90
"17853","55021","2018",3,3,0,73333.33,646,110.6667
"17854","55022","2018",2,2,0,53000,497.5,106
"17855","55023","2018",3,3,0,62611,520,119.3333
"17856","55024","2018",2,2,0,143875,1185.5,131
"17857","55025","2018",1,1,0,1e+05,1149,87
"17858","55026","2018",1,1,0,81000,1080,75
"17859","55027","2018",2,2,0,92000,634.5,149
"17860","55029","2018",166,99,67,108533.6,1142.771,93.45783
"17861","55031","2018",4,4,0,149175,1326.75,114.5
"17862","55034","2018",1,1,0,85000,766,111
"17863","55035","2018",5,5,0,123800,848.6,132.6
"17864","55037","2018",1,1,0,65000,504,129
"17865","55038","2018",2,2,0,70500,906.5,77.5
"17866","55040","2018",1,1,0,47500,766,62
"17867","55041","2018",11,11,0,132272.7,1262.455,102.1818
"17868","55042","2018",6,5,1,143983.3,1319.5,110.5
"17869","55043","2018",37,31,6,136234.7,1349.27,101.2973
"17870","55045","2018",2,2,0,111000,1045,101
"17871","55046","2018",1,1,0,20000,333,60
"17872","55047","2018",1,1,0,80000,506,158
"17873","55048","2018",1,1,0,115000,1438,80
"17874","55049","2018",4,4,0,88275,851.5,107.5
"17875","55053","2018",5,5,0,103130,739.6,137.4
"17876","55054","2018",2,2,0,40000,406.5,97.5
"17877","55057","2018",1,1,0,131000,1260,104
"17878","55058","2018",6,6,0,123583.3,1233,107.8333
"17879","55060","2018",1,1,0,53000,402,132
"17880","55061","2018",2,2,0,75000,669,122
"17881","55062","2018",1,1,0,94000,1044,90
"17882","55063","2018",36,35,1,75111.94,838.5833,87.08333
"17883","55064","2018",1,1,0,150000,1456,103
"17884","55065","2018",2,2,0,104150,708.5,140
"17885","55069","2018",1,1,0,175000,972,180
"17886","55070","2018",2,2,0,148000,946.5,159
"17887","55071","2018",6,6,0,64083.33,689.3333,94.33333
"17888","55072","2018",3,3,0,111866.7,818.3333,138.3333
"17889","55073","2018",6,5,1,161250,1492,109.5
"17890","55075","2018",2,2,0,243750,1913,106.5
"17891","55076","2018",2,2,0,140000,1022,143
"17892","55077","2018",3,3,0,142000,1472.333,91.33333
"17893","55078","2018",2,2,0,66250,592,96
"17894","55079","2018",10,10,0,145970,1286.2,118.9
"17895","55081","2018",1,1,0,78000,1114,70
"17896","55083","2018",2,2,0,142500,659.5,196.5
"17897","55085","2018",5,5,0,144400,936.4,155.8
"17898","55087","2018",1,1,0,119350,597,200
"17899","55088","2018",1,1,0,76000,1169,65
"17900","55089","2018",2,2,0,77850,673.5,115.5
"17901","55093","2018",5,5,0,88900,799.6,116.4
"17902","55094","2018",2,2,0,87000,1002.5,87.5
"17903","55095","2018",1,1,0,47000,662,71
"17904","55097","2018",6,6,0,100250,832,117.1667
"17905","55099","2018",2,2,0,146500,1106.5,136.5
"17906","55101","2018",1,1,0,140000,986,142
"17907","55102","2018",8,8,0,162450,1267.875,135
"17908","55105","2018",2,2,0,115000,1570,73
"17909","55106","2018",2,2,0,105000,1193.5,87.5
"17910","55107","2018",1,1,0,195000,1168,167
"17911","55108","2018",1,1,0,85000,528,161
"17912","55109","2018",1,1,0,98000,838,117
"17913","55110","2018",1,1,0,95000,864,110
"17914","55111","2018",4,4,0,128000,1113.75,106
"17915","55113","2018",1,1,0,38000,352,108
"17916","55114","2018",4,4,0,163500,852.25,175.5
"17917","55117","2018",8,8,0,91625,795.75,114.125
"17918","55118","2018",1,1,0,164200,1346,122
"17919","55119","2018",7,7,0,73785.71,767.8571,99.42857
"17920","55120","2018",11,11,0,143154.5,1496.273,94.45455
"17921","55121","2018",2,2,0,59000,843,65
"17922","55122","2018",34,31,3,93375.76,1065.5,86.26471
"17923","55123","2018",3,3,0,81333.33,665.3333,116.6667
"17924","55124","2018",4,4,0,138500,956,162
"17925","55125","2018",9,9,0,110773.3,1195.556,93.11111
"17926","55132","2018",18,16,2,103595.8,994.3889,103.2778
"17927","55134","2018",1,1,0,120000,642,187
"17928","55138","2018",1,1,0,60000,545,110
"17929","55141","2018",2,2,0,92500,673,136
"17930","55142","2018",3,3,0,75666.67,1192.667,76.66667
"17931","55143","2018",1,1,0,103000,945,109
"17932","55144","2018",1,1,0,30000,462,65
"17933","55145","2018",7,7,0,168000,1216.714,149.5714
"17934","55148","2018",1,1,0,160000,821,195
"17935","55150","2018",2,2,0,75000,505.5,140
"17936","55154","2018",16,16,0,119343.8,1287.812,90.6875
"17937","55155","2018",4,4,0,131917.5,1110.5,124.25
"17938","55158","2018",12,12,0,119637.5,1357.667,91.33333
"17939","55159","2018",3,3,0,107466.7,916.6667,120.6667
"17940","55163","2018",1,1,0,119000,595,200
"17941","55165","2018",2,2,0,120000,902.5,139.5
"17942","55166","2018",14,14,0,110421.4,1197.643,92.07143
"17943","55167","2018",6,5,1,79175.33,627.5,124.6667
"17944","55169","2018",7,6,1,108678.6,1082.286,104.2857
"17945","55170","2018",2,2,0,51000,626.5,82
"17946","55171","2018",2,2,0,185450,1379.5,134
"17947","55172","2018",1,1,0,86000,662,130
"17948","55174","2018",1,1,0,123000,2050,60
"17949","55177","2018",1,1,0,90000,900,100
"17950","55178","2018",2,2,0,128135,1114.5,114.5
"17951","55179","2018",1,1,0,104000,812,128
"17952","55180","2018",1,1,0,25000,463,54
"17953","55181","2018",31,28,3,115279.6,1022.742,114.7742
"17954","55182","2018",2,2,0,229500,1303,178
"17955","55183","2018",1,1,0,38000,760,50
"17956","55184","2018",20,20,0,101090,904.55,111.85
"17957","55186","2018",17,17,0,110771.3,990.5294,116.0588
"17958","55188","2018",3,3,0,182000,1304,147.6667
"17959","55191","2018",2,2,0,173600,1209.5,146
"17960","55192","2018",1,1,0,35000,422,83
"17961","55193","2018",2,2,0,147000,1225.5,119.5
"17962","55195","2018",1,1,0,130000,1121,116
"17963","55196","2018",1,1,0,95000,819,116
"17964","55197","2018",4,4,0,163700,1216.25,143
"17965","55198","2018",9,8,1,129111.3,1180,117.8889
"17966","55199","2018",1,1,0,106580,943,113
"17967","55200","2018",2,2,0,142000,1161.5,123.5
"17968","55201","2018",1,1,0,90000,957,94
"17969","55202","2018",3,3,0,89000,914,94
"17970","55206","2018",2,2,0,45000,518.5,88
"17971","55214","2018",1,1,0,18000,346,52
"17972","55215","2018",3,3,0,81000,980,84.33333
"17973","55217","2018",2,2,0,47000,782,71
"17974","55219","2018",1,1,0,159000,1383,115
"17975","55220","2018",1,1,0,260000,1040,250
"17976","55221","2018",2,2,0,130700,1062.5,123
"17977","55222","2018",2,2,0,154350,1599.5,96.5
"17978","55224","2018",6,6,0,129891.7,1184.833,109.8333
"17979","55225","2018",1,1,0,160000,1067,150
"17980","55228","2018",5,5,0,78572,744.4,102.8
"17981","55229","2018",9,9,0,147192.2,1150,125.6667
"17982","55232","2018",1,1,0,322000,1952,165
"17983","55236","2018",13,13,0,121723.1,1198.538,97.46154
"17984","55237","2018",1,1,0,40000,331,121
"17985","55241","2018",1,1,0,80000,1159,69
"17986","55242","2018",3,3,0,97666.67,995,94
"17987","55243","2018",3,3,0,174333.3,1761.333,102
"17988","55244","2018",2,2,0,66250,547.5,122.5
"17989","55246","2018",1,1,0,115000,661,174
"17990","55250","2018",3,3,0,84513.33,680.3333,122.3333
"17991","55251","2018",1,1,0,116346,1939,60
"17992","55252","2018",1,1,0,34500,493,70
"17993","55253","2018",10,10,0,93490,944,98
"17994","55255","2018",4,4,0,103500,679.75,149.75
"17995","55257","2018",1,1,0,119000,915,130
"17996","55258","2018",8,8,0,150284.4,2262.125,101.25
"17997","55260","2018",1,1,0,105050,1751,60
"17998","55261","2018",1,1,0,180000,1071,168
"17999","55262","2018",6,6,0,63376.83,851.1667,80
"18000","55263","2018",3,3,0,97333.33,795.6667,150.6667
"18001","55264","2018",5,5,0,73600,781.8,93.2
"18002","55265","2018",2,2,0,120000,1365,100
"18003","55266","2018",1,1,0,89000,1011,88
"18004","55267","2018",3,3,0,133333.3,1219,115
"18005","55268","2018",10,10,0,112600,1098.4,102.4
"18006","55271","2018",1,1,0,75000,815,92
"18007","55272","2018",6,6,0,144326.7,916.6667,155.8333
"18008","55274","2018",2,2,0,100500,993.5,106.5
"18009","55275","2018",2,2,0,62450,536.5,116
"18010","55276","2018",3,3,0,116000,941.6667,116
"18011","55278","2018",4,4,0,71697.5,651.75,115.5
"18012","55279","2018",3,3,0,75533.33,530.6667,144.6667
"18013","55280","2018",1,1,0,194000,1780,109
"18014","55281","2018",1,1,0,155000,1140,136
"18015","55282","2018",1,1,0,115000,1173,98
"18016","55284","2018",1,1,0,48500,334,145
"18017","55285","2018",1,1,0,60000,923,65
"18018","55286","2018",2,2,0,144500,1542.5,93
"18019","55288","2018",9,9,0,104888.9,1137.556,95
"18020","55291","2018",35,28,7,93275.14,1014.771,95.25714
"18021","55293","2018",1,1,0,70000,1129,62
"18022","55296","2018",10,10,0,97911.4,974.5,102.6
"18023","55297","2018",1,1,0,71000,607,117
"18024","55298","2018",3,3,0,81266.67,1319.667,68.66667
"18025","55300","2018",6,6,0,170266.7,1178.833,134.3333
"18026","55301","2018",2,2,0,47250,454.5,101.5
"18027","55302","2018",19,19,0,123572.9,1318.789,100.1053
"18028","55304","2018",2,2,0,157000,1109.5,143
"18029","55312","2018",1,1,0,155000,1230,126
"18030","55313","2018",2,2,0,120945,894.5,135
"18031","55315","2018",2,2,0,71250,858.5,87.5
"18032","55316","2018",1,1,0,42500,675,63
"18033","55317","2018",3,3,0,104333.3,1035.333,101.3333
"18034","55321","2018",3,3,0,146966.7,1610.333,90.33333
"18035","55322","2018",1,1,0,90500,487,186
"18036","55324","2018",6,6,0,152166.7,1622.167,101.6667
"18037","55327","2018",3,3,0,107500,955,123
"18038","55328","2018",3,3,0,61333.33,743,93.66667
"18039","55329","2018",2,2,0,62500,702,90
"18040","55330","2018",1,1,0,66956,744,90
"18041","55332","2018",3,3,0,159500,1086.667,177.6667
"18042","55334","2018",1,1,0,84446,384,220
"18043","55335","2018",1,1,0,78000,780,100
"18044","55336","2018",3,3,0,110666.7,910,120.3333
"18045","55338","2018",1,1,0,49000,803,61
"18046","55339","2018",3,3,0,94333.33,795,118.3333
"18047","55340","2018",3,3,0,103666.7,1034.667,96
"18048","55341","2018",1,1,0,165500,1591,104
"18049","55345","2018",2,2,0,61000,878,84.5
"18050","55346","2018",4,4,0,109975,845.5,132.5
"18051","55347","2018",1,1,0,40000,500,80
"18052","55348","2018",2,2,0,107500,1113.5,95.5
"18053","55349","2018",2,2,0,93000,690,182.5
"18054","55351","2018",10,9,1,130888,1155.2,110.1
"18055","55356","2018",1,1,0,171000,1140,150
"18056","55358","2018",2,2,0,33500,635.5,58.5
"18057","55359","2018",2,2,0,135500,1430,93.5
"18058","55360","2018",1,1,0,105400,1013,104
"18059","55361","2018",1,1,0,149600,1609,93
"18060","55362","2018",1,1,0,90000,841,107
"18061","55364","2018",6,6,0,107500,769.6667,148.3333
"18062","55366","2018",5,5,0,135460,1177.6,117.4
"18063","55368","2018",2,2,0,116000,1017.5,111
"18064","55369","2018",6,6,0,87933.33,851.6667,114
"18065","55372","2018",5,5,0,84400,840.2,110.2
"18066","55373","2018",3,3,0,62480,721.3333,82.66667
"18067","55374","2018",1,1,0,54600,709,77
"18068","55377","2018",1,1,0,120000,667,180
"18069","55379","2018",1,1,0,46500,1292,36
"18070","55382","2018",2,2,0,97750,1098.5,88.5
"18071","55383","2018",3,3,0,60500,474.3333,127.3333
"18072","55384","2018",2,2,0,87596,595.5,157.5
"18073","55385","2018",6,6,0,140778.8,1183.167,125.8333
"18074","55388","2018",3,3,0,133333.3,1617,86.33333
"18075","55389","2018",3,3,0,81483.33,828.6667,120
"18076","55391","2018",2,2,0,61500,786.5,80
"18077","55396","2018",4,4,0,101000,612.25,168.75
"18078","55397","2018",6,6,0,94916.67,1070.167,137.3333
"18079","55398","2018",19,18,1,107881.6,1179.632,95.21053
"18080","55401","2018",3,3,0,183410,1414.333,142.3333
"18081","55403","2018",1,1,0,112500,978,115
"18082","55404","2018",3,3,0,174833.3,1379.667,128.6667
"18083","55405","2018",2,2,0,156000,1169,129.5
"18084","55406","2018",1,1,0,55000,764,72
"18085","55407","2018",1,1,0,130000,1340,97
"18086","55408","2018",3,3,0,39873.33,596.3333,70.66667
"18087","55410","2018",3,3,0,112500,1276.667,90.66667
"18088","55412","2018",2,2,0,137430,920.5,151
"18089","55414","2018",3,3,0,117133.3,1311.667,89.66667
"18090","55415","2018",3,3,0,71666.67,503,150.6667
"18091","55416","2018",4,4,0,118225,792,153.75
"18092","55419","2018",1,1,0,275500,1013,272
"18093","55420","2018",1,1,0,121000,976,124
"18094","55422","2018",1,1,0,108173,1202,90
"18095","55426","2018",3,3,0,104556.7,876,122.3333
"18096","55427","2018",20,18,2,93970,962.35,100.75
"18097","55428","2018",4,4,0,95523.25,842,122
"18098","55431","2018",1,1,0,150000,1429,105
"18099","55433","2018",4,4,0,113250,1103.5,104.25
"18100","55434","2018",2,2,0,97250,833,96.5
"18101","55435","2018",7,7,0,89157.14,848,109.4286
"18102","55437","2018",1,1,0,87000,946,92
"18103","55438","2018",1,1,0,32500,464,70
"18104","55442","2018",1,1,0,284000,1291,220
"18105","55443","2018",4,4,0,152950,1394.75,109
"18106","55444","2018",1,1,0,1e+05,820,122
"18107","55445","2018",4,4,0,61250,681,94.25
"18108","55446","2018",4,4,0,82550,854.75,82.25
"18109","55447","2018",7,7,0,107042.9,788,132.4286
"18110","55448","2018",1,1,0,150000,1230,122
"18111","55449","2018",4,4,0,93750,1016,88.25
"18112","55452","2018",1,1,0,114000,1140,100
"18113","55453","2018",3,3,0,68166.67,694.6667,105.6667
"18114","55454","2018",1,1,0,40000,354,113
"18115","55456","2018",1,1,0,50000,435,115
"18116","55457","2018",2,2,0,1e+05,874.5,116
"18117","55458","2018",3,3,0,133000,3534.333,85
"18118","55459","2018",2,2,0,79500,729,112
"18119","55460","2018",1,1,0,149000,1274,117
"18120","55461","2018",7,7,0,99114.29,1372.429,74.71429
"18121","55462","2018",4,4,0,84875,714.75,122
"18122","55463","2018",28,26,2,85335.71,860.2857,107.2857
"18123","55464","2018",1,1,0,81000,600,135
"18124","55465","2018",2,2,0,101000,1206.5,85
"18125","55466","2018",5,5,0,96236,972.4,97.4
"18126","55467","2018",16,16,0,78529.06,916.6875,86.375
"18127","55468","2018",2,2,0,158750,1457.5,111.5
"18128","55470","2018",1,1,0,90000,1059,85
"18129","55471","2018",1,1,0,120000,870,138
"18130","55472","2018",1,1,0,154200,1952,79
"18131","55474","2018",2,2,0,115000,1744,70.5
"18132","55475","2018",1,1,0,99000,773,128
"18133","55476","2018",6,6,0,114000,1301.5,100.8333
"18134","55477","2018",1,1,0,90000,1059,85
"18135","55481","2018",2,2,0,69750,665,105
"18136","55482","2018",1,1,0,130000,660,197
"18137","55484","2018",1,1,0,127500,1109,115
"18138","55485","2018",2,2,0,48500,553.5,86.5
"18139","55487","2018",2,2,0,122500,1123.5,108.5
"18140","55488","2018",2,2,0,95000,1176,81
"18141","55489","2018",1,1,0,31000,633,49
"18142","55490","2018",5,5,0,92300,864.6,112.8
"18143","55492","2018",10,10,0,109375,918.9,114.6
"18144","55493","2018",3,3,0,141500,1257.667,111.6667
"18145","55494","2018",3,3,0,96100,982,89.33333
"18146","55495","2018",2,2,0,139500,1683,82.5
"18147","55496","2018",11,11,0,98729.09,1071.909,94.54545
"18148","55497","2018",4,4,0,170375,1350.5,128.5
"18149","55498","2018",5,5,0,164000,1406.8,130.8
"18150","55500","2018",15,15,0,135363.3,1244.267,116.2
"18151","55501","2018",5,5,0,102800,916,100.6
"18152","55502","2018",18,17,1,135719.4,1462.167,90.11111
"18153","55503","2018",2,2,0,116300,1004.5,132
"18154","55504","2018",2,2,0,94500,692.5,136
"18155","55505","2018",35,31,4,133544.3,1401.971,96.51429
"18156","55507","2018",3,3,0,52833.33,781,77.33333
"18157","55508","2018",4,4,0,147500,1312.25,108.75
"18158","55509","2018",2,2,0,50500,655.5,77.5
"18159","55510","2018",1,1,0,58000,523,111
"18160","55511","2018",1,1,0,67000,1000,67
"18161","55512","2018",2,2,0,80750,633.5,119
"18162","55514","2018",6,6,0,90100,669.6667,120.5
"18163","55515","2018",2,2,0,107500,635,168.5
"18164","55516","2018",5,5,0,72280,690.2,104.8
"18165","55517","2018",5,5,0,58500,512.8,116.8
"18166","55519","2018",7,7,0,113385.7,1086,116.7143
"18167","55521","2018",2,2,0,70000,665.5,119.5
"18168","55522","2018",1,1,0,50000,704,71
"18169","55523","2018",1,1,0,179000,1243,144
"18170","55525","2018",1,1,0,140000,1687,83
"18171","55526","2018",3,3,0,131416.7,1082.667,119.6667
"18172","55527","2018",4,4,0,105625,936.5,115.75
"18173","55530","2018",1,1,0,55000,611,90
"18174","55531","2018",3,3,0,128296.7,1161.667,112.6667
"18175","55532","2018",3,3,0,86833.33,1026.667,92.33333
"18176","55533","2018",14,14,0,86971.43,859.2143,94.35714
"18177","55537","2018",2,2,0,158200,1447,108
"18178","55540","2018",1,1,0,75000,429,175
"18179","55541","2018",4,4,0,112000,900.5,132.5
"18180","55543","2018",6,6,0,112725,997,118.6667
"18181","55545","2018",195,113,82,106929.3,1312.164,82.77436
"18182","55546","2018",1,1,0,30000,370,81
"18183","55549","2018",1,1,0,49000,612,80
"18184","55551","2018",16,16,0,105456.2,907.5625,119.8125
"18185","55553","2018",16,16,0,126831.2,1047.312,123.4375
"18186","55554","2018",1,1,0,60000,674,89
"18187","55562","2018",1,1,0,63000,788,80
"18188","55565","2018",3,3,0,101666.7,780.3333,132
"18189","55566","2018",1,1,0,125000,1437,87
"18190","55568","2018",5,5,0,71860,904.2,79.4
"18191","55570","2018",3,3,0,77083.33,808,104.6667
"18192","55571","2018",2,2,0,66500,982.5,66.5
"18193","55572","2018",2,2,0,57500,821.5,68.5
"18194","55573","2018",16,16,0,82443.75,872.125,92
"18195","55575","2018",1,1,0,25000,417,60
"18196","55577","2018",1,1,0,72900,858,85
"18197","55578","2018",2,2,0,105750,1187.5,85.5
"18198","55581","2018",1,1,0,75000,568,132
"18199","55582","2018",1,1,0,150000,1071,140
"18200","55583","2018",5,5,0,89300,872.8,141.8
"18201","55584","2018",2,2,0,90500,1023.5,81.5
"18202","55586","2018",1,1,0,80000,690,116
"18203","56001","2018",31,31,0,113480.8,1159.258,103.871
"18204","56002","2018",35,34,1,202792.2,2046.229,104.1143
"18205","56003","2018",74,60,14,449280.9,3790.392,116.0811
"18206","56004","2018",38,36,2,150663.7,1921.921,83.28947
"18207","56005","2018",127,70,57,261524.3,3635.244,75.70866
"18208","56006","2018",13,13,0,107935.4,1176.538,93.76923
"18209","56007","2018",281,120,161,188317,2459.146,76.40925
"18210","56008","2018",72,70,2,427269.8,3269.931,128.0833
"18211","56009","2018",15,15,0,348208,3350.333,104.4
"18212","56010","2018",84,77,7,124745.8,1388.345,92.17857
"18213","56011","2018",23,23,0,110144.2,1346.696,81.52174
"18214","56012","2018",20,20,0,143764,1341.7,108.45
"18215","56013","2018",61,54,7,256014.5,2518.869,101.3115
"18216","56014","2018",22,22,0,117283.6,1081.5,110.8182
"18217","56015","2018",28,27,1,179508.8,1588.786,111.8929
"18218","56017","2018",19,19,0,107114.8,1254.789,82.94737
"18219","56018","2018",15,13,2,201444,1833.667,106.1333
"18220","56019","2018",7,7,0,131414.3,1398.857,91.14286
"18221","56020","2018",16,16,0,142479.6,1490.562,97
"18222","56021","2018",17,17,0,184882.4,1865,101.2353
"18223","56022","2018",19,19,0,143600,1398.474,103.8421
"18224","56023","2018",67,55,12,205753.1,2204.209,94.47761
"18225","56024","2018",28,28,0,74202.21,782.1786,93.42857
"18226","56025","2018",5,5,0,70512,747.8,99.4
"18227","56026","2018",34,34,0,101352.9,1096.971,94.29412
"18228","56027","2018",9,9,0,183555.6,1706.333,91.11111
"18229","56028","2018",19,19,0,136669.7,1274.789,103.5789
"18230","56029","2018",15,15,0,142966.7,1545.933,86.13333
"18231","56030","2018",13,12,1,177815.4,2029.385,102.0769
"18232","56031","2018",49,48,1,132792.2,1601.796,89.79592
"18233","56032","2018",14,14,0,92235.86,1121.143,81.85714
"18234","56033","2018",41,41,0,108762.6,1290.073,89.58537
"18235","56034","2018",213,94,119,283904.1,4020.981,73.723
"18236","56035","2018",11,11,0,111345.5,1095.273,105.8182
"18237","56036","2018",50,44,6,164213,1650.68,102.5
"18238","56039","2018",14,14,0,141940.7,1481.929,97.92857
"18239","56040","2018",43,42,1,183100,1971.488,103.6279
"18240","56041","2018",48,48,0,103410.5,1124.208,95.70833
"18241","56042","2018",18,18,0,160376.1,1507.778,109
"18242","56043","2018",9,9,0,84111.11,1609.778,76.22222
"18243","56044","2018",6,6,0,89632.83,973.1667,86.83333
"18244","56045","2018",10,10,0,142740,1430.1,101.1
"18245","56046","2018",47,46,1,343279.8,2754.362,124.1489
"18246","56047","2018",17,17,0,99489.41,955.7059,105
"18247","56048","2018",14,14,0,67035.71,833.9286,81.21429
"18248","56050","2018",6,6,0,133816.7,1377.333,90.33333
"18249","56051","2018",10,10,0,52250,818.3,67.7
"18250","56052","2018",95,65,30,213717.3,3116.379,75.70526
"18251","56053","2018",84,73,11,164266.3,1751.429,95.07143
"18252","56054","2018",81,66,15,205048.7,2661.481,85.25926
"18253","56055","2018",58,33,25,210594.8,2742.845,78.81034
"18254","56056","2018",3,3,0,28500,602.6667,48.66667
"18255","56057","2018",44,43,1,78405.68,913.2727,87.20455
"18256","56058","2018",53,53,0,155987.5,1588.774,100.0943
"18257","56060","2018",7,7,0,120855.7,1209.571,106.2857
"18258","56061","2018",42,42,0,110627.9,1171.476,95.85714
"18259","56062","2018",22,21,1,198159.1,2508.818,83.22727
"18260","56063","2018",31,31,0,196445.3,1809.032,111.4516
"18261","56065","2018",6,6,0,173750,1692.5,101.6667
"18262","56066","2018",52,51,1,84912,925.6731,91.01923
"18263","56067","2018",61,60,1,186849.9,1747.213,110.6721
"18264","56068","2018",3,3,0,42666.67,708.6667,52.33333
"18265","56069","2018",69,69,0,229422.1,2716.29,86.92754
"18266","56070","2018",33,33,0,80267.82,929.0606,88.39394
"18267","56071","2018",16,16,0,107479.4,1118.375,100.1875
"18268","56072","2018",4,4,0,80000,892.25,100.5
"18269","56073","2018",22,21,1,73018.36,807.2273,91.63636
"18270","56074","2018",15,15,0,145386.4,1403.8,106.4667
"18271","56075","2018",55,50,5,127036.4,1225.945,104.4
"18272","56076","2018",13,13,0,98141.15,933.5385,109.7692
"18273","56077","2018",9,9,0,144555.6,1508.111,96.33333
"18274","56078","2018",225,133,92,183890.5,2317.933,82.36444
"18275","56079","2018",21,21,0,97539.62,1202.429,80.52381
"18276","56080","2018",30,30,0,76115.8,955.4,80
"18277","56081","2018",22,22,0,87545.45,985,91.68182
"18278","56082","2018",6,6,0,80908.33,1131.167,79
"18279","56083","2018",252,161,91,140771.4,1665.016,86.48016
"18280","56084","2018",9,9,0,219861.2,2270.222,97.66667
"18281","56085","2018",2,2,0,550500,7329.5,77.5
"18282","56086","2018",3,2,1,271666.7,6097.333,45.33333
"18283","56087","2018",24,19,5,439209,4624.042,88.20833
"18284","56088","2018",10,10,0,254250,3859.1,67.5
"18285","56089","2018",25,25,0,153907.9,1388.16,108.32
"18286","56090","2018",76,69,7,141239.5,1530.276,94.22368
"18287","56091","2018",35,34,1,104454.1,1188.886,89.65714
"18288","56092","2018",10,10,0,93396.9,1096,98.7
"18289","56093","2018",10,10,0,114150,1145,103.4
"18290","56094","2018",63,59,4,206245,1834.825,112.1587
"18291","56096","2018",10,10,0,198020,2118.4,104.8
"18292","56097","2018",53,50,3,169742.1,1776.189,98.30189
"18293","56098","2018",290,212,78,152661.6,1748.231,88.85172
"18294","56099","2018",14,14,0,59042.86,684.8571,93.92857
"18295","56100","2018",23,23,0,81600.43,944.0435,92.04348
"18296","56101","2018",87,82,5,149031,1515.77,104.6092
"18297","56102","2018",22,22,0,91774.14,901.5909,100.9091
"18298","56103","2018",3,3,0,87816.67,913.3333,83.66667
"18299","56104","2018",6,6,0,120750,1629.833,79.83333
"18300","56105","2018",22,22,0,75331.82,774.6364,99.13636
"18301","56106","2018",25,21,4,382324,3981.56,92.32
"18302","56107","2018",141,87,54,295332.6,3197.922,95.37589
"18303","56108","2018",10,10,0,185865,1441.7,121.9
"18304","56109","2018",14,14,0,174316.4,1812.214,97.14286
"18305","56110","2018",14,14,0,68162.36,776.9286,86.92857
"18306","56111","2018",21,21,0,106194.3,1183.429,89.66667
"18307","56112","2018",13,13,0,105037.2,978.4615,106
"18308","56113","2018",8,8,0,88000,1218.875,90.5
"18309","56114","2018",34,33,1,260608.6,3225.059,93.61765
"18310","56115","2018",24,24,0,191208.3,1770.25,108.75
"18311","56116","2018",33,24,9,259321.2,3745.636,71.21212
"18312","56117","2018",57,47,10,126564.5,1348.053,96.91228
"18313","56118","2018",88,71,17,175120,2036.932,88.48864
"18314","56119","2018",41,41,0,272799.7,2336.049,120.122
"18315","56120","2018",16,16,0,188375,2168.75,90.75
"18316","56121","2018",1029,355,674,138605.2,1790.884,77.26628
"18317","56122","2018",17,17,0,86311.65,1019.706,87.47059
"18318","56123","2018",14,14,0,122103.6,1448.071,93.42857
"18319","56124","2018",34,25,9,140023.7,1476.941,95.64706
"18320","56125","2018",14,14,0,136995.7,1155.857,127
"18321","56126","2018",28,28,0,151375.8,1630.071,100.5
"18322","56127","2018",40,40,0,82832.65,926.625,89.775
"18323","56128","2018",21,21,0,109233.3,1076.905,97.90476
"18324","56129","2018",22,22,0,77958.05,854.0455,91.22727
"18325","56130","2018",33,33,0,213468.3,1949.394,109.303
"18326","56131","2018",14,14,0,125814.3,1206.786,107.2857
"18327","56132","2018",39,36,3,192150,2077.308,97.33333
"18328","56133","2018",11,11,0,147318.2,1339.364,111.4545
"18329","56134","2018",17,17,0,74173.53,746.3529,97.76471
"18330","56135","2018",21,21,0,141861.4,1438.619,97.2381
"18331","56136","2018",6,6,0,96583.33,1195.667,84.33333
"18332","56137","2018",46,45,1,204837.9,1798.174,113.7391
"18333","56139","2018",4,4,0,114250,1133.75,92.5
"18334","56140","2018",41,41,0,118968.5,1208.171,97.85366
"18335","56141","2018",17,17,0,162069.4,1566.353,107.1176
"18336","56143","2018",64,59,5,180792.7,1873.844,95.39062
"18337","56144","2018",50,50,0,96494,1137.62,87.5
"18338","56145","2018",16,16,0,67818.69,937.1875,76.375
"18339","56146","2018",10,10,0,87286.2,926.1,102.9
"18340","56147","2018",72,72,0,162677.1,1628.125,105.5
"18341","56148","2018",21,21,0,219436.9,2250.238,109.2381
"18342","56149","2018",27,27,0,158160.4,1683.815,97.48148
"18343","56151","2018",27,27,0,108842.2,1145.037,96.74074
"18344","56152","2018",60,38,22,225405.2,3084.617,77.36667
"18345","56153","2018",32,31,1,121501.8,1412.969,88.34375
"18346","56154","2018",30,30,0,102137.5,1118.733,90.93333
"18347","56155","2018",87,80,7,185900.1,2693.644,74.24138
"18348","56156","2018",4,4,0,66125,839.75,76.5
"18349","56157","2018",29,29,0,202358,1617.862,122.5862
"18350","56158","2018",73,36,37,183351.9,2206.11,84.0411
"18351","56159","2018",16,16,0,120590.6,1156.75,99.9375
"18352","56160","2018",13,13,0,89052.15,979.6154,99.07692
"18353","56161","2018",50,40,10,222948.8,2252.3,100.06
"18354","56162","2018",253,194,59,249060.4,2567.526,100.3913
"18355","56163","2018",26,26,0,110092.7,1198.385,97.38462
"18356","56164","2018",82,67,15,254004.1,2336.415,109.6341
"18357","56165","2018",145,102,43,116565.9,1436.062,83.06897
"18358","56166","2018",57,55,2,145523.4,1373.123,108.0702
"18359","56167","2018",34,34,0,263309.7,2312.647,114.7353
"18360","56168","2018",34,33,1,266502.3,2480.294,109.2059
"18361","56169","2018",67,56,11,212416.6,2198.582,101.6418
"18362","56170","2018",19,19,0,68110.53,697.3684,93.94737
"18363","56171","2018",22,22,0,112602.3,1269.136,91.72727
"18364","56172","2018",30,30,0,136055,1273.033,106.0667
"18365","56173","2018",53,53,0,115855.5,1230.491,95.9434
"18366","56174","2018",32,32,0,145912.5,1364.625,110.875
"18367","56175","2018",45,44,1,202862.4,1876.044,110.2
"18368","56176","2018",78,55,23,181586.4,2026.372,90.10256
"18369","56177","2018",110,103,7,164646.1,1699.4,101.9818
"18370","56178","2018",193,128,65,105033.5,1312.301,81.19171
"18371","56179","2018",53,38,15,157537.2,1650.811,96.88679
"18372","56180","2018",9,9,0,88365.56,918.1111,97.11111
"18373","56181","2018",50,38,12,197484,2176.18,91.1
"18374","56182","2018",19,19,0,86713.95,1076.842,86.36842
"18375","56184","2018",105,96,9,153410.7,1588.019,99.34286
"18376","56185","2018",112,101,11,195029.3,1867.42,104.8036
"18377","56186","2018",222,98,124,240162.3,3744.887,67.90991
"18378","56188","2018",29,29,0,107716.3,1224.552,89.48276
"18379","56189","2018",8,8,0,110062.5,1072.75,105.125
"18380","56190","2018",20,20,0,99159.25,1128.75,92.75
"18381","56191","2018",6,6,0,72297.33,1007,74.5
"18382","56193","2018",74,74,0,226645.1,2026.041,110.0405
"18383","56194","2018",29,29,0,102288.4,1034.379,97.27586
"18384","56195","2018",20,9,11,125900,1681.2,71.9
"18385","56196","2018",7,7,0,123764.3,1229.286,105.7143
"18386","56197","2018",28,28,0,128890.5,1361,92.14286
"18387","56198","2018",34,34,0,92588.24,999.4412,92.41176
"18388","56199","2018",5,5,0,89200,1129,73.8
"18389","56200","2018",13,13,0,121106.9,1197.462,106.9231
"18390","56201","2018",16,16,0,80125,837.4375,99.1875
"18391","56202","2018",7,7,0,71285.71,787.7143,92.85714
"18392","56203","2018",19,19,0,97746.32,1243.579,80.31579
"18393","56204","2018",4,4,0,106875,852.25,128.75
"18394","56205","2018",13,13,0,255538.5,2210.385,118.4615
"18395","56206","2018",141,105,36,231969.4,2404.589,96.61702
"18396","56207","2018",14,14,0,109211.6,1111.714,99.14286
"18397","56208","2018",8,8,0,99712.5,1106.875,87.125
"18398","56209","2018",3,3,0,151480,1291.667,119.3333
"18399","56210","2018",2,2,0,53750,854.5,65.5
"18400","56211","2018",9,9,0,72355.56,866.1111,83.11111
"18401","56212","2018",29,29,0,116882.8,1356.862,84.93103
"18402","56213","2018",6,6,0,76416.67,1047.833,76.33333
"18403","56214","2018",72,67,5,328133.3,3330.083,106.5833
"18404","56215","2018",10,10,0,108780,1158.7,89.5
"18405","56216","2018",8,8,0,98441.88,898.875,110.625
"18406","56218","2018",16,16,0,96218.75,1213.312,74.6875
"18407","56219","2018",16,16,0,129309.5,1390.25,92.375
"18408","56220","2018",18,18,0,232097.2,2225.556,105.5556
"18409","56221","2018",17,17,0,83700.41,961.2941,86.94118
"18410","56222","2018",23,20,3,131360.1,1379.391,96.26087
"18411","56223","2018",14,14,0,126747.9,1187.214,96.71429
"18412","56224","2018",5,5,0,161400,1584.6,110.8
"18413","56225","2018",2,2,0,19350,524,37
"18414","56226","2018",9,9,0,143046.7,1338.333,102.5556
"18415","56227","2018",9,9,0,89802.44,928.3333,99.11111
"18416","56228","2018",10,9,1,117607,1257.3,90.9
"18417","56229","2018",13,13,0,121172.5,1026.231,114.3077
"18418","56230","2018",6,6,0,68707.5,695.3333,96.66667
"18419","56231","2018",44,42,2,236270.5,1977.409,120.3409
"18420","56232","2018",13,13,0,115491.5,1241.077,92.69231
"18421","56233","2018",43,25,18,266236.1,3282.837,80.48837
"18422","56234","2018",84,76,8,289049.3,3347.94,92.21429
"18423","56236","2018",16,16,0,73844.81,1061.25,76.3125
"18424","56237","2018",14,14,0,132463.6,1072.286,116.7143
"18425","56238","2018",9,9,0,97944.44,863.8889,113.6667
"18426","56239","2018",15,15,0,143899,1198.733,118.8667
"18427","56240","2018",279,230,49,267814.2,3027.247,93.93907
"18428","56241","2018",17,14,3,350073.8,3850.471,94.58824
"18429","56242","2018",16,16,0,66524.06,723.875,87.875
"18430","56243","2018",143,89,54,295240.4,3091.944,90.67133
"18431","56244","2018",43,43,0,109901.7,1281.93,92.34884
"18432","56245","2018",14,14,0,71521.43,932.5,75.92857
"18433","56246","2018",14,14,0,146249.3,1400.214,105.2857
"18434","56247","2018",41,41,0,186299.2,1947.463,101.7073
"18435","56248","2018",66,62,4,236086.2,2104.682,113.1364
"18436","56249","2018",32,32,0,124748.9,1242.406,98.125
"18437","56250","2018",7,7,0,116571.4,1008.286,118
"18438","56251","2018",85,77,8,251604,2272.035,114.6353
"18439","56252","2018",26,26,0,280721.2,2607.577,110.0769
"18440","56253","2018",14,14,0,77820,929.9286,86.71429
"18441","56254","2018",16,16,0,157559.4,1419.438,110.4375
"18442","56255","2018",26,25,1,197291,1798.077,117.0769
"18443","56256","2018",3,3,0,74666.67,979.3333,72
"18444","56257","2018",6,6,0,57073,641,103.8333
"18445","56258","2018",75,50,25,340819.1,3888.907,90.92
"18446","56259","2018",19,19,0,180073.7,1726.421,106.3684
"18447","56260","2018",1212,311,901,183444.7,2557.344,69.78548
"18448","56261","2018",12,12,0,179072.9,1898.667,100.5
"18449","56262","2018",47,40,7,258433.5,2666.915,98.46809
"18450","56263","2018",34,31,3,196510.3,1896.588,102.2353
"18451","56264","2018",7,7,0,113071.4,1024.571,107.1429
"18452","58002","2018",16,16,0,74758.75,1031,70.625
"18453","58003","2018",12,12,0,106301.2,1209.25,90.58333
"18454","58004","2018",5,5,0,53246,839.2,75.6
"18455","58005","2018",5,5,0,115200,806.8,134
"18456","58006","2018",6,5,1,73000,810.1667,84.66667
"18457","58007","2018",7,7,0,50214.29,745.4286,69.28571
"18458","58008","2018",1,1,0,27900,680,41
"18459","58009","2018",2,2,0,96500,751.5,124
"18460","58010","2018",10,10,0,76460,911.9,84
"18461","58011","2018",2,2,0,53000,803.5,65
"18462","58012","2018",5,5,0,58200,715.6,89.6
"18463","58013","2018",1,1,0,42000,467,90
"18464","58014","2018",1,1,0,140000,673,208
"18465","58015","2018",2,2,0,108000,1190,70.5
"18466","58017","2018",3,3,0,60833.33,813.3333,76.33333
"18467","58019","2018",1,1,0,105000,1094,96
"18468","58020","2018",1,1,0,160000,1600,100
"18469","58023","2018",1,1,0,54000,478,113
"18470","58024","2018",1,1,0,70000,1186,59
"18471","58025","2018",2,2,0,90000,907.5,99.5
"18472","58026","2018",3,3,0,130416.7,782,148.6667
"18473","58027","2018",1,1,0,82000,820,100
"18474","58028","2018",1,1,0,40000,541,74
"18475","58029","2018",2,2,0,55000,949,60
"18476","58030","2018",2,2,0,57500,645,85
"18477","58031","2018",3,3,0,83833.33,879,93
"18478","58032","2018",3,3,0,56833.33,956.6667,53
"18479","58033","2018",7,7,0,114142.9,846,112.8571
"18480","58035","2018",2,2,0,73750,908,86
"18481","58036","2018",11,11,0,90645.55,1080.727,101.6364
"18482","58037","2018",12,12,0,82212.5,1067.083,77.75
"18483","58039","2018",5,5,0,53100,843.8,64.2
"18484","58040","2018",1,1,0,111500,1126,99
"18485","58041","2018",5,5,0,43510,806.2,51.6
"18486","58042","2018",1,1,0,40000,556,72
"18487","58044","2018",10,10,0,103498.5,897.7,110.9
"18488","58046","2018",14,14,0,86185.71,902.2857,96.07143
"18489","58047","2018",6,6,0,83333.33,1009.5,89.16667
"18490","58048","2018",3,3,0,53236.67,742.3333,71
"18491","58049","2018",5,5,0,75800,1012.6,96.2
"18492","58050","2018",2,2,0,74370,715,114
"18493","58051","2018",17,17,0,114170.6,1226.882,92.94118
"18494","58052","2018",3,3,0,72833.33,742.3333,84
"18495","58053","2018",4,4,0,93875,1032,94
"18496","58054","2018",1,1,0,55000,1000,55
"18497","58055","2018",8,8,0,75437.5,929.875,78.125
"18498","58056","2018",1,1,0,185000,1360,136
"18499","58057","2018",18,18,0,92138.89,1222.333,77.72222
"18500","58058","2018",3,3,0,71666.67,962.3333,72.66667
"18501","58059","2018",57,51,6,94788.7,1094.526,90.10526
"18502","58060","2018",9,9,0,76000,835.8889,92.11111
"18503","58061","2018",2,2,0,25500,452,56
"18504","58062","2018",12,12,0,82600,810.9167,98.83333
"18505","58063","2018",4,4,0,41000,598.5,68.25
"18506","58064","2018",4,4,0,65425,787.5,82.75
"18507","58065","2018",7,7,0,71071.43,821.1429,85
"18508","58066","2018",1,1,0,47500,572,83
"18509","58067","2018",19,18,1,166660.5,1241.842,127.6842
"18510","58068","2018",10,10,0,95105,1323.7,83.1
"18511","58069","2018",2,2,0,85000,855,114
"18512","58070","2018",2,2,0,37500,410.5,95
"18513","58071","2018",1,1,0,160000,2286,70
"18514","58072","2018",7,7,0,110767.1,1274,95.42857
"18515","58073","2018",2,2,0,92750,903,100.5
"18516","58074","2018",8,8,0,103281.2,971.875,114.875
"18517","58075","2018",3,3,0,82000,998.6667,89.33333
"18518","58076","2018",2,2,0,73525,868,88
"18519","58077","2018",4,4,0,61250,861,73.5
"18520","58079","2018",24,23,1,69644.42,742.125,89.20833
"18521","58080","2018",5,5,0,61000,784.8,79.2
"18522","58081","2018",9,9,0,70111.11,803.5556,87.77778
"18523","58082","2018",6,6,0,80750,903.1667,80.33333
"18524","58083","2018",19,19,0,81526.32,868.5789,92
"18525","58085","2018",10,10,0,75900,719.8,102.3
"18526","58086","2018",147,127,20,94086.73,1109.639,87.02721
"18527","58087","2018",7,7,0,132714.3,1044.429,108.1429
"18528","58088","2018",41,38,3,121992,1287.268,93.17073
"18529","58089","2018",4,4,0,90250,928.75,92
"18530","58090","2018",1,1,0,41000,577,71
"18531","58092","2018",6,6,0,46833.33,797.5,70
"18532","58093","2018",1,1,0,56000,800,70
"18533","58094","2018",8,8,0,69937.5,762.625,85.875
"18534","58095","2018",62,52,10,79579.84,1035.065,76.93548
"18535","58096","2018",3,3,0,75666.67,1058.333,66.66667
"18536","58097","2018",4,4,0,126450,666,177.75
"18537","58098","2018",1,1,0,20000,444,45
"18538","58099","2018",3,3,0,52430.67,821.3333,60.66667
"18539","58101","2018",1,1,0,38000,644,59
"18540","58102","2018",21,21,0,66720.62,882.4762,74.33333
"18541","58103","2018",1,1,0,30000,500,60
"18542","58104","2018",18,18,0,104552.2,1060,98.77778
"18543","58105","2018",2,2,0,47000,858,54.5
"18544","58106","2018",8,8,0,122781.2,1002.875,115.375
"18545","58107","2018",3,3,0,60000,858,68.33333
"18546","58108","2018",2,2,0,115000,722.5,148.5
"18547","58109","2018",15,15,0,89976.67,750.6,117.2
"18548","58110","2018",5,5,0,55160,803.8,72
"18549","58111","2018",4,4,0,95500,972.75,93.75
"18550","58112","2018",9,9,0,120200,977.5556,113.5556
"18551","58113","2018",4,4,0,147125,2571,73
"18552","58115","2018",4,4,0,125750,1113,111.75
"18553","58117","2018",38,33,5,83048.58,1039.737,81.57895
"18554","58118","2018",9,9,0,70111.11,930.5556,81.77778
"18555","58120","2018",2,2,0,43500,621,91.5
"18556","58121","2018",39,35,4,78156.41,966.3846,80.05128
"18557","58122","2018",2,2,0,44000,741,60.5
"18558","58123","2018",2,2,0,52000,885.5,60
"18559","58124","2018",8,8,0,106075,978.875,102.625
"18560","58125","2018",1,1,0,45000,849,53
"18561","58126","2018",1,1,0,82000,1123,73
"18562","58127","2018",3,3,0,76666.67,1667.333,46
"18563","58128","2018",4,4,0,105000,1060.75,127.25
"18564","58129","2018",3,3,0,74000,914.6667,78.33333
"18565","58130","2018",1,1,0,165000,2500,66
"18566","58131","2018",33,33,0,97930.09,1046.303,95.69697
"18567","58132","2018",3,3,0,63000,701.6667,90
"18568","58134","2018",36,32,4,84362.19,993.1667,83.47222
"18569","58137","2018",3,3,0,138966.7,857,124
"18570","58138","2018",5,5,0,97460,1038.6,92.8
"18571","58139","2018",1,1,0,78000,1068,73
"18572","58140","2018",5,5,0,75744,1349.2,69.8
"18573","58141","2018",1,1,0,60000,1364,44
"18574","58142","2018",4,4,0,94562.5,1015.25,89.75
"18575","58144","2018",10,10,0,90200,825.1,113.6
"18576","58145","2018",23,23,0,87026.09,872.4783,102.0435
"18577","58146","2018",11,11,0,90877.27,980.5455,94.45455
"18578","58147","2018",3,3,0,82666.67,762,105.6667
"18579","58148","2018",5,5,0,77900,899.8,88.4
"18580","58149","2018",24,24,0,104094.7,899.8333,110.25
"18581","58150","2018",2,2,0,68750,953.5,89.5
"18582","58151","2018",34,34,0,57202.94,801.8824,67.88235
"18583","58152","2018",23,23,0,131223.9,1250.435,103.087
"18584","58153","2018",2,2,0,37750,611,63.5
"18585","58154","2018",3,3,0,116333.3,1806.667,65
"18586","58155","2018",10,10,0,167800,2115.4,90.9
"18587","58156","2018",5,5,0,58600,771,97.6
"18588","58157","2018",8,8,0,105800,1153.875,89.5
"18589","58158","2018",4,4,0,107500,812.5,134.25
"18590","58159","2018",3,3,0,70000,681,96
"18591","58160","2018",44,42,2,145443.9,1490.614,99.36364
"18592","58161","2018",2,2,0,192250,1378,132.5
"18593","58162","2018",2,2,0,73500,603.5,120
"18594","58163","2018",3,3,0,99333.33,843,114
"18595","58164","2018",8,8,0,102537.5,1198.875,86.375
"18596","58165","2018",7,7,0,58000,547.1429,105.4286
"18597","58166","2018",14,14,0,71071.43,747.6429,97.92857
"18598","58168","2018",6,6,0,89224.5,1196.667,82.33333
"18599","58170","2018",2,2,0,64000,658,102
"18600","58171","2018",4,4,0,98250,1240.75,84.25
"18601","58172","2018",2,2,0,164000,2123.5,85.5
"18602","58173","2018",4,4,0,90750,821.5,97
"18603","58174","2018",4,4,0,71750,759.25,100.25
"18604","58175","2018",2,2,0,95250,1130.5,84
"18605","58176","2018",4,4,0,134712.5,1488.25,93.25
"18606","58177","2018",8,8,0,81875,1154.75,77.875
"18607","58178","2018",3,3,0,52500,877,66.66667
"18608","58179","2018",7,7,0,69642.86,840.1429,92.71429
"18609","58180","2018",12,12,0,147101.7,1711.167,102.0833
"18610","58182","2018",22,22,0,80121.82,810.4545,98.45455
"18611","58183","2018",2,2,0,45000,667,67
"18612","58185","2018",9,9,0,138794.4,1022.778,132
"18613","58186","2018",3,3,0,85666.67,1128,74.33333
"18614","58187","2018",10,10,0,70010,891.5,78.4
"18615","58188","2018",2,2,0,71305,777,92.5
"18616","58189","2018",6,6,0,63500,904.6667,74
"18617","58190","2018",2,2,0,49000,1225,67.5
"18618","58191","2018",3,3,0,75333.33,746,102.3333
"18619","58192","2018",3,3,0,86666.67,1039.667,81.66667
"18620","58193","2018",19,19,0,70747.37,937.4737,83.31579
"18621","58194","2018",457,208,249,89312.82,1075.142,81.54705
"18622","58195","2018",3,3,0,52666.67,626.6667,84.66667
"18623","58196","2018",5,5,0,87360,895.8,112.6
"18624","58197","2018",1,1,0,27500,382,72
"18625","58198","2018",4,4,0,48625,577.25,81.25
"18626","58199","2018",3,3,0,80833.33,933,90.66667
"18627","58200","2018",2,2,0,82500,848.5,97
"18628","58201","2018",4,4,0,62500,844.25,78.25
"18629","58202","2018",2,2,0,106500,1095.5,96
"18630","58203","2018",1,1,0,40000,408,98
"18631","58204","2018",4,4,0,61500,576,110.75
"18632","58205","2018",10,10,0,108970.5,1090.5,108.9
"18633","58207","2018",16,14,2,125190.6,1362.062,102.125
"18634","58208","2018",2,2,0,44500,1057,42.5
"18635","58209","2018",1,1,0,138000,1062,130
"18636","58210","2018",5,5,0,58896,1128,52.8
"18637","58211","2018",2,2,0,57083.5,1010,64
"18638","58212","2018",7,7,0,79357.14,847.7143,97.14286
"18639","58213","2018",2,2,0,68500,1317,66
"18640","58214","2018",23,21,2,115991.3,1067.043,109.8696
"18641","58215","2018",25,24,1,88905.12,1261.88,80.6
"18642","58216","2018",3,3,0,97900,952,100
"18643","58217","2018",4,4,0,78750,786.25,100
"18644","58218","2018",20,19,1,46250,646.55,71.45
"18645","58219","2018",3,3,0,102666.7,1103.667,92.66667
"18646","58220","2018",12,12,0,123012.2,1197.333,114.5833
"18647","58221","2018",2,2,0,70000,763.5,89
"18648","58222","2018",1,1,0,125000,1712,73
"18649","58223","2018",11,11,0,99189.45,997.7273,88.18182
"18650","58224","2018",3,3,0,57666.67,1333.333,50
"18651","58225","2018",3,2,1,88666.67,716,120.3333
"18652","58226","2018",5,5,0,119900,1293,93.8
"18653","58227","2018",27,27,0,78192.59,821.963,96.2963
"18654","58228","2018",7,7,0,79142.86,1022.714,77.42857
"18655","58229","2018",5,5,0,133670,1342.2,103.2
"18656","58230","2018",1,1,0,156000,2836,55
"18657","58231","2018",4,4,0,79687.5,696.75,108.25
"18658","58232","2018",7,7,0,110142.9,945.4286,122.2857
"18659","58233","2018",4,4,0,35500,729.5,52.5
"18660","58234","2018",2,2,0,35000,526.5,63.5
"18661","58235","2018",5,5,0,46500,823.2,55
"18662","58236","2018",1,1,0,60000,1277,47
"18663","58238","2018",22,22,0,130157.8,1280,99.04545
"18664","58239","2018",3,3,0,116666.7,974.3333,115.6667
"18665","58240","2018",2,2,0,38000,515.5,72
"18666","58241","2018",4,4,0,148750,1266.25,115.75
"18667","58242","2018",1,1,0,106000,785,135
"18668","58244","2018",1,1,0,390000,6500,60
"18669","58245","2018",6,6,0,78587.5,930.5,80.66667
"18670","58246","2018",12,11,1,67416.67,744.8333,91
"18671","58247","2018",5,5,0,96400,937.8,107.8
"18672","58248","2018",3,3,0,54000,812.3333,72.66667
"18673","58249","2018",7,7,0,97928.57,1072,87.85714
"18674","58250","2018",16,15,1,84506.25,964.6875,87.4375
"18675","58251","2018",6,6,0,83500,956,87
"18676","58252","2018",3,3,0,74666.67,859,81.33333
"18677","58253","2018",2,2,0,107500,838,144
"18678","58254","2018",2,2,0,92300,1407.5,65.5
"18679","58255","2018",6,6,0,77833.33,952.1667,89.83333
"18680","58256","2018",6,6,0,87366.67,807,116.5
"18681","58258","2018",3,3,0,74333.33,899.3333,82
"18682","58259","2018",1,1,0,47000,904,52
"18683","58260","2018",19,19,0,104926.3,1119.947,97.52632
"18684","58261","2018",8,7,1,140562.5,1142.125,115.5
"18685","58262","2018",4,4,0,38000,692.75,54.5
"18686","58263","2018",3,3,0,77666.67,706.3333,107
"18687","58264","2018",3,3,0,169666.7,2410.667,70
"18688","58265","2018",3,3,0,50000,677,72
"18689","58266","2018",7,7,0,36142.86,652.1429,57.14286
"18690","58267","2018",6,6,0,67250,651.1667,103.1667
"18691","58268","2018",6,6,0,171908.3,1336.333,138.5
"18692","58269","2018",10,10,0,119900,1011.3,118.3
"18693","58270","2018",2,2,0,121500,1165,105
"18694","58271","2018",3,3,0,60500,687.6667,93
"18695","58272","2018",1,1,0,62500,744,84
"18696","58273","2018",9,9,0,148877.8,1280.333,107.2222
"18697","58274","2018",1,1,0,30000,405,74
"18698","58275","2018",3,3,0,62333.33,981.3333,63.33333
"18699","58276","2018",5,5,0,57315,891,69
"18700","58277","2018",5,5,0,103100,785.8,130
"18701","58278","2018",13,13,0,157814.6,1658.462,97.84615
"18702","58279","2018",2,2,0,201500,1435.5,119.5
"18703","58280","2018",6,6,0,119558.3,1178.167,100.1667
"18704","58281","2018",14,14,0,98648,969.3571,100
"18705","58282","2018",7,7,0,64428.57,926.2857,68.28571
"18706","58285","2018",2,2,0,50750,651.5,82.5
"18707","58286","2018",12,12,0,82110.83,933.6667,98.16667
"18708","58287","2018",1,1,0,1e+05,610,164
"18709","58288","2018",3,3,0,56000,904.6667,61.33333
"18710","58289","2018",3,3,0,66133.33,993.3333,63.33333
"18711","58291","2018",3,3,0,180526.7,1640.667,80.33333
"18712","58292","2018",3,3,0,71833.33,1036,66
"18713","58293","2018",1,1,0,45000,479,94
"18714","58294","2018",3,3,0,170000,1666.667,106.6667
"18715","58295","2018",15,14,1,59206.67,914.6,67.8
"18716","58296","2018",6,6,0,86500,1011,90
"18717","58297","2018",8,8,0,69175,726.875,102.625
"18718","58298","2018",7,7,0,80907.14,847.2857,92.57143
"18719","58299","2018",1,1,0,125000,1453,86
"18720","58300","2018",18,18,0,114814.4,1332.5,84.55556
"18721","58301","2018",2,2,0,40000,454.5,89.5
"18722","58302","2018",7,7,0,90285.71,1076.714,83.85714
"18723","58303","2018",97,86,11,108182.3,1308.309,83.91753
"18724","58304","2018",11,11,0,59231.82,1193.273,65.27273
"18725","58305","2018",2,2,0,65775,671,98
"18726","58306","2018",3,3,0,58500,892,60.33333
"18727","58307","2018",3,3,0,103916.7,938,109.3333
"18728","58308","2018",1,1,0,50000,3333,15
"18729","58309","2018",12,12,0,109543.3,1013.417,117.5
"18730","58310","2018",3,3,0,63777.33,634.3333,102
"18731","58311","2018",4,4,0,86550,962.25,87.5
"18732","58312","2018",5,4,1,88220,801.8,109
"18733","58313","2018",1,1,0,90000,738,122
"18734","59001","2018",1,1,0,150000,1515,99
"18735","59002","2018",41,40,1,133699.6,1393.561,98.73171
"18736","59003","2018",4,4,0,188868.8,1365.5,141.25
"18737","59004","2018",13,13,0,215734.2,2030.462,107.2308
"18738","59005","2018",31,30,1,207558.5,2003.419,102.6452
"18739","59006","2018",2,2,0,146750,1776.5,84
"18740","59007","2018",10,10,0,159822,1706.2,95.7
"18741","59008","2018",77,77,0,100298.7,1126.792,90.77922
"18742","59009","2018",551,390,161,235358.4,2636.922,88.49909
"18743","59010","2018",3,3,0,188130,1209.333,178.3333
"18744","59011","2018",168,157,11,181594.7,1976.565,94.09524
"18745","59012","2018",28,28,0,137831.4,1258.571,117
"18746","59013","2018",21,21,0,282107.1,2513.952,112
"18747","59014","2018",146,123,23,93400.14,1208.774,82.86986
"18748","59015","2018",35,35,0,160408.5,1498.371,105.2
"18749","59016","2018",23,23,0,166460,1738.087,98.26087
"18750","59017","2018",348,284,64,134958,1682.681,84.52299
"18751","59018","2018",9,9,0,163540.2,1492.778,122.7778
"18752","59019","2018",16,16,0,160618.8,1618.875,102.875
"18753","59021","2018",13,13,0,138188.9,1299.538,113.8462
"18754","59022","2018",22,22,0,269579.1,2342.364,112.5
"18755","59023","2018",5,5,0,134200,1505.2,88.2
"18756","59024","2018",49,48,1,116620.8,1300.286,91.93878
"18757","59025","2018",15,15,0,269586.7,2531,110.5333
"18758","59026","2018",17,17,0,115564.7,1251.471,92.82353
"18759","59027","2018",11,11,0,191713.6,1910.273,103
"18760","59028","2018",70,70,0,116565.8,1310.1,90.68571
"18761","59029","2018",18,18,0,291412.9,2169.167,135.9444
"18762","59031","2018",3,3,0,231290,2121.333,111.6667
"18763","59032","2018",67,66,1,138066.6,1604.433,91.89552
"18764","59033","2018",94,93,1,102295.2,1215.787,88.40426
"18765","59034","2018",29,27,2,270369,2610.31,107.6552
"18766","59035","2018",30,30,0,113053.3,1163.533,96.4
"18767","59036","2018",45,41,4,109187.1,1154.133,107.2222
"18768","59037","2018",50,50,0,84788.92,934.02,93.86
"18769","59038","2018",16,16,0,133685.3,1150.25,112.25
"18770","59039","2018",6,6,0,206152.5,1594.167,125.1667
"18771","59041","2018",19,19,0,107447.4,1126.526,94.47368
"18772","59042","2018",18,18,0,307321.9,2547.722,124
"18773","59043","2018",171,138,33,190456.8,2005.31,97.07602
"18774","59044","2018",72,68,4,264443,2565.861,103.0694
"18775","59045","2018",2,2,0,225000,2234.5,103.5
"18776","59046","2018",6,6,0,170833.3,1348,142.5
"18777","59047","2018",7,7,0,130192.9,1314,102.5714
"18778","59048","2018",4,4,0,141000,1343.25,110
"18779","59049","2018",9,9,0,103066.1,1257.222,83.77778
"18780","59050","2018",6,6,0,146983.3,1173.5,122.5
"18781","59051","2018",81,76,5,135278.4,1646.481,85.80247
"18782","59052","2018",65,65,0,156399.7,1637.754,95.92308
"18783","59053","2018",35,33,2,131998.6,1254.2,109.3714
"18784","59054","2018",9,9,0,129036.7,1331.444,97.44444
"18785","59055","2018",3,3,0,159000,1503.667,106.3333
"18786","59056","2018",8,8,0,223650,1882.75,137.25
"18787","59057","2018",10,10,0,210480,1942.7,118.2
"18788","59058","2018",5,5,0,192000,1587.6,122.6
"18789","59059","2018",4,4,0,75500,737.75,102.25
"18790","59060","2018",4,4,0,91750,820.5,120
"18791","59061","2018",3,3,0,163333.3,1647.333,97
"18792","59062","2018",2,2,0,110000,1502.5,73
"18793","59063","2018",27,27,0,83825.7,862.2593,103.2963
"18794","59064","2018",7,7,0,121214.3,1144.857,104.4286
"18795","59065","2018",12,12,0,106208.3,1211.25,88.33333
"18796","59066","2018",2,2,0,106000,1164.5,92
"18797","59067","2018",39,36,3,181645.8,1613.179,117.0256
"18798","59068","2018",33,33,0,120392.9,1095.364,106.5455
"18799","59069","2018",12,12,0,109458.3,1166.583,88.83333
"18800","59070","2018",5,5,0,124186,1225,98.8
"18801","59071","2018",41,40,1,244209.6,2196.268,114.0732
"18802","59072","2018",1,1,0,225300,2086,108
"18803","59073","2018",5,5,0,244920,1905.6,124.4
"18804","59074","2018",28,28,0,105890.7,1128.857,103.7143
"18805","59075","2018",3,3,0,74000,750.6667,101
"18806","59076","2018",3,3,0,136416,1527.667,90.66667
"18807","59077","2018",4,4,0,160625,1292.25,125.75
"18808","59078","2018",2,2,0,135500,1276,115
"18809","59079","2018",39,37,2,109447.2,1234.308,87.66667
"18810","59080","2018",31,31,0,194764.8,2025.548,101.5806
"18811","59082","2018",21,21,0,208476.2,1798.381,118.381
"18812","59083","2018",1,1,0,274900,1462,188
"18813","59084","2018",18,18,0,205405.6,1745.222,122.6667
"18814","59085","2018",5,5,0,142070,1218.6,116.8
"18815","59086","2018",15,15,0,181283.3,1657.667,111
"18816","59087","2018",8,8,0,151962.5,1762.875,101.625
"18817","59088","2018",23,23,0,290767,2524.087,113.5217
"18818","59089","2018",19,19,0,157839.5,1233.263,128.7895
"18819","59090","2018",146,137,9,430824.9,3414.164,125.4315
"18820","59091","2018",7,7,0,180310,1568.714,119.2857
"18821","59092","2018",43,43,0,137025,1449.977,95.23256
"18822","59093","2018",4,4,0,121250,1111.75,108.75
"18823","59094","2018",65,63,2,130152,1383.554,96.4
"18824","59096","2018",23,23,0,372077.8,2698.435,137.3043
"18825","59097","2018",2,2,0,166000,1241,154
"18826","59098","2018",63,58,5,233424.9,2186.095,104.7619
"18827","59099","2018",14,14,0,113685.7,1200.786,96.85714
"18828","59100","2018",5,5,0,245534.6,2032.6,127.4
"18829","59101","2018",9,9,0,171589.4,1677.111,105.5556
"18830","59102","2018",5,5,0,131400,1186.6,115.2
"18831","59103","2018",5,5,0,158700,1434,111.6
"18832","59104","2018",34,34,0,101701.3,1058.265,96.58824
"18833","59105","2018",20,20,0,260676.3,2172.25,126
"18834","59106","2018",10,10,0,341240.5,2536.8,136.2
"18835","59107","2018",127,61,66,144661.3,2404.937,67.96063
"18836","59108","2018",12,12,0,85433.33,802.3333,102.75
"18837","59109","2018",4,4,0,285000,1866.5,151.75
"18838","59110","2018",12,12,0,179325,1515.583,119.6667
"18839","59111","2018",3,3,0,187102.7,1812,103.3333
"18840","59112","2018",78,78,0,100504,1115.41,91.67949
"18841","59113","2018",11,11,0,141209.1,1292,114.6364
"18842","59114","2018",17,17,0,188070.1,1918.588,104.8235
"18843","59115","2018",6,6,0,99816.67,1526.667,65.5
"18844","59116","2018",3,3,0,202333.3,2107,109
"18845","59117","2018",13,13,0,136284.6,1219.692,108.6923
"18846","59118","2018",30,30,0,97966.2,1072.367,95.73333
"18847","59119","2018",6,6,0,128350,1431.167,89.83333
"18848","59120","2018",17,17,0,183722.4,1522.235,132.6471
"18849","59121","2018",2,2,0,123500,805,158
"18850","59122","2018",407,301,106,114333.6,1344.951,89.15479
"18851","59123","2018",22,22,0,222623.3,2100.727,111.6364
"18852","59124","2018",25,25,0,304939.8,2497.12,121.36
"18853","59125","2018",7,7,0,162035.7,1350,117.8571
"18854","59126","2018",22,22,0,158907.2,1407.455,111.3182
"18855","59127","2018",2,2,0,250000,3458.5,128.5
"18856","59128","2018",44,18,26,207570,2455.477,81.61364
"18857","59129","2018",18,18,0,265273.9,2320.389,118.7778
"18858","59130","2018",12,12,0,176750,1470.75,118.3333
"18859","59131","2018",77,77,0,151945.7,1600.649,95.35065
"18860","59132","2018",17,17,0,112000,1096.765,102.6471
"18861","59133","2018",17,17,0,209418.8,1948.176,109.5882
"18862","59134","2018",12,12,0,89729.17,1087.667,98.83333
"18863","59135","2018",28,27,1,200210.1,1954.25,106.1429
"18864","59136","2018",56,55,1,59646,802.7857,76.30357
"18865","59137","2018",10,10,0,89150,936.6,89.9
"18866","59138","2018",5,5,0,122600,933.4,124.4
"18867","59139","2018",132,126,6,82382.2,958.697,88.77273
"18868","59140","2018",9,9,0,90222.22,998.2222,101.5556
"18869","59141","2018",1,1,0,134000,1696,79
"18870","59142","2018",5,5,0,102238,1280.8,81.6
"18871","59143","2018",106,102,4,210791.2,2152.5,97.75472
"18872","59144","2018",10,10,0,165717,1534.3,110
"18873","59145","2018",4,4,0,281075,2025.5,141.75
"18874","59146","2018",51,48,3,292837.9,2921.471,102.0392
"18875","59147","2018",1,1,0,115000,906,127
"18876","59148","2018",4,4,0,172286.5,1191,143
"18877","59149","2018",12,12,0,127254.2,1251.417,108.6667
"18878","59150","2018",10,10,0,325869,2861.8,119.4
"18879","59151","2018",15,15,0,96766.67,1086.533,89.6
"18880","59152","2018",161,151,10,201163.4,2073.056,98.43478
"18881","59153","2018",63,60,3,127433.6,1368.397,99.12698
"18882","59155","2018",231,213,18,128882.5,1503.762,87.28571
"18883","59156","2018",27,25,2,149189.6,1581.593,99.48148
"18884","59157","2018",24,24,0,99795.88,1141.292,86.33333
"18885","59158","2018",35,35,0,277804,2045,138.2286
"18886","59159","2018",10,10,0,145680,1386.9,102.6
"18887","59160","2018",50,50,0,124381.4,1174.32,104.84
"18888","59161","2018",8,8,0,136231.2,1243.75,111.25
"18889","59162","2018",12,12,0,174354.2,1682.417,102.5833
"18890","59163","2018",347,234,113,213988.2,2239.876,91.45533
"18891","59164","2018",2,2,0,102500,1256,84
"18892","59165","2018",67,65,2,134827.3,1498.299,88.37313
"18893","59166","2018",20,20,0,148288.4,1413.7,100.15
"18894","59167","2018",2,2,0,148077.5,1338,104.5
"18895","59168","2018",60,50,10,221880.2,2216.3,98.48333
"18896","59170","2018",46,46,0,116571.9,1308.435,92.02174
"18897","59171","2018",1,1,0,55500,603,92
"18898","59172","2018",179,174,5,71060.37,857.2626,84.57542
"18899","59173","2018",15,15,0,254762.7,2359.533,106.8
"18900","59174","2018",7,7,0,157485.7,1532.857,101.5714
"18901","59175","2018",1,1,0,168500,1296,130
"18902","59176","2018",3,3,0,114666.7,1054,124.6667
"18903","59177","2018",4,4,0,131250,1410.75,96.75
"18904","59178","2018",473,293,180,121046.7,1439.304,86.33827
"18905","59179","2018",88,86,2,113108.9,1211.227,94.43182
"18906","59180","2018",12,12,0,200616.7,1700.333,127.1667
"18907","59181","2018",4,4,0,107438.2,1104.25,91.25
"18908","59182","2018",3,3,0,183033.3,1693,107.6667
"18909","59183","2018",1023,623,400,149242.6,1718.697,88.42033
"18910","59184","2018",9,9,0,175822.2,1356.778,135.1111
"18911","59185","2018",10,10,0,149985.3,1446,101.6
"18912","59187","2018",4,4,0,97250,963.25,100.25
"18913","59188","2018",2,2,0,142000,1109,109.5
"18914","59189","2018",8,8,0,179875,2069.75,89.875
"18915","59190","2018",2,2,0,109750,1197.5,110
"18916","59191","2018",7,7,0,60714.29,740.8571,83.42857
"18917","59192","2018",8,8,0,139343.8,1330.625,105.375
"18918","59193","2018",43,43,0,202438.1,2190.047,93.48837
"18919","59194","2018",20,20,0,145055.4,1140.25,131.7
"18920","59195","2018",12,12,0,387529.2,3007.25,125
"18921","59196","2018",13,13,0,296357.3,2279,135.7692
"18922","59197","2018",16,16,0,282581.2,2170.25,138.875
"18923","59198","2018",4,4,0,123500,1104.5,112.75
"18924","59199","2018",6,6,0,130950,1172.333,108.8333
"18925","59200","2018",4,4,0,173056.2,1555,103
"18926","59201","2018",12,12,0,297417.5,2722.5,107.4167
"18927","59202","2018",62,56,6,193040.7,2045.887,94.56452
"18928","59203","2018",26,26,0,161512.9,1704.231,99.26923
"18929","59204","2018",7,6,1,137007.1,1221.714,103
"18930","59205","2018",75,71,4,97703.59,1148.36,85.68
"18931","59206","2018",31,31,0,126862.9,1228.161,105.1613
"18932","59207","2018",26,26,0,107069.2,1107.462,98.76923
"18933","59208","2018",2,2,0,507500,2919.5,183
"18934","59209","2018",5,5,0,73660,809.6,90.6
"18935","59210","2018",23,23,0,168097.8,1508.043,118.7391
"18936","59211","2018",7,6,1,278400.7,1894.286,139.4286
"18937","59212","2018",71,69,2,149480.3,1528.479,100.493
"18938","59213","2018",6,6,0,115908.3,1379.667,88.83333
"18939","59214","2018",12,12,0,196250,1605.167,124.9167
"18940","59215","2018",11,11,0,201518.2,1923.636,108.1818
"18941","59217","2018",2,2,0,307000,2194.5,143.5
"18942","59218","2018",14,14,0,86035.71,965.8571,96.85714
"18943","59219","2018",7,7,0,129571.4,1209.286,111.5714
"18944","59220","2018",262,211,51,182602.8,2171.962,84.99237
"18945","59221","2018",19,9,10,98182.37,1537.474,73.42105
"18946","59222","2018",17,17,0,224787.1,2158.176,105.8824
"18947","59223","2018",7,7,0,86357.14,904.4286,89.71429
"18948","59224","2018",16,16,0,122468.8,1474.125,83
"18949","59225","2018",73,73,0,123342.3,1254.616,99.06849
"18950","59226","2018",8,8,0,157687.5,1118.625,148.625
"18951","59227","2018",63,63,0,133202,1533.302,87.90476
"18952","59228","2018",12,12,0,151903.2,1653.75,99.83333
"18953","59229","2018",6,6,0,114474.8,1261.167,90.66667
"18954","59230","2018",55,52,3,118545.6,1240.455,106.8545
"18955","59231","2018",12,12,0,98878.17,1176.25,84.83333
"18956","59232","2018",2,2,0,176000,2110.5,84.5
"18957","59233","2018",3,3,0,134666.7,1030.333,121.3333
"18958","59234","2018",52,51,1,118733.5,1458.135,82.19231
"18959","59236","2018",2,2,0,88750,846.5,111
"18960","59237","2018",9,9,0,174555.6,1634.556,104.3333
"18961","59238","2018",10,10,0,180605,1461.7,119.8
"18962","59239","2018",33,33,0,177726.4,1601,111.9394
"18963","59241","2018",6,6,0,140250,1316.333,107.5
"18964","59242","2018",4,4,0,95250,926.25,110.5
"18965","59243","2018",15,15,0,123226.7,1350.6,92.66667
"18966","59244","2018",19,19,0,140698.7,1245,107.2105
"18967","59246","2018",7,7,0,131357.1,979.2857,137.7143
"18968","59247","2018",17,17,0,234286.8,2301.941,102.8235
"18969","59249","2018",103,99,4,81397.09,890.0874,93.31068
"18970","59250","2018",28,26,2,260236.4,2426.464,107.4643
"18971","59251","2018",4,4,0,155750,1473.75,105
"18972","59252","2018",18,16,2,264913.9,2396.722,119.2778
"18973","59253","2018",69,69,0,91704.78,1000.13,93.53623
"18974","59254","2018",9,9,0,187511.1,1313.889,147.4444
"18975","59255","2018",6,6,0,158416.7,1354,114.6667
"18976","59256","2018",41,41,0,262001,2465.512,105.6098
"18977","59257","2018",10,10,0,257895.2,2479.1,104.4
"18978","59258","2018",28,28,0,277698.8,2471.393,112.3214
"18979","59259","2018",8,8,0,224806.2,1532.375,149.125
"18980","59260","2018",49,46,3,178317.4,1865.327,101.6939
"18981","59261","2018",22,22,0,89617.73,956.5455,91.5
"18982","59262","2018",29,29,0,222707.1,1782.621,126.4138
"18983","59263","2018",15,15,0,200034.7,1658.067,119.4667
"18984","59264","2018",7,7,0,154747.1,1411.143,112.4286
"18985","59265","2018",25,25,0,171212,1534.24,115.68
"18986","59266","2018",46,46,0,215743.6,2171.609,105.2391
"18987","59267","2018",3,3,0,163750,1396,111
"18988","59268","2018",63,55,8,161166.3,1687.175,93.93651
"18989","59269","2018",17,17,0,128201.8,1239,108.7647
"18990","59270","2018",3,3,0,104000,874.6667,124.3333
"18991","59271","2018",94,81,13,131011,1436.362,91.56383
"18992","59272","2018",68,67,1,116884,1443.632,82.04412
"18993","59273","2018",130,119,11,145643.2,1548,94.73077
"18994","59274","2018",5,5,0,93620,942.2,89.4
"18995","59275","2018",10,10,0,460698,3081.9,146.7
"18996","59276","2018",22,21,1,139346.6,1307.545,113.5455
"18997","59277","2018",7,7,0,117214.3,1289.143,92.14286
"18998","59278","2018",64,56,8,207526.7,2240.75,94.125
"18999","59279","2018",278,245,33,178352.3,1980.748,89.56115
"19000","59280","2018",12,12,0,93683.33,1114.667,74.83333
"19001","59281","2018",14,14,0,198076.9,1770.786,104.2857
"19002","59282","2018",2,2,0,215035,1935,122.5
"19003","59283","2018",6,6,0,183166.7,1792.167,98.83333
"19004","59284","2018",48,46,2,164164.5,1638.729,101.7917
"19005","59285","2018",27,27,0,123482.6,1356.185,88.81481
"19006","59286","2018",203,162,41,162229.9,2061.887,81.59113
"19007","59288","2018",30,30,0,104972,1186.367,88.73333
"19008","59289","2018",9,9,0,92555.56,1006.444,91.22222
"19009","59290","2018",2,2,0,117000,1470,81.5
"19010","59291","2018",128,127,1,92360.55,1007.359,93.28906
"19011","59292","2018",22,22,0,107602.7,1149.773,92.90909
"19012","59293","2018",20,20,0,164690.8,1680.8,104.7
"19013","59294","2018",5,5,0,160080,1586.2,101
"19014","59295","2018",259,226,33,155909.5,1745.363,91.36293
"19015","59296","2018",2,2,0,90000,1093,78.5
"19016","59297","2018",30,29,1,144114,1157.133,124.5333
"19017","59299","2018",215,203,12,276201.9,2474.833,108.4
"19018","59300","2018",7,7,0,98537.86,1085.857,84
"19019","59301","2018",45,45,0,147485.9,1507.133,104.7556
"19020","59302","2018",51,51,0,126406.8,1333.529,93.84314
"19021","59303","2018",22,21,1,209289.3,2124.727,99.40909
"19022","59304","2018",2,2,0,296485,2205.5,135.5
"19023","59305","2018",28,28,0,167225.4,1794.179,96.14286
"19024","59306","2018",2,2,0,151250,1191.5,110.5
"19025","59307","2018",4,4,0,116500,1106.25,100.5
"19026","59308","2018",10,10,0,203535,2140,100.8
"19027","59309","2018",41,39,2,156714.6,1499.878,107.2439
"19028","59310","2018",11,11,0,148590.9,1265.909,108.6364
"19029","59311","2018",6,6,0,90045.5,901,103.3333
"19030","59312","2018",4,4,0,105500,982.25,106
"19031","59313","2018",11,11,0,173168.6,1607.364,106.9091
"19032","59314","2018",31,31,0,140093.5,1447.968,99.22581
"19033","59315","2018",6,6,0,121283.3,1109,114.1667
"19034","59316","2018",48,48,0,222223,2243.333,105.3542
"19035","59317","2018",125,122,3,151412.6,1872.768,82.416
"19036","59318","2018",12,12,0,206752,1863.25,116.4167
"19037","59319","2018",36,36,0,213446.2,1851.167,116.9722
"19038","59320","2018",20,20,0,204756.2,2019.55,102.35
"19039","59321","2018",7,7,0,91285.71,915.8571,97.14286
"19040","59322","2018",41,41,0,116059.5,1184.512,97.95122
"19041","59323","2018",9,9,0,164833.3,1531.333,107.3333
"19042","59324","2018",84,82,2,84771.95,982.869,86.15476
"19043","59325","2018",8,8,0,184046.2,1765.875,104.375
"19044","59326","2018",15,15,0,167250,1783.133,97.86667
"19045","59327","2018",34,34,0,116669.1,1398.118,86.35294
"19046","59328","2018",503,321,182,239595.3,2801.264,85.67594
"19047","59329","2018",45,40,5,139106.7,1565.489,90.04444
"19048","59330","2018",26,26,0,225962.2,2187.5,110.7692
"19049","59331","2018",22,22,0,101413.6,1060,96.45455
"19050","59332","2018",34,13,21,120546.8,1783.882,72.35294
"19051","59333","2018",2,2,0,121750,1128.5,115.5
"19052","59334","2018",21,20,1,158802.7,1664.095,95.28571
"19053","59335","2018",30,30,0,266121.7,1959.533,136.4
"19054","59336","2018",19,19,0,104289.8,1196.947,81.05263
"19055","59337","2018",14,14,0,163013.6,1715.929,98.85714
"19056","59338","2018",8,8,0,163343.8,1756.5,102.625
"19057","59339","2018",131,127,4,216110.7,2255.595,98.0916
"19058","59340","2018",42,39,3,176920.8,1935.238,91.66667
"19059","59341","2018",5,5,0,117720,979,116
"19060","59342","2018",4,4,0,142625,1294.75,113.5
"19061","59343","2018",94,89,5,218017.4,2374.309,93.46809
"19062","59344","2018",17,17,0,118949.6,1150.647,100.8235
"19063","59345","2018",28,27,1,134303.6,1325.964,99.25
"19064","59346","2018",44,42,2,197404.4,2393.409,84.68182
"19065","59347","2018",6,6,0,113208.3,910.5,126
"19066","59348","2018",11,11,0,135325,1277.545,109
"19067","59349","2018",17,17,0,113582.4,909.1176,118.7059
"19068","59350","2018",4071,1081,2990,181236.5,2999.374,64.35323
"19069","59351","2018",5,5,0,126592.2,1284.4,107.4
"19070","59352","2018",104,96,8,259018.9,2486.288,104.7885
"19071","59353","2018",2,2,0,128000,1304.5,82.5
"19072","59354","2018",6,6,0,202175,2698.833,100.6667
"19073","59356","2018",24,23,1,321126.5,2753.125,117
"19074","59357","2018",17,17,0,137462.9,1376.471,100.5294
"19075","59358","2018",12,12,0,170219.2,1626.083,106.4167
"19076","59359","2018",62,62,0,151580.3,1609.194,95.56452
"19077","59360","2018",298,188,110,145640.7,2084.55,71.95302
"19078","59361","2018",30,30,0,79316.33,923.4333,86.8
"19079","59363","2018",7,7,0,104176.4,1253.857,82.85714
"19080","59364","2018",10,10,0,404897,2897.1,138.5
"19081","59365","2018",36,32,4,80083,960.8056,87.02778
"19082","59366","2018",14,14,0,178457.1,1728,106.4286
"19083","59367","2018",174,138,36,188486.3,2165.339,89
"19084","59368","2018",467,141,326,202435.1,2730.231,73.57816
"19085","59369","2018",42,39,3,129864.6,1260.929,105.0476
"19086","59370","2018",13,12,1,163836.5,1398.692,115.7692
"19087","59371","2018",8,8,0,267062.5,2487.625,113.625
"19088","59372","2018",6,6,0,85083.33,947,94.83333
"19089","59374","2018",4,4,0,94025,1227.75,82.25
"19090","59375","2018",54,52,2,167874.5,1758.889,96
"19091","59377","2018",23,23,0,134137,1249.696,106.2174
"19092","59378","2018",684,413,271,297508.9,3164.357,91.59357
"19093","59379","2018",3,3,0,183333.3,1968.333,92.66667
"19094","59381","2018",8,8,0,178881.2,1465.375,122.625
"19095","59382","2018",13,13,0,84076.92,825.9231,99.53846
"19096","59383","2018",115,99,16,123758.4,1400.991,86.69565
"19097","59384","2018",15,14,1,121150,1217.933,98.86667
"19098","59385","2018",24,23,1,82310.83,967.625,84.33333
"19099","59386","2018",126,121,5,220955.7,2734.595,82.51587
"19100","59387","2018",21,21,0,120233.3,1191.905,101.2381
"19101","59388","2018",24,24,0,233688.2,2109.458,114.7083
"19102","59389","2018",33,33,0,116987.9,1170.515,106.0303
"19103","59390","2018",25,25,0,126656,1286.4,101.24
"19104","59391","2018",8,8,0,133437.5,1422.75,94.875
"19105","59392","2018",274,193,81,90093.66,1085.628,82.90511
"19106","59393","2018",12,12,0,194325,1755,111.1667
"19107","59394","2018",7,7,0,83257.14,795,92.42857
"19108","59395","2018",5,5,0,87900,1014,85.6
"19109","59396","2018",11,11,0,153060.9,1530.273,105.1818
"19110","59397","2018",13,13,0,179197.7,1452.231,124.9231
"19111","59398","2018",34,32,2,390690.5,2808.882,138.7353
"19112","59399","2018",4,4,0,158000,1662.75,93
"19113","59400","2018",134,132,2,144240.1,1506.149,97.67164
"19114","59401","2018",24,23,1,188525,1783.708,106.75
"19115","59402","2018",4,4,0,109775,1237.5,87.75
"19116","59403","2018",6,6,0,104666.7,1528.667,71.33333
"19117","59405","2018",6,6,0,96200,1149,89
"19118","59406","2018",3,3,0,65000,777,80
"19119","59407","2018",12,12,0,179833.3,1417.833,126.9167
"19120","59408","2018",15,15,0,204595.1,2091.667,103.4667
"19121","59409","2018",27,27,0,115717.9,1276.185,90.11111
"19122","59410","2018",239,138,101,155844.9,1975.456,76.86192
"19123","59411","2018",26,26,0,243369.3,2091,119.0769
"19124","59412","2018",3,3,0,28166.67,443.3333,64.66667
"19125","59413","2018",9,9,0,72611.11,757.3333,92.11111
"19126","59414","2018",30,30,0,134853.3,1547.333,88.5
"19127","59415","2018",1,1,0,165000,1528,108
"19128","59416","2018",43,43,0,168903.5,1589.767,106.9535
"19129","59418","2018",12,12,0,98950,1062.167,93.58333
"19130","59419","2018",28,27,1,250852.6,2141.179,115.5
"19131","59420","2018",1,1,0,140000,1197,117
"19132","59421","2018",218,165,53,321150.4,2993.954,102.5183
"19133","59422","2018",4,4,0,142000,1290.25,107
"19134","59423","2018",9,9,0,221766.7,1986,122.5556
"19135","59424","2018",10,10,0,88692.5,972.4,95.7
"19136","59425","2018",2,2,0,115000,1154.5,97.5
"19137","59426","2018",128,123,5,210538.9,2182.367,97.05469
"19138","59427","2018",5,5,0,208700,2143.2,107.4
"19139","59428","2018",43,43,0,107987.1,1220.558,91.39535
"19140","59429","2018",47,47,0,99911.19,1092.085,91.85106
"19141","59430","2018",12,11,1,117995.8,1200.25,109
"19142","59431","2018",82,81,1,220025.1,2142.28,102.3537
"19143","59432","2018",4,4,0,196125,1627.25,120.75
"19144","59433","2018",12,12,0,136575,1472.083,91.66667
"19145","59434","2018",12,12,0,199612.5,1969.25,100.1667
"19146","59435","2018",31,31,0,258541.7,2253.484,121.6452
"19147","59436","2018",9,9,0,197050,1892.333,111.6667
"19148","59437","2018",9,9,0,268333.3,2375.333,109.8889
"19149","59438","2018",5,5,0,173500,1373.8,119.2
"19150","59439","2018",3,3,0,128510.3,1159.333,108
"19151","59440","2018",7,7,0,89496.57,1027,87.28571
"19152","59441","2018",11,11,0,170069.1,1251.091,134.9091
"19153","59442","2018",1,1,0,145000,1611,90
"19154","59443","2018",2,2,0,194750,1382.5,140.5
"19155","59444","2018",6,6,0,135787,1508.833,89.33333
"19156","59445","2018",13,13,0,132974.6,1213.462,107.9231
"19157","59446","2018",6,5,1,182400,1605.667,113.6667
"19158","59447","2018",67,67,0,121668.3,1334.104,91.56716
"19159","59448","2018",5,5,0,180200,1206.2,153.2
"19160","59449","2018",106,99,7,196766.3,2070.019,95.29245
"19161","59450","2018",9,9,0,106877.8,1042.778,100.1111
"19162","59451","2018",5,5,0,158960,1463.8,112
"19163","59452","2018",48,48,0,139400.6,1548.958,93.08333
"19164","59453","2018",4,4,0,176537.5,1613.25,108
"19165","59454","2018",7,7,0,192094.3,2047.143,99
"19166","59455","2018",16,16,0,125454.8,1265.438,99.8125
"19167","59456","2018",49,49,0,136992.8,1503.041,93.10204
"19168","59457","2018",113,106,7,202639.3,2315.248,88.56637
"19169","59458","2018",19,19,0,336871.8,3072.684,115.2105
"19170","59459","2018",50,48,2,122372.3,1354.68,91.9
"19171","59461","2018",4,4,0,157897.5,1071.75,152.75
"19172","59462","2018",71,59,12,188801.1,2116.155,90.69014
"19173","59463","2018",12,12,0,157565.8,1371,114.5833
"19174","59464","2018",29,29,0,107282.6,1043.276,100.0345
"19175","59465","2018",10,10,0,82050,959.5,88.4
"19176","59466","2018",34,30,4,228298.7,2434.824,95.23529
"19177","59467","2018",22,22,0,90748.86,1158.545,79.63636
"19178","59468","2018",10,10,0,176691,1604.5,110.6
"19179","59469","2018",3,3,0,258533.3,2170,119.6667
"19180","59470","2018",31,29,2,272411.7,2508.774,109.4194
"19181","59471","2018",19,19,0,137452.6,1512.316,90.10526
"19182","59472","2018",14,14,0,86582.14,968.0714,87.42857
"19183","59473","2018",3,3,0,145000,1503,95.33333
"19184","59474","2018",9,9,0,104833.3,1017.667,110.3333
"19185","59475","2018",24,24,0,126429.2,1345.458,90.41667
"19186","59476","2018",38,38,0,149719.7,1391.974,104.3158
"19187","59477","2018",56,55,1,171987.5,1933.5,90.83929
"19188","59478","2018",14,14,0,182761.1,1443.071,123.7857
"19189","59479","2018",37,37,0,130848,1341.081,99.48649
"19190","59480","2018",8,8,0,173387.5,1902.25,96
"19191","59481","2018",47,44,3,129411.5,1384.723,91.76596
"19192","59482","2018",71,67,4,244190.7,2379.338,104.4789
"19193","59484","2018",40,40,0,91475.57,992.775,95.4
"19194","59485","2018",27,27,0,109652.9,1122.963,98.22222
"19195","59486","2018",24,24,0,145621.2,1423.042,108.7083
"19196","59487","2018",19,19,0,382044.7,3132.316,132.8947
"19197","59488","2018",17,16,1,113926.5,1281,87.70588
"19198","59489","2018",52,51,1,165977.4,1611.827,105.9231
"19199","59490","2018",1,1,0,174000,1403,124
"19200","59491","2018",110,105,5,102554.9,1283.909,84.47273
"19201","59492","2018",5,5,0,165470,1769.6,99.8
"19202","59493","2018",1,1,0,45000,381,118
"19203","59494","2018",2,2,0,112500,931.5,105
"19204","59495","2018",19,19,0,113995.2,1127.474,97.10526
"19205","59496","2018",5,5,0,119968.6,1402.8,91
"19206","59497","2018",13,13,0,214607.1,2237.462,93.69231
"19207","59498","2018",3,3,0,157783.3,1116.333,139.6667
"19208","59499","2018",27,27,0,168591.7,1619.037,105.7778
"19209","59500","2018",3,3,0,149166.7,1043.667,140.3333
"19210","59501","2018",11,11,0,200790.9,1758.818,115.0909
"19211","59502","2018",17,17,0,70485.29,892.2353,79.58824
"19212","59503","2018",1,1,0,130000,670,194
"19213","59504","2018",50,50,0,115640.9,1144.86,101.46
"19214","59505","2018",10,10,0,199969,2003.5,106.6
"19215","59506","2018",2,2,0,174000,998.5,161.5
"19216","59507","2018",247,190,57,182865.6,2079.64,89.47773
"19217","59508","2018",176,152,24,255109.2,2531.301,101.2841
"19218","59509","2018",56,55,1,151205,1534.536,101.2679
"19219","59511","2018",26,26,0,171087.6,1689.769,100
"19220","59512","2018",842,565,277,133917.5,1504.998,90.04157
"19221","59513","2018",8,8,0,148368.8,1465.75,102.625
"19222","59514","2018",61,52,9,115597.6,1174.967,98.09836
"19223","59515","2018",4,4,0,99375,1046,89
"19224","59516","2018",11,11,0,139961.4,1544.909,97.36364
"19225","59517","2018",10,10,0,134780,1326.1,108
"19226","59518","2018",1,1,0,191120,1554,123
"19227","59519","2018",15,15,0,207830.4,1885.467,110.6
"19228","59520","2018",18,18,0,153933.9,1301.611,115.4444
"19229","59521","2018",2,2,0,90500,795.5,115
"19230","59522","2018",27,27,0,257525.9,2566.852,101.0741
"19231","59523","2018",36,36,0,341596.5,2834.139,120.1389
"19232","59524","2018",68,68,0,208523.1,2195.779,95.26471
"19233","59525","2018",29,28,1,96201.72,928.4138,106.6552
"19234","59526","2018",182,171,11,145633.6,1548.401,93.32418
"19235","59527","2018",220,138,82,201934.4,2622.577,77.54091
"19236","59528","2018",18,17,1,88602.78,950.9444,92.77778
"19237","59529","2018",3,3,0,182533.3,1514.667,128.3333
"19238","59533","2018",17,17,0,119614.7,1185.235,99.29412
"19239","59534","2018",6,6,0,144250,1288.833,114.6667
"19240","59535","2018",13,13,0,240482.3,2044.231,120.3846
"19241","59536","2018",7,7,0,159914.3,1305.143,119.4286
"19242","59537","2018",7,7,0,141214.3,1404.429,101.2857
"19243","59539","2018",6,6,0,187846.7,1954.833,97.5
"19244","59541","2018",9,9,0,86333.33,1010.778,88.77778
"19245","59542","2018",7,7,0,151571.4,1307.143,115.2857
"19246","59543","2018",8,8,0,116037.5,1124,95.75
"19247","59544","2018",143,120,23,158446.2,1648.483,94.78322
"19248","59545","2018",12,12,0,88931.25,966.5833,91.33333
"19249","59546","2018",19,19,0,188356.3,1408.632,134.0526
"19250","59547","2018",11,11,0,92927.82,1025.636,89.81818
"19251","59548","2018",9,9,0,146863.3,1332.444,114.5556
"19252","59549","2018",5,5,0,104600,1120,95
"19253","59550","2018",45,45,0,161811.3,1873.067,87.88889
"19254","59551","2018",22,22,0,241000.9,1981.545,123.0455
"19255","59552","2018",2,2,0,148500,1220.5,121
"19256","59553","2018",85,84,1,247872.4,2319.059,107.5059
"19257","59554","2018",7,7,0,320293.6,2098.429,154.1429
"19258","59555","2018",12,12,0,84916.67,800.1667,103.1667
"19259","59556","2018",3,3,0,97500,1051.333,86
"19260","59557","2018",16,15,1,165166.2,1555.062,105.75
"19261","59558","2018",14,14,0,110571.4,1038.571,99.64286
"19262","59559","2018",33,33,0,224602.1,1965.939,117.303
"19263","59560","2018",131,105,26,177717.1,2246.725,80.94656
"19264","59562","2018",3,3,0,114444.7,1395,85.66667
"19265","59563","2018",1,1,0,163000,1181,138
"19266","59564","2018",28,27,1,117319.8,1327.821,89.25
"19267","59565","2018",8,8,0,158325,1305.125,120.125
"19268","59566","2018",59,53,6,212542.4,2410.508,88.44068
"19269","59567","2018",1,1,0,200700,1556,129
"19270","59568","2018",2,2,0,242000,1301,185
"19271","59569","2018",130,110,20,108390.4,1221.969,91.33846
"19272","59570","2018",9,9,0,185738.9,1875.222,104.1111
"19273","59571","2018",45,45,0,100522.2,942.1778,104.9556
"19274","59572","2018",19,19,0,122640.4,1089.842,108.6842
"19275","59573","2018",2,2,0,135000,1697,79.5
"19276","59574","2018",135,130,5,117049.4,1320.237,89.40741
"19277","59575","2018",5,5,0,235480,1505.2,159.6
"19278","59576","2018",11,11,0,177664.5,1759.273,99.18182
"19279","59577","2018",7,7,0,163474.3,1484.571,115.1429
"19280","59578","2018",16,16,0,153853.1,1421.688,111.4375
"19281","59579","2018",15,15,0,213866,1827.867,114.7333
"19282","59580","2018",55,52,3,177860,1799.927,103.2
"19283","59581","2018",43,43,0,209964,1865.744,116.7442
"19284","59582","2018",12,12,0,194850,1739,119.8333
"19285","59583","2018",7,7,0,141328.6,1403.571,95.71429
"19286","59584","2018",8,8,0,173812.8,1336,132
"19287","59585","2018",51,47,4,247126.4,2627.294,90.88235
"19288","59586","2018",71,70,1,244629,2408.268,101.338
"19289","59587","2018",5,5,0,160280,1860.4,90
"19290","59588","2018",86,85,1,240475.6,2017.407,120.8953
"19291","59589","2018",26,26,0,135605.6,1428.423,97.69231
"19292","59590","2018",9,9,0,105491.4,1066.222,107.3333
"19293","59591","2018",7,7,0,162785.7,1452.429,112.1429
"19294","59592","2018",54,54,0,200441.7,1911.815,104.963
"19295","59593","2018",10,10,0,213285,1481.4,149.7
"19296","59594","2018",15,15,0,191872.7,1644.2,116.8
"19297","59595","2018",6,6,0,172733.3,1644.667,100
"19298","59596","2018",6,6,0,272708.3,2012.333,139.5
"19299","59597","2018",5,5,0,241800,1776.6,135.4
"19300","59598","2018",51,50,1,215415.4,2241.608,101.1765
"19301","59599","2018",1296,910,386,134156.6,1602.439,85.22068
"19302","59600","2018",11,11,0,303154.5,2966.636,106.3636
"19303","59601","2018",23,23,0,93899.13,964.913,103.7391
"19304","59602","2018",14,13,1,283535.7,2504.071,109.5
"19305","59603","2018",66,57,9,110708,1363,91.57576
"19306","59604","2018",11,11,0,99090.91,991,103.7273
"19307","59605","2018",20,20,0,173259.8,1971.9,90.45
"19308","59606","2018",667,355,312,121154.6,1569.894,79.32234
"19309","59607","2018",6,6,0,128645,1160.167,115.3333
"19310","59608","2018",5,5,0,184750,1441.6,128.6
"19311","59609","2018",22,18,4,206831.8,2234.5,91.95455
"19312","59610","2018",17,17,0,117690,1214.941,94.52941
"19313","59611","2018",23,23,0,372742.4,3082.391,120.913
"19314","59612","2018",7,7,0,168714.3,1298.714,131.5714
"19315","59613","2018",10,10,0,175311.4,1697,106.4
"19316","59614","2018",13,13,0,92967.69,1038.385,88.30769
"19317","59615","2018",28,28,0,186969.6,1588.5,118.2857
"19318","59616","2018",92,92,0,117227.6,1230.902,94.59783
"19319","59617","2018",2,2,0,230900,1640,130
"19320","59618","2018",10,10,0,133561,1653.4,84.6
"19321","59619","2018",13,13,0,176888.5,1806.231,95.23077
"19322","59620","2018",8,8,0,116975,1093.625,99.25
"19323","59622","2018",14,14,0,117889.3,1093.071,100.6429
"19324","59623","2018",7,7,0,72714.29,794.7143,93.28571
"19325","59624","2018",29,29,0,93814.31,872.6207,111.2759
"19326","59625","2018",5,5,0,95167.8,1168.2,88.8
"19327","59626","2018",12,12,0,192173.9,1713.75,115
"19328","59627","2018",12,12,0,105747.7,1081.25,102.75
"19329","59628","2018",2,2,0,158400,1703.5,102.5
"19330","59629","2018",19,19,0,192284.2,1888.789,104.0526
"19331","59630","2018",42,42,0,174230.1,1782.619,100.0238
"19332","59631","2018",30,30,0,107605.9,1035.867,106.0333
"19333","59632","2018",47,46,1,151004.4,1352.745,111.8936
"19334","59633","2018",5,5,0,157000,1118.8,136.4
"19335","59634","2018",5,5,0,153640,1546.2,99.2
"19336","59635","2018",1,1,0,1e+05,633,158
"19337","59636","2018",135,106,29,263510.6,2751.341,94.12593
"19338","59637","2018",16,16,0,186790.6,1759.938,104.125
"19339","59638","2018",17,17,0,269158.2,2733.706,102.3529
"19340","59639","2018",13,13,0,200503.8,1779.538,112.3846
"19341","59640","2018",5,5,0,225612.4,1220.8,184.6
"19342","59641","2018",21,21,0,167061.1,1583.333,108.3333
"19343","59642","2018",3,3,0,179666.7,1427,129
"19344","59643","2018",3,3,0,172500,2353.333,72.66667
"19345","59645","2018",8,8,0,178520,1340.375,123.625
"19346","59646","2018",284,225,59,266373.7,2765.732,94.34859
"19347","59647","2018",25,25,0,88904.4,1127.24,79.32
"19348","59648","2018",197,124,73,181398.9,2066.655,86.52792
"19349","59649","2018",3,3,0,146933.3,1194,122.6667
"19350","59650","2018",471,424,47,145994.5,1716.841,86.50743
"19351","59651","2018",25,25,0,80387.2,988.84,83
"19352","59652","2018",8,8,0,123293.8,1125.375,116.375
"19353","59653","2018",100,98,2,186945.2,2187.38,88.16
"19354","59654","2018",46,45,1,117322.8,1276.87,90.23913
"19355","59655","2018",4,4,0,168010,1726.25,113.25
"19356","59656","2018",65,61,4,222917.3,2091.969,105.6923
"19357","59657","2018",3,3,0,229100,1882,125
"19358","59658","2018",4,4,0,240500,2092,116.25
"19359","59659","2018",25,25,0,83617.44,797.92,103.64
"19360","59660","2018",31,31,0,259467.7,2491.871,101.0323
"19361","59661","2018",1,1,0,105000,1544,68
"19362","59662","2018",20,20,0,187630,1883.85,103.35
"19363","59663","2018",65,61,4,184600.2,1744.215,106.3692
"19364","59664","2018",3,3,0,142666.7,1148,126
"19365","59665","2018",5,5,0,170420,1831.4,92.6
"19366","59666","2018",16,16,0,140289.4,1484.938,95.1875
"19367","59668","2018",16,16,0,160856.7,1628.625,100.5625
"19368","59669","2018",8,8,0,163507.5,1935,89.375
"19369","59670","2018",20,19,1,189988.1,2118.2,93.85
"19370","60001","2018",4,4,0,108250,1220.75,87.75
"19371","60002","2018",8,8,0,246575,2080.5,122
"19372","60003","2018",5,5,0,163800,1773,98.2
"19373","60004","2018",3,3,0,125666.7,1737.333,96.33333
"19374","60005","2018",17,16,1,206117.6,2236.588,97.94118
"19375","60006","2018",8,8,0,165312.5,1722.125,101.125
"19376","60007","2018",25,25,0,195732,2027.6,100.84
"19377","60008","2018",3,3,0,197333.3,1883.667,109
"19378","60009","2018",20,20,0,229690,1979.75,121.45
"19379","60010","2018",18,16,2,219062.8,2326.222,96.05556
"19380","60011","2018",7,6,1,112357.1,2135,59
"19381","60012","2018",45,43,2,186532.2,2198.222,87.35556
"19382","60013","2018",12,12,0,199000,2161,97.33333
"19383","60014","2018",2,2,0,167000,1615,104
"19384","60015","2018",16,16,0,171812.5,1750.188,112.9375
"19385","60016","2018",3,3,0,119333.3,1711.667,66.33333
"19386","60017","2018",11,11,0,133572.7,1434.455,95.54545
"19387","60019","2018",7,7,0,215342.9,1810.571,122.4286
"19388","60020","2018",4,4,0,188500,2202.75,99.5
"19389","60021","2018",8,8,0,108987.5,1278.125,88.25
"19390","60022","2018",10,10,0,358230,2767.8,129.9
"19391","60024","2018",9,9,0,206860.4,1866.778,115
"19392","60025","2018",15,15,0,159466.7,1660.933,95.2
"19393","60026","2018",8,8,0,169080,1430.875,119.5
"19394","60028","2018",6,6,0,384063.7,4457.167,92.66667
"19395","60029","2018",30,30,0,163133.3,1927.433,89.76667
"19396","60030","2018",12,12,0,174083.3,1547.5,113.75
"19397","60031","2018",3,3,0,172500,2276.667,95
"19398","60032","2018",10,10,0,133900,1568.2,83.2
"19399","60033","2018",17,17,0,328735.3,3285.353,96.11765
"19400","60034","2018",20,20,0,135125,1379.2,102.95
"19401","60035","2018",4,4,0,137500,1434.5,111.75
"19402","60036","2018",3,3,0,182333.3,1663.333,108
"19403","60037","2018",6,6,0,81941.67,854.1667,95.16667
"19404","60039","2018",7,7,0,133157.1,1622.714,81.28571
"19405","60040","2018",10,10,0,184850,2258,80.8
"19406","60041","2018",29,29,0,184362.8,1958.103,95.96552
"19407","60042","2018",14,12,2,207635.7,2066.929,103.1429
"19408","60043","2018",7,7,0,149236.4,1447.714,97.85714
"19409","60044","2018",25,24,1,165632,1826.96,94.4
"19410","60045","2018",13,10,3,282519.2,2833.923,100.6154
"19411","60046","2018",1,1,0,119000,2333,51
"19412","60047","2018",9,9,0,285322.2,2574.444,120.3333
"19413","60048","2018",2,2,0,187000,1662.5,128
"19414","60050","2018",6,6,0,178500,2177.333,82
"19415","60051","2018",2,2,0,125675,1615.5,97.5
"19416","60052","2018",1,1,0,340000,1828,186
"19417","60053","2018",10,10,0,114920,1607.1,88.8
"19418","60054","2018",15,15,0,188048.2,2067.867,106.8
"19419","60055","2018",4,4,0,107750,1204.75,85
"19420","60057","2018",560,289,271,139482,1838.505,76.32143
"19421","60058","2018",4,4,0,125500,1238.5,101
"19422","60059","2018",2,2,0,139400,1248,112
"19423","60060","2018",10,10,0,221000,2262.8,99.3
"19424","60061","2018",2,2,0,179500,1165,137.5
"19425","60062","2018",5,5,0,118000,1232.2,98
"19426","60063","2018",11,11,0,196463.6,2331.909,97.90909
"19427","60064","2018",7,7,0,182678.6,1790.429,106.5714
"19428","60065","2018",15,15,0,194956.7,2081.333,97.53333
"19429","60066","2018",2,2,0,179000,2408.5,78.5
"19430","60067","2018",23,21,2,162956.5,2079.565,82.43478
"19431","60068","2018",46,42,4,173382.6,1946.065,93.34783
"19432","60069","2018",14,12,2,195042.9,2191.429,96.78571
"19433","60070","2018",3,3,0,155333.3,1795,89.33333
"19434","60071","2018",1,1,0,188000,1567,120
"19435","60073","2018",9,9,0,136822.2,1683.667,86.77778
"19436","60074","2018",13,12,1,268615.4,2293.769,126.3846
"19437","60075","2018",1,1,0,50000,877,57
"19438","60076","2018",3,3,0,61333.33,639,94
"19439","60077","2018",2,2,0,211500,1815.5,125
"19440","60078","2018",1,1,0,79000,1317,60
"19441","60079","2018",14,12,2,201076.1,1962.857,108.5714
"19442","60081","2018",1,1,0,95000,1759,54
"19443","60082","2018",14,14,0,102892.9,1499,72.71429
"19444","60083","2018",12,12,0,201791.7,1938.083,105.25
"19445","60084","2018",1,1,0,192000,1215,158
"19446","60086","2018",19,17,2,257126.3,2616.158,103.8421
"19447","60087","2018",4,4,0,468008.5,2849.25,162.75
"19448","60088","2018",64,55,9,220462.8,2572.906,88.14062
"19449","60089","2018",8,8,0,224689.4,1980.875,116.5
"19450","60090","2018",4,4,0,225000,2231.25,101.5
"19451","60091","2018",8,8,0,222255,2261.375,101.625
"19452","60092","2018",3,3,0,160551.3,2021.667,98
"19453","60093","2018",9,9,0,127855.6,1192.111,114.1111
"19454","60094","2018",5,5,0,146200,1608.8,98.8
"19455","60095","2018",6,6,0,212225,2299.5,96.66667
"19456","60097","2018",4,4,0,138000,1565,106
"19457","60098","2018",2,2,0,125000,783.5,174.5
"19458","60099","2018",5,5,0,252400,2923.8,103.4
"19459","60100","2018",3,3,0,308333.3,2736.667,91.66667
"19460","60101","2018",11,11,0,184272.7,2449.364,76.72727
"19461","60102","2018",35,34,1,195992.9,2200.171,93.82857
"19462","60103","2018",43,42,1,162112,2015.047,85.53488
"19463","60104","2018",34,34,0,123664.7,1471.941,84.29412
"19464","60105","2018",7,7,0,120842.9,1380.714,96.42857
"19465","60106","2018",22,22,0,211375.3,2299.318,96.40909
"19466","60107","2018",28,26,2,189161.6,2273.357,86.71429
"19467","60108","2018",1,1,0,145000,1835,79
"19468","60109","2018",5,5,0,153400,1880.2,89.2
"19469","60110","2018",3,3,0,103333.3,2094,52.66667
"19470","60112","2018",10,10,0,147872,1810.6,89.5
"19471","60114","2018",1,1,0,172000,1607,107
"19472","60115","2018",9,9,0,148388.9,1822.667,85.77778
"19473","60116","2018",36,36,0,156808.2,2008.278,82.94444
"19474","60117","2018",2,2,0,157500,1280,122
"19475","60119","2018",17,16,1,144617.6,1733.647,87.11765
"19476","60120","2018",17,17,0,174147.1,2050.471,87.64706
"19477","60121","2018",1,1,0,80000,1455,55
"19478","60122","2018",4,4,0,85000,1070.75,82.25
"19479","60123","2018",5,5,0,128800,1428,94.2
"19480","60124","2018",2,2,0,156000,1924,82.5
"19481","60125","2018",6,6,0,210583.3,1860.667,117.5
"19482","60126","2018",6,6,0,165833.3,1678.833,104.3333
"19483","60127","2018",3,3,0,139583.3,1616.667,85.33333
"19484","60128","2018",4,4,0,127125,1133.5,106.25
"19485","60129","2018",18,18,0,141750.6,1677.389,84.77778
"19486","60130","2018",17,17,0,176764.7,2090.235,89.29412
"19487","60131","2018",1,1,0,130000,1215,107
"19488","60132","2018",3,3,0,89666.67,635,152
"19489","60133","2018",5,5,0,132000,1467.2,95.6
"19490","60134","2018",23,21,2,197908.7,2281.13,87.91304
"19491","60135","2018",19,19,0,191244.2,2029.684,97.89474
"19492","60136","2018",5,5,0,156044,1552,101.8
"19493","60137","2018",4,4,0,218000,1401,167.5
"19494","60138","2018",9,7,2,340388.9,3193.333,113.4444
"19495","60139","2018",126,74,52,198973.5,2907.095,71.56349
"19496","60140","2018",7,7,0,210405,2794.143,81.14286
"19497","60141","2018",167,16,151,250018.9,3669.467,68.12575
"19498","60142","2018",57,40,17,247815,2875.579,91.49123
"19499","60143","2018",30,22,8,153480,2083.5,82.23333
"19500","60145","2018",12,12,0,153916.7,1777.083,88.33333
"19501","60146","2018",5,5,0,114400,1808.8,68.6
"19502","60147","2018",9,9,0,195444.4,1764.667,113.7778
"19503","60148","2018",6,6,0,219679.2,2050.833,118.6667
"19504","60149","2018",14,14,0,223392.9,2256.214,108.2143
"19505","60150","2018",14,14,0,143476.1,1882.357,82.71429
"19506","60151","2018",43,41,2,249580.6,2503.628,101.4419
"19507","60152","2018",3,3,0,192333.3,1883.333,103.6667
"19508","60153","2018",1,1,0,143000,1430,100
"19509","60154","2018",19,19,0,234402.6,2842.316,88.63158
"19510","60155","2018",49,39,10,162496.9,2210.571,78.89796
"19511","60156","2018",25,23,2,197996.8,1953.64,104.68
"19512","60157","2018",136,77,59,136439,1855.537,75.98529
"19513","60158","2018",6,6,0,90500,1307.667,75
"19514","60159","2018",521,151,370,181158.9,2301.616,77.08253
"19515","60160","2018",9,9,0,145888.9,1554.333,97.88889
"19516","60161","2018",1,1,0,80000,952,84
"19517","60162","2018",9,8,1,190277.8,1902.333,106.7778
"19518","60163","2018",11,11,0,116909.1,1398.182,84.54545
"19519","60164","2018",9,9,0,183722.2,1850.444,104.3333
"19520","60165","2018",5,5,0,193600,2357.2,92.2
"19521","60166","2018",12,12,0,156259.9,1776.25,89
"19522","60167","2018",5,5,0,189810,1749,108.2
"19523","60168","2018",2,1,1,214000,3957,69.5
"19524","60169","2018",12,12,0,229520.6,2045.75,118.3333
"19525","60170","2018",7,7,0,584985.7,3175.571,182.5714
"19526","60171","2018",1,1,0,50000,758,66
"19527","60172","2018",68,33,35,271897.4,3032.471,93.58824
"19528","60173","2018",7,5,2,128285.7,1524.143,86.42857
"19529","60174","2018",4,4,0,118375,1292,95.25
"19530","60175","2018",166,58,108,110193.6,1730.331,64.48193
"19531","60176","2018",175,107,68,184732.1,2521.411,75.68
"19532","60177","2018",11,11,0,208985.5,1892.364,115.5455
"19533","60178","2018",34,29,5,134044.7,1627.529,85.82353
"19534","60179","2018",1,1,0,215000,1208,178
"19535","60180","2018",6,6,0,186333.3,1938.833,96.5
"19536","60181","2018",16,16,0,145750,1328.875,108.25
"19537","60183","2018",5,5,0,210820,3675,91.4
"19538","60184","2018",1,1,0,156000,1773,88
"19539","60185","2018",10,10,0,235700,2230.8,106.9
"19540","60186","2018",2,2,0,230000,1657,175.5
"19541","60187","2018",14,14,0,132205.6,1633.357,87.14286
"19542","60188","2018",14,13,1,193291.1,1685.714,121.4286
"19543","60190","2018",4,4,0,233500,2095.75,117
"19544","60191","2018",9,9,0,138377.8,1394.778,104.6667
"19545","60192","2018",2,2,0,177500,1497,114
"19546","60193","2018",2,2,0,138000,1579,87
"19547","60194","2018",3,3,0,119000,1238,96.66667
"19548","60195","2018",11,9,2,171090.9,1984.455,91.54545
"19549","60196","2018",18,18,0,196023.3,1795.444,114
"19550","60197","2018",7,7,0,231714.3,2138.714,110.1429
"19551","60198","2018",7,7,0,150482.9,1746.286,95.85714
"19552","60199","2018",2,2,0,120000,1377,97.5
"19553","60200","2018",3,3,0,135000,1707,80
"19554","60201","2018",2,2,0,197500,1897,104.5
"19555","60203","2018",8,7,1,230671.2,2655.375,97.125
"19556","60205","2018",2,2,0,86750,987.5,90.5
"19557","60206","2018",12,12,0,149805.8,1586.083,96.58333
"19558","60207","2018",1,1,0,149000,1367,109
"19559","60208","2018",4,4,0,157250,2041,78.25
"19560","60209","2018",6,6,0,150833.3,1822.167,98.5
"19561","60210","2018",3,3,0,206133.3,1812.333,115.6667
"19562","60211","2018",9,9,0,135477.8,1640.778,82.11111
"19563","60212","2018",15,15,0,221025.6,2300,102.9333
"19564","60214","2018",3,3,0,158333.3,1712.333,106.6667
"19565","60215","2018",2,2,0,138831.5,1069.5,120
"19566","60216","2018",5,5,0,144650,1832.8,85.8
"19567","60217","2018",5,5,0,132900,1504.8,92.8
"19568","60218","2018",20,20,0,215051.6,2244.65,97.7
"19569","60219","2018",1,1,0,70000,1667,42
"19570","60220","2018",4,4,0,117250,1542.25,71
"19571","60221","2018",6,6,0,85000,926.8333,92.5
"19572","60222","2018",6,6,0,169155,1430.833,123.3333
"19573","60223","2018",32,32,0,201053.9,1929.625,112.0312
"19574","60224","2018",3,3,0,187000,2133,85
"19575","60225","2018",13,13,0,164076.9,1714.077,99.07692
"19576","60226","2018",5,4,1,206502,1927.2,108
"19577","60227","2018",1,1,0,1e+05,917,109
"19578","60228","2018",6,6,0,196833.3,1645.833,130.3333
"19579","60229","2018",2,2,0,136000,1710.5,79
"19580","60230","2018",6,6,0,145833.3,1792.167,90
"19581","60231","2018",6,4,2,162475,2144.167,74.33333
"19582","60232","2018",5,5,0,142105,1843.8,86.2
"19583","60233","2018",5,5,0,172740,1588.8,111.8
"19584","60234","2018",26,18,8,151957.7,2225.962,73.34615
"19585","60235","2018",16,16,0,161125,1811.5,94.75
"19586","60236","2018",4,4,0,116000,904.25,126.5
"19587","60238","2018",20,18,2,251173.4,2485.75,106.95
"19588","60239","2018",5,5,0,177600,1905,90.4
"19589","60240","2018",6,6,0,111416.7,1276.333,98.66667
"19590","60241","2018",6,6,0,408833.3,2754.5,142.3333
"19591","60242","2018",7,7,0,116428.6,1489,81.42857
"19592","60243","2018",4,4,0,240750,2228.75,109
"19593","60244","2018",3,3,0,155333.3,1657,96.66667
"19594","60245","2018",18,18,0,101387.4,1102.056,93
"19595","60247","2018",1,1,0,235000,1497,157
"19596","60248","2018",2,2,0,138500,1205,125
"19597","60249","2018",2,2,0,244500,2429,100
"19598","60250","2018",4,4,0,177750,1807.75,97.75
"19599","60251","2018",3,3,0,168266.7,2274,73.33333
"19600","60252","2018",2,2,0,156000,1860,84.5
"19601","60253","2018",4,4,0,218600,2133.5,109.25
"19602","60254","2018",8,8,0,191000,1972,97.75
"19603","60255","2018",2,2,0,101500,1208.5,84.5
"19604","60256","2018",11,11,0,169855.2,1870.727,104
"19605","60257","2018",13,13,0,183810.8,2131,91.38462
"19606","60258","2018",1,1,0,148650,1486,100
"19607","60259","2018",8,8,0,236812.5,2375.375,107.75
"19608","60260","2018",9,9,0,290855.6,2148.667,143.2222
"19609","60261","2018",16,11,5,217434.4,2449,94.875
"19610","60262","2018",2,2,0,273000,2437,112
"19611","60263","2018",5,5,0,129294,1240,104.2
"19612","60264","2018",7,7,0,192210,1897.714,106.1429
"19613","60265","2018",6,6,0,156133.3,1570,105.5
"19614","60267","2018",3,3,0,92000,1382.333,67
"19615","60268","2018",2,2,0,106000,1144,147.5
"19616","60269","2018",3,3,0,182333.3,1379.333,121
"19617","60270","2018",2,2,0,135500,1604.5,84.5
"19618","60272","2018",8,8,0,236150,2141.625,115.75
"19619","60273","2018",2,2,0,219000,2307,95
"19620","60274","2018",5,5,0,203000,1696.8,138.2
"19621","60275","2018",2,2,0,122000,1519.5,79
"19622","60276","2018",2,2,0,175500,1672.5,111
"19623","60277","2018",13,13,0,168294.2,1730.615,101.1538
"19624","60278","2018",5,5,0,94400,1038,85.4
"19625","60279","2018",2,2,0,202500,2667,76
"19626","60280","2018",1,1,0,101000,1530,66
"19627","60281","2018",15,15,0,159866.7,1633.6,103
"19628","60282","2018",147,98,49,326139.8,3421.735,99.23129
"19629","60284","2018",16,16,0,200131.2,2073.125,99.1875
"19630","60285","2018",5,5,0,155130,1527,110.8
"19631","60286","2018",23,21,2,123089.1,1499.913,87.6087
"19632","60287","2018",2,2,0,102450,1136.5,89.5
"19633","60288","2018",3,3,0,101666.7,1653,87.33333
"19634","60289","2018",6,6,0,128971.7,1401.833,98.16667
"19635","60290","2018",3,3,0,169200,1638.333,105.6667
"19636","60291","2018",18,18,0,121400,1250.111,104.8889
"19637","60292","2018",2,2,0,152500,1235,124.5
"19638","60293","2018",3,3,0,206666.7,2559,86
"19639","60294","2018",1,1,0,76000,1900,40
"19640","60295","2018",6,6,0,88000,1176.5,76.5
"19641","60296","2018",1,1,0,156000,1660,94
"19642","60297","2018",1,1,0,66000,1000,66
"19643","60298","2018",5,5,0,125600,1768.8,80.8
"19644","60299","2018",9,9,0,125222.2,1402.333,90.33333
"19645","60301","2018",1,1,0,185000,1637,113
"19646","60302","2018",9,9,0,129987.6,1427.333,92.22222
"19647","60303","2018",2,2,0,193000,1768.5,116.5
"19648","60304","2018",2,2,0,75000,848,94.5
"19649","60305","2018",4,4,0,121700,1547.75,75
"19650","60306","2018",2,2,0,107500,2060,55.5
"19651","60307","2018",7,7,0,207284.3,1957.429,110.8571
"19652","60308","2018",12,12,0,191783.6,1885.333,103.25
"19653","60309","2018",7,7,0,227928.6,1973.286,127.8571
"19654","60310","2018",4,4,0,160500,2345.75,69.75
"19655","60311","2018",3,3,0,117000,1064.667,115.6667
"19656","60312","2018",3,3,0,145000,1144.667,127
"19657","60313","2018",22,21,1,152584.8,1940.227,81.59091
"19658","60314","2018",2,2,0,147500,1275,115.5
"19659","60315","2018",9,9,0,178392.2,1659.889,113.1111
"19660","60316","2018",4,4,0,205000,2044,101.75
"19661","60317","2018",9,9,0,172555.6,1954.556,87.55556
"19662","60318","2018",7,7,0,243142.9,2034.286,129.7143
"19663","60319","2018",10,10,0,171415,2045.2,89.3
"19664","60320","2018",4,4,0,204250,2434.25,84.75
"19665","60321","2018",12,12,0,227500,2345,113.1667
"19666","60322","2018",2,2,0,192672.5,2258,85.5
"19667","60323","2018",7,7,0,153351.4,1638.429,90.14286
"19668","60324","2018",6,6,0,135166.7,1876.167,71.83333
"19669","60325","2018",18,16,2,213866.7,2182.722,96.22222
"19670","60327","2018",22,22,0,172698.8,2105.773,88.63636
"19671","60328","2018",1,1,0,225000,1907,118
"19672","60329","2018",3,3,0,207973.3,1573.667,134.6667
"19673","60330","2018",16,16,0,194484.4,1927.375,105.3125
"19674","60331","2018",4,4,0,193656.2,2261.25,101
"19675","60332","2018",5,5,0,245400,1927.6,126.8
"19676","60333","2018",18,15,3,123401.9,1814.111,77.27778
"19677","60334","2018",9,9,0,217013.3,2026,113.6667
"19678","60336","2018",1,1,0,1e+05,1786,56
"19679","60337","2018",5,4,1,275140,2412,128.2
"19680","60338","2018",68,58,10,202484,2177.397,95.44118
"19681","60339","2018",5,5,0,162800,2289.6,78.2
"19682","60340","2018",8,8,0,155501.9,1378.375,128.125
"19683","60341","2018",36,34,2,278212.9,2863.694,100.2222
"19684","60342","2018",56,47,9,186952.9,2172.196,90.32143
"19685","60343","2018",8,8,0,166812.5,1970.625,88.75
"19686","60344","2018",2,2,0,219000,2665.5,82
"19687","60345","2018",7,7,0,158795,1939.429,82.42857
"19688","60346","2018",145,103,42,392079.5,3571.441,117.5862
"19689","60347","2018",2,2,0,91500,1109.5,80.5
"19690","60348","2018",3,3,0,103666.7,1137.667,91.33333
"19691","60350","2018",19,19,0,160029.8,1739.789,95.78947
"19692","60351","2018",3,3,0,120166.7,1677.333,79.33333
"19693","60352","2018",2,2,0,430000,4514.5,150
"19694","60353","2018",1,1,0,148300,1809,82
"19695","60355","2018",12,12,0,203416.7,1835.333,137.9167
"19696","60356","2018",4,4,0,215842,1989,112.25
"19697","60357","2018",7,7,0,145714.3,1632.429,93.57143
"19698","60358","2018",10,9,1,213300,2104.9,110.1
"19699","60359","2018",1,1,0,90000,1636,55
"19700","60360","2018",82,65,17,150873.1,2028.488,77.76829
"19701","60361","2018",5,5,0,244960,1677.2,145.8
"19702","60362","2018",3,3,0,135333.3,879.3333,167.3333
"19703","60363","2018",4,4,0,255987,2259.25,122.5
"19704","60364","2018",5,4,1,150900,1704.6,90.4
"19705","60365","2018",5,5,0,108220,1572.6,70.8
"19706","60366","2018",4,4,0,201775,1670,122
"19707","60367","2018",1,1,0,290000,1629,178
"19708","60368","2018",19,19,0,154764.2,1974.053,86.36842
"19709","60369","2018",21,18,3,182166.1,1812.762,110.1429
"19710","60370","2018",12,12,0,208556.8,2174.083,100.3333
"19711","60371","2018",3,3,0,142333.3,1316,114.3333
"19712","60372","2018",3,3,0,218200,2191,107
"19713","60373","2018",10,10,0,178270,1908.4,93.5
"19714","60374","2018",21,21,0,145861.9,1555.857,95.52381
"19715","60375","2018",7,7,0,177428.6,2158.571,84.42857
"19716","60377","2018",3,3,0,92551.33,826.6667,114.3333
"19717","60378","2018",4,4,0,153000,1682.5,90.5
"19718","60379","2018",8,8,0,150533.1,1743.625,98
"19719","60380","2018",18,17,1,193283.3,1961.5,101.5556
"19720","60381","2018",3,3,0,198876,1568,130.6667
"19721","60382","2018",128,81,47,182872.1,2412.961,75.67969
"19722","60383","2018",4,4,0,172250,1315.5,139.75
"19723","60385","2018",7,7,0,168021.4,1939.714,89.71429
"19724","60386","2018",12,12,0,126147.4,1394.25,92.16667
"19725","60387","2018",10,10,0,126897,1399.2,91.8
"19726","60388","2018",2,2,0,126000,1493,80.5
"19727","60389","2018",3,3,0,157833.3,1240,129
"19728","60390","2018",2,2,0,147250,1452.5,102.5
"19729","60391","2018",2,2,0,181000,1959.5,93
"19730","60392","2018",5,5,0,181100,2186.6,92.2
"19731","60393","2018",5,4,1,148800,1979.2,77.8
"19732","60394","2018",2,2,0,88000,1395,64.5
"19733","60395","2018",127,100,27,166837.9,2082.811,84.5748
"19734","60396","2018",4,4,0,140482.5,1914.5,82.25
"19735","60397","2018",1,1,0,54000,871,62
"19736","60398","2018",29,22,7,222767.2,2832.448,81
"19737","60399","2018",5,5,0,91415.4,1122,85.6
"19738","60400","2018",2,2,0,147750,1326.5,111
"19739","60401","2018",7,7,0,196357.1,2422.857,84.42857
"19740","60403","2018",25,24,1,108221,1309.2,76.6
"19741","60404","2018",15,14,1,198216.7,2506,86.93333
"19742","60405","2018",7,7,0,103642.9,1122.286,98.42857
"19743","60406","2018",10,10,0,214500,2378.4,93.6
"19744","60407","2018",2,2,0,116000,1188.5,100.5
"19745","60408","2018",6,6,0,202042.3,2224.833,102.1667
"19746","60409","2018",25,24,1,167546.4,1908.88,88
"19747","60410","2018",1,1,0,190000,1610,118
"19748","60411","2018",13,13,0,232936.5,2465.308,99.84615
"19749","60412","2018",9,9,0,254060.4,2362.778,110.6667
"19750","60414","2018",79,61,18,143379.6,1971.494,76.32911
"19751","60415","2018",2,2,0,406500,2211.5,191
"19752","60416","2018",2,2,0,146500,1739.5,84
"19753","60418","2018",4,4,0,161750,2031.75,89.75
"19754","60420","2018",9,9,0,284115.6,2125.444,134.4444
"19755","60421","2018",4,4,0,306580,3375,92
"19756","60422","2018",4,4,0,281380,2976,92.5
"19757","60423","2018",12,12,0,175717.5,1804.25,100.1667
"19758","60424","2018",4,4,0,198267.5,2141,93.75
"19759","60425","2018",8,8,0,146450,1525.375,100.375
"19760","60426","2018",2,2,0,160000,2399.5,75
"19761","60427","2018",3,3,0,257666.7,2206.667,118
"19762","60428","2018",5,5,0,259100,1790.6,136.4
"19763","60429","2018",2,2,0,109344,1316,84.5
"19764","60430","2018",18,18,0,196937.4,2290.611,97.27778
"19765","60431","2018",7,7,0,132272.6,1421.286,100.1429
"19766","60432","2018",14,11,3,295240.7,2960.286,99.71429
"19767","60433","2018",16,16,0,232277.4,2307.062,108.375
"19768","60434","2018",7,7,0,154285.7,1778,92.14286
"19769","60435","2018",6,6,0,143166.7,1789.667,101.8333
"19770","60437","2018",1,1,0,169000,1252,135
"19771","60439","2018",70,64,6,155677.9,1904.714,86.01429
"19772","60440","2018",7,7,0,165714.3,1812.286,92.57143
"19773","60441","2018",2,2,0,229500,2150,104.5
"19774","60442","2018",1,1,0,192000,1714,112
"19775","60443","2018",5,5,0,126000,1883,69.8
"19776","60444","2018",2,2,0,138500,984.5,141
"19777","60445","2018",3,3,0,131333.3,1446.333,93
"19778","60446","2018",49,36,13,201627.1,2585.816,80.71429
"19779","60447","2018",9,9,0,218463.3,2430.111,107.3333
"19780","60448","2018",5,5,0,191020,2202.4,92.6
"19781","60449","2018",3,3,0,309366.7,3417,110.3333
"19782","60450","2018",37,31,6,212697.3,2301.757,100.1622
"19783","60451","2018",20,20,0,169130.8,1817.4,93.9
"19784","60452","2018",8,8,0,182212.5,2377.375,92.5
"19785","60454","2018",13,11,2,167153.8,1858.231,94.38462
"19786","60456","2018",9,9,0,159272.2,1663.889,94
"19787","60457","2018",2,2,0,151000,1625,94
"19788","60458","2018",2,2,0,179000,1652.5,109
"19789","60459","2018",1,1,0,165000,1460,113
"19790","60460","2018",2,2,0,155498,1798,81.5
"19791","60461","2018",2,2,0,201400,2454,82.5
"19792","60462","2018",34,31,3,190601.2,2286.147,87.35294
"19793","60463","2018",168,93,75,127512.4,1738.935,74.58333
"19794","60464","2018",16,16,0,190287.5,2438.438,87.9375
"19795","60466","2018",1,1,0,153000,1681,91
"19796","60468","2018",1,1,0,165000,1065,155
"19797","60469","2018",10,10,0,203324,2247.2,95
"19798","60470","2018",8,8,0,117125,1454.125,82.25
"19799","60471","2018",110,76,34,112392.1,1302.791,86.33636
"19800","60472","2018",1,1,0,136500,1230,111
"19801","60473","2018",5,5,0,191400,1966.4,95.4
"19802","60474","2018",3,3,0,116666.7,597.6667,199.6667
"19803","60476","2018",1,1,0,72000,462,156
"19804","60477","2018",11,11,0,171945.5,1910.909,97.27273
"19805","60478","2018",4,4,0,230073.5,1904.25,119.75
"19806","60479","2018",12,12,0,178763.7,2400.583,80.41667
"19807","60480","2018",5,5,0,147290.6,2042,81.4
"19808","60481","2018",8,8,0,226768.8,2089,103.125
"19809","60482","2018",46,41,5,303465.2,3418.696,93.73913
"19810","60483","2018",4,4,0,157120,1390.75,114.25
"19811","60484","2018",1,1,0,218250,1364,160
"19812","60485","2018",4,4,0,133000,1914.75,71.5
"19813","60486","2018",8,8,0,133050,1582,87.875
"19814","60487","2018",7,7,0,273721.4,2483.429,112.4286
"19815","60488","2018",4,4,0,151025,1733.5,94.75
"19816","60489","2018",16,16,0,216156.2,2251.188,104.0625
"19817","60490","2018",5,5,0,184000,1781.2,97.4
"19818","60491","2018",34,27,7,190991.1,2114.382,99.20588
"19819","60492","2018",10,10,0,161077,1703.8,95.4
"19820","60493","2018",6,6,0,176000,2031.667,93.5
"19821","60494","2018",21,19,2,280170,2964.381,94.80952
"19822","60495","2018",5,5,0,138900,1246.6,109.4
"19823","60496","2018",2,2,0,121000,1537,78.5
"19824","60497","2018",3,3,0,151000,1641.333,90
"19825","60498","2018",1,1,0,140000,2800,50
"19826","60499","2018",2,2,0,150000,1772.5,90
"19827","60500","2018",57,28,29,196170.4,2835.579,73.40351
"19828","60501","2018",14,14,0,157785.7,2059.5,78.07143
"19829","60502","2018",2,2,0,42368.5,481.5,88
"19830","60503","2018",1,1,0,320000,2133,150
"19831","60504","2018",14,14,0,177081.9,2308.071,89.85714
"19832","60505","2018",12,10,2,227217.9,2767.917,85.58333
"19833","60506","2018",5,5,0,91100,1212,77.4
"19834","60507","2018",1,1,0,160000,1231,130
"19835","60508","2018",43,36,7,216726.7,2393.256,94.34884
"19836","60509","2018",146,99,47,166481.4,2130.959,80.62329
"19837","60510","2018",9,9,0,179062.2,2027.778,88.55556
"19838","60511","2018",2,2,0,109650,1334,82.5
"19839","60512","2018",3,3,0,167133.3,1755.667,102.3333
"19840","60513","2018",37,33,4,269172.6,2752.189,103.973
"19841","60515","2018",1,1,0,176000,1853,95
"19842","60516","2018",3,3,0,162000,1630,122.3333
"19843","60517","2018",8,8,0,239750,2269.5,116.875
"19844","60518","2018",2,2,0,133025,1307.5,115.5
"19845","60519","2018",1,1,0,69900,874,80
"19846","60520","2018",2,2,0,170500,2595,77.5
"19847","60521","2018",7,7,0,90485.71,911.4286,90.42857
"19848","60522","2018",3,3,0,124333.3,1530.667,81.33333
"19849","60523","2018",12,12,0,160750,1667.417,99.91667
"19850","60524","2018",46,21,25,122423.9,1775.913,70.47826
"19851","60525","2018",1,1,0,344030,2294,150
"19852","60526","2018",23,22,1,142547,1613.957,88.26087
"19853","60528","2018",1,1,0,212000,1696,125
"19854","60530","2018",5,5,0,188100,2541,74.8
"19855","60533","2018",18,18,0,139820.2,1850.833,78.33333
"19856","60534","2018",11,11,0,187454.5,1832.091,104
"19857","60535","2018",3,3,0,163666.7,1563.333,113.3333
"19858","60536","2018",2,2,0,227500,2408.5,99
"19859","60537","2018",32,32,0,162280.4,1683.969,100.4375
"19860","60538","2018",5,5,0,177392,2215.6,91.4
"19861","60539","2018",16,16,0,181417.5,2018.562,91.4375
"19862","60541","2018",2,2,0,183450,2341,78.5
"19863","60542","2018",8,8,0,181750,1771.875,103
"19864","60544","2018",4,4,0,141500,1685.25,97
"19865","60545","2018",4,4,0,94250,942.75,108.75
"19866","60546","2018",3,3,0,215546.7,2820.333,85.66667
"19867","60547","2018",13,13,0,241283.8,2103,114.1538
"19868","60548","2018",7,7,0,274357.1,2318.857,131.5714
"19869","60549","2018",3,3,0,159000,1785.667,94
"19870","60550","2018",1,1,0,85000,720,118
"19871","60552","2018",3,3,0,180000,2267,79.33333
"19872","60554","2018",9,9,0,156833.3,1772,92.22222
"19873","60555","2018",1,1,0,50000,463,108
"19874","60556","2018",2,2,0,55000,620.5,89
"19875","60557","2018",4,4,0,156750,1617.5,99.75
"19876","60558","2018",4,4,0,144000,2013,75.25
"19877","60559","2018",9,9,0,167822.2,1816,117.1111
"19878","60560","2018",12,12,0,357499.2,2564.667,148.5833
"19879","60561","2018",1,0,1,7e+05,8750,80
"19880","60562","2018",15,12,3,213666.7,2343.933,89.66667
"19881","60563","2018",10,10,0,198725.4,2108.2,96
"19882","60564","2018",2,2,0,113000,1335.5,86.5
"19883","60565","2018",4,4,0,117322.8,1332.5,88.25
"19884","60566","2018",2,2,0,149000,1418,105
"19885","60567","2018",11,11,0,139336.4,1517.909,97.18182
"19886","60568","2018",4,4,0,114900,1654,75.25
"19887","60569","2018",3,3,0,189333.3,1949,98
"19888","60570","2018",24,22,2,206865.9,2093.792,106.3333
"19889","60571","2018",1,1,0,190000,1520,125
"19890","60572","2018",6,6,0,138766.7,1652.667,86.33333
"19891","60573","2018",5,5,0,124478.4,1373.8,89.8
"19892","60574","2018",11,11,0,202782.2,1917.545,107.2727
"19893","60575","2018",54,50,4,204293.3,2135.574,101.5556
"19894","60576","2018",4,4,0,213100,1861.5,116
"19895","60577","2018",22,22,0,118001.4,1524.818,81.04545
"19896","60578","2018",12,12,0,204750,2088.083,100.6667
"19897","60579","2018",7,4,3,254608.1,2013.429,142.4286
"19898","60581","2018",60,44,16,115131.1,1613.183,73.38333
"19899","60582","2018",11,11,0,160200,1911,83.36364
"19900","60583","2018",2,2,0,221000,1804.5,121.5
"19901","60584","2018",44,40,4,228429.1,2470.955,95.77273
"19902","60585","2018",4,4,0,114372.5,1773.5,75
"19903","60586","2018",8,7,1,145875,1382.75,105.875
"19904","60587","2018",13,12,1,170746.2,1918.385,90.92308
"19905","60588","2018",1,1,0,160000,920,174
"19906","60589","2018",25,19,6,228162.8,2724.08,87.28
"19907","60590","2018",3,3,0,142666.7,1901.667,82
"19908","60591","2018",14,14,0,213728.6,1968.5,116.5714
"19909","60592","2018",5,5,0,179000,1745.8,101.6
"19910","60593","2018",2,2,0,121000,1574,73.5
"19911","60594","2018",4,4,0,143500,1590.25,103.5
"19912","60595","2018",5,5,0,101900,1410.6,75.6
"19913","60596","2018",7,7,0,104342.9,1168.143,93.28571
"19914","60597","2018",26,26,0,191262.6,2013.308,94.30769
"19915","60598","2018",15,15,0,210565.3,2171.533,103
"19916","60600","2018",8,8,0,252968.8,2083.875,121.25
"19917","60601","2018",11,11,0,164545.5,2002.636,88.27273
"19918","60603","2018",12,12,0,177266.7,1542.083,121.1667
"19919","60604","2018",1,1,0,111000,1442,77
"19920","60608","2018",1,1,0,118000,1388,85
"19921","60609","2018",10,10,0,165066,1708.2,100.9
"19922","60610","2018",5,5,0,81500,1305,56
"19923","60611","2018",4,4,0,124000,1624,70.5
"19924","60612","2018",213,93,120,291876.7,3175.455,93.10798
"19925","60613","2018",10,10,0,207570,1991.1,111.7
"19926","60614","2018",2,2,0,205500,2227,95.5
"19927","60615","2018",2,2,0,160725,1681.5,98
"19928","60616","2018",32,31,1,153539.6,1553.969,104.875
"19929","60617","2018",3,3,0,122666.7,1337.667,91.66667
"19930","60618","2018",5,5,0,179313.4,1540.6,112.2
"19931","60619","2018",13,13,0,278915.4,2832.846,103.1538
"19932","60620","2018",4,4,0,251625,2911.5,102.75
"19933","60621","2018",1,1,0,98500,912,108
"19934","60622","2018",5,5,0,155607.2,1235.2,132.6
"19935","60623","2018",16,14,2,109281.2,1451.625,80.3125
"19936","60624","2018",2,2,0,112500,1410.5,79
"19937","60625","2018",4,4,0,151050,1545.75,99.75
"19938","60626","2018",9,9,0,157219.8,1844.889,96
"19939","60627","2018",4,4,0,157250,1200,124.75
"19940","60628","2018",13,13,0,148517.8,1945.538,80.61538
"19941","60629","2018",1,1,0,50000,847,59
"19942","60630","2018",5,5,0,370440,1810.6,210.8
"19943","60631","2018",11,10,1,266163.1,3022.727,92.09091
"19944","60632","2018",6,6,0,112500,1550.667,74.33333
"19945","60633","2018",8,8,0,154375,1430.125,110.375
"19946","60634","2018",4,4,0,142000,1099.5,128.75
"19947","60635","2018",14,12,2,182942.9,2207.286,85.92857
"19948","60636","2018",44,37,7,150940.3,1874.523,84.22727
"19949","60637","2018",4,4,0,173000,1722.5,102
"19950","60638","2018",11,11,0,185218.2,1981,97.27273
"19951","60639","2018",10,10,0,172570,2085.8,86.5
"19952","60640","2018",3,3,0,179633.3,3865.667,46.66667
"19953","60641","2018",17,15,2,136576.5,1438.824,97.11765
"19954","60642","2018",9,9,0,210222.2,1831.333,119.7778
"19955","60643","2018",12,12,0,138250,1795.5,81.5
"19956","60644","2018",31,30,1,202657.8,2240.194,97.3871
"19957","60645","2018",4,4,0,166250,1667.25,101.75
"19958","60646","2018",16,15,1,151812.5,1705.188,92.8125
"19959","60647","2018",21,19,2,164571.4,1714.524,94.33333
"19960","60650","2018",11,11,0,283536.4,2090.273,137.0909
"19961","60651","2018",23,23,0,180040.4,1895.913,97.95652
"19962","60652","2018",15,11,4,149606.7,1872.667,79.33333
"19963","60653","2018",3,3,0,168333.3,1643,103.3333
"19964","60654","2018",2,2,0,177275,2468,72.5
"19965","60655","2018",8,8,0,105500,1131,97.875
"19966","60656","2018",7,7,0,200642.9,2134.286,105
"19967","60657","2018",4,4,0,125487.5,1429.5,99.25
"19968","60658","2018",13,13,0,196846.2,2048.077,98.38462
"19969","60659","2018",6,6,0,285833.3,2108.5,134.3333
"19970","60660","2018",4,4,0,214169.8,2247.25,114.25
"19971","60661","2018",21,15,6,133948.7,1807.19,74.85714
"19972","60662","2018",10,10,0,139927.5,1563.2,91.8
"19973","60663","2018",5,5,0,200614,2074,102.6
"19974","60664","2018",4,4,0,143750,1637,87.25
"19975","60665","2018",38,28,10,164476.6,2165.605,80.76316
"19976","60666","2018",17,17,0,309387.9,2854.824,125.5294
"19977","60667","2018",63,44,19,173592.9,2127.19,87.01587
"19978","60669","2018",11,8,3,222090.9,2091.273,112.4545
"19979","60670","2018",75,63,12,200200.1,2347,89.56
"19980","60671","2018",2,2,0,173750,2247,76
"19981","60672","2018",3,3,0,117916.7,1526.333,83.33333
"19982","60673","2018",3,3,0,84916.67,1469.667,63
"19983","60674","2018",9,9,0,239238.9,2087.778,118.8889
"19984","60675","2018",4,4,0,171700,1760.5,99.5
"19985","60676","2018",11,11,0,149763.6,1573.909,103
"19986","60677","2018",4,4,0,153000,2155.75,80.5
"19987","60678","2018",21,20,1,211788.1,2258.952,101.619
"19988","60679","2018",4,4,0,203500,1838.5,108.25
"19989","60681","2018",4,4,0,210500,1679.5,147
"19990","60682","2018",8,5,3,362652.5,3252.25,107.625
"19991","60683","2018",6,6,0,221666.7,2083,111.8333
"19992","60684","2018",49,40,9,163488.4,2069.061,81.69388
"19993","60685","2018",14,14,0,177742.9,1938.571,99.71429
"19994","60686","2018",21,20,1,222459,2673.333,88.33333
"19995","60687","2018",2,2,0,180000,1645,117.5
"19996","60689","2018",22,21,1,261663.6,1903.045,137.5
"19997","60691","2018",5,5,0,118400,1334.4,88.2
"19998","60692","2018",4,4,0,103375,939.75,101.75
"19999","60693","2018",3,3,0,131333.3,1188,112
"20000","60695","2018",19,13,6,336294.7,3523,99.26316
"20001","60697","2018",1,1,0,170000,1417,120
"20002","60698","2018",5,5,0,177000,1782,100.6
"20003","60699","2018",1,1,0,155000,1938,80
"20004","60700","2018",10,10,0,174650,1844.2,93
"20005","60701","2018",9,9,0,154444.4,1461.667,110.5556
"20006","60702","2018",2,2,0,115000,959,125.5
"20007","60703","2018",6,6,0,189284.7,1993.333,99.66667
"20008","61001","2018",276,166,110,99731,1206.145,82.78261
"20009","61002","2018",14,14,0,128162.9,1235.143,99.92857
"20010","61006","2018",114,88,26,111392.8,1374.184,82.83333
"20011","61007","2018",58,56,2,93637.09,1168.724,88.63793
"20012","61008","2018",15,15,0,103350.5,1224.333,87
"20013","61010","2018",1,1,0,195000,1696,115
"20014","61011","2018",1,1,0,225000,750,300
"20015","61012","2018",3,3,0,110000,1306.667,82.66667
"20016","61014","2018",2,2,0,122500,1398,91
"20017","61015","2018",4,4,0,143625,1275.75,102
"20018","61018","2018",1,1,0,110000,1341,82
"20019","61020","2018",4,4,0,114000,962.75,114.75
"20020","61021","2018",5,5,0,80100,884.6,84.8
"20021","61023","2018",5,5,0,130104,1110.4,113.2
"20022","61024","2018",6,6,0,90666.67,993.6667,91.83333
"20023","61026","2018",6,6,0,82083.33,1253.833,73.66667
"20024","61028","2018",4,4,0,121412.5,1352.5,85.75
"20025","61029","2018",7,7,0,139557.1,1136.714,121.5714
"20026","61030","2018",1,1,0,248000,1734,143
"20027","61032","2018",3,3,0,69000,1065,65
"20028","61034","2018",2,2,0,52500,644,75.5
"20029","61035","2018",2,2,0,105000,1335.5,77.5
"20030","61036","2018",2,2,0,102500,668,153
"20031","61037","2018",4,4,0,292750,2353.25,96.25
"20032","61038","2018",19,17,2,117589.5,1042.579,105.1579
"20033","61039","2018",4,4,0,90575,892.5,100.75
"20034","61040","2018",7,7,0,52412.86,713.4286,80
"20035","61041","2018",4,4,0,238250,1837.75,135.5
"20036","61043","2018",12,12,0,139717.2,1318.917,105.1667
"20037","61044","2018",6,6,0,141950,1007.333,124.5
"20038","61046","2018",2,2,0,83150,657,123.5
"20039","61048","2018",2,2,0,176500,1664,108
"20040","61049","2018",2,2,0,117500,978.5,115
"20041","61050","2018",20,20,0,147647.9,1274.25,119.2
"20042","61051","2018",1,1,0,123750,1904,65
"20043","61053","2018",4,4,0,132500,1401.75,91.75
"20044","61054","2018",5,5,0,79412.4,1165,72.4
"20045","61055","2018",9,9,0,65266.67,721.5556,88.77778
"20046","61056","2018",2,2,0,135725,1584.5,85.5
"20047","61060","2018",3,3,0,70666.67,1274.667,63
"20048","61061","2018",28,28,0,101840.5,1145.25,90.39286
"20049","61063","2018",11,11,0,62875,729,85
"20050","61064","2018",3,3,0,136000,1944.333,95
"20051","61066","2018",1,1,0,67500,614,110
"20052","61067","2018",3,3,0,121333.3,2206,60
"20053","61069","2018",6,6,0,79300,777,102.5
"20054","61070","2018",5,5,0,98000,956.8,103.8
"20055","61071","2018",4,4,0,217579.5,1620.75,139.75
"20056","61072","2018",3,3,0,106666.7,1035.333,93.66667
"20057","61074","2018",10,10,0,68959,718.1,90.7
"20058","61075","2018",11,11,0,62832.73,776.8182,80.36364
"20059","61076","2018",1,1,0,87000,888,98
"20060","61077","2018",7,7,0,154571.4,1320.429,118.7143
"20061","61078","2018",6,6,0,135166.7,1310,107.3333
"20062","61079","2018",21,21,0,122888.7,1259.571,94.80952
"20063","61080","2018",2,2,0,65250,775,102.5
"20064","61081","2018",8,8,0,105312.5,1048.5,95.875
"20065","61082","2018",4,4,0,76750,1374.25,56
"20066","61084","2018",2,2,0,111600,1076,147
"20067","61086","2018",1,1,0,120000,1101,109
"20068","61087","2018",3,3,0,166510,2245,90
"20069","61089","2018",1,1,0,38000,447,85
"20070","61091","2018",15,15,0,89318.33,1009.067,99.53333
"20071","61092","2018",8,8,0,88776.75,1422.75,64.5
"20072","61093","2018",8,8,0,38563.12,744.5,54.5
"20073","61094","2018",6,6,0,145483.3,1080.833,131.8333
"20074","61095","2018",4,4,0,84000,939,80.5
"20075","61096","2018",25,25,0,65964,873.28,80.16
"20076","61097","2018",5,5,0,175470,1120,140.8
"20077","61098","2018",2,2,0,90000,951,94
"20078","61099","2018",7,7,0,131457.1,1126.857,99.85714
"20079","61100","2018",2,2,0,198962.5,1966,119
"20080","61101","2018",2,2,0,31250,891.5,46.5
"20081","61102","2018",2,2,0,33500,631.5,56
"20082","61103","2018",3,3,0,60000,654,87
"20083","61105","2018",1,1,0,258450,4169,62
"20084","61107","2018",4,4,0,142750,1632.75,86
"20085","61108","2018",3,3,0,98000,952.6667,102.6667
"20086","61111","2018",1,1,0,224000,2462,91
"20087","61113","2018",1,1,0,170000,1545,110
"20088","61114","2018",4,4,0,148750,1267,111.25
"20089","61116","2018",18,17,1,105142.2,1110.667,93.88889
"20090","61117","2018",24,24,0,142712,1469.333,95.04167
"20091","61118","2018",2,2,0,149750,1515,95
"20092","61120","2018",1,1,0,162500,1321,123
"20093","61121","2018",5,5,0,123000,1493.2,80.8
"20094","61123","2018",1,1,0,170900,1675,102
"20095","61124","2018",6,6,0,81133.33,922.3333,87
"20096","61126","2018",2,2,0,122900,1329.5,91.5
"20097","61129","2018",8,8,0,150025,1138.25,130.5
"20098","61130","2018",6,6,0,197816.7,1456.5,134.5
"20099","61133","2018",15,13,2,111541,1233,95.6
"20100","61137","2018",1,1,0,79450,771,103
"20101","61138","2018",2,2,0,121650,1452,97.5
"20102","61139","2018",4,4,0,184000,1412.25,126
"20103","61140","2018",10,10,0,126610,1303,92.9
"20104","61141","2018",3,3,0,177206.7,1507.333,115.6667
"20105","61142","2018",3,3,0,103333.3,1038,94.66667
"20106","61143","2018",28,24,4,102462.9,1419.857,73.75
"20107","61145","2018",36,33,3,84093.75,921.4722,86.36111
"20108","61146","2018",3,3,0,74500,935.3333,88
"20109","61148","2018",3,3,0,81500,934.3333,88
"20110","61149","2018",3,3,0,87333.33,1050.333,77
"20111","61150","2018",6,6,0,144383.3,1908.5,74.5
"20112","61151","2018",3,3,0,95000,1150.333,75.66667
"20113","61152","2018",1,1,0,230000,1533,150
"20114","61153","2018",21,20,1,130257.1,1346.714,93.80952
"20115","61156","2018",8,8,0,92062.5,1189.375,76.75
"20116","61158","2018",2,2,0,102750,1397,90.5
"20117","61160","2018",5,5,0,187700,1898.8,93.6
"20118","61163","2018",14,14,0,66328.57,854.7143,75.71429
"20119","61165","2018",5,5,0,168982,1500,111.4
"20120","61166","2018",6,6,0,75550,1032,73.16667
"20121","61167","2018",29,29,0,113403.3,1201.276,97.2069
"20122","61168","2018",53,49,4,90792.64,1006.377,91.9434
"20123","61169","2018",9,9,0,102294.4,1283,83.22222
"20124","61171","2018",2,2,0,145000,1169,122
"20125","61178","2018",2,2,0,131250,1377.5,96.5
"20126","61180","2018",2,2,0,67000,1432.5,46.5
"20127","61181","2018",17,16,1,83456.41,957.8824,83.70588
"20128","61182","2018",4,4,0,136750,1214.5,112.75
"20129","61183","2018",1,1,0,90000,643,140
"20130","61187","2018",2,2,0,88500,1331,66
"20131","61188","2018",2,2,0,307000,2411.5,117
"20132","61189","2018",6,6,0,119416.7,1116,111.8333
"20133","61192","2018",1,1,0,216500,1665,130
"20134","61193","2018",3,3,0,105000,1440.667,78
"20135","61194","2018",10,10,0,133410,1243.8,112.6
"20136","61195","2018",3,3,0,66933.33,965,64.66667
"20137","61196","2018",26,26,0,124759,1178.615,106.4231
"20138","61197","2018",2,2,0,156000,1093,142.5
"20139","61198","2018",2,2,0,169386.5,2159,79.5
"20140","61199","2018",4,4,0,183000,1169,153.5
"20141","61202","2018",2,2,0,212700,1510,140.5
"20142","61203","2018",12,12,0,151180.8,1226,125.9167
"20143","61206","2018",7,7,0,102428.6,1176,91
"20144","61207","2018",12,12,0,125404.2,1266.917,97.33333
"20145","61208","2018",7,7,0,92571.43,1172.714,77.42857
"20146","61209","2018",6,6,0,71300,1093.833,65.83333
"20147","61210","2018",1,1,0,37000,804,46
"20148","61211","2018",19,19,0,96895.05,961.6316,100.3684
"20149","61213","2018",4,4,0,79500,1289.25,60.5
"20150","61214","2018",67,59,8,104419.3,1320.06,83
"20151","61215","2018",4,4,0,73916.75,1141.5,70.75
"20152","61216","2018",3,3,0,44833.33,537,85
"20153","61217","2018",1,1,0,78000,975,80
"20154","61218","2018",21,21,0,96880.95,1163.714,83.2381
"20155","61219","2018",2,2,0,61000,1005.5,60.5
"20156","61221","2018",2,2,0,64000,598.5,98.5
"20157","61222","2018",8,8,0,120187.5,1121.625,113.875
"20158","61224","2018",4,4,0,149512.5,1412.5,106.5
"20159","61225","2018",1,1,0,160000,1468,109
"20160","61227","2018",1,1,0,99000,1042,95
"20161","61228","2018",10,10,0,101800,981.6,100.8
"20162","61229","2018",2,2,0,166500,1606.5,102
"20163","61230","2018",52,51,1,111065.2,1315.404,89.67308
"20164","61232","2018",13,13,0,95820,1142.923,94.15385
"20165","61233","2018",4,4,0,52500,822,64
"20166","61234","2018",11,11,0,165418.2,1478.818,111.0909
"20167","61237","2018",3,3,0,88333.33,827,115
"20168","61238","2018",3,3,0,40666.67,858.3333,46
"20169","61240","2018",7,7,0,86071.43,1174.429,74.28571
"20170","61241","2018",13,13,0,122923.1,1319.462,94.76923
"20171","61242","2018",5,5,0,189280,2084.8,93.8
"20172","61243","2018",16,16,0,136717.2,1295.938,109
"20173","61244","2018",4,4,0,113387,1775.25,75.75
"20174","61248","2018",9,9,0,64666.67,739.7778,84.55556
"20175","61251","2018",3,3,0,153333.3,1267.333,116.6667
"20176","61252","2018",5,5,0,105700,1270.6,88
"20177","61255","2018",11,11,0,166844,1746.091,101.8182
"20178","61256","2018",2,2,0,1e+05,894,111.5
"20179","61257","2018",3,3,0,56666.67,631,86.66667
"20180","61258","2018",11,11,0,84810.09,980.2727,93.90909
"20181","61260","2018",7,7,0,106662.9,963.8571,111.2857
"20182","61261","2018",4,4,0,139200,1309.75,115
"20183","61262","2018",3,3,0,116999.7,1327.667,87
"20184","61263","2018",3,3,0,310622.3,2235.667,136.6667
"20185","61265","2018",4,4,0,73500,833.25,102
"20186","61266","2018",1,1,0,150000,987,152
"20187","61267","2018",5,5,0,102740,1268.4,91.4
"20188","61268","2018",2,2,0,58000,896,64.5
"20189","61269","2018",8,8,0,89610,1071.375,84
"20190","61271","2018",2,2,0,106500,1634,66.5
"20191","61273","2018",3,3,0,109666.7,917,116.3333
"20192","61274","2018",4,4,0,122500,1297.5,98.75
"20193","61275","2018",12,12,0,81875,960.25,88.66667
"20194","61276","2018",1,1,0,185000,1850,100
"20195","61277","2018",3,3,0,148333.3,946,166.3333
"20196","61278","2018",15,15,0,99188.6,1089.867,96
"20197","61279","2018",2,2,0,188750,1680.5,115
"20198","61281","2018",4,4,0,135862.5,802.75,169.75
"20199","61283","2018",2,2,0,127500,1221.5,106
"20200","61284","2018",3,3,0,157666.7,1150,119
"20201","61286","2018",4,4,0,180250,1223,140.25
"20202","61287","2018",4,4,0,81625,789.5,96.25
"20203","61288","2018",6,6,0,135333.3,1503.833,92
"20204","61289","2018",2,2,0,108050,1217,88
"20205","61291","2018",1,1,0,50000,385,130
"20206","61292","2018",13,13,0,113111.5,1548.923,78.76923
"20207","61293","2018",36,32,4,105525,1202.778,85.19444
"20208","61294","2018",12,12,0,128666.7,1070.333,123.3333
"20209","61295","2018",1,1,0,157300,1258,125
"20210","61297","2018",4,4,0,55500,924.25,54.75
"20211","61298","2018",1,1,0,87450,595,147
"20212","61300","2018",13,13,0,196190.5,1879.846,107.6154
"20213","61302","2018",1,1,0,68000,932,73
"20214","61303","2018",10,10,0,116597.5,1181.2,99.4
"20215","61304","2018",6,6,0,111466.7,1125.833,98.33333
"20216","61307","2018",4,4,0,82250,1063,76.75
"20217","61308","2018",3,3,0,90000,782.6667,102.6667
"20218","61309","2018",30,30,0,131903.3,1378.067,98.7
"20219","61310","2018",6,6,0,136725,1561.167,95.66667
"20220","61314","2018",5,5,0,110960,1070.6,100
"20221","61317","2018",2,2,0,43500,1041.5,48
"20222","61319","2018",4,4,0,117990,1128,106.75
"20223","61321","2018",1,1,0,185000,1423,130
"20224","61322","2018",4,4,0,188329.8,1681.25,109
"20225","61323","2018",2,2,0,102750,1629,77.5
"20226","61324","2018",18,18,0,87605.56,967.1667,94.72222
"20227","61326","2018",2,2,0,84250,915.5,92.5
"20228","61327","2018",4,4,0,128375,2680,51.75
"20229","61328","2018",1,1,0,131500,1241,106
"20230","61329","2018",7,7,0,110606.3,1122.429,108.1429
"20231","61330","2018",3,3,0,55833.33,550,105
"20232","61331","2018",3,3,0,113133.3,1361.667,99.66667
"20233","61332","2018",3,3,0,72833.33,1224.667,62
"20234","61333","2018",5,5,0,71100,890.6,76.8
"20235","61336","2018",1,1,0,75000,1389,54
"20236","61339","2018",26,26,0,100244.2,1129.615,89.5
"20237","61341","2018",12,12,0,193339.2,1658.5,111.4167
"20238","61342","2018",14,14,0,100683,1317.143,83.78571
"20239","61344","2018",13,13,0,87761.54,836.8462,111.4615
"20240","61345","2018",32,31,1,162138.4,1621.844,98.34375
"20241","61346","2018",11,11,0,136508.6,1378.273,98.54545
"20242","61348","2018",4,4,0,142500,1424.25,93.75
"20243","61349","2018",2,2,0,102500,604.5,173.5
"20244","61351","2018",2,2,0,111500,1234.5,90.5
"20245","61352","2018",1,1,0,95000,990,96
"20246","61357","2018",3,3,0,141494.3,938,144.3333
"20247","61358","2018",1,1,0,157500,870,181
"20248","61360","2018",2,2,0,124260,1976,66
"20249","61361","2018",2,2,0,123000,1122.5,115
"20250","61362","2018",4,4,0,105575,1013.75,98.25
"20251","61363","2018",4,4,0,116375,1149.75,99.5
"20252","61365","2018",6,6,0,140300,1095.333,130.3333
"20253","61366","2018",2,2,0,109500,1051,109
"20254","61369","2018",14,14,0,102808.6,1302.786,84
"20255","61370","2018",2,2,0,93500,1194,83
"20256","61371","2018",3,3,0,116666.7,1317.667,90.33333
"20257","61372","2018",3,3,0,149166.7,1447,94.66667
"20258","61373","2018",5,5,0,102354,993.6,114
"20259","61374","2018",2,2,0,74550,954.5,77.5
"20260","61375","2018",11,11,0,113000,1111.455,103
"20261","61376","2018",10,10,0,77825,930,80.3
"20262","61379","2018",6,6,0,170416.7,2133.333,97.33333
"20263","61381","2018",1,1,0,60000,870,69
"20264","61382","2018",17,17,0,129870.3,1275.882,98.82353
"20265","61384","2018",4,4,0,43250,858.75,59
"20266","61385","2018",3,3,0,89000,1053.667,81.66667
"20267","61386","2018",7,7,0,106857.1,1555.571,79.14286
"20268","61387","2018",12,12,0,73613.75,804.9167,92.66667
"20269","61388","2018",7,7,0,90571.43,972.1429,87
"20270","61389","2018",15,15,0,83000.07,1059.933,80.4
"20271","61390","2018",2,2,0,53500,594,102
"20272","61391","2018",52,46,6,120367.1,1211.481,94.90385
"20273","61392","2018",1,1,0,65000,1016,64
"20274","61393","2018",4,4,0,365659.2,3264,84.75
"20275","61394","2018",13,13,0,138892.3,1225.308,89.30769
"20276","61395","2018",7,7,0,118385.7,1323.143,96.14286
"20277","61397","2018",33,32,1,125544.8,1439.182,89.0303
"20278","61400","2018",2,2,0,126500,1650,75
"20279","61402","2018",3,3,0,83333.33,837.3333,98.66667
"20280","61404","2018",3,3,0,96700,1241,78.66667
"20281","61405","2018",7,7,0,111812.9,1520.571,76.42857
"20282","61406","2018",3,3,0,83850,880.3333,96
"20283","61407","2018",7,7,0,90332.86,1206.143,76.42857
"20284","61408","2018",3,3,0,92333.33,1530.333,67.66667
"20285","61411","2018",5,5,0,147400,1261,120.2
"20286","61412","2018",8,8,0,128750,1057.75,123.75
"20287","61414","2018",11,11,0,122893.6,1201.909,100.5455
"20288","61415","2018",3,3,0,103333.3,1606.333,70
"20289","61416","2018",2,2,0,35275,555,69.5
"20290","61418","2018",8,8,0,152350,1224.375,123.625
"20291","61419","2018",3,3,0,103833.3,1017,99
"20292","61420","2018",1,1,0,118000,1168,101
"20293","61421","2018",15,15,0,74024.6,729.2667,97.93333
"20294","61422","2018",6,6,0,108000,944.6667,111.8333
"20295","61423","2018",7,7,0,145231.7,2396.286,80.42857
"20296","61425","2018",2,2,0,222500,1735.5,125
"20297","61426","2018",6,6,0,137557.5,1311.667,104.6667
"20298","61427","2018",2,2,0,104775,927.5,94.5
"20299","61429","2018",16,16,0,139306.6,1774.875,93.5
"20300","61432","2018",7,7,0,131055.7,1257.429,109.5714
"20301","61433","2018",3,3,0,118333.3,1322.333,89.66667
"20302","61435","2018",5,5,0,143200,1588.6,97.2
"20303","61436","2018",3,3,0,77466.67,895.3333,74
"20304","61438","2018",3,3,0,112000,1207.667,97
"20305","61440","2018",9,9,0,128111.1,1416.222,98.22222
"20306","61442","2018",4,4,0,123375,1225.25,100.75
"20307","61443","2018",8,8,0,94412.5,1035.125,90.75
"20308","61444","2018",2,2,0,114400,1210,95
"20309","61445","2018",4,4,0,95875,834.5,111
"20310","61446","2018",1,1,0,120000,2400,50
"20311","61447","2018",18,17,1,84187.22,937.3333,87.33333
"20312","61448","2018",8,8,0,138712.5,1403.875,98.875
"20313","61450","2018",2,2,0,237500,2156.5,133
"20314","61451","2018",3,3,0,80666.67,1067,78.33333
"20315","61453","2018",1,1,0,240000,1250,192
"20316","61454","2018",11,11,0,110140.9,981.0909,115.1818
"20317","61456","2018",16,16,0,141593.8,1271.438,119.6875
"20318","61457","2018",4,4,0,113086.8,1649.75,61.25
"20319","61459","2018",4,4,0,85375,1187,65
"20320","61460","2018",12,11,1,66516.67,897.1667,73
"20321","61461","2018",1,1,0,82500,1019,81
"20322","61462","2018",12,12,0,141487.5,1472.5,95.5
"20323","61463","2018",14,14,0,125649.3,1305.786,96.71429
"20324","61464","2018",40,40,0,110500,1115.9,100.95
"20325","61466","2018",15,15,0,115943.3,1209.2,96.86667
"20326","61467","2018",2,2,0,147500,1248.5,123
"20327","61472","2018",5,5,0,197040,1343.2,144.2
"20328","61473","2018",4,4,0,117125,1322.5,90
"20329","61474","2018",60,59,1,118673.4,1125.333,97.55
"20330","61475","2018",9,9,0,92111.11,1506.778,69.22222
"20331","61476","2018",2,2,0,119900,2166,65
"20332","61481","2018",2,2,0,251000,1492,145
"20333","61482","2018",3,3,0,216666.7,1134.667,187.6667
"20334","61483","2018",104,44,60,88200.9,1535.231,65.75962
"20335","61484","2018",46,46,0,115910.3,1213.326,93.43478
"20336","61485","2018",6,6,0,147566.7,1381.5,101.5
"20337","61486","2018",57,57,0,88964.23,917.1228,101.3684
"20338","61487","2018",3,3,0,87133.33,937.3333,91.33333
"20339","61488","2018",1,1,0,150000,1154,130
"20340","61490","2018",4,4,0,96000,906,104
"20341","61491","2018",35,35,0,123065.3,1154.657,104.2571
"20342","61494","2018",11,11,0,100109.1,961.3636,98.45455
"20343","61497","2018",18,18,0,174841.8,1561.333,113.9444
"20344","61498","2018",1,1,0,87000,1279,68
"20345","61499","2018",1,1,0,52000,1268,41
"20346","61500","2018",1,1,0,180000,1385,130
"20347","61501","2018",5,5,0,149020,1459.6,89
"20348","61502","2018",4,4,0,115750,1126.75,102.25
"20349","61503","2018",2,2,0,41500,657,63.5
"20350","61505","2018",2,2,0,142900,1573.5,92.5
"20351","61507","2018",2,2,0,117500,897,158
"20352","61508","2018",40,34,6,90350.15,1029.05,86.1
"20353","61510","2018",2,2,0,184000,2820.5,91
"20354","62001","2018",6,6,0,170141.7,1527.333,112.8333
"20355","62002","2018",2,2,0,135500,1488.5,90.5
"20356","62003","2018",8,7,1,201977.5,1668,114
"20357","62004","2018",89,84,5,136526.9,1507.045,90.91011
"20358","62005","2018",8,8,0,130250,1518.75,90.5
"20359","62006","2018",6,6,0,163333.3,1372.167,120.1667
"20360","62007","2018",8,8,0,235253.1,1871.625,129.875
"20361","62008","2018",2,2,0,201000,1634,123
"20362","62009","2018",1,1,0,190000,1418,134
"20363","62010","2018",2,2,0,165025,1607,102
"20364","62011","2018",5,5,0,263884,2069.2,129
"20365","62012","2018",3,3,0,157116.7,1917.667,85.33333
"20366","62013","2018",21,21,0,175604.8,1651.571,103.0476
"20367","62014","2018",91,87,4,127628.7,1291.648,100.2527
"20368","62015","2018",4,4,0,123475,1093.25,117
"20369","62016","2018",2,2,0,247500,2552.5,92.5
"20370","62017","2018",2,2,0,109000,1041.5,104
"20371","62018","2018",5,5,0,112800,1186.2,93
"20372","62019","2018",28,28,0,158790.4,1706.321,100.3929
"20373","62020","2018",9,9,0,161000,1673.222,98.88889
"20374","62021","2018",7,7,0,157000,1743.714,168.1429
"20375","62022","2018",1,1,0,115000,1456,79
"20376","62023","2018",38,38,0,111463.2,1248.079,91.97368
"20377","62024","2018",3,3,0,65000,958.3333,80.66667
"20378","62025","2018",48,39,9,199149.9,2628.521,84.9375
"20379","62026","2018",1,1,0,180000,1353,133
"20380","62028","2018",5,5,0,97900,1100.8,85.8
"20381","62029","2018",2,2,0,72000,870.5,88.5
"20382","62030","2018",4,4,0,76250,763.5,101.25
"20383","62031","2018",20,20,0,150697.5,1569.3,96.1
"20384","62032","2018",33,33,0,161521.5,1676.667,94.27273
"20385","62033","2018",45,45,0,147401.5,1611.956,92.66667
"20386","62034","2018",17,17,0,157717.6,1603.353,97.05882
"20387","62035","2018",57,57,0,130334.7,1375.175,93.70175
"20388","62036","2018",4,4,0,80525,670,130.75
"20389","62037","2018",42,39,3,221138.1,2137.071,104.5714
"20390","62038","2018",30,30,0,167687.7,1823.433,97.86667
"20391","62039","2018",8,8,0,181043.8,1926.125,94.125
"20392","62040","2018",104,101,3,130539,1479.462,90.17308
"20393","62041","2018",518,257,261,141981.5,1822.797,80.11776
"20394","62042","2018",9,9,0,124194.4,1362.667,88
"20395","62043","2018",20,20,0,175285,1521.5,118.9
"20396","62044","2018",5,5,0,120250.4,1511.2,90
"20397","62045","2018",11,10,1,159976.5,1638.273,101.9091
"20398","62046","2018",8,8,0,89125,927.75,96.25
"20399","62047","2018",2,2,0,136500,1232,111
"20400","62048","2018",81,77,4,97537.04,993.4938,101.3457
"20401","62049","2018",6,6,0,181806.2,1416.167,126
"20402","62050","2018",11,11,0,107965.9,1056.545,99.90909
"20403","62051","2018",45,45,0,152821.1,1755.667,91.37778
"20404","62052","2018",7,7,0,212044.3,1982.429,110.5714
"20405","62053","2018",6,6,0,108166.7,1197.667,94.5
"20406","62054","2018",17,16,1,263534.6,2964.824,94.88235
"20407","62055","2018",3,3,0,223123,2096,108.6667
"20408","62056","2018",16,15,1,263562.5,2785.5,93.5625
"20409","62057","2018",42,42,0,147222.4,1496.476,105.0238
"20410","62059","2018",3,3,0,196733.3,1721.667,112.3333
"20411","62060","2018",25,25,0,110100,1094.6,99.56
"20412","62061","2018",5,5,0,125560,1450,87.2
"20413","62062","2018",2,2,0,194600,1587,127.5
"20414","62063","2018",20,19,1,105698.2,1304.85,82.55
"20415","62064","2018",1,1,0,53000,981,54
"20416","62065","2018",118,111,7,122569.6,1366.254,90.32203
"20417","62067","2018",3,3,0,180666.7,1693,107
"20418","62068","2018",2,2,0,129000,903,132.5
"20419","62069","2018",3,3,0,126966.7,1345.333,94
"20420","62070","2018",3,3,0,100275.7,907,109.3333
"20421","62071","2018",7,7,0,158705.7,1378.714,116.4286
"20422","62072","2018",2,2,0,165376,1236,129.5
"20423","62073","2018",20,20,0,160592.2,1614.95,103.15
"20424","62074","2018",3,3,0,183066.7,1140,158.3333
"20425","62075","2018",17,17,0,232208.5,1918.118,119.9412
"20426","62076","2018",1,1,0,130000,1512,86
"20427","62077","2018",2,2,0,153500,1328.5,115.5
"20428","62078","2018",9,9,0,149794.4,1676.889,91.55556
"20429","62080","2018",28,26,2,91000,1073.107,88.64286
"20430","62081","2018",3,3,0,105000,788,135.6667
"20431","62082","2018",3,3,0,121666.7,927,136
"20432","62083","2018",49,48,1,120132.4,1441.469,85.18367
"20433","62084","2018",5,5,0,121500,1016,132.6
"20434","62085","2018",2,2,0,237100,1647.5,147.5
"20435","62086","2018",3,3,0,123494.7,1331.667,93
"20436","62087","2018",3,3,0,167000,1604.333,121.3333
"20437","62088","2018",4,4,0,111500,1428.5,77
"20438","62089","2018",7,7,0,210428.6,2122.143,108.7143
"20439","62090","2018",2,2,0,216000,1417.5,160.5
"20440","62092","2018",2,2,0,112000,1324,82.5
"20441","62093","2018",4,4,0,92625,1473.5,60.25
"20442","62094","2018",5,5,0,147100,4220,72.4
"20443","62095","2018",3,3,0,160000,1168,134
"20444","62096","2018",4,4,0,133375,1361.5,119
"20445","62097","2018",8,8,0,139519.4,1395.625,97.5
"20446","62099","2018",68,64,4,161557.9,1766.324,92.79412
"20447","62100","2018",26,26,0,115269.2,1404.231,86.26923
"20448","62101","2018",1,1,0,135000,918,147
"20449","62102","2018",3,3,0,136000,1009,151
"20450","62104","2018",6,6,0,224416.7,1763.833,126.6667
"20451","62105","2018",4,4,0,208750,1547.75,131
"20452","62106","2018",2,2,0,217000,1583.5,148.5
"20453","62107","2018",4,4,0,167250,1996.75,85
"20454","62108","2018",361,160,201,115161,2112.039,58.56787
"20455","62109","2018",3,3,0,57550,647,94.33333
"20456","62111","2018",1,1,0,52000,650,80
"20457","62112","2018",4,4,0,147250,1426.5,108.25
"20458","62113","2018",5,5,0,135400,1340.2,104.6
"20459","62114","2018",1,1,0,45000,643,70
"20460","62115","2018",4,4,0,162766.2,1485.5,102
"20461","62116","2018",1,1,0,360000,6429,56
"20462","62117","2018",4,4,0,100500,931,104.75
"20463","62118","2018",1,1,0,274200,1878,146
"20464","62119","2018",326,237,89,126046.1,1415.945,89.49693
"20465","62120","2018",5,5,0,129360,1473.8,93.6
"20466","62121","2018",1,1,0,99000,635,156
"20467","62122","2018",3,3,0,118083.3,1364,108
"20468","62123","2018",12,12,0,192100,1576.083,121.5
"20469","62124","2018",5,5,0,210450,1491.6,136.8
"20470","62125","2018",9,9,0,198666.7,1951.444,102.8889
"20471","62126","2018",116,107,9,125680.4,1465.672,89.5
"20472","62127","2018",1,1,0,215000,1287,167
"20473","62128","2018",45,44,1,143992.5,1491.756,97.73333
"20474","62129","2018",2,2,0,158500,1649.5,100
"20475","62130","2018",15,15,0,149896.7,1364.267,117
"20476","62131","2018",9,9,0,105411.1,978.6667,109.4444
"20477","62132","2018",63,63,0,149464.9,1711.333,90.34921
"20478","62133","2018",68,66,2,118255.8,1343.721,89.94118
"20479","62135","2018",2,2,0,87500,1188,75
"20480","62138","2018",6,6,0,133666.7,1078,124.1667
"20481","62139","2018",53,52,1,126059.5,1244.962,102.4528
"20482","62140","2018",2,2,0,102500,817.5,126
"20483","62141","2018",5,5,0,134020,1435.2,102.2
"20484","62142","2018",6,6,0,119833.3,1061.333,122.6667
"20485","62143","2018",1,1,0,115000,1150,100
"20486","62144","2018",3,3,0,177000,1655,104
"20487","62145","2018",3,3,0,110666.7,1392.333,78.33333
"20488","62146","2018",2,2,0,157750,1412,111
"20489","62147","2018",7,7,0,117014.3,1222.571,97.57143
"20490","62148","2018",8,8,0,146166.2,1492,97.625
"20491","62149","2018",1,1,0,45000,672,67
"20492","62150","2018",4,4,0,92750,867.5,100
"20493","62151","2018",10,10,0,161153.3,1480.9,109.9
"20494","62152","2018",3,3,0,241500,2038,117.3333
"20495","62153","2018",4,4,0,111317.5,1144.75,95.25
"20496","62154","2018",6,6,0,86750,1156.167,89
"20497","62155","2018",10,10,0,160340,1550.7,105.5
"20498","62156","2018",5,5,0,264400,1712.2,152.2
"20499","62157","2018",2,2,0,139500,1400,99.5
"20500","62158","2018",9,9,0,132594.4,1115.778,117.1111
"20501","62160","2018",409,228,181,120091.7,1474.391,86.27384
"20502","62161","2018",6,6,0,130166.7,1336,98.83333
"20503","62162","2018",8,7,1,107375,1121.875,103.25
"20504","62163","2018",2,2,0,86500,926,107
"20505","62164","2018",11,11,0,132004.5,1179.182,110.6364
"20506","62165","2018",4,4,0,134750,1335.5,107.5
"20507","62166","2018",3,3,0,96333.33,935,105
"20508","62167","2018",2,2,0,186500,1327,138.5
"20509","62168","2018",8,8,0,161675,1235.5,128.25
"20510","62170","2018",35,35,0,165907.1,1687.286,100.6571
"20511","62172","2018",6,6,0,186558.3,1589.667,121.6667
"20512","62173","2018",58,58,0,169901.4,1656.397,102.9655
"20513","62174","2018",20,20,0,184905,1728.1,107.55
"20514","62175","2018",2,2,0,174500,1549,108
"20515","62176","2018",4,4,0,210000,1827,126.75
"20516","62177","2018",14,14,0,97921.43,1242.5,77.42857
"20517","62178","2018",165,155,10,111737.2,1167.103,96.04848
"20518","62179","2018",6,6,0,123546,935.8333,130.3333
"20519","62180","2018",2,2,0,85000,1012,76
"20520","62181","2018",24,24,0,115240.7,1115.083,105.6667
"20521","62182","2018",4,4,0,67250,748.75,94.75
"20522","62183","2018",11,11,0,114706.2,1229.818,95.18182
"20523","62184","2018",3,3,0,131500,1368,136.6667
"20524","62185","2018",1,1,0,58000,806,72
"20525","62186","2018",89,83,6,136715.9,1499.506,93.77528
"20526","62188","2018",32,32,0,102651.6,1233.75,82.71875
"20527","62189","2018",1,1,0,50000,575,87
"20528","62190","2018",17,17,0,160117.6,1608.882,102.3529
"20529","62191","2018",4,4,0,164000,1846,90.5
"20530","62192","2018",2,2,0,117750,1488.5,69
"20531","62193","2018",855,664,191,112570.1,1406.86,83.62807
"20532","62194","2018",42,42,0,102270.2,1086.167,95.52381
"20533","62195","2018",21,21,0,183969,1492.238,128.2857
"20534","62196","2018",5,5,0,155830,1415,111.4
"20535","62197","2018",16,16,0,127081.2,1273.938,106
"20536","62198","2018",1,1,0,234000,1603,146
"20537","62199","2018",8,8,0,147000,1480.75,98.5
"20538","62200","2018",13,13,0,138850.7,1486.692,92.23077
"20539","62201","2018",125,68,57,128708.8,2415.36,55.512
"20540","62202","2018",6,6,0,118096.7,1149.5,106.6667
"20541","62203","2018",7,7,0,199492.9,1610.429,130.2857
"20542","62205","2018",14,14,0,245717.1,1955.429,126.0714
"20543","62207","2018",4,4,0,199765,1679,118
"20544","62208","2018",1,1,0,160000,1159,138
"20545","62209","2018",1,1,0,118000,855,138
"20546","62211","2018",3,3,0,280666.7,2184.333,132.6667
"20547","62212","2018",3,3,0,106610,923.6667,117
"20548","62213","2018",10,10,0,217350,1852.2,125.9
"20549","62214","2018",5,5,0,214000,1614.2,133.6
"20550","62215","2018",190,177,13,159686.9,1772.274,92.54737
"20551","62217","2018",27,27,0,109083.5,1166.778,94
"20552","62218","2018",4,4,0,161682.5,1657.75,97.5
"20553","62219","2018",1,1,0,115000,1045,110
"20554","62220","2018",10,10,0,110550,1340,91.9
"20555","62221","2018",2,2,0,86375,684.5,126.5
"20556","62222","2018",1,1,0,1e+05,877,114
"20557","62223","2018",2,2,0,57500,932,67.5
"20558","62224","2018",36,36,0,121303.6,1293.472,97.77778
"20559","62225","2018",6,6,0,200500,1737.333,129.5
"20560","62227","2018",1,1,0,6e+05,3030,198
"20561","62228","2018",1,1,0,247000,1563,158
"20562","62229","2018",8,8,0,181078.8,1565.875,117.5
"20563","62230","2018",2,2,0,130300,2138,58
"20564","62231","2018",3,3,0,223333.3,1721.333,149.6667
"20565","62232","2018",11,11,0,152558.2,1420.273,106.9091
"20566","62233","2018",9,9,0,194711.1,1704.556,119.7778
"20567","62234","2018",4,4,0,125537.5,1329,99.75
"20568","62235","2018",47,46,1,263791.5,2094.553,128.8298
"20569","62236","2018",4,4,0,81466.25,1092,77.5
"20570","62237","2018",3,3,0,262400,2415.667,111.3333
"20571","62238","2018",1,1,0,35000,761,46
"20572","62239","2018",27,20,7,190708.7,1991.333,100.1481
"20573","62240","2018",28,28,0,119532.1,1348.75,89.21429
"20574","62241","2018",4,4,0,136750,975,160
"20575","62244","2018",70,70,0,140352.9,1702.543,88.55714
"20576","62245","2018",5,5,0,110200,2081.6,63.4
"20577","62246","2018",1,1,0,192000,1143,168
"20578","62247","2018",4,4,0,110450,1052.75,105.75
"20579","62248","2018",7,7,0,168328.6,1288.714,142.2857
"20580","62249","2018",81,81,0,135294.6,1561.272,88.90123
"20581","62250","2018",96,94,2,148701.2,1559.646,97.20833
"20582","62251","2018",3,3,0,182600,1771.667,101.3333
"20583","62252","2018",26,26,0,208789,1799.231,119.3077
"20584","62254","2018",7,7,0,101540,1387.857,70.28571
"20585","62255","2018",5,5,0,183010.6,1432.8,129.6
"20586","62256","2018",2,2,0,47000,654,65
"20587","62257","2018",5,5,0,84900,1074,84.6
"20588","62258","2018",1,1,0,160000,1074,149
"20589","62259","2018",17,15,2,154685,1617.765,97.35294
"20590","62260","2018",6,6,0,123286.2,1188,114
"20591","62261","2018",199,107,92,193799.6,2950.241,67.51256
"20592","62262","2018",20,20,0,150225,1487.6,102.9
"20593","62263","2018",66,65,1,171130.2,1764.227,96.92424
"20594","62264","2018",14,14,0,161942.9,1453.357,110
"20595","62265","2018",13,13,0,145084.6,1328.692,109.0769
"20596","62267","2018",5,5,0,96700,1140,93
"20597","62268","2018",64,62,2,98443.36,1194.219,83.79688
"20598","62269","2018",8,8,0,144288.2,1433.5,101.875
"20599","62270","2018",55,53,2,104434.8,1223.2,87.92727
"20600","62271","2018",5,5,0,115400,1337.2,84.4
"20601","62272","2018",3,3,0,129000,1510.667,86.66667
"20602","62273","2018",7,7,0,218871.4,1669.429,123.1429
"20603","62274","2018",51,50,1,146523,1567.941,98.58824
"20604","62275","2018",5,5,0,78960,853.6,100
"20605","62276","2018",73,72,1,152972.5,1585.342,98.93151
"20606","62277","2018",26,26,0,150042.8,1658.077,91.5
"20607","62278","2018",3,3,0,258133.3,1625.333,152.6667
"20608","62279","2018",11,11,0,222359.1,1697.636,136
"20609","62280","2018",3,3,0,216100,2070,114.6667
"20610","62281","2018",2,2,0,206500,1586.5,137
"20611","62282","2018",3,3,0,161666.7,1466.667,118
"20612","62283","2018",1,1,0,147250,1888,78
"20613","62284","2018",20,20,0,116100,1287.35,91.05
"20614","62285","2018",3,3,0,87333.33,1059.333,81
"20615","62286","2018",4,4,0,129375,1186.25,111
"20616","62288","2018",15,15,0,142280,1375.8,104.4667
"20617","62289","2018",12,12,0,193750,2142.75,93.91667
"20618","62290","2018",3,3,0,277750,1928.667,135
"20619","62291","2018",31,31,0,132554.8,1460.742,90.93548
"20620","62292","2018",5,5,0,112523,1189.2,95.4
"20621","62293","2018",9,9,0,152255.6,1583.556,104.4444
"20622","62295","2018",17,17,0,118858.8,1290.471,95.23529
"20623","62296","2018",2,2,0,170840,1068.5,156.5
"20624","62297","2018",27,27,0,176736.1,1671.296,107.2222
"20625","62298","2018",2,2,0,213000,1321.5,163.5
"20626","62299","2018",1,1,0,95000,960,99
"20627","62300","2018",27,26,1,173217.2,1871.296,95.85185
"20628","62301","2018",1,1,0,80000,1111,72
"20629","62302","2018",5,5,0,111100,1096.2,107.8
"20630","62303","2018",4,4,0,143375,1482.25,100
"20631","62304","2018",2,2,0,70000,974,73
"20632","62306","2018",4,4,0,156310,1323.5,123.75
"20633","62307","2018",4,4,0,193500,1715.75,105
"20634","62308","2018",9,9,0,150227.8,1216,125
"20635","62309","2018",22,22,0,133207.5,1264.864,104.7273
"20636","62310","2018",18,18,0,140541.7,1498.111,93.27778
"20637","62311","2018",17,17,0,150735.3,1656.176,91.29412
"20638","62312","2018",2,2,0,248200,1929.5,128
"20639","62313","2018",10,10,0,98447,1047.8,93.2
"20640","62314","2018",3,3,0,143156.7,1363.333,107.6667
"20641","62315","2018",6,6,0,182050,1795.167,102.6667
"20642","62317","2018",9,9,0,128332.4,1153.444,111.1111
"20643","62318","2018",123,117,6,152184.5,1674.87,91.43089
"20644","62320","2018",6,6,0,126383.3,1439.333,91.66667
"20645","62321","2018",27,27,0,137145.2,1318.037,105.8148
"20646","62322","2018",1,1,0,65000,1048,62
"20647","62323","2018",22,22,0,183892.5,1870.591,99.72727
"20648","62324","2018",3,3,0,210000,1642,136.3333
"20649","62325","2018",8,8,0,107787.5,1153.875,96.25
"20650","62326","2018",3,3,0,182000,1219.667,159.6667
"20651","62327","2018",7,7,0,122997,1438.429,89.28571
"20652","62328","2018",12,12,0,118793.3,1081.5,107.9167
"20653","62329","2018",15,14,1,148456.7,1358.6,113.4667
"20654","62330","2018",11,11,0,215031.8,1818.455,123.9091
"20655","62331","2018",14,14,0,147510.7,1595.429,92.5
"20656","62332","2018",3,3,0,124233.3,1459.667,85.66667
"20657","62333","2018",3,3,0,136750,1313,107.3333
"20658","62334","2018",14,14,0,140285.7,1384.071,101.6429
"20659","62335","2018",3,3,0,67266.67,722,93.33333
"20660","62336","2018",5,5,0,99500,1355.6,73
"20661","62337","2018",1,1,0,153000,1070,143
"20662","62338","2018",30,30,0,275873.1,2126.133,130.8
"20663","62339","2018",2,2,0,65000,602.5,119
"20664","62340","2018",13,13,0,129576.9,1286.615,97.69231
"20665","62341","2018",3,3,0,83666.67,857,101.6667
"20666","62343","2018",2,2,0,199000,1547.5,128.5
"20667","62344","2018",3,3,0,291000,5664.667,94.33333
"20668","62345","2018",1,1,0,135000,1227,110
"20669","62346","2018",1,1,0,75000,1250,60
"20670","62349","2018",18,18,0,131027.8,1412.444,92.77778
"20671","62350","2018",17,17,0,158988.2,1511.059,104
"20672","62351","2018",44,44,0,122930.9,1335.841,93.52273
"20673","62352","2018",4,4,0,161162.5,1179,139.25
"20674","62353","2018",3,3,0,92400,920.6667,98.66667
"20675","62354","2018",7,7,0,139571.4,1747.857,89.14286
"20676","62355","2018",6,6,0,159833.3,1589.667,97.66667
"20677","62356","2018",9,9,0,141777.8,1401.333,103.5556
"20678","62357","2018",1,1,0,210000,1061,198
"20679","62359","2018",9,9,0,108858.3,1102.444,106.6667
"20680","62360","2018",20,20,0,185610,1650.9,112.65
"20681","62361","2018",20,20,0,76600,882.9,98.95
"20682","62362","2018",2,2,0,92000,1086,84
"20683","62363","2018",4,4,0,148000,1338,109.75
"20684","62364","2018",25,25,0,102032.8,1076.88,103.04
"20685","62365","2018",9,9,0,73305.56,1398.444,57.55556
"20686","62366","2018",3,3,0,119166.7,1375.333,84.66667
"20687","62367","2018",3,3,0,130146.7,1288,100.6667
"20688","62369","2018",12,12,0,199058.3,1580.583,128.5833
"20689","62370","2018",1,1,0,159000,994,160
"20690","62371","2018",30,30,0,166458,1579.267,104.4
"20691","62372","2018",1,1,0,125000,718,174
"20692","62373","2018",10,10,0,191380,1611.6,116.3
"20693","62376","2018",31,31,0,173143.2,1568.645,114.0968
"20694","62377","2018",9,9,0,149938.3,1704.111,95.22222
"20695","62378","2018",4,4,0,146500,1179.25,128.25
"20696","62379","2018",2,2,0,93050,1242,76.5
"20697","62380","2018",3,3,0,157766.7,1195,133.6667
"20698","62381","2018",6,6,0,113750,1072.833,120.5
"20699","62382","2018",7,7,0,95285.71,989.8571,99.42857
"20700","62383","2018",9,9,0,171188.9,1631.778,107.8889
"20701","62384","2018",3,3,0,106716.7,900,119.6667
"20702","62385","2018",6,6,0,132283.3,1105,121
"20703","62386","2018",44,42,2,135516.1,1403.5,99.13636
"20704","62387","2018",3,3,0,175973.3,1449.667,119.6667
"20705","62388","2018",5,5,0,90400,998.8,90.2
"20706","62390","2018",47,47,0,171162.8,1831.234,92.70213
"20707","62391","2018",17,17,0,131355.3,1358.529,96.05882
"20708","62392","2018",3,3,0,164833.3,1247.667,140.3333
"20709","62393","2018",15,15,0,141680.3,1500.533,98.53333
"20710","62395","2018",1,1,0,90000,1125,80
"20711","62397","2018",50,50,0,132433.4,1359.92,102
"20712","62398","2018",3,3,0,125333.3,1238.333,105.6667
"20713","62399","2018",7,7,0,207500,1673.714,127
"20714","62400","2018",52,52,0,119637,1337.5,91.09615
"20715","62401","2018",41,41,0,142641.2,1483.707,98.26829
"20716","62402","2018",3,3,0,110666.7,1251,98.33333
"20717","62403","2018",18,18,0,154343.3,1382.722,108
"20718","62404","2018",2,2,0,142950,983.5,145.5
"20719","62405","2018",8,8,0,151983.5,1576,99.375
"20720","62406","2018",5,5,0,133107,1046.6,119
"20721","62407","2018",6,6,0,164690,1402.167,117.3333
"20722","62408","2018",18,18,0,171180.6,1649.278,107.7222
"20723","62409","2018",1,1,0,150000,1724,87
"20724","62411","2018",1,1,0,122000,1109,110
"20725","62412","2018",15,14,1,139200,1425.133,105.5333
"20726","62413","2018",98,90,8,123261.1,1367.398,92.82653
"20727","62414","2018",4,4,0,128225,1304,96.75
"20728","62415","2018",4,4,0,259750,1522.75,160.75
"20729","62418","2018",1,1,0,143000,1589,90
"20730","62419","2018",1,1,0,143500,2080,69
"20731","62421","2018",6,6,0,104263.7,2052.833,86
"20732","62422","2018",4,4,0,94375,891.75,117.5
"20733","62423","2018",17,17,0,190165.9,1720.118,114
"20734","62424","2018",1,1,0,115000,958,120
"20735","62425","2018",2,2,0,192500,1762.5,109
"20736","62426","2018",4,4,0,121000,1214.25,98.5
"20737","62427","2018",263,245,18,124048.3,1346.437,93.75665
"20738","62428","2018",1,1,0,193000,2053,94
"20739","62429","2018",1,1,0,195000,1354,144
"20740","62432","2018",6,6,0,156000,1791.333,89.33333
"20741","62434","2018",1,1,0,121800,1791,68
"20742","62436","2018",2,2,0,237562.5,1454,163.5
"20743","62437","2018",3,3,0,129833.3,1417.333,90.33333
"20744","62438","2018",5,5,0,190590,1927.6,109
"20745","62439","2018",1,1,0,185000,1542,120
"20746","62440","2018",12,12,0,135435,1133.667,111.5833
"20747","62441","2018",1,1,0,280000,1522,184
"20748","62442","2018",4,4,0,128375,1325.75,98.25
"20749","62443","2018",39,39,0,132803.7,1319.846,103.2051
"20750","62444","2018",2,2,0,229075,1922,119.5
"20751","62445","2018",8,8,0,212307.8,1598,131.75
"20752","62446","2018",10,10,0,144248.4,1747.4,86.2
"20753","62447","2018",17,11,6,70909.94,947.5882,78.35294
"20754","62448","2018",31,31,0,190143.5,1887.645,106.2581
"20755","62450","2018",4,4,0,103400,1282,84.5
"20756","62451","2018",7,7,0,115857.1,1202,90.57143
"20757","62452","2018",16,16,0,189503.1,1776.188,106.1875
"20758","62454","2018",21,21,0,207185.7,1754.095,120.4762
"20759","62456","2018",12,12,0,171252.1,1665.75,104.5
"20760","62457","2018",60,60,0,133804.6,1451.683,98.25
"20761","62458","2018",18,18,0,102002.8,1335.5,77.5
"20762","62459","2018",2,2,0,97225,1299,77
"20763","62460","2018",4,4,0,280655,2149.25,123
"20764","62461","2018",8,8,0,128787.5,1266.125,108.25
"20765","62463","2018",5,5,0,113400,1103.6,122
"20766","62464","2018",33,33,0,182942.8,1885.879,98.69697
"20767","62465","2018",6,6,0,151500,1537.167,90.33333
"20768","62466","2018",1,1,0,52000,464,112
"20769","62467","2018",1,1,0,79000,790,100
"20770","62468","2018",2,2,0,154000,1401,109
"20771","62469","2018",9,9,0,109193.3,1101.667,106.1111
"20772","62471","2018",5,5,0,118940,1077,102.8
"20773","62472","2018",1,1,0,140000,1867,75
"20774","62473","2018",81,78,3,99671.42,1109.728,92.07407
"20775","62474","2018",12,9,3,143333.3,1739.5,83.33333
"20776","62475","2018",2,2,0,142750,1567,90.5
"20777","62476","2018",10,10,0,163377.2,1715.6,94.1
"20778","62477","2018",2,2,0,139900,1199.5,117
"20779","62478","2018",3,3,0,139533.7,1455,104.3333
"20780","62479","2018",17,17,0,116410,1276.471,92.35294
"20781","62480","2018",20,20,0,165557.5,1575.6,102.8
"20782","62481","2018",2,2,0,169500,1119.5,129
"20783","62483","2018",3,3,0,131833.3,1172.333,104
"20784","62484","2018",4,4,0,124446.5,1092,115
"20785","62485","2018",7,7,0,120414.3,1076,110.5714
"20786","62486","2018",8,8,0,99350,1268.5,76.875
"20787","62487","2018",15,15,0,152400,1623.2,95.2
"20788","62488","2018",8,8,0,173900,1621.25,110.25
"20789","62489","2018",27,27,0,145689.3,1432.259,102.8519
"20790","62490","2018",3,3,0,140000,1560.333,89.66667
"20791","62491","2018",68,66,2,217072,1932.029,115.4118
"20792","62492","2018",7,7,0,117357.1,1270.714,99.71429
"20793","62493","2018",2,2,0,152500,1146,133.5
"20794","62494","2018",1,1,0,164000,1093,150
"20795","62495","2018",4,4,0,126440,1420.25,98.75
"20796","62496","2018",5,5,0,156210,1579.4,102.4
"20797","62497","2018",65,65,0,145184,1462.062,100.2923
"20798","62498","2018",237,185,52,113705.2,1358.215,85.49789
"20799","62499","2018",3,3,0,215333.3,1859,110
"20800","62500","2018",1,1,0,94500,1112,85
"20801","62501","2018",2,2,0,158000,1275,139
"20802","62502","2018",50,50,0,201798,1728.38,116.88
"20803","62503","2018",5,5,0,238920,2277.4,105.4
"20804","62504","2018",2,2,0,150975,1620.5,92
"20805","62505","2018",7,7,0,223705.1,2012.143,120.7143
"20806","62506","2018",16,16,0,112656.2,1150.938,100.8125
"20807","62507","2018",3,3,0,175000,1305.667,144
"20808","62508","2018",4,4,0,93750,1145.5,86.75
"20809","62509","2018",3,3,0,195866.7,1368,151.6667
"20810","62510","2018",227,208,19,114967.6,1297.639,88.81057
"20811","62512","2018",7,7,0,163128.6,1378.143,122.2857
"20812","62514","2018",2,2,0,150775,2066,81
"20813","62515","2018",2,2,0,124500,1482,84
"20814","62516","2018",120,118,2,98706.25,1095.458,88.48333
"20815","62517","2018",8,8,0,102687.5,1145.25,97.125
"20816","62518","2018",2,2,0,89000,1083,82.5
"20817","62519","2018",3,3,0,115333.3,1010.667,115.6667
"20818","62520","2018",15,15,0,133766.7,1695.133,84.6
"20819","62521","2018",2,2,0,148000,2033,90
"20820","62522","2018",4,4,0,97750,1234.25,75
"20821","62523","2018",54,53,1,125711.6,1501.944,86.55556
"20822","62524","2018",17,17,0,161438.2,1651.529,97.82353
"20823","62525","2018",97,90,7,152346.2,1548.433,98.41237
"20824","62526","2018",2,2,0,159000,1848,84
"20825","62527","2018",1,1,0,182000,1896,96
"20826","62528","2018",50,48,2,148530.6,1518.46,101.04
"20827","62529","2018",10,10,0,303740,2154.5,140.7
"20828","62530","2018",6,6,0,148166.7,1541.5,103.5
"20829","62531","2018",5,5,0,152800,1575,118.8
"20830","62532","2018",15,15,0,113211.3,1120.067,102.6667
"20831","62533","2018",1,1,0,30000,1071,28
"20832","62534","2018",31,31,0,119949,1314.355,92.3871
"20833","62535","2018",1,1,0,145000,2339,62
"20834","62536","2018",7,7,0,142771.4,1232.286,121
"20835","62537","2018",2,2,0,111125,989.5,106.5
"20836","62538","2018",7,7,0,97285.71,1375,75.85714
"20837","62539","2018",4,4,0,73250,974.25,74.5
"20838","62540","2018",12,12,0,174150.2,1551.167,111.5833
"20839","62541","2018",3,3,0,80583.33,841.3333,107
"20840","62542","2018",2,2,0,107500,976,114.5
"20841","62543","2018",15,15,0,136006.7,1542.267,93.73333
"20842","62545","2018",1,1,0,57000,740,77
"20843","62546","2018",2,2,0,451650,2428,194
"20844","62547","2018",3,3,0,148833.3,1130.667,145.3333
"20845","62548","2018",120,118,2,167622.7,1714.192,100.275
"20846","62549","2018",12,11,1,94758.33,1215.5,82.33333
"20847","62550","2018",13,13,0,111153.8,1211.308,92.84615
"20848","62551","2018",1,1,0,217000,1466,148
"20849","62552","2018",6,5,1,88500,1077.167,81.5
"20850","62553","2018",4,4,0,93750,919.25,94.5
"20851","62555","2018",27,27,0,97210.19,1151.222,88.11111
"20852","62556","2018",7,7,0,101071.4,1551.286,71.28571
"20853","62557","2018",21,21,0,200713.6,1727.286,119
"20854","62559","2018",8,8,0,175387.5,1416.625,131
"20855","62560","2018",59,59,0,129114.7,1482.034,88.84746
"20856","62561","2018",1,1,0,50000,641,78
"20857","62562","2018",4,4,0,97505,1139.25,83
"20858","62563","2018",54,53,1,139455.6,1494.426,96.18519
"20859","62564","2018",4,4,0,111950,1161,93
"20860","62566","2018",7,7,0,165857.1,1315.857,133.4286
"20861","62567","2018",10,10,0,139300,1334.3,104.7
"20862","62568","2018",9,9,0,176527.8,1768.556,105.5556
"20863","62569","2018",8,8,0,115358.1,1090,110
"20864","62570","2018",88,87,1,128405.8,1431.318,90.59091
"20865","62571","2018",178,102,76,177217.8,2626.955,71.91573
"20866","62572","2018",9,9,0,94513.33,976.5556,106.6667
"20867","62573","2018",39,39,0,159982.3,1617.667,100.4359
"20868","62574","2018",4,4,0,148050,1213.25,119.75
"20869","62576","2018",2,2,0,75140,669.5,108
"20870","62577","2018",3,3,0,53666.67,867,61.66667
"20871","62579","2018",2,2,0,77500,894.5,95.5
"20872","62580","2018",3,3,0,148566.7,1407,107
"20873","62582","2018",6,6,0,185000,1345.167,139.3333
"20874","62583","2018",10,10,0,102850,966.6,114.2
"20875","62584","2018",16,16,0,191781.2,1788.062,113.5
"20876","62585","2018",4,4,0,157750,1526.75,105.25
"20877","62586","2018",3,3,0,84333.33,990.3333,75.66667
"20878","62587","2018",58,52,6,122083.1,1314.259,91.18966
"20879","62588","2018",42,39,3,171475.5,1811.714,95.16667
"20880","62589","2018",9,9,0,230445.6,1733.444,132.3333
"20881","62591","2018",1,1,0,96000,2133,45
"20882","62593","2018",1,1,0,172000,1470,117
"20883","62594","2018",4,4,0,138500,1306.75,116.25
"20884","62595","2018",11,11,0,169360,1651.727,105.7273
"20885","62597","2018",3,3,0,147933.3,1564.667,98.66667
"20886","62598","2018",13,13,0,163423.8,1525.154,112
"20887","62599","2018",2,2,0,235500,1994,118.5
"20888","62600","2018",1,1,0,227000,1645,138
"20889","62602","2018",3,3,0,243000,1464.333,168.3333
"20890","62603","2018",12,12,0,134130.8,1483.083,94.83333
"20891","62604","2018",194,98,96,269505.7,3121.624,95.28351
"20892","62606","2018",18,18,0,227208.9,1996.722,115.6111
"20893","62608","2018",4,4,0,62375,729.25,86.75
"20894","62609","2018",11,11,0,232372.7,2044.455,114.8182
"20895","62610","2018",8,8,0,150990,1347,112.125
"20896","62611","2018",2,2,0,142750,1192.5,117
"20897","62612","2018",3,3,0,105326,1301,83.66667
"20898","62613","2018",12,12,0,137308.3,1176.25,117.5
"20899","62614","2018",7,7,0,178928.6,1594,119
"20900","62615","2018",1,1,0,152500,1412,108
"20901","62616","2018",2,2,0,64500,775,96
"20902","62617","2018",87,84,3,119054.9,1318.678,94.5977
"20903","62618","2018",14,14,0,196978.6,1694,117.5
"20904","62619","2018",2,2,0,172680.5,1377.5,123
"20905","62620","2018",14,14,0,118330.7,1159.5,98.21429
"20906","62621","2018",15,15,0,153754.7,1447.133,111.2
"20907","62622","2018",4,4,0,192700,1253.25,153
"20908","62623","2018",4,4,0,194950,1623,122
"20909","62624","2018",33,32,1,133458.6,1458.212,93.54545
"20910","62626","2018",21,21,0,191295.2,1731.571,114
"20911","62627","2018",9,9,0,189347.8,1787.778,105.3333
"20912","62628","2018",36,33,3,109827.8,1332.778,82.36111
"20913","62629","2018",2,2,0,164080,1675,106.5
"20914","62630","2018",1,1,0,206600,984,210
"20915","62631","2018",2,2,0,129000,1382,93.5
"20916","62632","2018",3,3,0,119500,1480.333,81.66667
"20917","62633","2018",2,2,0,117500,627,191.5
"20918","62634","2018",17,17,0,188664.9,1753.882,106.6471
"20919","62635","2018",4,4,0,114000,1148.25,97.25
"20920","62636","2018",8,8,0,215375,1913.75,109.375
"20921","62637","2018",73,70,3,139668,1536.575,91.79452
"20922","62638","2018",13,13,0,109229.3,966.9231,107.6923
"20923","62639","2018",1,1,0,164000,1929,85
"20924","62640","2018",3,3,0,125783.3,1103.333,111.3333
"20925","62641","2018",3,3,0,147966.7,1606,92
"20926","62642","2018",3,3,0,123400,1056.333,117.6667
"20927","62643","2018",158,148,10,122442.3,1363.671,89.73418
"20928","62644","2018",4,4,0,109250,1106,96.25
"20929","62645","2018",61,61,0,157831.1,1670.77,96.68852
"20930","62646","2018",6,6,0,84603.33,992,79.66667
"20931","62647","2018",5,5,0,118700,1110.4,111.8
"20932","62648","2018",4,4,0,165250,1412,118
"20933","62649","2018",9,9,0,107211.1,1095.444,99.66667
"20934","62650","2018",8,8,0,161123.8,1511.75,104.875
"20935","62651","2018",2,2,0,154500,1102.5,180.5
"20936","62652","2018",11,11,0,107918.2,1236.091,87.81818
"20937","62653","2018",4,4,0,161557,1850,84.25
"20938","62654","2018",7,7,0,179664.3,1626.143,112.4286
"20939","62655","2018",3,3,0,132107,1264.667,114
"20940","62656","2018",10,10,0,173730,1272.1,128.1
"20941","62657","2018",5,5,0,185140,1928,111
"20942","62658","2018",2,2,0,87000,1147,65
"20943","62659","2018",1,1,0,161050,1438,112
"20944","62660","2018",5,5,0,159170,1583.4,100.4
"20945","62661","2018",5,5,0,108400,1171.4,92.6
"20946","62662","2018",7,7,0,210135.7,1410.429,135
"20947","62663","2018",3,3,0,142616.7,1274.667,112.3333
"20948","62664","2018",3,3,0,94666.67,1397.667,68.66667
"20949","62665","2018",4,4,0,120750,1145.75,107.75
"20950","62666","2018",46,46,0,125494.3,1270.565,99.8913
"20951","62667","2018",85,63,22,106279.8,1414.706,78.14118
"20952","62668","2018",2,2,0,106500,1377,79
"20953","62669","2018",3,3,0,90666.67,859.3333,98.33333
"20954","62670","2018",7,7,0,109714.3,1186.571,94.85714
"20955","62671","2018",3,3,0,104666.7,987,104
"20956","62672","2018",6,6,0,92500,1113,85
"20957","62673","2018",7,7,0,142314.3,1255.143,115.4286
"20958","62674","2018",1,1,0,173000,1648,105
"20959","62675","2018",4,4,0,148500,1294.25,115
"20960","62676","2018",2,2,0,65250,780,82.5
"20961","62677","2018",3,3,0,149333.3,1140.667,122
"20962","62678","2018",6,6,0,136900,1415.667,97.5
"20963","62679","2018",1,1,0,75000,1250,60
"20964","62680","2018",7,7,0,158571.4,1419.143,112.4286
"20965","62681","2018",4,4,0,138790,1562,89.75
"20966","62683","2018",4,4,0,109500,870,126.25
"20967","62684","2018",24,24,0,126181.7,1458.333,87
"20968","62688","2018",53,53,0,170227.4,1939.717,86.37736
"20969","62689","2018",3,3,0,169833.3,1603.333,104.6667
"20970","62690","2018",4,4,0,129237.5,1407.75,92.75
"20971","62691","2018",4,4,0,114147.5,1514.5,73.75
"20972","62692","2018",1,1,0,144000,2400,60
"20973","62693","2018",12,12,0,162207.5,1321.417,121
"20974","62694","2018",3,3,0,150500,1834.667,97.66667
"20975","62695","2018",6,6,0,136316.7,1292.167,109.5
"20976","62696","2018",1,1,0,263000,2505,105
"20977","62698","2018",2,2,0,154500,2022,83.5
"20978","62699","2018",6,6,0,112750,1218.333,89.16667
"20979","62700","2018",4,4,0,149000,1084.25,146.75
"20980","62701","2018",3,3,0,81000,1011,82.33333
"20981","62702","2018",5,5,0,132220,1285.2,95.6
"20982","62703","2018",1,1,0,153640,1360,113
"20983","62704","2018",8,8,0,133375,1330.625,107.75
"20984","62705","2018",18,18,0,162411.1,1698.111,98.44444
"20985","62706","2018",28,28,0,209459.6,1816.714,118.4643
"20986","62709","2018",4,4,0,169325,1159,150
"20987","62710","2018",4,4,0,112250,1224,91.75
"20988","62711","2018",35,35,0,135924.2,1423.4,94.65714
"20989","62712","2018",11,11,0,217197.7,1484.909,146.4545
"20990","62713","2018",19,19,0,160078.9,1458.263,110.6316
"20991","62714","2018",7,7,0,145714.3,1767.286,84
"20992","62715","2018",5,5,0,130800,1242.8,108
"20993","62716","2018",6,6,0,194166.7,1865.5,106.1667
"20994","62717","2018",4,4,0,108000,1007,112.5
"20995","62718","2018",13,13,0,186273.1,1917.923,97
"20996","62719","2018",4,4,0,132000,1001.25,134.25
"20997","62721","2018",13,13,0,161027.3,1789.846,88.46154
"20998","62722","2018",1,1,0,50000,588,85
"20999","62723","2018",2,2,0,137500,1339.5,101.5
"21000","62724","2018",58,57,1,143578.7,1504.966,96.05172
"21001","62726","2018",2,2,0,324000,1350,224
"21002","62727","2018",15,15,0,140772.3,1311.733,105.7333
"21003","62728","2018",7,7,0,151000,1529.286,100.1429
"21004","62729","2018",3,3,0,80666.67,995.3333,86.33333
"21005","62730","2018",18,18,0,128297.2,1573.833,90.05556
"21006","62731","2018",2,2,0,49000,670.5,73.5
"21007","62732","2018",6,6,0,143716.7,1811.333,85.5
"21008","62733","2018",4,4,0,128250,1074.5,126.75
"21009","62734","2018",4,4,0,169557.5,1696.75,103.25
"21010","62735","2018",30,30,0,136978.4,1470.267,96.16667
"21011","62736","2018",46,46,0,204598.9,2024.022,102.3043
"21012","62737","2018",64,62,2,120718.1,1378.453,88.67188
"21013","62738","2018",1,1,0,40000,635,63
"21014","62739","2018",3,3,0,131250,920,145.6667
"21015","62740","2018",5,5,0,87400,982,97.4
"21016","62741","2018",1,1,0,129200,1436,90
"21017","62742","2018",5,5,0,319880,1833.2,162.8
"21018","62743","2018",5,5,0,145200,1374,106.8
"21019","62744","2018",58,47,11,187017.2,1786.069,104.3448
"21020","62745","2018",1,1,0,50000,625,80
"21021","62746","2018",77,77,0,173192.6,1699.701,103.2597
"21022","62747","2018",6,6,0,181705.2,1500.333,122.8333
"21023","62748","2018",23,23,0,184548.7,1849.522,104.2609
"21024","62749","2018",2,2,0,125000,979.5,128.5
"21025","62750","2018",8,8,0,140500,1461.75,98.875
"21026","62751","2018",6,6,0,201096.7,1759.333,114.3333
"21027","62752","2018",14,14,0,253928.6,1905.643,141.0714
"21028","62753","2018",75,61,14,167215.5,1924.24,88.6
"21029","62754","2018",6,6,0,140891.7,1245.833,117.6667
"21030","62755","2018",33,33,0,167684.8,1668.03,102.9394
"21031","62756","2018",14,14,0,116500,1447.5,82.85714
"21032","62757","2018",76,74,2,163362,1603.487,105.8684
"21033","62758","2018",161,119,42,152527.7,1653.745,92.98137
"21034","62759","2018",3,3,0,99166.67,932.3333,115.6667
"21035","62760","2018",4,4,0,91573.25,1061.5,85.75
"21036","62762","2018",2,2,0,261000,1036,271.5
"21037","62763","2018",7,7,0,102378.6,938.2857,107.4286
"21038","62764","2018",47,45,2,151597.9,1529.851,97.57447
"21039","62765","2018",157,104,53,127724.2,1373.879,92.82166
"21040","62766","2018",12,12,0,173041.7,1589.583,113.6667
"21041","62767","2018",42,38,4,110936.8,1209.381,101.0476
"21042","62768","2018",5,5,0,91100,933.2,99
"21043","62769","2018",6,6,0,208916.7,1927.667,111.1667
"21044","62770","2018",28,27,1,143174.9,1382.571,106.1071
"21045","62771","2018",48,45,3,108370.1,1243.5,90.625
"21046","62772","2018",7,7,0,157015.7,1507,104.2857
"21047","62773","2018",56,56,0,157944.7,1679.321,94.19643
"21048","62774","2018",63,57,6,183697.5,2003.825,95.07937
"21049","62776","2018",4,4,0,143375,1321,109.5
"21050","62777","2018",1,1,0,80000,842,95
"21051","62779","2018",1,1,0,132700,976,136
"21052","62780","2018",5,5,0,105760,808,129.2
"21053","62781","2018",5,5,0,108900,955.4,108.2
"21054","62782","2018",1,1,0,170300,1670,102
"21055","62784","2018",7,7,0,134500,1194,111.4286
"21056","62785","2018",9,7,2,150305.6,1495.111,99.33333
"21057","62786","2018",2,2,0,107700,1302.5,82
"21058","62787","2018",4,4,0,162500,1477,110.75
"21059","62788","2018",9,9,0,155712.2,1429.111,110.8889
"21060","62789","2018",1,1,0,110000,1134,97
"21061","62790","2018",3,3,0,71666.67,903.3333,82.66667
"21062","62792","2018",21,21,0,137564.3,1630.571,87.09524
"21063","62793","2018",13,13,0,220151.5,1683.077,137.8462
"21064","62794","2018",8,8,0,157884.9,1442.5,110.875
"21065","62795","2018",1,1,0,133000,930,143
"21066","62796","2018",1,1,0,181500,1891,96
"21067","62797","2018",4,4,0,142380.2,1474,105.75
"21068","62798","2018",2,2,0,83250,821.5,110
"21069","62799","2018",12,12,0,159416.7,1649.167,98.41667
"21070","62800","2018",3,3,0,96666.67,1104.333,100.6667
"21071","62801","2018",35,34,1,173795.7,1735.743,100.9143
"21072","62802","2018",4,4,0,98225,1012.75,92.5
"21073","62803","2018",6,6,0,191916.7,1680.333,126.5
"21074","62804","2018",6,6,0,118500,832.6667,140.1667
"21075","62808","2018",1,1,0,40000,381,105
"21076","62809","2018",1,1,0,110000,1222,90
"21077","62810","2018",8,8,0,161937.5,1381.125,117
"21078","62811","2018",17,17,0,126431.8,1241.706,104.4118
"21079","62812","2018",8,8,0,105687.5,953.75,109.625
"21080","62813","2018",4,4,0,137162.5,1436.25,95.25
"21081","62814","2018",1,1,0,61000,649,94
"21082","62815","2018",1,1,0,122000,2440,50
"21083","62816","2018",7,7,0,192154.9,1763.857,112.7143
"21084","62817","2018",16,14,2,170188.8,1760.812,96.1875
"21085","62818","2018",4,4,0,136460,1439.5,94.5
"21086","62819","2018",8,8,0,158293.8,1861.25,92.125
"21087","62820","2018",4,4,0,156562.5,1469.75,111.75
"21088","62822","2018",2,2,0,115000,1161.5,98
"21089","62823","2018",3,3,0,119666.7,1097,110
"21090","62824","2018",6,6,0,147600,1399.5,108.8333
"21091","62825","2018",6,6,0,198284.2,2101.5,102.3333
"21092","62826","2018",553,176,377,374980.5,5174.257,73.24774
"21093","62827","2018",14,14,0,125785.7,1362.143,96.5
"21094","62828","2018",1,1,0,120000,1304,92
"21095","62829","2018",5,5,0,121380.2,1096.8,109.6
"21096","62830","2018",3,3,0,116066.7,1401,90
"21097","62832","2018",12,12,0,175881.8,1661.5,107.3333
"21098","62835","2018",4,4,0,143000,1140,124
"21099","62836","2018",9,9,0,201944.4,1540.778,134.5556
"21100","62837","2018",4,4,0,196512.5,1732,120
"21101","62838","2018",1,1,0,146000,1377,106
"21102","62839","2018",5,5,0,122780,1036.6,127
"21103","62841","2018",33,33,0,148990.9,1508.636,97.33333
"21104","62842","2018",57,54,3,155223.9,1603.351,96.85965
"21105","62843","2018",2,2,0,142000,1083.5,135
"21106","62844","2018",3,3,0,91166.67,1295,69.33333
"21107","62845","2018",5,5,0,186000,1712.8,108.6
"21108","62846","2018",45,45,0,131624.5,1467.644,93.24444
"21109","62847","2018",21,21,0,120076.2,1317.81,94.95238
"21110","62848","2018",40,40,0,133044.2,1391.325,93.725
"21111","62849","2018",26,26,0,197290.4,1766.269,118.1154
"21112","62850","2018",4,4,0,132597.5,1392.5,100.75
"21113","62851","2018",15,15,0,256750.7,1787.533,144
"21114","62852","2018",18,18,0,153864.4,1606.278,100.5
"21115","62853","2018",2,2,0,179150,1126,154
"21116","62854","2018",4,4,0,189875,1824.25,106
"21117","62855","2018",6,6,0,122384.2,1375.167,90
"21118","62856","2018",4,4,0,158315,1504.5,106.75
"21119","62857","2018",2,2,0,130000,1302,100
"21120","62858","2018",1,1,0,203300,968,210
"21121","62859","2018",2,2,0,76000,718.5,108.5
"21122","62860","2018",2,2,0,216875,1832,114
"21123","62861","2018",52,52,0,166012.6,1639.173,103.0385
"21124","62862","2018",1,1,0,170000,1181,144
"21125","62863","2018",6,6,0,225291.7,1612.333,151.3333
"21126","62864","2018",5,5,0,121940,1089.8,126.4
"21127","62865","2018",35,35,0,139415.7,1503.457,93.48571
"21128","62866","2018",6,6,0,159166.7,1810.667,96
"21129","62867","2018",3,3,0,239571.3,1815,150.3333
"21130","62868","2018",2,2,0,67500,623.5,120
"21131","62869","2018",13,13,0,222674.6,1775.462,124.9231
"21132","62870","2018",4,4,0,212750,2207.25,96.25
"21133","62871","2018",2,2,0,79750,2027.5,43
"21134","62872","2018",3,3,0,56666.67,838,86.33333
"21135","62873","2018",7,7,0,199000,1729.143,114.2857
"21136","62874","2018",10,10,0,175390,1535.4,112.7
"21137","62875","2018",16,16,0,158467.2,1475,116.5
"21138","62876","2018",4,4,0,161275,1285,132.5
"21139","62878","2018",1,1,0,125000,1453,86
"21140","62879","2018",2,2,0,179825,1346,135
"21141","62880","2018",5,5,0,192180,1716,118.2
"21142","62881","2018",4,4,0,62000,807,79.75
"21143","62882","2018",8,8,0,134812.5,1229.25,111.75
"21144","62883","2018",1,1,0,165000,663,249
"21145","62885","2018",1,1,0,127710,1596,80
"21146","62886","2018",2,2,0,119000,1597.5,74.5
"21147","62887","2018",3,3,0,129166.7,1610.667,80.66667
"21148","62888","2018",2,2,0,147500,1027.5,146
"21149","62889","2018",4,4,0,104750,1127.75,80.25
"21150","62890","2018",5,5,0,150000,1034.2,147.2
"21151","62891","2018",1,1,0,2e+05,976,205
"21152","62892","2018",6,6,0,210350.7,1810.167,119.1667
"21153","62893","2018",171,92,79,228786.4,3032.485,81.15789
"21154","62894","2018",54,53,1,172830.3,1924.352,91.27778
"21155","62895","2018",83,82,1,130310.9,1456.627,91.66265
"21156","62896","2018",7,7,0,174042.9,1667.143,105.2857
"21157","62897","2018",2,2,0,192575,1382.5,139
"21158","62898","2018",3,3,0,221236.7,1546.667,137
"21159","62899","2018",29,18,11,246751.7,3998.207,71.41379
"21160","62900","2018",5,5,0,129760,923.6,138
"21161","62901","2018",11,11,0,164819.1,1703.545,98.45455
"21162","62902","2018",36,36,0,122623.6,1264.472,99.38889
"21163","62903","2018",5,5,0,162240,1448.6,112
"21164","62904","2018",5,5,0,171800,1542.6,117.4
"21165","62905","2018",7,7,0,161794.3,1649.286,109.4286
"21166","62906","2018",22,22,0,159524,1446.545,114.1364
"21167","62907","2018",55,55,0,154306.9,1546.182,102.7636
"21168","62908","2018",17,17,0,251310.1,1950.824,130.0588
"21169","62909","2018",8,8,0,92875,994.375,89.25
"21170","63001","2018",25,25,0,152630.6,1434.08,113.68
"21171","63003","2018",59,55,4,101668,1078.746,93.83051
"21172","63004","2018",27,26,1,118895.6,1221.259,95.81481
"21173","63005","2018",5,5,0,111650,1493.8,76
"21174","63006","2018",5,5,0,39538,707.8,59.2
"21175","63007","2018",1,1,0,1e+05,781,128
"21176","63008","2018",8,8,0,110960.6,1372.875,90.25
"21177","63009","2018",5,5,0,71437,1128.4,83.6
"21178","63010","2018",14,14,0,76867.5,895.4286,87
"21179","63011","2018",3,3,0,71133.33,997,79.66667
"21180","63012","2018",15,15,0,103284.5,1169.4,91.73333
"21181","63013","2018",11,11,0,157358.2,1496.273,100.0909
"21182","63014","2018",112,77,35,167135.3,2108.107,81.50893
"21183","63015","2018",1,1,0,78000,650,120
"21184","63016","2018",7,7,0,105483.6,1256.714,79.14286
"21185","63017","2018",2,2,0,56000,1120,50
"21186","63019","2018",38,31,7,157344.9,2021.316,80.23684
"21187","63020","2018",5,5,0,141400,1780.8,89.2
"21188","63021","2018",9,9,0,196485.6,1773,108.8889
"21189","63022","2018",30,30,0,82854.03,1073.433,77.13333
"21190","63023","2018",4,4,0,77250,884.75,88.25
"21191","63024","2018",5,4,1,171052,1054,155.2
"21192","63025","2018",3,3,0,165800,1642.667,100.3333
"21193","63026","2018",28,27,1,190510.8,2163,89.17857
"21194","63027","2018",3,3,0,101333.3,840.6667,116.3333
"21195","63028","2018",4,4,0,40125,568.25,72
"21196","63029","2018",5,5,0,139623,1126.2,121.2
"21197","63030","2018",5,5,0,143634,1424,100.4
"21198","63031","2018",5,5,0,110044,1239.4,93.2
"21199","63032","2018",155,65,90,162899.9,2079.665,78.27097
"21200","63033","2018",2,2,0,148249,1231,120
"21201","63034","2018",7,7,0,187542.9,1653.143,107.5714
"21202","63035","2018",12,12,0,185068.7,1874.5,98.66667
"21203","63036","2018",4,4,0,136360,1293.5,113.5
"21204","63037","2018",5,5,0,64840,779.8,88.4
"21205","63038","2018",79,22,57,111794.7,2269.329,52.94937
"21206","63039","2018",4,4,0,52200,607.75,90.75
"21207","63040","2018",55,52,3,156040.8,1588.491,101.7636
"21208","63041","2018",1,1,0,140000,1077,130
"21209","63042","2018",25,24,1,202941.2,2014.48,100.08
"21210","63043","2018",4,4,0,64850,668.5,97.75
"21211","63044","2018",6,6,0,130970,1210.5,117.6667
"21212","63045","2018",2,2,0,117475,1411.5,88
"21213","63046","2018",6,6,0,126775,1274.5,98.33333
"21214","63047","2018",76,13,63,76410.07,1451.868,57.10526
"21215","63048","2018",5,5,0,88340,900.2,105
"21216","63049","2018",9,8,1,167388.9,2294.556,85.44444
"21217","63050","2018",39,38,1,100339.4,1149.513,87.15385
"21218","63051","2018",7,7,0,171292.9,1586.286,118.4286
"21219","63052","2018",9,9,0,87644.44,1113.111,80.77778
"21220","63053","2018",1,1,0,30000,667,45
"21221","63054","2018",9,8,1,90194.44,1428,60.88889
"21222","63055","2018",8,8,0,131625,1357.5,104.25
"21223","63056","2018",2,2,0,76000,710.5,92.5
"21224","63057","2018",4,4,0,86625,770.75,113
"21225","63058","2018",7,7,0,129785.7,1187.286,116.7143
"21226","63059","2018",1,1,0,69170,769,90
"21227","63060","2018",3,3,0,76583.33,677.3333,119.3333
"21228","63061","2018",6,6,0,171116.7,1410.167,112
"21229","63062","2018",4,4,0,73525,746,95.5
"21230","63063","2018",83,69,14,188077.6,1975.12,96.43373
"21231","63064","2018",2,2,0,131825,1287,128
"21232","63066","2018",14,14,0,65347.86,822.7143,78.21429
"21233","63067","2018",1,1,0,25000,676,37
"21234","63069","2018",58,52,6,174214.7,1906.707,93.10345
"21235","63070","2018",71,62,9,228645.3,2293.056,100.5634
"21236","63071","2018",9,9,0,150649,1578.222,97.11111
"21237","63072","2018",7,7,0,102428.6,928.7143,115.4286
"21238","63073","2018",4,4,0,180775,1637.5,103.25
"21239","63074","2018",3,3,0,83600,699,116.6667
"21240","63075","2018",394,50,344,165247.4,2095.855,73.46954
"21241","63076","2018",4,4,0,116517.5,1332.75,89.5
"21242","63077","2018",11,10,1,133133.6,3218.364,55.36364
"21243","63079","2018",3,3,0,108500,793,94
"21244","63080","2018",17,17,0,127546.5,1164,101.5882
"21245","63081","2018",3,3,0,77500,964.3333,77.66667
"21246","63082","2018",6,5,1,135275,1200.667,110.5
"21247","63083","2018",11,11,0,204472.7,1800.818,119
"21248","63084","2018",14,14,0,211032.9,2001.714,100.6429
"21249","63085","2018",14,14,0,125055.4,1357,93.71429
"21250","63086","2018",3,3,0,35416.67,554,60
"21251","63087","2018",1,1,0,135000,1667,81
"21252","63088","2018",4,4,0,119120,950,113
"21253","63089","2018",12,12,0,168118.8,1729,93.33333
"21254","63090","2018",3,3,0,180666.7,1500.667,120
"21255","63091","2018",11,10,1,133923.8,1368.273,95
"21256","63092","2018",27,27,0,172494.2,1719.222,99.51852
"21257","63093","2018",7,7,0,110294.3,1551.857,81.42857
"21258","63094","2018",1,1,0,49000,1225,40
"21259","63095","2018",2,2,0,141770,1557.5,94.5
"21260","63096","2018",3,3,0,138783.3,1263,104.6667
"21261","63097","2018",2,2,0,71000,739,105
"21262","63098","2018",7,4,3,83559.29,1778,52.85714
"21263","63099","2018",29,24,5,182499.6,1842.207,92.75862
"21264","63100","2018",5,5,0,65100,627.6,94.8
"21265","63101","2018",3,3,0,72751.67,704.3333,97.33333
"21266","63102","2018",10,7,3,65765.4,783.6,77.9
"21267","63103","2018",90,58,32,142799,1718.878,82.36667
"21268","63104","2018",2,2,0,102450,1147,90
"21269","63105","2018",4,4,0,77000,994.5,78.25
"21270","63106","2018",20,20,0,172464.5,1886.1,91.6
"21271","63107","2018",4,4,0,215450,1687,139.25
"21272","63108","2018",2,2,0,259649,1390,159.5
"21273","63109","2018",12,12,0,145969,1667.417,91.66667
"21274","63110","2018",6,6,0,110250,1024.833,101.6667
"21275","63112","2018",5,5,0,186320,1994.8,92.6
"21276","63113","2018",2247,364,1883,128796,1963.69,66.24121
"21277","63114","2018",3,3,0,105166.7,1032,110
"21278","63116","2018",31,30,1,132043.5,1494.903,87.45161
"21279","63117","2018",4,4,0,67375,800,78.5
"21280","63118","2018",4,4,0,65900,857.5,75.5
"21281","63119","2018",1,1,0,149001,1674,89
"21282","63120","2018",13,13,0,163414.6,1506.769,115.6154
"21283","63121","2018",16,16,0,148065.2,1629,94.5625
"21284","63122","2018",2,2,0,50750,809,57.5
"21285","63123","2018",4,4,0,117500,1202.75,95
"21286","63124","2018",238,157,81,178386.9,2123.647,85.71849
"21287","63125","2018",42,41,1,110934.4,1128.238,97.7619
"21288","63126","2018",4,4,0,148950,1479.75,103
"21289","63128","2018",10,10,0,107188,1013.8,104.6
"21290","63129","2018",2,2,0,38250,463,82
"21291","63130","2018",4,4,0,62450,702.75,90.75
"21292","63131","2018",14,14,0,150925,1515.214,109.8571
"21293","63132","2018",12,12,0,54445.25,750.5833,76.91667
"21294","63135","2018",6,6,0,196391.7,1827.833,110.1667
"21295","63136","2018",2,2,0,117500,1719.5,76
"21296","63137","2018",3,3,0,91250,963.3333,99.33333
"21297","63138","2018",5,5,0,173480,1622.8,107.2
"21298","63139","2018",6,6,0,64958.33,631.5,97.5
"21299","63140","2018",4,4,0,70125,777.5,88.75
"21300","63141","2018",14,14,0,289800,2227.857,127.9286
"21301","63142","2018",3,3,0,80852.67,730.3333,103
"21302","63143","2018",17,16,1,182703.5,1889,104.4118
"21303","63144","2018",14,14,0,89080,981.3571,93.14286
"21304","63146","2018",12,12,0,197851.1,1968.167,99.5
"21305","63147","2018",2,2,0,70250,787.5,93.5
"21306","63148","2018",20,20,0,164378,1747.5,93.95
"21307","63149","2018",9,9,0,168580,1365.667,124.1111
"21308","63150","2018",20,20,0,175056.2,1791.65,96.45
"21309","63151","2018",13,13,0,107425.4,1218.462,82.46154
"21310","63152","2018",6,6,0,91416.67,1356,68.33333
"21311","63154","2018",9,9,0,143530,1216.556,119.3333
"21312","63155","2018",7,7,0,141392.9,1338.286,101
"21313","63157","2018",4,4,0,110375,860.25,126.25
"21314","63158","2018",6,6,0,59844.5,751.5,79.66667
"21315","63160","2018",6,6,0,155016.7,1387.833,116.8333
"21316","63161","2018",1,1,0,50000,714,70
"21317","63162","2018",3,3,0,50183.33,521.6667,96.66667
"21318","63163","2018",8,7,1,47037.5,799.125,71
"21319","63164","2018",111,78,33,152294.9,1766.09,84.88288
"21320","63165","2018",8,8,0,57331.75,783.5,80.875
"21321","63166","2018",4,4,0,141025,1306.75,107.5
"21322","63167","2018",5,5,0,170833,2137.2,81.4
"21323","63168","2018",4,4,0,200838,1357.25,127.25
"21324","63170","2018",4,4,0,95250,844,110.5
"21325","63171","2018",4,4,0,91765,853,109.75
"21326","63172","2018",1,1,0,90000,698,129
"21327","63173","2018",4,4,0,36612.5,610.75,76.5
"21328","63175","2018",1,1,0,65000,485,134
"21329","63177","2018",7,7,0,125300,1125,117.4286
"21330","63178","2018",159,87,72,127069.6,1604.686,80.02516
"21331","63179","2018",11,11,0,77589.09,1050.727,75.90909
"21332","63180","2018",9,9,0,133211.1,1322.778,94.44444
"21333","63181","2018",9,9,0,134330,1795.444,109.1111
"21334","63182","2018",6,6,0,97000,919.3333,112.1667
"21335","63183","2018",1,1,0,118800,1828,65
"21336","63184","2018",7,7,0,96661,961.1429,96.14286
"21337","63185","2018",6,6,0,84625,1162.833,74
"21338","63187","2018",7,7,0,78414.29,674,121.5714
"21339","63188","2018",10,10,0,148690,1342.3,117.8
"21340","63189","2018",4,4,0,100287.5,1457.75,68.5
"21341","63190","2018",3,3,0,67066.67,771.6667,86.33333
"21342","63191","2018",1,1,0,45000,562,80
"21343","63192","2018",10,6,4,86946,1491.7,72.2
"21344","63193","2018",73,62,11,178246.5,2054.89,88.36986
"21345","63194","2018",3,3,0,197690,1850.333,107.3333
"21346","63195","2018",73,71,2,149540.4,1532.918,97.20548
"21347","63196","2018",5,4,1,106338,1171,89.8
"21348","63198","2018",21,21,0,166159.3,1862.952,97.14286
"21349","63199","2018",2,2,0,210750,1413,128.5
"21350","63200","2018",7,7,0,204878.6,2050.571,99.71429
"21351","63201","2018",10,10,0,127162,1264.8,113.6
"21352","63202","2018",3,3,0,97044.33,984,95.33333
"21353","63203","2018",10,10,0,177016.5,1865.6,88.6
"21354","63204","2018",13,12,1,141806.9,1847.692,79.92308
"21355","63205","2018",5,5,0,144200,1151.8,114
"21356","63206","2018",22,22,0,112046.8,1110.045,98.45455
"21357","63207","2018",14,14,0,84875,938.4286,90.85714
"21358","63209","2018",5,5,0,88690,1153.4,80.6
"21359","63210","2018",24,24,0,131113.1,1226.25,112.0417
"21360","63211","2018",20,19,1,104232.9,1091.15,95.6
"21361","63212","2018",13,13,0,252702.3,2063.077,124.4615
"21362","63213","2018",16,16,0,206018.1,1790.938,122.0625
"21363","63214","2018",43,39,4,177043.1,1852.209,95.16279
"21364","63215","2018",2,2,0,212303,1998,108
"21365","63216","2018",3,3,0,100833.3,900,112
"21366","63218","2018",5,5,0,104400,1093.2,91.4
"21367","63219","2018",5,5,0,137980,1528.2,90.6
"21368","63220","2018",2,2,0,32000,886.5,34.5
"21369","63221","2018",2,2,0,94500,1340,70.5
"21370","63222","2018",3,3,0,114283.3,1213,107
"21371","63223","2018",4,4,0,51335,677.25,73.25
"21372","63224","2018",13,13,0,144051.9,1559.308,94.07692
"21373","63225","2018",8,8,0,59275.75,743,79.5
"21374","63226","2018",24,24,0,205169.2,2086.333,95.45833
"21375","63227","2018",24,24,0,233114.5,2096.917,111.7917
"21376","63228","2018",12,12,0,92202.5,1117,88.33333
"21377","63229","2018",8,8,0,140712.5,1654.625,85
"21378","63230","2018",6,6,0,125183.3,1305.167,103.8333
"21379","63231","2018",9,9,0,66366.67,718.4444,88.66667
"21380","63232","2018",4,4,0,121500,980.75,119.75
"21381","63233","2018",6,6,0,62583.33,645.6667,98.83333
"21382","63234","2018",15,15,0,116256.7,1358.933,84.93333
"21383","63235","2018",6,6,0,138893.3,1699,81.5
"21384","63236","2018",101,19,82,94708.5,2176.772,43.47525
"21385","63237","2018",2,2,0,46715.5,561,85
"21386","63238","2018",3,3,0,153800,1582.333,96.66667
"21387","63239","2018",4,4,0,143058.8,1531.25,91.5
"21388","63240","2018",4,4,0,131862.5,1699.5,77
"21389","63241","2018",6,6,0,257616.7,2100.667,124.1667
"21390","63242","2018",4,4,0,153000,1493.25,97.5
"21391","63243","2018",3,3,0,70333.33,902,78.66667
"21392","63244","2018",16,16,0,197838.8,2022.438,95.5625
"21393","63245","2018",43,41,2,175807.3,1893.744,93.44186
"21394","63246","2018",18,14,4,119301.3,1507.222,79.88889
"21395","63247","2018",11,8,3,131036.4,1599.182,86.36364
"21396","63248","2018",6,6,0,137254,1405.833,97.5
"21397","63249","2018",10,10,0,92142,1020.5,91.8
"21398","63250","2018",8,8,0,94787.5,1338,73.875
"21399","63251","2018",4,4,0,134312.5,1144.75,131.25
"21400","63252","2018",4,4,0,192962.5,1759.75,110.75
"21401","63253","2018",1,1,0,192450,2212,87
"21402","63254","2018",18,18,0,192931.6,2054.278,92.44444
"21403","63255","2018",10,10,0,146582.5,1108.9,126.2
"21404","63256","2018",1,1,0,128620,1013,127
"21405","63257","2018",5,5,0,203484.2,1923.2,111.6
"21406","63258","2018",8,7,1,80063.75,1223.125,75.75
"21407","63259","2018",5,5,0,79060,1128,66.2
"21408","63260","2018",2,2,0,64125,1340.5,59
"21409","63261","2018",6,6,0,176558.3,1476.167,120
"21410","63262","2018",28,28,0,203536.4,1841.429,110.8929
"21411","63263","2018",8,8,0,232603.9,2177.625,114.625
"21412","63264","2018",2,1,1,52000,893,71
"21413","63265","2018",20,20,0,197010,1696,118.45
"21414","63267","2018",6,6,0,71495,655.8333,111
"21415","63268","2018",2,2,0,135250,1211,122
"21416","63269","2018",6,6,0,135716.7,1584.5,89
"21417","63271","2018",12,12,0,123805,1273,102.5833
"21418","63272","2018",28,27,1,270270.4,2312.036,119.9286
"21419","63273","2018",13,13,0,230834.6,2350.769,100.3077
"21420","63274","2018",4,4,0,128500,1486,86.5
"21421","63275","2018",7,7,0,151435.7,1341.143,121.8571
"21422","63276","2018",18,15,3,104451.7,1175.722,89.38889
"21423","63278","2018",6,6,0,234070.8,2239.333,101.6667
"21424","63279","2018",8,6,2,88281.25,1408.375,66
"21425","63280","2018",1,1,0,108500,1356,80
"21426","63281","2018",6,6,0,104275,1016.833,101.6667
"21427","63282","2018",24,24,0,208067.9,2208.083,97.375
"21428","63283","2018",9,9,0,89588.89,759.7778,114
"21429","63284","2018",115,107,8,196804.9,2039.243,95.56522
"21430","63285","2018",11,11,0,112759.1,1093.727,104.5455
"21431","63286","2018",4,4,0,144017.5,1404,100.25
"21432","63287","2018",3,3,0,130500,1074,127.6667
"21433","63288","2018",4,2,2,98167.5,902.25,109.25
"21434","63291","2018",19,19,0,109166.8,1307.789,93.26316
"21435","63292","2018",2,2,0,26500,484.5,54.5
"21436","63293","2018",7,7,0,76357.14,954,91.85714
"21437","63294","2018",2,2,0,105900,1054,99.5
"21438","63295","2018",20,20,0,125805,1147.3,110.6
"21439","63296","2018",4,4,0,101237.5,1565.25,82.25
"21440","63297","2018",4,4,0,253737.5,1723.75,144.75
"21441","63298","2018",2,2,0,48000,428.5,102.5
"21442","63300","2018",241,137,104,145723.9,1749.436,83.3195
"21443","63301","2018",4,4,0,111235,1149.5,94
"21444","63302","2018",51,46,5,220583,2267.353,97.41176
"21445","63303","2018",1,1,0,85500,961,89
"21446","63304","2018",2,2,0,42500,543,79
"21447","63305","2018",4,4,0,114050,858.75,133
"21448","63306","2018",3,3,0,170350,1488.667,118
"21449","63307","2018",76,55,21,181009.4,1952.632,91.06579
"21450","63308","2018",109,37,72,156358.4,1995.807,69.3945
"21451","63309","2018",5,5,0,78400,1171,68
"21452","63311","2018",3,3,0,94833.33,964.6667,95
"21453","63312","2018",3,3,0,106700,1345,98
"21454","63313","2018",1,1,0,1e+05,690,145
"21455","63314","2018",4,4,0,63520,745,86.5
"21456","63315","2018",16,16,0,179439.6,1737.312,108.8125
"21457","63317","2018",8,8,0,106687.5,1149.375,92.625
"21458","63318","2018",4,4,0,162600,1280.25,137.25
"21459","63319","2018",12,11,1,68973.33,1159.583,63
"21460","63320","2018",1,1,0,73650,887,83
"21461","63321","2018",4,4,0,153562.5,1520.5,98
"21462","63322","2018",24,22,2,193499.3,2142.25,92.20833
"21463","63323","2018",3,3,0,76500,774.6667,91
"21464","63324","2018",2,2,0,47500,627.5,79
"21465","63325","2018",2,2,0,206475,1859,112.5
"21466","63326","2018",9,9,0,134603.8,1348.222,106.4444
"21467","63327","2018",18,18,0,216721.2,1904.889,110.2222
"21468","63328","2018",2,2,0,59000,1076,61.5
"21469","63330","2018",2,2,0,93250,1129,73.5
"21470","63331","2018",3,3,0,48333.33,755.6667,69.66667
"21471","63332","2018",5,5,0,140740,1300,99.6
"21472","63333","2018",4,4,0,110737.5,1241.75,89
"21473","63334","2018",9,9,0,109988.9,1247.222,97.88889
"21474","63335","2018",8,8,0,112768.8,1232.75,97.625
"21475","63336","2018",1,1,0,65000,1083,60
"21476","63337","2018",1,1,0,42000,420,100
"21477","63338","2018",31,30,1,57161.29,628.0323,90.19355
"21478","63339","2018",4,4,0,111025,947.75,100.75
"21479","63340","2018",2,2,0,142775,1715.5,74.5
"21480","63341","2018",9,9,0,103878.9,1008.222,106.7778
"21481","63342","2018",3,3,0,102500,1093,90.66667
"21482","63343","2018",2,2,0,130900,1256,85
"21483","63344","2018",4,4,0,41262.5,795.5,56.25
"21484","63345","2018",26,26,0,241371.2,2173.154,117.8077
"21485","63347","2018",3,3,0,133976.7,1314.667,103
"21486","63348","2018",3,3,0,91966.67,1138.333,85
"21487","63349","2018",28,28,0,106757.9,1066.214,103.0357
"21488","63350","2018",11,11,0,202400.9,1892.364,114.2727
"21489","63352","2018",13,13,0,94138.46,1074.308,90.46154
"21490","63353","2018",2,2,0,112500,726,181.5
"21491","63354","2018",7,7,0,87542.86,980,90.85714
"21492","63355","2018",4,4,0,44000,622.25,73
"21493","63356","2018",4,4,0,86354.75,1181.75,74.5
"21494","63358","2018",4,4,0,144037.5,1163.75,112.25
"21495","63360","2018",3,3,0,72300,1006.333,77
"21496","63362","2018",8,8,0,196209.4,1751.5,113.25
"21497","63363","2018",6,6,0,66633.33,832.1667,88.16667
"21498","63364","2018",7,7,0,133342.3,1209.429,106
"21499","63365","2018",7,7,0,95835.71,984.5714,93.57143
"21500","63366","2018",3,3,0,51666.67,607.3333,76.33333
"21501","63367","2018",2,2,0,29200,496.5,57.5
"21502","63368","2018",11,11,0,135428.2,1463.909,98.63636
"21503","63370","2018",3,2,1,95533.33,1015.333,102.3333
"21504","63371","2018",2,2,0,149000,1669.5,81.5
"21505","63372","2018",5,5,0,143520,1463.4,101.6
"21506","63373","2018",2,2,0,83500,693.5,112
"21507","63374","2018",4,4,0,60250,842.25,84.75
"21508","63375","2018",4,4,0,92788.75,935.25,95.5
"21509","63376","2018",3,3,0,49333.33,624,90.33333
"21510","63377","2018",5,5,0,80060,839,99.4
"21511","63378","2018",12,12,0,190751.7,1660.667,117.6667
"21512","63379","2018",3,3,0,205533.3,1622.333,119
"21513","63380","2018",15,12,3,82931.67,1142.867,83.26667
"21514","63381","2018",12,11,1,127425.8,1347.667,97.16667
"21515","63382","2018",4,4,0,139875,1241.5,104
"21516","63384","2018",2,2,0,55000,954.5,65.5
"21517","63385","2018",8,8,0,106475,1140.25,98.75
"21518","63386","2018",2,2,0,114000,1217.5,90.5
"21519","63387","2018",16,16,0,126035.3,1369.062,86.1875
"21520","63388","2018",15,15,0,85986.67,921.2,98.53333
"21521","63389","2018",2,2,0,49975,687,70
"21522","63390","2018",9,9,0,138783.3,1294.556,112.4444
"21523","63391","2018",4,4,0,95451.5,941.25,102.25
"21524","63392","2018",6,6,0,152533.3,1745.167,88.66667
"21525","63393","2018",21,21,0,77662.86,1154.476,87.47619
"21526","63394","2018",1,1,0,55000,458,120
"21527","63395","2018",4,4,0,141562.5,1559.5,85
"21528","63396","2018",9,8,1,184544.4,1859.889,94
"21529","63397","2018",9,9,0,128672.2,1533.556,80
"21530","63398","2018",3,3,0,75933.33,564,138
"21531","63400","2018",9,9,0,71250,888.3333,87.55556
"21532","63401","2018",1,1,0,150000,1064,141
"21533","63402","2018",4,4,0,55062.5,883.5,68
"21534","63403","2018",2,2,0,104250,1470,83.5
"21535","63404","2018",4,4,0,91000,1466.25,84.5
"21536","63405","2018",11,11,0,154622.7,1386.182,107.1818
"21537","63406","2018",1,1,0,401500,1444,278
"21538","63407","2018",8,8,0,128689.4,1439.25,95.75
"21539","63408","2018",1,1,0,81650,592,138
"21540","63409","2018",1,1,0,138500,2131,65
"21541","63410","2018",2,2,0,69000,782,99.5
"21542","63411","2018",7,6,1,99535.71,1197,83.14286
"21543","63412","2018",3,3,0,72000,870.3333,85
"21544","63413","2018",10,9,1,224900,2164.4,103.6
"21545","63414","2018",5,5,0,118820,1188.6,100
"21546","63415","2018",17,17,0,120056.8,1054.059,114.9412
"21547","63416","2018",1,1,0,37200,744,50
"21548","63417","2018",25,25,0,223722,2154.16,100.84
"21549","63418","2018",13,13,0,93061.54,1072.538,88.07692
"21550","63419","2018",15,15,0,71816.67,855.2,84.86667
"21551","63420","2018",8,8,0,138768.8,1545.375,88.5
"21552","63421","2018",4,4,0,136937.5,1134.75,136
"21553","63422","2018",8,8,0,110090,1181.625,95.875
"21554","63423","2018",4,4,0,76300,855.75,101.25
"21555","63424","2018",4,3,1,155225,1498.25,97.25
"21556","63425","2018",18,18,0,268142.8,2520.278,106.7778
"21557","63426","2018",8,8,0,100125,1198,90.625
"21558","63427","2018",2,2,0,134750,1119.5,120.5
"21559","63428","2018",3,3,0,108311.7,1193.333,99.33333
"21560","63430","2018",119,89,30,99527.26,1086.395,89.29412
"21561","63431","2018",5,5,0,104400,854.2,125.2
"21562","63432","2018",11,10,1,171102.7,1625.455,108.3636
"21563","63434","2018",8,8,0,72849.38,978.25,77.5
"21564","63435","2018",2,2,0,72500,916.5,80.5
"21565","63436","2018",1,1,0,175000,875,200
"21566","63437","2018",2,2,0,78100,1031.5,77.5
"21567","63438","2018",10,10,0,122400,1468.3,91.2
"21568","63439","2018",2,2,0,197600,2396.5,82.5
"21569","63441","2018",3,3,0,55066.67,739.3333,77.33333
"21570","63442","2018",1,1,0,86500,840,103
"21571","63443","2018",3,3,0,141384.7,1427,101
"21572","63444","2018",2,2,0,196485,2097.5,89
"21573","63445","2018",2,2,0,182075,1557,124.5
"21574","63446","2018",4,4,0,121375,1473.75,80
"21575","63447","2018",1,1,0,1e+05,1449,69
"21576","63448","2018",14,14,0,85867.14,957.1429,97.64286
"21577","63449","2018",2,2,0,53600,738.5,63
"21578","63450","2018",1,1,0,126000,1008,125
"21579","63451","2018",8,8,0,113841,1395.375,87.875
"21580","63453","2018",33,31,2,169875.5,1817.818,91.66667
"21581","63454","2018",3,3,0,76866.67,951.6667,105
"21582","63455","2018",38,38,0,188391,1898.842,97.10526
"21583","63457","2018",50,45,5,159418,1792.94,88.86
"21584","63458","2018",1,1,0,15000,500,30
"21585","63459","2018",6,6,0,120991.7,1126.667,106
"21586","63460","2018",3,3,0,63833.33,916.6667,65.33333
"21587","63461","2018",4,4,0,139000,1029,134.25
"21588","63462","2018",2,2,0,37000,662.5,61.5
"21589","63463","2018",7,7,0,65650,825.2857,77.85714
"21590","63464","2018",2,2,0,153625,1247.5,123
"21591","63465","2018",8,8,0,100593,1158.125,88.75
"21592","63466","2018",3,3,0,81833.33,1240,80.66667
"21593","63468","2018",5,5,0,91000,965.8,100.4
"21594","63469","2018",8,8,0,101367.5,861,127.125
"21595","63470","2018",46,46,0,157245.4,1678.174,97.21739
"21596","63471","2018",10,9,1,70115,875.5,74.2
"21597","63472","2018",5,5,0,197730,1480.6,130.8
"21598","63473","2018",4,4,0,198637.5,2376.75,82
"21599","64001","2018",1,1,0,35000,361,97
"21600","64002","2018",2,2,0,147365,1039.5,151
"21601","64003","2018",2,2,0,102500,1006.5,101.5
"21602","64004","2018",1,1,0,130000,1300,100
"21603","64005","2018",3,3,0,176166.7,1509,118.3333
"21604","64006","2018",9,8,1,121129.4,1267.556,97.44444
"21605","64007","2018",4,4,0,177250,1769.25,111
"21606","64009","2018",29,18,11,433326,3974.552,109.3448
"21607","64010","2018",4,3,1,146912.5,1239.5,118.75
"21608","64014","2018",3,2,1,198333.3,1457.333,146.3333
"21609","64016","2018",1,1,0,118000,1494,79
"21610","64017","2018",2,2,0,126950,1105.5,128
"21611","64018","2018",3,3,0,154500,1425.333,111
"21612","64021","2018",7,7,0,237751.4,1518.857,162.5714
"21613","64022","2018",1,1,0,53170,844,63
"21614","64023","2018",5,5,0,212300,1735.4,124.6
"21615","64024","2018",840,228,612,318209.1,4125.129,75.04881
"21616","64026","2018",1,1,0,206000,2341,88
"21617","64027","2018",1,1,0,232000,2320,100
"21618","64028","2018",2,2,0,66100,792.5,87
"21619","64029","2018",7,6,1,134582.9,1205.571,112
"21620","64031","2018",1,1,0,155000,1174,132
"21621","64032","2018",2,2,0,186710,1188,166
"21622","64033","2018",2,2,0,167500,2544.5,87
"21623","64034","2018",1,1,0,299450,1782,168
"21624","64035","2018",27,19,8,592155.2,4013.556,134.7407
"21625","64036","2018",1,1,0,330000,2292,144
"21626","64037","2018",8,8,0,202943.8,1983.625,106.875
"21627","64038","2018",40,26,14,491683.5,4229.375,117.25
"21628","64039","2018",1,1,0,180500,1597,113
"21629","64040","2018",32,11,21,74455.03,1623.688,49.1875
"21630","64041","2018",5,5,0,199935,1618.2,128.6
"21631","64042","2018",13,13,0,166064.2,1586.231,110.6154
"21632","64043","2018",2,2,0,195980,1428.5,133
"21633","64046","2018",1,1,0,177600,1889,94
"21634","64047","2018",6,4,2,88133.33,1050.833,76.5
"21635","64048","2018",1,1,0,202475,1841,110
"21636","64051","2018",11,9,2,161402.9,1411.273,118.3636
"21637","64052","2018",1,1,0,86000,1194,72
"21638","64053","2018",1,1,0,470800,2170,217
"21639","64054","2018",3,3,0,238233.3,1542.333,147.6667
"21640","64056","2018",1,1,0,117000,780,150
"21641","64057","2018",15,14,1,164565,1682.533,104
"21642","64058","2018",3,3,0,184566.7,1249.667,151.6667
"21643","64059","2018",5,5,0,232260.4,1711.2,143.6
"21644","64060","2018",14,12,2,224107,2194.786,113.8571
"21645","64061","2018",38,28,10,147489.4,1568.447,95.55263
"21646","64062","2018",24,19,5,154483.3,1535,100.5833
"21647","64063","2018",5,5,0,117573.4,1360,98.8
"21648","64064","2018",2,1,1,142600,890,159
"21649","64065","2018",57,31,26,429799.5,3734.088,110.0877
"21650","64066","2018",3,1,2,118533.3,1328,96
"21651","64067","2018",25,22,3,192206.2,1890.28,108.04
"21652","64068","2018",21,21,0,157764.3,1646.429,101.6667
"21653","64069","2018",5,5,0,103824,1394.8,82.6
"21654","64070","2018",2,2,0,240000,1361.5,183
"21655","64071","2018",6,6,0,203666.7,1724.667,117.3333
"21656","64072","2018",9,9,0,199000,1647.222,123.6667
"21657","64073","2018",3,3,0,195816.7,1574.667,123.6667
"21658","64074","2018",2,2,0,222645,1972,130.5
"21659","64077","2018",5,5,0,198255,1655.8,122.2
"21660","64078","2018",2,2,0,231500,2414.5,90
"21661","64080","2018",9,9,0,194101.1,1756.333,113
"21662","64081","2018",1,1,0,72000,1600,45
"21663","64083","2018",1,1,0,137000,1142,120
"21664","64084","2018",2,2,0,81500,745,127
"21665","64085","2018",1,1,0,24500,817,30
"21666","64086","2018",7,6,1,210665,2026.714,106.7143
"21667","64087","2018",11,11,0,176793.9,1382,130.8182
"21668","64088","2018",3,3,0,2e+05,1468,146.6667
"21669","64091","2018",6,6,0,192590,1927,92.5
"21670","64093","2018",3,3,0,99666.67,734,157.6667
"21671","64094","2018",16,14,2,279980.2,2410.062,123.1875
"21672","64095","2018",3,3,0,187866.7,1617.333,118.3333
"21673","64096","2018",1,1,0,150000,1351,111
"21674","64097","2018",7,7,0,162592.1,1304.143,124
"21675","64098","2018",3,3,0,100333.3,819,122.6667
"21676","64100","2018",49,32,17,437068.7,3927.49,109.6122
"21677","64101","2018",6,5,1,156616.7,1737.333,93.83333
"21678","64102","2018",998,96,902,202902.2,2987.431,67.99299
"21679","64104","2018",6,3,3,107621.2,969.1667,111.5
"21680","64105","2018",1,1,0,200650,2027,99
"21681","64106","2018",4,4,0,167107.5,1418.75,108.5
"21682","64108","2018",9,9,0,128872.4,1088.333,128.6667
"21683","64109","2018",22,22,0,185326.4,1600.864,117.4091
"21684","64110","2018",2,2,0,105400,967.5,109
"21685","64112","2018",8,8,0,158306.2,1410.375,116
"21686","64113","2018",1,1,0,120000,1212,99
"21687","64114","2018",1,1,0,60000,1000,60
"21688","64115","2018",3,3,0,113000,1138.667,100.3333
"21689","64119","2018",5,5,0,219160,1504.8,151.2
"21690","64120","2018",4,4,0,170625,1448,122.75
"21691","64122","2018",852,136,716,378100.8,5543.883,68.85329
"21692","64123","2018",16,12,4,167618.8,1789.25,98.8125
"21693","64125","2018",162,61,101,390556.2,4830.37,81.68519
"21694","64126","2018",12,12,0,127575,1204.583,106
"21695","64127","2018",2,2,0,56500,525,110
"21696","64128","2018",2,2,0,105500,1722,62
"21697","64129","2018",264,74,190,134108.7,1784.216,75.01515
"21698","64130","2018",11,5,6,288297.7,2593.455,109
"21699","64131","2018",5,5,0,153000,1414,116.6
"21700","64132","2018",61,44,17,217859.2,1931.738,111.8361
"21701","64133","2018",9,6,3,149548.6,1528.222,98.44444
"21702","64134","2018",3,3,0,244616.7,2342,107.6667
"21703","64135","2018",3,3,0,256666.7,1984,132.6667
"21704","64136","2018",1,1,0,130000,867,150
"21705","64137","2018",2,2,0,143000,1648,86.5
"21706","64138","2018",26,25,1,193934,1816.385,108.0769
"21707","64139","2018",7,7,0,235921.4,2049.571,125.2857
"21708","64140","2018",123,53,70,223251.3,2802.236,80.69919
"21709","64141","2018",3,3,0,159233.3,1254.667,128.3333
"21710","64142","2018",6,6,0,192181.7,1854.167,106.1667
"21711","64143","2018",2,2,0,176700,1142.5,155
"21712","64144","2018",1,1,0,175000,1535,114
"21713","64145","2018",4,4,0,137275,1390,105.75
"21714","64146","2018",3,3,0,128000,1522.667,79
"21715","64147","2018",23,16,7,305842.8,2807.043,109.2174
"21716","64148","2018",7,7,0,132085.7,1265.143,112.1429
"21717","64149","2018",1,1,0,150000,1923,78
"21718","64151","2018",1,1,0,190000,1301,146
"21719","64152","2018",16,16,0,307962.5,2168.625,142.8125
"21720","64153","2018",2,2,0,135009,1077,103
"21721","64156","2018",4,4,0,127978,1339.25,98
"21722","64157","2018",7,7,0,173512,1624.571,109.5714
"21723","64158","2018",2,2,0,111450,918.5,123.5
"21724","64159","2018",2,2,0,174500,1372.5,145
"21725","64160","2018",103,31,72,177368.9,2665.553,69.51456
"21726","64161","2018",10,10,0,238065.9,1684.9,143.2
"21727","64162","2018",2,2,0,131765,1128.5,116
"21728","64167","2018",1,1,0,182140,1686,108
"21729","64168","2018",6,6,0,114666.7,1201.5,99.33333
"21730","64171","2018",4,4,0,200950,1339.5,157
"21731","64172","2018",1,1,0,58250,534,109
"21732","64173","2018",2,2,0,107500,1570,95.5
"21733","64174","2018",2,2,0,178000,1309,138.5
"21734","64175","2018",2,2,0,119500,1582.5,75.5
"21735","64176","2018",3,3,0,192950.7,1705.333,112.3333
"21736","64177","2018",4,4,0,198550,1461,137.25
"21737","64178","2018",4,4,0,145750,1289,113
"21738","64179","2018",3,3,0,220333.3,2217,97.66667
"21739","64180","2018",1,1,0,212500,1771,120
"21740","64181","2018",4,4,0,232010,1396.25,160
"21741","64183","2018",3,3,0,293640,1868.333,156
"21742","64184","2018",1,1,0,250000,1208,207
"21743","64185","2018",1,1,0,229500,1275,180
"21744","64186","2018",2,2,0,165100,1142.5,144.5
"21745","64187","2018",1,1,0,88000,352,250
"21746","64188","2018",9,9,0,101522.2,1044.444,101.5556
"21747","64189","2018",189,36,153,318340.5,4263.069,72.9418
"21748","64191","2018",22,20,2,176202.7,1509.045,128.2727
"21749","64193","2018",1,1,0,109000,838,130
"21750","64194","2018",3,3,0,149433.3,1052,130
"21751","64196","2018",1,1,0,145000,2071,70
"21752","64197","2018",2,2,0,152000,1755,98
"21753","64198","2018",19,19,0,221124.2,1923.789,120.3158
"21754","64199","2018",1,1,0,136000,1115,122
"21755","64200","2018",5,5,0,204100,1397,153.2
"21756","64202","2018",4,4,0,246691.5,1780,140.25
"21757","64203","2018",2,2,0,133000,1389.5,99.5
"21758","64204","2018",64,8,56,65636.02,1734.672,38.14062
"21759","64205","2018",3,2,1,116266.7,1369,82.33333
"21760","64206","2018",2,2,0,115120,2247.5,77
"21761","64208","2018",3,3,0,236508.7,1770.667,130.6667
"21762","64209","2018",1,1,0,173000,1648,105
"21763","64210","2018",5,5,0,129980,2070.2,92
"21764","64211","2018",6,6,0,190820.8,1589.333,116.3333
"21765","64213","2018",21,18,3,329975.7,2924.714,122.5714
"21766","64214","2018",4,4,0,120000,1076.75,112
"21767","64216","2018",11,11,0,257148.2,1692.273,158.2727
"21768","64217","2018",2,2,0,104000,999,105.5
"21769","64219","2018",2,2,0,108175,1078,99
"21770","64220","2018",4,4,0,195000,1499,133.75
"21771","64222","2018",1,1,0,100600,1734,58
"21772","64223","2018",9,9,0,74400,985.6667,76.77778
"21773","64224","2018",5,5,0,150260,1579,107.4
"21774","64225","2018",6,5,1,198767.3,1338.833,146.3333
"21775","64227","2018",5,5,0,172560,1754.6,100
"21776","64228","2018",2,2,0,226700,2006.5,113.5
"21777","64230","2018",64,57,7,186310.9,1664.172,115.4844
"21778","64231","2018",1,1,0,101000,971,104
"21779","64232","2018",1,1,0,141300,1413,100
"21780","64233","2018",12,12,0,126314.2,1356.083,92.41667
"21781","64234","2018",4,4,0,113050,819.75,142
"21782","64235","2018",4,3,1,201250,1739.75,124
"21783","64237","2018",38,23,15,181978.4,1715.921,101.9211
"21784","64238","2018",13,13,0,182243.1,1602.615,120.6154
"21785","64239","2018",2,2,0,70000,1156,61
"21786","64240","2018",2,2,0,114990,1778,67.5
"21787","64241","2018",1,1,0,164620,1646,100
"21788","64242","2018",1,1,0,196500,1489,132
"21789","64243","2018",3,3,0,180342.7,1798,100.6667
"21790","64245","2018",7,7,0,140673.6,1478.857,92.42857
"21791","64246","2018",3,3,0,294266.7,1891.667,153
"21792","64247","2018",6,6,0,123683.3,1026.833,127.8333
"21793","64249","2018",27,6,21,505685.5,6045.259,72.77778
"21794","64250","2018",5,2,3,218530,2250.6,94.8
"21795","64251","2018",2,2,0,149875,1405.5,112.5
"21796","64252","2018",9,9,0,150833.3,1981.333,85.44444
"21797","64253","2018",5,5,0,105334.2,893.2,118.4
"21798","64254","2018",7,6,1,112885.7,1441,87.14286
"21799","64255","2018",5,4,1,382275,3271.2,127.2
"21800","64256","2018",72,36,36,210659.5,2334.194,89.59722
"21801","64257","2018",3,3,0,171400,2801.333,62.33333
"21802","64259","2018",6,4,2,150000,1987.667,73.5
"21803","64260","2018",483,68,415,201322.6,3526.921,60.02899
"21804","64261","2018",1,1,0,170000,1417,120
"21805","64263","2018",2,2,0,190928.5,1959.5,98
"21806","64266","2018",2,2,0,161000,1384,116.5
"21807","64268","2018",1,1,0,162500,1083,150
"21808","64269","2018",41,37,4,276623.2,2166.878,122.3902
"21809","64270","2018",5,5,0,173700,1802.4,95.8
"21810","64271","2018",2,1,1,110864.5,1100.5,97.5
"21811","64273","2018",4,4,0,269547.5,1444.25,218.75
"21812","64275","2018",3,2,1,193703.3,2010.667,92
"21813","64276","2018",3,3,0,140833.3,1523.667,114
"21814","64277","2018",1,1,0,117000,688,170
"21815","64279","2018",22,15,7,258737.3,2770.273,94.22727
"21816","64280","2018",2,2,0,45500,587,79
"21817","64281","2018",2,2,0,105500,1245,87.5
"21818","64282","2018",5,5,0,258800,3407,106.4
"21819","64284","2018",77,42,35,167142.1,1791.818,97.4026
"21820","64286","2018",3,3,0,226666.7,1850.333,126.3333
"21821","64287","2018",1,1,0,310000,2818,110
"21822","64288","2018",4,4,0,194387.5,1834,112.5
"21823","64289","2018",4,4,0,275000,2231.25,127
"21824","64290","2018",3,3,0,137510,1374.667,98.66667
"21825","64291","2018",5,5,0,129700,1418.8,103.2
"21826","64294","2018",1,0,1,232300,1499,155
"21827","64295","2018",2,2,0,224641,1653,128
"21828","64296","2018",1,1,0,87000,1036,84
"21829","64297","2018",2,2,0,131275,1168,107.5
"21830","64298","2018",1,1,0,223600,2795,80
"21831","64299","2018",1,1,0,250000,1894,132
"21832","64300","2018",7,6,1,168321.4,1425.143,125.1429
"21833","64301","2018",12,12,0,139720.8,1527.5,97.16667
"21834","64302","2018",7,7,0,175078.6,1502.143,129.2857
"21835","64303","2018",1,1,0,102350,1024,100
"21836","64304","2018",34,23,11,296247,2747.882,109.0588
"21837","64305","2018",8,8,0,111380.6,1326.5,94.625
"21838","64306","2018",6,6,0,167025,1303.167,131.6667
"21839","64307","2018",3,3,0,152368.3,1213.667,122
"21840","64308","2018",1,1,0,175000,1483,118
"21841","64309","2018",1,1,0,70000,412,170
"21842","64310","2018",1,1,0,120000,571,210
"21843","64311","2018",2,2,0,54875,692.5,78.5
"21844","64312","2018",4,4,0,374350,1974.75,181.75
"21845","64313","2018",2,2,0,136804,1727,77
"21846","64314","2018",1,1,0,3e+05,1200,250
"21847","64315","2018",7,6,1,192610,1586.143,119.8571
"21848","64316","2018",2,2,0,145500,1327,99
"21849","64317","2018",22,10,12,226394.5,2721.273,89
"21850","64318","2018",1,1,0,80000,727,110
"21851","64320","2018",13,8,5,128639.6,1683.308,84.46154
"21852","64323","2018",3,3,0,164843.3,1870.667,103
"21853","64324","2018",26,26,0,180353.8,1410.731,130.7692
"21854","64325","2018",2,2,0,127000,818.5,163
"21855","64326","2018",1,1,0,118000,843,140
"21856","64327","2018",2,2,0,295442.5,1299,246.5
"21857","64328","2018",12,12,0,150041.7,1572.167,101.4167
"21858","64329","2018",9,9,0,309794.4,2054.667,151.5556
"21859","64330","2018",1,1,0,75000,652,115
"21860","64331","2018",7,7,0,98902.86,978.4286,96.57143
"21861","64332","2018",4,4,0,193350,1351.5,143.5
"21862","64334","2018",7,7,0,120071.4,1256.857,93.57143
"21863","64335","2018",93,78,15,258804.9,2220.355,117.3871
"21864","64336","2018",4,4,0,188000,1471.25,138.75
"21865","64337","2018",3,3,0,165266.7,1460,116.6667
"21866","64339","2018",3,3,0,165933.3,1673.333,100.3333
"21867","64341","2018",1,1,0,2e+05,1111,180
"21868","64343","2018",6,6,0,219575,1759.5,124.8333
"21869","64345","2018",1,1,0,167000,1152,145
"21870","64347","2018",7,7,0,221370,1884.571,116.7143
"21871","64348","2018",153,83,70,186615.3,2099.575,89.26144
"21872","64349","2018",6,6,0,175416.7,1512.167,117.3333
"21873","64350","2018",11,8,3,197495.5,2144.091,96.63636
"21874","64351","2018",2,1,1,53750,539,102
"21875","64352","2018",3,3,0,185576.7,1674.333,110.6667
"21876","64353","2018",11,10,1,126568.2,1201.727,105.7273
"21877","64354","2018",5,5,0,139416.2,1556.8,81.6
"21878","64355","2018",2,2,0,165200,1733.5,96
"21879","64359","2018",9,9,0,277316.7,1915.111,135.3333
"21880","64360","2018",3,3,0,149496.3,1166.667,117.3333
"21881","64361","2018",1,1,0,1e+05,1370,73
"21882","64362","2018",4,4,0,243604,2245.75,110.25
"21883","64363","2018",1,1,0,135340,521,260
"21884","64364","2018",4,4,0,214250,1798,117.75
"21885","64365","2018",4,4,0,118222.5,890.25,132.75
"21886","64366","2018",1,1,0,220000,1947,113
"21887","64367","2018",12,11,1,126950.2,1348.417,95.66667
"21888","64368","2018",3,3,0,124666.7,571.3333,214.3333
"21889","64369","2018",2,2,0,123500,1294,95.5
"21890","64370","2018",5,5,0,256365,1886.4,134.4
"21891","64371","2018",31,23,8,114790.5,1430.065,114.5161
"21892","64373","2018",10,10,0,211600.7,1919,113.2
"21893","64374","2018",13,13,0,191715.4,1678.462,112.6154
"21894","64375","2018",1,1,0,135000,1378,98
"21895","64376","2018",6,6,0,231500,1675.667,142.1667
"21896","64377","2018",4,3,1,228450,1699,139.5
"21897","64378","2018",1,1,0,1e+05,769,130
"21898","64379","2018",1,1,0,250000,1429,175
"21899","64380","2018",5,5,0,151167,1169.2,142.2
"21900","64381","2018",2,2,0,180000,1171.5,162.5
"21901","64383","2018",1,1,0,53112,565,94
"21902","64385","2018",2,2,0,193200,1618.5,120
"21903","64386","2018",20,15,5,180270.5,1680.95,107.8
"21904","64387","2018",9,9,0,221083.3,1568.778,139.5556
"21905","64389","2018",2,2,0,117500,1540.5,81.5
"21906","64390","2018",1,1,0,80000,1067,75
"21907","64391","2018",2,2,0,118000,1250.5,93
"21908","64392","2018",1,1,0,174900,1198,146
"21909","64393","2018",39,35,4,162497.1,1524.846,109.6154
"21910","64395","2018",4,4,0,90125,810.5,96.5
"21911","64396","2018",5,5,0,181000,2449.8,86.4
"21912","64397","2018",1,1,0,173000,1048,165
"21913","64398","2018",1,1,0,160000,1250,128
"21914","64399","2018",21,20,1,228704.3,1855.619,125.6667
"21915","64400","2018",6,6,0,155266.7,1975,88.66667
"21916","64401","2018",1,1,0,102000,1133,90
"21917","64403","2018",1,1,0,84000,667,126
"21918","64404","2018",1,1,0,158000,1859,85
"21919","64405","2018",35,32,3,220297.8,1785.257,125.8286
"21920","64406","2018",5,5,0,197800,1897.8,104.4
"21921","64407","2018",56,43,13,325016.6,2993.089,111.3393
"21922","64408","2018",1,1,0,226000,1449,156
"21923","64409","2018",13,13,0,147807.7,1334.077,111.8462
"21924","64410","2018",49,29,20,101291,1301.714,80.57143
"21925","64411","2018",1,1,0,54000,1080,50
"21926","64412","2018",1,1,0,91000,460,198
"21927","64413","2018",9,9,0,132532.6,1615.556,86.88889
"21928","64414","2018",2,2,0,132500,1644.5,83
"21929","64415","2018",11,11,0,173362.3,1714.273,104.2727
"21930","64416","2018",17,12,5,117037.6,1033.647,119.2353
"21931","64417","2018",39,27,12,161231.7,1376.923,115.8462
"21932","64419","2018",21,18,3,182521.3,1791.19,101.619
"21933","64420","2018",3,3,0,138916.7,1548.667,91
"21934","64421","2018",7,7,0,184814.3,1410.429,137.7143
"21935","64422","2018",133,76,57,112381.9,1262.835,90.00752
"21936","64423","2018",2,2,0,207500,1453,139
"21937","64424","2018",1,1,0,80000,1356,59
"21938","64425","2018",2,2,0,250150,2130.5,125.5
"21939","64426","2018",4,4,0,144967.5,1590,99.5
"21940","64427","2018",2,2,0,152500,1386.5,111.5
"21941","64428","2018",1,1,0,44400,342,130
"21942","64429","2018",2,2,0,287820,1594.5,175
"21943","64430","2018",148,84,64,119836.1,1407.426,87.68919
"21944","64431","2018",5,5,0,141676,1468.6,97
"21945","64432","2018",1,1,0,52000,364,143
"21946","64433","2018",1,1,0,169000,1470,115
"21947","64435","2018",1,1,0,188510,1571,120
"21948","64436","2018",2,2,0,280550,2062.5,145.5
"21949","64437","2018",2,2,0,110500,867,126.5
"21950","64438","2018",2,2,0,194600,1642.5,113
"21951","64439","2018",7,7,0,214457.1,2013.286,111.8571
"21952","64440","2018",6,6,0,196000,1446.833,138
"21953","64442","2018",1,1,0,217310,1402,155
"21954","64443","2018",7,6,1,165102.9,1368.857,123.4286
"21955","64444","2018",4,4,0,180200,1581.5,117
"21956","64445","2018",1705,257,1448,120722,1697.212,70.23695
"21957","64446","2018",1,1,0,130000,1413,92
"21958","64447","2018",2,2,0,114900,823,131.5
"21959","64448","2018",18,18,0,218544.4,2073.222,108
"21960","64450","2018",1,1,0,210000,1338,157
"21961","64451","2018",1,1,0,225000,1667,135
"21962","64453","2018",28,23,5,140009.3,1307.321,113.8929
"21963","64454","2018",1,1,0,143000,1182,121
"21964","64455","2018",2,2,0,124500,824,160
"21965","64456","2018",1,1,0,206500,1877,110
"21966","64458","2018",3,3,0,160666.7,1119.333,139.3333
"21967","64459","2018",2,2,0,148500,1133.5,133
"21968","64460","2018",2,2,0,105300,1054.5,100
"21969","64461","2018",15,15,0,139868.7,1376.8,99.4
"21970","64462","2018",7,7,0,126142.9,930.4286,131.8571
"21971","64463","2018",7,7,0,157583.7,1213.286,134.7143
"21972","64464","2018",2,2,0,146400,1847.5,80.5
"21973","64465","2018",1,1,0,146000,1141,128
"21974","64466","2018",1,1,0,130000,1354,96
"21975","64467","2018",5,5,0,189650,1920,99.8
"21976","64468","2018",1,1,0,123000,1398,88
"21977","64469","2018",1,1,0,214200,1530,140
"21978","64470","2018",3,3,0,172166.7,1202.667,138.3333
"21979","64471","2018",1,1,0,330000,1833,180
"21980","64472","2018",11,11,0,245877.4,1837.545,136.3636
"21981","64473","2018",2,2,0,143500,1051,132.5
"21982","64474","2018",1,1,0,105000,847,124
"21983","64475","2018",5,5,0,107385.6,973.6,132.4
"21984","64476","2018",4,4,0,202500,1822.75,118
"21985","64477","2018",12,11,1,152624,1534.083,111.0833
"21986","64478","2018",7,7,0,326542.9,2191.286,151
"21987","64482","2018",3,3,0,247766.7,1433.333,170
"21988","64483","2018",348,55,293,347591,5016.342,68.36207
"21989","64484","2018",4,3,1,149625,1630,105.25
"21990","64485","2018",12,7,5,211456.5,2693.583,80.25
"21991","64486","2018",1,1,0,125450,1293,97
"21992","64487","2018",2,2,0,181500,1483,146.5
"21993","64488","2018",1,1,0,220200,1668,132
"21994","64489","2018",2,2,0,225000,1615,128
"21995","64490","2018",1,1,0,305000,2961,103
"21996","64491","2018",3,3,0,145000,1041,130
"21997","64492","2018",2,2,0,145600,1626,123.5
"21998","64493","2018",20,12,8,141460,1386,107.35
"21999","64494","2018",4,4,0,182250,1200,160
"22000","64495","2018",55,24,31,252822.8,2927.618,85.74545
"22001","64496","2018",71,42,29,299548.7,2907.451,104.831
"22002","64498","2018",1,1,0,65000,783,83
"22003","64499","2018",85,65,20,148271.5,1569.918,102.4235
"22004","64500","2018",2,2,0,201065,1585.5,136.5
"22005","64501","2018",6,6,0,130325,1261.833,100.6667
"22006","64502","2018",9,9,0,231253,1798.111,121.8889
"22007","64504","2018",23,18,5,364374.6,2747.087,132
"22008","64505","2018",7,7,0,160785.7,1366.143,119.8571
"22009","64506","2018",1,1,0,71250,1048,68
"22010","64507","2018",1,1,0,207000,2352,88
"22011","64508","2018",1,1,0,170000,1683,101
"22012","64509","2018",4,4,0,78500,722.25,114
"22013","64510","2018",12,12,0,130550,1335.333,105
"22014","64511","2018",43,41,2,219101.2,1960.674,115.5349
"22015","64512","2018",1,1,0,65000,985,66
"22016","64513","2018",21,21,0,178609.6,1593.095,108.0476
"22017","64514","2018",4,4,0,193850,1752.5,108.25
"22018","64515","2018",2,2,0,173500,1374.5,127
"22019","64516","2018",4,4,0,198742.5,1523.5,131
"22020","64517","2018",3,3,0,123353.3,1094.667,124.3333
"22021","64518","2018",11,11,0,334890.9,2248.818,147.2727
"22022","64519","2018",36,30,6,258642.4,2309.694,115.4167
"22023","64520","2018",15,15,0,312191.3,2054.2,148.7333
"22024","64521","2018",4,4,0,222012.5,1778.5,125.25
"22025","64522","2018",2,2,0,218150,1377.5,144
"22026","64523","2018",7,7,0,169594.3,1618.857,107.8571
"22027","64524","2018",3,3,0,134666.7,1639,98
"22028","64525","2018",7,7,0,188489.3,1696.286,112.4286
"22029","64526","2018",22,18,4,187875.9,1907.136,99.72727
"22030","64527","2018",16,12,4,289212.5,2598.875,111.1875
"22031","64528","2018",2,2,0,124700,1293,95
"22032","64529","2018",2,2,0,165000,1141.5,147
"22033","64530","2018",5,5,0,165000,1725,96.6
"22034","64533","2018",2,2,0,127500,1369.5,108
"22035","64534","2018",5,5,0,173714,1461,125.6
"22036","64535","2018",6,6,0,242213.3,2069.333,120.8333
"22037","64536","2018",14,14,0,184080,1547.286,121.7143
"22038","64537","2018",1,1,0,177000,2682,66
"22039","64538","2018",16,4,12,91882.75,1794.062,58.25
"22040","64540","2018",35,21,14,291735.3,2615.429,113.2857
"22041","64541","2018",2,2,0,213180,1550,138
"22042","64543","2018",2,2,0,103750,1388.5,68.5
"22043","64545","2018",143,56,87,307455.2,3631.909,85.91608
"22044","64546","2018",32,19,13,211466.8,2174,101.2188
"22045","64547","2018",72,40,32,266008.5,2884.611,92.38889
"22046","64548","2018",4,4,0,157550,1232,129.25
"22047","64549","2018",7,7,0,196514.3,1693.857,129.7143
"22048","64550","2018",3,3,0,183216.7,1496.333,120.3333
"22049","64551","2018",1,1,0,160900,1768,91
"22050","64552","2018",2,2,0,136000,868.5,167.5
"22051","64554","2018",1,1,0,315930,2358,134
"22052","64555","2018",1,1,0,55000,632,87
"22053","64556","2018",1,1,0,150430,860,175
"22054","64557","2018",1,1,0,65000,942,69
"22055","64558","2018",19,14,5,353416.1,3022.947,122
"22056","64559","2018",8,8,0,122375,1160.5,105.25
"22057","64560","2018",1,1,0,456650,2283,200
"22058","65001","2018",1,0,1,124700,2011,62
"22059","65002","2018",4,4,0,147500,1656.5,90
"22060","65003","2018",17,3,14,51517.65,1257.412,36.94118
"22061","65004","2018",3,3,0,146666.7,1176.667,123.3333
"22062","65005","2018",3,3,0,220831.7,1415.667,145
"22063","65006","2018",2,2,0,162500,2033.5,102.5
"22064","65007","2018",15,15,0,154380,1622.267,98.6
"22065","65009","2018",3,3,0,95750,1281.667,79.66667
"22066","65010","2018",2,2,0,224195,1614.5,139
"22067","65011","2018",1,1,0,2e+05,1538,130
"22068","65017","2018",37,6,31,69320.3,1793.622,36.59459
"22069","65019","2018",4,4,0,207140,1441.5,154
"22070","65020","2018",5,5,0,164830,1659.6,106.4
"22071","65021","2018",5,4,1,176300,1758.6,102.2
"22072","65022","2018",2,2,0,196600,1418,150.5
"22073","65023","2018",1,1,0,81500,2717,30
"22074","65024","2018",3,3,0,173883.3,1686,82.66667
"22075","65025","2018",41,24,17,155691,1754.22,90.82927
"22076","65029","2018",4,4,0,190000,1837.25,114.75
"22077","65031","2018",27,12,15,99210.19,1794.741,57.88889
"22078","65032","2018",18,16,2,152666.1,1965.167,89.33333
"22079","65035","2018",5,5,0,124360,1079.2,123.2
"22080","65036","2018",2,2,0,136550,1901,78
"22081","65037","2018",2,2,0,116682.5,1001,117
"22082","65040","2018",1,1,0,94000,1541,61
"22083","65041","2018",3,3,0,141550,1607.667,97.66667
"22084","65042","2018",4,4,0,173550,1212,152.25
"22085","65043","2018",2,2,0,145000,2901.5,52
"22086","65045","2018",5,4,1,230818,3421.8,77.6
"22087","65046","2018",4,4,0,247892.8,1830.75,138
"22088","65047","2018",92,79,13,129309.3,1489.598,92.52174
"22089","65048","2018",6,5,1,176718.3,1494.833,120.8333
"22090","65049","2018",3,3,0,134666.7,1178,136.6667
"22091","65050","2018",1,1,0,230000,2805,82
"22092","65052","2018",1,1,0,135000,1985,68
"22093","65054","2018",2,2,0,175250,1610.5,108
"22094","65055","2018",4,4,0,231875,1634,159.25
"22095","65056","2018",7,7,0,190721.4,1687.429,117.5714
"22096","65057","2018",7,7,0,206748.6,1606.571,128
"22097","65058","2018",6,6,0,137983.3,1671.833,82
"22098","65059","2018",197,59,138,93611.69,1576.548,61.31472
"22099","65060","2018",1,1,0,81750,908,90
"22100","65062","2018",29,28,1,170812.1,1601.069,110.2069
"22101","65064","2018",2,2,0,137500,2335.5,58.5
"22102","65065","2018",2,2,0,198000,1467,133.5
"22103","65067","2018",1,1,0,131350,1564,84
"22104","65069","2018",13,13,0,146430.3,1468.846,100.9231
"22105","65070","2018",4,4,0,248950,1717,141.25
"22106","65072","2018",11,11,0,129952.5,1328.636,100.3636
"22107","65073","2018",5,5,0,87400,734,131
"22108","65074","2018",3,3,0,156415,1342,131
"22109","65075","2018",2,2,0,259467.5,2392,109.5
"22110","65076","2018",1,1,0,187000,1781,105
"22111","65077","2018",9,3,6,155200,2090.222,75.55556
"22112","65078","2018",6,6,0,157739.8,1795,84.33333
"22113","65079","2018",2,2,0,130000,1148.5,116
"22114","65080","2018",2,2,0,259700,1867.5,139
"22115","65081","2018",1,1,0,175000,1750,100
"22116","65083","2018",3,3,0,180475.7,1326.333,124
"22117","65084","2018",1,1,0,225000,1286,175
"22118","65086","2018",1,1,0,150000,1200,125
"22119","65087","2018",5,5,0,95860,1166.2,95.8
"22120","65091","2018",1,1,0,145000,659,220
"22121","65093","2018",2,2,0,96500,971,88
"22122","65094","2018",2,2,0,121675,1308.5,92
"22123","65095","2018",1,1,0,38000,447,85
"22124","65097","2018",3,3,0,149733.3,1181.667,134
"22125","65098","2018",1,1,0,185000,2312,80
"22126","65099","2018",3,3,0,165800,1702.667,112.6667
"22127","65100","2018",47,44,3,137745.2,1495.681,91.78723
"22128","65101","2018",9,9,0,140527.8,1492.778,94.55556
"22129","65103","2018",2,2,0,225825,800.5,274
"22130","65104","2018",1,1,0,185000,1888,98
"22131","65105","2018",2,2,0,145000,2147,80
"22132","65106","2018",3,0,3,84200,2889.333,28.66667
"22133","65108","2018",4,4,0,227543.8,1519,176.25
"22134","65110","2018",2,2,0,135520.5,1512.5,82.5
"22135","65111","2018",1,1,0,110000,2157,51
"22136","65112","2018",2,2,0,88200,1665,53
"22137","65113","2018",2,2,0,104500,808,123.5
"22138","65114","2018",1,1,0,185500,1237,150
"22139","65115","2018",2,2,0,208750,2132.5,97.5
"22140","65116","2018",1,1,0,258800,2488,104
"22141","65117","2018",1,1,0,120700,1947,62
"22142","65119","2018",2,2,0,41304,687.5,55
"22143","65120","2018",2,2,0,180500,2300.5,79
"22144","65121","2018",6,6,0,127965,1102,116.3333
"22145","65123","2018",45,36,9,130646.9,1550.244,91.64444
"22146","65125","2018",2,2,0,133000,1223.5,107
"22147","65127","2018",19,11,8,135783.2,1619.632,70.68421
"22148","65128","2018",1,1,0,45000,1125,40
"22149","65129","2018",12,12,0,125583.3,862,143.4167
"22150","65130","2018",9,9,0,120000,1034.889,119.8889
"22151","65132","2018",1,1,0,149800,1086,138
"22152","65133","2018",1,1,0,45000,366,123
"22153","65134","2018",1,1,0,135000,944,143
"22154","65135","2018",2,2,0,101000,1442,70
"22155","65137","2018",1,1,0,120000,1154,104
"22156","65138","2018",199,17,182,91684.58,2364.141,40.90452
"22157","65139","2018",3,3,0,91333.33,1150.667,93.33333
"22158","65141","2018",1,1,0,128000,1164,110
"22159","65143","2018",1,1,0,158000,1795,88
"22160","65144","2018",1,1,0,68000,1030,66
"22161","65145","2018",1,1,0,202700,2134,95
"22162","65146","2018",4,4,0,162464.8,1491,108.25
"22163","65147","2018",3,3,0,135000,1590.333,86.66667
"22164","65148","2018",3,3,0,169133.3,1444.333,120.6667
"22165","65149","2018",1,1,0,85000,708,120
"22166","65150","2018",4,4,0,163532.5,1326,140
"22167","65151","2018",1,1,0,160000,1203,133
"22168","65153","2018",3,3,0,150916.7,1069,145
"22169","65156","2018",1,1,0,245000,1161,211
"22170","65159","2018",1,1,0,185000,1623,114
"22171","65161","2018",3,3,0,154250,1264.333,115.3333
"22172","65163","2018",1,1,0,83000,384,216
"22173","65165","2018",4,4,0,110000,1277.25,91.75
"22174","65166","2018",1,1,0,148662,1487,100
"22175","65168","2018",18,4,14,112916.9,2551.444,46
"22176","65169","2018",5,5,0,179615,2515.2,85.8
"22177","65173","2018",1,1,0,126960,1587,80
"22178","65175","2018",4,4,0,104087.5,1208,75.75
"22179","65176","2018",2,2,0,160650,1817.5,89
"22180","65177","2018",2,2,0,160000,1324.5,115
"22181","65178","2018",1,1,0,108000,735,147
"22182","65179","2018",1,1,0,65000,1000,65
"22183","65181","2018",2,2,0,214060,1238.5,172.5
"22184","65182","2018",3,3,0,177533.3,3104.667,90
"22185","65183","2018",9,9,0,94327.78,790.2222,118.2222
"22186","65184","2018",1,1,0,170850,1525,112
"22187","65185","2018",2,2,0,188750,2064,97.5
"22188","65186","2018",1,1,0,65000,802,81
"22189","65189","2018",3,3,0,165166.7,1623,108
"22190","65190","2018",1,1,0,65000,520,125
"22191","65191","2018",3,3,0,107018.3,2359.333,43.33333
"22192","65192","2018",7,3,4,53443.86,1583.571,39
"22193","65193","2018",1,1,0,110000,1250,88
"22194","65195","2018",3,2,1,229333.3,3598.333,66.33333
"22195","65197","2018",1,1,0,221000,2065,107
"22196","65198","2018",6,6,0,176800,1626.333,111.6667
"22197","65199","2018",13,0,13,172322.2,2441.385,65.53846
"22198","65200","2018",4,4,0,118000,1443,78.5
"22199","65202","2018",1,0,1,74000,1644,45
"22200","65205","2018",2,2,0,289220,2627.5,110
"22201","65206","2018",3,3,0,107666.7,1217.333,89
"22202","65207","2018",1,0,1,121655,1466,83
"22203","65208","2018",2,2,0,115015,1917,60
"22204","65209","2018",2,1,1,108085,1646.5,60
"22205","65210","2018",1,1,0,115000,3286,35
"22206","65211","2018",2,1,1,163500,1403,108.5
"22207","65212","2018",10,6,4,141138,2059,80
"22208","65215","2018",1,1,0,116000,1275,91
"22209","65218","2018",6,6,0,107431.7,1197.5,104.6667
"22210","65220","2018",2,2,0,268000,1406.5,195
"22211","65221","2018",1,1,0,235000,1679,140
"22212","65222","2018",1,1,0,150000,1339,112
"22213","65223","2018",7,7,0,280026.4,3446.143,114.8571
"22214","65224","2018",2,2,0,114250,1044,114
"22215","65226","2018",30,24,6,199699.5,1897.633,111.7667
"22216","65228","2018",1,1,0,140000,875,160
"22217","65230","2018",1,1,0,135000,1080,125
"22218","65231","2018",3,3,0,107566.7,830.6667,146.6667
"22219","65232","2018",1,1,0,107000,856,125
"22220","65233","2018",2,1,1,94250,1533,57
"22221","65235","2018",35,34,1,153291,1626.571,93.4
"22222","65236","2018",2,2,0,127500,1329,98.5
"22223","65237","2018",2,2,0,62500,1221.5,53
"22224","65239","2018",2,2,0,139767.5,1120,112
"22225","65240","2018",5,5,0,67488.8,881.2,85.2
"22226","65241","2018",3,3,0,151526.7,2263.667,64.33333
"22227","65242","2018",4,4,0,200836.2,1479.25,140.5
"22228","65243","2018",7,7,0,103013.7,801,124.8571
"22229","65244","2018",3,3,0,194333.3,1699.667,114
"22230","65245","2018",1,1,0,224320,2289,98
"22231","65247","2018",1,1,0,128150,1831,70
"22232","65248","2018",3,3,0,212533.3,1122,219.6667
"22233","65250","2018",2,2,0,117900,1144.5,105.5
"22234","65251","2018",17,16,1,167571.8,1596.647,107.2353
"22235","65252","2018",7,5,2,135428.6,1326.286,111.7143
"22236","65254","2018",1,1,0,115000,1575,73
"22237","65256","2018",3,3,0,142850,1123.333,127.3333
"22238","65257","2018",3,3,0,176333.3,1361.333,121.6667
"22239","65258","2018",66,39,27,103463.1,1133.5,90
"22240","65259","2018",1,1,0,164000,1533,107
"22241","65262","2018",7,7,0,121928.6,912.4286,137.1429
"22242","65263","2018",2,2,0,77250,976.5,81.5
"22243","65265","2018",5,5,0,188245,1269.6,149.2
"22244","65267","2018",1,1,0,145000,1208,120
"22245","65269","2018",2,2,0,76000,868,79.5
"22246","65270","2018",3,3,0,150726,1355.333,117
"22247","65271","2018",1,1,0,118000,1000,118
"22248","65273","2018",4,4,0,151575,1211,132.25
"22249","65274","2018",2,2,0,192000,1371.5,140
"22250","65276","2018",1,1,0,130000,769,169
"22251","65279","2018",3,3,0,156666.7,1516.667,108.6667
"22252","65280","2018",1,1,0,202000,1287,157
"22253","65282","2018",1,0,1,4e+05,1905,210
"22254","65283","2018",3,2,1,315851.7,3121,82.33333
"22255","65284","2018",14,14,0,178549.1,1701,105.7857
"22256","65285","2018",1,1,0,153000,1286,119
"22257","65286","2018",205,70,135,91074.16,1193.859,76.9561
"22258","65287","2018",5,5,0,98800,1509.2,79.2
"22259","65288","2018",1,1,0,208000,1325,157
"22260","65289","2018",1,1,0,85000,1349,63
"22261","65290","2018",2,2,0,134000,1366.5,100
"22262","65291","2018",2,2,0,125000,1544,82.5
"22263","65292","2018",4,4,0,189887.5,1364,141
"22264","65293","2018",1,1,0,3e+05,2256,133
"22265","65295","2018",29,6,23,89977.93,1896.69,50.37931
"22266","65296","2018",9,9,0,108505.6,1041.333,121.5556
"22267","65299","2018",3,3,0,104447,1180.333,95
"22268","65301","2018",3,3,0,127200,1054,106.6667
"22269","65304","2018",27,27,0,118618.1,1142.741,105
"22270","65305","2018",3,3,0,43278.33,1134.667,43.66667
"22271","65306","2018",2,2,0,110000,1354,80
"22272","65307","2018",3,3,0,104800,705,162.3333
"22273","65308","2018",1,1,0,135000,900,150
"22274","65313","2018",6,6,0,216356.7,1667.833,128
"22275","65314","2018",3,3,0,107783.3,1149,102.3333
"22276","65315","2018",3,3,0,150478.3,1007.667,170.3333
"22277","65318","2018",3,3,0,138333.3,1217.333,129.3333
"22278","65319","2018",1,1,0,155000,861,180
"22279","65320","2018",3,2,1,248666.7,2669.667,100
"22280","65322","2018",4,4,0,87000,869.75,108.5
"22281","65327","2018",6,6,0,91280,829.8333,110.8333
"22282","65328","2018",3,3,0,171433.3,1368,136
"22283","65329","2018",7,7,0,53223.71,865.8571,59.71429
"22284","65330","2018",3,3,0,133833.3,1321,115
"22285","65331","2018",35,34,1,183467.5,1647.629,113.0571
"22286","65332","2018",1,1,0,138500,1574,88
"22287","65333","2018",2,2,0,204500,1983,100.5
"22288","65335","2018",6,6,0,180879.2,1808.833,104.1667
"22289","65336","2018",1,1,0,72000,791,91
"22290","65338","2018",4,4,0,195500,2537,88.5
"22291","65339","2018",3,3,0,182531.7,1332.333,136
"22292","65340","2018",14,14,0,144485.6,1330.214,108.3571
"22293","65341","2018",1,1,0,1e+05,746,134
"22294","65343","2018",5,5,0,91400,965.2,98.8
"22295","65344","2018",17,17,0,150196.1,1347.882,115.0588
"22296","65346","2018",2,2,0,178275,1334.5,130.5
"22297","65350","2018",13,13,0,173807.7,1593.769,106.0769
"22298","65351","2018",4,4,0,101000,1930.75,50.25
"22299","65352","2018",2,2,0,285000,1995,146.5
"22300","65353","2018",1,1,0,90000,818,110
"22301","65355","2018",2,2,0,89975,1192.5,76
"22302","65356","2018",1,1,0,20500,427,48
"22303","65357","2018",1,1,0,120000,1200,100
"22304","65360","2018",6,6,0,128991.7,1193.167,109.1667
"22305","65362","2018",20,11,9,113833.5,1413.35,85.1
"22306","65363","2018",2,2,0,157500,1424.5,110
"22307","65366","2018",2,2,0,268700,1807.5,147.5
"22308","65368","2018",1,1,0,174000,1115,156
"22309","65369","2018",4,4,0,154062.5,1307.5,109.25
"22310","65370","2018",11,9,2,166263.6,1909.273,87.72727
"22311","65371","2018",1,1,0,210500,1754,120
"22312","65372","2018",5,5,0,123780,1097.4,118.4
"22313","65373","2018",1,1,0,75000,882,85
"22314","65374","2018",1,1,0,97000,1347,72
"22315","65375","2018",15,13,2,99276.2,1003.6,96.93333
"22316","65376","2018",2,2,0,156825,1460,107
"22317","65378","2018",2,2,0,187000,1312,150.5
"22318","65380","2018",1,1,0,166430,1616,103
"22319","65382","2018",2,2,0,123600,1317,93.5
"22320","65384","2018",2,2,0,114450,1258.5,91
"22321","65386","2018",2,2,0,103750,1128,94
"22322","65387","2018",1,1,0,1e+05,1250,80
"22323","65388","2018",155,9,146,100506,2496.065,39.26452
"22324","65389","2018",13,12,1,104061.5,1097.077,97.38462
"22325","65390","2018",8,8,0,147598.8,1078.625,131.625
"22326","65392","2018",2,2,0,155000,647.5,236.5
"22327","65393","2018",3,3,0,115318.7,1628.333,94.66667
"22328","65394","2018",2,2,0,52500,705,71
"22329","65395","2018",14,13,1,105325.7,1581.214,113.9286
"22330","65396","2018",7,7,0,234714.3,1652.857,147.7143
"22331","65398","2018",6,6,0,118339.2,1046.667,120
"22332","65399","2018",1,1,0,270000,1421,190
"22333","65400","2018",5,5,0,155810,1359.8,105.6
"22334","65401","2018",5,5,0,208600,2116.6,99
"22335","65403","2018",2,2,0,141700,1467.5,101
"22336","65406","2018",6,6,0,167675,1482.333,123.5
"22337","65408","2018",18,13,5,87125,1013.611,84.16667
"22338","65409","2018",2,2,0,127500,1080.5,119
"22339","65410","2018",6,6,0,187111.7,1608.167,117.6667
"22340","65412","2018",1,1,0,68000,1153,59
"22341","65413","2018",6,4,2,117116.7,2157,60.66667
"22342","65415","2018",3,3,0,176013.3,1360.667,130
"22343","65417","2018",56,48,8,135225.2,1448.696,94.33929
"22344","65418","2018",4,4,0,161412.5,1573.75,100
"22345","65419","2018",1,1,0,1e+05,625,160
"22346","65422","2018",3,3,0,108333.3,991.3333,136.3333
"22347","65424","2018",1,0,1,112000,3027,37
"22348","65425","2018",1,1,0,145000,1480,98
"22349","65426","2018",1,1,0,126000,1273,99
"22350","65427","2018",2,2,0,68083,953.5,75
"22351","65428","2018",1,1,0,155000,1462,106
"22352","65429","2018",4,4,0,85125,861.5,101.5
"22353","65432","2018",1,1,0,78000,736,106
"22354","65433","2018",25,21,4,141155.4,1506.6,94.68
"22355","65435","2018",1,0,1,54900,1372,40
"22356","65436","2018",4,4,0,206550,1697.25,123.75
"22357","65437","2018",1,1,0,116500,1294,90
"22358","65439","2018",2,2,0,172600,1457.5,118
"22359","65440","2018",697,203,494,98201.45,1335.23,73.2396
"22360","65441","2018",4,4,0,58250,831.75,72
"22361","65442","2018",2,2,0,239750,1640.5,150.5
"22362","65444","2018",4,4,0,50875,563,97.5
"22363","65445","2018",3,3,0,170000,1440,111.3333
"22364","65446","2018",1,1,0,128000,1333,96
"22365","65447","2018",14,13,1,151575,1639.214,93.42857
"22366","65449","2018",3,3,0,133456.7,1632.667,82
"22367","65451","2018",9,9,0,155097.2,1305,136.5556
"22368","65452","2018",12,12,0,111375,987.9167,115.75
"22369","65455","2018",3,3,0,206800,1089,229
"22370","65456","2018",3,3,0,131000,855.3333,153
"22371","65458","2018",2,2,0,143000,3649,50.5
"22372","65459","2018",1,1,0,213000,1331,160
"22373","65460","2018",59,54,5,120317.2,1255.864,101.1525
"22374","65461","2018",1,1,0,224000,1445,155
"22375","65462","2018",4,4,0,152325,956.5,152
"22376","65463","2018",1,1,0,75000,833,90
"22377","65464","2018",2,2,0,171000,2037,86.5
"22378","65465","2018",18,5,13,134716,2478.667,55.16667
"22379","65471","2018",7,0,7,96014.29,2860.143,33.42857
"22380","65472","2018",2,2,0,165750,965.5,158.5
"22381","65473","2018",4,4,0,238750,1524,173.25
"22382","65474","2018",2,2,0,142500,1104.5,135.5
"22383","65478","2018",1,1,0,74500,931,80
"22384","65479","2018",1,1,0,239400,1140,210
"22385","65481","2018",21,0,21,74930.71,2064.524,35.90476
"22386","66001","2018",1,1,0,210000,1500,140
"22387","66002","2018",52,43,9,222824.5,2058.827,108.6538
"22388","66003","2018",182,21,161,65574.72,1287.846,50.82418
"22389","66004","2018",152,36,116,102467.7,2256.842,43.94737
"22390","66005","2018",9,6,3,153566.4,2302.889,71.33333
"22391","66006","2018",3,3,0,45000,591,78.33333
"22392","66007","2018",5,5,0,130000,1466.2,91.8
"22393","66008","2018",376,161,215,156618.4,2869.795,58.68351
"22394","66009","2018",1,1,0,3e+05,1613,186
"22395","66010","2018",1,1,0,93000,1033,90
"22396","66011","2018",62,57,5,166611.6,1855.129,88.95161
"22397","66012","2018",37,33,4,185845.7,2054.757,90.64865
"22398","66013","2018",1,1,0,90000,1579,57
"22399","66014","2018",36,32,4,118315.3,1424.889,82.88889
"22400","66015","2018",27,21,6,142873,1782.37,78.51852
"22401","66016","2018",112,46,66,210408,2877.92,73.67857
"22402","66017","2018",508,117,391,98960.82,2654.307,37.34646
"22403","66018","2018",2,2,0,130000,1754,71.5
"22404","66019","2018",3,3,0,146333.3,1488.333,100.6667
"22405","66020","2018",101,38,63,152845.9,2611.941,55.30693
"22406","66021","2018",103,99,4,192730.4,1956.495,98.50485
"22407","66022","2018",2,2,0,99600,1252,85.5
"22408","66023","2018",26,26,0,144171.1,1705.962,89.92308
"22409","66024","2018",87,59,28,160781.2,1920.207,81.44828
"22410","66025","2018",33,10,23,122022.3,2038.121,62.24242
"22411","66026","2018",23,23,0,218308.9,2069.652,104.2174
"22412","66027","2018",5,5,0,152000,1668.4,85.2
"22413","66028","2018",127,113,14,228060.8,2155.661,103.1811
"22414","66030","2018",3,3,0,125050,1663.333,82.33333
"22415","66032","2018",2,2,0,131000,1240.5,101
"22416","66033","2018",4,4,0,153750,2085.75,87.25
"22417","66034","2018",4,4,0,75250,1310,60.25
"22418","66035","2018",1,1,0,72000,1029,70
"22419","66036","2018",2,2,0,52500,681,73.5
"22420","66037","2018",526,162,364,156774.8,2896.211,55.22624
"22421","66038","2018",121,113,8,186622.5,1910.397,99.65289
"22422","66039","2018",3,3,0,64013.33,943,64
"22423","66041","2018",11,11,0,131925.5,1533.364,82.45455
"22424","66042","2018",9,9,0,116892.2,1860.111,76.66667
"22425","66043","2018",3,3,0,153666.7,2318.333,67.66667
"22426","66044","2018",3,2,1,180000,1895.333,90
"22427","66045","2018",12,12,0,177783.3,1803.667,101.5833
"22428","66046","2018",13,13,0,83774.62,913.2308,90.61538
"22429","66047","2018",1,1,0,35515,1421,25
"22430","66048","2018",36,15,21,140694.3,2240.056,63.75
"22431","66049","2018",108,68,40,175478,2063.639,84.99074
"22432","66050","2018",79,71,8,186174.6,1875.873,98.20253
"22433","66051","2018",7,7,0,152000,1433.714,104.4286
"22434","66052","2018",4,2,2,128750,1943.5,67.25
"22435","66053","2018",100,22,78,211594.1,4051.54,54.72
"22436","66054","2018",3,3,0,123333.3,1716.667,74.66667
"22437","66055","2018",11,11,0,180842.7,1880.273,94.81818
"22438","66056","2018",11,10,1,156582.2,1739.455,88.45455
"22439","66057","2018",7,7,0,112588.6,1217.143,89.71429
"22440","66058","2018",26,26,0,160701.5,1769.192,92.61538
"22441","66059","2018",34,34,0,163456.5,1800.529,92.82353
"22442","66060","2018",5,5,0,213278,1544.4,139.4
"22443","66062","2018",1,0,1,153340,3067,50
"22444","66063","2018",3,3,0,161333.3,2394,67
"22445","66064","2018",5,5,0,380070,3394.2,104.2
"22446","66065","2018",108,84,24,162633.6,1942.019,85.12963
"22447","66066","2018",24,13,11,175891.2,2466.458,68.5
"22448","66067","2018",10,5,5,128650,1713,83.9
"22449","66068","2018",2,2,0,55000,1282.5,43.5
"22450","66069","2018",31,30,1,204189.8,2003.903,104.8387
"22451","66070","2018",3,3,0,125800,1514.667,77
"22452","66071","2018",28,28,0,116946.4,1298.679,85
"22453","66072","2018",23,12,11,199926.1,2284.652,94.26087
"22454","66073","2018",2,2,0,76000,811,95
"22455","66074","2018",6,6,0,253900,2268.833,105.6667
"22456","66075","2018",17,8,9,87017.65,2044,41.35294
"22457","66076","2018",1,1,0,209050,1118,187
"22458","66077","2018",2,2,0,108500,999,133.5
"22459","66078","2018",8,7,1,129375,1597.375,83.25
"22460","66079","2018",5,4,1,156062.8,1896.8,78.6
"22461","66080","2018",3,3,0,55333.33,1140.333,67
"22462","66081","2018",5,5,0,134410,1947.2,72.2
"22463","66082","2018",15,11,4,153877,2473.267,68.26667
"22464","66083","2018",1,1,0,175000,1651,106
"22465","66084","2018",21,21,0,169369,1668.762,101.619
"22466","66085","2018",6,6,0,208133.3,2362.667,87.16667
"22467","66088","2018",53,48,5,124913.2,1593.698,79.67925
"22468","66089","2018",5,4,1,179236,1579.4,117.4
"22469","66090","2018",1,1,0,87000,4833,18
"22470","66091","2018",2,1,1,25500,594,44
"22471","66092","2018",5,5,0,119038,1319.2,87.8
"22472","66093","2018",44,43,1,285670.9,2768.227,103.5909
"22473","66094","2018",45,41,4,231173.3,2238.622,104.7333
"22474","66095","2018",10,7,3,139230.2,1534,91.2
"22475","66096","2018",19,18,1,117501.1,1226.947,90.73684
"22476","66097","2018",2,2,0,175050,1448,123.5
"22477","66098","2018",8,7,1,174497.5,1883,95.125
"22478","66099","2018",7,6,1,157000,1710.857,86.71429
"22479","66101","2018",26,26,0,198516.9,1856.5,106.1154
"22480","66103","2018",4,4,0,134931,1281.25,98.75
"22481","66104","2018",11,10,1,143773.6,1938.545,81.27273
"22482","66105","2018",7,6,1,156885.7,2234.857,68.71429
"22483","66106","2018",32,29,3,155695.5,1756.75,90.5
"22484","66107","2018",10,9,1,70950,750.9,90.2
"22485","66108","2018",61,58,3,153305,1770.131,93.21311
"22486","66109","2018",6,6,0,107500,1242.333,82.33333
"22487","66111","2018",2,2,0,41500,1560,27.5
"22488","66112","2018",1,1,0,330000,2946,112
"22489","66113","2018",7,4,3,151571.4,2155.143,67
"22490","66114","2018",14,14,0,220102.9,2140.571,101.5
"22491","66115","2018",32,31,1,241314.2,2138.406,110.4688
"22492","66117","2018",1,0,1,140000,2154,65
"22493","66118","2018",5,5,0,96023.2,1181.8,85.8
"22494","66119","2018",6,5,1,115581.7,1833.833,59.5
"22495","66120","2018",1,0,1,195480,2172,90
"22496","66121","2018",16,16,0,170015.6,2097.375,87.4375
"22497","66123","2018",5,5,0,106600,1803.6,66
"22498","66124","2018",158,21,137,94771.24,1974.905,46.42405
"22499","66125","2018",3,3,0,69693.33,1072,67.33333
"22500","66126","2018",8,8,0,230437.5,2198.875,113.375
"22501","66127","2018",15,15,0,140421.3,1765.333,88.13333
"22502","66128","2018",1,1,0,158000,1274,124
"22503","66129","2018",20,20,0,179059,1831.25,95.9
"22504","66130","2018",22,8,14,128829.5,2017.273,63.68182
"22505","66132","2018",10,6,4,151865.5,2126.7,75.1
"22506","66133","2018",50,47,3,179316.9,1897.24,93.44
"22507","66134","2018",14,14,0,161714.3,1730.857,91.28571
"22508","66136","2018",1996,546,1450,113430.3,1472.311,74.84719
"22509","66137","2018",2,2,0,168000,1822,92
"22510","66138","2018",15,15,0,156799.9,1646.2,104.2
"22511","66140","2018",38,34,4,160725.4,1886.605,87.73684
"22512","66141","2018",108,103,5,181568.9,1862.537,96.52778
"22513","66142","2018",2,2,0,127500,1510.5,86.5
"22514","66144","2018",64,57,7,211918.6,2047.609,103.0938
"22515","66145","2018",36,33,3,192631.9,1858.694,107.0556
"22516","66146","2018",2,2,0,80000,1354,60
"22517","66147","2018",7,5,2,83924.29,1537.714,69.14286
"22518","66148","2018",82,29,53,176360.8,2529.146,68.7439
"22519","66149","2018",87,59,28,128872.7,1544.23,83.10345
"22520","66150","2018",26,9,17,81278.85,1247.154,72.5
"22521","66151","2018",1,1,0,40000,1429,28
"22522","66152","2018",1,1,0,60000,504,119
"22523","66154","2018",13,10,3,77818.85,2040.154,41.53846
"22524","66155","2018",2,2,0,65000,1132,58.5
"22525","66156","2018",2,2,0,128750,1499,80
"22526","66158","2018",2,2,0,140007.5,1512,82.5
"22527","66159","2018",4,4,0,147625,1271,113.5
"22528","66160","2018",16,14,2,179118.8,2104.875,83.5625
"22529","66161","2018",18,18,0,124316.7,1378.056,91.38889
"22530","66162","2018",11,11,0,219229.1,1783.364,119.7273
"22531","66164","2018",84,71,13,136687.5,1779.976,78.84524
"22532","66165","2018",10,10,0,137672.5,1488.6,95.5
"22533","66166","2018",3,3,0,159333.3,1403,109
"22534","66167","2018",25,13,12,154408,2177.16,72.48
"22535","66168","2018",57,53,4,229260,2340.105,98.64912
"22536","66169","2018",1,1,0,49000,907,54
"22537","66171","2018",554,267,287,157942.4,3083.244,54.55776
"22538","66172","2018",152,93,59,151261.3,1825.368,83.29605
"22539","66173","2018",16,16,0,205355.9,2125.375,96.5
"22540","66174","2018",36,34,2,143639.4,1679.333,88.16667
"22541","66175","2018",50,45,5,216186,2433.86,90.14
"22542","66176","2018",36,34,2,193318.3,2076.139,88.66667
"22543","66177","2018",18,18,0,211586.1,2047.778,102
"22544","66178","2018",30,28,2,211563.3,2258.067,92.53333
"22545","66179","2018",17,12,5,158723.2,1669,84.82353
"22546","66180","2018",151,138,13,179525.4,2039.424,87.68874
"22547","66181","2018",12,5,7,129938.2,2224.5,54.58333
"22548","66182","2018",128,99,29,166279.6,3012.023,61.01562
"22549","66183","2018",2,2,0,57000,960,61
"22550","66184","2018",3,3,0,115333.3,944,114.3333
"22551","66185","2018",1,1,0,145000,1812,80
"22552","66186","2018",37,36,1,215789.7,2195.189,100.6216
"22553","66187","2018",20,17,3,79253.75,971.7,81.9
"22554","66188","2018",12,7,5,113371.4,1865.75,61.75
"22555","66189","2018",88,72,16,206342.5,2149.33,98.40909
"22556","66190","2018",38,37,1,145920.9,1791.289,83.5
"22557","66191","2018",1,1,0,80000,920,87
"22558","66192","2018",3,3,0,144000,1411,101.3333
"22559","66193","2018",3,3,0,77000,1015.333,77
"22560","66194","2018",4,4,0,160675,1534.75,101.75
"22561","66195","2018",93,87,6,198247.8,1872.763,106.7849
"22562","66196","2018",52,51,1,213316.6,2388.808,93.09615
"22563","66198","2018",6,6,0,81166.67,1016.667,75.66667
"22564","66199","2018",2,2,0,225100,3449,66.5
"22565","66201","2018",1,1,0,62700,1393,45
"22566","66202","2018",7,4,3,166271.4,2307.143,71.85714
"22567","66203","2018",1,1,0,139995,993,141
"22568","66204","2018",3,3,0,184333.3,1375,129.6667
"22569","66205","2018",16,16,0,152584.4,1403.75,100.875
"22570","66206","2018",5,5,0,95100,1048.4,90.6
"22571","66207","2018",8,8,0,129557.1,1570.75,85.25
"22572","66208","2018",19,19,0,217811.6,2107.579,105.1053
"22573","66209","2018",1,1,0,60460,1209,50
"22574","66210","2018",91,81,10,185587.7,1952.813,93.95604
"22575","66212","2018",97,87,10,151639.4,2214.113,70.05155
"22576","66213","2018",105,97,8,200248,1931.01,104.2286
"22577","66214","2018",22,18,4,155241.4,1820,82.95455
"22578","66215","2018",3,3,0,78733.33,1295.333,60.33333
"22579","66216","2018",2,2,0,30250,627.5,47
"22580","66217","2018",27,26,1,145978.2,1598.926,91.66667
"22581","66218","2018",4,1,3,93250,1496.5,61.25
"22582","66220","2018",3,3,0,151000,2045.333,70.33333
"22583","66221","2018",4,4,0,37367.5,789.25,48.25
"22584","66222","2018",64,22,42,76137.58,1319.062,57.54688
"22585","66223","2018",4,4,0,61750,728,90.5
"22586","66224","2018",38,37,1,168751.7,1627.632,100.2632
"22587","66225","2018",33,31,2,187184.8,2086.061,90.33333
"22588","66226","2018",15,14,1,173917.3,1973.067,90.8
"22589","66227","2018",69,65,4,226008.9,2041.275,108.7971
"22590","66228","2018",18,17,1,138439.6,1542.278,94.11111
"22591","66230","2018",30,28,2,109256.7,1278.967,87
"22592","66231","2018",6,6,0,153116.7,1146.167,123
"22593","66233","2018",4,4,0,465575,3203.75,139.75
"22594","69001","2018",6,6,0,170966.7,1625.333,112.3333
"22595","69002","2018",3,3,0,130680,1156.667,107.3333
"22596","69003","2018",29,9,20,270764.4,3235.276,89.2069
"22597","69004","2018",9,7,2,271326.7,2688.444,106.8889
"22598","69005","2018",6,6,0,322302.5,2557,128.1667
"22599","69006","2018",51,41,10,118415.7,1382.039,87.47059
"22600","69007","2018",20,15,5,212568.5,2316.2,95
"22601","69008","2018",4,4,0,199512.5,1798,113.5
"22602","69009","2018",88,56,32,235985.2,2815.477,85.05682
"22603","69010","2018",94,39,55,190474,2243.383,84.18085
"22604","69012","2018",5,5,0,199040,1672.4,114.6
"22605","69013","2018",46,22,24,206708.3,2059.087,99.23913
"22606","69014","2018",7,7,0,224114.3,1866.857,119.7143
"22607","69016","2018",1,1,0,85000,664,128
"22608","69017","2018",2,2,0,240500,1359.5,215
"22609","69018","2018",27,21,6,104852.2,1229.444,87.40741
"22610","69019","2018",153,100,53,189378.4,2031.556,95.4183
"22611","69020","2018",8,6,2,259293.8,2437.75,106.5
"22612","69021","2018",25,24,1,212213.7,2016.68,106.04
"22613","69022","2018",2,2,0,155000,1695.5,75
"22614","69023","2018",17,16,1,220856.8,2372.529,97.94118
"22615","69024","2018",49,38,11,258412,2439.306,114
"22616","69026","2018",4,3,1,226516.8,1696,136.75
"22617","69027","2018",143,68,75,269253.2,3129.636,86.32867
"22618","69028","2018",92,54,38,325076.5,3001.707,106.5543
"22619","69029","2018",416,88,328,213334.3,2791.632,75.60817
"22620","69030","2018",10,9,1,262410,2084.3,126
"22621","69031","2018",13,12,1,226147.7,2231.462,101.2308
"22622","69032","2018",32,17,15,210147.4,2175.219,92.96875
"22623","69033","2018",23,22,1,420886.1,3991.174,110.8696
"22624","69034","2018",709,87,622,292602.2,3632.01,78.05219
"22625","69035","2018",7,7,0,127122.9,1501.714,83.57143
"22626","69036","2018",13,10,3,154379.2,1648.923,96.92308
"22627","69037","2018",13,13,0,153334.6,1570.385,106.3077
"22628","69038","2018",11,10,1,146163.6,1506.273,96.27273
"22629","69039","2018",7,5,2,164158.6,1501.143,111
"22630","69040","2018",106,29,77,287713.9,3221.811,86.24528
"22631","69042","2018",6,6,0,172284.2,2045.833,87.16667
"22632","69043","2018",110,83,27,377675.6,3517.273,109.3091
"22633","69044","2018",91,52,39,534458,4370.264,121.5385
"22634","69045","2018",9,8,1,224738.9,2305.889,103.8889
"22635","69046","2018",57,45,12,397173.5,3655.105,109.8596
"22636","69047","2018",15,14,1,379746.7,2995.667,124.4667
"22637","69049","2018",31,24,7,337897.5,3086,111.2581
"22638","69050","2018",23,20,3,294094.8,2708.652,112.6957
"22639","69051","2018",9,9,0,299805.1,2399.667,133
"22640","69052","2018",54,43,11,325770.2,3129.13,105.7222
"22641","69053","2018",5,5,0,192310,2017.8,95.6
"22642","69054","2018",3,3,0,61500,1076,76.66667
"22643","69055","2018",19,14,5,292075.8,2709.263,113.3158
"22644","69056","2018",29,23,6,267263,2651.897,103.4828
"22645","69057","2018",7,6,1,217742.9,1766.429,115.7143
"22646","69058","2018",4,4,0,265775,1947.25,157
"22647","69059","2018",24,20,4,263493.1,2518.625,105.1667
"22648","69060","2018",6,5,1,88817.33,971,82.5
"22649","69061","2018",6,6,0,417416.7,2159.333,180.5
"22650","69062","2018",10,10,0,274266.1,2713.3,108.3
"22651","69063","2018",72,33,39,425182,3852.667,108.0278
"22652","69064","2018",58,36,22,182891,1929.897,97.03448
"22653","69065","2018",7,5,2,187214.3,1963.857,98.85714
"22654","69066","2018",44,39,5,102083.2,1052.659,96.56818
"22655","69067","2018",19,18,1,165907.9,1778.316,96.10526
"22656","69068","2018",32,24,8,308640.6,3198.344,97.59375
"22657","69069","2018",152,76,76,312085.1,3473.434,90.49342
"22658","69070","2018",20,20,0,123737.5,1313.65,101.55
"22659","69071","2018",13,9,4,355784.7,3443.077,107.3077
"22660","69072","2018",108,71,37,417348.2,3638.139,112.287
"22661","69074","2018",9,8,1,307627.8,2594.222,120
"22662","69075","2018",1,1,0,266000,1385,192
"22663","69076","2018",43,27,16,409055.1,3468.558,115.1395
"22664","69077","2018",8,8,0,223346.9,2008.125,118.625
"22665","69078","2018",8,7,1,167771.2,1962,96
"22666","69080","2018",21,20,1,253434.1,2465.238,99.80952
"22667","69081","2018",260,64,196,382361,3750.981,97.07692
"22668","69082","2018",3,3,0,142050,1447,105
"22669","69083","2018",13,11,2,329279.2,2992.769,111
"22670","69084","2018",14,12,2,197741.9,2596.429,96.85714
"22671","69085","2018",12,11,1,457070,4291,113.1667
"22672","69086","2018",23,22,1,328609.3,3068.609,111.1304
"22673","69087","2018",46,30,16,399805.3,3567.37,111.2609
"22674","69088","2018",114,8,106,231096.1,2873.763,78.64912
"22675","69089","2018",223,92,131,309686.9,3507.677,87.90135
"22676","69090","2018",12,12,0,226585,1952.583,122.3333
"22677","69091","2018",152,76,76,166354.4,1892.191,86.26974
"22678","69092","2018",78,51,27,243249.8,2196.141,108.2051
"22679","69093","2018",12,12,0,113270.8,1359.167,88
"22680","69094","2018",86,40,46,284908.7,3187.884,91.67442
"22681","69095","2018",8,8,0,147711.2,1595.625,92.375
"22682","69096","2018",151,59,92,164725.5,2141.265,76.24503
"22683","69097","2018",3,3,0,124293.3,1105,105.3333
"22684","69098","2018",9,9,0,137355.6,1219.333,114.7778
"22685","69099","2018",18,18,0,133996.1,1337.667,103.5556
"22686","69100","2018",88,42,46,254692,2786.625,90.20455
"22687","69102","2018",8,8,0,180750,1601.625,112.5
"22688","69103","2018",11,11,0,160637.3,1510.909,113.8182
"22689","69104","2018",3,3,0,184316.7,1702.333,109.6667
"22690","69105","2018",15,15,0,301328,3465.267,107.8667
"22691","69106","2018",8,7,1,413038.1,2825,152
"22692","69107","2018",4,4,0,152029.5,1611.75,101
"22693","69108","2018",18,15,3,235924.4,2221.056,107.2778
"22694","69109","2018",10,10,0,220780,1886.1,114.1
"22695","69110","2018",20,18,2,198365.5,1769.05,113.05
"22696","69111","2018",6,5,1,206660,2040.333,112.1667
"22697","69112","2018",78,47,31,327473.5,3254.718,103.3718
"22698","69113","2018",5,5,0,143400,1797.8,74.2
"22699","69115","2018",50,33,17,239950.3,2515.26,95.12
"22700","69116","2018",41,30,11,489287.4,3849.39,129.122
"22701","69117","2018",38,29,9,337662.1,2919.105,112.8947
"22702","69118","2018",27,19,8,193340.6,2242.926,91.81481
"22703","69119","2018",8,8,0,202842.5,2177.625,105.75
"22704","69120","2018",4,4,0,199050,1409.75,129.5
"22705","69121","2018",41,24,17,261156.6,2837.341,90.34146
"22706","69122","2018",32,21,11,265271.9,2718.531,102.5
"22707","69123","2018",7643,203,7440,267865.9,4026.96,67.17362
"22708","69124","2018",10,10,0,171700,1539.4,102.1
"22709","69125","2018",25,16,9,295520.6,2959.68,98.4
"22710","69126","2018",8,8,0,296200,2788.75,107.25
"22711","69127","2018",32,22,10,411223.9,3687.906,113.8438
"22712","69130","2018",2,2,0,110000,2287.5,54
"22713","69131","2018",29,22,7,299154.8,3127.621,98.62069
"22714","69132","2018",4,4,0,128375,1242,100.25
"22715","69134","2018",1,1,0,425000,2530,168
"22716","69135","2018",15,12,3,106994.4,972.6667,110.0667
"22717","69136","2018",25,25,0,329817.1,3135.84,106.68
"22718","69137","2018",7,6,1,219457.1,1878.857,124.5714
"22719","69138","2018",4,4,0,225725,1521.75,158
"22720","69139","2018",17,15,2,198906.5,1929.941,102.9412
"22721","69140","2018",26,24,2,339801.2,2931.846,114.9615
"22722","69141","2018",72,43,29,279378,2740.458,104.3194
"22723","69142","2018",123,11,112,214025.8,2775.797,70.47154
"22724","69143","2018",92,25,67,208718,2581.348,79.22826
"22725","69145","2018",13,12,1,186822.7,1812.462,106.3077
"22726","69148","2018",30,23,7,331052.7,3178.633,105.3667
"22727","69149","2018",410,67,343,195465.6,2736.417,71.28537
"22728","69151","2018",11,11,0,179376.1,2040.636,88.18182
"22729","69152","2018",104,28,76,194827,2593.827,73.04808
"22730","69153","2018",14,13,1,605462.5,4038.643,153.0714
"22731","69154","2018",48,26,22,286541.4,3090.562,91.4375
"22732","69155","2018",9,9,0,202372.2,1890.444,109.2222
"22733","69156","2018",25,19,6,432474.2,3194.56,127.68
"22734","69157","2018",33,26,7,246237.3,2324.303,108.2424
"22735","69159","2018",28,24,4,278069.5,2265.571,122.6071
"22736","69160","2018",17,17,0,112348.2,1145.235,98.35294
"22737","69161","2018",7,7,0,101727.1,1276.571,85.42857
"22738","69162","2018",12,12,0,200527.5,2080.667,99.25
"22739","69163","2018",30,23,7,296089.3,3155.233,95.23333
"22740","69164","2018",2,2,0,110650,1397,86
"22741","69165","2018",9,9,0,216244.4,1602.556,140
"22742","69166","2018",1,1,0,75000,1087,69
"22743","69167","2018",5,5,0,211040,1785.4,112.8
"22744","69168","2018",25,16,9,361420.3,3393.12,105.16
"22745","69169","2018",7,7,0,174337,1662.286,107.2857
"22746","69170","2018",14,13,1,288124.3,2882.357,101.3571
"22747","69171","2018",26,17,9,194703.7,2306.654,87.38462
"22748","69172","2018",7,5,2,250841.4,1972.714,128.8571
"22749","69173","2018",13,8,5,190652.3,2312.462,86.61538
"22750","69174","2018",6,6,0,152938.3,1333.333,134.3333
"22751","69175","2018",15,14,1,255616,2676.267,95.33333
"22752","69176","2018",44,30,14,284386,2932.523,97.22727
"22753","69177","2018",30,27,3,321592.8,2677.433,122.1667
"22754","69178","2018",5,5,0,158100,1915.8,89.8
"22755","69179","2018",39,35,4,300061.3,2856.051,108.1795
"22756","69180","2018",3,3,0,176646.7,2012.333,84
"22757","69181","2018",2,2,0,130750,1134,102
"22758","69182","2018",3,3,0,131200,915.6667,140.3333
"22759","69183","2018",3,3,0,122333.3,1356.667,90
"22760","69184","2018",16,15,1,195398.1,1864.5,106.4375
"22761","69186","2018",3,3,0,73000,1048.333,70
"22762","69187","2018",4,4,0,134850,1283,106.5
"22763","69188","2018",7,7,0,125974,1643,75.28571
"22764","69189","2018",42,10,32,195197.1,2392.667,80.2619
"22765","69190","2018",27,17,10,319106.7,3386.519,95.62963
"22766","69191","2018",73,46,27,558240.2,4638.137,119.6986
"22767","69192","2018",1,1,0,170000,1667,102
"22768","69193","2018",16,15,1,328617.8,2869.438,117.125
"22769","69194","2018",103,68,35,623411.3,4650.146,135.5146
"22770","69196","2018",12,10,2,143709.2,1437.333,95.91667
"22771","69197","2018",16,16,0,210228.3,2157.5,97.9375
"22772","69198","2018",14,14,0,228042.1,2215.643,109.2857
"22773","69199","2018",131,42,89,154209.3,2218.916,71.16031
"22774","69200","2018",14,12,2,178721.4,1679.857,103.5714
"22775","69201","2018",13,9,4,150724.2,1772.692,91.07692
"22776","69202","2018",352,63,289,291914.5,3208.088,87.00284
"22777","69203","2018",13,12,1,173938.5,1692.923,108.7692
"22778","69204","2018",269,112,157,292600.1,3206.985,87.33086
"22779","69205","2018",62,44,18,328209.4,3572,94.43548
"22780","69206","2018",53,47,6,217348.1,2097.396,106.1698
"22781","69207","2018",39,27,12,337566,3212.128,107.8462
"22782","69208","2018",13,12,1,293364.2,2493.923,121.4615
"22783","69209","2018",4,4,0,81487.5,1048,83.75
"22784","69212","2018",3,3,0,263791.7,2728,87.33333
"22785","69214","2018",17,17,0,161652.9,1391.412,118.5882
"22786","69215","2018",10,10,0,260985,2380.7,122.9
"22787","69216","2018",6,6,0,206150,1814.833,121
"22788","69217","2018",16,16,0,136305.6,1282.625,104.5
"22789","69218","2018",10,10,0,159935,1818.2,88.8
"22790","69219","2018",27,22,5,284555.8,2760.852,110.6296
"22791","69220","2018",26,23,3,145638.9,1648.192,97
"22792","69225","2018",6,6,0,247375,2201.167,112.6667
"22793","69227","2018",38,35,3,244251.7,2263.263,112.4211
"22794","69228","2018",40,32,8,233931.3,2203.9,107.325
"22795","69229","2018",9,9,0,137188.9,1423.889,97
"22796","69230","2018",4,4,0,225000,2201.25,101.5
"22797","69231","2018",41,30,11,236271.5,2275.756,103.8049
"22798","69233","2018",16,13,3,410888.1,3556.375,113.4375
"22799","69234","2018",15,15,0,199702.7,2134.867,93.4
"22800","69235","2018",21,12,9,212983.3,2123.476,101.9524
"22801","69236","2018",10,10,0,213832,2117.5,107.7
"22802","69238","2018",50,31,19,160902.2,1866.76,86.92
"22803","69239","2018",8,8,0,231034.4,1911.75,123
"22804","69240","2018",12,12,0,83787.5,858.6667,102.1667
"22805","69241","2018",36,29,7,323973.6,3209.278,103.8333
"22806","69242","2018",9,9,0,230764.4,2346.667,99.77778
"22807","69243","2018",109,32,77,112477.7,1342.45,84.74312
"22808","69244","2018",423,69,354,297971.4,3489.454,82.8156
"22809","69245","2018",7,5,2,146554.3,1915,70.71429
"22810","69246","2018",11,10,1,282196.7,2309.182,121.3636
"22811","69248","2018",46,39,7,124281.1,1299.326,102.1739
"22812","69249","2018",29,24,5,232482.8,2627.828,88.13793
"22813","69250","2018",56,45,11,392059.9,3526.589,114.25
"22814","69252","2018",8,7,1,191300.6,2004.375,96
"22815","69253","2018",6,4,2,176353.3,1938.167,94.33333
"22816","69254","2018",9,9,0,172578.9,1742.222,101.8889
"22817","69255","2018",49,32,17,272756.4,2881.245,95.67347
"22818","69256","2018",385,106,279,155354.1,2206.055,71.28831
"22819","69257","2018",21,20,1,223731.7,2004.19,114.8095
"22820","69258","2018",4,4,0,119875,1224.5,96.5
"22821","69259","2018",466,101,365,158314.1,2208.601,72.28326
"22822","69260","2018",54,36,18,316260.7,3195.426,105.0741
"22823","69263","2018",17,16,1,149911.8,1363.765,117.1176
"22824","69264","2018",571,78,493,140932.1,1983.877,71.57618
"22825","69265","2018",10,9,1,352840.5,3009.4,139.5
"22826","69266","2018",2478,140,2338,189717,3018.174,63.98749
"22827","69267","2018",18,16,2,186521.9,1855.667,100.6667
"22828","69268","2018",42,27,15,423542.1,3728.571,116.4524
"22829","69269","2018",11,10,1,205050,2320.545,97.81818
"22830","69270","2018",40,27,13,333716.8,3093.725,107.65
"22831","69271","2018",108,69,39,363641.2,3656.046,101.3519
"22832","69272","2018",45,36,9,325581.8,3230.578,100.3111
"22833","69273","2018",108,58,50,224060.9,2746.713,80.73148
"22834","69275","2018",362,109,253,207460.5,2752.11,75.79006
"22835","69276","2018",98,49,49,204037.4,2555.327,80.22449
"22836","69277","2018",132,103,29,390957.7,3755.939,105.4924
"22837","69278","2018",66,38,28,282603.3,2915.455,95.81818
"22838","69279","2018",60,53,7,294257.2,2951.25,103.45
"22839","69280","2018",14,12,2,232360,2529.5,94.64286
"22840","69281","2018",36,14,22,290713.9,3145.333,90.97222
"22841","69282","2018",379,231,148,265443,3194.789,83.87071
"22842","69283","2018",120,81,39,266997.1,3095.458,89.05
"22843","69284","2018",31,26,5,401252.9,3438.355,116.7097
"22844","69285","2018",49,42,7,312356.3,3151,101.9388
"22845","69286","2018",274,101,173,240564.5,2552.04,92.47445
"22846","69287","2018",58,35,23,283310,2973.431,98.82759
"22847","69288","2018",66,52,14,288415,3036.788,97.16667
"22848","69289","2018",57,45,12,278326.4,3168.754,88.84211
"22849","69290","2018",557,126,431,190811.1,2468.054,77.70197
"22850","69291","2018",61,30,31,248887.6,2872.738,89.14754
"22851","69292","2018",64,8,56,223184.8,2967.891,76.04688
"22852","69293","2018",17,12,5,439675,4064,119.1765
"22853","69294","2018",44,20,24,244985.5,2952.409,84.79545
"22854","69295","2018",19,11,8,297159.5,3381.368,90.42105
"22855","69296","2018",37,28,9,315305.7,3047.405,106.2703
"22856","69297","2018",61,39,22,271728.2,2924.328,92.7377
"22857","69298","2018",20,15,5,342045,3359.05,100.35
"22858","69299","2018",18,17,1,318958.6,3074.667,116.0556
"22859","70001","2018",1,1,0,125600,1532,82
"22860","70002","2018",2,2,0,71700,1098.5,69
"22861","70004","2018",2,2,0,152500,1346,114
"22862","70005","2018",1,1,0,75000,1190,63
"22863","70006","2018",10,10,0,90180,857.5,111.2
"22864","70007","2018",2,2,0,153500,1489,103.5
"22865","70008","2018",4,4,0,99625,962,103.5
"22866","70009","2018",2,2,0,95000,747,115.5
"22867","70011","2018",3,3,0,101266.7,1071.333,96.33333
"22868","70012","2018",7,6,1,102828.6,1044,99.14286
"22869","70013","2018",2,2,0,71500,768.5,110.5
"22870","70015","2018",1,1,0,37740,490,77
"22871","70016","2018",3,3,0,106036.7,1202.333,84
"22872","70017","2018",1,1,0,229000,2663,86
"22873","70018","2018",4,4,0,112230,928.5,122.25
"22874","70019","2018",1,1,0,170000,944,180
"22875","70020","2018",1,1,0,40000,500,80
"22876","70022","2018",1,1,0,101000,1403,72
"22877","70023","2018",4,4,0,65750,611,113
"22878","70024","2018",4,4,0,64750,665.75,105.75
"22879","70025","2018",1,1,0,92500,771,120
"22880","70026","2018",19,16,3,99857.89,915.1579,110.7895
"22881","70027","2018",1,1,0,66580,605,110
"22882","70028","2018",5,5,0,104196,958.4,105.8
"22883","70029","2018",4,4,0,121312.5,780.25,202
"22884","70031","2018",6,6,0,128708.3,1177.667,114.1667
"22885","70036","2018",3,3,0,198750,1659,123.6667
"22886","70037","2018",5,5,0,101280,1300.8,99.4
"22887","70038","2018",3,3,0,103006.7,1139.333,93.33333
"22888","70039","2018",5,5,0,141180,1331.8,118
"22889","70040","2018",5,5,0,114750,1108,105.8
"22890","70041","2018",8,8,0,134543.8,1293.625,105.625
"22891","70042","2018",1,1,0,85200,741,115
"22892","70044","2018",3,3,0,136766.7,1330.333,115.3333
"22893","70045","2018",5,4,1,80506,1230.8,71.2
"22894","70046","2018",4,4,0,122621,1330.5,93.75
"22895","70047","2018",1,1,0,122200,1358,90
"22896","70048","2018",6,6,0,149700,1524.833,102.1667
"22897","70049","2018",1,1,0,60000,667,90
"22898","70051","2018",1,1,0,75000,714,105
"22899","70052","2018",1,1,0,44000,454,97
"22900","70053","2018",2,2,0,1e+05,1006,101
"22901","70054","2018",1,1,0,116000,725,160
"22902","70055","2018",1,1,0,85000,625,136
"22903","70056","2018",2,2,0,80000,739,106.5
"22904","70057","2018",1,1,0,150000,1500,100
"22905","70058","2018",7,7,0,79007.14,792.4286,100.4286
"22906","70059","2018",2,2,0,161500,1609,100.5
"22907","70060","2018",2,2,0,155500,1413,113
"22908","70061","2018",2,2,0,98000,1283.5,85
"22909","70062","2018",1,1,0,125000,1078,116
"22910","70063","2018",1,1,0,35000,700,50
"22911","70064","2018",2,2,0,110000,1114.5,132
"22912","70065","2018",2,2,0,58000,470.5,124.5
"22913","70066","2018",2,2,0,249500,1328,184
"22914","70067","2018",1,1,0,143300,1194,120
"22915","70069","2018",1,1,0,75000,798,94
"22916","70070","2018",1,1,0,113155,531,213
"22917","70074","2018",2,2,0,38750,510.5,70
"22918","70075","2018",3,3,0,191033.3,1855.333,104
"22919","70076","2018",3,3,0,174300,1450.333,118.6667
"22920","70077","2018",4,4,0,81625,925.75,83.5
"22921","70078","2018",1,1,0,60000,508,118
"22922","70079","2018",1,1,0,144000,1029,140
"22923","70081","2018",1,1,0,109000,1730,63
"22924","70083","2018",9,9,0,99333.33,1190.111,100.4444
"22925","70084","2018",9,9,0,188922.2,1509.444,119.4444
"22926","70085","2018",1,0,1,176500,1471,120
"22927","70087","2018",1,1,0,181660,1075,169
"22928","70088","2018",2,2,0,112500,747.5,150
"22929","70089","2018",2,2,0,56237.5,647,87.5
"22930","70090","2018",2,0,2,68525,956,74.5
"22931","70091","2018",2,2,0,64000,759.5,88.5
"22932","70092","2018",3,3,0,187466.7,1661.333,103.6667
"22933","70093","2018",9,8,1,85666.67,1000.556,82.22222
"22934","70094","2018",1,1,0,31110,479,65
"22935","70095","2018",7,7,0,127928.6,1002.571,130.2857
"22936","70096","2018",8,7,1,167262.5,1531.5,117.75
"22937","70097","2018",3,3,0,66600,824.6667,87.33333
"22938","70099","2018",1,1,0,95300,794,120
"22939","70100","2018",1,1,0,73000,811,90
"22940","70101","2018",7,7,0,84142.86,788.5714,102.4286
"22941","70102","2018",5,5,0,200264,1520.6,151.4
"22942","70103","2018",1,1,0,144000,1600,90
"22943","70104","2018",6,6,0,79583.33,831.1667,92.83333
"22944","70107","2018",4,4,0,189487.5,1237.25,162
"22945","70109","2018",4,4,0,155761.2,1584.5,100.5
"22946","70111","2018",4,4,0,113517.5,888.75,125
"22947","70112","2018",2,2,0,104150,698.5,144.5
"22948","70113","2018",2,2,0,107500,987,104.5
"22949","70114","2018",1,1,0,126000,783,161
"22950","70115","2018",2,2,0,140000,1038,135.5
"22951","70116","2018",5,4,1,104758,1110.4,101.2
"22952","70117","2018",14,13,1,181399.3,1472.786,125.6429
"22953","70119","2018",6,6,0,169766.7,1366.167,123.1667
"22954","70120","2018",34,32,2,145907.4,1338.529,108.3529
"22955","70121","2018",6,6,0,145169,1291.5,121.3333
"22956","70122","2018",12,12,0,101998.3,779.5,122.6667
"22957","70125","2018",2,2,0,88000,923,107
"22958","70126","2018",1,1,0,106400,507,210
"22959","70128","2018",1,1,0,175000,1241,141
"22960","70129","2018",2,2,0,89722.5,1144,72
"22961","70130","2018",2,2,0,150280,1622,94.5
"22962","70132","2018",4,4,0,80750,942.5,85.75
"22963","70133","2018",5,5,0,85880,1031.2,84.6
"22964","70136","2018",2,2,0,221350,1593.5,138
"22965","70141","2018",3,3,0,51666.67,409.6667,126.3333
"22966","70142","2018",1,1,0,115000,821,140
"22967","70143","2018",1,1,0,99000,990,100
"22968","70145","2018",3,3,0,260386.7,1709.667,150
"22969","70147","2018",3,3,0,131583.3,1160.333,131
"22970","70148","2018",2,2,0,192000,2185.5,92.5
"22971","70149","2018",3,3,0,146500,1137.667,129
"22972","70150","2018",3,3,0,218533.3,1706.667,127.6667
"22973","70151","2018",1,1,0,65000,823,79
"22974","70152","2018",4,4,0,79185,598,134.75
"22975","70154","2018",1,1,0,80000,833,96
"22976","70155","2018",11,11,0,128946.8,1172.273,112.6364
"22977","70157","2018",8,8,0,136831.2,1222.5,111.875
"22978","70158","2018",1,1,0,89000,1047,85
"22979","70160","2018",1,1,0,135000,1216,111
"22980","70162","2018",9,9,0,164447.9,1179.111,137.6667
"22981","70163","2018",4,4,0,159350,1589.25,97.25
"22982","70165","2018",4,4,0,84300,1221.25,74.75
"22983","70167","2018",5,5,0,100400,1050.6,98
"22984","70168","2018",4,4,0,96037.5,787.25,95
"22985","70169","2018",4,4,0,81450,730.25,109
"22986","70171","2018",7,6,1,53242.86,619.5714,88.42857
"22987","70174","2018",1,1,0,40000,500,80
"22988","70175","2018",2,2,0,45750,433.5,105.5
"22989","70176","2018",2,2,0,52000,518.5,99.5
"22990","70177","2018",3,3,0,70000,742.3333,88.33333
"22991","70178","2018",8,8,0,152237.5,1654.75,120.25
"22992","70179","2018",3,3,0,74833.33,796,92.66667
"22993","70180","2018",5,5,0,95501,769.8,126.6
"22994","70182","2018",2,2,0,156000,1292.5,115
"22995","70184","2018",7,4,3,109200,1363.286,73.57143
"22996","70185","2018",3,3,0,89200,734.6667,110.3333
"22997","70186","2018",3,3,0,74333.33,654.3333,117.6667
"22998","70189","2018",1,1,0,139330,2284,61
"22999","70190","2018",1,1,0,93000,989,94
"23000","70193","2018",1,1,0,145000,1480,98
"23001","70195","2018",4,4,0,73625,939,89
"23002","70196","2018",3,3,0,110336.7,1161,93.33333
"23003","70197","2018",8,8,0,115300,915.625,117.125
"23004","70198","2018",6,6,0,94266.67,887.5,114.8333
"23005","70199","2018",2,2,0,101000,1363.5,85
"23006","70200","2018",2,2,0,131600,936,141.5
"23007","70201","2018",3,3,0,102000,928.3333,105
"23008","70206","2018",4,4,0,153750,1607.5,107.25
"23009","70207","2018",42,39,3,127587.9,1459.357,92.2619
"23010","70208","2018",3,3,0,68811,885,64.66667
"23011","70211","2018",3,3,0,104166.7,942.6667,114.6667
"23012","70213","2018",3,2,1,163666.7,1013.667,171
"23013","70215","2018",4,4,0,233755,1725.5,163.25
"23014","70216","2018",4,4,0,128907.5,1208.75,106.75
"23015","70217","2018",2,2,0,123500,766,148
"23016","70218","2018",1,1,0,190000,1086,175
"23017","70219","2018",12,11,1,111529.2,1042.417,108.75
"23018","70220","2018",4,4,0,111125,1518.5,78
"23019","70221","2018",4,4,0,147250,1286.25,117.75
"23020","70222","2018",1,1,0,29000,537,54
"23021","70224","2018",7,4,3,188728.6,1946.429,99
"23022","70225","2018",1,1,0,80000,667,120
"23023","70226","2018",1,1,0,70500,881,80
"23024","70227","2018",4,4,0,100747.5,857.5,127.25
"23025","70228","2018",15,14,1,99700,936.4,110.6667
"23026","70229","2018",3,3,0,131666.7,1065,135
"23027","70230","2018",3,3,0,71000,633.3333,151.3333
"23028","70233","2018",3,3,0,68333.33,1245.667,59.33333
"23029","70234","2018",4,4,0,112500,1257.75,136.75
"23030","70235","2018",2,2,0,97000,934,102.5
"23031","70236","2018",1,1,0,91000,538,169
"23032","70238","2018",1,1,0,88250,949,93
"23033","70239","2018",2,2,0,92500,1344.5,115
"23034","70240","2018",9,9,0,104468.9,1224.778,97.11111
"23035","70242","2018",1,1,0,38500,464,83
"23036","70244","2018",2,2,0,139800,890,157.5
"23037","70245","2018",34,32,2,100306.6,979.8824,108.4118
"23038","70247","2018",2,2,0,99100,846,107.5
"23039","70248","2018",5,5,0,90400,1967.6,42.8
"23040","70249","2018",1,1,0,50000,397,126
"23041","70250","2018",3,3,0,184666.7,1410.667,125.6667
"23042","70252","2018",2,2,0,49500,762.5,61
"23043","70253","2018",2,1,1,74000,937,78.5
"23044","70254","2018",5,5,0,103200,919,103.4
"23045","70255","2018",5,5,0,81040,971.8,81.4
"23046","70256","2018",9,9,0,96266.67,738.5556,130.5556
"23047","70257","2018",6,5,1,104996.7,1228.667,85.33333
"23048","70258","2018",18,17,1,107813.3,1082.167,101.2778
"23049","70259","2018",3,3,0,111500,1182.667,93.66667
"23050","70260","2018",4,4,0,155750,1435.25,109
"23051","70261","2018",26,24,2,133901.2,1308.885,99.73077
"23052","70262","2018",1,1,0,128500,988,130
"23053","70263","2018",1,1,0,20000,333,60
"23054","70265","2018",2,2,0,120770,877.5,138
"23055","70267","2018",7,7,0,134607.1,903.5714,153.2857
"23056","70268","2018",1,1,0,1e+05,769,130
"23057","70269","2018",1,1,0,95000,760,125
"23058","70271","2018",3,3,0,102833.3,1090,94.33333
"23059","70272","2018",3,3,0,56880,670.3333,93.66667
"23060","70273","2018",1,1,0,85000,582,146
"23061","70275","2018",9,9,0,119388.9,1063.444,112
"23062","70276","2018",1,1,0,144000,2000,72
"23063","70277","2018",2,2,0,162000,1140,142
"23064","70278","2018",1,1,0,150000,1875,80
"23065","70279","2018",36,22,14,85631.94,925.75,97.02778
"23066","70280","2018",10,10,0,95783.7,968.4,97.2
"23067","70282","2018",7,6,1,129850,1097.143,115.5714
"23068","70283","2018",7,6,1,85160.14,981.2857,89.57143
"23069","70284","2018",3,3,0,121583.3,1188.333,102
"23070","70285","2018",109,76,33,115816.7,1428.89,84.58716
"23071","70289","2018",2,2,0,96500,1057,96.5
"23072","70290","2018",1,1,0,70000,1077,65
"23073","70292","2018",15,13,2,75126.67,793.8667,92.2
"23074","70293","2018",1,1,0,119000,992,120
"23075","70294","2018",3,3,0,112633.3,990,115
"23076","70295","2018",1,1,0,80600,937,86
"23077","70296","2018",3,3,0,190966.7,1642,118
"23078","70297","2018",2,2,0,95500,574,158.5
"23079","70298","2018",5,5,0,64010,592.6,110.4
"23080","70299","2018",3,3,0,100500,914.6667,105.3333
"23081","70303","2018",1,1,0,140000,1129,124
"23082","70306","2018",7,7,0,152757.1,1407.714,107.2857
"23083","70308","2018",3,3,0,60666.67,634,103.3333
"23084","70309","2018",4,4,0,161250,1379.5,117
"23085","70310","2018",69,48,21,97900.84,1137.217,91.94203
"23086","70311","2018",90,41,49,78032.88,873.4667,88.11111
"23087","70312","2018",6,6,0,207441.7,2170.333,96.33333
"23088","70313","2018",6,6,0,148470.8,1550.5,96.5
"23089","70314","2018",1,1,0,45000,577,78
"23090","70315","2018",5,5,0,79000,796.6,95.6
"23091","70316","2018",1,1,0,90000,647,139
"23092","70317","2018",2,2,0,101000,1053,95
"23093","70318","2018",4,4,0,99975,1088.75,110.25
"23094","70319","2018",2,2,0,94000,2042,59
"23095","70320","2018",1,1,0,30000,361,83
"23096","70321","2018",9,9,0,129341.7,1288,102.7778
"23097","70322","2018",1,1,0,55000,611,90
"23098","70324","2018",8,7,1,102490.8,984.625,104.875
"23099","70326","2018",1,1,0,174000,1415,123
"23100","70327","2018",1,1,0,164260,1264,130
"23101","70328","2018",2,2,0,55000,537.5,96.5
"23102","70330","2018",2,2,0,302400,2411.5,131
"23103","70331","2018",6,6,0,76763.33,808.6667,98.5
"23104","70334","2018",16,14,2,149106.2,1497.688,97.375
"23105","70335","2018",1,1,0,280000,1556,180
"23106","70336","2018",2,2,0,74075,1024.5,75.5
"23107","70338","2018",2,2,0,63250,633.5,108
"23108","70339","2018",14,13,1,101628.6,966.2143,113.3571
"23109","70340","2018",1,1,0,37830,757,50
"23110","70341","2018",3,3,0,61100,682.3333,97
"23111","70342","2018",1,1,0,88000,1443,61
"23112","70343","2018",1,1,0,172950,1601,108
"23113","70344","2018",5,5,0,92600,849.8,104.6
"23114","70347","2018",3,3,0,79333.33,976.3333,81
"23115","70348","2018",7,7,0,110250,925.8571,112.4286
"23116","70349","2018",1,1,0,172000,1323,130
"23117","70350","2018",1,1,0,73600,398,185
"23118","70352","2018",1,1,0,1e+05,833,120
"23119","70353","2018",5,5,0,134472.8,1130.6,127
"23120","70355","2018",1,1,0,205000,1864,110
"23121","70356","2018",3,3,0,199150,1705,119.3333
"23122","70357","2018",6,5,1,66000,886,81
"23123","70360","2018",1,1,0,35000,337,104
"23124","70361","2018",1,1,0,45000,577,78
"23125","70363","2018",3,3,0,164166.7,1371,121.6667
"23126","70366","2018",2,2,0,1e+05,939.5,109.5
"23127","70368","2018",1,1,0,110000,705,156
"23128","70369","2018",1,1,0,65000,1083,60
"23129","70372","2018",3,3,0,56666.67,409.6667,132.6667
"23130","70373","2018",3,3,0,53948.33,556.6667,95.66667
"23131","70376","2018",4,4,0,222125,1079.25,192.75
"23132","70378","2018",28,19,9,121377.7,1196.643,97.64286
"23133","70381","2018",4,3,1,101437.5,845,119.5
"23134","70383","2018",3,3,0,156666.7,1697.333,82.66667
"23135","70384","2018",1,1,0,42000,525,80
"23136","70385","2018",4,4,0,88912.5,1180,85.75
"23137","70386","2018",1,1,0,77500,596,130
"23138","70387","2018",7,7,0,93650,1107,85
"23139","70388","2018",22,21,1,144188.2,1462.818,100.0455
"23140","70390","2018",5,5,0,97700,871.2,111.6
"23141","70393","2018",4,4,0,151227.5,1317,122.75
"23142","70397","2018",1,1,0,132500,1325,100
"23143","70400","2018",2,2,0,55000,578.5,102.5
"23144","70401","2018",2,2,0,91425,611.5,146
"23145","70402","2018",5,5,0,118400,1067.2,110.8
"23146","70404","2018",4,4,0,77000,772,104.75
"23147","70405","2018",2,1,1,98325,1013,95
"23148","70406","2018",2,2,0,67500,691.5,95
"23149","70408","2018",16,16,0,114410.6,1101.312,113.1875
"23150","70410","2018",6,5,1,134866.7,1547.5,87.33333
"23151","70412","2018",1,1,0,25000,333,75
"23152","70413","2018",24,24,0,122890.9,1505.833,85.20833
"23153","70414","2018",17,15,2,92417.65,967,96.05882
"23154","70415","2018",2,2,0,148500,1400,92.5
"23155","70417","2018",4,4,0,140675,1364.75,105
"23156","70418","2018",2,2,0,60000,478.5,123.5
"23157","70419","2018",3,3,0,69766.67,632.3333,106
"23158","70420","2018",3,3,0,118966.7,783.6667,147.6667
"23159","70421","2018",28,22,6,89008.93,971.5714,92
"23160","70422","2018",1,1,0,76000,661,115
"23161","70423","2018",2,2,0,107107,1275,84
"23162","70425","2018",2,2,0,210000,2149.5,96.5
"23163","70426","2018",2,2,0,163500,1460,128
"23164","70427","2018",4,4,0,70748.75,785.75,88.5
"23165","70428","2018",9,9,0,194350,1583.556,124.2222
"23166","70429","2018",7,7,0,158207.1,1556.714,102
"23167","70431","2018",1,1,0,188000,1880,100
"23168","70432","2018",1,1,0,64000,610,105
"23169","70433","2018",5,4,1,105800,1270.2,83.4
"23170","70435","2018",5,5,0,164520,1270,124.6
"23171","70436","2018",1,1,0,43000,457,94
"23172","70438","2018",2,2,0,139050,1153,120.5
"23173","70439","2018",2,2,0,97500,826.5,136
"23174","70440","2018",1,1,0,309830,1291,240
"23175","70441","2018",2,2,0,192500,1469,131
"23176","70442","2018",2,2,0,101500,978,107
"23177","70443","2018",2,2,0,70000,700,100
"23178","70444","2018",1,1,0,176400,767,230
"23179","70446","2018",4,4,0,122125,1054,119.25
"23180","70447","2018",21,19,2,187127.6,1788.19,108.8095
"23181","70449","2018",1,1,0,80000,842,95
"23182","70450","2018",1,1,0,50000,505,99
"23183","70451","2018",20,17,3,76505.1,888.15,89.2
"23184","70452","2018",2,2,0,137000,1483,93
"23185","70454","2018",1,1,0,25000,417,60
"23186","70455","2018",6,6,0,116325,1294.5,88.33333
"23187","70456","2018",2,2,0,163450,1601.5,103
"23188","70457","2018",2,2,0,82000,705,112
"23189","70459","2018",4,4,0,113475,1283.5,86.75
"23190","70460","2018",2,2,0,149000,1278,108
"23191","70464","2018",14,14,0,119167.9,1157.857,101.8571
"23192","70466","2018",1,1,0,22500,363,62
"23193","70467","2018",16,14,2,90006.25,913,105.9375
"23194","70469","2018",2,2,0,101200,758.5,130
"23195","70470","2018",2,2,0,143500,1196,120
"23196","70471","2018",1,1,0,85000,654,130
"23197","70472","2018",7,7,0,101250,1170.429,88.42857
"23198","70473","2018",22,21,1,85618.18,911.4545,93.54545
"23199","70474","2018",1,1,0,75000,393,191
"23200","70476","2018",2,2,0,76010,579.5,129.5
"23201","70477","2018",3,3,0,160166.7,1258.667,121
"23202","70478","2018",8,8,0,136100,1316.75,109.25
"23203","70479","2018",3,3,0,92666.67,1069.333,93.33333
"23204","70481","2018",2,2,0,53250,477,112
"23205","70482","2018",7,7,0,90714.29,905.8571,95.28571
"23206","70483","2018",1,1,0,218000,924,236
"23207","70484","2018",2,2,0,154000,1111.5,131
"23208","70485","2018",5,4,1,65000,687.6,98.6
"23209","70486","2018",1,1,0,48000,393,122
"23210","70487","2018",2,2,0,1e+05,1155.5,87
"23211","70488","2018",1,1,0,35000,389,90
"23212","70489","2018",10,10,0,87650,920.8,97.7
"23213","70490","2018",1,1,0,141000,1216,116
"23214","70491","2018",5,4,1,49000,521,96.4
"23215","70492","2018",5,5,0,131534,990.2,125
"23216","70493","2018",12,12,0,181175,1610.583,115.6667
"23217","70494","2018",3,3,0,106600,1017.333,101
"23218","70496","2018",1,1,0,146520,784,187
"23219","70498","2018",7,7,0,130285.7,888.8571,144.5714
"23220","70499","2018",2,2,0,135250,981,150
"23221","70500","2018",3,3,0,121416.7,883.6667,133
"23222","70502","2018",3,3,0,42666.67,450.6667,96
"23223","70503","2018",1,1,0,111500,907,123
"23224","70504","2018",3,3,0,36666.67,404.3333,89
"23225","70505","2018",4,4,0,135000,1315.25,103.5
"23226","70506","2018",3,2,1,118500,1163,101.3333
"23227","70507","2018",2,2,0,100240,828,120
"23228","70509","2018",3,3,0,137666.7,1141.667,115.3333
"23229","70510","2018",2,2,0,129022,1333.5,112.5
"23230","70511","2018",2,2,0,107000,679,162.5
"23231","70512","2018",2,2,0,145200,988.5,150
"23232","70513","2018",19,16,3,149305.3,1579.526,102.9474
"23233","70514","2018",5,4,1,112400,1269.8,93.4
"23234","70515","2018",2,2,0,171300,2288,100
"23235","70516","2018",1,1,0,280000,3111,90
"23236","70517","2018",9,9,0,153977.8,1279.889,123.5556
"23237","70518","2018",2,2,0,103200,967,109.5
"23238","70519","2018",1,1,0,165300,1945,85
"23239","70521","2018",1,1,0,116400,917,127
"23240","70524","2018",3,3,0,85333.33,882.3333,104.3333
"23241","70526","2018",7,7,0,83028.57,977.4286,83
"23242","70527","2018",1,1,0,197000,1407,140
"23243","70528","2018",3,3,0,142666.7,859.6667,177.6667
"23244","70529","2018",5,5,0,154526,1281.4,128.8
"23245","70530","2018",2,2,0,156500,852,187
"23246","70532","2018",8,8,0,140462.5,1119.5,127.625
"23247","70533","2018",2,2,0,157500,1262.5,140
"23248","70535","2018",1,1,0,55000,753,73
"23249","70536","2018",1,1,0,163300,1899,86
"23250","70537","2018",1,1,0,107000,823,130
"23251","70539","2018",1,1,0,65000,369,176
"23252","70540","2018",2,2,0,129300,1325.5,105
"23253","70541","2018",1,1,0,139000,2172,64
"23254","70545","2018",1,1,0,30000,500,60
"23255","70546","2018",1,1,0,50000,333,150
"23256","70547","2018",2,2,0,127500,1844,68.5
"23257","70548","2018",1,1,0,28500,419,68
"23258","70550","2018",211,69,142,93783.45,1177.043,79.47867
"23259","70552","2018",2,2,0,155700,1070.5,145.5
"23260","70554","2018",2,2,0,56750,595.5,95
"23261","70555","2018",3,3,0,109900,932.6667,127
"23262","70559","2018",3,3,0,124666.7,1439.333,89
"23263","70561","2018",15,14,1,133713.3,1179.133,115.2667
"23264","70563","2018",3,3,0,164500,1313.333,122.3333
"23265","70564","2018",7,6,1,88915.71,910.2857,103.5714
"23266","70566","2018",1,1,0,127000,941,135
"23267","70568","2018",1,1,0,42000,408,103
"23268","70572","2018",5,5,0,87000,864.4,100.2
"23269","70573","2018",1,1,0,50000,893,56
"23270","70575","2018",4,4,0,187750,1932.25,95.5
"23271","70577","2018",4,4,0,157750,1232.75,132
"23272","70579","2018",2,2,0,189587.5,1479.5,117.5
"23273","70580","2018",2,2,0,95500,901,102
"23274","70581","2018",6,6,0,135516.7,1056.667,126.5
"23275","70582","2018",2,2,0,133800,1049.5,131
"23276","70583","2018",1,1,0,180000,1176,153
"23277","71001","2018",6,6,0,155000,1185.833,117.3333
"23278","71002","2018",10,10,0,129030,1495,95
"23279","71003","2018",7,7,0,155314.3,1249.857,124.4286
"23280","71004","2018",12,12,0,196491.7,1595.167,125.0833
"23281","71005","2018",6,5,1,100083.3,1428,72
"23282","71006","2018",3,3,0,150033.3,1212,119.3333
"23283","71008","2018",2,2,0,98815,1040,91
"23284","71009","2018",17,17,0,77239.71,895,97.94118
"23285","71010","2018",8,8,0,87981.25,1010.875,89.375
"23286","71011","2018",4,4,0,123525,1240,102
"23287","71012","2018",7,7,0,104580,1071.857,107.8571
"23288","71013","2018",7,7,0,97542.86,923.1429,103.5714
"23289","71014","2018",113,65,48,102914,1133.168,91.84956
"23290","71015","2018",4,4,0,97600,1038.25,96.25
"23291","71016","2018",6,6,0,180305,1754.167,107
"23292","71017","2018",2,2,0,112080,923,137.5
"23293","71018","2018",9,9,0,196304.4,1850.556,119.7778
"23294","71019","2018",4,4,0,76500,980,73.75
"23295","71021","2018",3,3,0,98146.67,1433.667,69
"23296","71022","2018",9,9,0,141011.1,1265,112.2222
"23297","71023","2018",10,10,0,142130,1212.3,126.3
"23298","71024","2018",3,3,0,155082.3,1350,118.3333
"23299","71025","2018",8,7,1,100877.8,1069.875,96.375
"23300","71027","2018",10,10,0,146800,1352.3,109.6
"23301","71028","2018",4,4,0,110500,1243.5,91.75
"23302","71029","2018",4,4,0,103250,989.5,102.75
"23303","71030","2018",2,2,0,77500,1083.5,70
"23304","71032","2018",5,5,0,166730,1682,105.6
"23305","71033","2018",11,11,0,128468.2,1294.364,97.90909
"23306","71034","2018",1,1,0,230000,1345,171
"23307","71035","2018",2,2,0,179000,1892.5,98.5
"23308","71036","2018",3,3,0,88833.33,1216,71.66667
"23309","71037","2018",2,2,0,54600,1814.5,27
"23310","71039","2018",5,5,0,167881,2069,79
"23311","71040","2018",48,45,3,104541.3,1122.979,91.72917
"23312","71041","2018",3,3,0,105666.7,1313,81.33333
"23313","71042","2018",4,4,0,80562.5,1068,70.25
"23314","71043","2018",1,1,0,99139,1239,80
"23315","71044","2018",4,4,0,141250,1072,134
"23316","71045","2018",5,5,0,100600,1052.4,94.8
"23317","71046","2018",1,1,0,102000,962,106
"23318","71047","2018",57,52,5,79337.37,934.8772,85.22807
"23319","71048","2018",3,3,0,107666.7,1136.333,93.33333
"23320","71050","2018",3,3,0,132883.3,1337.667,103.3333
"23321","71051","2018",2,2,0,158000,2164,73.5
"23322","71052","2018",9,9,0,154155.6,1331.889,121
"23323","71054","2018",8,8,0,126062.5,1097.75,115.375
"23324","71056","2018",29,28,1,100213.8,1102,93.44828
"23325","71057","2018",2,2,0,309750,1326,214.5
"23326","71058","2018",2,2,0,160500,1305.5,127.5
"23327","71059","2018",31,30,1,121634.3,1211.032,100.6452
"23328","71060","2018",3,3,0,118666.7,1126.667,102.6667
"23329","71061","2018",10,10,0,128700,1284.3,103.4
"23330","71062","2018",5,5,0,105549.8,1198,90.2
"23331","71063","2018",7,7,0,133764.3,1191.714,101.7143
"23332","71064","2018",2,2,0,112750,1060.5,106
"23333","71065","2018",6,6,0,144000,1330,106.8333
"23334","71066","2018",2,2,0,183385,1935.5,94.5
"23335","71067","2018",4,4,0,83832.5,1200,67.25
"23336","71069","2018",7,6,1,151052.9,1709.143,85
"23337","71070","2018",21,19,2,139002.4,1131.286,125.0952
"23338","71071","2018",9,8,1,86277.78,767.3333,104.1111
"23339","71072","2018",1,1,0,136792,1487,92
"23340","71073","2018",52,42,10,146134,1541.5,95.11538
"23341","71074","2018",4,4,0,184962.5,1734.5,114.25
"23342","71075","2018",5,5,0,64000,751.4,86.6
"23343","71076","2018",658,111,547,94759.71,1219.526,76.01216
"23344","71077","2018",3,3,0,82666.67,767,110.6667
"23345","71078","2018",3,3,0,122833.3,1701.667,71
"23346","71079","2018",5,5,0,121050,1501.8,92.4
"23347","71081","2018",21,17,4,123861,1358,92.61905
"23348","71082","2018",1,1,0,88000,946,93
"23349","71084","2018",3,3,0,234466.7,2014,125.6667
"23350","71085","2018",2,2,0,125400,1885.5,69
"23351","71086","2018",2,2,0,122500,1179.5,105
"23352","71087","2018",4,4,0,136780,1741.25,82.25
"23353","71088","2018",2,2,0,109000,1244,88.5
"23354","71089","2018",7,7,0,145000,1465.571,97.85714
"23355","71090","2018",38,35,3,203647.9,1939.447,108.7895
"23356","71091","2018",2,2,0,194500,1360,142.5
"23357","71092","2018",8,8,0,120125,1333.625,98
"23358","71093","2018",11,11,0,122867.5,1004.273,123.3636
"23359","71094","2018",3,3,0,1e+05,1081.667,84.33333
"23360","71095","2018",3,3,0,100161,841.3333,122.6667
"23361","71097","2018",4,4,0,68288.75,758.5,83.5
"23362","71098","2018",3,3,0,59500,1075.333,53
"23363","71099","2018",2,2,0,275500,1737.5,159.5
"23364","71100","2018",3,3,0,293333.3,3268.667,106.3333
"23365","71101","2018",4,3,1,74750.25,974,72.75
"23366","71102","2018",6,6,0,176495,1470.833,132.5
"23367","71103","2018",1,1,0,207561,2531,82
"23368","71104","2018",3,3,0,88666.67,870,115.3333
"23369","71105","2018",120,61,59,161086.7,1790.267,88.53333
"23370","71106","2018",29,27,2,101625.2,987.2414,105.9655
"23371","71107","2018",7,7,0,95178.57,1007.714,91.57143
"23372","71109","2018",7,7,0,125714.3,1640.143,85.71429
"23373","71110","2018",7,7,0,97214.29,944.1429,115.5714
"23374","71111","2018",4,4,0,131742.5,914.75,129
"23375","71112","2018",3,3,0,172666.7,1293,124.6667
"23376","71115","2018",1,1,0,140000,778,180
"23377","71116","2018",1,1,0,108500,662,164
"23378","71117","2018",7,6,1,153192.9,1611.143,101.8571
"23379","71118","2018",75,60,15,146920.9,1660.507,90.37333
"23380","71119","2018",10,10,0,148822,1388.9,107.1
"23381","71120","2018",49,43,6,101138.2,1092.286,93.65306
"23382","71121","2018",7,7,0,102214.3,999.4286,100.4286
"23383","71122","2018",4,4,0,181700,1855.25,103.5
"23384","71123","2018",2,2,0,52500,599.5,89
"23385","71124","2018",5,5,0,168180.6,1496.6,100.6
"23386","71126","2018",10,10,0,310632,2335.6,128.3
"23387","71127","2018",2,2,0,121000,1321.5,95
"23388","71128","2018",1,1,0,97280,1390,70
"23389","71129","2018",7,7,0,62857.14,906.7143,71
"23390","71130","2018",6,6,0,102511.5,1094.333,88.5
"23391","71131","2018",3,3,0,90333.33,1149,83
"23392","71132","2018",21,21,0,107051.4,1072.857,98.85714
"23393","71133","2018",19,15,4,93516.84,1025.842,93.26316
"23394","71134","2018",6,6,0,107918.3,1166.5,96
"23395","71135","2018",6,6,0,174438.3,1779.667,105.1667
"23396","71136","2018",4,4,0,105250,1253.75,79
"23397","71137","2018",45,37,8,164268,1760.956,93.84444
"23398","71139","2018",2,2,0,97800,1170,83
"23399","71141","2018",1,1,0,139000,1829,76
"23400","71142","2018",3,3,0,116500,968.3333,109.6667
"23401","71143","2018",3,3,0,83666.67,943,89.66667
"23402","71144","2018",1,1,0,95000,950,100
"23403","71145","2018",4,4,0,95116.25,1430.75,71.75
"23404","71146","2018",4,4,0,84800,888.25,95.5
"23405","71147","2018",3,3,0,134333.3,1369.667,93.33333
"23406","71148","2018",11,11,0,95537.27,1017,94.36364
"23407","71149","2018",12,12,0,102170,1296.25,73.83333
"23408","71150","2018",36,27,9,182035.5,1889.5,98.44444
"23409","71151","2018",3,3,0,81833.33,764,107.6667
"23410","71153","2018",172,106,66,93808.47,1166.436,79.44186
"23411","71154","2018",28,27,1,155906.6,1659.929,95.32143
"23412","71155","2018",3,3,0,56416.67,530.6667,106.6667
"23413","71156","2018",3,3,0,195410,1384.667,154
"23414","71157","2018",20,19,1,122910,1250.65,106.8
"23415","71158","2018",25,22,3,129672.2,1340.12,97.64
"23416","71159","2018",4,4,0,116925,1226.25,111.5
"23417","71160","2018",2,2,0,94000,858.5,109.5
"23418","71161","2018",3,3,0,81000,816,93.33333
"23419","71162","2018",11,11,0,111280.5,1226,90.72727
"23420","71164","2018",3,3,0,92333.33,810.3333,100
"23421","71165","2018",8,8,0,83337.5,858.25,93.125
"23422","71167","2018",4,4,0,145275,1086.25,133
"23423","71168","2018",5,5,0,177650,1243.4,129.6
"23424","71169","2018",4,4,0,224850,2190.25,107.5
"23425","71170","2018",28,28,0,176360.7,1499.929,121.0714
"23426","71171","2018",1,1,0,86000,860,100
"23427","71172","2018",3,3,0,91416.67,961.3333,95
"23428","71173","2018",4,4,0,128351,1320.25,101.5
"23429","71174","2018",2,2,0,129500,1322.5,101.5
"23430","71175","2018",4,4,0,1e+05,1242.75,79.25
"23431","71176","2018",60,38,22,89286.63,940.2333,95.95
"23432","71177","2018",11,11,0,115245.5,1255.727,91.36364
"23433","71178","2018",13,13,0,125936.8,1259.231,101.7692
"23434","71181","2018",2,2,0,215250,1337.5,165
"23435","71182","2018",15,15,0,280980.9,2304.267,117.6667
"23436","71183","2018",3,3,0,97283.33,978.3333,93
"23437","71184","2018",6,6,0,107530,1186.333,91.33333
"23438","71185","2018",7,7,0,97500,927.5714,102.5714
"23439","71186","2018",2,2,0,105500,706,144.5
"23440","71187","2018",20,18,2,102419.5,1177.2,86.95
"23441","71188","2018",2,2,0,88000,1185.5,72.5
"23442","71189","2018",14,14,0,176567.1,1639.357,110.5
"23443","71190","2018",17,14,3,105235.3,1166.824,92.23529
"23444","71191","2018",2,2,0,171550,1474.5,113
"23445","71192","2018",19,19,0,103560.3,1126.053,90.63158
"23446","71193","2018",5,5,0,230708,1779,120.4
"23447","71194","2018",8,8,0,216680.6,1584.75,140.625
"23448","71195","2018",3,3,0,131333.3,1577.667,80
"23449","71196","2018",8,8,0,92731.25,1097.25,82.875
"23450","71198","2018",5,5,0,129000,1223.2,116.2
"23451","71199","2018",6,6,0,106583.3,1161.167,88.66667
"23452","71200","2018",7,7,0,81428.57,753.4286,104.5714
"23453","71201","2018",4,4,0,174212.5,1985.5,84.5
"23454","71202","2018",17,17,0,129945.3,1312.471,96.58824
"23455","71203","2018",1,1,0,208000,1793,116
"23456","71204","2018",11,11,0,189113.7,1726.364,109.9091
"23457","71205","2018",13,13,0,104166.9,1089.846,97.61538
"23458","71206","2018",2,2,0,175000,843,205
"23459","71207","2018",3,3,0,144666.7,1247.333,130.6667
"23460","71208","2018",3,3,0,109966.7,1154.333,112.3333
"23461","71209","2018",8,8,0,91850,1149.875,82.125
"23462","71210","2018",5,5,0,166830,1722.6,105.4
"23463","71212","2018",7,7,0,97260.57,995.7143,95.71429
"23464","71213","2018",6,6,0,102166.7,1342,78.83333
"23465","71214","2018",4,4,0,110100,995.5,112.25
"23466","71215","2018",2,2,0,78100,1270,93
"23467","71216","2018",5,5,0,86640,1277.6,81.4
"23468","71217","2018",1,1,0,25000,391,64
"23469","71218","2018",8,8,0,102206.2,1238.25,85.375
"23470","71219","2018",5,5,0,136940,1279.2,108.4
"23471","71220","2018",7,7,0,73714.29,902.1429,81.14286
"23472","71221","2018",42,39,3,222016,1878.024,116.6905
"23473","71222","2018",8,8,0,171427.8,1326.875,130.125
"23474","71223","2018",7,7,0,94435.71,885.4286,99.57143
"23475","71224","2018",3,3,0,133400,1236.667,96
"23476","71225","2018",6,6,0,170916.7,1572.5,108.8333
"23477","71226","2018",1,1,0,30000,375,80
"23478","71227","2018",8,8,0,69071.38,704.125,95.5
"23479","71228","2018",5,5,0,151170,1363,109.4
"23480","71229","2018",2,2,0,89000,754.5,111
"23481","71230","2018",63,55,8,78555.56,845.746,95.34921
"23482","71231","2018",10,10,0,164102,1349.3,97.7
"23483","71233","2018",4,4,0,69250,834.75,79.75
"23484","71234","2018",6,6,0,152333.3,1254.833,121.8333
"23485","71235","2018",18,18,0,254603.4,2315.611,114.8333
"23486","71236","2018",9,9,0,126097.8,1362.222,86.44444
"23487","71237","2018",6,6,0,69166.67,773.6667,85.66667
"23488","71238","2018",16,16,0,152417.7,1222.812,129.25
"23489","71239","2018",11,11,0,84227.27,835.4545,95.09091
"23490","71240","2018",5,5,0,138300,1532.6,90.2
"23491","71241","2018",3,3,0,144333.3,1937.667,69.66667
"23492","71242","2018",7,6,1,102042.9,1121.143,87.57143
"23493","71243","2018",6,6,0,90333.33,886.8333,102.5
"23494","71244","2018",4,4,0,86137.5,871.5,94
"23495","71245","2018",4,4,0,88500,1029.25,92.5
"23496","71246","2018",3,3,0,117666.7,1097.333,103.3333
"23497","71247","2018",2,2,0,117500,1847,65.5
"23498","71248","2018",15,15,0,125195.3,1199,108.7333
"23499","71249","2018",6,6,0,166803.3,1870.833,96.16667
"23500","71250","2018",10,10,0,151226.8,1408.2,103.7
"23501","71251","2018",8,8,0,66818.75,778.625,81.5
"23502","71252","2018",9,9,0,182138.9,1516.889,135.2222
"23503","71253","2018",5,5,0,158600,1622,91.6
"23504","71254","2018",5,5,0,68300,900.6,80.6
"23505","71255","2018",2,2,0,177000,1427,144
"23506","71256","2018",9,9,0,88200,937.1111,91.66667
"23507","71257","2018",6,6,0,172218.3,1557.833,117.3333
"23508","71258","2018",7,7,0,235023.4,1973.429,116.8571
"23509","71259","2018",7,7,0,143620.1,1082.286,136
"23510","71261","2018",14,14,0,117316.4,1215.071,100.9286
"23511","71262","2018",2,2,0,86000,1493,68.5
"23512","71263","2018",100,73,27,129591.6,1390.32,97.14
"23513","71264","2018",3,3,0,197100,1439.667,134
"23514","71266","2018",3,3,0,62833.33,612,100
"23515","71267","2018",9,8,1,172669.4,1245.111,133.3333
"23516","71268","2018",1,1,0,125000,718,174
"23517","71269","2018",32,22,10,141669.8,1655.906,86.28125
"23518","71270","2018",419,130,289,123639.7,1485.597,82.82578
"23519","71272","2018",5,5,0,67470,1069.4,62.2
"23520","71273","2018",1,1,0,78000,1026,76
"23521","71274","2018",5,5,0,141518,1437.6,98.8
"23522","71275","2018",16,15,1,100359.4,1036.812,92.375
"23523","71276","2018",4,4,0,153412.5,1411.5,99.5
"23524","71277","2018",7,7,0,138871.4,1249.714,109.5714
"23525","71278","2018",1,1,0,221500,1943,114
"23526","71279","2018",8,8,0,111552.4,887,129.75
"23527","71281","2018",4,4,0,76500,802.5,103
"23528","71282","2018",10,10,0,126410,1249,89.1
"23529","71283","2018",6,6,0,119061.7,1438.833,79.66667
"23530","71284","2018",2,2,0,83000,1248.5,68
"23531","71285","2018",2,2,0,129700,988.5,132
"23532","71286","2018",2,2,0,91225,1273.5,75
"23533","71287","2018",3,3,0,130666.7,1610.333,85.66667
"23534","71289","2018",9,9,0,148527.8,1354.333,119
"23535","71290","2018",2,2,0,105750,1734.5,87
"23536","71291","2018",9,8,1,119440.6,967.6667,127.6667
"23537","71292","2018",15,15,0,190509,1831,109.2667
"23538","71293","2018",3,3,0,105333.3,928,110.3333
"23539","71294","2018",13,11,2,129271.5,1581.077,81
"23540","71295","2018",26,26,0,125118,1461.846,85.38462
"23541","71296","2018",13,13,0,153811.5,1560.462,102
"23542","71297","2018",11,11,0,126431.8,872.3636,141.7273
"23543","71299","2018",3,3,0,168350,1779.667,95.66667
"23544","71300","2018",7,7,0,128935.7,1255.857,105.2857
"23545","71301","2018",1,1,0,160000,1839,87
"23546","71302","2018",3,3,0,169000,1638.667,93.66667
"23547","71303","2018",5,5,0,134850,1541.6,87.4
"23548","71305","2018",6,6,0,145946.7,1405.5,105.6667
"23549","71306","2018",160,120,40,84918.83,955.2188,89.25625
"23550","71307","2018",5,5,0,117060,1031,104.2
"23551","71308","2018",1,1,0,55000,733,75
"23552","71309","2018",15,13,2,131022.7,1302.2,97.2
"23553","71310","2018",45,34,11,106534.3,1230.267,86.84444
"23554","71311","2018",2,2,0,57000,702,84.5
"23555","71312","2018",3,3,0,142000,1407.667,113
"23556","71313","2018",2,2,0,127960,1301,97.5
"23557","71314","2018",4,4,0,123825,1430.5,88.75
"23558","71315","2018",2,2,0,162500,1238.5,137.5
"23559","71316","2018",2,2,0,60000,671,87.5
"23560","71317","2018",4,4,0,71625,689,102.25
"23561","71318","2018",18,17,1,104555.6,1058.389,98.94444
"23562","71319","2018",14,14,0,100164.3,1128.429,88.85714
"23563","71320","2018",8,8,0,122748.8,1485.25,95.375
"23564","71321","2018",4,4,0,141500,1207.75,125.5
"23565","71323","2018",2,2,0,238155,1909.5,125
"23566","71324","2018",5,5,0,131200,1894.6,77.6
"23567","71325","2018",12,12,0,107441.7,938.6667,94.33333
"23568","71326","2018",7,7,0,110642.9,1188.286,101.4286
"23569","71327","2018",5,5,0,93560,1097.4,92
"23570","71328","2018",4,4,0,156600,2349.75,95.5
"23571","71329","2018",6,6,0,125833.3,1331,99.33333
"23572","71330","2018",6,6,0,91416.67,1098.167,78
"23573","71332","2018",4,4,0,129155,1176,108.75
"23574","71333","2018",13,13,0,165646.2,1574.615,104.8462
"23575","71334","2018",4,4,0,119687.5,1022.25,115.5
"23576","71336","2018",24,22,2,132095.8,1342.75,99.20833
"23577","71337","2018",6,6,0,158750,937.3333,167
"23578","71338","2018",4,4,0,111775,1321.5,78.75
"23579","71339","2018",9,9,0,105166.7,1074.111,98.22222
"23580","71340","2018",9,9,0,121118.2,1203.778,96.77778
"23581","71341","2018",2,2,0,135225,1316.5,106
"23582","71342","2018",125,73,52,105824.5,1368.16,81.76
"23583","71343","2018",5,5,0,174680.6,1313.8,125.8
"23584","71345","2018",5,5,0,211482,2327.4,94.8
"23585","71346","2018",17,16,1,80208.82,796.0588,101.4118
"23586","71347","2018",12,12,0,150908.3,1291.833,115.4167
"23587","71348","2018",3,3,0,35500,561.3333,60.33333
"23588","71349","2018",1,1,0,130000,935,139
"23589","71350","2018",9,9,0,178394.4,1608.889,145.5556
"23590","71351","2018",31,30,1,106146.1,1107.871,94.54839
"23591","71352","2018",3,3,0,86033.33,1186.333,98
"23592","71353","2018",11,11,0,257970.5,1918.182,124.2727
"23593","71354","2018",3,3,0,60833.33,1129.667,53.66667
"23594","71355","2018",5,5,0,99280,1840.4,54.4
"23595","71356","2018",9,9,0,121766.7,1156.444,104.8889
"23596","71357","2018",1,1,0,90000,804,112
"23597","71358","2018",1,1,0,99500,1877,53
"23598","71359","2018",12,12,0,103016.7,1049.667,100.4167
"23599","71360","2018",18,17,1,223782.8,1790.5,121.6111
"23600","71362","2018",3,3,0,227833.3,2595.333,98
"23601","71363","2018",1,1,0,58000,1160,50
"23602","71364","2018",3,3,0,130333.3,1248.333,107.3333
"23603","71365","2018",16,15,1,113581.2,1097.5,106.125
"23604","71366","2018",6,6,0,111383.3,1307.167,97.66667
"23605","71367","2018",5,5,0,107500,1228,86.2
"23606","71369","2018",5,5,0,165320,1571.6,106
"23607","71371","2018",18,18,0,196260,1776.222,111.8889
"23608","71372","2018",28,27,1,185692.9,1923.25,99.07143
"23609","71373","2018",24,22,2,109577.5,987.9583,118.9167
"23610","71374","2018",1,1,0,84000,575,146
"23611","71376","2018",4,4,0,75530,1085.5,70.25
"23612","71377","2018",1,1,0,28000,622,45
"23613","71378","2018",27,24,3,178895.1,1748.593,108.3704
"23614","71379","2018",20,20,0,107315,1093.75,100.6
"23615","71380","2018",12,12,0,144608.3,1342.667,106.5
"23616","71381","2018",2,1,1,107500,1212,90.5
"23617","71382","2018",5,5,0,148180,1329.4,105.2
"23618","71383","2018",3,3,0,55583.33,800.6667,66
"23619","71384","2018",4,4,0,142026.8,1705.5,88.75
"23620","71385","2018",6,5,1,172783.3,2098.5,96
"23621","71386","2018",1,1,0,132000,1082,122
"23622","71387","2018",5,5,0,78170,873.4,87.2
"23623","71388","2018",5,5,0,78700,1031.6,76.2
"23624","71389","2018",6,6,0,47083.33,624,74.16667
"23625","71390","2018",7,7,0,94845.71,1177.143,87.85714
"23626","71391","2018",10,10,0,86643.7,1093.3,81
"23627","71392","2018",7,7,0,104571.4,1214.143,92.57143
"23628","71393","2018",4,4,0,181350,1713.75,110
"23629","71394","2018",8,8,0,77931.25,977,82.625
"23630","71395","2018",2,2,0,50000,488.5,99.5
"23631","71396","2018",9,9,0,69944.44,937.6667,82.88889
"23632","71397","2018",5,5,0,159730,1531.8,100
"23633","71398","2018",7,7,0,150032.9,1288.143,119.4286
"23634","71399","2018",5,5,0,103200,1133,92.4
"23635","71400","2018",3,3,0,174150,1577.667,111.3333
"23636","71401","2018",8,8,0,142062.5,1571.375,91.75
"23637","71402","2018",7,7,0,140357.1,1374.143,98.71429
"23638","71403","2018",4,4,0,136901.8,1105.75,116.75
"23639","71404","2018",7,7,0,153287.1,1338.571,118.5714
"23640","71405","2018",3,3,0,126166.7,1028.333,121.6667
"23641","71406","2018",4,4,0,74500,599,127.25
"23642","71407","2018",3,3,0,56666.67,570.3333,100
"23643","71408","2018",1,1,0,50000,625,80
"23644","71409","2018",5,5,0,137900,973.4,141.4
"23645","71410","2018",13,13,0,110300,1033.077,106.3077
"23646","71411","2018",3,3,0,158466.7,1564,95.33333
"23647","71412","2018",9,9,0,123652.6,1415,85.22222
"23648","71413","2018",6,6,0,124525,1128.833,112.6667
"23649","71414","2018",2,2,0,112175,836.5,127.5
"23650","71415","2018",2,2,0,79500,1423,56
"23651","71416","2018",5,5,0,173850,1777.4,120.6
"23652","71417","2018",18,17,1,114194.4,1221.833,93.77778
"23653","71419","2018",35,34,1,126907.1,1297.943,97.2
"23654","71420","2018",15,14,1,117521.3,1454.733,81.2
"23655","71422","2018",1,1,0,295000,1844,160
"23656","71423","2018",6,6,0,169500,1349.833,104.6667
"23657","71425","2018",6,6,0,103216.7,1204.333,91.5
"23658","71428","2018",1,1,0,190900,1097,174
"23659","71430","2018",5,5,0,106102,1102.6,107
"23660","71431","2018",4,4,0,150162.5,1531.25,109.75
"23661","71433","2018",8,8,0,187200,1194.75,140.375
"23662","71434","2018",1,1,0,110000,1467,75
"23663","71435","2018",1,1,0,189600,1823,104
"23664","71436","2018",5,5,0,161018,1323,122.6
"23665","71437","2018",2,2,0,189200,1140.5,161
"23666","71438","2018",8,8,0,105526.9,886.375,121.5
"23667","71439","2018",4,4,0,207875,1706.75,115.5
"23668","71440","2018",4,4,0,67500,876,84.5
"23669","71441","2018",3,2,1,40000,639.3333,58.33333
"23670","71442","2018",10,10,0,99760,1171,88.5
"23671","71443","2018",15,15,0,222963.3,1614.4,144.8
"23672","71444","2018",13,12,1,155243.1,1467.615,109.1538
"23673","71445","2018",70,51,19,134404.1,1440.857,93.54286
"23674","71446","2018",2,2,0,167750,1221.5,146
"23675","71447","2018",4,4,0,218507.5,1612.75,131.75
"23676","71448","2018",12,12,0,190190,2039.417,92.58333
"23677","71449","2018",2,2,0,205145,1470.5,145
"23678","71450","2018",1,1,0,120000,1200,100
"23679","71452","2018",2,2,0,115000,823.5,127.5
"23680","71454","2018",2,2,0,185500,1353,130
"23681","71455","2018",2,2,0,194025,1611.5,172
"23682","71456","2018",19,18,1,138600,1295.053,108.9474
"23683","71457","2018",2,2,0,142319,1721,89.5
"23684","71458","2018",2,2,0,197250,1160.5,170
"23685","71459","2018",1,1,0,126000,1500,84
"23686","71460","2018",7,7,0,178475.4,1239.714,168.8571
"23687","71462","2018",5,5,0,136799.8,1112.4,121.2
"23688","71463","2018",7,7,0,116757.1,1110,100.7143
"23689","71464","2018",2,2,0,177050,2708.5,69
"23690","71465","2018",2,2,0,120000,1105,108
"23691","71466","2018",2,2,0,128500,1383,90.5
"23692","71468","2018",4,4,0,155625,1581,97.5
"23693","71469","2018",1,1,0,120000,889,135
"23694","71470","2018",4,4,0,299727.5,1712.25,143
"23695","71472","2018",3,3,0,54486.67,750,71
"23696","71473","2018",1,1,0,69000,862,80
"23697","71474","2018",2,2,0,47250,546,85
"23698","71475","2018",45,39,6,132804.9,1555.889,87.28889
"23699","71477","2018",7,7,0,128857.1,1421.286,91.28571
"23700","71478","2018",1,1,0,85000,977,87
"23701","71479","2018",14,14,0,169131.1,1434.143,118.2143
"23702","71480","2018",9,9,0,124110,1470.556,85.22222
"23703","71481","2018",19,18,1,179331.1,1740.053,111.6316
"23704","71482","2018",9,9,0,113600,1369,78
"23705","71483","2018",4,4,0,114750,877.25,125.75
"23706","71484","2018",9,9,0,94566.67,1172.889,82.22222
"23707","71485","2018",1,1,0,18750,551,34
"23708","71486","2018",88,86,2,95552.84,1089.205,88.72727
"23709","71487","2018",2,2,0,275300,2372,162
"23710","71488","2018",2,2,0,87500,881,99
"23711","71489","2018",7,7,0,109500,1170.286,94.14286
"23712","71490","2018",8,8,0,113987.5,1192,96.625
"23713","71491","2018",17,16,1,128344.1,1571.706,106.8235
"23714","71492","2018",3,3,0,71466.67,768.6667,88.66667
"23715","71493","2018",8,8,0,141899.5,1120.625,122.125
"23716","71494","2018",9,9,0,185452.8,2167.667,88.33333
"23717","71495","2018",13,13,0,93700,995.4615,90.76923
"23718","71496","2018",2,2,0,172500,2001,99
"23719","71497","2018",18,16,2,195196,2245.833,98.55556
"23720","71498","2018",2,2,0,83500,925,85
"23721","71499","2018",30,30,0,88737.8,1052.467,81.7
"23722","71500","2018",2,2,0,60000,398,151
"23723","71501","2018",1,1,0,265300,1769,150
"23724","71502","2018",4,4,0,161000,1402.5,133
"23725","71504","2018",2,2,0,171050,1478,119
"23726","71505","2018",1,1,0,227000,1645,138
"23727","71506","2018",13,13,0,108942.3,1252.462,88.15385
"23728","71507","2018",4,4,0,98025,1329.25,73.5
"23729","71508","2018",10,10,0,112715,1107.9,107.6
"23730","71509","2018",6,6,0,127916.7,1398.667,91.5
"23731","71510","2018",4,4,0,111485,1001.25,107.75
"23732","71512","2018",28,26,2,136563,1350.286,104.2857
"23733","71513","2018",13,13,0,190026,2081.538,96
"23734","71514","2018",10,10,0,135400,1156.1,120.8
"23735","71515","2018",1,1,0,210070,1500,140
"23736","71516","2018",9,9,0,115181.1,1103,109.4444
"23737","71517","2018",4,4,0,124670,1380.75,95
"23738","71518","2018",4,4,0,209778.8,1570,150
"23739","71519","2018",3,3,0,128133.3,1052,128.3333
"23740","71520","2018",9,9,0,144832.2,1755.667,98
"23741","71521","2018",2,2,0,42750,802.5,54
"23742","71522","2018",23,23,0,116241.7,1209.435,100.2609
"23743","71523","2018",7,7,0,119757.1,1221.286,95.71429
"23744","71524","2018",3,3,0,110000,1334.333,85.66667
"23745","71525","2018",9,9,0,138533.3,1514.111,94.88889
"23746","71526","2018",3,3,0,233253.3,1854,130
"23747","71527","2018",4,4,0,96295.25,1022.75,91.25
"23748","71528","2018",28,27,1,115260.4,1066.321,105.7143
"23749","71529","2018",5,5,0,93652,1315.6,74.8
"23750","71530","2018",4,4,0,98750,1142.5,88
"23751","71531","2018",1,1,0,70000,660,106
"23752","71532","2018",1,1,0,165000,2012,82
"23753","71533","2018",6,6,0,128070,1186.667,113.6667
"23754","71534","2018",3,3,0,116666.7,1137,112.6667
"23755","71535","2018",1,1,0,120000,1071,112
"23756","71537","2018",1,1,0,85000,1417,60
"23757","71538","2018",4,4,0,114725,1156.25,93.75
"23758","71540","2018",13,11,2,90130.77,913.2308,96.92308
"23759","71541","2018",7,7,0,84214.29,861.7143,101.2857
"23760","71542","2018",19,19,0,87951.16,994,91.68421
"23761","71543","2018",59,43,16,118380.4,1281.119,89.61017
"23762","71544","2018",4,4,0,47750,850.75,60.5
"23763","71545","2018",7,6,1,105801.4,1065.286,97.14286
"23764","71546","2018",7,7,0,90171.43,1056.429,88.85714
"23765","71547","2018",3,3,0,112500,1264,90
"23766","71548","2018",3,3,0,172633.3,1406.667,123.3333
"23767","71549","2018",4,4,0,123250,1166.5,119.5
"23768","71550","2018",17,16,1,90718.53,983.1765,100.6471
"23769","71552","2018",4,4,0,75750,765.75,98.25
"23770","71553","2018",2,2,0,110975,903,136.5
"23771","71554","2018",2,2,0,230025,1740.5,133
"23772","71555","2018",17,17,0,172902.9,1637.176,108.2941
"23773","71556","2018",3,2,1,198226.7,1863.333,107.6667
"23774","71557","2018",6,6,0,174917.5,1135.167,172
"23775","71558","2018",10,10,0,121470,1102.8,111.9
"23776","71559","2018",3,3,0,57500,776,67.66667
"23777","71561","2018",3,3,0,116500,882.3333,136
"23778","71563","2018",4,4,0,39500,663.25,65.25
"23779","71564","2018",4,4,0,84000,1089.5,72.75
"23780","71565","2018",7,7,0,138200,696.1429,183.2857
"23781","71566","2018",14,12,2,105375,1565.286,91.71429
"23782","71567","2018",2,2,0,326000,3883,74
"23783","71570","2018",4,4,0,141375,1403,101.25
"23784","71571","2018",1,1,0,135000,763,177
"23785","71572","2018",3,3,0,144666.7,1443,114
"23786","71574","2018",17,17,0,207044.3,1905.471,107.5882
"23787","71576","2018",3,3,0,65000,819,84
"23788","71577","2018",3,3,0,162833.3,1463.667,119.6667
"23789","71578","2018",1,1,0,150000,949,158
"23790","71579","2018",2,2,0,71650,949,92
"23791","71580","2018",5,5,0,72400,912.8,72.2
"23792","71581","2018",3,3,0,160000,918.6667,163
"23793","71582","2018",10,10,0,224272,1433.9,155.3
"23794","71583","2018",5,5,0,256316,2281.6,114
"23795","71584","2018",6,6,0,123558.3,1322.5,98.5
"23796","71585","2018",16,14,2,154251.8,1638.312,96.875
"23797","71586","2018",1,1,0,41000,2050,20
"23798","71588","2018",12,12,0,121322.5,1272,95.5
"23799","71589","2018",7,7,0,73857.14,806,94.85714
"23800","71590","2018",8,8,0,143000,1370,108.25
"23801","71591","2018",4,3,1,127250,1286.5,107.5
"23802","72001","2018",13,13,0,163653.8,1764.769,101.2308
"23803","72002","2018",3,3,0,134847,1044.333,130.3333
"23804","72003","2018",99,65,34,102146.8,1249.091,80.93939
"23805","72004","2018",3,3,0,91333.33,1332,68
"23806","72005","2018",9,9,0,110111.1,1054,110.4444
"23807","72006","2018",23,23,0,129906.5,1331.087,101.2609
"23808","72007","2018",4,4,0,225000,1856.25,129.75
"23809","72008","2018",62,62,0,163031.2,1709.403,100.5645
"23810","72009","2018",4,4,0,110250,1059.75,106.25
"23811","72010","2018",4,4,0,147750,1544.25,87.25
"23812","72011","2018",8,8,0,110812.5,1281.25,96.875
"23813","72012","2018",4,4,0,122700,1598.75,88.5
"23814","72013","2018",20,20,0,83440,1063.45,76.75
"23815","72015","2018",2,2,0,108625,1129.5,103
"23816","72016","2018",24,24,0,99670.75,913.625,105.9167
"23817","72017","2018",4,4,0,214750,1656,141.25
"23818","72018","2018",1,1,0,125000,1042,120
"23819","72019","2018",2,2,0,160000,1489.5,115
"23820","72020","2018",9,9,0,88555.56,857.2222,101.8889
"23821","72021","2018",8,8,0,103820,1322.5,82.625
"23822","72022","2018",21,21,0,115190.5,1205.857,98.85714
"23823","72023","2018",25,25,0,86140,907.76,97.24
"23824","72024","2018",55,55,0,155777.3,1626.982,99.61818
"23825","72025","2018",27,27,0,127768.9,1200.593,105.7037
"23826","72026","2018",22,22,0,109985.7,1439.091,77.36364
"23827","72027","2018",2,2,0,117500,1507,78.5
"23828","72028","2018",7,7,0,74428.57,1022.286,74.85714
"23829","72029","2018",23,23,0,80178.7,994.9565,81.91304
"23830","72031","2018",6,6,0,121000,1166,104.3333
"23831","72032","2018",5,5,0,80560,870.8,89.6
"23832","72034","2018",5,5,0,172360,1436.6,117.6
"23833","72035","2018",22,22,0,76672.73,850.0455,85.18182
"23834","72036","2018",5,5,0,127200,1272.4,100.4
"23835","72037","2018",2,2,0,139000,1335,104
"23836","72038","2018",4,4,0,118750,898,133.5
"23837","72039","2018",54,54,0,94506.11,1105.519,86.2037
"23838","72040","2018",2,2,0,83000,1295,58.5
"23839","72041","2018",4,4,0,117912.5,1240.25,98.25
"23840","72042","2018",25,25,0,105352.8,1182.76,89.8
"23841","72043","2018",2,2,0,120000,1249.5,102
"23842","72044","2018",5,5,0,73540,1020.2,80.2
"23843","72045","2018",6,6,0,177083.3,1599.333,114.8333
"23844","72046","2018",22,21,1,109376.8,1239,89.27273
"23845","72047","2018",22,22,0,167643.2,1421.318,118.4545
"23846","72048","2018",3,3,0,102000,1131.667,90.33333
"23847","72049","2018",3,3,0,103333.3,767,135
"23848","72050","2018",9,9,0,121944.4,1174,104.6667
"23849","72051","2018",37,37,0,151974.2,1298.081,118.6757
"23850","72052","2018",8,8,0,98237.5,1017.5,93.625
"23851","72053","2018",10,10,0,136475,1356.2,107.1
"23852","72054","2018",19,19,0,143733.9,1480.684,94.63158
"23853","72056","2018",9,9,0,138053,1303.333,105.6667
"23854","72057","2018",2,2,0,115750,1187.5,97.5
"23855","72058","2018",55,54,1,214160.8,1788.327,124.5091
"23856","72059","2018",10,10,0,86315,839.6,106.1
"23857","72060","2018",4,4,0,81000,1216.25,63
"23858","72061","2018",18,18,0,103198.8,1136.722,96.61111
"23859","72062","2018",8,8,0,119257.2,1160.25,101.5
"23860","72064","2018",2,2,0,100500,1254,80
"23861","72065","2018",27,24,3,197232.3,1717.037,118.6667
"23862","72066","2018",3,3,0,171000,1493.667,114.3333
"23863","72067","2018",8,8,0,90726.25,1195.5,77.75
"23864","72068","2018",27,25,2,88945.37,1114.296,86.44444
"23865","72070","2018",2,2,0,135000,1357.5,104.5
"23866","72071","2018",59,59,0,91155.93,986.6441,89.86441
"23867","72072","2018",4,4,0,148800,1438.5,100.75
"23868","72073","2018",7,7,0,178452.7,1611.143,110
"23869","72074","2018",6,6,0,125833.3,1263.5,92.33333
"23870","72075","2018",11,11,0,139536.4,1174.818,116.3636
"23871","72076","2018",2,2,0,140250,1504,93.5
"23872","72077","2018",7,7,0,66757.14,802.2857,82.71429
"23873","72078","2018",5,5,0,86988,974.6,96
"23874","72079","2018",2,2,0,177500,1273.5,138.5
"23875","72080","2018",20,20,0,157075.7,1727.65,93.6
"23876","72083","2018",5,5,0,126500,1406,102.2
"23877","72084","2018",17,17,0,120587.5,1282.059,91.76471
"23878","72085","2018",6,6,0,104033.3,1002,106.5
"23879","72086","2018",2,2,0,116000,1039.5,108
"23880","72087","2018",4,4,0,74125,1042.25,72
"23881","72088","2018",5,5,0,72798,1113.2,64.8
"23882","72089","2018",20,20,0,94512.15,1118.2,83.05
"23883","72090","2018",33,32,1,115981.5,1253.455,90.84848
"23884","72091","2018",1,1,0,75000,735,102
"23885","72093","2018",10,10,0,96110,1023.8,91.4
"23886","72094","2018",10,10,0,85700,976.5,88.6
"23887","72095","2018",43,31,12,182092.8,1813.628,101.4651
"23888","72096","2018",16,16,0,159942.1,1572.25,102.4375
"23889","72098","2018",12,12,0,86366.67,837.75,107.5833
"23890","72099","2018",8,8,0,149038.8,1614.625,91.875
"23891","72100","2018",3,3,0,69333.33,889.6667,77.33333
"23892","72101","2018",9,9,0,95491.67,961.2222,97.33333
"23893","72102","2018",2,2,0,134235,1273,107
"23894","72103","2018",6,6,0,59500,542.6667,96.33333
"23895","72104","2018",7,7,0,76657.14,952,82.42857
"23896","72105","2018",3,3,0,88368.33,1139,82.33333
"23897","72106","2018",4,4,0,159241,1227,133.75
"23898","72107","2018",4,4,0,118220,1343.5,107.5
"23899","72109","2018",3,3,0,131666.7,1305.333,101.6667
"23900","72110","2018",15,15,0,112500,1278.4,91.66667
"23901","72111","2018",4,4,0,157000,1201.75,129.5
"23902","72112","2018",9,9,0,115566.7,1013.556,112.4444
"23903","72113","2018",11,11,0,148463.2,1445.364,99.09091
"23904","72114","2018",6,6,0,80709,870.6667,95.16667
"23905","72115","2018",15,15,0,114833.3,1043.467,100.2667
"23906","72118","2018",15,15,0,100966.7,1150.533,88.73333
"23907","72119","2018",20,20,0,138675.9,1302.75,117.4
"23908","72120","2018",1,1,0,102000,703,145
"23909","72121","2018",6,6,0,96166.67,1065,103.1667
"23910","72122","2018",18,18,0,126990.2,1315.667,98.94444
"23911","72123","2018",2,2,0,92250,804,115.5
"23912","72124","2018",51,46,5,129400.6,1390.216,92.86275
"23913","72125","2018",2,2,0,87250,971.5,92
"23914","72126","2018",3,3,0,116366.7,1092.667,105
"23915","72127","2018",22,22,0,158171.4,1543.591,105.1818
"23916","72128","2018",6,6,0,90250,841.8333,105.6667
"23917","72129","2018",9,9,0,219143.3,1769.333,122.5556
"23918","72130","2018",3,3,0,214280,1434,145.3333
"23919","72131","2018",6,6,0,112516.7,1285.833,83.5
"23920","72133","2018",5,5,0,193196,1445.2,128.4
"23921","72134","2018",5,5,0,70400,952.2,75.2
"23922","72135","2018",4,4,0,189725,1156.25,153.5
"23923","72136","2018",3,3,0,128066.7,1350.333,98.33333
"23924","72137","2018",19,19,0,135719.3,1338.053,102.7895
"23925","72138","2018",37,37,0,83754.59,938.3514,86.7027
"23926","72139","2018",6,6,0,134741.7,1009,135.3333
"23927","72141","2018",4,4,0,118869,1537.75,80.5
"23928","72142","2018",1,1,0,125000,893,140
"23929","72143","2018",23,23,0,106721.7,1107.043,98.78261
"23930","72144","2018",8,8,0,96006.25,1653.125,65.375
"23931","72146","2018",34,34,0,145335.4,1413.647,102.2059
"23932","72147","2018",16,16,0,128468.4,1361.562,101.125
"23933","72149","2018",12,12,0,92250,1041.417,85.41667
"23934","72150","2018",11,11,0,124473.5,1232.636,98.18182
"23935","72151","2018",7,7,0,95857.14,780.7143,124.5714
"23936","72152","2018",5,5,0,171900,1328.6,124.2
"23937","72153","2018",13,13,0,106346.2,1195.154,98.84615
"23938","72154","2018",156,147,9,135575.4,1354,100.2885
"23939","72155","2018",24,24,0,150308.8,1699.917,92.33333
"23940","72156","2018",11,11,0,100136.4,1158.091,93.72727
"23941","72157","2018",11,11,0,174613.6,1300.091,136.7273
"23942","72158","2018",8,8,0,92750,984.75,97.625
"23943","72160","2018",6,6,0,171333.3,1379.333,122.3333
"23944","72161","2018",14,14,0,77742.86,773.6429,96.92857
"23945","72163","2018",1,1,0,207000,1630,127
"23946","72165","2018",28,28,0,140480.9,1340.036,107.0357
"23947","72166","2018",4,4,0,132500,1188.5,109.75
"23948","72167","2018",11,11,0,155227.3,1429.727,106.8182
"23949","72168","2018",32,32,0,113113.5,1224.75,94.0625
"23950","72169","2018",13,12,1,138929.2,1540.154,88.92308
"23951","72170","2018",3,3,0,95433.33,923.3333,95.33333
"23952","72171","2018",3,3,0,95000,852.6667,106.6667
"23953","72172","2018",1,1,0,97000,795,122
"23954","72173","2018",12,12,0,119148.3,1276.583,91.08333
"23955","72174","2018",1,1,0,120000,1690,71
"23956","72175","2018",15,15,0,97672.93,1217.4,84.06667
"23957","72176","2018",55,55,0,94264.36,1053.655,89.90909
"23958","72177","2018",4,4,0,144250,1358.25,110.75
"23959","72178","2018",2,2,0,86950,1097.5,78
"23960","72179","2018",25,24,1,85492.04,993.56,85.4
"23961","72180","2018",45,44,1,90782.22,932.5556,98.68889
"23962","72181","2018",2290,1160,1130,125934.3,1603.979,76.21528
"23963","72182","2018",24,24,0,99282.92,1007.083,103.7083
"23964","72183","2018",18,18,0,122938.9,1236.611,100.5556
"23965","72184","2018",2,2,0,93250,1245,76.5
"23966","72185","2018",8,8,0,96562.5,1133.125,86.375
"23967","72186","2018",17,17,0,92437.06,1008,90.11765
"23968","72187","2018",17,17,0,124674.3,1319.294,98
"23969","72188","2018",1,1,0,95000,864,110
"23970","72189","2018",34,34,0,93254.41,999.0882,91.29412
"23971","72190","2018",2,2,0,89000,976,93.5
"23972","72191","2018",44,44,0,110947.2,1204.795,96.09091
"23973","72192","2018",3,3,0,93333.33,1092.667,96.33333
"23974","72193","2018",11,11,0,91727.27,1103.909,84.72727
"23975","72194","2018",2,2,0,105000,1170.5,95.5
"23976","72195","2018",20,20,0,111375,1212.3,90.8
"23977","72196","2018",8,8,0,112613.8,1248.5,90.125
"23978","72197","2018",5,5,0,121546,1276.6,98
"23979","72198","2018",27,27,0,211010.7,1826.556,117.037
"23980","72199","2018",5,5,0,79894,1093.8,82.6
"23981","72200","2018",42,42,0,163563.1,1696.905,98.40476
"23982","72201","2018",4,4,0,84965,981.5,92.75
"23983","72202","2018",4,4,0,97759.25,759.25,128.25
"23984","72204","2018",6,6,0,61500,881.3333,66
"23985","72205","2018",32,32,0,137058.4,1502.406,92.9375
"23986","72208","2018",6,6,0,107106.7,1265.833,84.5
"23987","72209","2018",3,3,0,71666.67,1070,74
"23988","72210","2018",2,2,0,32000,547,65
"23989","72211","2018",9,9,0,96111.11,1071.778,85.88889
"23990","72212","2018",9,9,0,119246,1501.333,85.77778
"23991","72213","2018",44,37,7,159206.5,2211.636,89.93182
"23992","72215","2018",13,13,0,88561.54,940.8462,91.15385
"23993","72216","2018",4,4,0,108250,1389.5,92.5
"23994","72217","2018",7,7,0,143714.3,1661.286,98.14286
"23995","72218","2018",5,5,0,83870,928,86
"23996","72219","2018",11,11,0,116910.9,1163.727,93.09091
"23997","72220","2018",11,11,0,73681.82,826.6364,92.09091
"23998","72221","2018",3,3,0,84666.67,1195.667,76.66667
"23999","72222","2018",3,3,0,41000,592,69.66667
"24000","72223","2018",35,35,0,98619.71,1212.514,81.54286
"24001","72224","2018",6,6,0,126041.7,1302.5,102.6667
"24002","72225","2018",6,6,0,101575,1435.833,67.5
"24003","72226","2018",16,16,0,126481.2,1215.188,105.875
"24004","72228","2018",24,24,0,113770.8,1218.042,93.91667
"24005","72229","2018",10,10,0,98300,934.3,103.5
"24006","72230","2018",6,6,0,161240,1364,123.1667
"24007","72231","2018",60,59,1,164119.1,1625.683,104.2333
"24008","72232","2018",3,3,0,71000,851,78.66667
"24009","72233","2018",1,1,0,79000,1317,60
"24010","72234","2018",4,4,0,102645.8,1115.25,96.25
"24011","72235","2018",3,3,0,90666.67,929,97.66667
"24012","72236","2018",1,1,0,143355,969,148
"24013","72237","2018",3,3,0,80940,853.6667,94.33333
"24014","72238","2018",1,1,0,90500,1040,87
"24015","72239","2018",5,5,0,85600,653.8,126.8
"24016","72241","2018",51,51,0,118866.4,1327.824,93.09804
"24017","72243","2018",22,22,0,126273.9,1081.182,119.5909
"24018","72244","2018",40,38,2,125287.2,1244.125,98.45
"24019","72245","2018",6,6,0,89850,1042.833,82.66667
"24020","72246","2018",4,4,0,146750,1187.5,121.75
"24021","72247","2018",9,9,0,188242.6,1763.556,107
"24022","72248","2018",5,5,0,126680,1079,138.2
"24023","72249","2018",7,7,0,163828.6,1478.286,114.8571
"24024","72250","2018",3,3,0,152800,1447.333,99
"24025","72251","2018",5,5,0,79200,1063.4,73.6
"24026","72252","2018",16,16,0,129692.1,1171.75,113.1875
"24027","72253","2018",9,9,0,145891.1,1354.556,103.5556
"24028","72254","2018",2,2,0,92250,1198,76.5
"24029","72255","2018",5,5,0,87600,1064.6,82.8
"24030","72256","2018",4,4,0,90250,991.75,87.25
"24031","72257","2018",18,18,0,207176.2,1727.278,121.6667
"24032","72259","2018",5,5,0,115000,1258.8,92
"24033","72260","2018",37,35,2,206369.4,1873.108,114.7568
"24034","72261","2018",3,3,0,124836.7,919.6667,135.6667
"24035","72262","2018",36,36,0,77702.83,893.4167,85.30556
"24036","72264","2018",107,91,16,113755.1,1285.458,89.82243
"24037","72265","2018",8,8,0,94750,1161.625,103.75
"24038","72266","2018",6,6,0,109166.7,1648.333,75
"24039","72267","2018",8,8,0,106130.4,1344.875,83.125
"24040","72268","2018",10,10,0,115207.3,1088.3,104.8
"24041","72269","2018",19,19,0,56678.95,728.1579,78.10526
"24042","72271","2018",13,13,0,119564.1,1347.462,97.61538
"24043","72272","2018",4,4,0,134250,1098.25,120.5
"24044","72273","2018",5,5,0,123020,1184.8,111.2
"24045","72274","2018",2,2,0,110000,1023.5,105.5
"24046","72275","2018",18,18,0,157611.2,1476.056,107.8333
"24047","72276","2018",30,30,0,93435.73,1032.7,90.8
"24048","72277","2018",2,2,0,223575,1669,135
"24049","72278","2018",4,4,0,49750,829.5,60
"24050","72279","2018",3,3,0,77946.67,852,93
"24051","72280","2018",20,20,0,168282.2,1543.8,102.4
"24052","72281","2018",6,6,0,202750,1297.167,133.1667
"24053","72282","2018",6,6,0,86000,915.5,93.83333
"24054","72283","2018",5,5,0,80500,712.6,132.2
"24055","72286","2018",7,7,0,96787.29,878.4286,105.7143
"24056","72287","2018",15,15,0,171725,1453.933,117.1333
"24057","72289","2018",31,30,1,126868.4,1484.097,85.80645
"24058","72290","2018",18,18,0,141942.8,1297.444,109.6111
"24059","72291","2018",15,15,0,92418,846.8667,107.6667
"24060","72292","2018",5,5,0,134900,1108.8,136
"24061","72293","2018",5,5,0,165759.6,1645.8,97.2
"24062","72294","2018",8,8,0,100123.8,1053.875,85.5
"24063","72295","2018",5,5,0,143150,1112,130.2
"24064","72296","2018",9,9,0,103695.6,1473.111,83.88889
"24065","72297","2018",10,10,0,86433.2,947.1,91.2
"24066","72298","2018",11,11,0,108518.2,969,109.2727
"24067","72299","2018",27,27,0,138532.1,1339.556,104.7778
"24068","72300","2018",25,25,0,137796.7,1792.08,84.76
"24069","72302","2018",1,1,0,140000,1373,102
"24070","72303","2018",6,6,0,101166.7,967.5,99.66667
"24071","72305","2018",8,8,0,98275,960.75,102.375
"24072","72306","2018",4,4,0,144546.2,1469.75,97.75
"24073","72307","2018",3,3,0,136333.3,922.6667,144.6667
"24074","72308","2018",20,20,0,115754,1368.25,97.3
"24075","72309","2018",5,5,0,66600,1251.4,60.8
"24076","72310","2018",20,20,0,212008,1818.95,117.05
"24077","72311","2018",6,6,0,76916.67,1078.833,76.5
"24078","72313","2018",2,2,0,115000,1247.5,92
"24079","72314","2018",7,7,0,72428.57,994.5714,72.28571
"24080","72315","2018",3,3,0,148000,1382.333,107.6667
"24081","72316","2018",7,7,0,99457.14,994,92.71429
"24082","72317","2018",7,7,0,74535.71,882.2857,78.71429
"24083","72319","2018",9,9,0,134388.9,1271.556,102.7778
"24084","72320","2018",22,22,0,193465,1842.545,105.4545
"24085","72321","2018",8,8,0,123575,1390,87.75
"24086","72322","2018",6,6,0,120816.7,1124.667,103.8333
"24087","72323","2018",5,5,0,117570,1361.8,92.4
"24088","72324","2018",6,6,0,149416.7,1238.5,118.6667
"24089","72325","2018",10,10,0,96600,1020.6,90.8
"24090","72326","2018",3,3,0,85000,916.6667,100
"24091","72327","2018",5,5,0,113780,1374.8,94.2
"24092","72328","2018",47,47,0,213850.8,1891.809,113.5319
"24093","72329","2018",41,41,0,173875.5,1612.293,109.4146
"24094","72330","2018",2,2,0,72500,896.5,85
"24095","72331","2018",8,8,0,100230,1216.25,72.125
"24096","72332","2018",5,5,0,88000,1051.6,68.4
"24097","72333","2018",6,6,0,85016.67,912.3333,92
"24098","72334","2018",28,28,0,83293.21,893.9286,92.64286
"24099","72335","2018",12,12,0,159299.8,1421.75,116.8333
"24100","72336","2018",14,13,1,156144.6,1516.5,106.2143
"24101","72337","2018",9,9,0,92576.11,902.4444,98
"24102","72338","2018",8,8,0,174097.5,1495,114.375
"24103","72339","2018",6,6,0,127143.3,1203.333,108.1667
"24104","72340","2018",12,12,0,150878,1362.333,112.0833
"24105","72341","2018",7,7,0,130357.1,1225,111.4286
"24106","72342","2018",1,1,0,230000,1620,142
"24107","72343","2018",3,3,0,154166.7,1348.333,113
"24108","72344","2018",34,34,0,176724.6,1664.971,107.6765
"24109","72345","2018",7,7,0,143842.1,1481.143,97.57143
"24110","72346","2018",27,25,2,113340,1354.778,82.18519
"24111","72347","2018",2,2,0,161000,1499,105
"24112","72348","2018",2,2,0,98750,1888,55
"24113","72349","2018",6,6,0,110516.7,1177,98.33333
"24114","72350","2018",35,35,0,175802.6,1702.943,104.6857
"24115","72351","2018",9,9,0,99338.89,1198.444,81.44444
"24116","72352","2018",1,1,0,107000,991,108
"24117","72353","2018",5,5,0,113000,1154.2,88.2
"24118","72354","2018",2,2,0,62000,843,70.5
"24119","72355","2018",1,1,0,77000,626,123
"24120","72356","2018",4,4,0,61041.75,723,85.75
"24121","72357","2018",10,10,0,98000,1182.6,87.4
"24122","72358","2018",5,5,0,120536,1093.2,118.8
"24123","72359","2018",21,21,0,133057.1,1298.476,98.7619
"24124","72360","2018",7,7,0,191016.3,1828.143,105.4286
"24125","72361","2018",12,12,0,86616.67,1078.167,80.66667
"24126","72362","2018",3,3,0,93083.33,935.3333,98
"24127","72363","2018",23,23,0,104613.8,1124.87,94.13043
"24128","72364","2018",25,25,0,93572.64,1304.84,83.36
"24129","72366","2018",4,4,0,42175,592,81.75
"24130","72367","2018",10,10,0,157960,1067.7,132.7
"24131","72368","2018",4,4,0,84875,1070.75,118.75
"24132","72369","2018",5,5,0,105600,907.8,111.6
"24133","72370","2018",6,6,0,93789.17,1073.667,87.66667
"24134","72372","2018",1,1,0,85000,1349,63
"24135","72373","2018",21,21,0,101308.5,1057.333,96.95238
"24136","72374","2018",1,1,0,98800,823,120
"24137","72375","2018",13,13,0,131658.2,1228.538,117.6154
"24138","72376","2018",5,5,0,103120,1150.8,96
"24139","72377","2018",12,12,0,143750,1428.917,106.5
"24140","72378","2018",12,12,0,111083.3,1268.917,96.33333
"24141","72379","2018",5,5,0,133500,1192.2,115.2
"24142","72380","2018",11,11,0,91878.18,1060.818,82.72727
"24143","72381","2018",13,13,0,134940.2,1517.846,88.46154
"24144","72382","2018",11,11,0,108454.5,1201.455,87.90909
"24145","72385","2018",27,27,0,133761.6,1416,96.25926
"24146","72386","2018",34,34,0,152500.9,1646.647,89.94118
"24147","73001","2018",12,10,2,245043.3,3351.083,85.75
"24148","73003","2018",39,21,18,176262.3,2110.949,83.94872
"24149","73004","2018",13,4,9,61583.08,1447.154,43.07692
"24150","73005","2018",5,5,0,139700,2076,75
"24151","73006","2018",96,22,74,143424.4,2858.135,52.04167
"24152","73007","2018",9,6,3,198166.9,2797.778,89.44444
"24153","73008","2018",660,108,552,202017.5,3120.574,65.65152
"24154","73010","2018",65,46,19,263165.7,2753.108,97.36923
"24155","73011","2018",287,56,231,128897,1837.223,71.38676
"24156","73012","2018",3,3,0,231100,2876,80
"24157","73013","2018",23,5,18,100913.5,2372.739,42.3913
"24158","73014","2018",2,2,0,152975,2311.5,65
"24159","73015","2018",175,20,155,372778.4,7296.44,48.13143
"24160","73017","2018",6,6,0,257560,2340.833,106.6667
"24161","73018","2018",11,6,5,179154.5,2080.909,83.81818
"24162","73019","2018",12,12,0,146024.2,1691.75,91
"24163","73020","2018",4,4,0,146820,1818.25,79.75
"24164","73021","2018",11,8,3,193240.9,2180.545,98.27273
"24165","73022","2018",6,6,0,255191.7,2285.5,128.5
"24166","73023","2018",24,2,22,142418.9,3160.958,44.45833
"24167","73024","2018",83,6,77,133603.2,3571.795,37.18072
"24168","73025","2018",3,3,0,166966.7,1884.333,88.66667
"24169","73026","2018",2,2,0,165413,1559,100
"24170","73027","2018",4,4,0,210025,2053,123.5
"24171","73028","2018",5,5,0,174492,2395.4,73
"24172","73029","2018",53,17,36,204264.5,2682.019,77.9434
"24173","73030","2018",37,11,26,203896.3,2648.27,78.51351
"24174","73031","2018",55,7,48,204757.9,2564.727,77.10909
"24175","73032","2018",16,14,2,125061.2,1444.75,95.3125
"24176","73033","2018",4,3,1,159733.5,1508,104.25
"24177","73034","2018",49,18,31,214335.5,4370.531,56.81633
"24178","73036","2018",5,5,0,188540,1900.4,94.8
"24179","73039","2018",3,3,0,187707.7,3033,88
"24180","73040","2018",10,1,9,107675,2915.3,36.5
"24181","73041","2018",3,2,1,182543.3,1573,141
"24182","73042","2018",1,1,0,187500,1705,110
"24183","73043","2018",21,18,3,268908.5,2439.381,117.0952
"24184","73047","2018",5,0,5,272247.4,5078,68
"24185","73048","2018",3,3,0,172896.3,1937.333,91.33333
"24186","73049","2018",1,1,0,247000,2398,103
"24187","73050","2018",7,4,3,387692.9,3874.857,98.42857
"24188","73051","2018",47,18,29,270899.3,3360.681,84.91489
"24189","73052","2018",4,4,0,167800,1545,108.25
"24190","73053","2018",4,4,0,191652.5,1965.75,101.5
"24191","73054","2018",305,17,288,156121,3762.784,43.0623
"24192","73055","2018",31,16,15,270507.4,3616.226,76.74194
"24193","73057","2018",54,2,52,127565,3371.87,37.46296
"24194","73058","2018",13,13,0,194365.4,2109.538,99.38462
"24195","73059","2018",36,31,5,394281.7,4020.667,103.1111
"24196","73061","2018",2,2,0,176625,1393,117
"24197","73063","2018",6,3,3,141710.2,1647.167,95.83333
"24198","73064","2018",63,21,42,246551.3,2842.603,87.98413
"24199","73065","2018",823,101,722,169454.2,2363.735,72.86027
"24200","73067","2018",10,2,8,119364,1352.6,91.2
"24201","73068","2018",9,7,2,207244.4,2373.333,88.33333
"24202","73069","2018",14,12,2,125708.3,1412.214,88.85714
"24203","73070","2018",5,4,1,158500,2102,71.8
"24204","73071","2018",36,7,29,260817.8,4303.389,56.13889
"24205","73072","2018",1,1,0,95500,1516,63
"24206","73073","2018",8,8,0,176880.6,2208.375,81
"24207","73074","2018",5,5,0,118791.4,1454.6,94.4
"24208","73075","2018",1,1,0,409200,2558,160
"24209","73076","2018",4,3,1,401292.5,2619,142.5
"24210","73077","2018",10,9,1,223517,2959.4,80.2
"24211","73078","2018",2,2,0,245038.5,1612.5,135.5
"24212","73079","2018",9,7,2,184238.9,2265.222,84.44444
"24213","73081","2018",8,7,1,209333.8,1959.125,96
"24214","73082","2018",4,1,3,179122.8,2787.75,65.75
"24215","73083","2018",3,3,0,131889,1551.333,71.66667
"24216","73084","2018",5,4,1,242800,2726,96.8
"24217","73085","2018",27,21,6,186897.3,2099.259,92.51852
"24218","73087","2018",67,14,53,183992.6,2433.716,78.68657
"24219","73088","2018",9,1,8,189933.3,3726.111,50.77778
"24220","73089","2018",7,6,1,207123.6,2276.286,90.42857
"24221","73090","2018",3,3,0,95556.67,1080.667,98
"24222","73091","2018",3,3,0,331330,3562,94.33333
"24223","73092","2018",3,3,0,192233.3,3109,69.33333
"24224","73094","2018",26,5,21,275532.3,4943.192,61
"24225","73096","2018",14,14,0,204700.4,2204.714,97.28571
"24226","73097","2018",7,7,0,266478.6,2953.429,103
"24227","73098","2018",24,18,6,205422,2854.833,80.66667
"24228","73099","2018",3,3,0,258366.7,1817.333,153.3333
"24229","73100","2018",29,28,1,185162.4,1860.931,100.931
"24230","73101","2018",1,1,0,65000,1182,55
"24231","73103","2018",34,16,18,340369.2,3327.235,104.1176
"24232","73104","2018",8,8,0,187427,1687.625,116.375
"24233","73105","2018",19,13,6,145517.9,1771.947,80.47368
"24234","73106","2018",5,5,0,128150,1291.6,104.2
"24235","73107","2018",3,3,0,140953.3,1922.333,76.33333
"24236","73109","2018",18,16,2,176346.2,1696.944,105.2778
"24237","73110","2018",8,8,0,113418.8,1479.5,86.125
"24238","73113","2018",4,4,0,204672.5,2083.25,96.75
"24239","73114","2018",19,2,17,125084.8,3125.842,40.47368
"24240","73116","2018",74,9,65,105665.7,2773.946,36.63514
"24241","73117","2018",5,1,4,94250,1303.2,73
"24242","73120","2018",2,2,0,89962,1458.5,60
"24243","73121","2018",11,8,3,177636.4,2121.364,82.90909
"24244","73122","2018",2,2,0,132500,1044.5,127.5
"24245","73123","2018",17,6,11,175458.8,3207.765,54.17647
"24246","73124","2018",28,16,12,222906.4,2351.429,101.25
"24247","73128","2018",61,27,34,272620.5,3144.525,90.14754
"24248","73129","2018",16,11,5,174203.8,2109.938,90.25
"24249","73130","2018",20,16,4,189088.5,2295,85.1
"24250","73131","2018",2,2,0,145000,1891.5,71
"24251","73132","2018",67,7,60,194098.4,5283.418,37.52239
"24252","73133","2018",5,5,0,182700,1797.6,106.8
"24253","73135","2018",9,8,1,131541.1,1667.444,78.22222
"24254","73137","2018",57,4,53,155412.2,2754.877,57.29825
"24255","73138","2018",9,9,0,119862.2,1672.556,67.44444
"24256","73139","2018",6,5,1,159247,2140.833,76.83333
"24257","73140","2018",6,6,0,172583.5,1950.833,89.83333
"24258","73141","2018",10,9,1,244780,2709.5,94
"24259","73142","2018",32,4,28,177790.8,3533.688,50.9375
"24260","73145","2018",5,5,0,224360,2893,87.2
"24261","73146","2018",8,6,2,187627.1,2208.375,103.875
"24262","73147","2018",2,2,0,240500,2262,106
"24263","73149","2018",4,4,0,209546.2,1747.75,118.25
"24264","73150","2018",266,32,234,125935.9,3456.778,37.6203
"24265","73151","2018",36,26,10,240874.9,2780.056,93.86111
"24266","73152","2018",2,2,0,292800,2702.5,108.5
"24267","73153","2018",11,8,3,167729.5,1937.182,88.27273
"24268","73154","2018",35,21,14,259688.9,2377.229,113.5143
"24269","73155","2018",22,12,10,283240,3338.909,86.68182
"24270","73156","2018",1,1,0,219000,2489,88
"24271","73157","2018",84,7,77,72324.89,1642.274,49.25
"24272","73159","2018",8,6,2,181938.8,2106.375,85
"24273","73160","2018",8,6,2,313074.6,2771.75,114.875
"24274","73161","2018",9,7,2,171955.6,2026.667,93.66667
"24275","73162","2018",7,7,0,235547.6,1904.143,121
"24276","73164","2018",11,9,2,303012.7,3005.091,105.3636
"24277","73166","2018",1,1,0,180000,1500,120
"24278","73168","2018",1,1,0,37000,1321,28
"24279","73170","2018",7,7,0,298451.4,2537.286,122.1429
"24280","73171","2018",47,11,36,157123.8,2205.234,73.12766
"24281","73173","2018",3,2,1,245573.3,3384,79.66667
"24282","73175","2018",2,2,0,139000,2148.5,61
"24283","73176","2018",64,3,61,186707.5,3590.172,49.625
"24284","73177","2018",3,2,1,202983.3,1837.667,105.6667
"24285","73178","2018",6,6,0,303961,2141.5,140.3333
"24286","73179","2018",133,41,92,223083.3,2807.248,78.3609
"24287","73180","2018",5,5,0,164490,2019.8,84.2
"24288","73181","2018",31,6,25,146884.7,1891.839,77.58065
"24289","73182","2018",16,13,3,305284.4,2932.688,104
"24290","73183","2018",9,6,3,353142.4,2853.667,121.4444
"24291","73184","2018",2,2,0,207537.5,2472.5,86
"24292","73186","2018",34,3,31,182666.8,3924.559,44.02941
"24293","73187","2018",24,14,10,151923.3,2686.375,60.20833
"24294","73188","2018",5,4,1,222880,2050.6,109.2
"24295","73189","2018",1,1,0,135000,1875,72
"24296","73190","2018",6,4,2,68268.33,1323.833,67.33333
"24297","73191","2018",18,16,2,230527.2,2190.889,99.22222
"24298","73192","2018",4,3,1,137965,1491,86.75
"24299","73193","2018",2,2,0,152500,1826.5,76
"24300","73194","2018",7,2,5,81805.71,1968.429,44
"24301","73196","2018",5,3,2,193980,1612.2,121
"24302","73197","2018",21,8,13,283008.7,3728.286,71.2381
"24303","73200","2018",4,3,1,212980,2689.5,104.25
"24304","73201","2018",5,4,1,148200,2024.4,72.2
"24305","73202","2018",4,4,0,174408.8,1839,96.5
"24306","73204","2018",16,10,6,157471.2,1770.188,89.3125
"24307","73205","2018",2,2,0,220495,2125,105
"24308","73206","2018",36,6,30,177672,3870.944,45.16667
"24309","73207","2018",3,3,0,222833.3,3175,70
"24310","73208","2018",17,13,4,421426.8,3364.059,121.1765
"24311","73210","2018",1,1,0,150200,1113,135
"24312","73211","2018",7,7,0,215557.1,2797.857,79.42857
"24313","73212","2018",18,15,3,147624.7,1738.889,83.05556
"24314","73213","2018",88,34,54,250741,2825.557,90.5
"24315","73214","2018",3,3,0,157333.3,1693.667,97.33333
"24316","73215","2018",39,24,15,171997.6,1756.256,97
"24317","73216","2018",4,4,0,118725,1808.5,79.5
"24318","73217","2018",4,2,2,188678.2,1725.25,113.5
"24319","73218","2018",6,5,1,132575,1625.5,78.5
"24320","73219","2018",8,7,1,304363.6,3539.375,93.5
"24321","73220","2018",9,9,0,121388.9,1594.889,75.33333
"24322","73221","2018",2,2,0,122712,1026.5,119
"24323","73222","2018",70,31,39,247903,2810,86.98571
"24324","73223","2018",9,6,3,136736.7,1369.111,103.2222
"24325","73224","2018",5,3,2,123600,2092.8,75.8
"24326","73225","2018",23,18,5,295649.3,2603.478,120.6087
"24327","73226","2018",18,17,1,176391.4,1718.722,101.6667
"24328","73227","2018",132,23,109,411898.1,6839.455,57.5
"24329","73228","2018",12,8,4,258558.3,2610.333,98.75
"24330","73229","2018",5,5,0,156510,1993.8,84.8
"24331","73230","2018",2,1,1,27000,470,58.5
"24332","73231","2018",13,12,1,129405,1536.462,86.07692
"24333","73232","2018",15,5,10,325006.8,4208.133,76.53333
"24334","73233","2018",2,2,0,155142.5,1162,132.5
"24335","73234","2018",4,4,0,172750,2364.25,84.25
"24336","73235","2018",63,5,58,107181.6,2611.492,41.93651
"24337","73236","2018",26,25,1,181209.6,1593.346,113
"24338","73237","2018",4,4,0,206662.5,2151,95
"24339","73240","2018",10,10,0,220295,2257,103.3
"24340","73241","2018",8,8,0,221545.2,2582.375,88.375
"24341","73242","2018",33,4,29,111510.8,2657.455,43.54545
"24342","73243","2018",15,11,4,273636.7,2808.4,97.33333
"24343","73245","2018",14,10,4,204690,2100.714,98.64286
"24344","73246","2018",3,3,0,143333.3,1589,93.66667
"24345","73247","2018",8,7,1,201242.5,1821.75,116.625
"24346","73248","2018",78,14,64,117513.9,1589.641,75.69231
"24347","73249","2018",31,6,25,261138.5,3065.806,86.54839
"24348","73250","2018",11,7,4,158711.3,1832.364,87.63636
"24349","73252","2018",2,2,0,110000,1329.5,74
"24350","73253","2018",9,4,5,144324.4,2150.667,68.44444
"24351","73254","2018",3,3,0,197500,2019.333,98.33333
"24352","73255","2018",5,4,1,126798.2,1959,78
"24353","73256","2018",2,2,0,127850,1376,98.5
"24354","73257","2018",339,31,308,171286.3,4901.339,34.28909
"24355","73258","2018",3,2,1,60666.67,765,62
"24356","73259","2018",5,5,0,160750,1813.8,96.8
"24357","73261","2018",35,21,14,107421.3,1259.571,86.8
"24358","73262","2018",7,4,3,342044.9,3194.143,92.57143
"24359","73263","2018",8,8,0,306203.8,2724.375,114.75
"24360","73265","2018",12,9,3,257975.4,2488.75,108.5833
"24361","73267","2018",7,4,3,144365,2354.429,55.71429
"24362","73268","2018",4,3,1,122060,1778.75,70
"24363","73269","2018",11,11,0,210557,2277.182,98.09091
"24364","73270","2018",53,33,20,176045.4,2071.83,88.4717
"24365","73271","2018",3,3,0,187372.3,2432,81.66667
"24366","73272","2018",2,2,0,111000,1545.5,68
"24367","73273","2018",10,10,0,171802.5,1630.9,110
"24368","73274","2018",8,8,0,180687.5,2196.125,90.625
"24369","73275","2018",2,2,0,168885,1958.5,84
"24370","73276","2018",3,3,0,213783.3,1586.333,142.3333
"24371","73277","2018",3,3,0,93516.67,1139.667,78.33333
"24372","73278","2018",11,10,1,138318.2,1682.455,75.72727
"24373","73280","2018",34,4,30,142484.7,2749.5,49.85294
"24374","73281","2018",4,4,0,298100,1926.5,168
"24375","73282","2018",7,6,1,224162.9,2341.857,103.5714
"24376","73283","2018",5,2,3,145288,1737.4,79.8
"24377","73284","2018",15,7,8,146575.7,2053.933,69.2
"24378","73285","2018",30,8,22,220125.5,2934.1,78.6
"24379","73286","2018",10,7,3,197198,1696.5,109.8
"24380","73288","2018",27,15,12,280956.7,2688.481,99.2963
"24381","73289","2018",11,11,0,139455.6,1530,90.36364
"24382","73290","2018",64,13,51,152865.4,3144.469,54.70312
"24383","73292","2018",4,3,1,247335,2265.25,99.75
"24384","73293","2018",10,10,0,208991,2294.1,91.5
"24385","73294","2018",3,2,1,168900,2469,71.33333
"24386","73296","2018",169,2,167,169461.5,4523.911,36.23077
"24387","73297","2018",4,4,0,163350,2044.5,78
"24388","73298","2018",4,3,1,165770,1465,110.75
"24389","73299","2018",4,4,0,168302.2,1818,82.25
"24390","73300","2018",50,20,30,346099.3,3588.2,93.56
"24391","73301","2018",7,6,1,334564.3,2841.429,120.5714
"24392","73302","2018",3,3,0,131666.7,1416.333,96.33333
"24393","73303","2018",59,36,23,176698.1,2074.441,86.37288
"24394","73304","2018",103,2,101,322237.5,7868.369,38.93204
"24395","73306","2018",87,4,83,170579.1,4065.448,41.34483
"24396","73307","2018",59,2,57,91944,2694.881,34.38983
"24397","73308","2018",4,4,0,270000,2390,115
"24398","73309","2018",4,4,0,130825,885.25,155.5
"24399","73310","2018",3,3,0,372333.3,2399,154.6667
"24400","73311","2018",2,2,0,146150,1092,131
"24401","73312","2018",6,6,0,253923.3,2612,97.5
"24402","73313","2018",5,5,0,172580,1919.4,89.2
"24403","73314","2018",1,1,0,275000,1858,148
"24404","73315","2018",8,8,0,170071.2,2070.875,84.5
"24405","73316","2018",6,4,2,108283.3,1295.667,86.83333
"24406","73317","2018",34,6,28,225116.5,4586.294,50.58824
"24407","73318","2018",72,0,72,46670.07,1699.847,26.36111
"24408","73320","2018",6,6,0,197366.7,1819.333,109.3333
"24409","73322","2018",31,0,31,75572.61,2537.742,30.35484
"24410","73323","2018",5,1,4,172400,2522.2,77.2
"24411","73324","2018",2,2,0,189500,3321.5,52
"24412","73326","2018",18,14,4,294698.2,3158.889,94.55556
"24413","73327","2018",3,3,0,128908.3,1123.333,117.3333
"24414","73328","2018",28,17,11,298426.2,3417.643,89.25
"24415","73329","2018",15,7,8,231841.7,2936.267,80.53333
"24416","73330","2018",26,19,7,151253.6,1785.154,86.69231
"24417","74001","2018",39,8,31,155910.1,2692.256,55.79487
"24418","74002","2018",26,10,16,240109.7,3168.769,76.53846
"24419","74003","2018",10,8,2,494066,3997,128
"24420","74004","2018",7,7,0,230741.4,3167.143,75.42857
"24421","74005","2018",53,42,11,331152.6,3341.075,98.16981
"24422","74006","2018",21,4,17,247575.9,3687.524,69.19048
"24423","74007","2018",22,14,8,309703.6,3139.273,107
"24424","74008","2018",99,12,87,209043.7,3346.838,60.31313
"24425","74009","2018",9,7,2,509903.9,4369.778,118.2222
"24426","74010","2018",1935,178,1757,281657.3,4059.257,69.46873
"24427","74012","2018",524,27,497,195510.3,3013.365,64.6813
"24428","74013","2018",33,22,11,446103.7,4806.788,95.06061
"24429","74014","2018",189,20,169,175392.7,3898.466,42.89418
"24430","74015","2018",11,8,3,295274.5,2629.818,111.5455
"24431","74016","2018",40,16,24,438496.5,4397.2,98.825
"24432","74018","2018",22,9,13,242235.8,2896.5,91.95455
"24433","74019","2018",29,13,16,316365.1,3617.586,91.37931
"24434","74020","2018",20,15,5,372409.6,3336.85,112.1
"24435","74021","2018",20,12,8,287742.5,2858.45,105.45
"24436","74024","2018",18,15,3,285535,2755.444,111.8333
"24437","74025","2018",15,13,2,436546.7,3648.6,125.8667
"24438","74026","2018",84,41,43,281886.6,3390.071,84.92857
"24439","74027","2018",1,1,0,235370,2354,100
"24440","74029","2018",9,9,0,138856.6,2330,66.77778
"24441","74030","2018",5,5,0,156509,3589.8,52
"24442","74031","2018",41,20,21,349207.1,3850.268,92.63415
"24443","74032","2018",30,6,24,101680.2,2360.033,42.86667
"24444","74033","2018",36,16,20,174155.4,2761.611,57.80556
"24445","74034","2018",33,19,14,186224.3,2430.848,71.9697
"24446","74035","2018",4,3,1,246007.5,2661.25,92.25
"24447","74036","2018",6,6,0,629075.8,5375.5,120.6667
"24448","74037","2018",22,13,9,314903.9,3320.5,98.22727
"24449","74038","2018",19,7,12,126925,2463.789,46.78947
"24450","74040","2018",40,21,19,318557.5,3688.525,89.6
"24451","74041","2018",2,2,0,235712.5,3093,76
"24452","74042","2018",192,43,149,176793.1,2552.141,72.03646
"24453","74043","2018",66,35,31,272549.7,3379.97,84.04545
"24454","74044","2018",16,10,6,562992.9,4711.125,110.1875
"24455","74045","2018",6,6,0,293951.7,3036.333,108.1667
"24456","74046","2018",2,2,0,336280,2759,126
"24457","74048","2018",7,7,0,509614.3,3221.571,160.7143
"24458","74049","2018",8,8,0,141625,2315.875,59.25
"24459","74050","2018",7,7,0,275367.1,3463.857,98
"24460","74051","2018",11,6,5,289424.6,3764.636,80.54545
"24461","74052","2018",9,3,6,305077.8,3655.778,81.33333
"24462","74053","2018",8,8,0,363937.5,2830.5,133.625
"24463","74054","2018",10,9,1,308368,3040.8,103.8
"24464","74055","2018",7,5,2,223057.1,2297.571,100
"24465","74056","2018",379,54,325,409486,6981.472,53.88918
"24466","74057","2018",7,7,0,397830,3695.571,112.8571
"24467","74058","2018",41,6,35,172204.4,3662.951,46.34146
"24468","74059","2018",4,3,1,298335,1832.75,177.5
"24469","74061","2018",10,5,5,289236.2,3445.4,86.6
"24470","74062","2018",19,8,11,340084.2,3723.211,93
"24471","74063","2018",125,13,112,212206.6,4311.648,46.824
"24472","74064","2018",14,12,2,229613.6,3080.214,81.57143
"24473","74065","2018",6,6,0,292295.8,2809.167,112.6667
"24474","74067","2018",15,9,6,353674.7,3486.267,110.8
"24475","74068","2018",4,4,0,368000,2873.25,128.75
"24476","74069","2018",11,5,6,379504.5,3909.091,97.36364
"24477","74070","2018",49,23,26,486550.3,4292,103.4898
"24478","74071","2018",3,3,0,238066.7,2104.667,115.6667
"24479","74072","2018",1,1,0,418000,3051,137
"24480","74073","2018",3,2,1,205060,1794.667,110.3333
"24481","74074","2018",6,3,3,323763.8,3916.5,89.66667
"24482","74075","2018",14,13,1,312614.3,2947.571,108.7143
"24483","74076","2018",29,22,7,339471.6,3055.517,113.4138
"24484","74077","2018",5,4,1,365926,3452.2,112.8
"24485","74078","2018",8,7,1,257843.9,2815.625,100.625
"24486","74079","2018",4,2,2,196078.8,3643,53.75
"24487","74080","2018",80,11,69,374426.7,6888.825,53
"24488","74081","2018",205,38,167,158791.1,2140.259,73.20488
"24489","74082","2018",69,19,50,309534.7,4146.101,73.23188
"24490","74083","2018",57,11,46,407553.4,5286.807,64.98246
"24491","74085","2018",68,9,59,216962.8,4022.368,50.32353
"24492","74086","2018",7,7,0,374264.3,3268,124
"24493","74087","2018",32,21,11,315440.3,3639.531,92.21875
"24494","74088","2018",27,16,11,412328.5,3706.63,117.0741
"24495","74089","2018",22,5,17,244585.9,3557.318,66.22727
"24496","74090","2018",19,9,10,303056.9,3181.316,99
"24497","74091","2018",6,1,5,217735.2,3896.667,56
"24498","74094","2018",66,47,19,376059.4,3442.455,108.9091
"24499","74095","2018",1,1,0,250300,2275,110
"24500","74096","2018",60,29,31,299225.9,3465,87.88333
"24501","74097","2018",20,19,1,341430.4,3546.45,103.75
"24502","74098","2018",14,12,2,427432.8,3554.571,131.0714
"24503","74099","2018",26,3,23,361457.2,5476.038,54.11538
"24504","74100","2018",12,11,1,234651.8,2339.583,103.25
"24505","74101","2018",12,7,5,322344.6,3142.167,102
"24506","74102","2018",13,9,4,321967.8,3367.154,98.46154
"24507","74103","2018",25,16,9,298362.4,3219.08,92.2
"24508","74104","2018",45,22,23,290153.7,3300.711,87.71111
"24509","74105","2018",118,48,70,258198.4,3283.186,80.38983
"24510","74106","2018",8,7,1,325620.2,2969.25,110
"24511","74107","2018",1,1,0,190000,2135,89
"24512","74108","2018",16,8,8,459360.6,5772.688,86.375
"24513","74109","2018",11,9,2,286610,3003.545,104
"24514","74111","2018",7,5,2,173921.4,3729.857,51.14286
"24515","74112","2018",113,34,79,311496.8,4089.796,76.63717
"24516","74114","2018",9,7,2,387555.6,4384.778,81.66667
"24517","74116","2018",14,10,4,379650,3227.571,129
"24518","74117","2018",6,6,0,433383.3,3380,129.5
"24519","74118","2018",38,13,25,272147.8,4277.921,65.07895
"24520","74119","2018",184,30,154,263356.1,3734.114,69.44022
"24521","74121","2018",12,11,1,353160,3685.417,100.0833
"24522","74122","2018",7,5,2,246864.3,2473.571,96.71429
"24523","74123","2018",75,41,34,175537,2171.093,84.70667
"24524","74124","2018",17,14,3,445085.3,4093.471,109.4706
"24525","74126","2018",11,11,0,336335.3,3184.909,112.2727
"24526","74127","2018",14,13,1,315489.2,3110.786,103.3571
"24527","74128","2018",33,30,3,382549.6,3381.303,117.0303
"24528","74129","2018",1,1,0,215000,2363,91
"24529","74130","2018",4,4,0,220375,2228,94.75
"24530","74131","2018",21,12,9,229565,2434.905,99.52381
"24531","74133","2018",188,21,167,185974.3,3194.5,55.54255
"24532","74134","2018",94,19,75,348690.8,6023.926,56.2766
"24533","74135","2018",12,7,5,206211.2,2366.5,96.16667
"24534","74136","2018",97,12,85,231164.8,5069.495,45.09278
"24535","74137","2018",42,18,24,334454.9,3812.381,86.83333
"24536","74138","2018",19,5,14,259621.8,3094,84.10526
"24537","74139","2018",14,10,4,239221.6,3032.214,81.85714
"24538","74140","2018",31,17,14,163604.8,2462.484,65.51613
"24539","74141","2018",8,6,2,294660,3274.25,94.125
"24540","74142","2018",12,9,3,274564.2,2942,96.25
"24541","74143","2018",143,32,111,275782.2,5037.86,54.84615
"24542","74144","2018",11,9,2,439207.3,3366.909,134.1818
"24543","74145","2018",10,9,1,404021,3102.4,143.4
"24544","74146","2018",26,25,1,366646.7,3008.846,127.3462
"24545","74147","2018",16,11,5,347262.9,3431.125,100
"24546","74148","2018",4,2,2,118250,1914.75,65.25
"24547","74150","2018",19,18,1,437818.4,3758.316,122.3158
"24548","74151","2018",5,5,0,227210,2515,90.8
"24549","74152","2018",15,9,6,371346.7,3553.333,106.6
"24550","74153","2018",29,22,7,316725,3452.69,91.93103
"24551","74154","2018",49,26,23,286547.4,3427.653,85.89796
"24552","74155","2018",11,10,1,227950,2668,89.45455
"24553","74156","2018",8,8,0,392118.8,3040.75,135.875
"24554","74157","2018",20,17,3,330944.3,2752.95,123.65
"24555","74158","2018",12,8,4,309304.2,3829.833,83.75
"24556","74159","2018",26,8,18,180990.2,2702.654,70.92308
"24557","74160","2018",63,9,54,156043.5,4272.46,35.80952
"24558","74161","2018",13,12,1,361373.1,3019.846,120.1538
"24559","74162","2018",8,6,2,325816.8,3643.625,89.375
"24560","74163","2018",15,13,2,310436,2989.933,101.5333
"24561","74164","2018",63,28,35,242231.1,2819.079,86.85714
"24562","74165","2018",3,1,2,137500,1894,87.33333
"24563","74166","2018",25,21,4,359799.4,3643.76,103.8
"24564","74167","2018",21,15,6,182780,1979.429,96.52381
"24565","74168","2018",13,9,4,291966.9,2960.692,102.2308
"24566","74169","2018",55,24,31,246503.3,2581.727,92.27273
"24567","74170","2018",11,11,0,252168.2,2728.636,93.90909
"24568","74171","2018",26,25,1,401860.9,3472.808,111.6538
"24569","74172","2018",24,17,7,314864.8,3820.417,85.375
"24570","74173","2018",156,17,139,534016.3,7322.987,64.98077
"24571","74174","2018",19,19,0,173060.2,2148.368,95.94737
"24572","74175","2018",8,5,3,261344.4,3574,75.375
"24573","74176","2018",23,14,9,625203.5,4844.174,129.5652
"24574","74177","2018",8,8,0,346173.1,4192,88.75
"24575","74178","2018",10,10,0,265571.7,2589.1,104.5
"24576","74179","2018",5,5,0,428240,3925.6,110.2
"24577","74180","2018",34,25,9,469462,4042.206,122.4412
"24578","74183","2018",36,23,13,258236.7,3112.722,83.83333
"24579","74184","2018",7,3,4,262406.4,3160.429,83
"24580","74185","2018",25,19,6,367536,3049.6,121.76
"24581","74186","2018",8,6,2,356257.2,3478.625,104.25
"24582","74188","2018",28,7,21,264842.5,4535.107,54.21429
"24583","74189","2018",38,17,21,163596.2,2531.079,65.44737
"24584","74190","2018",71,14,57,176797.6,3507.859,47.91549
"24585","74191","2018",232,31,201,271368.5,5578.517,49.18534
"24586","74192","2018",9,9,0,279916.7,2955.222,105.6667
"24587","74193","2018",8,8,0,309725,4575.25,79.125
"24588","74194","2018",15,2,13,224070.4,2957.8,79.4
"24589","74195","2018",2,2,0,253000,3371.5,81
"24590","74196","2018",5,5,0,178150,2458.4,77
"24591","74197","2018",30,9,21,233113.3,3250.533,66.8
"24592","74198","2018",3,0,3,369933.3,3341.333,105
"24593","74199","2018",11,10,1,663638.5,5355.545,126.1818
"24594","74200","2018",33,20,13,352386.1,3778.606,99.84848
"24595","74201","2018",22,13,9,478790.6,4182.864,115.5
"24596","74202","2018",10,6,4,285374.6,3431.2,84.9
"24597","74205","2018",42,21,21,161875.7,2597.357,60.7381
"24598","74206","2018",8,6,2,315326,3012,103.625
"24599","74208","2018",137,57,80,239988.8,2857.467,87.67153
"24600","74209","2018",7,7,0,353358.9,2909,132.7143
"24601","74210","2018",15,8,7,227802.6,2867.667,79.93333
"24602","74211","2018",37,31,6,334836.9,3372.432,102.5946
"24603","74212","2018",19,13,6,193225.7,2383.421,80.42105
"24604","74213","2018",91,37,54,326523.6,3929.703,87.23077
"24605","74215","2018",86,9,77,260595.2,4205.965,53.63953
"24606","74216","2018",17,8,9,380219,4199.235,95
"24607","74218","2018",95,55,40,325655.6,3817.189,85.57895
"24608","74219","2018",16,9,7,418824.4,4043.062,102.9375
"24609","74220","2018",98,34,64,288691.4,3497.316,84.13265
"24610","74221","2018",6,3,3,169878.5,2173.667,76.83333
"24611","74222","2018",4,3,1,191750,2466.5,73.75
"24612","74223","2018",7,7,0,219500,3299.143,74.42857
"24613","74224","2018",155,44,111,233510.7,2932.645,81.01935
"24614","74225","2018",237,54,183,167358.8,2336.84,72.97468
"24615","74226","2018",8,8,0,221352.1,4238,55.125
"24616","74228","2018",3,2,1,392117,4374,87.33333
"24617","74229","2018",43,33,10,368462.1,3342.14,112.2326
"24618","74231","2018",3,3,0,191100,2300.333,87.66667
"24619","74232","2018",7,4,3,248767.1,2715.857,88.28571
"24620","74233","2018",32,20,12,230594.6,2792.375,87.5
"24621","74234","2018",2,1,1,179025,2081,97.5
"24622","74235","2018",6,6,0,319633.3,2642,125.5
"24623","74236","2018",251,59,192,238011.5,3906.801,59.52988
"24624","74237","2018",17,7,10,235627.3,3325.824,75.41176
"24625","74238","2018",67,11,56,177196.4,3143.866,53.04478
"24626","74239","2018",32,11,21,283074.3,4548.688,59.9375
"24627","74240","2018",14,13,1,301932.1,2612.286,110.2143
"24628","74241","2018",53,24,29,187726.3,2485.264,74.22642
"24629","74242","2018",90,43,47,405437.7,4183.678,95.52222
"24630","74243","2018",183,33,150,333086.9,3970.71,84.51913
"24631","74244","2018",6,5,1,274676.5,2971.167,95.66667
"24632","74249","2018",7,5,2,307864.3,3135.286,97.28571
"24633","74250","2018",78,37,41,277210.2,3082.769,88.66667
"24634","74252","2018",7,7,0,366697,2246.286,175.4286
"24635","74253","2018",11,11,0,275664.1,3564.545,79.36364
"24636","74254","2018",10,8,2,273304,2466.5,108.6
"24637","74255","2018",26,21,5,279724,2965.308,95.88462
"24638","74256","2018",295,50,245,195434.4,2897.122,68.09153
"24639","74257","2018",12,8,4,227162.5,2251.833,100.25
"24640","74258","2018",127,29,98,251586.7,4394.087,53.77165
"24641","74259","2018",5,5,0,336658.6,2811.6,129.8
"24642","74260","2018",9,9,0,424940.9,3351.111,126.6667
"24643","74261","2018",6,5,1,243283.3,2712.833,90.33333
"24644","74262","2018",24,10,14,258416.1,3192.333,81.625
"24645","74263","2018",89,63,26,368235.4,3651.303,100.9551
"24646","74264","2018",98,33,65,169198.4,2160.929,80.4898
"24647","74265","2018",6,6,0,267125,2761.833,111.5
"24648","74266","2018",15,6,9,250415.3,4327.6,55.26667
"24649","74267","2018",48,24,24,576891.8,4914.167,112.6458
"24650","74269","2018",35,18,17,181139.8,2517.229,81.28571
"24651","74271","2018",4,3,1,472291.2,3715,132.25
"24652","74272","2018",23,11,12,317414.4,3772.435,84.17391
"24653","74273","2018",8,6,2,220690.5,3457.5,65.875
"24654","74275","2018",45,21,24,477260.8,4711.044,94.75556
"24655","74276","2018",71,23,48,186312.4,3131.901,59.64789
"24656","74278","2018",66,22,44,225721.9,2680.485,83.36364
"24657","74279","2018",71,21,50,141408.3,2748.592,51.19718
"24658","74280","2018",79,21,58,241956.8,3521.443,72.75949
"24659","74281","2018",666,122,544,225483.3,3101.335,71.59159
"24660","74282","2018",103,71,32,329316.2,3506.573,95.81553
"24661","74283","2018",15,15,0,294896.7,2656.667,115.2
"24662","74284","2018",9,5,4,233205.6,2872.667,85.22222
"24663","74285","2018",4,4,0,133962.5,1577.75,77
"24664","74286","2018",8,5,3,214085,2538.625,87.75
"24665","74287","2018",5,3,2,165200,2434.2,65
"24666","74288","2018",75,29,46,280904.3,3471.933,82.16
"24667","74289","2018",27,18,9,276865.2,3082.852,99.18519
"24668","74290","2018",6,6,0,344666.7,5209.833,62.83333
"24669","74291","2018",7,7,0,230714.3,2482.286,94.85714
"24670","74292","2018",8,8,0,333906.2,3898.375,108.25
"24671","74293","2018",62,31,31,409081.3,4086.677,99.77419
"24672","74294","2018",20,11,9,256641.7,3725.6,67.85
"24673","74295","2018",4,4,0,215763.5,3294.5,65.5
"24674","74296","2018",15,8,7,289367.1,3009.667,100.2
"24675","74297","2018",5,4,1,321350,2544.6,130.4
"24676","74298","2018",108,39,69,311097.1,3687.889,84.24074
"24677","74299","2018",32,16,16,954935.6,6918.406,127.75
"24678","74301","2018",11,5,6,213063.2,2266.545,100.6364
"24679","74302","2018",17,6,11,215104.5,3630.529,74.70588
"24680","74303","2018",31,21,10,454304.6,4818.581,102.4516
"24681","74304","2018",16,10,6,285812.5,3249.75,97.1875
"24682","74305","2018",118,35,83,278208.4,3613.627,74.23729
"24683","74306","2018",4,4,0,365687.5,3978.25,94
"24684","74307","2018",9,4,5,363505.6,3638.333,99.33333
"24685","74308","2018",9,9,0,289867.8,3504.444,91.77778
"24686","74309","2018",63,35,28,345486.4,3728.175,92.15873
"24687","74310","2018",12,7,5,344592.5,3459.833,105.5
"24688","74311","2018",63,31,32,255760.2,3294.444,79.5873
"24689","74312","2018",17,14,3,242776.8,2695.824,88.82353
"24690","74313","2018",9,5,4,300142.2,3294,96.66667
"24691","74314","2018",15,11,4,341518,3328.133,105.6
"24692","74315","2018",13,8,5,572858.7,5910.692,94.76923
"24693","75056","2018",30166,108,30058,492811.5,9339.571,52.1805
"24694","76001","2018",18,18,0,157498.3,1733.833,95.33333
"24695","76002","2018",5,5,0,165400,1442,127.2
"24696","76004","2018",4,4,0,143035,1735.25,73.25
"24697","76005","2018",40,38,2,151684.8,1716.175,89.1
"24698","76007","2018",7,7,0,165857.1,1500.143,122.8571
"24699","76008","2018",6,6,0,159905,1762,92.33333
"24700","76009","2018",2,2,0,95000,1285.5,73
"24701","76010","2018",3,3,0,151333.3,1661,91.33333
"24702","76011","2018",5,5,0,164840,1639.6,102.2
"24703","76012","2018",1,1,0,266600,1646,162
"24704","76013","2018",4,4,0,163750,1872,96.5
"24705","76014","2018",19,19,0,194102.6,2171.526,93.05263
"24706","76015","2018",8,8,0,170512.5,1961.25,88.5
"24707","76016","2018",2,2,0,122000,1497,80.5
"24708","76018","2018",11,11,0,137045.5,1575.636,88.63636
"24709","76019","2018",6,6,0,147491.7,1165.833,129.8333
"24710","76020","2018",13,13,0,142788.5,1527,94.84615
"24711","76021","2018",5,5,0,169840,1374,127.2
"24712","76022","2018",2,2,0,170000,1705,111
"24713","76023","2018",7,7,0,145871.9,1680.857,87.14286
"24714","76024","2018",2,2,0,176750,1504,126
"24715","76025","2018",7,6,1,118671.4,1417.143,89.14286
"24716","76026","2018",35,32,3,116842.3,1355.057,96.62857
"24717","76028","2018",2,2,0,97000,1003,96.5
"24718","76029","2018",1,1,0,178000,1894,94
"24719","76030","2018",4,4,0,188750,1614.5,116.25
"24720","76033","2018",6,6,0,170166.7,1710.5,101.1667
"24721","76034","2018",21,21,0,144416.7,1608.857,94.09524
"24722","76035","2018",13,13,0,110652.3,2121.077,68.61538
"24723","76036","2018",8,8,0,128875,1757.125,78.5
"24724","76038","2018",3,3,0,210000,2028,103
"24725","76039","2018",15,15,0,239738.7,2057.267,121.6667
"24726","76040","2018",2,2,0,186500,1735,107
"24727","76041","2018",8,8,0,210200,1698.375,121.375
"24728","76042","2018",4,4,0,131875,1162.5,118.75
"24729","76043","2018",11,11,0,191272.7,1874.909,104.5455
"24730","76045","2018",2,2,0,91250,1247.5,74
"24731","76046","2018",8,8,0,160012,1613.625,100.5
"24732","76047","2018",3,3,0,160993.3,1465.667,112.3333
"24733","76048","2018",4,4,0,212660,1986.5,112.75
"24734","76049","2018",4,4,0,114750,1300.75,83.5
"24735","76050","2018",10,10,0,108593,1275.1,82.5
"24736","76051","2018",17,17,0,146137.4,1481,102.7059
"24737","76052","2018",5,5,0,110688.6,1207.8,96.4
"24738","76054","2018",2,2,0,96000,1129.5,76.5
"24739","76055","2018",5,5,0,161410,1585.4,108.4
"24740","76056","2018",5,5,0,178360,1578.4,112.2
"24741","76057","2018",124,119,5,153242.6,1687.645,91.75
"24742","76059","2018",3,3,0,100733.3,1118.667,88.66667
"24743","76060","2018",7,7,0,125457.1,1595.429,82.42857
"24744","76062","2018",3,3,0,239166.7,1549.333,149.3333
"24745","76063","2018",5,5,0,143582.4,2254,69
"24746","76064","2018",11,10,1,187690.9,1842.909,99.90909
"24747","76065","2018",3,3,0,100500,1133.667,89.66667
"24748","76067","2018",18,18,0,131641.7,1226.778,111.6667
"24749","76068","2018",12,12,0,159144.2,1706.333,98.5
"24750","76069","2018",27,27,0,226930.4,2168.481,102.8519
"24751","76070","2018",8,8,0,108012.5,1140.75,94
"24752","76071","2018",5,5,0,109600,1383.2,78.4
"24753","76072","2018",10,10,0,228755,1898.1,125.9
"24754","76075","2018",6,6,0,128028.3,1298.333,104
"24755","76076","2018",3,3,0,158663.3,1683,93.66667
"24756","76077","2018",3,3,0,147000,1327,115.6667
"24757","76079","2018",2,2,0,174000,3006.5,90.5
"24758","76082","2018",7,7,0,155930,1625,98.57143
"24759","76083","2018",1,1,0,112000,747,150
"24760","76084","2018",1,1,0,156000,1300,120
"24761","76085","2018",6,6,0,187300,1561,117.6667
"24762","76086","2018",6,6,0,160966.7,1644.333,100.8333
"24763","76087","2018",10,10,0,149600,1623.6,99.9
"24764","76088","2018",6,6,0,172983.3,1447.5,129.3333
"24765","76090","2018",10,10,0,170800,1545.7,114.1
"24766","76091","2018",2,2,0,92000,1069.5,90
"24767","76092","2018",12,12,0,141576.9,2037.583,76.66667
"24768","76093","2018",9,9,0,158974.9,1398.889,117.6667
"24769","76094","2018",3,3,0,162083.3,1477,111.6667
"24770","76095","2018",135,75,60,195685.1,2002.511,92.88889
"24771","76096","2018",8,8,0,157000,1815.875,84
"24772","76099","2018",5,5,0,248700,2208,116.4
"24773","76100","2018",9,9,0,194677.8,1646.111,117.6667
"24774","76101","2018",19,19,0,91289.47,1314.105,70.84211
"24775","76103","2018",100,47,53,180171.1,2066.87,87.31
"24776","76104","2018",2,2,0,122350,2330.5,55
"24777","76105","2018",9,9,0,223527.8,1734.667,131.7778
"24778","76106","2018",5,5,0,261470,1988.6,137.4
"24779","76107","2018",4,4,0,151250,1489.5,102.75
"24780","76108","2018",246,154,92,286744.4,2705.878,106.8659
"24781","76110","2018",1,1,0,179000,1904,94
"24782","76111","2018",5,5,0,198600,1536.2,128
"24783","76112","2018",3,3,0,141666.7,1145,125
"24784","76113","2018",2,2,0,200950,1442,140
"24785","76114","2018",156,132,24,91171.81,1255.756,73.24359
"24786","76115","2018",8,8,0,154500,1661.25,97.75
"24787","76116","2018",42,41,1,222025,2086.19,109.381
"24788","76117","2018",4,4,0,182500,1778,103.25
"24789","76118","2018",2,2,0,131475,1900.5,71
"24790","76119","2018",1,1,0,110000,917,120
"24791","76120","2018",1,1,0,135000,1274,106
"24792","76121","2018",1,1,0,53000,803,66
"24793","76122","2018",8,8,0,120125,1248.125,101.375
"24794","76123","2018",10,10,0,253060,1822.7,142.9
"24795","76124","2018",5,5,0,185156,1786.8,106.4
"24796","76125","2018",20,20,0,160370,1391.9,120.15
"24797","76126","2018",6,6,0,129608.3,1482.333,88.66667
"24798","76128","2018",9,9,0,145811.1,1337.222,110.8889
"24799","76130","2018",5,5,0,95980,1330.8,69.6
"24800","76131","2018",16,12,4,144197.9,2163.062,82.0625
"24801","76132","2018",9,9,0,144238.9,1420.222,103.2222
"24802","76133","2018",7,7,0,212061.4,1776.714,115.8571
"24803","76134","2018",2,2,0,301790,1939.5,147
"24804","76135","2018",9,9,0,157938.9,1544.556,108
"24805","76136","2018",8,8,0,122543.8,1493.875,81.5
"24806","76138","2018",3,3,0,114333.3,1495,84.66667
"24807","76139","2018",1,1,0,87500,781,112
"24808","76140","2018",2,2,0,204050,1956.5,102
"24809","76141","2018",17,17,0,146088.2,1695.059,94.52941
"24810","76142","2018",3,3,0,127333.3,1236.333,104
"24811","76143","2018",13,13,0,156203.8,1557.231,103.8462
"24812","76144","2018",2,2,0,211000,1153,178.5
"24813","76146","2018",19,18,1,162123.7,1762.263,92.89474
"24814","76147","2018",8,8,0,139712.5,1461.75,110.375
"24815","76148","2018",1,1,0,124000,761,163
"24816","76149","2018",4,4,0,116987.5,1522.25,77.75
"24817","76151","2018",2,2,0,256500,1769.5,140
"24818","76152","2018",13,13,0,161926.9,1574.846,104.3846
"24819","76153","2018",6,6,0,172316.7,1687.833,105
"24820","76154","2018",6,6,0,52944.5,685.6667,79
"24821","76155","2018",4,4,0,182550,1378,121
"24822","76156","2018",4,4,0,135125,1243.5,102.25
"24823","76157","2018",116,72,44,143654.1,1631.491,88.37069
"24824","76158","2018",8,8,0,139125,1476,96.5
"24825","76159","2018",31,30,1,140062.8,1695.839,83.06452
"24826","76160","2018",2,2,0,122500,1864,67
"24827","76161","2018",2,2,0,102000,1193,89
"24828","76162","2018",6,6,0,145083.3,1223,110.3333
"24829","76163","2018",6,6,0,166370,1517.833,120
"24830","76164","2018",51,40,11,147032,1677.608,90.05882
"24831","76165","2018",108,83,25,124458.2,1418.407,89.25926
"24832","76166","2018",2,2,0,128650,1697.5,75
"24833","76167","2018",23,23,0,248945.7,2193.913,121.3478
"24834","76168","2018",3,3,0,119666.7,1686.333,71.33333
"24835","76169","2018",14,14,0,208157.1,2612,103.6429
"24836","76171","2018",1,1,0,130000,1275,102
"24837","76172","2018",3,3,0,237333.3,2419.667,91.33333
"24838","76173","2018",6,6,0,84250,1136.667,72.16667
"24839","76174","2018",2,2,0,195000,2045,95
"24840","76175","2018",1,1,0,42500,625,68
"24841","76176","2018",1,1,0,167870,1119,150
"24842","76177","2018",5,5,0,147840,1750.6,85.6
"24843","76178","2018",19,18,1,162302.6,1694.895,97.73684
"24844","76179","2018",22,20,2,179606.8,1766.955,103.7727
"24845","76180","2018",2,2,0,213700,1507,172
"24846","76181","2018",5,5,0,201200,2066.2,102
"24847","76182","2018",2,2,0,137000,1066.5,141
"24848","76183","2018",4,4,0,142837.5,1759.25,80.75
"24849","76186","2018",7,7,0,81142.86,1020.857,83.42857
"24850","76187","2018",4,4,0,185500,1299.75,150.75
"24851","76188","2018",6,6,0,178550,1623,110.8333
"24852","76189","2018",3,3,0,129357,1972.333,75
"24853","76190","2018",3,3,0,126223.3,1546,83
"24854","76192","2018",77,60,17,119131.4,1945.909,67.85714
"24855","76193","2018",3,3,0,227466.3,1343.667,153.6667
"24856","76194","2018",3,3,0,134382,1973.333,65.66667
"24857","76195","2018",3,3,0,168333.3,1136.667,174.3333
"24858","76196","2018",6,6,0,267250,2630.667,115.1667
"24859","76198","2018",7,7,0,155028.6,1533.857,100.1429
"24860","76199","2018",10,10,0,132315,1270,117.5
"24861","76200","2018",3,3,0,166333.3,1394.333,119.3333
"24862","76201","2018",9,9,0,139333.3,1825.778,81.33333
"24863","76202","2018",3,3,0,153333.3,1569.333,101.6667
"24864","76203","2018",13,13,0,169539.5,1505.615,128.3077
"24865","76204","2018",2,2,0,81200,1374,55.5
"24866","76205","2018",3,3,0,91333.33,1467.667,61.66667
"24867","76206","2018",7,7,0,243642.9,2096.143,118.2857
"24868","76207","2018",3,3,0,79333.33,968.6667,115.3333
"24869","76208","2018",4,4,0,126250,2077.25,65.5
"24870","76209","2018",9,9,0,130500,1530.667,88.22222
"24871","76210","2018",2,2,0,154200,1526,101
"24872","76211","2018",3,3,0,99200,1099.667,91.33333
"24873","76212","2018",97,67,30,138187.9,1820.66,77.26804
"24874","76213","2018",5,5,0,134400,1451,95.6
"24875","76214","2018",6,6,0,132500,1575.5,85
"24876","76216","2018",121,72,49,128377.1,1787.835,74.20661
"24877","76217","2018",430,199,231,124421.3,1706.463,74.50465
"24878","76218","2018",1,1,0,127000,648,196
"24879","76219","2018",24,23,1,144304.2,1434.958,101.4583
"24880","76220","2018",5,5,0,167000,1316.2,123.4
"24881","76221","2018",2,2,0,178800,1560.5,115.5
"24882","76222","2018",51,43,8,157271.6,1914.275,85.92157
"24883","76223","2018",4,4,0,157250,1990.25,89.75
"24884","76224","2018",12,12,0,185408.3,2010.833,99.41667
"24885","76225","2018",6,6,0,159716.7,1556,107
"24886","76226","2018",2,2,0,209170,1836,113.5
"24887","76227","2018",5,5,0,121780,1475,83.6
"24888","76228","2018",2,2,0,77500,1345.5,58
"24889","76229","2018",3,3,0,110224,1250.667,83
"24890","76230","2018",6,6,0,145100,1403.333,111.6667
"24891","76231","2018",131,75,56,120501.1,1393.191,89.50382
"24892","76232","2018",11,11,0,154040.9,1634.091,93.72727
"24893","76233","2018",1,1,0,97000,924,105
"24894","76234","2018",8,8,0,145012.5,1798.625,90.75
"24895","76235","2018",15,14,1,147346.7,1399.267,110.0667
"24896","76236","2018",4,4,0,132950,1355.75,97.5
"24897","76237","2018",6,6,0,183050,1831.667,102
"24898","76238","2018",25,25,0,194684,1985.52,99.28
"24899","76239","2018",9,9,0,222788.9,2094.444,109.7778
"24900","76240","2018",11,11,0,195313.6,1983,102
"24901","76241","2018",3,3,0,130450,1224.667,113.3333
"24902","76243","2018",2,2,0,192000,1458,135
"24903","76244","2018",6,6,0,134028.3,1485,99.66667
"24904","76245","2018",20,20,0,186790,1920.7,101.55
"24905","76247","2018",3,3,0,150466.7,1535.667,91.66667
"24906","76249","2018",9,9,0,114400,1216.556,97.22222
"24907","76250","2018",17,17,0,202410.9,2013.412,103.0588
"24908","76251","2018",4,4,0,111200,1519,69
"24909","76252","2018",13,13,0,153389.8,1562.846,104.6923
"24910","76253","2018",7,7,0,228628.6,1709,134.4286
"24911","76254","2018",48,34,14,187431.3,2387.979,84.72917
"24912","76255","2018",98,76,22,123286.2,1418.5,86.37755
"24913","76257","2018",1,1,0,90000,1098,82
"24914","76258","2018",29,27,2,139629.3,1544.759,91.55172
"24915","76259","2018",227,165,62,124463.4,1630.41,76.20705
"24916","76260","2018",10,10,0,139910,1876.7,74.7
"24917","76261","2018",1,1,0,157000,1892,83
"24918","76262","2018",2,2,0,161625,1728.5,92.5
"24919","76263","2018",17,17,0,142619.1,1608.176,92.05882
"24920","76264","2018",5,5,0,148512,1700.6,90.2
"24921","76266","2018",10,10,0,123530,1358.5,91.4
"24922","76268","2018",1,1,0,155000,1535,101
"24923","76269","2018",3,3,0,152500,1246.333,124.3333
"24924","76270","2018",21,21,0,289928.6,2287.381,131.7619
"24925","76271","2018",12,12,0,157705,1904.667,85.41667
"24926","76272","2018",11,11,0,129078.2,1484.818,87.27273
"24927","76273","2018",4,4,0,318750,2235,150
"24928","76274","2018",1,1,0,185000,1217,152
"24929","76275","2018",16,16,0,209113.4,2149.562,98.375
"24930","76276","2018",32,30,2,109885.2,1316.344,83.125
"24931","76278","2018",8,8,0,81215,975.375,94.75
"24932","76279","2018",2,2,0,158500,1311.5,123
"24933","76280","2018",3,3,0,84000,1599,53.66667
"24934","76281","2018",24,22,2,173613.8,1772.583,103.75
"24935","76282","2018",11,11,0,196918.2,1800.545,114.2727
"24936","76283","2018",1,1,0,156500,1647,95
"24937","76284","2018",5,5,0,147000,1583.2,94
"24938","76285","2018",7,7,0,219364.3,2125.571,113.1429
"24939","76286","2018",9,9,0,94166.67,979.4444,94.33333
"24940","76287","2018",18,18,0,188266.7,1936.889,99.22222
"24941","76288","2018",5,5,0,149500,1954.4,76.4
"24942","76289","2018",13,13,0,177426.9,1777.231,100.5385
"24943","76290","2018",5,5,0,314710,2086.8,149.6
"24944","76291","2018",11,11,0,167112.4,1697.545,97.81818
"24945","76292","2018",4,4,0,130250,1637.75,87.75
"24946","76293","2018",3,3,0,194884,1387.667,144.6667
"24947","76294","2018",7,7,0,167129.6,1520.143,109.8571
"24948","76295","2018",9,9,0,102500,1308.778,83.33333
"24949","76296","2018",35,35,0,198531.3,1846.686,109.9429
"24950","76297","2018",2,2,0,115500,1546,86
"24951","76298","2018",7,7,0,178185.7,1637,119.7143
"24952","76299","2018",7,7,0,196385.7,1663,119.1429
"24953","76300","2018",6,6,0,184783.3,2156.5,85.66667
"24954","76302","2018",2,2,0,231000,2383,98
"24955","76303","2018",9,9,0,137006.8,1315,103.4444
"24956","76304","2018",8,8,0,195512.5,1933.125,101.5
"24957","76305","2018",72,66,6,155520.1,2011.833,81.48611
"24958","76306","2018",3,3,0,209666.7,1616.333,143.6667
"24959","76307","2018",17,13,4,189482.4,2172.882,89.11765
"24960","76308","2018",3,3,0,133000,1613,84.33333
"24961","76309","2018",2,2,0,192400,1321,145
"24962","76311","2018",3,3,0,178500,1396,125
"24963","76312","2018",49,44,5,129815.3,1482.592,96.79592
"24964","76313","2018",1,1,0,161000,2875,56
"24965","76314","2018",6,6,0,228641.7,1964.333,120.3333
"24966","76315","2018",8,8,0,154125,1712.25,87.25
"24967","76316","2018",5,5,0,186400,2125.6,88.6
"24968","76317","2018",8,8,0,164368.8,1677.75,115
"24969","76318","2018",6,6,0,185808,1748.167,111.6667
"24970","76319","2018",69,65,4,160485.9,1802.739,91.68116
"24971","76320","2018",2,2,0,150000,1571.5,93.5
"24972","76321","2018",22,22,0,129022.7,1407.591,93.5
"24973","76322","2018",150,91,59,175447.7,2121.867,84.56667
"24974","76323","2018",1,1,0,314600,2477,127
"24975","76324","2018",3,3,0,179500,2054.333,100
"24976","76325","2018",8,8,0,155803.8,1264.75,134.625
"24977","76327","2018",1,1,0,170000,1809,94
"24978","76328","2018",5,5,0,159180,1839.8,90.4
"24979","76329","2018",46,46,0,147547.7,1693.435,92.71739
"24980","76330","2018",11,11,0,158533.2,1468.364,106.1818
"24981","76331","2018",3,3,0,167230,1569,108.3333
"24982","76332","2018",8,8,0,102937.6,1231.875,85.25
"24983","76333","2018",7,7,0,417500,3414.714,115.1429
"24984","76334","2018",8,8,0,183726.2,1467.875,133.875
"24985","76335","2018",2,2,0,147000,1370.5,111.5
"24986","76336","2018",10,10,0,168209,1370,128.9
"24987","76338","2018",4,4,0,152750,1427.5,107.25
"24988","76339","2018",2,2,0,215000,1364,149
"24989","76340","2018",4,4,0,100291.5,1034.75,95.25
"24990","76341","2018",72,52,20,153791.1,1911.931,83.43056
"24991","76342","2018",2,2,0,102500,1175,87.5
"24992","76343","2018",2,2,0,170000,1785.5,98
"24993","76344","2018",8,8,0,151601.2,1475.625,105.75
"24994","76345","2018",6,6,0,102000,1217.5,79
"24995","76346","2018",5,5,0,104284,1123,97.4
"24996","76347","2018",3,3,0,180000,1735,113.6667
"24997","76348","2018",3,3,0,148566.7,1423.333,102.6667
"24998","76349","2018",19,17,2,241387.9,2061.684,113.7895
"24999","76350","2018",3,3,0,165333.3,1808,91.66667
"25000","76351","2018",2452,904,1548,132500.1,1881.912,70.23899
"25001","76352","2018",3,3,0,108333.3,1350,82.33333
"25002","76353","2018",2,2,0,191250,1461,131.5
"25003","76355","2018",8,7,1,155590,1265,128.25
"25004","76357","2018",4,4,0,222375,2231.25,102.25
"25005","76358","2018",3,3,0,130666.7,1633.667,80
"25006","76359","2018",3,3,0,145833.3,1464.333,110.3333
"25007","76360","2018",4,4,0,115400,1298.75,88
"25008","76361","2018",5,5,0,221200,2061,107.6
"25009","76362","2018",6,6,0,169782.5,1675.167,117.1667
"25010","76363","2018",6,6,0,113000,1224,90.66667
"25011","76364","2018",6,6,0,152000,1127.167,135.5
"25012","76365","2018",1,1,0,232000,1681,138
"25013","76366","2018",52,51,1,137822.1,1787.731,79.38462
"25014","76367","2018",30,30,0,225721.7,2173.267,105.1
"25015","76368","2018",6,6,0,162216.7,1643.833,102
"25016","76369","2018",5,5,0,168740,1479,114
"25017","76370","2018",6,6,0,186700,1573,128.1667
"25018","76371","2018",3,3,0,117650,1095.333,111.6667
"25019","76372","2018",8,8,0,116687.5,1206.375,100
"25020","76374","2018",12,12,0,104370.8,1268.25,81.83333
"25021","76375","2018",3,3,0,158333.3,1387,115.3333
"25022","76377","2018",37,35,2,293857.9,2547.216,119.2703
"25023","76378","2018",2,2,0,381000,4848,163
"25024","76379","2018",2,2,0,222500,2090,103
"25025","76380","2018",2,2,0,165500,1643,101
"25026","76381","2018",4,4,0,104000,1470.25,69.75
"25027","76382","2018",17,17,0,135479.4,1551.353,86.70588
"25028","76383","2018",2,2,0,110000,850,135
"25029","76384","2018",92,78,14,108953.5,1557.261,72.56522
"25030","76385","2018",19,19,0,167636.8,1590.421,107.8421
"25031","76386","2018",3,3,0,189833.3,1876.667,100.3333
"25032","76387","2018",5,5,0,119410,1162.6,103.8
"25033","76388","2018",3,3,0,146833.3,2065.667,80.33333
"25034","76389","2018",3,3,0,134666.7,1578.333,89
"25035","76390","2018",14,14,0,153075,1637,96.85714
"25036","76391","2018",22,22,0,201072.3,1803.227,113.1818
"25037","76392","2018",13,13,0,117361.5,1228,100.3077
"25038","76394","2018",6,6,0,82666.67,1459,57.33333
"25039","76395","2018",6,6,0,221296.5,2351.833,128
"25040","76396","2018",3,3,0,206333.3,1795.333,127
"25041","76397","2018",7,7,0,129214.3,1229.143,107
"25042","76398","2018",8,8,0,178571.9,1577.75,114.375
"25043","76399","2018",3,3,0,180666.7,1280.333,119
"25044","76400","2018",27,24,3,152126.9,1949.704,84.66667
"25045","76401","2018",32,32,0,152267.2,1605.188,97.78125
"25046","76402","2018",73,71,2,165224.5,1969.904,91.80822
"25047","76403","2018",5,5,0,101440,2206.2,53.2
"25048","76404","2018",13,13,0,254726.9,2461.308,105.1538
"25049","76405","2018",1,1,0,169650,1542,110
"25050","76406","2018",5,4,1,168500,1636.6,105.8
"25051","76407","2018",2,2,0,206150,1868.5,111
"25052","76408","2018",16,16,0,153146.2,1605.25,100.75
"25053","76409","2018",3,3,0,251316.7,2410,108.6667
"25054","76410","2018",114,55,59,110002.4,1486.596,74.09649
"25055","76411","2018",4,4,0,93500,1108.5,80.5
"25056","76412","2018",15,15,0,197933.3,1947.067,108.1333
"25057","76413","2018",2,2,0,171500,1906,90
"25058","76414","2018",15,15,0,170221.3,1631.133,109.8667
"25059","76415","2018",2,2,0,111000,1295,87.5
"25060","76416","2018",6,6,0,167158.3,1619.333,106.5
"25061","76417","2018",3,3,0,139100,1163,120
"25062","76418","2018",9,9,0,153646.7,1577.111,104.1111
"25063","76420","2018",6,6,0,133150,1150.333,126.3333
"25064","76421","2018",13,13,0,189876.9,1881.846,105.2308
"25065","76422","2018",3,3,0,81066.67,1156.333,70.66667
"25066","76423","2018",7,7,0,101200,1564.714,68.71429
"25067","76424","2018",1,1,0,50000,427,117
"25068","76425","2018",3,3,0,227483.3,1883.667,120.6667
"25069","76426","2018",4,4,0,134750,2021.75,66.5
"25070","76427","2018",2,2,0,123250,954,128.5
"25071","76428","2018",1,1,0,214200,1071,200
"25072","76429","2018",100,86,14,260037.5,2452.12,108.27
"25073","76430","2018",2,2,0,69000,873,82
"25074","76432","2018",3,3,0,122500,1647.667,78
"25075","76433","2018",7,7,0,219321.4,1723.429,137.7143
"25076","76434","2018",9,9,0,206402.2,1896.111,109.3333
"25077","76435","2018",10,10,0,138375.8,1279,107.8
"25078","76436","2018",4,4,0,237075,1360.25,197
"25079","76437","2018",6,6,0,123916.7,1518.833,83.5
"25080","76438","2018",6,6,0,113000,1504.5,82.33333
"25081","76439","2018",2,2,0,183750,2375,73
"25082","76440","2018",1,1,0,166000,2101,79
"25083","76441","2018",8,8,0,94875,1107.5,99.375
"25084","76442","2018",5,5,0,145200,1258.4,122.8
"25085","76443","2018",7,7,0,186300,1796.714,104
"25086","76445","2018",4,4,0,165125,1538.25,105.25
"25087","76446","2018",4,4,0,259500,2686,106.25
"25088","76447","2018",221,179,42,184202.4,2156.014,86.65158
"25089","76448","2018",20,20,0,240787.5,2063.75,120.45
"25090","76449","2018",5,5,0,127060,1684.2,77.6
"25091","76450","2018",5,5,0,167440,1446.2,121.4
"25092","76451","2018",325,111,214,215349.7,2239.6,92.04615
"25093","76452","2018",45,44,1,171493.3,1966.956,90.84444
"25094","76453","2018",18,18,0,179645.6,1883.889,97.77778
"25095","76454","2018",3,3,0,91066.67,579.6667,151
"25096","76455","2018",3,3,0,145500,1220,122.6667
"25097","76456","2018",9,9,0,117111.1,1271,92.33333
"25098","76457","2018",16,9,7,124735.3,1486.062,79.4375
"25099","76459","2018",4,4,0,128125,1315.75,99.25
"25100","76460","2018",12,12,0,92415.42,1176.5,79.08333
"25101","76461","2018",4,4,0,167750,1624.75,105.5
"25102","76462","2018",63,54,9,123450,1424.635,90.12698
"25103","76463","2018",10,10,0,125920,2032.8,66
"25104","76464","2018",23,23,0,216399.1,1893.957,118.913
"25105","76465","2018",8,8,0,139978.8,1425.375,98.875
"25106","76467","2018",22,22,0,116384.5,1518.318,82.68182
"25107","76468","2018",15,15,0,154340,1491.4,109.6667
"25108","76469","2018",11,11,0,147018.2,1559.545,99.72727
"25109","76470","2018",4,4,0,165000,1448.25,117.75
"25110","76471","2018",8,8,0,174155,1981.375,89.625
"25111","76472","2018",6,6,0,148566.7,1449.333,103.6667
"25112","76473","2018",5,5,0,178689.8,1387,135.6
"25113","76474","2018",85,83,2,160201.8,1852.235,91.04706
"25114","76475","2018",71,64,7,264338.3,2411.042,111.1831
"25115","76476","2018",122,115,7,145661.4,1568.27,95.27869
"25116","76477","2018",3,3,0,268333.3,2175,116.3333
"25117","76480","2018",4,4,0,163875,1996,88
"25118","76481","2018",63,62,1,312275.6,2355.794,135.6032
"25119","76482","2018",22,21,1,199327.3,2096.864,97.36364
"25120","76483","2018",3,3,0,188444.7,1883.333,99.33333
"25121","76484","2018",101,99,2,152646.3,1724.624,91.71287
"25122","76485","2018",4,4,0,148875,1364,111.25
"25123","76486","2018",11,11,0,132627.3,1425.091,93.45455
"25124","76487","2018",2,2,0,1e+05,891.5,125
"25125","76488","2018",4,4,0,159187.5,1671.5,108
"25126","76489","2018",1,1,0,170000,1360,125
"25127","76490","2018",22,21,1,154068.2,1745.864,92.54545
"25128","76491","2018",7,7,0,166228.6,1606.714,105.7143
"25129","76492","2018",5,5,0,181800,1722,104.8
"25130","76493","2018",5,5,0,119710,1141.6,95.2
"25131","76494","2018",10,10,0,160700,1945.2,92.8
"25132","76495","2018",63,63,0,148324.5,1649.762,90.57143
"25133","76497","2018",85,63,22,154497.2,1784.8,87.31765
"25134","76498","2018",273,191,82,115692.5,1703.015,69.57875
"25135","76499","2018",15,15,0,175663.3,1693.733,111.5333
"25136","76500","2018",3,3,0,86066.67,1196.667,72.33333
"25137","76501","2018",1,1,0,150000,1181,127
"25138","76502","2018",9,9,0,201138.9,1889.333,110.2222
"25139","76503","2018",15,13,2,187393.3,1680.4,115.8667
"25140","76504","2018",2,2,0,155000,1286,113
"25141","76505","2018",2,2,0,176000,1291.5,148
"25142","76506","2018",7,7,0,152042.9,1423.143,108.1429
"25143","76507","2018",6,6,0,96066.67,1281.167,75.5
"25144","76508","2018",6,6,0,188733.3,1505.167,133.8333
"25145","76509","2018",2,2,0,2e+05,2048,102.5
"25146","76510","2018",2,2,0,101000,1190.5,83
"25147","76511","2018",2,2,0,60400,780,68
"25148","76512","2018",1,1,0,63500,538,118
"25149","76513","2018",5,5,0,2e+05,1618.2,119
"25150","76514","2018",1,1,0,162500,1958,83
"25151","76515","2018",11,9,2,141895.5,1688.182,85.18182
"25152","76516","2018",6,6,0,151400,1237.667,119.1667
"25153","76517","2018",30,30,0,273914.2,2246.133,123.4333
"25154","76518","2018",5,5,0,131104,1523.4,89.4
"25155","76519","2018",2,2,0,175000,1257.5,140.5
"25156","76520","2018",11,11,0,96786.36,1027.364,91.27273
"25157","76521","2018",3,3,0,149666.7,1557.333,98
"25158","76522","2018",17,17,0,211202.9,1809.294,115.4118
"25159","76523","2018",4,4,0,135850,1378.25,103
"25160","76524","2018",4,4,0,78975,1299,62.75
"25161","76526","2018",1,1,0,80000,678,118
"25162","76527","2018",3,3,0,208666.7,1357.333,159.3333
"25163","76528","2018",4,4,0,93000,1149.25,80.5
"25164","76529","2018",4,4,0,151462.5,1583.5,94
"25165","76530","2018",2,2,0,151950,3619.5,54
"25166","76531","2018",1,1,0,146000,1640,89
"25167","76532","2018",10,10,0,179247,1865.1,103.4
"25168","76533","2018",9,9,0,228605.6,2012.889,118.4444
"25169","76534","2018",12,12,0,208308.3,2143.917,102.5833
"25170","76535","2018",7,7,0,144664.3,1387.143,107.7143
"25171","76536","2018",13,13,0,199579.4,2017.385,100.8462
"25172","76537","2018",2,2,0,101093.5,843.5,119.5
"25173","76538","2018",4,4,0,166958,1688.25,106.5
"25174","76540","2018",2154,423,1731,141152.1,2386.247,61.27994
"25175","76541","2018",17,17,0,267370.6,2061.353,132.3529
"25176","76542","2018",1,1,0,85000,1214,70
"25177","76543","2018",5,5,0,205697.4,1661.6,124.8
"25178","76544","2018",2,2,0,211000,1670.5,128.5
"25179","76545","2018",22,19,3,149786.4,1641.318,89.40909
"25180","76546","2018",3,3,0,181900,1501,122
"25181","76547","2018",16,16,0,230342.5,1890.375,126.4375
"25182","76548","2018",7,7,0,142285.7,1296.571,115
"25183","76549","2018",5,5,0,160800,1324.4,134.4
"25184","76550","2018",14,14,0,187932.1,1870.429,102.6429
"25185","76551","2018",9,9,0,201704.4,1746.556,116.2222
"25186","76552","2018",137,77,60,306389.5,3047.234,99.16058
"25187","76553","2018",3,3,0,131933.3,1205,108
"25188","76554","2018",3,3,0,155910,1710,92
"25189","76555","2018",7,7,0,198342.9,1664.143,117.4286
"25190","76556","2018",4,4,0,195550,1588.5,125
"25191","76557","2018",14,14,0,167964.3,1622.571,103.3571
"25192","76558","2018",10,10,0,214788.8,1632.4,130.3
"25193","76559","2018",9,9,0,145666.7,1373.111,105.8889
"25194","76560","2018",8,8,0,285356.2,2367.5,121.5
"25195","76561","2018",80,67,13,135336.3,1625.162,84.9875
"25196","76562","2018",10,10,0,142300,1901.7,91.3
"25197","76563","2018",17,17,0,207373.5,1865.647,111.2941
"25198","76564","2018",7,7,0,157314.3,1711.571,108.1429
"25199","76565","2018",6,6,0,216916.7,1857.833,116.5
"25200","76566","2018",7,7,0,161628.6,1633.429,96.14286
"25201","76567","2018",2,2,0,107500,1093.5,93
"25202","76568","2018",7,7,0,204342.9,1818.714,112
"25203","76569","2018",1,1,0,184500,883,209
"25204","76570","2018",2,2,0,155478.5,1664.5,95
"25205","76571","2018",7,7,0,198982.1,1543.714,129.4286
"25206","76572","2018",1,1,0,107000,1390,77
"25207","76573","2018",5,5,0,202200,1998.6,118
"25208","76574","2018",12,12,0,188379.2,1689.417,114.9167
"25209","76575","2018",223,190,33,151061.3,1834.184,84.13453
"25210","76576","2018",8,8,0,133945,1615.375,82.875
"25211","76577","2018",5,5,0,165748,1493.6,108
"25212","76578","2018",5,5,0,118600,1535.8,71.8
"25213","76580","2018",6,6,0,299016.7,2049.5,149
"25214","76581","2018",2,2,0,174475,913,198.5
"25215","76582","2018",3,3,0,110000,1349.667,85
"25216","76583","2018",2,2,0,229650,1823.5,127
"25217","76584","2018",3,3,0,106000,1086.333,98.66667
"25218","76585","2018",5,5,0,157950,1511.8,115.6
"25219","76586","2018",10,10,0,158482,1814,94.4
"25220","76587","2018",9,9,0,163772.2,1458.444,120.7778
"25221","76588","2018",8,8,0,157437.5,1451.5,115.875
"25222","76589","2018",1,1,0,166000,1194,139
"25223","76590","2018",4,4,0,107625,1382.25,78.5
"25224","76591","2018",24,24,0,231542.9,2095.667,112.5417
"25225","76592","2018",13,13,0,159830.8,1315.462,120.3077
"25226","76593","2018",5,5,0,191500,1981.8,100
"25227","76594","2018",15,15,0,194072.7,1804.267,110.6667
"25228","76595","2018",19,19,0,194221.1,1942.263,105.5789
"25229","76596","2018",19,19,0,231554.7,2089.368,119.6316
"25230","76597","2018",8,8,0,118230,1426.375,93
"25231","76598","2018",7,7,0,73571.43,847.2857,89
"25232","76599","2018",37,33,4,183883.8,2150.486,87.08108
"25233","76600","2018",22,22,0,164795.5,1909.727,92.81818
"25234","76601","2018",2,2,0,151500,1086.5,141
"25235","76602","2018",5,5,0,193580,1567.8,127.2
"25236","76603","2018",5,5,0,161100,1423.8,120.2
"25237","76604","2018",3,3,0,94333.33,830.6667,114.3333
"25238","76605","2018",12,11,1,148037.5,1770.833,83.08333
"25239","76606","2018",2,2,0,149500,1160.5,131
"25240","76608","2018",21,20,1,166864.3,1799.19,99.14286
"25241","76609","2018",8,8,0,241209.8,1635,151
"25242","76610","2018",12,12,0,182778.9,2059.833,91.16667
"25243","76611","2018",2,2,0,153500,1778,86.5
"25244","76612","2018",3,3,0,84500,1198.333,67.33333
"25245","76613","2018",11,11,0,144225.5,2018.636,74.72727
"25246","76614","2018",20,19,1,300052.5,2348.85,142.65
"25247","76615","2018",6,6,0,209833.3,1946.5,106.6667
"25248","76616","2018",23,23,0,246362.2,2230.043,114.7826
"25249","76617","2018",21,21,0,353572.9,2687.952,128.6667
"25250","76618","2018",93,92,1,136882.8,1586.634,90.74194
"25251","76619","2018",2,2,0,218350,1602,139.5
"25252","76620","2018",2,2,0,141315,1509.5,95
"25253","76621","2018",10,10,0,134480,1284.8,108.8
"25254","76622","2018",4,4,0,172750,2105,82
"25255","76623","2018",1,1,0,180000,1935,93
"25256","76624","2018",44,44,0,132621.4,1601.841,87
"25257","76626","2018",4,4,0,173273.2,1560.5,116.75
"25258","76627","2018",33,33,0,180939.7,1852.364,101.7879
"25259","76628","2018",16,16,0,174950,1551.625,114.75
"25260","76629","2018",4,4,0,111000,1337.5,81.25
"25261","76630","2018",3,3,0,138217,1346.333,102.6667
"25262","76631","2018",12,12,0,190466.7,1929.083,105.6667
"25263","76632","2018",6,6,0,149483.3,1868.333,94.66667
"25264","76634","2018",12,12,0,209658.3,1894.167,113.1667
"25265","76635","2018",1,1,0,40000,645,62
"25266","76636","2018",20,20,0,161092.5,1765.6,94.55
"25267","76637","2018",16,15,1,159093.8,2405.812,80.0625
"25268","76638","2018",8,8,0,140337.5,1637.25,87.5
"25269","76640","2018",87,79,8,143456,1624.368,90.66667
"25270","76641","2018",4,4,0,192462.5,1808,107
"25271","76642","2018",3,3,0,137983.3,1741.333,75
"25272","76644","2018",7,7,0,173071.4,1351.857,131
"25273","76645","2018",2,2,0,119000,1277,92.5
"25274","76646","2018",2,2,0,197675,2135.5,95
"25275","76647","2018",52,45,7,196590.4,2079.635,97.01923
"25276","76648","2018",17,17,0,132282.4,1407.824,100
"25277","76649","2018",10,10,0,145100,1434.9,104.6
"25278","76650","2018",11,11,0,190272.7,2111.091,94.27273
"25279","76651","2018",1,1,0,106500,532,200
"25280","76652","2018",11,11,0,135559.1,1195.545,111.0909
"25281","76653","2018",4,4,0,131470,1524.75,88.75
"25282","76654","2018",3,3,0,185000,1909,99
"25283","76655","2018",72,41,31,149354.7,1926.681,81.18056
"25284","76656","2018",6,6,0,127803.3,1578.5,82.33333
"25285","76657","2018",17,17,0,184380.6,1715.882,109
"25286","76658","2018",3,3,0,303300,2648,120
"25287","76660","2018",7,7,0,179585.7,1847.143,97.42857
"25288","76662","2018",1,1,0,150000,2727,55
"25289","76663","2018",17,17,0,138182.4,1587.706,87.64706
"25290","76664","2018",2,2,0,156000,2000,106
"25291","76665","2018",3,3,0,170666.7,1508,110.6667
"25292","76666","2018",2,2,0,146100,1277,115
"25293","76667","2018",3,3,0,167333.3,1297.667,128.3333
"25294","76668","2018",4,4,0,138875,1690.25,84.75
"25295","76669","2018",6,6,0,148500,1766.5,84.66667
"25296","76670","2018",5,5,0,197600,2017.8,100.4
"25297","76671","2018",2,2,0,79900,911,86
"25298","76672","2018",13,13,0,118442.3,1312.154,95.53846
"25299","76673","2018",11,11,0,201181.8,2221.273,97.36364
"25300","76675","2018",9,9,0,198281.1,1828.667,108.1111
"25301","76676","2018",7,7,0,107000,1125.286,91.57143
"25302","76677","2018",2,2,0,128000,1371,91
"25303","76678","2018",19,19,0,122050.8,1435.947,88.63158
"25304","76679","2018",1,1,0,142000,1235,115
"25305","76680","2018",1,1,0,175000,1577,111
"25306","76681","2018",355,255,100,144687.9,1927.938,75.30423
"25307","76682","2018",11,11,0,172313.6,1809.727,94.27273
"25308","76683","2018",4,4,0,107987.5,2088.25,54
"25309","76684","2018",13,13,0,126700.8,1779.154,71.07692
"25310","76685","2018",10,10,0,139935,1597.6,89
"25311","76686","2018",6,6,0,141325,1595.5,85.5
"25312","76688","2018",7,7,0,148914.3,1471.857,106.2857
"25313","76689","2018",7,7,0,150242.9,1424.857,110
"25314","76690","2018",7,7,0,158830.7,1751.286,93.57143
"25315","76691","2018",3,3,0,191000,1620.667,115.6667
"25316","76692","2018",3,3,0,150333.3,1268,116
"25317","76693","2018",12,12,0,195883.3,1972.667,107.5
"25318","76695","2018",1,1,0,176500,1820,97
"25319","76697","2018",9,9,0,136605.6,1607.222,90.77778
"25320","76698","2018",5,5,0,127125,1799.4,74.4
"25321","76699","2018",4,4,0,104475,1376.25,73.25
"25322","76700","2018",14,14,0,173398.4,1641.071,124.2857
"25323","76702","2018",4,4,0,154125,1182,131.25
"25324","76705","2018",26,25,1,186873.1,1809.577,106.8077
"25325","76706","2018",6,6,0,185866.7,2065.167,105.8333
"25326","76707","2018",15,15,0,174936.7,1923,92.66667
"25327","76708","2018",10,10,0,135785,1550,97.2
"25328","76709","2018",49,47,2,124890.3,1564.755,82.26531
"25329","76710","2018",3,3,0,158166.7,1691.667,108.6667
"25330","76711","2018",100,50,50,80782.28,1543.46,56.87
"25331","76712","2018",7,7,0,175585.7,2078.143,94.28571
"25332","76714","2018",8,8,0,202043.8,2032.875,107.125
"25333","76715","2018",6,6,0,164500,2156.5,92.16667
"25334","76716","2018",15,15,0,200500,1833.6,119.9333
"25335","76717","2018",8,8,0,159400,1964,81.25
"25336","76718","2018",14,13,1,146842.9,1743.571,91.5
"25337","76719","2018",13,13,0,144692.3,1462.538,97.76923
"25338","76720","2018",13,8,5,172138.5,2547,69.46154
"25339","76721","2018",1,1,0,245500,1933,127
"25340","76723","2018",4,4,0,207125,2370,87
"25341","76724","2018",2,2,0,103500,1355.5,81
"25342","76725","2018",5,5,0,180840,1666.8,110.8
"25343","76726","2018",9,9,0,157023.9,1678.889,94.77778
"25344","76727","2018",14,14,0,147928.6,1738.571,87.42857
"25345","76728","2018",6,6,0,217666.7,2051,108.8333
"25346","76730","2018",1,1,0,1e+05,1176,85
"25347","76731","2018",4,4,0,156462.5,1658,95.5
"25348","76733","2018",3,3,0,136916.7,1190.667,110.3333
"25349","76734","2018",3,3,0,214333.3,1579,135
"25350","76735","2018",21,14,7,178905,2616.286,71.14286
"25351","76736","2018",8,8,0,176431.2,1616,107.625
"25352","76737","2018",8,8,0,176975,1785.25,102
"25353","76738","2018",9,9,0,174772.2,1674.778,103.7778
"25354","76739","2018",8,8,0,122650,1242.625,105.75
"25355","76740","2018",9,9,0,200522.2,1987.222,117.6667
"25356","76741","2018",9,9,0,183166.7,2155.222,103.8889
"25357","76743","2018",29,29,0,151283.9,1539.103,100.7586
"25358","76745","2018",2,2,0,96000,1352.5,88.5
"25359","76746","2018",7,7,0,149821.4,1899.571,78
"25360","76747","2018",3,3,0,194666.7,2228,96.66667
"25361","76748","2018",9,9,0,134298.9,1684,82.55556
"25362","76749","2018",2,2,0,87500,1400,62.5
"25363","76750","2018",4,4,0,134162.2,1607.5,85
"25364","76751","2018",15,15,0,129386.7,1656.933,79.4
"25365","76752","2018",31,27,4,153306.5,1836.871,88.19355
"25366","76753","2018",11,11,0,200259.1,1994.273,103.7273
"25367","76754","2018",23,21,2,174279.1,2920.087,71.78261
"25368","76755","2018",5,5,0,117300,1415.2,79
"25369","76756","2018",3,3,0,258950,1579.667,164
"25370","76757","2018",6,6,0,121166.7,1405.167,86.33333
"25371","76758","2018",104,63,41,152321.4,1857.173,82.71154
"25372","77001","2018",21,21,0,279311.8,2270.81,130.1429
"25373","77002","2018",13,13,0,176461.5,2037.308,94.30769
"25374","77003","2018",4,4,0,230287.5,2304.25,105.75
"25375","77004","2018",5,5,0,292880,2577.4,120
"25376","77005","2018",43,33,10,298943.8,3141.279,99.65116
"25377","77006","2018",10,9,1,315469,3113.3,109.6
"25378","77007","2018",6,6,0,306816.7,2667.5,126
"25379","77008","2018",10,10,0,197800,2148.5,92.9
"25380","77009","2018",2,2,0,145450,2066.5,93
"25381","77010","2018",14,13,1,211776.4,2684,84.71429
"25382","77011","2018",5,5,0,132546,1130.8,118
"25383","77012","2018",8,8,0,191857.5,1442.875,136.25
"25384","77013","2018",4,3,1,224750,1694.75,132
"25385","77014","2018",208,54,154,189608.3,2609.048,73.03846
"25386","77015","2018",3,3,0,157333.3,1664.333,94
"25387","77016","2018",21,21,0,148714.3,1920.524,80.66667
"25388","77018","2018",96,47,49,283591,3634.094,79.48958
"25389","77019","2018",3,3,0,149333.3,1316.333,113
"25390","77020","2018",10,10,0,210398,1749.8,126.6
"25391","77021","2018",6,6,0,179250,1859.833,99.16667
"25392","77022","2018",29,25,4,376319,3631.414,113.931
"25393","77023","2018",3,3,0,254333.3,2281,113
"25394","77024","2018",5,5,0,244000,1714.2,163.8
"25395","77025","2018",7,7,0,122714.3,1397.571,92.42857
"25396","77026","2018",4,4,0,115000,979.5,116.75
"25397","77027","2018",19,19,0,139179.2,1319.105,109.6842
"25398","77029","2018",2,2,0,169750,2212.5,83
"25399","77030","2018",13,13,0,178000,1845.308,97.30769
"25400","77031","2018",16,16,0,270994,2614.625,110.0625
"25401","77032","2018",15,13,2,167523.3,1854.533,89.53333
"25402","77033","2018",2,2,0,265500,1839,148
"25403","77034","2018",15,15,0,250124,2488.533,102.3333
"25404","77035","2018",8,8,0,145187.5,1413.5,110.75
"25405","77036","2018",2,2,0,224750,2081,114
"25406","77037","2018",77,63,14,348810.3,3407.234,109.6753
"25407","77038","2018",2,2,0,249100,4086,76
"25408","77039","2018",21,19,2,338251,2614.952,133.381
"25409","77040","2018",41,39,2,292073.4,2678.902,120.3659
"25410","77041","2018",5,5,0,233800,1622,145.2
"25411","77042","2018",33,33,0,200751.5,2052.303,99.09091
"25412","77043","2018",10,10,0,234840,1723.2,145.4
"25413","77044","2018",17,15,2,186309.4,2229.235,87.52941
"25414","77045","2018",7,7,0,151257.1,1337.714,113.7143
"25415","77046","2018",2,2,0,116000,2183,66
"25416","77047","2018",19,16,3,247446.8,3048.474,89.89474
"25417","77048","2018",39,36,3,311224,3068.769,113.2308
"25418","77049","2018",10,10,0,278850,2957.3,95.7
"25419","77050","2018",9,9,0,169666.7,1535.667,123
"25420","77051","2018",31,30,1,136574.2,1526.258,95.87097
"25421","77052","2018",5,5,0,211870,2068,112
"25422","77053","2018",274,117,157,218842.6,3089.891,73.4708
"25423","77054","2018",7,7,0,187378.6,2117.714,95.28571
"25424","77055","2018",75,13,62,186704.5,2645.573,71.45333
"25425","77056","2018",2,2,0,190000,1847.5,101.5
"25426","77057","2018",6,6,0,181333.3,1768.5,103
"25427","77058","2018",447,115,332,258833.1,3705.485,72.63758
"25428","77059","2018",10,9,1,439040,4584.9,104.8
"25429","77060","2018",13,13,0,159126.9,2214.385,72.69231
"25430","77061","2018",26,25,1,155038.5,1797.846,89.30769
"25431","77062","2018",5,3,2,341776,3658,91
"25432","77063","2018",18,18,0,278912.2,2382.111,125.8889
"25433","77065","2018",19,19,0,361760.9,3034.474,133.6842
"25434","77066","2018",9,9,0,183366.7,1510.889,125.8889
"25435","77067","2018",134,123,11,247413.8,2697.813,95.41791
"25436","77068","2018",2,2,0,336000,2601.5,137.5
"25437","77069","2018",24,22,2,311985.8,3095.75,118.7917
"25438","77070","2018",14,14,0,179939.4,1759.857,102.4286
"25439","77071","2018",9,9,0,163444.4,1460,118.8889
"25440","77072","2018",9,9,0,178465.6,1689.333,119.4444
"25441","77073","2018",8,8,0,189000,1671.75,117.75
"25442","77075","2018",19,16,3,368256.6,3368.579,122.5789
"25443","77076","2018",5,5,0,159080,1677.8,94.2
"25444","77077","2018",12,9,3,238498.2,2591.25,95.75
"25445","77078","2018",29,29,0,184351.7,1948.069,97.10345
"25446","77079","2018",58,48,10,169313.6,2466,74.7931
"25447","77080","2018",1,1,0,92500,1285,72
"25448","77081","2018",15,15,0,251996,2765.4,100.5333
"25449","77082","2018",15,11,4,179286.7,2657.2,70
"25450","77083","2018",255,102,153,257262.8,3263.906,81.02745
"25451","77084","2018",21,19,2,196017.1,2473.714,84.57143
"25452","77085","2018",47,31,16,311704.4,3787.596,84.14894
"25453","77086","2018",13,13,0,216810.4,2707.692,91.07692
"25454","77087","2018",9,8,1,208622.2,2113.778,101.1111
"25455","77088","2018",31,29,2,212754.2,2084.935,105.4194
"25456","77089","2018",19,19,0,207772.6,2136.684,99.15789
"25457","77090","2018",2,2,0,214500,1671.5,131
"25458","77091","2018",5,5,0,312600,2493,128.8
"25459","77093","2018",8,8,0,150125,1378.125,123.875
"25460","77094","2018",3,2,1,222000,2689.667,94.33333
"25461","77095","2018",17,14,3,279432,3102.412,91.52941
"25462","77096","2018",27,23,4,294780.2,3266.667,96.59259
"25463","77097","2018",4,4,0,202250,1927.25,107.75
"25464","77098","2018",11,11,0,174727.3,1825.364,102.5455
"25465","77099","2018",41,37,4,145612.9,1709.707,93.43902
"25466","77100","2018",47,44,3,190183.1,2340.638,83.44681
"25467","77101","2018",11,11,0,172940,1714.273,102.6364
"25468","77102","2018",2,2,0,148000,1795,82.5
"25469","77103","2018",4,4,0,190875,2382.75,90.5
"25470","77104","2018",11,11,0,322086.4,2867.727,114.7273
"25471","77106","2018",8,8,0,217624.6,1948,110.625
"25472","77107","2018",45,34,11,233809.8,2681.356,90.86667
"25473","77108","2018",700,322,378,230035.6,3166.723,74.20714
"25474","77109","2018",25,24,1,186853,1847.56,104.48
"25475","77110","2018",3,3,0,110833.3,1154,117.3333
"25476","77111","2018",89,40,49,320124.2,4310.798,81.91011
"25477","77112","2018",3,3,0,147283.3,1642.333,91
"25478","77113","2018",19,19,0,205169.1,2136.263,113.4737
"25479","77114","2018",47,36,11,296758.7,3151.362,97.06383
"25480","77115","2018",10,10,0,171960,1616.2,109.3
"25481","77116","2018",20,18,2,203897,1780,117.95
"25482","77117","2018",9,8,1,148297.8,1748.222,87.66667
"25483","77118","2018",147,86,61,282123.7,3538.435,82.40136
"25484","77119","2018",7,7,0,227491.4,2454.286,94.71429
"25485","77120","2018",8,8,0,185500,1930.875,104.125
"25486","77121","2018",34,20,14,271708.5,3479.353,80.91176
"25487","77122","2018",303,167,136,209780.7,2631.818,81.79208
"25488","77123","2018",4,4,0,282750,3014.5,112.25
"25489","77124","2018",18,17,1,398969.9,3519.056,129.7222
"25490","77125","2018",17,17,0,234474.1,2650.588,92.35294
"25491","77126","2018",28,28,0,226018.6,2271.107,108.1429
"25492","77127","2018",19,13,6,259451.1,3148.158,81.10526
"25493","77128","2018",34,31,3,278201.1,2953.706,100.4412
"25494","77129","2018",5,5,0,156400,2291.8,89.6
"25495","77130","2018",12,12,0,223202.2,2230.667,107.0833
"25496","77131","2018",204,109,95,179192.3,2456.23,77.09314
"25497","77132","2018",40,38,2,310131.6,3289.775,97.85
"25498","77133","2018",3,3,0,135666.7,1383,113.6667
"25499","77134","2018",1,1,0,254400,1542,165
"25500","77135","2018",29,28,1,243382.8,2530.931,99.58621
"25501","77136","2018",2,2,0,334000,2420.5,140
"25502","77137","2018",4,4,0,207500,2072.75,102.5
"25503","77138","2018",14,14,0,281418.8,2622.143,110.0714
"25504","77139","2018",82,71,11,274917.5,3262.683,88.20732
"25505","77140","2018",2,2,0,167500,1682.5,104
"25506","77141","2018",10,6,4,235855,4367.9,66.5
"25507","77142","2018",76,60,16,255074.6,2755.513,96.25
"25508","77143","2018",63,52,11,222208,2754.921,84.73016
"25509","77144","2018",7,7,0,261614.3,2549.429,107
"25510","77145","2018",8,8,0,214462.5,2085.5,108.5
"25511","77146","2018",18,16,2,352717.5,3265.833,109.6667
"25512","77147","2018",15,15,0,197100,2328.133,90.4
"25513","77148","2018",22,19,3,156278,1751.5,88.68182
"25514","77150","2018",4,4,0,235750,2337.5,101.75
"25515","77151","2018",3,3,0,471666.7,3737,128.6667
"25516","77152","2018",196,99,97,181324.8,2610.765,73.16837
"25517","77153","2018",147,78,69,210138.2,2951.653,74.95918
"25518","77154","2018",14,14,0,227934.6,2597.429,93
"25519","77155","2018",36,32,4,288484,3415.722,87.61111
"25520","77156","2018",7,7,0,202642.9,2143.714,99
"25521","77157","2018",10,10,0,171100,2042.8,89.7
"25522","77158","2018",2,2,0,277500,3528,76.5
"25523","77159","2018",36,32,4,125705.6,1606.556,81.25
"25524","77161","2018",13,13,0,191192.3,2145.077,103.2308
"25525","77162","2018",17,17,0,218641.8,2218.235,102.4706
"25526","77163","2018",4,3,1,128250,2139.75,59.5
"25527","77164","2018",6,6,0,192833.3,2408.333,79.66667
"25528","77165","2018",1,1,0,252000,3273,77
"25529","77167","2018",4,4,0,148500,1571.5,97.75
"25530","77168","2018",34,31,3,127497.4,1456.676,96.23529
"25531","77169","2018",99,41,58,258581.1,3178.515,83.31313
"25532","77171","2018",104,77,27,237516.9,3239.798,78.54808
"25533","77172","2018",17,17,0,160523.5,1987.529,86.76471
"25534","77173","2018",11,11,0,186636.4,1806.273,103.0909
"25535","77174","2018",7,7,0,159885.7,1583.571,107.2857
"25536","77175","2018",41,36,5,286092.3,2778.927,111.2439
"25537","77176","2018",44,38,6,204206.7,2356.932,93.25
"25538","77177","2018",19,17,2,346378.6,3280.211,111.6316
"25539","77178","2018",5,5,0,156736.2,1934.6,87.8
"25540","77179","2018",16,16,0,261196.9,2700.438,98.25
"25541","77180","2018",11,11,0,359036.4,3027.364,121.2727
"25542","77181","2018",54,25,29,267448.6,3770.185,73.44444
"25543","77182","2018",43,29,14,136400.3,1568.744,92.25581
"25544","77183","2018",136,94,42,169593.7,2254.132,80.19853
"25545","77184","2018",9,9,0,162666.7,1733.667,95.33333
"25546","77185","2018",2,2,0,267500,3567,75
"25547","77186","2018",329,81,248,298633.7,3688.505,78.54103
"25548","77187","2018",5,5,0,109540,972.2,115.4
"25549","77188","2018",16,15,1,292068.8,3138.125,94
"25550","77190","2018",2,2,0,199000,2097.5,107.5
"25551","77191","2018",12,12,0,224610.8,2172.75,106
"25552","77192","2018",80,57,23,229901.5,2685.088,88.8875
"25553","77193","2018",5,5,0,221600,2226,102
"25554","77194","2018",5,5,0,207800,1801.2,118.4
"25555","77195","2018",9,9,0,286088.9,3200,95.11111
"25556","77196","2018",12,10,2,268533.5,3029.917,92.25
"25557","77197","2018",1,1,0,202000,2000,101
"25558","77198","2018",3,3,0,178000,1548.333,115
"25559","77199","2018",16,16,0,228359.4,2673.812,92.9375
"25560","77200","2018",2,2,0,230550,2139,116
"25561","77201","2018",8,7,1,178250,2531.625,70.25
"25562","77202","2018",10,10,0,241670,2103.4,115.6
"25563","77203","2018",22,22,0,293870.9,2866.591,106.0909
"25564","77204","2018",2,2,0,187500,2585.5,75.5
"25565","77205","2018",2,2,0,235750,3496.5,73.5
"25566","77206","2018",2,2,0,263650,2650.5,99.5
"25567","77207","2018",1,1,0,135435,1278,106
"25568","77208","2018",18,18,0,157594.4,1628.444,99.22222
"25569","77209","2018",13,12,1,288969.2,2874.769,101.2308
"25570","77210","2018",29,27,2,173969,1944.241,93.48276
"25571","77211","2018",10,10,0,175000,1782.5,105.1
"25572","77212","2018",1,1,0,50000,714,70
"25573","77214","2018",10,10,0,346025,2978,118.5
"25574","77215","2018",103,72,31,253452.1,3247.806,81.69903
"25575","77216","2018",23,22,1,230975.2,1860.435,128.0435
"25576","77217","2018",31,25,6,260379.1,2859.71,94.3871
"25577","77218","2018",5,5,0,107000,1910.8,64.8
"25578","77219","2018",42,42,0,254221.9,2663.5,106.1667
"25579","77220","2018",1,1,0,175000,1458,120
"25580","77221","2018",26,23,3,404968,3429.692,119.0769
"25581","77222","2018",73,45,28,218651.4,2745.699,81.20548
"25582","77223","2018",9,9,0,160611.1,1186.111,136.2222
"25583","77224","2018",6,6,0,258000,2132.833,115.3333
"25584","77225","2018",7,7,0,199428.6,2289.286,99
"25585","77226","2018",37,37,0,290483.3,2970.162,109.2703
"25586","77227","2018",7,7,0,192357.1,1360,148.7143
"25587","77228","2018",4,4,0,170432.5,1931,84.75
"25588","77229","2018",23,20,3,274413.5,2737.304,104.9565
"25589","77230","2018",2,2,0,244500,1371.5,175
"25590","77231","2018",12,12,0,195107.9,2418.333,85.66667
"25591","77232","2018",10,8,2,254618,3045.6,87.2
"25592","77233","2018",6,6,0,217833.3,2642.667,83.66667
"25593","77234","2018",8,6,2,258525,2872.625,98.75
"25594","77235","2018",5,5,0,157127,1624.4,103.4
"25595","77236","2018",4,4,0,141500,1474,98.5
"25596","77237","2018",6,6,0,276583.3,3163.5,89
"25597","77238","2018",52,48,4,194684.6,2123.635,96.82692
"25598","77239","2018",26,25,1,215150,2048.615,116.5
"25599","77240","2018",32,31,1,148187.8,1850.188,86.53125
"25600","77241","2018",23,21,2,234313,2642.522,90.47826
"25601","77242","2018",9,9,0,150200,1537.222,107
"25602","77243","2018",305,119,186,249300.6,3512.052,73.13115
"25603","77244","2018",7,7,0,229150,1918.429,133.4286
"25604","77245","2018",7,7,0,229142.1,1935.571,116.5714
"25605","77246","2018",9,9,0,178122.2,1511.444,133.6667
"25606","77247","2018",3,3,0,322000,1914.667,154.6667
"25607","77248","2018",9,9,0,317066.7,2412.556,136.7778
"25608","77249","2018",122,117,5,354159.9,3287.344,109.1885
"25609","77251","2018",166,82,84,217619.7,2915.09,77.21687
"25610","77252","2018",9,9,0,315888.9,2730.222,135.4444
"25611","77253","2018",4,4,0,261550,2591.75,113.75
"25612","77254","2018",19,17,2,262302.6,2648.421,102.2105
"25613","77255","2018",24,23,1,265028.6,2870,99.45833
"25614","77256","2018",3,3,0,154000,1195.333,129.6667
"25615","77257","2018",30,24,6,178753.5,2175.333,86.83333
"25616","77258","2018",142,29,113,202874,3063.944,68.89437
"25617","77259","2018",23,16,7,235557.8,2832.478,89.08696
"25618","77260","2018",21,20,1,149214.3,1841.81,84.71429
"25619","77261","2018",15,15,0,203666.7,1906.2,108.8
"25620","77262","2018",7,7,0,108739.3,1131,98.14286
"25621","77263","2018",5,5,0,172600,1737,107.6
"25622","77264","2018",13,13,0,261609.2,2059.923,130.9231
"25623","77265","2018",15,12,3,170253.3,1885.333,97.93333
"25624","77266","2018",10,9,1,198065,2410.1,90.3
"25625","77267","2018",3,3,0,169000,1939.333,88.33333
"25626","77268","2018",152,62,90,310688.3,3852.25,83.20395
"25627","77269","2018",16,13,3,233453.1,2740.688,90
"25628","77270","2018",19,17,2,271881.3,2765.947,104.6316
"25629","77271","2018",2,2,0,174500,1073.5,160.5
"25630","77272","2018",11,10,1,160454.5,1718.273,95.36364
"25631","77273","2018",9,9,0,290496.7,2786.111,105
"25632","77274","2018",11,5,6,151454.5,2432.091,66.09091
"25633","77275","2018",1,1,0,149800,1827,82
"25634","77276","2018",37,30,7,271702.1,2708.351,103.8649
"25635","77277","2018",23,18,5,218132.6,2627.261,86.82609
"25636","77278","2018",9,9,0,211122.2,1764.222,134.8889
"25637","77279","2018",22,22,0,161692,1974,83.13636
"25638","77280","2018",13,11,2,164830.8,1813.538,96.69231
"25639","77281","2018",14,14,0,218622.9,2037.643,107.7143
"25640","77282","2018",1,1,0,131500,3207,41
"25641","77283","2018",10,10,0,192325,1912,107.4
"25642","77284","2018",627,157,470,175858,2651.53,69.23764
"25643","77285","2018",191,78,113,156560.5,1955.325,81.30366
"25644","77286","2018",6,6,0,196583.3,1533.333,128.5
"25645","77287","2018",4,4,0,193462.5,1171.75,160.5
"25646","77288","2018",473,101,372,150016.2,2516.433,63.10782
"25647","77289","2018",1,1,0,230000,2277,101
"25648","77290","2018",8,8,0,217437.5,2109.625,108.875
"25649","77291","2018",2,2,0,292850,2703.5,107.5
"25650","77292","2018",15,10,5,242533.3,2940.067,94.4
"25651","77293","2018",21,21,0,143328.1,1909.524,79.71429
"25652","77294","2018",196,139,57,221717.2,3087.122,75.28571
"25653","77295","2018",17,16,1,243921.5,2479.529,104.7647
"25654","77296","2018",228,108,120,196481.2,2645.158,75.82895
"25655","77297","2018",1,1,0,67000,459,146
"25656","77298","2018",6,6,0,111666.7,1530.167,79
"25657","77300","2018",12,12,0,237129.2,2381.167,105.1667
"25658","77301","2018",11,11,0,146540.9,1165.091,125.5455
"25659","77302","2018",22,22,0,205159.1,1912.682,109
"25660","77303","2018",6,6,0,126000,1242.5,101.3333
"25661","77304","2018",1,1,0,92000,1353,68
"25662","77305","2018",127,54,73,127287.9,1859.402,71.22047
"25663","77306","2018",6,6,0,239265,2892.833,93.5
"25664","77307","2018",264,48,216,218711.3,3807.856,59.07576
"25665","77308","2018",12,12,0,259458.3,2507.167,108.4167
"25666","77309","2018",29,25,4,204819.7,2724.241,81
"25667","77310","2018",8,8,0,173978.9,1530.25,117.5
"25668","77311","2018",19,18,1,153578.9,2044.368,78.57895
"25669","77312","2018",40,34,6,240321.6,2407.05,107.775
"25670","77313","2018",1,1,0,170000,3091,55
"25671","77314","2018",3,3,0,149066.7,1386.667,104
"25672","77315","2018",65,59,6,267240.5,3542.615,82.15385
"25673","77316","2018",189,150,39,218460.4,2533.122,89.55556
"25674","77317","2018",46,37,9,185604.1,2402.326,81.52174
"25675","77318","2018",21,18,3,244878.6,2626.857,94.95238
"25676","77319","2018",2,2,0,146900,1255,117.5
"25677","77320","2018",74,69,5,215247.9,2210.014,101.3243
"25678","77321","2018",8,8,0,168725,2021.25,87.25
"25679","77322","2018",30,29,1,273992.5,3067.033,93
"25680","77323","2018",20,9,11,169593.8,2596.85,67.4
"25681","77325","2018",7,7,0,156285.7,1520.286,103
"25682","77326","2018",66,52,14,236570.2,2627.409,91.77273
"25683","77327","2018",82,63,19,175578.6,2076.915,88.53659
"25684","77328","2018",6,6,0,269208.3,1971.667,134.6667
"25685","77329","2018",4,4,0,234375,1920.5,135.75
"25686","77330","2018",102,67,35,226310.3,2682.667,89.17647
"25687","77331","2018",8,5,3,127750,1583.5,80.75
"25688","77332","2018",2,1,1,172500,1993,87
"25689","77333","2018",124,76,48,156466.2,2122.435,79.76613
"25690","77335","2018",36,30,6,243448.6,2673.306,97.47222
"25691","77336","2018",12,9,3,263179.2,3291.917,87.91667
"25692","77337","2018",105,34,71,220774.2,2864.276,79.34286
"25693","77338","2018",4,4,0,144500,1029.25,155.75
"25694","77339","2018",37,35,2,347233,2599.622,144.8649
"25695","77340","2018",11,11,0,176184.8,1866.545,94.45455
"25696","77341","2018",5,5,0,159040,1211.8,158
"25697","77343","2018",4,4,0,126250,2116,62.75
"25698","77344","2018",34,34,0,285476.2,2854.706,103.4118
"25699","77345","2018",13,12,1,173500,1869.538,104.4615
"25700","77347","2018",13,12,1,151038.5,1650.077,92.92308
"25701","77348","2018",5,5,0,210113,2308.6,93.4
"25702","77349","2018",78,72,6,260231.9,2688.115,100.4231
"25703","77350","2018",279,202,77,284113.3,3344.197,90.36559
"25704","77352","2018",33,33,0,263478.5,2560.03,108.6061
"25705","77353","2018",7,7,0,174285.7,1961.571,91.28571
"25706","77354","2018",17,17,0,207816.4,2718.941,83.64706
"25707","77355","2018",2,2,0,150575.5,1357.5,110
"25708","77356","2018",2,2,0,143250,1321,109
"25709","77357","2018",11,9,2,225572.7,2254.364,101.0909
"25710","77358","2018",9,9,0,252555.6,2329.556,114.2222
"25711","77359","2018",16,15,1,281300,3068.312,98.6875
"25712","77360","2018",7,7,0,259800,2523.286,108.5714
"25713","77361","2018",6,6,0,226591.7,1896.167,130
"25714","77363","2018",10,4,6,207323,3197.5,68
"25715","77364","2018",4,4,0,244500,2338.75,109.25
"25716","77365","2018",5,5,0,347560,1777.8,175.6
"25717","77366","2018",3,3,0,267666.7,3360.333,87.33333
"25718","77367","2018",3,3,0,176666.7,2502.667,76
"25719","77368","2018",1,1,0,167000,1704,98
"25720","77369","2018",4,4,0,247250,4816.25,75.25
"25721","77370","2018",13,13,0,154015.4,1564,99.61538
"25722","77371","2018",51,49,2,199979.7,2354.549,88.35294
"25723","77372","2018",43,28,15,327969.8,3148.744,108.9535
"25724","77373","2018",436,238,198,249318,3558.83,73.26147
"25725","77374","2018",36,25,11,248163.3,3017.75,88.19444
"25726","77376","2018",8,8,0,244868.8,2629.375,93.25
"25727","77377","2018",35,32,3,283052,3159.857,93.37143
"25728","77378","2018",36,21,15,230084.7,2751.75,87.72222
"25729","77379","2018",126,68,58,152948.3,1890.563,83.97619
"25730","77380","2018",3,3,0,182333.3,1910.667,106.6667
"25731","77381","2018",7,7,0,230857.1,1957.571,124.2857
"25732","77382","2018",69,58,11,265814.9,2959.101,96.24638
"25733","77383","2018",10,10,0,188625,1779.5,110.2
"25734","77384","2018",4,4,0,294075,2809.25,111.5
"25735","77385","2018",35,28,7,176850.6,1707.857,104.3714
"25736","77386","2018",8,8,0,249375,2014.625,110.125
"25737","77387","2018",5,5,0,197360,1228.4,177.2
"25738","77388","2018",11,10,1,175903.6,2266,81.09091
"25739","77389","2018",52,22,30,235280.8,2713.827,87.51923
"25740","77390","2018",233,141,92,241908.6,3077.888,81.98283
"25741","77391","2018",6,6,0,239833.3,1634.333,141.1667
"25742","77392","2018",8,8,0,248736.2,2864.75,87
"25743","77393","2018",30,26,4,236911.7,2461.833,98.7
"25744","77394","2018",18,18,0,306936.1,2473.611,128.8889
"25745","77395","2018",1,1,0,343000,1665,206
"25746","77397","2018",37,37,0,147418.9,1669.514,92.02703
"25747","77398","2018",13,13,0,148538.5,1996.462,76.38462
"25748","77400","2018",17,17,0,247792.9,2520.765,100.4706
"25749","77401","2018",7,7,0,168142.9,1929.429,86
"25750","77402","2018",2,2,0,173500,957.5,183
"25751","77403","2018",5,5,0,248604,1553.6,160.8
"25752","77404","2018",12,12,0,187635.8,1706.417,119.5
"25753","77405","2018",29,27,2,176704.9,2164.931,90.93103
"25754","77406","2018",11,11,0,166240,1413.545,112.4545
"25755","77407","2018",178,121,57,251425.9,2776.365,93.10674
"25756","77408","2018",3,3,0,226333.3,1927.333,117.3333
"25757","77409","2018",25,25,0,181756.8,1824,106.4
"25758","77410","2018",7,7,0,248000,2630.286,94.42857
"25759","77411","2018",5,5,0,234870,2188,132.4
"25760","77412","2018",4,4,0,246662.5,2088.75,122.25
"25761","77413","2018",55,45,10,274132.8,3000.891,94.4
"25762","77414","2018",5,5,0,211000,2114.8,99.2
"25763","77415","2018",20,19,1,205055,2227.6,106.35
"25764","77416","2018",3,3,0,201333.3,1800.667,115
"25765","77417","2018",4,4,0,149500,1644.25,90.75
"25766","77418","2018",15,15,0,153546.7,1533,103.4667
"25767","77419","2018",40,33,7,172875,2372.275,75.65
"25768","77420","2018",51,38,13,222002.8,2984.353,76.94118
"25769","77421","2018",2,2,0,142000,1640.5,90.5
"25770","77423","2018",10,10,0,175100,1915.7,96.6
"25771","77424","2018",4,4,0,164500,1886.25,99.75
"25772","77425","2018",4,4,0,437500,2818.75,157
"25773","77426","2018",3,3,0,294333.3,2560.667,118.3333
"25774","77427","2018",6,6,0,292521.8,3003.333,101.6667
"25775","77428","2018",11,11,0,213026.2,2265.182,98.72727
"25776","77429","2018",11,11,0,208002,1769.455,131.7273
"25777","77430","2018",67,61,6,257789.9,2658.418,101.4776
"25778","77431","2018",78,73,5,182215.5,2127.128,92.25641
"25779","77432","2018",9,9,0,181020,1713.556,106.2222
"25780","77433","2018",30,28,2,226400,2066.067,119.0333
"25781","77434","2018",6,6,0,134916.7,3014.5,56.33333
"25782","77435","2018",12,12,0,338811.2,2826.5,121.8333
"25783","77436","2018",10,8,2,159600,1807.3,92.6
"25784","77437","2018",28,24,4,223803.6,2600.393,89.07143
"25785","77438","2018",80,51,29,305634.3,3555.287,85.65
"25786","77439","2018",12,12,0,179337.5,1870.75,100.5
"25787","77440","2018",13,12,1,207461.5,1788.846,127.6154
"25788","77441","2018",25,23,2,295496.8,2795.32,104.84
"25789","77442","2018",24,24,0,281191,2832.667,106.5417
"25790","77443","2018",6,6,0,243404.8,2400.167,103
"25791","77444","2018",4,4,0,151250,2092.75,74.5
"25792","77445","2018",337,198,139,201177.4,2436.009,84.34421
"25793","77446","2018",4,4,0,260025,2353.75,114.5
"25794","77447","2018",18,17,1,267498.6,2857.167,98.38889
"25795","77448","2018",5,4,1,223808,2348.6,102.2
"25796","77449","2018",119,27,92,279738.2,3974.882,71.93277
"25797","77450","2018",46,40,6,318558.5,2999.783,112.3043
"25798","77451","2018",7,7,0,210428.6,2299,97.71429
"25799","77453","2018",14,14,0,278408.6,2752.5,103.6429
"25800","77454","2018",2,2,0,239786,1517.5,169
"25801","77455","2018",40,33,7,233256.5,3028.575,82.4
"25802","77456","2018",9,9,0,154624.6,1211,124.3333
"25803","77457","2018",18,14,4,232595.6,3176.5,79.16667
"25804","77458","2018",59,55,4,142879,1680.492,89.05085
"25805","77459","2018",17,17,0,150811.8,1864.765,87.05882
"25806","77460","2018",4,4,0,210575,2308.75,93.75
"25807","77461","2018",4,4,0,209000,2258.75,103
"25808","77462","2018",17,7,10,147617.6,2703.059,55.64706
"25809","77463","2018",51,46,5,251688.8,2597.333,101.0196
"25810","77464","2018",150,70,80,244423.9,3210.553,79.72667
"25811","77465","2018",12,12,0,156655.8,1500.083,111.5
"25812","77466","2018",11,10,1,292555.5,2419,127.6364
"25813","77467","2018",4,4,0,158690,1433,113.5
"25814","77468","2018",252,77,175,226118.3,3139.742,74.48016
"25815","77469","2018",21,16,5,201838.1,2277.714,92.7619
"25816","77470","2018",101,46,55,223725.5,3481.574,72.91089
"25817","77471","2018",7,7,0,218585.7,1609.429,135.4286
"25818","77472","2018",6,6,0,169416.7,1730,99.33333
"25819","77473","2018",6,6,0,197720,1938.5,103.1667
"25820","77474","2018",7,7,0,283000,3002.571,96.28571
"25821","77475","2018",65,57,8,214118,2830.462,79.09231
"25822","77477","2018",5,5,0,272690,2562,112.2
"25823","77478","2018",17,15,2,181126.5,2225.647,84.64706
"25824","77479","2018",115,59,56,268276.8,3569.661,77.86957
"25825","77480","2018",11,11,0,189090.9,2381.818,92
"25826","77481","2018",2,2,0,174750,1802,99
"25827","77482","2018",35,32,3,237999.7,2789.286,88.42857
"25828","77483","2018",25,22,3,198594,2502.92,82.96
"25829","77484","2018",6,6,0,282333.3,2501.167,112.6667
"25830","77485","2018",13,13,0,354461.5,2818.769,127.3846
"25831","77486","2018",17,17,0,241321.2,2260.353,111.2353
"25832","77487","2018",114,72,42,245944.8,2608.974,97.45614
"25833","77489","2018",2,2,0,148500,1211,110.5
"25834","77490","2018",11,11,0,163886.4,1538.091,107.3636
"25835","77492","2018",6,6,0,131833.3,1199,113.3333
"25836","77493","2018",27,23,4,228032.6,2836.556,82.33333
"25837","77494","2018",28,27,1,196605.8,1935.643,105.6071
"25838","77495","2018",105,92,13,240447,2733.2,90.24762
"25839","77496","2018",2,2,0,198500,2198.5,90.5
"25840","77498","2018",1,1,0,261950,3082,85
"25841","77500","2018",5,5,0,209279,1525.4,138.4
"25842","77501","2018",10,10,0,178155,1822.9,104.5
"25843","77504","2018",16,16,0,225522.8,1929.812,123
"25844","77505","2018",10,10,0,240020,2201.1,109.4
"25845","77506","2018",5,5,0,263000,1744.6,150.8
"25846","77507","2018",8,8,0,139625,1548.75,100.625
"25847","77508","2018",24,22,2,316434.5,3910.833,88.625
"25848","77509","2018",7,7,0,197604.1,2154.286,99.42857
"25849","77510","2018",9,8,1,266738.9,3160.889,88.77778
"25850","77511","2018",6,4,2,191833.3,2457.167,80.66667
"25851","77512","2018",13,12,1,146000,1638.769,97.07692
"25852","77513","2018",64,29,35,190583,2821.859,70.10938
"25853","77514","2018",350,178,172,205977.3,3032.014,71.06
"25854","77515","2018",7,7,0,227714.3,2286.571,99.14286
"25855","77516","2018",16,15,1,182562.5,1897.5,102.0625
"25856","77517","2018",26,20,6,270092.2,3223.346,90.96154
"25857","77518","2018",5,5,0,244800,2860.2,87.6
"25858","77519","2018",11,10,1,132710,1337.182,108.5455
"25859","77520","2018",9,9,0,335583.3,1917.111,181.8889
"25860","77521","2018",22,22,0,253056.8,2874.682,95.63636
"25861","77522","2018",3,3,0,115333.3,1373.333,84.66667
"25862","77523","2018",3,3,0,102333.3,1269,80.33333
"25863","77524","2018",7,7,0,175273.9,1257,136.5714
"25864","77525","2018",5,5,0,255158.2,2608.4,103.4
"25865","77526","2018",5,5,0,176600,2060.2,88.8
"25866","77527","2018",7,7,0,308042.9,2475.857,134.4286
"25867","77528","2018",5,5,0,273860,3101.2,91.6
"25868","77529","2018",20,20,0,275925.1,2748.4,103.8
"25869","77530","2018",5,5,0,147400,1467.2,97.6
"25870","77531","2018",28,28,0,136316.1,1859.893,76
"25871","77532","2018",1,1,0,166450,1891,88
"25872","77533","2018",31,30,1,284021.1,2755.29,104.9355
"25873","77534","2018",6,6,0,254916.7,2819.833,94
"25874","78003","2018",42,40,2,238919,2231.929,110.4286
"25875","78005","2018",195,90,105,256163.4,3451.164,75.97436
"25876","78006","2018",10,10,0,332318.2,3430.9,125.3
"25877","78007","2018",14,14,0,589857.1,4529.286,138.5
"25878","78009","2018",6,6,0,209000,2118.5,100.5
"25879","78010","2018",13,13,0,425395.2,3697.462,115.4615
"25880","78015","2018",201,88,113,268536.1,3262.642,84.73134
"25881","78020","2018",15,14,1,296970.7,2263.8,136.4667
"25882","78029","2018",144,60,84,177225.4,2360.153,76.375
"25883","78030","2018",1,0,1,80000,3333,24
"25884","78031","2018",7,7,0,289571.4,2344.143,128
"25885","78033","2018",18,15,3,289751.1,2711.944,112.7778
"25886","78034","2018",13,13,0,357550,2957.769,124.3846
"25887","78036","2018",4,4,0,364422.5,3373.5,108.5
"25888","78043","2018",59,28,31,474694.4,4624.763,104.5254
"25889","78048","2018",20,18,2,322656.5,2496.4,132.15
"25890","78049","2018",24,22,2,328092.2,3367.917,104.375
"25891","78050","2018",8,8,0,892837.5,3965.875,226.75
"25892","78053","2018",8,8,0,303512.5,2507.375,129.5
"25893","78057","2018",13,13,0,175495.6,1982.231,93.15385
"25894","78062","2018",113,75,38,248743.2,2894.504,86.49558
"25895","78068","2018",9,9,0,323266.7,2405.889,140.7778
"25896","78070","2018",6,5,1,206833.3,2418.167,105.1667
"25897","78071","2018",5,5,0,208600,2146.8,100.8
"25898","78073","2018",215,62,153,240010.9,3322.916,72.26047
"25899","78076","2018",5,5,0,249100,2069.4,120.6
"25900","78077","2018",5,5,0,264912,2871.2,92.6
"25901","78082","2018",14,14,0,204675,2194.857,95.5
"25902","78084","2018",6,6,0,278083.3,2622.167,110.3333
"25903","78087","2018",19,17,2,295818.4,2838.895,110.6316
"25904","78089","2018",49,36,13,187150.9,2304,87.02041
"25905","78090","2018",19,18,1,269963.2,3037,94.68421
"25906","78092","2018",123,27,96,413903.9,4340.244,91.37398
"25907","78096","2018",2,2,0,617005,2433,264
"25908","78104","2018",4,4,0,205625,2536,85.25
"25909","78107","2018",24,22,2,230906.2,2517.625,92.29167
"25910","78108","2018",10,7,3,353968,3042.1,136.7
"25911","78113","2018",10,10,0,268279,2311.1,118.1
"25912","78117","2018",76,34,42,461465.6,4955.039,94.90789
"25913","78118","2018",31,26,5,226932.1,2839.419,87.90323
"25914","78120","2018",19,18,1,367078.9,2797.211,135.0526
"25915","78123","2018",187,73,114,216770,3249.299,68.54545
"25916","78124","2018",210,97,113,386451.2,4847.043,79.71905
"25917","78125","2018",9,9,0,338522.2,2963.222,116.2222
"25918","78126","2018",253,70,183,411675.6,4238.538,93.49012
"25919","78128","2018",23,21,2,351079,3201.826,108.2174
"25920","78133","2018",96,49,47,467350.6,4010.656,115.5729
"25921","78138","2018",85,68,17,279243.4,3107.941,91.88235
"25922","78140","2018",22,22,0,341180,3526.909,107.5909
"25923","78143","2018",25,21,4,475362.8,4163.68,117.88
"25924","78146","2018",470,132,338,415428.7,4959.787,81.21702
"25925","78147","2018",3,3,0,210333.3,1935.333,137
"25926","78152","2018",20,18,2,527554.7,3759.7,142
"25927","78158","2018",262,72,190,501314.1,5418.355,88.94275
"25928","78160","2018",66,40,26,347688.9,3962.167,96.75758
"25929","78162","2018",1,1,0,420000,2838,148
"25930","78163","2018",3,3,0,252173.3,2378,118
"25931","78164","2018",11,10,1,538466.4,2993.727,190
"25932","78165","2018",213,104,109,268686.8,3331.235,81.98122
"25933","78168","2018",32,22,10,275987.5,3671.781,83.1875
"25934","78171","2018",4,4,0,474800,2303.25,202.75
"25935","78172","2018",519,301,218,270348.7,3605.245,77.3738
"25936","78185","2018",4,4,0,272000,2774.5,97.5
"25937","78188","2018",4,4,0,255250,2541,108.75
"25938","78189","2018",34,34,0,529822.6,3697.059,153.9118
"25939","78190","2018",131,70,61,634529.4,5715,110.7939
"25940","78192","2018",17,17,0,214575,2566.765,92.52941
"25941","78193","2018",17,15,2,423383.9,3212.235,134.2941
"25942","78194","2018",2,2,0,232040,2421.5,100.5
"25943","78196","2018",4,3,1,462467.5,3460.75,139.75
"25944","78202","2018",2,2,0,436910,2578,171
"25945","78206","2018",60,51,9,259936.2,3238.683,84.9
"25946","78208","2018",427,128,299,214784.4,2809.618,78.726
"25947","78209","2018",5,5,0,295560,2845.2,116.6
"25948","78217","2018",78,64,14,246734.4,2770.154,93.4359
"25949","78220","2018",76,57,19,300351.9,3078.382,101.1316
"25950","78224","2018",74,48,26,543281.7,4772.77,114.9459
"25951","78227","2018",8,8,0,211915.1,2256.875,98.25
"25952","78230","2018",10,9,1,227245,3102.1,82.4
"25953","78231","2018",4,4,0,280312.5,2289.25,118
"25954","78233","2018",48,46,2,611768.1,3865.542,164.3125
"25955","78234","2018",4,4,0,251487.5,2794.5,91.5
"25956","78236","2018",6,6,0,318191.7,2736.667,126
"25957","78237","2018",2,2,0,224000,2233.5,101.5
"25958","78238","2018",24,20,4,235243.8,3014.792,82.70833
"25959","78239","2018",18,16,2,230752.8,2205.667,107.1111
"25960","78242","2018",139,35,104,248403.9,3397.288,71.89209
"25961","78245","2018",2,2,0,245000,2309,106
"25962","78246","2018",16,13,3,205812.5,2568,87.5625
"25963","78255","2018",36,34,2,212656.1,2185.528,102.75
"25964","78261","2018",7,7,0,263031.9,1834.714,160.7143
"25965","78262","2018",19,17,2,315930,3475.684,91.84211
"25966","78263","2018",44,42,2,365562,2853.795,131.5455
"25967","78264","2018",1,1,0,74600,617,121
"25968","78265","2018",31,24,7,296676.5,3120,102.1935
"25969","78267","2018",84,76,8,216491.6,2551.762,89.28571
"25970","78269","2018",11,10,1,319044.5,2496.455,133.7273
"25971","78276","2018",10,10,0,116685,1832.1,74
"25972","78278","2018",9,9,0,604805.6,3066.111,197.3333
"25973","78281","2018",5,4,1,279874,2338,133.6
"25974","78283","2018",2,2,0,344160,2040.5,168.5
"25975","78285","2018",2,2,0,214761.5,2185,101
"25976","78289","2018",10,10,0,682780.6,4943.2,147.9
"25977","78290","2018",9,9,0,228933.3,2600,97.22222
"25978","78291","2018",33,28,5,209788.5,2350.758,90.66667
"25979","78296","2018",10,10,0,244463,2433.3,107.5
"25980","78297","2018",256,69,187,279559.4,3692.254,77.26172
"25981","78299","2018",40,29,11,246650.1,2762.75,93.375
"25982","78300","2018",9,8,1,261511.1,2263.889,119.4444
"25983","78302","2018",7,7,0,398975.7,2589.714,158.1429
"25984","78305","2018",4,4,0,570050,3315.25,173.5
"25985","78307","2018",15,15,0,242562.1,2431.867,107.8667
"25986","78310","2018",59,32,27,230309,2869.169,81.57627
"25987","78311","2018",506,249,257,329313.9,4631.411,72.52767
"25988","78314","2018",37,30,7,208529.9,2446.703,87.02703
"25989","78317","2018",13,13,0,231686.9,2451.462,97.15385
"25990","78320","2018",5,5,0,244400,1711.6,147.2
"25991","78321","2018",3,3,0,508561.3,2957,178.6667
"25992","78322","2018",49,18,31,359440.9,4341.694,82.18367
"25993","78324","2018",7,4,3,228214.3,2234.714,110
"25994","78325","2018",11,9,2,268254.5,2755,99.18182
"25995","78327","2018",65,61,4,248785.8,2594.446,103.3385
"25996","78329","2018",13,13,0,234292.3,2753.154,92.46154
"25997","78334","2018",21,21,0,420946.2,3611.524,124.7143
"25998","78335","2018",142,102,40,188149.7,2352.873,81.88732
"25999","78337","2018",20,20,0,198025,2201.15,95.5
"26000","78343","2018",24,21,3,722309.6,4807.5,149.2917
"26001","78344","2018",8,8,0,190609.8,2465,76.25
"26002","78346","2018",14,12,2,264677.9,2504.786,114.2143
"26003","78349","2018",6,6,0,360966.7,3341.5,111.3333
"26004","78350","2018",103,28,75,528318.8,4503.262,111.6117
"26005","78354","2018",60,58,2,213579.9,2343.267,92.26667
"26006","78356","2018",98,69,29,298261.7,3289.347,91.39796
"26007","78358","2018",421,110,311,462263.8,5527.948,81.49406
"26008","78361","2018",334,96,238,163774.2,2478.293,66.70958
"26009","78362","2018",187,116,71,174554.5,2270.802,80.46524
"26010","78364","2018",11,10,1,303656.4,3373.818,93.72727
"26011","78366","2018",5,5,0,423091.4,2749,164
"26012","78367","2018",51,28,23,529016.5,4879.98,108.8431
"26013","78368","2018",25,25,0,383572.2,3299.44,120.72
"26014","78372","2018",258,49,209,331048.1,3911.326,81.46512
"26015","78380","2018",89,82,7,350896.8,3275.865,111.4944
"26016","78381","2018",11,10,1,265054.5,2772,97.81818
"26017","78382","2018",54,40,14,326806.1,3525.704,92.44444
"26018","78383","2018",270,127,143,243066.3,2900.989,84.23333
"26019","78384","2018",15,15,0,384731.3,4957.933,104.6
"26020","78389","2018",20,19,1,431292.5,3220.65,140.75
"26021","78391","2018",8,8,0,206168.8,2352.25,91.75
"26022","78396","2018",77,40,37,483214.5,4990.117,98.41558
"26023","78397","2018",100,77,23,336662.2,3507.48,99.92
"26024","78398","2018",6,6,0,658165,3637,182.8333
"26025","78401","2018",138,54,84,168218.5,2393.746,72.8913
"26026","78402","2018",48,38,10,257942.1,3053.5,89
"26027","78403","2018",39,35,4,249520.5,2787.41,91.23077
"26028","78404","2018",8,8,0,405507,3243.25,137.375
"26029","78406","2018",1,1,0,480000,4000,120
"26030","78407","2018",14,14,0,316145.6,2819.643,125.2143
"26031","78410","2018",16,16,0,219234.4,2176.438,109.5625
"26032","78413","2018",7,7,0,283857.1,1868.143,168.1429
"26033","78415","2018",4,4,0,355737.5,2881.75,128.75
"26034","78416","2018",2,2,0,376500,1945.5,194.5
"26035","78417","2018",3,3,0,273333.3,2903,107.6667
"26036","78418","2018",193,96,97,372717,4604.513,82.64249
"26037","78420","2018",47,37,10,451002.9,4011.064,117.6809
"26038","78423","2018",420,134,286,308162.5,3780.879,82.38333
"26039","78431","2018",50,49,1,494543.8,3617.64,138.22
"26040","78437","2018",8,8,0,188375,2342.125,84.25
"26041","78439","2018",3,3,0,308000,2729,119.6667
"26042","78440","2018",228,113,115,160937.7,2279.149,72.92982
"26043","78443","2018",5,3,2,286926,2401.2,120
"26044","78444","2018",11,11,0,221600.9,1902.727,118.1818
"26045","78451","2018",21,18,3,220309.5,2634.333,87.80952
"26046","78455","2018",82,47,35,484185.7,4543.951,105.5488
"26047","78460","2018",12,12,0,321595.8,2760.25,121.3333
"26048","78464","2018",5,5,0,266600,2173,123.2
"26049","78465","2018",21,21,0,312356.7,2836.524,116.9524
"26050","78466","2018",100,90,10,585441.3,4200.07,140.51
"26051","78470","2018",21,20,1,310738.1,2712.429,121.4762
"26052","78472","2018",3,2,1,245433.3,2245.333,119.6667
"26053","78474","2018",16,15,1,278180.3,2539.312,114.1875
"26054","78475","2018",3,3,0,303200,2974.667,101
"26055","78478","2018",3,3,0,265616.7,1981.667,133
"26056","78481","2018",259,47,212,340055.9,4372.745,76.56757
"26057","78484","2018",7,7,0,285992.9,2295.286,128
"26058","78486","2018",95,68,27,265283.7,3295.2,86.73684
"26059","78490","2018",407,150,257,238439.6,2990.302,81.04423
"26060","78497","2018",13,13,0,402542.3,3035.692,147.4615
"26061","78498","2018",463,109,354,250491,3621.145,70.56587
"26062","78499","2018",8,8,0,290937.5,2456.125,123.125
"26063","78501","2018",37,36,1,215479.8,2323.649,97.59459
"26064","78502","2018",63,10,53,292217.9,4144.952,71
"26065","78505","2018",5,5,0,320100,1711,228.6
"26066","78506","2018",19,19,0,284147.4,2295.579,129.2632
"26067","78513","2018",36,26,10,292478.8,3333.083,91.58333
"26068","78516","2018",9,9,0,355406.7,2588.667,144.4444
"26069","78517","2018",387,145,242,262011,3431.401,77.26873
"26070","78518","2018",4,4,0,741250,3603.75,211.75
"26071","78520","2018",12,11,1,278817.3,2792.583,108.3333
"26072","78522","2018",15,11,4,320826.1,2953.467,117.2667
"26073","78528","2018",5,5,0,174700,1207.8,146.4
"26074","78530","2018",2,2,0,285750,2336.5,118.5
"26075","78531","2018",71,56,15,192662.2,2326.62,88.15493
"26076","78536","2018",6,5,1,252083.3,2628.333,103.5
"26077","78537","2018",61,50,11,262502.5,2809.623,99.19672
"26078","78545","2018",273,64,209,283870,3791.337,73.19048
"26079","78548","2018",5,5,0,456300,2870,165.8
"26080","78550","2018",22,19,3,358314.3,3401.909,108
"26081","78551","2018",626,108,518,452385.2,5638.639,79.42332
"26082","78557","2018",21,20,1,229975.7,2476.714,99.85714
"26083","78558","2018",5,5,0,220320,2208.4,108.2
"26084","78559","2018",3,2,1,200500,2285.667,95
"26085","78561","2018",4,4,0,518862.5,3597,165.75
"26086","78562","2018",16,15,1,395431.2,2936.312,143.75
"26087","78564","2018",8,8,0,233537.5,2336.75,105.875
"26088","78565","2018",5,5,0,317580,2678.4,120
"26089","78567","2018",10,9,1,197070,2417.6,83.4
"26090","78569","2018",9,7,2,222448.9,2565.111,93.88889
"26091","78571","2018",77,66,11,655790.3,4326.104,159.0779
"26092","78575","2018",87,74,13,408049.8,4177.678,103.8161
"26093","78576","2018",21,16,5,447373.6,3024.19,152.6667
"26094","78586","2018",637,253,384,273751.1,4109.808,68.41758
"26095","78588","2018",5,5,0,335900,2838,123.2
"26096","78590","2018",4,3,1,387811.5,3590.25,121.5
"26097","78591","2018",35,33,2,266666.7,2355.2,115.2
"26098","78597","2018",11,10,1,251885.8,2244.273,108.8182
"26099","78601","2018",17,12,5,273514.7,2480.176,128.3529
"26100","78605","2018",15,15,0,295843.3,2798.8,108.4
"26101","78608","2018",2,2,0,275000,2124,122.5
"26102","78609","2018",16,16,0,280925,2817.375,101.3125
"26103","78615","2018",4,4,0,361675,4406.25,84.5
"26104","78616","2018",18,13,5,374260.8,3097.222,118.4444
"26105","78618","2018",7,7,0,260071.4,2075.143,124.7143
"26106","78620","2018",10,10,0,637592.3,4245.6,155.4
"26107","78621","2018",217,50,167,177480.6,2741.922,65.90783
"26108","78623","2018",13,8,5,340161.9,3050.077,121.8462
"26109","78624","2018",177,137,40,309904.6,3335.723,95.24294
"26110","78638","2018",53,47,6,307540.1,3210.415,101.0755
"26111","78640","2018",199,33,166,311859.2,4320.583,71.82412
"26112","78642","2018",224,101,123,276617.7,3043.603,89.9375
"26113","78643","2018",95,75,20,328098.7,3444.253,98.68421
"26114","78644","2018",22,20,2,276696.4,3315.682,85.40909
"26115","78646","2018",1048,118,930,461422.3,6230.007,73.41031
"26116","78647","2018",10,10,0,210150,2331.7,97.2
"26117","78650","2018",278,107,171,634392.6,6190.957,98.39209
"26118","78653","2018",6,6,0,393079.2,3082.167,137.1667
"26119","78655","2018",12,11,1,281011.7,2808.583,103.25
"26120","78668","2018",7,7,0,238194.3,2102.857,117
"26121","78672","2018",87,62,25,529161.2,4415.322,123.4253
"26122","78674","2018",136,106,30,321254.7,3570.051,90.88235
"26123","78677","2018",5,5,0,356000,2402.6,148.4
"26124","78681","2018",14,14,0,306032.1,3316.786,102.2857
"26125","78683","2018",4,4,0,375037.5,3652.5,100.75
"26126","78686","2018",228,70,158,458547.8,5908.469,73.95614
"26127","78688","2018",109,70,39,416036.9,4184.119,100.6422
"26128","79001","2018",14,14,0,99721.43,833.8571,117.5714
"26129","79002","2018",6,6,0,91166.67,817.6667,113.3333
"26130","79003","2018",60,60,0,149964.1,1390.567,106.65
"26131","79005","2018",42,42,0,98526.19,1055.81,93.47619
"26132","79007","2018",10,10,0,82040,780.9,105
"26133","79008","2018",8,7,1,118781.2,995.875,121.25
"26134","79009","2018",3,3,0,140166.7,1241.667,109.3333
"26135","79010","2018",20,19,1,95873.8,1089.85,88.95
"26136","79012","2018",16,16,0,95837.88,996.625,98.75
"26137","79013","2018",29,29,0,84489.14,823.8621,103.3793
"26138","79014","2018",23,23,0,76752.96,841.3913,90.78261
"26139","79015","2018",2,2,0,70857,935.5,111
"26140","79016","2018",8,8,0,129937.5,966.25,135.25
"26141","79018","2018",2,2,0,185000,1279.5,215
"26142","79020","2018",12,12,0,132416.7,1140.333,116.6667
"26143","79023","2018",1,1,0,124500,1164,107
"26144","79024","2018",18,18,0,160798.3,1493.889,108.6111
"26145","79025","2018",21,21,0,88374.95,809.9524,110
"26146","79029","2018",15,15,0,114370,1027.133,111.0667
"26147","79030","2018",7,7,0,91714.29,744.5714,130.4286
"26148","79031","2018",25,23,2,125058,1238.08,97.4
"26149","79032","2018",6,6,0,140666.7,1146.5,125.6667
"26150","79034","2018",20,20,0,164275,1522.45,110.7
"26151","79038","2018",10,10,0,123230,1023.7,122.4
"26152","79040","2018",3,3,0,71666.67,668,105.6667
"26153","79042","2018",1,1,0,90000,783,115
"26154","79046","2018",5,5,0,118624.4,1183.8,95.6
"26155","79047","2018",4,4,0,89625,693.25,138.75
"26156","79048","2018",59,59,0,144482.8,1377.22,107.7119
"26157","79049","2018",192,175,17,119389.3,1251.578,96.64062
"26158","79050","2018",3,3,0,97666.67,1002,102
"26159","79056","2018",5,5,0,99280,743.2,119.6
"26160","79057","2018",14,14,0,123604.3,1042.071,117.5714
"26161","79058","2018",9,9,0,156181.6,1155.667,137.8889
"26162","79059","2018",13,13,0,91065.92,920.1538,96.23077
"26163","79060","2018",1,1,0,105500,1055,100
"26164","79061","2018",32,31,1,115126.2,1047.344,113.75
"26165","79062","2018",40,40,0,91775,1009.525,93.875
"26166","79063","2018",31,31,0,98231.45,932.7419,103.7097
"26167","79064","2018",9,9,0,111822.2,979.5556,115.8889
"26168","79066","2018",21,21,0,95197.14,971.6667,100.619
"26169","79069","2018",10,10,0,128160,1033.4,129.9
"26170","79071","2018",8,8,0,133062.5,1086.375,117
"26171","79074","2018",2,2,0,43000,699.5,62.5
"26172","79076","2018",22,22,0,98577.27,857.4091,115.4545
"26173","79077","2018",11,11,0,110356.2,1039.455,111.1818
"26174","79078","2018",16,16,0,111031.2,980.1875,115.3125
"26175","79079","2018",87,87,0,122427.5,1135.23,106.5517
"26176","79080","2018",33,33,0,98421.21,1053.758,96.39394
"26177","79081","2018",83,81,2,190096.8,1804.843,105.8916
"26178","79083","2018",42,42,0,90350.93,852.881,110.4048
"26179","79084","2018",6,6,0,84000,719.3333,115.1667
"26180","79085","2018",1,1,0,230000,970,237
"26181","79086","2018",22,22,0,143708,1237.727,115.9545
"26182","79087","2018",8,8,0,94209,987.125,96
"26183","79088","2018",13,13,0,117346.2,1050.692,112.7692
"26184","79089","2018",2,2,0,86000,756.5,116
"26185","79090","2018",8,8,0,77056.25,822.5,98
"26186","79091","2018",12,12,0,112058.3,1232.333,96.08333
"26187","79092","2018",2,2,0,65000,643,90
"26188","79094","2018",14,14,0,109900,929.3571,119.5714
"26189","79095","2018",15,15,0,86736.67,745.6,124.1333
"26190","79096","2018",7,7,0,88142.86,1108.571,92.42857
"26191","79100","2018",31,30,1,166354.8,1397,117.4194
"26192","79101","2018",33,33,0,119941.9,1104.242,109.4848
"26193","79102","2018",3,3,0,66333.33,995.3333,74
"26194","79103","2018",25,25,0,68398,702.84,96.8
"26195","79104","2018",6,6,0,165478.7,1235.167,118.1667
"26196","79105","2018",2,2,0,87500,866.5,107.5
"26197","79106","2018",2,2,0,37500,419,87
"26198","79108","2018",1,1,0,120000,588,204
"26199","79109","2018",34,34,0,154224.4,1525.941,103.0882
"26200","79111","2018",4,4,0,92375,818.75,111.75
"26201","79112","2018",8,8,0,114262.2,1151.375,101.25
"26202","79114","2018",22,19,3,96886.36,1045.727,94.54545
"26203","79115","2018",5,5,0,89800,841,107.6
"26204","79116","2018",8,8,0,116525,966.25,117.125
"26205","79117","2018",7,7,0,152857.1,1395.429,122.7143
"26206","79118","2018",5,5,0,103600,864.2,117.6
"26207","79119","2018",9,9,0,84566.67,826.7778,100.5556
"26208","79120","2018",8,8,0,90426.88,764.875,123.875
"26209","79121","2018",1,1,0,30000,341,88
"26210","79122","2018",13,13,0,93092.31,771.8462,129.8462
"26211","79123","2018",25,25,0,93558.4,954.36,100
"26212","79124","2018",7,5,2,98865.29,1006.571,103.1429
"26213","79125","2018",21,21,0,144990.5,1210.048,127.3333
"26214","79126","2018",4,4,0,120750,867,140.5
"26215","79127","2018",15,15,0,120196,992.7333,124
"26216","79128","2018",12,12,0,180287.2,1369.833,134.1667
"26217","79129","2018",18,18,0,184389.8,1568.389,121.1111
"26218","79130","2018",45,44,1,132119.2,1274.511,106.2444
"26219","79131","2018",3,3,0,111666.7,1213.333,94
"26220","79132","2018",2,2,0,77550,872,86
"26221","79133","2018",11,11,0,159654.5,1352.091,119.1818
"26222","79134","2018",3,3,0,107000,937.3333,112.3333
"26223","79135","2018",13,13,0,131910.2,1073.615,119.6154
"26224","79136","2018",16,16,0,120347.8,917.125,132.9375
"26225","79137","2018",11,11,0,152590.9,1337.545,118.5455
"26226","79140","2018",12,12,0,100708.3,869,111.3333
"26227","79142","2018",4,4,0,107837.5,1002.25,109
"26228","79145","2018",2,2,0,96500,991.5,99
"26229","79147","2018",6,6,0,89750,934.5,94.83333
"26230","79148","2018",25,25,0,90520,809.64,117.32
"26231","79149","2018",2,2,0,124925,1693,60
"26232","79150","2018",9,9,0,134112.2,1540.333,101.7778
"26233","79152","2018",2,2,0,92500,1057.5,87.5
"26234","79153","2018",5,5,0,91200,822.2,101.6
"26235","79154","2018",11,11,0,72790,729.5455,97.27273
"26236","79156","2018",11,11,0,93590.91,964.5455,97.18182
"26237","79157","2018",5,5,0,114440,1151,100.8
"26238","79159","2018",2,2,0,73000,816.5,95
"26239","79160","2018",2,2,0,76300,846,96
"26240","79161","2018",4,4,0,93765.5,813,115
"26241","79162","2018",33,33,0,169068.8,1682.788,103.3333
"26242","79163","2018",10,10,0,110106,1181,103.9
"26243","79164","2018",2,2,0,54250,564.5,99
"26244","79165","2018",1,1,0,125000,772,162
"26245","79166","2018",6,6,0,108750,1179.167,87.83333
"26246","79170","2018",36,36,0,150611.4,1390.194,109.5833
"26247","79172","2018",16,16,0,95368.75,907.5,114.375
"26248","79174","2018",57,57,0,100769,1107.035,99.01754
"26249","79175","2018",8,8,0,131625.1,1123.625,118.625
"26250","79176","2018",11,11,0,119590.9,1177.091,101.4545
"26251","79177","2018",9,9,0,84740,773.3333,120.1111
"26252","79179","2018",65,65,0,97197.85,912.0769,106.0154
"26253","79180","2018",5,5,0,48034,520.4,88.8
"26254","79183","2018",1,1,0,75000,1027,73
"26255","79184","2018",26,25,1,107648.4,844.9231,128.0769
"26256","79185","2018",47,47,0,160731.9,1308.191,122.766
"26257","79189","2018",27,27,0,115798.5,1166.222,106.2963
"26258","79190","2018",5,5,0,86000,717.6,120
"26259","79191","2018",1097,792,305,128656.2,1510.183,85.77302
"26260","79195","2018",39,39,0,126043.9,1218.872,105.1282
"26261","79196","2018",23,23,0,102826.1,913.2609,114.3913
"26262","79197","2018",4,4,0,100250,805.25,114.75
"26263","79198","2018",5,5,0,131988,959,134.4
"26264","79200","2018",2,2,0,77000,807.5,97
"26265","79201","2018",26,26,0,94171.15,974.7308,98.30769
"26266","79202","2018",131,108,23,90620.54,1018.84,90.66412
"26267","79203","2018",5,5,0,56500,530.2,109.4
"26268","79204","2018",8,8,0,136198.8,974.125,138
"26269","79205","2018",2,2,0,62950,553,98.5
"26270","79207","2018",8,8,0,103000,1064.625,97.625
"26271","79208","2018",8,8,0,187500,1188.375,159.875
"26272","79209","2018",1,1,0,40000,656,61
"26273","79210","2018",9,9,0,130055.6,1024.444,121.3333
"26274","79212","2018",6,6,0,81103.33,702.3333,120.5
"26275","79213","2018",21,21,0,105349,1065.095,97
"26276","79215","2018",7,7,0,108158.1,868.8571,123.4286
"26277","79216","2018",21,21,0,179616.6,1642.714,111.381
"26278","79217","2018",8,8,0,138981.2,958.125,148
"26279","79220","2018",7,7,0,129571.4,1098,114.4286
"26280","79223","2018",2,2,0,126500,1040,143
"26281","79225","2018",5,5,0,88600,706.4,138.2
"26282","79226","2018",3,3,0,102000,1165.667,90
"26283","79229","2018",5,5,0,137080,1323.2,105.2
"26284","79230","2018",7,7,0,75585.71,688.2857,127.2857
"26285","79231","2018",9,9,0,135722.2,1336.222,104.5556
"26286","79235","2018",11,11,0,109772.7,1182.455,97.27273
"26287","79236","2018",10,10,0,129210,951.6,132.4
"26288","79238","2018",3,3,0,61500,663.3333,91.66667
"26289","79239","2018",14,14,0,97152.14,1010.429,97.07143
"26290","79241","2018",4,4,0,143000,946.75,168.25
"26291","79242","2018",10,10,0,125500,990.7,131.2
"26292","79243","2018",2,2,0,29750,501.5,56.5
"26293","79244","2018",3,3,0,61666.67,742.3333,77.66667
"26294","79246","2018",10,10,0,98150,948.7,106.1
"26295","79249","2018",25,24,1,142232,1490.48,97.48
"26296","79250","2018",2,2,0,85250,787.5,115
"26297","79251","2018",5,5,0,116718.8,928.4,125.6
"26298","79252","2018",3,3,0,82333.33,497.6667,154.6667
"26299","79253","2018",10,10,0,100550,1031.6,97.9
"26300","79254","2018",4,4,0,75000,647,121.5
"26301","79255","2018",4,4,0,89000,927,92.75
"26302","79256","2018",2,2,0,62500,615,102.5
"26303","79257","2018",17,17,0,152893.3,1278.059,114.7647
"26304","79258","2018",8,8,0,92500,933.75,99.5
"26305","79259","2018",18,18,0,114401.1,1013.111,115.1667
"26306","79263","2018",9,9,0,68777.78,796.1111,84.44444
"26307","79265","2018",8,8,0,125108.8,1335.375,93.875
"26308","79267","2018",4,4,0,98500,909.25,104.75
"26309","79268","2018",22,22,0,84168.18,844.4545,95.72727
"26310","79269","2018",1,1,0,94800,1247,76
"26311","79270","2018",90,82,8,94869.71,983.3,95.75556
"26312","79271","2018",3,3,0,144166.7,1055,147.6667
"26313","79273","2018",11,11,0,127054.5,1299.091,97.90909
"26314","79274","2018",3,3,0,111766.7,842.6667,148.6667
"26315","79276","2018",17,17,0,138879.4,1158.294,116.4706
"26316","79277","2018",8,8,0,105961.2,976.125,109.25
"26317","79278","2018",4,4,0,122840.8,800.75,167
"26318","79280","2018",9,9,0,76488.89,735.2222,105.8889
"26319","79281","2018",17,17,0,152484.2,1361.588,112.1765
"26320","79283","2018",11,11,0,146818.2,1151.727,133.8182
"26321","79284","2018",7,7,0,134557.1,1134,121.1429
"26322","79285","2018",19,19,0,99078.95,980.8421,102.1579
"26323","79286","2018",7,7,0,75428.57,667.7143,116.1429
"26324","79289","2018",12,12,0,127041.7,1291.667,100.0833
"26325","79290","2018",13,13,0,101407.7,1155.923,88.76923
"26326","79293","2018",9,9,0,147777.8,1599.111,97.77778
"26327","79294","2018",2,2,0,140000,1185.5,117.5
"26328","79295","2018",7,7,0,114038.6,1101.429,102.4286
"26329","79297","2018",5,5,0,161400,1124,135.6
"26330","79298","2018",19,19,0,182345.8,1701.211,107
"26331","79299","2018",19,19,0,118443.6,897.6842,127.6316
"26332","79300","2018",18,18,0,100345.6,1062.778,93.83333
"26333","79301","2018",6,6,0,124016.7,1115.5,117.5
"26334","79302","2018",17,17,0,141347.5,1295.941,106.4706
"26335","79303","2018",3,3,0,87000,992.6667,83.66667
"26336","79304","2018",11,11,0,147636.4,1343.182,113.9091
"26337","79307","2018",27,27,0,95255.22,853.037,117.963
"26338","79308","2018",6,6,0,111000,1146,88.66667
"26339","79309","2018",8,8,0,95137.5,912.375,112.75
"26340","79310","2018",2,2,0,93650,683,138
"26341","79311","2018",24,24,0,131354.2,1331.5,109.6667
"26342","79312","2018",2,2,0,165000,1272.5,133
"26343","79313","2018",4,4,0,98831.25,881,110.25
"26344","79316","2018",5,5,0,133320,1095.4,122
"26345","79319","2018",11,11,0,131875.6,1239.364,108.9091
"26346","79320","2018",12,12,0,125345.8,1023.75,119.6667
"26347","79322","2018",15,15,0,121900,1056.2,108.7333
"26348","79326","2018",10,9,1,67000,735.8,86.4
"26349","79329","2018",168,153,15,91184.83,1048.095,88.7381
"26350","79332","2018",1,1,0,118000,1475,80
"26351","79334","2018",16,16,0,124793.8,1218,117.125
"26352","79335","2018",11,11,0,156518.2,1593.636,106.7273
"26353","79336","2018",5,5,0,75596,752.2,91.8
"26354","79337","2018",14,14,0,135478.6,1099.786,125.5714
"26355","79338","2018",2,2,0,80575,596,132.5
"26356","79339","2018",19,19,0,106227.4,1034.632,104.7368
"26357","79340","2018",1,1,0,82000,500,164
"26358","79341","2018",1,1,0,125000,781,160
"26359","79342","2018",7,7,0,106571.4,925.7143,114.8571
"26360","79343","2018",2,2,0,113000,1466.5,77
"26361","79345","2018",7,7,0,120320,1045,126.1429
"26362","79346","2018",2,2,0,87500,840,92
"26363","79347","2018",6,6,0,115000,1125,102.3333
"26364","79349","2018",4,4,0,71735,927.5,75.5
"26365","79351","2018",22,22,0,146090.9,1276.818,117.0909
"26366","79352","2018",2,2,0,43750,568.5,78
"26367","79354","2018",2,2,0,116000,1071.5,111.5
"26368","79355","2018",32,32,0,170180.3,1654.594,106.3125
"26369","79357","2018",1,1,0,270000,2269,119
"26370","80001","2018",246,202,44,118035.2,1478.488,82.97561
"26371","80002","2018",5,5,0,104900,843.4,134.6
"26372","80003","2018",1,1,0,181000,1257,144
"26373","80004","2018",8,8,0,101968.8,1159.625,92.5
"26374","80008","2018",6,6,0,117583.3,1319.167,92.5
"26375","80009","2018",7,7,0,124714.3,1274.857,96.57143
"26376","80010","2018",37,37,0,157776.9,1748.73,95.43243
"26377","80011","2018",29,29,0,161031.9,1727.517,90.7931
"26378","80013","2018",16,16,0,108525,1135.562,100.6875
"26379","80014","2018",1,1,0,35000,583,60
"26380","80016","2018",133,119,14,109001.2,1438.91,80.2406
"26381","80017","2018",2,2,0,162000,1158,145
"26382","80018","2018",4,4,0,148375,1398.75,109.75
"26383","80019","2018",7,7,0,130050,1127.286,107
"26384","80020","2018",5,5,0,273076,2430.6,114.2
"26385","80021","2018",1664,987,677,153183.9,2108.916,74.48678
"26386","80022","2018",2,2,0,144000,655,220
"26387","80023","2018",4,4,0,138750,1098,139.5
"26388","80024","2018",5,5,0,185342,1809.6,104.6
"26389","80025","2018",7,7,0,123571.4,1491.571,86
"26390","80029","2018",3,3,0,40133.33,752.6667,55.33333
"26391","80030","2018",3,3,0,115666.7,1134,110.3333
"26392","80031","2018",7,7,0,110878.6,1358.286,83.42857
"26393","80032","2018",2,2,0,90000,926,96
"26394","80034","2018",7,7,0,71142.86,800.5714,89.14286
"26395","80036","2018",7,7,0,122850,1633.571,73.42857
"26396","80037","2018",2,2,0,90000,1010,87
"26397","80038","2018",2,2,0,197500,1044,190
"26398","80039","2018",66,34,32,78823.26,1437.455,56.83333
"26399","80040","2018",3,3,0,60333.33,616.3333,113.3333
"26400","80041","2018",2,2,0,95750,1741,59
"26401","80042","2018",1,1,0,65000,1140,57
"26402","80043","2018",2,2,0,138125,996,130
"26403","80044","2018",5,5,0,165740,2063.2,81
"26404","80045","2018",2,2,0,49750,832,59.5
"26405","80047","2018",2,2,0,114500,799.5,149.5
"26406","80048","2018",2,2,0,64500,858.5,78
"26407","80049","2018",2,2,0,107000,1471,74
"26408","80050","2018",6,6,0,211333.3,1759.333,109.5
"26409","80051","2018",4,4,0,117875,1164,100
"26410","80052","2018",3,3,0,107886.7,1044,102
"26411","80053","2018",1,1,0,85000,1328,64
"26412","80054","2018",1,1,0,103950,1961,53
"26413","80055","2018",2,2,0,59446.5,1586,61.5
"26414","80058","2018",3,3,0,175216.7,1446.667,116.3333
"26415","80059","2018",1,1,0,1e+05,1333,75
"26416","80060","2018",3,3,0,126000,1180,113.6667
"26417","80061","2018",1,1,0,135000,1227,110
"26418","80062","2018",11,11,0,79104.55,829.4545,95
"26419","80063","2018",11,11,0,109409.1,1162.091,93.36364
"26420","80064","2018",3,3,0,141000,918.6667,143.3333
"26421","80065","2018",2,2,0,126000,1038.5,123.5
"26422","80067","2018",1,1,0,183000,2080,88
"26423","80068","2018",1,1,0,190000,905,210
"26424","80069","2018",1,1,0,1e+05,1250,80
"26425","80070","2018",16,16,0,111096.9,1109.5,99.8125
"26426","80071","2018",23,23,0,96576.09,1190.826,89.26087
"26427","80073","2018",1,1,0,267750,1093,245
"26428","80076","2018",6,6,0,150383.3,1741.5,95
"26429","80078","2018",5,5,0,187200,1733.8,110.8
"26430","80079","2018",8,8,0,111312.5,1167.125,95.875
"26431","80080","2018",1,1,0,45000,882,51
"26432","80081","2018",2,2,0,223500,3418,104.5
"26433","80082","2018",14,14,0,184170.7,1817.429,113.7857
"26434","80083","2018",2,2,0,1e+05,1183.5,81.5
"26435","80084","2018",5,5,0,116200,1497.4,89.6
"26436","80085","2018",1,1,0,95000,969,98
"26437","80086","2018",8,7,1,110732.5,925.125,120.5
"26438","80087","2018",4,4,0,141250,1802.75,78.5
"26439","80088","2018",5,5,0,124500,1149.4,105
"26440","80089","2018",1,1,0,185000,1370,135
"26441","80092","2018",5,5,0,190840,2082,92.6
"26442","80093","2018",17,17,0,117230,1233.471,96.76471
"26443","80094","2018",1,1,0,215000,1991,108
"26444","80095","2018",4,4,0,132625,1410.75,99.25
"26445","80096","2018",9,9,0,111144.4,1247.667,97.77778
"26446","80097","2018",6,6,0,95095.83,1354.333,74.33333
"26447","80098","2018",2,2,0,108000,1375.5,78.5
"26448","80099","2018",1,1,0,85000,825,103
"26449","80100","2018",11,11,0,125272.7,1443.455,89.36364
"26450","80101","2018",8,8,0,105718.8,1229.25,84.875
"26451","80102","2018",6,6,0,97625,1248.667,79.66667
"26452","80104","2018",1,1,0,140000,972,144
"26453","80105","2018",1,1,0,29000,604,48
"26454","80106","2018",1,1,0,203000,1845,110
"26455","80107","2018",3,3,0,170894.3,1759.667,90.66667
"26456","80109","2018",4,4,0,103375,1011.25,104.25
"26457","80110","2018",2,2,0,194125,2079.5,94
"26458","80112","2018",2,2,0,213000,2076.5,102
"26459","80113","2018",1,1,0,129000,3071,42
"26460","80114","2018",8,8,0,165400,1483,116.75
"26461","80115","2018",3,3,0,110307,953,112.6667
"26462","80116","2018",5,5,0,134300,1166,116.8
"26463","80117","2018",1,1,0,140000,1867,75
"26464","80118","2018",2,2,0,90000,1000.5,92.5
"26465","80119","2018",6,6,0,125016.7,1233.333,101
"26466","80120","2018",6,6,0,130516.7,1115.5,116
"26467","80121","2018",3,3,0,152333.3,1478.667,105
"26468","80122","2018",6,6,0,75583.33,820.8333,94.83333
"26469","80123","2018",4,4,0,122500,1510.75,77.75
"26470","80124","2018",6,6,0,148008.3,1357.167,114.1667
"26471","80126","2018",7,7,0,117926.9,1496.857,77.28571
"26472","80127","2018",7,7,0,158488.6,1451.143,107.1429
"26473","80128","2018",1,1,0,93740,1008,93
"26474","80129","2018",3,3,0,168800,1272.333,124.3333
"26475","80130","2018",5,5,0,221093,1791.6,127.4
"26476","80131","2018",31,31,0,190089.5,1908.742,102
"26477","80132","2018",4,4,0,187675,1734.5,126
"26478","80133","2018",1,1,0,130000,798,163
"26479","80134","2018",1,1,0,75000,1500,50
"26480","80135","2018",1,1,0,90000,918,98
"26481","80136","2018",13,13,0,94363.38,1136.231,81.84615
"26482","80137","2018",8,8,0,130700,1463.125,88.875
"26483","80138","2018",4,3,1,156250,1288,121.25
"26484","80139","2018",1,1,0,165000,1320,125
"26485","80140","2018",1,1,0,127000,1000,127
"26486","80141","2018",3,3,0,99166.67,1079.667,103
"26487","80142","2018",5,5,0,139050,1637.4,94.8
"26488","80144","2018",6,6,0,87666.67,1009.333,84
"26489","80145","2018",1,1,0,153000,1330,115
"26490","80146","2018",1,1,0,42500,483,88
"26491","80147","2018",3,3,0,212166.7,1676.667,121.3333
"26492","80148","2018",5,5,0,128000,1465,89.4
"26493","80149","2018",4,4,0,97500,1339.25,73
"26494","80150","2018",1,1,0,110650,1106,100
"26495","80151","2018",3,3,0,87333.33,918,80.33333
"26496","80153","2018",1,1,0,90000,818,110
"26497","80154","2018",2,2,0,59550,650,93
"26498","80157","2018",3,3,0,210050,1491.667,144
"26499","80158","2018",1,1,0,86000,1000,86
"26500","80159","2018",5,5,0,203810,1640.4,124.8
"26501","80160","2018",11,11,0,244981.8,2338.091,106.3636
"26502","80161","2018",2,2,0,145000,1468.5,98.5
"26503","80162","2018",9,9,0,85666.89,1021.333,82.55556
"26504","80163","2018",13,13,0,166750.4,2593.385,83.38462
"26505","80164","2018",40,40,0,192822,1913.425,101.05
"26506","80165","2018",2,2,0,122000,976,121.5
"26507","80166","2018",8,8,0,177156.2,1670.5,109.125
"26508","80167","2018",5,5,0,152600,1298.2,117.4
"26509","80168","2018",10,10,0,113000,1185,99.8
"26510","80170","2018",3,3,0,109000,905,118
"26511","80171","2018",9,9,0,166500,1764,96.77778
"26512","80172","2018",8,8,0,121375,1209.125,96
"26513","80173","2018",5,5,0,213960,2068.4,102.2
"26514","80174","2018",1,1,0,70000,972,72
"26515","80176","2018",1,1,0,58000,866,67
"26516","80177","2018",7,7,0,124275.6,1155.857,106
"26517","80179","2018",2,2,0,140750,1362.5,102.5
"26518","80180","2018",1,1,0,115000,1307,88
"26519","80181","2018",2,2,0,126140,1089.5,115
"26520","80182","2018",91,73,18,106510.1,1773.659,65.21978
"26521","80183","2018",5,5,0,98500,1083.4,91.6
"26522","80184","2018",9,9,0,141646.7,1211.889,110.2222
"26523","80185","2018",2,2,0,177250,1464,118
"26524","80186","2018",22,22,0,92161.36,996.5909,94.18182
"26525","80187","2018",7,7,0,134147.4,1440.286,97.14286
"26526","80188","2018",7,7,0,145017.9,1484.714,95.14286
"26527","80189","2018",1,1,0,56500,543,104
"26528","80190","2018",11,11,0,92454.55,960,94.81818
"26529","80191","2018",4,4,0,109000,1362.75,82.75
"26530","80192","2018",6,6,0,101766.7,970.5,110.5
"26531","80193","2018",2,2,0,168500,1667.5,103.5
"26532","80194","2018",5,5,0,85240,1512,60.2
"26533","80195","2018",2,2,0,130296.5,1351,125
"26534","80198","2018",3,3,0,163333.3,1865.333,87.33333
"26535","80199","2018",10,10,0,105398.5,1123.2,90.6
"26536","80200","2018",1,1,0,267000,1628,164
"26537","80202","2018",5,5,0,238453,2089.6,111.2
"26538","80203","2018",2,2,0,142500,1519,93.5
"26539","80204","2018",12,12,0,108502.5,1001.083,122.75
"26540","80205","2018",11,11,0,95746.36,1440.273,81
"26541","80206","2018",2,2,0,150000,1458.5,105
"26542","80207","2018",1,1,0,720000,8000,90
"26543","80210","2018",1,1,0,160000,1404,114
"26544","80211","2018",18,18,0,164933.3,1481.778,110.6111
"26545","80212","2018",69,66,3,151851.1,1637.536,93.62319
"26546","80213","2018",5,5,0,295740,2070,150.8
"26547","80214","2018",4,4,0,74875,789.25,90.75
"26548","80215","2018",2,2,0,102500,1281,80
"26549","80216","2018",4,4,0,115606.2,1395.5,81.25
"26550","80218","2018",1,1,0,60000,800,75
"26551","80219","2018",3,3,0,152333.3,1593.333,103.6667
"26552","80220","2018",1,1,0,145000,1768,82
"26553","80221","2018",1,1,0,69800,698,100
"26554","80222","2018",15,14,1,144416.7,1188.8,128.5333
"26555","80223","2018",3,3,0,134133.3,997.3333,121.6667
"26556","80224","2018",2,2,0,137500,1252,111.5
"26557","80225","2018",1,1,0,267000,2405,111
"26558","80226","2018",7,7,0,69571.43,857.7143,80.71429
"26559","80227","2018",3,3,0,75933.33,1053.333,68
"26560","80228","2018",82,59,23,204399.8,3252.366,69.06098
"26561","80229","2018",7,2,5,94808.57,1085.714,89.28571
"26562","80230","2018",6,6,0,103458.3,1325.833,84.66667
"26563","80231","2018",1,1,0,63600,978,65
"26564","80232","2018",2,2,0,127000,1183,104
"26565","80233","2018",2,2,0,92250,984,96.5
"26566","80234","2018",8,8,0,142693.8,1757.5,83.875
"26567","80235","2018",17,16,1,121548.8,1307.824,92.64706
"26568","80236","2018",8,8,0,124825,1353.125,93.625
"26569","80237","2018",4,4,0,152425,1388.75,111.25
"26570","80238","2018",6,6,0,142091.7,1440.333,100.6667
"26571","80240","2018",14,14,0,137374.5,1013.929,124.5714
"26572","80241","2018",15,15,0,112633.3,1205.8,102.7333
"26573","80242","2018",6,5,1,129244.5,1827.5,78
"26574","80244","2018",3,3,0,140233.3,1486.333,96.33333
"26575","80245","2018",3,3,0,125833.3,1258.667,99
"26576","80246","2018",2,2,0,91250,1505,63.5
"26577","80247","2018",7,7,0,94480.57,997.8571,94.28571
"26578","80248","2018",7,7,0,109265.7,1619.429,70.71429
"26579","80249","2018",2,2,0,236000,2177.5,124.5
"26580","80250","2018",4,4,0,129000,1259,106.5
"26581","80251","2018",6,6,0,97083.33,1323.333,78.33333
"26582","80252","2018",1,1,0,90000,1154,78
"26583","80253","2018",51,46,5,104370.6,1229.667,85.80392
"26584","80256","2018",21,21,0,194938.1,1965.381,100.2857
"26585","80258","2018",2,2,0,120100,1451.5,88.5
"26586","80259","2018",1,1,0,115000,1139,101
"26587","80260","2018",8,8,0,167825,1359,128.125
"26588","80261","2018",15,14,1,396627.3,2483.4,147.3333
"26589","80262","2018",2,2,0,86250,1305,70
"26590","80263","2018",2,2,0,72500,1247,58.5
"26591","80264","2018",1,1,0,250000,1562,160
"26592","80265","2018",6,6,0,89500,1054.667,90.5
"26593","80266","2018",9,9,0,139736.7,1264.556,111.6667
"26594","80268","2018",7,7,0,105105.7,1378,78.42857
"26595","80269","2018",2,2,0,86250,1107,68.5
"26596","80271","2018",11,11,0,122627.3,975.2727,120.9091
"26597","80272","2018",1,1,0,65000,855,76
"26598","80273","2018",5,5,0,174000,1311.2,139.4
"26599","80274","2018",14,14,0,108835.7,1116.571,102
"26600","80275","2018",2,2,0,106250,966.5,127.5
"26601","80276","2018",3,3,0,144333.3,1565.667,94.33333
"26602","80279","2018",10,10,0,110965,1192.1,100.3
"26603","80280","2018",1,1,0,99900,1921,52
"26604","80281","2018",1,1,0,175000,1074,163
"26605","80282","2018",5,5,0,152500,1403.2,97.4
"26606","80284","2018",8,8,0,79562.5,952.375,80.875
"26607","80285","2018",3,3,0,275233.3,1960.667,143.3333
"26608","80288","2018",5,5,0,104080,1180.2,97
"26609","80290","2018",5,5,0,165600,1349.8,132.6
"26610","80291","2018",3,3,0,97666.67,1334.333,68.66667
"26611","80292","2018",1,1,0,104500,1112,94
"26612","80293","2018",6,6,0,153666.7,1483,107.1667
"26613","80295","2018",9,9,0,74422.22,995.2222,76.66667
"26614","80296","2018",16,16,0,86981.25,982.375,84.9375
"26615","80298","2018",10,10,0,99935.9,999.8,97.8
"26616","80299","2018",2,2,0,244000,1878,110
"26617","80300","2018",4,4,0,120470,1116.5,108.75
"26618","80301","2018",4,4,0,167000,1093.25,139
"26619","80303","2018",6,6,0,157000,1654.167,94.16667
"26620","80304","2018",1,1,0,78000,1200,65
"26621","80305","2018",8,8,0,226918.8,1882.625,126.375
"26622","80306","2018",1,1,0,40000,690,58
"26623","80307","2018",1,1,0,206500,2220,93
"26624","80308","2018",10,10,0,108500,1284.2,83.7
"26625","80310","2018",3,3,0,107890,904.6667,117.3333
"26626","80311","2018",1,1,0,80000,741,108
"26627","80312","2018",5,5,0,117000,1089.4,108.6
"26628","80313","2018",2,2,0,113250,1040,108.5
"26629","80314","2018",4,4,0,110775,1378.5,80
"26630","80315","2018",2,2,0,70000,919.5,81
"26631","80316","2018",20,20,0,170047.5,1774.8,97.7
"26632","80317","2018",1,1,0,131700,1304,101
"26633","80318","2018",24,24,0,107184.2,1300.167,82.95833
"26634","80320","2018",1,1,0,127960,1230,104
"26635","80321","2018",5,5,0,138800,1286.2,112.2
"26636","80322","2018",1,1,0,95000,1863,51
"26637","80325","2018",1,1,0,85750,655,131
"26638","80327","2018",4,4,0,157012.5,1085.75,150.5
"26639","80328","2018",7,7,0,124000,1258.429,96.57143
"26640","80329","2018",1,1,0,163000,2264,72
"26641","80330","2018",2,2,0,57500,724.5,78.5
"26642","80331","2018",2,2,0,143500,1382.5,105
"26643","80332","2018",6,6,0,112500,1378.333,78.83333
"26644","80333","2018",123,58,65,137028.2,2866.61,50.18699
"26645","80334","2018",1,1,0,168000,1787,94
"26646","80335","2018",3,3,0,88333.33,1213,67.33333
"26647","80337","2018",2,2,0,132036,1214,137
"26648","80338","2018",19,18,1,164190,1591.263,103.5263
"26649","80339","2018",1,1,0,58000,906,64
"26650","80340","2018",2,2,0,89500,1340,76.5
"26651","80341","2018",1,1,0,250030,2066,121
"26652","80342","2018",9,9,0,144726.7,1342.667,111.5556
"26653","80343","2018",2,2,0,93500,962,97.5
"26654","80344","2018",2,2,0,117500,1272,88
"26655","80345","2018",4,4,0,98000,1205.75,79.5
"26656","80346","2018",3,3,0,116000,1220,91.66667
"26657","80347","2018",1,1,0,30000,423,71
"26658","80348","2018",2,2,0,148000,1477,102
"26659","80349","2018",2,2,0,242225,1507,162
"26660","80350","2018",5,5,0,156960,1361.2,115
"26661","80352","2018",1,1,0,174000,2260,77
"26662","80354","2018",1,1,0,58000,967,60
"26663","80358","2018",1,1,0,192000,2560,75
"26664","80359","2018",2,2,0,65000,1050,65.5
"26665","80360","2018",17,17,0,113524.1,1349,87.88235
"26666","80361","2018",1,1,0,55000,833,66
"26667","80362","2018",6,6,0,97928.5,955.1667,105.6667
"26668","80364","2018",7,7,0,115568.9,1487.143,78.85714
"26669","80365","2018",2,2,0,201750,1432.5,146.5
"26670","80366","2018",3,3,0,150000,1194.667,131.3333
"26671","80367","2018",2,2,0,55500,972,58.5
"26672","80368","2018",40,34,6,104058.8,1185.2,87.225
"26673","80369","2018",1,1,0,40000,625,64
"26674","80371","2018",2,2,0,153750,1859,90
"26675","80372","2018",1,1,0,144500,1086,133
"26676","80373","2018",33,33,0,72641.52,964.8182,76.24242
"26677","80375","2018",4,4,0,115000,1359.25,85.25
"26678","80376","2018",7,7,0,225471.4,2307,101.1429
"26679","80377","2018",2,2,0,97500,1066.5,93
"26680","80379","2018",6,6,0,228766.7,1920.833,118.8333
"26681","80380","2018",2,2,0,135000,931.5,145.5
"26682","80383","2018",3,3,0,130000,881,147.3333
"26683","80384","2018",1,1,0,63000,829,76
"26684","80385","2018",7,7,0,184240.1,1638.857,111
"26685","80386","2018",2,2,0,140000,1122,127.5
"26686","80387","2018",4,4,0,176300,2072.5,96.75
"26687","80388","2018",3,3,0,194033.3,1278.333,151.6667
"26688","80390","2018",4,4,0,170000,1328.75,126.5
"26689","80391","2018",1,1,0,174700,1519,115
"26690","80392","2018",4,4,0,88847.5,741.25,124.5
"26691","80393","2018",3,3,0,108000,1089,96
"26692","80395","2018",8,8,0,88437.5,1100.125,80.375
"26693","80396","2018",3,3,0,99666.67,1154.667,75
"26694","80397","2018",1,1,0,99000,1338,74
"26695","80399","2018",6,6,0,200249.2,2182,106.5
"26696","80400","2018",4,4,0,127360,1572.25,101.25
"26697","80401","2018",2,2,0,172900,1365.5,127.5
"26698","80403","2018",3,3,0,188500,1711.333,134.6667
"26699","80404","2018",2,2,0,72500,922.5,73
"26700","80405","2018",6,6,0,155341.7,1716.833,95
"26701","80406","2018",14,14,0,99678.57,1064.643,92.42857
"26702","80407","2018",3,3,0,92000,4092.667,71
"26703","80408","2018",1,1,0,60000,522,115
"26704","80410","2018",46,42,4,86114.13,1134.217,83.23913
"26705","80411","2018",5,5,0,164400,1743.8,92.2
"26706","80412","2018",4,4,0,164462.5,1526.25,97
"26707","80414","2018",1,1,0,95000,1583,60
"26708","80415","2018",19,18,1,129078.9,1400.053,95.52632
"26709","80416","2018",7,7,0,144085.7,1528.143,94.14286
"26710","80417","2018",18,18,0,112473.7,1203.778,95.88889
"26711","80418","2018",2,2,0,67500,730.5,90
"26712","80421","2018",5,5,0,133600,1147.4,115
"26713","80422","2018",4,4,0,188380,1380,136.75
"26714","80423","2018",1,1,0,112000,896,125
"26715","80424","2018",5,5,0,225640,2079,108.6
"26716","80426","2018",7,7,0,168585.7,1737.571,100.1429
"26717","80427","2018",2,2,0,190825,1513,128.5
"26718","80428","2018",1,1,0,119000,1322,90
"26719","80429","2018",2,2,0,104650,1432.5,73
"26720","80430","2018",2,2,0,51625,751,70
"26721","80431","2018",2,2,0,193350,2357.5,81.5
"26722","80432","2018",3,3,0,156666.7,791.3333,192
"26723","80434","2018",1,1,0,132800,1071,124
"26724","80435","2018",1,1,0,69000,1015,68
"26725","80436","2018",11,11,0,105422.7,1274.273,84.81818
"26726","80437","2018",1,1,0,84900,858,99
"26727","80438","2018",7,7,0,68800,787.1429,89.85714
"26728","80439","2018",2,2,0,121500,833.5,142.5
"26729","80440","2018",3,3,0,92666.67,931,97.66667
"26730","80442","2018",13,13,0,101007.7,1021.308,99.53846
"26731","80443","2018",14,14,0,117607.1,1026.929,113.4286
"26732","80444","2018",6,6,0,112533.3,1356.333,84
"26733","80445","2018",4,4,0,121250,964,137.5
"26734","80446","2018",4,4,0,204575,1253.5,151
"26735","80449","2018",2,2,0,82500,1068,82.5
"26736","80450","2018",2,2,0,147000,1356.5,110
"26737","80452","2018",6,6,0,166333.3,1541.833,107.6667
"26738","80453","2018",1,1,0,150000,1351,111
"26739","80455","2018",2,2,0,76000,1019.5,73
"26740","80456","2018",4,4,0,85000,797.75,110.25
"26741","80458","2018",5,5,0,196686,1847.4,104.6
"26742","80459","2018",1,1,0,165910,1266,131
"26743","80461","2018",2,2,0,148050,1320.5,100
"26744","80463","2018",15,15,0,140875.4,1530.467,94.06667
"26745","80464","2018",12,12,0,104437.5,1427.417,76.25
"26746","80465","2018",3,3,0,105633.3,950.6667,114
"26747","80466","2018",2,2,0,111500,1002,141
"26748","80467","2018",1,1,0,55000,604,91
"26749","80468","2018",2,2,0,163000,1342,118.5
"26750","80469","2018",2,2,0,92500,819,105
"26751","80472","2018",1,1,0,45000,662,68
"26752","80473","2018",5,5,0,80600,946.6,83.4
"26753","80474","2018",6,6,0,97016.67,1023.333,94.33333
"26754","80475","2018",3,3,0,111000,1082,113.6667
"26755","80477","2018",1,1,0,114000,2000,57
"26756","80478","2018",1,1,0,97000,584,166
"26757","80479","2018",4,4,0,167875,1859,99.75
"26758","80481","2018",5,5,0,59703,948.2,68
"26759","80482","2018",2,2,0,121750,1499,82.5
"26760","80484","2018",3,3,0,97666.67,1116,86.33333
"26761","80485","2018",10,10,0,198943.5,1702.5,117.8
"26762","80486","2018",8,8,0,109250,1335.25,83.125
"26763","80487","2018",4,4,0,120825,770.75,163.5
"26764","80488","2018",14,14,0,109736.6,1669.929,73.07143
"26765","80489","2018",39,35,4,179743,2090.564,88.38462
"26766","80491","2018",1,1,0,43000,614,70
"26767","80493","2018",3,3,0,133433.3,1404.667,99.33333
"26768","80494","2018",1,1,0,85000,1371,62
"26769","80495","2018",6,6,0,126933.3,980.6667,127.1667
"26770","80496","2018",1,1,0,80000,1111,72
"26771","80497","2018",2,2,0,179000,2101,83
"26772","80498","2018",4,4,0,142350,1155.5,119.25
"26773","80500","2018",6,6,0,116166.7,1046.333,108.8333
"26774","80501","2018",4,4,0,93175,853,108.75
"26775","80503","2018",2,2,0,1e+05,798.5,126
"26776","80504","2018",1,1,0,85000,1466,58
"26777","80505","2018",3,3,0,122733.3,1100.333,131.3333
"26778","80507","2018",17,16,1,141132.6,1617.647,88.52941
"26779","80509","2018",7,7,0,115007.1,869.8571,126.7143
"26780","80511","2018",2,2,0,173200,1333.5,137.5
"26781","80512","2018",13,13,0,123548.5,1558.846,90.61538
"26782","80513","2018",1,1,0,138000,1062,130
"26783","80514","2018",1,1,0,50000,641,78
"26784","80515","2018",1,1,0,80000,1000,80
"26785","80516","2018",4,4,0,47000,600,83
"26786","80517","2018",2,2,0,110000,1287,82.5
"26787","80518","2018",5,5,0,114460,1272.8,88.4
"26788","80519","2018",1,1,0,125000,1374,91
"26789","80520","2018",1,1,0,38000,950,40
"26790","80522","2018",2,2,0,85000,1110,102.5
"26791","80523","2018",11,11,0,186759.1,1546.091,125
"26792","80524","2018",3,3,0,98894.67,1175,80.33333
"26793","80525","2018",3,3,0,99000,2230.667,46.66667
"26794","80526","2018",1,1,0,217150,1206,180
"26795","80530","2018",3,3,0,167000,1434,117
"26796","80531","2018",1,1,0,42500,452,94
"26797","80533","2018",95,54,41,103663.5,1692.632,63.48421
"26798","80535","2018",2,2,0,185500,1532.5,124
"26799","80536","2018",3,3,0,135333.3,1382,94.33333
"26800","80538","2018",1,1,0,94000,817,115
"26801","80540","2018",2,2,0,84750,1000.5,88.5
"26802","80541","2018",1,1,0,110000,1746,63
"26803","80542","2018",3,3,0,86333.33,1147.333,74.33333
"26804","80544","2018",4,4,0,82250,1375,60.75
"26805","80545","2018",9,9,0,170238.9,1408.889,119
"26806","80546","2018",10,10,0,143907.5,1499.1,98.1
"26807","80547","2018",1,1,0,240000,2330,103
"26808","80548","2018",1,1,0,140000,1628,86
"26809","80549","2018",8,8,0,93312.5,1126.5,83.125
"26810","80552","2018",16,16,0,81269.12,951.25,89.75
"26811","80554","2018",11,11,0,162590.9,1524.818,109.7273
"26812","80555","2018",10,10,0,71994,672.7,108.9
"26813","80556","2018",9,9,0,123000,1341.667,92.11111
"26814","80557","2018",2,2,0,118000,1560,71
"26815","80558","2018",2,2,0,173200,1503,122
"26816","80559","2018",5,5,0,112180,1219.6,96.2
"26817","80560","2018",4,4,0,133725,1263,99.75
"26818","80561","2018",55,54,1,121329.1,1362.927,89.87273
"26819","80562","2018",1,1,0,310000,1732,179
"26820","80563","2018",1,1,0,170000,1574,108
"26821","80566","2018",5,5,0,132900,1631.8,87.4
"26822","80568","2018",2,2,0,108500,1048.5,105.5
"26823","80570","2018",38,37,1,124883.7,1541.632,85.07895
"26824","80571","2018",3,3,0,179166.7,1823.333,100.3333
"26825","80572","2018",4,4,0,133125,1501.5,88.5
"26826","80573","2018",5,5,0,94300,928.4,94.4
"26827","80574","2018",1,1,0,80000,860,93
"26828","80576","2018",4,4,0,71250,849.25,81.25
"26829","80577","2018",2,2,0,75000,651,104
"26830","80578","2018",6,6,0,148200,1459.833,101.8333
"26831","80579","2018",2,2,0,101500,710,130.5
"26832","80580","2018",3,3,0,94333.33,1456,69
"26833","80582","2018",14,14,0,160007.1,1755.214,94.78571
"26834","80583","2018",1,1,0,174000,2900,60
"26835","80584","2018",12,12,0,156399,1456.917,110.8333
"26836","80585","2018",21,21,0,109073.3,1061.238,99
"26837","80586","2018",3,3,0,117768.3,1393,83
"26838","80588","2018",7,7,0,110678.6,1375.714,83.14286
"26839","80590","2018",4,4,0,131325,1559.5,84.75
"26840","80591","2018",1,1,0,95000,931,102
"26841","80592","2018",3,3,0,111000,1188,90.66667
"26842","80593","2018",3,3,0,96400,1241.333,75.66667
"26843","80595","2018",3,3,0,80533.33,946.6667,85.33333
"26844","80596","2018",2,2,0,135000,1041.5,143
"26845","80597","2018",1,1,0,156750,1451,108
"26846","80598","2018",8,8,0,142331.2,1517.5,90.125
"26847","80599","2018",2,2,0,195000,1325,222
"26848","80601","2018",3,3,0,172433.3,1175.333,143.6667
"26849","80602","2018",1,1,0,85000,780,109
"26850","80603","2018",2,2,0,115000,1126,102
"26851","80604","2018",1,1,0,210000,2019,104
"26852","80606","2018",7,7,0,89000,996.8571,85.85714
"26853","80607","2018",2,2,0,177300,1816.5,98
"26854","80609","2018",3,3,0,121460,1178,104
"26855","80611","2018",8,8,0,115852.5,1320.75,90.375
"26856","80613","2018",2,2,0,130360,1708,76.5
"26857","80614","2018",3,3,0,83333.33,875.6667,88
"26858","80615","2018",2,2,0,149000,1037.5,143.5
"26859","80616","2018",5,5,0,144702,1364.2,114.4
"26860","80617","2018",2,2,0,120500,1037,129
"26861","80618","2018",17,17,0,135235.7,1431.059,96.05882
"26862","80619","2018",7,7,0,143443.6,1421.857,102.2857
"26863","80620","2018",81,78,3,99728.07,1165.704,85.17284
"26864","80621","2018",4,4,0,141875,1312.5,110
"26865","80622","2018",19,19,0,103030,1214.579,87.10526
"26866","80623","2018",1,1,0,162000,1117,145
"26867","80624","2018",1,1,0,65000,1275,51
"26868","80625","2018",27,27,0,136533,1561.556,94.22222
"26869","80626","2018",3,3,0,129983.3,1758.333,75.33333
"26870","80627","2018",7,6,1,163244.3,1603.857,97
"26871","80628","2018",7,7,0,172571.4,1564,120.2857
"26872","80629","2018",1,1,0,72500,780,93
"26873","80630","2018",11,10,1,99195.45,1155.727,88.63636
"26874","80631","2018",4,4,0,102836,1252.75,88.25
"26875","80632","2018",26,24,2,216379,2234.115,93.84615
"26876","80633","2018",7,7,0,221085.7,2111.143,96
"26877","80634","2018",6,6,0,170675,1783.333,101.6667
"26878","80635","2018",18,18,0,93194.44,1065.889,90.44444
"26879","80637","2018",2,2,0,139500,1681,81.5
"26880","80638","2018",1,1,0,73000,664,110
"26881","80639","2018",10,10,0,178050,1851.7,97.7
"26882","80640","2018",3,3,0,206866.7,1202.667,170.6667
"26883","80642","2018",7,7,0,99571.43,1051.714,97.71429
"26884","80643","2018",6,6,0,223216.7,2385.667,93.16667
"26885","80644","2018",9,9,0,98197.78,997.7778,91.33333
"26886","80645","2018",5,5,0,118400,1066.6,111
"26887","80647","2018",4,4,0,122500,1210.75,103.75
"26888","80648","2018",1,1,0,85000,1133,75
"26889","80649","2018",71,51,20,157304.1,2505.606,71.49296
"26890","80650","2018",10,10,0,196035,1597.9,126.6
"26891","80651","2018",2,2,0,85500,945,94
"26892","80652","2018",11,11,0,128414.5,1308.182,97.63636
"26893","80654","2018",3,3,0,104666.7,1477.333,69
"26894","80655","2018",4,4,0,109250,1071.5,103
"26895","80656","2018",10,9,1,148506.6,1604.5,88.2
"26896","80657","2018",6,6,0,145333.3,1503.167,95.33333
"26897","80658","2018",2,2,0,96250,950.5,99.5
"26898","80659","2018",1,1,0,90000,581,155
"26899","80661","2018",7,7,0,224822.9,1728.714,146.1429
"26900","80662","2018",2,2,0,135000,1381,97.5
"26901","80663","2018",4,4,0,100225,1162,80.5
"26902","80664","2018",1,1,0,80000,976,82
"26903","80665","2018",4,4,0,82250,922.75,89.75
"26904","80667","2018",2,2,0,174000,1576.5,109
"26905","80668","2018",1,1,0,1e+05,4000,25
"26906","80669","2018",3,3,0,112000,1571.333,68.66667
"26907","80670","2018",4,4,0,121685,1370.75,88.25
"26908","80671","2018",3,3,0,191666.7,1239.333,152.3333
"26909","80672","2018",7,7,0,170185.7,1443.143,126
"26910","80673","2018",2,2,0,90000,708.5,132
"26911","80674","2018",49,42,7,155863.7,2075.204,75.2449
"26912","80675","2018",3,3,0,159833.3,1466.667,111
"26913","80676","2018",4,4,0,140750,1156,141.25
"26914","80677","2018",12,12,0,68395.83,958.0833,74.5
"26915","80678","2018",5,5,0,117480,1578.2,76.4
"26916","80679","2018",5,5,0,82416,871,97.8
"26917","80680","2018",27,27,0,111486.4,1293.63,90.14815
"26918","80681","2018",4,4,0,152500,1443.5,110
"26919","80682","2018",5,5,0,102920,1366.4,78
"26920","80684","2018",1,1,0,155000,1824,85
"26921","80685","2018",48,46,2,100505.2,1251.583,83.89583
"26922","80686","2018",6,6,0,172918.3,1756.333,99.83333
"26923","80688","2018",34,34,0,137705.9,1583.824,88.88235
"26924","80690","2018",5,5,0,207240,2048.8,99.2
"26925","80691","2018",3,3,0,74666.67,1016.333,69
"26926","80692","2018",8,8,0,100537.5,1280.5,80.625
"26927","80693","2018",3,3,0,158666.7,1397.667,111
"26928","80694","2018",3,3,0,139300,1434.333,93
"26929","80696","2018",14,14,0,237702.4,2061.571,116
"26930","80697","2018",1,1,0,67000,1015,66
"26931","80698","2018",1,1,0,85000,500,170
"26932","80699","2018",1,1,0,129500,2312,56
"26933","80700","2018",3,3,0,132283.3,1078.333,102.6667
"26934","80701","2018",4,4,0,116156.2,1412.5,82.25
"26935","80702","2018",13,13,0,354284.6,2483.385,142.6923
"26936","80703","2018",1,1,0,73000,912,80
"26937","80705","2018",1,1,0,160000,1111,144
"26938","80706","2018",17,17,0,97029.41,1182.059,84.64706
"26939","80707","2018",1,1,0,149000,2483,60
"26940","80709","2018",1,1,0,110000,957,115
"26941","80710","2018",5,5,0,93342.4,1265.8,75.8
"26942","80711","2018",15,15,0,70100,850.4,82.6
"26943","80713","2018",4,4,0,280125,2791,106
"26944","80714","2018",10,10,0,122445.1,1312.9,101.3
"26945","80716","2018",5,5,0,139960,1468,98.8
"26946","80717","2018",13,12,1,159684.6,1783,112
"26947","80718","2018",13,13,0,172615.4,1721.154,101.8462
"26948","80721","2018",57,47,10,172557,2700.912,72.52632
"26949","80722","2018",7,7,0,186734.1,1882.857,102.8571
"26950","80723","2018",1,1,0,125000,1389,90
"26951","80724","2018",26,24,2,198341.9,2040.231,99.11538
"26952","80725","2018",36,32,4,215405.4,2106.306,100.3889
"26953","80726","2018",4,4,0,123750,1436.25,84.75
"26954","80730","2018",9,9,0,214172.2,1801.889,114.4444
"26955","80732","2018",8,8,0,92500,1055,88.75
"26956","80733","2018",2,2,0,118000,1440,82.5
"26957","80734","2018",3,3,0,90000,1180.333,75.66667
"26958","80735","2018",1,1,0,164000,1673,98
"26959","80736","2018",3,3,0,96833.33,1262,76.66667
"26960","80737","2018",2,2,0,76000,915.5,85.5
"26961","80738","2018",1,1,0,180000,1395,129
"26962","80740","2018",1,1,0,175000,1902,92
"26963","80741","2018",2,2,0,127500,920.5,138.5
"26964","80743","2018",3,3,0,188683.3,1284.333,152.3333
"26965","80744","2018",1,1,0,75000,781,96
"26966","80746","2018",15,15,0,172755,1625,106.8667
"26967","80747","2018",1,1,0,30000,714,42
"26968","80748","2018",6,6,0,194000,1128.5,163
"26969","80749","2018",3,3,0,137666.7,1093,127
"26970","80751","2018",3,3,0,200700,1272.333,151.6667
"26971","80752","2018",6,6,0,238550,2230.333,114.6667
"26972","80754","2018",6,6,0,144616.7,1606.5,95.33333
"26973","80755","2018",2,2,0,94000,1196.5,75
"26974","80757","2018",3,3,0,78500,1181,68.33333
"26975","80758","2018",4,4,0,107750,1113.25,103.25
"26976","80759","2018",7,7,0,120284.3,1354.571,91.14286
"26977","80760","2018",5,5,0,108700,1279.4,83.2
"26978","80762","2018",3,3,0,106771,869,126.6667
"26979","80763","2018",4,4,0,151625,1467,109.75
"26980","80764","2018",3,3,0,75333.33,1552,62
"26981","80765","2018",8,8,0,131963.8,1276.875,106.125
"26982","80766","2018",5,5,0,88300,1126.8,82.4
"26983","80767","2018",4,4,0,130950,1264,118.25
"26984","80769","2018",4,4,0,193650,1465.25,133.75
"26985","80770","2018",3,3,0,59933.33,938,64
"26986","80771","2018",1,1,0,135000,860,157
"26987","80773","2018",1,1,0,134500,1416,95
"26988","80774","2018",3,3,0,163916.7,1554.667,104.3333
"26989","80775","2018",2,2,0,87250,1304,65.5
"26990","80776","2018",4,4,0,151500,1613.75,100.5
"26991","80777","2018",1,1,0,75000,652,115
"26992","80778","2018",1,1,0,96500,1072,90
"26993","80779","2018",7,7,0,98414.29,1212.429,82.71429
"26994","80780","2018",4,4,0,130250,1457.25,91
"26995","80781","2018",2,2,0,83400,829,96.5
"26996","80782","2018",8,8,0,172850,1777.25,114.25
"26997","80784","2018",2,2,0,140000,2040,67.5
"26998","80785","2018",6,6,0,174141.7,1878,94.83333
"26999","80786","2018",2,2,0,190850,1843,104.5
"27000","80787","2018",1,1,0,80000,1231,65
"27001","80788","2018",3,3,0,79127.33,1093.667,92.33333
"27002","80789","2018",1,1,0,130000,1150,113
"27003","80790","2018",4,4,0,112250,1028,139.25
"27004","80791","2018",4,4,0,241375,2005.5,114
"27005","80792","2018",4,4,0,171250,1655,115
"27006","80793","2018",24,24,0,157890,1674.625,101.75
"27007","80795","2018",3,3,0,122250,1123,114
"27008","80796","2018",1,1,0,48000,738,65
"27009","80798","2018",12,12,0,196500.8,1671.583,119.3333
"27010","80799","2018",43,42,1,177855.2,1795.209,100.9535
"27011","80800","2018",3,3,0,67333.33,1193.333,55.33333
"27012","80801","2018",5,5,0,200420,1787.6,101.8
"27013","80802","2018",2,2,0,41000,584.5,73.5
"27014","80803","2018",3,3,0,103500,1212,87
"27015","80804","2018",3,3,0,107500,712,149.6667
"27016","80805","2018",3,3,0,232666.7,1341,180.6667
"27017","80806","2018",6,6,0,165922.2,1744.167,110
"27018","80807","2018",4,4,0,107425,1231.25,84.5
"27019","80808","2018",2,2,0,89000,1296.5,73.5
"27020","80809","2018",4,4,0,135324.8,1178,109
"27021","80810","2018",1,1,0,87000,1115,78
"27022","80811","2018",8,8,0,97375,939.5,101.625
"27023","80812","2018",1,1,0,77000,1453,53
"27024","80814","2018",7,7,0,144392.9,1392.429,107.4286
"27025","80815","2018",11,11,0,101863.6,1286.545,80.27273
"27026","80819","2018",2,2,0,186950,1270,137
"27027","80820","2018",6,6,0,122758.3,1235.333,100
"27028","80821","2018",3,3,0,85750,1227,69
"27029","80822","2018",2,2,0,79000,1184.5,70
"27030","80823","2018",1,1,0,89500,1467,61
"27031","80824","2018",5,5,0,161880,1932,87
"27032","80825","2018",1,1,0,94500,1350,70
"27033","80826","2018",16,11,5,125033.8,1695.438,86.75
"27034","80827","2018",9,9,0,128408.9,1662.222,76.11111
"27035","80828","2018",1,1,0,171000,1357,126
"27036","80830","2018",1,1,0,212000,2718,78
"27037","80832","2018",2,2,0,115000,1301,88.5
"27038","80833","2018",1,1,0,112500,1125,100
"27039","80834","2018",8,8,0,110037.5,1284.375,91
"27040","80835","2018",2,2,0,101500,2357,61.5
"27041","80836","2018",2,2,0,242500,2087,114
"27042","81001","2018",1,1,0,175900,1832,96
"27043","81002","2018",27,26,1,120775.6,1091,115.6296
"27044","81003","2018",7,7,0,152334.3,1570.857,95.14286
"27045","81004","2018",666,360,306,148708.2,1845.083,82.68168
"27046","81005","2018",6,6,0,133171.7,1248.833,107.8333
"27047","81007","2018",2,2,0,138500,1410.5,106.5
"27048","81008","2018",4,4,0,91337.5,870.5,107.75
"27049","81009","2018",2,2,0,246000,1262.5,194.5
"27050","81010","2018",11,11,0,84673.82,976,91.81818
"27051","81011","2018",12,12,0,243464.1,1933,127.1667
"27052","81013","2018",3,3,0,107333.3,1222.333,92
"27053","81014","2018",7,7,0,94640,1246.857,96.71429
"27054","81016","2018",4,4,0,63250,559.75,121.5
"27055","81017","2018",2,2,0,42500,471,88.5
"27056","81018","2018",21,19,2,161880,1482.333,109.4762
"27057","81019","2018",3,3,0,166856.7,1822.333,97.66667
"27058","81020","2018",6,6,0,99393.33,1313.167,84.16667
"27059","81021","2018",56,52,4,103542.9,1031.661,103.9107
"27060","81022","2018",4,4,0,250387.5,1732.25,143.25
"27061","81023","2018",2,2,0,28500,572,54.5
"27062","81024","2018",3,3,0,166833.3,1615,107.6667
"27063","81025","2018",2,2,0,189000,1337.5,140
"27064","81026","2018",9,9,0,204025.4,1603.222,126.3333
"27065","81027","2018",4,4,0,208215,1645,126.5
"27066","81028","2018",2,2,0,41500,549,70.5
"27067","81029","2018",4,4,0,264908.5,1898,138.75
"27068","81030","2018",1,1,0,265000,1559,170
"27069","81031","2018",10,10,0,167152,1182.3,139
"27070","81032","2018",8,8,0,157550,1742.875,110
"27071","81033","2018",26,26,0,112451.2,1076.731,108.7692
"27072","81034","2018",3,3,0,91666.67,752.6667,96
"27073","81035","2018",3,3,0,211978.3,1799.667,120
"27074","81036","2018",11,11,0,140675.5,1317.636,105.7273
"27075","81037","2018",20,20,0,101845,1088.1,95.5
"27076","81038","2018",31,31,0,190773.7,1693.29,114.7742
"27077","81039","2018",34,34,0,129735.6,1228.882,107.5588
"27078","81040","2018",5,5,0,145059,1155.8,121
"27079","81041","2018",1,1,0,78455,835,94
"27080","81042","2018",19,19,0,164443.4,1197.579,129.6316
"27081","81043","2018",5,5,0,180205,1677.8,106.6
"27082","81044","2018",3,3,0,206000,2035.333,101.6667
"27083","81045","2018",7,7,0,156092.9,1112.286,140.7143
"27084","81046","2018",9,9,0,181003.6,1555.556,121.4444
"27085","81047","2018",2,2,0,43500,493.5,89.5
"27086","81048","2018",28,24,4,115526.8,1266.464,93.42857
"27087","81049","2018",1,1,0,86000,1132,76
"27088","81050","2018",2,2,0,107000.5,1707.5,54.5
"27089","81051","2018",7,7,0,163428.6,1562.571,104
"27090","81052","2018",17,17,0,194845.9,1782.824,108.8824
"27091","81053","2018",4,4,0,70015,1037.25,83.25
"27092","81054","2018",8,8,0,191552.1,1683.125,114.5
"27093","81055","2018",3,3,0,65000,766.3333,94.66667
"27094","81056","2018",3,3,0,260635,1780.333,152.6667
"27095","81058","2018",1,1,0,91200,800,114
"27096","81059","2018",6,6,0,290751.7,1816,149.5
"27097","81060","2018",119,109,10,105069.5,1025.798,102.2689
"27098","81061","2018",2,2,0,87250,789.5,115
"27099","81062","2018",14,14,0,77093.57,926.1429,81.28571
"27100","81063","2018",8,8,0,174253.8,1482.5,118.25
"27101","81064","2018",14,14,0,169889.8,1471,133.9286
"27102","81065","2018",599,437,162,124822.7,1377.701,91.76628
"27103","81066","2018",2,2,0,80000,943,78
"27104","81067","2018",5,5,0,133680,1118.8,117.8
"27105","81069","2018",16,14,2,121206.2,1280.938,97
"27106","81070","2018",23,23,0,176543.5,1756.348,103.9565
"27107","81071","2018",1,1,0,108000,982,110
"27108","81072","2018",2,2,0,170000,1365.5,131.5
"27109","81073","2018",2,2,0,106524.5,1798.5,62.5
"27110","81074","2018",12,12,0,182535,1682.833,112.75
"27111","81075","2018",4,4,0,207000,1809,114.25
"27112","81076","2018",4,4,0,98750,928,108.25
"27113","81077","2018",7,7,0,87035.71,740.2857,109.7143
"27114","81078","2018",15,15,0,171187.3,1403.933,128.7333
"27115","81079","2018",9,9,0,206018.4,1778.889,117.7778
"27116","81081","2018",17,17,0,98363.59,874.8235,109.2941
"27117","81082","2018",2,2,0,121500,901.5,146.5
"27118","81083","2018",8,7,1,139925,1364.375,109
"27119","81084","2018",6,5,1,102701.7,924.5,100.8333
"27120","81086","2018",4,4,0,75830,779.5,101.25
"27121","81087","2018",3,3,0,160333.3,1489.667,106.3333
"27122","81088","2018",4,4,0,168250,1329.5,140
"27123","81089","2018",1,1,0,80000,444,180
"27124","81090","2018",1,1,0,217000,1973,110
"27125","81092","2018",13,13,0,219924.2,1821.538,123
"27126","81093","2018",5,5,0,138900,1229.2,138.2
"27127","81096","2018",5,5,0,89292,1178.2,88.2
"27128","81097","2018",8,8,0,191986.2,1874,103.75
"27129","81098","2018",2,2,0,231000,1759.5,130
"27130","81099","2018",249,197,52,138104.3,1464.494,94.92369
"27131","81100","2018",1,1,0,150000,1071,140
"27132","81101","2018",12,12,0,173245.8,1368.75,126.4167
"27133","81102","2018",1,1,0,180000,3000,60
"27134","81104","2018",9,9,0,255363.1,1719.556,158.5556
"27135","81105","2018",156,139,17,108872.2,1151.019,94.99359
"27136","81106","2018",5,5,0,214874,1597.8,138.6
"27137","81108","2018",5,5,0,146264.6,1794.2,85
"27138","81109","2018",2,2,0,80000,407,195.5
"27139","81110","2018",5,5,0,88147.2,992.8,100.8
"27140","81112","2018",13,13,0,196107.7,1672.385,129.1538
"27141","81114","2018",7,7,0,220300,1703.286,130.4286
"27142","81115","2018",20,19,1,67112.5,1021.75,82
"27143","81116","2018",23,23,0,212295.8,1789.739,118.5217
"27144","81117","2018",6,6,0,234016.7,1762.833,127.3333
"27145","81119","2018",5,5,0,107970,1192.6,84.2
"27146","81120","2018",59,57,2,134799,1321.966,100.9153
"27147","81121","2018",5,5,0,62800,1479.2,53
"27148","81123","2018",1,1,0,145000,1526,95
"27149","81124","2018",24,23,1,84491.42,997.5833,85.70833
"27150","81125","2018",5,5,0,55090,698.6,74.8
"27151","81126","2018",1,1,0,145000,1510,96
"27152","81128","2018",10,10,0,117690,977.7,116.1
"27153","81130","2018",16,13,3,116009.4,1427.625,79.4375
"27154","81131","2018",19,19,0,177852.2,1770.737,102.6316
"27155","81132","2018",10,10,0,156165.8,1316.1,123.2
"27156","81133","2018",2,2,0,249800,1509.5,163.5
"27157","81134","2018",2,2,0,67830,1419.5,59
"27158","81135","2018",2,2,0,163000,824,200
"27159","81136","2018",4,4,0,69625,771,92.5
"27160","81137","2018",2,2,0,56000,900.5,96
"27161","81138","2018",4,4,0,152850,1800.25,83.75
"27162","81139","2018",16,16,0,210292.4,1496.562,140.3125
"27163","81140","2018",143,113,30,155705.1,1721.86,90.68531
"27164","81141","2018",2,2,0,155000,1081.5,146
"27165","81142","2018",7,7,0,189247.6,1284.857,140.2857
"27166","81143","2018",3,3,0,224000,2252,98
"27167","81144","2018",32,31,1,207085.1,1851.656,110.2188
"27168","81145","2018",53,51,2,154878.3,1580.094,101.7358
"27169","81146","2018",2,2,0,307000,3585.5,80
"27170","81147","2018",14,14,0,186131.1,1541.571,139.1429
"27171","81149","2018",5,5,0,147750,1279.4,122.6
"27172","81150","2018",9,9,0,254597.4,1785.889,153.5556
"27173","81152","2018",1,1,0,78455,853,92
"27174","81154","2018",1,1,0,109000,908,120
"27175","81156","2018",39,38,1,193642.3,1840.949,107.4359
"27176","81157","2018",2,2,0,236125,1898.5,127.5
"27177","81158","2018",1,1,0,68000,716,95
"27178","81159","2018",6,5,1,241075.3,1846.167,131.3333
"27179","81160","2018",8,8,0,95787.5,850.5,107.625
"27180","81161","2018",2,2,0,109000,542.5,163
"27181","81163","2018",133,111,22,99110.87,952.8872,106.6015
"27182","81164","2018",4,4,0,120187.5,1157.75,97.25
"27183","81165","2018",4,4,0,156724,1438.5,110.5
"27184","81166","2018",2,2,0,97500,1169,90
"27185","81167","2018",2,2,0,77500,1321.5,60.5
"27186","81168","2018",19,19,0,138239.1,1193.368,116.4737
"27187","81169","2018",1,1,0,138000,1533,90
"27188","81170","2018",20,20,0,103171.4,1269.85,99.9
"27189","81171","2018",17,17,0,119164.7,1370.882,90.29412
"27190","81174","2018",5,5,0,165600,1497,116
"27191","81175","2018",1,1,0,160000,1860,86
"27192","81176","2018",2,2,0,167500,1861.5,90
"27193","81177","2018",8,8,0,173387,1541,108.125
"27194","81178","2018",3,3,0,148283.3,1376,121.3333
"27195","81179","2018",5,5,0,152316,1667.8,107.2
"27196","81180","2018",5,5,0,78980,807.6,110.2
"27197","81182","2018",14,14,0,174392.9,1193.643,136.8571
"27198","81184","2018",1,1,0,46125,769,60
"27199","81185","2018",3,3,0,305326.7,1946.333,154.6667
"27200","81186","2018",5,5,0,136520,1012.4,138.4
"27201","81187","2018",3,3,0,206179.7,1410.667,146
"27202","81188","2018",2,2,0,102852.5,1394,68.5
"27203","81190","2018",2,2,0,149000,1426,109.5
"27204","81191","2018",5,5,0,220040,1647.6,146.4
"27205","81192","2018",11,11,0,63500,727.0909,90.27273
"27206","81193","2018",10,10,0,128405,1624.4,90.4
"27207","81195","2018",3,3,0,175166.7,1536.667,114.3333
"27208","81196","2018",9,9,0,61455.56,768.2222,83.11111
"27209","81197","2018",3,3,0,121908.3,1148.667,91.66667
"27210","81198","2018",3,3,0,214983.3,1588,140.3333
"27211","81199","2018",1,1,0,274000,1734,158
"27212","81200","2018",3,3,0,134333.3,1316.667,105.6667
"27213","81201","2018",9,9,0,149321.1,1253.889,123.5556
"27214","81202","2018",6,6,0,220505.5,1742.833,125.5
"27215","81203","2018",4,4,0,68970,756.5,105
"27216","81204","2018",26,26,0,136616.3,1337.269,96.84615
"27217","81205","2018",3,3,0,195300,1587.667,120
"27218","81206","2018",8,8,0,161056.2,2289.5,89.75
"27219","81208","2018",3,3,0,161433.3,1444,116.3333
"27220","81209","2018",18,18,0,127438.9,1037.667,122.2778
"27221","81210","2018",2,2,0,79000,1016.5,70
"27222","81211","2018",2,2,0,192750,1921.5,99
"27223","81212","2018",1,1,0,80000,640,125
"27224","81214","2018",1,1,0,160000,1240,129
"27225","81215","2018",5,5,0,213400,1656.6,134.2
"27226","81216","2018",1,1,0,172650,1798,96
"27227","81217","2018",10,9,1,169667.5,1750.3,97.6
"27228","81218","2018",39,38,1,215066.4,1880.667,116.5385
"27229","81219","2018",29,26,3,110735.6,1105.207,114.2414
"27230","81220","2018",69,62,7,201548.1,1786.638,117.1014
"27231","81222","2018",33,32,1,126437.2,1349.909,97.72727
"27232","81223","2018",1,1,0,39000,812,48
"27233","81224","2018",1,1,0,168170,1160,145
"27234","81225","2018",14,13,1,137449.6,1678.429,89.14286
"27235","81227","2018",20,20,0,141204.5,1308.4,104.75
"27236","81228","2018",5,5,0,229175,1721.8,128
"27237","81230","2018",8,8,0,141500,1107.5,135.5
"27238","81231","2018",5,5,0,109890.4,1099.2,105.8
"27239","81232","2018",6,6,0,248824,1725.833,144.1667
"27240","81233","2018",21,21,0,129642,1382.19,99.04762
"27241","81234","2018",2,2,0,167502.5,1904.5,88.5
"27242","81235","2018",7,7,0,163743.6,1551.857,104.7143
"27243","81236","2018",3,3,0,248300,1970.333,121.6667
"27244","81237","2018",2,2,0,170000,1434.5,119
"27245","81238","2018",10,10,0,95929.5,999,95.9
"27246","81239","2018",9,9,0,119411.1,1150.111,105
"27247","81240","2018",1,1,0,15000,600,25
"27248","81242","2018",1,1,0,175000,1651,106
"27249","81244","2018",26,26,0,104332.8,1138.692,89.73077
"27250","81245","2018",2,2,0,366000,1623.5,187.5
"27251","81246","2018",3,3,0,450400,1978,211.3333
"27252","81247","2018",3,3,0,139283.3,1529,86.66667
"27253","81248","2018",5,5,0,159600,1556,100.2
"27254","81249","2018",12,12,0,117900,1063.25,116.25
"27255","81250","2018",3,3,0,178333.3,1095.333,169
"27256","81251","2018",8,8,0,170059.2,1695.25,99.875
"27257","81252","2018",2,2,0,73500,756,99.5
"27258","81253","2018",9,9,0,135766.7,1120.222,114.1111
"27259","81254","2018",2,2,0,138000,669.5,190
"27260","81255","2018",8,8,0,232768.8,1778.875,130.625
"27261","81257","2018",79,62,17,138996.9,1479.911,96.96203
"27262","81258","2018",4,4,0,158750,1218.75,148
"27263","81259","2018",2,2,0,129005,619.5,194.5
"27264","81261","2018",14,14,0,267120.6,2905.071,112.5714
"27265","81262","2018",3,3,0,143438.3,1348,104.6667
"27266","81263","2018",6,6,0,95905,770.6667,107.8333
"27267","81264","2018",2,2,0,149000,978.5,146.5
"27268","81265","2018",2,2,0,85000,1131,69.5
"27269","81266","2018",11,11,0,140189.1,1435.545,98.09091
"27270","81267","2018",2,2,0,176250,1055,193.5
"27271","81268","2018",1,1,0,224076,3735,60
"27272","81269","2018",8,8,0,64830.38,805.25,77.625
"27273","81270","2018",1,1,0,204000,2400,85
"27274","81271","2018",143,121,22,182698.5,2006.587,92.37762
"27275","81272","2018",1,1,0,87500,941,93
"27276","81273","2018",26,25,1,166733.6,1500.346,111.4615
"27277","81274","2018",10,10,0,190453,1983.1,96.9
"27278","81275","2018",1,1,0,160000,1231,130
"27279","81276","2018",11,11,0,147727.3,1777.182,87.54545
"27280","81277","2018",4,4,0,304362.5,1554.75,183
"27281","81278","2018",2,2,0,115000,1119,104.5
"27282","81279","2018",1,1,0,216700,1806,120
"27283","81280","2018",6,6,0,122250,995.3333,116.3333
"27284","81281","2018",30,30,0,135467.9,1353.4,106.7667
"27285","81283","2018",7,7,0,237207.1,1818.143,123
"27286","81284","2018",18,16,2,170912.6,1901,89.5
"27287","81285","2018",3,3,0,79928.33,786,111.3333
"27288","81286","2018",10,10,0,178072.7,1327.4,142.5
"27289","81287","2018",1,1,0,158000,1699,93
"27290","81288","2018",37,30,7,139215.4,1430.892,94.67568
"27291","81289","2018",25,24,1,154109.3,1444.8,105.32
"27292","81290","2018",2,2,0,155225,2434.5,102
"27293","81291","2018",7,7,0,147892.9,1535.714,97.85714
"27294","81292","2018",9,9,0,112044.4,871,138.7778
"27295","81293","2018",7,7,0,194685.7,1620.286,130
"27296","81294","2018",4,4,0,166155,1233.75,149.5
"27297","81295","2018",3,3,0,163466.7,1497.333,103
"27298","81297","2018",14,14,0,218160.7,1849.071,119.5714
"27299","81298","2018",5,5,0,191655,1705.2,110.6
"27300","81299","2018",3,3,0,202833.3,1834,111.3333
"27301","81302","2018",1,1,0,41080,913,45
"27302","81303","2018",6,6,0,104583.3,1184,93.33333
"27303","81304","2018",5,5,0,116200,914,125.2
"27304","81305","2018",8,6,2,66287.5,630.125,105.5
"27305","81306","2018",8,8,0,112237.5,1088.625,106
"27306","81307","2018",11,11,0,129308.9,1315.091,102.3636
"27307","81308","2018",5,4,1,81384.2,861.8,111.8
"27308","81309","2018",3,3,0,83758.33,1035,80.66667
"27309","81311","2018",1,1,0,1e+05,1010,99
"27310","81312","2018",10,10,0,140358.3,1281.9,129.3
"27311","81313","2018",3,3,0,115900,1095,109.3333
"27312","81314","2018",7,7,0,46051.43,669,66.28571
"27313","81315","2018",12,12,0,128875,1200.75,106.25
"27314","81316","2018",3,3,0,150548.7,1355,112
"27315","81317","2018",8,8,0,184798.9,1744.625,114.375
"27316","81318","2018",1,1,0,40000,727,55
"27317","81319","2018",1,1,0,131000,891,147
"27318","81320","2018",3,3,0,142780.7,1248.667,116.6667
"27319","81322","2018",5,5,0,169462,1623.6,108.6
"27320","81323","2018",3,3,0,186333.3,1461.333,138
"27321","81324","2018",2,1,1,181500,1540,123
"27322","81325","2018",18,18,0,154404.9,1429.611,107.5556
"27323","81326","2018",6,6,0,227066.8,1570.833,138.8333
"27324","82001","2018",5,5,0,135700,1508.2,93
"27325","82002","2018",37,36,1,169301.9,1659.568,104.1622
"27326","82003","2018",1,1,0,168000,1750,96
"27327","82005","2018",12,11,1,164220,1758.5,95.58333
"27328","82006","2018",2,2,0,208425,1956.5,104
"27329","82008","2018",8,8,0,121487.5,1053.5,112.125
"27330","82010","2018",4,4,0,121000,1477.5,87
"27331","82011","2018",8,8,0,176687.5,1814.625,97.25
"27332","82012","2018",7,7,0,142992.9,1165.143,113
"27333","82013","2018",55,53,2,111903.7,1235.891,98.32727
"27334","82014","2018",5,5,0,195000,1377.8,146.4
"27335","82015","2018",2,2,0,120625,899,129.5
"27336","82016","2018",3,3,0,293333.3,2063.333,173.3333
"27337","82017","2018",15,15,0,173986.7,1565.133,112.2
"27338","82018","2018",13,13,0,182715.4,1565.692,121.6154
"27339","82019","2018",7,7,0,133351.4,1132.571,121.4286
"27340","82020","2018",8,8,0,161152.5,1385.25,133.125
"27341","82021","2018",3,3,0,177698.3,1088,149.3333
"27342","82022","2018",6,5,1,138906,1301.667,109.6667
"27343","82023","2018",8,8,0,120976.2,1275.625,95.625
"27344","82024","2018",4,4,0,107500,1180.5,90
"27345","82025","2018",33,30,3,173172.7,1636.242,107.4848
"27346","82026","2018",16,15,1,142306.2,1325.438,113.25
"27347","82027","2018",13,13,0,181440.8,1708.231,108.9231
"27348","82028","2018",10,10,0,216527,2110.5,102.1
"27349","82029","2018",3,3,0,88066.67,848.3333,111
"27350","82030","2018",7,7,0,116708.6,1006.857,124.4286
"27351","82031","2018",9,9,0,104111.1,915.7778,110.7778
"27352","82032","2018",8,8,0,126627,1201.625,104.375
"27353","82033","2018",152,131,21,124740.1,1268.039,100.1513
"27354","82035","2018",6,5,1,158473.3,1403.667,108.1667
"27355","82036","2018",2,2,0,190000,1600,118.5
"27356","82037","2018",101,80,21,120136.6,1392.97,85.44554
"27357","82038","2018",25,24,1,139563.5,1636.28,99.16
"27358","82039","2018",4,4,0,165337.5,1475,104.25
"27359","82040","2018",3,3,0,127575,2185.333,62
"27360","82041","2018",3,3,0,121666.7,1275.667,96.66667
"27361","82042","2018",14,14,0,160592.9,1490.071,108.0714
"27362","82043","2018",5,5,0,159100,1608.2,106.2
"27363","82044","2018",17,14,3,154960.4,1573.647,96.41176
"27364","82045","2018",7,7,0,183993,1549.429,120.8571
"27365","82047","2018",2,2,0,232000,2222.5,105
"27366","82048","2018",36,32,4,147610,1566.5,94.16667
"27367","82049","2018",8,8,0,115325,1225.25,110.75
"27368","82050","2018",10,9,1,133050,1504.2,107.9
"27369","82051","2018",8,8,0,203308.5,1588.875,132.25
"27370","82052","2018",9,9,0,168425.6,1369,132.3333
"27371","82053","2018",2,2,0,114170,1026,116.5
"27372","82054","2018",5,5,0,108400,1070.4,97.6
"27373","82055","2018",3,3,0,163166.7,885.3333,191.3333
"27374","82056","2018",1,1,0,60000,1500,40
"27375","82057","2018",5,5,0,176060,1664.4,108.2
"27376","82058","2018",2,2,0,175350,1237.5,144
"27377","82059","2018",2,2,0,91675,1345,80
"27378","82060","2018",1,1,0,2e+05,1515,132
"27379","82061","2018",2,2,0,203500,2170.5,101.5
"27380","82062","2018",29,29,0,132447.8,1386.655,99.44828
"27381","82063","2018",8,8,0,172163.8,1740.375,98.5
"27382","82065","2018",2,2,0,107500,1320,88
"27383","82066","2018",7,7,0,193322.9,1816.429,106.4286
"27384","82067","2018",4,4,0,136084,1158,126.5
"27385","82069","2018",4,4,0,243250,3200,94.5
"27386","82070","2018",2,2,0,59050,468.5,128
"27387","82072","2018",8,7,1,115112.5,1313.875,87
"27388","82073","2018",8,8,0,140720,1237.875,117.75
"27389","82074","2018",3,3,0,60500,707.3333,84
"27390","82075","2018",38,33,5,176275.7,1778.526,101.7895
"27391","82076","2018",10,10,0,155805,1478.1,108.7
"27392","82077","2018",4,4,0,235520.5,3185,76.75
"27393","82079","2018",9,9,0,179416.7,1702.778,107.7778
"27394","82080","2018",9,9,0,126207.8,1247.444,103.8889
"27395","82081","2018",3,3,0,73333.33,895.3333,77.33333
"27396","82084","2018",2,2,0,92000,968.5,96.5
"27397","82085","2018",9,9,0,156370.6,1619.444,100.4444
"27398","82087","2018",26,26,0,160534.3,1622.308,108.4615
"27399","82088","2018",13,13,0,71281.54,1120.231,74.69231
"27400","82089","2018",14,14,0,117328.6,1218.929,100.7857
"27401","82090","2018",7,6,1,137571.4,1363,100.5714
"27402","82091","2018",1,1,0,152400,1621,94
"27403","82092","2018",1,1,0,208800,1305,160
"27404","82093","2018",12,12,0,114800,1198.333,95.75
"27405","82094","2018",13,13,0,135974.6,1346.923,145
"27406","82095","2018",2,2,0,178680,1455,126
"27407","82096","2018",42,35,7,126222.6,1405.905,88.5
"27408","82097","2018",8,8,0,114937.5,1270.25,97.25
"27409","82098","2018",9,9,0,215692.2,1929.222,111.5556
"27410","82099","2018",3,3,0,184526,2169,104
"27411","82100","2018",1,1,0,157000,1744,90
"27412","82101","2018",9,9,0,138977.8,1194.444,113.8889
"27413","82102","2018",5,5,0,113760,1149.6,98.4
"27414","82103","2018",2,2,0,215000,2390,90.5
"27415","82105","2018",9,9,0,127500,1433.222,100
"27416","82106","2018",1,1,0,320000,1231,260
"27417","82107","2018",1,1,0,110700,1258,88
"27418","82108","2018",12,12,0,140525.5,1301.667,108
"27419","82109","2018",3,3,0,176666.7,1480.667,122.3333
"27420","82110","2018",8,8,0,122625,1187.875,96.875
"27421","82111","2018",2,2,0,67250,954,67.5
"27422","82112","2018",129,115,14,120506.4,1247.519,100.907
"27423","82113","2018",12,12,0,111133.3,1048.25,106.3333
"27424","82114","2018",6,6,0,199575,1691.667,116
"27425","82115","2018",26,25,1,153283.8,1346.846,110.5
"27426","82116","2018",3,3,0,161170,1662.667,126.6667
"27427","82117","2018",27,27,0,153084.4,1550.778,103.4815
"27428","82118","2018",1,1,0,140000,1400,100
"27429","82119","2018",4,4,0,178350,1678.75,107.75
"27430","82120","2018",5,5,0,148984,1283,113.8
"27431","82121","2018",903,509,394,148503.5,1653.573,88.47398
"27432","82123","2018",21,9,12,90618.57,1321.286,67.09524
"27433","82124","2018",61,43,18,148533.2,1563.426,92.78689
"27434","82125","2018",66,55,11,159821.3,1644.773,99.18182
"27435","82126","2018",11,11,0,159260.9,1504.727,106.1818
"27436","82127","2018",8,8,0,116531.2,1264.375,90.875
"27437","82129","2018",2,2,0,173000,1246,139
"27438","82130","2018",5,5,0,212170.6,1727.4,166.8
"27439","82131","2018",22,22,0,147687.6,1372.864,105.4091
"27440","82132","2018",18,17,1,120028.3,1165.944,103.1111
"27441","82133","2018",2,2,0,144500,1408.5,100.5
"27442","82134","2018",70,60,10,138427.7,1359.4,102.8571
"27443","82135","2018",11,10,1,177219.1,1771.273,104.4545
"27444","82136","2018",18,16,2,170627.9,1598.389,102.5
"27445","82137","2018",2,2,0,200276.5,1229,154.5
"27446","82138","2018",3,3,0,246000,1620,149
"27447","82139","2018",2,2,0,95675,656,140
"27448","82140","2018",2,2,0,122500,989,121
"27449","82141","2018",6,6,0,106349.2,1130.333,93.66667
"27450","82142","2018",16,16,0,204813.4,1735.5,118
"27451","82144","2018",11,11,0,183641.4,1593.909,113.0909
"27452","82145","2018",2,2,0,95000,1339.5,71.5
"27453","82146","2018",3,3,0,247833.3,1393.333,170.3333
"27454","82147","2018",4,4,0,183712.5,1240,162.5
"27455","82148","2018",9,9,0,72750.22,1041.556,72
"27456","82149","2018",26,26,0,156593.9,1716.577,93.07692
"27457","82150","2018",8,8,0,208175,1681,123.5
"27458","82151","2018",7,6,1,137499.3,1252.429,123.8571
"27459","82152","2018",3,3,0,111946.7,1058,105.6667
"27460","82153","2018",4,4,0,173068.5,1342.75,136.5
"27461","82154","2018",1,1,0,150000,2143,70
"27462","82155","2018",34,33,1,205005.7,1959.059,108.9118
"27463","82157","2018",3,3,0,109850,1124,106.3333
"27464","82158","2018",2,2,0,135050,1209.5,114.5
"27465","82159","2018",5,5,0,152670,1368.6,108.2
"27466","82160","2018",2,2,0,83000,1042.5,80
"27467","82161","2018",42,38,4,143870.7,1508.048,96.52381
"27468","82162","2018",1,1,0,109000,1362,80
"27469","82163","2018",2,2,0,80010,615.5,130
"27470","82164","2018",2,2,0,242500,2015.5,119.5
"27471","82165","2018",3,3,0,130333.3,1215.667,93.66667
"27472","82166","2018",5,4,1,110440,931.6,119
"27473","82167","2018",18,18,0,189852.8,1660.944,117.6111
"27474","82168","2018",1,1,0,16500,458,36
"27475","82169","2018",24,24,0,171417.3,1554.375,116.2917
"27476","82170","2018",3,3,0,143416.7,1903,73.33333
"27477","82171","2018",11,11,0,149854.1,1610.636,99
"27478","82172","2018",4,4,0,166696.2,1728.25,98
"27479","82173","2018",9,7,2,140938.9,1297,104.7778
"27480","82175","2018",1,1,0,1e+05,870,115
"27481","82176","2018",10,10,0,215126.1,1810.7,125.9
"27482","82177","2018",3,3,0,415773.3,2195.333,192.3333
"27483","82178","2018",5,5,0,190213,1896.2,95.4
"27484","82179","2018",36,31,5,128829.1,1345.917,98.44444
"27485","82180","2018",6,6,0,124083.3,985,121.1667
"27486","82181","2018",1,1,0,255000,773,330
"27487","82182","2018",8,8,0,181889.4,1773.875,109
"27488","82183","2018",4,4,0,249146.2,1602.25,157.5
"27489","82184","2018",8,8,0,253671.9,1627.625,146.625
"27490","82185","2018",6,6,0,114833.3,1368.167,80.16667
"27491","82186","2018",69,59,10,111412.7,1141.217,99.37681
"27492","82187","2018",11,11,0,139659.1,1200.909,116.1818
"27493","82189","2018",8,8,0,169000,1559,106.875
"27494","82190","2018",78,54,24,136270.4,1654.333,81.52564
"27495","82191","2018",4,4,0,221400,1994.25,107.5
"27496","82192","2018",4,4,0,287900,1874,145
"27497","82193","2018",3,3,0,127000,1479.333,78.33333
"27498","82194","2018",25,23,2,144729,1568,99
"27499","82195","2018",11,11,0,147625.9,1451.727,102.4545
"27500","83001","2018",26,24,2,481180.8,3988.423,121.6538
"27501","83002","2018",7,5,2,128687.9,2563.143,52.71429
"27502","83003","2018",12,11,1,190839.2,2421.333,84.41667
"27503","83004","2018",117,80,37,262433,2713.248,93.74359
"27504","83005","2018",11,11,0,140309.1,2322.818,62
"27505","83006","2018",6,6,0,264225,2350.667,120.3333
"27506","83007","2018",50,39,11,208965.8,2279.08,87.3
"27507","83008","2018",65,52,13,306290.8,3296.769,97.03077
"27508","83009","2018",376,63,313,287976,5196.569,56.41755
"27509","83010","2018",1,1,0,105000,1750,60
"27510","83011","2018",31,25,6,240896.5,2647.742,92
"27511","83012","2018",59,29,30,150596.4,1932.559,82
"27512","83013","2018",5,5,0,180000,2339.6,85.8
"27513","83014","2018",2,2,0,179000,2811,67
"27514","83015","2018",7,6,1,296428.6,3077.857,96.28571
"27515","83016","2018",153,108,45,326000.6,3746.935,88.65359
"27516","83017","2018",33,23,10,235954.4,2793.03,83.63636
"27517","83018","2018",54,51,3,217234.7,2505.13,89.42593
"27518","83019","2018",252,92,160,306944.7,4816.98,63.03968
"27519","83021","2018",35,30,5,252323.7,2481.543,102.2857
"27520","83023","2018",213,138,75,192497.1,2364.254,83.9108
"27521","83025","2018",25,17,8,212654,2343.96,90.48
"27522","83026","2018",28,25,3,188413.4,2343.143,86.42857
"27523","83027","2018",62,54,8,515602.9,4237.984,119.8871
"27524","83028","2018",32,24,8,225525.3,2318.969,102.5625
"27525","83029","2018",62,43,19,301540.2,2986.903,104.9355
"27526","83030","2018",19,19,0,225528.9,2533.158,93.73684
"27527","83031","2018",65,56,9,248658.9,2529.877,99.12308
"27528","83032","2018",58,43,15,195267.6,2062.517,93.46552
"27529","83033","2018",14,14,0,212491.8,3125.714,64.07143
"27530","83034","2018",159,59,100,403230.5,4837.654,79.55346
"27531","83035","2018",68,61,7,312426,3838.162,81.85294
"27532","83036","2018",303,80,223,317923.3,4887.528,62.9901
"27533","83037","2018",15,15,0,252545.5,2488.6,103.0667
"27534","83038","2018",13,13,0,189776.9,2313.385,83.46154
"27535","83039","2018",5,3,2,180280,2446.2,100.6
"27536","83041","2018",17,16,1,249362.4,2235.118,115.6471
"27537","83042","2018",170,75,95,240977.4,3635.065,69.55882
"27538","83043","2018",4,4,0,337605,2341.25,124.25
"27539","83044","2018",1,0,1,36000,1125,32
"27540","83045","2018",12,12,0,124637.2,2157.25,66.33333
"27541","83046","2018",49,40,9,285287.6,2794.98,96.63265
"27542","83047","2018",200,160,40,304567.8,3521.295,87.645
"27543","83048","2018",157,72,85,486280.1,6248.076,73.66242
"27544","83049","2018",182,122,60,226297.5,2761.159,83.8022
"27545","83050","2018",511,211,300,188179.4,2105.178,85.54012
"27546","83051","2018",16,16,0,222775,2470.875,102.375
"27547","83052","2018",5,5,0,130078,2266.4,64.4
"27548","83053","2018",22,17,5,275302.3,3551.182,78.45455
"27549","83054","2018",90,54,36,275527.9,3164.233,84.26667
"27550","83055","2018",120,91,29,299062.7,3292.2,95.3
"27551","83056","2018",25,23,2,215349.2,2457.92,91.72
"27552","83057","2018",58,47,11,195262.4,2088.069,95.55172
"27553","83058","2018",78,59,19,277033.4,2617.885,100.4231
"27554","83059","2018",66,46,20,237663.6,2823.288,86.9697
"27555","83060","2018",10,10,0,199370,1718.2,122.5
"27556","83061","2018",1291,286,1005,230678.8,3596.769,63.82339
"27557","83062","2018",327,112,215,246048.7,3169.498,77.61468
"27558","83063","2018",40,29,11,356094.6,3313.3,97.225
"27559","83064","2018",95,92,3,279775.6,2764.411,105.3263
"27560","83065","2018",68,44,24,608641.8,6095.971,87.88235
"27561","83066","2018",25,24,1,217946,2103.52,101.68
"27562","83067","2018",69,53,16,166289.9,1968.667,84.15942
"27563","83068","2018",235,110,125,579169,6204.438,90.53617
"27564","83069","2018",1053,265,788,235781.7,3553.415,66.38557
"27565","83070","2018",298,63,235,321211.5,5260.876,58.64094
"27566","83071","2018",270,139,131,286907.4,4387.437,68.03704
"27567","83072","2018",179,125,54,277904.2,2682.246,100.4469
"27568","83073","2018",138,90,48,182276,2360.877,77.85507
"27569","83074","2018",4,4,0,208625,2519.75,83.25
"27570","83075","2018",7,5,2,207271.4,1981.429,95.28571
"27571","83076","2018",16,14,2,191193.8,2143.5,86.3125
"27572","83077","2018",35,33,2,311873,2774.943,116.1143
"27573","83078","2018",17,17,0,206539.1,2159.765,92.29412
"27574","83079","2018",21,10,11,251345.2,3385.048,78.61905
"27575","83080","2018",17,15,2,320980.1,2569.941,123.8824
"27576","83081","2018",99,75,24,370857.7,3445.141,110.6364
"27577","83082","2018",6,5,1,139833.3,1992.333,75.5
"27578","83083","2018",22,22,0,178868,2154.364,82.77273
"27579","83084","2018",13,13,0,182492.3,2247.077,83.61538
"27580","83085","2018",54,42,12,234810.7,3450.407,76.59259
"27581","83086","2018",122,78,44,223854.9,2530.18,86.2459
"27582","83087","2018",72,57,15,258777.9,3001.528,88.68056
"27583","83088","2018",45,43,2,274426.1,2662.844,106
"27584","83089","2018",13,11,2,213816.9,2518.308,82.07692
"27585","83090","2018",145,80,65,307617,3481.903,86.33793
"27586","83091","2018",8,7,1,326451.1,3111.875,112.75
"27587","83092","2018",76,65,11,198813.7,2174.553,90.71053
"27588","83093","2018",36,19,17,201026.9,2974.167,72.36111
"27589","83094","2018",64,46,18,341143.8,3671.125,90.75
"27590","83095","2018",11,10,1,201327.3,2594.182,86.27273
"27591","83096","2018",34,32,2,238104.4,2958.382,81.32353
"27592","83097","2018",48,43,5,318153.1,3402.771,98.85417
"27593","83098","2018",168,70,98,295747.1,3618.405,79.0119
"27594","83099","2018",99,58,41,283630.4,3118.606,86.13131
"27595","83100","2018",56,46,10,204086.3,2646.018,85.07143
"27596","83101","2018",50,17,33,598092,6362.86,81.18
"27597","83102","2018",55,52,3,230740.3,2374.964,99.43636
"27598","83103","2018",34,29,5,318977.5,3617.147,90.55882
"27599","83104","2018",74,68,6,219308.4,2486.676,90.04054
"27600","83105","2018",1,1,0,1e+05,2273,44
"27601","83106","2018",5,4,1,224600,2740.4,79
"27602","83107","2018",365,232,133,360617.8,4089.449,86.95616
"27603","83108","2018",49,45,4,251082.3,2561.082,97.16327
"27604","83109","2018",4,4,0,111000,2227.5,49
"27605","83110","2018",14,9,5,222546.4,2493.071,92
"27606","83111","2018",28,24,4,256278.3,2671.964,101.3214
"27607","83112","2018",265,88,177,325010.4,4728.038,68.7283
"27608","83113","2018",38,36,2,193489.7,2114.684,92.36842
"27609","83114","2018",4,4,0,153750,1541.75,97.75
"27610","83115","2018",474,155,319,405774.8,4930.403,74.72574
"27611","83116","2018",247,202,45,278281.6,2945.308,96.90688
"27612","83117","2018",20,18,2,333115,3307.55,101.85
"27613","83118","2018",1171,284,887,310982.8,4194.332,72.10248
"27614","83119","2018",104,17,87,654808.2,8653.115,68.65385
"27615","83120","2018",60,41,19,296045.2,3668.967,83.83333
"27616","83121","2018",59,44,15,239667.4,2506.288,97.0339
"27617","83122","2018",8,5,3,132893,2458.125,56.875
"27618","83123","2018",465,139,326,325373.9,4853.632,67.93118
"27619","83124","2018",52,45,7,325583.9,2974.404,108.2308
"27620","83125","2018",43,32,11,235842.5,2792.093,86.60465
"27621","83126","2018",995,262,733,197364.1,3061.585,65.97186
"27622","83127","2018",39,34,5,262966.3,2846.974,97.79487
"27623","83128","2018",20,18,2,225493.2,2154.3,105.1
"27624","83129","2018",857,307,550,273002.5,4131.026,68.10618
"27625","83130","2018",181,115,66,236389.8,2794.155,85.25414
"27626","83131","2018",73,60,13,291397.7,3251.329,91.61644
"27627","83132","2018",24,24,0,337775,2996.458,108.7083
"27628","83133","2018",9,6,3,362555.6,3550.333,107.3333
"27629","83134","2018",49,46,3,266263.9,2990.959,90.77551
"27630","83135","2018",30,30,0,182331.7,2344.867,82
"27631","83136","2018",53,45,8,233315.8,2439.509,96.73585
"27632","83137","2018",2839,434,2405,173242.1,2558.679,65.41353
"27633","83138","2018",60,55,5,239954.8,3688.967,73.11667
"27634","83139","2018",11,11,0,366679.1,2826.818,130.0909
"27635","83140","2018",68,57,11,218793.5,2577.235,88.19118
"27636","83141","2018",78,51,27,233627.5,2499.846,91.96154
"27637","83143","2018",82,70,12,223873.6,2353.402,96.08537
"27638","83144","2018",355,92,263,220236.8,2921.096,75.3662
"27639","83145","2018",22,20,2,181406.8,2200.909,83.27273
"27640","83146","2018",31,30,1,187412.9,2178.774,87.25806
"27641","83148","2018",163,133,30,253439.7,2839.963,90.66871
"27642","83149","2018",30,24,6,230465.9,2703.5,86.6
"27643","83150","2018",35,29,6,227224.3,2249.314,98.71429
"27644","83151","2018",14,13,1,196571.4,2049.571,91.28571
"27645","83152","2018",37,21,16,572088.5,6289.865,91.54054
"27646","83153","2018",129,27,102,237378.2,3982.659,52.99225
"27647","83154","2018",16,16,0,276212.5,2739.312,109.4375
"27648","84001","2018",31,27,4,292052.6,2673.161,106.8065
"27649","84002","2018",16,14,2,415437.5,3507.812,115.125
"27650","84003","2018",117,54,63,151566.9,1849.145,77.64957
"27651","84004","2018",73,66,7,234224.1,2422,96.76712
"27652","84005","2018",6,6,0,162833.3,1926.5,88.33333
"27653","84006","2018",2,2,0,652500,3571,171.5
"27654","84007","2018",1493,429,1064,134942.6,2132.87,65.56865
"27655","84008","2018",10,10,0,322630,2867.5,112.2
"27656","84009","2018",25,22,3,216802.8,2163.4,103.52
"27657","84010","2018",7,7,0,226550,2457.857,100
"27658","84011","2018",7,7,0,261485.7,2767,98
"27659","84012","2018",28,28,0,279371.3,2795.429,98.14286
"27660","84013","2018",4,4,0,823704.8,4900.5,159.75
"27661","84014","2018",20,19,1,308089.1,2875.75,99.2
"27662","84015","2018",2,2,0,384500,2099.5,159.5
"27663","84016","2018",52,49,3,188520.8,1941.096,98.13462
"27664","84017","2018",70,64,6,250722.4,2838.714,92.8
"27665","84018","2018",7,7,0,395341.4,2335.857,164
"27666","84019","2018",140,114,26,164990.1,1810.429,94.37857
"27667","84020","2018",25,22,3,691782.8,5078.08,130.4
"27668","84021","2018",1,1,0,186000,1512,123
"27669","84022","2018",2,2,0,87500,2172,41
"27670","84023","2018",1,1,0,482500,4196,115
"27671","84024","2018",12,9,3,232547.1,2767.833,81.58333
"27672","84025","2018",26,25,1,490748.4,3828.231,121.5385
"27673","84026","2018",55,43,12,243319.1,2876.909,85.92727
"27674","84027","2018",28,27,1,188509.3,1982.429,98.85714
"27675","84028","2018",14,13,1,189003.6,1700.643,111.5714
"27676","84029","2018",65,63,2,180831.7,1742.246,104.1692
"27677","84030","2018",31,29,2,202101.3,2278.677,91.41935
"27678","84031","2018",407,252,155,166699.9,1869.496,86.40295
"27679","84032","2018",4,4,0,183620,2077.5,99
"27680","84033","2018",1,1,0,178000,2738,65
"27681","84034","2018",60,48,12,206017,2173.717,95.8
"27682","84035","2018",336,176,160,174657.1,2144.574,81.79762
"27683","84036","2018",34,30,4,293506.1,2556.971,114.5882
"27684","84037","2018",18,16,2,200258.6,1875.5,111.7778
"27685","84038","2018",36,32,4,282162.9,2913.833,100.6389
"27686","84039","2018",65,49,16,152706.5,1833.292,82.50769
"27687","84040","2018",7,6,1,457492.9,3364.286,128.5714
"27688","84041","2018",6,6,0,460053.3,4507.833,101.5
"27689","84042","2018",23,18,5,372982.4,3194.87,105.5217
"27690","84043","2018",89,74,15,230683.6,2376.404,96.17978
"27691","84044","2018",14,14,0,312435.7,2962.571,116.3571
"27692","84045","2018",11,11,0,165377.3,2037.909,80.72727
"27693","84046","2018",3,3,0,258050,2267.333,118
"27694","84047","2018",21,20,1,242609.5,2179.333,103.4762
"27695","84049","2018",5,5,0,327800,2660.4,123.6
"27696","84050","2018",42,41,1,765722.4,5304.667,150.4048
"27697","84051","2018",17,17,0,517823.5,4128.471,119
"27698","84052","2018",15,15,0,348100.7,3115.733,114.2
"27699","84053","2018",25,25,0,192410.4,1983.52,97.44
"27700","84054","2018",335,213,122,238608.1,2800.481,84.62985
"27701","84055","2018",23,20,3,257220.4,2806.565,91.65217
"27702","84056","2018",61,55,6,191731.8,1926.902,101.8361
"27703","84057","2018",6,5,1,214333.3,2543.667,89.66667
"27704","84058","2018",3,3,0,303333.3,3383.333,91.66667
"27705","84059","2018",1,1,0,212177,2306,92
"27706","84061","2018",8,8,0,318862.5,2678.125,118.75
"27707","84062","2018",21,18,3,330266.5,3105.667,102.8571
"27708","84063","2018",2,2,0,167500,926,165
"27709","84064","2018",36,30,6,131960.3,1414.806,93.19444
"27710","84065","2018",67,60,7,284826.9,2911.537,100.3881
"27711","84066","2018",5,5,0,270396,2547.8,101.6
"27712","84067","2018",30,28,2,264971.5,2585.133,110.4333
"27713","84068","2018",25,17,8,535197.2,5126.04,94.84
"27714","84069","2018",48,41,7,179121.6,2085.167,83.1875
"27715","84070","2018",27,26,1,248015.3,2565.704,99.40741
"27716","84071","2018",16,16,0,380178.8,3284.125,118.75
"27717","84072","2018",87,79,8,261756.1,2594.954,103.4943
"27718","84073","2018",16,14,2,583201.6,4153,125.125
"27719","84074","2018",39,37,2,275849,3040.179,94.4359
"27720","84075","2018",5,5,0,361890,4369,87.8
"27721","84076","2018",17,16,1,281450.6,2336.765,116.6471
"27722","84077","2018",8,8,0,289093.8,2239.125,134.25
"27723","84078","2018",34,31,3,213157.4,1777.235,109.2353
"27724","84079","2018",6,6,0,175375,1791.333,95
"27725","84080","2018",155,111,44,199101.7,2251.303,90.36129
"27726","84081","2018",101,80,21,203296.7,2265.871,92.46535
"27727","84082","2018",26,23,3,286408.1,2312.654,119.6923
"27728","84083","2018",27,24,3,215969.2,2202.185,96.48148
"27729","84084","2018",20,18,2,256343.2,2484.7,104.35
"27730","84085","2018",7,7,0,352764.3,3447.143,102.4286
"27731","84086","2018",17,15,2,604190,4427.824,144.5882
"27732","84087","2018",336,212,124,165952.9,1902.241,87.74405
"27733","84088","2018",100,86,14,304820.9,2957.71,102.2
"27734","84089","2018",245,137,108,226353.7,2884.331,78.43265
"27735","84090","2018",12,11,1,298511.2,2890.75,101
"27736","84091","2018",59,52,7,162795.8,1623.237,99.05085
"27737","84092","2018",219,129,90,150132,1897.123,79.44749
"27738","84093","2018",16,16,0,389545.2,3126.125,124.625
"27739","84094","2018",7,7,0,302200,2638.143,114.5714
"27740","84095","2018",12,12,0,346455.5,2973.167,113.75
"27741","84096","2018",6,6,0,259075,2947.5,124.3333
"27742","84097","2018",8,7,1,164312.5,1762.75,96.875
"27743","84098","2018",10,10,0,309916.6,3763.1,96.6
"27744","84099","2018",37,34,3,300073.8,2540.027,114.973
"27745","84100","2018",1,1,0,922900,4807,192
"27746","84101","2018",3,3,0,620000,3075.667,179.6667
"27747","84102","2018",21,20,1,476511.4,3197.619,137.7619
"27748","84103","2018",14,14,0,228484.3,2355,95.35714
"27749","84104","2018",29,25,4,187655,1852.828,98.75862
"27750","84105","2018",18,16,2,267424.4,2771.778,96.94444
"27751","84106","2018",32,29,3,229554.5,2030.781,109.125
"27752","84107","2018",10,10,0,112960,1505.1,74.3
"27753","84108","2018",32,31,1,299856.9,2771.031,106.875
"27754","84109","2018",1,1,0,65000,1548,42
"27755","84110","2018",1,1,0,195000,1226,159
"27756","84111","2018",2,2,0,408600,3089.5,134.5
"27757","84112","2018",15,15,0,197892.4,2448.733,80.66667
"27758","84113","2018",17,16,1,265306.2,2797.765,97.29412
"27759","84114","2018",3,3,0,308733.3,3134.333,97.66667
"27760","84115","2018",8,7,1,312250,2445.875,125.25
"27761","84116","2018",12,12,0,355052.2,3030,121.4167
"27762","84117","2018",5,5,0,181650,1712.2,107.6
"27763","84118","2018",45,42,3,364481.2,3171.667,114.8667
"27764","84119","2018",44,36,8,236733.3,2364.205,101.2273
"27765","84120","2018",2,2,0,315000,1739.5,179
"27766","84121","2018",1,1,0,950000,4043,235
"27767","84122","2018",55,51,4,247382.4,2170.091,114.6909
"27768","84123","2018",16,14,2,155687.5,1831.812,80.9375
"27769","84124","2018",16,10,6,387096.9,3371.938,114.5625
"27770","84126","2018",3,3,0,679333.3,3195,196.6667
"27771","84127","2018",35,32,3,197589,1963.486,99.2
"27772","84129","2018",240,158,82,162399.5,1944.179,82.39167
"27773","84130","2018",2,2,0,625000,3183,195
"27774","84131","2018",25,24,1,306766,2826.6,111.4
"27775","84132","2018",97,75,22,246642.2,2846.825,90.72165
"27776","84133","2018",42,31,11,243939.8,2663.095,86.52381
"27777","84134","2018",5,5,0,292000,2317.6,122.6
"27778","84135","2018",26,25,1,219225.4,1847.731,120.8462
"27779","84136","2018",15,14,1,227761.7,1963.2,121.6
"27780","84137","2018",114,82,32,259194.6,2505.711,101.6404
"27781","84138","2018",153,119,34,138201.9,1572.693,88.35294
"27782","84139","2018",13,9,4,181600,1813.769,104.1538
"27783","84140","2018",8,8,0,504706.2,3944.875,119.25
"27784","84141","2018",147,114,33,209499.4,2339.306,90.57823
"27785","84142","2018",28,27,1,260139.6,2389.107,111.2857
"27786","84143","2018",15,14,1,439138,3390.867,128.2667
"27787","84144","2018",13,11,2,179000,2157.769,79.07692
"27788","84145","2018",12,12,0,217811.1,2671,92.66667
"27789","84146","2018",9,9,0,342994.4,3262.333,109.1111
"27790","84147","2018",36,29,7,267540.8,2858.028,92.61111
"27791","84148","2018",15,15,0,164900,2089.667,88.46667
"27792","84149","2018",25,24,1,150426.6,1585.88,96.8
"27793","84150","2018",21,20,1,214645,2019.095,102.381
"27794","84151","2018",2,2,0,475475,4360.5,112
"27795","85001","2018",138,130,8,141664.1,2088.92,73.26087
"27796","85002","2018",25,25,0,157846.8,1801.8,86.8
"27797","85003","2018",104,96,8,169575.9,1758.971,98.39423
"27798","85004","2018",83,80,3,153765,1889.602,83.63855
"27799","85005","2018",12,12,0,127623.7,1096.833,106.6667
"27800","85006","2018",37,37,0,127786.5,1468.676,92.21622
"27801","85008","2018",79,77,2,165698.2,1705.937,98.59494
"27802","85009","2018",10,10,0,141550,1226,116.4
"27803","85010","2018",33,33,0,158635.5,1523.212,104.0606
"27804","85011","2018",71,68,3,228650.7,3162.93,77.14085
"27805","85012","2018",70,55,15,150487.9,1983.371,80.11429
"27806","85013","2018",13,13,0,129538.5,1500.846,85.69231
"27807","85014","2018",14,14,0,121767.9,1178.429,110.5
"27808","85015","2018",19,19,0,153063.2,1465.632,107
"27809","85016","2018",27,27,0,149482.6,1623.556,90.7037
"27810","85017","2018",14,14,0,130817.9,1277.214,109.1429
"27811","85018","2018",62,58,4,145341.8,1662.935,89.77419
"27812","85019","2018",62,62,0,175561.3,1619.532,108.9516
"27813","85020","2018",40,40,0,141982.5,1363.95,106.825
"27814","85021","2018",21,21,0,175086.2,1598.143,116.8095
"27815","85022","2018",35,35,0,163587.4,1772.829,97.05714
"27816","85023","2018",7,7,0,129621.4,1291.143,104.7143
"27817","85024","2018",31,30,1,163547.4,1625.677,101.2903
"27818","85025","2018",29,29,0,151444.7,1604.586,95.13793
"27819","85026","2018",14,14,0,177126.4,1709.571,108.7143
"27820","85028","2018",7,7,0,126828.6,1498,101.7143
"27821","85029","2018",52,52,0,133465.8,1461.981,92.40385
"27822","85031","2018",39,38,1,113891.2,1248.974,91.23077
"27823","85033","2018",13,13,0,102450,963.2308,108
"27824","85034","2018",21,21,0,125166.7,1390.19,95.09524
"27825","85035","2018",214,181,33,191670,2949.93,71.39252
"27826","85036","2018",9,9,0,108888.9,1138,100.4444
"27827","85037","2018",9,9,0,106344.4,974.1111,118.3333
"27828","85038","2018",33,33,0,142501.1,1422.242,100.1818
"27829","85039","2018",29,29,0,143935.9,1483.172,103.4138
"27830","85040","2018",17,17,0,173500,1207.353,133.5294
"27831","85042","2018",35,35,0,118357.1,1232.371,98.62857
"27832","85045","2018",25,25,0,218072.8,2434.24,87.4
"27833","85046","2018",40,40,0,146384.4,1484.5,99.175
"27834","85047","2018",298,243,55,170888.3,1963.128,89.69128
"27835","85049","2018",33,33,0,139183,1334.758,109.2727
"27836","85050","2018",40,39,1,111334,1248.825,93.6
"27837","85051","2018",89,80,9,110947.7,1308.539,88.70787
"27838","85053","2018",1,1,0,40000,556,72
"27839","85054","2018",15,15,0,134223.3,1551.4,91.33333
"27840","85055","2018",11,11,0,123504.5,1510.273,83
"27841","85056","2018",8,8,0,145525,1131.625,155.125
"27842","85058","2018",7,7,0,234788.6,1796,127.8571
"27843","85059","2018",23,23,0,118826.1,1264.957,96.86957
"27844","85061","2018",18,18,0,144888.9,1440.333,101.5
"27845","85062","2018",11,11,0,181872.7,1681.909,111.8182
"27846","85064","2018",29,29,0,134548.3,1340.931,103.0345
"27847","85065","2018",38,38,0,130939.5,1247.053,110.7632
"27848","85066","2018",17,17,0,97824.12,1095.824,89.58824
"27849","85067","2018",6,6,0,152333.3,1186.5,124.3333
"27850","85070","2018",51,51,0,157090.3,1577.784,96.96078
"27851","85071","2018",49,48,1,170837.6,1863.612,96.46939
"27852","85072","2018",7,7,0,132142.9,1533,96.42857
"27853","85073","2018",8,8,0,148803.1,1588.625,98.75
"27854","85074","2018",4,4,0,73100,996.75,83.25
"27855","85076","2018",46,45,1,186400.2,2008.326,94.63043
"27856","85077","2018",10,10,0,127654,1158.7,104.3
"27857","85078","2018",13,13,0,119033.1,1342.154,90.84615
"27858","85080","2018",20,20,0,120975,1096.05,113.05
"27859","85081","2018",47,47,0,184103.2,1748.511,105.1702
"27860","85082","2018",34,32,2,125667.6,1367.235,91.58824
"27861","85083","2018",43,43,0,284178.4,3526.163,84.34884
"27862","85084","2018",88,87,1,134382.5,1467.864,103.5795
"27863","85086","2018",18,17,1,147833.3,1415.611,103.7778
"27864","85087","2018",10,10,0,73222.8,808.2,84.5
"27865","85088","2018",97,92,5,244547.1,2496.01,98.92784
"27866","85089","2018",56,55,1,154933.3,1672.196,96.10714
"27867","85090","2018",41,40,1,114875.6,1257.61,96.7561
"27868","85092","2018",177,153,24,109496.3,1085.153,101.0734
"27869","85093","2018",9,9,0,94822.22,1040.667,94.33333
"27870","85094","2018",20,19,1,122507.5,993.8,126.75
"27871","85095","2018",20,20,0,156762.5,1488.1,108.65
"27872","85096","2018",59,57,2,161054.1,1691,95.20339
"27873","85097","2018",21,21,0,107995.2,1249.667,86.19048
"27874","85098","2018",21,21,0,159792.7,1709.81,95.95238
"27875","85099","2018",21,21,0,186750,1712.571,108.7143
"27876","85100","2018",38,37,1,214561.4,2466.632,88.34211
"27877","85101","2018",7,7,0,174571.4,1660,104.1429
"27878","85102","2018",9,9,0,129666.7,1146.889,114.8889
"27879","85103","2018",39,38,1,164570,1735.026,95.74359
"27880","85104","2018",25,24,1,144620,1719.92,87.32
"27881","85105","2018",5,5,0,118060,1179,99.8
"27882","85106","2018",51,49,2,270854.1,3427.941,82.66667
"27883","85108","2018",44,44,0,164457,1661.364,100.5227
"27884","85109","2018",171,152,19,151037,1711.146,89.67836
"27885","85110","2018",15,15,0,107639.3,862.8667,135.9333
"27886","85111","2018",27,27,0,99695.56,1053.37,93.25926
"27887","85112","2018",40,40,0,195019.2,1904.1,105.8
"27888","85113","2018",109,104,5,326032.7,3989.954,81.88991
"27889","85114","2018",130,107,23,178672.6,2630.492,72.44615
"27890","85115","2018",13,13,0,80730.77,919.2308,91.53846
"27891","85116","2018",4,4,0,191250,1735.5,116.25
"27892","85117","2018",9,9,0,139711.1,1419,99.11111
"27893","85118","2018",32,32,0,175471.8,1622.25,110.4688
"27894","85119","2018",25,25,0,127757.1,1235.4,105.04
"27895","85120","2018",33,32,1,174353.7,1791.212,97.81818
"27896","85121","2018",14,14,0,111564.3,933.4286,123.6429
"27897","85123","2018",6,6,0,96977.5,816.3333,136.3333
"27898","85126","2018",10,10,0,133100,1133.6,120.3
"27899","85127","2018",102,97,5,153798.8,2241,72.55882
"27900","85128","2018",161,152,9,141251.9,1445.186,98.63354
"27901","85129","2018",42,42,0,162391.5,1546.81,104.2857
"27902","85130","2018",28,27,1,150828.2,1622.143,94.60714
"27903","85131","2018",22,21,1,143500,1380.182,101.6818
"27904","85132","2018",9,9,0,126900,1023.111,126.3333
"27905","85133","2018",7,7,0,118875.7,1174,114.8571
"27906","85134","2018",4,4,0,103600,1346.75,74.75
"27907","85135","2018",37,37,0,113802.6,1306.73,89.48649
"27908","85136","2018",3,3,0,64033.33,691.6667,89.33333
"27909","85137","2018",10,10,0,88810.8,885.1,108
"27910","85138","2018",9,9,0,159833.3,1477,111.6667
"27911","85139","2018",6,6,0,131500,1045.333,117
"27912","85140","2018",10,10,0,122531,1218.7,99.3
"27913","85141","2018",5,5,0,63200,667.4,90.8
"27914","85142","2018",11,11,0,154604.5,1447.636,97.27273
"27915","85143","2018",16,16,0,106437.5,1179.062,93.3125
"27916","85144","2018",19,19,0,139173.3,1500.526,96.21053
"27917","85145","2018",12,11,1,101114.2,1037.833,103
"27918","85146","2018",201,181,20,164818,1827.532,91.99005
"27919","85147","2018",24,24,0,78753.12,814.9167,94.125
"27920","85148","2018",8,8,0,103687.5,1239,80.75
"27921","85151","2018",73,71,2,138906.8,1503.301,94.08219
"27922","85152","2018",65,65,0,163931.2,1738.769,96.58462
"27923","85153","2018",35,34,1,119752.6,1190.371,97.8
"27924","85154","2018",22,22,0,113552.5,1114.682,103
"27925","85155","2018",50,50,0,190707.6,1842.9,103.34
"27926","85157","2018",9,9,0,117488.9,974.8889,118.4444
"27927","85158","2018",11,11,0,110063.6,1189.727,91.63636
"27928","85159","2018",24,24,0,144682.1,1251.708,116.375
"27929","85160","2018",23,21,2,171171.7,1547.826,108.8696
"27930","85161","2018",29,29,0,143172.1,1538.138,95.62069
"27931","85162","2018",21,21,0,131938,1217.286,111.381
"27932","85163","2018",155,135,20,311704.8,3829.181,84.16774
"27933","85164","2018",98,56,42,142286.5,2415.786,62.63265
"27934","85167","2018",13,13,0,159376.9,1452.385,115.6923
"27935","85169","2018",18,18,0,140861.1,1486.5,96.27778
"27936","85171","2018",11,11,0,112636.4,1274.818,89.09091
"27937","85172","2018",40,40,0,168015.3,1785.125,96.65
"27938","85174","2018",12,12,0,98229.17,834.6667,114
"27939","85175","2018",8,8,0,87122,948.25,88.875
"27940","85176","2018",14,14,0,99285.71,1088.786,90.78571
"27941","85177","2018",18,18,0,103218.4,1003.667,102.8333
"27942","85178","2018",113,107,6,169643.8,1701.832,99.75221
"27943","85179","2018",28,28,0,143875,1552.607,93.03571
"27944","85181","2018",5,5,0,133700,1094.6,127.4
"27945","85182","2018",64,62,2,128605.2,1403.922,94.54688
"27946","85184","2018",6,6,0,99583.33,1050.667,95.33333
"27947","85185","2018",11,11,0,152145.5,1437.364,110.2727
"27948","85186","2018",11,11,0,109514.5,1169.727,99.54545
"27949","85187","2018",11,11,0,119409.1,1074.909,113.8182
"27950","85188","2018",12,12,0,90475,963.9167,94.58333
"27951","85189","2018",30,30,0,158926.8,2093.733,76.16667
"27952","85190","2018",44,42,2,138988,1479.659,93.02273
"27953","85191","2018",879,505,374,143061.2,1744.91,82.1661
"27954","85192","2018",15,12,3,114806.7,1240.267,96.8
"27955","85193","2018",10,10,0,114275,1105.6,107.4
"27956","85194","2018",1324,771,553,231159,3265.586,74.00529
"27957","85196","2018",20,20,0,129050,1460.6,90.75
"27958","85197","2018",35,35,0,140915.9,1370.314,104.8571
"27959","85198","2018",9,9,0,123181.3,1587.556,73.44444
"27960","85199","2018",9,9,0,149514.8,1388.889,111.5556
"27961","85200","2018",8,8,0,171587.5,1512.875,115.875
"27962","85201","2018",7,7,0,173912.1,1770.429,97.42857
"27963","85202","2018",10,10,0,89757.5,944.9,100.8
"27964","85204","2018",41,41,0,162571.2,1562.171,108.2439
"27965","85205","2018",10,10,0,119880,1028.8,117.9
"27966","85206","2018",19,18,1,95115.79,1174.789,84.63158
"27967","85207","2018",14,14,0,139278.6,1351.571,108.1429
"27968","85208","2018",21,21,0,136247.6,1427.143,99.57143
"27969","85209","2018",12,12,0,117250,1028.5,115.5833
"27970","85210","2018",33,33,0,123033.3,1231,99.9697
"27971","85211","2018",33,33,0,163399.5,1662.818,101.2727
"27972","85213","2018",73,73,0,147582,1416.096,106.0411
"27973","85214","2018",25,25,0,200379.5,2129.76,94
"27974","85215","2018",20,20,0,154025,1516.65,108.75
"27975","85216","2018",24,24,0,144757.3,1377.25,105.9583
"27976","85218","2018",15,15,0,159904.1,1766.8,95.46667
"27977","85220","2018",9,9,0,131103.3,1231,108
"27978","85221","2018",44,44,0,177821.9,1772.773,104.5455
"27979","85222","2018",270,162,108,227550.8,3324.104,73.64815
"27980","85223","2018",40,38,2,104056.5,1180.5,94
"27981","85226","2018",456,230,226,154093.2,2487.461,62.1886
"27982","85227","2018",23,23,0,120778.3,978.5652,130.4348
"27983","85229","2018",7,7,0,352921.4,1420.571,158.8571
"27984","85231","2018",8,8,0,137487.5,1843.125,80.25
"27985","85232","2018",11,11,0,114290.9,1107.364,100.6364
"27986","85233","2018",13,13,0,158996.2,1363.538,117.7692
"27987","85234","2018",448,219,229,144518,2435.02,60.13393
"27988","85235","2018",7,7,0,100885.7,1225.286,85.28571
"27989","85236","2018",13,13,0,140153.8,1644.231,87.61538
"27990","85237","2018",6,6,0,181570.8,1282.333,143.6667
"27991","85238","2018",30,28,2,142890,1520.7,98
"27992","85239","2018",19,19,0,155039.3,1882.053,83.89474
"27993","85240","2018",8,8,0,137750,1506.5,95.375
"27994","85242","2018",8,8,0,113750,1008.875,130.875
"27995","85243","2018",69,68,1,175155.9,2397.435,78.01449
"27996","85244","2018",9,9,0,126666.7,1134.333,113.2222
"27997","85245","2018",1,1,0,122000,718,170
"27998","85246","2018",23,23,0,134995.7,1435.348,94.56522
"27999","85247","2018",5,5,0,131302.4,1366.2,91
"28000","85248","2018",5,5,0,123200,1142.6,109.4
"28001","85250","2018",35,35,0,175580,1922.171,93.71429
"28002","85251","2018",9,9,0,78022.22,724.6667,112.7778
"28003","85252","2018",8,8,0,97500,950.875,100.125
"28004","85254","2018",14,14,0,101500,1087.071,89.78571
"28005","85255","2018",46,46,0,143229.7,1522.413,98.19565
"28006","85256","2018",9,9,0,131285.7,1118.889,114.1111
"28007","85259","2018",8,8,0,118500,1428.5,80.5
"28008","85260","2018",16,16,0,152734.4,1559.375,101
"28009","85261","2018",4,4,0,108475,1622.5,78.5
"28010","85262","2018",42,38,4,146991.2,1662.667,90.78571
"28011","85264","2018",10,10,0,96550,930.2,105.9
"28012","85265","2018",16,16,0,130062.5,915.875,147.375
"28013","85266","2018",5,5,0,133100,1234.6,110
"28014","85267","2018",20,20,0,130310.7,1294.55,104.1
"28015","85268","2018",18,18,0,180316.2,1861.667,98.55556
"28016","85269","2018",3,3,0,125000,819.6667,142.3333
"28017","85271","2018",9,9,0,110521.7,1124.889,102.1111
"28018","85273","2018",30,30,0,147000.7,1643.667,92.33333
"28019","85274","2018",9,9,0,129605.3,1177.444,112.6667
"28020","85276","2018",9,9,0,99577.78,920.7778,112.1111
"28021","85277","2018",17,17,0,157087.6,1334.529,119.1765
"28022","85278","2018",69,62,7,170489.3,2563.493,74.27536
"28023","85280","2018",46,46,0,188387.3,1893.652,99.28261
"28024","85281","2018",11,11,0,106008.5,1012.273,101.9091
"28025","85282","2018",14,14,0,140050,1172.357,117.0714
"28026","85284","2018",69,68,1,191994.3,1882.029,103.5362
"28027","85285","2018",14,14,0,170639.3,1635.714,113.7857
"28028","85286","2018",12,12,0,126476.7,1020.667,123.5
"28029","85287","2018",7,7,0,153670.7,1385.286,119.4286
"28030","85288","2018",232,157,75,190579.6,2296.974,81.59483
"28031","85289","2018",11,11,0,144386.4,1402.545,108.7273
"28032","85290","2018",7,7,0,91928.57,955.5714,103.5714
"28033","85291","2018",21,20,1,128978.5,1398.095,92.90476
"28034","85292","2018",9,9,0,116942.9,1146.111,107.7778
"28035","85293","2018",15,15,0,130806,1229.267,105.7333
"28036","85294","2018",197,173,24,176048.7,2759.843,67.91878
"28037","85295","2018",39,39,0,152577.4,1446.154,106.1538
"28038","85296","2018",16,16,0,123093.8,1049.875,114.5625
"28039","85297","2018",13,13,0,111813.8,1400.538,86.53846
"28040","85298","2018",20,20,0,182872.8,1812.45,100.6
"28041","85300","2018",49,49,0,191741.9,1839.878,107.0204
"28042","85301","2018",15,15,0,128680.4,1290.267,100.4
"28043","85302","2018",44,44,0,136829.5,1411.455,100.5
"28044","85303","2018",24,24,0,120616.7,1085.583,114.2083
"28045","85304","2018",12,12,0,103044.2,1282.667,85.25
"28046","85305","2018",15,15,0,165526.7,1714.8,99.86667
"28047","85306","2018",11,11,0,114554.5,1073.455,112.2727
"28048","86001","2018",8,8,0,124686.2,1096,109.5
"28049","86002","2018",9,9,0,119597.3,1262.778,97
"28050","86003","2018",3,3,0,113000,1235.333,92.66667
"28051","86004","2018",6,6,0,157941.7,1318,111.1667
"28052","86005","2018",7,7,0,121714.3,1200.571,109
"28053","86006","2018",6,6,0,126827.5,1277.5,101.5
"28054","86007","2018",5,5,0,112600,1321,82.6
"28055","86008","2018",7,7,0,103658.6,1014,111.4286
"28056","86009","2018",9,9,0,107418.9,1071.333,108.5556
"28057","86010","2018",9,9,0,129316.7,1862.667,75.88889
"28058","86011","2018",4,4,0,58500,665,88.25
"28059","86012","2018",1,1,0,260000,1281,203
"28060","86013","2018",1,1,0,141000,881,160
"28061","86014","2018",13,11,2,127375.6,1243,104.2308
"28062","86015","2018",29,28,1,82258.62,932.1034,87.51724
"28063","86016","2018",29,29,0,178293.8,1681.241,108.2069
"28064","86017","2018",9,9,0,124156.6,1203.889,119.8889
"28065","86018","2018",3,3,0,122166.7,1254,103.3333
"28066","86019","2018",33,33,0,142029.7,1539.242,93.54545
"28067","86022","2018",9,9,0,101177.8,936.8889,103
"28068","86023","2018",2,2,0,78000,940.5,90
"28069","86024","2018",13,13,0,198744.6,1496,137.1538
"28070","86025","2018",7,7,0,107714.3,860.7143,110.2857
"28071","86026","2018",9,9,0,116388.9,1164.556,95.66667
"28072","86027","2018",18,18,0,209524.9,1670.222,130.2222
"28073","86028","2018",10,10,0,162450,1702.6,95.4
"28074","86029","2018",17,17,0,128481.5,1165.882,113.7647
"28075","86031","2018",18,18,0,107212,1125.222,93.05556
"28076","86032","2018",25,24,1,137445.4,1298.4,106.8
"28077","86034","2018",1,1,0,108000,720,150
"28078","86035","2018",3,3,0,44633.33,497.6667,90
"28079","86036","2018",9,9,0,120360.2,1427.222,89.88889
"28080","86037","2018",6,6,0,112022.7,1208.333,98.66667
"28081","86038","2018",1,1,0,75000,1119,67
"28082","86039","2018",6,6,0,92666.67,829.6667,115.3333
"28083","86040","2018",11,11,0,82272.73,1056.182,81.09091
"28084","86041","2018",148,89,59,140831.4,1693.541,82.7973
"28085","86042","2018",9,9,0,96500,1037.444,90.22222
"28086","86044","2018",8,8,0,129582.6,871,153.75
"28087","86045","2018",7,7,0,118428.6,1339.857,88.85714
"28088","86046","2018",16,16,0,116123.6,1269.188,90.8125
"28089","86047","2018",2,2,0,172500,1446,130
"28090","86048","2018",15,15,0,187948.6,1504.2,132.8
"28091","86049","2018",6,6,0,136233.3,1104.167,119.5
"28092","86050","2018",16,16,0,94562.5,1087.938,88.75
"28093","86051","2018",3,3,0,72666.67,651.6667,109
"28094","86052","2018",15,15,0,139808,1066.533,140.1333
"28095","86053","2018",21,21,0,132597.6,1247.81,112.3333
"28096","86054","2018",5,5,0,81410,726.6,110.4
"28097","86055","2018",2,2,0,110500,1217,104
"28098","86058","2018",7,7,0,161944,1645.714,109.1429
"28099","86059","2018",5,5,0,129230,953.2,145.6
"28100","86061","2018",8,8,0,57731.25,666,88.875
"28101","86062","2018",66,51,15,126819.9,1744.833,79.33333
"28102","86063","2018",6,6,0,83339.67,684.6667,125.5
"28103","86064","2018",4,4,0,57250,554.25,107.25
"28104","86065","2018",12,12,0,133833.3,1340.667,101.4167
"28105","86066","2018",348,267,81,103132.2,1190.621,86.99138
"28106","86068","2018",12,12,0,95601.25,919,98.75
"28107","86069","2018",4,4,0,59875,847.75,72.5
"28108","86070","2018",80,77,3,116917.5,1338.45,88.7125
"28109","86072","2018",7,7,0,134652.9,1278.286,110.2857
"28110","86073","2018",8,8,0,86912.5,905.875,98.125
"28111","86074","2018",5,5,0,101400,933.6,111.6
"28112","86075","2018",8,8,0,83375,1009.625,83
"28113","86076","2018",14,14,0,167412.5,1433.857,118.7143
"28114","86077","2018",5,5,0,156256,1833.2,96.4
"28115","86078","2018",35,35,0,99847.86,981.0286,104.2286
"28116","86079","2018",3,3,0,106983,744.6667,105.6667
"28117","86080","2018",7,7,0,158892.9,1381.714,127.7143
"28118","86081","2018",11,11,0,123577.3,1176.091,98.63636
"28119","86082","2018",60,59,1,100346.1,1067.217,98.81667
"28120","86083","2018",14,14,0,121416.4,1292.071,95.5
"28121","86084","2018",3,3,0,100333.3,675.3333,163.3333
"28122","86085","2018",2,2,0,93000,1030,90
"28123","86086","2018",9,9,0,76455.56,903.4444,83.33333
"28124","86087","2018",2,2,0,50000,575,87
"28125","86088","2018",7,6,1,161671.4,1559.857,104.7143
"28126","86089","2018",8,8,0,74128.75,957.125,87.5
"28127","86090","2018",6,6,0,117683.3,1143.167,101
"28128","86091","2018",4,4,0,58250,866,62.75
"28129","86092","2018",39,36,3,100659.7,1097.795,91.64103
"28130","86093","2018",2,2,0,72500,1008,72
"28131","86094","2018",6,6,0,107750,972.3333,106
"28132","86095","2018",32,32,0,124615.6,1234.344,105.5625
"28133","86096","2018",5,5,0,89800,938.6,90.8
"28134","86097","2018",3,3,0,108000,887.3333,113.6667
"28135","86098","2018",1,1,0,85000,1049,81
"28136","86099","2018",10,10,0,127811,1419.5,91.1
"28137","86100","2018",45,44,1,198142.2,1816.267,111.2222
"28138","86102","2018",6,6,0,139375,1367.333,101.6667
"28139","86103","2018",11,10,1,146950,1362.364,111.7273
"28140","86104","2018",11,11,0,102062.7,1208.636,86.63636
"28141","86105","2018",3,3,0,144333.3,1255.667,110.3333
"28142","86106","2018",2,2,0,136425,1148,134.5
"28143","86107","2018",7,7,0,86000,925.1429,87.57143
"28144","86108","2018",6,6,0,107737.5,854.5,117.6667
"28145","86109","2018",4,4,0,63250,852.5,73
"28146","86110","2018",3,3,0,41666.67,919.6667,43.66667
"28147","86111","2018",20,20,0,106284.2,1044.3,103.9
"28148","86112","2018",17,17,0,83545.29,911.8824,90.35294
"28149","86113","2018",26,25,1,160085.3,1522.885,109.8462
"28150","86114","2018",7,7,0,230714.3,1574.571,145.8571
"28151","86115","2018",83,71,12,125924.2,1523.361,86.55422
"28152","86116","2018",13,13,0,116080.8,1048.923,109.5385
"28153","86117","2018",8,8,0,96625,846,107.625
"28154","86118","2018",4,4,0,146404,1155.75,117
"28155","86119","2018",1,1,0,62865,776,81
"28156","86120","2018",13,13,0,62780.77,616.1538,102.4615
"28157","86121","2018",6,6,0,109831.7,1557,84.66667
"28158","86122","2018",1,1,0,155000,1409,110
"28159","86123","2018",27,26,1,129316.3,1167.667,125.8889
"28160","86124","2018",13,13,0,133001.5,1342.308,105.6923
"28161","86125","2018",4,4,0,128500,1304.75,102.25
"28162","86126","2018",9,9,0,95222.22,1143.333,101.8889
"28163","86127","2018",6,6,0,81333.33,930.8333,88.16667
"28164","86128","2018",26,26,0,99775.85,1105.115,96.73077
"28165","86129","2018",5,5,0,93400,993.6,88.8
"28166","86130","2018",8,8,0,93487.5,996.125,100.375
"28167","86131","2018",10,10,0,96690,1081.1,90.2
"28168","86132","2018",6,6,0,51333.33,575.6667,92
"28169","86133","2018",34,33,1,201089.6,2075.735,99.97059
"28170","86134","2018",5,5,0,103500,826.2,127.2
"28171","86135","2018",6,6,0,160333.3,1512.833,112.1667
"28172","86136","2018",4,4,0,79000,658.5,126.5
"28173","86137","2018",67,64,3,94151.94,980.2687,98.91045
"28174","86138","2018",6,6,0,111916.7,956.8333,120
"28175","86139","2018",24,23,1,106437.5,1176.583,94.41667
"28176","86140","2018",29,28,1,104635.7,1135.966,92.10345
"28177","86141","2018",8,8,0,105937.5,1109.5,92.25
"28178","86142","2018",5,5,0,122080,1208.8,100.2
"28179","86143","2018",7,7,0,74500,809.5714,94.57143
"28180","86144","2018",2,2,0,36500,494,74
"28181","86145","2018",15,15,0,146806.7,1369.533,108.9333
"28182","86147","2018",3,3,0,156400,1382.333,118
"28183","86148","2018",4,4,0,183078.8,1349.75,142.25
"28184","86149","2018",2,2,0,94500,949.5,101.5
"28185","86150","2018",4,4,0,123990,958.25,128
"28186","86151","2018",3,3,0,84000,1272.667,67.66667
"28187","86152","2018",9,9,0,127555.6,1829.778,93.33333
"28188","86153","2018",8,8,0,95843.75,983.25,95.875
"28189","86154","2018",4,4,0,85000,1124.25,70.25
"28190","86156","2018",3,3,0,87833.33,736.6667,125.6667
"28191","86157","2018",47,42,5,221270.8,1955.043,112.7872
"28192","86158","2018",67,65,2,167907.5,1692.522,101.8657
"28193","86159","2018",8,8,0,170182.9,1888.875,104.375
"28194","86160","2018",22,22,0,106395,966.9545,111.9091
"28195","86161","2018",18,18,0,102052.2,829.4444,121.5
"28196","86162","2018",1,1,0,84000,1527,55
"28197","86163","2018",34,33,1,207601.2,1893.206,115.1765
"28198","86164","2018",6,6,0,97833.33,1371.167,70.33333
"28199","86165","2018",72,64,8,101946.6,1341.056,82.63889
"28200","86167","2018",8,8,0,114929.9,1053.625,107.25
"28201","86169","2018",4,4,0,102500,780,134.25
"28202","86170","2018",4,4,0,84750,958,86.25
"28203","86171","2018",11,11,0,68909.09,861.2727,80.45455
"28204","86172","2018",1,1,0,165000,1833,90
"28205","86173","2018",5,5,0,142800,1096.6,127.8
"28206","86174","2018",55,55,0,123706.1,1301.564,97.76364
"28207","86175","2018",5,5,0,73800,802.6,90
"28208","86176","2018",2,2,0,39155,444,86.5
"28209","86177","2018",65,59,6,150436.1,1506.8,104.0308
"28210","86178","2018",21,21,0,158425,1463.048,111.9048
"28211","86180","2018",5,5,0,260136.6,1860,139
"28212","86181","2018",3,3,0,42333.33,669.6667,58.33333
"28213","86182","2018",5,5,0,90800,884.8,103.6
"28214","86183","2018",14,14,0,95807.86,1026.929,90.92857
"28215","86184","2018",12,12,0,124966.7,1283,101.8333
"28216","86186","2018",6,6,0,125416.7,1168.833,107.1667
"28217","86187","2018",5,5,0,89400,883.4,101.8
"28218","86189","2018",3,3,0,54450,664.3333,81
"28219","86190","2018",9,9,0,47183.33,717.3333,69.77778
"28220","86191","2018",3,3,0,124690.7,1151.667,116
"28221","86192","2018",2,2,0,35000,620,57
"28222","86193","2018",10,10,0,133125,1204.7,116.7
"28223","86194","2018",1410,487,923,109384.8,1709.843,65.88227
"28224","86195","2018",2,2,0,105000,991.5,99
"28225","86196","2018",1,1,0,135000,1205,112
"28226","86197","2018",8,8,0,79000,897.5,90
"28227","86198","2018",6,6,0,140515.7,1339.167,106.5
"28228","86200","2018",6,6,0,153000,1918.333,79.16667
"28229","86202","2018",8,8,0,134062.5,1090.25,126.5
"28230","86203","2018",12,12,0,86758.33,1187.917,86.08333
"28231","86204","2018",22,22,0,175170.5,1601.591,113.4091
"28232","86205","2018",2,2,0,141000,1038.5,137
"28233","86206","2018",1,1,0,119030,763,156
"28234","86207","2018",34,20,14,113029.6,1468.735,81.52941
"28235","86209","2018",17,17,0,133123.3,1374.059,93.05882
"28236","86210","2018",5,5,0,111800,1116.4,103.6
"28237","86211","2018",18,18,0,76551.67,854.7222,92.05556
"28238","86213","2018",27,27,0,109829.6,1092.556,102.4444
"28239","86214","2018",95,77,18,174629.1,1734.263,102.7789
"28240","86217","2018",6,6,0,93550,1062,95.5
"28241","86218","2018",2,2,0,107879.5,1187.5,87.5
"28242","86220","2018",7,7,0,102794.3,869.8571,113
"28243","86221","2018",12,12,0,96403.83,1070.167,93.5
"28244","86222","2018",44,44,0,175098,1638.682,111.1591
"28245","86223","2018",12,12,0,89250,1027.25,87.66667
"28246","86224","2018",15,15,0,135743,1007.467,137.9333
"28247","86225","2018",11,11,0,80807.27,873.9091,96.81818
"28248","86226","2018",23,23,0,143770.1,1504.739,97.21739
"28249","86228","2018",1,1,0,104500,1229,85
"28250","86229","2018",7,7,0,113971.4,1026,111
"28251","86230","2018",3,3,0,49666.67,569,89.66667
"28252","86231","2018",4,4,0,49805,767,63
"28253","86233","2018",33,33,0,118613.1,1179.303,104.9394
"28254","86234","2018",5,5,0,70240.2,624.2,99.2
"28255","86235","2018",11,11,0,114603.1,1150,95.81818
"28256","86236","2018",7,7,0,137488.6,1516.571,89.42857
"28257","86237","2018",5,5,0,116400,1252.4,95.2
"28258","86239","2018",1,1,0,205000,1206,170
"28259","86241","2018",5,5,0,134930,1175,142.6
"28260","86242","2018",5,5,0,68814,967.8,68.2
"28261","86244","2018",14,14,0,103770.7,945.3571,114.5
"28262","86245","2018",15,15,0,144386.7,1308,112.7333
"28263","86246","2018",6,6,0,113941.7,889.1667,124.3333
"28264","86247","2018",5,5,0,81800,1069.2,83.4
"28265","86248","2018",10,10,0,96500,910.7,102.3
"28266","86250","2018",2,2,0,92295,1031.5,90
"28267","86252","2018",7,7,0,89857.14,830,106.1429
"28268","86253","2018",7,7,0,111548,1082.714,108
"28269","86254","2018",9,9,0,105551.1,916,108.8889
"28270","86255","2018",10,10,0,80110,947.3,81
"28271","86256","2018",6,6,0,176758.3,1618.5,109.5
"28272","86257","2018",5,5,0,203400,1544.6,108
"28273","86258","2018",30,30,0,114887.8,1121.267,105.6
"28274","86260","2018",5,5,0,94380,1013,97.4
"28275","86261","2018",19,19,0,193873.8,1740.053,112.6842
"28276","86262","2018",11,11,0,103154.5,994.6364,111.7273
"28277","86263","2018",18,18,0,159992.5,1589.389,102.1667
"28278","86264","2018",5,5,0,110800,1173.2,93.4
"28279","86265","2018",2,2,0,131500,1408.5,94
"28280","86268","2018",16,16,0,142617.1,1424.25,103.875
"28281","86269","2018",1,1,0,157000,1189,132
"28282","86271","2018",9,9,0,112638.9,1031.889,105.7778
"28283","86272","2018",23,23,0,147980.4,1312.391,114.1739
"28284","86273","2018",12,12,0,100600.4,771.75,117.1667
"28285","86274","2018",9,9,0,142291.1,1419.556,123.1111
"28286","86275","2018",6,6,0,107400,1153.167,93.5
"28287","86276","2018",7,7,0,70121.43,727.5714,105.5714
"28288","86279","2018",13,13,0,101661.5,1061.769,94
"28289","86280","2018",6,6,0,127041.5,1064.833,109
"28290","86281","2018",56,55,1,146720.6,1370.393,108.9643
"28291","86284","2018",7,7,0,106908,1402,80.42857
"28292","86285","2018",18,18,0,104069.9,1035.778,101.2222
"28293","86286","2018",7,7,0,73714.29,951,81.71429
"28294","86287","2018",3,3,0,176000,1164,172
"28295","86288","2018",7,7,0,69792.86,838.8571,82.28571
"28296","86289","2018",12,12,0,101534.2,1050.917,93.5
"28297","86290","2018",13,12,1,138934.3,1610.462,86.61538
"28298","86291","2018",1,1,0,50000,556,90
"28299","86292","2018",7,7,0,197444.3,1731.143,111.7143
"28300","86293","2018",49,46,3,135701.4,1452.592,92.10204
"28301","86294","2018",37,37,0,165761.1,1500.865,112.8378
"28302","86295","2018",6,6,0,89358.33,915.5,101.3333
"28303","86296","2018",4,4,0,104000,1206.25,76.25
"28304","86297","2018",56,53,3,209206.2,1848.286,111.6964
"28305","86298","2018",29,26,3,120596.6,1575.138,98.96552
"28306","86299","2018",8,8,0,89875,1102.625,82.875
"28307","86300","2018",8,8,0,133543.8,1246.25,111.625
"28308","87001","2018",61,55,6,130524.7,1412.082,99.68852
"28309","87002","2018",58,56,2,125623.3,1212.914,108.5345
"28310","87003","2018",15,15,0,98497.6,1054.267,89.4
"28311","87004","2018",4,4,0,107250,647,173.25
"28312","87005","2018",13,13,0,208200,1964.308,114
"28313","87006","2018",6,6,0,52102.33,708.8333,74
"28314","87007","2018",3,3,0,48666.67,660.6667,70
"28315","87008","2018",1,1,0,68500,623,110
"28316","87009","2018",6,6,0,129041.8,1628.333,91.5
"28317","87011","2018",47,42,5,85973.4,888.8936,101.2553
"28318","87012","2018",4,4,0,79000,892,85.25
"28319","87013","2018",9,9,0,93800,1162.778,83.55556
"28320","87014","2018",18,18,0,91093.06,1292.111,85
"28321","87015","2018",9,9,0,132477.8,1103.778,123
"28322","87016","2018",3,3,0,73400,849.6667,90
"28323","87017","2018",1,1,0,27000,900,30
"28324","87018","2018",14,14,0,77531.79,821,95.42857
"28325","87019","2018",24,24,0,195223.5,1667.042,119.6667
"28326","87020","2018",19,19,0,151034.2,1540.789,100.1579
"28327","87021","2018",39,38,1,128320.5,1384.564,94.53846
"28328","87023","2018",3,3,0,46083.33,794,64.66667
"28329","87024","2018",17,17,0,73745.88,847.7059,93.17647
"28330","87025","2018",6,6,0,155881.7,1371.667,111.3333
"28331","87027","2018",25,25,0,94048.56,1063.08,93.48
"28332","87028","2018",35,35,0,77007.8,738.8857,106.2571
"28333","87029","2018",7,7,0,77067.86,841.7143,90.85714
"28334","87030","2018",9,9,0,112649.1,1110.222,105.2222
"28335","87031","2018",11,11,0,112896.4,1423.273,81.90909
"28336","87032","2018",18,17,1,75678.89,922.8333,83.55556
"28337","87033","2018",6,6,0,82716.17,827,99.33333
"28338","87034","2018",5,5,0,53360,743.6,74.4
"28339","87035","2018",5,5,0,80612,981.6,81.6
"28340","87036","2018",18,18,0,102446.1,1302.167,82.38889
"28341","87037","2018",2,2,0,54500,788,69
"28342","87038","2018",23,23,0,145212.3,1551.391,101.1739
"28343","87039","2018",10,10,0,111200,1391.8,78
"28344","87040","2018",24,24,0,74793.75,1065.458,85.33333
"28345","87041","2018",25,24,1,86872.8,969.36,93.8
"28346","87042","2018",2,2,0,72000,772,81.5
"28347","87043","2018",8,7,1,117534.4,1024.75,126.875
"28348","87044","2018",9,9,0,101507.8,944.3333,102.3333
"28349","87045","2018",16,16,0,109289.4,1451.438,84.4375
"28350","87046","2018",16,15,1,104221.9,1172.062,86.3125
"28351","87047","2018",16,16,0,94690.62,1232.938,77.625
"28352","87048","2018",60,45,15,140327,1578.083,88.66667
"28353","87049","2018",22,22,0,103446.1,1142.045,96.09091
"28354","87050","2018",84,71,13,156928.8,1669.988,96.21429
"28355","87051","2018",14,14,0,92428.57,962.4286,94.57143
"28356","87052","2018",2,2,0,87500,583.5,185
"28357","87053","2018",7,7,0,83526.57,1201.286,69
"28358","87054","2018",16,16,0,77528.12,933.8125,80.5
"28359","87056","2018",6,6,0,116316.7,966.6667,120.6667
"28360","87057","2018",6,6,0,103662.2,1190,98.83333
"28361","87058","2018",2,2,0,175000,1745.5,103.5
"28362","87059","2018",16,15,1,86084.06,1113.25,90.375
"28363","87060","2018",6,6,0,83208.33,882.8333,89
"28364","87061","2018",6,6,0,49488.33,487.6667,100.1667
"28365","87062","2018",5,5,0,90620,1104,79.8
"28366","87063","2018",11,11,0,108818.3,1383.182,81.72727
"28367","87064","2018",28,27,1,95138.21,1145.607,89.82143
"28368","87065","2018",54,54,0,174870.4,1665,107.1111
"28369","87066","2018",12,11,1,117504.2,1334.167,91
"28370","87067","2018",7,7,0,96407.14,1081.857,85.42857
"28371","87068","2018",8,8,0,177126.8,1370.125,90.875
"28372","87069","2018",3,3,0,84666.67,1073.667,85.33333
"28373","87070","2018",9,9,0,140388.9,1265.889,111.6667
"28374","87071","2018",9,9,0,147666.7,1499.111,94.55556
"28375","87072","2018",5,5,0,107180.2,1107,95
"28376","87073","2018",11,11,0,85339,1009.818,91.09091
"28377","87074","2018",1,1,0,80000,833,96
"28378","87075","2018",84,73,11,162837.6,1653.19,98.66667
"28379","87076","2018",3,3,0,32500,477.3333,70.33333
"28380","87077","2018",5,5,0,110832,1110.2,103
"28381","87078","2018",6,6,0,82608.33,886.3333,94.83333
"28382","87079","2018",19,17,2,107284.8,1045.368,103.5263
"28383","87080","2018",4,4,0,52875,862.75,59.75
"28384","87081","2018",10,10,0,150546.9,1417.8,106.3
"28385","87082","2018",16,15,1,77125,1094.625,73.4375
"28386","87083","2018",7,7,0,70728.57,837.1429,85.42857
"28387","87085","2018",1867,602,1265,106159.8,1429.467,73.07017
"28388","87086","2018",18,17,1,89408.33,1015.5,88.77778
"28389","87087","2018",8,8,0,89851.62,958.375,93.875
"28390","87088","2018",14,14,0,103086.4,1194,89.35714
"28391","87089","2018",12,12,0,78020.42,812.5833,94.58333
"28392","87090","2018",2,2,0,32500,631,64.5
"28393","87091","2018",5,5,0,65840,707.8,94.6
"28394","87092","2018",7,7,0,135853.6,1768.429,83.28571
"28395","87093","2018",5,5,0,128220,1046.8,113
"28396","87094","2018",6,6,0,140841.7,1493.833,87.66667
"28397","87095","2018",6,6,0,74491.67,1111.667,65.66667
"28398","87096","2018",12,12,0,87525,847,105
"28399","87097","2018",11,11,0,96077.55,968,94.72727
"28400","87099","2018",4,4,0,136609.2,1347.25,101
"28401","87100","2018",7,7,0,76207.14,873.4286,85.71429
"28402","87101","2018",3,3,0,68666.67,660.3333,93.66667
"28403","87103","2018",16,16,0,95881.25,973.75,95.125
"28404","87104","2018",7,7,0,59500.86,838.7143,73.71429
"28405","87105","2018",13,12,1,84003.85,986.3077,89
"28406","87106","2018",22,21,1,134981.8,1483.545,94.95455
"28407","87107","2018",17,16,1,154511.3,1446.882,113.4118
"28408","87108","2018",7,7,0,76400,827,100.7143
"28409","87109","2018",8,8,0,185040.9,1182.25,126.5
"28410","87110","2018",24,24,0,125652.9,1411.333,92.16667
"28411","87111","2018",16,16,0,73442.94,894.5625,89.0625
"28412","87112","2018",6,6,0,120210.8,1045.833,111.8333
"28413","87113","2018",50,49,1,150752,1636.68,95.08
"28414","87114","2018",110,101,9,155245.5,1604.155,97.22727
"28415","87115","2018",5,5,0,148400,1235.4,117
"28416","87116","2018",10,10,0,77583.3,1018.8,76.6
"28417","87117","2018",16,16,0,86102.88,1021.688,89.5
"28418","87118","2018",16,16,0,119436,1219.688,100.9375
"28419","87119","2018",13,13,0,86384.62,1018.385,82.84615
"28420","87120","2018",8,8,0,98151.38,1061.875,96.625
"28421","87121","2018",6,6,0,93810,988.1667,93.16667
"28422","87122","2018",14,13,1,110665.2,1319,80.07143
"28423","87123","2018",2,2,0,66075,678,97.5
"28424","87124","2018",5,5,0,115260,1045.6,100
"28425","87125","2018",50,49,1,159995.9,1693.82,103.38
"28426","87126","2018",49,48,1,97858.16,976.7755,101.4286
"28427","87127","2018",5,5,0,85400,719.8,113.8
"28428","87128","2018",22,22,0,90709.09,1096.364,82.31818
"28429","87129","2018",11,11,0,129813.6,1377.455,94.18182
"28430","87130","2018",2,2,0,55750,658,85
"28431","87131","2018",15,15,0,104172.3,1037.867,102.8667
"28432","87132","2018",2,2,0,82032.5,557.5,159
"28433","87133","2018",5,5,0,96620,932.2,107
"28434","87135","2018",11,11,0,92156.36,1016.909,92.81818
"28435","87138","2018",7,7,0,108628.6,935.5714,119.7143
"28436","87139","2018",6,6,0,46166.67,704,65.5
"28437","87141","2018",6,6,0,98156.67,1307.667,76.83333
"28438","87142","2018",12,12,0,111916.7,1310.833,89.41667
"28439","87143","2018",17,16,1,153726.1,1399.529,123.2941
"28440","87144","2018",6,6,0,127216.5,1154.333,117.8333
"28441","87145","2018",5,5,0,90200,1427.8,74
"28442","87146","2018",16,16,0,110904.8,994.5,108.75
"28443","87147","2018",1,1,0,85000,924,92
"28444","87148","2018",10,10,0,151684,1408,113.8
"28445","87149","2018",1,1,0,66825,703,95
"28446","87150","2018",10,10,0,113640,1242.5,103.3
"28447","87151","2018",3,3,0,94553.33,1187,74.33333
"28448","87152","2018",24,24,0,124779.2,1388.917,92.45833
"28449","87153","2018",7,6,1,49857.14,861.4286,62.71429
"28450","87154","2018",125,114,11,115972.9,1249.744,96.752
"28451","87156","2018",18,18,0,145675.4,1504.611,99.5
"28452","87157","2018",10,10,0,120390,1219.3,107.1
"28453","87158","2018",6,6,0,99608.33,971,98.66667
"28454","87159","2018",6,6,0,66466.67,741.6667,90.16667
"28455","87160","2018",9,9,0,83432.78,901.5556,93.88889
"28456","87161","2018",54,47,7,107910.9,1189.444,89.74074
"28457","87162","2018",2,2,0,125700,1283,96.5
"28458","87163","2018",4,4,0,49000,692,81.5
"28459","87164","2018",13,13,0,151803.8,1457.846,113.5385
"28460","87165","2018",3,3,0,79840,747.6667,117
"28461","87166","2018",8,8,0,159151.6,1990.125,82.125
"28462","87167","2018",11,11,0,124436.5,1324.636,94
"28463","87168","2018",16,16,0,96512.5,925,101.375
"28464","87169","2018",1,1,0,68500,714,96
"28465","87170","2018",7,7,0,81421.43,1142.714,67.28571
"28466","87172","2018",2,2,0,47800,876,51.5
"28467","87174","2018",14,14,0,118666.4,1153.214,103.2857
"28468","87176","2018",6,6,0,154266.7,1288.167,121.8333
"28469","87177","2018",18,18,0,115323.9,1290.556,93.05556
"28470","87178","2018",32,30,2,125846.9,1343.656,94.1875
"28471","87179","2018",6,6,0,125142.2,895.6667,128.1667
"28472","87180","2018",4,4,0,77750,795.25,90.75
"28473","87181","2018",16,16,0,70500,822.4375,94.3125
"28474","87182","2018",11,11,0,88400,871.9091,97.27273
"28475","87183","2018",14,13,1,102317.6,1108.929,87.64286
"28476","87185","2018",27,27,0,119561.1,1181.741,102.6296
"28477","87186","2018",8,8,0,105616.1,1433.625,78.875
"28478","87187","2018",85,76,9,96321.04,1021.941,96.64706
"28479","87188","2018",7,7,0,131710,1267.571,102.4286
"28480","87189","2018",7,7,0,86057.14,994.2857,92
"28481","87190","2018",9,9,0,93088.89,933.6667,100.6667
"28482","87191","2018",28,28,0,125734.6,1330.571,101.5714
"28483","87192","2018",9,9,0,175588.9,1497.889,123.5556
"28484","87193","2018",1,1,0,150000,1304,115
"28485","87194","2018",6,6,0,101114.2,1322.833,85.66667
"28486","87195","2018",2,2,0,60500,619,97.5
"28487","87197","2018",6,6,0,101891.7,977.6667,114.1667
"28488","87198","2018",10,10,0,105410.1,1029.7,95.2
"28489","87199","2018",16,16,0,119162.5,1171.938,98.5
"28490","87200","2018",2,2,0,21500,418.5,51.5
"28491","87201","2018",40,40,0,178068.5,1679.5,111.825
"28492","87202","2018",17,17,0,150661.8,1407,108.1765
"28493","87203","2018",12,12,0,112925,1207.25,99.25
"28494","87204","2018",4,4,0,108075,922,126.5
"28495","87205","2018",24,24,0,167135.4,1549.208,109.4167
"28496","87206","2018",3,3,0,62333.33,858.6667,80
"28497","88002","2018",2,2,0,116000,831,143.5
"28498","88003","2018",1,1,0,30139,377,80
"28499","88005","2018",1,1,0,55000,1279,43
"28500","88006","2018",3,3,0,115000,812,136.3333
"28501","88007","2018",1,1,0,85000,914,93
"28502","88008","2018",2,1,1,69250,795.5,83
"28503","88009","2018",33,32,1,129471.8,1365.545,100.1212
"28504","88010","2018",1,1,0,72300,482,150
"28505","88011","2018",22,19,3,143589.1,1339,109
"28506","88012","2018",6,6,0,123500,1330,91.33333
"28507","88013","2018",1,1,0,48000,615,78
"28508","88014","2018",2,2,0,80500,858.5,95
"28509","88015","2018",4,4,0,55225,481.5,114.25
"28510","88016","2018",3,3,0,129900,1196.333,109.3333
"28511","88019","2018",1,1,0,82500,688,120
"28512","88020","2018",1,1,0,156350,1117,140
"28513","88021","2018",3,3,0,79526.67,903.6667,94
"28514","88024","2018",1,1,0,160300,802,200
"28515","88026","2018",7,7,0,116914.3,1426.857,80.71429
"28516","88028","2018",4,3,1,133982.5,1461.5,91
"28517","88029","2018",9,8,1,82805.56,961,88.11111
"28518","88032","2018",11,11,0,117919.1,1329.636,90.63636
"28519","88033","2018",1,1,0,130000,929,140
"28520","88035","2018",3,3,0,161666.7,2511.667,63
"28521","88037","2018",3,2,1,77953.33,1654.333,49
"28522","88039","2018",1,1,0,80700,897,90
"28523","88041","2018",3,2,1,116600,1014.333,130.3333
"28524","88042","2018",2,2,0,117000,1018.5,116.5
"28525","88043","2018",4,4,0,81750,890.25,89.5
"28526","88044","2018",8,8,0,101875,926.875,109.375
"28527","88046","2018",1,1,0,35000,368,95
"28528","88048","2018",6,6,0,86683.33,808.8333,119.1667
"28529","88049","2018",1,1,0,23690,515,46
"28530","88050","2018",5,5,0,87980,1520.8,60
"28531","88051","2018",2,2,0,46500,641.5,76
"28532","88052","2018",1,1,0,60000,800,75
"28533","88053","2018",3,3,0,71566.67,845,84.33333
"28534","88054","2018",6,6,0,168091.7,1803.5,101.8333
"28535","88055","2018",1,1,0,35000,350,100
"28536","88059","2018",6,6,0,94333.33,841.6667,110.6667
"28537","88061","2018",1,1,0,143500,652,220
"28538","88062","2018",1,1,0,50000,625,80
"28539","88063","2018",1,1,0,1e+05,709,141
"28540","88064","2018",1,1,0,150000,3750,40
"28541","88065","2018",2,2,0,47500,502,94
"28542","88066","2018",1,1,0,172500,964,179
"28543","88068","2018",12,12,0,116813.3,1789.75,77.41667
"28544","88069","2018",2,2,0,211000,1409.5,161.5
"28545","88070","2018",1,1,0,121000,1344,90
"28546","88071","2018",1,1,0,55000,887,62
"28547","88073","2018",1,1,0,160090,1074,149
"28548","88074","2018",1,1,0,61000,355,172
"28549","88075","2018",113,46,67,121578.4,1840.973,69.59292
"28550","88076","2018",6,6,0,68916.67,842.6667,83.16667
"28551","88077","2018",3,3,0,125333.3,855.6667,154.3333
"28552","88078","2018",30,26,4,112113.3,925.3,119.1
"28553","88079","2018",9,9,0,143719.3,1418.222,101.4444
"28554","88080","2018",1,1,0,217500,1002,217
"28555","88081","2018",17,13,4,120832.6,1587.176,83
"28556","88082","2018",9,8,1,85970,911,105.4444
"28557","88084","2018",3,3,0,89333.33,1169.667,70.33333
"28558","88085","2018",8,8,0,131175,1655.375,79.625
"28559","88086","2018",3,3,0,143833.3,1343,105
"28560","88087","2018",57,31,26,115909.6,1255.667,87.42105
"28561","88088","2018",6,6,0,73133.33,659.8333,116.8333
"28562","88089","2018",9,9,0,83206.67,811.4444,102.5556
"28563","88090","2018",53,38,15,108291,1160.283,91.39623
"28564","88091","2018",3,3,0,80333.33,775,105.6667
"28565","88092","2018",7,7,0,82685.71,995.4286,80.71429
"28566","88093","2018",1,1,0,80700,1091,74
"28567","88094","2018",5,5,0,149400,1017.8,161
"28568","88095","2018",14,14,0,87866.43,791.3571,107.5714
"28569","88096","2018",1,1,0,39500,359,110
"28570","88099","2018",11,8,3,153542.8,1684.364,94.18182
"28571","88101","2018",8,8,0,102750,1110.5,95.5
"28572","88103","2018",1,1,0,59000,615,96
"28573","88104","2018",1,1,0,124500,1368,91
"28574","88105","2018",2,2,0,61000,752,90.5
"28575","88106","2018",17,16,1,136649.4,1982.706,77.41176
"28576","88108","2018",12,11,1,74526.17,851,92.08333
"28577","88109","2018",2,2,0,133000,1312.5,117
"28578","88113","2018",3,3,0,127000,1353,95
"28579","88114","2018",23,15,8,96132.61,1193.739,79.78261
"28580","88115","2018",19,14,5,96797.37,1145.789,94.63158
"28581","88116","2018",33,21,12,97275,1169.727,92.72727
"28582","88118","2018",8,8,0,91531.25,910,107.5
"28583","88119","2018",5,5,0,103700,1071,99.4
"28584","88120","2018",3,2,1,63333.33,934.6667,65.66667
"28585","88121","2018",1,1,0,50000,485,103
"28586","88122","2018",1,1,0,117000,775,151
"28587","88123","2018",2,2,0,30215,347.5,87.5
"28588","88124","2018",8,7,1,55232.25,572.125,101.5
"28589","88125","2018",1,1,0,70450,719,98
"28590","88126","2018",13,11,2,149530.8,1479.538,102.6923
"28591","88128","2018",1,1,0,107400,707,152
"28592","88130","2018",1,1,0,179000,1346,133
"28593","88131","2018",2,2,0,101250,927.5,109
"28594","88132","2018",14,13,1,125928.6,1210.429,119.0714
"28595","88133","2018",2,2,0,157200,1448,112.5
"28596","88134","2018",7,7,0,139450,1341,106.7143
"28597","88135","2018",12,12,0,87316.67,885.0833,102
"28598","88136","2018",13,11,2,163492.3,1359.308,121.5385
"28599","88139","2018",3,3,0,108333.3,863,128
"28600","88140","2018",4,4,0,141091.2,1031.25,139.25
"28601","88141","2018",2,2,0,100500,809.5,124.5
"28602","88142","2018",5,5,0,145100,1506.4,109
"28603","88143","2018",2,2,0,98500,776,114.5
"28604","88145","2018",4,3,1,87000,1002,87.25
"28605","88146","2018",1,1,0,95000,699,136
"28606","88147","2018",3,3,0,175000,1290.333,142.6667
"28607","88148","2018",14,12,2,112635,1089.286,107.5714
"28608","88150","2018",2,1,1,359000,6648.5,98
"28609","88151","2018",9,9,0,86977.78,1044.222,83.11111
"28610","88153","2018",6,6,0,104686.7,854.8333,122.1667
"28611","88154","2018",3,3,0,124623.3,919.3333,123
"28612","88156","2018",2,2,0,112075,902.5,121.5
"28613","88157","2018",5,5,0,151800,1092.6,133.8
"28614","88158","2018",32,20,12,114147.1,1150.344,98.125
"28615","88159","2018",5,5,0,143300,1410.4,101
"28616","88160","2018",403,170,233,104530.6,1223.362,85.80149
"28617","88161","2018",3,2,1,124333.3,1025,119.3333
"28618","88162","2018",1,1,0,30000,333,90
"28619","88163","2018",12,12,0,135725,1270.583,107.6667
"28620","88165","2018",28,27,1,133152.9,1282.464,104.6429
"28621","88166","2018",1,1,0,205000,1881,109
"28622","88167","2018",1,1,0,167000,1898,88
"28623","88169","2018",1,1,0,101000,1148,88
"28624","88170","2018",6,6,0,104166.7,927.5,110.8333
"28625","88172","2018",2,2,0,80000,912,89
"28626","88173","2018",5,5,0,162844,1423.2,122.4
"28627","88174","2018",2,1,1,82000,714.5,130
"28628","88175","2018",1,1,0,116000,967,120
"28629","88176","2018",7,7,0,71091.43,680.1429,100.1429
"28630","88177","2018",7,7,0,149811.4,1310.143,125.7143
"28631","88178","2018",17,16,1,167791.2,1641.647,103.0588
"28632","88179","2018",1,1,0,33000,412,80
"28633","88180","2018",1,1,0,35000,427,82
"28634","88181","2018",34,27,7,101277.6,1224.206,85.97059
"28635","88182","2018",3,3,0,107000,806,129
"28636","88183","2018",1,1,0,143400,478,300
"28637","88184","2018",5,5,0,119421,799.6,144.8
"28638","88185","2018",2,2,0,117500,715.5,155.5
"28639","88188","2018",12,11,1,96658.33,1123.917,88.83333
"28640","88189","2018",2,2,0,60025,472.5,127
"28641","88190","2018",1,1,0,161320,1494,108
"28642","88193","2018",1,1,0,107000,1029,104
"28643","88195","2018",1,1,0,40000,400,100
"28644","88196","2018",228,72,156,146635.7,2200.439,69.86842
"28645","88197","2018",2,2,0,99920,2068,47.5
"28646","88198","2018",7,7,0,197457.1,1992.143,111.4286
"28647","88200","2018",1,1,0,139800,999,140
"28648","88201","2018",11,11,0,154925.2,1421.455,113.1818
"28649","88203","2018",2,2,0,108000,949.5,113.5
"28650","88205","2018",1,1,0,80000,1270,63
"28651","88206","2018",9,8,1,72635,670.4444,110.1111
"28652","88208","2018",2,2,0,69295,829,79
"28653","88209","2018",82,35,47,105470.7,1284.146,82.36585
"28654","88210","2018",2,2,0,117900,952.5,120.5
"28655","88212","2018",5,5,0,53000,437.2,125.6
"28656","88213","2018",3,3,0,171466.7,1090,153.6667
"28657","88215","2018",1,1,0,123700,1606,77
"28658","88216","2018",8,8,0,119025,903.25,131.875
"28659","88218","2018",19,17,2,92292.95,898.0526,106.0526
"28660","88219","2018",3,3,0,53333.33,663.6667,79.33333
"28661","88221","2018",3,3,0,47666.67,447,103
"28662","88222","2018",3,3,0,130633.3,951.6667,137.3333
"28663","88223","2018",1,1,0,65000,631,103
"28664","88224","2018",3,3,0,109800,1037.333,110
"28665","88225","2018",14,14,0,143046.4,1253.143,114.4286
"28666","88228","2018",3,3,0,60866.67,609.6667,117
"28667","88229","2018",1,1,0,51583,737,70
"28668","88231","2018",2,2,0,140000,1193.5,119
"28669","88232","2018",2,2,0,84250,582,133
"28670","88233","2018",3,3,0,142550,879.3333,176.3333
"28671","88236","2018",1,1,0,175000,2692,65
"28672","88237","2018",4,4,0,197012.8,1206.5,170.75
"28673","88238","2018",3,3,0,106783.3,1281.667,94.66667
"28674","88240","2018",2,2,0,146500,1540,95
"28675","88241","2018",7,6,1,92874.29,700.8571,134.1429
"28676","88243","2018",3,3,0,65000,779.6667,84.33333
"28677","88244","2018",3,3,0,109666.7,1295.667,84.66667
"28678","88245","2018",3,3,0,229166.7,2196.333,105.3333
"28679","88246","2018",2,2,0,92500,1090,86
"28680","88247","2018",8,7,1,138715,1417.625,107.75
"28681","88248","2018",2,2,0,64265,758,95
"28682","88250","2018",3,2,1,123833.3,1094.333,102
"28683","88251","2018",12,11,1,95108.75,961,104.75
"28684","88253","2018",4,3,1,110400,1198.25,100
"28685","88254","2018",1,1,0,176000,978,180
"28686","88256","2018",3,3,0,103789.3,754.3333,135
"28687","88257","2018",2,2,0,115400,1107,104.5
"28688","88258","2018",7,7,0,63692.86,602.1429,102.5714
"28689","88259","2018",1,1,0,120000,1000,120
"28690","88260","2018",2,2,0,92000,862.5,107.5
"28691","88261","2018",8,8,0,150500,1141.25,140.125
"28692","88262","2018",7,4,3,72928.57,777.2857,99.57143
"28693","88263","2018",9,9,0,127351.7,1638.222,82.11111
"28694","88266","2018",11,7,4,77754.55,765,92.81818
"28695","88267","2018",2,2,0,123540,1167,108.5
"28696","88268","2018",3,3,0,104000,1114,94
"28697","88269","2018",12,12,0,157815.8,2410.917,77.41667
"28698","88270","2018",11,11,0,63681.82,699.8182,96.27273
"28699","88272","2018",1,1,0,73000,652,112
"28700","88273","2018",3,3,0,144500,962,146.3333
"28701","88275","2018",2,2,0,169045,1591,109
"28702","88276","2018",3,2,1,97166.67,1480.333,71.66667
"28703","88277","2018",3,3,0,64333.33,691.6667,100.3333
"28704","88278","2018",1,1,0,48000,828,58
"28705","88281","2018",3,3,0,126000,1321.333,102.6667
"28706","88283","2018",1,1,0,137500,557,247
"28707","88284","2018",4,4,0,116000,1279.5,95
"28708","88285","2018",2,2,0,80000,739,110.5
"28709","88286","2018",1,1,0,125000,1078,116
"28710","88289","2018",6,6,0,103633.3,752.3333,131.3333
"28711","88290","2018",1,1,0,65000,1016,64
"28712","88291","2018",3,3,0,65800,551.6667,118.6667
"28713","88292","2018",5,5,0,135200,919.8,164.8
"28714","88293","2018",3,3,0,85500,1009,90
"28715","88294","2018",3,3,0,133000,1176.333,125.6667
"28716","88295","2018",4,4,0,75002.5,721,104.25
"28717","88296","2018",3,3,0,60583.33,511.3333,118.3333
"28718","88297","2018",3,3,0,112300,779.6667,128
"28719","88298","2018",1,1,0,108000,1241,87
"28720","88299","2018",1,1,0,75000,701,107
"28721","88300","2018",2,2,0,78500,579.5,134.5
"28722","88301","2018",3,3,0,110400,1083,106.6667
"28723","88302","2018",14,11,3,143900.1,1363.857,119.3571
"28724","88303","2018",2,2,0,96117.5,635,150
"28725","88304","2018",34,23,11,91627.35,918.4118,96.73529
"28726","88305","2018",1,1,0,150000,1172,128
"28727","88308","2018",4,4,0,75500,835.25,85.25
"28728","88309","2018",1,1,0,186000,1292,144
"28729","88310","2018",2,2,0,55184.5,804,67.5
"28730","88311","2018",1,1,0,65000,1182,55
"28731","88312","2018",1,1,0,105000,1221,86
"28732","88313","2018",5,4,1,109930,922.2,128.8
"28733","88314","2018",1,1,0,110440,1241,89
"28734","88315","2018",4,4,0,82500,1115.75,74.5
"28735","88316","2018",1,1,0,71500,953,75
"28736","88317","2018",3,3,0,72833.33,834,84
"28737","88318","2018",2,2,0,89640,670,131
"28738","88319","2018",37,35,2,96112.84,1063.081,89.43243
"28739","88320","2018",12,12,0,104466.7,1017.667,103.5
"28740","88321","2018",64,53,11,89963.91,1007.562,92.51562
"28741","88322","2018",2,2,0,80000,960,84
"28742","88324","2018",6,5,1,85266.67,738.8333,107.8333
"28743","88327","2018",13,13,0,94225,1146.231,88.23077
"28744","88328","2018",2,1,1,56500,708.5,80
"28745","88330","2018",1,1,0,190000,860,221
"28746","88332","2018",1,1,0,59000,670,88
"28747","88333","2018",2,2,0,138740,853,163.5
"28748","88334","2018",1,1,0,76000,691,110
"28749","88335","2018",1,1,0,124000,1088,114
"28750","88336","2018",1,1,0,25000,352,71
"28751","88338","2018",1,1,0,35000,330,106
"28752","88340","2018",7,7,0,140384.9,1226,113.5714
"28753","88341","2018",4,3,1,159075,1349.25,125
"28754","88343","2018",2,2,0,149258,1030.5,179.5
"28755","88344","2018",4,4,0,101575,959.5,105.5
"28756","88345","2018",3,3,0,90833.33,789.6667,116
"28757","88346","2018",10,10,0,100259,1117,101.1
"28758","88347","2018",2,2,0,79975,1192,69
"28759","88349","2018",25,17,8,106032.6,1233.24,82.44
"28760","88351","2018",25,16,9,94968,1267.24,87.8
"28761","88354","2018",1,1,0,55000,1058,52
"28762","88355","2018",14,14,0,127678.6,1164,105.8571
"28763","88356","2018",6,6,0,71701.33,894.8333,80.16667
"28764","88357","2018",6,6,0,114433.3,885.3333,124.6667
"28765","88358","2018",16,13,3,121070,1249,98.6875
"28766","88359","2018",2,2,0,147500,1361,116
"28767","88360","2018",1,1,0,93000,715,130
"28768","88361","2018",21,20,1,92494.05,1079.429,95.85714
"28769","88362","2018",2,2,0,89500,1251,73.5
"28770","88363","2018",3,3,0,144696.7,1152.667,129
"28771","88365","2018",1,1,0,45000,938,48
"28772","88366","2018",3,3,0,61666.67,502.3333,114
"28773","88367","2018",35,29,6,86274.69,928.8286,94.85714
"28774","88368","2018",1,1,0,59000,546,108
"28775","88369","2018",16,15,1,139447.4,1201.375,118.9375
"28776","88371","2018",12,12,0,114664,1253.583,94.66667
"28777","88372","2018",53,45,8,93185.75,973.2264,96.49057
"28778","88375","2018",2,2,0,112500,1183,89
"28779","88376","2018",1,1,0,35000,473,74
"28780","88379","2018",5,5,0,116120,1174.4,96.4
"28781","88380","2018",2,2,0,80500,1622,52.5
"28782","88383","2018",125,28,97,90911.96,1080.096,85.36
"28783","88385","2018",2,2,0,95000,1028.5,88.5
"28784","88386","2018",6,6,0,122611.7,1021.833,126.8333
"28785","88387","2018",1,1,0,85000,955,89
"28786","88388","2018",1,1,0,120000,750,160
"28787","88389","2018",1,1,0,158700,1571,101
"28788","88390","2018",1,1,0,34000,378,90
"28789","88391","2018",14,13,1,134981.8,1585.214,89.35714
"28790","88395","2018",4,4,0,108137.5,915.75,122
"28791","88398","2018",1,1,0,120000,1000,120
"28792","88401","2018",3,3,0,133166.7,941.6667,134
"28793","88402","2018",1,1,0,120000,845,142
"28794","88403","2018",1,1,0,99000,678,146
"28795","88404","2018",1,1,0,33800,422,80
"28796","88406","2018",3,3,0,73746.67,831,81.33333
"28797","88407","2018",3,3,0,115446.7,1073.333,102.3333
"28798","88408","2018",32,26,6,96161.97,1025.125,96.1875
"28799","88409","2018",21,17,4,119396.4,1268.476,95.80952
"28800","88410","2018",5,5,0,79200,781.4,97.8
"28801","88411","2018",3,3,0,79166.67,859.6667,89
"28802","88412","2018",4,4,0,122457.5,1176.25,103
"28803","88413","2018",211,96,115,99131.79,1033.005,95.33175
"28804","88415","2018",46,34,12,110110.7,1227.109,90.95652
"28805","88417","2018",4,4,0,89144.25,933,100.5
"28806","88418","2018",6,6,0,109333.3,1027.833,103.6667
"28807","88419","2018",3,3,0,89000,893.6667,96
"28808","88421","2018",1,1,0,55000,579,95
"28809","88423","2018",16,15,1,128289.8,1230.75,103.75
"28810","88424","2018",22,19,3,109088.6,1258.545,88.54545
"28811","88425","2018",2,2,0,173000,1228.5,145
"28812","88426","2018",26,23,3,135201.4,1425.231,100.5
"28813","88428","2018",14,9,5,110250.7,992,121
"28814","88429","2018",30,28,2,145906,1332.867,109
"28815","88430","2018",4,4,0,134675,950.5,143
"28816","88431","2018",1,1,0,153600,1371,112
"28817","88432","2018",1,1,0,80900,632,128
"28818","88434","2018",1,1,0,70000,1094,64
"28819","88435","2018",3,3,0,165766.7,1235,134
"28820","88436","2018",2,2,0,80000,1371,73
"28821","88437","2018",1,1,0,70000,729,96
"28822","88438","2018",7,7,0,177135.7,1284,140.7143
"28823","88439","2018",9,9,0,157666.7,2413.333,101.7778
"28824","88441","2018",1,1,0,199500,1295,154
"28825","88442","2018",8,8,0,141386.2,1494.75,100.625
"28826","88443","2018",2,2,0,83000,636.5,124.5
"28827","88444","2018",1,1,0,128370,665,193
"28828","88445","2018",25,23,2,157600.3,1326.76,119.6
"28829","88446","2018",2,2,0,83500,735.5,106
"28830","88447","2018",23,21,2,108618.6,1166.348,93.21739
"28831","88448","2018",1,1,0,38000,792,48
"28832","88451","2018",19,15,4,69750.21,748.7895,96.63158
"28833","88452","2018",1,1,0,98000,503,195
"28834","88454","2018",1,1,0,72000,867,83
"28835","88456","2018",1,1,0,77500,934,83
"28836","88457","2018",3,3,0,128266.7,923.3333,143.3333
"28837","88458","2018",2,2,0,188250,1228,159
"28838","88459","2018",1,1,0,30000,698,43
"28839","88460","2018",9,9,0,127529.3,1171.667,109.7778
"28840","88461","2018",2,2,0,122000,1111.5,129.5
"28841","88462","2018",19,19,0,119383.2,1321.789,96.89474
"28842","88463","2018",22,21,1,128364.5,1332.5,96.09091
"28843","88464","2018",4,4,0,141825,1222.25,121.5
"28844","88465","2018",91,71,20,107660.3,1196.33,89.35165
"28845","88466","2018",2,2,0,79000,3927.5,46
"28846","88467","2018",7,7,0,89965.71,734.8571,126.7143
"28847","88468","2018",35,32,3,129839.7,1229.543,110.3429
"28848","88470","2018",31,15,16,94523.97,1492.065,71.93548
"28849","88471","2018",1,1,0,58150,447,130
"28850","88472","2018",2,2,0,60500,560.5,111
"28851","88474","2018",1,1,0,50000,625,80
"28852","88476","2018",1,1,0,36100,410,88
"28853","88479","2018",1,1,0,98000,594,165
"28854","88480","2018",1,1,0,156520,1550,101
"28855","88481","2018",11,10,1,127318.2,1652.909,101.0909
"28856","88483","2018",17,17,0,193655.3,1566.412,126.1176
"28857","88484","2018",9,9,0,136543,1381.556,103.1111
"28858","88485","2018",2,2,0,132025,874,148.5
"28859","88486","2018",39,30,9,117038.5,1359.923,92.69231
"28860","88487","2018",34,34,0,117666.5,1134.647,106.8529
"28861","88488","2018",4,4,0,114250,831.75,130.5
"28862","88489","2018",2,2,0,101500,903,111.5
"28863","88490","2018",1,1,0,55000,598,92
"28864","88491","2018",1,1,0,128250,1336,96
"28865","88492","2018",5,5,0,149200,1321.2,119.2
"28866","88495","2018",1,1,0,54000,346,156
"28867","88496","2018",1,1,0,52000,520,100
"28868","88497","2018",6,6,0,110699.8,1036.667,115.1667
"28869","88498","2018",1,1,0,110000,821,134
"28870","88499","2018",1,1,0,50000,625,80
"28871","88500","2018",10,7,3,104515,1334.4,102.9
"28872","88501","2018",1,1,0,120000,1500,80
"28873","88503","2018",1,1,0,59000,421,140
"28874","88504","2018",1,1,0,19000,373,51
"28875","88505","2018",2,2,0,72650,1678.5,52
"28876","88506","2018",2,2,0,108500,857,128
"28877","88507","2018",2,2,0,125350,1359,92
"28878","88508","2018",4,4,0,129012.5,1372.25,111
"28879","88509","2018",1,1,0,111000,1442,77
"28880","88511","2018",1,1,0,25000,490,51
"28881","88512","2018",3,3,0,152000,1331.333,143
"28882","88513","2018",29,28,1,113269.3,1228.828,94.44828
"28883","88514","2018",2,2,0,120250,970,139
"28884","88515","2018",3,3,0,66366.67,636.3333,102
"28885","88516","2018",64,31,33,92760.58,1089.469,85.26562
"28886","88517","2018",2,2,0,142100,1458,97.5
"28887","88519","2018",6,6,0,170141.7,1434.5,122.8333
"28888","88520","2018",3,2,1,156533.3,1612,97
"28889","88521","2018",3,3,0,78166.67,840.6667,97.66667
"28890","88522","2018",1,1,0,70000,490,143
"28891","88523","2018",2,2,0,80375,842.5,91
"28892","88524","2018",3,3,0,103666.7,850.3333,123
"28893","88525","2018",3,3,0,91750,703.3333,122.6667
"28894","88526","2018",9,9,0,83555.56,1314.667,67.44444
"28895","88527","2018",1,1,0,54500,574,95
"28896","88528","2018",2,2,0,93500,1668.5,57
"28897","88529","2018",1,1,0,80500,592,136
"28898","88530","2018",24,24,0,123757.1,1033.542,126.0417
"28899","88531","2018",47,26,21,146101.2,1992.447,76.02128
"28900","89003","2018",41,40,1,126393.1,1370.951,94.29268
"28901","89004","2018",4,4,0,57750,654.25,86.5
"28902","89005","2018",3,3,0,81000,927.6667,91
"28903","89006","2018",2,2,0,106578,931.5,116
"28904","89007","2018",7,7,0,78357.14,885.7143,88.85714
"28905","89008","2018",2,2,0,97500,1007,100.5
"28906","89009","2018",6,6,0,149911,1239.167,120.8333
"28907","89010","2018",3,3,0,53833.33,676,80.66667
"28908","89012","2018",1,1,0,170000,1104,154
"28909","89013","2018",42,41,1,134512.8,1559.81,86.61905
"28910","89014","2018",9,9,0,76849.89,953.8889,84.33333
"28911","89015","2018",9,9,0,90994.44,1097.222,95.66667
"28912","89016","2018",1,1,0,69000,945,73
"28913","89017","2018",2,2,0,65000,1093,58.5
"28914","89018","2018",15,15,0,102400,1259.067,85.4
"28915","89019","2018",4,4,0,59125,805,80.5
"28916","89020","2018",3,3,0,47333.33,665.6667,73.66667
"28917","89021","2018",5,5,0,104000,1029.4,100.2
"28918","89022","2018",2,2,0,142500,1188.5,121
"28919","89023","2018",13,13,0,134265.4,1516.769,86.69231
"28920","89024","2018",504,237,267,121440,1603.806,76.00794
"28921","89025","2018",75,54,21,114591.2,1223.72,99.36
"28922","89027","2018",2,2,0,100250,991,127
"28923","89028","2018",1,1,0,55000,1833,30
"28924","89029","2018",10,10,0,122850,1361.4,93.6
"28925","89030","2018",7,7,0,110385.7,1110.429,100.4286
"28926","89031","2018",8,8,0,121687.5,1481.5,84.375
"28927","89032","2018",1,1,0,115000,1575,73
"28928","89033","2018",4,4,0,108500,974.75,111.75
"28929","89034","2018",7,7,0,139900,1343.571,100
"28930","89035","2018",2,2,0,126000,1262.5,96.5
"28931","89036","2018",2,2,0,185600,863.5,196
"28932","89037","2018",6,6,0,92333.33,871.8333,115.5
"28933","89038","2018",1,1,0,85000,1090,78
"28934","89039","2018",2,2,0,122000,1089,112
"28935","89040","2018",1,1,0,75000,926,81
"28936","89042","2018",3,3,0,77333.33,1037.667,89
"28937","89043","2018",1,1,0,67000,416,161
"28938","89044","2018",3,3,0,73166.67,966.3333,74.66667
"28939","89045","2018",4,4,0,108800,1165.25,88.25
"28940","89046","2018",22,22,0,69543.18,927.2273,80.31818
"28941","89048","2018",10,10,0,163019.6,1261.4,134.5
"28942","89049","2018",1,1,0,128400,988,130
"28943","89050","2018",9,8,1,111888.9,1304.333,84.22222
"28944","89051","2018",6,6,0,111833.3,1485.5,74.66667
"28945","89053","2018",5,5,0,107000,1124.2,93.6
"28946","89054","2018",25,25,0,136671.8,1445.48,96.64
"28947","89055","2018",25,23,2,101920,1145.32,87.24
"28948","89056","2018",6,6,0,110666.7,1079.833,104.6667
"28949","89057","2018",3,3,0,130956.7,1048.667,121.6667
"28950","89058","2018",2,2,0,155132.5,995.5,158
"28951","89059","2018",7,7,0,83714.29,1068.286,80.71429
"28952","89060","2018",10,10,0,96314,1207.9,82.7
"28953","89061","2018",6,6,0,130325,1103.833,116.1667
"28954","89062","2018",1,1,0,57000,422,135
"28955","89063","2018",15,15,0,122201.7,1414.867,93.6
"28956","89064","2018",1,1,0,132000,1073,123
"28957","89065","2018",1,1,0,175000,1336,131
"28958","89066","2018",8,8,0,101935,1152.625,85.75
"28959","89067","2018",13,13,0,105190,1122.385,92.53846
"28960","89068","2018",36,33,3,147950.9,1679.667,91
"28961","89069","2018",8,8,0,70451.88,637.625,110.25
"28962","89072","2018",4,4,0,91251.75,979.75,98.5
"28963","89073","2018",17,17,0,83994.53,1171.824,76.70588
"28964","89074","2018",31,31,0,138843.5,1681.645,90.32258
"28965","89075","2018",6,6,0,133203.3,1371,100.6667
"28966","89076","2018",5,5,0,85948,824.4,110.6
"28967","89077","2018",21,21,0,140859.5,1374.476,102.6667
"28968","89079","2018",6,6,0,107250,1288.167,83
"28969","89080","2018",3,3,0,68333.33,1020,75.33333
"28970","89081","2018",1,1,0,166700,1126,148
"28971","89083","2018",20,20,0,181322.5,1524.95,123.4
"28972","89084","2018",1,1,0,90000,909,99
"28973","89085","2018",13,13,0,108161.5,1209.231,89.23077
"28974","89086","2018",65,65,0,106355.7,1125.077,97.56923
"28975","89088","2018",10,10,0,234950,2318.5,102.6
"28976","89089","2018",5,5,0,86400,955.4,88.6
"28977","89091","2018",9,8,1,86944.44,1077.444,83
"28978","89092","2018",4,4,0,137740,1490.25,89.75
"28979","89093","2018",9,9,0,125866.7,1502,90
"28980","89094","2018",14,14,0,126050,1235.286,104.1429
"28981","89095","2018",1,1,0,28000,549,51
"28982","89096","2018",8,8,0,153625,1581.25,96.5
"28983","89099","2018",28,27,1,98839.29,1233.607,81.03571
"28984","89100","2018",23,22,1,124470.9,1598.304,82.43478
"28985","89101","2018",6,6,0,98833.33,944,104
"28986","89102","2018",28,28,0,132647.5,1278.964,115.3214
"28987","89104","2018",4,4,0,146392.5,1258.75,108.25
"28988","89105","2018",7,7,0,139121.4,1369.286,102.1429
"28989","89108","2018",4,4,0,106250,1045.5,107.75
"28990","89111","2018",3,3,0,151833.3,806.3333,182.3333
"28991","89112","2018",2,2,0,82000,1226,66
"28992","89113","2018",6,6,0,152000,1301,113
"28993","89115","2018",3,3,0,102133.3,1144,82
"28994","89116","2018",4,4,0,147750,1338.75,116.5
"28995","89117","2018",2,2,0,92900,913.5,102
"28996","89118","2018",6,6,0,90244.17,801,117.3333
"28997","89119","2018",10,9,1,99800,1039.9,86.6
"28998","89122","2018",10,10,0,96600,1018.5,97.7
"28999","89123","2018",5,5,0,67100,1306.8,54.4
"29000","89124","2018",18,18,0,147295,1564.889,105.5556
"29001","89125","2018",12,11,1,70212.92,804.5,86.16667
"29002","89127","2018",5,5,0,167798,1905,92.4
"29003","89128","2018",4,4,0,70875,719.5,93.5
"29004","89129","2018",4,4,0,57000,716,70.25
"29005","89130","2018",22,22,0,106278.2,997.7273,111.3636
"29006","89131","2018",3,3,0,48000,1796,41
"29007","89132","2018",1,1,0,120000,952,126
"29008","89133","2018",5,5,0,130018,1258.4,106.4
"29009","89134","2018",9,9,0,150480.6,1307.222,136.2222
"29010","89136","2018",4,4,0,179547.5,1677.25,106.75
"29011","89137","2018",4,4,0,128737.5,1271.75,100.25
"29012","89139","2018",15,15,0,112987.2,1180.4,99.73333
"29013","89142","2018",18,18,0,106233.3,1266.056,98.5
"29014","89143","2018",6,6,0,215916.7,1715.5,126.8333
"29015","89144","2018",16,16,0,107616.3,1138.875,101.9375
"29016","89145","2018",2,1,1,88500,820,101
"29017","89147","2018",5,5,0,118800,945.6,124
"29018","89148","2018",3,3,0,72666.67,1140.667,68
"29019","89149","2018",1,1,0,40000,381,105
"29020","89150","2018",7,7,0,122455.7,1231,104.7143
"29021","89151","2018",14,14,0,119571.4,1363.571,77.64286
"29022","89152","2018",14,14,0,79250,1008.5,85.5
"29023","89153","2018",3,3,0,128138.3,1354,95.66667
"29024","89154","2018",10,10,0,118825.4,1369.8,87.6
"29025","89155","2018",9,9,0,164426.7,1474.333,105.2222
"29026","89158","2018",12,12,0,86833.33,799.0833,113
"29027","89160","2018",10,10,0,100600,1540.9,65
"29028","89161","2018",4,4,0,85750,778.5,110.75
"29029","89162","2018",7,7,0,180007.1,1733.143,115.8571
"29030","89163","2018",12,12,0,157666.7,1135.167,130.6667
"29031","89165","2018",6,6,0,122600,1132.333,104
"29032","89167","2018",14,14,0,156475.4,1249.929,135.7143
"29033","89169","2018",8,8,0,89375,1066.125,85.375
"29034","89170","2018",2,2,0,43500,568.5,88
"29035","89171","2018",6,6,0,83333.33,999,88.16667
"29036","89172","2018",9,9,0,129505.6,1263.667,107.2222
"29037","89173","2018",4,4,0,136625,1074.25,127.75
"29038","89176","2018",6,6,0,59576.67,792.1667,76
"29039","89177","2018",1,1,0,18000,450,40
"29040","89179","2018",7,7,0,82678.57,922.4286,84.28571
"29041","89180","2018",2,2,0,130500,1175,111
"29042","89181","2018",1,1,0,80000,816,98
"29043","89182","2018",5,5,0,69060,744.6,90.4
"29044","89183","2018",1,1,0,43500,640,68
"29045","89184","2018",3,3,0,150466.7,1034,139
"29046","89186","2018",2,2,0,163500,1188.5,141.5
"29047","89187","2018",1,1,0,101900,1213,84
"29048","89188","2018",3,3,0,98666.67,939.3333,106.6667
"29049","89189","2018",1,1,0,133000,2418,55
"29050","89190","2018",2,2,0,60500,1092,50.5
"29051","89191","2018",1,1,0,25000,373,67
"29052","89194","2018",1,1,0,70000,1000,70
"29053","89195","2018",11,11,0,174099.3,1740,101.3636
"29054","89196","2018",15,15,0,129704.6,1024.6,131.2
"29055","89197","2018",7,7,0,133414.3,913.4286,138.2857
"29056","89198","2018",29,29,0,149176.9,1616,95.72414
"29057","89199","2018",5,5,0,102973.2,1038.4,101
"29058","89200","2018",7,7,0,147285.7,1608.857,94.14286
"29059","89201","2018",15,15,0,142428,1472.733,99.8
"29060","89202","2018",6,6,0,165500,1370.167,127.8333
"29061","89203","2018",5,5,0,99794,1052,88.8
"29062","89204","2018",2,2,0,82474.5,1092,75.5
"29063","89205","2018",3,3,0,66500,578,118.3333
"29064","89206","2018",80,65,15,94727.75,1160.013,82.05
"29065","89207","2018",1,1,0,45000,469,96
"29066","89208","2018",4,4,0,52252.5,784.25,67.25
"29067","89209","2018",6,6,0,130250,1390.667,93
"29068","89210","2018",1,1,0,170000,850,200
"29069","89212","2018",5,5,0,126465.2,1230.2,101.2
"29070","89214","2018",5,5,0,86350,892.8,101.4
"29071","89215","2018",3,3,0,133333.3,1086,140.3333
"29072","89216","2018",3,3,0,149500,1341.667,103.3333
"29073","89217","2018",3,3,0,125511.7,1462.667,95.33333
"29074","89218","2018",10,10,0,100477,1396.7,72.4
"29075","89219","2018",3,3,0,98866.67,919.3333,110.6667
"29076","89220","2018",5,5,0,69276,986,69.8
"29077","89221","2018",4,4,0,131500,1301.75,84.75
"29078","89222","2018",2,2,0,84200,835.5,106
"29079","89223","2018",5,5,0,87600,997.2,91.8
"29080","89224","2018",2,2,0,109250,1897,60
"29081","89225","2018",2,2,0,114000,730,183.5
"29082","89227","2018",9,9,0,101738.9,911.3333,112.2222
"29083","89228","2018",17,17,0,153310.1,1435.824,115.5294
"29084","89229","2018",10,10,0,162260,1373.7,117.4
"29085","89230","2018",5,5,0,104358.2,1312.6,81.8
"29086","89232","2018",4,4,0,115088.8,913,125.5
"29087","89233","2018",4,4,0,66000,822.5,82.25
"29088","89234","2018",2,2,0,37000,445,81.5
"29089","89235","2018",9,9,0,115587.8,1139.333,105.3333
"29090","89236","2018",17,17,0,186232.4,1458.588,132.2941
"29091","89237","2018",9,9,0,72111.11,768,95.77778
"29092","89238","2018",7,7,0,71642.86,909.7143,77.71429
"29093","89239","2018",20,20,0,155987.5,1533,103.6
"29094","89240","2018",3,3,0,111666.7,1107.333,103.6667
"29095","89242","2018",11,10,1,87196.36,1190.818,74.27273
"29096","89245","2018",19,19,0,144872.1,1246.316,117.3684
"29097","89246","2018",1,1,0,110000,917,120
"29098","89247","2018",3,3,0,56333.33,654.6667,88
"29099","89248","2018",3,3,0,78966.67,758,94.66667
"29100","89249","2018",1,1,0,135000,1570,86
"29101","89250","2018",1,1,0,35000,1591,22
"29102","89251","2018",4,4,0,81000,982,81.75
"29103","89253","2018",2,2,0,55000,759,75
"29104","89254","2018",8,8,0,131660.6,1624.5,89.625
"29105","89255","2018",15,15,0,147108,1678.733,92.06667
"29106","89256","2018",6,6,0,60500,873.1667,78.66667
"29107","89257","2018",71,57,14,85059.03,1123.549,78.80282
"29108","89259","2018",1,1,0,98000,961,102
"29109","89261","2018",4,3,1,116250,957,142.5
"29110","89263","2018",51,49,2,137151.9,1509.412,93.35294
"29111","89264","2018",9,9,0,140833.3,1558.444,97.22222
"29112","89265","2018",9,9,0,176774.4,2441.222,92.22222
"29113","89266","2018",7,7,0,112428.6,901.7143,120
"29114","89267","2018",2,2,0,60000,943.5,64.5
"29115","89268","2018",9,8,1,91233.33,1165.778,86.11111
"29116","89270","2018",1,1,0,56000,448,125
"29117","89271","2018",1,1,0,48000,444,108
"29118","89272","2018",3,3,0,137533.3,943.3333,148
"29119","89273","2018",8,8,0,124625,1207.5,95.125
"29120","89274","2018",18,18,0,168166.7,1652.833,102.8889
"29121","89276","2018",14,14,0,105230.7,897.1429,115.7857
"29122","89277","2018",2,2,0,41500,405.5,102.5
"29123","89278","2018",10,10,0,132200,1409.6,102.3
"29124","89279","2018",10,9,1,128043.8,1316.5,103.1
"29125","89280","2018",1,1,0,90000,763,118
"29126","89281","2018",6,6,0,107225,1104.833,109.6667
"29127","89282","2018",5,5,0,119378,1385.6,106.4
"29128","89283","2018",8,8,0,101750,1005.75,100.875
"29129","89284","2018",1,1,0,1e+05,1389,72
"29130","89285","2018",4,4,0,162002.5,1193.5,135.25
"29131","89286","2018",12,12,0,137180,1160,118.8333
"29132","89287","2018",35,30,5,138354.3,1427.486,99.31429
"29133","89289","2018",2,2,0,161000,1501.5,120
"29134","89290","2018",1,1,0,60000,500,120
"29135","89291","2018",1,1,0,210000,1448,145
"29136","89292","2018",8,8,0,144539.4,1314.375,119.625
"29137","89295","2018",10,9,1,148860,1344.3,115.8
"29138","89296","2018",1,1,0,155500,1603,97
"29139","89297","2018",2,2,0,82890,1018,77
"29140","89298","2018",8,8,0,89750,1243.625,87.125
"29141","89300","2018",2,2,0,165000,1039,131
"29142","89302","2018",6,6,0,114606.2,1133.667,101.5
"29143","89303","2018",4,4,0,98456.25,1293,74.75
"29144","89304","2018",6,6,0,103500,1176.667,86
"29145","89306","2018",3,3,0,82000,676.3333,115.6667
"29146","89307","2018",8,8,0,105187.5,1275.125,82.375
"29147","89308","2018",2,2,0,100500,679.5,150.5
"29148","89309","2018",47,46,1,124300.4,1541.191,84.51064
"29149","89310","2018",1,1,0,90500,1207,75
"29150","89311","2018",16,16,0,138521.6,1292.188,112.625
"29151","89312","2018",1,1,0,62150,901,69
"29152","89313","2018",8,8,0,101775,1331.125,82
"29153","89314","2018",1,1,0,141000,1237,114
"29154","89315","2018",2,2,0,77000,843,98
"29155","89316","2018",2,2,0,106250,930.5,109
"29156","89318","2018",10,10,0,107700,1226.8,89
"29157","89319","2018",4,4,0,145625,1496.25,94.75
"29158","89320","2018",1,1,0,113910,2071,55
"29159","89321","2018",5,5,0,94300,1173.4,80.6
"29160","89323","2018",2,2,0,81500,615,150
"29161","89324","2018",10,10,0,87450,1060.5,81.1
"29162","89325","2018",5,5,0,69600,871.8,83.4
"29163","89326","2018",16,16,0,117192.5,1429.125,81.125
"29164","89327","2018",6,6,0,130164.2,1164.667,112.8333
"29165","89328","2018",3,3,0,205373.3,1978,116
"29166","89329","2018",1,1,0,40700,904,45
"29167","89331","2018",2,2,0,80000,737.5,107.5
"29168","89332","2018",9,9,0,133555.6,1489.889,92
"29169","89333","2018",1,1,0,89000,674,132
"29170","89334","2018",5,5,0,167410,1166.4,158.2
"29171","89335","2018",5,5,0,142894.8,1260.8,121
"29172","89336","2018",1,1,0,201000,718,280
"29173","89337","2018",14,14,0,126678.6,1293.429,99.35714
"29174","89338","2018",43,35,8,139943,1549.977,92.25581
"29175","89341","2018",5,5,0,90600,920.6,113
"29176","89342","2018",7,6,1,148382.9,1963.143,74.14286
"29177","89344","2018",35,35,0,77354.71,964.4286,79.34286
"29178","89345","2018",36,32,4,79269.44,861.3056,94
"29179","89346","2018",46,37,9,166134.8,1816.609,92.84783
"29180","89347","2018",6,6,0,90333.33,888.1667,111
"29181","89348","2018",34,34,0,113663.5,1342.5,85.70588
"29182","89349","2018",9,9,0,96366.67,1290.556,75.33333
"29183","89350","2018",3,3,0,106333.3,1260.667,86.33333
"29184","89351","2018",2,2,0,120610,1294,90
"29185","89352","2018",5,5,0,118200,1184,93
"29186","89353","2018",6,6,0,137050,1452,103.6667
"29187","89354","2018",18,18,0,151666.4,1397.667,108.1667
"29188","89355","2018",2,2,0,116500,1122,104
"29189","89359","2018",8,8,0,131750,1138.5,118.375
"29190","89360","2018",5,5,0,187200,1489.2,131.6
"29191","89361","2018",5,5,0,128000,1003.2,123
"29192","89362","2018",7,7,0,113876.4,2004.857,76.85714
"29193","89363","2018",3,3,0,64000,684,79
"29194","89365","2018",12,12,0,80575,938,84.66667
"29195","89367","2018",10,10,0,129585,980.8,126.9
"29196","89368","2018",6,5,1,166833.3,1166.167,140.3333
"29197","89369","2018",7,7,0,112714.3,1111.429,98.71429
"29198","89370","2018",16,15,1,151171.9,1461.438,103.6875
"29199","89371","2018",1,1,0,226995,3153,72
"29200","89373","2018",4,3,1,138500,2198,76.25
"29201","89375","2018",1,1,0,45000,726,62
"29202","89376","2018",3,3,0,79466.67,846.6667,88
"29203","89378","2018",5,5,0,125050,1223.6,104.2
"29204","89379","2018",3,3,0,113000,1142.333,97.33333
"29205","89380","2018",18,10,8,188311,3062.722,64.05556
"29206","89382","2018",23,23,0,116369.6,1300.043,91.3913
"29207","89383","2018",1,1,0,97500,793,123
"29208","89384","2018",12,12,0,104108.8,1255.333,83.83333
"29209","89385","2018",1,1,0,80000,1194,67
"29210","89386","2018",2,2,0,71075,757.5,93
"29211","89387","2018",294,136,158,110975.3,1517.759,74.03061
"29212","89388","2018",5,5,0,80700,869,102.6
"29213","89390","2018",8,8,0,138312.5,1373.25,106.75
"29214","89391","2018",20,19,1,107143.5,1397.4,77.5
"29215","89392","2018",1,1,0,71500,1100,65
"29216","89394","2018",1,1,0,77000,1013,76
"29217","89395","2018",4,4,0,86000,1171.5,73.25
"29218","89397","2018",12,12,0,67608.33,1102,62.33333
"29219","89398","2018",7,7,0,78279.29,996.5714,72.57143
"29220","89399","2018",22,22,0,142636.4,1663.727,88.77273
"29221","89400","2018",3,3,0,37166.67,571.6667,62.66667
"29222","89402","2018",1,1,0,149000,1355,110
"29223","89403","2018",6,6,0,58400,707.5,85.5
"29224","89404","2018",2,2,0,148530,1985.5,77.5
"29225","89405","2018",5,5,0,65740,775,83
"29226","89407","2018",13,13,0,99319.23,1048.308,101.6923
"29227","89408","2018",8,8,0,110081.2,944,105.25
"29228","89410","2018",2,2,0,94500,1023,90
"29229","89411","2018",15,15,0,118062.3,1282.333,92.73333
"29230","89414","2018",31,27,4,117336.5,1343.968,91.67742
"29231","89416","2018",7,7,0,72214.29,824.5714,97.28571
"29232","89418","2018",37,33,4,68951.35,858.2703,81.78378
"29233","89419","2018",34,32,2,124707.1,1608.206,83.02941
"29234","89420","2018",25,24,1,103802,1044.88,103.64
"29235","89423","2018",1,1,0,42000,494,85
"29236","89424","2018",2,2,0,85500,1110,77
"29237","89425","2018",9,9,0,119611.1,1638,73.44444
"29238","89426","2018",10,10,0,108720,1051.6,102.7
"29239","89427","2018",11,11,0,132655.3,1403.636,96
"29240","89428","2018",11,11,0,116309.1,1427.818,86.90909
"29241","89430","2018",4,4,0,134885,1213.5,114.25
"29242","89431","2018",1,1,0,240000,1257,191
"29243","89432","2018",7,7,0,107642.9,838.8571,120.7143
"29244","89433","2018",6,6,0,185550,1467.167,121.5
"29245","89434","2018",5,5,0,163590,1437.4,115
"29246","89436","2018",8,8,0,86440,1076.75,85.75
"29247","89437","2018",1,1,0,159000,1544,103
"29248","89438","2018",16,16,0,131437.8,1487.062,90.5625
"29249","89439","2018",16,16,0,119035,1153.875,106.625
"29250","89440","2018",4,4,0,134250,1078.5,131.5
"29251","89441","2018",17,17,0,116918.2,1051.176,104.9412
"29252","89442","2018",7,7,0,181545.7,1193,152.7143
"29253","89443","2018",18,18,0,128777.8,1448.611,95.5
"29254","89446","2018",8,8,0,206100,1958.5,115.875
"29255","89447","2018",3,3,0,25000,683,37.33333
"29256","89449","2018",25,25,0,141857.2,1703.4,85.32
"29257","89450","2018",8,8,0,156732.5,1412.25,117.125
"29258","89451","2018",5,5,0,91700,995.4,97.4
"29259","89452","2018",4,4,0,83500,941.5,86.75
"29260","89453","2018",11,11,0,163593.9,1678.727,95.90909
"29261","89456","2018",11,11,0,105454.5,1428,76.36364
"29262","89458","2018",1,1,0,68000,368,185
"29263","89459","2018",7,7,0,152331,1487.429,103.4286
"29264","89460","2018",41,39,2,142734.6,1455.049,99.34146
"29265","89461","2018",16,16,0,83600,955.75,91.6875
"29266","89462","2018",5,5,0,75800,911.4,81.4
"29267","89463","2018",1,1,0,228255,1841,124
"29268","89464","2018",70,60,10,103265.9,1359.014,81.24286
"29269","89465","2018",7,7,0,105771.4,1335.714,87.14286
"29270","89466","2018",7,7,0,194428.6,1797.429,110
"29271","89467","2018",16,16,0,147930.6,1358.562,114
"29272","89468","2018",10,10,0,109100,1331.4,83.3
"29273","89469","2018",22,22,0,112303.2,1151.682,99.59091
"29274","89470","2018",2,2,0,73000,1034.5,69
"29275","89471","2018",4,4,0,102900,1317,78.5
"29276","89472","2018",10,10,0,100075,1082.8,89.7
"29277","89474","2018",2,2,0,75750,1044,73
"29278","89475","2018",2,2,0,75250,686,95
"29279","89477","2018",1,1,0,1e+05,1064,94
"29280","89478","2018",14,14,0,130142.9,1311.214,93.64286
"29281","89479","2018",8,8,0,96242.5,1095.875,79.75
"29282","89480","2018",15,15,0,154066.7,1867.733,84.13333
"29283","89482","2018",1,1,0,160000,1119,143
"29284","89483","2018",4,4,0,173237.5,1145.75,156
"29285","89485","2018",2,2,0,47325,593,86.5
"29286","89486","2018",2,2,0,72525,590,124
"29287","90001","2018",14,13,1,163392.9,1772.571,90.35714
"29288","90002","2018",4,4,0,234212.5,1950.25,121
"29289","90003","2018",7,6,1,179550,1417.714,133.2857
"29290","90004","2018",5,3,2,182650,1646.6,115.4
"29291","90005","2018",4,4,0,212000,1273.5,153.75
"29292","90006","2018",5,5,0,112650,1213,104.4
"29293","90007","2018",2,2,0,114000,1308,100.5
"29294","90008","2018",47,23,24,148990.4,1647.489,95.23404
"29295","90009","2018",51,31,20,108220.4,1203,89.33333
"29296","90010","2018",554,103,451,95485.3,1246.139,75.10108
"29297","90011","2018",2,2,0,392390,2742.5,143.5
"29298","90012","2018",10,10,0,290263.7,1889.8,158.3
"29299","90013","2018",1,1,0,325000,2057,158
"29300","90014","2018",4,4,0,193100,1717.5,120.5
"29301","90017","2018",15,10,5,177510,1583.933,110
"29302","90019","2018",1,1,0,111500,1297,86
"29303","90020","2018",1,1,0,191810,2019,95
"29304","90021","2018",2,2,0,158500,1092,142.5
"29305","90022","2018",32,24,8,118352.5,1421.312,84.75
"29306","90023","2018",9,9,0,137627.8,1274.333,108.2222
"29307","90025","2018",3,2,1,162700,1726.667,92.66667
"29308","90026","2018",15,11,4,205580,1920.533,108.4
"29309","90028","2018",7,7,0,180257.1,1637.429,112
"29310","90029","2018",15,11,4,166584.3,1438.467,109.8
"29311","90031","2018",2,2,0,169500,1745.5,104.5
"29312","90032","2018",30,19,11,150523.3,1413.933,107.0333
"29313","90033","2018",49,32,17,145558,1511.082,97.44898
"29314","90034","2018",8,8,0,217081.2,1648.75,130.875
"29315","90035","2018",6,5,1,258383.3,1690.167,147.3333
"29316","90036","2018",2,2,0,180850,1980.5,90.5
"29317","90037","2018",5,5,0,163846.6,1111.4,139.4
"29318","90039","2018",36,23,13,166687.3,1724.917,96.63889
"29319","90041","2018",16,13,3,154395.4,1409.125,110.5
"29320","90042","2018",13,11,2,202933.8,1877.692,118.3077
"29321","90043","2018",6,6,0,213858.3,1835.333,115.6667
"29322","90044","2018",3,3,0,210533.3,1365.667,153.6667
"29323","90045","2018",6,6,0,211816.7,1650.167,126.8333
"29324","90046","2018",8,8,0,194100,1355.75,137.375
"29325","90047","2018",4,4,0,194279.5,1968.75,99.75
"29326","90049","2018",11,10,1,168951.8,1543.455,110.0909
"29327","90050","2018",2,2,0,123000,2832,70.5
"29328","90051","2018",4,3,1,163962.5,1594.25,104.5
"29329","90052","2018",41,24,17,116155.6,1259.098,95.85366
"29330","90053","2018",27,21,6,135768.1,1475.481,91.92593
"29331","90054","2018",9,8,1,136394.4,1219.444,118.6667
"29332","90055","2018",4,4,0,196640.5,1369.25,145.5
"29333","90056","2018",13,13,0,161169.2,1585.308,98.61538
"29334","90057","2018",6,5,1,211300,1430.5,159.1667
"29335","90058","2018",9,6,3,184451.1,1613.333,112.6667
"29336","90060","2018",2,2,0,346000,3542.5,119.5
"29337","90062","2018",2,2,0,191675,1650,115
"29338","90063","2018",4,4,0,172537.5,1690.5,107.25
"29339","90064","2018",1,1,0,265000,1840,144
"29340","90065","2018",10,9,1,126995,1358.9,94.7
"29341","90066","2018",2,2,0,123800,1643,75.5
"29342","90067","2018",4,4,0,219740.8,1592,128.75
"29343","90068","2018",7,6,1,205416.4,1927.571,106.1429
"29344","90069","2018",13,10,3,101289.2,1134.154,91.30769
"29345","90070","2018",5,5,0,135040,1076.4,125.8
"29346","90071","2018",12,5,7,170818.2,1809.75,99.08333
"29347","90072","2018",8,7,1,171238.8,1719.5,95.25
"29348","90074","2018",2,2,0,196125,1442,135
"29349","90075","2018",42,27,15,166167.9,1638.452,102.1667
"29350","90076","2018",9,7,2,211766.7,1815.222,115.8889
"29351","90077","2018",2,2,0,208500,1507,141
"29352","90079","2018",6,6,0,147575,1739.333,84.33333
"29353","90080","2018",3,3,0,157507.7,1764,89.66667
"29354","90081","2018",9,8,1,176617.8,1456.556,125
"29355","90082","2018",2,2,0,207800,1702.5,128
"29356","90084","2018",2,1,1,171050,1701.5,99
"29357","90085","2018",1,1,0,138150,2228,62
"29358","90086","2018",3,3,0,171800,1285.333,147
"29359","90087","2018",9,8,1,206783.3,1768,115.3333
"29360","90088","2018",11,11,0,164302.7,1494.909,114.5455
"29361","90089","2018",11,3,8,100926.9,1182.364,88.27273
"29362","90090","2018",4,4,0,161250,1552.75,117
"29363","90091","2018",4,4,0,187775,1739.5,108
"29364","90093","2018",14,10,4,150507.1,1598.643,99.07143
"29365","90094","2018",4,2,2,107550,1571.75,72
"29366","90095","2018",2,2,0,158850,1042,115
"29367","90096","2018",3,3,0,193400,1735.667,112.3333
"29368","90097","2018",17,16,1,179585.9,2043.765,90
"29369","90098","2018",3,3,0,138148.3,1364,95
"29370","90099","2018",77,30,47,105778.4,1328.935,78.48052
"29371","90100","2018",1,1,0,349650,1850,189
"29372","90101","2018",4,4,0,179250,1812.75,110.75
"29373","90102","2018",9,9,0,133233.3,1337.889,103.8889
"29374","90103","2018",5,4,1,190410,1601.8,133.2
"29375","90104","2018",10,7,3,141240,1524.7,91.7
"29376","90105","2018",2,2,0,152000,1549,96
"29377","91001","2018",3,3,0,217166.7,2138.667,113
"29378","91016","2018",50,43,7,170887,2031.86,87
"29379","91017","2018",23,20,3,251322.5,2886.348,94.34783
"29380","91021","2018",160,37,123,185997.4,3186.769,61.93125
"29381","91022","2018",1,1,0,195000,2010,97
"29382","91027","2018",323,150,173,225763.5,3412.028,69.14551
"29383","91035","2018",4,4,0,229742.5,2296.75,103
"29384","91037","2018",2,1,1,182000,2404.5,72
"29385","91038","2018",17,14,3,257960,2495,116.7059
"29386","91041","2018",9,8,1,364802.6,2944.667,131.3333
"29387","91044","2018",64,45,19,317807.3,3377.297,96.3125
"29388","91045","2018",102,82,20,248080.2,2813.49,93.10784
"29389","91047","2018",22,17,5,287563.6,2670.727,99.59091
"29390","91064","2018",57,39,18,470686.5,4546.596,105.386
"29391","91067","2018",3,3,0,178666.7,1718,115
"29392","91069","2018",5,4,1,153200,1618,90.8
"29393","91075","2018",1,1,0,167000,2386,70
"29394","91079","2018",5,5,0,235320,2236,114.2
"29395","91080","2018",13,10,3,215354.8,2628.923,82.38462
"29396","91081","2018",3,3,0,226333.3,2369,96.66667
"29397","91085","2018",50,42,8,250109.6,3108.76,90.64
"29398","91086","2018",130,96,34,256853.4,2793.892,93.96923
"29399","91093","2018",7,7,0,388428.6,4026,106.8571
"29400","91095","2018",29,20,9,220243.1,2962.276,77.65517
"29401","91097","2018",100,37,63,186927.6,2531.09,75.67
"29402","91098","2018",6,6,0,234636.7,2286.167,104.1667
"29403","91099","2018",63,55,8,232357.1,2678.429,93.63492
"29404","91100","2018",13,13,0,264201.9,2435.923,117.3077
"29405","91103","2018",277,139,138,215096.7,2974.289,75.50542
"29406","91105","2018",75,66,9,247550.9,2755.853,97.32
"29407","91106","2018",17,15,2,221652.9,2923.529,81.88235
"29408","91109","2018",15,15,0,267510.7,2575.667,114.0667
"29409","91111","2018",38,33,5,286592.6,2844.368,104.8947
"29410","91114","2018",351,186,165,274750.9,3233.453,86.81197
"29411","91115","2018",36,26,10,241143.1,2864.639,85.75
"29412","91121","2018",5,5,0,266100,2885.4,98.4
"29413","91122","2018",92,69,23,354131.4,3795.196,99.36957
"29414","91129","2018",47,44,3,245257.3,2642.064,98.14894
"29415","91130","2018",20,18,2,230191.5,2135,116.75
"29416","91131","2018",5,5,0,181240,1846.4,106
"29417","91132","2018",18,16,2,257803.3,2977.667,92.66667
"29418","91135","2018",21,21,0,248989,2585.857,96.66667
"29419","91136","2018",28,20,8,239865,3641.571,69.89286
"29420","91137","2018",7,7,0,187678.6,1782,108.8571
"29421","91145","2018",1,1,0,225000,2273,99
"29422","91148","2018",2,2,0,273750,3307,94.5
"29423","91156","2018",33,24,9,226465.8,2788.939,83.66667
"29424","91159","2018",20,18,2,271146.8,2876.15,98.9
"29425","91161","2018",296,55,241,180484.2,2780.807,68.48311
"29426","91174","2018",686,187,499,147904.2,2435.749,62.51895
"29427","91175","2018",19,16,3,230847.4,3103.368,87.36842
"29428","91179","2018",62,40,22,263976.5,2768,97.01613
"29429","91180","2018",5,5,0,359862,2715.6,132.6
"29430","91184","2018",4,4,0,224000,2575.5,92.5
"29431","91186","2018",3,3,0,274033.3,2910.333,94.66667
"29432","91191","2018",144,48,96,207004.3,2879.396,73.86806
"29433","91195","2018",6,6,0,277500,2454.5,118.1667
"29434","91198","2018",24,21,3,219320.8,2574.667,86.875
"29435","91200","2018",124,68,56,227665.5,2902.202,84.62903
"29436","91201","2018",336,225,111,261875.4,3291.72,82.80952
"29437","91204","2018",9,9,0,250445.6,2629.778,90.77778
"29438","91207","2018",43,31,12,248920.2,2919.465,88.69767
"29439","91215","2018",88,27,61,154414.6,2116.614,74.18182
"29440","91216","2018",130,87,43,275438.5,3340.792,84.63077
"29441","91223","2018",334,132,202,157939.6,2230.82,72.63473
"29442","91225","2018",34,29,5,385841.2,3149.5,131.1176
"29443","91226","2018",96,67,29,232408.7,3268.938,77.5
"29444","91228","2018",629,115,514,148815.8,2139.237,71.86169
"29445","91232","2018",61,36,25,218872.1,2563.23,94.7377
"29446","91235","2018",41,14,27,202999.7,3037.732,70.02439
"29447","91240","2018",5,2,3,180000,1927.2,107.2
"29448","91243","2018",25,21,4,288893.2,3046.04,100.68
"29449","91244","2018",13,9,4,298034.3,3175.538,97.07692
"29450","91247","2018",2,2,0,194000,2194,89.5
"29451","91248","2018",2,2,0,185475,1762.5,105
"29452","91249","2018",57,41,16,257684.6,2927.228,92.12281
"29453","91272","2018",236,124,112,364338.2,3774.161,98.25424
"29454","91273","2018",11,10,1,215970.9,2605.636,88.36364
"29455","91274","2018",17,17,0,403925.3,3380.882,128.0588
"29456","91275","2018",20,15,5,314179.4,4164.4,81.75
"29457","91284","2018",14,13,1,263728.6,2500.571,108
"29458","91286","2018",34,15,19,184300,2484.471,77.67647
"29459","91292","2018",6,6,0,288291.7,2700.833,107.8333
"29460","91293","2018",15,14,1,231604.5,2227.067,120.8667
"29461","91294","2018",13,13,0,235107.7,2298.385,111.1538
"29462","91312","2018",107,77,30,381895.7,4352.224,92.49533
"29463","91315","2018",97,92,5,245805.6,2805.402,90.96907
"29464","91318","2018",35,32,3,259189.7,3063.143,88.91429
"29465","91319","2018",5,4,1,497160,3546.2,131.6
"29466","91326","2018",242,63,179,200114.5,3299.496,61.7314
"29467","91330","2018",79,63,16,269265.2,3121.291,88.70886
"29468","91332","2018",24,16,8,234075.6,2773.292,88.375
"29469","91333","2018",76,61,15,270268.1,3113.882,90.80263
"29470","91338","2018",80,70,10,320414.3,3092.588,108.2875
"29471","91339","2018",83,45,38,226742.8,3147.747,73.80723
"29472","91340","2018",78,58,20,236893.3,2727.679,91.26923
"29473","91345","2018",258,72,186,192493.4,2802.027,69.23643
"29474","91347","2018",89,57,32,251865,3126.337,83.4382
"29475","91359","2018",42,37,5,209506.1,2404.69,93
"29476","91363","2018",90,66,24,276400.5,3144.367,91.77778
"29477","91374","2018",4,4,0,252750,2077,122
"29478","91376","2018",77,54,23,259276.1,3013.169,90.42857
"29479","91377","2018",507,59,448,237681.1,3505.418,70.26233
"29480","91378","2018",18,3,15,187058.9,2519.389,76.11111
"29481","91386","2018",221,163,58,267220.2,2873.602,96.74661
"29482","91390","2018",49,46,3,183793.5,1886.939,99.34694
"29483","91393","2018",9,9,0,170233.3,2081.889,95.55556
"29484","91399","2018",2,2,0,222000,1703,142.5
"29485","91405","2018",68,58,10,235193.8,2807.397,88.47059
"29486","91408","2018",25,25,0,254496,3000.4,89.36
"29487","91411","2018",25,23,2,380468,3301.24,119.84
"29488","91412","2018",6,6,0,270583.3,3749.333,85.83333
"29489","91414","2018",2,2,0,177500,1880.5,90.5
"29490","91421","2018",304,181,123,269055.8,3551.836,79.85197
"29491","91425","2018",81,40,41,250535.9,3403.765,77.45679
"29492","91432","2018",165,109,56,260843.8,3544.242,77.05455
"29493","91433","2018",36,24,12,217655.9,2665.639,82.22222
"29494","91434","2018",269,179,90,254364.9,3278.985,80.44981
"29495","91435","2018",9,9,0,553166.7,3204.111,167
"29496","91441","2018",10,10,0,274755,3084.9,93.3
"29497","91457","2018",52,40,12,263131.8,2853.192,98
"29498","91458","2018",42,26,16,290497.3,3226.738,95.92857
"29499","91461","2018",44,39,5,254284.8,2855.477,92.65909
"29500","91463","2018",10,10,0,281915,2698.4,107.5
"29501","91468","2018",30,28,2,243987.7,2728.533,93.2
"29502","91469","2018",12,12,0,240931.7,2510.667,106.75
"29503","91471","2018",199,122,77,362414.7,4263.151,88.52764
"29504","91477","2018",380,146,234,285943.3,3760.016,77.83684
"29505","91479","2018",60,53,7,293671.6,4173.4,77.25
"29506","91482","2018",8,7,1,287900,2925.125,97.125
"29507","91494","2018",45,36,9,277268.8,2949.2,97.28889
"29508","91495","2018",3,3,0,233333.3,2605.333,95.66667
"29509","91507","2018",6,6,0,256333.3,2743.167,96.83333
"29510","91508","2018",4,4,0,221250,2359.75,96.75
"29511","91511","2018",33,27,6,161618.2,2144.576,77.72727
"29512","91514","2018",99,62,37,225004.1,2935.343,78.9798
"29513","91519","2018",5,5,0,315600,2165.8,152.6
"29514","91521","2018",260,124,136,182103.5,2463.673,75.28846
"29515","91525","2018",14,11,3,304550.6,3444.143,114.5714
"29516","91533","2018",32,30,2,209065,2213.031,99.5
"29517","91534","2018",45,38,7,439128.3,4384.844,103.5333
"29518","91538","2018",8,6,2,328806.9,3251.125,102.875
"29519","91540","2018",78,59,19,227997.4,2687.218,88.70513
"29520","91544","2018",4,4,0,276445,2524.75,109
"29521","91546","2018",15,14,1,250794.1,2396.933,117.2667
"29522","91547","2018",9,9,0,196555.6,2172.333,93.22222
"29523","91549","2018",371,216,155,247194,3322.019,77.04043
"29524","91552","2018",114,80,34,230631.2,2738.351,87.58772
"29525","91553","2018",123,94,29,286592.1,3196.602,96.41463
"29526","91556","2018",3,3,0,234333.3,1955,119
"29527","91560","2018",5,4,1,266574,2850.2,94.2
"29528","91568","2018",10,10,0,361524.2,2673.7,146
"29529","91570","2018",237,110,127,207456.7,2676.932,78.92405
"29530","91573","2018",158,96,62,257496.1,3192.38,83.63291
"29531","91577","2018",73,60,13,266903.7,2958.63,94.87671
"29532","91578","2018",4,4,0,289943.2,3773.5,78.5
"29533","91579","2018",42,22,20,225571.2,3091.095,79.11905
"29534","91581","2018",9,9,0,279136.2,2669.222,108.4444
"29535","91587","2018",84,54,30,291561.4,3377.012,89.5119
"29536","91589","2018",489,278,211,225973.8,3240.873,71.50307
"29537","91593","2018",27,23,4,275922.3,2470.148,118.5556
"29538","91599","2018",18,18,0,257043.9,3086.944,87.55556
"29539","91600","2018",106,60,46,287308.3,3131.33,95.16981
"29540","91602","2018",2,2,0,274495,2852,96
"29541","91613","2018",2,2,0,177000,1684.5,105.5
"29542","91617","2018",59,43,16,268006.6,3195.085,88.49153
"29543","91619","2018",2,2,0,350550,2406,155
"29544","91629","2018",6,6,0,165256.7,2051.167,86
"29545","91630","2018",21,18,3,255622.9,2334.095,116.0476
"29546","91631","2018",17,17,0,355713.5,3237.765,112.1765
"29547","91634","2018",16,12,4,268458.8,2995.938,90.1875
"29548","91635","2018",23,22,1,493911.8,4423.87,115.3913
"29549","91639","2018",9,9,0,211483.3,2351.889,95.22222
"29550","91645","2018",190,102,88,469355.1,4617.389,102.0105
"29551","91648","2018",30,19,11,224484.7,2680.133,88.4
"29552","91649","2018",38,28,10,244632.1,3072,81.28947
"29553","91654","2018",6,6,0,236491.7,2137.167,132.8333
"29554","91657","2018",295,182,113,223833.6,3246.376,71.79661
"29555","91659","2018",66,42,24,228856.1,2792.939,80.77273
"29556","91661","2018",110,39,71,270338,3491.936,76.6
"29557","91662","2018",6,6,0,346541.7,2824,125
"29558","91665","2018",79,66,13,274914.5,3271.595,88.55696
"29559","91666","2018",30,26,4,285778.8,3294.333,96.46667
"29560","91667","2018",82,67,15,302533.2,3406.341,92.53659
"29561","91671","2018",3,3,0,233860,2658,89
"29562","91679","2018",14,9,5,307362,3868.786,82.21429
"29563","91685","2018",47,34,13,253699.5,3155.617,81.61702
"29564","91687","2018",329,132,197,214986.1,3011.158,73.95441
"29565","91689","2018",94,43,51,319435.8,4109.84,79.88298
"29566","91691","2018",440,186,254,252814.2,3164.855,83.10909
"29567","91692","2018",218,29,189,171721.5,2353.271,74
"29568","92002","2018",700,259,441,408744.8,5177.853,78.99286
"29569","92004","2018",1397,124,1273,358429.3,5859.649,59.99069
"29570","92007","2018",247,54,193,303178.6,4853.668,64.61134
"29571","92009","2018",454,99,355,423311.5,6108.341,66.76652
"29572","92012","2018",1853,42,1811,516522.3,8160.507,61.66379
"29573","92014","2018",255,63,192,388841.8,5432.671,72.30588
"29574","92019","2018",335,30,305,297338.1,4349.97,68.93134
"29575","92020","2018",448,71,377,359121.6,5631.826,64.43304
"29576","92022","2018",248,75,173,433827.2,5635.899,75.46774
"29577","92023","2018",652,222,430,430056.4,5722.503,74.75307
"29578","92024","2018",655,7,648,262023,5985.362,43.78015
"29579","92025","2018",1101,322,779,340953.8,5078.994,65.21889
"29580","92026","2018",1212,43,1169,393458.5,6540.49,59.80033
"29581","92032","2018",250,55,195,336599.4,4674.896,72.836
"29582","92033","2018",256,57,199,520019.5,5785.715,85.53516
"29583","92035","2018",487,58,429,415982.2,6278.68,63.71047
"29584","92036","2018",200,31,169,243237.5,3912.63,64.495
"29585","92040","2018",853,53,800,427562.2,7244.168,58.00117
"29586","92044","2018",1007,6,1001,471749.3,8529.155,54.83515
"29587","92046","2018",282,44,238,305855.8,6311.95,48.08156
"29588","92047","2018",10,7,3,1101187,7363.4,143
"29589","92048","2018",690,97,593,416997.1,5397.517,73.22319
"29590","92049","2018",664,23,641,370744.7,6683.401,54.82078
"29591","92050","2018",587,145,442,343181.5,5186.782,66.78194
"29592","92051","2018",1071,16,1055,817436.4,9837.498,81.70588
"29593","92060","2018",400,38,362,338152.9,5150.767,66.265
"29594","92062","2018",545,20,525,377948.3,6587.912,58.27156
"29595","92063","2018",1069,220,849,446611.9,5746.095,74.71094
"29596","92064","2018",453,65,388,577487.3,6607.576,85.04194
"29597","92071","2018",239,55,184,538733.4,6201.272,83.72385
"29598","92072","2018",284,67,217,537951.3,6029.187,84.62324
"29599","92073","2018",612,95,517,449310.5,6552.781,67.62908
"29600","92075","2018",352,27,325,352853.9,6143.531,56.17045
"29601","92076","2018",155,38,117,571095.3,5179.219,107.7677
"29602","92077","2018",123,33,90,601090.6,5798.902,99.81301
"29603","92078","2018",132,23,109,212684.9,3180.674,67.18939
"29604","93001","2018",575,50,525,172485.1,3447.87,51.50261
"29605","93005","2018",634,391,243,225440.1,3156.481,75.02524
"29606","93006","2018",336,65,271,278078.9,4881.054,58.02083
"29607","93007","2018",346,213,133,222737.4,3361.292,69.93064
"29608","93008","2018",224,84,140,193318.3,3124.384,63.49554
"29609","93010","2018",405,195,210,198269.9,3109.98,65.84691
"29610","93013","2018",163,25,138,156174.8,3055.399,53.30675
"29611","93014","2018",205,65,140,122094.2,1701.239,70.27805
"29612","93015","2018",71,43,28,235625.4,2897.254,85.3662
"29613","93027","2018",189,41,148,171034.6,2960.058,60.16931
"29614","93029","2018",617,320,297,205056.8,3357.864,63.3987
"29615","93030","2018",55,14,41,172954.6,2715.764,65.78182
"29616","93031","2018",509,122,387,173731.8,2634.896,67.50884
"29617","93032","2018",497,262,235,231695.7,3198.68,73.71429
"29618","93033","2018",104,67,37,305810,3983.529,81.22115
"29619","93039","2018",42,2,40,183186.5,3314.81,57.45238
"29620","93045","2018",312,39,273,336078.1,6127.67,54.63782
"29621","93046","2018",596,248,348,211964.9,3065.341,71
"29622","93047","2018",248,196,52,243320.5,3101.395,83.05645
"29623","93048","2018",1228,230,998,312632.7,5478.179,58.43893
"29624","93049","2018",287,119,168,273901.5,3886.655,72.09756
"29625","93050","2018",319,67,252,195526.2,3074.219,65.03448
"29626","93051","2018",822,236,586,248247.8,3788.948,68.51825
"29627","93053","2018",332,106,226,227138.7,3668.509,63.38253
"29628","93055","2018",650,36,614,250419,5069.585,49.85692
"29629","93057","2018",359,156,203,212848.6,3250.61,68.50696
"29630","93059","2018",183,101,82,189811.4,2968.552,68.54098
"29631","93061","2018",214,18,196,282873.7,5414.262,50.39252
"29632","93062","2018",269,69,200,289733.4,4000.539,74.43123
"29633","93063","2018",237,75,162,285228.3,4544.768,65.05907
"29634","93064","2018",533,102,431,215586.6,3472.099,64.34709
"29635","93066","2018",879,89,790,185645.4,3509.934,54.18771
"29636","93070","2018",501,29,472,257278,5175.577,49.83433
"29637","93071","2018",328,184,144,188696.4,2623.131,74.31098
"29638","93072","2018",188,94,94,177938.8,2742.824,66.70745
"29639","93073","2018",377,277,100,227958.1,2958.125,81.34483
"29640","93074","2018",76,33,43,202751.4,2931.526,75.43421
"29641","93077","2018",407,184,223,255940.3,3687.545,70.36855
"29642","93078","2018",288,180,108,200709.9,2680.806,77.44444
"29643","93079","2018",62,38,24,196731.3,2812.565,71.58065
"29644","94001","2018",89,31,58,215313,2852.64,76.93258
"29645","94002","2018",516,71,445,252368.3,4527.101,56.24225
"29646","94003","2018",170,44,126,285895.3,5192.135,56.46471
"29647","94004","2018",181,59,122,211942.8,2961.271,75.30387
"29648","94011","2018",187,36,151,220948.8,3369.176,67.5508
"29649","94015","2018",261,99,162,381107.8,4697.969,81.00766
"29650","94016","2018",297,68,229,318515.7,4939.808,66.40404
"29651","94017","2018",735,316,419,252263.5,3780.414,69.85442
"29652","94018","2018",424,7,417,423680.4,6959.604,60.16745
"29653","94019","2018",277,97,180,245620.1,3374.812,74.3213
"29654","94021","2018",164,26,138,218542.5,3463.921,64.89634
"29655","94022","2018",523,94,429,202146.2,3537.713,59.28107
"29656","94028","2018",816,91,725,240943.1,3565.197,69.01716
"29657","94033","2018",578,178,400,381497.2,5654.912,68.52076
"29658","94034","2018",379,56,323,218973.4,3158.879,69.93668
"29659","94037","2018",129,23,106,286912.8,5712.155,52.25581
"29660","94038","2018",340,107,233,291526.6,4146.671,70.88824
"29661","94041","2018",499,44,455,248085.6,4741.132,53.40481
"29662","94042","2018",261,69,192,352828.4,5308.797,67.42912
"29663","94043","2018",230,12,218,275085.5,5490.717,52.3
"29664","94044","2018",317,102,215,212168.5,3084.003,71.23028
"29665","94046","2018",679,111,568,308513.6,5142.468,60.13844
"29666","94047","2018",60,48,12,291122.6,3016.55,101.1167
"29667","94048","2018",58,52,6,357752.3,3123.379,120.1897
"29668","94052","2018",600,77,523,399538.1,5873.472,66.90167
"29669","94053","2018",64,42,22,305757.8,3646.484,88.23438
"29670","94054","2018",152,72,80,250850,3359.645,77.52632
"29671","94055","2018",132,130,2,379627.9,4248.098,94.97727
"29672","94056","2018",50,41,9,294552,3067.94,97.82
"29673","94058","2018",660,194,466,379196.3,5197.397,70.94545
"29674","94059","2018",254,66,188,275360.3,3515.756,78.67717
"29675","94060","2018",115,98,17,293875.9,3215.235,95.76522
"29676","94065","2018",81,25,56,296956,4052.469,73.85185
"29677","94067","2018",391,7,384,554994.6,8081.609,67.85166
"29678","94068","2018",1323,407,916,394434.7,5513.787,71.21466
"29679","94069","2018",214,11,203,321460,5460.472,58.79907
"29680","94070","2018",52,38,14,350582.2,3425.635,110.1346
"29681","94071","2018",317,184,133,320873.1,3657.874,91.76025
"29682","94073","2018",387,85,302,240442.6,3619.767,68.00517
"29683","94074","2018",79,42,37,222532.3,3271.633,71.82278
"29684","94075","2018",151,101,50,284354.4,3078.722,95.40397
"29685","94076","2018",587,117,470,262065.1,4642.889,58.54855
"29686","94077","2018",205,123,82,226788.4,3561.493,67.64878
"29687","94078","2018",255,98,157,171102,2898.627,61.90196
"29688","94079","2018",363,154,209,281711.8,3877.256,74.29752
"29689","94080","2018",829,45,784,451067.3,8003.226,55.06755
"29690","94081","2018",651,175,476,244454.4,4051.086,62.61137
"29691","95002","2018",9,9,0,303105.6,2669.111,115.4444
"29692","95008","2018",12,11,1,179934.2,1972,93.66667
"29693","95011","2018",7,6,1,197678.6,2466.286,79.85714
"29694","95012","2018",4,3,1,125500,1918,81.25
"29695","95014","2018",23,18,5,402343.5,3812.652,111.7826
"29696","95018","2018",1174,518,656,210055.2,3229.312,66.66951
"29697","95019","2018",160,114,46,221886.8,3148.387,73.16875
"29698","95023","2018",11,11,0,284395.5,2803.273,116.0909
"29699","95024","2018",3,3,0,247833.3,2109.333,129.6667
"29700","95026","2018",31,27,4,267751.6,2736.032,103.4516
"29701","95028","2018",27,22,5,285337,3082.556,99.11111
"29702","95039","2018",80,73,7,309709,3514.963,94.2375
"29703","95040","2018",7,7,0,262821.1,2268.857,113.7143
"29704","95042","2018",29,26,3,282296.6,2965.172,97.51724
"29705","95051","2018",118,83,35,308671.8,3683.237,86.11017
"29706","95052","2018",156,86,70,186514.6,2692.891,72.38462
"29707","95054","2018",4,3,1,176787.5,2183.25,86
"29708","95055","2018",9,9,0,260066.7,2501.444,107.7778
"29709","95056","2018",36,30,6,236066.1,3037.25,82
"29710","95058","2018",25,25,0,243080,2790.36,91.28
"29711","95059","2018",2,2,0,262460,2296.5,114.5
"29712","95060","2018",123,71,52,256583.2,3398.122,76.19512
"29713","95061","2018",9,9,0,311696.3,2654.444,122.7778
"29714","95063","2018",303,137,166,270966.7,3992.799,69.90759
"29715","95074","2018",11,11,0,412063.6,2995.455,145.8182
"29716","95078","2018",32,24,8,258736.9,2817.656,99.78125
"29717","95088","2018",13,6,7,195678.5,3249.846,63.84615
"29718","95091","2018",61,57,4,281004.9,2869.525,99.03279
"29719","95094","2018",1,1,0,2e+05,1802,111
"29720","95101","2018",10,10,0,189860,2219.2,88.7
"29721","95102","2018",7,7,0,281500,1999.571,144.2857
"29722","95110","2018",3,3,0,395733.3,2935,137
"29723","95116","2018",38,34,4,231476,2691.447,89
"29724","95119","2018",5,5,0,231812,2888.4,84.6
"29725","95120","2018",29,26,3,294235.8,3113.724,101.1724
"29726","95127","2018",673,169,504,190647.6,2835.502,70.96434
"29727","95134","2018",59,48,11,260331.4,2805.966,94.40678
"29728","95139","2018",3,3,0,200750,1867.667,111.3333
"29729","95142","2018",28,25,3,203473.6,2567.714,84.71429
"29730","95144","2018",1,1,0,325000,2355,138
"29731","95149","2018",55,49,6,304203.2,3277.218,97.49091
"29732","95150","2018",11,11,0,286767.7,2611.364,126.9091
"29733","95151","2018",5,5,0,205907.2,2646,81
"29734","95154","2018",4,4,0,270000,2800.5,108.25
"29735","95157","2018",4,4,0,331125,1979.25,169
"29736","95166","2018",4,4,0,238475,2627.25,103.25
"29737","95169","2018",6,5,1,263050,3524.333,80.5
"29738","95170","2018",5,3,2,219630,2847.6,80.8
"29739","95176","2018",336,195,141,310939.9,3924.119,80.67262
"29740","95177","2018",15,13,2,268136.7,2486,112.4
"29741","95181","2018",1,1,0,316650,3045,104
"29742","95183","2018",108,65,43,254329.9,3124.306,84.62037
"29743","95197","2018",368,152,216,254188,3438.709,75.80707
"29744","95199","2018",210,101,109,237820,3169.576,77.58571
"29745","95203","2018",313,152,161,302776.8,3737.927,81.47284
"29746","95205","2018",85,43,42,230533.2,2855.671,84.11765
"29747","95210","2018",204,53,151,354545.6,4792.936,73.87745
"29748","95211","2018",24,23,1,318572.9,3116.583,105.0833
"29749","95212","2018",1,1,0,109000,1211,90
"29750","95213","2018",5,5,0,329890,2509,131.8
"29751","95218","2018",249,110,139,235048.6,2932.554,83.42972
"29752","95219","2018",358,145,213,275331.6,3691.743,75.69832
"29753","95229","2018",119,52,67,231480,3009.277,78.57143
"29754","95241","2018",17,15,2,225000,2626.765,93.05882
"29755","95250","2018",127,118,9,225383.1,2662.157,89.25984
"29756","95252","2018",575,135,440,207873,2994.348,69.91478
"29757","95253","2018",9,9,0,317096.7,2470.667,129.4444
"29758","95254","2018",9,6,3,220166.7,2628.889,86.44444
"29759","95256","2018",43,33,10,294429.1,3213.419,94.25581
"29760","95257","2018",66,38,28,300738.8,3726.924,82.78788
"29761","95258","2018",9,9,0,312588.9,2782.333,119.4444
"29762","95268","2018",242,71,171,152611,2305.421,67.61157
"29763","95270","2018",3,2,1,206166.7,2447,87.66667
"29764","95271","2018",8,8,0,296306.2,2940.25,105.125
"29765","95277","2018",193,99,94,188336.6,2806.539,68.91192
"29766","95280","2018",250,203,47,211465.3,3138.596,72.604
"29767","95287","2018",4,4,0,359250,2530.25,151
"29768","95288","2018",113,64,49,266297.5,3308.15,84.74336
"29769","95295","2018",1,1,0,276300,3289,84
"29770","95298","2018",8,8,0,372800,2847,139
"29771","95301","2018",10,7,3,153945.6,4245.4,58.3
"29772","95303","2018",6,2,4,233750,2462.167,93.66667
"29773","95304","2018",3,3,0,483076.7,2880.333,178.6667
"29774","95306","2018",407,220,187,272467.7,3607.614,77.8231
"29775","95308","2018",6,6,0,331083.3,3190.5,104.8333
"29776","95309","2018",4,4,0,233500,1691.25,145
"29777","95313","2018",196,98,98,306997.4,3608.194,86.96939
"29778","95316","2018",4,4,0,406087.5,2239.25,194.25
"29779","95323","2018",209,181,28,253781,2767.833,94.91388
"29780","95328","2018",7,5,2,170342.9,2350.857,72.57143
"29781","95331","2018",5,1,4,173800,2686.8,65
"29782","95341","2018",4,4,0,295950,2348,126
"29783","95348","2018",6,6,0,212055.5,2812.833,77.33333
"29784","95351","2018",118,77,41,198815,2752.839,74.98305
"29785","95352","2018",54,40,14,273193.5,3248,87.62963
"29786","95353","2018",47,30,17,247021,3195.66,84.02128
"29787","95355","2018",78,60,18,210180.2,2494.705,88.82051
"29788","95365","2018",12,11,1,289552.8,2897.583,110.4167
"29789","95369","2018",41,28,13,305622.8,3483.78,89.39024
"29790","95370","2018",45,42,3,258506.7,2627.867,100.4667
"29791","95371","2018",76,67,9,240500.7,2951.053,86.25
"29792","95387","2018",1,1,0,265780,2953,90
"29793","95388","2018",72,56,16,234133.8,2781.153,85.125
"29794","95392","2018",53,41,12,269769.5,3329.377,87.88679
"29795","95394","2018",119,81,38,260277.6,3050.706,87.60504
"29796","95395","2018",9,7,2,206331.1,2466.444,86.88889
"29797","95409","2018",14,5,9,237467.9,3077.786,77.78571
"29798","95422","2018",5,5,0,311470,2398.8,135
"29799","95424","2018",183,106,77,225842.6,2875.077,81.63934
"29800","95426","2018",32,24,8,348397.2,3409.688,105.0312
"29801","95427","2018",170,76,94,211832.8,2797.5,78.62353
"29802","95428","2018",359,117,242,310420.9,3682.117,86.56825
"29803","95429","2018",3,3,0,352440,1676,242.6667
"29804","95430","2018",43,33,10,271844.7,2959.558,95.06977
"29805","95436","2018",13,12,1,272769.2,2746.846,99.92308
"29806","95438","2018",1,1,0,184855,2282,81
"29807","95445","2018",9,9,0,273666.7,2825.889,100.1111
"29808","95446","2018",41,40,1,320313.2,3441.61,99.73171
"29809","95447","2018",3,3,0,207166.7,2186.667,89.66667
"29810","95450","2018",15,15,0,351240,3212.667,115.6667
"29811","95452","2018",15,13,2,240806.7,2809.333,89.8
"29812","95456","2018",6,6,0,284616.7,2480.5,118.8333
"29813","95459","2018",8,8,0,252845.1,2761.375,93.75
"29814","95462","2018",7,7,0,217628.6,2570.714,94.42857
"29815","95476","2018",166,121,45,265676.3,3039.133,92.41566
"29816","95480","2018",106,94,12,318849.1,3314.302,101.1792
"29817","95483","2018",5,5,0,328000,3085.6,108
"29818","95487","2018",121,65,56,177732.8,2697.198,69.65289
"29819","95488","2018",86,64,22,246313.4,3490.221,77.74419
"29820","95489","2018",7,6,1,335228.6,3116.571,115.2857
"29821","95491","2018",135,65,70,263450.3,3509.504,76.54074
"29822","95493","2018",2,2,0,167000,6243,43
"29823","95500","2018",371,105,266,204164.2,2941.164,72
"29824","95504","2018",55,43,12,258797.7,3427.964,81.90909
"29825","95509","2018",49,39,10,225119.4,2658.878,89.30612
"29826","95510","2018",3,3,0,332000,2516.667,132.6667
"29827","95523","2018",13,7,6,190030.8,2252.846,88.23077
"29828","95527","2018",28,11,17,219146.4,3729.214,63.10714
"29829","95529","2018",10,10,0,274200,3402.3,88.5
"29830","95535","2018",11,10,1,224209.1,2471,105.3636
"29831","95539","2018",178,85,93,241094.4,3106.034,80.53371
"29832","95541","2018",17,17,0,196271.2,2037.882,97
"29833","95543","2018",2,2,0,250000,2228,115.5
"29834","95554","2018",13,13,0,237923.1,2344.077,102.6154
"29835","95555","2018",250,76,174,271785.3,3576.216,76.836
"29836","95563","2018",218,142,76,290049.4,3486.096,85.12385
"29837","95566","2018",41,37,4,235845.4,2710.902,90.07317
"29838","95572","2018",307,120,187,192493.2,2877.577,68.68078
"29839","95574","2018",88,67,21,368747.5,3818.08,101.8636
"29840","95580","2018",22,18,4,431377.3,2976.818,143.8182
"29841","95582","2018",340,137,203,262632.1,3498.735,76.02353
"29842","95584","2018",14,13,1,265890.4,2849.143,93.07143
"29843","95585","2018",279,99,180,175910.3,2409.118,76.14695
"29844","95592","2018",12,11,1,274786.7,2495.25,119.4167
"29845","95594","2018",11,10,1,244877.3,2705.182,95.36364
"29846","95598","2018",225,111,114,301032.1,3726.062,81.91111
"29847","95604","2018",74,31,43,175277.4,2461.622,74.14865
"29848","95607","2018",365,166,199,236589.6,3210.03,75.85479
"29849","95610","2018",2,2,0,225500,1938.5,116.5
"29850","95612","2018",43,36,7,235581.4,2991.488,82.02326
"29851","95625","2018",17,16,1,291660,2884.118,102.7059
"29852","95627","2018",12,10,2,325424.2,2640.417,134.0833
"29853","95628","2018",14,10,4,334685.7,3668.071,100.8571
"29854","95633","2018",1,1,0,265000,2598,102
"29855","95637","2018",195,144,51,261741,3064.754,88.70769
"29856","95641","2018",33,24,9,239942.7,3006,84.69697
"29857","95651","2018",16,15,1,245293.8,2489.562,96.375
"29858","95652","2018",83,75,8,257384.9,3014.373,90.84337
"29859","95656","2018",5,5,0,309984.6,2079.4,150.8
"29860","95658","2018",7,7,0,268028.6,3502.714,77.14286
"29861","95660","2018",19,17,2,302850,2881.158,112.7368
"29862","95675","2018",11,6,5,249454.5,3147.909,84.45455
"29863","95676","2018",8,8,0,222591.9,2297.375,104.375
"29864","95678","2018",13,13,0,359880.8,3494,105.3846
"29865","95680","2018",188,68,120,158170.9,2329.191,71.09043
"29866","95682","2018",7,5,2,240857.1,3211.714,82.71429
"29867","95690","2018",3,3,0,280500,2034.667,126.6667
"29868",NA,"2018",8050,NA,NA,189199.6,2497.817,77.83342
