"","INSEE_COM","Annee","Nb_mutations","NbMaisons","NbApparts","PrixMoyen","Prixm2Moyen","SurfaceMoy"
"1","01001","2019",19,19,0,245456.315789474,2001.26315789474,125.157894736842
"2","01002","2019",8,8,0,124866.25,1130.25,112.125
"3","01004","2019",207,109,98,168338.516908213,2043.31400966184,82.4589371980676
"4","01005","2019",34,26,8,247461.058823529,2427.26470588235,105.470588235294
"5","01006","2019",1,0,1,157100,1155,136
"6","01007","2019",43,40,3,183494.88372093,1987.18604651163,92.3720930232558
"7","01008","2019",5,5,0,212850,1987.6,104.2
"8","01009","2019",3,2,1,114583.333333333,1112.66666666667,104.333333333333
"9","01010","2019",20,16,4,171602.25,2012.1,87.9
"10","01011","2019",2,2,0,127500,1731.5,79
"11","01012","2019",6,6,0,123450,1076.5,111.833333333333
"12","01013","2019",4,4,0,115414,1029.75,107.75
"13","01014","2019",28,18,10,163307.142857143,1936.67857142857,83.1428571428571
"14","01015","2019",9,9,0,169936.555555556,1244.22222222222,147.333333333333
"15","01016","2019",4,4,0,75205,1246,79
"16","01017","2019",9,9,0,85612.5555555556,1021.66666666667,83.3333333333333
"17","01021","2019",18,15,3,262828.5,2129.55555555556,133.611111111111
"18","01022","2019",19,17,2,149659.368421053,1489.94736842105,108.105263157895
"19","01023","2019",1,1,0,118000,1180,100
"20","01024","2019",44,35,9,198583.590909091,2078.72727272727,96.1818181818182
"21","01025","2019",46,45,1,198374.130434783,1862.60869565217,108.826086956522
"22","01026","2019",11,10,1,179951.727272727,1746.27272727273,110.363636363636
"23","01027","2019",23,20,3,261198.739130435,2559,104.782608695652
"24","01028","2019",7,7,0,250477.571428571,2006.85714285714,128.285714285714
"25","01029","2019",6,6,0,119888.5,1116.83333333333,104
"26","01030","2019",16,10,6,208426.3125,2223.125,96
"27","01031","2019",28,13,15,133456.428571429,1510.92857142857,82.7857142857143
"28","01032","2019",29,25,4,249341.827586207,2357.41379310345,107.724137931034
"29","01033","2019",249,80,169,166125.522088353,2109.88353413655,78.7028112449799
"30","01034","2019",123,69,54,149035.105691057,1574.24390243902,94.7560975609756
"31","01035","2019",5,5,0,99500,1416.2,69.2
"32","01036","2019",25,25,0,153536.52,1486.12,99.88
"33","01037","2019",3,3,0,144383.333333333,1574,85
"34","01038","2019",9,9,0,203738.888888889,1684.33333333333,137.444444444444
"35","01039","2019",5,4,1,165750,1628.4,118.2
"36","01040","2019",9,9,0,156615.222222222,1497,105.333333333333
"37","01041","2019",17,17,0,130287.058823529,1587.94117647059,84.0588235294118
"38","01042","2019",2,2,0,209450,2168.5,100.5
"39","01043","2019",70,51,19,320412.857142857,3182.97142857143,104.342857142857
"40","01044","2019",3,3,0,312500,2166.66666666667,144.333333333333
"41","01045","2019",2,2,0,372700,1983.5,190
"42","01046","2019",10,10,0,203104,1683.2,118.2
"43","01047","2019",14,14,0,254018.357142857,2349.78571428571,111.071428571429
"44","01049","2019",43,36,7,249819.069767442,2584.53488372093,99.4651162790698
"45","01050","2019",2,2,0,186000,1132,210
"46","01051","2019",4,4,0,134382.5,1093.5,120
"47","01052","2019",2,2,0,306090,1649.5,185.5
"48","01053","2019",627,134,493,129674.315789474,1660.9696969697,77.8867623604466
"49","01054","2019",15,15,0,240308.2,1987,123.2
"50","01056","2019",9,9,0,96865.4444444444,1166.66666666667,85.2222222222222
"51","01057","2019",5,5,0,173150,1480.8,118.4
"52","01058","2019",6,5,1,123866.666666667,1456.16666666667,89.3333333333333
"53","01060","2019",8,8,0,146037.5,1447.625,133.75
"54","01061","2019",17,17,0,192100.529411765,1788.58823529412,114.941176470588
"55","01062","2019",15,13,2,330149.333333333,2620.13333333333,132.266666666667
"56","01063","2019",3,3,0,208633.333333333,2538.66666666667,85
"57","01064","2019",14,13,1,151475,1686.07142857143,88.7142857142857
"58","01065","2019",14,13,1,176402.928571429,1922.21428571429,96.4285714285714
"59","01066","2019",3,3,0,96000,1195.66666666667,76
"60","01067","2019",2,2,0,142500,1123.5,129.5
"61","01068","2019",15,13,2,106233.333333333,1315.33333333333,87.1333333333333
"62","01069","2019",25,20,5,187765.8,1876.16,101.16
"63","01071","2019",62,34,28,455581.080645161,4398.74193548387,104.806451612903
"64","01072","2019",30,28,2,217266.333333333,2065.73333333333,107.733333333333
"65","01073","2019",10,9,1,176605.5,1892,92.9
"66","01074","2019",43,32,11,180043.418604651,2103.79069767442,87.2790697674419
"67","01075","2019",24,20,4,212333.166666667,2061.95833333333,103.791666666667
"68","01076","2019",5,5,0,50560,688.6,81.6
"69","01077","2019",3,3,0,126895,1209.66666666667,98
"70","01078","2019",22,12,10,364242.727272727,3867.90909090909,95.1818181818182
"71","01079","2019",7,7,0,128668.571428571,1146.85714285714,110.857142857143
"72","01080","2019",9,9,0,118065,1431.33333333333,82.5555555555556
"73","01081","2019",7,5,2,225467.142857143,2226,103.571428571429
"74","01082","2019",7,5,2,210420,2182.42857142857,100.857142857143
"75","01083","2019",14,9,5,169886.571428571,1806.28571428571,89.5714285714286
"76","01084","2019",11,11,0,203285.454545455,1990.90909090909,102.272727272727
"77","01085","2019",1,1,0,231200,2245,103
"78","01087","2019",4,4,0,144000,1263.5,108.75
"79","01088","2019",11,11,0,269931.818181818,2565.18181818182,108.272727272727
"80","01089","2019",28,28,0,180172.25,1942.25,91.6428571428571
"81","01090","2019",3,3,0,191917.333333333,1852.33333333333,106.666666666667
"82","01092","2019",28,27,1,203805.321428571,1723.78571428571,124.25
"83","01093","2019",63,33,30,196609.952380952,2207.55555555556,91.8571428571429
"84","01094","2019",16,16,0,160998.125,1306.625,126.9375
"85","01095","2019",9,8,1,147026.666666667,1457.88888888889,97.2222222222222
"86","01096","2019",9,9,0,207256.555555556,2045,106.555555555556
"87","01098","2019",10,9,1,149910,1211.7,115.4
"88","01099","2019",22,21,1,191395.909090909,1932.59090909091,98.5454545454545
"89","01100","2019",2,2,0,177500,1060.5,156.5
"90","01101","2019",2,2,0,181000,1742,101
"91","01102","2019",14,14,0,178337.142857143,1611.21428571429,109.571428571429
"92","01103","2019",41,20,21,430361.365853659,4632.14634146341,94.609756097561
"93","01104","2019",5,4,1,271000,1600.4,156.8
"94","01105","2019",14,9,5,291618.571428571,3042.42857142857,99.2142857142857
"95","01106","2019",2,2,0,46000,1136.5,40.5
"96","01107","2019",3,3,0,79600,1443.66666666667,58.6666666666667
"97","01108","2019",25,24,1,122432,1118.28,109.76
"98","01109","2019",29,27,2,365514.344827586,3659,101.206896551724
"99","01110","2019",2,2,0,198250,1275.5,156
"100","01111","2019",4,4,0,69540,1136.25,61
"101","01112","2019",8,8,0,233418.125,1761.625,132.375
"102","01113","2019",11,11,0,173316.363636364,1448.27272727273,120
"103","01114","2019",5,5,0,204780,3366,60.4
"104","01115","2019",14,14,0,213005.714285714,1726.28571428571,128.571428571429
"105","01116","2019",7,7,0,204744.285714286,1699.42857142857,123.714285714286
"106","01117","2019",2,2,0,206250,959,228
"107","01118","2019",14,13,1,196680.714285714,1926.21428571429,105.285714285714
"108","01123","2019",14,14,0,214279.214285714,1876.5,118.642857142857
"109","01124","2019",12,12,0,139322.083333333,1408.25,96.5
"110","01125","2019",10,10,0,136811,1136.4,118
"111","01127","2019",8,8,0,196345.625,1857.75,105.375
"112","01128","2019",6,6,0,170986.666666667,1627.16666666667,102.666666666667
"113","01129","2019",3,3,0,169966.666666667,1920.33333333333,96.6666666666667
"114","01130","2019",21,20,1,222928.095238095,1828.90476190476,121.333333333333
"115","01133","2019",5,5,0,188824,1564.4,119.8
"116","01134","2019",17,15,2,196032.058823529,1825.35294117647,109.176470588235
"117","01135","2019",26,20,6,511080.615384615,4230.69230769231,123.5
"118","01136","2019",16,16,0,215993.125,1882.4375,119.3125
"119","01138","2019",36,29,7,140509.444444444,1525.58333333333,98.4722222222222
"120","01139","2019",4,4,0,111480,918,139.5
"121","01140","2019",10,10,0,153792,1798.5,95
"122","01141","2019",2,2,0,149500,1736.5,86
"123","01142","2019",72,39,33,215581.527777778,2453.65277777778,88
"124","01143","2019",195,54,141,511717.964102564,5228.42564102564,98.7384615384615
"125","01145","2019",10,10,0,231627,1861.3,132.1
"126","01146","2019",3,3,0,230950,1901.33333333333,119.666666666667
"127","01147","2019",7,7,0,124834.285714286,1231.85714285714,93.2857142857143
"128","01148","2019",16,12,4,140681.0625,1743.6875,82.75
"129","01149","2019",12,12,0,294865.416666667,1995.91666666667,140.333333333333
"130","01150","2019",4,4,0,156225,1532.75,102
"131","01151","2019",20,20,0,137259.75,1559.8,84.1
"132","01152","2019",8,7,1,184380,1886.5,99.75
"133","01153","2019",37,34,3,497872.378378378,4003.40540540541,124.540540540541
"134","01155","2019",1,1,0,116940,2339,50
"135","01156","2019",12,12,0,238050.833333333,2326.83333333333,106.333333333333
"136","01157","2019",31,26,5,266189.677419355,2276.25806451613,118.548387096774
"137","01158","2019",14,10,4,411745.785714286,3679.07142857143,108
"138","01159","2019",34,32,2,164468.529411765,1571.47058823529,109.5
"139","01160","2019",116,9,107,303973.844827586,3968.39655172414,77.0603448275862
"140","01162","2019",1,1,0,82500,660,125
"141","01163","2019",13,13,0,187300,1737.76923076923,115.692307692308
"142","01165","2019",22,22,0,237439.136363636,2345.90909090909,101.818181818182
"143","01166","2019",38,30,8,286556.657894737,2950.57894736842,96.6578947368421
"144","01167","2019",3,3,0,189223.333333333,1793.33333333333,114.333333333333
"145","01169","2019",11,10,1,234645.454545455,2232.45454545455,104.454545454545
"146","01170","2019",10,10,0,211172,1791.7,121.7
"147","01171","2019",4,4,0,305050,2236.75,133.75
"148","01173","2019",195,45,150,325571.112820513,3837.08205128205,83.548717948718
"149","01174","2019",1,1,0,115000,1474,78
"150","01175","2019",5,5,0,135472,1350,92.8
"151","01177","2019",2,2,0,150015,1516.5,97.5
"152","01179","2019",24,21,3,187964.25,1778.5,110.208333333333
"153","01180","2019",16,10,6,622031.0625,4582.4375,139.9375
"154","01181","2019",9,9,0,190135.555555556,1831.55555555556,98.4444444444444
"155","01183","2019",16,16,0,211609.375,2159.125,96.25
"156","01184","2019",18,18,0,162619.444444444,1870.33333333333,93.3888888888889
"157","01185","2019",59,51,8,130544.491525424,1535.30508474576,95.1186440677966
"158","01187","2019",14,10,4,127612,1330.85714285714,100.928571428571
"159","01188","2019",9,9,0,257315.555555556,2023.11111111111,129.555555555556
"160","01189","2019",7,6,1,196930.428571429,1833,105.714285714286
"161","01190","2019",1,1,0,67000,1288,52
"162","01191","2019",2,2,0,144650,1563,92
"163","01192","2019",15,15,0,228318.4,2165,125.333333333333
"164","01193","2019",5,5,0,173540,1779,105.6
"165","01194","2019",87,52,35,242641.505747126,2539.34482758621,97.0804597701149
"166","01195","2019",15,15,0,221525.533333333,1856.4,117.066666666667
"167","01196","2019",18,18,0,175395,1881.44444444444,99.5
"168","01197","2019",2,2,0,198350,2844.5,85
"169","01199","2019",38,34,4,151752.684210526,1654.84210526316,87.2105263157895
"170","01200","2019",3,3,0,135750,1303.66666666667,103.333333333333
"171","01202","2019",88,57,31,182019.409090909,1905.98863636364,96.2045454545455
"172","01203","2019",6,6,0,177226.333333333,1941.5,99.3333333333333
"173","01204","2019",9,8,1,173222.222222222,1750.11111111111,107.666666666667
"174","01206","2019",4,3,1,94419,1256.75,73.5
"175","01207","2019",2,2,0,353660,5125,82
"176","01208","2019",1,1,0,1e+05,781,128
"177","01209","2019",10,9,1,292044.3,2674.4,111.9
"178","01210","2019",17,4,13,70986.4117647059,1679.17647058824,48.8235294117647
"179","01211","2019",14,14,0,177257.285714286,1861.5,95.8571428571429
"180","01212","2019",4,3,1,104512.5,1166,89.25
"181","01213","2019",22,22,0,200065.909090909,2156.86363636364,93.2272727272727
"182","01214","2019",1,1,0,70000,560,125
"183","01215","2019",1,1,0,129000,822,157
"184","01216","2019",12,12,0,173549.833333333,1775.83333333333,97.8333333333333
"185","01219","2019",3,3,0,81666.6666666667,1402.33333333333,59.3333333333333
"186","01224","2019",48,33,15,232084.104166667,2532.39583333333,94.5208333333333
"187","01225","2019",3,3,0,274633.333333333,2584,132
"188","01227","2019",12,12,0,136258.333333333,1624.25,82.3333333333333
"189","01228","2019",2,2,0,1e+05,1079.5,95
"190","01229","2019",5,4,1,137715,1577.2,89.8
"191","01230","2019",3,3,0,84711.3333333333,1044.33333333333,79
"192","01231","2019",16,15,1,181665.9375,1782.625,102.5
"193","01232","2019",23,22,1,173762.956521739,1397.91304347826,126.521739130435
"194","01233","2019",2,2,0,168216.5,2304.5,84.5
"195","01234","2019",2,2,0,82500,739.5,92.5
"196","01235","2019",7,5,2,207281.428571429,1938.14285714286,111.285714285714
"197","01236","2019",11,11,0,186118.181818182,1633.36363636364,118.545454545455
"198","01237","2019",15,15,0,179441,1675.6,113.4
"199","01238","2019",39,35,4,293710.41025641,2954.17948717949,100.74358974359
"200","01239","2019",2,2,0,291000,2742,106
"201","01240","2019",10,9,1,95244.3,1509.2,73.2
"202","01241","2019",10,10,0,183516.5,1753.4,107.2
"203","01242","2019",2,2,0,88800,862,106.5
"204","01243","2019",25,21,4,291190.68,2285.68,121.76
"205","01244","2019",97,69,28,209360.865979381,2247.65979381443,94.659793814433
"206","01245","2019",6,6,0,155574.666666667,1685.5,96.5
"207","01246","2019",30,27,3,203505.833333333,1792.56666666667,111.933333333333
"208","01247","2019",20,5,15,106167.25,2350.1,38.95
"209","01248","2019",24,18,6,311496.541666667,2889.16666666667,111.416666666667
"210","01249","2019",136,62,74,249986.617647059,2919.20588235294,86.2352941176471
"211","01250","2019",29,29,0,310778.275862069,2664.68965517241,120.034482758621
"212","01252","2019",12,12,0,218925,2160.66666666667,105.5
"213","01254","2019",14,13,1,260471.785714286,1975.85714285714,130.428571428571
"214","01255","2019",8,8,0,163117.5,1825,88.125
"215","01257","2019",5,5,0,291257.8,2357.6,131.4
"216","01258","2019",21,19,2,239720.19047619,2249.28571428571,111.047619047619
"217","01259","2019",1,1,0,160000,1928,83
"218","01260","2019",8,8,0,204338.75,1961.625,106.75
"219","01261","2019",3,3,0,344283.333333333,2903,117
"220","01262","2019",116,54,62,184814.50862069,2275.87931034483,82.8103448275862
"221","01263","2019",60,40,20,225412.75,2516.45,91.35
"222","01264","2019",9,9,0,191016.666666667,1648.66666666667,121
"223","01265","2019",27,12,15,132367.444444444,1744.59259259259,78.037037037037
"224","01266","2019",49,30,19,152768.632653061,1714.24489795918,90.7959183673469
"225","01267","2019",8,8,0,174492.625,1698.875,102.375
"226","01268","2019",1,1,0,178150,2375,75
"227","01269","2019",38,10,28,87721.6578947368,1122.21052631579,78.4736842105263
"228","01272","2019",29,26,3,165467.413793103,1644.79310344828,102.896551724138
"229","01273","2019",27,27,0,158262.259259259,1670.51851851852,90.8148148148148
"230","01274","2019",4,4,0,119250,1413.5,89
"231","01275","2019",33,27,6,394439.090909091,3604.93939393939,114.606060606061
"232","01276","2019",9,9,0,282086.111111111,3003.77777777778,93.7777777777778
"233","01279","2019",2,2,0,121000,1432,65.5
"234","01280","2019",1,1,0,1e+05,1250,80
"235","01281","2019",58,35,23,475031.672413793,4750.56896551724,100.758620689655
"236","01282","2019",3,3,0,155633.333333333,1169.66666666667,140.666666666667
"237","01283","2019",185,82,103,122688.994594595,1451.13513513514,85.6108108108108
"238","01284","2019",5,5,0,166030,1921.6,85.6
"239","01285","2019",18,15,3,274981.111111111,2644.88888888889,103.277777777778
"240","01286","2019",14,14,0,198442.857142857,1870.64285714286,103.285714285714
"241","01288","2019",31,24,7,408003.032258065,3860.8064516129,106.41935483871
"242","01289","2019",92,55,37,167958.782608696,1972.67391304348,84.1847826086957
"243","01290","2019",16,13,3,288040.625,2651.5,116.5625
"244","01291","2019",16,16,0,209418.125,2115.5625,100.4375
"245","01294","2019",10,10,0,166540,1794.6,97.1
"246","01295","2019",12,10,2,227579.166666667,2117.58333333333,112.583333333333
"247","01296","2019",7,7,0,177771.428571429,1721,105
"248","01297","2019",21,18,3,271159.047619048,2506.85714285714,111.904761904762
"249","01298","2019",1,1,0,215000,2172,99
"250","01299","2019",3,3,0,227466.666666667,1991.33333333333,110.666666666667
"251","01301","2019",21,20,1,181013.857142857,1841.19047619048,100.190476190476
"252","01302","2019",1,1,0,205000,2330,88
"253","01303","2019",27,26,1,112022.222222222,1339,90.7037037037037
"254","01304","2019",34,26,8,153273.764705882,1606.52941176471,97.5588235294118
"255","01305","2019",21,15,6,126842.857142857,1483.57142857143,84.8095238095238
"256","01306","2019",22,8,14,109889.681818182,1489.36363636364,72.8181818181818
"257","01307","2019",11,5,6,108403.636363636,1351.72727272727,98.4545454545455
"258","01308","2019",12,12,0,407798.166666667,3036.91666666667,133.666666666667
"259","01309","2019",1,1,0,125000,1250,100
"260","01310","2019",2,2,0,290975,1688.5,173
"261","01311","2019",2,2,0,135000,1332,101.5
"262","01313","2019",127,59,68,459609.141732283,4579.44881889764,100.755905511811
"263","01314","2019",28,28,0,164555.714285714,1721.71428571429,98.5714285714286
"264","01317","2019",2,1,1,180200,2026,90
"265","01318","2019",11,11,0,314168.545454545,2623.54545454545,120.090909090909
"266","01319","2019",5,5,0,221545,2192.4,105.2
"267","01320","2019",51,49,2,193254.509803922,1980.60784313725,102.705882352941
"268","01321","2019",14,12,2,249220,1957.5,126.214285714286
"269","01322","2019",59,54,5,347754.898305085,2764.93220338983,130.220338983051
"270","01323","2019",7,7,0,140742.857142857,1425.71428571429,110.428571428571
"271","01325","2019",10,10,0,230335,2109,111.6
"272","01328","2019",5,5,0,392944,2295.8,143.8
"273","01329","2019",3,3,0,70333.3333333333,677.666666666667,108.666666666667
"274","01330","2019",2,2,0,58265,646.5,90
"275","01331","2019",1,1,0,94500,1890,50
"276","01332","2019",6,6,0,197807.166666667,2078.83333333333,95.5
"277","01333","2019",49,24,25,247484.448979592,2919.40816326531,86.2040816326531
"278","01334","2019",11,11,0,242380.909090909,2014.09090909091,122.636363636364
"279","01335","2019",5,5,0,263616.2,1745.6,155
"280","01336","2019",9,8,1,185009.888888889,2173.33333333333,89.1111111111111
"281","01337","2019",13,13,0,173285.384615385,1619.23076923077,111.076923076923
"282","01338","2019",16,16,0,151558.4375,1525.3125,101.5625
"283","01339","2019",19,19,0,316248.684210526,2794.31578947368,114.210526315789
"284","01342","2019",4,4,0,326722.5,2808.5,119.25
"285","01343","2019",21,21,0,239192.619047619,1774.95238095238,138.047619047619
"286","01344","2019",75,60,15,220801.88,2105.92,107.04
"287","01345","2019",43,30,13,152846.162790698,1686.25581395349,90.1162790697674
"288","01346","2019",15,13,2,195670,1816.53333333333,108.4
"289","01347","2019",19,19,0,321343.894736842,2799.21052631579,119.315789473684
"290","01348","2019",47,40,7,222554.361702128,1953.87234042553,113.808510638298
"291","01349","2019",1,1,0,286500,3256,88
"292","01350","2019",37,29,8,172570.27027027,1691.05405405405,103.135135135135
"293","01351","2019",29,26,3,192208.448275862,1933.13793103448,104.310344827586
"294","01352","2019",7,7,0,100006.428571429,1090.42857142857,103.428571428571
"295","01353","2019",23,17,6,264542.739130435,2573.95652173913,102.95652173913
"296","01354","2019",192,54,138,394479.484375,4115.15104166667,94.6822916666667
"297","01355","2019",5,5,0,170400,1393.4,117.2
"298","01357","2019",7,6,1,148454.285714286,1614.14285714286,108.142857142857
"299","01358","2019",5,5,0,142500,1286.4,108.6
"300","01359","2019",4,4,0,212875,2647.25,83.75
"301","01360","2019",43,31,12,443745.162790698,4039.25581395349,113.139534883721
"302","01361","2019",23,21,2,246539.52173913,2319.08695652174,114.434782608696
"303","01362","2019",10,7,3,279008,2234.1,116
"304","01363","2019",24,20,4,154098.333333333,1567.95833333333,102.583333333333
"305","01364","2019",14,14,0,178872.142857143,1616.71428571429,119.285714285714
"306","01365","2019",12,12,0,187870.833333333,1571.25,132.75
"307","01366","2019",14,12,2,227499.5,2189.42857142857,106
"308","01367","2019",5,4,1,107225,1175.4,88
"309","01368","2019",7,7,0,176264.285714286,2068.28571428571,89.8571428571429
"310","01369","2019",14,12,2,202581.571428571,1695,123.5
"311","01370","2019",43,2,41,102872.581395349,1433.16279069767,75.3255813953488
"312","01371","2019",24,16,8,259735.416666667,2648.70833333333,99.9166666666667
"313","01372","2019",7,7,0,107682.857142857,982.571428571429,109.857142857143
"314","01373","2019",10,10,0,163951.5,1338.3,125.5
"315","01374","2019",24,24,0,227516.25,1778.75,130.541666666667
"316","01375","2019",6,6,0,153034.166666667,1682.66666666667,99.5
"317","01376","2019",57,18,39,204144.912280702,2420.54385964912,83.5614035087719
"318","01378","2019",34,34,0,261768.882352941,2482.55882352941,106.323529411765
"319","01379","2019",12,11,1,148934.583333333,2008.75,75.25
"320","01380","2019",3,3,0,115400,1227,91
"321","01381","2019",11,11,0,176649.090909091,1948.45454545455,91.3636363636364
"322","01382","2019",5,5,0,356122,2243.4,178
"323","01383","2019",15,13,2,208431.333333333,1971.2,103.266666666667
"324","01384","2019",31,24,7,126692.580645161,1350.51612903226,95.4838709677419
"325","01385","2019",9,9,0,243838.888888889,2175.55555555556,120.888888888889
"326","01386","2019",8,7,1,207580.625,1901.875,117.75
"327","01387","2019",1,1,0,226000,1249,181
"328","01388","2019",17,15,2,141445.882352941,1407.94117647059,98.7058823529412
"329","01389","2019",19,17,2,238990.526315789,2132.21052631579,124.421052631579
"330","01390","2019",7,7,0,193895.714285714,2119.85714285714,96
"331","01391","2019",2,2,0,179600,1503.5,138.5
"332","01392","2019",8,8,0,203950,1761.125,114.875
"333","01393","2019",3,3,0,283763.333333333,2262,126.333333333333
"334","01396","2019",12,10,2,141274.166666667,1883.91666666667,81.9166666666667
"335","01397","2019",13,13,0,682327.461538462,4601.61538461538,157.384615384615
"336","01398","2019",34,28,6,244593.5,2460.61764705882,109.176470588235
"337","01399","2019",30,19,11,447363.566666667,4407.93333333333,103.233333333333
"338","01400","2019",2,2,0,160500,1238,130
"339","01401","2019",33,24,9,480333.787878788,4058.69696969697,121.212121212121
"340","01402","2019",12,12,0,133130.416666667,1350.83333333333,100.333333333333
"341","01403","2019",25,25,0,157004.4,1417.32,111.52
"342","01404","2019",4,4,0,71250,1453.25,64.75
"343","01405","2019",16,16,0,186416.4375,1842.8125,98.5625
"344","01406","2019",1,1,0,220900,1673,132
"345","01407","2019",26,13,13,130134.615384615,1697.69230769231,81.5384615384615
"346","01408","2019",8,8,0,130181.25,1395.5,92.25
"347","01410","2019",4,4,0,115537.5,950.5,137.75
"348","01411","2019",2,2,0,150500,1701.5,82
"349","01412","2019",13,13,0,254788.846153846,2090.84615384615,126.692307692308
"350","01415","2019",6,6,0,187000,1593.33333333333,119.666666666667
"351","01416","2019",19,16,3,94305.2631578947,1069.78947368421,93.6842105263158
"352","01418","2019",15,14,1,339181.666666667,2897.8,117.933333333333
"353","01419","2019",70,41,29,415083.742857143,4044.44285714286,103.442857142857
"354","01420","2019",18,6,12,134949.444444444,1553.16666666667,92.2222222222222
"355","01421","2019",14,14,0,128067.857142857,1493.78571428571,89.0714285714286
"356","01422","2019",16,15,1,207275.4375,2051,106.25
"357","01423","2019",22,22,0,312900.045454545,2913.18181818182,108.772727272727
"358","01424","2019",16,13,3,325445.3125,2838.3125,114
"359","01425","2019",1,1,0,190000,1900,100
"360","01426","2019",26,26,0,162369.230769231,1643.65384615385,106.038461538462
"361","01427","2019",97,53,44,214725.773195876,2506.88659793814,85.1237113402062
"362","01428","2019",5,5,0,245800,1944,130.6
"363","01429","2019",4,4,0,210275,1719.5,124
"364","01430","2019",11,11,0,207094.545454545,1956.90909090909,112.090909090909
"365","01431","2019",18,16,2,127031.111111111,1559.27777777778,88.5
"366","01432","2019",8,8,0,197096.25,1721.875,122
"367","01433","2019",4,4,0,104750,934.75,109.75
"368","01434","2019",4,4,0,262060,2111.5,125.25
"369","01435","2019",24,21,3,461421.666666667,4262.33333333333,111.291666666667
"370","01436","2019",11,5,6,352020.909090909,3296.81818181818,103.454545454545
"371","01437","2019",2,2,0,135725,1500.5,92.5
"372","01439","2019",2,2,0,212950,1779.5,123
"373","01441","2019",13,13,0,145616.076923077,1501.23076923077,101.153846153846
"374","01443","2019",75,50,25,219365.32,2445.05333333333,92.8266666666667
"375","01444","2019",32,26,6,133152.1875,1316,97.78125
"376","01445","2019",12,12,0,183994.083333333,1514.41666666667,138.25
"377","01446","2019",14,13,1,370818.142857143,2777,128.714285714286
"378","01447","2019",18,18,0,129185.666666667,1364,93.6111111111111
"379","01448","2019",5,3,2,232600,2722.8,86.4
"380","01449","2019",8,8,0,221782.5,2007,117.875
"381","01450","2019",40,37,3,233885.25,2338.15,109.45
"382","01451","2019",63,58,5,202619.793650794,1873.25396825397,110.031746031746
"383","01452","2019",17,15,2,102211.764705882,1296.88235294118,80.8235294117647
"384","01453","2019",10,10,0,109404.4,1371.1,98.9
"385","01454","2019",17,14,3,168291.176470588,1894.35294117647,92.9411764705882
"386","01456","2019",1,1,0,130000,1646,79
"387","01457","2019",38,34,4,165692.236842105,1693.81578947368,99.1315789473684
"388","02001","2019",7,7,0,86180.8571428571,1015.42857142857,83
"389","02002","2019",5,5,0,95410,1377.6,77.8
"390","02003","2019",8,8,0,130487.5,1644.75,77.5
"391","02004","2019",1,1,0,162000,1266,128
"392","02005","2019",5,5,0,142185.8,1192.4,119.6
"393","02007","2019",2,2,0,41000,1129.5,34.5
"394","02008","2019",4,4,0,115575,1196.25,95.25
"395","02009","2019",8,8,0,128600,1264,102.375
"396","02010","2019",2,2,0,123950,1485,83.5
"397","02011","2019",23,23,0,134694.347826087,1414.17391304348,101.347826086957
"398","02012","2019",2,2,0,106610,1056.5,94.5
"399","02013","2019",1,1,0,169000,2012,84
"400","02014","2019",6,6,0,150058.333333333,1502.66666666667,100.5
"401","02016","2019",1,1,0,85000,885,96
"402","02017","2019",3,3,0,70333.3333333333,719,84
"403","02018","2019",27,27,0,108042.592592593,1250,88.9259259259259
"404","02019","2019",4,4,0,197662.5,1256,150.75
"405","02020","2019",3,3,0,106300,918.666666666667,117.333333333333
"406","02022","2019",8,8,0,94762.5,1201.5,79.625
"407","02023","2019",2,2,0,171500,1447,121.5
"408","02024","2019",2,2,0,127467.5,1503,93.5
"409","02025","2019",2,2,0,112500,1324.5,84.5
"410","02027","2019",1,1,0,150000,938,160
"411","02028","2019",30,30,0,127091.666666667,1300.2,99.9333333333333
"412","02029","2019",3,3,0,141000,1624,88.3333333333333
"413","02031","2019",4,4,0,61675,743,84.25
"414","02032","2019",2,2,0,41000,581,70
"415","02034","2019",2,2,0,117500,1235.5,96.5
"416","02035","2019",4,4,0,105750,1096.75,94
"417","02036","2019",1,1,0,120000,1000,120
"418","02037","2019",11,11,0,149568.181818182,1349.90909090909,113.727272727273
"419","02038","2019",2,2,0,57500,592,100
"420","02039","2019",5,5,0,114600,1293.2,94
"421","02041","2019",7,7,0,95142.8571428571,943.571428571429,101.428571428571
"422","02042","2019",3,3,0,183000,1787.66666666667,103.666666666667
"423","02043","2019",1,1,0,107200,1554,69
"424","02046","2019",6,6,0,111583.333333333,1068,111.666666666667
"425","02049","2019",10,10,0,137380,1061.7,130.6
"426","02050","2019",4,4,0,110050,904.25,125
"427","02051","2019",3,3,0,115166.666666667,1650.66666666667,73
"428","02053","2019",7,7,0,120385.714285714,1240.57142857143,96.8571428571429
"429","02054","2019",5,5,0,142600,1677.4,87.6
"430","02055","2019",2,2,0,68500,777.5,86.5
"431","02056","2019",2,2,0,141750,1194,119
"432","02057","2019",10,10,0,86825,1032.4,92.5
"433","02058","2019",14,13,1,133957.142857143,1169.42857142857,117.857142857143
"434","02059","2019",18,18,0,75191.1111111111,919.722222222222,78.9444444444444
"435","02060","2019",1,1,0,105000,890,118
"436","02061","2019",4,4,0,85250,834.25,109.75
"437","02062","2019",2,2,0,107500,1553,68
"438","02063","2019",7,7,0,116114.285714286,1332.28571428571,88.2857142857143
"439","02064","2019",29,29,0,123325.551724138,1457.79310344828,84.8620689655172
"440","02065","2019",4,4,0,133033.5,1080.5,120.25
"441","02066","2019",5,5,0,154364,1208.4,129
"442","02067","2019",2,2,0,59000,872,75
"443","02068","2019",1,1,0,143000,1625,88
"444","02069","2019",1,1,0,50000,495,101
"445","02070","2019",5,5,0,107280,828.8,136
"446","02071","2019",4,4,0,112875,1273,86.5
"447","02072","2019",3,3,0,92666.6666666667,1009,88.3333333333333
"448","02073","2019",2,2,0,137500,1380.5,87
"449","02074","2019",15,15,0,102787.333333333,1057.2,93.9333333333333
"450","02075","2019",2,2,0,208500,1205,178.5
"451","02076","2019",2,2,0,136450,1302,88.5
"452","02077","2019",6,5,1,120483.333333333,1705,80.3333333333333
"453","02079","2019",3,3,0,79500,851,93
"454","02080","2019",1,1,0,150000,1103,136
"455","02081","2019",6,6,0,144400,1699.33333333333,88.6666666666667
"456","02082","2019",2,2,0,87100,1082,86.5
"457","02083","2019",10,10,0,138300,1555.5,89.9
"458","02084","2019",5,5,0,170420,1973.4,95.8
"459","02085","2019",8,8,0,154786.25,1524.375,103.125
"460","02086","2019",13,13,0,113961.538461538,1116.46153846154,105.923076923077
"461","02089","2019",19,18,1,120907.894736842,1302.15789473684,94.3684210526316
"462","02090","2019",7,7,0,140620,1055.28571428571,142.714285714286
"463","02093","2019",20,19,1,105585,1203.75,89.15
"464","02094","2019",8,8,0,173887.5,1309.875,127.25
"465","02095","2019",66,66,0,66766.7878787879,720.015151515152,93.4545454545455
"466","02096","2019",1,1,0,159000,1325,120
"467","02097","2019",1,1,0,78000,722,108
"468","02098","2019",7,7,0,141841.428571429,1466.85714285714,100.714285714286
"469","02099","2019",2,2,0,161000,1522,103.5
"470","02100","2019",1,1,0,148000,855,173
"471","02101","2019",3,3,0,97666.6666666667,756,138.666666666667
"472","02102","2019",1,1,0,128500,918,140
"473","02103","2019",18,18,0,96638.8888888889,1022.77777777778,100.055555555556
"474","02104","2019",1,1,0,138000,1704,81
"475","02105","2019",4,4,0,126000,1605,82
"476","02106","2019",8,8,0,116937.5,1247,94.875
"477","02108","2019",3,3,0,196333.333333333,1114.66666666667,178.333333333333
"478","02109","2019",4,4,0,91250,647,152.75
"479","02110","2019",23,23,0,123443.086956522,1144.04347826087,111.217391304348
"480","02111","2019",5,5,0,126600,1081.6,116.4
"481","02112","2019",11,11,0,87283.6363636364,871.363636363636,107
"482","02114","2019",18,18,0,174090.888888889,1721.94444444444,103.888888888889
"483","02115","2019",5,5,0,117660,1269.8,95.2
"484","02116","2019",2,2,0,71000,776.5,91.5
"485","02117","2019",1,1,0,191500,1841,104
"486","02118","2019",6,6,0,127166.666666667,1435.16666666667,89
"487","02119","2019",2,2,0,229000,1164.5,180.5
"488","02121","2019",1,1,0,71000,789,90
"489","02123","2019",3,3,0,93666.6666666667,1042,104.666666666667
"490","02124","2019",7,7,0,82689.2857142857,903,88.4285714285714
"491","02125","2019",4,4,0,138083.25,1703.25,83.5
"492","02126","2019",4,4,0,73564.25,769,100.5
"493","02127","2019",1,1,0,117500,979,120
"494","02128","2019",16,16,0,133687.5,1394.375,93.5
"495","02130","2019",2,2,0,167250,1178,134
"496","02131","2019",34,34,0,154420.205882353,1687.44117647059,94.1176470588235
"497","02132","2019",2,2,0,147250,1358.5,117.5
"498","02133","2019",1,1,0,77500,912,85
"499","02134","2019",5,5,0,72200,724.2,90.2
"500","02135","2019",7,7,0,68785.7142857143,624.285714285714,104.285714285714
"501","02136","2019",1,1,0,68500,640,107
"502","02137","2019",2,2,0,123750,1397.5,88
"503","02139","2019",5,5,0,164500,1357.2,130.4
"504","02140","2019",5,5,0,135340,1341,99.2
"505","02141","2019",13,13,0,90992.3076923077,759,118.153846153846
"506","02142","2019",3,3,0,166333.333333333,1235.33333333333,129.333333333333
"507","02143","2019",3,3,0,81666.6666666667,908.333333333333,99.3333333333333
"508","02144","2019",3,3,0,112333.333333333,1119.66666666667,92.6666666666667
"509","02145","2019",7,7,0,148734.571428571,1276.28571428571,118.857142857143
"510","02146","2019",1,1,0,156000,1714,91
"511","02148","2019",3,3,0,122000,1173.66666666667,102
"512","02150","2019",1,1,0,133000,1529,87
"513","02151","2019",1,1,0,137500,2083,66
"514","02152","2019",1,1,0,165700,1534,108
"515","02153","2019",4,4,0,107125,1084.25,89.25
"516","02154","2019",2,2,0,232000,1271,183
"517","02155","2019",3,3,0,141000,1298,121.333333333333
"518","02156","2019",3,3,0,152933.333333333,1222,114.333333333333
"519","02157","2019",4,4,0,111750,1347.75,82.25
"520","02158","2019",1,1,0,246000,1224,201
"521","02159","2019",4,4,0,112000,1196.75,97
"522","02160","2019",2,2,0,73450,871,83.5
"523","02162","2019",3,3,0,106500,1266.66666666667,91.3333333333333
"524","02163","2019",22,17,5,155390.909090909,1511.45454545455,99.9090909090909
"525","02164","2019",2,2,0,115000,1087.5,88
"526","02165","2019",21,21,0,79361.9047619048,862.571428571429,91
"527","02166","2019",13,13,0,121423.076923077,1269.23076923077,95.0769230769231
"528","02167","2019",15,15,0,141751.333333333,1478.46666666667,94.1333333333333
"529","02168","2019",158,94,64,136269.582278481,1679.58860759494,83.4367088607595
"530","02169","2019",1,1,0,90000,1071,84
"531","02170","2019",1,1,0,210000,1826,115
"532","02171","2019",4,4,0,127950,1145.25,109.75
"533","02172","2019",2,2,0,93500,1069,87
"534","02173","2019",134,118,16,96135.7462686567,1162.07462686567,83.365671641791
"535","02174","2019",11,10,1,141618.181818182,1383.81818181818,104.090909090909
"536","02175","2019",2,2,0,140000,1523.5,95
"537","02176","2019",4,4,0,117000,1362.75,83.75
"538","02177","2019",2,2,0,109000,1144,97.5
"539","02178","2019",1,1,0,160000,2162,74
"540","02179","2019",7,7,0,156967.857142857,1335.71428571429,125.285714285714
"541","02180","2019",9,9,0,108736.222222222,1053.33333333333,107.444444444444
"542","02181","2019",1,1,0,23000,460,50
"543","02182","2019",1,1,0,127000,870,146
"544","02183","2019",2,2,0,117400,1316,89
"545","02184","2019",3,3,0,99750,775.666666666667,109.666666666667
"546","02185","2019",4,4,0,147750,1279.75,116.25
"547","02186","2019",17,17,0,120476.470588235,1777.58823529412,72.1176470588235
"548","02187","2019",12,11,1,174208.333333333,1916.33333333333,89.4166666666667
"549","02188","2019",2,2,0,132500,1428.5,99
"550","02189","2019",4,4,0,90475,1156.25,81.5
"551","02190","2019",1,1,0,79000,1197,66
"552","02191","2019",7,7,0,118857.142857143,1397.14285714286,81.1428571428571
"553","02192","2019",9,9,0,139722.222222222,1240.33333333333,112
"554","02193","2019",1,1,0,295000,952,310
"555","02194","2019",1,1,0,80000,1290,62
"556","02195","2019",6,6,0,141750,1392.5,101.5
"557","02197","2019",3,3,0,118133.333333333,1221,106.666666666667
"558","02198","2019",5,5,0,159050,1499.6,114.4
"559","02199","2019",8,8,0,118050,1260.375,96.25
"560","02201","2019",8,8,0,166393.75,1853.75,92.25
"561","02203","2019",12,12,0,83425,1186.41666666667,84.25
"562","02205","2019",2,2,0,107400,857.5,120.5
"563","02207","2019",1,1,0,132000,1257,105
"564","02208","2019",4,4,0,203760,1644.5,136
"565","02209","2019",8,8,0,103175,1180.5,84.375
"566","02210","2019",1,1,0,149000,1585,94
"567","02211","2019",6,6,0,140683.333333333,1301.5,102
"568","02212","2019",6,6,0,93666.6666666667,1072.33333333333,89.8333333333333
"569","02213","2019",7,7,0,90000,1128,93
"570","02214","2019",1,1,0,110000,917,120
"571","02215","2019",12,12,0,102381.916666667,1208.75,88.1666666666667
"572","02216","2019",5,5,0,137380,1349,100.2
"573","02217","2019",9,9,0,133162.222222222,1236.77777777778,106.222222222222
"574","02218","2019",6,6,0,140883.333333333,1090.16666666667,139
"575","02219","2019",4,4,0,169410,1774.5,112.75
"576","02220","2019",5,5,0,107000,902,112.6
"577","02221","2019",2,2,0,119000,1608.5,75
"578","02223","2019",3,3,0,125000,1948.66666666667,69
"579","02224","2019",3,3,0,149166.666666667,1022.33333333333,146.666666666667
"580","02226","2019",20,19,1,149622.35,1617.55,93.85
"581","02228","2019",1,1,0,110000,1358,81
"582","02229","2019",3,3,0,115333.333333333,948.333333333333,129.666666666667
"583","02230","2019",1,1,0,87000,1088,80
"584","02231","2019",15,15,0,100500,1118.4,88.0666666666667
"585","02232","2019",4,4,0,149750,1270.5,111.75
"586","02233","2019",1,1,0,112500,1705,66
"587","02234","2019",2,2,0,143250,1237.5,110
"588","02235","2019",1,1,0,142000,993,143
"589","02236","2019",8,8,0,135250,1124.25,129.125
"590","02237","2019",15,15,0,93516.6666666667,906.2,105.333333333333
"591","02238","2019",25,25,0,123936,1275.32,109.28
"592","02239","2019",15,15,0,127580,1871.2,77.3333333333333
"593","02240","2019",1,1,0,102000,1214,84
"594","02241","2019",1,1,0,86400,432,200
"595","02242","2019",8,8,0,125625,1420.25,89.75
"596","02243","2019",28,25,3,136893.285714286,1595.42857142857,89.1785714285714
"597","02245","2019",25,25,0,131527.56,1475.4,90.56
"598","02246","2019",8,8,0,92636.25,1146,83.625
"599","02249","2019",3,3,0,126000,1426,89.3333333333333
"600","02252","2019",3,3,0,113486.666666667,1094,109
"601","02253","2019",4,4,0,214175,1527,131.25
"602","02254","2019",5,5,0,134600,1773.6,86.6
"603","02255","2019",4,4,0,74325,1139,68.25
"604","02256","2019",2,2,0,71450,483.5,159.5
"605","02257","2019",5,5,0,166700,1642.8,104.4
"606","02258","2019",4,4,0,125250,1293.5,99.5
"607","02259","2019",4,4,0,218500,1612,144.75
"608","02260","2019",5,5,0,114900,972,127.8
"609","02261","2019",6,6,0,66873.3333333333,875.666666666667,82.5
"610","02262","2019",6,6,0,114916.666666667,1227,93.3333333333333
"611","02263","2019",3,3,0,153000,877,156
"612","02264","2019",4,4,0,82237.5,1058.75,84.5
"613","02265","2019",2,2,0,60000,551,109.5
"614","02267","2019",5,5,0,160022,1605.2,100.6
"615","02268","2019",7,7,0,149571.428571429,1563.85714285714,97.7142857142857
"616","02269","2019",1,1,0,70000,824,85
"617","02271","2019",3,3,0,108333.333333333,923,119
"618","02273","2019",3,3,0,123333.333333333,1172,110
"619","02274","2019",1,1,0,96000,1433,67
"620","02275","2019",1,1,0,102000,850,120
"621","02276","2019",2,2,0,121055,992.5,124.5
"622","02277","2019",6,6,0,128416.666666667,1414.33333333333,97.3333333333333
"623","02279","2019",6,6,0,157889.666666667,2169,75.3333333333333
"624","02280","2019",3,3,0,202333.333333333,2059.66666666667,113
"625","02281","2019",5,4,1,127600,1628.2,85.8
"626","02282","2019",5,5,0,108000,1078.4,98.2
"627","02283","2019",3,3,0,98108.6666666667,897.666666666667,114
"628","02286","2019",5,5,0,109500,1130,85.6
"629","02287","2019",14,14,0,131130.714285714,1295.71428571429,108.5
"630","02288","2019",5,5,0,86290,744.8,124.6
"631","02289","2019",8,8,0,155300,1363.5,112.125
"632","02290","2019",25,25,0,146101.72,1431.6,105.92
"633","02291","2019",4,4,0,71250,860.75,74.75
"634","02292","2019",15,15,0,164800,1775.73333333333,102
"635","02293","2019",11,11,0,54654.5454545455,853.909090909091,64.2727272727273
"636","02294","2019",2,2,0,148750,1189.5,120
"637","02295","2019",7,7,0,89642.8571428571,1162.85714285714,85.2857142857143
"638","02296","2019",13,13,0,153088.461538462,1408.15384615385,109.076923076923
"639","02297","2019",1,1,0,135000,1071,126
"640","02298","2019",10,10,0,71940,792.9,91.5
"641","02299","2019",10,10,0,122645,1353.5,88.6
"642","02302","2019",4,4,0,159863,1337.75,117.5
"643","02303","2019",6,6,0,199333.333333333,1392,149
"644","02304","2019",24,21,3,66566.6666666667,767.875,92.5833333333333
"645","02305","2019",22,20,2,104651.818181818,1190,89.6818181818182
"646","02306","2019",11,11,0,73690.9090909091,759.181818181818,98.9090909090909
"647","02307","2019",24,21,3,141040,1639.83333333333,94.1666666666667
"648","02308","2019",7,7,0,113655.142857143,950.142857142857,124.714285714286
"649","02309","2019",5,5,0,117780,1262.6,93.8
"650","02310","2019",1,1,0,133000,530,251
"651","02312","2019",12,12,0,118312.5,1045.75,117.833333333333
"652","02313","2019",4,4,0,60089.5,588.5,95.25
"653","02315","2019",22,22,0,100113.636363636,1074.68181818182,91.5454545454545
"654","02317","2019",3,3,0,81666.6666666667,1016.66666666667,79.6666666666667
"655","02318","2019",11,10,1,93995.4545454545,1093.45454545455,87.6363636363636
"656","02319","2019",5,5,0,66000,767.8,83.2
"657","02320","2019",3,3,0,125166.666666667,1037,113
"658","02321","2019",3,3,0,69166.6666666667,989,69.3333333333333
"659","02322","2019",5,5,0,84800,839.8,100.8
"660","02323","2019",1,1,0,78000,586,133
"661","02324","2019",1,1,0,220000,1410,156
"662","02326","2019",6,6,0,192200,1206.83333333333,151
"663","02327","2019",1,1,0,60000,857,70
"664","02328","2019",7,7,0,130728.571428571,1526.14285714286,87.1428571428571
"665","02329","2019",4,4,0,107750,1453.5,78.75
"666","02330","2019",5,5,0,139900,1329.8,93.6
"667","02331","2019",4,4,0,99125,830,139
"668","02332","2019",2,2,0,121000,1382.5,90.5
"669","02333","2019",3,3,0,105000,1611.33333333333,65.3333333333333
"670","02334","2019",24,24,0,92595.25,856.25,105
"671","02335","2019",4,4,0,133100,1298.25,99.75
"672","02336","2019",8,8,0,144675,1378.125,110
"673","02337","2019",2,2,0,93500,910,104
"674","02338","2019",2,2,0,91500,706,126.5
"675","02339","2019",10,10,0,136304,1261.8,118.9
"676","02340","2019",63,61,2,103288.825396825,1203.73015873016,86.3650793650794
"677","02341","2019",2,2,0,72500,570,125.5
"678","02342","2019",1,1,0,55000,764,72
"679","02343","2019",1,1,0,160000,800,200
"680","02345","2019",1,1,0,94000,777,121
"681","02346","2019",8,8,0,124250,1015.5,123.75
"682","02347","2019",1,1,0,218000,1817,120
"683","02349","2019",1,1,0,82000,1439,57
"684","02350","2019",1,1,0,63500,2117,30
"685","02351","2019",1,1,0,138500,1108,125
"686","02352","2019",10,10,0,58670,797.3,71.4
"687","02353","2019",6,6,0,127000,1073,114.5
"688","02355","2019",13,13,0,142900,1427.38461538462,96.9230769230769
"689","02356","2019",4,4,0,119725,1153.75,116.25
"690","02358","2019",7,7,0,71214.2857142857,768.142857142857,90.8571428571429
"691","02359","2019",29,28,1,120472.517241379,1404.8275862069,83.3448275862069
"692","02360","2019",35,35,0,166977.142857143,1688.97142857143,103.057142857143
"693","02361","2019",54,52,2,85690.6666666667,921.703703703704,92.5925925925926
"694","02362","2019",3,3,0,79000,858.666666666667,105
"695","02363","2019",6,6,0,90483.3333333333,949.833333333333,100.5
"696","02364","2019",1,1,0,43000,632,68
"697","02366","2019",3,3,0,129166.666666667,1024,119
"698","02367","2019",1,1,0,131000,771,170
"699","02368","2019",6,5,1,174583.333333333,1695.16666666667,106.833333333333
"700","02369","2019",5,5,0,93000,833.4,108.6
"701","02370","2019",5,5,0,103400,975.2,107
"702","02371","2019",14,14,0,118778.571428571,1340.78571428571,86.6428571428571
"703","02372","2019",2,2,0,151500,1259.5,106
"704","02373","2019",4,4,0,113067.5,1243,96.75
"705","02374","2019",11,6,5,78563.6363636364,1043.54545454545,73.6363636363636
"706","02375","2019",1,1,0,131000,1394,94
"707","02376","2019",1,1,0,75000,600,125
"708","02377","2019",2,2,0,86750,777,107.5
"709","02378","2019",2,2,0,97500,583.5,140.5
"710","02379","2019",2,2,0,56000,751,90
"711","02381","2019",80,76,4,68359.7625,799.5375,87.7125
"712","02382","2019",9,9,0,180977.777777778,1662.88888888889,112.333333333333
"713","02383","2019",11,11,0,139077.272727273,1260.54545454545,109.636363636364
"714","02384","2019",1,1,0,49000,605,81
"715","02385","2019",1,1,0,60000,500,120
"716","02386","2019",1,1,0,70000,569,123
"717","02387","2019",1,1,0,250238,2580,97
"718","02388","2019",1,1,0,120000,1379,87
"719","02389","2019",14,13,1,126428.571428571,1344.92857142857,100.571428571429
"720","02390","2019",2,2,0,87000,1195,73.5
"721","02391","2019",3,3,0,123400,1141.33333333333,106.666666666667
"722","02392","2019",2,2,0,52500,562.5,90
"723","02395","2019",2,2,0,147000,1495.5,100
"724","02396","2019",1,1,0,220000,1176,187
"725","02397","2019",13,13,0,122275.384615385,1229.30769230769,99.6153846153846
"726","02398","2019",3,3,0,138333.333333333,1731,85.6666666666667
"727","02399","2019",10,10,0,161897,1419,125.1
"728","02400","2019",1,1,0,190000,1275,149
"729","02401","2019",2,2,0,171725,1170.5,145
"730","02403","2019",4,4,0,98000,1006.25,105.75
"731","02405","2019",3,3,0,154286.666666667,1526.66666666667,101.333333333333
"732","02406","2019",2,2,0,133000,1288.5,100
"733","02407","2019",1,1,0,212000,1618,131
"734","02408","2019",253,154,99,90463.0948616601,1128.55335968379,80.5691699604743
"735","02409","2019",4,4,0,76250,1103.5,71.5
"736","02410","2019",3,3,0,136500,1502.33333333333,95
"737","02411","2019",3,3,0,167266.666666667,1675,105.333333333333
"738","02413","2019",3,3,0,210000,1299.66666666667,161.666666666667
"739","02414","2019",3,3,0,106150,1097.33333333333,97
"740","02415","2019",2,2,0,177500,1713,104
"741","02416","2019",2,2,0,82075,755,104.5
"742","02418","2019",4,4,0,112775,1232,93.25
"743","02419","2019",3,3,0,125833.333333333,1158.66666666667,110.666666666667
"744","02420","2019",5,5,0,150400,1596.2,92.8
"745","02421","2019",1,1,0,120000,845,142
"746","02422","2019",6,6,0,69600,676.5,103.166666666667
"747","02423","2019",1,1,0,72000,900,80
"748","02424","2019",2,2,0,114235,1326.5,85
"749","02425","2019",1,1,0,90000,857,105
"750","02426","2019",7,7,0,90928.5714285714,1085.28571428571,87.5714285714286
"751","02428","2019",1,1,0,230000,1100,209
"752","02429","2019",1,1,0,54500,1112,49
"753","02430","2019",10,10,0,128550,1101.5,114.9
"754","02431","2019",6,6,0,95483.3333333333,1068.33333333333,101
"755","02435","2019",2,2,0,62500,755.5,78
"756","02438","2019",1,1,0,95000,633,150
"757","02439","2019",11,11,0,136605.363636364,1444.81818181818,102.454545454545
"758","02440","2019",2,2,0,120000,997,118
"759","02441","2019",5,5,0,178000,1558.6,123.2
"760","02445","2019",3,3,0,69333.3333333333,674,104.666666666667
"761","02446","2019",1,1,0,35000,461,76
"762","02447","2019",2,2,0,146000,1242,126
"763","02448","2019",1,1,0,112000,982,114
"764","02449","2019",1,1,0,138100,979,141
"765","02450","2019",3,3,0,124166.666666667,1138.33333333333,103.333333333333
"766","02451","2019",2,2,0,166250,1017.5,164.5
"767","02452","2019",2,2,0,98250,838.5,113.5
"768","02453","2019",7,7,0,133452.857142857,1487.28571428571,99.1428571428571
"769","02454","2019",8,8,0,101187.5,1013.375,105
"770","02456","2019",3,3,0,90666.6666666667,959.666666666667,98.3333333333333
"771","02457","2019",5,5,0,104930,1178,86.4
"772","02458","2019",9,9,0,119421.666666667,1385.55555555556,94.3333333333333
"773","02459","2019",3,3,0,150633.333333333,1151.33333333333,145.666666666667
"774","02461","2019",2,2,0,97000,932,99.5
"775","02462","2019",3,3,0,81450,815,100
"776","02463","2019",2,2,0,150000,1093.5,133.5
"777","02464","2019",5,5,0,111600,1375,87
"778","02465","2019",10,10,0,156299,1597.9,100.9
"779","02468","2019",16,16,0,104768.75,864.3125,123.5
"780","02469","2019",12,12,0,94820,919.25,107.583333333333
"781","02470","2019",5,5,0,1e+05,996.2,102
"782","02471","2019",2,2,0,103500,748,124
"783","02472","2019",6,6,0,79900,882,106.333333333333
"784","02473","2019",2,2,0,60000,617.5,96.5
"785","02474","2019",5,5,0,118520,1332.8,103
"786","02476","2019",7,7,0,74251.4285714286,712.714285714286,102.571428571429
"787","02477","2019",12,12,0,155594.916666667,1660.33333333333,98.9166666666667
"788","02478","2019",1,1,0,135000,1776,76
"789","02480","2019",6,6,0,77250,737.833333333333,106
"790","02481","2019",4,4,0,156100,1246.75,123.75
"791","02483","2019",5,5,0,120300,1042.6,121.6
"792","02484","2019",8,8,0,112663.75,1355.625,86.375
"793","02485","2019",2,2,0,139850,1364,103
"794","02487","2019",9,9,0,150168.888888889,1590.44444444444,98.2222222222222
"795","02488","2019",2,2,0,35500,603.5,70.5
"796","02489","2019",3,3,0,120666.666666667,1246.33333333333,95
"797","02491","2019",4,4,0,147625,861.25,186
"798","02492","2019",2,2,0,99680,1032,86.5
"799","02493","2019",1,1,0,160000,1096,146
"800","02495","2019",5,5,0,120100,961.4,141.6
"801","02497","2019",15,15,0,129060,1351.8,99
"802","02498","2019",10,10,0,138061.2,1404.5,104
"803","02500","2019",5,5,0,105200,797,128.6
"804","02501","2019",1,1,0,120000,3333,36
"805","02502","2019",9,9,0,77655.5555555556,919.333333333333,84
"806","02503","2019",6,6,0,113000,947.333333333333,141.5
"807","02504","2019",24,24,0,99955.125,1287.5,83.625
"808","02505","2019",5,5,0,142140,1740.6,85.6
"809","02506","2019",6,6,0,174166.666666667,1599.5,112
"810","02507","2019",2,2,0,158500,1633.5,97.5
"811","02508","2019",2,2,0,135500,897,129
"812","02509","2019",2,2,0,125000,1579.5,83.5
"813","02510","2019",2,2,0,179251.5,2437,72.5
"814","02511","2019",1,1,0,72500,684,106
"815","02512","2019",4,4,0,191750,1743.5,116.75
"816","02513","2019",3,3,0,117000,828.666666666667,129.333333333333
"817","02514","2019",7,7,0,143142.857142857,1527.42857142857,92.5714285714286
"818","02517","2019",5,5,0,92400,1016.6,90.8
"819","02518","2019",5,5,0,187000,1372.4,162.6
"820","02519","2019",3,3,0,82833.3333333333,1061,72.3333333333333
"821","02520","2019",12,12,0,129158.333333333,1369.08333333333,95.75
"822","02521","2019",17,17,0,161229.411764706,1693.23529411765,99.0588235294118
"823","02522","2019",1,1,0,146000,772,189
"824","02524","2019",8,8,0,106917.875,1470.625,70.375
"825","02525","2019",4,4,0,129000,1457.5,86.25
"826","02527","2019",5,5,0,119600,1385.4,86.8
"827","02528","2019",3,3,0,175666.666666667,1647,106.666666666667
"828","02529","2019",1,1,0,84000,1091,77
"829","02531","2019",2,2,0,161450,1374.5,125.5
"830","02532","2019",12,12,0,127741.666666667,1255.91666666667,102.583333333333
"831","02533","2019",2,2,0,129500,946,148
"832","02536","2019",1,1,0,98550,530,186
"833","02537","2019",1,1,0,150000,1485,101
"834","02539","2019",14,14,0,80635.7142857143,911.857142857143,84.7142857142857
"835","02540","2019",11,10,1,188490,2152,87.2727272727273
"836","02541","2019",7,7,0,148608.571428571,1576.71428571429,98.7142857142857
"837","02543","2019",36,35,1,89550,1168.41666666667,77.5277777777778
"838","02544","2019",5,5,0,90876,1140.6,78
"839","02545","2019",1,1,0,62900,623,101
"840","02546","2019",5,5,0,177580,1491.8,120.8
"841","02547","2019",1,1,0,54000,446,121
"842","02548","2019",3,3,0,115266.666666667,702.666666666667,167
"843","02549","2019",13,13,0,135344.230769231,1370.53846153846,98.5384615384615
"844","02550","2019",3,3,0,113400,1065.33333333333,114.666666666667
"845","02552","2019",1,1,0,195000,1354,144
"846","02554","2019",14,12,2,163863.214285714,1795.92857142857,94.5
"847","02555","2019",31,22,9,127054.838709677,1383.83870967742,100.258064516129
"848","02557","2019",1,1,0,197000,1527,129
"849","02558","2019",23,23,0,99993.0434782609,1013.5652173913,104.521739130435
"850","02559","2019",1,1,0,30000,1071,28
"851","02560","2019",4,4,0,75975,881.5,85.25
"852","02561","2019",1,1,0,630000,1636,385
"853","02562","2019",2,2,0,162000,1100,143.5
"854","02563","2019",1,1,0,22800,380,60
"855","02564","2019",3,3,0,103000,1551.33333333333,67
"856","02565","2019",4,4,0,126450,1146.25,100.25
"857","02566","2019",15,15,0,121848.666666667,1314.4,93
"858","02568","2019",4,4,0,170750,1679.75,98.25
"859","02569","2019",4,4,0,84750,1246.5,75.25
"860","02570","2019",1,1,0,42450,685,62
"861","02571","2019",13,13,0,109821.461538462,1125.38461538462,96.8461538461538
"862","02572","2019",7,7,0,198532.857142857,1732.42857142857,112.857142857143
"863","02573","2019",1,1,0,85000,1349,63
"864","02574","2019",9,9,0,79209.4444444444,851.111111111111,91.4444444444444
"865","02575","2019",17,17,0,95298.2352941177,896.882352941176,103.823529411765
"866","02576","2019",4,4,0,194716.25,1280.25,150.25
"867","02578","2019",2,2,0,134025,1120.5,103
"868","02579","2019",2,2,0,117500,1456.5,81
"869","02580","2019",11,11,0,86454.5454545455,1207.27272727273,75
"870","02583","2019",1,1,0,30000,1304,23
"871","02584","2019",3,3,0,134300,1235.33333333333,106.333333333333
"872","02587","2019",4,4,0,140375,1290.5,106.75
"873","02588","2019",1,1,0,2e+05,1111,180
"874","02589","2019",2,2,0,163500,1263.5,131.5
"875","02590","2019",6,6,0,114500,1400.16666666667,90.3333333333333
"876","02591","2019",1,1,0,116000,734,158
"877","02592","2019",5,5,0,87980,846,109.4
"878","02593","2019",12,12,0,136806.25,1621.16666666667,85.4166666666667
"879","02594","2019",2,2,0,167000,1501.5,109.5
"880","02596","2019",17,15,2,142755.882352941,1456.88235294118,105.411764705882
"881","02598","2019",10,10,0,136650,1656.3,83.3
"882","02599","2019",5,5,0,87624,1037,83.8
"883","02600","2019",4,4,0,89000,936,92.75
"884","02601","2019",1,1,0,138710,1692,82
"885","02602","2019",22,22,0,100045.454545455,1206.04545454545,83.9090909090909
"886","02604","2019",1,1,0,90000,1304,69
"887","02605","2019",1,1,0,41000,683,60
"888","02606","2019",1,1,0,33000,2750,12
"889","02607","2019",1,1,0,171000,1390,123
"890","02608","2019",5,5,0,76200,957.6,81.4
"891","02610","2019",9,9,0,172433.333333333,1661.11111111111,104.111111111111
"892","02613","2019",11,11,0,151209.090909091,1497.81818181818,100.454545454545
"893","02614","2019",2,2,0,98850,816.5,121.5
"894","02615","2019",4,4,0,107250,1556.25,68.75
"895","02616","2019",1,1,0,45000,1364,33
"896","02617","2019",4,4,0,95725,724,140.25
"897","02618","2019",8,8,0,183500,1692.5,101.625
"898","02619","2019",5,5,0,94400,1176.4,81.6
"899","02620","2019",4,4,0,145850,1110.75,127.5
"900","02621","2019",4,4,0,222000,1400.5,150.75
"901","02624","2019",4,4,0,59000,759.75,79.25
"902","02625","2019",1,1,0,126000,1938,65
"903","02626","2019",4,4,0,133937.5,1793,73.25
"904","02627","2019",3,3,0,160866.666666667,1512.33333333333,97
"905","02628","2019",2,2,0,184362.5,1324.5,146
"906","02629","2019",2,2,0,52000,623,82
"907","02631","2019",2,2,0,68500,1483.5,50
"908","02634","2019",1,1,0,110000,733,150
"909","02635","2019",1,1,0,90000,682,132
"910","02636","2019",1,1,0,175500,1032,170
"911","02637","2019",2,2,0,113500,1062,116.5
"912","02638","2019",4,4,0,129450,1264.25,103.5
"913","02639","2019",5,5,0,119842,1002.6,126.8
"914","02640","2019",1,1,0,25000,342,73
"915","02641","2019",1,1,0,80000,762,105
"916","02643","2019",8,8,0,191093.75,1692.375,136.875
"917","02644","2019",10,10,0,133260,1820.5,81.2
"918","02645","2019",5,5,0,100600,1184.4,82.8
"919","02647","2019",1,1,0,85000,833,102
"920","02648","2019",22,22,0,84345.4545454545,891.454545454545,93.4545454545455
"921","02649","2019",4,4,0,102525,1007,110.75
"922","02650","2019",5,5,0,94480,765.4,115.4
"923","02653","2019",3,3,0,224983.333333333,1808.66666666667,127.333333333333
"924","02654","2019",1,1,0,132000,1211,109
"925","02655","2019",3,3,0,93833.3333333333,1201,76
"926","02656","2019",6,6,0,188005,1191.66666666667,167.333333333333
"927","02657","2019",2,2,0,64000,787,82
"928","02658","2019",3,3,0,201333.333333333,1066,198.666666666667
"929","02659","2019",5,5,0,101790,1229.2,91.2
"930","02661","2019",2,2,0,55000,858.5,64.5
"931","02662","2019",2,2,0,82250,1221,73.5
"932","02663","2019",3,3,0,151100,1439,100
"933","02664","2019",4,4,0,134875,1435.25,94
"934","02665","2019",4,4,0,144500,1338.5,111
"935","02666","2019",11,11,0,89345.4545454545,762.181818181818,119.272727272727
"936","02668","2019",7,7,0,76200,776,100.857142857143
"937","02670","2019",5,5,0,77100,1081,87.4
"938","02671","2019",4,4,0,128000,1456.5,95.5
"939","02672","2019",7,7,0,176285.714285714,1562.85714285714,112.142857142857
"940","02675","2019",1,1,0,85000,1889,45
"941","02676","2019",16,16,0,106944.75,1136.125,95.25
"942","02680","2019",26,24,2,94669.2307692308,1073,93.2692307692308
"943","02682","2019",2,2,0,153500,1506.5,109
"944","02683","2019",1,1,0,150000,898,167
"945","02684","2019",27,27,0,93414.4444444444,952.185185185185,96.8518518518518
"946","02685","2019",1,1,0,72000,947,76
"947","02686","2019",4,4,0,98000,1128.5,88.5
"948","02687","2019",3,3,0,225624,1505.66666666667,151.333333333333
"949","02688","2019",2,2,0,96900,646,150
"950","02689","2019",2,2,0,112500,1293,87
"951","02690","2019",2,2,0,70450,854,84
"952","02691","2019",658,552,106,94310.73556231,1068.72188449848,88.7112462006079
"953","02693","2019",5,5,0,156000,2899.2,67.2
"954","02694","2019",9,9,0,97582.2222222222,1088.11111111111,91.7777777777778
"955","02697","2019",5,5,0,132080,1304.6,101.4
"956","02698","2019",2,2,0,130325,1189,111.5
"957","02699","2019",8,8,0,133275,1514.625,90.375
"958","02701","2019",9,7,2,131111.111111111,1703.77777777778,77.3333333333333
"959","02702","2019",2,2,0,189262.5,1874,105
"960","02703","2019",14,14,0,101695.714285714,997.785714285714,105
"961","02704","2019",3,3,0,85000,913,94.6666666666667
"962","02705","2019",2,2,0,120000,1215.5,100
"963","02706","2019",5,5,0,111200,1654.6,71.8
"964","02707","2019",4,4,0,83050,737,107.25
"965","02708","2019",2,2,0,151750,1003.5,152
"966","02709","2019",5,5,0,70300,740,96.6
"967","02710","2019",15,15,0,105993.866666667,987.066666666667,115.6
"968","02711","2019",2,2,0,108000,1223.5,86.5
"969","02712","2019",3,3,0,80666.6666666667,837.333333333333,87.6666666666667
"970","02713","2019",6,6,0,146458.333333333,1183.5,132.5
"971","02714","2019",2,2,0,104250,1400.5,85.5
"972","02716","2019",5,5,0,128000,1417.8,99.2
"973","02717","2019",15,15,0,129800,1112.46666666667,115.6
"974","02718","2019",2,2,0,103000,607.5,157
"975","02719","2019",26,26,0,119271.153846154,1137.96153846154,106.653846153846
"976","02720","2019",11,11,0,100177.272727273,1082.90909090909,96.7272727272727
"977","02721","2019",6,6,0,185750,1276.5,147.166666666667
"978","02722","2019",305,156,149,127407.02295082,1620.20327868852,80.8622950819672
"979","02723","2019",2,2,0,31750,437.5,74
"980","02725","2019",4,4,0,107500,849.25,135.5
"981","02726","2019",2,2,0,79500,941,85.5
"982","02727","2019",3,3,0,59666.6666666667,622.666666666667,95.3333333333333
"983","02728","2019",1,1,0,110000,1038,106
"984","02729","2019",3,3,0,158833.333333333,1731.33333333333,93.3333333333333
"985","02730","2019",4,4,0,88400,1076.25,90.5
"986","02731","2019",2,2,0,107000,772,140.5
"987","02734","2019",5,5,0,199800,1435.6,137.6
"988","02736","2019",2,2,0,135000,1072.5,121.5
"989","02737","2019",5,5,0,115200,944.8,130
"990","02738","2019",129,127,2,79624.8527131783,974.046511627907,83.015503875969
"991","02739","2019",1,1,0,168650,1222,138
"992","02740","2019",4,4,0,53750,663.5,79
"993","02741","2019",5,5,0,49800,602.6,81.8
"994","02743","2019",1,1,0,139800,847,165
"995","02744","2019",2,2,0,143300,1796,80
"996","02745","2019",1,1,0,27500,387,71
"997","02746","2019",5,5,0,116140,1373,85.6
"998","02747","2019",1,1,0,155000,1040,149
"999","02748","2019",16,16,0,106278.75,1080.75,102.4375
"1000","02749","2019",4,4,0,124375,941.5,130.5
"1001","02750","2019",10,9,1,112555,1080.5,108.7
"1002","02751","2019",1,1,0,130000,1512,86
"1003","02752","2019",3,3,0,78465.3333333333,635,115.666666666667
"1004","02753","2019",4,3,1,56500,544.25,105.75
"1005","02754","2019",5,5,0,160100,1772.6,101.8
"1006","02755","2019",7,7,0,95014.2857142857,1144.28571428571,80
"1007","02756","2019",4,4,0,141337.5,1142.75,109.75
"1008","02757","2019",4,4,0,164350,1568.25,97
"1009","02758","2019",24,19,5,114404.166666667,1241.45833333333,100.125
"1010","02759","2019",2,2,0,116500,792.5,156.5
"1011","02760","2019",4,4,0,104850,1062,94.75
"1012","02761","2019",4,4,0,107375,1044.25,117
"1013","02762","2019",4,4,0,165250,2058.25,95
"1014","02763","2019",4,4,0,177500,1270.25,139.25
"1015","02764","2019",3,3,0,115098.333333333,1310.33333333333,94.6666666666667
"1016","02765","2019",2,2,0,163500,1915.5,87
"1017","02766","2019",4,4,0,138250,1393.5,101.5
"1018","02767","2019",2,2,0,197500,1975,100
"1019","02768","2019",3,3,0,115000,902.333333333333,118.333333333333
"1020","02769","2019",8,8,0,72306.25,913.625,80
"1021","02770","2019",9,8,1,112436.666666667,1611.55555555556,76.6666666666667
"1022","02772","2019",1,1,0,82000,1000,82
"1023","02773","2019",2,2,0,46500,525.5,88.5
"1024","02774","2019",1,1,0,155000,1685,92
"1025","02775","2019",10,10,0,113770,1125.4,98.9
"1026","02776","2019",4,4,0,87000,1039,92.25
"1027","02777","2019",5,5,0,184646,1705.2,107.8
"1028","02779","2019",2,2,0,57500,687,85.5
"1029","02780","2019",14,14,0,159543.214285714,1479.21428571429,114.428571428571
"1030","02781","2019",4,4,0,109375,776.75,143
"1031","02782","2019",1,1,0,99000,971,102
"1032","02783","2019",4,4,0,134512.5,1223.75,110.5
"1033","02784","2019",2,2,0,100268.5,920.5,108.5
"1034","02785","2019",14,14,0,125127.714285714,1054.42857142857,117.214285714286
"1035","02786","2019",1,1,0,132000,1082,122
"1036","02787","2019",2,2,0,151500,1101.5,131.5
"1037","02788","2019",11,11,0,128649.090909091,1093.81818181818,116.181818181818
"1038","02789","2019",18,17,1,73311.1111111111,863.722222222222,87
"1039","02790","2019",1,1,0,143700,971,148
"1040","02791","2019",3,3,0,129833.333333333,1255.33333333333,104
"1041","02792","2019",2,2,0,158500,1749.5,91
"1042","02794","2019",2,2,0,92500,1323.5,65.5
"1043","02795","2019",19,16,3,133371.578947368,1329.15789473684,97.9473684210526
"1044","02796","2019",2,2,0,122500,1718,70
"1045","02797","2019",1,1,0,80000,667,120
"1046","02798","2019",15,15,0,163181.333333333,1781.4,101.4
"1047","02799","2019",6,6,0,122083.333333333,1245.16666666667,117.666666666667
"1048","02800","2019",5,5,0,151700,1580.2,106.8
"1049","02801","2019",1,1,0,120000,1333,90
"1050","02802","2019",1,1,0,90000,891,101
"1051","02803","2019",1,1,0,128900,1183,109
"1052","02804","2019",3,3,0,67166.6666666667,1156.66666666667,63
"1053","02805","2019",23,19,4,117074.260869565,1452.73913043478,81.0434782608696
"1054","02806","2019",2,2,0,123000,1498,81.5
"1055","02807","2019",13,13,0,148426.692307692,1173.30769230769,129.846153846154
"1056","02808","2019",6,6,0,58750,684.5,86.1666666666667
"1057","02809","2019",3,3,0,107333.333333333,1127.33333333333,95
"1058","02810","2019",119,72,47,124690.924369748,1739.78991596639,73.3865546218487
"1059","02812","2019",7,7,0,132571.428571429,1431.28571428571,96.5714285714286
"1060","02813","2019",5,5,0,129500,1289.4,107.2
"1061","02815","2019",8,8,0,130950,1155.375,112
"1062","02816","2019",5,5,0,117005,1265.8,88.4
"1063","02818","2019",11,11,0,144727.272727273,1791.36363636364,84.4545454545455
"1064","02819","2019",1,1,0,43000,434,99
"1065","02820","2019",18,18,0,123738.888888889,1190.38888888889,105.666666666667
"1066","02821","2019",9,9,0,136755.555555556,1181,115.666666666667
"1067","02822","2019",5,5,0,186352,1859.4,100.8
"1068","02824","2019",4,4,0,214500,1383.5,154.5
"1069","02826","2019",1,1,0,25250,421,60
"1070","02827","2019",8,8,0,103450,878.5,125
"1071","02828","2019",1,1,0,114000,1606,71
"1072","02830","2019",8,8,0,134412.5,1034.375,131.375
"1073","02831","2019",1,1,0,87000,696,125
"1074","02832","2019",3,3,0,132166.666666667,1200.33333333333,119.666666666667
"1075","02833","2019",4,4,0,108000,1253.5,91.25
"1076","03001","2019",41,41,0,157052.195121951,1446.90243902439,105.390243902439
"1077","03002","2019",1,1,0,75000,773,97
"1078","03003","2019",9,9,0,57609.4444444444,573.666666666667,107.333333333333
"1079","03005","2019",2,2,0,63750,879,71.5
"1080","03006","2019",12,12,0,63591.6666666667,714.75,93.75
"1081","03007","2019",3,3,0,102000,929.666666666667,97.3333333333333
"1082","03008","2019",4,4,0,61625,870,83.5
"1083","03009","2019",1,1,0,138000,1394,99
"1084","03010","2019",3,3,0,77333.3333333333,798,104.666666666667
"1085","03012","2019",4,4,0,130771.25,1035.25,134
"1086","03013","2019",35,35,0,141527.714285714,1460.2,98.3714285714286
"1087","03014","2019",4,4,0,120640,1039.5,113.25
"1088","03015","2019",3,3,0,77333.3333333333,831.666666666667,90
"1089","03017","2019",2,2,0,120500,1323.5,88.5
"1090","03018","2019",7,7,0,127935.714285714,1092.85714285714,115.142857142857
"1091","03019","2019",19,19,0,78434.2105263158,857,89.7894736842105
"1092","03020","2019",3,2,1,35833.3333333333,572,62.3333333333333
"1093","03021","2019",1,1,0,130000,1140,114
"1094","03022","2019",13,13,0,129046.153846154,992,133.076923076923
"1095","03023","2019",134,100,34,141529.835820896,1510.87313432836,91.8731343283582
"1096","03024","2019",4,4,0,47650,540,89.5
"1097","03025","2019",19,19,0,113370.789473684,1091.52631578947,106.789473684211
"1098","03026","2019",7,7,0,123714.285714286,1121.14285714286,110.428571428571
"1099","03027","2019",13,13,0,70236.9230769231,883,80.2307692307692
"1100","03028","2019",9,9,0,110368.333333333,1074.77777777778,101.222222222222
"1101","03029","2019",14,14,0,103263.071428571,1093.07142857143,98.2142857142857
"1102","03030","2019",11,11,0,117170.272727273,1089,103
"1103","03031","2019",2,2,0,233700,2003,112
"1104","03032","2019",3,3,0,102500,902.666666666667,95
"1105","03033","2019",2,2,0,76500,920,87.5
"1106","03034","2019",15,15,0,80354,908.066666666667,84.4666666666667
"1107","03035","2019",3,3,0,170666.666666667,1141.66666666667,158.666666666667
"1108","03036","2019",32,31,1,105120,1177.8125,89.75
"1109","03037","2019",1,1,0,95000,1145,83
"1110","03038","2019",6,6,0,90400,1175,80.6666666666667
"1111","03039","2019",5,5,0,127800,1311.8,96.4
"1112","03040","2019",9,9,0,143655.555555556,1445.33333333333,115.222222222222
"1113","03041","2019",1,1,0,132000,1158,114
"1114","03042","2019",11,11,0,83072.7272727273,943.818181818182,87.1818181818182
"1115","03043","2019",8,8,0,97406.25,962.625,96.875
"1116","03044","2019",12,12,0,107575,1161.5,98.1666666666667
"1117","03045","2019",14,14,0,108155.214285714,1136.07142857143,94.8571428571429
"1118","03046","2019",11,11,0,89146.8181818182,845,95.0909090909091
"1119","03047","2019",6,6,0,65583.3333333333,795.5,85.6666666666667
"1120","03048","2019",9,9,0,120450,1101.66666666667,102
"1121","03049","2019",8,8,0,115350,1884,69.375
"1122","03050","2019",4,4,0,57375,959,70.25
"1123","03051","2019",3,3,0,83696.6666666667,1038,81.6666666666667
"1124","03052","2019",6,6,0,108300,930,125.666666666667
"1125","03053","2019",7,7,0,110874.285714286,976.714285714286,109.142857142857
"1126","03054","2019",2,2,0,46500,759.5,62.5
"1127","03055","2019",10,9,1,130330,1174.5,108.7
"1128","03056","2019",4,4,0,141000,1276.75,116
"1129","03057","2019",2,2,0,73000,718,95.5
"1130","03058","2019",2,2,0,81785,1154,69
"1131","03059","2019",2,2,0,113250,1538,74.5
"1132","03060","2019",10,10,0,181277,1523.8,115.1
"1133","03061","2019",1,1,0,129700,1601,81
"1134","03062","2019",12,12,0,158058.333333333,1306.08333333333,113.583333333333
"1135","03063","2019",10,10,0,77903,968.6,80.2
"1136","03064","2019",1,1,0,30000,349,86
"1137","03065","2019",4,4,0,74495,738.25,106.75
"1138","03066","2019",3,3,0,83166.6666666667,1115.66666666667,77.6666666666667
"1139","03067","2019",1,1,0,1e+05,625,160
"1140","03068","2019",1,1,0,18000,562,32
"1141","03069","2019",6,6,0,151800,1166.83333333333,127.833333333333
"1142","03070","2019",1,1,0,227300,1590,143
"1143","03072","2019",1,1,0,50000,667,75
"1144","03073","2019",3,3,0,142041.666666667,1091.33333333333,129.666666666667
"1145","03074","2019",8,8,0,70762.5,804.625,88
"1146","03075","2019",4,4,0,100425,1058.75,99.5
"1147","03077","2019",1,1,0,94800,846,112
"1148","03078","2019",5,5,0,74600,752.4,101
"1149","03079","2019",5,5,0,89804,1096,90.2
"1150","03080","2019",8,8,0,117150,1224.625,102.375
"1151","03081","2019",5,5,0,56600,775.4,65
"1152","03082","2019",63,62,1,75615.3650793651,878.190476190476,86.6031746031746
"1153","03083","2019",8,8,0,98087.5,1044.875,95.25
"1154","03084","2019",25,25,0,81249.4,874.84,90.6
"1155","03085","2019",6,6,0,113583.333333333,1175,95.1666666666667
"1156","03086","2019",4,4,0,83750,1071.25,79.75
"1157","03087","2019",7,7,0,140485.714285714,1329.71428571429,91.4285714285714
"1158","03088","2019",8,8,0,66350,798.5,77.125
"1159","03089","2019",4,4,0,43625,730.5,60
"1160","03090","2019",3,3,0,78666.6666666667,798.666666666667,104
"1161","03091","2019",1,1,0,165800,1783,93
"1162","03092","2019",8,8,0,84487.5,767,108.75
"1163","03093","2019",11,11,0,115181.818181818,1236.90909090909,95.5454545454545
"1164","03094","2019",37,33,4,154721.621621622,1513.37837837838,101.864864864865
"1165","03095","2019",206,127,79,108891.466019417,1251.05339805825,83.368932038835
"1166","03096","2019",4,4,0,107730,832.75,105.75
"1167","03097","2019",4,4,0,101855,727.5,120
"1168","03098","2019",46,41,5,91142.6086956522,1047.41304347826,84.0652173913043
"1169","03099","2019",1,1,0,27500,458,60
"1170","03100","2019",18,18,0,82458.3333333333,1003.77777777778,87.6666666666667
"1171","03101","2019",102,97,5,107513.303921569,1163.28431372549,93.1960784313726
"1172","03102","2019",24,22,2,96708.3333333333,1030.83333333333,96.7916666666667
"1173","03103","2019",9,8,1,119866.666666667,914.444444444444,135
"1174","03104","2019",9,9,0,81582.2222222222,866.222222222222,99.7777777777778
"1175","03105","2019",1,1,0,107000,1115,96
"1176","03106","2019",11,11,0,118937.818181818,1195.27272727273,105.272727272727
"1177","03107","2019",15,15,0,138497.333333333,1069.86666666667,128.8
"1178","03108","2019",8,8,0,55033.75,828.875,68.875
"1179","03109","2019",6,6,0,105308.333333333,1148.66666666667,98.5
"1180","03110","2019",15,15,0,162399.333333333,1544.06666666667,111.2
"1181","03111","2019",9,9,0,99100,998.333333333333,95.5555555555556
"1182","03112","2019",5,5,0,96900,1004.6,95
"1183","03113","2019",4,4,0,69250,610,112
"1184","03114","2019",1,1,0,203117,1354,150
"1185","03115","2019",11,11,0,131136.363636364,1105.81818181818,116.363636363636
"1186","03116","2019",3,3,0,53333.3333333333,832,73
"1187","03117","2019",7,7,0,98214.2857142857,1043.71428571429,96.5714285714286
"1188","03118","2019",81,75,6,105713.333333333,1227,87.8888888888889
"1189","03120","2019",6,6,0,87500,1129.5,78.8333333333333
"1190","03121","2019",5,5,0,161380,1337.8,120.6
"1191","03122","2019",6,6,0,68816.6666666667,893.5,76.5
"1192","03124","2019",2,2,0,62500,781,80
"1193","03125","2019",2,2,0,54700,849,83
"1194","03126","2019",11,9,2,100772.727272727,1111.72727272727,92.3636363636364
"1195","03127","2019",9,9,0,77058.8888888889,763.888888888889,113.444444444444
"1196","03128","2019",24,24,0,91406.5416666667,1033.70833333333,90.2083333333333
"1197","03129","2019",5,5,0,137700,948.8,132.2
"1198","03130","2019",4,4,0,82625,763.5,115
"1199","03131","2019",4,4,0,130807.5,1010,134.25
"1200","03132","2019",4,4,0,85375,1108.75,85
"1201","03133","2019",5,5,0,97110,995.4,96.8
"1202","03134","2019",1,1,0,130000,2167,60
"1203","03135","2019",7,7,0,124164.285714286,1673.71428571429,76.4285714285714
"1204","03137","2019",3,3,0,79808.3333333333,1144.33333333333,66.6666666666667
"1205","03138","2019",37,32,5,72214.5135135135,864.918918918919,83.945945945946
"1206","03139","2019",7,5,2,80185.7142857143,1607.28571428571,68.7142857142857
"1207","03140","2019",12,12,0,87916.6666666667,1049.08333333333,84.1666666666667
"1208","03141","2019",1,1,0,25000,455,55
"1209","03142","2019",4,4,0,104530,782.5,130.25
"1210","03143","2019",1,1,0,60000,480,125
"1211","03144","2019",2,2,0,53500,1000,50
"1212","03145","2019",3,3,0,150650,1222.33333333333,134
"1213","03146","2019",3,3,0,148000,887.333333333333,167.666666666667
"1214","03147","2019",3,3,0,50333.3333333333,723.666666666667,69
"1215","03149","2019",6,6,0,130066.666666667,1034,123
"1216","03151","2019",2,2,0,50000,720,76
"1217","03152","2019",6,6,0,102400,1159,94.1666666666667
"1218","03154","2019",2,2,0,137985,1246,110
"1219","03155","2019",18,18,0,78594.4444444444,868.388888888889,90.4444444444444
"1220","03156","2019",16,16,0,104506.25,1238.125,83.75
"1221","03157","2019",11,10,1,106974.545454545,1082.90909090909,103
"1222","03158","2019",12,12,0,145224.333333333,1603.16666666667,108.916666666667
"1223","03159","2019",12,12,0,103566.666666667,1026.41666666667,98.4166666666667
"1224","03160","2019",3,3,0,86000,878.333333333333,106.333333333333
"1225","03161","2019",11,11,0,67645.4545454545,878.909090909091,77.9090909090909
"1226","03162","2019",2,2,0,72090,1025,74
"1227","03163","2019",11,11,0,164318.181818182,1394.45454545455,112.272727272727
"1228","03164","2019",6,6,0,90583.3333333333,806.666666666667,99
"1229","03165","2019",15,14,1,87700,968.466666666667,101.2
"1230","03166","2019",3,3,0,90900,901,110.333333333333
"1231","03167","2019",5,5,0,119200,1041.4,106.6
"1232","03168","2019",14,13,1,65478.5714285714,1061.78571428571,69.2142857142857
"1233","03169","2019",4,4,0,92475,1065,75.25
"1234","03171","2019",5,5,0,106890,1094.8,98.2
"1235","03172","2019",3,3,0,74766.6666666667,688.666666666667,100
"1236","03173","2019",12,11,1,110533.333333333,1178.33333333333,93.4166666666667
"1237","03174","2019",7,7,0,91071.4285714286,1019.57142857143,96.2857142857143
"1238","03175","2019",3,3,0,34000,520,76.3333333333333
"1239","03176","2019",8,8,0,100425,1028.125,103.625
"1240","03177","2019",2,2,0,34000,555.5,56
"1241","03178","2019",6,6,0,95466.6666666667,872.333333333333,114.333333333333
"1242","03179","2019",2,2,0,342850,2247,121
"1243","03180","2019",4,4,0,119800,1210.25,107.25
"1244","03181","2019",8,8,0,69993.75,931.5,77.75
"1245","03182","2019",6,6,0,158250,1420,101
"1246","03183","2019",4,3,1,92168.75,814.5,124.5
"1247","03184","2019",7,7,0,166150,1900.57142857143,98
"1248","03185","2019",446,254,192,76885.5448430493,937.381165919282,81.7309417040359
"1249","03186","2019",16,15,1,78523.4375,749.75,112.6875
"1250","03187","2019",6,6,0,92866.6666666667,1099.33333333333,80.6666666666667
"1251","03189","2019",12,12,0,80750,843.166666666667,91.25
"1252","03190","2019",260,102,158,101269.830769231,1370.75769230769,78.0538461538462
"1253","03191","2019",3,3,0,83666.6666666667,939.333333333333,89.6666666666667
"1254","03192","2019",4,4,0,86250,1172.5,77.75
"1255","03193","2019",3,3,0,124666.666666667,1278.33333333333,93.3333333333333
"1256","03194","2019",2,2,0,38770,768.5,49.5
"1257","03195","2019",31,29,2,108058.322580645,1107.93548387097,96.5161290322581
"1258","03196","2019",2,2,0,50000,575,86.5
"1259","03197","2019",21,21,0,105143.80952381,1063.85714285714,99.5714285714286
"1260","03198","2019",1,1,0,48400,1210,40
"1261","03200","2019",22,22,0,138595.454545455,1389.68181818182,101.909090909091
"1262","03201","2019",5,5,0,84786.6,880,100.2
"1263","03202","2019",14,14,0,83962.8571428571,1027.64285714286,78.5714285714286
"1264","03203","2019",2,2,0,85000,711.5,110.5
"1265","03204","2019",1,1,0,161080,1491,108
"1266","03205","2019",3,3,0,85806.6666666667,1036,79.3333333333333
"1267","03206","2019",2,2,0,85000,957.5,74.5
"1268","03207","2019",11,11,0,90863.6363636364,1066.18181818182,87.2727272727273
"1269","03208","2019",1,1,0,79555,1591,50
"1270","03210","2019",6,6,0,152364.166666667,809.166666666667,145.5
"1271","03211","2019",24,23,1,142995.416666667,1356.16666666667,104
"1272","03212","2019",10,10,0,122550,1248.1,91.8
"1273","03213","2019",6,6,0,112800,1056,106.5
"1274","03214","2019",3,3,0,152178.333333333,1887.33333333333,92.6666666666667
"1275","03215","2019",4,4,0,121087.5,1135,121.5
"1276","03216","2019",2,2,0,159100,697.5,226
"1277","03217","2019",4,4,0,95366.25,1035.5,93.25
"1278","03218","2019",1,1,0,102550,820,125
"1279","03220","2019",7,7,0,107785.714285714,1320.42857142857,79.7142857142857
"1280","03221","2019",12,12,0,91562.5,979.833333333333,80.25
"1281","03223","2019",5,5,0,130000,1177.6,116.2
"1282","03224","2019",4,4,0,48125,572.75,87
"1283","03225","2019",7,7,0,70785.7142857143,950.142857142857,75.7142857142857
"1284","03227","2019",5,5,0,128400,1280.6,105.6
"1285","03229","2019",2,2,0,79950,493.5,156.5
"1286","03230","2019",12,12,0,112639.166666667,966.5,119.75
"1287","03231","2019",2,2,0,49500,682.5,79
"1288","03232","2019",1,1,0,62500,595,105
"1289","03233","2019",4,4,0,154975,1337.75,114.25
"1290","03234","2019",10,10,0,113035,1083.5,105.1
"1291","03235","2019",7,6,1,64806.8571428571,862.285714285714,76.2857142857143
"1292","03236","2019",48,43,5,102299.5,1136.8125,88.9375
"1293","03237","2019",9,9,0,106255.555555556,1067.55555555556,109.222222222222
"1294","03238","2019",5,5,0,91290,1062.6,85.2
"1295","03239","2019",3,3,0,56833.3333333333,804.666666666667,70.6666666666667
"1296","03240","2019",12,12,0,59652.5,882.083333333333,73.3333333333333
"1297","03241","2019",4,4,0,56750,504.25,117
"1298","03242","2019",9,9,0,103288.888888889,974.777777777778,108.111111111111
"1299","03244","2019",1,1,0,26500,331,80
"1300","03245","2019",1,1,0,45000,634,71
"1301","03246","2019",5,5,0,88400,974.6,87
"1302","03247","2019",9,9,0,137000,1524.88888888889,85.2222222222222
"1303","03248","2019",2,2,0,53500,628,85
"1304","03249","2019",4,4,0,36500,612.5,63
"1305","03250","2019",4,4,0,83525,1096.5,72.75
"1306","03251","2019",10,9,1,82990,741,116.3
"1307","03252","2019",7,7,0,178407.428571429,1609.57142857143,108.285714285714
"1308","03253","2019",3,3,0,70210.3333333333,1023,69
"1309","03254","2019",65,53,12,101009.230769231,1187.13846153846,87.2769230769231
"1310","03255","2019",4,4,0,59500,842.5,74.5
"1311","03257","2019",6,6,0,94891.6666666667,1053.66666666667,86.5
"1312","03258","2019",18,18,0,140198.888888889,1421.33333333333,93.5
"1313","03259","2019",5,5,0,79560,845.4,98.2
"1314","03260","2019",1,1,0,52000,351,148
"1315","03261","2019",1,1,0,24000,480,50
"1316","03262","2019",20,19,1,144575,1522.1,96.5
"1317","03263","2019",2,2,0,103000,1152,100.5
"1318","03264","2019",33,33,0,112199.848484848,1315.69696969697,83.7878787878788
"1319","03265","2019",9,9,0,100191.111111111,1034.11111111111,96.1111111111111
"1320","03266","2019",3,3,0,96949.3333333333,991.333333333333,103.333333333333
"1321","03267","2019",10,10,0,128517.3,1432.4,93.8
"1322","03268","2019",3,3,0,108166.666666667,1472.33333333333,80
"1323","03271","2019",17,17,0,123474.705882353,1241.23529411765,95.5294117647059
"1324","03272","2019",3,3,0,77000,737.333333333333,101.333333333333
"1325","03273","2019",5,5,0,149340,1195.6,123.4
"1326","03274","2019",2,2,0,147500,2950,50
"1327","03275","2019",30,28,2,92507.9,997.266666666667,96.4333333333333
"1328","03276","2019",3,3,0,116500,1083.33333333333,130
"1329","03277","2019",1,1,0,64000,941,68
"1330","03278","2019",1,1,0,319900,1600,200
"1331","03279","2019",10,10,0,108200,1100.5,100.1
"1332","03280","2019",3,3,0,62333.3333333333,953,75.3333333333333
"1333","03281","2019",4,4,0,97887.5,1029.75,100
"1334","03282","2019",5,5,0,89210,894.8,102.6
"1335","03283","2019",9,9,0,105716.666666667,1007.11111111111,99.7777777777778
"1336","03284","2019",5,5,0,59480,755.8,80.8
"1337","03285","2019",1,1,0,74000,569,130
"1338","03286","2019",13,13,0,144550,1503.07692307692,93.6153846153846
"1339","03287","2019",4,4,0,74750,798.75,84.5
"1340","03288","2019",7,7,0,83357.1428571429,1056.71428571429,78.4285714285714
"1341","03289","2019",1,1,0,22500,375,60
"1342","03290","2019",19,19,0,160623.157894737,1407.68421052632,114.684210526316
"1343","03291","2019",6,6,0,81066.6666666667,945.666666666667,87.5
"1344","03292","2019",4,4,0,73587.5,900.75,79.5
"1345","03293","2019",8,8,0,82700,1220.625,81.5
"1346","03294","2019",2,2,0,115000,2683.5,56.5
"1347","03295","2019",1,1,0,125000,969,129
"1348","03296","2019",4,4,0,58500,762.25,78
"1349","03297","2019",24,24,0,72966.25,815.791666666667,86.125
"1350","03298","2019",41,35,6,73081.2195121951,916.90243902439,79.9512195121951
"1351","03300","2019",3,3,0,78666.6666666667,830.333333333333,94.6666666666667
"1352","03301","2019",12,12,0,110083.166666667,1080.33333333333,98.9166666666667
"1353","03302","2019",1,1,0,105000,795,132
"1354","03303","2019",2,2,0,116500,1766,72.5
"1355","03304","2019",31,31,0,118735.483870968,1204.51612903226,99.2258064516129
"1356","03305","2019",6,6,0,124725,1370.16666666667,91.1666666666667
"1357","03306","2019",18,18,0,131421.555555556,1400.94444444444,96.3888888888889
"1358","03307","2019",2,2,0,148470,2045,84.5
"1359","03308","2019",4,4,0,122625,1427.5,88.5
"1360","03309","2019",3,3,0,48833.3333333333,540.666666666667,90.6666666666667
"1361","03310","2019",753,184,569,104536.491367862,1387.15803452855,72.4860557768924
"1362","03311","2019",7,7,0,130857.142857143,1285.71428571429,99
"1363","03312","2019",1,1,0,50000,847,59
"1364","03313","2019",5,5,0,96391.2,1070,85.6
"1365","03314","2019",15,15,0,153972.666666667,1259.46666666667,125.266666666667
"1366","03315","2019",15,15,0,89660.6666666667,909.933333333333,101.133333333333
"1367","03316","2019",15,15,0,114134,1109.6,103.266666666667
"1368","03317","2019",3,3,0,76700,828.666666666667,91.3333333333333
"1369","03319","2019",4,4,0,68000,900.25,71.25
"1370","03320","2019",8,8,0,74913.75,695.5,101.875
"1371","03321","2019",141,120,21,115389.184397163,1360.13475177305,85.6099290780142
"1372","04001","2019",9,6,3,216216.666666667,2241.88888888889,97.7777777777778
"1373","04004","2019",15,13,2,116233.333333333,1792.13333333333,63.4
"1374","04005","2019",1,0,1,34600,1048,33
"1375","04006","2019",158,13,145,66387.164556962,1954.98101265823,31.4873417721519
"1376","04007","2019",2,2,0,104050,1236,84.5
"1377","04008","2019",19,8,11,92494.3157894737,1722.36842105263,53.4210526315789
"1378","04012","2019",1,1,0,474500,3163,150
"1379","04013","2019",5,4,1,124420,1592.6,81
"1380","04017","2019",3,0,3,23284.3333333333,1082.33333333333,22.3333333333333
"1381","04018","2019",19,15,4,209492.105263158,2307.89473684211,99.1052631578947
"1382","04019","2019",82,11,71,102464,2049.70731707317,51.1829268292683
"1383","04020","2019",2,2,0,89600,858.5,102.5
"1384","04021","2019",1,1,0,355000,2336,152
"1385","04022","2019",8,5,3,71268.75,1125.375,57.125
"1386","04023","2019",6,6,0,185733.333333333,2294.66666666667,101
"1387","04024","2019",1,1,0,41000,719,57
"1388","04025","2019",19,16,3,165687.368421053,2162.84210526316,79.4210526315789
"1389","04026","2019",1,1,0,140000,1474,95
"1390","04027","2019",3,3,0,232916.666666667,1860.66666666667,123.666666666667
"1391","04028","2019",1,1,0,345000,1438,240
"1392","04031","2019",11,11,0,159765.454545455,1857,86.3636363636364
"1393","04032","2019",2,2,0,104416.5,2128.5,51.5
"1394","04033","2019",8,8,0,158135.25,1830.75,97.125
"1395","04034","2019",10,10,0,180274.1,2032.7,95
"1396","04035","2019",4,1,3,138250,1427.5,91.25
"1397","04036","2019",12,9,3,171444.166666667,1818.58333333333,89.4166666666667
"1398","04037","2019",1,1,0,53000,1205,44
"1399","04039","2019",25,17,8,122162,2172.2,66.56
"1400","04040","2019",1,1,0,222700,1856,120
"1401","04041","2019",2,2,0,192000,2067.5,91.5
"1402","04042","2019",1,0,1,154000,2110,73
"1403","04043","2019",2,2,0,102000,1200.5,85
"1404","04045","2019",22,21,1,201826.818181818,2200.77272727273,90.5909090909091
"1405","04047","2019",2,2,0,409000,3866.5,95
"1406","04049","2019",52,25,27,142994.980769231,1732.53846153846,84.9615384615385
"1407","04051","2019",2,2,0,142500,1824,76
"1408","04053","2019",4,3,1,195350,2129.25,99
"1409","04058","2019",2,2,0,202000,2583,79
"1410","04059","2019",3,3,0,74333.3333333333,1089.66666666667,68.3333333333333
"1411","04061","2019",15,10,5,114933.4,1687.6,69.1333333333333
"1412","04062","2019",4,1,3,70525,792.5,95.25
"1413","04063","2019",14,14,0,245721.428571429,2519.78571428571,96.5714285714286
"1414","04065","2019",9,9,0,210057.777777778,2767.88888888889,79
"1415","04066","2019",3,3,0,350600,3575.66666666667,115.666666666667
"1416","04067","2019",1,1,0,3e+05,4110,73
"1417","04068","2019",11,11,0,263924.545454545,2637.81818181818,100
"1418","04070","2019",231,72,159,113369.051948052,1612.25974025974,69.8917748917749
"1419","04072","2019",3,3,0,332076.666666667,2307.33333333333,144.666666666667
"1420","04073","2019",50,8,42,83569.5,1800.26,42.44
"1421","04074","2019",1,0,1,80000,741,108
"1422","04075","2019",5,5,0,267390,2779.8,102.2
"1423","04076","2019",6,3,3,116916.666666667,2075.33333333333,58.8333333333333
"1424","04077","2019",2,2,0,142100,1708.5,87.5
"1425","04079","2019",13,11,2,175548.461538462,2103.84615384615,82.5384615384615
"1426","04081","2019",6,5,1,185920,2506.83333333333,75.5
"1427","04084","2019",4,4,0,87925,1403,63.75
"1428","04085","2019",1,1,0,32500,1121,29
"1429","04086","2019",3,2,1,195433.333333333,2144.66666666667,80.3333333333333
"1430","04087","2019",1,1,0,280912,2531,111
"1431","04088","2019",80,39,41,206152.15,2265.5625,88.3
"1432","04090","2019",1,1,0,222500,1636,136
"1433","04091","2019",1,1,0,150600,2353,64
"1434","04092","2019",3,2,1,42500,1214.66666666667,38.6666666666667
"1435","04094","2019",148,36,112,114704.310810811,2681.27027027027,45.3378378378378
"1436","04095","2019",2,2,0,290898,1847,146.5
"1437","04096","2019",21,6,15,113041.666666667,1567.14285714286,74.3333333333333
"1438","04097","2019",3,3,0,49600,976,51.6666666666667
"1439","04099","2019",1,1,0,87500,1182,74
"1440","04101","2019",6,6,0,162757.5,1671.16666666667,113.666666666667
"1441","04102","2019",2,2,0,95000,1708.5,55
"1442","04104","2019",2,2,0,377400,2017.5,187
"1443","04106","2019",4,3,1,352425,2544.75,149.5
"1444","04108","2019",16,12,4,148458.75,1658.125,84.375
"1445","04109","2019",9,9,0,257011.888888889,2556.33333333333,102.333333333333
"1446","04110","2019",8,8,0,155046.5,2484.25,66.25
"1447","04111","2019",13,12,1,223173.076923077,2611.15384615385,89
"1448","04112","2019",310,114,196,150838.806451613,1998.14193548387,75.9193548387097
"1449","04113","2019",4,4,0,164922.5,2056.75,76.25
"1450","04115","2019",10,7,3,100818,2853.6,49.7
"1451","04116","2019",24,21,3,157786.25,1945.70833333333,85.7083333333333
"1452","04118","2019",1,1,0,343000,2541,135
"1453","04120","2019",2,2,0,231650,1880,130
"1454","04121","2019",4,3,1,144000,1686,82.75
"1455","04122","2019",6,6,0,164066.666666667,1950.33333333333,80.6666666666667
"1456","04123","2019",8,8,0,197725,1781.5,108.25
"1457","04124","2019",10,10,0,165876.5,1947.3,83.3
"1458","04126","2019",44,14,30,86011.4772727273,1797.79545454545,49
"1459","04127","2019",1,1,0,226150,2406,94
"1460","04128","2019",1,1,0,80000,1333,60
"1461","04129","2019",1,1,0,450000,4787,94
"1462","04130","2019",1,1,0,35000,1207,29
"1463","04132","2019",1,1,0,136500,3102,44
"1464","04133","2019",5,5,0,73680,1075.2,66.4
"1465","04134","2019",7,7,0,115946.428571429,1929.71428571429,60.7142857142857
"1466","04135","2019",6,6,0,399166.666666667,3627.16666666667,119.833333333333
"1467","04136","2019",7,7,0,61367.1428571429,1108.14285714286,58.7142857142857
"1468","04138","2019",2,2,0,235965,1400.5,136
"1469","04139","2019",5,5,0,179932,2229.8,81.2
"1470","04141","2019",3,3,0,228333.333333333,2792.66666666667,83.6666666666667
"1471","04143","2019",89,70,19,197497.685393258,2117.51685393258,93.1011235955056
"1472","04144","2019",4,4,0,81137.5,1852.75,51
"1473","04145","2019",11,11,0,196545.454545455,1936.18181818182,106
"1474","04148","2019",5,5,0,133600,1437,92
"1475","04149","2019",42,36,6,174772.30952381,1776.88095238095,94.4285714285714
"1476","04150","2019",2,0,2,38893,1576.5,24.5
"1477","04151","2019",9,9,0,288736.666666667,2411.77777777778,109.666666666667
"1478","04152","2019",54,52,2,246403.888888889,2417.05555555556,102.759259259259
"1479","04155","2019",5,4,1,66700,917.4,67.8
"1480","04156","2019",2,2,0,110765,1337,87.5
"1481","04157","2019",9,9,0,116277.777777778,1476.66666666667,74
"1482","04158","2019",10,9,1,145689.3,1959.9,75.9
"1483","04160","2019",23,19,4,221428.260869565,2661.39130434783,86.0434782608696
"1484","04161","2019",7,7,0,103797.142857143,1249.28571428571,73.2857142857143
"1485","04162","2019",3,3,0,63333.3333333333,1013.33333333333,65.3333333333333
"1486","04163","2019",6,5,1,96495,1322.83333333333,69.6666666666667
"1487","04164","2019",1,1,0,195000,1573,124
"1488","04166","2019",23,19,4,177972.434782609,1969.69565217391,88.8695652173913
"1489","04167","2019",4,3,1,144387.5,1677,85
"1490","04169","2019",2,2,0,132500,2563.5,62.5
"1491","04170","2019",2,2,0,60000,1226,46
"1492","04171","2019",5,4,1,150000,2418.6,57.4
"1493","04172","2019",7,7,0,136470,1707,77.7142857142857
"1494","04173","2019",10,10,0,134325,1973.9,69.4
"1495","04174","2019",3,3,0,150666.666666667,2852.66666666667,51.6666666666667
"1496","04175","2019",1,1,0,455000,2974,153
"1497","04176","2019",5,4,1,248900,2461.8,95.8
"1498","04177","2019",1,1,0,696300,4025,173
"1499","04178","2019",24,21,3,177107.916666667,1992,86.625
"1500","04179","2019",1,1,0,95000,2375,40
"1501","04180","2019",1,1,0,80000,833,96
"1502","04182","2019",5,5,0,201560,2595,80.6
"1503","04184","2019",3,3,0,95000,1716.33333333333,59
"1504","04186","2019",3,1,2,174320.333333333,2388,74
"1505","04188","2019",18,15,3,172163.444444444,2074.33333333333,86.6111111111111
"1506","04189","2019",13,13,0,153829.923076923,2115,73.2307692307692
"1507","04192","2019",14,13,1,173546.428571429,2126.64285714286,82.8571428571429
"1508","04193","2019",7,7,0,117928.571428571,1342.14285714286,94.2857142857143
"1509","04194","2019",4,4,0,115537.5,1621.75,78
"1510","04195","2019",7,6,1,138792.857142857,1743.57142857143,64
"1511","04197","2019",43,33,10,176093.976744186,1988.90697674419,87.6976744186046
"1512","04199","2019",4,4,0,235454.25,2662,105.25
"1513","04200","2019",6,6,0,243156.5,2617.66666666667,95.1666666666667
"1514","04201","2019",3,3,0,156000,1708.66666666667,86
"1515","04202","2019",7,5,2,165969.571428571,2038.42857142857,75.8571428571429
"1516","04203","2019",13,4,9,75371.1538461538,1707.30769230769,42.4615384615385
"1517","04204","2019",2,1,1,27200,586,47.5
"1518","04205","2019",46,16,30,90939.7826086956,1534.08695652174,55.2608695652174
"1519","04206","2019",7,7,0,128735.714285714,2032.71428571429,83.7142857142857
"1520","04208","2019",10,9,1,155075,1983.7,76.3
"1521","04209","2019",76,40,36,128947.210526316,1679.84210526316,75.9473684210526
"1522","04210","2019",2,0,2,42975,1258,42.5
"1523","04211","2019",1,1,0,194000,1687,115
"1524","04214","2019",4,4,0,152525,1753.25,87
"1525","04216","2019",4,4,0,153250,2398,65.5
"1526","04217","2019",14,10,4,175523.571428571,1943.85714285714,86.4285714285714
"1527","04218","2019",7,6,1,85475.7142857143,1316.71428571429,68.4285714285714
"1528","04219","2019",9,9,0,111732.777777778,1391.66666666667,79
"1529","04220","2019",12,6,6,118473.166666667,1783.25,67.9166666666667
"1530","04222","2019",4,3,1,118875,2018.25,58.25
"1531","04224","2019",1,1,0,57000,633,90
"1532","04226","2019",113,8,105,93715.7610619469,2325.70796460177,39.1504424778761
"1533","04227","2019",9,9,0,145422.222222222,2148.44444444444,67.6666666666667
"1534","04228","2019",1,1,0,72100,1602,45
"1535","04229","2019",2,1,1,161000,1449,111
"1536","04230","2019",42,36,6,177503.095238095,2088.80952380952,88.9523809523809
"1537","04231","2019",1,1,0,160000,1758,91
"1538","04233","2019",3,3,0,164000,1378,116.666666666667
"1539","04234","2019",1,1,0,165000,1684,98
"1540","04235","2019",1,1,0,63000,630,100
"1541","04236","2019",3,3,0,132566.666666667,1371.33333333333,104.333333333333
"1542","04237","2019",5,3,2,111100,1261.6,76.6
"1543","04240","2019",9,7,2,96144.4444444444,1505.55555555556,67.7777777777778
"1544","04241","2019",2,2,0,237050,2134,111
"1545","04242","2019",42,40,2,234938.547619048,2307.97619047619,103.119047619048
"1546","04244","2019",30,18,12,148303.333333333,1890.26666666667,80.8333333333333
"1547","04245","2019",36,31,5,184467.055555556,2145.97222222222,87.8333333333333
"1548","05001","2019",7,2,5,142461.857142857,2391.28571428571,60.4285714285714
"1549","05003","2019",10,3,7,74060,1304.9,58
"1550","05004","2019",58,9,49,97036.7931034483,2177.34482758621,44.7413793103448
"1551","05006","2019",12,6,6,139501.666666667,1733,81.0833333333333
"1552","05007","2019",4,2,2,102000,1905.5,62
"1553","05008","2019",11,10,1,119279.090909091,1320.27272727273,84.0909090909091
"1554","05009","2019",2,2,0,152500,1085.5,128
"1555","05010","2019",14,14,0,127003.142857143,1424.78571428571,86.2142857142857
"1556","05012","2019",9,4,5,196833.333333333,2936.77777777778,71.5555555555556
"1557","05013","2019",3,2,1,196450,2267,82.3333333333333
"1558","05014","2019",1,1,0,120000,857,140
"1559","05016","2019",3,2,1,96316.6666666667,1537.66666666667,61.3333333333333
"1560","05017","2019",28,23,5,219451.214285714,2526.07142857143,92.5357142857143
"1561","05018","2019",7,7,0,252619.285714286,2353.85714285714,106.285714285714
"1562","05019","2019",2,2,0,83850,1279.5,65
"1563","05021","2019",2,2,0,139500,1602.5,88.5
"1564","05022","2019",4,4,0,124487.5,1484.25,76.5
"1565","05023","2019",267,34,233,148670.434456929,2309.7265917603,63.5093632958801
"1566","05024","2019",1,1,0,62000,1590,39
"1567","05025","2019",2,1,1,128000,2014.5,65
"1568","05026","2019",13,4,9,147983.461538462,3032.53846153846,45.3076923076923
"1569","05027","2019",7,4,3,127979.285714286,1819.85714285714,74
"1570","05029","2019",11,8,3,188283.454545455,1731.63636363636,114.545454545455
"1571","05031","2019",3,3,0,194499,2404,80.6666666666667
"1572","05032","2019",3,2,1,108079,1308.33333333333,73.6666666666667
"1573","05033","2019",2,2,0,278140,2409.5,165
"1574","05036","2019",17,12,5,188559.764705882,2488.52941176471,76.4705882352941
"1575","05037","2019",5,5,0,323030,2463,138.2
"1576","05038","2019",4,2,2,169485,1746.25,82.75
"1577","05039","2019",6,5,1,136500,1608.33333333333,86.8333333333333
"1578","05040","2019",41,30,11,192391.951219512,2510.65853658537,80
"1579","05044","2019",2,0,2,101792.5,2827.5,36
"1580","05045","2019",14,11,3,249337.142857143,2191.64285714286,107.857142857143
"1581","05046","2019",168,28,140,167112.672619048,2696.44047619048,62.0416666666667
"1582","05047","2019",2,2,0,135000,1687,80
"1583","05048","2019",2,2,0,199000,1829.5,113
"1584","05049","2019",2,2,0,169700,1479,122
"1585","05050","2019",7,2,5,91678.5714285714,1474.14285714286,67.7142857142857
"1586","05052","2019",10,5,5,179624,2156.2,80.1
"1587","05053","2019",4,4,0,134425,2123.75,66.25
"1588","05054","2019",3,0,3,61333.3333333333,1380.33333333333,45.6666666666667
"1589","05055","2019",8,8,0,123833.125,1198.125,103.875
"1590","05056","2019",3,3,0,161166.666666667,2395.33333333333,66.6666666666667
"1591","05058","2019",4,4,0,153800,2251,64.75
"1592","05059","2019",8,8,0,256491.25,2410.125,105
"1593","05061","2019",588,153,435,168821.930272109,2215.69727891156,76.4965986394558
"1594","05062","2019",2,2,0,106750,1648,69
"1595","05063","2019",12,5,7,96042.5,2877.08333333333,36.25
"1596","05064","2019",2,1,1,56520,942.5,54.5
"1597","05065","2019",47,8,39,144625.574468085,2134.51063829787,68
"1598","05066","2019",1,1,0,145000,1074,135
"1599","05068","2019",5,5,0,266320,2717,97
"1600","05070","2019",28,17,11,129598.428571429,1531.53571428571,84.2142857142857
"1601","05071","2019",3,3,0,130411.666666667,1587.66666666667,78.6666666666667
"1602","05072","2019",18,4,14,82773.6666666667,1788.27777777778,43.7222222222222
"1603","05073","2019",2,2,0,250000,2034.5,122.5
"1604","05074","2019",4,4,0,197815,2078.25,87.75
"1605","05075","2019",17,17,0,163178.235294118,2833.64705882353,75.4705882352941
"1606","05077","2019",18,4,14,168993.888888889,3086.77777777778,56.3888888888889
"1607","05078","2019",2,2,0,196650,2264,86.5
"1608","05079","2019",53,16,37,308980.452830189,3632.60377358491,80.811320754717
"1609","05080","2019",2,2,0,105650,1109.5,95.5
"1610","05081","2019",2,2,0,23000,466,49
"1611","05082","2019",1,1,0,270000,3649,74
"1612","05084","2019",2,2,0,207365,2873.5,74.5
"1613","05085","2019",58,7,51,207225.827586207,3862.70689655172,54.1034482758621
"1614","05086","2019",4,4,0,153070.75,1671,93.5
"1615","05087","2019",5,5,0,162084,1546.2,101.6
"1616","05090","2019",3,2,1,140896.666666667,1623.66666666667,94
"1617","05092","2019",6,6,0,264866.666666667,4040.5,100.833333333333
"1618","05093","2019",15,6,9,198627.266666667,2851.6,71.1333333333333
"1619","05095","2019",6,6,0,131913.333333333,1661.5,88.3333333333333
"1620","05096","2019",121,12,109,81861.9504132231,1792.64462809917,46.3388429752066
"1621","05097","2019",7,6,1,110940.714285714,1664.57142857143,62.7142857142857
"1622","05098","2019",88,5,83,93738.5,2550.98863636364,36.75
"1623","05099","2019",4,3,1,168155,1576.25,104
"1624","05100","2019",4,4,0,421575,2983.75,141
"1625","05101","2019",39,12,27,151680.564102564,2514.41025641026,57.6923076923077
"1626","05102","2019",2,2,0,145000,1277.5,106.5
"1627","05103","2019",8,8,0,178550,1900.25,95.75
"1628","05104","2019",14,13,1,177741.785714286,1859.5,95.5714285714286
"1629","05106","2019",6,4,2,303783.333333333,2481.33333333333,126.333333333333
"1630","05107","2019",2,2,0,388500,2609.5,151.5
"1631","05108","2019",1,1,0,160000,4444,36
"1632","05109","2019",3,1,2,78345,1113.33333333333,94.3333333333333
"1633","05110","2019",82,7,75,73378.9512195122,1958.96341463415,33.0609756097561
"1634","05111","2019",6,5,1,284016.666666667,3475.33333333333,85.5
"1635","05112","2019",3,3,0,67333.3333333333,1447,54.3333333333333
"1636","05113","2019",2,0,2,156556.5,1772,95
"1637","05114","2019",10,4,6,123323.1,2314.3,51
"1638","05115","2019",5,5,0,119880,1394.2,87.6
"1639","05116","2019",3,3,0,199969.333333333,2382.66666666667,85.3333333333333
"1640","05117","2019",1,1,0,130000,1398,93
"1641","05118","2019",23,17,6,140343.47826087,1715.30434782609,79.3913043478261
"1642","05119","2019",114,5,109,92944.149122807,3112.29824561404,29.2543859649123
"1643","05121","2019",4,4,0,166311.25,2242,74.75
"1644","05122","2019",10,10,0,199393,1903.9,107.6
"1645","05123","2019",16,11,5,167049.6875,1927.625,99.625
"1646","05124","2019",2,2,0,236950,1852.5,129.5
"1647","05126","2019",7,7,0,87657.1428571429,955.428571428571,102.857142857143
"1648","05127","2019",4,1,3,126862.5,1677.75,77.25
"1649","05128","2019",4,4,0,244250,2429.5,96.25
"1650","05129","2019",2,2,0,224925,3247.5,82
"1651","05130","2019",5,5,0,460003,3037.4,148.6
"1652","05132","2019",34,19,15,132441.323529412,1788.41176470588,72.4117647058823
"1653","05133","2019",81,11,70,175816.555555556,3210.46913580247,49.9753086419753
"1654","05134","2019",8,3,5,101643.75,1466,69.75
"1655","05135","2019",1,1,0,249700,2098,119
"1656","05136","2019",9,5,4,219555.555555556,2375.55555555556,92.8888888888889
"1657","05139","2019",223,20,203,74382.2466367713,1912.09417040359,34.3004484304933
"1658","05140","2019",3,3,0,196675,2089.66666666667,92.3333333333333
"1659","05142","2019",17,10,7,115471.470588235,1616.35294117647,75.7058823529412
"1660","05144","2019",2,2,0,58175,1023,56.5
"1661","05145","2019",16,12,4,170059.1875,2449.4375,69.625
"1662","05146","2019",4,2,2,75383.75,945.75,76.5
"1663","05147","2019",2,2,0,219100,2648,85
"1664","05148","2019",5,3,2,153000,1596,111.4
"1665","05149","2019",37,5,32,74422.1621621622,1777.81081081081,41.027027027027
"1666","05151","2019",9,7,2,154922.222222222,2356,73.1111111111111
"1667","05152","2019",1,1,0,80000,1000,80
"1668","05153","2019",24,6,18,89284.1666666667,1936.70833333333,40.5833333333333
"1669","05154","2019",2,2,0,43000,1541.5,28.5
"1670","05155","2019",2,2,0,78000,952.5,77
"1671","05156","2019",3,3,0,253500,2328.66666666667,103
"1672","05157","2019",2,2,0,143050,1513.5,98.5
"1673","05160","2019",1,1,0,65000,2600,25
"1674","05161","2019",112,15,97,179337.0625,3444.88392857143,48.5178571428571
"1675","05162","2019",25,15,10,170772,1867.64,88.88
"1676","05163","2019",4,4,0,263312.5,5109.75,77.75
"1677","05164","2019",23,4,19,162945.652173913,2627.4347826087,62.5217391304348
"1678","05165","2019",5,5,0,169100,1932.4,90
"1679","05166","2019",19,13,6,89100,1441,63.7894736842105
"1680","05167","2019",1,1,0,92650,1090,85
"1681","05168","2019",6,3,3,146753.5,1631.5,82.5
"1682","05170","2019",27,13,14,158361.111111111,2115.81481481481,77.4444444444444
"1683","05171","2019",2,2,0,83000,999.5,88.5
"1684","05172","2019",4,4,0,85250,1216.75,74
"1685","05173","2019",4,4,0,127500,1367.5,113.25
"1686","05174","2019",13,8,5,190335,2558.53846153846,70.6923076923077
"1687","05176","2019",7,6,1,136000,1764.14285714286,77
"1688","05177","2019",112,2,110,118637.401785714,3054.90178571429,36.8214285714286
"1689","05178","2019",5,5,0,131160,2212.4,64.8
"1690","05179","2019",49,32,17,123538.469387755,1449.5306122449,84.3469387755102
"1691","05180","2019",11,9,2,189435.454545455,2693.81818181818,69.5454545454545
"1692","05181","2019",3,1,2,109506.666666667,2377,49.3333333333333
"1693","05183","2019",12,7,5,148312.5,2659.33333333333,62.1666666666667
"1694","05184","2019",2,2,0,181250,1606,115
"1695","06003","2019",21,12,9,129232.761904762,1817.04761904762,66.7619047619048
"1696","06004","2019",2208,217,1991,282532.870923913,4555.69519927536,60.3215579710145
"1697","06005","2019",3,3,0,152333.333333333,2089.66666666667,71
"1698","06006","2019",21,17,4,424957.761904762,4043.2380952381,105.52380952381
"1699","06007","2019",41,28,13,330644.902439024,4269.78048780488,81.5853658536585
"1700","06009","2019",1,1,0,25000,658,38
"1701","06010","2019",27,16,11,353109.444444444,3839.62962962963,85.3333333333333
"1702","06011","2019",115,5,110,385464.208695652,6032.08695652174,62.7478260869565
"1703","06012","2019",274,12,262,325053.835766423,6086.34306569343,53.036496350365
"1704","06013","2019",14,7,7,107857.142857143,2088.42857142857,56.1428571428571
"1705","06014","2019",15,13,2,243989.333333333,3499.6,73.3333333333333
"1706","06015","2019",24,15,9,259688.75,2994.875,83.375
"1707","06016","2019",23,7,16,108712.391304348,2569.47826086957,43.7826086956522
"1708","06017","2019",2,0,2,75000,1721.5,54
"1709","06018","2019",140,85,55,507285.514285714,5080.91428571429,99.6285714285714
"1710","06019","2019",8,4,4,218687.5,2774.375,79.625
"1711","06020","2019",11,5,6,91454.5454545455,1765.09090909091,50.6363636363636
"1712","06021","2019",12,10,2,220090.416666667,3102.33333333333,77.4166666666667
"1713","06022","2019",7,4,3,150614.285714286,2002.14285714286,89
"1714","06023","2019",42,18,24,118395.238095238,2315.64285714286,57.4523809523809
"1715","06024","2019",5,5,0,105070,1543.8,69.8
"1716","06025","2019",14,6,8,233646.428571429,2679.5,83.5
"1717","06026","2019",23,20,3,658223,4343,146.217391304348
"1718","06027","2019",1218,155,1063,249238.710180624,4192.24712643678,60.0049261083744
"1719","06028","2019",16,16,0,141340,1718.0625,83.1875
"1720","06029","2019",2711,118,2593,307936.537071191,4938.67834747326,60.2585761711546
"1721","06030","2019",1052,102,950,234215.992395437,3502.06463878327,63.111216730038
"1722","06031","2019",10,8,2,314977,3617,85.9
"1723","06032","2019",67,4,63,451140.895522388,7331.61194029851,59.4477611940299
"1724","06033","2019",94,24,70,223535.70212766,2852.54255319149,76.6595744680851
"1725","06034","2019",19,16,3,380500.473684211,4348,94.7368421052632
"1726","06035","2019",15,7,8,208000,3481.33333333333,64.5333333333333
"1727","06036","2019",7,3,4,257214.285714286,3452.85714285714,75.5714285714286
"1728","06037","2019",3,3,0,208933.333333333,2672.33333333333,70.3333333333333
"1729","06038","2019",47,40,7,646798.680851064,4555.23404255319,135.127659574468
"1730","06039","2019",6,3,3,239500,4127,58.1666666666667
"1731","06041","2019",10,6,4,147821,1908.5,75
"1732","06042","2019",9,7,2,157055.555555556,2030.88888888889,79.8888888888889
"1733","06043","2019",11,5,6,189963.636363636,2408.90909090909,93.3636363636364
"1734","06044","2019",105,64,41,479727.457142857,4727.34285714286,98.3047619047619
"1735","06045","2019",1,1,0,55200,1104,50
"1736","06046","2019",33,27,6,472504.545454545,4126.87878787879,116.969696969697
"1737","06047","2019",1,1,0,210000,3134,67
"1738","06048","2019",61,38,23,271113.967213115,3158.18032786885,89.2950819672131
"1739","06049","2019",2,1,1,227900,2283,69.5
"1740","06050","2019",8,6,2,207204.125,3327.375,64.625
"1741","06051","2019",6,5,1,89000,1119,67.8333333333333
"1742","06052","2019",2,2,0,123500,2326,52
"1743","06054","2019",42,17,25,250361.904761905,2968.92857142857,86.2380952380952
"1744","06055","2019",6,6,0,98333.3333333333,1967.5,45.3333333333333
"1745","06057","2019",23,9,14,205854.043478261,2601.17391304348,79.1304347826087
"1746","06058","2019",11,9,2,174120.545454545,1988.72727272727,86.7272727272727
"1747","06059","2019",45,18,27,745861.066666667,7789.84444444444,95.7333333333333
"1748","06060","2019",14,8,6,496720.714285714,4802.92857142857,102.142857142857
"1749","06061","2019",2,1,1,112500,1666.5,71.5
"1750","06062","2019",4,2,2,105250,1938.75,54.25
"1751","06063","2019",2,2,0,43250,1126,35.5
"1752","06064","2019",45,38,7,381231.555555556,3699.8,102.8
"1753","06065","2019",85,75,10,450177.141176471,4561.69411764706,107.658823529412
"1754","06066","2019",22,16,6,219022.727272727,2747.13636363636,78.8181818181818
"1755","06067","2019",22,8,14,249272.727272727,4374.90909090909,58.3636363636364
"1756","06068","2019",2,0,2,153500,2402.5,60
"1757","06069","2019",971,262,709,216875.847579815,2912.38928939238,72.5458290422245
"1758","06070","2019",31,7,24,90912.7741935484,1691.48387096774,47.5483870967742
"1759","06071","2019",34,8,26,129583.382352941,2722.38235294118,54.2647058823529
"1760","06072","2019",1,1,0,70000,1667,42
"1761","06073","2019",125,8,117,132717.4,3434.216,38.28
"1762","06074","2019",16,9,7,113581.25,2245.3125,53.9375
"1763","06075","2019",71,51,20,301584.028169014,3629.35211267606,86.3802816901408
"1764","06076","2019",1,1,0,150000,2459,61
"1765","06077","2019",14,7,7,142847.142857143,2177.78571428571,65.5
"1766","06078","2019",5,4,1,181170,2772.6,70.6
"1767","06079","2019",953,133,820,299532.74501574,4403.19097586569,64.9087093389297
"1768","06081","2019",4,3,1,45125,803.5,53.75
"1769","06082","2019",4,3,1,165625,2303,65.5
"1770","06083","2019",954,61,893,241140.170859539,4375.79454926625,55.3605870020964
"1771","06084","2019",134,81,53,486927.059701493,4295.41044776119,108.634328358209
"1772","06085","2019",377,175,202,498687.554376658,4798.09814323607,96.1458885941645
"1773","06086","2019",4,3,1,122375,1674.5,67.75
"1774","06088","2019",8406,305,8101,239038.043064478,4101.92624315965,58.206519152986
"1775","06089","2019",2,2,0,420000,3435,122.5
"1776","06090","2019",106,56,50,267619.839622642,3905.62264150943,69.0094339622642
"1777","06091","2019",35,25,10,351671.771428571,3989.8,82.7142857142857
"1778","06092","2019",9,7,2,264711.111111111,3116.55555555556,86.6666666666667
"1779","06093","2019",3,3,0,175000,1713.66666666667,107.333333333333
"1780","06094","2019",70,8,62,149561.5,3187.38571428571,48.6142857142857
"1781","06095","2019",170,103,67,311185.476470588,3424.59411764706,86.7235294117647
"1782","06097","2019",1,1,0,279100,2114,132
"1783","06098","2019",1,0,1,95000,2209,43
"1784","06099","2019",21,7,14,132778.095238095,1701.14285714286,77.9523809523809
"1785","06100","2019",3,3,0,224186.666666667,3025.66666666667,77
"1786","06101","2019",5,3,2,139200,2346.8,57.2
"1787","06102","2019",1,0,1,41000,1414,29
"1788","06103","2019",35,12,23,119560,2040.91428571429,64.5714285714286
"1789","06104","2019",447,40,407,345346.803131991,5781.08724832215,56.1454138702461
"1790","06105","2019",109,98,11,642614.23853211,4829.5504587156,133.183486238532
"1791","06106","2019",5,3,2,129520,1646.8,73
"1792","06107","2019",2,1,1,97500,1843.5,48
"1793","06108","2019",54,38,16,390664.259259259,3814.44444444444,106.62962962963
"1794","06109","2019",9,7,2,233740.888888889,2561.22222222222,113.888888888889
"1795","06110","2019",7,6,1,125214.285714286,2543.71428571429,47.2857142857143
"1796","06112","2019",48,36,12,432552.1875,4388.5,101.208333333333
"1797","06113","2019",14,7,7,305171.428571429,3866.14285714286,78
"1798","06114","2019",49,16,33,253507.06122449,4268.30612244898,59.469387755102
"1799","06115","2019",2,2,0,186100,2248,88
"1800","06116","2019",4,3,1,82000,1511,50
"1801","06117","2019",10,10,0,316006.3,3059,109.7
"1802","06118","2019",74,61,13,302132.878378378,3457.37837837838,91.5
"1803","06119","2019",1,1,0,126500,1054,120
"1804","06120","2019",116,8,108,165405.948275862,3885.81896551724,40.7327586206897
"1805","06121","2019",17,2,15,822006.294117647,9241.23529411765,81.5882352941177
"1806","06122","2019",52,44,8,427227.557692308,4451.25,101.423076923077
"1807","06123","2019",640,51,589,254254.8453125,4172.1328125,61.4234375
"1808","06124","2019",4,3,1,92000,1115,79.5
"1809","06125","2019",5,2,3,36800,1135.2,48.8
"1810","06126","2019",25,12,13,249594.8,3126.48,82.2
"1811","06127","2019",46,20,26,136872.673913043,2876.73913043478,52.5434782608696
"1812","06128","2019",57,40,17,765698.754385965,5419.38596491228,132.789473684211
"1813","06129","2019",2,0,2,82950,2883.5,32.5
"1814","06130","2019",78,65,13,245851.794871795,3171.35897435897,83.1666666666667
"1815","06131","2019",1,1,0,70500,1259,56
"1816","06132","2019",10,3,7,96400,1683.7,57.3
"1817","06133","2019",1,1,0,25000,833,30
"1818","06134","2019",14,9,5,134571.428571429,1492.92857142857,88.7142857142857
"1819","06135","2019",4,2,2,111500,1454.75,73.5
"1820","06136","2019",88,46,42,219152.272727273,2808.51136363636,78.5568181818182
"1821","06137","2019",21,17,4,507709.047619048,3799.61904761905,136
"1822","06138","2019",95,14,81,390211.726315789,6262.90526315789,58.9473684210526
"1823","06140","2019",38,35,3,427186.736842105,3947.13157894737,110.789473684211
"1824","06141","2019",6,5,1,186666.666666667,2243.33333333333,76
"1825","06142","2019",8,4,4,164207.25,2949,59.75
"1826","06143","2019",7,5,2,248285.714285714,2376.57142857143,102.428571428571
"1827","06144","2019",8,7,1,138150,2695.125,62.375
"1828","06145","2019",4,1,3,72500,1866.5,40.75
"1829","06146","2019",1,1,0,167000,4073,41
"1830","06147","2019",47,32,15,301592.617021277,3671.04255319149,87.3404255319149
"1831","06148","2019",55,45,10,517768.690909091,4069.2,126.181818181818
"1832","06149","2019",122,29,93,218825.336065574,3010.03278688525,73.8360655737705
"1833","06150","2019",36,17,19,597307.916666667,5846.44444444444,94.0833333333333
"1834","06151","2019",18,9,9,109000,1768.83333333333,61.0555555555556
"1835","06152","2019",199,99,100,435008.110552764,4539.68341708543,88.8894472361809
"1836","06153","2019",32,15,17,136600.3125,2229.875,58.53125
"1837","06154","2019",12,9,3,162018.583333333,2125.58333333333,80.8333333333333
"1838","06155","2019",750,118,632,273363.104,4175.408,61.6773333333333
"1839","06156","2019",5,5,0,194528,3360,75.2
"1840","06157","2019",362,104,258,308689.154696133,3863.70994475138,76.4447513812155
"1841","06158","2019",14,8,6,160051.428571429,2114.5,76.8571428571429
"1842","06159","2019",179,19,160,506897.38547486,6540.95530726257,73.072625698324
"1843","06160","2019",1,1,0,70000,1522,46
"1844","06161","2019",541,97,444,300643.846580407,5194.47689463956,56.8391866913124
"1845","06162","2019",10,6,4,110465,1552.3,75.2
"1846","06163","2019",37,9,28,73612.4864864865,1243.89189189189,58.0810810810811
"1847","07001","2019",1,1,0,190340,1903,100
"1848","07002","2019",8,8,0,194635,1544.625,122.875
"1849","07003","2019",3,3,0,108066.666666667,1231.66666666667,90.6666666666667
"1850","07004","2019",1,1,0,98000,817,120
"1851","07005","2019",18,18,0,171086.388888889,1983.72222222222,84.7777777777778
"1852","07006","2019",1,1,0,190000,3167,60
"1853","07007","2019",9,9,0,188944.444444444,2045.77777777778,119.333333333333
"1854","07008","2019",15,15,0,181155.333333333,1531.86666666667,122.2
"1855","07009","2019",22,17,5,102400,1210.13636363636,85
"1856","07010","2019",212,82,130,111809.476415094,1263.04245283019,83.9433962264151
"1857","07011","2019",14,11,3,114820.857142857,1596.28571428571,77.2142857142857
"1858","07012","2019",1,1,0,130000,929,140
"1859","07013","2019",12,12,0,128512.5,1741.83333333333,72.4166666666667
"1860","07014","2019",5,5,0,152200,1787.6,81
"1861","07015","2019",6,6,0,184500,1805.16666666667,98.5
"1862","07017","2019",8,8,0,246596.25,2396.375,108.625
"1863","07018","2019",1,0,1,200150,1756,114
"1864","07019","2019",176,54,122,113144.130681818,1624.64204545455,71.2386363636364
"1865","07020","2019",2,2,0,152500,1425,108
"1866","07022","2019",18,18,0,161452.777777778,1804.11111111111,85.8333333333333
"1867","07023","2019",4,3,1,233327.5,2625.5,87.75
"1868","07024","2019",7,7,0,172285.714285714,1896.85714285714,91
"1869","07025","2019",7,7,0,79285.7142857143,1011.57142857143,78.4285714285714
"1870","07026","2019",3,3,0,63333.3333333333,714.333333333333,87.3333333333333
"1871","07027","2019",21,20,1,169729.333333333,1951.28571428571,94
"1872","07028","2019",5,5,0,271720,2670,102.4
"1873","07029","2019",1,1,0,50000,1250,40
"1874","07030","2019",2,2,0,162000,2659,72.5
"1875","07031","2019",9,8,1,205338.888888889,2161.33333333333,92.6666666666667
"1876","07032","2019",2,2,0,130000,1364,94.5
"1877","07033","2019",1,1,0,291100,2772,105
"1878","07035","2019",13,13,0,121765.384615385,1349.84615384615,90.2307692307692
"1879","07036","2019",2,2,0,203500,1886,110
"1880","07037","2019",1,1,0,30000,750,40
"1881","07039","2019",1,1,0,65000,833,78
"1882","07040","2019",4,4,0,150850,1492.5,106.75
"1883","07041","2019",18,17,1,149413.944444444,1573.38888888889,101.277777777778
"1884","07042","2019",99,61,38,117879.646464646,1375.48484848485,83.6666666666667
"1885","07044","2019",5,5,0,146688,1378.2,98.4
"1886","07045","2019",11,11,0,110636.363636364,1721.72727272727,70.0909090909091
"1887","07048","2019",4,3,1,66062.5,1372,47.25
"1888","07049","2019",3,3,0,58833.3333333333,1026,50.6666666666667
"1889","07050","2019",11,11,0,181070.909090909,2658.63636363636,76.5454545454545
"1890","07051","2019",8,8,0,154925,1528.25,102.75
"1891","07052","2019",4,4,0,158225,1806,91.25
"1892","07053","2019",6,5,1,113500,1709,72.5
"1893","07054","2019",7,5,2,101271.428571429,1456.71428571429,69.1428571428571
"1894","07055","2019",23,23,0,231091.739130435,2189.26086956522,104.347826086957
"1895","07056","2019",6,6,0,210995.833333333,1844.33333333333,122.5
"1896","07058","2019",13,13,0,205750,1906.92307692308,114.384615384615
"1897","07060","2019",2,2,0,122600,1841,64.5
"1898","07061","2019",5,4,1,207090,2537,74.6
"1899","07062","2019",3,3,0,174333.333333333,2320.33333333333,74
"1900","07063","2019",1,1,0,287000,1472,195
"1901","07064","2019",22,12,10,87192.5,1140.27272727273,75
"1902","07065","2019",5,5,0,145134,1955,72
"1903","07066","2019",33,29,4,165046.96969697,1837.87878787879,93.4848484848485
"1904","07067","2019",1,1,0,80000,2286,35
"1905","07068","2019",11,11,0,171010.272727273,1574.09090909091,108.727272727273
"1906","07069","2019",4,4,0,125650,2205.75,73.5
"1907","07070","2019",20,20,0,231857.5,2224.9,105.7
"1908","07071","2019",9,9,0,151021,1449,107.111111111111
"1909","07072","2019",16,16,0,201281.25,1832.0625,108.4375
"1910","07073","2019",4,4,0,107000,1099.25,84.75
"1911","07075","2019",4,3,1,109375,1203.75,86
"1912","07076","2019",24,21,3,146637.333333333,1558.33333333333,89.25
"1913","07077","2019",2,2,0,352400,4161,91.5
"1914","07078","2019",41,30,11,183153.609756098,1914.51219512195,97.390243902439
"1915","07079","2019",12,11,1,100684.583333333,1362.75,81.5833333333333
"1916","07080","2019",7,6,1,171214.285714286,1373.71428571429,112.714285714286
"1917","07081","2019",3,3,0,81666.6666666667,1676.66666666667,49
"1918","07082","2019",4,4,0,93000,1081.75,85.25
"1919","07083","2019",11,11,0,149133.272727273,1548.09090909091,97.3636363636364
"1920","07084","2019",14,14,0,146191.285714286,1621.85714285714,90.6428571428571
"1921","07085","2019",10,10,0,171696.2,1752.2,104.2
"1922","07086","2019",13,13,0,196804.230769231,1872.15384615385,101.384615384615
"1923","07087","2019",2,2,0,177500,1823.5,106
"1924","07088","2019",1,1,0,70000,1167,60
"1925","07089","2019",16,16,0,153556.25,1720,86.1875
"1926","07090","2019",16,13,3,133206.25,1653.4375,83.3125
"1927","07091","2019",3,3,0,174666.666666667,1914.33333333333,83.6666666666667
"1928","07092","2019",2,2,0,94500,2595.5,36.5
"1929","07093","2019",3,3,0,246666.666666667,1440.33333333333,133.666666666667
"1930","07094","2019",3,3,0,207216.666666667,1909.66666666667,109.333333333333
"1931","07095","2019",5,5,0,178870,2078.8,90.6
"1932","07096","2019",8,8,0,136323.25,1741.625,72.25
"1933","07097","2019",4,4,0,189225,2054,92.5
"1934","07098","2019",1,1,0,115000,1983,58
"1935","07099","2019",8,8,0,186943.75,2239.125,86.5
"1936","07100","2019",7,7,0,133535,1751.14285714286,69
"1937","07101","2019",4,4,0,277250,2367,117.25
"1938","07102","2019",214,61,153,171108.144859813,2121.31308411215,79.2056074766355
"1939","07103","2019",6,6,0,86641.6666666667,1414.83333333333,59.3333333333333
"1940","07104","2019",4,4,0,160000,1969,81.5
"1941","07105","2019",2,2,0,55000,962.5,52.5
"1942","07106","2019",3,3,0,103333.333333333,724,142
"1943","07107","2019",16,13,3,156537.5,1692.875,95.375
"1944","07110","2019",21,16,5,164262.380952381,1932.95238095238,86.1428571428571
"1945","07111","2019",3,3,0,124666.666666667,1318.33333333333,97.3333333333333
"1946","07112","2019",5,5,0,124060,1349.4,108.8
"1947","07113","2019",8,8,0,283856.5,2640.125,112.75
"1948","07114","2019",8,8,0,204492.5,3473.75,84.875
"1949","07115","2019",10,10,0,268055,2347.3,117.3
"1950","07116","2019",17,10,7,110335.588235294,1455.94117647059,78.8235294117647
"1951","07117","2019",23,21,2,221413.47826087,2315.26086956522,95.6521739130435
"1952","07118","2019",2,2,0,108617.5,1552,70
"1953","07119","2019",2,2,0,118470,1406.5,92
"1954","07120","2019",3,3,0,139000,1616,84.6666666666667
"1955","07121","2019",3,3,0,72500,1254,58.3333333333333
"1956","07122","2019",17,16,1,186611.294117647,1934.35294117647,98
"1957","07123","2019",5,5,0,74600,1450.8,49.6
"1958","07126","2019",14,14,0,197478.571428571,2182.71428571429,95.5714285714286
"1959","07127","2019",8,6,2,99006.25,1180.125,80.5
"1960","07128","2019",8,4,4,103606.25,1130.875,97.625
"1961","07129","2019",21,18,3,101973.80952381,1350.47619047619,81.9523809523809
"1962","07130","2019",6,6,0,100666.666666667,1085.33333333333,93.1666666666667
"1963","07131","2019",4,4,0,155500,1887,78.25
"1964","07132","2019",15,13,2,141730,1453.33333333333,107.666666666667
"1965","07133","2019",6,6,0,213158.333333333,2052.16666666667,106.666666666667
"1966","07134","2019",6,6,0,136750,1297.33333333333,99.3333333333333
"1967","07136","2019",2,2,0,99500,1110,110
"1968","07138","2019",18,15,3,155165.277777778,2011.27777777778,78.3333333333333
"1969","07139","2019",5,5,0,123016,1251.6,94.4
"1970","07140","2019",5,5,0,178710,1460.4,128
"1971","07141","2019",4,4,0,166125,1478,97.25
"1972","07142","2019",4,4,0,77630,845.25,82.5
"1973","07143","2019",13,13,0,147570.615384615,1384.76923076923,106.538461538462
"1974","07144","2019",1,1,0,122500,1531,80
"1975","07145","2019",14,14,0,167756.785714286,1729.78571428571,99.2142857142857
"1976","07146","2019",7,4,3,119498.571428571,1518.71428571429,77
"1977","07147","2019",5,5,0,142322,1858.6,72.2
"1978","07148","2019",10,10,0,222040,2542.7,105.7
"1979","07149","2019",4,4,0,78500,1063.75,73.25
"1980","07150","2019",7,7,0,145428.571428571,1388.28571428571,109.428571428571
"1981","07151","2019",9,9,0,124213.333333333,1669.66666666667,87.1111111111111
"1982","07152","2019",14,13,1,170000.285714286,1954.21428571429,89.7857142857143
"1983","07153","2019",6,6,0,47416.6666666667,1151.33333333333,49.6666666666667
"1984","07154","2019",7,7,0,112657.142857143,1360.85714285714,91
"1985","07155","2019",13,12,1,179888.461538462,2014.61538461538,90.6153846153846
"1986","07156","2019",9,7,2,92888.8888888889,1363,72.1111111111111
"1987","07157","2019",19,12,7,151498.947368421,1514.89473684211,99.1052631578947
"1988","07158","2019",5,5,0,108800,821.8,130.4
"1989","07159","2019",10,10,0,220577.5,1752.3,129.4
"1990","07160","2019",3,3,0,138333.333333333,1336,103
"1991","07161","2019",17,17,0,95078.2352941177,1399.23529411765,74.2941176470588
"1992","07162","2019",6,4,2,179750,3838.5,69.3333333333333
"1993","07165","2019",8,8,0,112615,1415.625,77.625
"1994","07166","2019",4,4,0,143750,1835,78.25
"1995","07167","2019",11,10,1,143019.454545455,1367.63636363636,97.2727272727273
"1996","07168","2019",8,8,0,229063.125,2219.5,104.375
"1997","07169","2019",3,3,0,155000,1432.33333333333,104.333333333333
"1998","07170","2019",10,10,0,85885,1227.6,76.3
"1999","07171","2019",7,6,1,234214.285714286,3234.28571428571,76.8571428571429
"2000","07172","2019",15,15,0,232643.333333333,1967.26666666667,120.666666666667
"2001","07173","2019",1,1,0,121000,3184,38
"2002","07174","2019",5,5,0,113040,1251.8,99
"2003","07176","2019",4,4,0,203962.5,1823.25,110.5
"2004","07177","2019",13,13,0,168907.692307692,1512.84615384615,101.923076923077
"2005","07178","2019",12,12,0,81470.8333333333,1000.58333333333,81.3333333333333
"2006","07179","2019",3,3,0,164666.666666667,1112.33333333333,155
"2007","07181","2019",30,23,7,128737.733333333,1548.73333333333,82.4333333333333
"2008","07182","2019",10,10,0,214896,2034.4,107.8
"2009","07183","2019",7,7,0,210232.142857143,2230.57142857143,99.7142857142857
"2010","07184","2019",3,3,0,132333.333333333,1151,123.333333333333
"2011","07185","2019",11,11,0,181480,1565.18181818182,126.545454545455
"2012","07186","2019",119,48,71,110551,1403.29411764706,78.5126050420168
"2013","07187","2019",5,5,0,285999,2562.6,106
"2014","07188","2019",20,20,0,183987.5,1632.25,117.2
"2015","07189","2019",4,4,0,408662.5,3018.25,132.25
"2016","07190","2019",2,2,0,160000,2135.5,85
"2017","07191","2019",21,20,1,192140,1722.7619047619,112.857142857143
"2018","07192","2019",11,11,0,119604.545454545,1605.45454545455,81.1818181818182
"2019","07193","2019",6,6,0,187308.333333333,2034.66666666667,97.6666666666667
"2020","07194","2019",1,1,0,50000,543,92
"2021","07195","2019",3,3,0,70106.6666666667,2260.66666666667,32.6666666666667
"2022","07196","2019",6,6,0,187033.333333333,2231,86.3333333333333
"2023","07197","2019",27,26,1,189134.444444444,1866.66666666667,104.444444444444
"2024","07198","2019",13,13,0,161988.461538462,1830.38461538462,91.6923076923077
"2025","07199","2019",15,15,0,142289.4,2129.26666666667,67.6
"2026","07200","2019",1,1,0,135000,1500,90
"2027","07201","2019",32,23,9,149980.625,2244.96875,68.5
"2028","07202","2019",3,3,0,84500,730,113.333333333333
"2029","07204","2019",21,19,2,134038.095238095,1549.28571428571,94.2857142857143
"2030","07205","2019",5,5,0,130110,1634,77.8
"2031","07207","2019",16,16,0,223305.9375,2655.8125,82.9375
"2032","07208","2019",3,3,0,153333.333333333,1458.33333333333,107
"2033","07210","2019",2,2,0,151000,2776.5,59
"2034","07211","2019",4,4,0,183037.5,1887,94.25
"2035","07212","2019",2,2,0,137750,1180,111.5
"2036","07213","2019",2,2,0,56000,641.5,86
"2037","07214","2019",1,1,0,2e+05,1538,130
"2038","07215","2019",3,3,0,86750,1253.33333333333,73
"2039","07216","2019",5,5,0,137046,1524.8,87.4
"2040","07217","2019",7,7,0,126046.428571429,1395.85714285714,84.8571428571429
"2041","07218","2019",7,7,0,130827.142857143,1522,79.4285714285714
"2042","07219","2019",3,3,0,226026.666666667,1914,118.333333333333
"2043","07220","2019",2,2,0,84000,1059,79.5
"2044","07221","2019",3,2,1,159333.333333333,2004.33333333333,88.3333333333333
"2045","07222","2019",2,2,0,179915,1965,91.5
"2046","07223","2019",2,2,0,109515,1248.5,74.5
"2047","07224","2019",6,4,2,63826.6666666667,1077.66666666667,63.6666666666667
"2048","07225","2019",7,7,0,218120,1996.71428571429,106.714285714286
"2049","07226","2019",2,2,0,47000,1562.5,27
"2050","07227","2019",16,16,0,155751.875,1580.25,99.5
"2051","07228","2019",9,9,0,165362.888888889,1540,102.888888888889
"2052","07229","2019",8,8,0,185840,2086,93.125
"2053","07230","2019",3,3,0,176633.333333333,1383.33333333333,123.666666666667
"2054","07231","2019",19,19,0,191507.894736842,1833.68421052632,108.421052631579
"2055","07232","2019",7,7,0,123685.714285714,1601.14285714286,76.4285714285714
"2056","07233","2019",2,2,0,139000,2029.5,70.5
"2057","07235","2019",4,4,0,112450,1579.5,71.75
"2058","07236","2019",12,10,2,123479.583333333,1378.91666666667,88.5
"2059","07237","2019",8,6,2,144062.5,2146.875,81
"2060","07238","2019",2,2,0,80000,1733.5,65
"2061","07239","2019",6,6,0,158108.333333333,1484.16666666667,109.833333333333
"2062","07240","2019",17,15,2,242087.647058824,2333.94117647059,99.1764705882353
"2063","07241","2019",10,10,0,202040,2151.2,95.6
"2064","07243","2019",5,5,0,162599.8,1970.6,82.8
"2065","07244","2019",5,5,0,326120,2754.8,106.4
"2066","07245","2019",20,17,3,222467.5,2044.3,104.7
"2067","07247","2019",13,13,0,163513.076923077,1441.92307692308,113.538461538462
"2068","07248","2019",3,3,0,98333.3333333333,980.666666666667,102.666666666667
"2069","07249","2019",2,2,0,63500,1069.5,77
"2070","07250","2019",3,3,0,231333.333333333,1921.66666666667,115.333333333333
"2071","07251","2019",2,2,0,79500,1268.5,65
"2072","07253","2019",7,6,1,86364.2857142857,1090.42857142857,79.5714285714286
"2073","07254","2019",7,7,0,139257.142857143,1356.28571428571,108.857142857143
"2074","07255","2019",17,16,1,158355.882352941,1839.88235294118,86.5882352941177
"2075","07257","2019",4,4,0,174772.5,2947.5,70
"2076","07258","2019",4,4,0,54750,570,95
"2077","07259","2019",18,16,2,185236.777777778,1837.83333333333,104.222222222222
"2078","07260","2019",5,5,0,235888,2294.6,105.2
"2079","07261","2019",25,22,3,190580.68,1802.6,107.4
"2080","07262","2019",3,3,0,155166.666666667,1450.33333333333,95.3333333333333
"2081","07263","2019",7,7,0,169722.571428571,1657,101.285714285714
"2082","07264","2019",18,17,1,196025,2095,95.7777777777778
"2083","07265","2019",8,7,1,129125,1382.875,97.375
"2084","07267","2019",5,5,0,103950,1160.6,91
"2085","07268","2019",16,5,11,126129.375,3550.5625,38.375
"2086","07269","2019",5,5,0,119876,1362.8,78.6
"2087","07270","2019",7,7,0,267506.428571429,2361,117
"2088","07272","2019",2,2,0,160500,1692.5,97.5
"2089","07273","2019",2,2,0,143910,1704,97.5
"2090","07274","2019",3,3,0,49666.6666666667,934.666666666667,47
"2091","07275","2019",6,5,1,190000,2528.33333333333,78.6666666666667
"2092","07276","2019",2,2,0,178385,1432.5,138.5
"2093","07278","2019",10,7,3,127750,1639.5,82.7
"2094","07279","2019",20,19,1,186244,2028.1,94.6
"2095","07280","2019",14,14,0,173039.285714286,2128.21428571429,82.7142857142857
"2096","07281","2019",71,57,14,256418.169014085,2542.25352112676,101.239436619718
"2097","07282","2019",7,6,1,102785.714285714,1073.85714285714,98.8571428571429
"2098","07283","2019",1,1,0,180000,1525,118
"2099","07284","2019",4,4,0,105875,1280.25,89
"2100","07285","2019",3,3,0,93133.3333333333,1589.33333333333,50
"2101","07286","2019",6,6,0,174633.333333333,1872.5,96.6666666666667
"2102","07287","2019",4,3,1,149475,1812.75,81
"2103","07288","2019",12,12,0,195958.333333333,1982.33333333333,103.5
"2104","07289","2019",20,19,1,151253,1573.2,93.4
"2105","07290","2019",3,3,0,187766.666666667,2253,99.6666666666667
"2106","07291","2019",16,16,0,169666.25,2114.375,86.625
"2107","07292","2019",10,9,1,150886.7,1548.4,95.5
"2108","07293","2019",15,15,0,158851.066666667,1554.46666666667,111.2
"2109","07294","2019",5,4,1,273820,2567.6,101.4
"2110","07295","2019",4,4,0,167562.5,1537.75,106.5
"2111","07296","2019",7,7,0,231117.142857143,2179.42857142857,101.571428571429
"2112","07297","2019",3,3,0,146458.333333333,1493.33333333333,98.3333333333333
"2113","07298","2019",5,5,0,166200,1426.2,126.6
"2114","07300","2019",4,4,0,150375,1249,99
"2115","07301","2019",14,14,0,100142.857142857,1319.71428571429,84.4285714285714
"2116","07302","2019",7,7,0,217372.857142857,2126.28571428571,104.142857142857
"2117","07303","2019",3,3,0,218062.666666667,1623.66666666667,131.666666666667
"2118","07304","2019",30,16,14,125136.1,1927.13333333333,65.6
"2119","07305","2019",3,3,0,218333.333333333,2189.66666666667,97
"2120","07306","2019",1,0,1,132500,2409,55
"2121","07307","2019",5,4,1,206864,2562.8,88
"2122","07308","2019",22,16,6,145562.136363636,1687.68181818182,84.6363636363636
"2123","07309","2019",18,15,3,163375,1540.83333333333,101.555555555556
"2124","07310","2019",8,8,0,153562.5,2224.25,71.375
"2125","07311","2019",2,2,0,126683.5,1935,74
"2126","07312","2019",6,6,0,164650,1850.16666666667,89.8333333333333
"2127","07313","2019",16,14,2,89600,1312,68.25
"2128","07314","2019",6,6,0,240500,1682.16666666667,151.5
"2129","07315","2019",7,7,0,174642.857142857,1984,86
"2130","07316","2019",22,21,1,266304.090909091,2359.18181818182,114.590909090909
"2131","07317","2019",10,10,0,219535,1846.5,120.9
"2132","07318","2019",3,3,0,232403.333333333,1600,133
"2133","07319","2019",100,68,32,136752.92,1566.54,85.7
"2134","07321","2019",2,2,0,110500,1090,94
"2135","07322","2019",15,14,1,141022.666666667,1645.93333333333,83.2
"2136","07323","2019",14,13,1,255276.428571429,2349.78571428571,112
"2137","07324","2019",154,65,89,144079.383116883,1860.19480519481,80.7987012987013
"2138","07325","2019",26,18,8,154138.461538462,1929.30769230769,83.7307692307692
"2139","07326","2019",1,1,0,82500,1375,60
"2140","07327","2019",7,7,0,123342.857142857,1329.85714285714,107.571428571429
"2141","07328","2019",3,3,0,222333.333333333,2345,99
"2142","07329","2019",10,10,0,114133,1486.7,81.9
"2143","07330","2019",35,31,4,179717.8,2169.31428571429,89.0285714285714
"2144","07331","2019",71,38,33,131531.478873239,1611.14084507042,83.2253521126761
"2145","07332","2019",4,4,0,236250,2256.5,103.75
"2146","07333","2019",8,8,0,132912.5,1535.375,102.75
"2147","07334","2019",50,31,19,188921.44,2072.5,91.9
"2148","07335","2019",1,1,0,145000,1593,91
"2149","07336","2019",3,3,0,213666.666666667,2532,85.3333333333333
"2150","07337","2019",19,19,0,165844.789473684,1664.05263157895,101.842105263158
"2151","07338","2019",25,22,3,140846.8,1874.6,79
"2152","07339","2019",20,20,0,158206.55,1661.35,95.15
"2153","07340","2019",17,13,4,189738.235294118,1878.05882352941,99.7647058823529
"2154","07341","2019",28,26,2,177073.25,1782.85714285714,95.8571428571429
"2155","07342","2019",9,7,2,121527.777777778,1428.55555555556,79
"2156","07343","2019",8,8,0,181863.75,1559.375,108.25
"2157","07344","2019",5,5,0,146080,1407.6,102
"2158","07345","2019",11,10,1,194126.363636364,1981.09090909091,100.272727272727
"2159","07346","2019",35,27,8,174058.142857143,1839.28571428571,92.7714285714286
"2160","07347","2019",8,8,0,123783.125,1179.875,114.75
"2161","07348","2019",10,9,1,132030,2221.1,67.3
"2162","07349","2019",73,47,26,130350.136986301,1616.28767123288,79.2876712328767
"2163","08001","2019",1,1,0,170000,1868,91
"2164","08003","2019",31,31,0,154459.677419355,1365.25806451613,114.516129032258
"2165","08004","2019",2,2,0,103450,1724.5,60
"2166","08005","2019",1,1,0,182000,1389,131
"2167","08006","2019",3,3,0,48600,833.333333333333,72.3333333333333
"2168","08008","2019",5,5,0,90242,1065.6,81.4
"2169","08010","2019",2,2,0,75000,809.5,91
"2170","08011","2019",3,3,0,76983.3333333333,903,92.6666666666667
"2171","08013","2019",2,2,0,90450,862,103.5
"2172","08014","2019",1,1,0,121500,1095,111
"2173","08015","2019",1,1,0,80000,678,118
"2174","08016","2019",1,1,0,26000,394,66
"2175","08017","2019",2,2,0,97500,566.5,177
"2176","08018","2019",2,2,0,95500,945,89.5
"2177","08021","2019",2,2,0,136000,1379.5,97
"2178","08022","2019",1,1,0,54800,512,107
"2179","08023","2019",1,1,0,139000,1479,94
"2180","08024","2019",15,14,1,136306.666666667,1286.8,109.466666666667
"2181","08025","2019",10,10,0,71425,880.6,79.7
"2182","08026","2019",5,5,0,122502,1422.2,106.6
"2183","08028","2019",5,5,0,100400,1305.4,78.4
"2184","08029","2019",3,3,0,147000,1279.66666666667,111
"2185","08032","2019",1,1,0,63000,1432,44
"2186","08033","2019",1,1,0,50000,595,84
"2187","08034","2019",5,5,0,120600,888.6,132
"2188","08036","2019",1,1,0,30000,600,50
"2189","08037","2019",10,10,0,103240,1042.9,100.5
"2190","08038","2019",3,3,0,192000,1297,148.666666666667
"2191","08039","2019",7,7,0,100671.428571429,1112.28571428571,89.7142857142857
"2192","08040","2019",10,10,0,264702,2823.8,105.6
"2193","08041","2019",2,2,0,80500,531.5,167.5
"2194","08043","2019",13,9,4,135707.692307692,1132.30769230769,118.615384615385
"2195","08044","2019",2,2,0,126850,1518.5,85
"2196","08046","2019",4,4,0,73750,694.75,115
"2197","08048","2019",1,1,0,284100,2059,138
"2198","08049","2019",1,1,0,392533,4461,88
"2199","08052","2019",2,2,0,83050,1336,69
"2200","08053","2019",19,19,0,132675.473684211,1267.36842105263,108.578947368421
"2201","08055","2019",5,5,0,100480,955,103.8
"2202","08057","2019",3,3,0,85333.3333333333,699.333333333333,114.666666666667
"2203","08058","2019",1,1,0,30000,577,52
"2204","08059","2019",1,1,0,48000,522,92
"2205","08060","2019",2,2,0,197500,1121,175
"2206","08061","2019",1,1,0,61000,575,106
"2207","08062","2019",1,1,0,189600,1481,128
"2208","08064","2019",2,2,0,196000,2346.5,85.5
"2209","08065","2019",1,1,0,33000,347,95
"2210","08066","2019",1,1,0,75000,1705,44
"2211","08067","2019",23,23,0,95260.8695652174,1049.73913043478,92.6086956521739
"2212","08069","2019",1,1,0,20000,333,60
"2213","08070","2019",4,4,0,99425,1041,97.75
"2214","08071","2019",3,3,0,86666.6666666667,895.666666666667,101.333333333333
"2215","08074","2019",1,1,0,37500,383,98
"2216","08075","2019",2,2,0,65000,357.5,185.5
"2217","08076","2019",6,6,0,78333.3333333333,973.5,81.1666666666667
"2218","08078","2019",6,6,0,111408.333333333,1185.16666666667,91.5
"2219","08081","2019",44,43,1,76225,863.522727272727,86.3409090909091
"2220","08082","2019",1,1,0,43000,478,90
"2221","08083","2019",4,4,0,110250,1112,99.75
"2222","08084","2019",2,2,0,156400,1774.5,93.5
"2223","08085","2019",2,2,0,147500,1303,141.5
"2224","08086","2019",3,3,0,76466.6666666667,1099.66666666667,66.6666666666667
"2225","08087","2019",4,4,0,172500,993.25,178.25
"2226","08089","2019",6,6,0,145202.666666667,1317.83333333333,94.6666666666667
"2227","08090","2019",31,24,7,103330.64516129,1003.93548387097,105.935483870968
"2228","08092","2019",4,4,0,127881.25,1353,92.5
"2229","08095","2019",1,1,0,120000,600,200
"2230","08096","2019",7,7,0,154314,1494,98.1428571428571
"2231","08097","2019",8,8,0,95300,916.125,106.625
"2232","08099","2019",1,1,0,1e+05,1220,82
"2233","08101","2019",1,1,0,95000,1234,77
"2234","08103","2019",1,1,0,63000,562,112
"2235","08104","2019",1,1,0,156500,1003,156
"2236","08105","2019",552,265,287,104706.03442029,1269.51268115942,82.5199275362319
"2237","08107","2019",5,5,0,104000,1253,81.4
"2238","08110","2019",1,1,0,92500,974,95
"2239","08111","2019",5,5,0,188320,1650,133.8
"2240","08115","2019",2,2,0,129500,709.5,175
"2241","08116","2019",1,1,0,147000,588,250
"2242","08121","2019",4,4,0,155749.75,1141.75,151
"2243","08122","2019",6,6,0,84916.6666666667,904.166666666667,95.6666666666667
"2244","08124","2019",4,4,0,137750,1247,112
"2245","08125","2019",4,4,0,195750,1684,115.75
"2246","08128","2019",3,3,0,45000,445.333333333333,98
"2247","08131","2019",1,1,0,41200,749,55
"2248","08132","2019",4,4,0,131900.25,844.5,162.25
"2249","08133","2019",5,5,0,140300,1165.6,123.8
"2250","08134","2019",1,1,0,125000,962,130
"2251","08136","2019",4,4,0,128500,1545,86
"2252","08137","2019",5,5,0,132250,1298,106.4
"2253","08139","2019",12,11,1,62291.6666666667,709.833333333333,86
"2254","08140","2019",9,7,2,135388.888888889,1447.33333333333,94
"2255","08141","2019",2,2,0,68000,596,97.5
"2256","08142","2019",23,19,4,109021.739130435,1280.73913043478,86.6521739130435
"2257","08144","2019",2,2,0,217500,1485.5,150
"2258","08145","2019",15,15,0,134194.666666667,1382.26666666667,101.8
"2259","08148","2019",4,4,0,176587.5,1714.5,101
"2260","08150","2019",1,1,0,18000,333,54
"2261","08151","2019",1,1,0,56000,949,59
"2262","08153","2019",6,6,0,105166.666666667,933.5,123.833333333333
"2263","08154","2019",1,1,0,66000,550,120
"2264","08155","2019",1,1,0,170000,1429,119
"2265","08156","2019",4,4,0,114250,1035.75,103
"2266","08158","2019",6,6,0,152558.333333333,1092,134.166666666667
"2267","08159","2019",1,1,0,135000,750,180
"2268","08160","2019",3,3,0,89000,688.666666666667,127
"2269","08162","2019",4,4,0,252875,1857.25,128.75
"2270","08164","2019",1,1,0,59900,689,87
"2271","08165","2019",2,2,0,123000,1162.5,111
"2272","08166","2019",3,3,0,115666.666666667,1131.66666666667,104.666666666667
"2273","08167","2019",4,4,0,95600,618.5,141.5
"2274","08170","2019",7,7,0,103264.285714286,976.714285714286,113
"2275","08171","2019",1,1,0,90000,826,109
"2276","08172","2019",3,3,0,117666.666666667,682.333333333333,173.666666666667
"2277","08173","2019",19,19,0,138473.684210526,1422.63157894737,99.7368421052632
"2278","08174","2019",30,29,1,139828,1424.83333333333,103.366666666667
"2279","08179","2019",5,5,0,102920,1065.2,92.4
"2280","08180","2019",20,16,4,129546.05,1427.1,93.05
"2281","08182","2019",1,1,0,150000,1471,102
"2282","08183","2019",9,9,0,80666.6666666667,1021.33333333333,77.2222222222222
"2283","08184","2019",1,1,0,108000,1350,80
"2284","08185","2019",23,22,1,89402.5652173913,993.565217391304,87.8260869565217
"2285","08187","2019",2,2,0,127500,863,135
"2286","08188","2019",8,7,1,113781.25,1062.125,105.5
"2287","08189","2019",1,1,0,109100,1240,88
"2288","08190","2019",67,56,11,115677.611940299,1277.32835820896,97.7611940298507
"2289","08191","2019",6,6,0,172365,1370,129.333333333333
"2290","08192","2019",3,3,0,112000,1296.66666666667,91.3333333333333
"2291","08193","2019",5,5,0,86120,1003.8,90
"2292","08194","2019",10,10,0,120879,1299.3,93.1
"2293","08195","2019",6,6,0,97275,1056,96.5
"2294","08199","2019",10,9,1,142651,1350,106.7
"2295","08200","2019",3,3,0,122200,900,135.666666666667
"2296","08202","2019",5,5,0,157182.6,1439.6,108
"2297","08203","2019",5,5,0,106500,1555.6,86
"2298","08204","2019",1,1,0,173400,2168,80
"2299","08206","2019",1,1,0,115800,973,119
"2300","08207","2019",3,3,0,88833.3333333333,1204.33333333333,61.6666666666667
"2301","08208","2019",2,2,0,101750,850.5,122.5
"2302","08209","2019",6,6,0,121316.666666667,1298.66666666667,83.5
"2303","08211","2019",5,5,0,79473,974.4,82.2
"2304","08212","2019",6,6,0,129416.666666667,1424,97.1666666666667
"2305","08214","2019",5,5,0,90400,685.6,129.2
"2306","08215","2019",2,2,0,105000,740.5,140.5
"2307","08216","2019",4,4,0,253237.5,2286,110.5
"2308","08217","2019",3,3,0,70000,989,75
"2309","08218","2019",11,11,0,81000,827.818181818182,96.6363636363636
"2310","08220","2019",5,5,0,133700,1591.6,115.4
"2311","08222","2019",24,24,0,86589.6666666667,1007.91666666667,86.8333333333333
"2312","08223","2019",1,1,0,239050,1195,200
"2313","08225","2019",2,2,0,130000,1090.5,112.5
"2314","08226","2019",2,2,0,132000,1130.5,116
"2315","08229","2019",4,4,0,174575,1815,110.5
"2316","08230","2019",5,5,0,187880,1382.2,137.6
"2317","08232","2019",5,5,0,93600,927.6,98.4
"2318","08233","2019",2,2,0,71500,621.5,122.5
"2319","08234","2019",1,1,0,105000,946,111
"2320","08235","2019",6,6,0,123826.333333333,1322,97
"2321","08236","2019",2,2,0,147500,1002,143.5
"2322","08237","2019",9,9,0,108211.111111111,1009.66666666667,110.111111111111
"2323","08239","2019",6,6,0,160833.333333333,1408.66666666667,127.5
"2324","08242","2019",4,4,0,98250,748.25,128.75
"2325","08243","2019",1,1,0,110000,1048,105
"2326","08244","2019",1,1,0,70000,350,200
"2327","08246","2019",2,2,0,53250,1737,54
"2328","08248","2019",7,7,0,117628.571428571,1314.57142857143,87.7142857142857
"2329","08249","2019",2,2,0,147500,1571,94.5
"2330","08250","2019",6,6,0,102833.333333333,882.666666666667,114.5
"2331","08254","2019",6,6,0,100333.333333333,1060.66666666667,105
"2332","08255","2019",2,2,0,40500,593.5,67
"2333","08257","2019",4,4,0,98173,783,121.25
"2334","08260","2019",8,8,0,183562.5,1563.75,111.875
"2335","08262","2019",7,7,0,98317.8571428571,1009.28571428571,105.285714285714
"2336","08263","2019",13,13,0,145349.230769231,1645.69230769231,92.5384615384615
"2337","08264","2019",6,6,0,88300,869.5,105.166666666667
"2338","08269","2019",1,1,0,110000,902,122
"2339","08275","2019",3,3,0,72666.6666666667,755,94
"2340","08276","2019",4,4,0,140292.5,1194.25,125.25
"2341","08277","2019",4,4,0,102250,975.75,107
"2342","08281","2019",10,10,0,67350,767.9,91.9
"2343","08282","2019",6,6,0,112610.666666667,2167.5,70.1666666666667
"2344","08284","2019",10,10,0,98294.5,1083.4,89.3
"2345","08289","2019",2,2,0,118750,1271.5,91
"2346","08291","2019",3,3,0,134333.333333333,1420.33333333333,87.3333333333333
"2347","08293","2019",2,2,0,65900,1194,57
"2348","08294","2019",1,1,0,155000,1890,82
"2349","08295","2019",1,1,0,266300,1318,202
"2350","08296","2019",2,2,0,145425,1105,134
"2351","08297","2019",1,1,0,145970,1622,90
"2352","08298","2019",25,20,5,122944,1315.2,91.2
"2353","08300","2019",1,1,0,3e+05,1807,166
"2354","08302","2019",22,21,1,84030.9090909091,863.727272727273,98.4545454545455
"2355","08303","2019",6,6,0,124500,958.5,135.166666666667
"2356","08307","2019",1,1,0,85000,773,110
"2357","08309","2019",1,1,0,85000,759,112
"2358","08311","2019",21,16,5,90076.6666666667,1033.14285714286,93.4285714285714
"2359","08312","2019",5,5,0,137264,1171.4,127.2
"2360","08313","2019",1,1,0,129000,1518,85
"2361","08314","2019",8,8,0,181593.75,1873,102.625
"2362","08316","2019",15,15,0,97213.3333333333,1000.2,98.5333333333333
"2363","08318","2019",5,5,0,120150,949.2,118
"2364","08319","2019",5,5,0,145058,1382.8,113.2
"2365","08320","2019",2,2,0,133750,1026,118
"2366","08322","2019",3,3,0,211633.333333333,1358,157.333333333333
"2367","08327","2019",13,13,0,139423.076923077,1395.84615384615,105
"2368","08328","2019",50,43,7,83182,1019.34,79.14
"2369","08330","2019",10,10,0,139098.6,1270.8,108.3
"2370","08331","2019",9,9,0,94827.7777777778,899.555555555556,106.111111111111
"2371","08333","2019",4,4,0,53075,750.5,80.75
"2372","08336","2019",2,2,0,85000,934,100
"2373","08338","2019",1,1,0,1e+05,1087,92
"2374","08339","2019",2,2,0,174940.5,1695,102
"2375","08340","2019",4,4,0,186140,1728.5,107.75
"2376","08341","2019",4,4,0,87125,739,102.5
"2377","08342","2019",2,2,0,94000,1034.5,92
"2378","08343","2019",7,7,0,103857.142857143,805.142857142857,132.714285714286
"2379","08344","2019",1,1,0,30000,500,60
"2380","08346","2019",13,13,0,137288.461538462,1541.23076923077,89.4615384615385
"2381","08347","2019",5,5,0,93600,1188,93
"2382","08349","2019",8,8,0,93375,985.375,86
"2383","08350","2019",1,1,0,95000,864,110
"2384","08352","2019",2,2,0,145000,1287.5,115.5
"2385","08353","2019",14,14,0,136064.285714286,1131.14285714286,119.357142857143
"2386","08354","2019",8,8,0,60562.5,702.5,80.625
"2387","08355","2019",4,4,0,127000,1466.5,97.5
"2388","08356","2019",3,3,0,137833.333333333,1601.66666666667,88.6666666666667
"2389","08357","2019",8,8,0,79731.25,775.75,106.25
"2390","08358","2019",5,5,0,128440,1305.6,93.4
"2391","08361","2019",9,8,1,133163.333333333,1144,112.333333333333
"2392","08362","2019",80,56,24,123585.625,1333.1125,94.6125
"2393","08363","2019",59,59,0,74593.2203389831,870.508474576271,85.5762711864407
"2394","08364","2019",1,1,0,54000,900,60
"2395","08365","2019",21,21,0,105724.714285714,1068.7619047619,102.380952380952
"2396","08366","2019",8,8,0,103562.5,1472.75,100.625
"2397","08367","2019",23,23,0,99647.8260869565,1092.73913043478,85.9130434782609
"2398","08368","2019",4,4,0,128250,1444.5,98.25
"2399","08370","2019",7,7,0,131400,1283.28571428571,102.428571428571
"2400","08373","2019",2,2,0,65850,527.5,126
"2401","08374","2019",1,1,0,105000,525,200
"2402","08375","2019",2,2,0,144500,1072,145.5
"2403","08376","2019",1,1,0,125000,1330,94
"2404","08377","2019",4,4,0,170975,1252.75,141
"2405","08378","2019",2,2,0,160000,1045.5,155
"2406","08379","2019",1,1,0,110000,873,126
"2407","08380","2019",1,1,0,96000,1231,78
"2408","08381","2019",13,13,0,148076.923076923,1283,123.538461538462
"2409","08384","2019",2,2,0,85000,724,125
"2410","08385","2019",15,14,1,136840,1409.86666666667,96.4666666666667
"2411","08386","2019",4,4,0,398625,3537.75,106.75
"2412","08388","2019",3,3,0,196233.333333333,1469.66666666667,146.333333333333
"2413","08390","2019",1,1,0,93000,921,101
"2414","08391","2019",12,12,0,123008.333333333,1208.75,98.4166666666667
"2415","08392","2019",1,1,0,62000,886,70
"2416","08395","2019",1,1,0,271700,1091,249
"2417","08396","2019",4,4,0,122500,903.75,132.5
"2418","08397","2019",2,2,0,1e+05,1033.5,97
"2419","08398","2019",1,1,0,110000,1222,90
"2420","08399","2019",1,1,0,225000,987,228
"2421","08400","2019",3,3,0,119356.666666667,1275.33333333333,93.3333333333333
"2422","08402","2019",12,12,0,141022.416666667,1121.33333333333,135.916666666667
"2423","08403","2019",14,14,0,140607.142857143,1408,102.714285714286
"2424","08404","2019",3,3,0,156733.333333333,1549.66666666667,101
"2425","08405","2019",2,2,0,118000,1549,77
"2426","08406","2019",1,1,0,30000,375,80
"2427","08408","2019",2,2,0,178500,1484,120.5
"2428","08409","2019",162,73,89,77566.7592592593,916.981481481482,85.1049382716049
"2429","08410","2019",1,1,0,147500,760,194
"2430","08413","2019",5,5,0,78860,672.2,112.6
"2431","08415","2019",1,1,0,1e+05,351,285
"2432","08416","2019",5,5,0,79200,950.6,100.2
"2433","08417","2019",4,4,0,88125,797,100.5
"2434","08418","2019",2,2,0,140000,1152,120.5
"2435","08419","2019",7,7,0,138863.714285714,1187.71428571429,112.142857142857
"2436","08420","2019",11,11,0,95481.8181818182,992.636363636364,98.6363636363636
"2437","08421","2019",1,1,0,29000,439,66
"2438","08422","2019",1,1,0,1e+05,714,140
"2439","08424","2019",1,1,0,105000,938,112
"2440","08427","2019",2,2,0,142500,1121.5,124.5
"2441","08428","2019",1,1,0,90000,750,120
"2442","08429","2019",2,2,0,160000,1525.5,103.5
"2443","08432","2019",2,2,0,97500,1133.5,85
"2444","08434","2019",3,3,0,136333.333333333,916,143.666666666667
"2445","08435","2019",14,14,0,136778.571428571,1522.35714285714,90.1428571428571
"2446","08436","2019",5,5,0,104400,1236.4,85
"2447","08437","2019",1,1,0,89500,617,145
"2448","08438","2019",2,2,0,128000,938.5,131
"2449","08444","2019",1,1,0,85000,924,92
"2450","08445","2019",2,2,0,166500,1348,130
"2451","08446","2019",2,2,0,294000,2503,88
"2452","08448","2019",20,20,0,83274,1012.15,91.05
"2453","08449","2019",10,10,0,92810,756.2,129.5
"2454","08450","2019",5,5,0,102381.2,1181.6,97.8
"2455","08451","2019",7,7,0,108457.142857143,1441.28571428571,84
"2456","08452","2019",6,6,0,98583.3333333333,984.833333333333,124.5
"2457","08453","2019",2,2,0,31250,573,56.5
"2458","08456","2019",4,4,0,165520,1392,119.25
"2459","08457","2019",12,12,0,158487.5,1296,125.083333333333
"2460","08460","2019",3,3,0,137833.333333333,1062.66666666667,132.666666666667
"2461","08461","2019",1,1,0,41000,854,48
"2462","08464","2019",2,2,0,102750,626.5,164
"2463","08465","2019",1,1,0,52000,897,58
"2464","08466","2019",1,1,0,49000,700,70
"2465","08468","2019",2,2,0,147900,1259,124.5
"2466","08469","2019",4,4,0,67500,759.5,98
"2467","08470","2019",1,1,0,25000,352,71
"2468","08473","2019",5,5,0,150790,1617.2,91.6
"2469","08476","2019",6,6,0,125650,1291.66666666667,91.3333333333333
"2470","08477","2019",1,1,0,152000,1169,130
"2471","08478","2019",2,2,0,205725,1022.5,193.5
"2472","08480","2019",26,26,0,141874.615384615,1509.76923076923,100.5
"2473","08481","2019",2,2,0,76250,738,100
"2474","08482","2019",1,1,0,278600,1833,152
"2475","08483","2019",9,9,0,115111.111111111,1102.44444444444,104.333333333333
"2476","08485","2019",2,2,0,117500,1198.5,98.5
"2477","08486","2019",27,26,1,91094.4444444444,980.111111111111,95.6666666666667
"2478","08487","2019",23,23,0,140217.391304348,1244.60869565217,101.434782608696
"2479","08488","2019",28,27,1,109710.714285714,1196.82142857143,92.8571428571429
"2480","08490","2019",28,24,4,98817.8571428571,1060.57142857143,95.3214285714286
"2481","08491","2019",34,33,1,128505.470588235,1344.05882352941,99.3823529411765
"2482","08492","2019",2,2,0,106500,1144,88
"2483","08494","2019",5,5,0,131000,1432.6,93.8
"2484","08497","2019",9,8,1,126611.111111111,1269,98
"2485","08498","2019",2,2,0,223500,2453,91.5
"2486","08501","2019",2,2,0,189325,1797,106.5
"2487","08502","2019",1,1,0,45000,634,71
"2488","08503","2019",1,1,0,237000,1539,154
"2489","09002","2019",3,3,0,176333.333333333,1402.66666666667,125.333333333333
"2490","09003","2019",8,8,0,75212.5,943.25,80.875
"2491","09005","2019",9,9,0,95187.7777777778,1540.77777777778,78.7777777777778
"2492","09007","2019",1,1,0,367170,1943,189
"2493","09008","2019",4,4,0,111625,1604.25,59.25
"2494","09009","2019",4,4,0,155750,1360.75,115
"2495","09013","2019",3,3,0,173333.333333333,1824.66666666667,79.3333333333333
"2496","09014","2019",3,3,0,67560,1227,60
"2497","09015","2019",7,7,0,104285.714285714,1040.85714285714,101.714285714286
"2498","09016","2019",1,1,0,205000,2470,83
"2499","09017","2019",4,4,0,57862.5,879.25,63
"2500","09018","2019",3,3,0,138666.666666667,2134.66666666667,66.3333333333333
"2501","09019","2019",7,7,0,213270.142857143,1494.57142857143,155.714285714286
"2502","09020","2019",2,2,0,96500,1125,87
"2503","09021","2019",4,4,0,241289.25,1623.25,149
"2504","09022","2019",3,3,0,131666.666666667,1335.33333333333,96
"2505","09023","2019",7,7,0,145640,1633.85714285714,88.4285714285714
"2506","09024","2019",4,4,0,95400,1128.75,87.5
"2507","09025","2019",3,3,0,140666.666666667,1355.66666666667,106
"2508","09026","2019",4,4,0,107808,1198.5,86.25
"2509","09029","2019",12,4,8,50560.1666666667,1066.66666666667,52.5833333333333
"2510","09030","2019",9,9,0,60555.5555555556,1049.55555555556,61.2222222222222
"2511","09032","2019",76,15,61,87399.8947368421,2074.84210526316,46.0789473684211
"2512","09033","2019",1,1,0,216000,2400,90
"2513","09035","2019",3,3,0,63333.3333333333,1188.66666666667,58.6666666666667
"2514","09038","2019",5,5,0,137000,1411.2,102.2
"2515","09039","2019",9,9,0,135833.333333333,1260.11111111111,105.222222222222
"2516","09040","2019",6,6,0,150906.666666667,1592.33333333333,104
"2517","09041","2019",3,3,0,114518.333333333,1420.66666666667,83
"2518","09042","2019",12,12,0,119302.5,1266.16666666667,109.166666666667
"2519","09043","2019",13,12,1,92488.4615384615,1067.53846153846,87.8461538461538
"2520","09044","2019",3,3,0,159633.333333333,1560,126
"2521","09045","2019",2,2,0,128300,1452.5,88.5
"2522","09046","2019",1,1,0,352800,1857,190
"2523","09047","2019",19,18,1,78659.4736842105,746.421052631579,109.684210526316
"2524","09048","2019",1,1,0,60000,600,100
"2525","09049","2019",3,3,0,142345,1809.33333333333,85
"2526","09050","2019",5,5,0,161103.8,1274,127.4
"2527","09051","2019",2,2,0,220000,1414,153
"2528","09052","2019",2,2,0,155000,1444.5,107.5
"2529","09053","2019",1,1,0,85000,810,105
"2530","09054","2019",4,4,0,110625,1222.25,95.25
"2531","09055","2019",5,5,0,52792.6,1160.6,42
"2532","09056","2019",2,2,0,166850,1458,100
"2533","09057","2019",6,6,0,124950,1769.16666666667,65.5
"2534","09058","2019",1,1,0,113000,831,136
"2535","09059","2019",8,8,0,75250,1292.25,57.375
"2536","09060","2019",9,9,0,86830,960.666666666667,98.6666666666667
"2537","09061","2019",7,7,0,98125.4285714286,1019.42857142857,85.7142857142857
"2538","09062","2019",8,8,0,87881.5,1227.25,79.125
"2539","09063","2019",2,2,0,56600,698,75.5
"2540","09065","2019",14,14,0,104073.571428571,1490.71428571429,62.2142857142857
"2541","09066","2019",8,8,0,143312.5,1556.5,92.875
"2542","09067","2019",5,5,0,120584.6,1215.8,103.2
"2543","09068","2019",1,1,0,181380,2015,90
"2544","09069","2019",3,3,0,119888.666666667,1586.33333333333,78
"2545","09070","2019",2,2,0,141500,1280.5,111
"2546","09071","2019",2,2,0,80000,729.5,109.5
"2547","09072","2019",1,1,0,34000,567,60
"2548","09073","2019",2,2,0,60500,445,139.5
"2549","09074","2019",5,5,0,76500,1011.4,83.4
"2550","09075","2019",5,5,0,53840,766,67.2
"2551","09076","2019",4,4,0,151250,2166.5,85.75
"2552","09077","2019",4,4,0,103600,1093.75,86.5
"2553","09078","2019",1,1,0,50000,1042,48
"2554","09079","2019",4,4,0,155750,1324,113.25
"2555","09080","2019",3,3,0,124000,972.666666666667,119.333333333333
"2556","09081","2019",2,2,0,160387.5,1000,156.5
"2557","09082","2019",8,8,0,74475,993.25,78.5
"2558","09085","2019",5,5,0,142377,1737.8,71.4
"2559","09086","2019",3,3,0,74333.3333333333,1052.66666666667,72.6666666666667
"2560","09087","2019",2,2,0,133500,1362.5,97.5
"2561","09088","2019",2,2,0,50000,651,78
"2562","09090","2019",1,1,0,530000,1587,334
"2563","09091","2019",4,4,0,106625,1082.5,98.75
"2564","09092","2019",1,1,0,95000,401,237
"2565","09093","2019",2,2,0,44000,772.5,62
"2566","09094","2019",2,2,0,85000,866,97.5
"2567","09095","2019",4,4,0,63250,722,89.5
"2568","09097","2019",4,4,0,104500,1004,97.25
"2569","09099","2019",1,1,0,167000,1856,90
"2570","09100","2019",4,2,2,62930,1313.5,55.75
"2571","09101","2019",3,3,0,223000,1728.66666666667,126.666666666667
"2572","09102","2019",3,3,0,48333.3333333333,693.333333333333,74.3333333333333
"2573","09103","2019",10,10,0,156875.9,1450.5,107.4
"2574","09104","2019",5,5,0,139625,1195,112.8
"2575","09105","2019",14,13,1,94039.8571428571,1206.64285714286,79.5
"2576","09106","2019",2,2,0,140000,1687.5,90
"2577","09107","2019",1,1,0,315000,2234,141
"2578","09108","2019",3,3,0,45313.3333333333,920.333333333333,53.3333333333333
"2579","09110","2019",1,1,0,45000,1500,30
"2580","09111","2019",3,3,0,75000,975,76
"2581","09113","2019",7,7,0,94821.4285714286,1225.28571428571,82.1428571428571
"2582","09114","2019",4,4,0,111625,1302.5,75.5
"2583","09115","2019",2,2,0,122075,1199,92
"2584","09116","2019",6,5,1,185273.333333333,1707.33333333333,112
"2585","09118","2019",2,2,0,138000,1003.5,142.5
"2586","09119","2019",5,5,0,79200,1046,65.8
"2587","09120","2019",2,2,0,62500,517.5,122
"2588","09121","2019",7,7,0,187302.142857143,2161,91.7142857142857
"2589","09122","2019",145,83,62,104468.986206897,1322.83448275862,80.048275862069
"2590","09124","2019",17,14,3,109158.823529412,1303.05882352941,83.4117647058823
"2591","09125","2019",15,15,0,122075.333333333,1149.2,98.4
"2592","09126","2019",5,5,0,79640,784.6,119.2
"2593","09127","2019",1,1,0,44000,1257,35
"2594","09128","2019",2,2,0,156000,1527.5,110.5
"2595","09129","2019",5,5,0,78000,1600.2,47
"2596","09130","2019",5,5,0,148200,1563,101.2
"2597","09132","2019",4,4,0,93250,1012,82.25
"2598","09133","2019",1,1,0,167000,1518,110
"2599","09136","2019",2,2,0,61250,1084,59.5
"2600","09139","2019",1,0,1,116700,2382,49
"2601","09140","2019",2,2,0,85290,1218,70
"2602","09142","2019",4,4,0,79500,796.75,99
"2603","09143","2019",1,1,0,88000,1100,80
"2604","09145","2019",4,4,0,97250,1204.25,85
"2605","09147","2019",5,5,0,227600,1921.8,122
"2606","09148","2019",1,1,0,28000,483,58
"2607","09149","2019",5,5,0,68300,884.8,75.8
"2608","09150","2019",2,1,1,213000,1256,168
"2609","09153","2019",1,1,0,92000,876,105
"2610","09154","2019",1,1,0,136000,1088,125
"2611","09156","2019",1,1,0,148000,1358,109
"2612","09157","2019",26,25,1,93316.1153846154,1012.38461538462,96.5384615384615
"2613","09158","2019",3,3,0,182666.666666667,2016,122.666666666667
"2614","09159","2019",3,3,0,101950,1735,53
"2615","09160","2019",94,82,12,76794.4787234043,857.010638297872,91.8723404255319
"2616","09161","2019",11,11,0,100594.545454545,1166.81818181818,91.6363636363636
"2617","09163","2019",1,1,0,230000,1278,180
"2618","09164","2019",1,1,0,78000,804,97
"2619","09165","2019",3,3,0,110400,1132,98
"2620","09166","2019",2,2,0,85950,1647,52.5
"2621","09167","2019",31,29,2,152482.741935484,1598.09677419355,101.258064516129
"2622","09168","2019",2,2,0,197000,1318,155
"2623","09169","2019",1,1,0,150000,1119,134
"2624","09170","2019",3,3,0,104550,1100.33333333333,98
"2625","09171","2019",2,2,0,146803,1972.5,77
"2626","09173","2019",2,2,0,312600,1792.5,169
"2627","09174","2019",4,4,0,151587.5,1742.25,87.75
"2628","09175","2019",1,1,0,99000,1088,91
"2629","09176","2019",6,5,1,101771.666666667,1009.33333333333,105.166666666667
"2630","09177","2019",4,4,0,103775,869.25,135
"2631","09181","2019",19,19,0,91147.2105263158,955.947368421053,88.5263157894737
"2632","09182","2019",17,17,0,69170,1344.41176470588,60.2352941176471
"2633","09183","2019",2,2,0,142000,1501,95
"2634","09185","2019",69,67,2,130652.913043478,1358.55072463768,97.0434782608696
"2635","09187","2019",2,2,0,95000,1774,52.5
"2636","09188","2019",17,17,0,126931.764705882,1370.05882352941,89.1176470588235
"2637","09189","2019",4,4,0,76143.75,1173.75,63.5
"2638","09192","2019",5,5,0,80600,870.8,90.2
"2639","09193","2019",4,4,0,111650,1438.25,78.25
"2640","09194","2019",63,49,14,140384.53968254,1307.96825396825,107.603174603175
"2641","09196","2019",2,2,0,89750,1192,69
"2642","09197","2019",1,1,0,30000,333,90
"2643","09198","2019",3,3,0,123333.333333333,1263,99.3333333333333
"2644","09199","2019",5,5,0,134000,1118.4,137.6
"2645","09201","2019",1,1,0,118750,1397,85
"2646","09202","2019",5,5,0,126400,1435.6,97.8
"2647","09203","2019",1,1,0,66000,635,104
"2648","09204","2019",1,1,0,265000,2760,96
"2649","09206","2019",24,21,3,86161.4583333333,1362.79166666667,73.7916666666667
"2650","09207","2019",12,12,0,138314.166666667,1420.75,96.3333333333333
"2651","09208","2019",1,1,0,202000,1122,180
"2652","09209","2019",10,10,0,146085,1198.5,122.7
"2653","09210","2019",5,4,1,174570,1263,126.6
"2654","09211","2019",5,5,0,111400,1219.4,94
"2655","09213","2019",2,2,0,119750,1396.5,114
"2656","09214","2019",13,13,0,142707.769230769,1569.69230769231,83.6923076923077
"2657","09215","2019",1,1,0,118000,983,120
"2658","09216","2019",2,2,0,34150,569.5,60
"2659","09217","2019",1,1,0,42680,440,97
"2660","09218","2019",4,4,0,128940,1619.75,83.25
"2661","09219","2019",3,3,0,123116.666666667,1313.33333333333,97.6666666666667
"2662","09220","2019",3,3,0,196611.666666667,1963.33333333333,100.333333333333
"2663","09221","2019",5,4,1,76932.8,1003.2,71.4
"2664","09222","2019",1,1,0,25000,500,50
"2665","09223","2019",10,10,0,107274,1507.2,75.2
"2666","09224","2019",14,14,0,112214.285714286,1288.35714285714,86.2142857142857
"2667","09225","2019",263,171,92,106478.053231939,1271.83650190114,85.1596958174905
"2668","09226","2019",1,1,0,107000,1783,60
"2669","09227","2019",3,3,0,182333.333333333,1258,127
"2670","09228","2019",4,4,0,110563,865.5,102
"2671","09229","2019",3,3,0,114666.666666667,1165.33333333333,97.6666666666667
"2672","09230","2019",2,2,0,90600,977.5,93
"2673","09231","2019",10,10,0,54400,1248.1,54.7
"2674","09232","2019",9,9,0,71358.8888888889,932.888888888889,80.2222222222222
"2675","09233","2019",1,1,0,120000,863,139
"2676","09234","2019",1,1,0,80000,650,123
"2677","09235","2019",14,14,0,121542.857142857,1264.21428571429,94
"2678","09236","2019",8,8,0,118868.75,1304.625,91.625
"2679","09237","2019",2,2,0,63857.5,1152.5,57
"2680","09238","2019",6,6,0,125775,1154.33333333333,109.333333333333
"2681","09239","2019",6,6,0,101916.666666667,1229.33333333333,83
"2682","09240","2019",4,4,0,149750,1186.75,125
"2683","09241","2019",8,8,0,92380.625,1020,101.375
"2684","09243","2019",3,3,0,92166.6666666667,937.666666666667,80
"2685","09244","2019",11,11,0,170477,1285.90909090909,134.727272727273
"2686","09245","2019",8,7,1,177500,2243.875,91.25
"2687","09246","2019",13,13,0,113420.769230769,1012,109.615384615385
"2688","09247","2019",1,1,0,88000,1467,60
"2689","09249","2019",2,2,0,228000,2492.5,90
"2690","09251","2019",3,3,0,174333.333333333,1292.66666666667,137.333333333333
"2691","09252","2019",3,3,0,110736.666666667,1640,76.6666666666667
"2692","09253","2019",2,2,0,58000,491.5,105
"2693","09254","2019",3,3,0,230816.666666667,1623.33333333333,136.666666666667
"2694","09255","2019",2,2,0,109000,1499.5,78
"2695","09257","2019",13,13,0,158161.923076923,1557.76923076923,106.153846153846
"2696","09258","2019",3,3,0,170800,1371,121.666666666667
"2697","09259","2019",1,1,0,168000,1768,95
"2698","09261","2019",93,61,32,102359.569892473,1264.17204301075,84.8064516129032
"2699","09262","2019",1,1,0,75000,676,111
"2700","09264","2019",13,13,0,150438.461538462,1502.07692307692,99.6153846153846
"2701","09265","2019",32,22,10,122012.1875,1497.65625,84.4375
"2702","09266","2019",1,1,0,233319,1667,140
"2703","09267","2019",5,5,0,56450,1219.6,45.8
"2704","09268","2019",20,18,2,155851.5,2010.65,90.35
"2705","09269","2019",3,3,0,135040.666666667,1340,97.3333333333333
"2706","09270","2019",5,5,0,212770,1529.8,132.4
"2707","09272","2019",21,21,0,117499.857142857,1224.66666666667,106.809523809524
"2708","09273","2019",8,8,0,117625,1137.5,101.625
"2709","09274","2019",4,4,0,138216.25,1440.5,99.5
"2710","09275","2019",6,6,0,131016.666666667,1314.66666666667,98.5
"2711","09276","2019",1,1,0,131000,819,160
"2712","09277","2019",12,12,0,129068.333333333,1447.41666666667,94.1666666666667
"2713","09279","2019",3,3,0,77393.3333333333,1539,54
"2714","09280","2019",27,27,0,96509.2592592593,1294.25925925926,91.2962962962963
"2715","09282","2019",77,61,16,127284.909090909,1364.46753246753,95.6363636363636
"2716","09283","2019",9,4,5,49707.7777777778,1406,37.2222222222222
"2717","09284","2019",2,2,0,88712.5,1087.5,74
"2718","09285","2019",14,14,0,153085.714285714,1408,108.857142857143
"2719","09289","2019",7,7,0,117611.857142857,1727.28571428571,76.8571428571429
"2720","09290","2019",3,3,0,83000,2054,45.6666666666667
"2721","09291","2019",3,3,0,78000,1900.66666666667,51
"2722","09292","2019",1,1,0,47050,588,80
"2723","09293","2019",19,19,0,132724.578947368,1403.84210526316,100.578947368421
"2724","09294","2019",2,2,0,227500,1572,141
"2725","09295","2019",1,1,0,60000,2308,26
"2726","09296","2019",3,3,0,113066.666666667,1218.33333333333,85.6666666666667
"2727","09298","2019",5,5,0,117094,1419,90.8
"2728","09299","2019",14,14,0,108916.785714286,1712.71428571429,77.3571428571429
"2729","09300","2019",3,3,0,189141.666666667,1442.66666666667,128
"2730","09301","2019",14,14,0,92757.1428571429,1036,86.0714285714286
"2731","09303","2019",3,3,0,90000,1237,73.3333333333333
"2732","09305","2019",3,3,0,181533.333333333,1334.33333333333,136.333333333333
"2733","09306","2019",28,25,3,126885,1458.60714285714,88.7142857142857
"2734","09307","2019",1,1,0,80000,559,143
"2735","09308","2019",4,4,0,195012.5,1246.25,167.5
"2736","09312","2019",31,31,0,174447.903225806,1755.90322580645,98.258064516129
"2737","09313","2019",2,2,0,104500,1248.5,83
"2738","09314","2019",2,2,0,140505,1961.5,71.5
"2739","09315","2019",1,1,0,27000,551,49
"2740","09316","2019",1,1,0,94500,756,125
"2741","09318","2019",1,1,0,158000,7900,20
"2742","09319","2019",2,2,0,75250,768,98
"2743","09320","2019",1,1,0,90000,1607,56
"2744","09321","2019",7,2,5,37414.2857142857,821.428571428571,40.8571428571429
"2745","09322","2019",39,28,11,83305.4615384615,1625.23076923077,50.6410256410256
"2746","09323","2019",3,3,0,147666.666666667,1034,137.666666666667
"2747","09324","2019",46,46,0,137893.608695652,1423.45652173913,98.1521739130435
"2748","09326","2019",2,2,0,43000,715,67.5
"2749","09327","2019",1,1,0,140000,741,189
"2750","09328","2019",3,3,0,97666.6666666667,1042,91
"2751","09329","2019",7,7,0,134421.428571429,1456.42857142857,92.4285714285714
"2752","09330","2019",1,1,0,149500,1438,104
"2753","09331","2019",13,13,0,143457.692307692,1371.53846153846,106.230769230769
"2754","09332","2019",21,19,2,172966.666666667,1533,106.047619047619
"2755","09334","2019",17,15,2,81493.1764705882,1131.94117647059,74.5882352941177
"2756","09336","2019",16,16,0,84105.625,840.8125,100.8125
"2757","09338","2019",1,1,0,202850,2135,95
"2758","09339","2019",11,11,0,146400,1462.90909090909,99.3636363636364
"2759","09340","2019",2,2,0,125875,1488.5,84
"2760","09342","2019",3,3,0,186333.333333333,1955.33333333333,91
"2761","10002","2019",4,4,0,81125,1168.25,68.5
"2762","10003","2019",61,60,1,98213.1147540984,1045.83606557377,97.016393442623
"2763","10005","2019",1,1,0,25000,347,72
"2764","10006","2019",30,27,3,134213.333333333,1367.83333333333,99.5666666666667
"2765","10009","2019",1,1,0,70000,556,126
"2766","10010","2019",1,1,0,70000,921,76
"2767","10011","2019",2,2,0,43500,945.5,54.5
"2768","10012","2019",2,2,0,104350,1164.5,83
"2769","10013","2019",2,2,0,159725,1780,90
"2770","10015","2019",4,4,0,142750,1601.75,99.75
"2771","10018","2019",11,11,0,114136.363636364,1063,112
"2772","10019","2019",3,3,0,107666.666666667,1175.33333333333,89.6666666666667
"2773","10020","2019",9,9,0,134000,1198.77777777778,110.555555555556
"2774","10021","2019",3,3,0,83000,790,132.666666666667
"2775","10022","2019",4,4,0,61848.25,650.25,100.75
"2776","10023","2019",1,1,0,195000,929,210
"2777","10024","2019",3,3,0,103500,937.666666666667,114.333333333333
"2778","10025","2019",1,1,0,70000,547,128
"2779","10027","2019",1,1,0,92000,760,121
"2780","10029","2019",1,1,0,38000,432,88
"2781","10030","2019",19,13,6,203263.157894737,1902.57894736842,107
"2782","10031","2019",7,7,0,136928.571428571,1336.85714285714,100.714285714286
"2783","10032","2019",2,2,0,220375,1720.5,126.5
"2784","10033","2019",33,27,6,95980.303030303,918.878787878788,108.969696969697
"2785","10034","2019",15,11,4,77333.3333333333,1049.26666666667,73.8666666666667
"2786","10035","2019",6,6,0,61166.6666666667,735.5,76.1666666666667
"2787","10037","2019",8,8,0,132787.5,1342.875,103.75
"2788","10038","2019",3,3,0,92666.6666666667,974.333333333333,92.6666666666667
"2789","10040","2019",2,2,0,55500,612,90
"2790","10042","2019",4,4,0,53000,939.75,57.25
"2791","10043","2019",1,1,0,30000,667,45
"2792","10045","2019",1,1,0,77000,770,100
"2793","10046","2019",1,1,0,69700,871,80
"2794","10048","2019",2,2,0,97000,719.5,129.5
"2795","10049","2019",4,4,0,214575,1676,129.25
"2796","10050","2019",1,1,0,160000,1368,117
"2797","10051","2019",8,7,1,166875,1230.625,138.25
"2798","10052","2019",3,3,0,119666.666666667,931.333333333333,129.666666666667
"2799","10053","2019",8,8,0,156250,1548.625,105.375
"2800","10054","2019",2,2,0,175950,1556,128.5
"2801","10056","2019",2,2,0,212000,1677.5,124.5
"2802","10057","2019",2,2,0,77500,857,101.5
"2803","10058","2019",4,4,0,72000,845,82
"2804","10059","2019",1,1,0,69500,747,93
"2805","10060","2019",25,22,3,199546,1872.36,108.72
"2806","10062","2019",8,8,0,178856.25,1539.75,111.25
"2807","10063","2019",2,2,0,69500,860.5,81
"2808","10065","2019",1,1,0,98500,547,180
"2809","10066","2019",8,8,0,171275,1394.75,119.25
"2810","10067","2019",19,16,3,165957.894736842,1618.05263157895,105.578947368421
"2811","10068","2019",1,1,0,123500,950,130
"2812","10069","2019",1,1,0,119000,730,163
"2813","10070","2019",5,5,0,176900,1432,95
"2814","10073","2019",2,2,0,66000,651,100.5
"2815","10074","2019",6,6,0,112250,1258,92.6666666666667
"2816","10075","2019",3,3,0,140650,681,203
"2817","10076","2019",1,1,0,90000,1125,80
"2818","10077","2019",2,2,0,130000,1296.5,101.5
"2819","10080","2019",10,10,0,110400,1038.5,108.1
"2820","10081","2019",106,60,46,118883.481132075,1489.04716981132,79.5849056603774
"2821","10083","2019",5,5,0,96500,1582.6,65.6
"2822","10084","2019",12,12,0,199244.166666667,1540.25,129.166666666667
"2823","10085","2019",1,1,0,210000,1500,140
"2824","10086","2019",4,4,0,113475,927.75,120.75
"2825","10089","2019",5,5,0,146822,1336.6,107.6
"2826","10091","2019",2,2,0,171000,1087.5,168
"2827","10092","2019",1,1,0,322100,2301,140
"2828","10093","2019",1,1,0,73000,483,151
"2829","10094","2019",4,4,0,62875,702.75,88.5
"2830","10095","2019",1,1,0,92000,1122,82
"2831","10096","2019",4,4,0,91500,1294.5,78
"2832","10097","2019",3,3,0,105483.333333333,934,125
"2833","10099","2019",9,9,0,73111.1111111111,896.333333333333,87.3333333333333
"2834","10100","2019",12,12,0,140250,1570.83333333333,88.25
"2835","10101","2019",2,2,0,133500,1184,109
"2836","10102","2019",2,2,0,94000,994,103
"2837","10103","2019",2,2,0,67333.5,539.5,123
"2838","10104","2019",3,3,0,199333.333333333,1564.33333333333,127.333333333333
"2839","10106","2019",1,1,0,88800,1184,75
"2840","10107","2019",2,2,0,60000,799.5,74.5
"2841","10108","2019",3,3,0,93833.3333333333,1158.66666666667,81.6666666666667
"2842","10109","2019",3,3,0,169166.666666667,1408.66666666667,128.333333333333
"2843","10110","2019",4,4,0,159500,1538.25,104
"2844","10111","2019",3,3,0,99166.6666666667,1084.33333333333,103.666666666667
"2845","10113","2019",5,5,0,116537.6,1154.8,90.4
"2846","10114","2019",14,14,0,100738.5,1081.64285714286,90.0714285714286
"2847","10115","2019",13,12,1,166961.538461538,1557.07692307692,113.769230769231
"2848","10116","2019",4,4,0,121375,1262.5,103.5
"2849","10117","2019",1,1,0,136300,1175,116
"2850","10119","2019",2,2,0,184370,1153,195
"2851","10120","2019",2,2,0,137500,1771,70
"2852","10121","2019",2,2,0,87000,538,157.5
"2853","10122","2019",6,6,0,93858.3333333333,803,124.166666666667
"2854","10123","2019",19,17,2,105505.263157895,1198.63157894737,91.2105263157895
"2855","10124","2019",3,3,0,163333.333333333,1733,95.3333333333333
"2856","10125","2019",3,3,0,141000,1374,103
"2857","10126","2019",2,2,0,75000,665,113.5
"2858","10128","2019",1,1,0,36000,450,80
"2859","10129","2019",3,3,0,266333.333333333,1008,244
"2860","10130","2019",3,3,0,150000,892,165
"2861","10131","2019",3,3,0,129666.666666667,943.666666666667,142
"2862","10132","2019",8,8,0,89750,977.75,90.75
"2863","10133","2019",4,4,0,109750,984.75,109.5
"2864","10135","2019",3,3,0,123333.333333333,1003.33333333333,126
"2865","10136","2019",2,2,0,110000,954.5,122
"2866","10138","2019",1,1,0,80000,645,124
"2867","10139","2019",2,2,0,95000,934.5,100
"2868","10140","2019",12,12,0,76250,817.5,93.4166666666667
"2869","10141","2019",13,13,0,100461.538461538,1222.53846153846,99.1538461538462
"2870","10142","2019",17,17,0,128182.352941176,1240.94117647059,99.5294117647059
"2871","10143","2019",2,2,0,71000,733.5,100
"2872","10144","2019",2,2,0,103500,1057,112.5
"2873","10145","2019",3,3,0,164330,1462,115
"2874","10146","2019",3,3,0,122333.333333333,1871.66666666667,70
"2875","10147","2019",2,2,0,107500,1228.5,87
"2876","10148","2019",3,2,1,50250,651.333333333333,75.3333333333333
"2877","10149","2019",1,1,0,216850,1560,139
"2878","10150","2019",3,3,0,93333.3333333333,1250.33333333333,72.6666666666667
"2879","10151","2019",6,6,0,130203.333333333,1262.5,103.833333333333
"2880","10153","2019",6,6,0,163041.666666667,1643,103.5
"2881","10155","2019",4,4,0,65031.5,959,87
"2882","10156","2019",8,8,0,182457.5,1373.5,134.25
"2883","10157","2019",1,1,0,140000,1538,91
"2884","10158","2019",10,10,0,131630,1507.4,82
"2885","10159","2019",3,3,0,112000,805.666666666667,145.666666666667
"2886","10162","2019",3,3,0,117666.666666667,1237,96
"2887","10164","2019",4,4,0,90125,793,112
"2888","10165","2019",6,6,0,144123.333333333,1573.16666666667,90.1666666666667
"2889","10166","2019",9,8,1,136353.333333333,1493.11111111111,98.2222222222222
"2890","10167","2019",2,2,0,117500,1646.5,64.5
"2891","10169","2019",2,2,0,122500,808,146
"2892","10170","2019",7,7,0,140542.857142857,1331,113.714285714286
"2893","10171","2019",6,6,0,98750,920.333333333333,115.166666666667
"2894","10172","2019",2,2,0,108500,1269,87
"2895","10173","2019",5,5,0,129000,1619.8,85.6
"2896","10174","2019",1,1,0,35000,333,105
"2897","10177","2019",1,1,0,145000,2339,62
"2898","10178","2019",1,1,0,120000,1200,100
"2899","10179","2019",2,2,0,162500,1675.5,97
"2900","10180","2019",1,1,0,90000,938,96
"2901","10181","2019",8,8,0,110312.5,982.375,115.25
"2902","10182","2019",4,4,0,76000,752.5,115.75
"2903","10185","2019",3,3,0,165000,1186.33333333333,131.333333333333
"2904","10186","2019",10,9,1,192450,1508,123.8
"2905","10187","2019",9,9,0,99701.1111111111,952.333333333333,128.222222222222
"2906","10188","2019",1,1,0,75000,1014,74
"2907","10189","2019",2,2,0,153400,1476.5,106
"2908","10190","2019",6,6,0,181250,2504.5,81.1666666666667
"2909","10191","2019",12,11,1,195039.5,1719.5,116.416666666667
"2910","10192","2019",3,3,0,90518,774.333333333333,112.666666666667
"2911","10193","2019",4,4,0,94000,857.75,115.25
"2912","10194","2019",4,4,0,88000,904,96.25
"2913","10195","2019",4,4,0,90795,599.25,149.25
"2914","10196","2019",1,1,0,119000,1253,95
"2915","10198","2019",2,2,0,164000,1346.5,127
"2916","10199","2019",6,6,0,131833.333333333,1031.83333333333,127.333333333333
"2917","10200","2019",3,3,0,140333.333333333,1597,99.6666666666667
"2918","10201","2019",1,1,0,29000,806,36
"2919","10202","2019",3,3,0,86666.6666666667,960.333333333333,85
"2920","10203","2019",3,3,0,99333.3333333333,1132.66666666667,89
"2921","10204","2019",4,4,0,146787.5,1268.25,116
"2922","10208","2019",3,3,0,127266.666666667,1710.66666666667,89.3333333333333
"2923","10209","2019",22,21,1,204252.954545455,1631.40909090909,124.954545454545
"2924","10210","2019",7,7,0,147371.428571429,1587,93.7142857142857
"2925","10211","2019",21,21,0,220364.285714286,1697.28571428571,134.904761904762
"2926","10212","2019",1,1,0,109000,1453,75
"2927","10213","2019",1,1,0,80000,909,88
"2928","10214","2019",1,1,0,125000,1562,80
"2929","10215","2019",2,2,0,120000,1114.5,119.5
"2930","10216","2019",6,6,0,120316.666666667,949,127
"2931","10217","2019",1,1,0,62500,772,81
"2932","10218","2019",2,2,0,109250,827.5,127.5
"2933","10220","2019",28,28,0,141624.642857143,1269.67857142857,113.178571428571
"2934","10221","2019",3,3,0,140833.333333333,1092.33333333333,126.666666666667
"2935","10222","2019",8,8,0,89000,760.75,117.25
"2936","10223","2019",7,7,0,69571.4285714286,780,98.4285714285714
"2937","10224","2019",18,15,3,122193.888888889,1205.61111111111,103.055555555556
"2938","10225","2019",4,4,0,99050,1134.5,87.75
"2939","10226","2019",2,1,1,57950,659.5,90
"2940","10227","2019",3,3,0,51666.6666666667,725,74.6666666666667
"2941","10228","2019",1,1,0,80000,667,120
"2942","10229","2019",4,4,0,130250,1322.75,95.25
"2943","10230","2019",7,7,0,175935.714285714,1695.85714285714,104
"2944","10231","2019",6,6,0,157325,1484.66666666667,107.833333333333
"2945","10232","2019",9,9,0,107222.222222222,1049.22222222222,106.888888888889
"2946","10233","2019",19,18,1,119395.263157895,1194.73684210526,100.578947368421
"2947","10234","2019",4,4,0,136550,1511.75,88.75
"2948","10235","2019",1,1,0,139000,1716,81
"2949","10236","2019",1,1,0,179000,737,243
"2950","10237","2019",6,6,0,194033.333333333,1969.66666666667,120.5
"2951","10238","2019",9,9,0,186341.111111111,2266.66666666667,104.888888888889
"2952","10239","2019",7,7,0,184038.571428571,1652.85714285714,112.142857142857
"2953","10243","2019",1,1,0,45000,562,80
"2954","10245","2019",6,6,0,154291.666666667,1514.66666666667,101.833333333333
"2955","10246","2019",3,3,0,126783,1047,117
"2956","10247","2019",1,1,0,114500,1258,91
"2957","10248","2019",2,2,0,141764,859,172.5
"2958","10249","2019",5,5,0,162500,1505.8,106
"2959","10250","2019",2,2,0,147700,1434,100
"2960","10251","2019",2,2,0,65500,910,90
"2961","10254","2019",6,6,0,133500,1806.33333333333,87.6666666666667
"2962","10255","2019",4,4,0,143932.5,1695,97.25
"2963","10256","2019",5,5,0,168960,1446.2,116
"2964","10257","2019",3,3,0,92333.3333333333,924.333333333333,98
"2965","10258","2019",1,1,0,119000,1352,88
"2966","10259","2019",5,5,0,121800,1242.6,99.2
"2967","10260","2019",5,5,0,243748,1920.6,125.2
"2968","10261","2019",7,7,0,71028.5714285714,857,82
"2969","10262","2019",6,6,0,72666.6666666667,646.5,114.666666666667
"2970","10263","2019",6,6,0,113716.666666667,893,141.5
"2971","10264","2019",2,2,0,82000,1067,75.5
"2972","10265","2019",15,10,5,152593.333333333,1813.8,84.2666666666667
"2973","10267","2019",1,1,0,85000,1700,50
"2974","10268","2019",71,58,13,131435.915492958,1531.54929577465,88.5211267605634
"2975","10269","2019",1,1,0,93000,1134,82
"2976","10270","2019",3,3,0,184333.333333333,1605.33333333333,115
"2977","10271","2019",7,7,0,101927.142857143,1045.42857142857,94.7142857142857
"2978","10272","2019",1,1,0,86250,526,164
"2979","10274","2019",3,3,0,145000,1463.66666666667,100
"2980","10275","2019",4,4,0,81250,1143,75.5
"2981","10276","2019",6,6,0,120250,1118.33333333333,113.5
"2982","10278","2019",3,3,0,61166.6666666667,1008,68
"2983","10280","2019",14,14,0,113928.571428571,1233.35714285714,91.5714285714286
"2984","10281","2019",4,4,0,169875,2090.25,82.5
"2985","10282","2019",11,10,1,171200,1703.18181818182,104.727272727273
"2986","10283","2019",3,3,0,65833.3333333333,803,83
"2987","10284","2019",5,5,0,143600,1183.8,125.8
"2988","10286","2019",3,3,0,119797,926.666666666667,143
"2989","10287","2019",10,10,0,95550,945.4,105.1
"2990","10288","2019",3,3,0,82666.6666666667,972.333333333333,84.3333333333333
"2991","10289","2019",12,11,1,70958.3333333333,801.833333333333,86.25
"2992","10290","2019",4,4,0,58000,768.75,80.75
"2993","10291","2019",5,5,0,121700,981.6,121.6
"2994","10293","2019",1,1,0,180190,1243,145
"2995","10297","2019",51,38,13,141049.607843137,1642.27450980392,89.6470588235294
"2996","10299","2019",5,5,0,105400,1331,86.8
"2997","10300","2019",8,8,0,117500,1023.5,114.375
"2998","10301","2019",1,1,0,103000,669,154
"2999","10304","2019",3,3,0,170000,1158,165.666666666667
"3000","10305","2019",1,1,0,95000,792,120
"3001","10307","2019",2,2,0,187000,1588.5,116
"3002","10308","2019",1,1,0,105000,1167,90
"3003","10309","2019",1,1,0,60000,667,90
"3004","10310","2019",2,2,0,182892.5,1222.5,158
"3005","10312","2019",3,3,0,57633.3333333333,1297.33333333333,56.6666666666667
"3006","10313","2019",4,4,0,124950,1215.25,96.25
"3007","10314","2019",6,6,0,129891.666666667,984,125.166666666667
"3008","10316","2019",2,2,0,101500,643,172
"3009","10317","2019",5,5,0,69980,740,96.4
"3010","10318","2019",2,2,0,153000,1146.5,127.5
"3011","10319","2019",10,10,0,79978,646.6,127.4
"3012","10320","2019",3,3,0,107500,809.333333333333,132.333333333333
"3013","10321","2019",35,35,0,195567.428571429,1995.14285714286,97.3428571428571
"3014","10323","2019",197,174,23,84004.7969543147,1019.66497461929,83.9289340101523
"3015","10324","2019",3,3,0,120940,1084,133
"3016","10325","2019",41,32,9,203702.926829268,1979.43902439024,105.951219512195
"3017","10326","2019",5,5,0,106982,1271.2,83
"3018","10328","2019",5,5,0,204710,1629,125.8
"3019","10329","2019",13,13,0,197676.923076923,1614.84615384615,123.461538461538
"3020","10330","2019",1,1,0,70000,667,105
"3021","10331","2019",5,5,0,184220,1430.4,143.4
"3022","10332","2019",6,6,0,186241.666666667,1822,100.5
"3023","10333","2019",259,137,122,122477.760617761,1527.47876447876,79.4015444015444
"3024","10334","2019",7,7,0,120821.428571429,1200.71428571429,96.5714285714286
"3025","10335","2019",2,2,0,90000,866,101
"3026","10336","2019",4,4,0,166000,1706.5,96.5
"3027","10337","2019",1,1,0,50000,476,105
"3028","10339","2019",4,4,0,66625,966.5,66
"3029","10340","2019",25,24,1,192016.76,2114.24,102.16
"3030","10341","2019",6,6,0,133750,1321,101.166666666667
"3031","10342","2019",7,7,0,162864.285714286,1338,140.571428571429
"3032","10343","2019",116,79,37,132542.068965517,1547.87068965517,84.9224137931034
"3033","10344","2019",5,5,0,223360,1624.6,141.8
"3034","10345","2019",8,8,0,95625,1187.5,78
"3035","10346","2019",2,2,0,86500,922.5,85.5
"3036","10347","2019",2,2,0,96000,972,100
"3037","10348","2019",2,2,0,131000,1271,108.5
"3038","10349","2019",37,37,0,175353.513513514,1824.35135135135,104.864864864865
"3039","10350","2019",17,17,0,91500,982,95.7647058823529
"3040","10351","2019",7,7,0,97714.2857142857,954.714285714286,98.5714285714286
"3041","10352","2019",12,12,0,182405.833333333,1755,106.333333333333
"3042","10353","2019",8,8,0,147125,1336.625,107.875
"3043","10354","2019",4,4,0,122778.5,1178,105
"3044","10355","2019",1,1,0,108000,1019,106
"3045","10356","2019",5,5,0,159400,1743.8,103
"3046","10357","2019",32,29,3,176084.0625,1945.25,93.53125
"3047","10358","2019",12,11,1,130356.416666667,1468.41666666667,88.3333333333333
"3048","10359","2019",8,8,0,100812.5,899.375,115.75
"3049","10360","2019",7,7,0,177428.571428571,1971.57142857143,91.7142857142857
"3050","10361","2019",1,1,0,87000,798,109
"3051","10362","2019",203,97,106,125670.300492611,1657.02955665025,75.1231527093596
"3052","10363","2019",4,4,0,203625,1957.25,108
"3053","10364","2019",1,1,0,87000,725,120
"3054","10365","2019",5,5,0,109840,1074.2,105.2
"3055","10367","2019",7,7,0,95664.2857142857,1176.42857142857,88
"3056","10368","2019",9,9,0,159611.111111111,1503.44444444444,99.7777777777778
"3057","10369","2019",2,2,0,96500,822.5,128.5
"3058","10370","2019",5,5,0,210400,1652.4,124.2
"3059","10371","2019",4,4,0,151000,1518.5,105.25
"3060","10373","2019",3,3,0,195000,1904,103
"3061","10374","2019",2,2,0,90000,1505.5,67
"3062","10376","2019",2,2,0,142125,843.5,170.5
"3063","10377","2019",1,1,0,21000,333,63
"3064","10379","2019",3,3,0,108666.666666667,1068,98
"3065","10381","2019",11,8,3,197945.454545455,1892.36363636364,105.818181818182
"3066","10382","2019",10,10,0,87100,1151.9,82.5
"3067","10383","2019",3,3,0,166333.333333333,1902,95
"3068","10386","2019",3,3,0,64666.6666666667,570.333333333333,113
"3069","10387","2019",1163,226,937,100401.689595873,1496.19948409286,67.5563198624248
"3070","10388","2019",1,1,0,114002,1462,78
"3071","10390","2019",1,1,0,159000,1060,150
"3072","10391","2019",4,4,0,167750,1550.75,112
"3073","10392","2019",2,2,0,124150,1622,79.5
"3074","10393","2019",1,1,0,112900,1086,104
"3075","10395","2019",2,2,0,52000,617.5,80
"3076","10396","2019",11,11,0,156594.363636364,1234.18181818182,138.818181818182
"3077","10397","2019",5,5,0,105480,940.2,109.8
"3078","10399","2019",1,1,0,30000,1071,28
"3079","10400","2019",1,1,0,182000,1213,150
"3080","10401","2019",23,20,3,89837.0869565217,923.782608695652,96.9565217391304
"3081","10402","2019",4,4,0,139375,984.25,162.75
"3082","10403","2019",1,1,0,40000,563,71
"3083","10404","2019",1,1,0,80000,889,90
"3084","10405","2019",1,1,0,144000,1532,94
"3085","10406","2019",33,33,0,174775.303030303,1735.54545454545,99.9090909090909
"3086","10408","2019",3,3,0,114666.666666667,1109.66666666667,108
"3087","10409","2019",4,4,0,237446.25,1481,166.75
"3088","10410","2019",3,3,0,101333.333333333,824,121
"3089","10412","2019",10,10,0,209941,1864.5,112.1
"3090","10414","2019",2,2,0,85000,1362,59
"3091","10416","2019",5,5,0,152620,1602,103
"3092","10417","2019",6,6,0,119000,1035.83333333333,115
"3093","10418","2019",5,5,0,96800,789.6,112.6
"3094","10419","2019",2,2,0,194000,1496.5,129.5
"3095","10420","2019",24,22,2,115673.75,1156.91666666667,99.5
"3096","10421","2019",1,1,0,96000,2133,45
"3097","10422","2019",5,5,0,80670,785.6,100.6
"3098","10423","2019",2,2,0,175100,1209.5,146
"3099","10424","2019",1,1,0,21000,467,45
"3100","10425","2019",6,6,0,151650,1507.16666666667,103.166666666667
"3101","10426","2019",7,6,1,82885.7142857143,696.285714285714,125.428571428571
"3102","10427","2019",1,1,0,146000,1377,106
"3103","10428","2019",1,1,0,215000,1547,139
"3104","10429","2019",6,6,0,149333.333333333,1361,112.333333333333
"3105","10431","2019",1,1,0,37000,468,79
"3106","10433","2019",4,4,0,168231.25,1210,134.75
"3107","10435","2019",1,1,0,119450,1866,64
"3108","10436","2019",1,1,0,54000,900,60
"3109","10437","2019",6,6,0,113166.666666667,1290,86.6666666666667
"3110","10439","2019",2,2,0,135250,915,150
"3111","10440","2019",1,1,0,115000,1278,90
"3112","10441","2019",4,4,0,97820,869.25,109.25
"3113","10442","2019",4,4,0,145250,1522.5,95.75
"3114","10444","2019",2,2,0,131250,1054,133
"3115","10445","2019",1,1,0,77000,951,81
"3116","11001","2019",7,7,0,104921.428571429,1122.28571428571,89.2857142857143
"3117","11002","2019",2,2,0,188500,1340,137.5
"3118","11004","2019",4,4,0,214317.5,1418,130.25
"3119","11005","2019",18,18,0,164254.333333333,1618.22222222222,101.166666666667
"3120","11006","2019",1,1,0,95600,1648,58
"3121","11007","2019",3,3,0,198000,1471,128.666666666667
"3122","11008","2019",5,5,0,90200,1209.4,73.6
"3123","11009","2019",20,20,0,108710.5,1080.5,101.45
"3124","11011","2019",8,8,0,215891.875,1610.5,124.125
"3125","11012","2019",34,34,0,170033.676470588,1767.70588235294,97.7352941176471
"3126","11013","2019",4,4,0,155798.75,1506.5,95
"3127","11014","2019",14,13,1,203498.928571429,2271.85714285714,91.6428571428571
"3128","11015","2019",4,4,0,120791,1088.5,92.75
"3129","11016","2019",1,1,0,39900,338,118
"3130","11018","2019",10,10,0,141295,1520.6,93.5
"3131","11019","2019",2,2,0,55000,800.5,70
"3132","11021","2019",9,8,1,114037.222222222,1192.66666666667,99.5555555555556
"3133","11022","2019",14,13,1,98160.7142857143,1126.57142857143,93.4285714285714
"3134","11023","2019",11,11,0,115890,1078.54545454545,110.636363636364
"3135","11024","2019",14,13,1,266071.428571429,2086.35714285714,123.928571428571
"3136","11025","2019",1,1,0,35395,843,42
"3137","11026","2019",2,2,0,183975,1589,115.5
"3138","11027","2019",9,9,0,90016.6666666667,1069.77777777778,84.3333333333333
"3139","11028","2019",9,9,0,100699.444444444,1224,88.2222222222222
"3140","11029","2019",1,1,0,153000,1987,77
"3141","11030","2019",1,1,0,405000,3857,105
"3142","11031","2019",1,1,0,40000,1143,35
"3143","11032","2019",3,3,0,204833.333333333,1507.66666666667,128.333333333333
"3144","11033","2019",22,20,2,118058.454545455,1249.5,97.2727272727273
"3145","11034","2019",12,12,0,117833.25,1268.75,90
"3146","11035","2019",6,6,0,143798.333333333,1097.5,116.833333333333
"3147","11036","2019",3,3,0,61633.3333333333,704.333333333333,93
"3148","11037","2019",10,8,2,112700,1084.6,96.5
"3149","11038","2019",1,1,0,84810,719,118
"3150","11040","2019",24,22,2,170552.166666667,1611.75,110.458333333333
"3151","11041","2019",13,13,0,182237.692307692,1711.30769230769,108.615384615385
"3152","11042","2019",4,4,0,86250,833.25,97.75
"3153","11043","2019",2,2,0,145750,1601,95
"3154","11045","2019",2,2,0,125000,1278,99
"3155","11046","2019",1,1,0,90000,763,118
"3156","11047","2019",2,2,0,127800,1658,77.5
"3157","11048","2019",9,9,0,157680,1435.11111111111,103.555555555556
"3158","11049","2019",36,35,1,121062.222222222,1363.91666666667,94.1666666666667
"3159","11051","2019",2,2,0,191400,1242,159
"3160","11052","2019",8,8,0,134153.125,1427.5,95
"3161","11053","2019",9,9,0,135000,1449.11111111111,91.7777777777778
"3162","11054","2019",3,3,0,334548.666666667,2006,146.333333333333
"3163","11055","2019",1,1,0,370000,1947,190
"3164","11056","2019",3,3,0,112333.333333333,1273.33333333333,92.6666666666667
"3165","11058","2019",7,7,0,177777.142857143,1207.14285714286,140.571428571429
"3166","11059","2019",2,2,0,135500,1343.5,101.5
"3167","11061","2019",4,4,0,124000,1292.5,98
"3168","11062","2019",1,1,0,69000,1500,46
"3169","11063","2019",6,6,0,93833.3333333333,824.5,113
"3170","11064","2019",3,3,0,87666.6666666667,996.333333333333,79
"3171","11066","2019",8,8,0,87596.25,1245.5,71.25
"3172","11067","2019",31,31,0,174549.903225806,1834.87096774194,94.6451612903226
"3173","11068","2019",12,12,0,241279.25,2429.5,102.416666666667
"3174","11069","2019",840,474,366,105135.305952381,1320.47380952381,80.6619047619048
"3175","11070","2019",5,5,0,166876,1612.2,103
"3176","11072","2019",2,2,0,92500,1058,96.5
"3177","11074","2019",5,5,0,203820,1714,120.6
"3178","11075","2019",2,2,0,106757.5,1483,72
"3179","11076","2019",149,115,34,115979.040268456,1389.1677852349,86.6711409395973
"3180","11077","2019",13,12,1,111268.230769231,1305.46153846154,87.6153846153846
"3181","11078","2019",7,7,0,117314.285714286,1387.85714285714,85.5714285714286
"3182","11079","2019",1,1,0,177969,1424,125
"3183","11080","2019",2,2,0,118250,1255,93
"3184","11081","2019",22,22,0,133379.772727273,1265.72727272727,107.727272727273
"3185","11083","2019",1,1,0,44000,537,82
"3186","11084","2019",7,7,0,171874.285714286,1810.71428571429,95.4285714285714
"3187","11085","2019",11,11,0,98036.3636363636,1129.45454545455,83.4545454545455
"3188","11086","2019",21,21,0,190399.714285714,2081.28571428571,92.3809523809524
"3189","11087","2019",3,3,0,98833.3333333333,1062.66666666667,97.3333333333333
"3190","11088","2019",24,24,0,160888.75,1608.95833333333,99.7083333333333
"3191","11089","2019",7,6,1,122164.285714286,1263.14285714286,89
"3192","11090","2019",6,6,0,145666.666666667,1603,89.1666666666667
"3193","11091","2019",13,13,0,92526.9230769231,918.846153846154,97.4615384615385
"3194","11092","2019",1,1,0,85000,810,105
"3195","11094","2019",1,1,0,76000,1086,70
"3196","11095","2019",5,5,0,182600,1657.4,110.8
"3197","11098","2019",10,10,0,167510,1385.8,121.6
"3198","11099","2019",36,36,0,130594.166666667,1291.66666666667,97.3888888888889
"3199","11101","2019",1,1,0,33000,344,96
"3200","11102","2019",5,5,0,131240,1234.4,100.2
"3201","11103","2019",11,11,0,86431.8181818182,896.909090909091,96.1818181818182
"3202","11105","2019",8,8,0,124514.375,1198.125,103.125
"3203","11106","2019",85,77,8,136620.376470588,1530.07058823529,91.1882352941176
"3204","11107","2019",2,2,0,170592.5,1703.5,91.5
"3205","11109","2019",1,1,0,210000,1944,108
"3206","11110","2019",2,2,0,54000,596.5,79
"3207","11111","2019",18,18,0,187768.277777778,1806.27777777778,103.5
"3208","11113","2019",2,2,0,180500,1983.5,110.5
"3209","11115","2019",11,11,0,118454.545454545,1352.45454545455,90.2727272727273
"3210","11116","2019",56,54,2,162194.142857143,1528.53571428571,105.5
"3211","11117","2019",1,1,0,35000,393,89
"3212","11118","2019",2,1,1,102000,1398,72.5
"3213","11119","2019",8,8,0,109928.875,1175.5,94.25
"3214","11120","2019",2,2,0,144200,1581.5,91.5
"3215","11121","2019",3,2,1,134152,968.333333333333,127.333333333333
"3216","11122","2019",8,8,0,107262.5,1079.375,89.875
"3217","11124","2019",12,12,0,150821.083333333,1275.33333333333,105.333333333333
"3218","11125","2019",1,1,0,38000,644,59
"3219","11126","2019",10,10,0,139267,1528.5,92
"3220","11127","2019",4,4,0,71793,636.75,126.5
"3221","11128","2019",7,7,0,161641.428571429,1622.57142857143,105
"3222","11129","2019",35,31,4,81415,1070.62857142857,79.6571428571429
"3223","11130","2019",9,9,0,113333.333333333,950.666666666667,127.888888888889
"3224","11131","2019",11,11,0,72932.3636363636,928.181818181818,80.5454545454545
"3225","11132","2019",28,26,2,116191.428571429,1153.42857142857,96.4285714285714
"3226","11135","2019",1,1,0,40000,500,80
"3227","11136","2019",8,8,0,166078.125,1334.625,130
"3228","11138","2019",6,6,0,103599.166666667,1017.16666666667,96.3333333333333
"3229","11140","2019",16,16,0,138814.1875,1330.5625,102.9375
"3230","11142","2019",3,3,0,112166.666666667,1287.33333333333,86.3333333333333
"3231","11143","2019",3,3,0,70488.3333333333,1087,62.6666666666667
"3232","11144","2019",32,26,6,180195.59375,1901.8125,87.46875
"3233","11145","2019",290,155,135,116019.786206897,2680.63793103448,47.6137931034483
"3234","11146","2019",4,4,0,100375,1230.25,80.25
"3235","11148","2019",4,3,1,106432,1400.75,71.75
"3236","11150","2019",5,5,0,115210,1225.8,97.8
"3237","11151","2019",5,5,0,136984.8,1578.2,88.4
"3238","11152","2019",3,3,0,147833.333333333,1378.66666666667,119
"3239","11153","2019",5,5,0,209600,1612,132
"3240","11154","2019",1,1,0,157100,1765,89
"3241","11155","2019",3,3,0,66833.3333333333,921.666666666667,75.3333333333333
"3242","11156","2019",3,3,0,94100,964,88
"3243","11157","2019",2,2,0,106500,1342,81
"3244","11158","2019",2,2,0,415000,3486.5,129.5
"3245","11159","2019",3,3,0,43000,648.333333333333,66.3333333333333
"3246","11160","2019",3,3,0,323333.333333333,2423.33333333333,159
"3247","11161","2019",3,3,0,116833.333333333,1302.66666666667,92.6666666666667
"3248","11163","2019",1,1,0,40000,513,78
"3249","11164","2019",30,30,0,201831.5,1966.86666666667,104.033333333333
"3250","11165","2019",8,7,1,139313.75,1445.25,102.25
"3251","11166","2019",2,2,0,199850,1847.5,110.5
"3252","11167","2019",2,2,0,109975,774,147
"3253","11168","2019",1,1,0,129500,1079,120
"3254","11170","2019",456,175,281,124286.094298246,3017.16447368421,40.6271929824561
"3255","11172","2019",6,6,0,173658.333333333,1291.83333333333,117.666666666667
"3256","11173","2019",3,3,0,122038.333333333,862,158
"3257","11174","2019",3,3,0,88000,1078.66666666667,72
"3258","11175","2019",1,1,0,197000,1970,100
"3259","11176","2019",1,1,0,206000,1661,124
"3260","11178","2019",21,21,0,147274.285714286,1363.80952380952,111.428571428571
"3261","11179","2019",2,2,0,48500,1356.5,35.5
"3262","11180","2019",1,1,0,41530,451,92
"3263","11181","2019",7,7,0,176408.571428571,1295,135.714285714286
"3264","11182","2019",5,5,0,126241.4,1204.6,90.8
"3265","11183","2019",3,3,0,113663.333333333,1479,89
"3266","11184","2019",1,1,0,74000,974,76
"3267","11185","2019",7,4,3,170341.857142857,2552.42857142857,79.1428571428571
"3268","11186","2019",1,1,0,150000,728,206
"3269","11187","2019",4,4,0,113870,1321,95.25
"3270","11188","2019",37,35,2,175444.756756757,1991.32432432432,94.0810810810811
"3271","11189","2019",4,4,0,67000,1021.5,65
"3272","11190","2019",19,19,0,110482.315789474,1288.63157894737,88.2631578947368
"3273","11191","2019",1,1,0,25000,543,46
"3274","11192","2019",7,7,0,69414.2857142857,878.428571428571,76.4285714285714
"3275","11193","2019",1,1,0,205000,1916,107
"3276","11194","2019",4,4,0,133000,1142,112.25
"3277","11195","2019",3,3,0,226166.666666667,1702.33333333333,132
"3278","11196","2019",2,2,0,117500,1675.5,73.5
"3279","11197","2019",10,10,0,145850,1282.9,111.8
"3280","11198","2019",18,18,0,78933.3333333333,980.444444444444,88.4444444444444
"3281","11199","2019",22,22,0,156692.272727273,1624.5,99.6363636363636
"3282","11200","2019",2,2,0,134352,1429,85
"3283","11201","2019",13,13,0,129276.923076923,1327.69230769231,89.9230769230769
"3284","11202","2019",494,210,284,101916.129554656,2742.59311740891,37.3481781376518
"3285","11203","2019",134,110,24,115081.455223881,1347.35820895522,88.4925373134328
"3286","11204","2019",1,1,0,299000,1967,152
"3287","11205","2019",1,1,0,45000,776,58
"3288","11206","2019",127,106,21,127281.456692913,1331.63779527559,96.5275590551181
"3289","11207","2019",2,2,0,105000,1473,73.5
"3290","11208","2019",4,4,0,141050,1026.25,136.5
"3291","11210","2019",19,19,0,148228.052631579,1533.94736842105,102.210526315789
"3292","11211","2019",8,8,0,147230,1283,107.5
"3293","11212","2019",10,10,0,166905.5,1376.4,121.5
"3294","11213","2019",1,1,0,128520,1460,88
"3295","11214","2019",5,5,0,81380,875,100
"3296","11215","2019",9,9,0,120888.888888889,1335.88888888889,86.8888888888889
"3297","11216","2019",4,4,0,229200,1326,150.5
"3298","11217","2019",15,14,1,180190,1770.46666666667,107.133333333333
"3299","11219","2019",2,2,0,112765,1569,72.5
"3300","11220","2019",11,10,1,118763.636363636,1435.18181818182,103.272727272727
"3301","11221","2019",2,2,0,107000,895.5,108.5
"3302","11222","2019",2,2,0,72500,1073.5,72.5
"3303","11223","2019",1,1,0,75000,750,100
"3304","11225","2019",13,13,0,138883.846153846,1329.84615384615,109.461538461538
"3305","11226","2019",2,2,0,131000,1312.5,115
"3306","11228","2019",1,1,0,127000,676,188
"3307","11229","2019",1,1,0,70000,519,135
"3308","11231","2019",2,2,0,147500,2051.5,77
"3309","11232","2019",3,3,0,66166.6666666667,1148.33333333333,62.6666666666667
"3310","11233","2019",9,9,0,194171,1998.77777777778,100.444444444444
"3311","11235","2019",2,2,0,104000,910.5,115
"3312","11236","2019",4,4,0,103425,695,123.75
"3313","11240","2019",10,10,0,126498,1370.8,95.9
"3314","11241","2019",7,7,0,103814.285714286,1067.57142857143,112.571428571429
"3315","11242","2019",3,3,0,73000,801.666666666667,93.3333333333333
"3316","11243","2019",7,7,0,174285.714285714,1833.28571428571,98.2857142857143
"3317","11244","2019",6,6,0,64253.6666666667,839.833333333333,71.6666666666667
"3318","11249","2019",1,1,0,64000,901,71
"3319","11250","2019",1,1,0,70000,538,130
"3320","11251","2019",7,7,0,131985.714285714,1281,99.5714285714286
"3321","11252","2019",5,5,0,169200,1115,150.4
"3322","11253","2019",8,8,0,138000,1373.75,97.875
"3323","11254","2019",17,16,1,110069.882352941,1271.58823529412,86.8235294117647
"3324","11255","2019",19,17,2,170983.157894737,1735.89473684211,103.157894736842
"3325","11256","2019",11,11,0,200095,2119.72727272727,99.7272727272727
"3326","11257","2019",4,4,0,108500,1228.5,91.5
"3327","11258","2019",35,33,2,177303.857142857,1868.14285714286,98.8285714285714
"3328","11259","2019",16,16,0,124025.625,1279.5625,103.625
"3329","11260","2019",3,3,0,126666.666666667,1237.33333333333,102
"3330","11261","2019",10,10,0,106561.2,995.3,98.8
"3331","11262","2019",1081,449,632,149474.565217391,2124.00555041628,70.2377428307123
"3332","11263","2019",4,4,0,134250,1166.5,114
"3333","11264","2019",16,15,1,146093.75,1526.75,103.25
"3334","11265","2019",1,0,1,52000,825,63
"3335","11266","2019",193,86,107,109015.96373057,2096.08808290155,54.9326424870466
"3336","11267","2019",20,19,1,137789.4,1513.4,90.25
"3337","11269","2019",44,42,2,141975.772727273,1397.56818181818,98.5454545454545
"3338","11270","2019",5,5,0,85308,1263,76.6
"3339","11271","2019",2,2,0,67120,1118.5,60
"3340","11272","2019",31,31,0,175951.838709677,1753.48387096774,102.612903225806
"3341","11273","2019",11,11,0,193903.818181818,1851.81818181818,103.727272727273
"3342","11274","2019",5,5,0,160800,1458.2,117.4
"3343","11275","2019",1,1,0,2e+05,1887,106
"3344","11276","2019",15,15,0,77427.3333333333,867.933333333333,88.4666666666667
"3345","11278","2019",2,2,0,106000,1236.5,85
"3346","11279","2019",27,26,1,134308.592592593,1421.85185185185,91.2962962962963
"3347","11280","2019",17,17,0,184180.470588235,1483.11764705882,131.823529411765
"3348","11281","2019",17,17,0,104235.882352941,1263.64705882353,86
"3349","11283","2019",4,4,0,176057.5,1238.75,141.25
"3350","11284","2019",1,1,0,150000,1515,99
"3351","11285","2019",12,11,1,232317.333333333,2588.08333333333,96.5
"3352","11286","2019",15,15,0,113033.333333333,1177.13333333333,94.0666666666667
"3353","11288","2019",24,23,1,150072.916666667,1727.375,90
"3354","11289","2019",9,9,0,138608.333333333,1355.66666666667,109.444444444444
"3355","11292","2019",1,0,1,215000,1222,176
"3356","11293","2019",15,15,0,172493.733333333,1502.46666666667,114.266666666667
"3357","11294","2019",1,1,0,280000,2500,112
"3358","11295","2019",19,17,2,152099,1661.89473684211,98.2631578947368
"3359","11296","2019",9,9,0,196293.333333333,2084.22222222222,91.1111111111111
"3360","11297","2019",5,5,0,45790,676,73.8
"3361","11299","2019",9,9,0,133332.222222222,1233,114.111111111111
"3362","11300","2019",3,3,0,201666.666666667,1346.33333333333,145.333333333333
"3363","11301","2019",19,18,1,95269.4736842105,1044.36842105263,87.7894736842105
"3364","11302","2019",2,2,0,55000,2396,26
"3365","11303","2019",11,10,1,109919.272727273,1349.18181818182,96.6363636363636
"3366","11304","2019",53,48,5,107931.886792453,1157.84905660377,95.4716981132076
"3367","11305","2019",2,2,0,68500,810.5,86.5
"3368","11307","2019",1,1,0,2e+05,1739,115
"3369","11308","2019",7,7,0,161378.571428571,1362,132.714285714286
"3370","11309","2019",1,1,0,90000,978,92
"3371","11310","2019",7,2,5,68162.8571428571,1453.14285714286,41.1428571428571
"3372","11311","2019",8,8,0,138275,1332.25,107
"3373","11312","2019",1,1,0,89000,809,110
"3374","11313","2019",4,4,0,145196.5,1356,102
"3375","11314","2019",1,1,0,70000,1000,70
"3376","11315","2019",21,21,0,117833.333333333,1268.66666666667,93.8571428571429
"3377","11316","2019",2,2,0,145000,1090.5,135
"3378","11317","2019",3,3,0,45000,731,66.3333333333333
"3379","11318","2019",4,4,0,148250,1654.25,89.25
"3380","11319","2019",1,1,0,115000,2875,40
"3381","11320","2019",6,6,0,75133.3333333333,749,108.666666666667
"3382","11321","2019",3,3,0,59166.6666666667,797.666666666667,74
"3383","11322","2019",27,25,2,198508.62962963,1858.07407407407,110.62962962963
"3384","11324","2019",8,8,0,167937.5,1422.875,114
"3385","11325","2019",6,5,1,128616.666666667,1239.5,117
"3386","11326","2019",1,1,0,55000,2037,27
"3387","11327","2019",5,5,0,153260,1538.2,99.2
"3388","11328","2019",8,8,0,97626.25,896.625,115.625
"3389","11330","2019",2,2,0,120000,1148,107.5
"3390","11331","2019",3,3,0,114333.333333333,1078.33333333333,117.333333333333
"3391","11332","2019",28,28,0,164331.428571429,1692.85714285714,96.8214285714286
"3392","11334","2019",1,1,0,60225,1075,56
"3393","11335","2019",2,2,0,102985,1246.5,87.5
"3394","11336","2019",13,12,1,102089.846153846,911.153846153846,105
"3395","11337","2019",6,6,0,75900,1003.33333333333,80.3333333333333
"3396","11338","2019",1,1,0,50040,589,85
"3397","11339","2019",7,7,0,118928.571428571,1363.71428571429,88.1428571428571
"3398","11340","2019",5,5,0,197880,1683.2,118
"3399","11341","2019",2,2,0,47500,557.5,85.5
"3400","11342","2019",5,5,0,141100,1421.8,96.6
"3401","11343","2019",3,3,0,287476.666666667,2641.33333333333,146
"3402","11344","2019",6,6,0,71133.3333333333,841.666666666667,89.3333333333333
"3403","11345","2019",5,5,0,113520,1262,84.4
"3404","11346","2019",3,3,0,121266.666666667,1142.33333333333,94.6666666666667
"3405","11347","2019",3,3,0,149333.333333333,1618.33333333333,94.3333333333333
"3406","11351","2019",13,13,0,187072,1478.07692307692,121.769230769231
"3407","11352","2019",2,2,0,81500,1082.5,77
"3408","11353","2019",28,28,0,190513.75,1758.71428571429,106.964285714286
"3409","11355","2019",4,4,0,110000,1080,101.75
"3410","11356","2019",8,8,0,155500,1221.875,125.625
"3411","11357","2019",2,2,0,93000,1700,54
"3412","11358","2019",1,1,0,45000,446,101
"3413","11359","2019",12,11,1,156350,1579.25,106.75
"3414","11360","2019",34,34,0,196718.264705882,1907.79411764706,102.823529411765
"3415","11361","2019",9,9,0,111122.222222222,1186.77777777778,98.2222222222222
"3416","11362","2019",2,2,0,157750,3153.5,57.5
"3417","11363","2019",5,5,0,174200,1631.4,102
"3418","11364","2019",3,3,0,170000,1390.33333333333,112.666666666667
"3419","11366","2019",18,18,0,138384.666666667,1540.61111111111,93.6111111111111
"3420","11367","2019",13,13,0,106038.461538462,1259.07692307692,87.6153846153846
"3421","11368","2019",1,1,0,206700,1554,133
"3422","11369","2019",37,34,3,181990.675675676,1765.56756756757,100.918918918919
"3423","11370","2019",64,60,4,201746.328125,2016.140625,99.515625
"3424","11371","2019",9,9,0,178704.444444444,1629.44444444444,109.777777777778
"3425","11372","2019",6,6,0,69500,762.5,84
"3426","11373","2019",3,3,0,36000,736,54.3333333333333
"3427","11374","2019",1,1,0,62600,2722,23
"3428","11375","2019",1,1,0,84600,1880,45
"3429","11376","2019",2,2,0,152500,1167,127.5
"3430","11377","2019",3,3,0,132335,1442.33333333333,107
"3431","11379","2019",90,77,13,163374.744444444,1848.98888888889,91.2888888888889
"3432","11381","2019",2,2,0,130000,1457,112.5
"3433","11383","2019",2,2,0,126000,1348.5,95
"3434","11384","2019",1,1,0,79800,1064,75
"3435","11385","2019",4,4,0,181900,2109.5,87.5
"3436","11386","2019",6,6,0,61525,718.666666666667,88.3333333333333
"3437","11388","2019",1,1,0,80000,630,127
"3438","11390","2019",8,7,1,138180,1437.75,88.875
"3439","11391","2019",2,2,0,56500,619,98
"3440","11392","2019",6,6,0,115083.166666667,1379,93.6666666666667
"3441","11393","2019",7,7,0,130821.428571429,1288.14285714286,109.428571428571
"3442","11394","2019",1,1,0,2e+05,1515,132
"3443","11396","2019",15,15,0,134939.466666667,1164.13333333333,103.466666666667
"3444","11397","2019",60,53,7,96839.9666666667,1122.36666666667,82.8
"3445","11398","2019",2,2,0,129700,1374,95
"3446","11399","2019",2,2,0,163000,1487.5,110
"3447","11400","2019",3,3,0,161533.333333333,1895.33333333333,87.3333333333333
"3448","11401","2019",14,14,0,71775,1026.5,70
"3449","11404","2019",8,8,0,105147.5,1180.375,89
"3450","11405","2019",14,14,0,180612.142857143,1764.92857142857,104.714285714286
"3451","11406","2019",1,1,0,120000,1739,69
"3452","11407","2019",7,7,0,162400,1264.85714285714,117.857142857143
"3453","11408","2019",3,3,0,140000,1349.66666666667,101
"3454","11409","2019",2,2,0,117500,1195,106
"3455","11410","2019",16,15,1,113351.625,1240.75,90.375
"3456","11411","2019",3,3,0,164810,3409,78.6666666666667
"3457","11413","2019",8,8,0,110248.75,1034.5,102.75
"3458","11415","2019",1,1,0,260000,1182,220
"3459","11416","2019",5,5,0,132260,1343,97.6
"3460","11417","2019",3,3,0,104664.666666667,992.666666666667,96.6666666666667
"3461","11418","2019",15,15,0,119304.533333333,1149.33333333333,104.333333333333
"3462","11419","2019",1,1,0,190000,1652,115
"3463","11420","2019",2,2,0,90915,842.5,106
"3464","11421","2019",9,9,0,155610,1819.55555555556,89
"3465","11422","2019",7,7,0,226750,1899.28571428571,125.571428571429
"3466","11424","2019",1,1,0,113500,1158,98
"3467","11425","2019",17,17,0,151438.823529412,1477.58823529412,105.235294117647
"3468","11426","2019",14,8,6,147892,1664.92857142857,91
"3469","11427","2019",5,5,0,58778.4,825.8,69
"3470","11428","2019",5,5,0,127200,1420.8,84.2
"3471","11429","2019",59,55,4,171021.796610169,1605.84745762712,103.694915254237
"3472","11430","2019",10,10,0,153239.2,1569.5,98.2
"3473","11431","2019",2,2,0,66500,823,80
"3474","11432","2019",3,3,0,212333.333333333,1980,111.333333333333
"3475","11433","2019",16,16,0,148692.8125,1357.625,117.125
"3476","11434","2019",17,17,0,108948.235294118,1094.23529411765,95.9411764705882
"3477","11435","2019",4,4,0,109000,1029.75,110
"3478","11436","2019",6,6,0,137234.5,1227.83333333333,103.666666666667
"3479","11437","2019",13,13,0,170177.692307692,1468,113.923076923077
"3480","11438","2019",6,6,0,104726.666666667,1542,70.6666666666667
"3481","11439","2019",7,7,0,105511.428571429,1186.85714285714,92.2857142857143
"3482","11440","2019",1,1,0,30000,500,60
"3483","11441","2019",38,35,3,196938.631578947,2129.31578947368,93.8684210526316
"3484","12001","2019",9,9,0,133309.222222222,1306.33333333333,101.555555555556
"3485","12002","2019",13,11,2,135443.846153846,1293.69230769231,109.384615384615
"3486","12003","2019",1,1,0,76600,696,110
"3487","12004","2019",1,1,0,167200,1393,120
"3488","12006","2019",4,4,0,85975,1259.75,75
"3489","12007","2019",9,9,0,92533.3333333333,1077.33333333333,93.2222222222222
"3490","12008","2019",8,8,0,143182.5,1639.625,90.5
"3491","12010","2019",1,1,0,79000,681,116
"3492","12011","2019",9,9,0,117491.666666667,1327.55555555556,85.1111111111111
"3493","12012","2019",9,9,0,100011.111111111,1274.33333333333,81.1111111111111
"3494","12013","2019",39,38,1,86130.3846153846,971.25641025641,84.9230769230769
"3495","12016","2019",7,7,0,114471.428571429,1104,109.285714285714
"3496","12018","2019",1,1,0,80000,1143,70
"3497","12019","2019",4,4,0,50490,793.75,63
"3498","12021","2019",20,19,1,101386.25,1129.8,91.8
"3499","12022","2019",1,1,0,186500,2664,70
"3500","12023","2019",3,3,0,51666.6666666667,642.666666666667,76.3333333333333
"3501","12024","2019",1,1,0,55000,539,102
"3502","12025","2019",9,9,0,108222.222222222,1136.44444444444,101.666666666667
"3503","12026","2019",14,14,0,108092.857142857,1277.5,87.5714285714286
"3504","12027","2019",1,1,0,183500,1748,105
"3505","12028","2019",3,3,0,69433.3333333333,629.333333333333,104.666666666667
"3506","12029","2019",4,4,0,98545,1181.5,84.5
"3507","12030","2019",4,4,0,114875,891,116.5
"3508","12031","2019",4,4,0,55150,561,89.25
"3509","12032","2019",4,4,0,176550,1557.5,119.75
"3510","12033","2019",27,20,7,155246.296296296,2038.22222222222,78.8518518518518
"3511","12035","2019",1,1,0,348000,2189,159
"3512","12036","2019",3,3,0,74666.6666666667,969.666666666667,79.6666666666667
"3513","12037","2019",9,9,0,85522.2222222222,1063.66666666667,78.7777777777778
"3514","12038","2019",6,6,0,134583.333333333,1370.83333333333,92
"3515","12039","2019",5,5,0,66700,1454,57.6
"3516","12041","2019",2,2,0,137500,969,120
"3517","12042","2019",1,1,0,149000,1490,100
"3518","12043","2019",16,16,0,177121.875,1698.875,106.0625
"3519","12044","2019",9,8,1,122010,1320.77777777778,93
"3520","12045","2019",3,3,0,96833.3333333333,865,105.333333333333
"3521","12046","2019",6,6,0,125713.666666667,1202,114.5
"3522","12047","2019",7,7,0,112900,1084.28571428571,93
"3523","12048","2019",3,3,0,63333.3333333333,1017,57.3333333333333
"3524","12049","2019",6,6,0,148566.666666667,1238,122.333333333333
"3525","12050","2019",5,5,0,114557,1614.4,73.6
"3526","12051","2019",7,7,0,106871.428571429,938.285714285714,120.285714285714
"3527","12052","2019",67,59,8,95507.8507462687,1186.71641791045,85.1641791044776
"3528","12053","2019",2,2,0,137230,1423,97.5
"3529","12054","2019",5,5,0,113370,1086,101.4
"3530","12055","2019",1,1,0,15000,500,30
"3531","12056","2019",26,20,6,129846.923076923,1318.26923076923,97.4230769230769
"3532","12057","2019",15,15,0,99826.6666666667,1331,83.9333333333333
"3533","12058","2019",2,2,0,168130,1232.5,129.5
"3534","12059","2019",2,2,0,74750,1003,86.5
"3535","12060","2019",1,1,0,182405,1673,109
"3536","12061","2019",6,6,0,153400,1410.16666666667,106.666666666667
"3537","12062","2019",3,3,0,47666.6666666667,409.666666666667,113.333333333333
"3538","12063","2019",13,12,1,142584.615384615,1445.23076923077,98.4615384615385
"3539","12064","2019",2,2,0,75000,793.5,93.5
"3540","12065","2019",4,4,0,84000,1268.75,66.5
"3541","12066","2019",11,11,0,203972.727272727,2244,93.9090909090909
"3542","12068","2019",12,12,0,94503.3333333333,897.083333333333,118.666666666667
"3543","12069","2019",3,3,0,97603.3333333333,845.666666666667,111.333333333333
"3544","12070","2019",5,4,1,121200,1183.4,101
"3545","12071","2019",6,6,0,116666.666666667,1133.66666666667,111.333333333333
"3546","12072","2019",6,6,0,56833.3333333333,1111.66666666667,64.6666666666667
"3547","12073","2019",3,3,0,82000,844.666666666667,85.3333333333333
"3548","12074","2019",3,3,0,200533.333333333,1567.33333333333,127
"3549","12075","2019",1,1,0,20000,2000,10
"3550","12076","2019",17,16,1,141205.823529412,1488.52941176471,96.9411764705882
"3551","12077","2019",7,6,1,84740,860.428571428571,104.571428571429
"3552","12078","2019",1,1,0,162000,1604,101
"3553","12079","2019",6,6,0,117683.333333333,1517.66666666667,94
"3554","12080","2019",1,1,0,55000,688,80
"3555","12082","2019",2,2,0,80000,1132,70.5
"3556","12083","2019",20,16,4,66692.5,914.3,74.6
"3557","12084","2019",13,10,3,205419.230769231,1985.92307692308,111.384615384615
"3558","12085","2019",2,2,0,81673.5,995,80
"3559","12086","2019",4,4,0,181900,1394.75,123.75
"3560","12088","2019",1,1,0,189700,2108,90
"3561","12089","2019",50,41,9,74937,900.68,82.54
"3562","12090","2019",25,25,0,188200.8,1815.24,110.88
"3563","12091","2019",2,2,0,113550,1060.5,107
"3564","12092","2019",10,10,0,72941,752.4,99.5
"3565","12093","2019",6,6,0,141813.333333333,1936,82.8333333333333
"3566","12094","2019",16,14,2,108791.25,1260.625,88.5625
"3567","12095","2019",3,3,0,43920,894.666666666667,49.3333333333333
"3568","12096","2019",66,35,31,124618.106060606,1424.63636363636,87.8030303030303
"3569","12098","2019",6,6,0,96833.3333333333,1171.16666666667,97.1666666666667
"3570","12099","2019",5,3,2,144798,1092.6,127.4
"3571","12100","2019",26,24,2,94063.4615384615,1083.5,87.2307692307692
"3572","12101","2019",8,8,0,120643.75,1305.375,90.875
"3573","12102","2019",21,20,1,167480.952380952,1656.57142857143,102.380952380952
"3574","12103","2019",6,6,0,152666.666666667,1376.16666666667,108.5
"3575","12104","2019",6,6,0,145416.666666667,1206.33333333333,121.333333333333
"3576","12105","2019",9,9,0,184900,1424.22222222222,125.555555555556
"3577","12106","2019",2,2,0,154250,1618.5,96.5
"3578","12107","2019",2,2,0,103500,1290.5,81
"3579","12108","2019",7,7,0,117785.714285714,1043.57142857143,109.428571428571
"3580","12109","2019",2,2,0,95250,1243,69
"3581","12110","2019",7,7,0,88857.1428571429,1005.85714285714,100.142857142857
"3582","12111","2019",5,5,0,91800,890.2,93.6
"3583","12113","2019",4,4,0,87575.25,898.25,100
"3584","12115","2019",6,6,0,123736.666666667,1512.66666666667,81.5
"3585","12116","2019",3,3,0,68333.3333333333,764.333333333333,93.3333333333333
"3586","12118","2019",5,5,0,102984,1452.4,85
"3587","12119","2019",13,7,6,117185.384615385,1480.69230769231,84.0769230769231
"3588","12120","2019",18,13,5,130741.666666667,1562.5,83.7222222222222
"3589","12121","2019",4,3,1,77500,984.25,81.75
"3590","12122","2019",1,1,0,72000,847,85
"3591","12124","2019",10,10,0,75850,640.9,121.1
"3592","12125","2019",4,4,0,71250,849,76
"3593","12127","2019",9,8,1,99366.6666666667,849.888888888889,120.555555555556
"3594","12128","2019",3,3,0,168873.333333333,1286,139.333333333333
"3595","12129","2019",6,5,1,57750,608.5,99.8333333333333
"3596","12130","2019",10,10,0,83250,998.2,79.4
"3597","12131","2019",10,10,0,223458,1654,141.2
"3598","12133","2019",54,37,17,163737.277777778,1857.35185185185,93.3518518518518
"3599","12134","2019",3,3,0,47733.3333333333,925.666666666667,53.6666666666667
"3600","12135","2019",5,5,0,69772,791.2,80.4
"3601","12136","2019",7,7,0,184438,1134.14285714286,155.285714285714
"3602","12137","2019",4,4,0,168175,1677,108
"3603","12138","2019",18,16,2,124066.666666667,1411.22222222222,92.7222222222222
"3604","12139","2019",3,3,0,68466.6666666667,1146.33333333333,57.3333333333333
"3605","12140","2019",11,11,0,167662.727272727,1916.54545454545,84
"3606","12141","2019",5,5,0,255890.4,2150.6,129.4
"3607","12142","2019",2,2,0,189295,1349,122.5
"3608","12144","2019",2,2,0,115000,1090,125
"3609","12145","2019",381,143,238,124108.763779528,1573.2624671916,77.1417322834646
"3610","12146","2019",40,30,10,165819.25,1832.4,89.625
"3611","12147","2019",4,4,0,100217.5,914.75,132.5
"3612","12148","2019",8,5,3,87725,1114.875,77.875
"3613","12150","2019",7,7,0,85950,1076.57142857143,79.7142857142857
"3614","12151","2019",4,4,0,114750,980.25,115
"3615","12152","2019",1,1,0,68000,829,82
"3616","12153","2019",3,3,0,136993.333333333,1231,108.666666666667
"3617","12154","2019",3,3,0,56552,790,74.6666666666667
"3618","12155","2019",1,1,0,40000,870,46
"3619","12157","2019",19,17,2,168761.157894737,1464.84210526316,114.894736842105
"3620","12158","2019",4,4,0,117413.75,1645.5,76.25
"3621","12159","2019",2,2,0,136500,971.5,133
"3622","12160","2019",9,9,0,226851.111111111,2222.66666666667,104.222222222222
"3623","12161","2019",3,3,0,166386.666666667,1466,98.3333333333333
"3624","12162","2019",7,7,0,122428.571428571,1580.85714285714,88.1428571428571
"3625","12163","2019",2,2,0,164500,1645,107.5
"3626","12164","2019",6,5,1,64500,765.333333333333,89
"3627","12165","2019",5,5,0,116284,1245.2,77
"3628","12167","2019",25,25,0,135714.68,1470.72,89.32
"3629","12168","2019",15,13,2,98484.6666666667,1314.06666666667,75.4
"3630","12169","2019",16,15,1,104756.25,1205.9375,89.375
"3631","12170","2019",6,6,0,199591.666666667,1581.5,119
"3632","12171","2019",9,9,0,93252.7777777778,1108.55555555556,83.8888888888889
"3633","12172","2019",6,6,0,101638.333333333,837.666666666667,122.166666666667
"3634","12174","2019",49,27,22,158493.204081633,1806.57142857143,90.2040816326531
"3635","12175","2019",2,2,0,156750,1291.5,123
"3636","12176","2019",219,84,135,136523.465753425,1827.04566210046,75.9771689497717
"3637","12177","2019",7,7,0,327535.142857143,2383,107.285714285714
"3638","12178","2019",3,3,0,198193.333333333,2047.66666666667,104
"3639","12179","2019",3,3,0,40000,653.333333333333,69
"3640","12183","2019",2,2,0,111750,840,130
"3641","12184","2019",2,2,0,108250,1014,112
"3642","12185","2019",15,14,1,116773.333333333,1300.4,91.0666666666667
"3643","12186","2019",3,3,0,93933.3333333333,1489,70.6666666666667
"3644","12187","2019",9,8,1,64463.3333333333,964.444444444444,65.3333333333333
"3645","12188","2019",2,2,0,135000,2164.5,87.5
"3646","12189","2019",8,8,0,126111.25,1220.125,106.375
"3647","12190","2019",2,2,0,120500,1636.5,76
"3648","12191","2019",6,6,0,138854.333333333,1255.5,104.333333333333
"3649","12192","2019",4,4,0,53000,706.25,79.5
"3650","12193","2019",3,3,0,127086.666666667,1340.33333333333,95
"3651","12194","2019",11,11,0,160765.454545455,1867.54545454545,94
"3652","12195","2019",3,3,0,128000,1109.33333333333,111.666666666667
"3653","12197","2019",21,20,1,113766.19047619,1184.90476190476,103.714285714286
"3654","12198","2019",13,11,2,88563.0769230769,991.846153846154,96.5384615384615
"3655","12199","2019",29,14,15,94650.8620689655,1319.58620689655,69.2068965517241
"3656","12200","2019",15,13,2,117869.733333333,1350.8,88.2666666666667
"3657","12201","2019",6,6,0,180150,2341,73.5
"3658","12202","2019",561,76,485,122044.037433155,1733.4688057041,70.2620320855615
"3659","12203","2019",7,7,0,88385.7142857143,1101.71428571429,88.1428571428571
"3660","12204","2019",7,7,0,129258.571428571,1495.71428571429,90.8571428571429
"3661","12205","2019",10,10,0,150205,1426.9,106.3
"3662","12206","2019",3,3,0,208626.666666667,2211.66666666667,97.6666666666667
"3663","12207","2019",3,3,0,151566.666666667,1022.66666666667,138.333333333333
"3664","12208","2019",98,67,31,114635.836734694,1386.10204081633,84.2551020408163
"3665","12209","2019",8,8,0,117212.5,993.125,130.125
"3666","12210","2019",9,9,0,173115,1394.66666666667,112.888888888889
"3667","12211","2019",2,2,0,180500,1525.5,113
"3668","12212","2019",4,4,0,88000,1019.75,91.75
"3669","12213","2019",5,5,0,167330,1625.8,107
"3670","12214","2019",3,2,1,58333.3333333333,868.666666666667,70
"3671","12215","2019",9,7,2,117448.333333333,1495.77777777778,74.7777777777778
"3672","12216","2019",15,13,2,145681.333333333,1664.86666666667,90.8666666666667
"3673","12217","2019",6,6,0,110029.166666667,1163,89.8333333333333
"3674","12219","2019",2,2,0,256825,2164,121.5
"3675","12220","2019",2,2,0,151790,1058.5,161
"3676","12221","2019",3,3,0,80005.3333333333,908,88.3333333333333
"3677","12222","2019",4,4,0,43575,677.75,65.75
"3678","12223","2019",15,15,0,134130.666666667,1250.93333333333,106.533333333333
"3679","12224","2019",44,19,25,83497.8181818182,1202.70454545455,66.9090909090909
"3680","12225","2019",23,21,2,123312.130434783,1334.39130434783,92.1739130434783
"3681","12226","2019",8,8,0,79737.25,899.25,91.375
"3682","12227","2019",2,2,0,205050,1995,103
"3683","12228","2019",8,8,0,94986.25,1109.25,91.625
"3684","12229","2019",1,1,0,106000,1432,74
"3685","12230","2019",5,5,0,121000,1398.4,88
"3686","12231","2019",13,10,3,120031.538461538,1068,103.923076923077
"3687","12232","2019",3,3,0,138786.666666667,1440.66666666667,108.333333333333
"3688","12233","2019",4,4,0,104375,882.5,135.5
"3689","12234","2019",6,6,0,183066.666666667,1691.5,110
"3690","12235","2019",6,6,0,89633.3333333333,832.666666666667,108.833333333333
"3691","12236","2019",3,3,0,94866.6666666667,1392.66666666667,70.3333333333333
"3692","12237","2019",8,7,1,78812.5,1041.375,73.875
"3693","12238","2019",3,3,0,155920,1576.33333333333,100.666666666667
"3694","12239","2019",5,5,0,80120,883.2,93.4
"3695","12240","2019",3,3,0,83666.6666666667,1032,96
"3696","12241","2019",11,11,0,247124.545454545,2009.36363636364,127
"3697","12242","2019",2,2,0,255000,2072,109
"3698","12243","2019",16,16,0,115456.625,1191.6875,94.625
"3699","12244","2019",8,5,3,80418.75,1082.125,82.75
"3700","12246","2019",1,1,0,140000,1522,92
"3701","12247","2019",7,7,0,119468.571428571,1101.28571428571,98
"3702","12248","2019",4,3,1,131212.5,1255.5,106
"3703","12249","2019",3,3,0,51550,744,68
"3704","12250","2019",2,2,0,71500,1442.5,50.5
"3705","12251","2019",9,9,0,77377.7777777778,853.222222222222,97.3333333333333
"3706","12252","2019",6,6,0,88075,1505.33333333333,62.5
"3707","12253","2019",21,18,3,106524.761904762,1351.09523809524,84.7619047619048
"3708","12254","2019",26,26,0,214766.730769231,2018.84615384615,110.923076923077
"3709","12255","2019",8,8,0,135107.5,1203.125,114.75
"3710","12256","2019",6,6,0,135393.333333333,1357.5,105.833333333333
"3711","12257","2019",6,6,0,115533,1039.33333333333,110.166666666667
"3712","12258","2019",12,12,0,122206.25,1329.25,89.5833333333333
"3713","12259","2019",5,5,0,178521,1693.6,107
"3714","12260","2019",2,2,0,60232.5,740.5,70.5
"3715","12261","2019",3,3,0,144333.333333333,1226.66666666667,100.333333333333
"3716","12262","2019",12,12,0,78812.5,1051.91666666667,81
"3717","12263","2019",2,2,0,93720,790.5,100
"3718","12264","2019",25,19,6,204596,2154.52,96.96
"3719","12265","2019",2,2,0,84000,1167.5,69.5
"3720","12266","2019",1,1,0,56000,386,145
"3721","12267","2019",10,9,1,175230,1459.2,116
"3722","12268","2019",3,3,0,57676.6666666667,943.666666666667,63
"3723","12269","2019",1,1,0,45000,450,100
"3724","12270","2019",36,31,5,106191.138888889,1380.38888888889,82.1388888888889
"3725","12272","2019",6,6,0,111833.333333333,1410,79.5
"3726","12273","2019",3,3,0,103610,945.666666666667,112
"3727","12274","2019",1,0,1,144650,1446,100
"3728","12275","2019",1,1,0,19000,500,38
"3729","12276","2019",4,4,0,124500,1635.5,81.5
"3730","12277","2019",6,6,0,103973.333333333,1043.66666666667,99
"3731","12278","2019",2,2,0,75750,1033,74
"3732","12280","2019",6,5,1,87666.6666666667,1123.33333333333,100.333333333333
"3733","12281","2019",6,6,0,139316.666666667,1176,116.5
"3734","12282","2019",3,3,0,99666.6666666667,1295.66666666667,71
"3735","12283","2019",3,3,0,124900,1434.33333333333,94.6666666666667
"3736","12284","2019",9,9,0,68286.6666666667,1111,65.1111111111111
"3737","12286","2019",9,9,0,152487.777777778,1339.66666666667,120.666666666667
"3738","12287","2019",7,7,0,91985.7142857143,1101.85714285714,83.8571428571429
"3739","12288","2019",14,14,0,219460.714285714,2175,104.357142857143
"3740","12289","2019",2,2,0,169800,1598.5,106.5
"3741","12290","2019",1,1,0,40000,500,80
"3742","12291","2019",6,6,0,151425,1980.5,78.5
"3743","12292","2019",3,3,0,129000,1180,100.666666666667
"3744","12293","2019",2,2,0,63000,1344.5,46.5
"3745","12294","2019",9,9,0,85622.2222222222,1136,76.7777777777778
"3746","12295","2019",1,1,0,79000,608,130
"3747","12296","2019",7,7,0,60357.1428571429,855.857142857143,67
"3748","12297","2019",4,4,0,112750,1609.5,77
"3749","12298","2019",4,4,0,86625,1060.25,103.5
"3750","12299","2019",8,8,0,111938.125,1428,82
"3751","12300","2019",115,78,37,113957.391304348,1348.40869565217,87.7304347826087
"3752","12301","2019",21,21,0,139264.285714286,1481.47619047619,95.5714285714286
"3753","12303","2019",1,1,0,115950,1026,113
"3754","12305","2019",13,10,3,55360.7692307692,685.846153846154,75.2307692307692
"3755","12307","2019",2,2,0,75000,1754,55.5
"3756","13001","2019",2313,370,1943,296476.497189797,4460.22265456118,65.2360570687419
"3757","13002","2019",264,166,98,302017.28030303,3726.54924242424,83.7424242424242
"3758","13003","2019",27,26,1,244342.037037037,2685.85185185185,93.2962962962963
"3759","13004","2019",627,383,244,193708.620414673,2533.54226475279,77.0398724082935
"3760","13005","2019",558,181,377,230649.154121864,3044.1917562724,75.1021505376344
"3761","13006","2019",20,20,0,265475.25,3024.35,91.15
"3762","13007","2019",147,105,42,317647.176870748,3622.6462585034,87.5986394557823
"3763","13008","2019",5,5,0,292964,3085.6,85.6
"3764","13009","2019",8,8,0,317506.25,2808,114
"3765","13010","2019",49,44,5,242134.081632653,2656.97959183673,88.6938775510204
"3766","13011","2019",5,5,0,561600,3513.8,145.6
"3767","13012","2019",4,4,0,1192500,6798,181.5
"3768","13013","2019",15,15,0,344986.8,3737.13333333333,92.4
"3769","13014","2019",98,58,40,215269.5,2640.60204081633,81.7448979591837
"3770","13015","2019",141,106,35,452709.531914894,4334.17021276596,103.730496453901
"3771","13016","2019",69,56,13,310751.956521739,3536.55072463768,87.7536231884058
"3772","13017","2019",18,17,1,260624,2645.77777777778,97.7222222222222
"3773","13018","2019",59,53,6,233958.457627119,2338.08474576271,97.7796610169491
"3774","13019","2019",107,91,16,470972.644859813,4594.10280373832,103.429906542056
"3775","13020","2019",26,22,4,338151.961538462,3461.30769230769,96.2307692307692
"3776","13021","2019",113,52,61,423938.123893805,5531.15044247788,77.7433628318584
"3777","13022","2019",144,23,121,400328.9375,6374.96527777778,64.5069444444444
"3778","13023","2019",50,43,7,428203.12,4446.16,94.76
"3779","13024","2019",31,24,7,237149.419354839,2631,91.6774193548387
"3780","13025","2019",29,22,7,416736.862068966,4239.44827586207,100.51724137931
"3781","13026","2019",220,124,96,241342.645454545,3222.2,75.8363636363636
"3782","13027","2019",206,148,58,225766.252427184,2514.94174757282,89.747572815534
"3783","13028","2019",814,163,651,270222.100737101,4273.21498771499,63.2235872235872
"3784","13029","2019",14,13,1,324541.071428571,3387.64285714286,98.2142857142857
"3785","13030","2019",61,52,9,285288.590163934,3321.72131147541,88.1803278688525
"3786","13031","2019",40,22,18,284363.75,3285.275,88.15
"3787","13032","2019",120,87,33,465862.158333333,4428.94166666667,101.616666666667
"3788","13033","2019",80,66,14,405905.8375,4826.1625,89.3
"3789","13034","2019",29,27,2,895490.517241379,5955.13793103448,147.103448275862
"3790","13035","2019",103,82,21,266168.495145631,3452.74757281553,84.1650485436893
"3791","13036","2019",46,39,7,305572.173913043,2723.30434782609,106.739130434783
"3792","13037","2019",110,82,28,279263.636363636,3531.56363636364,82.2545454545455
"3793","13038","2019",52,47,5,369613.480769231,3384.78846153846,105.326923076923
"3794","13039","2019",187,122,65,219972.673796791,2923.97860962567,76.7219251336898
"3795","13040","2019",122,89,33,377132.581967213,4106.25409836066,95.2950819672131
"3796","13041","2019",242,109,133,248253.256198347,3317.51652892562,75.7479338842975
"3797","13042","2019",68,49,19,475490.735294118,4190.38235294118,115.588235294118
"3798","13043","2019",109,80,29,270398.055045872,3181.08256880734,85.9449541284404
"3799","13044","2019",53,38,15,272730.056603774,3067.75471698113,94.7924528301887
"3800","13045","2019",72,64,8,246653.625,2740.19444444444,94.25
"3801","13046","2019",41,39,2,309098.707317073,4145.24390243902,84.1463414634146
"3802","13047","2019",459,256,203,210214.581699346,2709.32897603486,78.0021786492375
"3803","13048","2019",46,43,3,315209.673913043,3334.32608695652,97.3695652173913
"3804","13049","2019",24,18,6,255288.333333333,2983.375,85.7083333333333
"3805","13050","2019",139,90,49,305723.179856115,3480.31654676259,89.2589928057554
"3806","13051","2019",123,94,29,297145.869918699,3319.91869918699,94.6666666666667
"3807","13052","2019",19,15,4,256851.421052632,2806.15789473684,86.5789473684211
"3808","13053","2019",131,75,56,254141.122137405,2966.58015267176,83.6106870229008
"3809","13054","2019",444,172,272,207602.391891892,2717.65540540541,75.7972972972973
"3810","13055","2019",13327,1767,11560,194132.80543258,2853.9921212576,65.7635626922788
"3811","13056","2019",447,150,297,215410.10738255,2846.29530201342,76.8187919463087
"3812","13057","2019",4,4,0,330750,3345.75,99.5
"3813","13058","2019",49,41,8,397376.530612245,4547.87755102041,92.265306122449
"3814","13059","2019",38,21,17,262134.078947368,2853.10526315789,86.5789473684211
"3815","13060","2019",60,47,13,462758.15,4525.16666666667,102.216666666667
"3816","13061","2019",1,1,0,150000,3750,40
"3817","13062","2019",43,40,3,409731.186046512,4106.3023255814,100.883720930233
"3818","13063","2019",270,145,125,192901.166666667,2528.82222222222,77.2851851851852
"3819","13064","2019",28,27,1,327836.142857143,3116.35714285714,105.75
"3820","13065","2019",59,58,1,339844.915254237,3310.10169491525,99.3220338983051
"3821","13066","2019",59,48,11,255371.610169492,2962.94915254237,89.7457627118644
"3822","13067","2019",37,35,2,216320.135135135,2354.40540540541,93.5675675675676
"3823","13068","2019",37,34,3,441388.216216216,3696.81081081081,111.243243243243
"3824","13069","2019",139,117,22,297201.863309353,3197.23741007194,93.4028776978417
"3825","13070","2019",66,33,33,262973.303030303,3483.95454545455,76.6969696969697
"3826","13071","2019",209,143,66,290507.009569378,3568.58851674641,82.7511961722488
"3827","13072","2019",41,35,6,364218.951219512,3517.17073170732,103.390243902439
"3828","13073","2019",83,62,21,304593.361445783,3625.63855421687,88.566265060241
"3829","13074","2019",72,49,23,274036.583333333,3190.88888888889,86.8472222222222
"3830","13075","2019",144,70,74,289951.618055556,3680.94444444444,79.7777777777778
"3831","13076","2019",51,46,5,242784.980392157,2425.11764705882,99.3725490196078
"3832","13077","2019",150,82,68,181426.133333333,2399.95333333333,76.12
"3833","13078","2019",72,46,26,153213.958333333,2137.02777777778,73
"3834","13079","2019",16,13,3,379981.25,3473.5,93.6875
"3835","13080","2019",62,45,17,323930.419354839,3558.77419354839,91.1935483870968
"3836","13081","2019",116,83,33,286712.465517241,3187.5775862069,91.801724137931
"3837","13082","2019",49,45,4,540254.448979592,3995.30612244898,132.836734693878
"3838","13083","2019",30,28,2,296019.5,2754.43333333333,107.166666666667
"3839","13084","2019",53,45,8,246745.283018868,2757.39622641509,91.7169811320755
"3840","13085","2019",59,26,33,295973.322033898,3637.86440677966,81.9491525423729
"3841","13086","2019",91,58,33,300849.032967033,4049.18681318681,81
"3842","13087","2019",63,39,24,284190.158730159,3575.53968253968,84.0952380952381
"3843","13088","2019",62,45,17,299433.338709677,3991.03225806452,78.9354838709677
"3844","13089","2019",31,25,6,228348.612903226,2237.41935483871,95.8709677419355
"3845","13090","2019",3,3,0,304833.333333333,3668.33333333333,77.3333333333333
"3846","13091","2019",68,56,12,395954.5,4001.36764705882,103.029411764706
"3847","13092","2019",120,62,58,212560.525,2783.4,76.8
"3848","13093","2019",2,2,0,275500,3158.5,86
"3849","13094","2019",30,24,6,357084.333333333,3101.23333333333,120.566666666667
"3850","13095","2019",17,16,1,1098751.17647059,5512.29411764706,198.941176470588
"3851","13096","2019",85,25,60,174667.352941176,3473.05882352941,57.7764705882353
"3852","13097","2019",160,133,27,258286.38125,2768.1875,94.91875
"3853","13098","2019",82,68,14,313144.219512195,3358.76829268293,96.609756097561
"3854","13099","2019",15,5,10,130264,1857.4,68.4
"3855","13100","2019",168,130,38,467528.821428571,4101.39285714286,104.214285714286
"3856","13101","2019",39,23,16,295436.794871795,3680.02564102564,80.6410256410256
"3857","13102","2019",60,43,17,244744.15,3369.16666666667,77.9333333333333
"3858","13103","2019",707,257,450,200090.381895332,2635.88260254597,75.6039603960396
"3859","13104","2019",171,74,97,304263.070175439,5862.59064327485,56.4912280701754
"3860","13105","2019",65,52,13,253350.292307692,3005.86153846154,87.8
"3861","13106","2019",141,72,69,226923.219858156,3157.43262411347,72.5106382978723
"3862","13107","2019",59,52,7,406411.847457627,3793.16949152542,107.033898305085
"3863","13108","2019",185,119,66,163670.978378378,1762.73513513514,90.0108108108108
"3864","13109","2019",36,20,16,533543.055555556,4953.05555555556,105.472222222222
"3865","13110","2019",157,112,45,271377.242038217,3294.68152866242,83.2420382165605
"3866","13111","2019",15,11,4,630560,4804.26666666667,114.133333333333
"3867","13112","2019",90,77,13,380130.511111111,3918.01111111111,100.533333333333
"3868","13113","2019",107,70,37,380740.654205607,4130.86915887851,91.785046728972
"3869","13114","2019",68,60,8,486252.544117647,4297.32352941176,113.529411764706
"3870","13115","2019",22,22,0,344990.545454545,3521.31818181818,100.909090909091
"3871","13116","2019",5,5,0,326826,2879.8,114.8
"3872","13117","2019",372,176,196,227487.782258065,2912.1935483871,77.9838709677419
"3873","13118","2019",48,40,8,364333.333333333,3891.4375,94.125
"3874","13119","2019",83,40,43,321181.795180723,3598.46987951807,85.8915662650602
"3875","14001","2019",19,19,0,249514.473684211,2346.94736842105,104.052631578947
"3876","14003","2019",5,5,0,170710,1655.6,106.6
"3877","14005","2019",17,17,0,191902.941176471,1786.47058823529,112.470588235294
"3878","14006","2019",20,20,0,211531.5,2173.65,106
"3879","14007","2019",2,2,0,183000,1859,98
"3880","14009","2019",21,20,1,228278.571428571,2240.28571428571,104.285714285714
"3881","14011","2019",32,32,0,189161.09375,1712.6875,116.40625
"3882","14012","2019",6,6,0,223683.333333333,1773.83333333333,121.666666666667
"3883","14014","2019",17,17,0,272444.705882353,2297.82352941176,121.176470588235
"3884","14015","2019",19,18,1,162715.789473684,1359.68421052632,125
"3885","14016","2019",11,11,0,194236.818181818,2157.36363636364,93.1818181818182
"3886","14019","2019",3,3,0,277519.666666667,2101.33333333333,130.333333333333
"3887","14020","2019",47,45,2,202454,2005.65957446809,102.978723404255
"3888","14021","2019",9,5,4,195107.777777778,2210.11111111111,91.2222222222222
"3889","14022","2019",20,17,3,156775,2049.6,82.6
"3890","14023","2019",2,2,0,165000,1656,96.5
"3891","14024","2019",15,15,0,358980.666666667,2468.46666666667,148.733333333333
"3892","14025","2019",4,4,0,223750,1906.25,126.5
"3893","14026","2019",30,30,0,176632.433333333,1537.83333333333,120.433333333333
"3894","14027","2019",65,63,2,130297.384615385,1303.29230769231,101.415384615385
"3895","14030","2019",17,17,0,256682.117647059,2649.05882352941,102.294117647059
"3896","14032","2019",7,7,0,300728.571428571,2354.57142857143,142.714285714286
"3897","14033","2019",4,4,0,190168.5,1962.25,97.5
"3898","14034","2019",3,3,0,240946.666666667,2728.66666666667,88.6666666666667
"3899","14035","2019",20,19,1,135900,1240.15,105.9
"3900","14036","2019",3,3,0,242833.333333333,2174.66666666667,112
"3901","14037","2019",11,11,0,168809.090909091,1508,115.909090909091
"3902","14038","2019",16,16,0,187267.5625,1716.9375,116.0625
"3903","14039","2019",13,13,0,143974.230769231,1465.23076923077,99.3076923076923
"3904","14040","2019",2,2,0,101300,1173,98
"3905","14041","2019",4,4,0,359500,3272.25,120
"3906","14042","2019",22,22,0,137944.090909091,1485.54545454545,98.8181818181818
"3907","14044","2019",8,8,0,261915,2318.25,114.5
"3908","14046","2019",27,27,0,225925.925925926,2269.22222222222,105
"3909","14047","2019",232,108,124,154919.452586207,1922.92672413793,77.7758620689655
"3910","14049","2019",2,2,0,186875,2137.5,87.5
"3911","14053","2019",4,4,0,117000,1344.5,84.75
"3912","14054","2019",3,3,0,136966.666666667,1110.33333333333,124
"3913","14055","2019",13,11,2,219769.230769231,2448.30769230769,85.7692307692308
"3914","14057","2019",16,16,0,195613.625,2052.875,94.0625
"3915","14059","2019",55,12,43,281813.909090909,4150.03636363636,60.4545454545455
"3916","14060","2019",30,30,0,332038.533333333,2714.9,128.833333333333
"3917","14061","2019",126,126,0,102834.285714286,1162.80158730159,94.7222222222222
"3918","14062","2019",8,8,0,242368.75,2203.75,110.5
"3919","14063","2019",6,6,0,130250,1235.5,107
"3920","14064","2019",4,4,0,117875,1398,86.75
"3921","14066","2019",59,37,22,151517.796610169,2291.67796610169,69.6440677966102
"3922","14068","2019",62,61,1,235406.967741935,1995.27419354839,118.112903225806
"3923","14069","2019",18,16,2,136433.333333333,1511.11111111111,89.6666666666667
"3924","14070","2019",7,7,0,337014.285714286,2410.71428571429,138.571428571429
"3925","14076","2019",73,40,33,174887.191780822,2247.72602739726,78.1917808219178
"3926","14077","2019",8,8,0,247445,1961.5,123.5
"3927","14078","2019",11,11,0,177386.363636364,1672.81818181818,109.909090909091
"3928","14079","2019",115,32,83,198243.834782609,3182.89565217391,58.9652173913043
"3929","14080","2019",4,4,0,115275,1100.75,101.25
"3930","14082","2019",1,1,0,179800,1498,120
"3931","14083","2019",15,15,0,168820,1523.73333333333,111
"3932","14084","2019",4,4,0,132875,1460.75,88
"3933","14085","2019",21,21,0,218448.285714286,1978.66666666667,112.619047619048
"3934","14086","2019",6,6,0,482495,2820.16666666667,158.5
"3935","14088","2019",6,6,0,187166.666666667,1463.16666666667,132.5
"3936","14089","2019",5,5,0,207400,1867.6,125.6
"3937","14090","2019",12,12,0,129566.666666667,1280.75,99.6666666666667
"3938","14091","2019",4,4,0,458777.5,3729.25,124.25
"3939","14092","2019",26,24,2,211956.384615385,2098.11538461538,103.769230769231
"3940","14093","2019",4,4,0,227125,2332,97.5
"3941","14096","2019",2,2,0,118250,993.5,120
"3942","14097","2019",1,1,0,103000,1717,60
"3943","14098","2019",79,77,2,199766.70886076,1980.9746835443,104.759493670886
"3944","14100","2019",26,23,3,155684.615384615,1789.96153846154,90.8846153846154
"3945","14101","2019",55,50,5,236874.363636364,2537.01818181818,97.7636363636364
"3946","14102","2019",12,12,0,240566.666666667,2078.5,106.416666666667
"3947","14103","2019",7,7,0,142203.428571429,1429.85714285714,97.8571428571429
"3948","14104","2019",2,2,0,152000,1525,100.5
"3949","14106","2019",4,4,0,202950,1790.5,113.25
"3950","14107","2019",3,3,0,118666.666666667,1382.66666666667,98
"3951","14110","2019",2,2,0,330000,1881.5,188
"3952","14111","2019",7,7,0,181607.142857143,1641,115.571428571429
"3953","14116","2019",1,1,0,2e+05,1600,125
"3954","14117","2019",492,83,409,138617.032520325,3362.34146341463,41.280487804878
"3955","14118","2019",2243,359,1884,152555.516272849,2392.18724921979,64.6883637984842
"3956","14119","2019",13,13,0,187584.615384615,1672,112.307692307692
"3957","14120","2019",25,25,0,157788,1426.96,118.28
"3958","14121","2019",4,4,0,187075,1374.5,151.5
"3959","14122","2019",2,2,0,185750,1568.5,115.5
"3960","14123","2019",25,25,0,316065.2,2430.52,132.84
"3961","14124","2019",13,13,0,166541.076923077,1611.61538461538,106.230769230769
"3962","14125","2019",25,23,2,270095.2,2136.04,127.84
"3963","14126","2019",25,25,0,217810.2,1869.08,118.28
"3964","14127","2019",8,8,0,80175,847.125,93.375
"3965","14130","2019",2,2,0,149500,1240.5,117
"3966","14131","2019",7,7,0,423546.428571429,2802.57142857143,156.714285714286
"3967","14132","2019",5,5,0,109000,885,119.6
"3968","14134","2019",4,4,0,231250,1641.25,144.25
"3969","14135","2019",5,5,0,191890,1719.8,124.2
"3970","14136","2019",1,1,0,169000,1610,105
"3971","14137","2019",29,27,2,214999.172413793,2236.51724137931,98.1379310344828
"3972","14140","2019",2,2,0,148500,1836,82
"3973","14141","2019",6,6,0,228966.666666667,1653.83333333333,123.166666666667
"3974","14143","2019",35,35,0,131686.571428571,1219.14285714286,113.514285714286
"3975","14145","2019",6,6,0,149000,1809.83333333333,83.8333333333333
"3976","14146","2019",3,3,0,98700,788.666666666667,121.666666666667
"3977","14147","2019",2,2,0,92481.5,1016,90
"3978","14149","2019",6,6,0,182695.333333333,1564.83333333333,116
"3979","14150","2019",7,7,0,185998.571428571,1655.42857142857,117.142857142857
"3980","14159","2019",1,1,0,43000,506,85
"3981","14160","2019",4,3,1,131550,1717.75,80
"3982","14161","2019",7,7,0,328820,2661.71428571429,123.285714285714
"3983","14162","2019",24,23,1,104057.916666667,1229.875,86.5833333333333
"3984","14163","2019",4,4,0,213000,1799.25,121
"3985","14165","2019",6,6,0,271483.333333333,2588.83333333333,126.666666666667
"3986","14166","2019",55,52,3,219227.8,2277.12727272727,99.0727272727273
"3987","14167","2019",49,32,17,164246.12244898,2262.04081632653,75.2040816326531
"3988","14168","2019",4,4,0,160150,1441,114.25
"3989","14169","2019",6,6,0,129750,1125.5,106
"3990","14171","2019",4,4,0,127525,1349.25,102
"3991","14172","2019",15,15,0,196962.6,1880.53333333333,103.333333333333
"3992","14173","2019",7,7,0,170642.857142857,1545.28571428571,120
"3993","14174","2019",61,54,7,97564.5081967213,1029.44262295082,94.1147540983606
"3994","14175","2019",2,2,0,144075,1503.5,113
"3995","14177","2019",9,9,0,198788.888888889,1838.33333333333,111.777777777778
"3996","14179","2019",5,5,0,169940,1510.4,107.6
"3997","14180","2019",3,3,0,200300,1611,152
"3998","14181","2019",62,39,23,171366.548387097,2244.62903225806,75.0322580645161
"3999","14182","2019",7,7,0,84214.2857142857,961.142857142857,82.1428571428571
"4000","14183","2019",3,3,0,77400,1669.66666666667,54.6666666666667
"4001","14184","2019",3,3,0,142650,1677.66666666667,95.3333333333333
"4002","14190","2019",2,2,0,103000,956,107
"4003","14191","2019",279,65,214,119412.125448029,2446.15053763441,50.1505376344086
"4004","14193","2019",10,10,0,144690,1631.7,91.7
"4005","14194","2019",12,12,0,102289.5,972.5,103.25
"4006","14195","2019",3,3,0,136666.666666667,1383.66666666667,106.666666666667
"4007","14196","2019",5,5,0,203820,1508.6,161.6
"4008","14197","2019",13,13,0,268919.230769231,2438.76923076923,123
"4009","14198","2019",3,3,0,151800,2044.66666666667,72.6666666666667
"4010","14200","2019",42,40,2,169813.095238095,1845.11904761905,100.642857142857
"4011","14202","2019",1,1,0,565000,2868,197
"4012","14203","2019",4,4,0,337675,2603.75,134
"4013","14204","2019",2,2,0,147000,1876.5,78.5
"4014","14205","2019",3,3,0,165666.666666667,1507.66666666667,98.6666666666667
"4015","14206","2019",5,5,0,121622,1181.6,106.8
"4016","14207","2019",3,3,0,128568,1327.66666666667,109.333333333333
"4017","14209","2019",12,12,0,158345.166666667,1357.08333333333,112.916666666667
"4018","14211","2019",6,6,0,159240,1712,99.5
"4019","14214","2019",1,1,0,152000,1206,126
"4020","14215","2019",18,14,4,216738.888888889,2367.16666666667,95.5
"4021","14216","2019",8,8,0,140318.75,1628,95.625
"4022","14218","2019",13,13,0,155089.230769231,2080.61538461538,77.7692307692308
"4023","14220","2019",379,70,309,298839.187335092,4900.1055408971,60.3799472295514
"4024","14221","2019",54,51,3,204758.888888889,2258.88888888889,94.5925925925926
"4025","14223","2019",1,1,0,130000,949,137
"4026","14224","2019",1,1,0,224800,2391,94
"4027","14225","2019",131,83,48,165508.992366412,2923.70229007634,59.3969465648855
"4028","14226","2019",4,4,0,90758.75,748.75,126
"4029","14227","2019",3,3,0,195333.333333333,2133.66666666667,87.6666666666667
"4030","14228","2019",76,58,18,205609.473684211,2160.97368421053,96.6184210526316
"4031","14229","2019",31,29,2,125500.806451613,1474.58064516129,83.7741935483871
"4032","14230","2019",1,1,0,144000,1800,80
"4033","14231","2019",8,8,0,236875,2638.25,99.75
"4034","14232","2019",2,2,0,222425,2304.5,98
"4035","14236","2019",9,9,0,195244.444444444,1605,115.444444444444
"4036","14237","2019",5,5,0,230920,1678.2,157.2
"4037","14239","2019",1,1,0,90000,1800,50
"4038","14240","2019",11,11,0,133213.636363636,1369.45454545455,101.727272727273
"4039","14241","2019",10,10,0,180105,1638.2,110.6
"4040","14242","2019",23,17,6,230822.173913043,2478.13043478261,93.9130434782609
"4041","14243","2019",37,26,11,268228.486486487,2626.83783783784,105.027027027027
"4042","14244","2019",2,2,0,161550,1469.5,110.5
"4043","14245","2019",7,7,0,133035.714285714,1091.14285714286,116.285714285714
"4044","14246","2019",16,16,0,208847.3125,2022.8125,107.1875
"4045","14248","2019",1,1,0,175000,1287,136
"4046","14249","2019",8,8,0,202706.25,1569.25,133.625
"4047","14250","2019",3,3,0,194673.333333333,1646,116.666666666667
"4048","14251","2019",8,8,0,188435,1786,106.625
"4049","14252","2019",2,2,0,171200,1754.5,97.5
"4050","14254","2019",17,17,0,207890.705882353,2082.82352941176,100.058823529412
"4051","14256","2019",2,2,0,342500,2005,168.5
"4052","14257","2019",20,20,0,193194.5,1976.95,98.05
"4053","14258","2019",95,70,25,136822.968421053,1496.05263157895,93.6421052631579
"4054","14260","2019",5,5,0,356301,2138.4,175
"4055","14261","2019",4,4,0,202565,1812,109.5
"4056","14266","2019",23,23,0,263940.043478261,2156.91304347826,126.347826086957
"4057","14269","2019",1,1,0,184900,1651,112
"4058","14270","2019",2,2,0,139500,1405.5,98.5
"4059","14271","2019",56,51,5,197886.785714286,2299.39285714286,88.1964285714286
"4060","14273","2019",4,4,0,153840,1408.75,108.5
"4061","14274","2019",37,36,1,242161.189189189,1873.56756756757,131.135135135135
"4062","14275","2019",12,12,0,137700,1415.16666666667,105.5
"4063","14276","2019",3,3,0,139780,1514,92.3333333333333
"4064","14277","2019",23,23,0,181700,1818.39130434783,104.652173913043
"4065","14278","2019",17,17,0,185281.764705882,1987.11764705882,95.1764705882353
"4066","14280","2019",3,3,0,213233.333333333,1919.66666666667,116.333333333333
"4067","14281","2019",9,9,0,154940,2170.22222222222,102.666666666667
"4068","14282","2019",6,6,0,153833.333333333,1475.5,106.333333333333
"4069","14283","2019",5,5,0,187700,1325,146
"4070","14284","2019",3,3,0,159333.333333333,1550,102.333333333333
"4071","14285","2019",2,2,0,194000,1838.5,111.5
"4072","14286","2019",10,10,0,252747.8,1970.4,134
"4073","14287","2019",41,41,0,163798.682926829,1760.53658536585,93.0975609756098
"4074","14288","2019",13,13,0,225518.461538462,1840.07692307692,124.692307692308
"4075","14289","2019",14,14,0,136835.714285714,1340.21428571429,101.428571428571
"4076","14290","2019",13,13,0,158406.538461538,1653.61538461538,98
"4077","14291","2019",5,5,0,210794.6,1260.6,163.2
"4078","14293","2019",4,4,0,195256.25,1804,108.75
"4079","14297","2019",6,6,0,234483.333333333,1913.5,125
"4080","14298","2019",6,6,0,72250,1254.5,64.1666666666667
"4081","14299","2019",13,13,0,309702.615384615,2506.38461538462,117.461538461538
"4082","14300","2019",1,1,0,310000,2296,135
"4083","14301","2019",46,45,1,193960.173913043,2372.63043478261,85.804347826087
"4084","14302","2019",5,5,0,436240,3230.6,138.2
"4085","14303","2019",8,8,0,160962.5,1670,102.5
"4086","14304","2019",16,16,0,345126.875,2393.625,148.625
"4087","14305","2019",23,23,0,404520.826086957,2999.95652173913,149.304347826087
"4088","14306","2019",2,2,0,359500,2309,178
"4089","14308","2019",1,1,0,159000,3975,40
"4090","14309","2019",9,7,2,144769.444444444,1648.22222222222,86.7777777777778
"4091","14310","2019",15,15,0,191216.666666667,1700.4,114.466666666667
"4092","14311","2019",9,9,0,166818.888888889,1802.33333333333,97.7777777777778
"4093","14312","2019",76,57,19,106228.881578947,1642.89473684211,65.1447368421053
"4094","14316","2019",7,7,0,527601.428571429,2698.42857142857,194
"4095","14318","2019",21,21,0,132727.142857143,1318.71428571429,110.904761904762
"4096","14319","2019",15,15,0,191616.666666667,2307.8,82.9333333333333
"4097","14320","2019",3,3,0,167333.333333333,1207,130.666666666667
"4098","14322","2019",8,8,0,277442.5,1910.25,146.75
"4099","14325","2019",44,39,5,240219.886363636,2563.95454545455,85.2727272727273
"4100","14326","2019",6,6,0,207916.666666667,2442.5,82
"4101","14327","2019",290,80,210,110269.462068966,1614.21379310345,67.9206896551724
"4102","14328","2019",11,11,0,252250,1864.45454545455,124.363636363636
"4103","14332","2019",9,9,0,123877.777777778,1632.55555555556,82.1111111111111
"4104","14334","2019",5,5,0,143661.2,1628.8,86.4
"4105","14335","2019",5,5,0,197130,1804.8,110
"4106","14336","2019",5,5,0,174600,1314.2,129.6
"4107","14337","2019",3,3,0,164090,1494.66666666667,118.333333333333
"4108","14338","2019",233,67,166,166432.888412017,2855.74678111588,56.2231759656652
"4109","14341","2019",137,80,57,162353.248175182,1949.3795620438,82.8759124087591
"4110","14342","2019",63,59,4,113452.222222222,1122.42857142857,99.7619047619048
"4111","14343","2019",1,1,0,196000,1188,165
"4112","14344","2019",4,4,0,172300,1406.75,124.25
"4113","14345","2019",4,4,0,96235,1056.75,96
"4114","14346","2019",8,8,0,158738.75,1381.875,114
"4115","14347","2019",12,12,0,140023.333333333,1326.5,107
"4116","14349","2019",27,27,0,200546.296296296,1826.88888888889,110.703703703704
"4117","14352","2019",9,9,0,91347.2222222222,858.555555555556,111.666666666667
"4118","14353","2019",3,3,0,184000,1785,107
"4119","14354","2019",49,33,16,196888.408163265,2827.77551020408,73
"4120","14355","2019",14,14,0,210692.857142857,1762.35714285714,120.785714285714
"4121","14357","2019",14,14,0,113990,860,125.642857142857
"4122","14358","2019",1,1,0,65000,867,75
"4123","14360","2019",2,2,0,144500,1658,88.5
"4124","14362","2019",3,3,0,274400,1478,183
"4125","14364","2019",7,7,0,232924.857142857,1932.28571428571,131.571428571429
"4126","14365","2019",60,45,15,193641.366666667,2574.13333333333,77.1333333333333
"4127","14366","2019",308,103,205,105871.441558442,1392.78571428571,75.7175324675325
"4128","14367","2019",4,4,0,68000,830,85.25
"4129","14368","2019",6,6,0,101776.666666667,1312.5,77
"4130","14369","2019",4,4,0,113450,945.75,120.25
"4131","14370","2019",44,43,1,139589.340909091,1498.22727272727,100.75
"4132","14371","2019",97,97,0,142786.134020619,1438.45360824742,101.752577319588
"4133","14374","2019",3,3,0,131666.666666667,1137.33333333333,117.333333333333
"4134","14375","2019",2,2,0,124500,1405,87.5
"4135","14377","2019",10,10,0,140711.5,1421.2,98.3
"4136","14378","2019",7,7,0,147250,1223.14285714286,121.285714285714
"4137","14379","2019",5,5,0,103600,1231.6,81.6
"4138","14380","2019",1,1,0,120000,2000,60
"4139","14383","2019",32,27,5,245021.875,2393.40625,103.96875
"4140","14384","2019",85,48,37,181187.023529412,2824.85882352941,68.6705882352941
"4141","14385","2019",1,1,0,267000,1383,193
"4142","14389","2019",1,1,0,180000,2222,81
"4143","14390","2019",2,2,0,136000,1385,93
"4144","14391","2019",3,3,0,114466.666666667,821.333333333333,126.333333333333
"4145","14393","2019",2,2,0,245875,1894.5,132
"4146","14394","2019",9,9,0,172111.111111111,1411,125.888888888889
"4147","14396","2019",14,14,0,215301.428571429,2287.28571428571,96.1428571428571
"4148","14397","2019",5,5,0,152080,1333.2,112.8
"4149","14398","2019",6,6,0,230712.5,2102,111.333333333333
"4150","14399","2019",8,8,0,180463.25,1640.75,115.5
"4151","14401","2019",1,1,0,125000,1190,105
"4152","14402","2019",1,1,0,125000,1645,76
"4153","14403","2019",7,7,0,134714.285714286,1706.85714285714,79.5714285714286
"4154","14404","2019",1,1,0,205000,1228,167
"4155","14405","2019",7,7,0,124800,1154.42857142857,107.285714285714
"4156","14406","2019",9,9,0,195086.666666667,1976.66666666667,105.777777777778
"4157","14407","2019",38,33,5,331701.815789474,2719.94736842105,124.605263157895
"4158","14408","2019",26,23,3,184110,1898.46153846154,97.7692307692308
"4159","14409","2019",128,76,52,174063.4140625,2830.359375,67.1484375
"4160","14410","2019",15,15,0,149809.333333333,1475.4,106.333333333333
"4161","14411","2019",8,8,0,179612.5,1542.375,123.375
"4162","14419","2019",5,5,0,122320,1465.2,85.2
"4163","14421","2019",3,3,0,200666.666666667,1633.33333333333,123.666666666667
"4164","14425","2019",4,4,0,224488.75,1601,146.25
"4165","14426","2019",3,3,0,203800,1850.66666666667,121.666666666667
"4166","14427","2019",8,8,0,79137.5,1077.75,78.5
"4167","14430","2019",1,1,0,191000,2851,67
"4168","14431","2019",135,130,5,146347.311111111,1522.98518518519,100.044444444444
"4169","14435","2019",1,1,0,185000,1285,144
"4170","14436","2019",7,7,0,161714.285714286,1372,113.285714285714
"4171","14437","2019",142,83,59,150911.176056338,2259.71126760563,68.8943661971831
"4172","14438","2019",13,13,0,202658.461538462,1966.15384615385,106.153846153846
"4173","14445","2019",5,5,0,147350,1189.2,115.2
"4174","14448","2019",1,1,0,275000,1447,190
"4175","14449","2019",4,4,0,260500,2128.25,138.5
"4176","14452","2019",6,6,0,125116.666666667,1352.66666666667,96
"4177","14453","2019",5,5,0,169380,1465.2,121.4
"4178","14454","2019",21,18,3,191373.80952381,2016.71428571429,98.6190476190476
"4179","14455","2019",3,3,0,169333.333333333,1709.33333333333,99.3333333333333
"4180","14456","2019",33,33,0,194303.939393939,1978.54545454545,102.030303030303
"4181","14457","2019",2,2,0,117000,938,112
"4182","14458","2019",3,3,0,215366.666666667,1371.66666666667,131.333333333333
"4183","14460","2019",19,18,1,170657.894736842,1484.42105263158,115.631578947368
"4184","14461","2019",9,9,0,227293.333333333,1601.66666666667,161.222222222222
"4185","14465","2019",9,9,0,219033.333333333,1812,123.888888888889
"4186","14466","2019",5,5,0,214910,1944.2,109.4
"4187","14467","2019",3,3,0,313333.333333333,1919,145.333333333333
"4188","14468","2019",5,5,0,120900,1302.8,96.6
"4189","14469","2019",2,2,0,171650,1515.5,95.5
"4190","14474","2019",3,3,0,1e+05,1786.33333333333,57.6666666666667
"4191","14475","2019",34,34,0,179557.647058824,1600.14705882353,114.5
"4192","14476","2019",2,2,0,167000,1266.5,132
"4193","14478","2019",38,35,3,89485.1315789474,968.631578947368,92.8157894736842
"4194","14480","2019",8,8,0,123837.5,1063.125,116.375
"4195","14482","2019",3,3,0,199733.333333333,2335,101
"4196","14483","2019",3,3,0,141249.666666667,1587,91.3333333333333
"4197","14484","2019",3,3,0,232233.333333333,1698,138
"4198","14486","2019",7,7,0,117085.714285714,1171.14285714286,97.4285714285714
"4199","14487","2019",13,13,0,123938.461538462,1603.30769230769,84.1538461538462
"4200","14488","2019",240,139,101,196137.308333333,2718.89583333333,74.4625
"4201","14491","2019",4,4,0,282000,1353.75,211.25
"4202","14492","2019",8,8,0,307368.125,2760.75,108.625
"4203","14495","2019",11,11,0,305136.363636364,2429.27272727273,131
"4204","14496","2019",2,2,0,35000,521,78
"4205","14497","2019",8,8,0,123250,1162.5,103.625
"4206","14498","2019",2,2,0,112500,1081,103
"4207","14499","2019",8,8,0,269046.875,2159.875,138.125
"4208","14500","2019",1,1,0,160000,2759,58
"4209","14501","2019",5,5,0,94400,881.4,112.2
"4210","14502","2019",1,1,0,146000,1446,101
"4211","14504","2019",13,13,0,224228.461538462,1951.46153846154,118.846153846154
"4212","14506","2019",5,5,0,164950,1802.8,89.8
"4213","14509","2019",4,4,0,381125,2998.75,118.25
"4214","14510","2019",1,1,0,30000,566,53
"4215","14511","2019",1,1,0,120000,750,160
"4216","14514","2019",55,36,19,214342.927272727,2520.69090909091,89.8
"4217","14515","2019",48,31,17,132083.583333333,1911.29166666667,72.0208333333333
"4218","14516","2019",32,32,0,131419.375,1707.125,84
"4219","14519","2019",2,2,0,458500,2666,160
"4220","14520","2019",5,5,0,189344,1866.8,105
"4221","14524","2019",6,6,0,236610,2053.16666666667,117.5
"4222","14527","2019",9,9,0,204322.222222222,1595.11111111111,126.333333333333
"4223","14528","2019",5,5,0,273950,1896.6,142
"4224","14529","2019",2,2,0,149000,1179,122
"4225","14530","2019",43,42,1,183803.023255814,1761.41860465116,105.139534883721
"4226","14534","2019",5,5,0,227800,2332.4,96.2
"4227","14535","2019",8,8,0,137706.25,1669.125,92.625
"4228","14536","2019",35,29,6,193370.885714286,2165.08571428571,92.6
"4229","14538","2019",25,22,3,210809.6,2053.36,102.64
"4230","14540","2019",4,4,0,244250,2606,104
"4231","14542","2019",10,10,0,139350,1320.4,107.3
"4232","14543","2019",31,31,0,236332.419354839,1958.09677419355,130.870967741935
"4233","14546","2019",3,3,0,161666.666666667,1638.33333333333,98.3333333333333
"4234","14547","2019",4,4,0,136625,1028.5,132.5
"4235","14550","2019",2,2,0,170000,1821,109.5
"4236","14552","2019",9,9,0,176661.111111111,1877.77777777778,102.333333333333
"4237","14554","2019",25,25,0,182496,1807.4,101.6
"4238","14555","2019",9,9,0,258296.222222222,2093.33333333333,123.777777777778
"4239","14556","2019",10,10,0,188708,2556.5,77.5
"4240","14557","2019",45,28,17,324957.111111111,3090.75555555556,94.1555555555556
"4241","14558","2019",11,11,0,218459.090909091,2222,99.4545454545455
"4242","14559","2019",6,6,0,93533.3333333333,876.166666666667,107
"4243","14562","2019",73,38,35,181225.342465753,2599.52054794521,69.6849315068493
"4244","14563","2019",7,7,0,262685.714285714,2465.71428571429,109
"4245","14565","2019",4,4,0,95000,2038.5,64.75
"4246","14566","2019",20,19,1,248415.75,2209.75,114.65
"4247","14569","2019",3,3,0,232666.666666667,2071,116
"4248","14570","2019",38,38,0,124690,1365.92105263158,95.3947368421053
"4249","14571","2019",9,9,0,155444.444444444,1849.22222222222,89.6666666666667
"4250","14572","2019",11,11,0,96026.4545454545,1131.54545454545,84.2727272727273
"4251","14574","2019",21,21,0,193125.238095238,1574.95238095238,130.285714285714
"4252","14575","2019",8,8,0,273515,3123.875,108.875
"4253","14576","2019",3,3,0,224653.333333333,1652.66666666667,133
"4254","14578","2019",26,26,0,328072.730769231,2648,118.769230769231
"4255","14579","2019",15,15,0,192030,1643.13333333333,112.866666666667
"4256","14582","2019",12,12,0,177557.333333333,1595.66666666667,112.5
"4257","14586","2019",1,1,0,119000,1653,72
"4258","14587","2019",16,12,4,214574.875,2402.9375,92.4375
"4259","14588","2019",8,8,0,158468.75,1398.875,112.5
"4260","14589","2019",13,13,0,101126.923076923,1466.92307692308,77.5384615384615
"4261","14591","2019",16,16,0,168862.5,1840.875,96.8125
"4262","14592","2019",21,21,0,192157.761904762,1471.80952380952,131
"4263","14593","2019",13,13,0,290915.384615385,2191.23076923077,130.230769230769
"4264","14595","2019",3,3,0,105433.333333333,1170,107.666666666667
"4265","14598","2019",2,2,0,40250,568,71
"4266","14601","2019",4,4,0,314625,2933,116.25
"4267","14602","2019",2,2,0,91100,1539.5,57.5
"4268","14603","2019",4,4,0,203175,1845.25,110.5
"4269","14605","2019",9,9,0,145649.777777778,1828.11111111111,79.3333333333333
"4270","14606","2019",1,1,0,138000,1423,97
"4271","14607","2019",1,1,0,172000,1564,110
"4272","14609","2019",6,6,0,263560,2023.5,129.5
"4273","14610","2019",33,32,1,193753.939393939,1818.72727272727,108.636363636364
"4274","14614","2019",8,8,0,118862.5,1224.625,116.25
"4275","14620","2019",6,6,0,251539,2259.83333333333,111.5
"4276","14621","2019",12,11,1,110595.166666667,1210.16666666667,90.1666666666667
"4277","14622","2019",5,5,0,150200,1265.8,121.8
"4278","14623","2019",26,25,1,202574.615384615,2335.07692307692,89.6923076923077
"4279","14625","2019",6,6,0,172166.666666667,1629.66666666667,108.333333333333
"4280","14626","2019",13,13,0,144171.923076923,1636.84615384615,89.0769230769231
"4281","14627","2019",2,2,0,56000,986.5,55
"4282","14630","2019",7,7,0,201110,1878.71428571429,117.714285714286
"4283","14635","2019",2,2,0,76800,692,101.5
"4284","14637","2019",5,5,0,314200,2276.6,116.8
"4285","14639","2019",3,3,0,210666.666666667,2410.66666666667,90.3333333333333
"4286","14643","2019",14,14,0,182371.642857143,1499.07142857143,120.642857142857
"4287","14644","2019",9,9,0,204222.222222222,1805.77777777778,119.111111111111
"4288","14645","2019",4,4,0,592412.5,3440.25,159
"4289","14646","2019",5,5,0,137880,1906.8,75.6
"4290","14648","2019",5,5,0,173338,1668,112
"4291","14649","2019",4,4,0,108841.25,1260.25,81.25
"4292","14650","2019",2,2,0,121995,1173.5,99.5
"4293","14651","2019",1,1,0,1e+05,1053,95
"4294","14654","2019",124,122,2,130743.830645161,1380.16935483871,95.9112903225806
"4295","14656","2019",15,15,0,83816.6666666667,1115,75.9333333333333
"4296","14657","2019",5,5,0,202100,1773.4,113.6
"4297","14658","2019",51,51,0,100278.705882353,940.666666666667,105.235294117647
"4298","14659","2019",20,20,0,185900,1837.6,103.8
"4299","14660","2019",5,5,0,172400,2385.4,88.4
"4300","14661","2019",2,2,0,267500,2278,134.5
"4301","14663","2019",41,40,1,204855.292682927,1952.41463414634,108.073170731707
"4302","14664","2019",4,4,0,151712.5,1402.25,109.5
"4303","14665","2019",5,5,0,265640,2407.6,110
"4304","14666","2019",41,38,3,161080.731707317,1777.53658536585,94.0487804878049
"4305","14667","2019",7,7,0,153176.428571429,1502,106.428571428571
"4306","14668","2019",6,6,0,119641.666666667,1439.5,86.8333333333333
"4307","14669","2019",4,4,0,134500,1249.75,122.75
"4308","14672","2019",18,18,0,126001,1254.88888888889,103.166666666667
"4309","14674","2019",1,1,0,280000,1000,280
"4310","14675","2019",24,24,0,175241.416666667,1841.04166666667,100.541666666667
"4311","14676","2019",20,20,0,196060,1653.3,119.2
"4312","14677","2019",3,3,0,136333.333333333,1489.66666666667,90
"4313","14678","2019",13,13,0,135645.461538462,1289.23076923077,114.615384615385
"4314","14679","2019",9,9,0,197372.222222222,1948.88888888889,101.888888888889
"4315","14680","2019",1,1,0,245000,1750,140
"4316","14681","2019",5,5,0,162400,1484.4,115.6
"4317","14682","2019",9,9,0,268875.555555556,2061.77777777778,131
"4318","14684","2019",3,3,0,246666.666666667,1751.66666666667,136
"4319","14685","2019",24,24,0,199864.25,1917.95833333333,107.083333333333
"4320","14687","2019",3,3,0,203300,1959,115
"4321","14689","2019",45,39,6,144228.888888889,1509.66666666667,97.7111111111111
"4322","14692","2019",38,38,0,145655.263157895,1437.44736842105,103.815789473684
"4323","14694","2019",9,9,0,189333.333333333,1756.77777777778,102.888888888889
"4324","14698","2019",2,2,0,142750,1666.5,85.5
"4325","14699","2019",102,47,55,184438.725490196,2673.43137254902,69.3137254901961
"4326","14700","2019",14,14,0,199712.5,1860.28571428571,110.785714285714
"4327","14701","2019",85,22,63,309561.176470588,4033.62352941176,75.7294117647059
"4328","14705","2019",3,3,0,97333.3333333333,917.333333333333,108
"4329","14706","2019",4,4,0,342625,2465,143
"4330","14707","2019",14,14,0,184421.428571429,1694.64285714286,111.714285714286
"4331","14708","2019",5,5,0,285900,1824.2,156.6
"4332","14709","2019",8,8,0,183976.25,1558.25,115
"4333","14710","2019",1,1,0,80000,1212,66
"4334","14711","2019",18,17,1,141883.888888889,1604.5,94.4444444444444
"4335","14712","2019",52,49,3,180194.807692308,2094.61538461538,88.3846153846154
"4336","14713","2019",11,11,0,202990.909090909,2163.90909090909,102.454545454545
"4337","14714","2019",6,6,0,107716.666666667,1199.66666666667,91
"4338","14715","2019",367,108,259,232815.989100817,4153.51771117166,55.9346049046322
"4339","14716","2019",5,5,0,211100,1479.4,139.4
"4340","14719","2019",19,18,1,158797.368421053,1545.15789473684,103.947368421053
"4341","14720","2019",13,13,0,133307.692307692,1537.61538461538,93.4615384615385
"4342","14721","2019",5,5,0,237600,1819.2,139
"4343","14723","2019",8,8,0,363815,3150.625,128.625
"4344","14724","2019",44,30,14,268160,3096.72727272727,86.4545454545455
"4345","14726","2019",80,80,0,104846.125,1061.8375,95.0875
"4346","14728","2019",9,9,0,241322.222222222,2316.77777777778,112.666666666667
"4347","14731","2019",4,4,0,661475,3300.75,174.5
"4348","14732","2019",2,2,0,205000,1714.5,119.5
"4349","14733","2019",5,5,0,219080,1676.8,137.6
"4350","14734","2019",1,1,0,329000,1495,220
"4351","14735","2019",5,5,0,162560,1627.2,95.4
"4352","14737","2019",7,7,0,158413.571428571,1534,117.285714285714
"4353","14738","2019",37,36,1,245232.594594595,2270.24324324324,109.027027027027
"4354","14739","2019",40,39,1,218448.625,2294,92.475
"4355","14740","2019",13,13,0,126619.230769231,1254.53846153846,101.153846153846
"4356","14741","2019",1,1,0,175000,1458,120
"4357","14743","2019",4,4,0,349125,2431.25,139
"4358","14744","2019",1,1,0,160000,1584,101
"4359","14745","2019",9,8,1,175511.111111111,1935.77777777778,90.1111111111111
"4360","14747","2019",6,6,0,207541.666666667,2298.66666666667,92.8333333333333
"4361","14751","2019",4,4,0,180000,935.75,200.5
"4362","14752","2019",42,34,8,185282.571428571,2206.47619047619,92.1666666666667
"4363","14753","2019",6,6,0,192598.333333333,1453.83333333333,128.166666666667
"4364","14754","2019",450,59,391,129241.724444444,3068.44222222222,41.6422222222222
"4365","14755","2019",34,22,12,232865.470588235,2649.61764705882,81.5882352941177
"4366","14756","2019",3,3,0,113333.333333333,1092.33333333333,104.333333333333
"4367","14758","2019",10,10,0,353300,2376.8,152.8
"4368","14759","2019",3,3,0,120500,1710,81.3333333333333
"4369","14760","2019",8,8,0,156561.25,1596.875,105
"4370","14761","2019",11,11,0,191454.545454545,2044.90909090909,95.4545454545455
"4371","14762","2019",217,154,63,120463.239631336,1311.65437788018,92.1935483870968
"4372","14764","2019",11,11,0,97663.6363636364,910,111.818181818182
"4373","15001","2019",10,9,1,100882,941.4,97.8
"4374","15002","2019",1,1,0,103000,1030,100
"4375","15003","2019",7,7,0,73214.2857142857,1108.28571428571,61.5714285714286
"4376","15004","2019",1,1,0,129700,1663,78
"4377","15005","2019",1,1,0,80000,1951,41
"4378","15006","2019",6,6,0,90333.3333333333,901.333333333333,91.8333333333333
"4379","15007","2019",1,1,0,30000,341,88
"4380","15008","2019",8,8,0,74937.5,827.625,91.875
"4381","15009","2019",2,2,0,73370,1296,53
"4382","15011","2019",3,3,0,119200,1329.66666666667,88
"4383","15012","2019",63,44,19,118867.650793651,1380.92063492063,86.6666666666667
"4384","15013","2019",2,2,0,39160,649,62.5
"4385","15014","2019",426,112,314,98616.2417840376,1288.52816901408,75.669014084507
"4386","15015","2019",2,2,0,39250,722,56.5
"4387","15016","2019",6,6,0,90450,1090.16666666667,85.3333333333333
"4388","15017","2019",3,3,0,75666.6666666667,1034.66666666667,71
"4389","15018","2019",1,1,0,26500,491,54
"4390","15019","2019",2,2,0,37500,678.5,69
"4391","15020","2019",4,3,1,100657.5,1076,95.5
"4392","15021","2019",10,10,0,94739.6,1071.7,80.6
"4393","15022","2019",4,3,1,65250,798,78.25
"4394","15024","2019",3,3,0,36333.3333333333,487,75.6666666666667
"4395","15025","2019",2,1,1,76250,1281.5,60.5
"4396","15026","2019",1,1,0,68000,944,72
"4397","15027","2019",6,6,0,152666.666666667,1193.5,125.833333333333
"4398","15028","2019",10,10,0,150422.2,1401.9,104.9
"4399","15029","2019",5,5,0,152679.2,1793.4,83.6
"4400","15030","2019",4,4,0,96587.5,1090.5,90
"4401","15033","2019",3,3,0,55236.6666666667,1516,77.6666666666667
"4402","15034","2019",1,1,0,130000,765,170
"4403","15036","2019",3,3,0,78800,835.333333333333,86.6666666666667
"4404","15037","2019",6,5,1,66663.3333333333,952.5,74.6666666666667
"4405","15038","2019",12,12,0,103569.166666667,1125.08333333333,91.3333333333333
"4406","15040","2019",1,1,0,20500,342,60
"4407","15041","2019",2,2,0,149650,1324.5,113.5
"4408","15042","2019",2,2,0,93750,922,109
"4409","15045","2019",10,9,1,86430.5,868.5,98.6
"4410","15046","2019",1,1,0,40000,364,110
"4411","15049","2019",6,6,0,63461.6666666667,1251,61
"4412","15050","2019",3,3,0,151940,1851,87.6666666666667
"4413","15051","2019",2,2,0,54000,515,102.5
"4414","15052","2019",3,3,0,71880,687.666666666667,93.3333333333333
"4415","15053","2019",3,3,0,104100,1539,68.3333333333333
"4416","15054","2019",9,8,1,113127.777777778,1021.55555555556,109.555555555556
"4417","15055","2019",3,3,0,170916.666666667,1596,107.333333333333
"4418","15056","2019",5,5,0,176440.4,1704.2,102.8
"4419","15057","2019",4,4,0,61732.5,840,73.75
"4420","15058","2019",4,4,0,54425,662.75,88.75
"4421","15059","2019",2,2,0,142378,1668.5,87.5
"4422","15061","2019",5,5,0,104168,1420.4,90.2
"4423","15063","2019",3,3,0,30666.6666666667,738,50
"4424","15065","2019",1,1,0,45000,469,96
"4425","15066","2019",6,6,0,109829.166666667,1237.5,113.5
"4426","15067","2019",4,4,0,85175.5,1203.25,82.5
"4427","15069","2019",6,6,0,66358.3333333333,716.166666666667,87.5
"4428","15070","2019",2,2,0,80250,663.5,121
"4429","15072","2019",3,3,0,151143,1119,120.333333333333
"4430","15074","2019",5,5,0,221240,1959.8,111.2
"4431","15076","2019",3,3,0,112216.666666667,1075.33333333333,117
"4432","15077","2019",1,1,0,57250,716,80
"4433","15078","2019",1,1,0,124700,2227,56
"4434","15079","2019",8,8,0,104302.5,1014.375,104.875
"4435","15080","2019",1,1,0,33000,367,90
"4436","15081","2019",2,2,0,210135,1158.5,158.5
"4437","15082","2019",3,3,0,142866.666666667,1042,103
"4438","15083","2019",30,30,0,121834.7,1331.03333333333,92.9666666666667
"4439","15084","2019",2,2,0,1e+05,914.5,106
"4440","15085","2019",6,6,0,114183.333333333,1301.16666666667,87.5
"4441","15087","2019",2,2,0,74500,792,94
"4442","15088","2019",8,8,0,151176.5,1369.625,102.25
"4443","15089","2019",2,2,0,61250,677.5,90
"4444","15090","2019",5,5,0,132586,1470,93
"4445","15091","2019",1,1,0,155000,1409,110
"4446","15092","2019",10,10,0,87870,1099.8,80.3
"4447","15093","2019",2,2,0,195487.5,1817.5,104
"4448","15094","2019",3,3,0,66666.6666666667,786.666666666667,75.6666666666667
"4449","15095","2019",5,5,0,126820,1175.4,98.2
"4450","15096","2019",1,1,0,32000,914,35
"4451","15097","2019",3,3,0,67666.6666666667,640,89.3333333333333
"4452","15101","2019",34,2,32,73236.2647058823,2544.29411764706,31.2941176470588
"4453","15102","2019",3,3,0,56333.3333333333,1136,54.3333333333333
"4454","15103","2019",2,2,0,72500,1238.5,57.5
"4455","15104","2019",4,4,0,101487.5,1075.25,95.5
"4456","15106","2019",5,5,0,86500,863,95.6
"4457","15108","2019",10,8,2,102035.9,1456.8,76.4
"4458","15110","2019",2,2,0,42500,382,113
"4459","15112","2019",1,1,0,45000,1000,45
"4460","15113","2019",4,4,0,101750,1480.25,73.5
"4461","15114","2019",5,5,0,73220,1074.6,79.8
"4462","15116","2019",2,2,0,94000,2107,65
"4463","15117","2019",6,5,1,59166.6666666667,1078.16666666667,55.3333333333333
"4464","15118","2019",6,6,0,135516.666666667,1349.33333333333,96.3333333333333
"4465","15119","2019",20,19,1,119448.8,1050.05,111.05
"4466","15120","2019",34,27,7,93644.1176470588,1021.58823529412,92.7647058823529
"4467","15122","2019",21,21,0,100730,1093.90476190476,106.52380952381
"4468","15123","2019",1,1,0,82000,1344,61
"4469","15124","2019",6,6,0,84666.6666666667,1027,83.5
"4470","15127","2019",3,3,0,99387.6666666667,679.666666666667,161.333333333333
"4471","15128","2019",1,1,0,151000,1348,112
"4472","15129","2019",1,1,0,49500,550,90
"4473","15130","2019",2,2,0,49090,595,89.5
"4474","15131","2019",2,2,0,85000,943,102
"4475","15132","2019",2,2,0,252500,2330,108
"4476","15134","2019",6,6,0,71533.3333333333,902.166666666667,79.5
"4477","15135","2019",1,1,0,95000,1827,52
"4478","15137","2019",4,4,0,51922.5,665,78.75
"4479","15138","2019",10,9,1,100166,1004.6,110.6
"4480","15139","2019",1,1,0,116350,771,151
"4481","15140","2019",21,21,0,140516.047619048,1615.33333333333,88.0952380952381
"4482","15141","2019",13,11,2,106336.153846154,856.769230769231,117.923076923077
"4483","15142","2019",19,19,0,126680.263157895,1083.26315789474,122.789473684211
"4484","15143","2019",1,1,0,146970,1361,108
"4485","15144","2019",3,3,0,171163.333333333,1275,138
"4486","15146","2019",2,2,0,138850,975.5,141.5
"4487","15147","2019",3,3,0,55716.6666666667,1013.66666666667,68.3333333333333
"4488","15148","2019",2,2,0,97000,928,92.5
"4489","15149","2019",4,4,0,132725,1815.5,66.75
"4490","15151","2019",1,0,1,58000,892,65
"4491","15152","2019",7,7,0,71201.4285714286,827.571428571429,87
"4492","15153","2019",19,19,0,75613.4736842105,836.789473684211,91.8421052631579
"4493","15154","2019",10,10,0,126284.8,1397.4,91.6
"4494","15155","2019",1,1,0,17500,417,42
"4495","15156","2019",5,5,0,146253.8,1346.6,103.2
"4496","15157","2019",3,3,0,81666.6666666667,855.333333333333,91.3333333333333
"4497","15159","2019",2,2,0,90250,925.5,96
"4498","15160","2019",9,9,0,157200,1312.22222222222,115.666666666667
"4499","15161","2019",1,1,0,18000,360,50
"4500","15162","2019",27,20,7,85127.7777777778,992.407407407407,84.2592592592593
"4501","15163","2019",11,11,0,129527.272727273,1240.81818181818,95.2727272727273
"4502","15164","2019",4,4,0,134445,1413,97.5
"4503","15165","2019",1,1,0,120000,1412,85
"4504","15168","2019",5,5,0,105800,2211.2,86.4
"4505","15169","2019",9,9,0,106533.333333333,1114,100.444444444444
"4506","15170","2019",1,1,0,66300,947,70
"4507","15173","2019",2,2,0,33365,689.5,48.5
"4508","15175","2019",16,16,0,135803.5625,1249.5,108.625
"4509","15176","2019",2,2,0,46500,605,76.5
"4510","15178","2019",1,1,0,130000,1477,88
"4511","15179","2019",5,5,0,104548,1196.8,93
"4512","15180","2019",2,2,0,136770.5,1883.5,82
"4513","15181","2019",8,7,1,102437.5,1026.625,98.5
"4514","15182","2019",1,1,0,40000,357,112
"4515","15184","2019",5,5,0,95010,1443,76.4
"4516","15185","2019",4,4,0,80750,846,103.75
"4517","15186","2019",4,4,0,85375,725,109
"4518","15187","2019",56,30,26,109051.464285714,1370.57142857143,83.0178571428571
"4519","15188","2019",8,8,0,149850,1500.375,101
"4520","15189","2019",8,8,0,109607.5,1218.375,91.25
"4521","15190","2019",1,1,0,17000,486,35
"4522","15191","2019",8,8,0,83199.625,967.375,88.5
"4523","15192","2019",13,8,5,118991.615384615,2177.92307692308,65.7692307692308
"4524","15194","2019",1,1,0,97000,1426,68
"4525","15196","2019",15,14,1,128057.133333333,1436.93333333333,86.8666666666667
"4526","15199","2019",1,1,0,154000,2333,66
"4527","15200","2019",3,3,0,87433.3333333333,947.333333333333,90.6666666666667
"4528","15202","2019",9,9,0,97139.1111111111,978.555555555556,98.5555555555556
"4529","15203","2019",3,3,0,76900,902.333333333333,87.6666666666667
"4530","15204","2019",18,18,0,149347.777777778,1530.27777777778,97.0555555555556
"4531","15205","2019",7,7,0,51550,862.857142857143,65.8571428571429
"4532","15206","2019",1,1,0,55000,696,79
"4533","15207","2019",3,3,0,55000,702,73.6666666666667
"4534","15208","2019",5,5,0,161800,1286,107.8
"4535","15209","2019",2,2,0,22250,910.5,24.5
"4536","15211","2019",3,3,0,97356.6666666667,1297,103
"4537","15212","2019",6,6,0,74305.3333333333,728.5,101.333333333333
"4538","15213","2019",1,1,0,81705,908,90
"4539","15214","2019",1,1,0,73943,913,81
"4540","15215","2019",12,12,0,152737.5,1524,98.3333333333333
"4541","15216","2019",8,8,0,57187.5,1340.625,49
"4542","15218","2019",2,2,0,103100,1157,88
"4543","15219","2019",3,3,0,167666.666666667,1331.66666666667,113
"4544","15220","2019",2,2,0,151750,1567.5,92.5
"4545","15221","2019",11,11,0,179672.727272727,1605.27272727273,115
"4546","15223","2019",1,1,0,135514,874,155
"4547","15224","2019",2,2,0,68000,722.5,97
"4548","15225","2019",4,4,0,40000,649,60.25
"4549","15226","2019",3,3,0,84933.3333333333,1228,68.6666666666667
"4550","15228","2019",2,2,0,88180,1012.5,80.5
"4551","15231","2019",2,2,0,91575,1086,80.5
"4552","15232","2019",3,3,0,82166.6666666667,816.666666666667,101.333333333333
"4553","15234","2019",2,2,0,132050,1227,104.5
"4554","15235","2019",5,5,0,139936,1370.4,108.6
"4555","15236","2019",9,8,1,108322.222222222,2524,79
"4556","15238","2019",2,2,0,64750,525,125
"4557","15240","2019",3,3,0,124883.333333333,1299.66666666667,97.3333333333333
"4558","15241","2019",1,1,0,50000,510,98
"4559","15242","2019",1,1,0,35000,686,51
"4560","15243","2019",11,10,1,63727.2727272727,792.363636363636,79.1818181818182
"4561","15244","2019",4,4,0,113887.5,1090,101
"4562","15245","2019",1,1,0,80000,1000,80
"4563","15248","2019",7,7,0,98357.1428571429,1225.85714285714,84.2857142857143
"4564","15249","2019",1,1,0,24800,551,45
"4565","15250","2019",6,6,0,116863.333333333,1254.16666666667,93.3333333333333
"4566","15251","2019",1,1,0,70000,714,98
"4567","15252","2019",4,4,0,152250,1191.25,130
"4568","15254","2019",2,2,0,97500,1047,95
"4569","15255","2019",10,10,0,150241,1723.6,87.8
"4570","15256","2019",1,1,0,48500,1212,40
"4571","15257","2019",1,1,0,50500,481,105
"4572","15258","2019",26,19,7,100588.961538462,1082.11538461538,91.8846153846154
"4573","15259","2019",2,2,0,120050,1260.5,95.5
"4574","15260","2019",2,2,0,175160,2201.5,85
"4575","15261","2019",10,10,0,81521.4,1109.7,72.3
"4576","15262","2019",5,5,0,138632,1550.2,99.4
"4577","15263","2019",2,2,0,72500,723.5,102.5
"4578","15264","2019",2,2,0,125500,1768.5,73.5
"4579","15265","2019",11,10,1,62243.6363636364,822.818181818182,76
"4580","15266","2019",3,3,0,117180,1379,83.3333333333333
"4581","15267","2019",40,39,1,166217.95,1721.5,97.7
"4582","15268","2019",18,17,1,137603.888888889,1253.11111111111,110.722222222222
"4583","15269","2019",3,3,0,49566.6666666667,866,60.3333333333333
"4584","16001","2019",5,5,0,59500,729,89
"4585","16002","2019",5,5,0,136000,1281,106.6
"4586","16003","2019",10,10,0,105820,1143.8,91
"4587","16005","2019",20,20,0,91234.4,895.3,101.45
"4588","16007","2019",5,5,0,63832,785,75.8
"4589","16008","2019",7,7,0,124000,928.857142857143,135
"4590","16009","2019",3,3,0,86689.3333333333,952.333333333333,89
"4591","16011","2019",6,6,0,133716.666666667,1285.16666666667,108
"4592","16012","2019",4,4,0,140950,1170,122.75
"4593","16013","2019",4,4,0,216000,1593.75,126.25
"4594","16014","2019",2,2,0,1e+05,1046,90
"4595","16015","2019",786,487,299,116945.438931298,1447.65776081425,82.8180661577608
"4596","16016","2019",11,11,0,89254.5454545455,925.545454545455,97.0909090909091
"4597","16018","2019",7,7,0,252042.857142857,1712.57142857143,142.428571428571
"4598","16019","2019",23,23,0,145241.304347826,1302.26086956522,111
"4599","16020","2019",10,9,1,155400,1729.5,109.6
"4600","16023","2019",11,11,0,119435.454545455,950.727272727273,124.090909090909
"4601","16024","2019",10,10,0,100355,1155.7,89.1
"4602","16025","2019",9,9,0,136411.111111111,1221,122.222222222222
"4603","16026","2019",10,10,0,190932,1446.6,130
"4604","16027","2019",5,5,0,111900,773.6,140.4
"4605","16028","2019",56,55,1,122028.035714286,1103.94642857143,110.803571428571
"4606","16029","2019",4,4,0,130300,864.75,155
"4607","16030","2019",8,8,0,165677.5,1779.75,98
"4608","16031","2019",6,6,0,187014,1251,148.666666666667
"4609","16032","2019",7,7,0,141328.571428571,1114.14285714286,141.857142857143
"4610","16034","2019",3,3,0,74000,1007.33333333333,68.6666666666667
"4611","16035","2019",5,5,0,86860,809.8,101.6
"4612","16036","2019",4,4,0,143425.25,1377,109.75
"4613","16037","2019",4,4,0,93000,874,112
"4614","16038","2019",7,7,0,89432.8571428571,1023.57142857143,98.8571428571429
"4615","16039","2019",2,2,0,82500,881.5,96.5
"4616","16040","2019",5,5,0,121000,1261.4,105.2
"4617","16041","2019",2,2,0,93575,1003.5,102
"4618","16042","2019",2,2,0,139000,1010.5,143
"4619","16044","2019",2,2,0,49000,757,63
"4620","16045","2019",5,5,0,185880,1425.4,129.2
"4621","16046","2019",4,4,0,115000,1052.25,112
"4622","16047","2019",3,3,0,93566.6666666667,984.666666666667,94.6666666666667
"4623","16049","2019",5,5,0,78480,1301.8,66.8
"4624","16050","2019",1,1,0,40000,769,52
"4625","16052","2019",2,1,1,258458,1921.5,120.5
"4626","16053","2019",2,2,0,118000,1340.5,88
"4627","16054","2019",1,1,0,66000,667,99
"4628","16055","2019",3,3,0,134680.666666667,1320,102
"4629","16056","2019",11,11,0,134909.545454545,1142.90909090909,119.727272727273
"4630","16057","2019",1,1,0,237000,1185,200
"4631","16058","2019",25,25,0,169913,1492.16,114.32
"4632","16059","2019",3,3,0,84500,1045.66666666667,82
"4633","16060","2019",4,4,0,123122.5,902,135.75
"4634","16061","2019",28,28,0,141052.857142857,1537.64285714286,90.2142857142857
"4635","16062","2019",2,2,0,122500,2504.5,48
"4636","16063","2019",1,1,0,160000,1119,143
"4637","16064","2019",12,12,0,103922.666666667,989.333333333333,109.5
"4638","16065","2019",7,7,0,96142.8571428571,877.428571428571,99.5714285714286
"4639","16066","2019",13,13,0,152663.615384615,1143.23076923077,134.230769230769
"4640","16067","2019",7,7,0,120414.285714286,1140.57142857143,105.428571428571
"4641","16068","2019",9,9,0,119765.555555556,1001.11111111111,129.777777777778
"4642","16069","2019",8,8,0,64298.75,811.25,81
"4643","16070","2019",21,20,1,100049.857142857,853.666666666667,114
"4644","16071","2019",10,10,0,105350,1177.5,83.5
"4645","16072","2019",5,5,0,135354,927.8,149
"4646","16073","2019",21,20,1,84223.9523809524,840.857142857143,99.1428571428571
"4647","16074","2019",6,6,0,114466.666666667,1262.66666666667,96.1666666666667
"4648","16076","2019",11,11,0,129322.727272727,1387.09090909091,103.181818181818
"4649","16077","2019",6,6,0,182086.666666667,1287.16666666667,133
"4650","16078","2019",60,59,1,165333.4,1488.21666666667,110.866666666667
"4651","16079","2019",5,5,0,140300,1335.2,104
"4652","16081","2019",4,4,0,78750,862.25,96.5
"4653","16082","2019",3,3,0,185616.666666667,1301.33333333333,137.333333333333
"4654","16083","2019",2,2,0,110500,985.5,111
"4655","16084","2019",8,6,2,132675,1438.25,93.625
"4656","16085","2019",41,41,0,97037.9024390244,950.243902439024,104.365853658537
"4657","16086","2019",24,24,0,84457.5,947,87.75
"4658","16087","2019",6,6,0,73133.3333333333,877.833333333333,87.1666666666667
"4659","16088","2019",19,19,0,134574.473684211,1154.36842105263,117.578947368421
"4660","16089","2019",48,46,2,151126.041666667,1554.3125,98.4166666666667
"4661","16090","2019",51,50,1,130232.352941176,1182.05882352941,115.490196078431
"4662","16091","2019",2,2,0,85000,781,106
"4663","16093","2019",24,24,0,133589,1153.70833333333,116.375
"4664","16096","2019",9,9,0,142577.777777778,1142.66666666667,123.333333333333
"4665","16097","2019",22,22,0,140046.590909091,1365.13636363636,103.545454545455
"4666","16098","2019",2,2,0,85000,753,114.5
"4667","16099","2019",3,3,0,132666.666666667,685.666666666667,189.333333333333
"4668","16100","2019",10,10,0,110460,919,129.6
"4669","16101","2019",13,13,0,177567.692307692,1490.15384615385,120.769230769231
"4670","16102","2019",342,271,71,124200.447368421,1408.43859649123,89.4795321637427
"4671","16103","2019",3,3,0,124266.666666667,1897.66666666667,64.6666666666667
"4672","16104","2019",6,6,0,152700,1153.5,119.333333333333
"4673","16105","2019",8,8,0,139450,899.25,148.25
"4674","16106","2019",35,33,2,82845.2,902.828571428571,99.1714285714286
"4675","16107","2019",10,10,0,91231,1022.7,91.9
"4676","16108","2019",1,1,0,105000,1346,78
"4677","16109","2019",10,10,0,153526,1088.1,144.5
"4678","16110","2019",8,8,0,167544.625,1075.625,156.25
"4679","16111","2019",2,2,0,97500,808,114.5
"4680","16112","2019",1,1,0,92000,1150,80
"4681","16113","2019",73,71,2,130241.205479452,1378.1095890411,93.5479452054795
"4682","16114","2019",2,2,0,58500,848,66.5
"4683","16116","2019",3,3,0,140241.666666667,777.333333333333,181.666666666667
"4684","16118","2019",3,3,0,34266.6666666667,468.666666666667,81.6666666666667
"4685","16119","2019",17,17,0,111587.470588235,1108.52941176471,101.058823529412
"4686","16120","2019",15,15,0,172860.266666667,1737.26666666667,103.466666666667
"4687","16121","2019",9,9,0,151252.222222222,1297.33333333333,115.777777777778
"4688","16123","2019",6,6,0,139401.666666667,1178.66666666667,119.5
"4689","16124","2019",21,21,0,99561.5714285714,1076.80952380952,97.6666666666667
"4690","16125","2019",3,3,0,135465,2424.33333333333,97.3333333333333
"4691","16127","2019",2,2,0,164378,1169.5,127.5
"4692","16128","2019",2,2,0,138950,1475,83
"4693","16131","2019",5,5,0,67024,752.8,88.8
"4694","16132","2019",4,4,0,101500,940,104.75
"4695","16133","2019",3,3,0,120416.666666667,1174.66666666667,104.666666666667
"4696","16134","2019",12,12,0,92243.25,919.75,95.5
"4697","16135","2019",2,2,0,62850,561,111.5
"4698","16136","2019",8,8,0,82125,1024.875,80.5
"4699","16137","2019",4,4,0,149250,1406.5,108
"4700","16138","2019",40,37,3,143009,1458.7,97.95
"4701","16139","2019",1,1,0,57200,609,94
"4702","16140","2019",5,5,0,117320,1054.4,110.4
"4703","16141","2019",4,4,0,106075,1205.25,89.5
"4704","16142","2019",1,1,0,146226,1083,135
"4705","16143","2019",7,7,0,171515.714285714,1496.14285714286,116.428571428571
"4706","16144","2019",9,9,0,71844.4444444444,764.333333333333,92.5555555555556
"4707","16145","2019",5,5,0,107240,1130.6,114.4
"4708","16146","2019",18,18,0,169047.777777778,1508.38888888889,115.111111111111
"4709","16147","2019",4,4,0,107637.5,930.25,119.75
"4710","16148","2019",17,17,0,101405.294117647,942.764705882353,114.705882352941
"4711","16150","2019",18,18,0,252689.166666667,1482.55555555556,175.444444444444
"4712","16151","2019",9,9,0,171277.777777778,1340.55555555556,134.111111111111
"4713","16152","2019",5,5,0,153200,1425,109
"4714","16153","2019",12,12,0,154637.5,1399.5,112.25
"4715","16154","2019",112,104,8,116398.125,1349.95535714286,85.8125
"4716","16155","2019",1,1,0,35000,350,100
"4717","16157","2019",1,1,0,276000,1551,178
"4718","16158","2019",7,7,0,125692.857142857,922.571428571429,128.857142857143
"4719","16160","2019",1,1,0,295000,1229,240
"4720","16161","2019",2,2,0,89500,939.5,95.5
"4721","16162","2019",1,1,0,825000,3161,261
"4722","16163","2019",8,8,0,126562.5,1273.5,98.375
"4723","16164","2019",1,1,0,84700,605,140
"4724","16165","2019",7,7,0,95900,760.428571428571,128.285714285714
"4725","16166","2019",83,75,8,135221.710843373,1424.18072289157,92.8915662650602
"4726","16167","2019",77,76,1,134310.025974026,1278.53246753247,103.272727272727
"4727","16168","2019",16,16,0,150323.625,1283.4375,120.5
"4728","16169","2019",12,11,1,115025,1241.25,92.1666666666667
"4729","16170","2019",6,6,0,131333.333333333,1110.83333333333,114.833333333333
"4730","16171","2019",9,9,0,137902.222222222,1222.66666666667,129.222222222222
"4731","16173","2019",2,2,0,95150,956.5,102.5
"4732","16174","2019",4,4,0,342177.25,2476.25,133.75
"4733","16175","2019",9,9,0,137229,1131.66666666667,123.111111111111
"4734","16176","2019",2,2,0,153300,1083.5,141
"4735","16177","2019",1,1,0,60000,652,92
"4736","16178","2019",1,1,0,115000,1369,84
"4737","16180","2019",3,3,0,235833.333333333,1816,130.666666666667
"4738","16181","2019",9,9,0,47366.6666666667,770.666666666667,70.1111111111111
"4739","16182","2019",5,5,0,78788,646.4,122
"4740","16183","2019",7,7,0,84566,857.857142857143,102
"4741","16184","2019",1,1,0,140000,1102,127
"4742","16185","2019",2,2,0,55093.5,592,82.5
"4743","16186","2019",5,5,0,124660,1100.2,114.6
"4744","16187","2019",25,25,0,131897.28,1421.04,97.08
"4745","16188","2019",9,9,0,78212.8888888889,957.888888888889,84.1111111111111
"4746","16189","2019",2,2,0,163500,1072,142.5
"4747","16190","2019",4,4,0,107255,921,122
"4748","16191","2019",2,2,0,115150,1545.5,73.5
"4749","16192","2019",34,33,1,91998.4411764706,900.382352941176,97.6176470588235
"4750","16193","2019",10,10,0,130299,1299.7,99.6
"4751","16194","2019",3,3,0,144597,1265.33333333333,104.666666666667
"4752","16195","2019",1,1,0,96000,671,143
"4753","16196","2019",13,13,0,103365.384615385,1020.84615384615,103.230769230769
"4754","16197","2019",2,2,0,109900,684.5,165
"4755","16198","2019",4,4,0,110250,1093,104.25
"4756","16199","2019",45,45,0,135477.133333333,1409.02222222222,99.0444444444445
"4757","16200","2019",6,6,0,134833.333333333,1524,93.3333333333333
"4758","16203","2019",1,1,0,55000,724,76
"4759","16204","2019",11,11,0,147281.818181818,1019.36363636364,135.181818181818
"4760","16205","2019",5,5,0,91836,1053.6,88.8
"4761","16206","2019",28,28,0,113371.607142857,1058.46428571429,107.892857142857
"4762","16207","2019",8,8,0,107737.5,992.75,100
"4763","16208","2019",5,5,0,126870,1276,93.6
"4764","16209","2019",9,9,0,128783.333333333,1015.22222222222,120
"4765","16210","2019",16,16,0,127171.875,1073.5,115.25
"4766","16211","2019",5,5,0,178870,1143,160.2
"4767","16212","2019",4,4,0,48950,684,76.75
"4768","16213","2019",7,7,0,84139,822.714285714286,92.1428571428571
"4769","16215","2019",3,3,0,202607.333333333,1408.33333333333,139.333333333333
"4770","16216","2019",8,8,0,188642.25,1485.75,138.625
"4771","16217","2019",20,20,0,137610,1474.45,96.55
"4772","16218","2019",1,1,0,55000,604,91
"4773","16220","2019",5,5,0,129640,1241,100.8
"4774","16221","2019",4,4,0,85875,1105.5,99.25
"4775","16222","2019",5,5,0,107060,1277.4,88.8
"4776","16223","2019",31,31,0,102602.483870968,974.58064516129,106.935483870968
"4777","16224","2019",6,6,0,177027.833333333,1129.5,153.333333333333
"4778","16225","2019",4,4,0,139212.5,1405.25,81
"4779","16226","2019",7,6,1,120151.428571429,1398.85714285714,91.4285714285714
"4780","16227","2019",5,3,2,147491.4,1932.6,82.6
"4781","16229","2019",4,4,0,71036.25,1012,77.25
"4782","16230","2019",28,28,0,117755.357142857,964.607142857143,120.214285714286
"4783","16231","2019",3,3,0,50166.6666666667,814,60.6666666666667
"4784","16232","2019",29,29,0,153293.103448276,1302,118.551724137931
"4785","16233","2019",4,4,0,180550,1317.25,152.75
"4786","16234","2019",11,11,0,188650,1475.81818181818,128.818181818182
"4787","16236","2019",16,16,0,136190.9375,1389.0625,97.625
"4788","16237","2019",5,5,0,64380,1111,76.8
"4789","16239","2019",3,3,0,124433.333333333,758.333333333333,150.666666666667
"4790","16240","2019",3,3,0,267363.333333333,1896,136.666666666667
"4791","16241","2019",1,1,0,183000,943,194
"4792","16242","2019",26,26,0,107625.038461538,926.423076923077,117.461538461538
"4793","16243","2019",15,15,0,157981.4,1273.93333333333,124.4
"4794","16244","2019",34,33,1,133048.970588235,1316.67647058824,100.117647058824
"4795","16245","2019",9,9,0,86733.3333333333,1159.77777777778,89
"4796","16246","2019",1,1,0,220000,1302,169
"4797","16249","2019",4,4,0,121500,1218.5,94.5
"4798","16250","2019",4,4,0,113950,960.75,109.75
"4799","16251","2019",3,3,0,148586.666666667,1057.66666666667,135
"4800","16252","2019",1,1,0,258734,2512,103
"4801","16253","2019",7,7,0,128442.857142857,1216,110.571428571429
"4802","16254","2019",5,5,0,142884.8,1157.8,142.6
"4803","16255","2019",3,3,0,112936.666666667,1136.66666666667,92
"4804","16256","2019",1,1,0,88000,587,150
"4805","16258","2019",3,3,0,194600,2872,77.3333333333333
"4806","16260","2019",3,3,0,94834.3333333333,1478.33333333333,59
"4807","16261","2019",5,5,0,143920,1343,126.6
"4808","16263","2019",4,4,0,100250,896.25,112.25
"4809","16264","2019",6,6,0,78066.6666666667,903.5,88
"4810","16268","2019",5,5,0,143208.6,961.4,141.6
"4811","16269","2019",12,12,0,128187.083333333,1290.16666666667,100.75
"4812","16270","2019",6,6,0,140797.5,936.833333333333,147
"4813","16271","2019",16,16,0,205728.75,1661.125,122.0625
"4814","16272","2019",11,11,0,149900,1261,124.454545454545
"4815","16273","2019",3,3,0,40500,554.666666666667,74.6666666666667
"4816","16275","2019",5,5,0,93584,995,112
"4817","16276","2019",8,8,0,111083.75,1052.5,100.25
"4818","16277","2019",11,11,0,160913.181818182,1345.27272727273,120.181818181818
"4819","16279","2019",4,4,0,101050,1220.5,85.5
"4820","16280","2019",18,18,0,131083.444444444,1270.33333333333,101.5
"4821","16281","2019",53,48,5,114227.188679245,1226.2641509434,98.811320754717
"4822","16282","2019",7,7,0,139600,1240.14285714286,106.571428571429
"4823","16283","2019",5,5,0,131595,1273.2,103
"4824","16285","2019",6,6,0,111166.666666667,989.5,109.166666666667
"4825","16286","2019",38,38,0,114832.552631579,1049.34210526316,113.973684210526
"4826","16287","2019",43,43,0,142096.046511628,1368,105.883720930233
"4827","16289","2019",5,5,0,148093.8,981.4,128.8
"4828","16290","2019",3,3,0,229166.666666667,1187.66666666667,192
"4829","16291","2019",110,109,1,106724.036363636,1265.70909090909,85.8
"4830","16292","2019",44,44,0,87825.0454545455,922.022727272727,97.3863636363636
"4831","16293","2019",8,8,0,104618.75,1137.625,89
"4832","16295","2019",18,18,0,132686.722222222,1174.33333333333,115.611111111111
"4833","16297","2019",2,2,0,103745,1096,90
"4834","16298","2019",5,5,0,133360,1230.8,113
"4835","16300","2019",16,16,0,127928.125,1228.0625,102.625
"4836","16302","2019",3,3,0,99833.3333333333,1009.66666666667,96.6666666666667
"4837","16303","2019",6,6,0,147196.666666667,1214.33333333333,122.333333333333
"4838","16304","2019",24,24,0,213290.833333333,1679.5,126.375
"4839","16306","2019",7,7,0,59987.1428571429,940.428571428571,85.8571428571429
"4840","16307","2019",3,3,0,83100,950.333333333333,84
"4841","16308","2019",14,14,0,107846.357142857,880.285714285714,124
"4842","16312","2019",5,5,0,146999.4,1261.2,119.8
"4843","16315","2019",2,2,0,101727.5,720,137
"4844","16316","2019",2,2,0,97500,1053,99.5
"4845","16317","2019",7,7,0,85658.1428571429,765.428571428571,110.428571428571
"4846","16318","2019",7,7,0,118600,1040.42857142857,119
"4847","16320","2019",11,11,0,109150,1002.18181818182,109.727272727273
"4848","16323","2019",5,5,0,188080,1878.6,102.8
"4849","16325","2019",3,3,0,87333.3333333333,757.666666666667,115
"4850","16326","2019",4,4,0,162687.5,1414.25,120.75
"4851","16329","2019",9,9,0,108000,1192.55555555556,94.4444444444444
"4852","16330","2019",8,8,0,154312.5,1194.5,131.25
"4853","16334","2019",2,2,0,134250,1090.5,125
"4854","16335","2019",2,2,0,112500,969,115
"4855","16336","2019",2,2,0,100250,986,100.5
"4856","16337","2019",14,14,0,119875,917.857142857143,115.571428571429
"4857","16338","2019",3,3,0,135306.666666667,1243.66666666667,133.333333333333
"4858","16339","2019",7,7,0,76087.5714285714,856.285714285714,84.7142857142857
"4859","16340","2019",16,16,0,172341.5,1189.875,138.375
"4860","16341","2019",53,43,10,107780.377358491,1281.33962264151,84.188679245283
"4861","16342","2019",5,5,0,153600,1143.8,129.2
"4862","16343","2019",4,4,0,123375,739.25,171.5
"4863","16346","2019",4,4,0,92497.25,776,121
"4864","16347","2019",8,8,0,142097.5,1132.625,132.25
"4865","16348","2019",17,17,0,288175.235294118,2485.94117647059,120.117647058824
"4866","16349","2019",7,7,0,109142.857142857,942.285714285714,114
"4867","16350","2019",14,14,0,100522.071428571,959.714285714286,108.071428571429
"4868","16352","2019",2,2,0,89500,931,95
"4869","16353","2019",8,8,0,91212.5,998.125,90.125
"4870","16354","2019",2,2,0,108875,1013,110.5
"4871","16355","2019",16,16,0,163483.125,1174.0625,140.25
"4872","16356","2019",1,1,0,40000,364,110
"4873","16357","2019",1,1,0,388000,1252,310
"4874","16358","2019",87,85,2,162995.126436782,1571.72413793103,103.103448275862
"4875","16359","2019",11,11,0,162704.545454545,1400.09090909091,112.636363636364
"4876","16361","2019",3,3,0,169750,1052,155.333333333333
"4877","16362","2019",4,4,0,153170.5,1244.75,112.75
"4878","16363","2019",8,8,0,110484.125,965.375,108.875
"4879","16366","2019",25,25,0,131757.92,1273.92,102.48
"4880","16368","2019",8,8,0,114537.5,1063.125,113.125
"4881","16369","2019",11,11,0,150372.727272727,1272.63636363636,119.272727272727
"4882","16370","2019",5,5,0,116582,1368,89.6
"4883","16372","2019",3,3,0,103500,1173.33333333333,88
"4884","16373","2019",1,1,0,281000,2007,140
"4885","16374","2019",139,118,21,115136.079136691,1336.20863309353,87.9496402877698
"4886","16375","2019",9,9,0,106488.666666667,980.444444444444,111.888888888889
"4887","16377","2019",1,1,0,223000,1115,200
"4888","16378","2019",3,3,0,99000,815,130.333333333333
"4889","16379","2019",22,22,0,111772.227272727,1078.09090909091,107.181818181818
"4890","16380","2019",4,4,0,131812.5,1052.5,112.75
"4891","16381","2019",2,2,0,107500,741.5,145
"4892","16382","2019",7,7,0,194678.571428571,1486.85714285714,130.571428571429
"4893","16383","2019",7,7,0,108400,1171.28571428571,92.2857142857143
"4894","16384","2019",10,10,0,94232,856,106.6
"4895","16385","2019",16,16,0,154919.375,1479.1875,103.9375
"4896","16387","2019",11,11,0,185163.181818182,1516.54545454545,125.909090909091
"4897","16388","2019",11,11,0,198490.909090909,1638.27272727273,127.909090909091
"4898","16390","2019",1,1,0,52000,743,70
"4899","16392","2019",2,2,0,64150,829,75.5
"4900","16393","2019",34,33,1,132635.558823529,1178,117.088235294118
"4901","16394","2019",2,2,0,168700,1691,100.5
"4902","16395","2019",4,4,0,126375,1122.5,123.75
"4903","16396","2019",1,1,0,75000,536,140
"4904","16397","2019",5,5,0,92024,812.4,113
"4905","16398","2019",1,1,0,139045,1209,115
"4906","16399","2019",1,1,0,1e+05,971,103
"4907","16400","2019",23,23,0,184907.391304348,1755.82608695652,113.565217391304
"4908","16401","2019",3,3,0,121266.666666667,1748.33333333333,78.3333333333333
"4909","16402","2019",6,6,0,116645.833333333,1271.16666666667,90.1666666666667
"4910","16403","2019",1,1,0,156050,1040,150
"4911","16404","2019",1,1,0,69613,1071,65
"4912","16406","2019",15,15,0,121873.333333333,1170.53333333333,101.866666666667
"4913","16408","2019",9,9,0,126790,1301,114.555555555556
"4914","16409","2019",8,8,0,98228.75,935.25,98.125
"4915","16412","2019",5,5,0,111100,1225,89
"4916","16413","2019",5,5,0,69880,811.8,85
"4917","16414","2019",4,4,0,89500,623,139
"4918","16415","2019",12,12,0,136341.666666667,1374.16666666667,99.75
"4919","16416","2019",9,9,0,87568.6666666667,900.222222222222,102.333333333333
"4920","16418","2019",21,21,0,144417.476190476,1315.09523809524,111.333333333333
"4921","16419","2019",5,5,0,122120,1267.8,91.8
"4922","16420","2019",2,2,0,103000,1501,68
"4923","16421","2019",3,3,0,131083.333333333,1275.66666666667,103.333333333333
"4924","16422","2019",8,8,0,140903.125,969.625,159.125
"4925","16423","2019",1,1,0,70000,490,143
"4926","16424","2019",5,5,0,83161.8,689.8,131.6
"4927","16425","2019",8,8,0,108500,1064.125,100.125
"4928","17002","2019",3,3,0,90166.6666666667,888.333333333333,109.333333333333
"4929","17003","2019",72,72,0,192780.305555556,1883.625,103.236111111111
"4930","17004","2019",6,6,0,192750,4430.16666666667,71.1666666666667
"4931","17005","2019",1,1,0,95000,655,145
"4932","17006","2019",3,3,0,151433.333333333,1127,153
"4933","17007","2019",4,4,0,188875,1699.75,112
"4934","17008","2019",33,33,0,204989.878787879,1969.24242424242,106.060606060606
"4935","17009","2019",17,17,0,235400.705882353,2141.05882352941,113.823529411765
"4936","17010","2019",60,59,1,292840.866666667,3393.01666666667,87.2666666666667
"4937","17011","2019",3,3,0,356366.666666667,2065,157.333333333333
"4938","17012","2019",6,6,0,89916.6666666667,1166.66666666667,77.5
"4939","17013","2019",4,4,0,166500,1235,129.25
"4940","17015","2019",14,14,0,173424.928571429,1614.35714285714,108.928571428571
"4941","17016","2019",13,13,0,105665.230769231,1017.15384615385,105
"4942","17017","2019",8,8,0,129643.75,1212.125,105.5
"4943","17018","2019",15,15,0,181593.333333333,1666.33333333333,111.4
"4944","17019","2019",34,32,2,481546.911764706,5671.94117647059,90.0588235294118
"4945","17020","2019",3,3,0,182666.666666667,1766.66666666667,102
"4946","17021","2019",55,50,5,189366.381818182,2023.16363636364,102.381818181818
"4947","17022","2019",11,11,0,154772.727272727,1293.36363636364,123.545454545455
"4948","17023","2019",5,5,0,88800,1079.4,81
"4949","17024","2019",30,30,0,116224.166666667,1214.9,110.666666666667
"4950","17025","2019",15,15,0,213000,1308.8,152.066666666667
"4951","17026","2019",3,3,0,153333.333333333,1247,123.333333333333
"4952","17027","2019",6,6,0,128000,1335.33333333333,97
"4953","17028","2019",188,106,82,209905.60106383,2949.1170212766,74.4893617021277
"4954","17029","2019",3,3,0,71000,1286,60
"4955","17030","2019",9,9,0,170777.777777778,1555.55555555556,110.111111111111
"4956","17031","2019",7,7,0,134855.714285714,1108,120.714285714286
"4957","17032","2019",19,19,0,199960.526315789,1764.15789473684,124.421052631579
"4958","17033","2019",5,5,0,118800,1252.2,87.6
"4959","17034","2019",10,10,0,121145,1426.5,84.7
"4960","17035","2019",1,1,0,80000,672,119
"4961","17036","2019",12,12,0,176250,1707.25,105.166666666667
"4962","17037","2019",5,5,0,69600,678.4,100.8
"4963","17038","2019",6,6,0,136625,1380.5,100.333333333333
"4964","17041","2019",26,26,0,173991.769230769,1898.34615384615,93.3076923076923
"4965","17042","2019",7,7,0,127428.571428571,1008.85714285714,129.857142857143
"4966","17043","2019",8,8,0,173487.5,1219.125,137.125
"4967","17044","2019",15,15,0,149470,1616.33333333333,96.8666666666667
"4968","17045","2019",24,23,1,143516.25,1295.20833333333,120.125
"4969","17046","2019",4,4,0,118575,1285,93
"4970","17047","2019",1,1,0,2e+05,1111,180
"4971","17048","2019",8,8,0,113125,934,123.5
"4972","17049","2019",2,2,0,148190,1100.5,135
"4973","17050","2019",13,13,0,137138.461538462,1358.38461538462,106.769230769231
"4974","17051","2019",60,60,0,660068.466666667,6330.35,105.333333333333
"4975","17052","2019",9,9,0,100905.555555556,1094.88888888889,96
"4976","17053","2019",16,16,0,120218.75,1230.625,97.625
"4977","17054","2019",3,3,0,78333.3333333333,719.333333333333,124.333333333333
"4978","17055","2019",3,3,0,134333.333333333,1061.33333333333,112.666666666667
"4979","17056","2019",7,7,0,136404.428571429,1141.42857142857,119.428571428571
"4980","17057","2019",13,13,0,203458.846153846,1651.53846153846,122.153846153846
"4981","17058","2019",67,66,1,164228.044776119,1975.50746268657,89.3731343283582
"4982","17059","2019",18,18,0,249373.611111111,2060.5,130.666666666667
"4983","17060","2019",1,1,0,288500,1898,152
"4984","17061","2019",1,1,0,125000,772,162
"4985","17062","2019",1,1,0,60000,1132,53
"4986","17063","2019",2,2,0,130000,1072.5,106.5
"4987","17064","2019",74,74,0,286286.77027027,2602.33783783784,110.378378378378
"4988","17065","2019",21,21,0,246008.142857143,2209.90476190476,117.095238095238
"4989","17066","2019",2,2,0,153750,1187.5,126
"4990","17067","2019",3,3,0,97000,844.666666666667,117
"4991","17068","2019",2,2,0,160000,986.5,152.5
"4992","17069","2019",3,3,0,137633.333333333,966.666666666667,145
"4993","17070","2019",11,11,0,126172.727272727,1191.36363636364,107.454545454545
"4994","17071","2019",7,7,0,132214.285714286,1245.85714285714,113
"4995","17072","2019",11,11,0,95363.6363636364,964,105.363636363636
"4996","17073","2019",20,20,0,161902.65,1423.35,108.95
"4997","17074","2019",12,12,0,141192.5,1469.75,97.4166666666667
"4998","17075","2019",23,23,0,179621.52173913,1553.26086956522,113.478260869565
"4999","17076","2019",9,9,0,140009.777777778,1555.77777777778,111.777777777778
"5000","17077","2019",16,16,0,118818.75,922.125,144.5625
"5001","17078","2019",7,7,0,127750,1131.14285714286,118.428571428571
"5002","17079","2019",30,30,0,204223.6,1960.03333333333,102.733333333333
"5003","17080","2019",15,15,0,183639.266666667,1528.46666666667,122.066666666667
"5004","17081","2019",9,9,0,118666.666666667,1181.22222222222,103.777777777778
"5005","17082","2019",2,2,0,126500,1289.5,114
"5006","17083","2019",12,12,0,148876.5,1175.16666666667,129.333333333333
"5007","17084","2019",12,12,0,171029.583333333,1360.08333333333,123.166666666667
"5008","17085","2019",3,3,0,147561.666666667,1131.33333333333,136
"5009","17086","2019",47,47,0,165670.531914894,1510.6170212766,115.723404255319
"5010","17087","2019",3,3,0,117666.666666667,1022,122
"5011","17089","2019",17,17,0,151391,1311.76470588235,111.941176470588
"5012","17091","2019",34,34,0,211677.647058824,1886.02941176471,118.676470588235
"5013","17092","2019",4,4,0,120299.75,961,109.75
"5014","17093","2019",97,87,10,210846.463917526,2736.58762886598,79.1958762886598
"5015","17094","2019",185,131,54,285177.675675676,3875.57837837838,77.7189189189189
"5016","17095","2019",4,4,0,144800.75,1273.5,119
"5017","17096","2019",2,2,0,109093,912.5,124
"5018","17097","2019",10,10,0,194290.4,1765.5,109.2
"5019","17098","2019",23,23,0,164938.260869565,1532.95652173913,110.739130434783
"5020","17099","2019",9,9,0,107277.777777778,1130.55555555556,93.4444444444444
"5021","17100","2019",9,9,0,97273,924,109.444444444444
"5022","17101","2019",9,9,0,81896,734.666666666667,122.666666666667
"5023","17102","2019",14,14,0,199500,1697.14285714286,121.428571428571
"5024","17104","2019",8,8,0,100481.25,1026.125,93.75
"5025","17105","2019",5,5,0,87753.4,790.8,118.2
"5026","17106","2019",7,7,0,164905.142857143,1477.28571428571,117.142857142857
"5027","17107","2019",35,35,0,204210.571428571,1794.62857142857,113.228571428571
"5028","17108","2019",8,8,0,180623.75,1608.875,113.625
"5029","17109","2019",30,27,3,232430,2304.53333333333,102.5
"5030","17110","2019",12,12,0,133141.666666667,1157.25,117.166666666667
"5031","17111","2019",12,12,0,136414.583333333,1268.16666666667,109.5
"5032","17112","2019",13,12,1,183438.461538462,1837.30769230769,102.846153846154
"5033","17113","2019",8,8,0,148489,1368.125,111.125
"5034","17114","2019",4,4,0,87400,828.75,97.25
"5035","17115","2019",7,7,0,190806.285714286,1382.85714285714,147.714285714286
"5036","17116","2019",1,1,0,213630,1594,134
"5037","17117","2019",1,1,0,66000,985,67
"5038","17118","2019",3,3,0,123306.666666667,1176.33333333333,114.333333333333
"5039","17119","2019",17,17,0,204227.058823529,1687.64705882353,121.176470588235
"5040","17120","2019",23,23,0,184909.782608696,1609.21739130435,116
"5041","17121","2019",52,48,4,590778.846153846,6040.42307692308,100.980769230769
"5042","17124","2019",8,8,0,101973.75,1011.875,101
"5043","17125","2019",10,10,0,161135.4,1202.1,136.7
"5044","17126","2019",3,3,0,92333.3333333333,1047.66666666667,87.3333333333333
"5045","17127","2019",59,51,8,145730.101694915,1447.89830508475,97.7796610169491
"5046","17128","2019",16,16,0,142552.5,1260.8125,111.1875
"5047","17129","2019",8,8,0,119537.5,1222,97.375
"5048","17130","2019",7,7,0,183502.142857143,1519.42857142857,121.571428571429
"5049","17131","2019",42,42,0,163246.666666667,1484.59523809524,113.166666666667
"5050","17132","2019",6,6,0,129395.666666667,1163,113.833333333333
"5051","17133","2019",11,11,0,129154.545454545,1299.90909090909,99.7272727272727
"5052","17134","2019",5,5,0,151180,1288,119.4
"5053","17135","2019",5,5,0,133000,1301.6,115.2
"5054","17136","2019",20,17,3,198883.5,2023.85,100.8
"5055","17137","2019",4,4,0,97350,893,104.75
"5056","17138","2019",3,3,0,97666.6666666667,932.666666666667,99.3333333333333
"5057","17139","2019",5,5,0,128680,1191.6,106.4
"5058","17140","2019",105,94,11,211359.552380952,2999.61904761905,74.1904761904762
"5059","17141","2019",4,4,0,123700,1433.5,80.25
"5060","17142","2019",82,73,9,280646.951219512,2717.76829268293,104.817073170732
"5061","17143","2019",5,3,2,131700,1243,107
"5062","17145","2019",8,8,0,156397.75,1161.125,131.375
"5063","17146","2019",63,55,8,166586.015873016,1822.68253968254,92.3333333333333
"5064","17147","2019",21,21,0,114140.428571429,1105.71428571429,108.095238095238
"5065","17148","2019",2,2,0,176645,2027.5,87
"5066","17149","2019",1,1,0,50000,641,78
"5067","17150","2019",13,13,0,80092.2307692308,840.153846153846,98
"5068","17151","2019",21,21,0,167028.428571429,1572.33333333333,110.380952380952
"5069","17152","2019",14,14,0,152993.785714286,1433.42857142857,109.785714285714
"5070","17153","2019",36,36,0,218549.611111111,2204.5,98.6944444444444
"5071","17154","2019",4,4,0,191926.25,1511.5,130.25
"5072","17155","2019",59,54,5,209203.288135593,2174.83050847458,93.8305084745763
"5073","17157","2019",2,2,0,105700,1000,93
"5074","17158","2019",13,13,0,180284.153846154,1844.30769230769,97.9230769230769
"5075","17159","2019",2,2,0,116000,1207.5,98.5
"5076","17160","2019",9,9,0,189148.888888889,2069.22222222222,92.5555555555556
"5077","17161","2019",62,54,8,543555.790322581,6077.43548387097,94.3870967741936
"5078","17162","2019",2,2,0,59500,631.5,94.5
"5079","17163","2019",3,3,0,166666.666666667,1420.66666666667,117.666666666667
"5080","17164","2019",48,48,0,213317.208333333,1831.3125,121.708333333333
"5081","17165","2019",4,4,0,95000,1162.75,84.25
"5082","17166","2019",18,18,0,173012.777777778,1810.22222222222,103.888888888889
"5083","17167","2019",5,5,0,119856,1188.8,107
"5084","17168","2019",135,118,17,283930.762962963,3474.63703703704,86.362962962963
"5085","17171","2019",16,16,0,150192.8125,1391.9375,107.375
"5086","17172","2019",56,55,1,139801.196428571,1343.23214285714,106.982142857143
"5087","17173","2019",4,4,0,176887.5,1402,116.25
"5088","17174","2019",12,12,0,175137.833333333,1507.16666666667,124.416666666667
"5089","17175","2019",8,8,0,152146.625,1357.75,117.75
"5090","17177","2019",2,2,0,89750,604.5,145
"5091","17178","2019",1,1,0,115000,1264,91
"5092","17179","2019",27,27,0,186760.333333333,1873.59259259259,100.62962962963
"5093","17180","2019",2,2,0,77505,1387.5,60.5
"5094","17181","2019",7,7,0,106754.285714286,1212.57142857143,95
"5095","17182","2019",7,7,0,98957.1428571429,1027.85714285714,126.285714285714
"5096","17183","2019",13,13,0,195817.538461538,1750.69230769231,108.923076923077
"5097","17184","2019",4,4,0,148125,1236.75,118.75
"5098","17185","2019",31,31,0,181790.838709677,2035.1935483871,92
"5099","17186","2019",11,11,0,154863.636363636,1497.09090909091,98.6363636363636
"5100","17187","2019",1,1,0,260000,1376,189
"5101","17188","2019",7,7,0,131042.857142857,920.285714285714,143.428571428571
"5102","17190","2019",42,41,1,318396.476190476,3142.14285714286,100.238095238095
"5103","17191","2019",9,9,0,126477.777777778,1063.11111111111,119.777777777778
"5104","17192","2019",6,6,0,134750,1069.66666666667,124
"5105","17193","2019",34,34,0,219584.794117647,2605.26470588235,90.6176470588235
"5106","17194","2019",61,60,1,261616.62295082,2494.22950819672,106.147540983607
"5107","17195","2019",8,8,0,106569.375,1055.125,98.375
"5108","17196","2019",7,7,0,151414.285714286,1245.14285714286,126.142857142857
"5109","17197","2019",68,51,17,141217.426470588,1863.76470588235,91.0147058823529
"5110","17198","2019",5,5,0,147612.8,1319,113.8
"5111","17199","2019",3,3,0,86666.6666666667,917.666666666667,101
"5112","17200","2019",120,99,21,305249.483333333,2949.85,101.258333333333
"5113","17201","2019",9,9,0,187877.666666667,1661.88888888889,115.777777777778
"5114","17202","2019",5,5,0,147530,1749,85.8
"5115","17203","2019",16,16,0,192181.25,1595.25,121.0625
"5116","17204","2019",2,2,0,95000,1249.5,79.5
"5117","17205","2019",2,2,0,110175,1493,71
"5118","17206","2019",5,5,0,109000,926.2,115.8
"5119","17207","2019",33,32,1,617563.848484849,5737.78787878788,116.333333333333
"5120","17208","2019",26,26,0,247079.269230769,2247.88461538462,111.346153846154
"5121","17209","2019",3,3,0,133333.333333333,3528,71
"5122","17210","2019",6,6,0,80373.3333333333,1469.83333333333,57.3333333333333
"5123","17211","2019",7,7,0,157200,1294.14285714286,121.285714285714
"5124","17212","2019",1,1,0,413395,1334,310
"5125","17213","2019",7,7,0,65482.8571428571,805.285714285714,82.2857142857143
"5126","17214","2019",2,2,0,213900,1808,118.5
"5127","17216","2019",12,12,0,177258.333333333,1495.5,120.083333333333
"5128","17217","2019",3,3,0,135666.666666667,1297.66666666667,105.666666666667
"5129","17218","2019",99,84,15,142587.333333333,1544.20202020202,93.3939393939394
"5130","17219","2019",136,128,8,169147.536764706,1928.48529411765,90.4485294117647
"5131","17220","2019",7,7,0,146538.142857143,1358.57142857143,106
"5132","17221","2019",19,19,0,124203.736842105,1106.68421052632,114.421052631579
"5133","17222","2019",69,68,1,332568.768115942,2776.27536231884,119.826086956522
"5134","17223","2019",2,2,0,85500,751.5,112.5
"5135","17224","2019",17,16,1,106082.352941176,1149.41176470588,94.5294117647059
"5136","17225","2019",178,156,22,195252.297752809,3337.01685393258,65.5449438202247
"5137","17226","2019",11,11,0,121113.636363636,1193.27272727273,108
"5138","17227","2019",6,6,0,204326.833333333,1305.33333333333,154.333333333333
"5139","17228","2019",59,57,2,218318.983050847,2180.42372881356,102.576271186441
"5140","17229","2019",3,3,0,174433.333333333,1810.33333333333,94.3333333333333
"5141","17230","2019",127,114,13,214861.330708661,2840.54330708661,80.244094488189
"5142","17231","2019",1,1,0,98000,1032,95
"5143","17232","2019",25,24,1,162843.2,1425.4,118.88
"5144","17233","2019",2,2,0,231510,1480,151.5
"5145","17234","2019",3,3,0,127166.666666667,821,195.333333333333
"5146","17235","2019",7,7,0,155857,1011.57142857143,156.142857142857
"5147","17236","2019",21,17,4,93692.8571428571,982.714285714286,98.3333333333333
"5148","17237","2019",14,14,0,148564.285714286,1574.57142857143,95.7857142857143
"5149","17239","2019",2,2,0,61600,604,105
"5150","17240","2019",49,45,4,103683.224489796,1175.42857142857,91.7959183673469
"5151","17241","2019",17,17,0,123671.529411765,1188.94117647059,113.235294117647
"5152","17242","2019",12,12,0,199520,1594.08333333333,138.833333333333
"5153","17243","2019",17,17,0,107847.058823529,911.529411764706,117.117647058824
"5154","17244","2019",14,14,0,162332.142857143,1403.92857142857,115.642857142857
"5155","17245","2019",11,11,0,304179.090909091,2480.27272727273,122.181818181818
"5156","17246","2019",10,10,0,168600,1569.4,110.1
"5157","17247","2019",20,19,1,197492.5,1922.7,107.3
"5158","17248","2019",24,23,1,143130.416666667,1411.41666666667,101.833333333333
"5159","17250","2019",10,10,0,135155.5,1206.7,111.2
"5160","17252","2019",5,5,0,183200,1555.6,122
"5161","17253","2019",20,20,0,151836.5,1371.6,112.05
"5162","17254","2019",7,7,0,90875.7142857143,1088.71428571429,87.2857142857143
"5163","17255","2019",15,15,0,169668,1482,108.733333333333
"5164","17256","2019",9,9,0,178238.888888889,1295.77777777778,144.222222222222
"5165","17257","2019",22,22,0,107350.045454545,890.909090909091,119.045454545455
"5166","17258","2019",3,3,0,150083.333333333,1104.33333333333,141
"5167","17260","2019",4,4,0,105850,1253.75,85.75
"5168","17261","2019",4,4,0,246547.5,1172.25,176.75
"5169","17262","2019",16,16,0,186107.8125,1886.6875,107.6875
"5170","17263","2019",12,12,0,140397.083333333,1299.75,91.75
"5171","17264","2019",93,92,1,302834.666666667,2925.95698924731,103.763440860215
"5172","17265","2019",25,25,0,173512.96,1666.52,105.24
"5173","17266","2019",10,10,0,142382,1503.9,92.3
"5174","17267","2019",23,23,0,216263.130434783,1900.21739130435,116.652173913043
"5175","17268","2019",3,3,0,68333.3333333333,800.666666666667,90.6666666666667
"5176","17269","2019",7,7,0,127428.571428571,1090,112.857142857143
"5177","17270","2019",11,11,0,145923.181818182,1499.90909090909,103.909090909091
"5178","17271","2019",5,5,0,122493.2,1097.8,111
"5179","17273","2019",9,9,0,137077.777777778,1067.55555555556,136.888888888889
"5180","17274","2019",135,90,45,291204.637037037,3142.56296296296,92.2814814814815
"5181","17275","2019",10,10,0,134785,1472.3,92.3
"5182","17276","2019",1,1,0,352000,1271,277
"5183","17277","2019",13,13,0,119158.076923077,1151.53846153846,109.538461538462
"5184","17278","2019",18,18,0,148848.888888889,1548.16666666667,102.5
"5185","17279","2019",9,9,0,142053,1384.33333333333,99.5555555555556
"5186","17280","2019",7,7,0,154142.857142857,1521.57142857143,108.857142857143
"5187","17282","2019",2,2,0,60000,438.5,133.5
"5188","17283","2019",61,57,4,116544.475409836,1190.13114754098,102.098360655738
"5189","17284","2019",36,36,0,152029.166666667,1462.83333333333,106.583333333333
"5190","17285","2019",13,13,0,163092.307692308,1214.61538461538,136.923076923077
"5191","17286","2019",38,38,0,744768.473684211,7173.1052631579,100.578947368421
"5192","17287","2019",6,6,0,83396.6666666667,667,111
"5193","17288","2019",3,3,0,55400,561.666666666667,97.6666666666667
"5194","17289","2019",5,5,0,203040,1467.4,141
"5195","17290","2019",2,2,0,98625,635.5,155
"5196","17291","2019",104,82,22,254094.009615385,2785.48076923077,92.1057692307692
"5197","17292","2019",8,8,0,166125,1251.75,142.375
"5198","17293","2019",14,14,0,206803.571428571,1677.28571428571,121.642857142857
"5199","17294","2019",2,2,0,61900,955,66.5
"5200","17295","2019",10,10,0,127419.9,1050.7,128.8
"5201","17296","2019",15,15,0,142170,1286.33333333333,108.533333333333
"5202","17297","2019",61,57,4,503815.524590164,5840.98360655738,87.1803278688525
"5203","17298","2019",14,14,0,151228.571428571,1327.64285714286,119.214285714286
"5204","17299","2019",589,287,302,136747.966044143,1905.97283531409,76.4040747028862
"5205","17300","2019",1946,685,1261,245113.284686536,3790.45529290853,66.8093525179856
"5206","17301","2019",1,1,0,130000,1102,118
"5207","17302","2019",6,6,0,114181.333333333,1652.5,83.8333333333333
"5208","17303","2019",19,19,0,151567.894736842,1404.57894736842,111.631578947368
"5209","17304","2019",7,7,0,152648.714285714,1505.28571428571,97.2857142857143
"5210","17305","2019",5,5,0,123762,1296,98.8
"5211","17306","2019",843,341,502,218554.209964413,3122.56583629893,70.7497034400949
"5212","17307","2019",25,25,0,146273.92,1327.96,116.04
"5213","17308","2019",35,35,0,167876.971428571,1601.88571428571,106.828571428571
"5214","17309","2019",35,35,0,101571.428571429,1147.08571428571,95.3428571428571
"5215","17310","2019",13,13,0,201179.538461538,1694.15384615385,120.230769230769
"5216","17311","2019",29,28,1,188208.103448276,2127.93103448276,87.6896551724138
"5217","17312","2019",9,9,0,90161.6666666667,829,104.888888888889
"5218","17313","2019",6,6,0,130243,1084.33333333333,108.333333333333
"5219","17314","2019",16,16,0,154166.25,1346.25,117.25
"5220","17315","2019",16,16,0,181146.5625,1850.3125,104
"5221","17316","2019",2,2,0,145000,1057,155
"5222","17317","2019",15,15,0,122447,1158.73333333333,97.6666666666667
"5223","17318","2019",32,30,2,389966.03125,4619.25,86.71875
"5224","17320","2019",3,3,0,148066.666666667,1493,98.6666666666667
"5225","17321","2019",4,4,0,142862.5,1106,158.25
"5226","17322","2019",6,6,0,171354.833333333,1763,99.5
"5227","17323","2019",74,72,2,212983.121621622,3315.83783783784,71.9594594594595
"5228","17324","2019",1,1,0,222000,1805,123
"5229","17325","2019",9,9,0,118858.333333333,1141.55555555556,105.111111111111
"5230","17326","2019",2,2,0,147250,1073,145.5
"5231","17327","2019",5,5,0,77000,625.6,117.8
"5232","17328","2019",19,19,0,146236.842105263,1266.47368421053,121.315789473684
"5233","17329","2019",8,8,0,147218.75,1851.875,96.125
"5234","17330","2019",28,28,0,129198.428571429,1353.5,95.8571428571429
"5235","17331","2019",17,17,0,116970.588235294,1107.11764705882,106.529411764706
"5236","17332","2019",4,4,0,179512.5,1708.5,101.75
"5237","17333","2019",335,183,152,202963.501492537,3176.22388059702,66.2835820895522
"5238","17334","2019",2,2,0,129500,913.5,144
"5239","17335","2019",8,8,0,145502.375,2058.5,94.375
"5240","17336","2019",33,33,0,191366.060606061,1711.75757575758,115.575757575758
"5241","17337","2019",181,169,12,226130.209944751,3077.57458563536,74.7016574585635
"5242","17338","2019",36,36,0,139120.833333333,1210.97222222222,114.833333333333
"5243","17339","2019",12,12,0,151689.583333333,1470.75,114.666666666667
"5244","17340","2019",36,36,0,145859.722222222,1428.80555555556,105.305555555556
"5245","17342","2019",1,1,0,378000,2054,184
"5246","17343","2019",4,4,0,251877.5,1632.5,164.5
"5247","17344","2019",21,21,0,119775.904761905,1180.42857142857,107.857142857143
"5248","17345","2019",4,4,0,134500,1477.5,91.25
"5249","17346","2019",25,25,0,169698.8,1699.68,103.48
"5250","17347","2019",158,138,20,111532.759493671,1120.25949367089,102.905063291139
"5251","17348","2019",9,9,0,123164.444444444,1369.11111111111,90.3333333333333
"5252","17349","2019",42,42,0,172450,1744.7619047619,99.1428571428571
"5253","17350","2019",13,13,0,152528.692307692,1377.30769230769,111.384615384615
"5254","17351","2019",32,32,0,176207.34375,1768.84375,100
"5255","17353","2019",44,44,0,215040.386363636,2267.36363636364,96.5227272727273
"5256","17354","2019",5,5,0,180550,1546,116.4
"5257","17355","2019",4,4,0,148000,1319.75,109.75
"5258","17356","2019",6,6,0,142250,1282.66666666667,110.333333333333
"5259","17357","2019",2,2,0,108900,874,140
"5260","17358","2019",4,4,0,127000,1011.25,126.5
"5261","17359","2019",21,21,0,146866.666666667,1230.61904761905,123.47619047619
"5262","17360","2019",103,102,1,568069.689320388,5093.35922330097,114.553398058252
"5263","17361","2019",4,4,0,107300,1285.75,98.5
"5264","17362","2019",2,2,0,111750,1088,102.5
"5265","17363","2019",4,4,0,158000,1703.5,93.75
"5266","17364","2019",2,2,0,164437.5,1468.5,112
"5267","17365","2019",4,4,0,129250,1115.75,118.25
"5268","17366","2019",8,8,0,126250,909.125,158.5
"5269","17367","2019",5,5,0,98766.6,828.2,116.2
"5270","17369","2019",67,29,38,401857.134328358,5962.14925373134,66.5074626865672
"5271","17373","2019",42,42,0,265962.523809524,2218.02380952381,122.857142857143
"5272","17374","2019",5,5,0,104600,1176.2,87.2
"5273","17375","2019",29,29,0,165220,1670.8275862069,108.068965517241
"5274","17376","2019",33,33,0,233577.090909091,2113.15151515152,113.363636363636
"5275","17378","2019",5,5,0,173060,1428.6,120
"5276","17379","2019",1,1,0,162000,2893,56
"5277","17380","2019",211,144,67,246513.606635071,3557.71563981043,72.8009478672986
"5278","17381","2019",1,1,0,135000,1392,97
"5279","17382","2019",12,12,0,141607.25,1202.08333333333,119.25
"5280","17383","2019",5,5,0,123780.2,1119.8,105.2
"5281","17384","2019",9,9,0,79490.6666666667,961.555555555556,86.8888888888889
"5282","17385","2019",223,216,7,225163.928251121,2817.87443946188,82.237668161435
"5283","17386","2019",2,2,0,135000,999.5,131.5
"5284","17387","2019",27,27,0,153142.222222222,1521.11111111111,103.962962962963
"5285","17389","2019",5,4,1,181300,1837,105
"5286","17390","2019",1,1,0,156075,1951,80
"5287","17391","2019",36,36,0,353876.055555556,2744.55555555556,131.222222222222
"5288","17393","2019",25,25,0,166698.48,1487,120.6
"5289","17394","2019",16,16,0,124661.3125,1108.625,112.375
"5290","17395","2019",10,10,0,179003,1613.3,114.1
"5291","17396","2019",35,35,0,240903.142857143,1910.77142857143,131.885714285714
"5292","17397","2019",46,45,1,121366.956521739,1239.63043478261,102.782608695652
"5293","17398","2019",1,1,0,240000,1644,146
"5294","17400","2019",9,9,0,154911.111111111,1054.66666666667,150.555555555556
"5295","17401","2019",4,4,0,104500,915,109.75
"5296","17402","2019",3,3,0,141333.333333333,1326.66666666667,107
"5297","17403","2019",11,11,0,147204.545454545,1375.09090909091,109.272727272727
"5298","17404","2019",9,9,0,118116.666666667,1231,95.3333333333333
"5299","17405","2019",4,4,0,75750,990.5,79.25
"5300","17406","2019",7,7,0,154789,1677.85714285714,101.571428571429
"5301","17407","2019",70,65,5,239563.1,2269.52857142857,109.514285714286
"5302","17408","2019",14,14,0,167570.714285714,1495.78571428571,117.428571428571
"5303","17409","2019",58,58,0,235353.482758621,2275.55172413793,105.275862068966
"5304","17410","2019",16,16,0,86100,920.25,94.25
"5305","17411","2019",49,45,4,193268.448979592,3151.36734693878,68.4081632653061
"5306","17412","2019",4,4,0,113250,1367.25,92.5
"5307","17413","2019",24,23,1,299960.875,2815.375,109.166666666667
"5308","17414","2019",71,70,1,256671.901408451,2716.85915492958,95.4084507042254
"5309","17415","2019",521,364,157,151603.049904031,1756.02111324376,86.9500959692898
"5310","17416","2019",3,3,0,74333.3333333333,788,91.3333333333333
"5311","17417","2019",2,2,0,137632.5,1408.5,101
"5312","17418","2019",10,10,0,135505,921.4,138.6
"5313","17420","2019",35,32,3,280811.057142857,2617.65714285714,111.114285714286
"5314","17421","2019",179,145,34,179558.558659218,2027.83240223464,89.2067039106145
"5315","17422","2019",1,1,0,136250,2034,67
"5316","17424","2019",3,3,0,95000,842,125.666666666667
"5317","17425","2019",45,44,1,188749.333333333,1976.31111111111,100.533333333333
"5318","17426","2019",8,8,0,124975,1127.75,119.75
"5319","17427","2019",1,1,0,128415,494,260
"5320","17428","2019",7,7,0,112042,1128.71428571429,112.857142857143
"5321","17429","2019",32,32,0,186054.375,2090.34375,91.125
"5322","17430","2019",7,7,0,119785.714285714,934.714285714286,122.714285714286
"5323","17431","2019",6,6,0,164812.5,1360.16666666667,122.5
"5324","17432","2019",6,6,0,123033.333333333,1170.16666666667,103.166666666667
"5325","17433","2019",4,4,0,158200,1291.5,116.75
"5326","17434","2019",118,103,15,125429.279661017,1494.6186440678,84.5762711864407
"5327","17435","2019",1,1,0,253150,1947,130
"5328","17436","2019",15,15,0,115680,1123,103.066666666667
"5329","17437","2019",2,2,0,270000,4072.5,67.5
"5330","17438","2019",3,3,0,117333.333333333,921.333333333333,126.666666666667
"5331","17439","2019",17,17,0,139841.176470588,1664.47058823529,81.5294117647059
"5332","17440","2019",9,8,1,106182,1371,81.3333333333333
"5333","17441","2019",12,12,0,159741.333333333,1461.08333333333,110
"5334","17442","2019",7,7,0,122428.571428571,1312.71428571429,93.5714285714286
"5335","17443","2019",32,32,0,229598.46875,2027.71875,115.34375
"5336","17444","2019",21,20,1,189616.428571429,1911.66666666667,106.857142857143
"5337","17445","2019",3,3,0,132683.333333333,1343.33333333333,99.3333333333333
"5338","17446","2019",9,9,0,144707.444444444,1249.55555555556,114.111111111111
"5339","17447","2019",34,34,0,188348.323529412,1873.17647058824,102.441176470588
"5340","17448","2019",18,18,0,127855.555555556,1417.33333333333,98
"5341","17449","2019",151,110,41,140375.556291391,1597.01986754967,88.4900662251656
"5342","17450","2019",5,5,0,91400,955.4,92.8
"5343","17451","2019",3,3,0,113333.333333333,1198.66666666667,93
"5344","17452","2019",145,128,17,216797.648275862,2800.14482758621,82.3724137931034
"5345","17453","2019",19,19,0,145046.894736842,1417.21052631579,100.631578947368
"5346","17454","2019",6,6,0,105833.333333333,1003.83333333333,105
"5347","17455","2019",14,14,0,168585.714285714,1574.85714285714,115.5
"5348","17457","2019",32,32,0,117317.1875,1435,92.125
"5349","17458","2019",3,3,0,184680,1267.66666666667,155.666666666667
"5350","17459","2019",15,15,0,133500,1381.86666666667,115.066666666667
"5351","17460","2019",12,12,0,256086,1645,158.166666666667
"5352","17461","2019",194,113,81,249677.128865979,3588.00515463918,71.8041237113402
"5353","17462","2019",11,11,0,138909.090909091,1406.54545454545,102.181818181818
"5354","17463","2019",36,36,0,207111,2067.72222222222,100.694444444444
"5355","17464","2019",1,1,0,67000,379,177
"5356","17465","2019",8,8,0,133978.125,1000.125,134.25
"5357","17466","2019",38,38,0,232117.973684211,2045.76315789474,115.421052631579
"5358","17467","2019",3,3,0,124166.666666667,1052.66666666667,110.333333333333
"5359","17468","2019",2,2,0,227317.5,1053,198.5
"5360","17469","2019",3,3,0,123333.333333333,961.333333333333,130
"5361","17470","2019",1,1,0,108000,1286,84
"5362","17471","2019",3,3,0,69600,851.333333333333,79
"5363","17472","2019",42,42,0,230462.5,2375.69047619048,98
"5364","17473","2019",1,1,0,98000,1342,73
"5365","17474","2019",15,15,0,92275.3333333333,851.666666666667,105.466666666667
"5366","17476","2019",4,4,0,202600,1302,152.75
"5367","17477","2019",1,1,0,39500,506,78
"5368","17478","2019",4,4,0,109250,922.5,118.5
"5369","17479","2019",1,1,0,216400,1139,190
"5370","17480","2019",11,11,0,190741.818181818,1790.27272727273,109.454545454545
"5371","17481","2019",4,4,0,83594.5,718,134.5
"5372","17482","2019",9,9,0,155516.666666667,1574.88888888889,99.3333333333333
"5373","17483","2019",31,31,0,200010.870967742,2334.67741935484,94.3870967741936
"5374","17484","2019",55,54,1,163508.309090909,1861.92727272727,88.8363636363636
"5375","17485","2019",25,23,2,233859.08,2928.88,84.76
"5376","17486","2019",51,49,2,202312.392156863,3205.1568627451,67.7450980392157
"5377","18001","2019",7,7,0,170571.428571429,1601.71428571429,98.4285714285714
"5378","18003","2019",30,30,0,91732.6333333333,1078.16666666667,88.0666666666667
"5379","18004","2019",17,17,0,160204.705882353,1288.41176470588,129.705882352941
"5380","18005","2019",11,11,0,177313.181818182,1430,132.727272727273
"5381","18006","2019",9,9,0,103603.333333333,933.888888888889,116.555555555556
"5382","18008","2019",11,11,0,129181.818181818,1175.36363636364,114.090909090909
"5383","18009","2019",4,4,0,132000,1199,116.75
"5384","18010","2019",5,5,0,95000,1502.8,76.4
"5385","18011","2019",24,24,0,86250,1025.04166666667,80.625
"5386","18012","2019",7,7,0,67128.5714285714,773,88.5714285714286
"5387","18013","2019",4,4,0,37825,506.25,70.25
"5388","18014","2019",4,4,0,71750,1229.75,59.5
"5389","18015","2019",60,56,4,105621.666666667,1194.85,85.9166666666667
"5390","18016","2019",3,3,0,139505.666666667,1925,75.3333333333333
"5391","18017","2019",4,4,0,57550,888.5,74.75
"5392","18018","2019",27,27,0,115885.296296296,1199.07407407407,98.7407407407407
"5393","18019","2019",10,10,0,106664,1031.8,109.8
"5394","18020","2019",16,16,0,78406.25,903.6875,83.9375
"5395","18021","2019",4,4,0,70187.5,848,92
"5396","18022","2019",10,10,0,66700,860.7,71
"5397","18023","2019",18,18,0,121710.666666667,1268.16666666667,105
"5398","18024","2019",2,2,0,61500,435,142
"5399","18025","2019",5,5,0,73400,869.6,80.2
"5400","18026","2019",25,25,0,101951.6,1152.8,91.96
"5401","18027","2019",6,6,0,102250,1120,102.333333333333
"5402","18028","2019",12,12,0,186691.666666667,1674.5,114.25
"5403","18029","2019",4,4,0,71250,927.5,102
"5404","18030","2019",8,8,0,112375,1721.5,85.375
"5405","18031","2019",4,4,0,76250,720.25,106.75
"5406","18032","2019",12,12,0,94416.6666666667,1011.16666666667,92.3333333333333
"5407","18033","2019",1065,545,520,119300.99342723,1489.23004694836,80.2150234741784
"5408","18034","2019",2,2,0,179500,1781.5,103
"5409","18035","2019",11,11,0,109255.727272727,1185.36363636364,92.5454545454545
"5410","18036","2019",10,10,0,124920,1208.8,114.1
"5411","18037","2019",12,11,1,133000,1084.5,100.916666666667
"5412","18038","2019",9,8,1,93300,1281.44444444444,78.5555555555556
"5413","18039","2019",1,1,0,40000,755,53
"5414","18040","2019",5,5,0,191600,1413.8,161.6
"5415","18041","2019",3,3,0,85000,923.666666666667,90.3333333333333
"5416","18043","2019",2,2,0,142380,1489.5,78
"5417","18044","2019",6,6,0,113325,947.833333333333,123.333333333333
"5418","18045","2019",4,4,0,85912.5,712.25,119
"5419","18046","2019",2,2,0,80500,962,86.5
"5420","18047","2019",6,6,0,80208.3333333333,699.666666666667,106
"5421","18048","2019",4,4,0,64500,805,83.25
"5422","18049","2019",6,6,0,59500,778.166666666667,77.3333333333333
"5423","18050","2019",42,42,0,157401.30952381,1561.59523809524,102.404761904762
"5424","18051","2019",4,4,0,75031,965,88
"5425","18052","2019",7,7,0,69928.5714285714,814.714285714286,84.8571428571429
"5426","18053","2019",4,4,0,99500,1026,92.75
"5427","18054","2019",5,5,0,71800,580.8,131
"5428","18055","2019",20,20,0,83805,883.65,91.75
"5429","18056","2019",7,7,0,78000,809.428571428571,91.8571428571429
"5430","18057","2019",17,17,0,59738.2352941177,862.117647058824,69.1176470588235
"5431","18058","2019",12,11,1,77412.5,911.083333333333,85.0833333333333
"5432","18059","2019",13,13,0,107264.615384615,1254.76923076923,81.3076923076923
"5433","18062","2019",3,3,0,155233.333333333,880.666666666667,179.666666666667
"5434","18064","2019",4,4,0,119822.5,1073.25,113.5
"5435","18065","2019",10,10,0,76650,845.6,93
"5436","18066","2019",10,10,0,96270,916.7,110.9
"5437","18067","2019",11,11,0,84636.3636363636,1287.63636363636,78.1818181818182
"5438","18069","2019",7,7,0,143957.142857143,1471.14285714286,104.428571428571
"5439","18070","2019",3,3,0,74333.3333333333,796.666666666667,85
"5440","18072","2019",2,2,0,127250,943,135
"5441","18074","2019",7,7,0,129000,1141.14285714286,114.428571428571
"5442","18075","2019",6,6,0,116116.666666667,1233.16666666667,97.8333333333333
"5443","18076","2019",7,7,0,150928.571428571,1131.57142857143,140.142857142857
"5444","18077","2019",3,3,0,113333.333333333,1051,106
"5445","18079","2019",4,4,0,64000,871,74.5
"5446","18080","2019",3,3,0,72500,940.333333333333,77
"5447","18081","2019",3,3,0,112166.666666667,1104.33333333333,105.666666666667
"5448","18082","2019",10,10,0,119750,1448.8,99.9
"5449","18083","2019",16,15,1,82312.5,752.125,104.8125
"5450","18084","2019",2,2,0,76500,875.5,82
"5451","18085","2019",5,5,0,109900,1185.6,94
"5452","18086","2019",12,12,0,119940.166666667,1150,99.75
"5453","18087","2019",50,48,2,95784,1040.02,93.58
"5454","18088","2019",1,1,0,180000,1154,156
"5455","18089","2019",6,6,0,77875,834.5,91.6666666666667
"5456","18090","2019",3,3,0,96033.3333333333,960,95.3333333333333
"5457","18092","2019",15,15,0,113953.266666667,1023.4,110.2
"5458","18093","2019",3,3,0,40333.3333333333,746,58.3333333333333
"5459","18094","2019",6,6,0,89500,926.666666666667,97
"5460","18095","2019",4,4,0,94687.5,1056,89.25
"5461","18096","2019",29,29,0,97128.1034482759,1000.31034482759,97.5172413793103
"5462","18097","2019",14,14,0,154980.357142857,1539.35714285714,101.642857142857
"5463","18098","2019",3,3,0,101666.666666667,1052,97.3333333333333
"5464","18099","2019",2,2,0,36500,416,90.5
"5465","18100","2019",8,8,0,82500,828.375,91.625
"5466","18101","2019",9,9,0,54055.5555555556,644.888888888889,83.4444444444444
"5467","18102","2019",2,2,0,47000,526.5,85
"5468","18103","2019",21,20,1,71357.1428571429,851.285714285714,85.1428571428571
"5469","18104","2019",2,2,0,75000,626.5,110
"5470","18105","2019",5,5,0,99100,1334.8,71.8
"5471","18106","2019",6,6,0,45700,576,83.3333333333333
"5472","18108","2019",59,57,2,82614.593220339,955.677966101695,86.8135593220339
"5473","18109","2019",17,17,0,98720.5882352941,1047.82352941176,97.2352941176471
"5474","18110","2019",15,15,0,109424.666666667,939.933333333333,122.066666666667
"5475","18111","2019",1,1,0,37000,493,75
"5476","18112","2019",3,3,0,24333.3333333333,435,56.3333333333333
"5477","18113","2019",1,1,0,79000,718,110
"5478","18114","2019",1,1,0,114000,1481,77
"5479","18115","2019",11,11,0,101727.272727273,1234,98.6363636363636
"5480","18116","2019",8,8,0,87937.5,1008.125,87.5
"5481","18117","2019",6,6,0,91000,1015.83333333333,85.3333333333333
"5482","18118","2019",19,18,1,80710.5263157895,890.789473684211,94.1578947368421
"5483","18119","2019",1,1,0,65000,970,67
"5484","18120","2019",9,9,0,80733.3333333333,798.666666666667,110.666666666667
"5485","18122","2019",5,5,0,97900,1064.6,92.8
"5486","18124","2019",9,9,0,107000,919.333333333333,118.333333333333
"5487","18125","2019",18,18,0,102211.111111111,903.555555555556,113.888888888889
"5488","18126","2019",23,23,0,118030.434782609,1198.04347826087,104
"5489","18127","2019",16,16,0,70468.75,795.25,87
"5490","18128","2019",4,4,0,52375,714,77.25
"5491","18129","2019",6,6,0,179191.666666667,1467.16666666667,127
"5492","18130","2019",5,5,0,77060,864.6,87
"5493","18132","2019",2,2,0,44000,760,65
"5494","18133","2019",13,13,0,91803.8461538462,1157.61538461538,81.5384615384615
"5495","18134","2019",9,9,0,53166.6666666667,714.555555555556,70.3333333333333
"5496","18135","2019",2,2,0,76250,1227,66.5
"5497","18136","2019",6,6,0,125666.666666667,862.666666666667,146.5
"5498","18137","2019",9,9,0,81144.4444444444,758.222222222222,104.555555555556
"5499","18138","2019",30,30,0,158423.133333333,1594.3,99.4666666666667
"5500","18139","2019",6,6,0,117015.5,827.5,113.166666666667
"5501","18140","2019",6,6,0,75727.3333333333,814.5,92.3333333333333
"5502","18141","2019",100,97,3,109007.17,1186.14,90.83
"5503","18142","2019",11,11,0,106068.181818182,1099.09090909091,98.1818181818182
"5504","18143","2019",3,3,0,77283.3333333333,653.666666666667,127
"5505","18144","2019",4,4,0,91095,1200.75,78.75
"5506","18145","2019",26,26,0,88927.5769230769,912.076923076923,102.346153846154
"5507","18146","2019",6,6,0,62833.3333333333,786,77.3333333333333
"5508","18147","2019",2,2,0,134950,1037,125
"5509","18148","2019",22,22,0,132640.909090909,1247.59090909091,102.772727272727
"5510","18149","2019",4,4,0,69000,786.5,119.25
"5511","18150","2019",6,6,0,67166.6666666667,782.833333333333,92.1666666666667
"5512","18151","2019",7,7,0,72473.1428571429,804.714285714286,91.8571428571429
"5513","18153","2019",3,3,0,93000,787,130
"5514","18154","2019",1,1,0,83000,415,200
"5515","18155","2019",11,11,0,103363.636363636,1000.45454545455,101.545454545455
"5516","18156","2019",7,7,0,67642.8571428571,883.285714285714,74.4285714285714
"5517","18157","2019",17,17,0,131357.411764706,1386.94117647059,96.5294117647059
"5518","18158","2019",11,11,0,146935.454545455,1357.45454545455,110.090909090909
"5519","18159","2019",8,8,0,251833.25,2502,93.125
"5520","18160","2019",8,8,0,127906.25,1348.25,94
"5521","18161","2019",2,2,0,74500,1011.5,76
"5522","18162","2019",3,3,0,158533.333333333,1748,79
"5523","18163","2019",2,2,0,94250,1393,83.5
"5524","18164","2019",3,3,0,70333.3333333333,790.666666666667,80.3333333333333
"5525","18165","2019",21,21,0,131521.428571429,1140.19047619048,97.1428571428571
"5526","18166","2019",7,7,0,254470.714285714,2232.14285714286,120.714285714286
"5527","18167","2019",2,2,0,137500,1136.5,122.5
"5528","18168","2019",7,7,0,116571.428571429,1025.71428571429,107.857142857143
"5529","18169","2019",1,1,0,98900,2150,46
"5530","18170","2019",8,7,1,93875,858.5,108.375
"5531","18171","2019",5,5,0,153524,1231.4,113.2
"5532","18172","2019",27,25,2,99459.1481481481,1094.81481481481,88.4444444444444
"5533","18173","2019",4,4,0,98000,1069,103.5
"5534","18175","2019",10,10,0,103960.2,862.6,115
"5535","18176","2019",6,6,0,65240,760.333333333333,84.1666666666667
"5536","18178","2019",2,2,0,53500,683.5,72.5
"5537","18179","2019",5,5,0,197560.2,1392.4,140.8
"5538","18180","2019",23,23,0,178719.565217391,1526.4347826087,120.130434782609
"5539","18181","2019",3,3,0,96100,1546,68
"5540","18182","2019",5,5,0,84518.8,898,108.8
"5541","18183","2019",1,1,0,130000,1140,114
"5542","18184","2019",2,2,0,56500,696.5,91
"5543","18185","2019",3,3,0,68333.3333333333,852,82
"5544","18186","2019",10,10,0,142700,1423.9,102.9
"5545","18187","2019",15,15,0,74732,903.8,90.4
"5546","18188","2019",2,2,0,113750,915,136
"5547","18189","2019",5,5,0,116200,1329,90.8
"5548","18190","2019",8,8,0,128250,1021,125.875
"5549","18191","2019",2,2,0,72500,656,119
"5550","18192","2019",5,5,0,93700,1486.8,62.4
"5551","18193","2019",3,3,0,53000,701.666666666667,79.3333333333333
"5552","18194","2019",8,8,0,94862.5,1034.25,94.75
"5553","18195","2019",3,3,0,95366.6666666667,797.333333333333,112
"5554","18197","2019",138,118,20,88069.8695652174,991.123188405797,88.536231884058
"5555","18198","2019",4,4,0,93375,739.25,121.25
"5556","18199","2019",3,3,0,51666.6666666667,946.333333333333,55.6666666666667
"5557","18200","2019",5,5,0,79200,856,96.8
"5558","18201","2019",7,7,0,154857.142857143,1828.85714285714,92.5714285714286
"5559","18203","2019",1,1,0,110000,733,150
"5560","18204","2019",3,3,0,85000,762.666666666667,100.333333333333
"5561","18205","2019",91,86,5,171370.714285714,1638.79120879121,104.615384615385
"5562","18206","2019",16,16,0,150423.9375,1381.75,115
"5563","18207","2019",86,75,11,102479.662790698,1135.46511627907,92.953488372093
"5564","18208","2019",6,6,0,107175,1891,81.5
"5565","18209","2019",8,8,0,103119.75,880.25,109.875
"5566","18210","2019",9,9,0,92700,760,123
"5567","18211","2019",6,6,0,123541.666666667,1076,114
"5568","18212","2019",4,4,0,171250,1672,126.25
"5569","18213","2019",53,52,1,125492.660377358,1506.03773584906,88.8867924528302
"5570","18214","2019",6,6,0,95858.3333333333,1058.33333333333,91.8333333333333
"5571","18215","2019",5,5,0,82000,731.4,114.4
"5572","18216","2019",8,8,0,60759.5,816.375,75.25
"5573","18218","2019",7,6,1,142142.857142857,1420.28571428571,100.857142857143
"5574","18219","2019",3,3,0,112666.666666667,730,159.666666666667
"5575","18220","2019",1,1,0,140000,2000,70
"5576","18221","2019",1,1,0,270000,1350,200
"5577","18223","2019",26,25,1,132942.115384615,1471.69230769231,99.9615384615385
"5578","18224","2019",1,1,0,82000,891,92
"5579","18225","2019",4,4,0,148675,1288.75,111.5
"5580","18226","2019",3,3,0,142333.333333333,1464,97.3333333333333
"5581","18227","2019",5,5,0,131000,1119.8,112.6
"5582","18228","2019",5,5,0,61900,939.6,62.6
"5583","18229","2019",7,7,0,112215.714285714,1195.28571428571,96.8571428571429
"5584","18230","2019",6,6,0,66083.3333333333,602.5,121.166666666667
"5585","18231","2019",3,3,0,74583.3333333333,923.666666666667,80.3333333333333
"5586","18232","2019",1,1,0,36000,621,58
"5587","18233","2019",31,31,0,89966.7741935484,1001,87.2903225806452
"5588","18234","2019",8,8,0,62462.5,823.125,81.625
"5589","18235","2019",11,11,0,110044.545454545,1227.45454545455,89.2727272727273
"5590","18236","2019",2,2,0,179750,2142,103
"5591","18237","2019",11,11,0,97272.7272727273,1039.72727272727,93
"5592","18238","2019",4,4,0,62750,630,93.5
"5593","18240","2019",6,6,0,107783.333333333,1070.83333333333,110
"5594","18241","2019",28,25,3,88033.9285714286,1214.14285714286,75.2142857142857
"5595","18242","2019",33,33,0,79148.4848484848,817.151515151515,92.0606060606061
"5596","18243","2019",6,6,0,72291.6666666667,846.833333333333,78.1666666666667
"5597","18244","2019",1,1,0,1e+05,1136,88
"5598","18245","2019",5,5,0,65290,788,77.2
"5599","18246","2019",24,24,0,104047.083333333,1027.08333333333,102.125
"5600","18247","2019",9,9,0,165466.666666667,1314.11111111111,124.111111111111
"5601","18248","2019",3,3,0,183108.333333333,1329,138
"5602","18249","2019",5,5,0,56600,623,88.6
"5603","18250","2019",1,1,0,130000,1083,120
"5604","18251","2019",1,1,0,228000,1096,208
"5605","18252","2019",6,6,0,59425,770.5,73.8333333333333
"5606","18253","2019",3,3,0,114666.666666667,1017.66666666667,110
"5607","18254","2019",14,14,0,132285.714285714,1386.5,97.3571428571429
"5608","18255","2019",8,8,0,168100,1594.25,106.75
"5609","18256","2019",8,8,0,111736.5,857.5,139.875
"5610","18257","2019",6,6,0,76500,751,95.1666666666667
"5611","18258","2019",10,10,0,78500,872.2,90.8
"5612","18259","2019",2,2,0,69500,997,105
"5613","18261","2019",2,2,0,108500,1007.5,105
"5614","18262","2019",6,6,0,79233.3333333333,980.166666666667,84.5
"5615","18263","2019",4,4,0,441750,2325.5,174.5
"5616","18265","2019",7,7,0,75885.7142857143,875.857142857143,101.714285714286
"5617","18266","2019",4,4,0,47825,986.75,63
"5618","18267","2019",39,39,0,148944.102564103,1407.28205128205,107.051282051282
"5619","18268","2019",5,5,0,68120,1006.2,67.4
"5620","18269","2019",7,7,0,44714.2857142857,700,68.1428571428571
"5621","18270","2019",2,2,0,99000,2091,62.5
"5622","18271","2019",16,16,0,173056.6875,1771.625,96.5
"5623","18272","2019",10,10,0,75150,744.5,102.6
"5624","18273","2019",17,17,0,64441.1764705882,706.588235294118,87.4117647058823
"5625","18274","2019",4,4,0,205000,1566.5,133.25
"5626","18275","2019",3,3,0,106333.333333333,1288.66666666667,87.3333333333333
"5627","18278","2019",4,4,0,67062.5,765.75,89.75
"5628","18279","2019",339,275,64,75074.2507374631,910,82.6666666666667
"5629","18280","2019",10,10,0,125604.7,1235.3,103.6
"5630","18281","2019",21,21,0,101695.476190476,1229.33333333333,87.2380952380952
"5631","18282","2019",7,7,0,91942.8571428571,1075.42857142857,83.4285714285714
"5632","18283","2019",2,2,0,142775,715.5,191
"5633","18284","2019",3,3,0,107333.333333333,1060.33333333333,109.666666666667
"5634","18285","2019",2,2,0,140450,882.5,159
"5635","18286","2019",8,8,0,90500,982,90.75
"5636","18287","2019",8,8,0,73250,740.875,97.625
"5637","18288","2019",1,1,0,1e+05,909,110
"5638","18289","2019",8,8,0,107300,1275.375,85.25
"5639","18290","2019",8,8,0,110221.25,974.125,99.375
"5640","19001","2019",4,3,1,105500,968.25,94.75
"5641","19002","2019",4,4,0,136175,1185.25,124.25
"5642","19003","2019",4,4,0,229539.5,1429.5,156
"5643","19004","2019",12,12,0,90125,886.25,103.25
"5644","19005","2019",50,48,2,122542.1,1284.08,98.86
"5645","19006","2019",1,1,0,1e+05,901,111
"5646","19007","2019",12,12,0,144504.166666667,1511.16666666667,98
"5647","19008","2019",3,3,0,68333.3333333333,721.666666666667,99.3333333333333
"5648","19009","2019",1,1,0,192887,1084,178
"5649","19010","2019",42,38,4,107981.714285714,1235.92857142857,92.0238095238095
"5650","19011","2019",15,12,3,89594,1121.33333333333,76.6666666666667
"5651","19012","2019",4,4,0,154780,1486.75,104
"5652","19013","2019",16,13,3,103918.75,1487.4375,76.4375
"5653","19014","2019",3,3,0,96000,833.333333333333,122.333333333333
"5654","19015","2019",7,6,1,219754.857142857,1383.42857142857,125.571428571429
"5655","19016","2019",2,2,0,156500,1128,139
"5656","19019","2019",19,16,3,92628.4210526316,1215.31578947368,80.4736842105263
"5657","19020","2019",1,1,0,79800,570,140
"5658","19021","2019",1,1,0,106000,505,210
"5659","19022","2019",4,4,0,148117.5,1148.75,124.75
"5660","19023","2019",18,18,0,99413.8888888889,933.888888888889,102.111111111111
"5661","19024","2019",3,3,0,133333.333333333,1801.66666666667,69.3333333333333
"5662","19025","2019",4,4,0,110850,1122.75,99.25
"5663","19026","2019",2,2,0,66500,762.5,90.5
"5664","19027","2019",3,3,0,90500,764.333333333333,121.666666666667
"5665","19028","2019",14,12,2,80040,976.285714285714,91.9285714285714
"5666","19029","2019",7,7,0,159257.142857143,1656.42857142857,98
"5667","19030","2019",6,6,0,111574.833333333,1315,85.3333333333333
"5668","19031","2019",858,434,424,123328.552447552,1565.90442890443,78.4230769230769
"5669","19033","2019",12,11,1,73008.3333333333,932,87.5
"5670","19034","2019",2,2,0,136000,1280,106.5
"5671","19035","2019",4,4,0,181750,1413,123.25
"5672","19036","2019",15,15,0,85118,1327.06666666667,70.4666666666667
"5673","19037","2019",12,12,0,86025,989.083333333333,89.75
"5674","19038","2019",16,16,0,115035.625,1310.6875,87.9375
"5675","19039","2019",2,2,0,148400,1415,114.5
"5676","19040","2019",4,4,0,72250,1074.5,68
"5677","19041","2019",8,8,0,108536.5,1069.375,102.625
"5678","19042","2019",5,5,0,86500,1188.8,73.6
"5679","19043","2019",3,3,0,185333.333333333,1510.66666666667,120.666666666667
"5680","19044","2019",1,1,0,160000,1495,107
"5681","19046","2019",1,1,0,130000,1529,85
"5682","19047","2019",6,6,0,109625,1359.33333333333,90.5
"5683","19048","2019",3,3,0,117666.666666667,1189.66666666667,94
"5684","19049","2019",14,14,0,144385.214285714,1521.5,98
"5685","19050","2019",4,4,0,110000,1146.25,97.25
"5686","19051","2019",1,1,0,35000,438,80
"5687","19053","2019",3,3,0,129833.333333333,1272.66666666667,99.6666666666667
"5688","19054","2019",3,3,0,190636.666666667,2235,93.3333333333333
"5689","19055","2019",5,5,0,49214,813.8,63.6
"5690","19056","2019",5,5,0,73900,1107,70.8
"5691","19057","2019",5,5,0,173960,2406.8,73.2
"5692","19058","2019",1,1,0,20000,400,50
"5693","19059","2019",4,4,0,128137.5,1244,94
"5694","19060","2019",7,7,0,83642.8571428571,983.285714285714,96
"5695","19061","2019",6,5,1,109511.666666667,964.833333333333,109.333333333333
"5696","19062","2019",11,11,0,113007.272727273,1097.81818181818,97.1818181818182
"5697","19063","2019",40,33,7,190387.75,2760.225,96.275
"5698","19065","2019",1,1,0,80000,964,83
"5699","19066","2019",14,14,0,126961.357142857,1346.64285714286,96.9285714285714
"5700","19067","2019",1,1,0,195000,2167,90
"5701","19068","2019",9,9,0,161011.111111111,1577.77777777778,100
"5702","19069","2019",1,1,0,110000,1264,87
"5703","19070","2019",7,7,0,90642.8571428571,1241.71428571429,71.7142857142857
"5704","19071","2019",3,3,0,102244.666666667,1109.33333333333,95
"5705","19072","2019",30,29,1,154640.4,1489.6,103.933333333333
"5706","19073","2019",28,27,1,100702.857142857,1073.60714285714,99.0714285714286
"5707","19075","2019",9,9,0,98080.5555555556,1001,96
"5708","19076","2019",1,1,0,107000,1019,105
"5709","19077","2019",2,2,0,110000,1037.5,102
"5710","19078","2019",3,3,0,106000,1405,67.6666666666667
"5711","19079","2019",7,7,0,57985.7142857143,770.571428571429,72.8571428571429
"5712","19080","2019",9,9,0,105572.222222222,922,104.888888888889
"5713","19081","2019",6,6,0,89833.3333333333,1091.16666666667,84.1666666666667
"5714","19082","2019",11,11,0,160207,1390.54545454545,122.545454545455
"5715","19084","2019",4,4,0,90312.5,1075.5,83.25
"5716","19085","2019",7,7,0,118428.571428571,1548.85714285714,77.7142857142857
"5717","19086","2019",2,2,0,133750,1844.5,79
"5718","19087","2019",1,1,0,55800,900,62
"5719","19088","2019",1,1,0,67500,1125,60
"5720","19089","2019",3,3,0,99000,1168.33333333333,105.666666666667
"5721","19090","2019",3,3,0,65000,849,79.3333333333333
"5722","19091","2019",1,1,0,135000,1436,94
"5723","19093","2019",8,8,0,157850,1549.375,105.125
"5724","19094","2019",14,14,0,121265.714285714,1130.21428571429,102.071428571429
"5725","19096","2019",2,2,0,52500,630,101
"5726","19097","2019",3,3,0,108466.666666667,1289,85
"5727","19098","2019",7,7,0,103642.857142857,1240,81.2857142857143
"5728","19099","2019",1,1,0,30000,361,83
"5729","19100","2019",11,10,1,104391.454545455,1243.09090909091,85.4545454545455
"5730","19101","2019",12,10,2,86136.6666666667,1009.66666666667,91.5833333333333
"5731","19102","2019",2,2,0,74500,1202.5,62
"5732","19104","2019",3,3,0,138700,1447.66666666667,101
"5733","19105","2019",4,4,0,96500,1320.25,71.75
"5734","19106","2019",6,6,0,63051.6666666667,933.833333333333,71.1666666666667
"5735","19107","2019",26,21,5,108827.423076923,1463.92307692308,77.3076923076923
"5736","19108","2019",2,2,0,84500,616,137.5
"5737","19109","2019",1,1,0,163000,1358,120
"5738","19110","2019",2,2,0,77000,888.5,111
"5739","19111","2019",3,3,0,35666.6666666667,594.333333333333,60
"5740","19113","2019",14,13,1,74071.4285714286,978.142857142857,80.3571428571429
"5741","19114","2019",1,1,0,46000,821,56
"5742","19115","2019",2,2,0,212335,1893.5,123
"5743","19116","2019",1,1,0,107350,2236,48
"5744","19117","2019",17,17,0,132682.352941176,1473.58823529412,82.9411764705882
"5745","19118","2019",12,12,0,72812.5,768.333333333333,99.5833333333333
"5746","19119","2019",2,2,0,160500,2168.5,72.5
"5747","19120","2019",1,1,0,70000,1029,68
"5748","19121","2019",18,15,3,109611.111111111,1300.38888888889,92.5
"5749","19122","2019",4,4,0,246500,1650,147
"5750","19123","2019",131,89,42,122445,1477.99236641221,82.969465648855
"5751","19124","2019",17,17,0,152382.352941176,1400.17647058824,109.058823529412
"5752","19125","2019",19,18,1,88964.2631578947,998.315789473684,99.1578947368421
"5753","19126","2019",3,3,0,92666.6666666667,1159,73.3333333333333
"5754","19128","2019",4,4,0,92612.5,996.75,90.25
"5755","19129","2019",14,14,0,99689.2857142857,939.285714285714,108.571428571429
"5756","19130","2019",5,5,0,96200,1377.8,71
"5757","19131","2019",13,13,0,78321.5384615385,903.538461538462,88.3846153846154
"5758","19132","2019",4,4,0,127874.25,1622.25,78.5
"5759","19133","2019",1,1,0,142500,1159,123
"5760","19134","2019",4,4,0,72750,830.5,95.75
"5761","19135","2019",1,1,0,105000,827,127
"5762","19136","2019",31,31,0,91962.9032258065,1056.16129032258,86.6129032258064
"5763","19138","2019",21,21,0,128471.142857143,1337.42857142857,100.52380952381
"5764","19140","2019",3,3,0,77708.3333333333,1057.33333333333,81
"5765","19141","2019",2,2,0,64625,800.5,90
"5766","19142","2019",3,3,0,83666.6666666667,1342.33333333333,70.3333333333333
"5767","19143","2019",6,6,0,94250,1069,95.5
"5768","19144","2019",4,4,0,88500,1124.5,97.5
"5769","19145","2019",4,4,0,89000,994.25,90.25
"5770","19146","2019",13,12,1,140686.384615385,1308.69230769231,106.461538461538
"5771","19147","2019",4,4,0,176937.5,1738,104.75
"5772","19148","2019",16,16,0,99409.375,1365.5625,84.5
"5773","19149","2019",8,6,2,114731.25,1218,87.875
"5774","19150","2019",5,5,0,135880,1221.2,110.6
"5775","19151","2019",15,15,0,147027.066666667,1778.4,89.4
"5776","19152","2019",5,5,0,94300,1194.6,79.2
"5777","19153","2019",60,52,8,111979.766666667,1373.16666666667,84.0666666666667
"5778","19154","2019",6,6,0,151625,1645.66666666667,93.5
"5779","19155","2019",5,5,0,153760,1326.6,134.8
"5780","19156","2019",2,2,0,186450,2152.5,87
"5781","19157","2019",3,3,0,43777.6666666667,519.666666666667,87
"5782","19158","2019",2,2,0,152600,1638.5,95
"5783","19160","2019",6,6,0,86666.6666666667,1070.5,86.6666666666667
"5784","19161","2019",2,2,0,91000,837.5,106
"5785","19162","2019",10,10,0,111800,1154.6,96
"5786","19163","2019",4,4,0,84325,1094,81.25
"5787","19164","2019",8,8,0,82262.5,908,92.375
"5788","19165","2019",2,2,0,51000,1208,42
"5789","19166","2019",3,3,0,142666.666666667,1580.66666666667,102
"5790","19169","2019",3,3,0,117000,1210,89.6666666666667
"5791","19170","2019",2,2,0,177250,1627.5,106
"5792","19171","2019",1,1,0,250000,3012,83
"5793","19172","2019",3,3,0,69333.3333333333,947.333333333333,72.3333333333333
"5794","19173","2019",3,3,0,92833.3333333333,1112.66666666667,80.3333333333333
"5795","19174","2019",5,5,0,95808,1087.6,94.4
"5796","19175","2019",1,1,0,43000,860,50
"5797","19176","2019",13,12,1,95315.3846153846,1024.61538461538,90.5384615384615
"5798","19177","2019",1,1,0,140000,761,184
"5799","19178","2019",11,11,0,137327.272727273,1576.54545454545,87.3636363636364
"5800","19180","2019",5,4,1,89852,790.6,114.8
"5801","19181","2019",4,4,0,86837.5,1020.25,83.5
"5802","19182","2019",9,9,0,114665.555555556,966.333333333333,106.555555555556
"5803","19184","2019",6,6,0,89218.3333333333,1262,71.5
"5804","19186","2019",7,7,0,89110,940.857142857143,92.2857142857143
"5805","19187","2019",5,5,0,95500,1483.8,67.6
"5806","19188","2019",3,3,0,149566.666666667,1660,91.6666666666667
"5807","19190","2019",1,1,0,138950,1188,117
"5808","19191","2019",8,8,0,198493.75,1666,126.5
"5809","19192","2019",5,5,0,93600,1247.6,77.4
"5810","19193","2019",3,3,0,117333.333333333,1274.33333333333,85.6666666666667
"5811","19194","2019",9,9,0,148108.111111111,1096.44444444444,126.222222222222
"5812","19195","2019",1,1,0,146000,1141,128
"5813","19196","2019",6,5,1,98716.6666666667,1298.16666666667,85.1666666666667
"5814","19198","2019",2,2,0,140500,1617.5,95
"5815","19199","2019",7,7,0,90135.7142857143,973.142857142857,97.4285714285714
"5816","19201","2019",5,5,0,124520,1395.8,94.8
"5817","19202","2019",21,20,1,169099.761904762,1642.19047619048,103.714285714286
"5818","19203","2019",19,18,1,112558.684210526,1190.94736842105,92.1578947368421
"5819","19204","2019",5,5,0,115040.2,1046.8,102.4
"5820","19205","2019",1,1,0,69000,590,117
"5821","19206","2019",1,1,0,64500,448,144
"5822","19207","2019",13,13,0,122269.230769231,1277.38461538462,93.8461538461538
"5823","19208","2019",4,4,0,59125,990,62.25
"5824","19209","2019",4,4,0,115900,1267.5,93.5
"5825","19210","2019",1,1,0,55000,618,89
"5826","19211","2019",10,9,1,157021,1441,113.3
"5827","19213","2019",4,4,0,83155,885.5,97.5
"5828","19214","2019",8,8,0,61426.625,895.625,66.375
"5829","19216","2019",3,3,0,76000,873,91.3333333333333
"5830","19217","2019",1,1,0,81000,1266,64
"5831","19219","2019",4,4,0,71500,912.5,78.75
"5832","19220","2019",3,3,0,69000,976,69.6666666666667
"5833","19221","2019",2,2,0,95000,1037.5,90
"5834","19222","2019",13,13,0,103242.307692308,999,104.153846153846
"5835","19223","2019",3,3,0,135333.333333333,2211,66.6666666666667
"5836","19225","2019",2,2,0,74250,751,101.5
"5837","19226","2019",1,1,0,86000,717,120
"5838","19227","2019",13,13,0,137133.076923077,1346.61538461538,104.846153846154
"5839","19228","2019",1,1,0,50000,926,54
"5840","19229","2019",56,48,8,149490.625,1657.85714285714,90.625
"5841","19230","2019",2,2,0,72575,855.5,84
"5842","19231","2019",4,4,0,93000,1325.5,66.75
"5843","19232","2019",3,3,0,75333.3333333333,1028.33333333333,73.3333333333333
"5844","19233","2019",1,1,0,107000,1092,98
"5845","19234","2019",5,5,0,101726,1333.8,77.8
"5846","19236","2019",3,2,1,91800,1234,75
"5847","19237","2019",9,9,0,62700,821.888888888889,76.2222222222222
"5848","19238","2019",2,2,0,123250,1024.5,121
"5849","19239","2019",5,5,0,80236,992.2,77.8
"5850","19240","2019",3,3,0,86570,956.666666666667,92.3333333333333
"5851","19241","2019",4,4,0,78800,861.25,101.5
"5852","19242","2019",6,6,0,96583.3333333333,1100.33333333333,89.8333333333333
"5853","19243","2019",11,11,0,143209.090909091,1280.72727272727,115
"5854","19245","2019",2,2,0,52500,739.5,70
"5855","19246","2019",13,12,1,190769.230769231,1713.30769230769,108.461538461538
"5856","19247","2019",1,1,0,152000,1505,101
"5857","19248","2019",6,6,0,94033.3333333333,1065.16666666667,93.8333333333333
"5858","19249","2019",3,3,0,86500,940.333333333333,91
"5859","19250","2019",7,7,0,85111.4285714286,1111,75.8571428571429
"5860","19251","2019",1,1,0,125000,2232,56
"5861","19252","2019",16,16,0,97671.875,999.75,99.25
"5862","19253","2019",4,4,0,88928.75,1095.75,78.75
"5863","19254","2019",6,6,0,124868.333333333,2370.16666666667,68.5
"5864","19255","2019",18,18,0,122633.888888889,1373.16666666667,89.9444444444444
"5865","19256","2019",5,5,0,93636,962.6,98.6
"5866","19257","2019",5,5,0,124980,1264,101.4
"5867","19258","2019",8,8,0,67437.5,1002.75,68.625
"5868","19259","2019",1,1,0,36000,800,45
"5869","19260","2019",3,3,0,145933.333333333,1292,114.666666666667
"5870","19261","2019",7,7,0,85214.2857142857,1068,85.1428571428571
"5871","19262","2019",4,4,0,110000,1920.25,74.5
"5872","19263","2019",4,4,0,97375,907.25,100.25
"5873","19264","2019",6,6,0,94493.6666666667,868.833333333333,97.3333333333333
"5874","19265","2019",4,4,0,148000,1683.5,94
"5875","19269","2019",31,30,1,64689.3548387097,873.032258064516,82.6129032258064
"5876","19270","2019",5,5,0,122800,1353.8,89.4
"5877","19271","2019",6,6,0,125031.666666667,1740.66666666667,70.6666666666667
"5878","19272","2019",148,68,80,74093.7297297297,950.594594594595,82.0608108108108
"5879","19273","2019",10,10,0,119990.5,1278.6,91
"5880","19274","2019",42,38,4,173282.857142857,1572.16666666667,113.309523809524
"5881","19275","2019",90,74,16,92041.5,1032.01111111111,91.2
"5882","19276","2019",40,36,4,92677.5,964.475,94.65
"5883","19277","2019",2,2,0,109000,1280.5,85
"5884","19278","2019",22,22,0,142478.181818182,1585.18181818182,92.8181818181818
"5885","19279","2019",2,2,0,137925,1397.5,98
"5886","19281","2019",1,1,0,41500,377,110
"5887","19283","2019",1,1,0,65000,406,160
"5888","19284","2019",2,2,0,85000,1001.5,86
"5889","19285","2019",22,22,0,98574.0909090909,1083.22727272727,84.5
"5890","19286","2019",8,8,0,120062.5,1226.875,101.875
"5891","19287","2019",3,3,0,222666.666666667,2501.33333333333,106.666666666667
"5892","19288","2019",16,16,0,102656.25,1174.4375,88.375
"5893","19289","2019",7,7,0,157184.142857143,1595.71428571429,101.142857142857
"5894","21001","2019",1,1,0,235000,3456,68
"5895","21002","2019",3,3,0,154666.666666667,1727.33333333333,94.6666666666667
"5896","21003","2019",16,6,10,182637.5,2640.6875,68.625
"5897","21004","2019",2,2,0,64361,705,99
"5898","21005","2019",23,23,0,206923.043478261,1915.13043478261,111.130434782609
"5899","21006","2019",2,2,0,67500,662,98.5
"5900","21007","2019",3,2,1,104666.666666667,1191,92.6666666666667
"5901","21008","2019",7,7,0,103303.571428571,1036.42857142857,102.714285714286
"5902","21009","2019",1,1,0,79600,995,80
"5903","21010","2019",3,3,0,191666.666666667,2061.33333333333,95.6666666666667
"5904","21011","2019",1,1,0,150000,974,154
"5905","21012","2019",3,3,0,128233.333333333,1485.66666666667,87
"5906","21013","2019",2,2,0,211500,1319.5,159
"5907","21016","2019",9,9,0,274428.888888889,2384.44444444444,120.777777777778
"5908","21017","2019",6,6,0,163215,1828.5,89.3333333333333
"5909","21020","2019",3,3,0,121941.666666667,976,122
"5910","21021","2019",32,29,3,223665.8125,2155.3125,106.71875
"5911","21022","2019",10,10,0,179674,1353.4,122.6
"5912","21023","2019",14,13,1,117144.5,1064.71428571429,115.642857142857
"5913","21024","2019",1,1,0,65000,1182,55
"5914","21026","2019",4,4,0,158750,1821.25,79.75
"5915","21027","2019",18,15,3,376768.388888889,2779.33333333333,137.277777777778
"5916","21028","2019",8,8,0,167753.75,1301.375,134.125
"5917","21029","2019",1,1,0,330000,1833,180
"5918","21031","2019",6,6,0,172783.333333333,1400.5,123
"5919","21032","2019",1,1,0,72500,771,94
"5920","21033","2019",1,1,0,80000,816,98
"5921","21034","2019",1,1,0,25000,368,68
"5922","21035","2019",1,1,0,40000,952,42
"5923","21036","2019",1,1,0,78975,699,113
"5924","21037","2019",4,4,0,91500,1061.5,82.5
"5925","21038","2019",85,44,41,125373.176470588,1406.49411764706,92.1411764705882
"5926","21040","2019",3,3,0,60666.6666666667,828.333333333333,70.3333333333333
"5927","21041","2019",8,8,0,101062.5,1247.75,95
"5928","21042","2019",6,6,0,137750,1125.83333333333,113.833333333333
"5929","21043","2019",1,1,0,36000,554,65
"5930","21045","2019",6,6,0,135312.5,1359.66666666667,90
"5931","21047","2019",2,2,0,48500,535,92.5
"5932","21050","2019",3,3,0,221157.333333333,1915,106.333333333333
"5933","21051","2019",2,2,0,38750,632.5,57.5
"5934","21052","2019",4,4,0,60962.5,896.5,71
"5935","21053","2019",3,3,0,142416.333333333,844,144.333333333333
"5936","21054","2019",416,175,241,180063.675480769,2226.23798076923,80.5288461538462
"5937","21055","2019",2,2,0,33000,489,68
"5938","21056","2019",16,11,5,201501.5625,1810.8125,105.25
"5939","21058","2019",3,3,0,65500,542,112.666666666667
"5940","21059","2019",8,7,1,246199.375,2029.25,116.75
"5941","21060","2019",19,19,0,185913.157894737,1945.68421052632,97.5789473684211
"5942","21062","2019",2,2,0,222200,1853.5,115
"5943","21064","2019",1,1,0,45000,750,60
"5944","21066","2019",1,1,0,45000,450,100
"5945","21067","2019",14,14,0,169420.214285714,1599.71428571429,110.357142857143
"5946","21069","2019",3,3,0,71666.6666666667,1070,75
"5947","21070","2019",2,2,0,102750,1175,101
"5948","21071","2019",12,12,0,207312.5,2438,96
"5949","21072","2019",3,3,0,124633.333333333,1281.33333333333,94
"5950","21074","2019",3,3,0,144333.333333333,1733,83.3333333333333
"5951","21075","2019",3,3,0,78333.3333333333,800,93.6666666666667
"5952","21076","2019",9,8,1,205168.888888889,1793.77777777778,124.333333333333
"5953","21077","2019",1,1,0,55000,887,62
"5954","21079","2019",2,2,0,97995,1392.5,64
"5955","21080","2019",12,11,1,171891.666666667,1498.08333333333,124.666666666667
"5956","21081","2019",4,4,0,219500,1756.5,132.75
"5957","21083","2019",2,2,0,61250,834,72.5
"5958","21084","2019",1,1,0,73500,782,94
"5959","21086","2019",18,18,0,241997.888888889,2023.38888888889,108.333333333333
"5960","21087","2019",10,10,0,147082.7,1182.3,133.1
"5961","21088","2019",2,2,0,222500,1823.5,125
"5962","21089","2019",11,11,0,133735.454545455,1435.81818181818,95.0909090909091
"5963","21092","2019",3,3,0,103666.666666667,1559,60
"5964","21093","2019",5,4,1,99300,833.4,117.4
"5965","21094","2019",7,7,0,144139.142857143,1527.28571428571,95.5714285714286
"5966","21095","2019",5,5,0,155800,1111.8,149
"5967","21096","2019",2,2,0,206745,858,275.5
"5968","21098","2019",2,2,0,55000,592,91.5
"5969","21099","2019",7,7,0,256750.714285714,2065.71428571429,129.857142857143
"5970","21100","2019",1,1,0,55100,424,130
"5971","21101","2019",3,3,0,150283.333333333,1702.66666666667,117
"5972","21102","2019",4,4,0,129427.5,928.5,154
"5973","21103","2019",30,30,0,155213.333333333,1519.13333333333,104.9
"5974","21105","2019",18,18,0,226893,2149.22222222222,107.555555555556
"5975","21106","2019",8,8,0,304706.25,2340.25,127.75
"5976","21107","2019",12,12,0,296290.333333333,2443.75,125.25
"5977","21108","2019",2,2,0,96710,1404.5,67.5
"5978","21109","2019",3,3,0,77000,957.333333333333,84.6666666666667
"5979","21110","2019",4,3,1,169750,1549.25,116.5
"5980","21111","2019",3,3,0,269733.333333333,2095,129
"5981","21112","2019",6,6,0,159100,1885,85.3333333333333
"5982","21113","2019",3,3,0,208233.333333333,1433.33333333333,142.333333333333
"5983","21114","2019",2,2,0,123315,1391.5,88.5
"5984","21115","2019",2,2,0,92500,968.5,91.5
"5985","21116","2019",2,2,0,280180,2767.5,105
"5986","21117","2019",1,1,0,65000,464,140
"5987","21118","2019",1,1,0,173000,1081,160
"5988","21120","2019",5,5,0,117800,1031.2,111.2
"5989","21122","2019",2,2,0,78500,1072,67
"5990","21123","2019",2,2,0,70666.5,528.5,137.5
"5991","21124","2019",1,1,0,50000,476,105
"5992","21125","2019",2,2,0,98000,1082,91.5
"5993","21126","2019",6,6,0,259458.333333333,1724.16666666667,149.333333333333
"5994","21127","2019",10,10,0,192481,1604.7,135.3
"5995","21128","2019",7,7,0,96785.7142857143,1178.85714285714,86.2857142857143
"5996","21130","2019",6,6,0,149116.5,1535,94.8333333333333
"5997","21131","2019",6,6,0,142891.666666667,1382.16666666667,105.833333333333
"5998","21132","2019",5,5,0,172720,1208,152.4
"5999","21133","2019",5,5,0,148178,1336.6,123.6
"6000","21134","2019",2,2,0,61250,1037,63
"6001","21135","2019",8,8,0,153137.5,1525.75,100.5
"6002","21136","2019",1,1,0,24000,358,67
"6003","21137","2019",2,2,0,135750,1645.5,82.5
"6004","21138","2019",12,11,1,126988.333333333,1251.41666666667,107.083333333333
"6005","21139","2019",7,7,0,166714.285714286,2824.57142857143,96.8571428571429
"6006","21140","2019",1,1,0,46667,583,80
"6007","21142","2019",1,1,0,90000,612,147
"6008","21146","2019",1,1,0,204000,2040,100
"6009","21147","2019",2,2,0,27500,598,46
"6010","21148","2019",2,2,0,133750,836,160
"6011","21150","2019",11,11,0,169304.545454545,1715.36363636364,117.545454545455
"6012","21151","2019",1,1,0,142000,1291,110
"6013","21152","2019",2,2,0,188275,1733,109
"6014","21153","2019",1,1,0,80000,444,180
"6015","21154","2019",55,33,22,89780.5454545455,932.272727272727,91.3090909090909
"6016","21155","2019",1,1,0,97500,975,100
"6017","21156","2019",1,1,0,90000,1452,62
"6018","21157","2019",1,1,0,50000,595,84
"6019","21158","2019",2,2,0,95000,831.5,116.5
"6020","21159","2019",2,2,0,54000,464.5,116
"6021","21160","2019",3,3,0,101666.666666667,1287.66666666667,92
"6022","21161","2019",3,3,0,123633.333333333,1180.66666666667,106.333333333333
"6023","21162","2019",6,6,0,132000,1844.83333333333,76.1666666666667
"6024","21163","2019",5,5,0,107200,1085.8,103.2
"6025","21164","2019",1,1,0,63800,3753,17
"6026","21166","2019",159,56,103,116543.452830189,1582.06918238994,73.1572327044025
"6027","21167","2019",1,1,0,110000,1467,75
"6028","21169","2019",3,3,0,184200,2213.66666666667,84
"6029","21170","2019",8,8,0,166687.5,1464.75,117
"6030","21171","2019",186,62,124,172499.822580645,2099.61290322581,81.5806451612903
"6031","21172","2019",2,2,0,87500,1045,85
"6032","21173","2019",8,8,0,198699.375,1991,103.125
"6033","21175","2019",3,3,0,196716.666666667,1480.33333333333,132
"6034","21176","2019",2,2,0,152100,1445.5,98.5
"6035","21178","2019",6,6,0,193203.333333333,1487.33333333333,133
"6036","21179","2019",5,5,0,279900,2588.8,108.6
"6037","21180","2019",4,4,0,148575,1344.5,123.75
"6038","21181","2019",1,1,0,63500,617,103
"6039","21182","2019",4,4,0,180500,1062.25,171.25
"6040","21183","2019",5,5,0,191538,1614.6,123.4
"6041","21184","2019",1,1,0,210000,1221,172
"6042","21185","2019",5,5,0,184480,1631.8,111.6
"6043","21186","2019",9,8,1,146547.777777778,1696.11111111111,87.3333333333333
"6044","21189","2019",9,9,0,187259.888888889,1474.88888888889,127.777777777778
"6045","21190","2019",3,3,0,196700,1504.33333333333,139
"6046","21191","2019",12,10,2,182688.75,1703.58333333333,104.75
"6047","21192","2019",14,13,1,219589.285714286,2149.92857142857,103.214285714286
"6048","21193","2019",3,3,0,164000,1739.33333333333,94.6666666666667
"6049","21194","2019",4,4,0,192310,2534,83.5
"6050","21195","2019",5,5,0,182368,1480.8,127.2
"6051","21196","2019",13,13,0,161763.076923077,1578.61538461538,100.076923076923
"6052","21197","2019",1,1,0,119700,998,120
"6053","21198","2019",1,1,0,90000,682,132
"6054","21199","2019",2,2,0,85000,978,87
"6055","21200","2019",24,20,4,220314.666666667,2069.20833333333,102.333333333333
"6056","21201","2019",5,5,0,55000,825,68.6
"6057","21202","2019",4,4,0,69650,469.75,145.75
"6058","21203","2019",2,2,0,230000,1068,226
"6059","21204","2019",1,1,0,73800,559,132
"6060","21207","2019",1,1,0,57000,950,60
"6061","21208","2019",3,3,0,146666.666666667,875,171.666666666667
"6062","21209","2019",15,14,1,275496.666666667,2737,107.066666666667
"6063","21210","2019",7,7,0,114800.285714286,1259,92.4285714285714
"6064","21211","2019",2,2,0,174007.5,1563,111.5
"6065","21212","2019",1,1,0,45000,536,84
"6066","21214","2019",5,5,0,86442,864.2,106.6
"6067","21215","2019",2,2,0,145000,1419,102
"6068","21216","2019",2,2,0,78000,921,84.5
"6069","21217","2019",1,1,0,138740,1756,79
"6070","21218","2019",4,4,0,168212.5,2536,72.25
"6071","21219","2019",1,1,0,65100,381,171
"6072","21221","2019",1,1,0,64000,492,130
"6073","21222","2019",1,1,0,82000,631,130
"6074","21223","2019",13,12,1,392758.384615385,3200,119.769230769231
"6075","21225","2019",3,3,0,138300,1584,94
"6076","21226","2019",4,4,0,108825,1308,86.75
"6077","21227","2019",4,4,0,301000,2602,124.25
"6078","21228","2019",1,1,0,195000,2120,92
"6079","21229","2019",1,1,0,105000,583,180
"6080","21230","2019",5,5,0,183318.8,1324.8,158.2
"6081","21231","2019",3596,459,3137,140566.535038932,2299.04171301446,61.567296996663
"6082","21232","2019",2,2,0,55000,775,75
"6083","21235","2019",2,2,0,56250,764.5,74
"6084","21236","2019",3,3,0,174800,1960,91
"6085","21237","2019",2,2,0,65450,780.5,89.5
"6086","21238","2019",3,3,0,147900,2071,77
"6087","21239","2019",15,15,0,124599.333333333,1267.46666666667,98.9333333333333
"6088","21240","2019",4,4,0,180800,1704.5,109
"6089","21241","2019",1,1,0,160000,1600,100
"6090","21242","2019",2,2,0,195750,2144,91
"6091","21243","2019",1,1,0,150000,938,160
"6092","21245","2019",4,4,0,279250,2199,126.5
"6093","21246","2019",1,1,0,209000,2029,103
"6094","21247","2019",8,8,0,86250,1005.75,91
"6095","21249","2019",13,13,0,128224.461538462,1334.61538461538,100.846153846154
"6096","21250","2019",3,3,0,103900,832,124.666666666667
"6097","21251","2019",8,8,0,127711.25,1154.5,115.875
"6098","21253","2019",3,3,0,34866.6666666667,448.333333333333,78.6666666666667
"6099","21254","2019",5,5,0,101775,1110.4,98.8
"6100","21255","2019",1,1,0,496300,3623,137
"6101","21256","2019",2,2,0,179500,1377.5,133.5
"6102","21257","2019",1,1,0,80000,808,99
"6103","21258","2019",1,1,0,48500,808,60
"6104","21259","2019",2,2,0,107005,949.5,118
"6105","21260","2019",1,1,0,30000,517,58
"6106","21261","2019",10,10,0,236703.5,2172.3,118.5
"6107","21263","2019",25,24,1,245919,2274.04,109.36
"6108","21265","2019",7,7,0,281224.285714286,2887.85714285714,105.285714285714
"6109","21266","2019",5,5,0,302000,2395.2,132.8
"6110","21267","2019",2,2,0,245500,4284.5,91.5
"6111","21268","2019",3,3,0,136133.333333333,1545.33333333333,89
"6112","21269","2019",3,3,0,163020,1510.33333333333,131.333333333333
"6113","21270","2019",6,6,0,197014.166666667,1608,122.166666666667
"6114","21271","2019",6,6,0,96000,1015.5,105.666666666667
"6115","21272","2019",1,1,0,70000,972,72
"6116","21273","2019",22,21,1,252474.545454545,2149.04545454545,124.636363636364
"6117","21274","2019",2,2,0,92500,814.5,96
"6118","21275","2019",2,2,0,204000,1537.5,139
"6119","21276","2019",2,2,0,80875,570.5,138.5
"6120","21277","2019",15,14,1,121883.333333333,1093.86666666667,128.4
"6121","21278","2019",157,77,80,236327.458598726,2552.67515923567,89.5350318471338
"6122","21281","2019",4,4,0,101212.5,996,103.25
"6123","21282","2019",1,1,0,212000,1309,162
"6124","21285","2019",5,5,0,136400,1036,146.2
"6125","21286","2019",2,2,0,119250,1174,108.5
"6126","21287","2019",3,3,0,115633.333333333,1212,97
"6127","21288","2019",6,6,0,88250,1147,70.6666666666667
"6128","21289","2019",2,2,0,115000,1577,78.5
"6129","21290","2019",14,14,0,190393.571428571,1647.57142857143,118.428571428571
"6130","21291","2019",4,4,0,43050,676.25,65.5
"6131","21292","2019",70,51,19,159403.285714286,1878.44285714286,86.2428571428571
"6132","21293","2019",1,1,0,30000,375,80
"6133","21294","2019",4,4,0,240091.5,1755.5,137.75
"6134","21295","2019",34,27,7,234266.323529412,2226.14705882353,101.029411764706
"6135","21296","2019",1,1,0,63000,733,86
"6136","21297","2019",8,7,1,275666.625,2277.5,120.5
"6137","21298","2019",2,2,0,77825,783,114.5
"6138","21299","2019",3,3,0,55688.3333333333,651.333333333333,83
"6139","21300","2019",6,6,0,154338.333333333,1548.16666666667,115.833333333333
"6140","21301","2019",2,2,0,132500,1294.5,104.5
"6141","21302","2019",1,1,0,220000,2366,93
"6142","21304","2019",2,2,0,96750,614,155
"6143","21305","2019",2,2,0,66800,543.5,131.5
"6144","21306","2019",1,1,0,1e+05,870,115
"6145","21308","2019",1,1,0,66950,869,77
"6146","21310","2019",3,3,0,206933.333333333,1729,121.333333333333
"6147","21311","2019",1,1,0,157000,1454,108
"6148","21314","2019",2,2,0,129500,1358.5,97.5
"6149","21315","2019",5,5,0,306570,2083,146.2
"6150","21316","2019",5,5,0,99600,1668.6,74.8
"6151","21317","2019",48,38,10,157767.4375,1578.875,101.416666666667
"6152","21319","2019",13,13,0,207903.230769231,1918.69230769231,110.307692307692
"6153","21320","2019",17,17,0,212371.764705882,1968.05882352941,110.058823529412
"6154","21322","2019",2,2,0,137750,1290,109.5
"6155","21323","2019",3,3,0,156000,1585.33333333333,110
"6156","21324","2019",1,1,0,75000,641,117
"6157","21325","2019",6,6,0,100733.333333333,1197.5,99
"6158","21326","2019",1,1,0,55000,833,66
"6159","21327","2019",3,3,0,77833.3333333333,581,133.666666666667
"6160","21330","2019",5,5,0,163000,2139.2,82.2
"6161","21331","2019",3,3,0,172333.333333333,1418.66666666667,122.666666666667
"6162","21332","2019",18,18,0,146072.222222222,1450.05555555556,108.277777777778
"6163","21333","2019",3,3,0,174583.333333333,1489.33333333333,125.333333333333
"6164","21334","2019",7,5,2,66492.8571428571,752.142857142857,92.7142857142857
"6165","21335","2019",2,2,0,65250,640,95.5
"6166","21336","2019",5,5,0,76850,635,115.6
"6167","21337","2019",23,23,0,149397.391304348,1558.5652173913,100
"6168","21338","2019",2,2,0,41500,497,84.5
"6169","21339","2019",11,9,2,177463.181818182,1844.63636363636,99.7272727272727
"6170","21340","2019",4,4,0,134250,1483.5,93.5
"6171","21341","2019",1,1,0,243200,1456,167
"6172","21342","2019",8,8,0,161945.125,1391.25,120
"6173","21343","2019",4,4,0,38750,635.5,83
"6174","21344","2019",5,5,0,86600,1189.6,84.2
"6175","21345","2019",1,1,0,67000,1047,64
"6176","21346","2019",1,1,0,40000,377,106
"6177","21347","2019",2,2,0,345000,2651,136
"6178","21349","2019",5,5,0,108000,1164,116.8
"6179","21350","2019",1,1,0,1e+05,1429,70
"6180","21351","2019",13,13,0,174366.923076923,1773.46153846154,99.9230769230769
"6181","21352","2019",12,12,0,192529.166666667,1784.75,112.083333333333
"6182","21353","2019",14,14,0,199880.5,1914.92857142857,107.785714285714
"6183","21355","2019",111,49,62,167346.117117117,2061.92792792793,78.8648648648649
"6184","21356","2019",23,23,0,169157.826086957,1642.86956521739,103.086956521739
"6185","21358","2019",2,2,0,90000,856.5,109
"6186","21360","2019",3,3,0,112750,1569.33333333333,82.3333333333333
"6187","21361","2019",2,2,0,221000,2100.5,117.5
"6188","21362","2019",1,1,0,147100,1167,126
"6189","21363","2019",3,3,0,106983.333333333,1135.66666666667,99
"6190","21365","2019",2,2,0,102552.5,763,128.5
"6191","21366","2019",4,4,0,110125,1646,79.5
"6192","21367","2019",4,4,0,156000,1742.5,88.5
"6193","21368","2019",3,3,0,202766.666666667,2261.66666666667,90
"6194","21369","2019",4,4,0,207000,1542.25,144.75
"6195","21370","2019",9,9,0,284563.888888889,2222.66666666667,128.222222222222
"6196","21371","2019",13,13,0,125173.076923077,1357.92307692308,99.6923076923077
"6197","21373","2019",14,12,2,158842.214285714,1697.21428571429,98.7142857142857
"6198","21374","2019",4,4,0,89160,842,106
"6199","21375","2019",6,6,0,53825,698.166666666667,80.1666666666667
"6200","21376","2019",1,1,0,270000,1627,166
"6201","21378","2019",1,1,0,55000,550,100
"6202","21379","2019",6,6,0,60233.3333333333,947.333333333333,78.5
"6203","21381","2019",2,2,0,115400,910,120.5
"6204","21382","2019",2,2,0,192000,1263.5,154.5
"6205","21383","2019",22,21,1,173162.272727273,1601.54545454545,108.545454545455
"6206","21384","2019",2,2,0,102250,849.5,120
"6207","21385","2019",3,3,0,104600,1123.33333333333,90.3333333333333
"6208","21386","2019",1,1,0,130000,722,180
"6209","21387","2019",4,4,0,266875,1861.75,124.5
"6210","21388","2019",9,9,0,189108.888888889,1826.22222222222,104.222222222222
"6211","21390","2019",98,86,12,203783.734693878,2297.40816326531,87.2551020408163
"6212","21391","2019",13,13,0,229460,1960.07692307692,122.846153846154
"6213","21393","2019",1,1,0,48000,522,92
"6214","21394","2019",2,2,0,92500,1175,84.5
"6215","21397","2019",2,2,0,178612.5,1759,99.5
"6216","21398","2019",1,1,0,185000,2011,92
"6217","21399","2019",4,4,0,100250,916.25,120.25
"6218","21401","2019",11,11,0,168336.363636364,2018,89.5454545454545
"6219","21402","2019",1,1,0,20000,333,60
"6220","21403","2019",1,1,0,63000,788,80
"6221","21404","2019",8,8,0,109212.5,1232.5,92.625
"6222","21407","2019",4,4,0,91750,1210.25,76.75
"6223","21408","2019",17,10,7,186500.823529412,2295.64705882353,78.4705882352941
"6224","21409","2019",12,12,0,193220.75,1689.83333333333,117.916666666667
"6225","21411","2019",6,6,0,180708.833333333,1511.33333333333,120.333333333333
"6226","21412","2019",21,20,1,262074.761904762,2137.47619047619,123.047619047619
"6227","21413","2019",2,2,0,170850,1882,91
"6228","21414","2019",3,3,0,140666.666666667,1246,115.333333333333
"6229","21415","2019",3,3,0,125566.666666667,1210.66666666667,90
"6230","21416","2019",26,24,2,197243.846153846,1847.5,107.576923076923
"6231","21417","2019",3,3,0,106666.666666667,1102.66666666667,94.3333333333333
"6232","21419","2019",1,1,0,85000,567,150
"6233","21420","2019",5,5,0,82846,1151.2,80.2
"6234","21421","2019",5,5,0,164930,1393.6,115.8
"6235","21422","2019",1,1,0,105000,1010,104
"6236","21423","2019",11,11,0,253608.181818182,2296.45454545455,102.545454545455
"6237","21425","2019",63,49,14,100119.047619048,1198.39682539683,81.9047619047619
"6238","21426","2019",5,5,0,67100,972.6,68.6
"6239","21427","2019",4,4,0,108067.5,1085.5,101.5
"6240","21428","2019",2,2,0,160350,1928,83
"6241","21429","2019",5,5,0,192980,1392,138.6
"6242","21431","2019",4,4,0,96300,968.5,98.75
"6243","21432","2019",3,3,0,87166.6666666667,1268.33333333333,81.6666666666667
"6244","21433","2019",7,7,0,119142.857142857,698.142857142857,161.714285714286
"6245","21434","2019",2,2,0,97850,741,129
"6246","21435","2019",1,1,0,152200,1492,102
"6247","21436","2019",2,2,0,140000,1423,105
"6248","21437","2019",4,4,0,190525,1662.25,120
"6249","21438","2019",1,1,0,59800,906,66
"6250","21439","2019",3,3,0,224533.333333333,1463.66666666667,159.333333333333
"6251","21440","2019",3,3,0,108583.333333333,1607.66666666667,63.3333333333333
"6252","21441","2019",5,5,0,196000,1356,136.2
"6253","21442","2019",5,5,0,207192,1935.4,121.8
"6254","21445","2019",2,2,0,123258.5,1095.5,167
"6255","21446","2019",2,2,0,92500,716.5,132
"6256","21447","2019",1,1,0,85000,1545,55
"6257","21448","2019",2,2,0,99000,1021,96.5
"6258","21449","2019",1,1,0,112500,1172,96
"6259","21450","2019",3,3,0,203426.666666667,1830.66666666667,124
"6260","21451","2019",1,1,0,95000,792,120
"6261","21452","2019",41,39,2,226561.682926829,2348,101.268292682927
"6262","21454","2019",2,2,0,29425,437,65
"6263","21455","2019",1,1,0,105000,677,155
"6264","21456","2019",1,1,0,162440,1194,136
"6265","21457","2019",2,2,0,1e+05,1074.5,85.5
"6266","21458","2019",14,14,0,245015.714285714,2127.78571428571,118.642857142857
"6267","21459","2019",6,6,0,104271.666666667,1045.16666666667,94.8333333333333
"6268","21461","2019",33,32,1,101750.03030303,1259.0303030303,82.9090909090909
"6269","21462","2019",13,9,4,233296.153846154,2171.53846153846,112.230769230769
"6270","21463","2019",1,1,0,165000,1138,145
"6271","21464","2019",90,47,43,148308.288888889,1882.77777777778,82.5111111111111
"6272","21465","2019",1,1,0,22000,400,55
"6273","21467","2019",5,5,0,149500,1657.2,106.2
"6274","21469","2019",2,2,0,264000,1513.5,177
"6275","21470","2019",1,1,0,30000,405,74
"6276","21472","2019",2,2,0,188425,1472,126.5
"6277","21473","2019",9,9,0,256344.444444444,2491.77777777778,107.111111111111
"6278","21474","2019",9,9,0,87300,934.555555555556,95.2222222222222
"6279","21475","2019",6,6,0,133305.5,971.166666666667,136.333333333333
"6280","21476","2019",2,2,0,129000,1048,126
"6281","21477","2019",3,3,0,126183.333333333,1341.66666666667,82.3333333333333
"6282","21478","2019",4,4,0,200337.5,1672.75,121
"6283","21479","2019",1,1,0,83000,1203,69
"6284","21480","2019",1,1,0,85000,1635,52
"6285","21481","2019",24,23,1,240575.125,2129.79166666667,112.708333333333
"6286","21482","2019",10,10,0,125050,1552.1,94
"6287","21483","2019",3,3,0,228500,1875.33333333333,128.333333333333
"6288","21485","2019",41,36,5,183722.634146341,2349.87804878049,88.6829268292683
"6289","21487","2019",2,2,0,92000,1339,66.5
"6290","21488","2019",2,2,0,92500,891.5,109.5
"6291","21491","2019",2,2,0,120000,1125,96.5
"6292","21492","2019",8,7,1,183490.75,2050.875,92.875
"6293","21493","2019",12,11,1,142416.666666667,1588.91666666667,97.75
"6294","21495","2019",2,2,0,195000,2104.5,93.5
"6295","21496","2019",28,23,5,116607.964285714,1454.64285714286,82.8214285714286
"6296","21497","2019",5,5,0,177000,2009.2,101.6
"6297","21498","2019",1,1,0,25000,676,37
"6298","21499","2019",1,1,0,59000,983,60
"6299","21500","2019",10,9,1,131030,1328.3,100.1
"6300","21501","2019",15,10,5,140321,1624.4,104.266666666667
"6301","21502","2019",8,8,0,139587.5,1281.25,119.5
"6302","21503","2019",1,1,0,35000,530,66
"6303","21504","2019",2,2,0,141250,903.5,144.5
"6304","21505","2019",5,5,0,129270,1120,123.6
"6305","21506","2019",8,8,0,145287.5,1545.25,97.625
"6306","21508","2019",5,5,0,189320,1875.6,102.8
"6307","21510","2019",4,4,0,192000,2364.25,110.5
"6308","21512","2019",6,6,0,186886.833333333,1913.33333333333,92.5
"6309","21514","2019",1,1,0,125000,446,280
"6310","21515","2019",104,42,62,170234.153846154,2013.07692307692,82.7596153846154
"6311","21517","2019",4,3,1,143100,1427.75,100.75
"6312","21518","2019",4,4,0,116512.5,1084.75,96.75
"6313","21519","2019",2,2,0,73000,972,75.5
"6314","21521","2019",9,9,0,199110,1928.11111111111,103.777777777778
"6315","21522","2019",7,7,0,117314.285714286,1315.28571428571,83.7142857142857
"6316","21524","2019",3,3,0,90666.6666666667,833.333333333333,116.333333333333
"6317","21525","2019",16,16,0,114563.4375,1101.1875,106.4375
"6318","21526","2019",1,1,0,149120,1021,146
"6319","21527","2019",3,3,0,121286.666666667,978.333333333333,115.333333333333
"6320","21530","2019",4,4,0,49961.25,644,80.25
"6321","21531","2019",6,6,0,150425.5,1096.83333333333,111.666666666667
"6322","21532","2019",18,18,0,249963.722222222,2172.61111111111,118.777777777778
"6323","21534","2019",7,7,0,237417.142857143,1643.71428571429,148.285714285714
"6324","21535","2019",13,13,0,258841.923076923,2375.84615384615,110.230769230769
"6325","21536","2019",6,6,0,90200,786.166666666667,111.5
"6326","21537","2019",6,6,0,72441.6666666667,834.833333333333,85.5
"6327","21538","2019",3,3,0,102549.666666667,1474.66666666667,97.3333333333333
"6328","21539","2019",1,1,0,201310,1274,158
"6329","21540","2019",121,71,50,216094.132231405,2521.55371900826,85.9504132231405
"6330","21541","2019",4,4,0,244347.5,1634.5,144
"6331","21542","2019",6,6,0,222016.666666667,1838.83333333333,127.5
"6332","21543","2019",3,3,0,79333.3333333333,889.666666666667,105
"6333","21544","2019",1,1,0,147540,2459,60
"6334","21545","2019",15,13,2,88654.6666666667,930.733333333333,93.2666666666667
"6335","21546","2019",4,4,0,73125,1135.75,66.25
"6336","21547","2019",3,3,0,110488.666666667,1224,90.3333333333333
"6337","21548","2019",4,4,0,127500,1165.5,114.75
"6338","21550","2019",2,2,0,121000,1131.5,102
"6339","21554","2019",31,10,21,69403.2258064516,827.290322580645,82.741935483871
"6340","21555","2019",14,13,1,263015.714285714,2323.42857142857,115.571428571429
"6341","21556","2019",5,5,0,164338,1273.6,137.6
"6342","21557","2019",1,1,0,110000,827,133
"6343","21558","2019",10,8,2,148200,1690,85
"6344","21559","2019",10,10,0,205104,1695.8,124.8
"6345","21560","2019",4,4,0,120125,1168.5,109
"6346","21561","2019",3,3,0,104000,902.333333333333,115.333333333333
"6347","21562","2019",4,4,0,117375,963,129.75
"6348","21563","2019",1,1,0,87516,591,148
"6349","21564","2019",4,4,0,126271,1545.75,86.5
"6350","21565","2019",9,9,0,231647.111111111,2401.66666666667,99.5555555555556
"6351","21566","2019",1,1,0,50000,833,60
"6352","21568","2019",7,7,0,128714.285714286,1275.28571428571,101.857142857143
"6353","21569","2019",3,3,0,143543.666666667,1397,102.666666666667
"6354","21570","2019",4,4,0,74250,897.75,79.5
"6355","21571","2019",4,4,0,149250,1457.25,111.25
"6356","21572","2019",10,10,0,187030,1514.5,127.6
"6357","21573","2019",5,5,0,142380,2001.2,79.4
"6358","21574","2019",1,1,0,82000,1367,60
"6359","21575","2019",5,4,1,138100,1431,96.4
"6360","21576","2019",1,1,0,157150,1429,110
"6361","21577","2019",20,20,0,144388.5,1438.1,102.75
"6362","21578","2019",2,2,0,157000,1361.5,108
"6363","21579","2019",1,1,0,265000,1767,150
"6364","21580","2019",4,4,0,104000,1002,111.5
"6365","21582","2019",16,15,1,127570,1420.875,90.1875
"6366","21584","2019",28,27,1,100200,1104.32142857143,90.9285714285714
"6367","21585","2019",6,6,0,214033.333333333,2006.16666666667,110.166666666667
"6368","21586","2019",10,10,0,233380,1878.8,122.1
"6369","21587","2019",1,1,0,165000,1447,114
"6370","21588","2019",1,1,0,90000,865,104
"6371","21589","2019",1,1,0,202200,1042,194
"6372","21590","2019",18,18,0,148894.444444444,1618.94444444444,92.4444444444444
"6373","21591","2019",5,5,0,320200,2592.4,131.2
"6374","21592","2019",4,4,0,187750,1458.5,135
"6375","21594","2019",1,1,0,91600,2290,40
"6376","21595","2019",1,1,0,217800,2420,90
"6377","21596","2019",6,5,1,204641.666666667,1608.66666666667,129.333333333333
"6378","21597","2019",1,1,0,159000,1262,126
"6379","21598","2019",2,2,0,67500,824.5,79.5
"6380","21599","2019",27,26,1,159290.740740741,1537.96296296296,110.222222222222
"6381","21602","2019",1,1,0,140000,2979,47
"6382","21603","2019",57,47,10,148430.087719298,1521.80701754386,100.421052631579
"6383","21605","2019",21,21,0,194363.095238095,2023.85714285714,98.0952380952381
"6384","21606","2019",20,20,0,207115,1848.55,114.25
"6385","21607","2019",26,22,4,97021.1538461538,1183.88461538462,85.4230769230769
"6386","21609","2019",7,7,0,183714.285714286,1679.28571428571,109.428571428571
"6387","21610","2019",5,5,0,143471.2,1131.2,124
"6388","21611","2019",10,10,0,120337,1392.2,85.3
"6389","21613","2019",4,4,0,160250,1025.75,160
"6390","21614","2019",5,5,0,249214,2151.2,118.6
"6391","21615","2019",4,4,0,91262.5,1048.25,91.5
"6392","21616","2019",3,3,0,309166.666666667,1739.33333333333,185.666666666667
"6393","21617","2019",167,70,97,192779.395209581,2164.50898203593,86.7544910179641
"6394","21618","2019",4,3,1,114250,1107,112
"6395","21619","2019",3,3,0,180565,1612.66666666667,113.333333333333
"6396","21620","2019",4,4,0,125350,1431.5,86.5
"6397","21623","2019",14,14,0,221781.571428571,2035.21428571429,113.071428571429
"6398","21624","2019",2,2,0,149900,1279,131
"6399","21625","2019",1,1,0,189000,2124,89
"6400","21626","2019",3,3,0,54666.6666666667,782.333333333333,71
"6401","21627","2019",2,2,0,199500,1150,178
"6402","21629","2019",3,3,0,86833.3333333333,1055.66666666667,93.3333333333333
"6403","21630","2019",4,4,0,166025,1092,134.25
"6404","21632","2019",18,17,1,205235,2042.27777777778,106.5
"6405","21633","2019",2,2,0,110750,842,126.5
"6406","21634","2019",6,6,0,136550,1028.66666666667,117.333333333333
"6407","21635","2019",2,2,0,44500,576,77.5
"6408","21636","2019",4,4,0,95225,1019,102.25
"6409","21637","2019",2,2,0,161500,1206.5,132
"6410","21638","2019",12,9,3,144613.75,1604.08333333333,93.5833333333333
"6411","21639","2019",8,8,0,128925,1426.75,87.875
"6412","21640","2019",2,2,0,119625,1113.5,107.5
"6413","21641","2019",3,3,0,135666.666666667,978.333333333333,147.333333333333
"6414","21642","2019",7,6,1,90071.4285714286,1211.28571428571,76.1428571428571
"6415","21643","2019",13,13,0,184282.307692308,1615.61538461538,122.153846153846
"6416","21644","2019",1,1,0,1e+05,870,115
"6417","21645","2019",11,10,1,148522.727272727,1530.36363636364,96.8181818181818
"6418","21646","2019",1,1,0,89000,864,103
"6419","21647","2019",2,2,0,73000,670.5,101.5
"6420","21648","2019",2,2,0,206000,1558.5,127.5
"6421","21649","2019",2,2,0,131000,1030.5,128
"6422","21650","2019",3,3,0,156766.666666667,1664,91
"6423","21651","2019",1,1,0,144350,2154,67
"6424","21652","2019",6,6,0,90663.3333333333,904.333333333333,103.166666666667
"6425","21655","2019",1,1,0,60000,513,117
"6426","21656","2019",5,4,1,163300,1696.4,91.4
"6427","21657","2019",33,32,1,285517.060606061,2582.18181818182,112.787878787879
"6428","21659","2019",3,3,0,174800,1276.33333333333,137.666666666667
"6429","21661","2019",19,18,1,237015.789473684,2122.31578947368,114.368421052632
"6430","21663","2019",17,17,0,130779.411764706,1467,97.8235294117647
"6431","21664","2019",2,2,0,80250,889,83.5
"6432","21665","2019",1,1,0,98000,1089,90
"6433","21666","2019",2,2,0,335475,2197.5,154
"6434","21667","2019",3,3,0,202760,1565.66666666667,130
"6435","21670","2019",6,5,1,101797,842.166666666667,104.666666666667
"6436","21671","2019",1,1,0,55000,1833,30
"6437","21673","2019",2,2,0,62750,882.5,73
"6438","21674","2019",1,1,0,59000,908,65
"6439","21675","2019",1,1,0,25000,781,32
"6440","21676","2019",1,1,0,130000,909,143
"6441","21679","2019",3,3,0,196416.666666667,1767,112.333333333333
"6442","21680","2019",4,4,0,114267.5,1179,91.5
"6443","21681","2019",1,1,0,131000,766,171
"6444","21682","2019",7,7,0,163684.285714286,1428.57142857143,114.857142857143
"6445","21683","2019",7,7,0,66742.8571428571,1111.71428571429,61.4285714285714
"6446","21684","2019",7,7,0,233728.571428571,2382.85714285714,100.428571428571
"6447","21685","2019",5,5,0,98230,950.8,98.8
"6448","21686","2019",1,1,0,102000,1437,71
"6449","21687","2019",1,1,0,160000,1333,120
"6450","21688","2019",3,3,0,190216.333333333,1530,117.333333333333
"6451","21691","2019",5,5,0,184730,2013.6,90.2
"6452","21692","2019",3,3,0,289666.666666667,1698,183.666666666667
"6453","21693","2019",1,1,0,28000,718,39
"6454","21695","2019",1,1,0,143400,1434,100
"6455","21696","2019",2,2,0,48000,1119.5,53
"6456","21698","2019",4,4,0,196625,1741,115.25
"6457","21699","2019",17,17,0,155664.411764706,1512.70588235294,107.176470588235
"6458","21701","2019",2,2,0,137550,1533.5,90
"6459","21702","2019",7,7,0,111027.142857143,1245.28571428571,92.7142857142857
"6460","21703","2019",1,1,0,36000,720,50
"6461","21704","2019",2,2,0,102500,1243,79.5
"6462","21705","2019",1,1,0,143700,777,185
"6463","21706","2019",1,1,0,123000,1025,120
"6464","21707","2019",3,3,0,90916.6666666667,1012.33333333333,79.3333333333333
"6465","21708","2019",5,5,0,175765.2,1983,91
"6466","21709","2019",4,4,0,74950,1026.25,74.75
"6467","21710","2019",11,11,0,123496.636363636,1399.72727272727,87.6363636363636
"6468","21712","2019",3,3,0,404706.666666667,4466,91.3333333333333
"6469","21713","2019",9,8,1,140845.444444444,1492.22222222222,92.2222222222222
"6470","21714","2019",5,5,0,284400,2792.6,106
"6471","21715","2019",3,3,0,73516.6666666667,906.333333333333,79.6666666666667
"6472","21717","2019",4,4,0,92250,779.5,95.25
"6473","22001","2019",8,8,0,62237.5,733.375,81.875
"6474","22002","2019",11,11,0,176804.545454545,1611.63636363636,109.181818181818
"6475","22003","2019",11,11,0,157089.454545455,1757.27272727273,88.4545454545455
"6476","22004","2019",71,71,0,105919.154929577,1312.3661971831,84
"6477","22005","2019",15,15,0,80994.8,968.2,86.4666666666667
"6478","22006","2019",3,3,0,78166.6666666667,864.666666666667,84
"6479","22008","2019",18,18,0,214640,1890.27777777778,111.111111111111
"6480","22009","2019",4,4,0,101250,1096.75,88.75
"6481","22011","2019",17,17,0,124952.941176471,1307.29411764706,95.4117647058823
"6482","22012","2019",9,9,0,136450,1198,116.222222222222
"6483","22013","2019",20,19,1,102757.85,1176.3,89.75
"6484","22014","2019",15,15,0,138981.666666667,1317.46666666667,106.533333333333
"6485","22015","2019",16,16,0,147278.75,1404.125,108.1875
"6486","22016","2019",12,11,1,488949.583333333,4356.33333333333,103.416666666667
"6487","22018","2019",8,8,0,140943.75,1405.125,100.875
"6488","22019","2019",6,6,0,136303.333333333,1180.33333333333,107.666666666667
"6489","22020","2019",39,36,3,111129.487179487,1251.02564102564,96.0769230769231
"6490","22021","2019",18,18,0,141333.333333333,1497.77777777778,96.1111111111111
"6491","22023","2019",14,14,0,99250,1130.92857142857,85.9285714285714
"6492","22024","2019",3,3,0,62666.6666666667,630.333333333333,95.3333333333333
"6493","22025","2019",39,38,1,92354.1538461538,957.641025641026,99.5128205128205
"6494","22026","2019",5,5,0,157340,1479.8,105.8
"6495","22027","2019",7,7,0,64514.2857142857,953.571428571429,65.1428571428571
"6496","22028","2019",8,8,0,129275,1405.375,93.375
"6497","22029","2019",1,1,0,82000,562,146
"6498","22030","2019",13,13,0,124891.230769231,1199.61538461538,106.923076923077
"6499","22031","2019",17,17,0,73580.5882352941,833.235294117647,94.5294117647059
"6500","22032","2019",31,31,0,121062.903225806,1123.09677419355,107.838709677419
"6501","22033","2019",9,9,0,97543.3333333333,1150.22222222222,85.2222222222222
"6502","22034","2019",15,15,0,117300,1321.86666666667,99.2
"6503","22035","2019",13,13,0,161230.769230769,1434.23076923077,114.769230769231
"6504","22036","2019",3,3,0,86500,1331,59.6666666666667
"6505","22037","2019",7,7,0,55257.1428571429,1036.42857142857,56.5714285714286
"6506","22039","2019",7,7,0,84285.7142857143,965.857142857143,90.1428571428571
"6507","22040","2019",4,4,0,89500,822,111
"6508","22041","2019",2,2,0,127500,1244.5,100
"6509","22042","2019",12,12,0,123500,1204.25,111.666666666667
"6510","22043","2019",3,3,0,147964.666666667,1047,136.333333333333
"6511","22044","2019",18,18,0,147652.222222222,1556.33333333333,96.7777777777778
"6512","22045","2019",4,4,0,113500,1125,98.75
"6513","22046","2019",92,91,1,90091.9565217391,957.021739130435,100.336956521739
"6514","22047","2019",20,20,0,83747.5,846.65,102.7
"6515","22048","2019",33,33,0,169049.757575758,1507.42424242424,114.69696969697
"6516","22049","2019",22,22,0,169232.954545455,1682.18181818182,102.318181818182
"6517","22050","2019",325,175,150,187332.107692308,2016.80307692308,93.3784615384615
"6518","22052","2019",5,5,0,51000,721,69.6
"6519","22053","2019",7,7,0,88071.4285714286,807.857142857143,106
"6520","22054","2019",131,86,45,210040.396946565,2546.6106870229,86.7251908396947
"6521","22055","2019",172,140,32,209630.296511628,2378.28488372093,93.2790697674419
"6522","22056","2019",20,20,0,132434,1472.05,91.2
"6523","22057","2019",5,5,0,131600,1310.2,103.2
"6524","22059","2019",13,13,0,138876.153846154,1270.46153846154,115
"6525","22060","2019",9,9,0,136344.444444444,1191.11111111111,112.888888888889
"6526","22061","2019",24,24,0,81800.8333333333,1030,84.0416666666667
"6527","22062","2019",6,6,0,98950,1026.5,91
"6528","22063","2019",18,18,0,89099.7222222222,962.444444444444,93.2222222222222
"6529","22064","2019",23,23,0,76667.1304347826,920.434782608696,89.5652173913043
"6530","22065","2019",20,19,1,145390.4,1278.65,115.25
"6531","22067","2019",44,44,0,122156.863636364,1305.88636363636,98.0227272727273
"6532","22068","2019",8,8,0,73125,774.125,94.5
"6533","22069","2019",6,6,0,156416.666666667,1245.33333333333,132.166666666667
"6534","22070","2019",112,60,52,94137.2767857143,1164.82142857143,84.0267857142857
"6535","22071","2019",6,6,0,115333.333333333,1400.5,91.5
"6536","22072","2019",5,5,0,80900,1321.6,65
"6537","22073","2019",6,6,0,109950,1044.66666666667,102.166666666667
"6538","22074","2019",12,12,0,112933.333333333,1096.58333333333,101.583333333333
"6539","22075","2019",5,5,0,90000,974.2,86.8
"6540","22076","2019",15,14,1,130700,1128.73333333333,120.333333333333
"6541","22077","2019",15,15,0,122886.666666667,1189.66666666667,106.733333333333
"6542","22079","2019",15,15,0,102540.333333333,1231.8,80.6666666666667
"6543","22081","2019",43,43,0,159689.558139535,1610,102.023255813953
"6544","22082","2019",16,16,0,153718.75,1530,104.375
"6545","22083","2019",13,13,0,91845,979,91.6923076923077
"6546","22084","2019",29,27,2,116642.551724138,1425.68965517241,88.6896551724138
"6547","22085","2019",8,8,0,206375,2086.625,107
"6548","22086","2019",17,17,0,148658.823529412,1375.88235294118,110.823529411765
"6549","22087","2019",15,15,0,63835,829,71
"6550","22088","2019",5,5,0,96500,1460.8,80.2
"6551","22090","2019",18,18,0,148219.444444444,1434,109.944444444444
"6552","22091","2019",6,6,0,104966.666666667,1163.33333333333,99.5
"6553","22092","2019",1,1,0,50000,403,124
"6554","22093","2019",243,166,77,147853.288065844,1687.11111111111,88.1316872427983
"6555","22094","2019",34,28,6,278010.352941176,3257.08823529412,91.0588235294118
"6556","22095","2019",1,1,0,92000,902,102
"6557","22096","2019",6,6,0,124916.666666667,1364,95
"6558","22097","2019",9,9,0,169238.888888889,1341.33333333333,128.111111111111
"6559","22098","2019",14,14,0,146698.571428571,1315,112.285714285714
"6560","22099","2019",13,13,0,97065.3846153846,1149.38461538462,88.1538461538462
"6561","22101","2019",26,26,0,128953.461538462,1265.42307692308,102.5
"6562","22103","2019",9,9,0,266838.777777778,2018.77777777778,126.222222222222
"6563","22104","2019",10,10,0,104050,1055.2,104.4
"6564","22105","2019",22,21,1,153734.454545455,1685.72727272727,103.409090909091
"6565","22106","2019",109,85,24,171655.633027523,1776.22935779817,97.1376146788991
"6566","22107","2019",21,21,0,93083.3333333333,908.47619047619,107.904761904762
"6567","22109","2019",10,10,0,132554.2,1368.8,92
"6568","22110","2019",9,9,0,125100,1256.55555555556,109.555555555556
"6569","22111","2019",6,6,0,161916.666666667,1752.5,97
"6570","22112","2019",5,5,0,112992,1387.8,88.4
"6571","22113","2019",345,232,113,133189.086956522,1536.51304347826,87.168115942029
"6572","22114","2019",19,19,0,107102.315789474,918.473684210526,124
"6573","22115","2019",7,7,0,94370.2857142857,731.857142857143,126.714285714286
"6574","22116","2019",8,8,0,68437.5,894.375,77
"6575","22117","2019",20,20,0,168421,1656.75,103.2
"6576","22118","2019",74,63,11,172822.635135135,1778.06756756757,102.094594594595
"6577","22119","2019",21,21,0,127416.047619048,1397.2380952381,88.3809523809524
"6578","22121","2019",28,28,0,139636.785714286,1448.89285714286,101.392857142857
"6579","22122","2019",10,10,0,59456,627.7,99.8
"6580","22124","2019",2,2,0,117064.5,1001.5,127
"6581","22126","2019",2,2,0,83750,1409.5,60
"6582","22127","2019",42,39,3,201470,1890.19047619048,111.309523809524
"6583","22128","2019",12,12,0,67000,830.333333333333,78.75
"6584","22129","2019",2,2,0,41500,731.5,53
"6585","22131","2019",17,17,0,78882.3529411765,864.647058823529,95.1176470588235
"6586","22132","2019",4,4,0,44750,735.75,65.5
"6587","22133","2019",9,9,0,113522.222222222,1044.77777777778,106.555555555556
"6588","22134","2019",59,58,1,205810.93220339,2061.23728813559,101.525423728814
"6589","22135","2019",32,32,0,107207.8125,1117.3125,104.46875
"6590","22136","2019",113,84,29,103874.601769912,1205.61946902655,91.5221238938053
"6591","22137","2019",35,35,0,66832.5714285714,706.942857142857,94.9428571428571
"6592","22138","2019",5,5,0,40680,671.4,64.4
"6593","22140","2019",9,8,1,130904.444444444,1455.11111111111,92
"6594","22141","2019",5,5,0,154000,1713.4,89.2
"6595","22143","2019",43,29,14,129459.76744186,1636.25581395349,80.4651162790698
"6596","22144","2019",7,7,0,157783.285714286,1485.14285714286,106.142857142857
"6597","22145","2019",17,17,0,114667.647058824,1118,102.705882352941
"6598","22146","2019",5,5,0,93200,2251.6,53.2
"6599","22147","2019",34,32,2,89792.6470588235,988.647058823529,91.3529411764706
"6600","22148","2019",5,5,0,119540,1343.8,94.2
"6601","22149","2019",8,8,0,55903.125,701.125,86.125
"6602","22150","2019",11,11,0,154727.272727273,1379.81818181818,110.545454545455
"6603","22152","2019",16,16,0,163846.875,1444.8125,112.0625
"6604","22153","2019",9,9,0,114888.888888889,1327.11111111111,84.1111111111111
"6605","22155","2019",19,19,0,97378.9473684211,1033.26315789474,92.3684210526316
"6606","22156","2019",7,7,0,62928.5714285714,786.714285714286,78.4285714285714
"6607","22157","2019",10,10,0,103453.6,1060.8,98
"6608","22158","2019",48,47,1,98214.7291666667,1034.35416666667,100.125
"6609","22160","2019",8,8,0,176312.5,1546.125,115.5
"6610","22161","2019",36,36,0,120942.611111111,1317,95.2222222222222
"6611","22162","2019",158,115,43,172973.658227848,2140.1835443038,84.2025316455696
"6612","22163","2019",16,16,0,89239.375,884.6875,99.5
"6613","22164","2019",26,26,0,93608.1153846154,981.076923076923,93.4230769230769
"6614","22165","2019",8,8,0,144175,1336,109.75
"6615","22166","2019",65,65,0,196962.292307692,2155.73846153846,98.1384615384615
"6616","22168","2019",241,146,95,191923.605809129,2474.24066390041,81.3029045643154
"6617","22169","2019",1,1,0,111750,1215,92
"6618","22170","2019",16,16,0,142525,1605.3125,91.9375
"6619","22171","2019",46,46,0,143275.956521739,1529.4347826087,97.5869565217391
"6620","22172","2019",60,45,15,132219.166666667,1462.3,92.4833333333333
"6621","22174","2019",11,11,0,151772.727272727,1663.90909090909,108.363636363636
"6622","22175","2019",19,19,0,119805.315789474,1235.94736842105,99.9473684210526
"6623","22176","2019",61,54,7,128033.704918033,1402.86885245902,92.6393442622951
"6624","22177","2019",15,15,0,156756.666666667,1596.93333333333,99.7333333333333
"6625","22178","2019",25,25,0,123125.72,1264.52,98.84
"6626","22179","2019",79,55,24,189043.911392405,2367.69620253165,85.253164556962
"6627","22180","2019",22,21,1,161374.090909091,1562.31818181818,105.545454545455
"6628","22181","2019",14,14,0,121542.857142857,1071.42857142857,112.142857142857
"6629","22182","2019",36,36,0,139297.805555556,1271.97222222222,111.777777777778
"6630","22183","2019",42,42,0,93230.3809523809,1002.83333333333,91.5
"6631","22184","2019",21,20,1,111621.904761905,969.47619047619,117.857142857143
"6632","22185","2019",30,29,1,105219.566666667,1305.4,86.7333333333333
"6633","22186","2019",144,76,68,223240.381944444,2865.28472222222,83.0833333333333
"6634","22187","2019",239,198,41,186226.560669456,2058.01255230126,91.7238493723849
"6635","22188","2019",9,9,0,123116.666666667,1262.88888888889,96.4444444444444
"6636","22189","2019",10,10,0,105117.5,1039.3,106.7
"6637","22190","2019",69,68,1,172179.811594203,1651.78260869565,104.652173913043
"6638","22193","2019",18,16,2,155038.888888889,1402.27777777778,115.222222222222
"6639","22194","2019",82,74,8,149936.780487805,1517.20731707317,102.134146341463
"6640","22195","2019",61,60,1,169766.885245902,1669.31147540984,102.180327868852
"6641","22196","2019",19,19,0,136266.578947368,1290.52631578947,101.157894736842
"6642","22197","2019",51,50,1,191845.666666667,1837.13725490196,100.960784313725
"6643","22198","2019",70,68,2,226763.142857143,2225.31428571429,100.9
"6644","22199","2019",10,10,0,112311,1160.3,107
"6645","22200","2019",5,5,0,107000,1302.4,82.4
"6646","22201","2019",26,24,2,194487.538461538,2039.46153846154,102
"6647","22202","2019",16,16,0,86862.5,993.9375,88.8125
"6648","22203","2019",53,51,2,107680.528301887,1078.03773584906,97.7547169811321
"6649","22204","2019",21,21,0,112163.333333333,1091.95238095238,98.5714285714286
"6650","22205","2019",11,11,0,134345.454545455,1220.81818181818,113.818181818182
"6651","22206","2019",57,53,4,126244.140350877,1293.31578947368,100.263157894737
"6652","22207","2019",32,32,0,118205.9375,1316.34375,95.21875
"6653","22208","2019",25,25,0,128470.56,1256.8,108.68
"6654","22209","2019",47,35,12,171175.255319149,2022.27659574468,84.6595744680851
"6655","22210","2019",74,73,1,234767.324324324,2265.32432432432,104.527027027027
"6656","22211","2019",64,64,0,161127.625,1537.515625,108.46875
"6657","22212","2019",18,18,0,90671.6666666667,1030.88888888889,88.5
"6658","22213","2019",61,57,4,234060.278688525,2213.80327868852,107.983606557377
"6659","22214","2019",83,83,0,159495.710843373,1797.66265060241,93.855421686747
"6660","22215","2019",117,104,13,134337,1460.35897435897,93.2991452991453
"6661","22216","2019",9,9,0,74166.6666666667,879,86.6666666666667
"6662","22217","2019",4,4,0,82375,920.75,97
"6663","22218","2019",25,25,0,187736,1923.72,99.16
"6664","22219","2019",31,31,0,110617.419354839,948.58064516129,121.548387096774
"6665","22220","2019",27,27,0,77081.4814814815,781.148148148148,99.962962962963
"6666","22221","2019",44,44,0,115537.477272727,1229.25,92.7045454545455
"6667","22222","2019",120,105,15,167604.525,1756.86666666667,96.5666666666667
"6668","22223","2019",30,30,0,107764.466666667,1184.33333333333,88.1
"6669","22224","2019",16,16,0,195809.3125,2422.1875,94.9375
"6670","22225","2019",64,58,6,111029.53125,1189.390625,92.609375
"6671","22226","2019",32,32,0,117031.875,1209.25,97.375
"6672","22227","2019",9,9,0,87266.6666666667,1128,84.8888888888889
"6673","22228","2019",20,20,0,91175,1017.95,92.7
"6674","22229","2019",19,19,0,90239.4736842105,856.842105263158,106.526315789474
"6675","22231","2019",10,10,0,71620,957.1,82.6
"6676","22232","2019",32,32,0,161705.9375,1627.3125,102.28125
"6677","22233","2019",44,44,0,138647.818181818,1475.86363636364,95.2045454545455
"6678","22234","2019",10,10,0,151968.5,1594.2,94.2
"6679","22235","2019",2,2,0,112500,898,128.5
"6680","22236","2019",11,11,0,128635.454545455,1337.45454545455,94.9090909090909
"6681","22237","2019",18,18,0,157451.111111111,1589.38888888889,106.722222222222
"6682","22238","2019",11,11,0,122681.818181818,1347.36363636364,93.1818181818182
"6683","22239","2019",21,21,0,131603.714285714,1302.85714285714,109.095238095238
"6684","22240","2019",15,15,0,77518.1333333333,1097.06666666667,75.1333333333333
"6685","22241","2019",15,15,0,77345.3333333333,837.4,92.8666666666667
"6686","22242","2019",24,23,1,173266.666666667,1677.5,105.791666666667
"6687","22243","2019",7,7,0,106925,959,113.857142857143
"6688","22244","2019",11,11,0,65153.6363636364,742.909090909091,92.4545454545455
"6689","22245","2019",17,17,0,92029.4117647059,1083.11764705882,90.3529411764706
"6690","22246","2019",5,5,0,108690,1324.6,88
"6691","22248","2019",30,30,0,134703.333333333,1305.5,102.3
"6692","22249","2019",13,13,0,85619.7692307692,777.923076923077,108.846153846154
"6693","22250","2019",14,9,5,93165.7142857143,1100.64285714286,84.5714285714286
"6694","22251","2019",115,108,7,205505.817391304,1926.02608695652,108.886956521739
"6695","22254","2019",8,8,0,113184.375,1123.375,100.125
"6696","22255","2019",5,5,0,87080,1030.8,83.6
"6697","22256","2019",21,21,0,100908.571428571,1003.90476190476,100.142857142857
"6698","22257","2019",5,5,0,134799.8,1248.8,108
"6699","22258","2019",56,55,1,141360.053571429,1461.03571428571,100.357142857143
"6700","22259","2019",61,57,4,167721.147540984,1734.26229508197,99.1803278688525
"6701","22260","2019",4,4,0,49500,663,80.75
"6702","22261","2019",6,6,0,148750,1270.16666666667,117
"6703","22262","2019",41,37,4,125831.707317073,1183.14634146341,112.414634146341
"6704","22263","2019",5,5,0,115092,1111,107
"6705","22264","2019",38,38,0,96026.0526315789,999.868421052632,98.9210526315789
"6706","22265","2019",21,21,0,136597.619047619,1288.52380952381,109.095238095238
"6707","22266","2019",60,59,1,70804.4166666667,784.766666666667,90.4
"6708","22267","2019",2,2,0,34500,552.5,63
"6709","22268","2019",12,12,0,127066.666666667,1417.41666666667,91
"6710","22269","2019",3,3,0,88183.3333333333,814,114.666666666667
"6711","22271","2019",6,6,0,111833.333333333,1143.5,103.5
"6712","22272","2019",22,20,2,120575.227272727,1318,90.7727272727273
"6713","22273","2019",32,32,0,191413.8125,1792,104.0625
"6714","22274","2019",5,5,0,152050,1350.2,112
"6715","22275","2019",10,10,0,76720,830,92.4
"6716","22277","2019",28,28,0,115426.785714286,1351.60714285714,87.8571428571429
"6717","22278","2019",1005,437,568,102127.547263682,1315.08358208955,76.2626865671642
"6718","22279","2019",13,13,0,83846.1538461538,1021.07692307692,84.9230769230769
"6719","22280","2019",12,12,0,123783.333333333,1460.33333333333,85.25
"6720","22281","2019",13,13,0,123086.153846154,1277.61538461538,97.3846153846154
"6721","22282","2019",161,93,68,214167.50310559,2695.49689440994,82.0124223602485
"6722","22283","2019",17,17,0,91632.3529411765,996.058823529412,95.6470588235294
"6723","22284","2019",5,5,0,95560,1314.4,78.4
"6724","22285","2019",1,1,0,40000,426,94
"6725","22286","2019",7,7,0,138528.571428571,1169.57142857143,129.571428571429
"6726","22287","2019",16,16,0,144021.25,1257.875,116.125
"6727","22288","2019",2,2,0,38500,380,101
"6728","22289","2019",3,3,0,69000,947.333333333333,86.6666666666667
"6729","22291","2019",2,2,0,95420,655,146
"6730","22293","2019",7,7,0,93271.4285714286,1075.57142857143,88
"6731","22294","2019",3,3,0,75666.6666666667,774.666666666667,95.6666666666667
"6732","22295","2019",5,5,0,83520,1000.2,82
"6733","22296","2019",11,11,0,112031.818181818,1208.09090909091,95.3636363636364
"6734","22299","2019",23,23,0,188778.260869565,1738.86956521739,109.608695652174
"6735","22300","2019",3,3,0,244166.666666667,2435,91.6666666666667
"6736","22302","2019",32,29,3,275443.34375,3119.65625,93.75
"6737","22304","2019",7,7,0,137571.428571429,1333.57142857143,121
"6738","22305","2019",6,6,0,91166.6666666667,847,113.166666666667
"6739","22306","2019",11,11,0,135000,1301.63636363636,106.636363636364
"6740","22307","2019",24,23,1,145037.25,1367.58333333333,105.833333333333
"6741","22308","2019",9,9,0,132535.555555556,1162.66666666667,107.111111111111
"6742","22309","2019",4,4,0,64625,892.25,73.25
"6743","22310","2019",9,9,0,102966.111111111,1070.55555555556,96.5555555555556
"6744","22311","2019",12,12,0,177958.333333333,1826.75,96.5833333333333
"6745","22312","2019",1,1,0,71800,1305,55
"6746","22313","2019",4,4,0,106250,1123,96.5
"6747","22314","2019",1,1,0,155000,1165,133
"6748","22315","2019",8,8,0,163625,1343.875,118.875
"6749","22316","2019",10,10,0,53140.5,663.7,80.6
"6750","22317","2019",5,5,0,96600,790.8,118.2
"6751","22318","2019",6,6,0,99364.6666666667,1039.33333333333,97.6666666666667
"6752","22319","2019",8,7,1,132687.5,1961.5,86
"6753","22320","2019",4,4,0,94500,1092,87.25
"6754","22321","2019",38,38,0,84715.7894736842,886.368421052632,86.4736842105263
"6755","22322","2019",2,2,0,102500,1135,91
"6756","22323","2019",19,19,0,135844.736842105,1422.57894736842,92.3684210526316
"6757","22324","2019",12,12,0,167166.666666667,1507.5,110.25
"6758","22325","2019",136,78,58,185593.477941176,2513.00735294118,78.0220588235294
"6759","22326","2019",10,10,0,136150,1271.8,106.3
"6760","22327","2019",27,27,0,188736.666666667,1747.59259259259,110.814814814815
"6761","22328","2019",13,13,0,60227.7692307692,768.384615384615,78.3846153846154
"6762","22330","2019",6,6,0,70750,752.166666666667,95
"6763","22331","2019",2,2,0,176250,1671,99
"6764","22332","2019",6,6,0,167100,1534,110.333333333333
"6765","22333","2019",4,4,0,52000,780.25,65.5
"6766","22334","2019",3,3,0,99166.6666666667,775.333333333333,109
"6767","22337","2019",16,16,0,77195.625,873.6875,82.625
"6768","22338","2019",9,9,0,110222.222222222,1095.66666666667,98.8888888888889
"6769","22339","2019",76,59,17,148477.815789474,1799.13157894737,84.3815789473684
"6770","22340","2019",13,13,0,129653.846153846,1250.07692307692,104.153846153846
"6771","22341","2019",6,6,0,150650,1547,103.833333333333
"6772","22342","2019",6,6,0,138000,1350.16666666667,95
"6773","22343","2019",103,68,35,197140.67961165,2239.27184466019,91.5825242718447
"6774","22344","2019",9,9,0,70777.7777777778,716.444444444444,93.6666666666667
"6775","22345","2019",18,18,0,104534.444444444,1317.27777777778,90.5555555555556
"6776","22346","2019",11,11,0,141681.818181818,1121.90909090909,114.545454545455
"6777","22347","2019",24,23,1,139293.75,1384.54166666667,101.291666666667
"6778","22348","2019",8,8,0,126731.25,1290.375,100.5
"6779","22349","2019",27,27,0,198519,1974.66666666667,101.62962962963
"6780","22350","2019",5,5,0,121600,1377.8,89.4
"6781","22351","2019",5,5,0,121737.2,1172.2,108.4
"6782","22352","2019",4,4,0,117654.5,1417.75,84.5
"6783","22353","2019",66,51,15,228866.924242424,2598.65151515152,92.2575757575758
"6784","22354","2019",11,11,0,112082.727272727,1167.63636363636,98.7272727272727
"6785","22356","2019",9,9,0,147327.777777778,1471.66666666667,99.2222222222222
"6786","22358","2019",4,4,0,72875,1143,62.25
"6787","22359","2019",5,5,0,117200,1132.6,100.2
"6788","22360","2019",108,97,11,153584.592592593,1643.31481481481,94.9537037037037
"6789","22361","2019",13,13,0,118334.615384615,1116.61538461538,102.153846153846
"6790","22362","2019",48,37,11,123728.958333333,1323.3125,97.0416666666667
"6791","22363","2019",31,31,0,191818.161290323,1787.64516129032,106
"6792","22364","2019",40,35,5,132438.15,1491.475,90.45
"6793","22365","2019",4,4,0,145625,1412.5,99.75
"6794","22366","2019",8,8,0,98523.75,1171.625,84.75
"6795","22368","2019",14,14,0,203164.285714286,2040.5,102.857142857143
"6796","22369","2019",10,10,0,98800,988.7,99.2
"6797","22370","2019",5,5,0,135894.2,1184.4,113
"6798","22371","2019",11,11,0,91382.7272727273,894.454545454545,87.1818181818182
"6799","22372","2019",23,21,2,116537.086956522,1296.13043478261,91.0869565217391
"6800","22373","2019",1,1,0,90000,789,114
"6801","22375","2019",12,12,0,141744.583333333,1458.66666666667,96.3333333333333
"6802","22376","2019",12,12,0,126750,1196.08333333333,122.333333333333
"6803","22377","2019",19,18,1,204288.157894737,2001.47368421053,108.052631578947
"6804","22378","2019",3,3,0,141000,1538.33333333333,91.6666666666667
"6805","22379","2019",42,36,6,173160.166666667,2480.69047619048,82.1428571428571
"6806","22380","2019",8,8,0,138350,1443.75,94.75
"6807","22381","2019",2,2,0,132675,1735,76.5
"6808","22383","2019",5,5,0,77000,861.4,98.6
"6809","22384","2019",5,5,0,108400,1013.4,108.4
"6810","22385","2019",17,17,0,207380.882352941,1882.05882352941,116.352941176471
"6811","22386","2019",7,7,0,102864.285714286,1210.71428571429,85.7142857142857
"6812","22387","2019",25,25,0,91596.16,1095.24,88.36
"6813","22388","2019",4,4,0,150375,1715.25,87
"6814","22389","2019",58,46,12,135504.655172414,1554.72413793103,88.7586206896552
"6815","22390","2019",12,12,0,165541.666666667,1479.08333333333,112.75
"6816","22391","2019",32,32,0,102357.5625,933.53125,108.71875
"6817","23001","2019",17,17,0,97995.2941176471,995.764705882353,95.0588235294118
"6818","23002","2019",11,11,0,88187.2727272727,887.636363636364,101.181818181818
"6819","23003","2019",3,3,0,73333.3333333333,856.333333333333,80
"6820","23004","2019",4,4,0,125400,1584,80.5
"6821","23005","2019",3,3,0,50150,642.666666666667,77.6666666666667
"6822","23006","2019",3,3,0,62333.3333333333,602,104.666666666667
"6823","23007","2019",3,3,0,102666.666666667,1418.66666666667,97
"6824","23008","2019",34,28,6,69445.1470588235,830.5,83.8529411764706
"6825","23009","2019",2,2,0,64925,714.5,91
"6826","23010","2019",1,1,0,22000,458,48
"6827","23011","2019",1,1,0,38000,594,64
"6828","23012","2019",3,3,0,86166.6666666667,989,98.3333333333333
"6829","23013","2019",13,13,0,95462.3076923077,994.615384615385,96.0769230769231
"6830","23015","2019",16,16,0,90263.8125,802.9375,105.625
"6831","23016","2019",2,2,0,79250,607,129.5
"6832","23017","2019",2,2,0,45730,614,73.5
"6833","23018","2019",3,3,0,55333.3333333333,714,79
"6834","23020","2019",3,3,0,83000,704.666666666667,123.333333333333
"6835","23021","2019",8,8,0,124248.375,1036.625,118.875
"6836","23022","2019",2,2,0,39950,1044.5,38.5
"6837","23024","2019",5,5,0,72720,688.2,107.6
"6838","23025","2019",18,18,0,96363.6666666667,1046.77777777778,92.5555555555556
"6839","23026","2019",8,8,0,85500,881.125,106.5
"6840","23027","2019",3,3,0,53333.3333333333,390,135
"6841","23028","2019",3,3,0,76966.6666666667,800,94.6666666666667
"6842","23029","2019",5,5,0,47900,678.8,72.4
"6843","23030","2019",21,19,2,66623.8095238095,756.761904761905,85.4761904761905
"6844","23031","2019",12,10,2,73375,997.916666666667,78.25
"6845","23032","2019",12,12,0,118620,1753.25,81.0833333333333
"6846","23033","2019",2,2,0,131000,803.5,162.5
"6847","23035","2019",4,4,0,103275,1237.75,80.25
"6848","23036","2019",16,16,0,73083.4375,858.75,87.6875
"6849","23037","2019",1,1,0,159000,1272,125
"6850","23038","2019",6,6,0,61333.3333333333,1287.16666666667,63.8333333333333
"6851","23039","2019",12,12,0,49625,634,84.5833333333333
"6852","23041","2019",2,2,0,65600,522.5,115.5
"6853","23042","2019",1,1,0,95000,805,118
"6854","23043","2019",2,2,0,60000,744.5,82.5
"6855","23044","2019",2,2,0,73000,583,143
"6856","23045","2019",9,9,0,55422.2222222222,651.444444444444,82
"6857","23046","2019",1,1,0,43500,572,76
"6858","23047","2019",5,5,0,64000,674,89.2
"6859","23048","2019",7,6,1,76285.7142857143,719,103.142857142857
"6860","23049","2019",10,10,0,108955,926.7,109.2
"6861","23050","2019",2,2,0,82500,894.5,97
"6862","23051","2019",1,1,0,53000,482,110
"6863","23052","2019",3,3,0,67266.6666666667,610,110.333333333333
"6864","23053","2019",2,2,0,99557.5,867.5,116
"6865","23054","2019",5,5,0,112800,964.8,111
"6866","23056","2019",13,13,0,67865.3846153846,849.076923076923,79.3076923076923
"6867","23057","2019",7,7,0,66714.2857142857,767.142857142857,89
"6868","23058","2019",1,1,0,76500,425,180
"6869","23060","2019",5,5,0,76200,818.2,106
"6870","23061","2019",9,8,1,74533.3333333333,805.666666666667,93.8888888888889
"6871","23062","2019",5,5,0,79400,728.2,114.6
"6872","23063","2019",3,3,0,120066.666666667,1232.66666666667,98.3333333333333
"6873","23064","2019",14,14,0,61833.7142857143,713.142857142857,86.7142857142857
"6874","23065","2019",3,3,0,74133.3333333333,780,81.6666666666667
"6875","23066","2019",4,4,0,55545.25,470,117.75
"6876","23067","2019",3,3,0,63783.3333333333,515.333333333333,121
"6877","23068","2019",10,10,0,61525,690.3,85.7
"6878","23069","2019",2,2,0,68000,907,74
"6879","23070","2019",11,10,1,125421.181818182,995.181818181818,110.545454545455
"6880","23071","2019",1,1,0,133000,1108,120
"6881","23072","2019",1,1,0,81800,1022,80
"6882","23073","2019",5,5,0,69700,708.4,97.6
"6883","23074","2019",2,2,0,42983,765.5,63.5
"6884","23075","2019",15,14,1,60562,685.533333333333,90.4666666666667
"6885","23076","2019",16,13,3,66580,903.9375,86.5625
"6886","23077","2019",12,12,0,60633.3333333333,712.166666666667,87.1666666666667
"6887","23078","2019",1,1,0,110000,1528,72
"6888","23079","2019",21,19,2,79100,1000.33333333333,86.6666666666667
"6889","23081","2019",1,1,0,189000,2554,74
"6890","23082","2019",4,4,0,114628,1499.25,82.5
"6891","23083","2019",1,1,0,20000,488,41
"6892","23084","2019",5,5,0,55800,625.6,88
"6893","23086","2019",2,2,0,113000,1564,71
"6894","23087","2019",9,9,0,83597.7777777778,836.666666666667,102
"6895","23088","2019",2,2,0,64350,535.5,121.5
"6896","23089","2019",6,6,0,97463.6666666667,1065.5,88.8333333333333
"6897","23090","2019",6,6,0,69754.3333333333,786,83.1666666666667
"6898","23091","2019",2,2,0,118205,1741,68
"6899","23092","2019",7,7,0,78907.1428571429,808.714285714286,86
"6900","23093","2019",25,25,0,100236.6,936,104.8
"6901","23095","2019",17,17,0,92620,980.647058823529,100.294117647059
"6902","23096","2019",163,102,61,83269.8159509203,960.319018404908,85.6932515337423
"6903","23097","2019",7,7,0,57800,628.142857142857,95.1428571428571
"6904","23099","2019",4,4,0,38125,492.75,77
"6905","23100","2019",3,3,0,115666.666666667,662.666666666667,174
"6906","23101","2019",4,4,0,105750,809.75,137.25
"6907","23102","2019",4,4,0,57250,847.25,71
"6908","23103","2019",8,8,0,63775,764.875,86.5
"6909","23104","2019",6,6,0,54166.6666666667,613.166666666667,94.8333333333333
"6910","23105","2019",1,1,0,77000,856,90
"6911","23106","2019",5,5,0,48570,760.6,66.6
"6912","23107","2019",2,2,0,62500,1045,67.5
"6913","23109","2019",1,1,0,40000,588,68
"6914","23110","2019",1,1,0,44000,367,120
"6915","23111","2019",2,2,0,80250,606,127
"6916","23112","2019",13,12,1,54850,734.846153846154,69
"6917","23113","2019",4,4,0,101750,1034.75,101.5
"6918","23114","2019",4,4,0,36500,606.75,78.75
"6919","23115","2019",4,4,0,57500,902.75,68.25
"6920","23116","2019",2,2,0,95750,715.5,143.5
"6921","23117","2019",1,1,0,70000,1944,36
"6922","23118","2019",2,2,0,49250,513.5,99
"6923","23120","2019",2,2,0,58000,790,83
"6924","23123","2019",1,1,0,67000,893,75
"6925","23124","2019",17,17,0,84813.2941176471,883.647058823529,102.411764705882
"6926","23125","2019",2,2,0,29850,1132.5,28.5
"6927","23127","2019",2,2,0,58000,685.5,88.5
"6928","23128","2019",2,2,0,37900,915,45
"6929","23129","2019",1,1,0,130100,971,134
"6930","23130","2019",7,7,0,40357.1428571429,529.571428571429,77.8571428571429
"6931","23131","2019",11,9,2,49454.5454545455,646.454545454545,75.5454545454545
"6932","23132","2019",5,5,0,75902,971,82.2
"6933","23133","2019",5,5,0,59400,573.8,103.8
"6934","23134","2019",2,2,0,107900,900.5,119
"6935","23136","2019",3,3,0,67333.3333333333,963.666666666667,73.6666666666667
"6936","23137","2019",6,6,0,63833.3333333333,788.666666666667,82.1666666666667
"6937","23138","2019",1,1,0,41000,512,80
"6938","23139","2019",8,8,0,79743.75,953.875,98.875
"6939","23140","2019",8,8,0,60250,660,90.625
"6940","23141","2019",6,6,0,55831.6666666667,774,72.8333333333333
"6941","23142","2019",6,6,0,71025,662.833333333333,107.666666666667
"6942","23143","2019",6,6,0,93398.1666666667,783.166666666667,126.666666666667
"6943","23144","2019",5,5,0,56600,636.8,86.4
"6944","23145","2019",3,3,0,77600,824.333333333333,113.333333333333
"6945","23146","2019",6,6,0,66916.6666666667,774.166666666667,101.833333333333
"6946","23147","2019",1,1,0,41000,820,50
"6947","23148","2019",5,5,0,39786,474.8,84.8
"6948","23149","2019",8,8,0,80018.75,1054.5,77.125
"6949","23150","2019",1,1,0,35000,538,65
"6950","23151","2019",6,6,0,78333.3333333333,840.833333333333,96.6666666666667
"6951","23152","2019",1,1,0,58000,563,103
"6952","23154","2019",7,7,0,84381,966,90.7142857142857
"6953","23155","2019",4,4,0,102428.5,1141.75,84
"6954","23156","2019",2,2,0,41255,634,69.5
"6955","23158","2019",2,2,0,77500,761.5,97.5
"6956","23159","2019",2,2,0,95500,687.5,133.5
"6957","23160","2019",2,2,0,90000,850,105
"6958","23162","2019",4,4,0,51207.5,644.25,76
"6959","23164","2019",8,8,0,110436.25,1054.375,106
"6960","23165","2019",12,12,0,75835.4166666667,1408.5,63.1666666666667
"6961","23167","2019",6,6,0,79883.3333333333,777,103.5
"6962","23168","2019",10,10,0,83730,1133.3,91
"6963","23169","2019",9,9,0,85231.6666666667,930.777777777778,99.1111111111111
"6964","23172","2019",4,4,0,97600,778,130.25
"6965","23173","2019",3,3,0,55750,562,102.333333333333
"6966","23174","2019",8,8,0,70562.5,726.875,94.875
"6967","23175","2019",2,2,0,88000,916,97.5
"6968","23176","2019",50,42,8,88820.1,1009.7,90.72
"6969","23177","2019",6,6,0,82166.6666666667,916,91.1666666666667
"6970","23178","2019",6,6,0,84166.6666666667,1115.5,84.6666666666667
"6971","23179","2019",2,2,0,87500,984.5,89
"6972","23180","2019",4,3,1,82025,1031.75,77
"6973","23181","2019",3,3,0,61333.3333333333,726.333333333333,82.6666666666667
"6974","23183","2019",1,1,0,65000,602,108
"6975","23184","2019",2,2,0,67500,646,107.5
"6976","23185","2019",3,3,0,50743.3333333333,791,82
"6977","23186","2019",2,2,0,119000,1120.5,111.5
"6978","23187","2019",2,2,0,24250,464.5,54.5
"6979","23188","2019",8,8,0,56281.25,656.625,88.75
"6980","23189","2019",17,17,0,94620,873.764705882353,113.470588235294
"6981","23190","2019",1,1,0,90000,1023,88
"6982","23191","2019",1,1,0,1e+05,870,115
"6983","23192","2019",21,21,0,79391.4285714286,859.952380952381,94.3333333333333
"6984","23193","2019",26,25,1,91955,965.576923076923,93.6538461538462
"6985","23194","2019",1,1,0,47000,560,84
"6986","23195","2019",6,6,0,101500,933.333333333333,113.833333333333
"6987","23197","2019",2,2,0,50080,772.5,59.5
"6988","23198","2019",1,1,0,1e+05,1000,100
"6989","23199","2019",5,5,0,95164,1048.6,108
"6990","23200","2019",2,2,0,175185,774.5,190
"6991","23201","2019",2,2,0,1e+05,719,190
"6992","23202","2019",2,2,0,57500,578,93.5
"6993","23203","2019",1,1,0,105000,1364,77
"6994","23205","2019",3,3,0,76333.3333333333,815.666666666667,92.6666666666667
"6995","23206","2019",6,6,0,147696.666666667,1341.5,110.5
"6996","23207","2019",1,1,0,80000,952,84
"6997","23208","2019",2,2,0,87650,946,88.5
"6998","23209","2019",4,4,0,103000,953,100.5
"6999","23210","2019",1,1,0,208000,1300,160
"7000","23211","2019",7,7,0,56357.1428571429,731.285714285714,78.1428571428571
"7001","23212","2019",1,1,0,492000,1608,306
"7002","23213","2019",3,3,0,164950,1115.33333333333,167
"7003","23214","2019",2,2,0,123000,910,135.5
"7004","23215","2019",1,1,0,145000,1074,135
"7005","23216","2019",7,7,0,79714.2857142857,798.428571428571,94.2857142857143
"7006","23217","2019",6,6,0,87475,798.166666666667,109.833333333333
"7007","23218","2019",1,1,0,52800,629,84
"7008","23219","2019",9,9,0,106500,991.111111111111,107.777777777778
"7009","23220","2019",12,12,0,93180.8333333333,990.416666666667,105.5
"7010","23221","2019",3,3,0,61733.3333333333,759.333333333333,78.6666666666667
"7011","23222","2019",5,5,0,63880,705.4,91.8
"7012","23223","2019",6,6,0,93456.6666666667,1045.83333333333,101.5
"7013","23224","2019",1,1,0,140000,1228,114
"7014","23225","2019",1,1,0,228000,1036,220
"7015","23226","2019",1,1,0,96000,980,98
"7016","23227","2019",3,3,0,60333.3333333333,577.666666666667,101.666666666667
"7017","23229","2019",2,2,0,107875,786.5,145
"7018","23230","2019",3,3,0,40333.3333333333,527.333333333333,87.3333333333333
"7019","23232","2019",5,5,0,98600,643.2,131.8
"7020","23233","2019",3,3,0,86666.6666666667,933.333333333333,83.3333333333333
"7021","23234","2019",1,1,0,84000,750,112
"7022","23235","2019",2,2,0,63000,558.5,107.5
"7023","23238","2019",4,4,0,63875,933.75,70
"7024","23239","2019",10,9,1,60399.5,785.3,78.8
"7025","23240","2019",10,10,0,84350,829,90.3
"7026","23241","2019",1,1,0,50000,909,55
"7027","23242","2019",3,3,0,98100,922,95
"7028","23243","2019",1,1,0,370000,1850,200
"7029","23244","2019",3,3,0,88666.6666666667,746.333333333333,111.333333333333
"7030","23245","2019",17,17,0,76914.7058823529,943.294117647059,81.5882352941177
"7031","23246","2019",3,3,0,80666.6666666667,879.333333333333,89.6666666666667
"7032","23247","2019",26,26,0,75958.8461538462,1047.61538461538,82.3076923076923
"7033","23248","2019",6,6,0,98816.6666666667,1027.16666666667,98.3333333333333
"7034","23249","2019",5,5,0,83800,911.6,90.4
"7035","23250","2019",3,3,0,91666.6666666667,759.333333333333,125.333333333333
"7036","23251","2019",3,3,0,94066.6666666667,876.666666666667,104
"7037","23252","2019",2,2,0,62500,933.5,67
"7038","23253","2019",4,4,0,90000,1002,88.5
"7039","23254","2019",2,2,0,148000,1127.5,122
"7040","23255","2019",1,1,0,46500,489,95
"7041","23257","2019",7,7,0,106657.142857143,886,126.714285714286
"7042","23258","2019",3,3,0,107500,738.666666666667,143.333333333333
"7043","23260","2019",5,5,0,42000,618.6,64.8
"7044","23261","2019",1,1,0,80000,792,101
"7045","23262","2019",4,4,0,59728,552.75,105.25
"7046","23263","2019",2,2,0,110000,1256,88
"7047","23264","2019",1,1,0,233800,1901,123
"7048","23266","2019",1,1,0,40000,533,75
"7049","24001","2019",10,10,0,122518,1461.1,96.4
"7050","24002","2019",13,13,0,142165.307692308,1296.15384615385,104.615384615385
"7051","24004","2019",5,5,0,227560,1969.4,122.8
"7052","24005","2019",4,4,0,193725,1723.75,120.25
"7053","24006","2019",3,2,1,106000,1413,91.6666666666667
"7054","24007","2019",6,6,0,112700,1093.5,110
"7055","24008","2019",5,5,0,97862,1063,89.2
"7056","24009","2019",2,2,0,193000,3115.5,77.5
"7057","24010","2019",16,16,0,152618.75,1517.9375,106.1875
"7058","24011","2019",9,9,0,131972.222222222,1441.88888888889,96.2222222222222
"7059","24012","2019",2,2,0,155675,2251.5,69
"7060","24014","2019",10,10,0,207150,1620.9,130
"7061","24015","2019",6,6,0,200791.666666667,1525.66666666667,125.833333333333
"7062","24016","2019",11,11,0,79254.5454545455,1066.72727272727,80
"7063","24018","2019",2,2,0,70000,1085,65
"7064","24019","2019",9,9,0,92616.6666666667,1351.11111111111,66.7777777777778
"7065","24020","2019",10,10,0,201447.5,1907.1,104.8
"7066","24021","2019",5,5,0,139670,1314,97.4
"7067","24022","2019",6,6,0,226336.666666667,1850.83333333333,115.166666666667
"7068","24023","2019",4,4,0,131125,1324,99.25
"7069","24024","2019",2,2,0,260000,1805.5,171.5
"7070","24025","2019",5,5,0,196921.2,1967,89.6
"7071","24026","2019",35,35,0,160093.314285714,1472.77142857143,113.828571428571
"7072","24027","2019",10,10,0,149300,1280.9,124.1
"7073","24028","2019",32,32,0,159969.1875,1597.90625,97.25
"7074","24029","2019",4,4,0,98992.5,877.5,121.75
"7075","24030","2019",4,4,0,173678,1685,103.25
"7076","24031","2019",2,2,0,125000,1217,103.5
"7077","24032","2019",4,4,0,121340,904,136
"7078","24034","2019",4,4,0,192750,1502.75,126.25
"7079","24035","2019",23,23,0,115917.391304348,1217.26086956522,99.7826086956522
"7080","24036","2019",3,3,0,262468.333333333,1684.33333333333,160.333333333333
"7081","24037","2019",550,397,153,120565.967272727,1402.78,86.8945454545455
"7082","24038","2019",6,6,0,141777.5,1183.33333333333,119.333333333333
"7083","24039","2019",2,2,0,138500,989.5,140
"7084","24040","2019",3,3,0,188463.333333333,1624,124.666666666667
"7085","24042","2019",7,7,0,118171.428571429,1170.14285714286,102.857142857143
"7086","24043","2019",3,3,0,223000,1956.33333333333,117.333333333333
"7087","24045","2019",4,4,0,247537.5,2012.25,126
"7088","24046","2019",2,2,0,30500,517,63
"7089","24048","2019",4,4,0,158180,1657.75,97.25
"7090","24050","2019",3,3,0,135000,1564.66666666667,93.3333333333333
"7091","24051","2019",3,3,0,200490.333333333,1565.33333333333,132.333333333333
"7092","24052","2019",1,1,0,120000,1714,70
"7093","24053","2019",86,59,27,154513.953488372,1586.38372093023,95.7093023255814
"7094","24054","2019",7,7,0,114914.285714286,987.285714285714,108.714285714286
"7095","24055","2019",7,7,0,159300,1544.85714285714,105
"7096","24056","2019",3,3,0,217946,3388.66666666667,76.6666666666667
"7097","24058","2019",4,4,0,81914.75,1008.75,85.75
"7098","24059","2019",3,3,0,134333.333333333,1881,92.3333333333333
"7099","24061","2019",1,1,0,160000,1151,139
"7100","24062","2019",2,2,0,291622.5,1372.5,214.5
"7101","24063","2019",5,5,0,155797,1427.8,112.8
"7102","24064","2019",38,38,0,146768.289473684,1403.47368421053,107.131578947368
"7103","24066","2019",2,2,0,142500,1770,82.5
"7104","24067","2019",49,49,0,145033.489795918,1608.18367346939,90.9387755102041
"7105","24068","2019",30,29,1,162976.933333333,1412.96666666667,113.866666666667
"7106","24069","2019",5,5,0,128200,1466.8,85.6
"7107","24070","2019",14,14,0,123822.5,957.642857142857,119.928571428571
"7108","24071","2019",8,8,0,153545,1008.75,126.625
"7109","24073","2019",8,8,0,132937.5,1292.75,108.375
"7110","24074","2019",6,6,0,126233.333333333,1471.66666666667,88.3333333333333
"7111","24075","2019",6,6,0,154111.666666667,1401.66666666667,116.166666666667
"7112","24076","2019",4,4,0,102575,1097.75,90.25
"7113","24077","2019",5,5,0,139500,1210.4,119
"7114","24080","2019",6,6,0,138833.333333333,1393,106
"7115","24081","2019",10,10,0,130111.7,1093.4,117.8
"7116","24082","2019",16,16,0,238121.5625,2301.875,115.1875
"7117","24083","2019",1,1,0,116300,895,130
"7118","24084","2019",1,1,0,315000,2072,152
"7119","24085","2019",1,1,0,67000,931,72
"7120","24086","2019",8,7,1,230511.25,1689,140.625
"7121","24087","2019",10,10,0,154319,1639.1,102.2
"7122","24088","2019",3,3,0,198666.666666667,1586.66666666667,132.333333333333
"7123","24090","2019",6,6,0,94000,1011.5,95
"7124","24091","2019",19,19,0,225654.736842105,1829.84210526316,124.368421052632
"7125","24094","2019",3,3,0,113333.333333333,1417.33333333333,93.3333333333333
"7126","24095","2019",5,5,0,145830.4,1754.2,91.8
"7127","24096","2019",10,10,0,120566.3,1133.2,104.5
"7128","24097","2019",8,7,1,114000,991,119.375
"7129","24098","2019",49,37,12,184222.795918367,1736.65306122449,101.571428571429
"7130","24100","2019",8,8,0,79218.75,861.875,91.125
"7131","24101","2019",3,3,0,148761.666666667,1361,113.333333333333
"7132","24102","2019",53,45,8,139410.377358491,1673.75471698113,89.7924528301887
"7133","24104","2019",7,7,0,99921.4285714286,1213.14285714286,85.1428571428571
"7134","24105","2019",2,2,0,219340,936,218
"7135","24106","2019",5,5,0,157000,1326.8,111
"7136","24107","2019",4,4,0,143000,2265.25,75.25
"7137","24108","2019",6,6,0,148595.833333333,1409.5,106.5
"7138","24109","2019",3,3,0,165866.666666667,1706,97
"7139","24111","2019",1,1,0,199000,1990,100
"7140","24113","2019",2,2,0,220085,1267.5,180
"7141","24115","2019",20,20,0,157625,1449.25,105.4
"7142","24116","2019",3,3,0,160600,1384,116.333333333333
"7143","24117","2019",6,6,0,145858.666666667,1377.66666666667,108.333333333333
"7144","24119","2019",7,7,0,149037.857142857,1186,123.428571428571
"7145","24120","2019",8,8,0,81708.875,877.75,88.625
"7146","24124","2019",5,5,0,116600,1172.6,96.4
"7147","24126","2019",2,2,0,176400,1465,118.5
"7148","24128","2019",2,2,0,123400,736,190
"7149","24129","2019",8,8,0,85635,1050.875,88.5
"7150","24130","2019",9,9,0,145222.222222222,1464.77777777778,106.666666666667
"7151","24131","2019",1,1,0,92000,639,144
"7152","24132","2019",1,1,0,43000,796,54
"7153","24133","2019",25,25,0,69444,944.56,76.88
"7154","24134","2019",12,12,0,129250,961.75,130.416666666667
"7155","24135","2019",3,3,0,112333.333333333,1241.33333333333,93
"7156","24136","2019",1,1,0,88600,1214,73
"7157","24137","2019",5,5,0,160880,1098.8,141
"7158","24138","2019",138,112,26,115878.797101449,1328.39855072464,88.6086956521739
"7159","24139","2019",24,24,0,156493.125,1499.41666666667,105.666666666667
"7160","24140","2019",16,16,0,157537.5,1534,103.0625
"7161","24141","2019",4,4,0,94437.75,1112.25,83.75
"7162","24142","2019",15,15,0,166506.666666667,1566.46666666667,109.266666666667
"7163","24143","2019",7,7,0,168990.285714286,1535.14285714286,108.428571428571
"7164","24144","2019",2,2,0,55000,982,59
"7165","24145","2019",16,15,1,145143.9375,1511.1875,96.75
"7166","24146","2019",3,3,0,230990,2027,112.666666666667
"7167","24147","2019",20,20,0,115695.2,1278.5,93.1
"7168","24148","2019",10,10,0,158631.1,1236,113.9
"7169","24150","2019",9,9,0,174322.222222222,1775.77777777778,98.8888888888889
"7170","24151","2019",2,2,0,120000,1952.5,62
"7171","24152","2019",25,25,0,204660.84,2149.6,99.92
"7172","24153","2019",7,7,0,153682.857142857,1340.71428571429,110.428571428571
"7173","24154","2019",4,4,0,117500,1672.25,87
"7174","24155","2019",9,9,0,272688.888888889,2231.33333333333,132.333333333333
"7175","24156","2019",10,9,1,130470,1321.3,101.1
"7176","24157","2019",16,16,0,110077.25,1272.75,88.8125
"7177","24158","2019",6,6,0,123833.333333333,1285.66666666667,106.833333333333
"7178","24159","2019",6,6,0,125500,1833.16666666667,73.1666666666667
"7179","24160","2019",5,5,0,164300,1498.8,110.6
"7180","24161","2019",1,1,0,283680,2488,114
"7181","24162","2019",6,6,0,143700,1309.5,111.833333333333
"7182","24163","2019",1,1,0,85000,1771,48
"7183","24164","2019",13,12,1,116438.461538462,1344.38461538462,93.3076923076923
"7184","24165","2019",6,6,0,230825,1614.33333333333,108.333333333333
"7185","24167","2019",55,54,1,148887.836363636,1414.50909090909,103.454545454545
"7186","24168","2019",5,5,0,179811.8,1382.2,153.8
"7187","24171","2019",9,9,0,90444.4444444444,961.555555555556,105
"7188","24172","2019",21,20,1,179424.047619048,1531.71428571429,117.761904761905
"7189","24174","2019",2,2,0,120000,2100,57.5
"7190","24175","2019",5,5,0,280328,1888.8,153.2
"7191","24176","2019",1,1,0,239876,2423,99
"7192","24177","2019",8,8,0,160321.25,1359.375,124.375
"7193","24179","2019",7,7,0,144142.857142857,1435.42857142857,98.2857142857143
"7194","24180","2019",2,2,0,135000,770,181
"7195","24182","2019",22,22,0,127858.636363636,1245.54545454545,103.545454545455
"7196","24183","2019",3,3,0,2e+05,2076.33333333333,92.3333333333333
"7197","24184","2019",6,6,0,188333.333333333,1752.33333333333,108
"7198","24186","2019",8,8,0,139793.75,1126.75,122.625
"7199","24188","2019",3,3,0,116266.666666667,1242.33333333333,87.6666666666667
"7200","24189","2019",5,5,0,86250,1000,87.4
"7201","24190","2019",2,2,0,181250,1510.5,120
"7202","24191","2019",2,2,0,86000,576.5,156.5
"7203","24192","2019",3,3,0,296700,2498.33333333333,115.666666666667
"7204","24193","2019",6,6,0,209508.333333333,1797.33333333333,113.666666666667
"7205","24194","2019",23,23,0,137197.826086957,1356.60869565217,102.695652173913
"7206","24195","2019",2,2,0,66000,1055.5,61
"7207","24196","2019",6,6,0,97891.6666666667,1051.16666666667,93
"7208","24197","2019",12,12,0,179348.75,1628,111.333333333333
"7209","24199","2019",2,2,0,88250,957.5,90
"7210","24200","2019",8,8,0,155182.5,1701.5,95.625
"7211","24205","2019",9,9,0,115524,1251.22222222222,93.7777777777778
"7212","24207","2019",11,11,0,128926.090909091,1641,81.3636363636364
"7213","24208","2019",1,1,0,112000,1867,60
"7214","24209","2019",3,3,0,103366.666666667,994.333333333333,96.3333333333333
"7215","24210","2019",4,3,1,135075,1429.5,89.25
"7216","24211","2019",13,12,1,172638.461538462,1609.15384615385,119.923076923077
"7217","24212","2019",22,22,0,136806.136363636,1479,98.2272727272727
"7218","24214","2019",9,8,1,75411.1111111111,774,89.4444444444444
"7219","24215","2019",2,2,0,544466.5,7223.5,80.5
"7220","24216","2019",1,1,0,30000,366,82
"7221","24217","2019",6,6,0,206323.166666667,1727.83333333333,120.166666666667
"7222","24218","2019",23,23,0,111966.956521739,1325.95652173913,86.2173913043478
"7223","24220","2019",3,3,0,132400,1325.66666666667,98
"7224","24221","2019",1,1,0,40000,556,72
"7225","24222","2019",27,27,0,146168.703703704,1544.03703703704,94.7407407407407
"7226","24223","2019",48,46,2,135511.979166667,1403.10416666667,98.625
"7227","24224","2019",10,10,0,197035,1505.2,134.7
"7228","24225","2019",31,31,0,156783.548387097,1542.64516129032,112.741935483871
"7229","24226","2019",14,14,0,154563.785714286,1453.57142857143,112
"7230","24227","2019",13,13,0,84844.2307692308,954.153846153846,103.461538461538
"7231","24228","2019",5,5,0,190440,1500.4,123.2
"7232","24229","2019",11,11,0,110545.454545455,1407.36363636364,91.1818181818182
"7233","24230","2019",3,3,0,124000,1247.66666666667,98.3333333333333
"7234","24231","2019",3,3,0,146333.333333333,1490,95
"7235","24234","2019",4,4,0,226675,1275,169.5
"7236","24236","2019",9,9,0,155053.333333333,1567.77777777778,104.222222222222
"7237","24237","2019",12,12,0,186173.583333333,1864.66666666667,114.166666666667
"7238","24238","2019",3,3,0,130000,1224,98.6666666666667
"7239","24240","2019",3,3,0,313433.333333333,2677.33333333333,116
"7240","24241","2019",7,7,0,212754.285714286,1485.14285714286,135.857142857143
"7241","24242","2019",1,1,0,185850,1430,130
"7242","24243","2019",13,13,0,113386.076923077,984.076923076923,116.923076923077
"7243","24244","2019",1,1,0,45000,818,55
"7244","24245","2019",1,1,0,162000,2025,80
"7245","24246","2019",6,6,0,282067,1854.5,148.666666666667
"7246","24247","2019",3,3,0,94598,890,114
"7247","24248","2019",6,6,0,134666.666666667,1219,112.666666666667
"7248","24251","2019",10,10,0,153603.4,1285.9,116.2
"7249","24252","2019",9,9,0,180260.222222222,1603.33333333333,115.777777777778
"7250","24253","2019",22,21,1,102669.954545455,960.818181818182,110.681818181818
"7251","24254","2019",3,3,0,147908.333333333,2054.66666666667,77
"7252","24255","2019",2,2,0,179500,1645,107.5
"7253","24256","2019",41,31,10,121692.682926829,1444.63414634146,83.8048780487805
"7254","24257","2019",2,2,0,177500,1559.5,111.5
"7255","24259","2019",23,23,0,158288.47826087,1415.17391304348,109.608695652174
"7256","24260","2019",5,5,0,189936.2,1586,102.8
"7257","24261","2019",2,2,0,115250,1699,70
"7258","24262","2019",3,3,0,188683.333333333,1431,137.666666666667
"7259","24263","2019",2,2,0,137325,1332,106.5
"7260","24264","2019",34,34,0,124945.588235294,1421.23529411765,86.6176470588235
"7261","24266","2019",13,13,0,148331.153846154,1332.23076923077,116.307692307692
"7262","24267","2019",2,2,0,262500,1678,147.5
"7263","24268","2019",10,10,0,207900,1582.4,132.6
"7264","24269","2019",13,13,0,144300.769230769,1417.15384615385,97
"7265","24271","2019",12,12,0,121041.666666667,1288,102.833333333333
"7266","24272","2019",4,4,0,249597.5,1676.5,152
"7267","24273","2019",4,4,0,135980,1496.25,91.25
"7268","24274","2019",6,6,0,276333.333333333,2060.83333333333,147.666666666667
"7269","24276","2019",9,9,0,211967.333333333,1608,121.444444444444
"7270","24277","2019",3,3,0,151266.666666667,1409.66666666667,107.333333333333
"7271","24278","2019",2,2,0,172000,1739.5,106.5
"7272","24280","2019",12,12,0,193958.333333333,1684.75,110.916666666667
"7273","24281","2019",1,1,0,74000,822,90
"7274","24282","2019",2,2,0,70000,966.5,72.5
"7275","24284","2019",4,4,0,124125,1544.25,75.5
"7276","24285","2019",6,6,0,216700,2031,106.166666666667
"7277","24286","2019",5,5,0,126865,1700.2,93.6
"7278","24287","2019",2,2,0,355250,1972,181.5
"7279","24288","2019",3,3,0,164565.666666667,1586.33333333333,99.3333333333333
"7280","24289","2019",28,28,0,131898.571428571,1310.07142857143,106.071428571429
"7281","24290","2019",1,1,0,159270,1810,88
"7282","24291","2019",49,42,7,120867.836734694,1435.24489795918,84.5714285714286
"7283","24292","2019",12,12,0,149632.5,1361.75,119
"7284","24293","2019",2,2,0,208000,1495,140
"7285","24294","2019",99,97,2,120849.878787879,1291.50505050505,96.5151515151515
"7286","24295","2019",10,10,0,123940,1395.1,90.1
"7287","24296","2019",19,19,0,100772.631578947,1039.57894736842,96.6315789473684
"7288","24297","2019",17,15,2,117012.117647059,1310.41176470588,91.8235294117647
"7289","24299","2019",47,44,3,99104.3829787234,1165.48936170213,89.8297872340426
"7290","24300","2019",5,5,0,177350,1249.4,132.6
"7291","24301","2019",5,5,0,111798,1087.4,101.6
"7292","24302","2019",2,2,0,165750,1851.5,90
"7293","24303","2019",2,2,0,170691,1434.5,116
"7294","24304","2019",13,13,0,130884.615384615,1345.76923076923,94.4615384615385
"7295","24305","2019",2,2,0,111000,1199,97.5
"7296","24307","2019",3,3,0,115436.666666667,1447.66666666667,89.3333333333333
"7297","24308","2019",10,10,0,82780,1102.4,88.6
"7298","24309","2019",48,48,0,118051.333333333,1222.79166666667,99.6458333333333
"7299","24311","2019",38,37,1,102922.789473684,1046.55263157895,102.894736842105
"7300","24312","2019",56,47,9,167745.357142857,1765.125,98.8571428571429
"7301","24316","2019",13,13,0,106115.384615385,1255,87.7692307692308
"7302","24317","2019",3,3,0,131333.333333333,1207.33333333333,109
"7303","24318","2019",8,8,0,159599.375,1978.875,84.125
"7304","24319","2019",7,7,0,153776.571428571,1576.57142857143,108.571428571429
"7305","24320","2019",10,10,0,107350,1044.6,104.5
"7306","24321","2019",12,11,1,122895.416666667,1267.75,94.5833333333333
"7307","24322","2019",590,227,363,119253.055932203,1605.66101694915,75.0305084745763
"7308","24323","2019",4,4,0,77825.75,773,99.75
"7309","24324","2019",5,5,0,185000,1486,128.4
"7310","24325","2019",4,4,0,328912.5,3104.75,134.25
"7311","24326","2019",8,8,0,189606.25,1902.75,110.5
"7312","24327","2019",1,1,0,288000,1152,250
"7313","24328","2019",17,15,2,89227.6470588235,1057.41176470588,90.4705882352941
"7314","24329","2019",19,19,0,121172.894736842,1268.94736842105,105.631578947368
"7315","24330","2019",11,11,0,212095.454545455,2218.09090909091,99.8181818181818
"7316","24331","2019",5,5,0,193128,1364.8,140.2
"7317","24334","2019",4,4,0,142125,1330.75,111.25
"7318","24335","2019",28,27,1,172692.857142857,1735.32142857143,117.678571428571
"7319","24336","2019",1,1,0,230000,2371,97
"7320","24337","2019",2,2,0,177500,1091.5,150
"7321","24338","2019",7,7,0,248457.142857143,1579.71428571429,152.142857142857
"7322","24339","2019",3,3,0,86333.3333333333,1020.33333333333,84.6666666666667
"7323","24340","2019",50,50,0,158611.86,1436.2,108.24
"7324","24341","2019",6,6,0,242900,2256,114.833333333333
"7325","24345","2019",6,6,0,162166.666666667,1487.5,118.5
"7326","24346","2019",7,7,0,170428.571428571,1217.28571428571,119.857142857143
"7327","24347","2019",3,3,0,180063,1324,131.333333333333
"7328","24348","2019",9,9,0,141550.444444444,1324.44444444444,107.111111111111
"7329","24349","2019",4,4,0,151375,1231.25,127.75
"7330","24350","2019",35,33,2,128215.142857143,1451.05714285714,90.5142857142857
"7331","24351","2019",2,2,0,162500,918,175.5
"7332","24352","2019",52,51,1,109263.25,1219.98076923077,92.8269230769231
"7333","24353","2019",3,3,0,100220.333333333,726.666666666667,134.666666666667
"7334","24354","2019",33,33,0,103119.848484848,1187.45454545455,89.8787878787879
"7335","24355","2019",4,4,0,231368,2165.75,106
"7336","24356","2019",26,26,0,176809.615384615,1530.15384615385,116.307692307692
"7337","24357","2019",4,4,0,203915,1174.5,195
"7338","24360","2019",2,2,0,217000,1501.5,144
"7339","24361","2019",5,5,0,143270,1225.8,112
"7340","24362","2019",20,20,0,143145,1432.35,101.65
"7341","24364","2019",3,3,0,138770,1308.33333333333,112.666666666667
"7342","24365","2019",2,2,0,135250,1597.5,85
"7343","24366","2019",7,7,0,199335.714285714,1915.85714285714,110
"7344","24370","2019",26,26,0,156328.653846154,1233.5,123.5
"7345","24371","2019",8,8,0,195153,1504.375,137
"7346","24372","2019",72,51,21,112664.305555556,1301.59722222222,86.5555555555556
"7347","24373","2019",7,7,0,199140,1324.42857142857,144.857142857143
"7348","24374","2019",5,5,0,115984,1490.4,80
"7349","24375","2019",1,1,0,310000,1856,167
"7350","24376","2019",17,17,0,110528.529411765,1139.88235294118,97.8235294117647
"7351","24378","2019",4,4,0,99750,1069.5,91.75
"7352","24379","2019",2,2,0,165000,1083.5,143.5
"7353","24380","2019",6,6,0,170210,1425.83333333333,133.5
"7354","24381","2019",2,2,0,66325,855.5,90
"7355","24382","2019",7,7,0,129760,1076.85714285714,106.428571428571
"7356","24383","2019",3,3,0,165000,1184,141.666666666667
"7357","24384","2019",1,1,0,3e+05,1339,224
"7358","24385","2019",1,1,0,4e+05,1544,259
"7359","24386","2019",1,1,0,71500,1277,56
"7360","24388","2019",6,6,0,166102.333333333,1699.33333333333,99
"7361","24390","2019",3,3,0,151000,1528,100
"7362","24392","2019",5,5,0,209283,1635.4,128.4
"7363","24393","2019",1,1,0,74000,822,90
"7364","24394","2019",3,3,0,52166.6666666667,774.333333333333,68.6666666666667
"7365","24395","2019",5,5,0,183810,1544,124.4
"7366","24396","2019",22,21,1,142680.909090909,1475.72727272727,99.8636363636364
"7367","24397","2019",2,2,0,50000,1166.5,75
"7368","24398","2019",17,17,0,109758.823529412,1136.76470588235,104.529411764706
"7369","24401","2019",4,4,0,97481.25,1139.75,68.75
"7370","24404","2019",1,1,0,1e+05,606,165
"7371","24405","2019",4,4,0,175250,1170.5,154.75
"7372","24408","2019",2,2,0,157500,1146,133.5
"7373","24409","2019",21,21,0,112421.428571429,1142.19047619048,100.904761904762
"7374","24410","2019",8,8,0,72395,894.25,84.875
"7375","24411","2019",3,3,0,134044.333333333,757.666666666667,175.333333333333
"7376","24412","2019",11,11,0,227571.727272727,2811.18181818182,91.8181818181818
"7377","24413","2019",3,3,0,149833.333333333,1366,109
"7378","24414","2019",6,6,0,142966.666666667,1360.83333333333,108.5
"7379","24415","2019",6,6,0,191483.333333333,1546.66666666667,126
"7380","24416","2019",4,4,0,209250,1949.25,88.5
"7381","24417","2019",8,8,0,131921.25,1492.5,89.5
"7382","24418","2019",15,14,1,113524.4,1249.2,90.4
"7383","24419","2019",12,12,0,135614.583333333,1357.08333333333,99.3333333333333
"7384","24420","2019",1,1,0,90000,1125,80
"7385","24421","2019",1,1,0,170000,1466,116
"7386","24422","2019",3,3,0,263293.333333333,1686.66666666667,159
"7387","24423","2019",5,5,0,183230,1567.8,138.8
"7388","24424","2019",1,1,0,233000,1664,140
"7389","24425","2019",11,11,0,125054.545454545,1111.09090909091,120.272727272727
"7390","24426","2019",1,1,0,190000,2714,70
"7391","24428","2019",12,12,0,120520.166666667,1392.83333333333,86.6666666666667
"7392","24429","2019",1,1,0,2e+05,3333,60
"7393","24432","2019",9,9,0,178404.555555556,1798.33333333333,93.8888888888889
"7394","24434","2019",2,2,0,101750,1476.5,68
"7395","24436","2019",13,13,0,116148.384615385,1118.92307692308,104.153846153846
"7396","24437","2019",10,10,0,203370,1558.4,141.6
"7397","24438","2019",2,2,0,107875,802.5,134
"7398","24441","2019",1,1,0,285000,5700,50
"7399","24442","2019",26,26,0,98017.6923076923,1148.15384615385,84.3461538461538
"7400","24443","2019",8,8,0,165535.875,2530.875,67.5
"7401","24444","2019",2,2,0,86250,978.5,88
"7402","24445","2019",7,7,0,192292.428571429,1332.71428571429,143.285714285714
"7403","24446","2019",1,1,0,80000,2000,40
"7404","24448","2019",5,5,0,138455,1166,119.8
"7405","24449","2019",13,13,0,118158.846153846,1242.92307692308,98
"7406","24450","2019",12,11,1,132995.833333333,1413.16666666667,99.1666666666667
"7407","24451","2019",9,9,0,78565,881.666666666667,81.5555555555556
"7408","24452","2019",4,4,0,187022.5,1048.75,150
"7409","24453","2019",6,6,0,152666.666666667,1034.66666666667,147
"7410","24454","2019",14,14,0,228531.571428571,1770,129.642857142857
"7411","24455","2019",4,4,0,156967.5,1376.5,115.5
"7412","24456","2019",2,2,0,149265,1482,87.5
"7413","24457","2019",1,1,0,167000,3340,50
"7414","24458","2019",3,3,0,137000,1076.66666666667,123
"7415","24459","2019",3,3,0,192333.333333333,1218.66666666667,148.333333333333
"7416","24460","2019",4,4,0,128645.25,1289.5,113.25
"7417","24461","2019",16,16,0,108209.375,1053.9375,107.125
"7418","24462","2019",20,20,0,108551.5,1108.6,101.8
"7419","24463","2019",4,4,0,104875,1136.25,87.75
"7420","24464","2019",5,5,0,80162.8,880.4,89.4
"7421","24465","2019",2,2,0,149000,1215,117
"7422","24466","2019",6,6,0,147474.833333333,1416.83333333333,111.666666666667
"7423","24468","2019",2,2,0,212500,1412.5,150.5
"7424","24470","2019",7,7,0,152795.714285714,1895.28571428571,109.428571428571
"7425","24471","2019",4,4,0,243750,1846.75,156.5
"7426","24472","2019",11,11,0,215308.181818182,1762.36363636364,133.090909090909
"7427","24473","2019",6,6,0,116240.166666667,1269.83333333333,100.166666666667
"7428","24474","2019",2,2,0,57500,773.5,81.5
"7429","24476","2019",1,1,0,210000,1438,146
"7430","24477","2019",4,4,0,301270,1538.5,181
"7431","24479","2019",27,27,0,95710.5185185185,899.037037037037,108.814814814815
"7432","24480","2019",6,6,0,174259.666666667,1868.16666666667,95
"7433","24481","2019",9,9,0,127678.888888889,1796.66666666667,76.5555555555556
"7434","24482","2019",5,5,0,104640,1053.2,120
"7435","24483","2019",1,1,0,250000,1064,235
"7436","24484","2019",16,16,0,142575,1271,110.625
"7437","24485","2019",6,6,0,115261.666666667,1290.5,87.8333333333333
"7438","24486","2019",6,6,0,90750,1320.33333333333,81.8333333333333
"7439","24487","2019",21,21,0,132064.857142857,1196.90476190476,118.095238095238
"7440","24488","2019",4,4,0,143000,1278.75,111.75
"7441","24489","2019",7,7,0,127955.857142857,998.285714285714,121.857142857143
"7442","24490","2019",9,9,0,130714.444444444,1073.77777777778,121
"7443","24491","2019",10,10,0,163974.5,1299.9,115.6
"7444","24493","2019",1,1,0,109570,1660,66
"7445","24494","2019",9,9,0,126537.777777778,1288.88888888889,98.6666666666667
"7446","24496","2019",3,3,0,168333.333333333,1570,111.333333333333
"7447","24498","2019",21,20,1,148570.904761905,1406.52380952381,104.142857142857
"7448","24499","2019",13,13,0,175829.230769231,1559.46153846154,110.230769230769
"7449","24500","2019",1,1,0,212000,752,282
"7450","24501","2019",15,15,0,134766.666666667,1164.93333333333,123.066666666667
"7451","24504","2019",4,4,0,111200,1075,98.75
"7452","24505","2019",9,9,0,81045,949.222222222222,104.777777777778
"7453","24507","2019",5,5,0,76406,1011.8,76.4
"7454","24509","2019",7,7,0,103250,1138.57142857143,90
"7455","24510","2019",7,7,0,136714.285714286,1917.57142857143,73.5714285714286
"7456","24511","2019",2,2,0,90000,720,119
"7457","24512","2019",1,1,0,50000,714,70
"7458","24513","2019",2,2,0,114500,894,126
"7459","24514","2019",3,3,0,175333.333333333,2136.33333333333,95
"7460","24515","2019",3,3,0,185966.666666667,1488,120
"7461","24516","2019",22,22,0,183450.681818182,1710.72727272727,107.181818181818
"7462","24517","2019",1,1,0,291500,3101,94
"7463","24518","2019",2,2,0,127300,1231,106.5
"7464","24519","2019",5,5,0,103935,1528,70.6
"7465","24520","2019",188,120,68,142222.792553191,1776.23936170213,85.968085106383
"7466","24521","2019",16,16,0,134457.6875,1230,103.125
"7467","24522","2019",5,5,0,189873,2183.8,102
"7468","24523","2019",4,4,0,106987.5,1116,91.5
"7469","24524","2019",5,5,0,206400,1580.8,135
"7470","24525","2019",1,1,0,54511,649,84
"7471","24526","2019",15,15,0,96348.3333333333,1031.26666666667,92.8
"7472","24527","2019",18,18,0,116405,1122.44444444444,105.111111111111
"7473","24528","2019",1,1,0,169250,990,171
"7474","24529","2019",2,2,0,85600,1057.5,75.5
"7475","24531","2019",1,1,0,117000,680,172
"7476","24532","2019",4,4,0,224975,1262.5,179.25
"7477","24533","2019",1,1,0,40000,367,109
"7478","24534","2019",21,21,0,187818.571428571,1639.71428571429,109.142857142857
"7479","24535","2019",4,4,0,212750,1782.25,127.75
"7480","24536","2019",2,2,0,133000,1571,90
"7481","24537","2019",4,4,0,118822.5,1200.25,93.25
"7482","24538","2019",12,12,0,133981,1394.16666666667,98.9166666666667
"7483","24540","2019",18,18,0,114376.666666667,1281.27777777778,91.9444444444444
"7484","24543","2019",20,20,0,120052.5,1251.85,97.9
"7485","24544","2019",2,2,0,125000,860.5,144.5
"7486","24547","2019",78,55,23,96909.858974359,1275.32051282051,76.9230769230769
"7487","24548","2019",4,4,0,113462.5,1303,81.25
"7488","24549","2019",4,4,0,237480,2314.75,107.5
"7489","24550","2019",17,17,0,115829.411764706,1167.17647058824,101.941176470588
"7490","24551","2019",31,28,3,96709.6774193548,944.322580645161,104.645161290323
"7491","24552","2019",2,2,0,263500,1793,158
"7492","24553","2019",18,18,0,80783.6111111111,913.5,90.4444444444444
"7493","24554","2019",10,10,0,109392.5,1080.7,101.9
"7494","24555","2019",5,5,0,94600,1040.2,88.2
"7495","24557","2019",129,101,28,137764.240310078,1570.29457364341,88.2558139534884
"7496","24558","2019",11,11,0,199909.090909091,1679.09090909091,134.727272727273
"7497","24559","2019",3,3,0,133103.333333333,1684.33333333333,74.3333333333333
"7498","24560","2019",1,1,0,41000,707,58
"7499","24562","2019",1,1,0,207000,1643,126
"7500","24563","2019",6,6,0,176666.666666667,1619.33333333333,107.333333333333
"7501","24564","2019",10,10,0,131957.6,1427.7,98.8
"7502","24565","2019",9,9,0,86918.8888888889,874.222222222222,105.111111111111
"7503","24566","2019",8,8,0,84625,997.625,85.125
"7504","24567","2019",1,1,0,115000,1494,77
"7505","24568","2019",19,17,2,115922.473684211,1088.84210526316,107.263157894737
"7506","24569","2019",1,1,0,90000,1286,70
"7507","24571","2019",14,13,1,184571.428571429,1583.78571428571,114.857142857143
"7508","24572","2019",3,3,0,259366.666666667,2321,104.333333333333
"7509","24573","2019",5,5,0,113200.8,1034.8,111.2
"7510","24574","2019",5,5,0,173400,1617,100
"7511","24575","2019",2,2,0,280000,2285.5,114.5
"7512","24576","2019",6,6,0,241916.666666667,1658.16666666667,141
"7513","24577","2019",7,7,0,159328.571428571,1607,90.8571428571429
"7514","24580","2019",6,6,0,101096.333333333,1191,89.1666666666667
"7515","24581","2019",8,8,0,162812.5,1487.5,117.375
"7516","24582","2019",10,10,0,192010.4,1645,116.6
"7517","24584","2019",26,26,0,125352.961538462,1216.42307692308,105.192307692308
"7518","24585","2019",12,12,0,97808.3333333333,1211.41666666667,96.75
"7519","24586","2019",12,11,1,129312.166666667,1364.66666666667,102.083333333333
"7520","24587","2019",12,11,1,156539.25,1776.16666666667,99.9166666666667
"7521","25001","2019",2,2,0,164950,1702,96
"7522","25002","2019",3,3,0,128000,1281.66666666667,100
"7523","25004","2019",15,11,4,151354.466666667,1364.2,111.466666666667
"7524","25005","2019",1,1,0,27000,338,80
"7525","25007","2019",1,1,0,143800,992,145
"7526","25008","2019",6,6,0,152616.666666667,1413,119.833333333333
"7527","25009","2019",3,2,1,90666.6666666667,855,116
"7528","25011","2019",7,7,0,198814.285714286,1956,100.571428571429
"7529","25012","2019",2,2,0,194250,1773.5,104.5
"7530","25013","2019",4,2,2,99291.5,1299,74.25
"7531","25014","2019",13,11,2,154119.230769231,1900.23076923077,91.2307692307692
"7532","25015","2019",3,2,1,82504.6666666667,1195.66666666667,86.6666666666667
"7533","25016","2019",3,3,0,190183.333333333,1305.33333333333,147.333333333333
"7534","25018","2019",2,2,0,129500,1558.5,80
"7535","25019","2019",4,4,0,115340,965,113.5
"7536","25020","2019",13,7,6,96500,1257.23076923077,74.6923076923077
"7537","25021","2019",14,14,0,124837.928571429,1368,92.8571428571429
"7538","25022","2019",22,21,1,155830,1416.59090909091,114.909090909091
"7539","25024","2019",8,3,5,205084.375,2381.625,90.625
"7540","25025","2019",9,9,0,201733.333333333,2193.77777777778,98.6666666666667
"7541","25026","2019",3,3,0,130666.666666667,1472,88.6666666666667
"7542","25029","2019",2,1,1,105500,1311,83.5
"7543","25030","2019",2,2,0,213750,2178.5,98.5
"7544","25031","2019",164,98,66,110804.317073171,1265.00609756098,87.030487804878
"7545","25032","2019",2,2,0,212600,1479,143
"7546","25033","2019",7,7,0,122164.285714286,1394.42857142857,90.7142857142857
"7547","25035","2019",25,23,2,231691.8,1975.24,118.28
"7548","25036","2019",25,16,9,199676,1835.88,105.8
"7549","25038","2019",6,6,0,154399.5,1501.66666666667,114
"7550","25039","2019",10,10,0,192255,1889.8,122.5
"7551","25040","2019",11,8,3,139887.909090909,1474.45454545455,93.8181818181818
"7552","25041","2019",3,1,2,82666.6666666667,535,151.333333333333
"7553","25042","2019",1,1,0,2e+05,2273,88
"7554","25043","2019",23,14,9,141610,1461.04347826087,99.6086956521739
"7555","25044","2019",1,1,0,115000,1150,100
"7556","25046","2019",2,2,0,73000,1164,57
"7557","25047","2019",82,50,32,114513.536585366,1305.36585365854,85.4024390243902
"7558","25048","2019",39,31,8,140514.230769231,1569.10256410256,86.6923076923077
"7559","25049","2019",1,1,0,335000,3073,109
"7560","25050","2019",1,1,0,249000,2567,97
"7561","25051","2019",6,5,1,169716.666666667,1133.5,169.5
"7562","25052","2019",1,1,0,83250,724,115
"7563","25054","2019",4,4,0,233854.25,1957.25,115.75
"7564","25055","2019",3,3,0,179666.666666667,1908.33333333333,98.3333333333333
"7565","25056","2019",1982,215,1767,127678.024217962,1869.11957618567,69.1337033299697
"7566","25057","2019",36,29,7,117194.722222222,1271.97222222222,91.9444444444444
"7567","25058","2019",24,13,11,175831.25,1879.20833333333,95.6666666666667
"7568","25059","2019",1,1,0,179900,1353,133
"7569","25060","2019",4,1,3,148150,2381.25,65.75
"7570","25061","2019",1,1,0,33800,1690,20
"7571","25063","2019",14,10,4,167929.428571429,1665.92857142857,102.571428571429
"7572","25067","2019",3,3,0,147000,1179.66666666667,116.333333333333
"7573","25070","2019",3,3,0,87567.3333333333,1003,84.3333333333333
"7574","25071","2019",9,2,7,79522.2222222222,1197.33333333333,64.6666666666667
"7575","25073","2019",6,6,0,163783.333333333,1602.83333333333,109.5
"7576","25074","2019",8,7,1,212795,1951.125,110.875
"7577","25075","2019",6,6,0,189364.833333333,1668.33333333333,109.666666666667
"7578","25078","2019",9,9,0,145308.888888889,1638.33333333333,98.2222222222222
"7579","25079","2019",4,2,2,145000,1094.25,128.25
"7580","25082","2019",7,7,0,165500,1848.57142857143,89.1428571428571
"7581","25083","2019",2,2,0,96500,1228,94
"7582","25084","2019",14,10,4,184252.142857143,1924.92857142857,96
"7583","25085","2019",4,3,1,197855.5,1926.25,102
"7584","25086","2019",2,2,0,160250,1849.5,104
"7585","25087","2019",2,2,0,77500,1102.5,63.5
"7586","25088","2019",1,1,0,125000,1389,90
"7587","25089","2019",2,2,0,229750,1636.5,141
"7588","25091","2019",4,4,0,174000,1975.75,89.25
"7589","25094","2019",1,1,0,55000,611,90
"7590","25095","2019",4,2,2,145218.5,1204.25,114.5
"7591","25096","2019",1,1,0,253500,2148,118
"7592","25097","2019",3,3,0,297960,2082.33333333333,143.666666666667
"7593","25098","2019",1,1,0,402000,1827,220
"7594","25099","2019",1,1,0,239400,1260,190
"7595","25100","2019",9,2,7,185820.555555556,1777.22222222222,105.111111111111
"7596","25101","2019",8,8,0,254329.375,1781,144.5
"7597","25103","2019",7,6,1,193147.142857143,2045,93.4285714285714
"7598","25105","2019",12,11,1,165944.166666667,1540.5,102.083333333333
"7599","25106","2019",2,2,0,114413,925.5,122.5
"7600","25108","2019",5,4,1,218900,1838.8,121
"7601","25109","2019",6,5,1,152741.666666667,1494.83333333333,106.833333333333
"7602","25110","2019",16,8,8,268014.75,2687.75,108.75
"7603","25111","2019",8,5,3,139252.25,1598,88.875
"7604","25112","2019",28,11,17,155854.571428571,1833.32142857143,85.1785714285714
"7605","25113","2019",3,3,0,185666.666666667,1994,98
"7606","25114","2019",5,5,0,114383,1166.8,114.2
"7607","25115","2019",1,1,0,245800,2892,85
"7608","25116","2019",1,1,0,270336,1287,210
"7609","25117","2019",1,1,0,247200,2026,122
"7610","25119","2019",2,2,0,109500,1757.5,61.5
"7611","25120","2019",1,1,0,268810,1780,151
"7612","25121","2019",2,2,0,743000,6246,132.5
"7613","25122","2019",7,5,2,208185.714285714,1634.85714285714,130.428571428571
"7614","25124","2019",5,5,0,219520.4,2027.4,109.2
"7615","25125","2019",5,5,0,101594,1051.2,93
"7616","25126","2019",5,5,0,164000,1556.2,107.8
"7617","25127","2019",62,31,31,168897.870967742,1835.79032258065,93.1129032258064
"7618","25129","2019",1,1,0,130000,929,140
"7619","25131","2019",3,3,0,202000,2285.66666666667,105.333333333333
"7620","25132","2019",2,2,0,237150,1670.5,156.5
"7621","25133","2019",16,13,3,221921.875,2008.125,112.25
"7622","25136","2019",4,4,0,145310,1495.25,97
"7623","25138","2019",1,1,0,150000,1064,141
"7624","25139","2019",5,3,2,245270,2371,111.4
"7625","25141","2019",1,1,0,50360,719,70
"7626","25142","2019",5,3,2,144105,2270.8,57.8
"7627","25143","2019",3,3,0,194716.666666667,1497.66666666667,132
"7628","25145","2019",2,2,0,92500,677.5,129
"7629","25147","2019",21,18,3,208285.714285714,2125.38095238095,99.8571428571429
"7630","25148","2019",9,9,0,291316.666666667,2536.77777777778,116.777777777778
"7631","25149","2019",3,3,0,150474,2150.33333333333,63
"7632","25150","2019",6,6,0,237238.333333333,1914.83333333333,120.166666666667
"7633","25154","2019",3,2,1,91645.3333333333,1129.33333333333,85
"7634","25155","2019",1,1,0,135000,1298,104
"7635","25156","2019",10,10,0,90566.4,1152.6,84.4
"7636","25157","2019",17,6,11,208000,2565.41176470588,85.0588235294118
"7637","25159","2019",17,12,5,104569.823529412,1293.82352941176,81.5294117647059
"7638","25160","2019",7,7,0,293721.428571429,2502.85714285714,118
"7639","25162","2019",3,3,0,226866.666666667,2058,118
"7640","25164","2019",2,2,0,217600,1854,116.5
"7641","25170","2019",22,16,6,164411.409090909,1589.68181818182,100.590909090909
"7642","25172","2019",2,2,0,194650,1724.5,119.5
"7643","25174","2019",10,9,1,161645,1555.2,120.8
"7644","25175","2019",1,1,0,125000,1761,71
"7645","25176","2019",3,3,0,182133.333333333,1814.33333333333,109.333333333333
"7646","25177","2019",2,2,0,133500,887.5,143
"7647","25180","2019",6,6,0,157083.333333333,1496.66666666667,104.5
"7648","25181","2019",1,1,0,60000,750,80
"7649","25182","2019",1,1,0,147900,1590,93
"7650","25184","2019",3,3,0,92400,673,141.333333333333
"7651","25186","2019",9,6,3,191981.111111111,1962.22222222222,96.3333333333333
"7652","25187","2019",6,6,0,142083.333333333,1198.83333333333,125.833333333333
"7653","25188","2019",4,4,0,169497.5,2048.5,80.5
"7654","25190","2019",20,16,4,151226.7,1666.05,88.85
"7655","25191","2019",6,6,0,115666.666666667,1174.5,113.666666666667
"7656","25192","2019",2,2,0,165435,3748.5,64.5
"7657","25193","2019",21,15,6,174490.476190476,1784.71428571429,101.666666666667
"7658","25194","2019",1,1,0,99000,943,105
"7659","25195","2019",14,13,1,180619.285714286,1617.5,115.571428571429
"7660","25196","2019",11,9,2,152304.545454545,1480.45454545455,106.818181818182
"7661","25197","2019",12,6,6,112367.5,1620.33333333333,70.8333333333333
"7662","25198","2019",3,3,0,100833.333333333,904.666666666667,111
"7663","25199","2019",4,4,0,98775,1131.25,84.75
"7664","25200","2019",9,8,1,224462.222222222,2150.33333333333,105
"7665","25201","2019",17,4,13,193608.823529412,2530.41176470588,80.1764705882353
"7666","25202","2019",4,3,1,215000,1855.5,126.75
"7667","25203","2019",1,1,0,130000,1340,97
"7668","25204","2019",45,18,27,225474.8,2642.17777777778,88.3111111111111
"7669","25207","2019",12,11,1,183129.166666667,1575.5,111.583333333333
"7670","25208","2019",1,1,0,120000,1600,75
"7671","25209","2019",2,2,0,188500,1430,136.5
"7672","25210","2019",2,2,0,206825,2013,113.5
"7673","25211","2019",1,1,0,123000,6833,18
"7674","25212","2019",22,18,4,221923.727272727,2239.81818181818,100.090909090909
"7675","25213","2019",11,10,1,234309.090909091,2322.27272727273,102.727272727273
"7676","25214","2019",5,5,0,187082,1431.2,129.4
"7677","25215","2019",1,1,0,257000,1353,190
"7678","25216","2019",2,2,0,159400,1600,99.5
"7679","25217","2019",4,4,0,191701.25,1160.25,157.5
"7680","25219","2019",5,4,1,174600,1599.8,109.6
"7681","25220","2019",6,6,0,125877.166666667,1273.16666666667,100
"7682","25221","2019",2,2,0,74000,1760,75.5
"7683","25222","2019",13,11,2,176047.692307692,1733.92307692308,103.692307692308
"7684","25223","2019",3,3,0,161000,1249,141.666666666667
"7685","25224","2019",10,10,0,146865,1406.8,106
"7686","25225","2019",3,3,0,153666.666666667,1346.33333333333,119
"7687","25226","2019",3,3,0,182000,1650.66666666667,109.666666666667
"7688","25227","2019",4,1,3,151037.5,1712.25,87.25
"7689","25228","2019",36,32,4,169079.944444444,1569.33333333333,106.583333333333
"7690","25229","2019",1,1,0,203000,2707,75
"7691","25230","2019",39,33,6,146137.282051282,1534.76923076923,99.8205128205128
"7692","25232","2019",1,1,0,35000,467,75
"7693","25233","2019",2,2,0,57500,744,77
"7694","25234","2019",1,0,1,135000,1392,97
"7695","25235","2019",4,3,1,199875.25,1670.25,124.25
"7696","25236","2019",2,2,0,201500,1919.5,105
"7697","25237","2019",32,28,4,125231.25,1373.34375,90.125
"7698","25238","2019",4,3,1,152687,1027,153.25
"7699","25239","2019",2,2,0,1e+05,1109,88
"7700","25240","2019",30,27,3,267312.8,2596.73333333333,107.733333333333
"7701","25241","2019",3,3,0,157516.666666667,1895.66666666667,98.3333333333333
"7702","25242","2019",2,2,0,103112.5,1309.5,80.5
"7703","25243","2019",5,5,0,125600,1707.4,73.4
"7704","25244","2019",1,1,0,55000,3235,17
"7705","25245","2019",9,8,1,216849.444444444,1991.77777777778,116
"7706","25246","2019",1,1,0,39000,696,56
"7707","25248","2019",5,5,0,155800,2028.4,85
"7708","25249","2019",1,1,0,80329,669,120
"7709","25253","2019",2,2,0,191000,1669,116.5
"7710","25254","2019",17,6,11,176658.235294118,2385.64705882353,91
"7711","25255","2019",6,3,3,152083.333333333,1725.33333333333,90.8333333333333
"7712","25256","2019",8,4,4,164940,2083.75,93.25
"7713","25257","2019",2,2,0,186000,1452,128
"7714","25258","2019",21,16,5,239143.333333333,2195.57142857143,111.190476190476
"7715","25259","2019",35,22,13,191146.257142857,2083.71428571429,97.2571428571429
"7716","25262","2019",3,3,0,194846.666666667,2116,96.3333333333333
"7717","25263","2019",3,2,1,219333.333333333,2137.66666666667,118
"7718","25264","2019",1,1,0,180000,1978,91
"7719","25265","2019",12,10,2,220579.166666667,2044.33333333333,108.833333333333
"7720","25267","2019",16,14,2,198839.5625,1681.625,118.9375
"7721","25269","2019",1,1,0,194100,2181,89
"7722","25270","2019",1,1,0,177400,1674,106
"7723","25271","2019",10,8,2,233965,2350.4,102.2
"7724","25274","2019",6,3,3,113916.666666667,1100.66666666667,106
"7725","25275","2019",4,4,0,86125,1463,85.25
"7726","25278","2019",3,3,0,217650,1706.66666666667,126.666666666667
"7727","25279","2019",1,1,0,17000,340,50
"7728","25280","2019",10,10,0,151903.6,2241.2,89.7
"7729","25281","2019",1,1,0,205000,1708,120
"7730","25282","2019",4,3,1,177375,1648.75,108.75
"7731","25283","2019",1,1,0,150000,877,171
"7732","25284","2019",49,28,21,125500.285714286,1429.48979591837,91.5918367346939
"7733","25285","2019",20,16,4,265420.5,2395.35,124.95
"7734","25286","2019",2,2,0,260000,1925,133
"7735","25287","2019",18,17,1,235126.388888889,2105.5,111.833333333333
"7736","25288","2019",8,6,2,220453.75,2177.5,104.875
"7737","25290","2019",1,1,0,65000,929,70
"7738","25293","2019",13,5,8,247244.538461538,2764.92307692308,93.0769230769231
"7739","25295","2019",5,3,2,252190,2995.2,95.4
"7740","25296","2019",16,12,4,216055.6875,2233.5625,102.75
"7741","25298","2019",2,2,0,137800,1524.5,93
"7742","25299","2019",1,1,0,110000,1250,88
"7743","25300","2019",3,3,0,184633.333333333,1584.66666666667,113.333333333333
"7744","25301","2019",4,4,0,225825,1895.75,121.25
"7745","25303","2019",1,1,0,350000,2000,175
"7746","25304","2019",48,30,18,106335.416666667,1188.14583333333,87.9791666666667
"7747","25305","2019",4,2,2,181525,1604,115
"7748","25307","2019",28,12,16,236523.821428571,2835.42857142857,81.8928571428571
"7749","25308","2019",4,3,1,238005,2251,105.25
"7750","25309","2019",26,18,8,231675.769230769,2611.46153846154,96.8846153846154
"7751","25310","2019",2,2,0,130000,960.5,130
"7752","25311","2019",5,5,0,129448,960.4,133
"7753","25312","2019",2,2,0,114975,779.5,135
"7754","25313","2019",1,1,0,55000,688,80
"7755","25314","2019",6,5,1,149650,1422.5,117.5
"7756","25315","2019",41,33,8,102061.219512195,1108.46341463415,94.4634146341463
"7757","25316","2019",4,4,0,194937.5,1157.75,173.25
"7758","25318","2019",38,20,18,231492.631578947,3171.02631578947,80.3684210526316
"7759","25320","2019",32,8,24,203544.09375,2443.625,86.59375
"7760","25321","2019",108,57,51,229721.398148148,2543.75925925926,90.5092592592593
"7761","25322","2019",2,1,1,162000,1677,97.5
"7762","25323","2019",8,5,3,145162.5,1670.25,99.125
"7763","25325","2019",1,1,0,190000,984,193
"7764","25326","2019",6,5,1,194933.333333333,1811.83333333333,115.5
"7765","25328","2019",4,4,0,205255,1852.5,107
"7766","25331","2019",1,1,0,63000,900,70
"7767","25332","2019",6,6,0,190950,1857.5,105
"7768","25333","2019",5,5,0,107800,1167.8,92.8
"7769","25334","2019",29,20,9,175247.103448276,1662.68965517241,108.206896551724
"7770","25335","2019",1,1,0,72000,600,120
"7771","25336","2019",4,4,0,168425,1610.75,106
"7772","25338","2019",2,2,0,85000,956.5,88.5
"7773","25339","2019",6,3,3,94833.3333333333,933,94.5
"7774","25340","2019",4,4,0,150922,1772.75,110.75
"7775","25341","2019",1,1,0,140000,636,220
"7776","25342","2019",1,1,0,210000,991,212
"7777","25343","2019",4,4,0,203558.25,1742.5,123.5
"7778","25344","2019",1,1,0,90000,763,118
"7779","25345","2019",9,9,0,151633.333333333,1574.55555555556,105.444444444444
"7780","25346","2019",1,1,0,138000,1747,79
"7781","25347","2019",11,10,1,244617,2946.63636363636,114.818181818182
"7782","25348","2019",14,9,5,227173.571428571,2882.5,92.0714285714286
"7783","25349","2019",12,7,5,127070.25,1607,79.6666666666667
"7784","25350","2019",11,11,0,94061.5454545455,997.727272727273,105.818181818182
"7785","25351","2019",3,2,1,188583.333333333,1974.33333333333,95
"7786","25354","2019",1,1,0,58000,446,130
"7787","25356","2019",54,36,18,182898.833333333,1909.59259259259,97.5
"7788","25357","2019",5,5,0,260000,2326,112.4
"7789","25361","2019",21,7,14,249833.333333333,3210,73.1428571428571
"7790","25362","2019",3,1,2,173750,2304.33333333333,76.6666666666667
"7791","25364","2019",16,14,2,196982.8125,1849.75,114.875
"7792","25365","2019",3,3,0,88533.3333333333,1903.66666666667,52.6666666666667
"7793","25366","2019",2,2,0,278450,2367.5,126.5
"7794","25367","2019",53,39,14,108206.150943396,1276.64150943396,87.8679245283019
"7795","25368","2019",17,14,3,176502.941176471,1661.41176470588,106.529411764706
"7796","25369","2019",4,2,2,103625,1131.5,98.5
"7797","25370","2019",16,13,3,138703.125,1512.5625,93.1875
"7798","25372","2019",4,3,1,87937.5,959,97
"7799","25374","2019",3,3,0,161422,1372.33333333333,110.666666666667
"7800","25375","2019",4,4,0,180025,1782.25,94.75
"7801","25376","2019",2,2,0,235450,2116.5,112.5
"7802","25377","2019",2,2,0,59960,734,79.5
"7803","25378","2019",5,2,3,104320,832,122.8
"7804","25380","2019",110,33,77,123642.209090909,3002.35454545455,41.2272727272727
"7805","25381","2019",27,23,4,228675.925925926,1961.18518518519,117.074074074074
"7806","25382","2019",8,8,0,184250,1850.625,106.125
"7807","25383","2019",3,3,0,145000,1400,111.666666666667
"7808","25384","2019",2,2,0,90000,844.5,109.5
"7809","25385","2019",1,1,0,125000,672,186
"7810","25386","2019",1,1,0,140630,1512,93
"7811","25387","2019",4,4,0,194087.5,1755,114
"7812","25388","2019",322,93,229,93003.3757763975,1140.26397515528,79.0962732919255
"7813","25390","2019",5,4,1,249598.2,2254.6,110.2
"7814","25392","2019",5,5,0,227960,1702,132.8
"7815","25393","2019",7,7,0,101411.857142857,1353.28571428571,83.7142857142857
"7816","25394","2019",19,19,0,189470.789473684,1878.42105263158,103.631578947368
"7817","25395","2019",16,14,2,293561.875,2021.25,152.0625
"7818","25397","2019",37,28,9,199467.054054054,1922.83783783784,104.162162162162
"7819","25398","2019",1,1,0,371150,2236,166
"7820","25400","2019",9,8,1,166209.222222222,1454.88888888889,113
"7821","25401","2019",1,1,0,115000,1620,71
"7822","25403","2019",27,11,16,230097.111111111,2437.48148148148,101.444444444444
"7823","25404","2019",4,4,0,164375,1266.25,184.25
"7824","25405","2019",18,15,3,262719.722222222,2416.44444444444,110.166666666667
"7825","25406","2019",5,5,0,121800,1124,111.2
"7826","25410","2019",13,12,1,134957.153846154,1555,92.2307692307692
"7827","25411","2019",146,31,115,172794.452054795,2278.41095890411,77.1506849315068
"7828","25413","2019",25,7,18,158538.8,1982.6,79.56
"7829","25414","2019",2,2,0,117850,916.5,127.5
"7830","25415","2019",5,4,1,133800,1622.4,72.4
"7831","25416","2019",1,1,0,161400,1508,107
"7832","25417","2019",4,4,0,177875,1739.25,101
"7833","25418","2019",15,12,3,174157.866666667,1536.6,117.6
"7834","25419","2019",1,1,0,35000,1000,35
"7835","25420","2019",1,1,0,251000,1731,145
"7836","25421","2019",2,2,0,230265,1711,130
"7837","25422","2019",2,2,0,148875,1690.5,88
"7838","25424","2019",14,11,3,169432.142857143,1495.21428571429,109.214285714286
"7839","25425","2019",4,4,0,261200,2457.5,107.5
"7840","25426","2019",1,1,0,190000,2468,77
"7841","25427","2019",2,2,0,238285,2121.5,113
"7842","25428","2019",22,20,2,154055.090909091,1601.40909090909,97.5909090909091
"7843","25429","2019",12,9,3,152465.666666667,1693.33333333333,86.75
"7844","25430","2019",1,0,1,1e+05,1111,90
"7845","25431","2019",4,4,0,128375,1396,88.5
"7846","25432","2019",17,13,4,212243.235294118,2109.76470588235,105.117647058824
"7847","25433","2019",1,1,0,269900,2347,115
"7848","25434","2019",62,40,22,133738.338709677,1580.16129032258,85.6774193548387
"7849","25435","2019",3,3,0,134000,1153,119.333333333333
"7850","25436","2019",3,3,0,125000,928.333333333333,174.333333333333
"7851","25437","2019",2,2,0,196075,2152,91
"7852","25438","2019",15,14,1,177115,1449.66666666667,123.2
"7853","25439","2019",3,3,0,88666.6666666667,881.333333333333,88
"7854","25440","2019",7,3,4,161378.571428571,2026.85714285714,84.5714285714286
"7855","25442","2019",14,6,8,256208.214285714,2505.21428571429,104.357142857143
"7856","25443","2019",1,1,0,168600,1653,102
"7857","25444","2019",1,1,0,70100,1593,44
"7858","25446","2019",3,3,0,132266.666666667,1533.66666666667,84.6666666666667
"7859","25447","2019",2,1,1,144000,1202.5,117.5
"7860","25448","2019",11,8,3,173759.090909091,1873.54545454545,97.2727272727273
"7861","25449","2019",2,2,0,70000,870,80.5
"7862","25451","2019",1,1,0,320900,2342,137
"7863","25452","2019",4,1,3,117550,1261.75,82.5
"7864","25453","2019",14,14,0,160936.785714286,1372.42857142857,127.571428571429
"7865","25454","2019",23,18,5,217001.173913043,2088.65217391304,111.739130434783
"7866","25455","2019",4,3,1,199362.5,1755,113
"7867","25456","2019",3,2,1,139666.666666667,1569.66666666667,96.6666666666667
"7868","25457","2019",5,4,1,136000,1245.6,100.2
"7869","25459","2019",2,2,0,237000,2598.5,91
"7870","25460","2019",2,2,0,139075,1074,126.5
"7871","25461","2019",4,4,0,162150,1481.5,112.5
"7872","25462","2019",357,57,300,166616.271708683,2279.55182072829,73.9495798319328
"7873","25463","2019",42,26,16,117042.857142857,1333.90476190476,87.5
"7874","25464","2019",2,2,0,377350,2657.5,144
"7875","25465","2019",1,1,0,2e+05,1418,141
"7876","25466","2019",7,6,1,192065,1813,106.571428571429
"7877","25467","2019",28,22,6,193164.892857143,1919.35714285714,102.857142857143
"7878","25468","2019",11,11,0,172743,1365.27272727273,137.636363636364
"7879","25469","2019",9,9,0,151873.444444444,1556.77777777778,101.555555555556
"7880","25470","2019",3,3,0,121170,1052,114.333333333333
"7881","25471","2019",1,1,0,1e+05,637,157
"7882","25473","2019",4,4,0,207421.5,1727.5,136.5
"7883","25475","2019",10,8,2,115219,1180.1,102.1
"7884","25476","2019",1,1,0,202850,1705,119
"7885","25477","2019",1,1,0,33000,1179,28
"7886","25478","2019",2,2,0,103500,697,148
"7887","25479","2019",5,4,1,92200,1261,72.2
"7888","25481","2019",2,2,0,145500,1265,125.5
"7889","25482","2019",6,6,0,188983.333333333,1717.5,115
"7890","25485","2019",1,1,0,270230,1689,160
"7891","25486","2019",10,5,5,199382,1833.6,104.6
"7892","25487","2019",2,2,0,71555,783.5,94.5
"7893","25488","2019",2,2,0,107955,1056.5,95
"7894","25489","2019",2,2,0,135750,1528.5,89
"7895","25490","2019",1,1,0,125500,2092,60
"7896","25491","2019",2,2,0,175200,1252,144
"7897","25493","2019",9,8,1,228194.444444444,2020.22222222222,115.555555555556
"7898","25494","2019",11,7,4,160789.090909091,2173.72727272727,78.3636363636364
"7899","25495","2019",21,15,6,193771.952380952,1846.7619047619,102.761904761905
"7900","25496","2019",4,4,0,77775,801,98.5
"7901","25497","2019",6,6,0,174566.666666667,1927.5,91.1666666666667
"7902","25499","2019",2,2,0,93500,1022.5,90
"7903","25500","2019",1,1,0,160000,1509,106
"7904","25502","2019",5,5,0,190532.8,1855.8,101.4
"7905","25503","2019",2,2,0,233750,1692,133.5
"7906","25504","2019",1,1,0,77000,802,96
"7907","25505","2019",12,10,2,110167.916666667,935.666666666667,108.916666666667
"7908","25507","2019",2,2,0,1e+05,1322.5,75.5
"7909","25508","2019",8,7,1,170762.5,1720.25,97.25
"7910","25510","2019",2,2,0,212725,1680.5,124.5
"7911","25511","2019",2,2,0,327000,3374,93.5
"7912","25512","2019",36,27,9,227039.638888889,1932.97222222222,119.694444444444
"7913","25514","2019",3,0,3,54500,1914,29
"7914","25515","2019",15,8,7,214097.333333333,2196.86666666667,101.066666666667
"7915","25516","2019",2,1,1,54500,699,84.5
"7916","25517","2019",6,4,2,197579.333333333,1939.33333333333,111.666666666667
"7917","25519","2019",7,5,2,101542.857142857,954.571428571429,104.857142857143
"7918","25522","2019",1,1,0,235000,2582,91
"7919","25523","2019",9,9,0,175033.333333333,1443.88888888889,121.888888888889
"7920","25524","2019",10,10,0,137040,1300.5,107.4
"7921","25525","2019",9,4,5,299167.444444444,2875.88888888889,102
"7922","25526","2019",13,6,7,104557.692307692,1325.38461538462,74.7692307692308
"7923","25527","2019",58,43,15,172877.75862069,1758.1724137931,100.086206896552
"7924","25529","2019",10,8,2,191430,1761.2,111.3
"7925","25532","2019",30,19,11,210676.5,2093.73333333333,106.3
"7926","25534","2019",3,2,1,181000,1532.33333333333,117
"7927","25535","2019",3,3,0,195866.666666667,1663.66666666667,115.333333333333
"7928","25536","2019",2,2,0,116000,1035.5,111
"7929","25537","2019",6,6,0,167416.666666667,1410.66666666667,121.166666666667
"7930","25538","2019",1,1,0,98200,1228,80
"7931","25539","2019",88,50,38,113928.704545455,1352.22727272727,84.3295454545455
"7932","25541","2019",2,1,1,221650,1495,151
"7933","25542","2019",25,19,6,203222,2211.4,95.68
"7934","25545","2019",2,2,0,73600,900,82
"7935","25546","2019",1,1,0,190000,1188,160
"7936","25547","2019",28,7,21,87098.8928571429,1028.57142857143,83
"7937","25548","2019",3,3,0,148956.666666667,1399.33333333333,105.666666666667
"7938","25549","2019",9,8,1,228570,1981,120.333333333333
"7939","25551","2019",2,2,0,136000,2427.5,56
"7940","25553","2019",8,8,0,100047.5,942.625,103
"7941","25555","2019",18,12,6,147972.222222222,1589.88888888889,93.8888888888889
"7942","25556","2019",1,1,0,120000,851,141
"7943","25557","2019",5,5,0,362220,2673.6,139.4
"7944","25558","2019",18,18,0,210399.277777778,1714.11111111111,129
"7945","25559","2019",2,2,0,211773.5,1859.5,110.5
"7946","25560","2019",33,28,5,185003.878787879,1846.93939393939,104.242424242424
"7947","25561","2019",6,2,4,84358.3333333333,1700,53
"7948","25562","2019",4,4,0,236640,2277.5,105.25
"7949","25564","2019",9,8,1,217172.222222222,2124,104
"7950","25565","2019",4,3,1,226587.5,2844.5,80.5
"7951","25566","2019",1,1,0,283030,1505,188
"7952","25567","2019",2,2,0,61750,707,86.5
"7953","25569","2019",2,2,0,158500,1015,139.5
"7954","25570","2019",2,2,0,69000,745.5,92.5
"7955","25571","2019",7,6,1,166734.857142857,1586.57142857143,112.428571428571
"7956","25572","2019",2,2,0,130833,1073.5,132.5
"7957","25574","2019",4,4,0,93762.5,689.5,126
"7958","25575","2019",3,3,0,148316.666666667,1449,93
"7959","25578","2019",69,32,37,161612.52173913,1888.91304347826,92.9855072463768
"7960","25579","2019",4,4,0,216300,1683.25,133.25
"7961","25580","2019",111,75,36,109398.513513514,1180.88288288288,90.7747747747748
"7962","25582","2019",1,1,0,140000,1842,76
"7963","25586","2019",4,4,0,231912.5,1851.25,127.75
"7964","25588","2019",1,1,0,154000,2053,75
"7965","25589","2019",1,1,0,30000,1250,24
"7966","25590","2019",1,1,0,2e+05,2128,94
"7967","25591","2019",1,1,0,165000,2171,76
"7968","25592","2019",8,5,3,236974.375,2379.125,105.75
"7969","25594","2019",3,3,0,236366.666666667,2353.66666666667,99.6666666666667
"7970","25595","2019",2,2,0,128500,1245.5,101.5
"7971","25596","2019",1,1,0,35000,412,85
"7972","25597","2019",4,4,0,84733.75,785.5,105.25
"7973","25598","2019",6,5,1,163671.666666667,1449.33333333333,106.333333333333
"7974","25599","2019",1,1,0,215000,1604,134
"7975","25601","2019",14,11,3,156250,1639,96.2142857142857
"7976","25605","2019",6,5,1,195890.666666667,1759.66666666667,111.166666666667
"7977","25607","2019",1,1,0,75000,670,112
"7978","25608","2019",2,2,0,137818.5,1466,97
"7979","25609","2019",2,1,1,229500,1662.5,134.5
"7980","25611","2019",3,2,1,293333.333333333,2536,124.333333333333
"7981","25612","2019",12,11,1,155176.666666667,1926.08333333333,92.8333333333333
"7982","25613","2019",1,1,0,70000,700,100
"7983","25614","2019",43,25,18,123735.348837209,1466.37209302326,85.2325581395349
"7984","25615","2019",3,3,0,173566.666666667,1192.66666666667,131.333333333333
"7985","25618","2019",1,1,0,80000,1250,64
"7986","25619","2019",6,3,3,103554,1751.83333333333,64.1666666666667
"7987","25620","2019",1,1,0,491000,2584,190
"7988","25622","2019",1,1,0,150382,1550,97
"7989","25623","2019",2,2,0,96500,1266.5,77
"7990","25624","2019",4,3,1,141925,1413.25,96.5
"7991","25626","2019",2,2,0,166450,1563,106.5
"7992","25627","2019",3,3,0,146666.666666667,1252.33333333333,120.666666666667
"7993","25630","2019",2,1,1,136850,1332.5,106.5
"7994","25631","2019",5,4,1,220054,2009.6,113.8
"7995","25632","2019",31,28,3,128583.806451613,1491.48387096774,85.9354838709677
"7996","25633","2019",12,12,0,170164.166666667,1421.08333333333,128.916666666667
"7997","25634","2019",6,4,2,270804.666666667,2483.16666666667,113.166666666667
"7998","25635","2019",4,4,0,134682.5,1263,117.75
"7999","26001","2019",5,5,0,278600,2482,130.2
"8000","26002","2019",24,23,1,189602.916666667,1807.29166666667,111.458333333333
"8001","26004","2019",35,30,5,214527.2,2031.71428571429,106.485714285714
"8002","26005","2019",28,28,0,316293.75,2209.07142857143,134.392857142857
"8003","26006","2019",25,25,0,253537.08,2141.92,128.76
"8004","26007","2019",1,1,0,498930,2772,180
"8005","26008","2019",19,16,3,152227.894736842,1781.36842105263,85.6842105263158
"8006","26009","2019",13,13,0,159869.230769231,1567.92307692308,108.923076923077
"8007","26010","2019",49,42,7,151068.775510204,1579.75510204082,98.5102040816327
"8008","26011","2019",36,33,3,176035.25,1978.69444444444,90.1388888888889
"8009","26012","2019",1,1,0,147000,2042,72
"8010","26013","2019",1,1,0,216500,1604,135
"8011","26014","2019",5,5,0,289992.8,1932,151.2
"8012","26016","2019",4,4,0,221025,2556,85.5
"8013","26019","2019",2,2,0,113695,1492,74.5
"8014","26021","2019",2,2,0,320000,3611.5,106
"8015","26023","2019",16,15,1,186020,2064.375,94.5625
"8016","26024","2019",3,3,0,210466.666666667,1800.66666666667,124
"8017","26025","2019",2,2,0,125000,1326.5,91
"8018","26028","2019",3,3,0,217999.666666667,2128.33333333333,101.666666666667
"8019","26031","2019",12,10,2,212574.416666667,2137.83333333333,101.5
"8020","26032","2019",4,4,0,168200,1258.5,123
"8021","26033","2019",8,7,1,272606.25,2413.125,101.625
"8022","26034","2019",8,8,0,180464.375,1556.75,112.875
"8023","26035","2019",7,6,1,179228.571428571,2337.85714285714,86.7142857142857
"8024","26036","2019",2,2,0,152500,995,159
"8025","26037","2019",40,39,1,263975.675,2544.875,102.475
"8026","26038","2019",17,17,0,162734.058823529,1746.41176470588,98.3529411764706
"8027","26039","2019",8,8,0,267859.375,2324.75,119
"8028","26040","2019",1,1,0,80000,1127,71
"8029","26041","2019",19,19,0,225157.894736842,1925.26315789474,117.684210526316
"8030","26042","2019",21,21,0,256783.80952381,2246.90476190476,112.142857142857
"8031","26043","2019",4,4,0,370825,3306.5,110.25
"8032","26045","2019",25,23,2,220173.56,2031.72,110.76
"8033","26047","2019",4,4,0,113650,1477,91
"8034","26048","2019",1,1,0,90000,1023,88
"8035","26049","2019",22,22,0,212391.318181818,1906.04545454545,118.090909090909
"8036","26052","2019",2,2,0,207500,1931,109
"8037","26054","2019",24,22,2,267077.083333333,2572.04166666667,108.666666666667
"8038","26055","2019",3,3,0,66666.6666666667,1113.33333333333,58.6666666666667
"8039","26056","2019",13,13,0,172420.384615385,1657.38461538462,100.923076923077
"8040","26057","2019",164,113,51,152654.5,1885.07317073171,82.9024390243902
"8041","26058","2019",321,120,201,145004.6105919,1775.31464174455,80.6978193146417
"8042","26059","2019",10,8,2,97249.5,1185.8,86.6
"8043","26060","2019",5,5,0,202900,2218.2,108.6
"8044","26061","2019",6,5,1,289944.333333333,2251.33333333333,127.166666666667
"8045","26063","2019",48,46,2,210365.625,2272.39583333333,94.3541666666667
"8046","26064","2019",69,64,5,242890.869565217,2428.49275362319,99.5797101449275
"8047","26065","2019",8,8,0,272225,2403.875,113.75
"8048","26066","2019",1,1,0,83000,692,120
"8049","26067","2019",1,1,0,332200,2063,161
"8050","26069","2019",2,2,0,91875,1408.5,62.5
"8051","26070","2019",9,7,2,269810.777777778,2380.11111111111,113.777777777778
"8052","26071","2019",7,7,0,237114,2003.28571428571,124
"8053","26072","2019",17,17,0,207510.588235294,1858.17647058824,110.882352941176
"8054","26073","2019",6,6,0,238000,2650,95.6666666666667
"8055","26074","2019",22,18,4,173637.454545455,1903.72727272727,98.5454545454545
"8056","26075","2019",1,1,0,58000,906,64
"8057","26076","2019",2,2,0,108500,1857,56
"8058","26077","2019",9,8,1,206755.555555556,2006,114.777777777778
"8059","26078","2019",23,23,0,232856.47826087,1922.39130434783,108.695652173913
"8060","26079","2019",6,6,0,273761.666666667,2241.66666666667,114.166666666667
"8061","26081","2019",7,6,1,202255.142857143,2207.14285714286,90.5714285714286
"8062","26082","2019",3,3,0,257566.666666667,2485,117.333333333333
"8063","26083","2019",12,11,1,238990,1918.16666666667,130.583333333333
"8064","26084","2019",47,39,8,205993,2037.02127659574,103.510638297872
"8065","26085","2019",49,41,8,180921.204081633,1900.04081632653,96.2244897959184
"8066","26086","2019",13,12,1,145866.461538462,1574.61538461538,88.1538461538462
"8067","26087","2019",15,12,3,187210,1778.26666666667,107.733333333333
"8068","26088","2019",62,53,9,202154.080645161,2027.77419354839,104.370967741935
"8069","26091","2019",2,2,0,29750,583,51
"8070","26092","2019",5,4,1,215800,1894,119.2
"8071","26093","2019",3,2,1,737553.333333333,3094.66666666667,199.666666666667
"8072","26094","2019",4,4,0,211555,2012,107.25
"8073","26095","2019",8,8,0,204732.5,1907,106.375
"8074","26096","2019",32,32,0,181880.46875,1904.875,95.65625
"8075","26097","2019",8,8,0,237687.5,1861.25,137.75
"8076","26098","2019",2,2,0,356020,2178,195
"8077","26099","2019",4,4,0,180250,1807.25,110.75
"8078","26100","2019",8,8,0,254762.5,2191,117.5
"8079","26103","2019",6,5,1,245333.333333333,2846.33333333333,89
"8080","26105","2019",2,2,0,205000,1819.5,98
"8081","26106","2019",15,15,0,160981.066666667,1679,105.133333333333
"8082","26107","2019",5,5,0,140206.6,1515.2,87.2
"8083","26108","2019",118,78,40,176605.788135593,2073.19491525424,87.7118644067797
"8084","26110","2019",7,6,1,262642.857142857,2259.14285714286,113
"8085","26111","2019",3,3,0,316920,2253,150.666666666667
"8086","26112","2019",3,3,0,228183.333333333,1762.33333333333,125.333333333333
"8087","26113","2019",71,55,16,181260.366197183,1781.50704225352,103.549295774648
"8088","26114","2019",56,44,12,201353.375,2356.42857142857,89.1964285714286
"8089","26115","2019",8,8,0,295478.125,1843.875,169.125
"8090","26116","2019",65,49,16,167769.461538462,1801.03076923077,92.4307692307692
"8091","26117","2019",1,1,0,86000,2457,35
"8092","26118","2019",18,17,1,194255.833333333,1765.38888888889,113.888888888889
"8093","26119","2019",15,11,4,128646.666666667,1531,85.4
"8094","26121","2019",19,17,2,167823.684210526,1707.63157894737,94.0526315789474
"8095","26122","2019",5,5,0,178304,2072.8,84.6
"8096","26123","2019",2,2,0,91000,1368.5,67
"8097","26124","2019",52,46,6,223988.884615385,2205.78846153846,103.057692307692
"8098","26125","2019",18,18,0,268636.111111111,2483.27777777778,111.388888888889
"8099","26126","2019",1,1,0,55000,482,114
"8100","26127","2019",1,1,0,143200,1909,75
"8101","26129","2019",20,20,0,214609,1951.25,111.75
"8102","26130","2019",1,1,0,225000,2250,100
"8103","26131","2019",3,3,0,175146.666666667,2279,83.3333333333333
"8104","26133","2019",2,2,0,188225,2052,97
"8105","26134","2019",1,1,0,305000,1968,155
"8106","26135","2019",4,4,0,166500,1951.5,89.25
"8107","26137","2019",3,3,0,250250,2448.66666666667,108.333333333333
"8108","26138","2019",19,19,0,303412.789473684,3041.26315789474,108.894736842105
"8109","26139","2019",26,19,7,189855.384615385,1952.11538461538,98.8076923076923
"8110","26140","2019",7,7,0,248548.571428571,2151.57142857143,116.142857142857
"8111","26141","2019",3,3,0,196698.333333333,1730,106.333333333333
"8112","26143","2019",11,11,0,143140.909090909,1363.72727272727,106.636363636364
"8113","26144","2019",17,14,3,191774.117647059,1908.58823529412,103.647058823529
"8114","26145","2019",10,10,0,186520,1959.8,95.7
"8115","26146","2019",22,18,4,262666.590909091,2629.68181818182,99.1818181818182
"8116","26148","2019",23,22,1,179432.608695652,1860.5652173913,99.6086956521739
"8117","26149","2019",9,6,3,182472.555555556,1892.44444444444,103.555555555556
"8118","26150","2019",1,1,0,215000,3468,62
"8119","26153","2019",1,1,0,201350,1766,114
"8120","26154","2019",2,2,0,137500,1569,91
"8121","26155","2019",8,7,1,190421.25,1757.625,112.25
"8122","26156","2019",13,13,0,226249.230769231,1881.53846153846,121.153846153846
"8123","26157","2019",7,7,0,174520.714285714,1848.28571428571,98.2857142857143
"8124","26159","2019",2,2,0,150000,2244,56.5
"8125","26160","2019",12,9,3,159109.166666667,1920.25,81.5833333333333
"8126","26162","2019",10,9,1,154065,2223.7,79.2
"8127","26163","2019",1,1,0,70000,7000,10
"8128","26165","2019",120,97,23,177464.791666667,1912.15833333333,94.35
"8129","26166","2019",84,79,5,190155.297619048,1917.07142857143,98.8095238095238
"8130","26167","2019",7,7,0,202557.142857143,2312.42857142857,88.7142857142857
"8131","26168","2019",11,4,7,84188.6363636364,1378.09090909091,69.2727272727273
"8132","26169","2019",28,27,1,227794.142857143,2235.25,98.9285714285714
"8133","26170","2019",42,39,3,217249.714285714,2144.04761904762,107.785714285714
"8134","26171","2019",6,6,0,244073.333333333,2414.33333333333,104
"8135","26172","2019",11,10,1,160400,1474.54545454545,112.090909090909
"8136","26173","2019",8,7,1,231588.75,1882,117.375
"8137","26174","2019",14,14,0,222467.857142857,1844.71428571429,125.785714285714
"8138","26175","2019",1,1,0,235000,2098,112
"8139","26176","2019",20,20,0,311127.9,2618.05,119.75
"8140","26177","2019",15,15,0,127566.666666667,1474,95.6666666666667
"8141","26178","2019",7,7,0,156687.142857143,1404.71428571429,113.285714285714
"8142","26179","2019",20,20,0,229952.5,2469.3,103.1
"8143","26180","2019",4,4,0,846100,5636.5,151.75
"8144","26181","2019",1,1,0,159000,1747,91
"8145","26182","2019",26,22,4,281575.384615385,2660.23076923077,101.038461538462
"8146","26183","2019",8,8,0,266412.5,2561.375,109
"8147","26185","2019",13,13,0,257315.307692308,2355,104.076923076923
"8148","26188","2019",22,18,4,192189.681818182,2031.68181818182,103
"8149","26189","2019",3,3,0,128623.333333333,2554,55
"8150","26190","2019",1,1,0,565000,5136,110
"8151","26191","2019",51,38,13,229664.176470588,2028.92156862745,119.960784313725
"8152","26193","2019",12,3,9,117874.166666667,2150.25,53.5833333333333
"8153","26194","2019",5,5,0,232310,2259.6,110
"8154","26195","2019",7,7,0,230033.571428571,2133.42857142857,105.428571428571
"8155","26196","2019",13,13,0,325025.384615385,2760.07692307692,120.692307692308
"8156","26197","2019",39,33,6,279392.974358974,2706.15384615385,112.102564102564
"8157","26198","2019",727,309,418,149165.066024759,1754.4552957359,82.8294360385144
"8158","26200","2019",3,3,0,103333.333333333,1391,68.6666666666667
"8159","26202","2019",3,2,1,142666.666666667,1662.66666666667,87
"8160","26203","2019",1,1,0,89000,1413,63
"8161","26205","2019",2,2,0,224000,2203.5,112
"8162","26206","2019",37,34,3,245916.891891892,2372.72972972973,114.621621621622
"8163","26207","2019",6,6,0,198500,1645.83333333333,117.833333333333
"8164","26208","2019",18,18,0,251203.055555556,2274.88888888889,108.333333333333
"8165","26209","2019",1,1,0,105000,2100,50
"8166","26210","2019",12,12,0,172788.083333333,1579.33333333333,108
"8167","26211","2019",19,17,2,297463.947368421,2916.36842105263,102.789473684211
"8168","26212","2019",16,14,2,167059.375,1974.125,87.5
"8169","26213","2019",7,6,1,135982.857142857,1855.28571428571,101.714285714286
"8170","26215","2019",9,9,0,106995.555555556,1659.44444444444,71.1111111111111
"8171","26216","2019",9,9,0,163372.222222222,1665.77777777778,97.8888888888889
"8172","26217","2019",1,1,0,267300,1782,150
"8173","26218","2019",40,37,3,223679.375,2037.325,111.875
"8174","26220","2019",129,67,62,199052.224806202,2338.96124031008,84.7054263565891
"8175","26223","2019",4,4,0,140282.5,1654.5,86.75
"8176","26224","2019",1,1,0,554650,2292,242
"8177","26225","2019",8,8,0,181923.875,1889.625,116.25
"8178","26226","2019",3,3,0,192646.666666667,1590,117.666666666667
"8179","26231","2019",36,34,2,214664.722222222,1928.02777777778,113.416666666667
"8180","26232","2019",6,6,0,226692.5,2323.33333333333,113.166666666667
"8181","26234","2019",11,10,1,209185.454545455,2079.90909090909,104.363636363636
"8182","26235","2019",171,125,46,161532.824561404,1797.58479532164,89.859649122807
"8183","26236","2019",3,3,0,221583.333333333,1865,115
"8184","26238","2019",1,1,0,147200,1227,120
"8185","26239","2019",3,3,0,186666.666666667,1607.33333333333,107.333333333333
"8186","26240","2019",7,7,0,116801.428571429,1709.85714285714,78.8571428571429
"8187","26241","2019",1,1,0,199800,1816,110
"8188","26242","2019",1,1,0,67600,1733,39
"8189","26243","2019",18,15,3,250730,2535.33333333333,102.222222222222
"8190","26244","2019",3,3,0,308333.333333333,2241,145
"8191","26246","2019",1,1,0,275000,4583,60
"8192","26247","2019",2,2,0,65500,1606,41
"8193","26248","2019",2,2,0,66000,1034,64.5
"8194","26249","2019",7,7,0,177214.285714286,1804,107.857142857143
"8195","26250","2019",35,29,6,213335.2,2267.4,98.1714285714286
"8196","26251","2019",3,3,0,215766.666666667,2009,109.333333333333
"8197","26252","2019",145,78,67,163761.489655172,1930.38620689655,83.8551724137931
"8198","26253","2019",2,2,0,132250,1652.5,70
"8199","26256","2019",2,2,0,438750,3425,127.5
"8200","26257","2019",5,5,0,215000,2878.2,80.4
"8201","26258","2019",11,11,0,250388.181818182,3070.45454545455,109.909090909091
"8202","26259","2019",5,5,0,249640,1966.8,118.4
"8203","26261","2019",3,3,0,204400,2841.66666666667,74.3333333333333
"8204","26262","2019",4,3,1,119000,1365.75,99
"8205","26263","2019",4,0,4,1e+05,2458.75,41
"8206","26264","2019",5,4,1,95000,2177.6,61.2
"8207","26268","2019",6,6,0,175833.333333333,2264.16666666667,87.3333333333333
"8208","26269","2019",1,1,0,150000,5000,30
"8209","26270","2019",2,2,0,274000,2012.5,140
"8210","26271","2019",41,34,7,194150.170731707,2192.41463414634,88.5365853658537
"8211","26273","2019",5,5,0,314864,2488.8,126.4
"8212","26275","2019",21,20,1,224607.619047619,2118.38095238095,108.380952380952
"8213","26276","2019",7,6,1,231990.714285714,3288.42857142857,82
"8214","26277","2019",2,2,0,260000,2102,129.5
"8215","26278","2019",3,2,1,187500,2286,80
"8216","26279","2019",1,1,0,176000,1760,100
"8217","26281","2019",575,227,348,129714.648695652,1587.17739130435,81.5617391304348
"8218","26282","2019",5,5,0,187720,2121.6,89
"8219","26284","2019",9,9,0,229380,1866.88888888889,117.444444444444
"8220","26285","2019",2,2,0,445750,3360,136.5
"8221","26287","2019",5,3,2,350900,2819.4,124.4
"8222","26288","2019",3,3,0,163333.333333333,1578.66666666667,100.666666666667
"8223","26289","2019",29,23,6,150219.827586207,1845.93103448276,84.3793103448276
"8224","26290","2019",20,6,14,75745.9,1522.3,52.6
"8225","26292","2019",5,5,0,133000,1843.4,78.2
"8226","26293","2019",4,4,0,175860,1464,121.25
"8227","26294","2019",6,6,0,230743.333333333,2111.33333333333,113
"8228","26295","2019",15,15,0,184686.266666667,1658.66666666667,108.733333333333
"8229","26298","2019",8,8,0,159448.75,1380.875,126.5
"8230","26299","2019",1,1,0,40000,769,52
"8231","26300","2019",3,3,0,99816.6666666667,968,102
"8232","26301","2019",62,50,12,189176.935483871,1841.58064516129,103.370967741935
"8233","26302","2019",6,6,0,160941.666666667,1623,100.5
"8234","26303","2019",1,1,0,87500,1094,80
"8235","26304","2019",4,4,0,297325,1921.75,145
"8236","26305","2019",14,13,1,239541.071428571,1964.85714285714,115.642857142857
"8237","26306","2019",5,5,0,152874,1660,98.6
"8238","26307","2019",26,21,5,191742.307692308,1951.61538461538,102.153846153846
"8239","26308","2019",4,4,0,173625,1949,102.5
"8240","26309","2019",4,3,1,145146.25,1434.25,95.75
"8241","26311","2019",12,11,1,207750,1945,111.833333333333
"8242","26312","2019",10,9,1,182982,1736.7,103.1
"8243","26313","2019",62,59,3,230246.532258065,2306.62903225806,101.306451612903
"8244","26314","2019",5,4,1,183537,1482.8,119.6
"8245","26315","2019",7,5,2,168142.857142857,1316,127.857142857143
"8246","26316","2019",2,2,0,208475,1710,122.5
"8247","26317","2019",13,11,2,176192.153846154,1571.23076923077,107.153846153846
"8248","26319","2019",8,8,0,203173.75,1697,110.375
"8249","26320","2019",7,4,3,73785.7142857143,1015.71428571429,79
"8250","26321","2019",6,6,0,101533.333333333,1451.83333333333,66
"8251","26322","2019",12,5,7,218237.916666667,2288.33333333333,90.9166666666667
"8252","26323","2019",17,17,0,187938.235294118,1786.52941176471,112.235294117647
"8253","26324","2019",113,69,44,175141.407079646,1876.92920353982,93.1150442477876
"8254","26325","2019",80,69,11,149958.3125,1594.4625,93.7125
"8255","26326","2019",12,11,1,270686.25,2280.33333333333,119
"8256","26327","2019",2,2,0,164575,2234.5,71.5
"8257","26329","2019",1,1,0,205040,1577,130
"8258","26330","2019",24,22,2,190322.916666667,1687.375,115.125
"8259","26332","2019",30,27,3,158008.333333333,1492.7,108.133333333333
"8260","26333","2019",55,19,36,92598.8181818182,1089.90909090909,89.2545454545455
"8261","26334","2019",1,1,0,304000,2375,128
"8262","26335","2019",5,5,0,178660,1452.8,122.8
"8263","26336","2019",7,7,0,238271.428571429,2848.57142857143,83.7142857142857
"8264","26337","2019",14,14,0,151904.785714286,1683.21428571429,90
"8265","26338","2019",19,16,3,278327.052631579,2174.15789473684,123.157894736842
"8266","26339","2019",14,13,1,220952.857142857,2074.14285714286,108.142857142857
"8267","26340","2019",3,3,0,100166.666666667,1425,73.3333333333333
"8268","26341","2019",8,8,0,181793.75,1673.375,111.75
"8269","26342","2019",8,8,0,308951.25,2801,117.375
"8270","26343","2019",2,2,0,273100,3260.5,104.5
"8271","26344","2019",2,2,0,276050,2273,147
"8272","26345","2019",22,22,0,295380.045454545,2440.68181818182,118.272727272727
"8273","26347","2019",90,34,56,148247.977777778,1902.47777777778,81.0777777777778
"8274","26348","2019",25,25,0,209574.8,2071.52,96.24
"8275","26349","2019",6,6,0,221859.166666667,2521.16666666667,102
"8276","26350","2019",1,1,0,468500,5856,80
"8277","26352","2019",4,4,0,263925,1759.25,139.75
"8278","26353","2019",22,17,5,139881.363636364,1472.86363636364,94.5
"8279","26355","2019",4,4,0,280050,2001.75,133.25
"8280","26356","2019",4,4,0,374788.75,1828.75,193.5
"8281","26357","2019",22,21,1,184923.5,1859.63636363636,98.4545454545455
"8282","26358","2019",13,13,0,274446.153846154,2681.61538461538,102.615384615385
"8283","26360","2019",11,11,0,206841.090909091,3275.63636363636,77.3636363636364
"8284","26361","2019",3,3,0,81900,1085.66666666667,85
"8285","26362","2019",1246,273,973,142421.25682183,1891.67335473515,75.199036918138
"8286","26364","2019",7,7,0,140781.571428571,1732,91.1428571428571
"8287","26365","2019",6,6,0,205048.333333333,1215,168.166666666667
"8288","26367","2019",13,13,0,262315.384615385,2227.92307692308,122.538461538462
"8289","26368","2019",1,1,0,137000,1712,80
"8290","26370","2019",2,2,0,121000,1090,107.5
"8291","26373","2019",2,2,0,138750,1395,114.5
"8292","26375","2019",1,1,0,25000,625,40
"8293","26376","2019",2,2,0,192100,1945.5,99
"8294","26377","2019",21,20,1,226523.857142857,2550.38095238095,97.6666666666667
"8295","26378","2019",1,1,0,115060,1644,70
"8296","26379","2019",7,6,1,218514.285714286,2083.85714285714,107
"8297","26380","2019",5,5,0,155345.4,1629.8,91.6
"8298","26381","2019",12,9,3,181821.916666667,1583.83333333333,118.583333333333
"8299","26382","2019",6,6,0,84038.3333333333,804.333333333333,105.166666666667
"8300","27001","2019",4,4,0,113250,1421,80.5
"8301","27002","2019",10,10,0,117926,1181.1,98
"8302","27003","2019",24,24,0,160122,1923.16666666667,90.875
"8303","27004","2019",8,8,0,237687.5,2394.25,104
"8304","27005","2019",16,16,0,203534.375,1785.375,116.875
"8305","27006","2019",4,4,0,214876.5,1711.5,139.75
"8306","27008","2019",18,18,0,179219.888888889,1740.72222222222,103.833333333333
"8307","27009","2019",13,13,0,97976.9230769231,1182.15384615385,83.2307692307692
"8308","27011","2019",16,16,0,174706.25,1617.5,109.8125
"8309","27012","2019",7,7,0,139557.142857143,1276.85714285714,115
"8310","27013","2019",11,11,0,190850,1769.72727272727,106.727272727273
"8311","27014","2019",14,14,0,195603,1690.5,117.857142857143
"8312","27015","2019",15,15,0,219420,2124.66666666667,101.933333333333
"8313","27016","2019",95,84,11,139612.273684211,1667.15789473684,87.6526315789474
"8314","27017","2019",21,21,0,200470.333333333,1724.28571428571,116.47619047619
"8315","27018","2019",11,11,0,173833.636363636,1578.90909090909,122.909090909091
"8316","27019","2019",5,5,0,124600,1372.8,98.4
"8317","27020","2019",15,15,0,171094.066666667,1998.6,90.7333333333333
"8318","27021","2019",7,7,0,207142.857142857,1764.85714285714,116
"8319","27022","2019",57,56,1,166871.263157895,1791.52631578947,97.8947368421053
"8320","27023","2019",10,10,0,137200,1800.2,80
"8321","27025","2019",19,18,1,132181.157894737,1554.05263157895,91.3684210526316
"8322","27026","2019",11,10,1,178693.636363636,1760.54545454545,107.181818181818
"8323","27027","2019",1,1,0,190000,1810,105
"8324","27028","2019",5,5,0,125600,1244.6,102.4
"8325","27031","2019",8,8,0,210587.5,1792.125,121.375
"8326","27032","2019",17,17,0,140047.647058824,1569.35294117647,91.8235294117647
"8327","27033","2019",4,4,0,164750,1757.5,95
"8328","27034","2019",10,10,0,144765,1590.5,92.9
"8329","27035","2019",5,5,0,237227.6,1673.4,147.4
"8330","27036","2019",11,11,0,141424.545454545,1395.27272727273,107.454545454545
"8331","27037","2019",21,21,0,129614.285714286,1406.95238095238,91.2857142857143
"8332","27038","2019",9,9,0,185944.444444444,1867.55555555556,111.666666666667
"8333","27039","2019",6,6,0,212000,1574.5,152.166666666667
"8334","27040","2019",4,4,0,99500,1177.75,83
"8335","27042","2019",1,1,0,152000,2141,71
"8336","27043","2019",7,7,0,141000,1756.71428571429,83.7142857142857
"8337","27044","2019",15,15,0,155960.666666667,1669.6,97.4666666666667
"8338","27045","2019",10,10,0,193435,1800,112.5
"8339","27046","2019",3,3,0,141500,1711.33333333333,85
"8340","27047","2019",3,3,0,113000,1647.33333333333,73
"8341","27048","2019",4,4,0,183000,1434.5,128.75
"8342","27049","2019",71,71,0,127119.85915493,1351.3661971831,98.830985915493
"8343","27050","2019",14,14,0,153085.071428571,1431.71428571429,115.428571428571
"8344","27051","2019",41,39,2,125663.414634146,1591.65853658537,85.9512195121951
"8345","27052","2019",6,6,0,130925,1497,90.6666666666667
"8346","27053","2019",3,3,0,277666.666666667,1422,179
"8347","27054","2019",8,8,0,128637.5,1270.375,101.75
"8348","27055","2019",7,7,0,157197.857142857,1569.71428571429,104.571428571429
"8349","27056","2019",126,94,32,133684.166666667,1603.38095238095,82.5476190476191
"8350","27057","2019",3,3,0,162333.333333333,1463.33333333333,113.333333333333
"8351","27058","2019",18,18,0,237828.111111111,1753.44444444444,126.666666666667
"8352","27059","2019",2,2,0,119405,1331.5,113.5
"8353","27061","2019",4,4,0,151325,1763,90
"8354","27062","2019",20,20,0,181191,1553.45,120.6
"8355","27063","2019",2,2,0,151500,1297.5,118
"8356","27064","2019",14,14,0,170587.142857143,2049.57142857143,96.6428571428571
"8357","27065","2019",85,60,25,159236.905882353,1716.77647058824,89.4823529411765
"8358","27066","2019",6,6,0,176000,1650.66666666667,102.166666666667
"8359","27067","2019",22,22,0,156891.818181818,1512.54545454545,114.772727272727
"8360","27068","2019",3,3,0,213833.333333333,2551,85.6666666666667
"8361","27069","2019",11,11,0,104681.818181818,1192.72727272727,90.9090909090909
"8362","27070","2019",18,18,0,160277.777777778,1707.44444444444,98.5555555555556
"8363","27071","2019",1,1,0,68000,472,144
"8364","27072","2019",12,12,0,189885.916666667,1905.41666666667,104.166666666667
"8365","27073","2019",18,18,0,177981.944444444,1978,90.9444444444444
"8366","27074","2019",4,4,0,136962.5,1578,91
"8367","27075","2019",7,7,0,115428.571428571,1304.71428571429,92.2857142857143
"8368","27076","2019",11,11,0,207704.545454545,1666.81818181818,129.545454545455
"8369","27077","2019",12,12,0,143852.5,1448.08333333333,102.166666666667
"8370","27078","2019",4,4,0,209500,1845,113
"8371","27079","2019",4,4,0,142750,1523.25,100.75
"8372","27082","2019",26,24,2,149035.769230769,1674.26923076923,94.3461538461538
"8373","27083","2019",1,1,0,259990,1733,150
"8374","27085","2019",18,18,0,181383.333333333,2080.55555555556,90.9444444444444
"8375","27089","2019",7,7,0,141114.285714286,1405.42857142857,96.8571428571429
"8376","27090","2019",46,46,0,180313.804347826,1930.23913043478,97.7826086956522
"8377","27091","2019",13,13,0,173611.538461538,1793.76923076923,98.0769230769231
"8378","27094","2019",3,3,0,209666.666666667,1394.33333333333,149
"8379","27095","2019",11,11,0,151236.363636364,1452.36363636364,100.909090909091
"8380","27096","2019",11,11,0,116972.727272727,1331.09090909091,87.8181818181818
"8381","27097","2019",7,7,0,202121.428571429,1753.14285714286,120.714285714286
"8382","27098","2019",1,1,0,199000,1618,123
"8383","27099","2019",13,13,0,171846.153846154,1783.23076923077,96.5384615384615
"8384","27100","2019",21,16,5,171078.857142857,2139.57142857143,80.3333333333333
"8385","27101","2019",5,5,0,165200,1542.6,104.8
"8386","27102","2019",14,14,0,194069.285714286,1812.07142857143,116
"8387","27103","2019",33,27,6,186106.606060606,1923.75757575758,97.2424242424242
"8388","27104","2019",18,18,0,157327.777777778,1719.88888888889,98.5555555555556
"8389","27105","2019",49,48,1,163267.285714286,1768.16326530612,96.6530612244898
"8390","27106","2019",13,13,0,110884.615384615,1087.84615384615,103.538461538462
"8391","27107","2019",11,10,1,168659.090909091,1465.90909090909,116.727272727273
"8392","27108","2019",16,16,0,100506.25,1039.5,99.0625
"8393","27109","2019",7,7,0,141417.428571429,1482.85714285714,108.857142857143
"8394","27110","2019",12,12,0,137541.666666667,1599.5,92.3333333333333
"8395","27111","2019",5,5,0,279000,3074.6,90.4
"8396","27112","2019",47,45,2,105989.361702128,1508.42553191489,81.2127659574468
"8397","27113","2019",4,4,0,170562.5,1630.25,109
"8398","27114","2019",11,11,0,231704.545454545,2465.81818181818,105.818181818182
"8399","27115","2019",3,3,0,152936.666666667,1398.33333333333,105.666666666667
"8400","27116","2019",53,47,6,102289.622641509,1473.16981132075,74.622641509434
"8401","27117","2019",19,18,1,74351.1578947368,939.789473684211,86.3684210526316
"8402","27118","2019",10,10,0,176250,1645.8,109.8
"8403","27119","2019",31,31,0,177890.580645161,2317.90322580645,82.5806451612903
"8404","27120","2019",3,3,0,128666.666666667,1273,97
"8405","27123","2019",3,2,1,145000,1744,88.3333333333333
"8406","27124","2019",1,1,0,187000,1685,111
"8407","27125","2019",9,9,0,121266.666666667,1443,90.2222222222222
"8408","27126","2019",16,16,0,152075,1572.8125,98.0625
"8409","27127","2019",9,9,0,135668.888888889,1411.11111111111,97.5555555555556
"8410","27129","2019",14,14,0,154357.142857143,1528.35714285714,101
"8411","27130","2019",15,15,0,131768.8,1407.06666666667,96.8666666666667
"8412","27132","2019",8,8,0,182681.25,2080,90.125
"8413","27133","2019",16,16,0,214941.5625,1831.375,121.375
"8414","27134","2019",2,2,0,105000,1212.5,90
"8415","27135","2019",8,8,0,131750,1509.375,88
"8416","27136","2019",4,4,0,243500,2582.25,102
"8417","27137","2019",4,4,0,142000,1304.75,112
"8418","27138","2019",3,3,0,194666.666666667,1832,115.333333333333
"8419","27139","2019",5,5,0,132410,1618.6,81.4
"8420","27140","2019",5,5,0,267540,2135.6,127.6
"8421","27142","2019",2,2,0,281000,1704.5,172
"8422","27144","2019",5,5,0,175830,1791.2,100.4
"8423","27146","2019",4,4,0,189550,1296,151.5
"8424","27147","2019",13,13,0,172152.307692308,1777.46153846154,97.9230769230769
"8425","27148","2019",8,8,0,119325,1316.75,92.875
"8426","27149","2019",1,1,0,136000,2194,62
"8427","27151","2019",31,31,0,120648.387096774,1438.48387096774,92.2903225806452
"8428","27152","2019",12,9,3,107895.833333333,1174.33333333333,105.583333333333
"8429","27153","2019",7,7,0,201714.285714286,1696.28571428571,112.571428571429
"8430","27154","2019",5,5,0,156400,1191,138.4
"8431","27156","2019",10,10,0,126800,1504.1,88.6
"8432","27157","2019",24,24,0,126562.5,1308.70833333333,99.6666666666667
"8433","27158","2019",15,15,0,158490,1794.53333333333,88.4666666666667
"8434","27161","2019",8,8,0,158650,1433.375,110.5
"8435","27162","2019",8,8,0,136500,1615.375,83.375
"8436","27163","2019",4,4,0,164572.5,1585,104.75
"8437","27164","2019",12,12,0,180600,1779.41666666667,105.75
"8438","27165","2019",66,56,10,137364.772727273,1562.98484848485,90.0454545454545
"8439","27167","2019",12,12,0,196833.333333333,1743.41666666667,115.083333333333
"8440","27168","2019",4,4,0,223725,1671.5,143.25
"8441","27169","2019",20,20,0,190252.5,1989.75,100.1
"8442","27170","2019",22,21,1,150206.045454545,1755.18181818182,82.4545454545455
"8443","27171","2019",7,7,0,228707.142857143,1944.57142857143,119.857142857143
"8444","27173","2019",1,1,0,27000,519,52
"8445","27174","2019",12,12,0,150200,1326.66666666667,113.25
"8446","27176","2019",3,3,0,125166.666666667,1723,74.3333333333333
"8447","27177","2019",10,10,0,157311,1434.6,110.7
"8448","27179","2019",9,9,0,139922.222222222,1478.44444444444,101.333333333333
"8449","27180","2019",20,20,0,170338,1801.5,97.4
"8450","27181","2019",7,7,0,179891.428571429,1669.85714285714,109
"8451","27182","2019",3,3,0,133666.666666667,1383.33333333333,96.6666666666667
"8452","27183","2019",29,28,1,161430.689655172,1851.1724137931,92.8965517241379
"8453","27185","2019",6,6,0,136683.333333333,1600.83333333333,88.3333333333333
"8454","27187","2019",4,4,0,121775,1091.25,101.75
"8455","27188","2019",19,19,0,150592.105263158,1585.73684210526,98.6842105263158
"8456","27189","2019",5,5,0,219300,1884.4,117.2
"8457","27190","2019",2,1,1,117000,2397,48
"8458","27191","2019",40,40,0,184587.625,1746.525,114.175
"8459","27192","2019",8,8,0,187650,1798.5,105
"8460","27193","2019",23,23,0,171600.826086957,1926.69565217391,96.3913043478261
"8461","27194","2019",3,3,0,123996.666666667,1442.33333333333,88.6666666666667
"8462","27196","2019",9,9,0,174183.333333333,2151.88888888889,79
"8463","27198","2019",83,82,1,136477.915662651,1479.10843373494,96.8192771084337
"8464","27199","2019",8,8,0,212333,1849.75,121
"8465","27200","2019",2,2,0,237500,1732,136.5
"8466","27201","2019",2,2,0,159325,1813.5,91.5
"8467","27202","2019",9,9,0,114398,1173.66666666667,99
"8468","27203","2019",10,10,0,227886,2259.5,117.6
"8469","27204","2019",6,6,0,182433.333333333,2149.83333333333,99.5
"8470","27205","2019",2,2,0,97500,1303.5,75
"8471","27206","2019",6,6,0,153250,1385.5,110.833333333333
"8472","27207","2019",11,11,0,175909.090909091,1560.63636363636,110.818181818182
"8473","27208","2019",1,1,0,99500,930,107
"8474","27209","2019",8,8,0,160293.75,1719.5,93.75
"8475","27210","2019",9,9,0,137761.111111111,1510.77777777778,93
"8476","27212","2019",3,3,0,221333.333333333,1546.33333333333,146
"8477","27213","2019",86,85,1,195086.651162791,1833.31395348837,109.779069767442
"8478","27214","2019",10,10,0,145900,1479.3,97.4
"8479","27215","2019",5,5,0,136500,1610,88
"8480","27216","2019",4,4,0,194275,1934,108.75
"8481","27217","2019",3,3,0,122666.666666667,1218,103
"8482","27218","2019",19,19,0,170297.263157895,1565.73684210526,111.894736842105
"8483","27219","2019",11,11,0,160709.090909091,1644.63636363636,96.9090909090909
"8484","27220","2019",6,6,0,213758.333333333,1945.33333333333,114.166666666667
"8485","27222","2019",4,4,0,191150,1566.75,134
"8486","27224","2019",2,2,0,185200,2899,62.5
"8487","27226","2019",64,59,5,148326.203125,1873.671875,85.328125
"8488","27227","2019",6,6,0,128616.666666667,1573.83333333333,86.3333333333333
"8489","27228","2019",3,3,0,86666.6666666667,1367.33333333333,62.6666666666667
"8490","27229","2019",643,269,374,119294.045101089,1670.21150855365,71.3825816485225
"8491","27230","2019",67,59,8,168688.149253731,1949.58208955224,92.1641791044776
"8492","27231","2019",7,7,0,209650,2273,101.857142857143
"8493","27232","2019",3,3,0,240773.333333333,1609,159.333333333333
"8494","27233","2019",10,10,0,171686.6,1678.2,102.7
"8495","27234","2019",1,1,0,174150,1451,120
"8496","27235","2019",1,1,0,150000,1034,145
"8497","27237","2019",4,4,0,148487.5,1665.5,86.5
"8498","27238","2019",12,12,0,172972.083333333,1520.5,116.583333333333
"8499","27239","2019",1,1,0,151500,1578,96
"8500","27240","2019",6,6,0,84816.6666666667,1454,71.6666666666667
"8501","27241","2019",1,1,0,182000,1857,98
"8502","27242","2019",12,12,0,143328.333333333,1589.83333333333,96.4166666666667
"8503","27243","2019",9,9,0,194822.222222222,2541.66666666667,81
"8504","27245","2019",7,7,0,131785.714285714,1321.42857142857,100.142857142857
"8505","27246","2019",26,26,0,120458.153846154,1598.69230769231,79.1538461538462
"8506","27247","2019",3,3,0,124146.666666667,913.666666666667,125.666666666667
"8507","27248","2019",1,1,0,59000,415,142
"8508","27249","2019",18,18,0,180358.333333333,1660.77777777778,111.611111111111
"8509","27251","2019",8,8,0,127450,1170.75,103.625
"8510","27252","2019",10,10,0,139050,1499,99.7
"8511","27254","2019",17,17,0,211146.764705882,2004.41176470588,106.117647058824
"8512","27256","2019",7,7,0,174464.285714286,2048.14285714286,98.5714285714286
"8513","27258","2019",7,7,0,230651.428571429,2028.71428571429,112
"8514","27259","2019",2,2,0,201950,1066,210.5
"8515","27260","2019",5,5,0,182300,1745.2,99.2
"8516","27261","2019",13,13,0,161592.307692308,1567.15384615385,103.846153846154
"8517","27263","2019",9,9,0,191416.666666667,1734.11111111111,110
"8518","27266","2019",6,6,0,170750,1671.5,110.5
"8519","27267","2019",4,4,0,224875,1644,132.5
"8520","27269","2019",2,2,0,153000,2627.5,58.5
"8521","27271","2019",1,1,0,102000,2550,40
"8522","27273","2019",7,7,0,217103.571428571,1800.28571428571,120.428571428571
"8523","27275","2019",96,49,47,118267.5,1587.1875,74.2083333333333
"8524","27276","2019",5,5,0,208700,1545.2,140.6
"8525","27277","2019",14,14,0,169692.571428571,1420,122.214285714286
"8526","27278","2019",33,33,0,194277.939393939,2076,96.8484848484848
"8527","27279","2019",37,31,6,166810.540540541,1815.51351351351,91.972972972973
"8528","27280","2019",4,4,0,162625,1930.5,87
"8529","27281","2019",3,3,0,153000,1645,94.6666666666667
"8530","27282","2019",12,12,0,154641.666666667,1662.5,96.8333333333333
"8531","27284","2019",152,96,56,148865.105263158,2066.91447368421,74.1776315789474
"8532","27285","2019",1,1,0,450000,6000,75
"8533","27286","2019",6,6,0,120916.666666667,1226,103.166666666667
"8534","27287","2019",9,9,0,150833.333333333,1538.11111111111,99.6666666666667
"8535","27288","2019",5,5,0,143266.8,1577.8,89.6
"8536","27289","2019",8,8,0,105112.5,1259.875,85.5
"8537","27290","2019",11,11,0,144654.545454545,1438.63636363636,98.5454545454545
"8538","27291","2019",1,1,0,211550,1627,130
"8539","27294","2019",14,14,0,129402.857142857,1752.42857142857,79.9285714285714
"8540","27295","2019",7,7,0,148142.857142857,1338,111.142857142857
"8541","27298","2019",6,6,0,161875,1747,97.8333333333333
"8542","27299","2019",56,42,14,128437.553571429,1710.10714285714,76.5892857142857
"8543","27300","2019",5,5,0,106250,1351.2,81.2
"8544","27301","2019",16,16,0,178865,1707.5625,107.6875
"8545","27302","2019",12,12,0,151234.75,1521.41666666667,99.0833333333333
"8546","27304","2019",4,4,0,229750,1849.75,123.75
"8547","27306","2019",43,43,0,201959.558139535,1918.76744186047,110.627906976744
"8548","27307","2019",4,4,0,144900,2825.5,69.25
"8549","27309","2019",10,10,0,170245,1645.9,110.9
"8550","27310","2019",5,5,0,160189.4,1879.4,89.4
"8551","27311","2019",12,12,0,180041.666666667,1911.25,92.3333333333333
"8552","27312","2019",6,6,0,184083.333333333,2189,85.1666666666667
"8553","27313","2019",9,9,0,180116.666666667,1607.55555555556,113.222222222222
"8554","27315","2019",3,3,0,126000,1771,73.3333333333333
"8555","27316","2019",20,20,0,173782.5,1820.3,98.75
"8556","27317","2019",10,10,0,177302.8,1414.7,126.3
"8557","27318","2019",4,4,0,120662.5,1206,102.75
"8558","27319","2019",5,5,0,120520,1522,83.8
"8559","27320","2019",7,7,0,150728.571428571,1611.57142857143,97.4285714285714
"8560","27321","2019",2,2,0,112500,1341.5,99.5
"8561","27322","2019",21,21,0,150104.761904762,1615.2380952381,95.2380952380952
"8562","27323","2019",4,4,0,101500,1381.5,80.25
"8563","27324","2019",8,8,0,178562.5,1826.25,101.25
"8564","27325","2019",1,1,0,252000,1984,127
"8565","27326","2019",4,4,0,149100,2104.25,76.5
"8566","27327","2019",6,6,0,167558.333333333,1681.5,104.5
"8567","27329","2019",14,14,0,162357.142857143,1619.57142857143,101.071428571429
"8568","27331","2019",13,13,0,176776.923076923,1975.15384615385,95.2307692307692
"8569","27332","2019",14,14,0,231238.5,1911.85714285714,122.285714285714
"8570","27333","2019",8,8,0,188300,1826,105.875
"8571","27334","2019",2,2,0,203000,1780.5,113.5
"8572","27335","2019",16,15,1,227368.75,1743.6875,135.9375
"8573","27336","2019",2,2,0,192545,1651,112
"8574","27337","2019",6,6,0,149246.666666667,1511.5,100.166666666667
"8575","27338","2019",12,12,0,172620.833333333,1612.5,107.166666666667
"8576","27339","2019",7,7,0,149027.571428571,1689.42857142857,88.7142857142857
"8577","27340","2019",8,8,0,183840,1629.125,133.875
"8578","27341","2019",3,3,0,155333.333333333,1337.33333333333,117.333333333333
"8579","27342","2019",1,1,0,225000,2500,90
"8580","27343","2019",20,20,0,232587.1,2046.15,126.4
"8581","27345","2019",8,8,0,167187.5,1620.5,109.625
"8582","27346","2019",4,4,0,151000,1949.75,78.25
"8583","27347","2019",9,9,0,204716.666666667,1650,131.111111111111
"8584","27348","2019",18,18,0,190963.888888889,2055.77777777778,99.7222222222222
"8585","27349","2019",17,17,0,166281.352941176,1623.70588235294,105.235294117647
"8586","27350","2019",13,13,0,152950.769230769,1794.15384615385,93.8461538461538
"8587","27351","2019",30,30,0,169492,1791.56666666667,100.5
"8588","27353","2019",10,10,0,188372.2,1762.2,113.4
"8589","27354","2019",4,4,0,147500,1572,99
"8590","27355","2019",37,30,7,158906.837837838,2135.08108108108,79.4864864864865
"8591","27358","2019",8,8,0,210400,2866.25,76.75
"8592","27359","2019",1,1,0,165000,1571,105
"8593","27360","2019",5,5,0,148300,1607,94.4
"8594","27361","2019",6,6,0,182471.666666667,1808,103.833333333333
"8595","27364","2019",2,2,0,99000,1861,59.5
"8596","27365","2019",15,14,1,161837.333333333,1703,104.066666666667
"8597","27366","2019",2,2,0,232500,1883,118
"8598","27367","2019",22,22,0,148099.818181818,1439.72727272727,113.909090909091
"8599","27368","2019",6,6,0,189333.333333333,1573.83333333333,123
"8600","27369","2019",1,1,0,160000,1818,88
"8601","27370","2019",6,6,0,170678,1809,95.8333333333333
"8602","27371","2019",4,4,0,123000,1294.25,92.25
"8603","27372","2019",16,16,0,154109.375,1748.8125,93.3125
"8604","27373","2019",1,1,0,143000,1702,84
"8605","27374","2019",8,8,0,120200,1566.375,78.875
"8606","27375","2019",209,155,54,143786.985645933,1737.54066985646,84.7511961722488
"8607","27376","2019",4,4,0,156650,1072.5,141.5
"8608","27377","2019",10,10,0,154127.9,1761.4,95.9
"8609","27378","2019",18,18,0,161038.888888889,1643.83333333333,98
"8610","27379","2019",6,5,1,116483.333333333,1171.33333333333,98.8333333333333
"8611","27380","2019",4,4,0,207225,2124.5,109.25
"8612","27381","2019",2,2,0,135000,1564,91
"8613","27382","2019",4,4,0,116300,1257.75,102
"8614","27383","2019",9,9,0,143301.555555556,1403,101.777777777778
"8615","27384","2019",5,5,0,324400,2335,139
"8616","27385","2019",30,25,5,154652.333333333,1569.2,98.1666666666667
"8617","27386","2019",15,15,0,121472.666666667,1544.8,83.2666666666667
"8618","27388","2019",17,17,0,161405.882352941,1570.70588235294,108.705882352941
"8619","27389","2019",6,6,0,170833.333333333,1673.33333333333,104
"8620","27390","2019",14,14,0,156785.714285714,1475.71428571429,114.5
"8621","27391","2019",17,17,0,174354.529411765,1762.05882352941,106.647058823529
"8622","27392","2019",3,3,0,171666.666666667,1715.66666666667,98
"8623","27393","2019",10,10,0,179370,1893,97.4
"8624","27394","2019",6,6,0,153383.333333333,1751.16666666667,89.5
"8625","27395","2019",2,2,0,77000,771,106
"8626","27396","2019",13,13,0,157233.307692308,1856.30769230769,89
"8627","27397","2019",17,16,1,198844.117647059,2001.05882352941,104.294117647059
"8628","27398","2019",17,17,0,189676.470588235,1914.47058823529,107.352941176471
"8629","27399","2019",2,2,0,210000,1962.5,112.5
"8630","27400","2019",9,9,0,271060.444444444,2022.55555555556,133.555555555556
"8631","27401","2019",2,2,0,217050,1609.5,136
"8632","27403","2019",2,2,0,120500,903,133
"8633","27404","2019",2,2,0,106000,1055.5,102.5
"8634","27406","2019",16,16,0,139338.4375,1417.0625,102.75
"8635","27407","2019",3,3,0,155000,1590,95.6666666666667
"8636","27408","2019",7,7,0,184857.142857143,1930.57142857143,96.5714285714286
"8637","27410","2019",10,10,0,203440,1750,120
"8638","27411","2019",4,4,0,176482.5,1264.75,137.25
"8639","27412","2019",13,12,1,188489.384615385,1737.76923076923,114.076923076923
"8640","27413","2019",4,4,0,254025,1787.75,169.25
"8641","27414","2019",15,15,0,137850,1380.4,104.533333333333
"8642","27415","2019",9,9,0,181147.777777778,1449.88888888889,126.333333333333
"8643","27417","2019",13,13,0,152577.230769231,1881.23076923077,89.0769230769231
"8644","27418","2019",1,1,0,279700,3780,74
"8645","27419","2019",26,26,0,169787.307692308,1903.84615384615,92.2307692307692
"8646","27420","2019",3,3,0,162760,1829.33333333333,90.6666666666667
"8647","27421","2019",11,11,0,150390.909090909,1704.72727272727,97.2727272727273
"8648","27422","2019",21,18,3,152983.333333333,1730.42857142857,86.1904761904762
"8649","27423","2019",9,9,0,204035.555555556,2153.33333333333,99.2222222222222
"8650","27424","2019",4,4,0,178427.5,1432.75,140.25
"8651","27425","2019",36,35,1,125903,1567.41666666667,82.1111111111111
"8652","27426","2019",24,24,0,178743.333333333,2157.16666666667,86.0416666666667
"8653","27427","2019",6,6,0,127166.666666667,1248.83333333333,103.166666666667
"8654","27428","2019",56,46,10,151554.285714286,1989.25,81.1785714285714
"8655","27429","2019",4,4,0,166987.5,1320,137.5
"8656","27430","2019",1,1,0,44000,1000,44
"8657","27431","2019",9,9,0,88711.1111111111,1450.22222222222,68
"8658","27432","2019",9,9,0,149944.444444444,1692.33333333333,91.5555555555556
"8659","27433","2019",1,1,0,104000,1733,60
"8660","27434","2019",3,3,0,156166.666666667,1944,77.6666666666667
"8661","27435","2019",6,6,0,159533.333333333,1461.66666666667,116.333333333333
"8662","27436","2019",8,8,0,162300,1398.125,118.875
"8663","27437","2019",8,8,0,147667.625,1595,91.875
"8664","27438","2019",26,23,3,109437.307692308,1353.80769230769,90.4615384615385
"8665","27439","2019",24,24,0,191326.083333333,1746.54166666667,114.166666666667
"8666","27440","2019",15,15,0,218850.266666667,2201.26666666667,102.466666666667
"8667","27441","2019",3,3,0,202000,2169.33333333333,93.3333333333333
"8668","27442","2019",8,8,0,123250,1511.5,79.875
"8669","27444","2019",3,3,0,108666.666666667,1335,79
"8670","27445","2019",3,3,0,193343.333333333,1563,123
"8671","27446","2019",4,4,0,168125,1471.25,111.25
"8672","27447","2019",11,11,0,159731.818181818,1876.18181818182,88.4545454545455
"8673","27448","2019",57,55,2,225772.807017544,2412.87719298246,93.1052631578947
"8674","27451","2019",3,3,0,152000,2010.33333333333,77
"8675","27453","2019",25,25,0,136921.4,1500.92,94.72
"8676","27454","2019",10,10,0,123478.6,1537.5,82.4
"8677","27455","2019",1,1,0,214000,3057,70
"8678","27456","2019",15,15,0,116246.666666667,1136.2,102.6
"8679","27457","2019",7,7,0,127285.714285714,1619.42857142857,87.1428571428571
"8680","27458","2019",39,39,0,150201.615384615,1621.74358974359,93.5128205128205
"8681","27462","2019",2,2,0,85500,1466.5,59.5
"8682","27463","2019",8,8,0,131947.5,1424,105.375
"8683","27464","2019",4,4,0,176000,1558.75,124.5
"8684","27465","2019",7,7,0,238035.714285714,1985.71428571429,129.285714285714
"8685","27466","2019",7,7,0,128454.285714286,1298.85714285714,101.142857142857
"8686","27467","2019",126,80,46,112688.69047619,1595.86507936508,71.7460317460317
"8687","27468","2019",6,6,0,102750,1295.5,79.6666666666667
"8688","27469","2019",40,37,3,164152.85,1883.375,91.525
"8689","27470","2019",22,21,1,120171.045454545,1343.27272727273,95.3181818181818
"8690","27471","2019",1,1,0,98500,794,124
"8691","27472","2019",2,2,0,191500,1526.5,125.5
"8692","27473","2019",10,10,0,193700,1892.1,98.6
"8693","27474","2019",15,15,0,187412,1827.4,105.333333333333
"8694","27475","2019",2,2,0,135000,955,127
"8695","27476","2019",7,7,0,135000,1480.85714285714,92.2857142857143
"8696","27477","2019",9,9,0,161297.222222222,1345.88888888889,122.888888888889
"8697","27478","2019",15,15,0,171636.666666667,1808.93333333333,98.2666666666667
"8698","27480","2019",9,9,0,149745.888888889,1677.33333333333,92.2222222222222
"8699","27481","2019",8,8,0,170875,1675,107.25
"8700","27483","2019",5,5,0,133000,1401.4,96.2
"8701","27485","2019",15,15,0,111560.666666667,1185.6,92.7333333333333
"8702","27486","2019",9,9,0,143777.777777778,1667.44444444444,88
"8703","27487","2019",9,9,0,138055.555555556,1912,74.4444444444444
"8704","27488","2019",2,2,0,142500,1814,78.5
"8705","27489","2019",11,11,0,201531.818181818,1939.72727272727,107.909090909091
"8706","27490","2019",2,2,0,136850,1443,97
"8707","27492","2019",1,1,0,336000,2947,114
"8708","27493","2019",41,41,0,145030.414634146,1702.19512195122,91.0243902439024
"8709","27495","2019",5,5,0,141496,2428,69.6
"8710","27496","2019",8,8,0,154000,1399.875,125
"8711","27497","2019",18,18,0,158502.777777778,1823.88888888889,87.3888888888889
"8712","27498","2019",4,4,0,145000,1583.25,91.75
"8713","27500","2019",22,22,0,148121.818181818,1956.22727272727,80.3636363636364
"8714","27501","2019",5,5,0,232800,2328.4,102
"8715","27502","2019",31,31,0,122548.387096774,1298.90322580645,92.1935483870968
"8716","27504","2019",25,25,0,184324.48,1810.4,104.2
"8717","27505","2019",2,2,0,108900,1795.5,58.5
"8718","27507","2019",58,53,5,149681.034482759,1827.39655172414,85.7413793103448
"8719","27508","2019",1,1,0,175000,1636,107
"8720","27511","2019",9,9,0,149388.888888889,1658.55555555556,91.2222222222222
"8721","27512","2019",3,3,0,253333.333333333,1910.33333333333,131
"8722","27514","2019",7,7,0,112614.285714286,1138.14285714286,106.857142857143
"8723","27516","2019",21,21,0,179042.857142857,1569.28571428571,114.666666666667
"8724","27517","2019",19,19,0,232300,2161.63157894737,115.894736842105
"8725","27518","2019",8,8,0,145207.5,1490.125,98.625
"8726","27520","2019",1,1,0,129900,1048,124
"8727","27521","2019",4,4,0,164862.5,1340.5,130.5
"8728","27522","2019",6,6,0,221708.333333333,1810.16666666667,122.166666666667
"8729","27524","2019",9,9,0,179452.333333333,1524.77777777778,118.777777777778
"8730","27525","2019",7,7,0,253146.428571429,1990.71428571429,131.857142857143
"8731","27527","2019",2,2,0,179500,1513,122.5
"8732","27528","2019",42,37,5,213379.666666667,1989.07142857143,108.452380952381
"8733","27529","2019",5,5,0,337600,1810,187.8
"8734","27531","2019",4,4,0,147379.75,1662.75,86.25
"8735","27533","2019",13,12,1,259965.384615385,2186.30769230769,135.615384615385
"8736","27534","2019",14,14,0,168035.714285714,1456.57142857143,122
"8737","27535","2019",5,5,0,149520,1703.2,89.6
"8738","27536","2019",9,9,0,130333.333333333,1256.33333333333,97
"8739","27537","2019",13,11,2,136162.923076923,1324.92307692308,104.153846153846
"8740","27538","2019",18,18,0,180068.333333333,1709.66666666667,111.444444444444
"8741","27539","2019",5,5,0,176720,1557.8,113.8
"8742","27540","2019",12,12,0,174928.333333333,1710.66666666667,100.75
"8743","27541","2019",3,3,0,102733.333333333,1287.33333333333,82.6666666666667
"8744","27542","2019",16,16,0,169066.3125,1647.375,99.4375
"8745","27543","2019",12,12,0,166166.666666667,1753.75,96.4166666666667
"8746","27544","2019",1,1,0,145000,1495,97
"8747","27546","2019",1,1,0,169000,1252,135
"8748","27547","2019",18,18,0,147934.444444444,1384.33333333333,106
"8749","27548","2019",21,21,0,167992.19047619,1571.04761904762,112.809523809524
"8750","27550","2019",6,6,0,138333.333333333,1572.83333333333,85
"8751","27552","2019",5,5,0,197383.2,1995,97.2
"8752","27553","2019",3,3,0,112500,1098.33333333333,75
"8753","27554","2019",35,34,1,224254.171428571,2116.17142857143,109.657142857143
"8754","27555","2019",2,2,0,220250,1546,147
"8755","27556","2019",1,1,0,85000,639,133
"8756","27557","2019",5,5,0,124080,1626.8,78.2
"8757","27558","2019",3,3,0,121706.666666667,1649.33333333333,74.3333333333333
"8758","27560","2019",2,2,0,123050,1432.5,84
"8759","27561","2019",9,9,0,122437.777777778,1335.77777777778,96
"8760","27562","2019",49,34,15,186405.081632653,1900,95.2857142857143
"8761","27563","2019",12,12,0,155995,1237.5,122.25
"8762","27564","2019",5,5,0,122800,1415,86.2
"8763","27565","2019",4,4,0,134587.5,1714,79.5
"8764","27567","2019",1,1,0,214500,2410,89
"8765","27568","2019",7,7,0,134285.714285714,1554.85714285714,98.5714285714286
"8766","27569","2019",3,3,0,157000,1517,107.666666666667
"8767","27570","2019",2,2,0,133000,1283.5,104
"8768","27571","2019",2,2,0,125000,1485,83
"8769","27572","2019",2,2,0,102500,1029.5,99
"8770","27576","2019",7,7,0,216711.142857143,1393.42857142857,164
"8771","27577","2019",7,7,0,159752.714285714,1529.85714285714,113.714285714286
"8772","27578","2019",10,10,0,152601,1403.4,111.6
"8773","27579","2019",1,1,0,165000,1213,136
"8774","27580","2019",17,17,0,210574.705882353,1835.70588235294,116.411764705882
"8775","27582","2019",22,22,0,159235.681818182,1498.63636363636,108.090909090909
"8776","27584","2019",4,4,0,178715.75,1982.5,89.75
"8777","27586","2019",3,3,0,176666.666666667,1337.33333333333,140.333333333333
"8778","27587","2019",13,13,0,132733.846153846,1377.38461538462,105.153846153846
"8779","27589","2019",15,15,0,200016,1912.73333333333,109.066666666667
"8780","27590","2019",4,4,0,90375,1175,91.25
"8781","27591","2019",13,13,0,196488.461538462,2228.38461538462,95.9230769230769
"8782","27592","2019",1,1,0,230000,3485,66
"8783","27593","2019",23,23,0,177436.956521739,1832.52173913043,100.347826086957
"8784","27594","2019",5,5,0,128300,1226.4,99.2
"8785","27595","2019",10,10,0,191100,1886,107.1
"8786","27597","2019",12,12,0,249357.083333333,2168.33333333333,123.666666666667
"8787","27598","2019",20,19,1,204341,1963.4,102.85
"8788","27599","2019",10,10,0,175240,1757,108.5
"8789","27601","2019",3,3,0,125833.333333333,1294.33333333333,87.3333333333333
"8790","27602","2019",72,69,3,153767.597222222,1636.19444444444,94.8194444444444
"8791","27603","2019",2,2,0,160500,1659.5,97.5
"8792","27604","2019",7,7,0,221382.428571429,1839.57142857143,121.571428571429
"8793","27605","2019",4,4,0,126750,1289.5,103.75
"8794","27606","2019",7,7,0,185028.571428571,1601.85714285714,122.142857142857
"8795","27608","2019",13,13,0,149961.538461538,1393.38461538462,112.538461538462
"8796","27609","2019",6,6,0,198483.333333333,1993.5,97.1666666666667
"8797","27610","2019",1,1,0,119376,1137,105
"8798","27611","2019",2,2,0,87750,1055.5,85
"8799","27612","2019",3,3,0,205000,1259.33333333333,169.666666666667
"8800","27613","2019",3,3,0,145000,1352,107
"8801","27614","2019",3,3,0,125666.666666667,1645.66666666667,77.3333333333333
"8802","27615","2019",4,4,0,175750,2037.5,91.25
"8803","27616","2019",18,18,0,181207.222222222,1850.11111111111,98.9444444444444
"8804","27617","2019",9,9,0,137805.555555556,1359.11111111111,102
"8805","27618","2019",14,14,0,143607.142857143,1394.14285714286,105.928571428571
"8806","27620","2019",5,5,0,143180,1608.6,92.2
"8807","27621","2019",2,2,0,189250,1845.5,102.5
"8808","27622","2019",33,33,0,97196.9696969697,1219.18181818182,83.1818181818182
"8809","27623","2019",15,15,0,133853.333333333,1298.13333333333,102.133333333333
"8810","27624","2019",9,9,0,156357.777777778,1635.77777777778,98.4444444444444
"8811","27625","2019",5,5,0,150252,1648.2,98.4
"8812","27627","2019",3,3,0,229166.666666667,1335.66666666667,167.666666666667
"8813","27629","2019",13,12,1,166465.153846154,1681.23076923077,110.538461538462
"8814","27630","2019",8,8,0,170975,1275.75,129
"8815","27631","2019",5,5,0,135900,1349.4,102.8
"8816","27632","2019",7,7,0,194282,1838.28571428571,107.714285714286
"8817","27633","2019",5,5,0,168300,1668.8,105
"8818","27635","2019",1,1,0,233100,3700,63
"8819","27638","2019",55,55,0,167963.563636364,1622.8,112.472727272727
"8820","27640","2019",2,2,0,137000,1266.5,108.5
"8821","27641","2019",1,1,0,145000,1510,96
"8822","27643","2019",13,13,0,109407.692307692,1300.76923076923,85.6153846153846
"8823","27644","2019",6,6,0,234895,1847.33333333333,129.166666666667
"8824","27645","2019",2,2,0,153250,1745,87.5
"8825","27646","2019",8,8,0,142433.75,1740,82.875
"8826","27649","2019",4,4,0,162050,1899.25,83.75
"8827","27650","2019",6,6,0,181166.666666667,1662,111.5
"8828","27652","2019",5,5,0,192040,1840.6,108.8
"8829","27654","2019",10,10,0,148458,1540.8,99
"8830","27655","2019",6,6,0,181440.833333333,1487.33333333333,119.833333333333
"8831","27656","2019",22,22,0,140165.863636364,1444.22727272727,94.8636363636364
"8832","27658","2019",4,4,0,136750,1211.75,114.75
"8833","27659","2019",1,1,0,190000,1792,106
"8834","27660","2019",3,3,0,127500,1745,82.3333333333333
"8835","27661","2019",1,1,0,198000,1356,146
"8836","27662","2019",6,6,0,161561.166666667,1235,132
"8837","27663","2019",4,4,0,188750,1606.75,118.5
"8838","27664","2019",8,8,0,141437.5,1654,88.25
"8839","27665","2019",12,12,0,143179.166666667,1470.08333333333,104.75
"8840","27666","2019",7,7,0,159039.428571429,1786.14285714286,89.5714285714286
"8841","27667","2019",7,7,0,193328.571428571,1990,99
"8842","27668","2019",8,8,0,166187.5,2174.5,77.125
"8843","27669","2019",6,6,0,201091.666666667,1440.16666666667,137.666666666667
"8844","27670","2019",10,10,0,139255,1419,99
"8845","27671","2019",2,2,0,120500,1410.5,87.5
"8846","27672","2019",3,3,0,115300,1203.33333333333,92.3333333333333
"8847","27673","2019",4,4,0,139750,1424.25,102
"8848","27677","2019",1,1,0,146870,2069,71
"8849","27678","2019",14,14,0,130750,1460.78571428571,93.5
"8850","27679","2019",103,81,22,119594.087378641,1452.8932038835,83.4271844660194
"8851","27680","2019",6,6,0,150500,1137.5,128.666666666667
"8852","27681","2019",344,176,168,168809.761627907,2225.61627906977,76.8343023255814
"8853","27682","2019",7,7,0,181760,2278.28571428571,81.5714285714286
"8854","27683","2019",2,2,0,144250,1464,97
"8855","27684","2019",7,7,0,160428.571428571,1735.85714285714,88.1428571428571
"8856","27685","2019",18,18,0,149935,1321.33333333333,111.111111111111
"8857","27689","2019",9,9,0,133705.555555556,1534.66666666667,80.8888888888889
"8858","27690","2019",4,4,0,292000,2119.25,136
"8859","27691","2019",11,11,0,162481.818181818,1760.36363636364,95.1818181818182
"8860","27692","2019",2,2,0,157500,1065,147.5
"8861","27693","2019",18,18,0,205638.888888889,1823.72222222222,122.166666666667
"8862","27694","2019",3,3,0,308166.666666667,2348.66666666667,131
"8863","27695","2019",2,2,0,178500,1715.5,103.5
"8864","27696","2019",16,16,0,183441.875,1900.75,100.25
"8865","27697","2019",4,4,0,202625,1945.75,110.75
"8866","27698","2019",9,9,0,147309.555555556,1675.44444444444,90.1111111111111
"8867","27699","2019",1,1,0,150000,1282,117
"8868","27700","2019",8,8,0,149689.125,1483.125,112.125
"8869","27701","2019",70,66,4,157582.2,1656.51428571429,95.6571428571429
"8870","28001","2019",34,32,2,241281.647058824,2104.58823529412,122.411764705882
"8871","28003","2019",2,2,0,184650,1615.5,114.5
"8872","28004","2019",3,3,0,128000,806.333333333333,165.333333333333
"8873","28005","2019",12,11,1,94916.6666666667,1294.75,75.6666666666667
"8874","28006","2019",26,26,0,167396.153846154,1770.30769230769,97.4230769230769
"8875","28007","2019",46,41,5,177658.5,2129.71739130435,87.0869565217391
"8876","28008","2019",1,1,0,265000,2208,120
"8877","28010","2019",5,5,0,103220,1110,88.6
"8878","28012","2019",67,67,0,90854.1194029851,1044.46268656716,93.1044776119403
"8879","28013","2019",22,22,0,182210.909090909,1943.86363636364,100.5
"8880","28014","2019",8,8,0,147251.25,1842,80.5
"8881","28015","2019",73,58,15,173045.890410959,2037.47945205479,90.5479452054795
"8882","28016","2019",10,10,0,95800,910.6,101.8
"8883","28018","2019",23,21,2,112134.782608696,1208.26086956522,95.4347826086957
"8884","28019","2019",2,2,0,72500,1347.5,52.5
"8885","28021","2019",19,19,0,167805.263157895,1603.05263157895,104.842105263158
"8886","28022","2019",13,13,0,227529.230769231,1730.23076923077,139
"8887","28023","2019",23,22,1,205707.608695652,1933.69565217391,110.695652173913
"8888","28024","2019",8,8,0,302143.75,1947.125,159.375
"8889","28025","2019",3,3,0,135000,1397.66666666667,93.6666666666667
"8890","28026","2019",3,3,0,178500,1188.66666666667,169.333333333333
"8891","28027","2019",18,17,1,88076.1111111111,1009.66666666667,87.1111111111111
"8892","28028","2019",8,8,0,97250,1379.375,76.75
"8893","28029","2019",7,6,1,139941.142857143,1364.14285714286,100.142857142857
"8894","28030","2019",6,6,0,96250,1230.83333333333,84.5
"8895","28031","2019",3,3,0,60000,949.333333333333,60.6666666666667
"8896","28032","2019",4,4,0,100500,1036.5,101.5
"8897","28033","2019",15,15,0,122816.666666667,1303.86666666667,94.3333333333333
"8898","28034","2019",11,11,0,180029.090909091,1893.90909090909,97.5454545454545
"8899","28035","2019",16,16,0,178041.625,1806.125,105.5625
"8900","28036","2019",18,18,0,261563.166666667,2339.5,118.333333333333
"8901","28037","2019",6,6,0,128833.333333333,1239.33333333333,103.333333333333
"8902","28038","2019",3,3,0,120766.666666667,1238.33333333333,109.666666666667
"8903","28039","2019",31,30,1,194830.580645161,1967.64516129032,100.645161290323
"8904","28040","2019",4,4,0,110850,1377.5,82.75
"8905","28041","2019",4,4,0,115750,1267.25,109.25
"8906","28045","2019",2,2,0,188250,1528,123
"8907","28046","2019",8,8,0,170047.5,1223.5,142.375
"8908","28047","2019",7,7,0,126900.714285714,1281.57142857143,96.5714285714286
"8909","28048","2019",10,10,0,199340,1978,109.1
"8910","28049","2019",3,3,0,124833.333333333,1161.33333333333,109.666666666667
"8911","28050","2019",8,8,0,162201,1851.125,88.125
"8912","28051","2019",60,54,6,118469.583333333,1455.91666666667,81.6833333333333
"8913","28052","2019",18,17,1,223044.444444444,1964,120.722222222222
"8914","28053","2019",2,2,0,188750,1393.5,135
"8915","28054","2019",7,7,0,180782.857142857,1675.57142857143,117.285714285714
"8916","28055","2019",10,10,0,175795,1664.5,116.7
"8917","28056","2019",23,23,0,275576.086956522,2170.78260869565,142.391304347826
"8918","28057","2019",5,5,0,122400,1614.8,83.8
"8919","28058","2019",12,12,0,248668.75,2040.75,131.916666666667
"8920","28059","2019",28,28,0,114298.928571429,1267.60714285714,90.5714285714286
"8921","28060","2019",5,5,0,180242.2,1787.2,101.4
"8922","28061","2019",39,38,1,111840.230769231,1303.94871794872,85
"8923","28062","2019",15,14,1,197238.2,2103.46666666667,101.266666666667
"8924","28064","2019",36,36,0,212683.138888889,2150.75,104.305555555556
"8925","28065","2019",1,1,0,20000,541,37
"8926","28067","2019",1,1,0,110000,1507,73
"8927","28068","2019",6,6,0,184108.333333333,1759.66666666667,111.333333333333
"8928","28070","2019",32,32,0,239475.625,2177.125,113.59375
"8929","28071","2019",6,6,0,114306.666666667,1155.33333333333,98.5
"8930","28072","2019",2,2,0,115500,1179.5,98.5
"8931","28073","2019",10,10,0,225125,1726.2,135.3
"8932","28074","2019",6,6,0,179900,1710.66666666667,108.833333333333
"8933","28075","2019",8,8,0,118178.125,1521.625,84.375
"8934","28076","2019",5,5,0,253100,2472.8,103.2
"8935","28078","2019",2,2,0,107500,1240.5,85
"8936","28079","2019",6,6,0,76000,927.833333333333,81.6666666666667
"8937","28080","2019",8,8,0,83125,1255.25,73.625
"8938","28081","2019",5,5,0,106600,1022.8,108
"8939","28082","2019",10,10,0,179100,1924.1,100.6
"8940","28084","2019",6,6,0,204250,2047.66666666667,100.666666666667
"8941","28085","2019",698,227,471,160140.236389685,2260.60888252149,70.8022922636103
"8942","28086","2019",5,5,0,77000,989.8,82.8
"8943","28087","2019",2,2,0,162500,1265,140
"8944","28088","2019",148,117,31,106249.567567568,1303.27702702703,84.0405405405405
"8945","28089","2019",35,30,5,140960.285714286,1635.65714285714,89.0285714285714
"8946","28090","2019",3,3,0,134500,1740.33333333333,71.3333333333333
"8947","28092","2019",6,6,0,132466.666666667,1833.16666666667,92
"8948","28094","2019",26,26,0,155107.692307692,1811.42307692308,95.3846153846154
"8949","28095","2019",4,4,0,164937.5,1622,103.5
"8950","28096","2019",19,18,1,199303.684210526,1929.26315789474,106.526315789474
"8951","28098","2019",28,28,0,202290.75,2073.75,102.357142857143
"8952","28099","2019",16,16,0,144922.9375,1661.125,93.4375
"8953","28100","2019",12,12,0,170426.25,1804.16666666667,99.6666666666667
"8954","28102","2019",14,13,1,143942.5,1524.71428571429,103.214285714286
"8955","28103","2019",92,92,0,105340.565217391,1181.9347826087,93.3369565217391
"8956","28104","2019",13,13,0,197207.692307692,2079.15384615385,102.230769230769
"8957","28105","2019",9,9,0,122144.444444444,1361,86.3333333333333
"8958","28106","2019",5,5,0,126250,1301,93.6
"8959","28107","2019",1,1,0,175000,2188,80
"8960","28108","2019",4,4,0,112187.5,1181.75,97.25
"8961","28109","2019",4,4,0,109025,1194,91.25
"8962","28110","2019",62,35,27,201935,2418.56451612903,86.6129032258064
"8963","28111","2019",8,8,0,263543.75,1838,137.375
"8964","28113","2019",17,15,2,185515.882352941,1913.58823529412,99.4705882352941
"8965","28114","2019",2,2,0,55500,1078,51
"8966","28116","2019",29,29,0,148141.379310345,1953.8275862069,89.5862068965517
"8967","28117","2019",4,4,0,186050,1351.25,144.75
"8968","28118","2019",3,3,0,228588.333333333,1534,147
"8969","28119","2019",6,6,0,111500,1237.66666666667,89.3333333333333
"8970","28120","2019",6,6,0,147300,1215.5,141.166666666667
"8971","28122","2019",12,12,0,186475,2019.33333333333,99.4166666666667
"8972","28123","2019",5,5,0,104000,1191,85.8
"8973","28124","2019",15,15,0,147534,1360.66666666667,110.866666666667
"8974","28126","2019",5,5,0,90520,1148.4,76.8
"8975","28127","2019",15,15,0,80590.4,1105.4,76.2
"8976","28128","2019",4,4,0,163380,1385.5,118.5
"8977","28129","2019",14,14,0,181867.857142857,1753.5,103.357142857143
"8978","28130","2019",10,10,0,90060,1003.6,90
"8979","28132","2019",8,8,0,98302.5,976,98.25
"8980","28134","2019",325,167,158,118636.541538462,1596.26153846154,75.0523076923077
"8981","28135","2019",15,11,4,273540,2295.26666666667,117.4
"8982","28136","2019",1,1,0,455000,2275,200
"8983","28137","2019",17,17,0,220862.352941176,2103.23529411765,108.941176470588
"8984","28139","2019",7,7,0,160791.428571429,1537.28571428571,107.428571428571
"8985","28140","2019",89,32,57,164418.314606742,2530.89887640449,67.5730337078652
"8986","28141","2019",6,6,0,166833.333333333,1804.5,113.5
"8987","28142","2019",4,4,0,104250,1187.25,84
"8988","28143","2019",3,3,0,163000,1385,114.666666666667
"8989","28144","2019",9,9,0,92155.5555555556,1054.66666666667,91.1111111111111
"8990","28146","2019",15,15,0,234396.666666667,1906.4,126.533333333333
"8991","28147","2019",7,7,0,139080,1496,97.1428571428571
"8992","28148","2019",6,6,0,117533.333333333,1171,99
"8993","28149","2019",11,11,0,107340.909090909,1416.45454545455,75.7272727272727
"8994","28151","2019",6,6,0,99070.8333333333,1267,75.6666666666667
"8995","28154","2019",10,10,0,189385,1834.9,104.7
"8996","28155","2019",5,5,0,170004,1697.2,106.2
"8997","28156","2019",23,23,0,116476.956521739,1162.39130434783,97.8695652173913
"8998","28157","2019",3,3,0,126500,1801.33333333333,72
"8999","28158","2019",9,9,0,256266.666666667,2499.22222222222,106.222222222222
"9000","28159","2019",7,7,0,123071.428571429,1259.85714285714,101.428571428571
"9001","28160","2019",10,10,0,153986,2185.5,72.4
"9002","28161","2019",10,10,0,99295,999.1,104.3
"9003","28163","2019",6,6,0,178813.333333333,1669.5,108
"9004","28164","2019",7,7,0,152571.428571429,1641.14285714286,93
"9005","28166","2019",4,4,0,119000,1406.75,88
"9006","28167","2019",3,3,0,144866.666666667,1323.33333333333,112.666666666667
"9007","28168","2019",55,48,7,185475.327272727,2041.96363636364,96.6727272727273
"9008","28169","2019",5,5,0,213200,2540.2,91.6
"9009","28170","2019",3,3,0,129833.333333333,1385,94.6666666666667
"9010","28171","2019",14,14,0,184525.714285714,1632.57142857143,116.357142857143
"9011","28172","2019",8,8,0,154441.625,1902.375,82
"9012","28173","2019",12,12,0,279425.416666667,2149.25,133.083333333333
"9013","28175","2019",2,2,0,125000,1715.5,72.5
"9014","28176","2019",19,19,0,113226.578947368,1186.21052631579,97.9473684210526
"9015","28177","2019",3,3,0,235580,2495.33333333333,96.6666666666667
"9016","28178","2019",2,2,0,186000,1779.5,109.5
"9017","28180","2019",11,11,0,194791.090909091,2117.09090909091,99.0909090909091
"9018","28182","2019",2,2,0,173000,1313.5,134
"9019","28183","2019",7,7,0,136571.428571429,1940.57142857143,81.7142857142857
"9020","28184","2019",4,4,0,181750,1574,118.5
"9021","28185","2019",13,12,1,266924.307692308,2764.76923076923,98.6153846153846
"9022","28187","2019",13,13,0,312669.230769231,2195.30769230769,140.923076923077
"9023","28188","2019",18,17,1,191030.5,1720.55555555556,110.111111111111
"9024","28189","2019",1,1,0,85000,2024,42
"9025","28190","2019",6,6,0,99916.6666666667,1042.16666666667,95
"9026","28191","2019",42,39,3,221973.571428571,2319.04761904762,100.785714285714
"9027","28192","2019",6,6,0,93613.3333333333,1208.33333333333,92.1666666666667
"9028","28193","2019",3,3,0,260666.666666667,2010,133.333333333333
"9029","28194","2019",8,8,0,143654,1502.5,101.25
"9030","28195","2019",15,15,0,207566.666666667,1885.8,111.466666666667
"9031","28196","2019",51,48,3,135592.745098039,1545.47058823529,96.4313725490196
"9032","28197","2019",2,2,0,125500,1493,81
"9033","28198","2019",15,15,0,121933.333333333,1367.4,90.4
"9034","28199","2019",30,29,1,133143.366666667,1519.1,95.1
"9035","28200","2019",8,8,0,138525,1399.625,96.75
"9036","28201","2019",23,23,0,187097.826086957,2503.21739130435,91.8695652173913
"9037","28202","2019",5,4,1,90400,1149.2,77.4
"9038","28203","2019",20,20,0,165908,1610.9,104.4
"9039","28206","2019",5,4,1,153430,1507.2,116.2
"9040","28207","2019",6,6,0,169833.333333333,1955.16666666667,90.3333333333333
"9041","28208","2019",4,4,0,224450,2761.5,86
"9042","28209","2019",72,53,19,206387.291666667,2183.44444444444,96.4027777777778
"9043","28210","2019",6,6,0,148966.666666667,1726.83333333333,105
"9044","28211","2019",7,7,0,89814.2857142857,863.428571428571,103.571428571429
"9045","28212","2019",3,3,0,102250,836.666666666667,138.666666666667
"9046","28213","2019",6,4,2,145441.666666667,1631.33333333333,93.3333333333333
"9047","28214","2019",51,48,3,95446.0784313725,1183.43137254902,85.0588235294118
"9048","28215","2019",4,4,0,139235,1624,85.75
"9049","28216","2019",4,4,0,215000,1678.25,145.25
"9050","28217","2019",5,5,0,113400,1056.8,111
"9051","28218","2019",135,70,65,142584.274074074,2009.02962962963,74
"9052","28219","2019",6,6,0,88833.3333333333,1090.16666666667,89.5
"9053","28220","2019",95,78,17,220813.894736842,2293.22105263158,96.2526315789474
"9054","28221","2019",4,4,0,108625,992,132
"9055","28222","2019",9,9,0,132213.333333333,1528.11111111111,95.3333333333333
"9056","28223","2019",16,16,0,181518.75,1905.5625,98.1875
"9057","28225","2019",9,9,0,156916.666666667,1725.55555555556,96.7777777777778
"9058","28226","2019",17,16,1,140967.882352941,1325.23529411765,108
"9059","28227","2019",61,49,12,186386.393442623,2441.55737704918,81.7049180327869
"9060","28229","2019",159,79,80,156308.20754717,2008.18238993711,79.2955974842767
"9061","28230","2019",6,6,0,149025,1501.66666666667,100.666666666667
"9062","28231","2019",3,3,0,135300,1699,91.3333333333333
"9063","28232","2019",10,10,0,125190,1398.9,87.2
"9064","28233","2019",14,14,0,84989.2857142857,1025.14285714286,81.2142857142857
"9065","28234","2019",7,7,0,147999.142857143,1338,111.142857142857
"9066","28235","2019",7,7,0,250100,2673.57142857143,104.285714285714
"9067","28236","2019",25,25,0,127319.6,1254.96,96.08
"9068","28237","2019",5,5,0,74160,984.6,81
"9069","28239","2019",6,6,0,226666.666666667,1932.33333333333,117.666666666667
"9070","28240","2019",4,4,0,103875,1187.75,89.75
"9071","28242","2019",1,1,0,185000,1927,96
"9072","28243","2019",3,3,0,136666.666666667,1396.33333333333,100.333333333333
"9073","28245","2019",1,1,0,1e+05,1053,95
"9074","28246","2019",13,13,0,102524.615384615,1253.23076923077,88.7692307692308
"9075","28247","2019",11,11,0,217634.272727273,2096,106.818181818182
"9076","28248","2019",10,10,0,108330,969.5,110.9
"9077","28249","2019",7,7,0,225735.714285714,2153.71428571429,104.857142857143
"9078","28251","2019",17,17,0,227367.647058824,1966.76470588235,122.941176470588
"9079","28252","2019",5,5,0,58300,900.8,69.6
"9080","28253","2019",13,12,1,205824.461538462,2074.30769230769,100.923076923077
"9081","28254","2019",12,12,0,168704.166666667,1506.66666666667,115.5
"9082","28255","2019",2,2,0,182283.5,1520.5,120.5
"9083","28256","2019",9,9,0,113216.666666667,1295.33333333333,93.6666666666667
"9084","28257","2019",2,2,0,134000,1381.5,88.5
"9085","28259","2019",6,6,0,118300,1359.33333333333,90
"9086","28260","2019",3,3,0,176916.666666667,1550.33333333333,117.333333333333
"9087","28261","2019",21,21,0,117979.523809524,1200.52380952381,102.952380952381
"9088","28263","2019",9,9,0,137555.555555556,1322.55555555556,113.888888888889
"9089","28264","2019",2,2,0,192500,1287.5,160
"9090","28265","2019",8,8,0,90000,870.5,110.375
"9091","28267","2019",2,2,0,199500,1497,135.5
"9092","28269","2019",25,25,0,243618,2025.76,126.96
"9093","28270","2019",4,4,0,159881.75,1710.25,101.5
"9094","28271","2019",1,1,0,185000,764,242
"9095","28272","2019",3,3,0,144666.666666667,1370.33333333333,102.333333333333
"9096","28273","2019",5,5,0,117400,1014,132.6
"9097","28274","2019",3,3,0,109666.666666667,1319,80.3333333333333
"9098","28275","2019",14,14,0,156392.857142857,1695.14285714286,96.2142857142857
"9099","28276","2019",3,3,0,196533.333333333,1569,124.666666666667
"9100","28277","2019",4,4,0,136150,1587,89
"9101","28278","2019",14,11,3,241306.857142857,2685.5,117.5
"9102","28279","2019",62,48,14,149592.741935484,1914.96774193548,83.2096774193548
"9103","28280","2019",129,88,41,99714.7286821705,1169.44186046512,86.2480620155039
"9104","28281","2019",6,6,0,170000,1671.33333333333,108
"9105","28282","2019",12,12,0,101250,1336.33333333333,84
"9106","28283","2019",5,5,0,107420,1139.8,104.2
"9107","28284","2019",5,5,0,85960,1147.8,72
"9108","28285","2019",3,3,0,521333.333333333,3113.33333333333,137
"9109","28286","2019",7,7,0,130428.571428571,1876.85714285714,74.4285714285714
"9110","28287","2019",17,17,0,152933.176470588,1491.35294117647,99.7058823529412
"9111","28289","2019",3,3,0,158550,2568.66666666667,65.3333333333333
"9112","28290","2019",3,3,0,154000,1519.66666666667,98
"9113","28291","2019",11,11,0,116000,1603.36363636364,75.6363636363636
"9114","28292","2019",10,10,0,213288,1974.6,120
"9115","28293","2019",11,9,2,179936.363636364,1811.18181818182,113.454545454545
"9116","28294","2019",10,10,0,153815,1845.1,84.4
"9117","28296","2019",3,3,0,139333.333333333,1602.66666666667,87
"9118","28298","2019",49,42,7,182334.693877551,2193.91836734694,85.8367346938775
"9119","28299","2019",3,3,0,133916.666666667,1317.66666666667,106.666666666667
"9120","28300","2019",5,5,0,105000,1024.8,104
"9121","28301","2019",4,4,0,203090,1907,107.25
"9122","28302","2019",12,12,0,126510.416666667,1372.16666666667,94.8333333333333
"9123","28304","2019",7,7,0,111000,1383.28571428571,83
"9124","28305","2019",5,5,0,120000,1574,82.2
"9125","28306","2019",2,2,0,86000,1749,57
"9126","28308","2019",1,1,0,1e+05,847,118
"9127","28309","2019",18,18,0,151027.777777778,1697.72222222222,88.6111111111111
"9128","28310","2019",6,6,0,103958.166666667,1374.83333333333,76.8333333333333
"9129","28312","2019",3,3,0,252333.333333333,1566.33333333333,159.333333333333
"9130","28313","2019",4,4,0,169000,1230.5,152.25
"9131","28314","2019",3,3,0,79666.6666666667,1461.33333333333,73.3333333333333
"9132","28316","2019",3,3,0,136833.333333333,1271.33333333333,116
"9133","28317","2019",8,8,0,189936.25,2233,86
"9134","28319","2019",15,15,0,157950,1575,104.733333333333
"9135","28321","2019",17,17,0,228623.529411765,2221.82352941176,102.941176470588
"9136","28322","2019",4,4,0,220750,1734.75,125
"9137","28323","2019",9,9,0,134222.222222222,1337,101.777777777778
"9138","28324","2019",12,12,0,133938,1472.25,97.6666666666667
"9139","28325","2019",10,10,0,178438.6,1794.7,105.4
"9140","28326","2019",2,2,0,158300,1386.5,114.5
"9141","28327","2019",4,4,0,114500,1030.75,113.5
"9142","28329","2019",1,1,0,153000,987,155
"9143","28330","2019",24,24,0,121824.75,1311.875,92.0833333333333
"9144","28331","2019",11,11,0,120981.818181818,1048.90909090909,110.454545454545
"9145","28332","2019",13,13,0,194092.307692308,1931.38461538462,102.615384615385
"9146","28333","2019",5,5,0,134380,1197.8,118.4
"9147","28334","2019",21,21,0,121615.619047619,1353.61904761905,91.9523809523809
"9148","28335","2019",8,8,0,113600,1251.125,97.75
"9149","28336","2019",2,2,0,105000,1458.5,70
"9150","28337","2019",33,32,1,186731.818181818,1988.93939393939,95.8181818181818
"9151","28339","2019",7,7,0,151498.571428571,1222.42857142857,119.142857142857
"9152","28341","2019",4,4,0,182525,1695.5,112.25
"9153","28342","2019",2,2,0,167000,1363.5,122
"9154","28343","2019",9,9,0,235273.777777778,2076.22222222222,137.111111111111
"9155","28344","2019",6,6,0,208786.666666667,1835.83333333333,121
"9156","28347","2019",16,13,3,257606.25,2687.0625,99.1875
"9157","28348","2019",40,38,2,132104.8,1497.2,95.175
"9158","28349","2019",1,1,0,610000,1748,349
"9159","28350","2019",15,15,0,158770.666666667,1557.4,104
"9160","28351","2019",10,10,0,176617,1650.4,108
"9161","28352","2019",20,20,0,200662.5,2132.85,96.8
"9162","28353","2019",5,5,0,135200,1313.8,118.4
"9163","28354","2019",7,7,0,133610,1449.42857142857,92.8571428571429
"9164","28355","2019",9,9,0,329998,2189.77777777778,154
"9165","28357","2019",16,16,0,174340.625,1953.6875,95
"9166","28358","2019",25,25,0,248424.52,1915.76,140.56
"9167","28359","2019",46,45,1,138222.608695652,1633.4347826087,87.0434782608696
"9168","28360","2019",12,12,0,154214.25,1442.91666666667,116.666666666667
"9169","28362","2019",7,7,0,105714.285714286,1094.57142857143,97.2857142857143
"9170","28363","2019",16,16,0,184602.1875,1970.3125,98.5
"9171","28364","2019",11,11,0,129690,1271.54545454545,104
"9172","28365","2019",6,6,0,161533.333333333,1368.83333333333,125.666666666667
"9173","28366","2019",4,4,0,136125,1460.25,98.75
"9174","28367","2019",1,1,0,50000,1190,42
"9175","28368","2019",2,2,0,132000,1248.5,95
"9176","28369","2019",8,7,1,138600.25,1252.625,97.875
"9177","28370","2019",11,11,0,116045.454545455,1343.18181818182,87.0909090909091
"9178","28371","2019",19,19,0,218821.052631579,1996.78947368421,111.421052631579
"9179","28372","2019",12,12,0,199630.083333333,1856.33333333333,116
"9180","28373","2019",43,42,1,121258.11627907,1144,106.348837209302
"9181","28374","2019",6,6,0,200811.666666667,1590,124.666666666667
"9182","28375","2019",9,9,0,194538.666666667,2391.55555555556,81.1111111111111
"9183","28377","2019",29,28,1,192427.586206897,2181.79310344828,112.551724137931
"9184","28378","2019",4,4,0,165000,1576.25,98.5
"9185","28379","2019",5,5,0,161200,1850.6,92.4
"9186","28380","2019",13,13,0,202373.076923077,2024.46153846154,109.153846153846
"9187","28382","2019",12,12,0,188691.333333333,1724.91666666667,115.583333333333
"9188","28383","2019",17,17,0,132555.294117647,1337.05882352941,102.647058823529
"9189","28385","2019",7,7,0,142017.142857143,1584.71428571429,92.7142857142857
"9190","28386","2019",22,22,0,153052.5,1551.72727272727,103.272727272727
"9191","28387","2019",11,11,0,89909.0909090909,1160.27272727273,76.6363636363636
"9192","28388","2019",11,10,1,157190.909090909,1832,88.3636363636364
"9193","28389","2019",4,4,0,114200,1200.75,95.25
"9194","28390","2019",1,1,0,154000,962,160
"9195","28391","2019",48,40,8,123981.625,1472.25,89.5416666666667
"9196","28392","2019",3,3,0,181666.666666667,1325.66666666667,134.666666666667
"9197","28393","2019",28,28,0,183603.75,1584.85714285714,115.928571428571
"9198","28394","2019",12,12,0,186183.333333333,1673.5,115.833333333333
"9199","28395","2019",2,2,0,56000,729,70
"9200","28396","2019",7,7,0,88252.8571428571,1183.71428571429,75.1428571428571
"9201","28397","2019",10,10,0,176050,1892.9,93.7
"9202","28398","2019",23,23,0,98869.1304347826,1080.82608695652,91.1304347826087
"9203","28400","2019",3,3,0,98816.6666666667,1139,97.6666666666667
"9204","28401","2019",10,10,0,143349.9,1340.7,107.1
"9205","28403","2019",7,7,0,234428.571428571,1757.42857142857,136.857142857143
"9206","28404","2019",117,96,21,151957.658119658,1717.38461538462,91.7606837606838
"9207","28405","2019",19,19,0,198928.421052632,1950.10526315789,102.631578947368
"9208","28406","2019",26,26,0,100188.461538462,1186.88461538462,91.4615384615385
"9209","28407","2019",9,9,0,223676.111111111,1740.33333333333,131
"9210","28408","2019",1,1,0,163000,2173,75
"9211","28409","2019",2,2,0,173000,1433,124
"9212","28410","2019",9,9,0,139200,1181.11111111111,115
"9213","28411","2019",2,2,0,99500,1073.5,90
"9214","28414","2019",1,1,0,158000,1699,93
"9215","28415","2019",22,22,0,176434.090909091,1637.40909090909,116.818181818182
"9216","28417","2019",25,25,0,226235.2,1932.88,125.04
"9217","28418","2019",4,4,0,159509.25,1565.25,94
"9218","28419","2019",5,5,0,118540,1140.4,105
"9219","28421","2019",4,4,0,131250,1943,70
"9220","28422","2019",74,70,4,127112.702702703,1444.10810810811,89.3378378378378
"9221","28423","2019",7,7,0,174614.285714286,2135.71428571429,90
"9222","28424","2019",26,25,1,105832.692307692,1296.76923076923,85.1153846153846
"9223","28425","2019",18,17,1,191223.333333333,2209.77777777778,96.3333333333333
"9224","28426","2019",7,7,0,135142.857142857,1431,106.285714285714
"9225","29001","2019",13,13,0,140646.153846154,1567.61538461538,92.4615384615385
"9226","29002","2019",12,12,0,161404.583333333,1759.41666666667,105.166666666667
"9227","29003","2019",118,77,41,136070.13559322,1684.9406779661,83.6016949152542
"9228","29004","2019",80,78,2,140456.125,1528.6,98.1625
"9229","29005","2019",12,12,0,160304.166666667,1616.33333333333,98.75
"9230","29006","2019",160,69,91,184517.0625,2584.225,71.84375
"9231","29007","2019",18,18,0,83792.6111111111,1035,82.7777777777778
"9232","29008","2019",16,16,0,137762.5,1518.75,93.4375
"9233","29010","2019",15,15,0,124100.666666667,1151.4,109.666666666667
"9234","29011","2019",36,35,1,238802.638888889,2011.80555555556,118.833333333333
"9235","29012","2019",7,6,1,59804.2857142857,822.857142857143,76.4285714285714
"9236","29013","2019",5,5,0,90145.8,732,116.4
"9237","29014","2019",7,7,0,85866.8571428571,847,98
"9238","29015","2019",40,38,2,168919.2,1624.8,107.45
"9239","29016","2019",10,10,0,68534,975.1,75.5
"9240","29017","2019",9,9,0,122790.222222222,1335.66666666667,97.8888888888889
"9241","29018","2019",9,9,0,73088.4444444444,1075.44444444444,83.4444444444444
"9242","29019","2019",3284,784,2500,111864.706151035,1563.7158952497,71.0837393422655
"9243","29020","2019",78,73,5,128420.371794872,1326.62820512821,99.7307692307692
"9244","29021","2019",48,46,2,161171.145833333,1659.14583333333,96.3958333333333
"9245","29022","2019",78,65,13,150734.756410256,1805.23076923077,88.4487179487179
"9246","29023","2019",69,53,16,223120.884057971,2288.91304347826,96.6376811594203
"9247","29024","2019",99,84,15,92529.6464646465,1067.0404040404,89.2222222222222
"9248","29025","2019",20,19,1,109081,1204.7,93.3
"9249","29026","2019",79,61,18,90435.7721518987,1103.77215189873,81.0506329113924
"9250","29027","2019",45,44,1,89055.5555555556,919.644444444444,94.8666666666667
"9251","29028","2019",15,15,0,136733.333333333,1433.4,102.133333333333
"9252","29029","2019",17,17,0,85381.3529411765,1083.41176470588,77.7058823529412
"9253","29030","2019",63,62,1,120859.587301587,1277.09523809524,99.3015873015873
"9254","29031","2019",112,80,32,207536.232142857,2457.92857142857,89.5625
"9255","29032","2019",49,47,2,238565.87755102,1882.32653061224,126.632653061224
"9256","29033","2019",3,3,0,62266.6666666667,631,97.3333333333333
"9257","29034","2019",13,13,0,94312.3076923077,1081.92307692308,90.3076923076923
"9258","29035","2019",18,18,0,155305.555555556,1587,116.388888888889
"9259","29036","2019",14,14,0,67130,692.214285714286,107.714285714286
"9260","29037","2019",85,73,12,229719.352941176,2354.68235294118,99.2470588235294
"9261","29038","2019",21,21,0,96855.3809523809,950.238095238095,101
"9262","29039","2019",437,238,199,169485.505720824,2119.70938215103,81.3135011441648
"9263","29040","2019",43,35,8,195949.069767442,2232.18604651163,90.1162790697674
"9264","29041","2019",20,20,0,122090,1299.45,98.75
"9265","29042","2019",202,157,45,170686.02970297,2040.94554455446,86.4554455445545
"9266","29043","2019",26,26,0,175967.307692308,1612.19230769231,109.538461538462
"9267","29044","2019",17,17,0,120548.235294118,1245.58823529412,97.1176470588235
"9268","29045","2019",27,27,0,192683.296296296,1684.18518518519,120.111111111111
"9269","29046","2019",314,180,134,116999.318471338,1476.73248407643,83.5828025477707
"9270","29047","2019",22,22,0,163122.863636364,1530.86363636364,111.409090909091
"9271","29048","2019",28,28,0,132414.285714286,1208.64285714286,111.428571428571
"9272","29049","2019",52,52,0,133488.923076923,1257.61538461538,102.403846153846
"9273","29051","2019",108,107,1,156107.462962963,1566.43518518519,102.12962962963
"9274","29053","2019",29,29,0,132922.586206897,1289,104.241379310345
"9275","29054","2019",18,18,0,69644.4444444444,947.888888888889,75.4444444444444
"9276","29055","2019",37,35,2,157039.513513514,1694.24324324324,99.4324324324324
"9277","29056","2019",22,21,1,171727.272727273,1686.40909090909,102.954545454545
"9278","29057","2019",72,45,27,227347.777777778,2215.52777777778,102.458333333333
"9279","29058","2019",210,151,59,226161.142857143,2480.05238095238,95
"9280","29059","2019",12,12,0,97991.6666666667,1165.75,86.75
"9281","29060","2019",37,37,0,229987.837837838,2011.21621621622,115.567567567568
"9282","29061","2019",65,57,8,192729.876923077,2004.87692307692,102.984615384615
"9283","29062","2019",24,24,0,81420,858.25,96.9583333333333
"9284","29063","2019",7,6,1,96011.5714285714,924.571428571429,99.4285714285714
"9285","29064","2019",7,7,0,88027.1428571429,1103,85.7142857142857
"9286","29065","2019",17,17,0,122609.823529412,1266.82352941176,99.2352941176471
"9287","29066","2019",16,16,0,181887.5,1480.125,123.625
"9288","29067","2019",23,23,0,84500.4347826087,1001.26086956522,92.8695652173913
"9289","29068","2019",34,34,0,128679.617647059,1208.32352941176,109.852941176471
"9290","29069","2019",87,83,4,184271.126436782,1829.57471264368,101.816091954023
"9291","29070","2019",6,6,0,90483.3333333333,1130.5,79.5
"9292","29071","2019",15,15,0,129670.666666667,1295.6,97.7333333333333
"9293","29072","2019",86,71,15,125549.127906977,1660.82558139535,79.6627906976744
"9294","29073","2019",17,17,0,139135.294117647,1219.70588235294,115.705882352941
"9295","29074","2019",12,12,0,132593.25,1097.5,121.75
"9296","29075","2019",149,138,11,193901.382550336,1932.87919463087,100.805369127517
"9297","29076","2019",56,55,1,181728.464285714,1687.83928571429,112.339285714286
"9298","29077","2019",31,31,0,125322.612903226,1420.48387096774,91.7741935483871
"9299","29078","2019",26,26,0,143525.384615385,1738.23076923077,94.2692307692308
"9300","29079","2019",26,25,1,122743.653846154,1158.26923076923,107.653846153846
"9301","29080","2019",38,38,0,175732.868421053,1698.15789473684,103.184210526316
"9302","29081","2019",56,54,2,102216.607142857,1105.44642857143,96.4285714285714
"9303","29082","2019",10,10,0,218240,2964.6,80.5
"9304","29085","2019",35,20,15,187226.657142857,2474.05714285714,77.1714285714286
"9305","29086","2019",27,27,0,141746.777777778,1482.25925925926,95.9259259259259
"9306","29087","2019",9,9,0,133155.555555556,1520.66666666667,86.3333333333333
"9307","29089","2019",18,18,0,74336.1111111111,965.444444444444,77.2222222222222
"9308","29090","2019",11,11,0,189845.454545455,1502.27272727273,123.545454545455
"9309","29091","2019",39,39,0,130643.435897436,1330.35897435897,102.692307692308
"9310","29093","2019",14,14,0,133280,1456.42857142857,98.2857142857143
"9311","29094","2019",10,10,0,128500,1222.4,108
"9312","29095","2019",14,14,0,173167.714285714,1732.5,99.5
"9313","29097","2019",28,28,0,134637.142857143,1286.07142857143,106
"9314","29098","2019",43,42,1,161221.488372093,1765.23255813953,95.2790697674419
"9315","29099","2019",18,18,0,184587.222222222,1795.94444444444,100.944444444444
"9316","29100","2019",5,5,0,123149,1222.8,102
"9317","29101","2019",68,62,6,174937.794117647,1748.11764705882,101.735294117647
"9318","29102","2019",15,15,0,78173.3333333333,904.266666666667,92.4
"9319","29103","2019",240,155,85,138659.608333333,1676.3,84.025
"9320","29104","2019",9,9,0,88500,1041.44444444444,83.7777777777778
"9321","29105","2019",154,121,33,115737.441558442,1259.27272727273,91.3051948051948
"9322","29106","2019",20,20,0,142217.05,1214.05,116.55
"9323","29107","2019",12,12,0,119775.5,1222.75,98.0833333333333
"9324","29108","2019",12,12,0,117671.666666667,1078.25,115.333333333333
"9325","29109","2019",25,25,0,199286,2045.72,103.88
"9326","29110","2019",11,11,0,155772.727272727,1346.54545454545,112.727272727273
"9327","29111","2019",21,21,0,109851.761904762,1165.71428571429,97.6190476190476
"9328","29112","2019",18,18,0,190847.222222222,1532.94444444444,118.944444444444
"9329","29113","2019",35,34,1,127785.514285714,1269.97142857143,103
"9330","29114","2019",2,2,0,48500,589,73.5
"9331","29115","2019",7,7,0,79941.7142857143,980.285714285714,91
"9332","29116","2019",2,2,0,153217.5,1966.5,78.5
"9333","29117","2019",87,79,8,150499.586206897,1588.81609195402,95.6091954022989
"9334","29119","2019",10,10,0,188706,1623.2,120.2
"9335","29120","2019",33,27,6,140343.424242424,1439.21212121212,96.6060606060606
"9336","29122","2019",16,16,0,90625,974.4375,99.6875
"9337","29123","2019",13,13,0,92961.5384615385,960.538461538462,100.923076923077
"9338","29124","2019",142,106,36,129982.211267606,1431.25352112676,92.1267605633803
"9339","29125","2019",19,19,0,63605.2631578947,686.052631578947,90.4210526315789
"9340","29126","2019",3,3,0,196666.666666667,1550.33333333333,125.333333333333
"9341","29128","2019",1,1,0,1e+05,1075,93
"9342","29130","2019",63,58,5,200916.349206349,1927.60317460317,102.84126984127
"9343","29131","2019",8,8,0,118925,1165.75,100.625
"9344","29132","2019",22,21,1,177437.5,1746.40909090909,101.727272727273
"9345","29133","2019",54,48,6,198362.962962963,2491.31481481481,84.8888888888889
"9346","29134","2019",11,11,0,196454.545454545,1796.18181818182,101.272727272727
"9347","29135","2019",99,94,5,192194.111111111,2043.68686868687,100.828282828283
"9348","29136","2019",16,16,0,133305.0625,1312.3125,99.5625
"9349","29137","2019",37,37,0,169370.540540541,1790.21621621622,97.972972972973
"9350","29139","2019",10,10,0,135500,1411.1,101.4
"9351","29140","2019",43,43,0,214740.395348837,1827.09302325581,116.651162790698
"9352","29141","2019",12,12,0,73601.25,906.833333333333,83.6666666666667
"9353","29142","2019",7,7,0,137081.142857143,1199.28571428571,117.142857142857
"9354","29143","2019",11,11,0,167327.636363636,1302,132.363636363636
"9355","29144","2019",13,13,0,134410.153846154,1319,100.384615384615
"9356","29145","2019",8,8,0,140168.75,1164,128.5
"9357","29146","2019",24,24,0,168190.041666667,1539.75,112
"9358","29147","2019",40,38,2,179771.25,1648.575,111.025
"9359","29148","2019",16,16,0,109215.625,987.625,115.875
"9360","29150","2019",156,143,13,196986.083333333,1957.98076923077,104.666666666667
"9361","29151","2019",316,182,134,90943.917721519,1093.17088607595,82.0379746835443
"9362","29152","2019",6,6,0,46416.6666666667,592.5,76.3333333333333
"9363","29153","2019",64,60,4,211128.59375,2127.15625,102.515625
"9364","29155","2019",13,13,0,182103.461538462,2216.46153846154,80.6153846153846
"9365","29156","2019",23,23,0,198020.217391304,1762.95652173913,114
"9366","29158","2019",136,129,7,152233.382352941,1642.13970588235,98.0588235294118
"9367","29159","2019",14,14,0,142792.857142857,1392.5,109.928571428571
"9368","29160","2019",103,94,9,179440.563106796,1765.82524271845,101.902912621359
"9369","29161","2019",43,40,3,197426.046511628,1910.51162790698,107.720930232558
"9370","29162","2019",40,40,0,103138.25,1079.05,97.475
"9371","29163","2019",32,32,0,107669.65625,1200.09375,94.59375
"9372","29165","2019",68,64,4,198136.411764706,1949.88235294118,102.073529411765
"9373","29166","2019",8,8,0,105337.5,1008.125,107
"9374","29167","2019",21,21,0,126958.095238095,1233.2380952381,103.47619047619
"9375","29168","2019",28,28,0,120651.428571429,1374.25,87.5
"9376","29169","2019",35,33,2,146279.571428571,1459.34285714286,102
"9377","29170","2019",45,43,2,185350.511111111,1678.35555555556,112.511111111111
"9378","29171","2019",59,59,0,176845.101694915,1728.45762711864,111.745762711864
"9379","29172","2019",40,40,0,166038.5,1658.825,102.7
"9380","29173","2019",24,24,0,173337.5,1590.29166666667,110.416666666667
"9381","29174","2019",90,89,1,155767.388888889,1671.73333333333,98.7444444444444
"9382","29175","2019",41,41,0,86890,1096.56097560976,90.3170731707317
"9383","29176","2019",21,21,0,158144.761904762,1789.47619047619,102.952380952381
"9384","29177","2019",50,49,1,176174.46,1809.82,101.68
"9385","29178","2019",107,101,6,173135.327102804,1701.55140186916,100.196261682243
"9386","29179","2019",53,53,0,130560.641509434,1267.79245283019,105.698113207547
"9387","29180","2019",8,8,0,127487.5,1564.875,99.125
"9388","29181","2019",29,29,0,152323.172413793,1538.86206896552,101.206896551724
"9389","29182","2019",14,14,0,124464.285714286,1234.57142857143,99.2857142857143
"9390","29183","2019",9,9,0,138000,1271.11111111111,106.888888888889
"9391","29184","2019",35,35,0,116783.8,1196.45714285714,95.7142857142857
"9392","29185","2019",76,70,6,126810.763157895,1323.30263157895,98.5394736842105
"9393","29186","2019",29,29,0,167895.862068966,1683.75862068966,105.862068965517
"9394","29187","2019",8,8,0,128640.625,1463.625,86.5
"9395","29188","2019",83,80,3,201162.289156627,1826.3734939759,111.048192771084
"9396","29189","2019",178,158,20,201923.202247191,1964.84831460674,104.230337078652
"9397","29190","2019",79,61,18,233533.037974684,2245.87341772152,102.949367088608
"9398","29191","2019",38,38,0,140947.368421053,1300.23684210526,102.394736842105
"9399","29192","2019",23,23,0,149103.913043478,1461.65217391304,102.478260869565
"9400","29193","2019",16,16,0,145545,1208.8125,119.8125
"9401","29195","2019",127,121,6,148202.677165354,1656.55905511811,89.8425196850394
"9402","29196","2019",19,19,0,127121.789473684,1321.94736842105,97.2631578947368
"9403","29197","2019",124,121,3,159192.419354839,1670.35483870968,97.0564516129032
"9404","29198","2019",27,27,0,149836.481481481,1428.74074074074,113.925925925926
"9405","29199","2019",79,79,0,124024.46835443,1239.50632911392,101.696202531646
"9406","29201","2019",19,19,0,128828.842105263,1615.36842105263,84.4736842105263
"9407","29202","2019",28,28,0,87605.3571428571,940.5,91.4642857142857
"9408","29204","2019",26,26,0,159656.384615385,1442.57692307692,110.5
"9409","29205","2019",11,11,0,88290.9090909091,995.636363636364,88.2727272727273
"9410","29206","2019",50,49,1,112311.96,1124.28,100.22
"9411","29207","2019",56,54,2,128183.928571429,1198.66071428571,106.803571428571
"9412","29208","2019",21,21,0,155881.904761905,1652.28571428571,94.0476190476191
"9413","29209","2019",33,32,1,152707.575757576,1592.72727272727,97.7272727272727
"9414","29210","2019",34,34,0,129317.882352941,1075.97058823529,120.823529411765
"9415","29211","2019",14,14,0,78737.8571428571,987.142857142857,81.6428571428571
"9416","29212","2019",131,121,10,182015.526717557,1800.02290076336,101.908396946565
"9417","29213","2019",29,29,0,111827.206896552,1099.44827586207,113.620689655172
"9418","29214","2019",11,11,0,174781.636363636,1901.27272727273,100.636363636364
"9419","29215","2019",60,60,0,137890,1456.78333333333,97.2666666666667
"9420","29216","2019",28,28,0,177440.857142857,1550.75,118.5
"9421","29217","2019",73,65,8,168910.739726027,1762.21917808219,97.9178082191781
"9422","29218","2019",32,32,0,165228.125,1452.53125,112.0625
"9423","29220","2019",187,132,55,135542.352941176,1713.56684491979,80.3208556149733
"9424","29221","2019",34,34,0,177340.176470588,1847.23529411765,106.264705882353
"9425","29222","2019",9,8,1,102798.888888889,1222.88888888889,78.3333333333333
"9426","29224","2019",16,16,0,145446.9375,1418.9375,114.5625
"9427","29225","2019",38,38,0,155141.552631579,1574.44736842105,105.184210526316
"9428","29226","2019",13,11,2,167432.692307692,1507.76923076923,104.461538461538
"9429","29227","2019",24,24,0,71604.375,793.5,91.5833333333333
"9430","29228","2019",13,13,0,169577.692307692,1602.38461538462,104.692307692308
"9431","29229","2019",7,7,0,106302.142857143,1325.42857142857,74.4285714285714
"9432","29230","2019",19,19,0,119131.578947368,1164,103.368421052632
"9433","29232","2019",1537,668,869,122369.690305791,1624.63109954457,74.9772283669486
"9434","29233","2019",200,153,47,134388.94,1505.77,91.215
"9435","29234","2019",29,29,0,200739.482758621,1695.24137931034,117.48275862069
"9436","29235","2019",162,125,37,216571.734567901,2181.82098765432,99
"9437","29236","2019",70,69,1,146597.714285714,1489.85714285714,102.1
"9438","29237","2019",26,26,0,137685,1380.57692307692,99.8076923076923
"9439","29238","2019",20,20,0,166755.5,1859.6,92.55
"9440","29239","2019",63,36,27,168565.476190476,2227.01587301587,77.1904761904762
"9441","29240","2019",10,10,0,118070.6,1585.7,88.5
"9442","29241","2019",127,117,10,123093.929133858,1294.08661417323,96.2047244094488
"9443","29243","2019",11,11,0,125748.727272727,1218.90909090909,103.727272727273
"9444","29244","2019",12,12,0,89199.25,944.833333333333,96.6666666666667
"9445","29245","2019",16,16,0,158434.375,1560.75,103.0625
"9446","29246","2019",5,5,0,112200,1080.2,107.6
"9447","29247","2019",38,37,1,199877.210526316,1851,108.894736842105
"9448","29248","2019",10,10,0,130265,1214.1,109.8
"9449","29249","2019",17,17,0,83302.9411764706,799.470588235294,105.058823529412
"9450","29250","2019",12,12,0,86830.9166666667,998.916666666667,87.5
"9451","29251","2019",13,13,0,138398.153846154,1711.15384615385,90
"9452","29252","2019",12,12,0,201591.666666667,1938.83333333333,109.25
"9453","29254","2019",87,73,14,116587.862068966,1242.95402298851,92.6091954022989
"9454","29255","2019",9,9,0,151179.222222222,1396.22222222222,112.555555555556
"9455","29256","2019",34,15,19,107837.852941176,2003.58823529412,64.2352941176471
"9456","29257","2019",46,45,1,178852.043478261,1723.5652173913,101
"9457","29259","2019",132,111,21,135664.128787879,1376.70454545455,98.9318181818182
"9458","29260","2019",101,77,24,162380.059405941,1803,93.7821782178218
"9459","29261","2019",4,4,0,92030,1002,91.75
"9460","29262","2019",6,6,0,91697.3333333333,1099.83333333333,95.3333333333333
"9461","29263","2019",13,13,0,125947.461538462,1262.84615384615,96.9230769230769
"9462","29264","2019",8,8,0,102186.25,988.625,99.875
"9463","29265","2019",9,8,1,125833.333333333,1152.33333333333,111.888888888889
"9464","29266","2019",32,32,0,108414.0625,1018.8125,106.9375
"9465","29267","2019",11,11,0,118169.090909091,1362,96.0909090909091
"9466","29268","2019",12,12,0,172445.083333333,1620.33333333333,105.5
"9467","29269","2019",14,14,0,107321.428571429,1153.21428571429,92.7857142857143
"9468","29270","2019",22,22,0,164384.954545455,1511.5,109.409090909091
"9469","29271","2019",17,17,0,111332.352941176,1017.29411764706,113.588235294118
"9470","29272","2019",31,31,0,148451.35483871,1404.90322580645,108.064516129032
"9471","29273","2019",27,27,0,196120.925925926,1594.48148148148,120.518518518519
"9472","29274","2019",84,84,0,99939.6785714286,1127.2619047619,94.4761904761905
"9473","29275","2019",23,23,0,78728.9130434783,955.478260869565,92.304347826087
"9474","29276","2019",21,21,0,173215.714285714,1576.61904761905,106.238095238095
"9475","29277","2019",29,29,0,97849.6551724138,958.172413793103,99.6896551724138
"9476","29278","2019",36,36,0,76812.6388888889,887.027777777778,85.75
"9477","29279","2019",28,28,0,94070.6071428571,985.821428571429,95.3214285714286
"9478","29280","2019",40,40,0,184454.825,1786.05,104.725
"9479","29281","2019",19,19,0,128894.736842105,1241.63157894737,109.157894736842
"9480","29282","2019",4,4,0,145500,1462.25,98.5
"9481","29284","2019",40,40,0,187780.625,1789.525,107
"9482","29285","2019",5,5,0,144900,1415.8,106.6
"9483","29286","2019",3,3,0,89333.3333333333,847,107.333333333333
"9484","29287","2019",14,14,0,137103.571428571,1374.64285714286,101.071428571429
"9485","29288","2019",8,8,0,150099.375,1369.25,111.625
"9486","29289","2019",6,6,0,90960,1013.83333333333,96.8333333333333
"9487","29290","2019",15,15,0,142354.4,1466.53333333333,97.6666666666667
"9488","29291","2019",20,20,0,107217.9,1087.8,105.15
"9489","29292","2019",7,7,0,196314.285714286,2433,86.2857142857143
"9490","29293","2019",132,118,14,197320.613636364,2145.49242424242,95.8863636363636
"9491","29294","2019",14,14,0,126696.428571429,1155.28571428571,111.857142857143
"9492","29295","2019",9,9,0,140198.888888889,1390,108.444444444444
"9493","29296","2019",10,10,0,228090,2053.6,112.8
"9494","29297","2019",21,20,1,122397.619047619,1382.71428571429,88.1904761904762
"9495","29298","2019",8,8,0,110366.375,1016.875,108.375
"9496","29299","2019",4,4,0,132689,1268,109
"9497","29300","2019",15,15,0,118038.666666667,1232.73333333333,93.6
"9498","29301","2019",5,5,0,110690,846.8,123.2
"9499","29302","2019",64,63,1,103070.015625,1138.375,89.96875
"9500","2A001","2019",20,18,2,385139.75,3633.75,109.1
"9501","2A004","2019",910,35,875,233443.116483516,3295.97362637363,71.7703296703297
"9502","2A006","2019",22,20,2,395643.772727273,3660.09090909091,108.454545454545
"9503","2A008","2019",45,24,21,484572.311111111,5281.44444444444,94.2444444444444
"9504","2A017","2019",12,11,1,318019.166666667,3893.58333333333,93.3333333333333
"9505","2A018","2019",2,1,1,124252,1403,95
"9506","2A019","2019",2,1,1,53800,576,98.5
"9507","2A024","2019",4,3,1,54500,1039.25,54.5
"9508","2A026","2019",3,3,0,135666.666666667,1436,96.3333333333333
"9509","2A027","2019",1,1,0,33000,688,48
"9510","2A028","2019",1,1,0,110000,1294,85
"9511","2A031","2019",8,7,1,91343.75,1232.375,75
"9512","2A032","2019",23,15,8,344523.52173913,3855.47826086957,90.695652173913
"9513","2A035","2019",3,3,0,676666.666666667,6492.66666666667,103.333333333333
"9514","2A038","2019",1,0,1,253570,3962,64
"9515","2A040","2019",6,5,1,236416.666666667,1988.66666666667,130.333333333333
"9516","2A041","2019",31,18,13,543864.709677419,5308.12903225806,97.0967741935484
"9517","2A048","2019",14,4,10,232797.142857143,4535.07142857143,56.0714285714286
"9518","2A056","2019",1,1,0,160000,2388,67
"9519","2A060","2019",1,1,0,30000,750,40
"9520","2A061","2019",1,1,0,190000,2568,74
"9521","2A062","2019",8,8,0,171561.875,1719,109.875
"9522","2A064","2019",2,2,0,376250,2320,161.5
"9523","2A065","2019",11,8,3,459046.545454545,4852.54545454545,99.6363636363636
"9524","2A066","2019",2,0,2,34875,634,55
"9525","2A070","2019",11,0,11,169458.181818182,4396.81818181818,40.2727272727273
"9526","2A071","2019",3,3,0,301333.333333333,2736.66666666667,107.666666666667
"9527","2A085","2019",14,10,4,300130,3188.78571428571,105.214285714286
"9528","2A090","2019",13,5,8,241533.076923077,3752.15384615385,66.9230769230769
"9529","2A092","2019",18,11,7,355050.277777778,3556.11111111111,98.5
"9530","2A094","2019",1,1,0,120000,714,168
"9531","2A098","2019",19,18,1,707279.473684211,4725.68421052632,129.052631578947
"9532","2A099","2019",2,1,1,93000,1535,84
"9533","2A103","2019",6,4,2,191137.333333333,2032.83333333333,100
"9534","2A104","2019",4,3,1,311360,3615.75,87.5
"9535","2A108","2019",4,1,3,73500,1066.75,68.75
"9536","2A114","2019",6,4,2,191416.666666667,2403.33333333333,83.6666666666667
"9537","2A115","2019",2,2,0,230000,3180.5,75
"9538","2A118","2019",1,1,0,80000,1905,42
"9539","2A119","2019",1,0,1,150000,2500,60
"9540","2A127","2019",1,1,0,2e+05,2500,80
"9541","2A128","2019",1,1,0,121600,2533,48
"9542","2A130","2019",67,28,39,264344.537313433,4631.34328358209,57.2985074626866
"9543","2A132","2019",1,0,1,15000,500,30
"9544","2A139","2019",38,30,8,648741.684210526,5455.05263157895,111.736842105263
"9545","2A141","2019",3,1,2,93333.3333333333,1511.33333333333,46.6666666666667
"9546","2A142","2019",5,2,3,112528,1957,68.8
"9547","2A144","2019",1,1,0,92000,968,95
"9548","2A154","2019",2,1,1,73315,1529.5,47
"9549","2A160","2019",2,1,1,75500,1155,59.5
"9550","2A163","2019",4,3,1,350405,3780.75,80.25
"9551","2A174","2019",2,1,1,85000,1576,45.5
"9552","2A181","2019",3,3,0,217993.333333333,2805.33333333333,76.3333333333333
"9553","2A186","2019",3,3,0,123333.333333333,1769.66666666667,75
"9554","2A189","2019",11,9,2,387576.545454545,4626.09090909091,74.8181818181818
"9555","2A196","2019",1,1,0,60000,1034,58
"9556","2A198","2019",3,0,3,100150,2385.33333333333,39
"9557","2A203","2019",1,1,0,70000,3500,20
"9558","2A209","2019",10,9,1,303829,2942,114.8
"9559","2A211","2019",2,1,1,198770,2309.5,76.5
"9560","2A212","2019",1,1,0,245000,4900,50
"9561","2A215","2019",6,5,1,688000,5112.5,108.166666666667
"9562","2A228","2019",27,12,15,443327.851851852,5390.33333333333,76.7037037037037
"9563","2A232","2019",2,0,2,36000,1012,35.5
"9564","2A247","2019",172,88,84,409992.488372093,4628.07558139535,85.8488372093023
"9565","2A249","2019",64,11,53,197504.375,3394.65625,60.625
"9566","2A254","2019",5,5,0,167330.8,2012.6,74.2
"9567","2A258","2019",2,1,1,48100,1127,43
"9568","2A259","2019",1,1,0,40000,800,50
"9569","2A262","2019",1,0,1,31000,861,36
"9570","2A266","2019",2,2,0,50750,890.5,54
"9571","2A269","2019",32,8,24,336834.125,4109.3125,86.03125
"9572","2A270","2019",5,5,0,229683.6,2545.2,89.2
"9573","2A271","2019",35,12,23,241440.857142857,3258.65714285714,76.8285714285714
"9574","2A272","2019",35,14,21,232569.142857143,2824.08571428571,85.4857142857143
"9575","2A276","2019",11,5,6,338124.636363636,3995.72727272727,79.8181818181818
"9576","2A278","2019",2,2,0,151000,1166.5,132
"9577","2A284","2019",6,3,3,183433.333333333,2321.83333333333,65.3333333333333
"9578","2A285","2019",1,1,0,21000,350,60
"9579","2A288","2019",15,7,8,200261.4,2403.33333333333,79.5333333333333
"9580","2A295","2019",1,1,0,290000,3053,95
"9581","2A300","2019",6,6,0,337833.333333333,3165.83333333333,108.5
"9582","2A308","2019",3,3,0,125000,2048.33333333333,62.6666666666667
"9583","2A310","2019",1,1,0,115000,1438,80
"9584","2A312","2019",6,5,1,227416.666666667,2116,101
"9585","2A322","2019",1,1,0,20000,2000,10
"9586","2A323","2019",5,5,0,337863.2,2915.6,121.2
"9587","2A324","2019",6,3,3,125726.333333333,2069.16666666667,62.1666666666667
"9588","2A326","2019",2,0,2,50000,1219.5,41
"9589","2A330","2019",3,3,0,176666.666666667,2308,74.6666666666667
"9590","2A331","2019",1,1,0,183000,1830,100
"9591","2A336","2019",3,3,0,349656.666666667,3278.33333333333,109
"9592","2A345","2019",8,6,2,271191,2919.875,81.5
"9593","2A348","2019",13,2,11,220537,3627.15384615385,57.3846153846154
"9594","2A349","2019",10,9,1,385390,4362.2,91.4
"9595","2A351","2019",2,2,0,362500,3625,100
"9596","2A359","2019",1,1,0,112000,3111,36
"9597","2A360","2019",2,2,0,130000,1793.5,74.5
"9598","2A362","2019",67,51,16,593987.791044776,4854,112.417910447761
"9599","2A363","2019",1,0,1,70000,1273,55
"9600","2B002","2019",2,1,1,80000,966.5,87.5
"9601","2B005","2019",1,0,1,41600,520,80
"9602","2B007","2019",2,1,1,37000,730.5,49.5
"9603","2B009","2019",18,8,10,186465.833333333,2392.61111111111,82.9444444444444
"9604","2B010","2019",15,1,14,261418.2,4694.8,55.6666666666667
"9605","2B012","2019",3,3,0,50433.3333333333,823.666666666667,60
"9606","2B016","2019",5,3,2,160880,1679.2,85.6
"9607","2B020","2019",7,4,3,385520,3478,106.285714285714
"9608","2B023","2019",2,2,0,127500,2693,52
"9609","2B025","2019",2,1,1,186500,1889.5,74.5
"9610","2B029","2019",5,4,1,294160,3789,83.6
"9611","2B030","2019",4,4,0,224500,2172.75,117
"9612","2B033","2019",369,24,345,178590.430894309,2597.43631436314,68.940379403794
"9613","2B034","2019",15,5,10,149388.8,3255,45.2666666666667
"9614","2B037","2019",78,41,37,257380.820512821,2765.62820512821,94.1410256410256
"9615","2B042","2019",125,69,56,198187.216,2700.296,74.136
"9616","2B043","2019",21,12,9,329346.619047619,3643.14285714286,95.4761904761905
"9617","2B045","2019",2,2,0,35000,717.5,49
"9618","2B046","2019",2,1,1,20000,520.5,38.5
"9619","2B047","2019",3,2,1,95333.3333333333,1226,66.3333333333333
"9620","2B049","2019",24,13,11,247048.083333333,2762.58333333333,93.6666666666667
"9621","2B050","2019",123,11,112,204058.756097561,3760.06504065041,53.8617886178862
"9622","2B054","2019",1,1,0,120000,938,128
"9623","2B057","2019",1,1,0,205005,1767,116
"9624","2B058","2019",6,3,3,131875,2253.66666666667,73
"9625","2B059","2019",1,1,0,104500,1432,73
"9626","2B072","2019",1,1,0,55000,688,80
"9627","2B073","2019",2,1,1,66000,1253.5,46
"9628","2B074","2019",1,1,0,1e+05,935,107
"9629","2B077","2019",7,5,2,335408.142857143,3214.42857142857,102.428571428571
"9630","2B080","2019",2,2,0,129500,3151,53.5
"9631","2B083","2019",1,1,0,136637,3036,45
"9632","2B084","2019",1,1,0,145000,2589,56
"9633","2B086","2019",2,2,0,250000,4206.5,59.5
"9634","2B087","2019",14,5,9,146821.428571429,2127.42857142857,66.9285714285714
"9635","2B088","2019",3,3,0,186000,2550.33333333333,73
"9636","2B093","2019",10,8,2,759550.5,6489.8,109.3
"9637","2B095","2019",3,3,0,45333.3333333333,837,57.6666666666667
"9638","2B096","2019",49,4,45,129163.551020408,2258.67346938776,64.3673469387755
"9639","2B097","2019",1,1,0,60000,1200,50
"9640","2B105","2019",1,1,0,250000,2273,110
"9641","2B107","2019",4,3,1,243832.75,1732,117.5
"9642","2B109","2019",4,4,0,108875,2023.5,58.75
"9643","2B110","2019",1,1,0,50000,455,110
"9644","2B111","2019",1,1,0,132980,1750,76
"9645","2B116","2019",1,1,0,45000,750,60
"9646","2B120","2019",34,18,16,215104.441176471,2527.94117647059,85.4411764705882
"9647","2B121","2019",3,1,2,115666.666666667,1840.33333333333,58.3333333333333
"9648","2B122","2019",3,3,0,73333.3333333333,766,100.666666666667
"9649","2B123","2019",29,14,15,158330.517241379,2184.37931034483,80
"9650","2B124","2019",2,0,2,25250,1251.5,20
"9651","2B134","2019",66,1,65,224101.272727273,3872.69696969697,59.6666666666667
"9652","2B135","2019",2,0,2,64000,1766.5,52.5
"9653","2B136","2019",2,1,1,132500,1883.5,100
"9654","2B138","2019",1,1,0,660000,5366,123
"9655","2B140","2019",1,0,1,40000,400,100
"9656","2B143","2019",28,8,20,93753.9285714286,2054.14285714286,49.25
"9657","2B145","2019",1,1,0,120000,1846,65
"9658","2B147","2019",1,0,1,35000,1000,35
"9659","2B148","2019",62,34,28,174085.629032258,2421.83870967742,74.741935483871
"9660","2B150","2019",61,10,51,269116.31147541,4650.91803278689,55.2786885245902
"9661","2B152","2019",13,5,8,128888.461538462,2375.07692307692,64.5384615384615
"9662","2B153","2019",1,1,0,16000,533,30
"9663","2B159","2019",3,1,2,172666.666666667,2084.33333333333,90.6666666666667
"9664","2B162","2019",2,1,1,48150,745.5,64
"9665","2B165","2019",4,3,1,309340.25,4400.25,82
"9666","2B166","2019",2,2,0,138000,1881,55.5
"9667","2B167","2019",1,1,0,215000,3981,54
"9668","2B168","2019",24,15,9,399937.5,4370.25,94.875
"9669","2B169","2019",1,1,0,120000,1200,100
"9670","2B170","2019",2,0,2,57500,989.5,50
"9671","2B172","2019",3,2,1,155666.666666667,1557.66666666667,90.6666666666667
"9672","2B173","2019",4,2,2,162250,2417.25,72
"9673","2B175","2019",1,1,0,220000,3438,64
"9674","2B178","2019",1,1,0,350000,4667,75
"9675","2B182","2019",3,3,0,207666.666666667,2718.33333333333,73
"9676","2B183","2019",1,0,1,330000,1833,180
"9677","2B185","2019",31,15,16,226963.032258065,2924.51612903226,82.1290322580645
"9678","2B188","2019",6,6,0,310950,2886.33333333333,107
"9679","2B190","2019",1,0,1,1e+05,2000,50
"9680","2B192","2019",1,1,0,225000,2344,96
"9681","2B193","2019",6,5,1,92166.6666666667,941.833333333333,101.666666666667
"9682","2B195","2019",1,1,0,75000,1250,60
"9683","2B199","2019",4,4,0,163287.5,1941.5,88.25
"9684","2B201","2019",1,1,0,225000,3516,64
"9685","2B205","2019",13,7,6,203661.538461538,4084.92307692308,55.0769230769231
"9686","2B207","2019",48,38,10,211935.583333333,2455.66666666667,89.3958333333333
"9687","2B213","2019",1,1,0,120000,857,140
"9688","2B217","2019",1,1,0,160000,1067,150
"9689","2B218","2019",2,1,1,75000,1042.5,70
"9690","2B220","2019",1,1,0,225000,1264,178
"9691","2B222","2019",1,1,0,60000,1200,50
"9692","2B223","2019",2,0,2,31500,630,50
"9693","2B224","2019",11,7,4,176068.181818182,2726.81818181818,68.0909090909091
"9694","2B225","2019",3,2,1,132663.333333333,1641.33333333333,79.3333333333333
"9695","2B226","2019",4,2,2,92500,1064,81.75
"9696","2B229","2019",3,3,0,2e+05,2468.33333333333,81.6666666666667
"9697","2B231","2019",1,1,0,350000,2500,140
"9698","2B233","2019",2,0,2,373901.5,4588,59.5
"9699","2B236","2019",2,1,1,47000,660.5,71
"9700","2B238","2019",1,0,1,15000,833,18
"9701","2B239","2019",1,1,0,251000,8367,30
"9702","2B242","2019",16,13,3,151035.625,2678.1875,58.3125
"9703","2B243","2019",1,1,0,32900,1219,27
"9704","2B246","2019",5,4,1,106800,1315.6,80
"9705","2B250","2019",1,1,0,91000,1400,65
"9706","2B251","2019",31,25,6,197658.322580645,2140.16129032258,92.3225806451613
"9707","2B252","2019",1,0,1,65000,2167,30
"9708","2B255","2019",1,1,0,60000,706,85
"9709","2B257","2019",4,3,1,117743.5,1194.5,95.5
"9710","2B260","2019",1,1,0,60000,682,88
"9711","2B261","2019",6,4,2,186541.666666667,3056.33333333333,60.6666666666667
"9712","2B265","2019",5,3,2,199320,1779.4,122.4
"9713","2B277","2019",4,3,1,83125,1220.5,64.5
"9714","2B280","2019",3,3,0,106666.666666667,1892.66666666667,60.6666666666667
"9715","2B281","2019",8,5,3,121106.375,2101.375,57.625
"9716","2B283","2019",9,9,0,253900,2455.33333333333,97.2222222222222
"9717","2B286","2019",6,4,2,191193.333333333,2193.5,77.6666666666667
"9718","2B287","2019",1,1,0,115000,4423,26
"9719","2B289","2019",1,1,0,53000,1893,28
"9720","2B290","2019",2,1,1,266000,4631.5,69.5
"9721","2B291","2019",1,1,0,35394,708,50
"9722","2B292","2019",1,1,0,45500,812,56
"9723","2B293","2019",5,4,1,163550,2319.2,79.6
"9724","2B296","2019",1,1,0,65000,1757,37
"9725","2B298","2019",27,7,20,366884.592592593,4294.07407407407,80.2222222222222
"9726","2B302","2019",4,2,2,111750,939.25,100.75
"9727","2B303","2019",3,2,1,221666.666666667,3112.33333333333,69.3333333333333
"9728","2B305","2019",42,13,29,250581.19047619,3107.19047619048,81.3333333333333
"9729","2B307","2019",22,12,10,160770.590909091,2490.68181818182,64.7272727272727
"9730","2B309","2019",19,10,9,346564.210526316,2946.42105263158,114.842105263158
"9731","2B311","2019",13,12,1,231970,3002.61538461538,78.1538461538462
"9732","2B313","2019",62,6,56,109975.387096774,2511.53225806452,44.3225806451613
"9733","2B314","2019",3,3,0,99666.6666666667,2354.33333333333,33
"9734","2B316","2019",9,6,3,383537.666666667,3953.33333333333,89.4444444444444
"9735","2B318","2019",5,4,1,173600,1838.4,105.4
"9736","2B319","2019",1,1,0,390000,3223,121
"9737","2B320","2019",1,1,0,209800,3497,60
"9738","2B327","2019",1,0,1,237000,2788,85
"9739","2B328","2019",2,1,1,47500,770,53.5
"9740","2B332","2019",5,2,3,125800,2418.4,52.6
"9741","2B333","2019",1,1,0,7e+05,4375,160
"9742","2B340","2019",1,0,1,35000,921,38
"9743","2B341","2019",10,5,5,114420,1516.4,84
"9744","2B342","2019",11,10,1,244739.090909091,2252.18181818182,105.636363636364
"9745","2B343","2019",13,11,2,205570.384615385,2187.15384615385,92.6153846153846
"9746","2B344","2019",1,1,0,146000,6083,24
"9747","2B346","2019",21,14,7,214202.857142857,2367.7619047619,95.9523809523809
"9748","2B347","2019",1,0,1,105000,3500,30
"9749","2B352","2019",4,1,3,126500,1784.75,70.75
"9750","2B353","2019",41,8,33,260588.292682927,2899.68292682927,87.0975609756098
"9751","2B354","2019",3,2,1,82666.6666666667,1522.33333333333,52.3333333333333
"9752","2B355","2019",6,5,1,215911.666666667,2622.66666666667,94.6666666666667
"9753","2B356","2019",3,2,1,86333.3333333333,1026.33333333333,84
"9754","2B361","2019",2,0,2,128500,3575,45
"9755","30001","2019",6,6,0,236016.666666667,2240,106
"9756","30002","2019",9,9,0,212907.777777778,1832.44444444444,116.222222222222
"9757","30003","2019",176,133,43,252551.375,3220.84659090909,80.5909090909091
"9758","30004","2019",21,21,0,225634.714285714,2252.33333333333,103.52380952381
"9759","30005","2019",4,4,0,129850,2075.25,64
"9760","30006","2019",94,81,13,211932.712765957,2299.75531914894,93.2553191489362
"9761","30007","2019",516,221,295,124901.901162791,1600.40891472868,75.2364341085271
"9762","30008","2019",10,10,0,155200,1863.8,83.8
"9763","30009","2019",4,4,0,127525,1151.25,107.5
"9764","30010","2019",40,33,7,167974.2,1875.275,93.05
"9765","30011","2019",154,75,79,204215.584415584,2729.95454545455,75.6558441558442
"9766","30012","2019",41,35,6,225879.024390244,2244.26829268293,95.0731707317073
"9767","30013","2019",3,3,0,258500,2439.66666666667,112
"9768","30014","2019",16,13,3,292894.375,3277.125,97.1875
"9769","30015","2019",3,2,1,140763.333333333,2530.66666666667,70.6666666666667
"9770","30016","2019",5,4,1,180400,1098.4,130.4
"9771","30017","2019",9,9,0,113941.111111111,1506,75.3333333333333
"9772","30018","2019",10,10,0,266280,2328.1,123.2
"9773","30019","2019",36,36,0,281301.305555556,2413.66666666667,112.222222222222
"9774","30020","2019",28,27,1,240462.714285714,2194.60714285714,114.785714285714
"9775","30021","2019",1,1,0,615000,2050,300
"9776","30022","2019",3,3,0,93500,1889.33333333333,55.3333333333333
"9777","30023","2019",7,7,0,234692.857142857,2121.28571428571,110.285714285714
"9778","30024","2019",9,8,1,161311.111111111,1481.77777777778,102.444444444444
"9779","30025","2019",3,3,0,66466.6666666667,1063.33333333333,58.3333333333333
"9780","30026","2019",24,23,1,143670.583333333,1575.79166666667,91.7916666666667
"9781","30027","2019",24,24,0,211295.416666667,2027.20833333333,106.708333333333
"9782","30028","2019",246,126,120,130330.231707317,1631.25609756098,77.7479674796748
"9783","30029","2019",21,17,4,202444.285714286,2232.2380952381,93.5714285714286
"9784","30030","2019",2,2,0,220700,3420,82.5
"9785","30031","2019",1,1,0,630000,2739,230
"9786","30032","2019",176,119,57,131041.232954545,1515.27272727273,84.5511363636364
"9787","30033","2019",76,71,5,209224.263157895,2265.65789473684,91.9473684210526
"9788","30034","2019",78,69,9,207647.192307692,2268.79487179487,90.6538461538462
"9789","30035","2019",4,4,0,276250,3685.5,115.5
"9790","30036","2019",35,31,4,198731.971428571,2346.8,89.5714285714286
"9791","30037","2019",28,16,12,89767.8571428571,1147,80.4285714285714
"9792","30038","2019",5,5,0,120740,1492,82.6
"9793","30039","2019",34,28,6,213853.647058824,2119.26470588235,101.058823529412
"9794","30040","2019",2,2,0,120700,1764.5,66
"9795","30041","2019",18,18,0,300991.166666667,2539.88888888889,121.555555555556
"9796","30042","2019",24,22,2,259987.291666667,2491.04166666667,103.25
"9797","30043","2019",14,14,0,251361.857142857,2175.85714285714,113.5
"9798","30044","2019",1,1,0,6e+05,2564,234
"9799","30045","2019",5,3,2,86900,1520.8,56.4
"9800","30046","2019",10,10,0,137740,1646.8,81.9
"9801","30047","2019",57,52,5,218565.228070175,2296.21052631579,98.5438596491228
"9802","30048","2019",2,2,0,185250,1953.5,98.5
"9803","30049","2019",4,4,0,406087.5,2433.25,183.75
"9804","30050","2019",2,2,0,158360,2264,82.5
"9805","30051","2019",13,11,2,149610.461538462,1854.38461538462,82.5384615384615
"9806","30052","2019",11,10,1,122933.636363636,1465.90909090909,85.2727272727273
"9807","30053","2019",9,9,0,181246.666666667,1640.22222222222,108.333333333333
"9808","30054","2019",4,4,0,121523.75,1520.25,76.25
"9809","30055","2019",5,4,1,123520,1603.6,78.6
"9810","30056","2019",4,4,0,656111.5,2995.25,193
"9811","30057","2019",17,17,0,214160.176470588,2201.58823529412,94.9411764705882
"9812","30058","2019",3,3,0,121666.666666667,1877,94
"9813","30059","2019",38,32,6,217085.789473684,2290.15789473684,94.4473684210526
"9814","30060","2019",51,47,4,228658.431372549,2274.90196078431,102.313725490196
"9815","30061","2019",23,17,6,173552.173913043,1937.52173913043,89.9565217391304
"9816","30062","2019",103,67,36,207777.40776699,2457.09708737864,85.2135922330097
"9817","30064","2019",1,1,0,135350,1381,98
"9818","30065","2019",12,12,0,225106.25,1606.41666666667,139.833333333333
"9819","30066","2019",15,15,0,237412,1854.13333333333,134.266666666667
"9820","30067","2019",10,10,0,291055,2313.3,128.4
"9821","30068","2019",11,11,0,207120,2117.72727272727,93.4545454545455
"9822","30069","2019",8,8,0,227572.5,2450.25,98.5
"9823","30070","2019",8,8,0,249358.125,2524.625,107.625
"9824","30071","2019",1,1,0,190000,1863,102
"9825","30072","2019",5,5,0,167184,2052,79.8
"9826","30073","2019",23,22,1,315231.739130435,2596.47826086957,120.217391304348
"9827","30075","2019",58,56,2,279035.172413793,2576.20689655172,111.362068965517
"9828","30076","2019",19,19,0,296424.789473684,2370.84210526316,117.263157894737
"9829","30077","2019",12,10,2,155192.583333333,1602.33333333333,96.9166666666667
"9830","30079","2019",4,4,0,139125,1710.25,84.25
"9831","30080","2019",12,11,1,96377,1520.66666666667,72.3333333333333
"9832","30081","2019",11,10,1,196821.818181818,1923.81818181818,108.545454545455
"9833","30082","2019",50,44,6,222317.5,2387.02,93.44
"9834","30083","2019",53,47,6,227711.471698113,2379.16981132075,98.6981132075472
"9835","30084","2019",6,6,0,163833.333333333,1769.5,91.3333333333333
"9836","30085","2019",15,15,0,275436,2419.8,116.133333333333
"9837","30086","2019",6,5,1,178091.666666667,2189.83333333333,80.8333333333333
"9838","30087","2019",3,3,0,123500,1887.66666666667,64
"9839","30088","2019",5,5,0,203506,2054.8,99.6
"9840","30089","2019",30,30,0,205388.633333333,2129.86666666667,95.3333333333333
"9841","30090","2019",6,6,0,122491.666666667,1738,83.8333333333333
"9842","30091","2019",27,26,1,282037.222222222,2559.88888888889,113.777777777778
"9843","30092","2019",27,26,1,181673.851851852,1863.48148148148,101.148148148148
"9844","30093","2019",1,1,0,245000,2076,118
"9845","30094","2019",5,3,2,152200,2285,66.8
"9846","30095","2019",15,15,0,212199,2138.73333333333,107.533333333333
"9847","30096","2019",8,8,0,187991.25,2944,78.875
"9848","30097","2019",9,9,0,146944.444444444,1551.11111111111,91.1111111111111
"9849","30098","2019",6,6,0,207220.833333333,2099.66666666667,98.3333333333333
"9850","30099","2019",2,2,0,297500,1782,117.5
"9851","30100","2019",7,7,0,232350,2032.57142857143,114.571428571429
"9852","30101","2019",5,4,1,252900,2195.6,114.6
"9853","30102","2019",9,9,0,139495.555555556,1439.66666666667,100.555555555556
"9854","30103","2019",11,11,0,301541.272727273,2626.54545454545,117.272727272727
"9855","30104","2019",10,10,0,213335,1987.4,108.4
"9856","30105","2019",6,6,0,105211.666666667,1265.5,93.3333333333333
"9857","30106","2019",15,15,0,171576.666666667,1831.26666666667,100.333333333333
"9858","30107","2019",6,6,0,327762.5,2701.83333333333,120.166666666667
"9859","30108","2019",5,5,0,130620,1477,102.8
"9860","30109","2019",1,1,0,145000,2071,70
"9861","30110","2019",11,10,1,310990.818181818,2237.18181818182,135.727272727273
"9862","30111","2019",7,7,0,242867.428571429,2507.71428571429,99.4285714285714
"9863","30112","2019",20,20,0,185548.25,1892.8,97.65
"9864","30113","2019",6,6,0,235750,2181.66666666667,102.166666666667
"9865","30114","2019",7,7,0,258580.857142857,2365.28571428571,108.857142857143
"9866","30115","2019",5,5,0,282510,2305.6,119
"9867","30116","2019",14,13,1,196514.285714286,2309.14285714286,91.8571428571429
"9868","30117","2019",35,25,10,218378.4,2268,90.2571428571429
"9869","30119","2019",2,2,0,254125,2195.5,116.5
"9870","30120","2019",18,16,2,150018.611111111,1867.11111111111,84.2777777777778
"9871","30121","2019",4,4,0,224237.5,2583.25,92.5
"9872","30122","2019",9,9,0,175936.666666667,1745.88888888889,102.444444444444
"9873","30123","2019",47,42,5,257053.29787234,2408.34042553192,109.276595744681
"9874","30124","2019",2,2,0,155000,1610,96.5
"9875","30125","2019",46,37,9,206231.02173913,2108.58695652174,98.5217391304348
"9876","30126","2019",12,12,0,293385,2340.58333333333,126.5
"9877","30127","2019",14,14,0,229750.714285714,2285.78571428571,96.0714285714286
"9878","30128","2019",60,48,12,182562.816666667,2041.58333333333,89.1333333333333
"9879","30129","2019",3,2,1,103066.666666667,2650.33333333333,42
"9880","30130","2019",14,13,1,117106.428571429,1445.78571428571,77.1428571428571
"9881","30131","2019",17,14,3,195479,2231.17647058824,86.8235294117647
"9882","30132","2019",22,15,7,99601.1363636364,1199.31818181818,84.4090909090909
"9883","30133","2019",892,65,827,164204.489910314,4126.4932735426,39.5784753363229
"9884","30134","2019",4,4,0,319912.5,4722.25,78
"9885","30135","2019",44,39,5,193083.295454545,2131.61363636364,95.0454545454545
"9886","30136","2019",17,16,1,236726.470588235,2625.35294117647,94.1176470588235
"9887","30137","2019",3,3,0,115000,1231.66666666667,91.3333333333333
"9888","30138","2019",21,19,2,302286.666666667,2410.61904761905,127.095238095238
"9889","30139","2019",3,3,0,50543.3333333333,1119.66666666667,54.6666666666667
"9890","30140","2019",16,12,4,141866.5,1634.8125,88.5
"9891","30141","2019",51,49,2,217312.745098039,2114.43137254902,105.627450980392
"9892","30142","2019",13,13,0,142981.461538462,1506.84615384615,95.3076923076923
"9893","30143","2019",2,2,0,237010,1788,134.5
"9894","30144","2019",4,4,0,302190,2438.25,129.5
"9895","30145","2019",21,21,0,205681.952380952,2161.80952380952,98
"9896","30146","2019",19,16,3,173022.105263158,1756.26315789474,99.3157894736842
"9897","30147","2019",18,17,1,180641.666666667,1855,92.4444444444444
"9898","30148","2019",4,4,0,269953.75,2131.25,136.75
"9899","30149","2019",15,15,0,222723.6,2176,101.133333333333
"9900","30150","2019",8,7,1,187701.375,1791.375,110.625
"9901","30151","2019",18,18,0,240116.666666667,2188.16666666667,107.055555555556
"9902","30152","2019",22,21,1,153416.818181818,1645.45454545455,94.1818181818182
"9903","30153","2019",2,2,0,93000,773,120
"9904","30154","2019",2,2,0,166060,1353.5,122
"9905","30155","2019",74,73,1,219843.081081081,2170.87837837838,105.135135135135
"9906","30156","2019",103,79,24,204505.194174757,2353.74757281553,88.6019417475728
"9907","30158","2019",3,3,0,283676.666666667,2143.33333333333,132
"9908","30159","2019",11,8,3,138818.181818182,1456.09090909091,101.727272727273
"9909","30160","2019",2,2,0,87500,771,114
"9910","30161","2019",2,1,1,73410,1165,60.5
"9911","30162","2019",8,7,1,231235,2022.75,114.125
"9912","30163","2019",1,1,0,195000,1413,138
"9913","30164","2019",15,15,0,135794.666666667,1879.93333333333,73.2
"9914","30165","2019",9,6,3,194438.888888889,1753.11111111111,103.444444444444
"9915","30166","2019",24,24,0,196673.333333333,2024.79166666667,92.75
"9916","30167","2019",9,9,0,163038.888888889,1487.44444444444,112.777777777778
"9917","30168","2019",7,7,0,204718.571428571,2211.14285714286,88.5714285714286
"9918","30169","2019",71,57,14,175799.802816901,2073.57746478873,85
"9919","30170","2019",10,10,0,142450,1308,107.2
"9920","30171","2019",12,9,3,121473.416666667,1610.16666666667,75.9166666666667
"9921","30172","2019",6,6,0,221111,1534,142
"9922","30173","2019",20,20,0,221003.3,1918.9,117.3
"9923","30174","2019",30,29,1,243271.833333333,2364.06666666667,106.433333333333
"9924","30175","2019",3,3,0,253833.333333333,2256.33333333333,111.666666666667
"9925","30176","2019",3,3,0,124000,1211,95.3333333333333
"9926","30177","2019",13,13,0,223354.615384615,2229.84615384615,101
"9927","30178","2019",15,14,1,220384,2191.86666666667,98
"9928","30179","2019",51,49,2,169732.921568627,1879.05882352941,93.078431372549
"9929","30180","2019",5,5,0,213600,2288,96.6
"9930","30181","2019",10,10,0,204401,1706,130.5
"9931","30182","2019",20,19,1,189745,2123.65,90
"9932","30183","2019",12,12,0,161736.666666667,1678.41666666667,94.0833333333333
"9933","30184","2019",16,15,1,207299.375,2003.625,102.625
"9934","30185","2019",19,17,2,256683.210526316,2803,105.157894736842
"9935","30186","2019",25,24,1,273966.68,2526.04,109.32
"9936","30187","2019",2,2,0,115750,1445.5,86.5
"9937","30188","2019",12,12,0,207268.333333333,1696.91666666667,127.083333333333
"9938","30189","2019",2428,675,1753,144489.440691928,2023.99258649094,69.8492586490939
"9939","30191","2019",17,15,2,204166.823529412,1978.29411764706,101
"9940","30192","2019",8,8,0,233442.25,2196.375,109.125
"9941","30193","2019",8,8,0,170081.25,1706.375,99.75
"9942","30194","2019",7,7,0,158142.857142857,1669.71428571429,96
"9943","30195","2019",1,1,0,365000,3042,120
"9944","30196","2019",8,8,0,210000,1962.125,101.125
"9945","30197","2019",2,2,0,209750,1444.5,144.5
"9946","30198","2019",5,5,0,89904,1950.4,45.4
"9947","30199","2019",1,1,0,217000,2170,100
"9948","30200","2019",13,13,0,201442.307692308,1791.15384615385,108.538461538462
"9949","30201","2019",4,4,0,188477.5,1472.75,127.5
"9950","30202","2019",151,104,47,140087.688741722,1653.93377483444,85.3112582781457
"9951","30203","2019",6,6,0,124530,2369,69.6666666666667
"9952","30204","2019",1,1,0,125000,893,140
"9953","30205","2019",4,4,0,176150,1419,117.75
"9954","30206","2019",50,48,2,251468.22,2434.3,103.06
"9955","30207","2019",9,9,0,186130,1976.88888888889,96.4444444444444
"9956","30209","2019",41,37,4,304558.536585366,2746.34146341463,112.170731707317
"9957","30210","2019",33,28,5,202473.878787879,2015.75757575758,103.121212121212
"9958","30211","2019",32,31,1,267681,2763.5,98.09375
"9959","30212","2019",25,16,9,172897.6,1839.36,98.44
"9960","30213","2019",1,1,0,140000,3111,45
"9961","30214","2019",33,30,3,175724.090909091,1701.54545454545,103.424242424242
"9962","30215","2019",5,5,0,133600,1498.8,84
"9963","30216","2019",10,6,4,104550,1238.2,76.3
"9964","30217","2019",96,93,3,263887.104166667,2629.01041666667,100.822916666667
"9965","30218","2019",6,6,0,196486.666666667,2339.16666666667,99.8333333333333
"9966","30219","2019",3,3,0,181691.666666667,2186,93
"9967","30220","2019",2,2,0,174000,2207,82
"9968","30221","2019",71,55,16,180452.746478873,2124.07042253521,84.3661971830986
"9969","30222","2019",3,3,0,358873.333333333,3196.66666666667,119
"9970","30223","2019",51,51,0,186396.431372549,1895.27450980392,97.7843137254902
"9971","30224","2019",3,3,0,206804,1693.33333333333,115
"9972","30225","2019",22,22,0,258480.590909091,2429.09090909091,109.818181818182
"9973","30226","2019",9,9,0,226373.333333333,2067.88888888889,108.222222222222
"9974","30227","2019",24,19,5,116065.416666667,1379.5,78.3333333333333
"9975","30228","2019",20,20,0,244479.25,2566.35,105.75
"9976","30229","2019",11,10,1,115441.363636364,1458,80.4545454545455
"9977","30230","2019",4,4,0,201175,1996.75,101
"9978","30231","2019",6,6,0,133070,1226.16666666667,103
"9979","30232","2019",3,3,0,219781.666666667,2066,102
"9980","30233","2019",11,11,0,178528.545454545,1770.63636363636,101.545454545455
"9981","30234","2019",5,5,0,183013,1852.8,100.2
"9982","30235","2019",14,13,1,206637.857142857,2343.42857142857,88.1428571428571
"9983","30237","2019",13,13,0,208628.230769231,1833.76923076923,108.923076923077
"9984","30239","2019",8,8,0,133659.5,1475.875,97.875
"9985","30240","2019",7,6,1,159557.142857143,2122.14285714286,74.1428571428571
"9986","30241","2019",16,16,0,218958.75,2290,97.5
"9987","30242","2019",1,1,0,149000,1674,89
"9988","30243","2019",66,57,9,189909.575757576,1972.45454545455,95.8333333333333
"9989","30244","2019",8,8,0,317235,2679.625,116.375
"9990","30245","2019",6,6,0,225467.5,2415,97.3333333333333
"9991","30247","2019",2,2,0,108425,2911.5,40.5
"9992","30248","2019",3,3,0,227533.333333333,2306.66666666667,99.3333333333333
"9993","30249","2019",10,9,1,238365,2086,117.7
"9994","30250","2019",4,4,0,185637.5,1572.75,117.5
"9995","30251","2019",10,9,1,170620,1725.1,96.3
"9996","30252","2019",2,2,0,102000,1504,111
"9997","30253","2019",14,12,2,146658.214285714,1461.07142857143,99.5714285714286
"9998","30254","2019",17,15,2,175885.294117647,1973.17647058824,91.3529411764706
"9999","30255","2019",25,21,4,145442.2,1750.96,84.32
"10000","30256","2019",4,4,0,135100,1333.25,105
"10001","30257","2019",13,11,2,187492.230769231,2356.53846153846,81.7692307692308
"10002","30258","2019",199,147,52,131492.060301508,1630.36683417085,79.1909547738694
"10003","30259","2019",48,47,1,218152.708333333,2083.4375,103.166666666667
"10004","30260","2019",16,16,0,175387.8125,2045.625,91.1875
"10005","30261","2019",5,5,0,206120,1801.4,113.8
"10006","30262","2019",9,8,1,253587,2255.55555555556,109.666666666667
"10007","30263","2019",41,40,1,161781.170731707,1577.75609756098,98.8292682926829
"10008","30264","2019",3,3,0,259600,2228.66666666667,114.666666666667
"10009","30265","2019",1,1,0,171000,1379,124
"10010","30266","2019",23,22,1,206160.086956522,2242.78260869565,93.0869565217391
"10011","30267","2019",4,4,0,130125,1408.75,82
"10012","30268","2019",7,5,2,113271.428571429,1254.85714285714,88.8571428571429
"10013","30269","2019",23,17,6,132684.782608696,1502.04347826087,83.2608695652174
"10014","30270","2019",10,10,0,218008,1920.3,123.4
"10015","30271","2019",4,4,0,227000,2438.5,91.75
"10016","30272","2019",1,1,0,40000,333,120
"10017","30273","2019",19,18,1,197045.736842105,2217,90
"10018","30274","2019",30,30,0,188910.566666667,1841.7,101.233333333333
"10019","30275","2019",2,2,0,301100,2127,141
"10020","30276","2019",53,45,8,237783.754716981,2606.33962264151,91.1320754716981
"10021","30277","2019",8,8,0,248399.375,2079.625,117.75
"10022","30278","2019",43,39,4,236096.76744186,2390.74418604651,98.5581395348837
"10023","30279","2019",19,19,0,222468.684210526,2283.94736842105,107.736842105263
"10024","30280","2019",7,7,0,120912.857142857,1301.57142857143,105.285714285714
"10025","30281","2019",14,12,2,187221.428571429,1853.14285714286,99.8571428571429
"10026","30282","2019",7,7,0,182707.142857143,2094.28571428571,78.7142857142857
"10027","30283","2019",2,2,0,105000,1416.5,80
"10028","30284","2019",36,31,5,151966.388888889,1601.5,96.1666666666667
"10029","30285","2019",10,10,0,269443,2590.9,100.3
"10030","30286","2019",14,13,1,271576.428571429,2649.64285714286,97.5
"10031","30287","2019",4,3,1,214175,2006,97.75
"10032","30288","2019",14,9,5,190825.714285714,1704.14285714286,103.857142857143
"10033","30290","2019",24,22,2,194259.291666667,2064.08333333333,94.1666666666667
"10034","30291","2019",4,4,0,111000,2185,58
"10035","30292","2019",5,5,0,138600,2018.6,66.4
"10036","30293","2019",5,5,0,242100,2342.6,97.8
"10037","30294","2019",58,44,14,174367.293103448,1901.70689655172,89.7931034482759
"10038","30295","2019",42,33,9,239835.571428571,2441.42857142857,94.5238095238095
"10039","30296","2019",2,2,0,137000,1880.5,79
"10040","30297","2019",8,8,0,151891.25,2184.875,74.75
"10041","30298","2019",6,5,1,164533.333333333,1629.5,110.166666666667
"10042","30299","2019",29,28,1,382432.068965517,2876.1724137931,126.862068965517
"10043","30300","2019",5,5,0,255988,2233.4,117.6
"10044","30301","2019",10,10,0,308202,3050.9,95.4
"10045","30302","2019",29,29,0,221826.931034483,2196.51724137931,106.275862068966
"10046","30303","2019",10,9,1,141305,1554.8,87.4
"10047","30304","2019",4,4,0,146983,1806,81.75
"10048","30305","2019",35,30,5,143951.485714286,1695.17142857143,85.2
"10049","30306","2019",5,5,0,266128,2276.6,117.2
"10050","30307","2019",20,17,3,104954.25,1252.6,82.75
"10051","30308","2019",11,11,0,320009.545454545,3012,113.363636363636
"10052","30309","2019",7,7,0,274978.571428571,2295.14285714286,122.571428571429
"10053","30310","2019",2,2,0,135000,1539,85.5
"10054","30311","2019",32,21,11,177503.5,1631.03125,102.78125
"10055","30312","2019",23,23,0,228184.217391304,2416.21739130435,95.6521739130435
"10056","30313","2019",3,3,0,189533.333333333,1936.66666666667,102
"10057","30314","2019",1,1,0,320000,1882,170
"10058","30315","2019",20,19,1,231050,2457.05,94.45
"10059","30316","2019",5,5,0,110600,1479.6,80
"10060","30317","2019",25,18,7,155940.2,1876.44,80.56
"10061","30318","2019",2,2,0,148500,1509.5,98.5
"10062","30319","2019",14,14,0,339816.428571429,2462.64285714286,128.857142857143
"10063","30320","2019",3,3,0,176216.666666667,1875,122.666666666667
"10064","30321","2019",66,44,22,211581.166666667,2689.12121212121,81.6515151515152
"10065","30322","2019",3,3,0,156000,1610,84.6666666666667
"10066","30323","2019",1,1,0,140000,1414,99
"10067","30324","2019",9,9,0,205161.555555556,2473.22222222222,86.4444444444444
"10068","30325","2019",11,8,3,132319,1595.90909090909,83.1818181818182
"10069","30326","2019",21,19,2,238579.047619048,2145.90476190476,110.666666666667
"10070","30327","2019",2,2,0,148500,4078,51.5
"10071","30328","2019",12,11,1,181813.333333333,1615.58333333333,110.166666666667
"10072","30329","2019",6,6,0,195736.666666667,1847,101
"10073","30330","2019",12,11,1,185233.333333333,1705.75,109.083333333333
"10074","30331","2019",14,14,0,201875,1928,113.785714285714
"10075","30332","2019",2,2,0,45750,908.5,50
"10076","30333","2019",53,41,12,199361.735849057,2119.8679245283,93.4339622641509
"10077","30334","2019",185,81,104,243211.794594595,2901.15675675676,81.6756756756757
"10078","30335","2019",1,1,0,235171,2556,92
"10079","30336","2019",32,30,2,161771.03125,1711.21875,95.5
"10080","30337","2019",3,3,0,330316.666666667,2610.33333333333,124.666666666667
"10081","30338","2019",1,1,0,70000,2917,24
"10082","30339","2019",34,25,9,108993.764705882,1438.97058823529,82.3529411764706
"10083","30340","2019",9,9,0,213933.333333333,2232.11111111111,95.4444444444444
"10084","30341","2019",142,115,27,185808.992957746,2021.0985915493,94.5774647887324
"10085","30342","2019",5,4,1,199076.2,2005.8,103.4
"10086","30343","2019",9,9,0,221664.111111111,2321.55555555556,95.2222222222222
"10087","30344","2019",65,50,15,210629.769230769,2233.21538461538,97.8923076923077
"10088","30345","2019",11,6,5,61654.5454545455,813.363636363636,78.2727272727273
"10089","30346","2019",30,26,4,237768.666666667,2411.33333333333,101.533333333333
"10090","30347","2019",16,15,1,213046.375,2427.9375,88.875
"10091","30348","2019",18,18,0,223773.888888889,2187.72222222222,107.944444444444
"10092","30349","2019",12,11,1,207114.916666667,2536.33333333333,88.4166666666667
"10093","30350","2019",59,31,28,110567.355932203,1268.27118644068,85.8813559322034
"10094","30351","2019",249,167,82,291122.417670683,3060.63052208835,94.855421686747
"10095","30352","2019",27,26,1,306295.407407407,2686.77777777778,115.148148148148
"10096","30353","2019",1,1,0,41000,631,65
"10097","30354","2019",4,4,0,175282.5,1724.5,105
"10098","30355","2019",10,9,1,192237.5,1888.8,101
"10099","30356","2019",27,24,3,230739.074074074,2259.96296296296,102.777777777778
"10100","31001","2019",2,2,0,155000,1671.5,94.5
"10101","31002","2019",2,2,0,136925,1064.5,127.5
"10102","31003","2019",9,7,2,371635.666666667,2946.22222222222,125.666666666667
"10103","31004","2019",30,30,0,279008.666666667,2447.53333333333,113.166666666667
"10104","31005","2019",3,3,0,190000,1333.66666666667,146.666666666667
"10105","31006","2019",2,2,0,241350,2903,101
"10106","31008","2019",6,6,0,181756.666666667,1215.66666666667,151.333333333333
"10107","31009","2019",1,1,0,60000,1875,32
"10108","31011","2019",3,3,0,111000,1844.66666666667,60.6666666666667
"10109","31012","2019",2,2,0,113025,1759.5,67
"10110","31013","2019",5,5,0,112360,1171.8,103.2
"10111","31015","2019",2,2,0,136000,1844.5,72.5
"10112","31017","2019",2,2,0,53000,838,63
"10113","31018","2019",1,1,0,107000,1259,85
"10114","31020","2019",18,17,1,106499.722222222,1097.11111111111,92.6666666666667
"10115","31021","2019",1,1,0,245000,1633,150
"10116","31022","2019",177,48,129,155533.892655367,2454.54237288136,63.0677966101695
"10117","31023","2019",4,4,0,92000,901,100
"10118","31024","2019",5,5,0,150000,1423.4,106.8
"10119","31025","2019",6,6,0,384058.333333333,3115.83333333333,124.166666666667
"10120","31026","2019",15,14,1,206658.666666667,1930.06666666667,111.8
"10121","31027","2019",1,1,0,210570,1483,142
"10122","31028","2019",12,10,2,91338.75,969.666666666667,94.75
"10123","31029","2019",2,2,0,343075,2516.5,135
"10124","31031","2019",5,5,0,151600,1353.6,109.8
"10125","31032","2019",101,60,41,209121.475247525,2441.54455445545,86.2871287128713
"10126","31033","2019",146,109,37,154573.260273973,1791.6095890411,85.3972602739726
"10127","31034","2019",1,1,0,85000,434,196
"10128","31035","2019",35,20,15,327335.942857143,3054.2,107.114285714286
"10129","31036","2019",23,21,2,341004.652173913,2793.39130434783,127.565217391304
"10130","31037","2019",16,16,0,242970,1829.8125,133.625
"10131","31038","2019",9,9,0,257702.222222222,1692.66666666667,153.111111111111
"10132","31039","2019",2,2,0,139000,2343.5,58
"10133","31040","2019",1,1,0,156000,963,162
"10134","31041","2019",2,2,0,66500,1213,58
"10135","31042","2019",142,21,121,87577.2887323944,1792.97887323944,51.2112676056338
"10136","31044","2019",241,103,138,292867.298755187,3346.91286307054,85.7800829875519
"10137","31045","2019",7,6,1,133647.142857143,1247.42857142857,107.285714285714
"10138","31048","2019",45,45,0,246714.755555556,2483.4,102.577777777778
"10139","31049","2019",5,5,0,242419,2048.4,123.2
"10140","31050","2019",6,6,0,155666.666666667,1301.5,121.666666666667
"10141","31051","2019",4,4,0,250000,2284.5,108.5
"10142","31052","2019",24,24,0,205541.833333333,2076.83333333333,99.0833333333333
"10143","31053","2019",9,9,0,356851.555555556,2752.22222222222,135.222222222222
"10144","31055","2019",1,1,0,249000,732,340
"10145","31056","2019",77,49,28,250908.038961039,2810.87012987013,88.4155844155844
"10146","31057","2019",17,17,0,296933.529411765,2646.70588235294,118.176470588235
"10147","31058","2019",1,1,0,315000,2250,140
"10148","31059","2019",2,2,0,116500,1294.5,90
"10149","31060","2019",2,2,0,92000,826,109
"10150","31061","2019",1,1,0,248000,2756,90
"10151","31062","2019",4,4,0,195025,1704.25,116.25
"10152","31063","2019",3,3,0,108533.333333333,948,114.333333333333
"10153","31065","2019",39,39,0,223219.974358974,2012.35897435897,119.205128205128
"10154","31066","2019",81,53,28,157557.407407407,1833.92592592593,84.3086419753086
"10155","31067","2019",2,2,0,151870,2336.5,65
"10156","31068","2019",2,2,0,130000,1042.5,136
"10157","31069","2019",391,113,278,212228.749360614,2911.98976982097,71.4936061381074
"10158","31070","2019",7,7,0,141435.714285714,1241.85714285714,110.571428571429
"10159","31071","2019",3,3,0,179516.666666667,2486.33333333333,77.6666666666667
"10160","31072","2019",1,1,0,80000,727,110
"10161","31073","2019",12,12,0,199758,2058.58333333333,98.75
"10162","31074","2019",4,4,0,346750,2844.5,122
"10163","31075","2019",16,16,0,290287.125,2329.375,128.125
"10164","31076","2019",4,4,0,228750,2024.5,113.5
"10165","31077","2019",4,4,0,202990,1394.75,144.25
"10166","31078","2019",1,1,0,105000,574,183
"10167","31079","2019",7,7,0,289052.857142857,2827.14285714286,102.285714285714
"10168","31080","2019",16,16,0,122987.5625,1064.0625,111.375
"10169","31081","2019",1,1,0,1e+05,971,103
"10170","31082","2019",9,7,2,215800,2206,105.333333333333
"10171","31083","2019",3,3,0,234366.666666667,1210.33333333333,183
"10172","31084","2019",11,11,0,144473.636363636,1558.72727272727,99.0909090909091
"10173","31085","2019",14,9,5,93733.5714285714,1479.14285714286,60.4285714285714
"10174","31086","2019",2,2,0,229775,1557.5,147.5
"10175","31087","2019",5,4,1,186980,2031.8,90.6
"10176","31088","2019",30,29,1,329796.333333333,2929.13333333333,115.3
"10177","31089","2019",5,5,0,271540,3004.4,93
"10178","31090","2019",7,6,1,184985.714285714,1601.14285714286,125.285714285714
"10179","31091","2019",79,62,17,219710.924050633,2279.35443037975,95.5443037974684
"10180","31092","2019",2,2,0,63500,845,94.5
"10181","31093","2019",7,7,0,163238.571428571,1684.14285714286,103.428571428571
"10182","31094","2019",48,37,11,192667.8125,2143.8125,90.6458333333333
"10183","31095","2019",1,1,0,168500,1204,140
"10184","31096","2019",2,2,0,287400,1506,197
"10185","31097","2019",10,10,0,203650.3,1711.8,131.3
"10186","31098","2019",14,12,2,151544.5,1483.85714285714,102.357142857143
"10187","31099","2019",6,6,0,242591.666666667,2222.33333333333,110.333333333333
"10188","31100","2019",25,25,0,173543,1762.76,98.28
"10189","31101","2019",4,4,0,232375,2006.75,116
"10190","31102","2019",2,2,0,331871,2649,125
"10191","31104","2019",8,8,0,240803,2658.5,99.375
"10192","31105","2019",4,4,0,270705,2550.75,118.75
"10193","31106","2019",38,36,2,201097.526315789,2071.73684210526,100.815789473684
"10194","31107","2019",83,70,13,187475.21686747,1906.73493975904,98.289156626506
"10195","31108","2019",3,3,0,144000,918.666666666667,155.666666666667
"10196","31109","2019",5,5,0,155100,1366.8,124
"10197","31110","2019",8,8,0,135167.5,1340.25,99.625
"10198","31111","2019",4,4,0,172872.5,1720.25,106.25
"10199","31113","2019",164,68,96,238087.530487805,2837.53658536585,84.1463414634146
"10200","31114","2019",1,1,0,146000,1622,90
"10201","31115","2019",1,1,0,75000,1339,56
"10202","31116","2019",194,113,81,208320.56185567,2517.11855670103,82.5979381443299
"10203","31117","2019",42,42,0,328830.095238095,2886.7619047619,116.142857142857
"10204","31118","2019",139,73,66,163795.791366906,2101.61151079137,74.7913669064748
"10205","31119","2019",6,6,0,174483.333333333,1429.33333333333,135.833333333333
"10206","31120","2019",11,11,0,326337.181818182,2542,150.454545454545
"10207","31121","2019",1,1,0,275000,1250,220
"10208","31122","2019",2,2,0,83850,963,87
"10209","31123","2019",3,3,0,194666.666666667,2523,74.6666666666667
"10210","31124","2019",2,2,0,254350,1772.5,142
"10211","31125","2019",1,1,0,101000,3483,29
"10212","31126","2019",4,4,0,204733.75,1449.25,153.25
"10213","31128","2019",8,8,0,178500,1877.875,92
"10214","31130","2019",1,1,0,50000,556,90
"10215","31131","2019",1,1,0,57000,814,70
"10216","31132","2019",4,4,0,152925,1722,96.75
"10217","31133","2019",4,4,0,156805,1639,96.75
"10218","31134","2019",1,1,0,280000,1750,160
"10219","31135","2019",77,59,18,135238.974025974,1564.22077922078,89.2207792207792
"10220","31136","2019",21,16,5,200108.285714286,2205.04761904762,88.7619047619048
"10221","31137","2019",3,3,0,257331.666666667,2054.33333333333,126
"10222","31138","2019",1,1,0,197620,2635,75
"10223","31139","2019",4,4,0,109166.25,969.5,109.25
"10224","31140","2019",5,5,0,119800,1415.4,88.8
"10225","31142","2019",4,4,0,217750,2380.75,86.75
"10226","31143","2019",2,2,0,161500,1258.5,149
"10227","31144","2019",12,12,0,100212.5,1040.66666666667,99.5
"10228","31145","2019",42,39,3,166795.595238095,1702.28571428571,98.6190476190476
"10229","31146","2019",1,1,0,113000,769,147
"10230","31147","2019",3,3,0,186666.666666667,1790.33333333333,108
"10231","31148","2019",6,6,0,383908.333333333,2333.16666666667,169.333333333333
"10232","31149","2019",554,228,326,199332.996389892,2475.79422382671,78.5361010830325
"10233","31150","2019",138,94,44,218832.239130435,2561.33333333333,84.8405797101449
"10234","31151","2019",10,9,1,344982,2892.6,126.5
"10235","31152","2019",1,1,0,123000,1732,71
"10236","31153","2019",5,5,0,91162,1540.8,78.6
"10237","31155","2019",2,2,0,129000,1551.5,88
"10238","31156","2019",7,7,0,147835.857142857,1412.42857142857,105.857142857143
"10239","31157","2019",306,158,148,204816.539215686,2518.9477124183,80.1732026143791
"10240","31158","2019",2,2,0,169835,1740.5,100.5
"10241","31159","2019",3,3,0,130666.666666667,1389.33333333333,98.6666666666667
"10242","31160","2019",25,24,1,252246.84,2393.4,105.8
"10243","31161","2019",11,8,3,250444,2736.27272727273,94.2727272727273
"10244","31162","2019",11,11,0,335568.818181818,2528,140.454545454545
"10245","31163","2019",23,20,3,367927.565217391,3225.60869565217,118.434782608696
"10246","31164","2019",2,2,0,193750,774.5,224
"10247","31165","2019",74,47,27,201831.635135135,2179.52702702703,88.9864864864865
"10248","31166","2019",8,8,0,148812.5,1613,100.125
"10249","31167","2019",3,3,0,125436.666666667,1556.66666666667,80
"10250","31168","2019",2,2,0,225042.5,2101.5,106
"10251","31169","2019",71,45,26,263073,2916,89.887323943662
"10252","31170","2019",2,2,0,187500,2138.5,90.5
"10253","31171","2019",6,6,0,365920,3054.33333333333,126
"10254","31173","2019",6,6,0,165945,1715.66666666667,94.6666666666667
"10255","31174","2019",7,7,0,192107.142857143,1226.42857142857,158.285714285714
"10256","31175","2019",6,6,0,140055.166666667,1150.5,122.5
"10257","31176","2019",1,1,0,1e+05,1695,59
"10258","31178","2019",1,1,0,160000,731,219
"10259","31179","2019",1,1,0,163670,1605,102
"10260","31180","2019",2,2,0,336777.5,1680,200
"10261","31181","2019",24,16,8,197656.25,2067.5,95.625
"10262","31182","2019",105,39,66,143718.428571429,2085.51428571429,67.7714285714286
"10263","31183","2019",3,3,0,117333.333333333,1064.66666666667,114.666666666667
"10264","31184","2019",23,20,3,297408.347826087,2838.52173913043,105.565217391304
"10265","31185","2019",1,1,0,365000,1237,295
"10266","31186","2019",89,25,64,164012.179775281,2355.33707865169,66.4606741573034
"10267","31187","2019",187,130,57,230673.427807487,2390.35828877005,94.807486631016
"10268","31188","2019",4,4,0,456937.5,2500.25,179.25
"10269","31189","2019",2,2,0,144545,1540,82
"10270","31190","2019",5,5,0,61784.2,986.6,59.8
"10271","31191","2019",4,4,0,102700,1027,104.75
"10272","31192","2019",9,9,0,276783.333333333,2680.88888888889,103.666666666667
"10273","31193","2019",26,25,1,147106.730769231,1563.42307692308,96.1538461538462
"10274","31194","2019",1,1,0,170000,2125,80
"10275","31196","2019",2,2,0,182400,2080.5,91
"10276","31197","2019",2,2,0,139600,1361,88
"10277","31198","2019",4,4,0,153178.75,1628.5,92
"10278","31200","2019",1,1,0,20000,500,40
"10279","31202","2019",65,54,11,218314.846153846,2238.87692307692,100.492307692308
"10280","31203","2019",116,74,42,216766.75862069,2661.65517241379,84.698275862069
"10281","31204","2019",1,1,0,164000,1312,125
"10282","31205","2019",50,12,38,149864.2,2187.08,69.02
"10283","31206","2019",4,3,1,139625,1390.5,117
"10284","31207","2019",1,1,0,125000,1276,98
"10285","31208","2019",4,4,0,107662.5,1077.25,100
"10286","31209","2019",2,2,0,215710,1660.5,126.5
"10287","31210","2019",15,14,1,199840,1983.4,101.266666666667
"10288","31211","2019",4,4,0,191357.5,1815.75,105.25
"10289","31212","2019",20,14,6,226870.5,2237.65,104.05
"10290","31213","2019",6,4,2,93659,1458.5,70.8333333333333
"10291","31215","2019",3,3,0,137777.666666667,1298.33333333333,109
"10292","31216","2019",6,6,0,295014.166666667,2250.33333333333,136.666666666667
"10293","31217","2019",3,3,0,109353.333333333,1070,111.666666666667
"10294","31218","2019",3,3,0,248480,1595.33333333333,169.666666666667
"10295","31219","2019",3,3,0,111000,1427.66666666667,76
"10296","31220","2019",7,7,0,195552.857142857,1835.57142857143,118
"10297","31221","2019",6,1,5,83124.1666666667,1571,52.6666666666667
"10298","31224","2019",11,10,1,124567.363636364,1329.72727272727,101.727272727273
"10299","31225","2019",2,2,0,234500,2159,107
"10300","31226","2019",2,2,0,112500,1062.5,105
"10301","31227","2019",6,6,0,307125,2567.16666666667,130.5
"10302","31228","2019",34,22,12,234023.382352941,2581.79411764706,90
"10303","31229","2019",10,10,0,200860,1840.9,135.7
"10304","31230","2019",10,10,0,270396.7,2512.5,114.3
"10305","31231","2019",13,13,0,183123.076923077,1870.23076923077,100.461538461538
"10306","31232","2019",148,86,62,175606.47972973,2080.2027027027,84.5405405405405
"10307","31233","2019",12,12,0,246961.666666667,2115.08333333333,123.416666666667
"10308","31234","2019",7,7,0,177792.857142857,1889.71428571429,91.1428571428571
"10309","31235","2019",4,4,0,110250,1350.25,89.25
"10310","31236","2019",1,1,0,127950,1968,65
"10311","31237","2019",4,4,0,90500,1049.5,79.25
"10312","31238","2019",4,4,0,106037.5,853.75,135.75
"10313","31239","2019",31,30,1,118672.35483871,1121.64516129032,113.41935483871
"10314","31240","2019",6,6,0,197425,2179,93.3333333333333
"10315","31241","2019",3,3,0,117666.666666667,735.666666666667,146.333333333333
"10316","31242","2019",1,1,0,50000,2381,21
"10317","31243","2019",2,2,0,183226.5,1582.5,128
"10318","31244","2019",1,0,1,114970,1173,98
"10319","31245","2019",2,2,0,84000,665.5,118
"10320","31246","2019",12,11,1,137333.333333333,1294.33333333333,102.666666666667
"10321","31247","2019",20,20,0,155898.25,1423.85,118.8
"10322","31248","2019",51,42,9,233353.803921569,2368.70588235294,101.372549019608
"10323","31249","2019",13,10,3,201384.538461538,1990.23076923077,99.6153846153846
"10324","31250","2019",10,10,0,187057.7,1882.4,100.6
"10325","31251","2019",1,1,0,178000,1348,132
"10326","31252","2019",37,30,7,219290.324324324,2406.78378378378,91
"10327","31253","2019",33,24,9,201647.848484848,2216.60606060606,93.3030303030303
"10328","31254","2019",30,24,6,305925.933333333,3013,103.366666666667
"10329","31255","2019",7,7,0,119420,994.714285714286,130.571428571429
"10330","31256","2019",4,4,0,303745,2445.75,121.25
"10331","31258","2019",3,3,0,177333.333333333,1446,129
"10332","31259","2019",25,19,6,355954,2834.8,131.88
"10333","31260","2019",4,4,0,104000,1296.25,80.25
"10334","31261","2019",14,14,0,224539.928571429,1963.14285714286,116.357142857143
"10335","31262","2019",6,6,0,189916.666666667,1410,131.166666666667
"10336","31263","2019",38,38,0,222373.105263158,2182.44736842105,102.763157894737
"10337","31264","2019",2,2,0,247500,1930.5,117.5
"10338","31265","2019",7,7,0,208958.285714286,1978.28571428571,109.142857142857
"10339","31266","2019",3,3,0,236876.666666667,2213.33333333333,116.666666666667
"10340","31267","2019",1,1,0,255000,1759,145
"10341","31268","2019",3,3,0,130333.333333333,1269.66666666667,107.333333333333
"10342","31269","2019",15,15,0,217110,2115.73333333333,103.533333333333
"10343","31270","2019",8,8,0,193039.75,1615,137.875
"10344","31271","2019",35,23,12,257897.314285714,2463.97142857143,103.971428571429
"10345","31272","2019",1,1,0,525000,2273,231
"10346","31273","2019",14,12,2,288688.571428571,2586.35714285714,110.928571428571
"10347","31274","2019",3,3,0,98500,639,156.666666666667
"10348","31275","2019",1,1,0,1150000,3194,360
"10349","31276","2019",3,3,0,121083.333333333,939,131.666666666667
"10350","31277","2019",16,16,0,283276.25,2384.5625,121.0625
"10351","31278","2019",4,4,0,127717.5,1315.75,103.25
"10352","31280","2019",8,8,0,236587.5,1487.25,149.375
"10353","31281","2019",13,11,2,201586.923076923,2098.61538461538,100.538461538462
"10354","31282","2019",122,70,52,221452.672131148,2644.00819672131,80.9344262295082
"10355","31284","2019",12,10,2,338630.833333333,2491,136.166666666667
"10356","31285","2019",5,5,0,360800,3443.2,105.4
"10357","31286","2019",14,14,0,122254.642857143,1338.35714285714,96.2857142857143
"10358","31287","2019",43,33,10,188073.76744186,2035.95348837209,95.4883720930233
"10359","31288","2019",2,2,0,228000,1766,158
"10360","31289","2019",3,3,0,156816.666666667,964.333333333333,161
"10361","31291","2019",131,64,67,184250.290076336,2363.65648854962,75.4656488549618
"10362","31292","2019",2,2,0,247225,2138.5,116
"10363","31293","2019",33,26,7,241770.303030303,2525.72727272727,97.3939393939394
"10364","31294","2019",1,1,0,115000,767,150
"10365","31296","2019",3,3,0,61666.6666666667,749.333333333333,102.333333333333
"10366","31297","2019",29,25,4,228777.586206897,2323.24137931034,96.1379310344828
"10367","31299","2019",35,27,8,201129.485714286,2006.42857142857,101.828571428571
"10368","31300","2019",1,1,0,135000,1098,123
"10369","31301","2019",5,5,0,147700,1417.8,118.8
"10370","31302","2019",2,2,0,117750,953,132
"10371","31303","2019",46,39,7,209676.195652174,1914.41304347826,108.282608695652
"10372","31304","2019",6,5,1,186542,1933.33333333333,99.6666666666667
"10373","31305","2019",2,2,0,39000,1360,32
"10374","31306","2019",3,3,0,153183.333333333,1939.33333333333,80
"10375","31309","2019",6,6,0,205403.333333333,1644.66666666667,129
"10376","31310","2019",1,1,0,233000,1864,125
"10377","31311","2019",11,11,0,249314.545454545,2418.63636363636,106.272727272727
"10378","31313","2019",6,6,0,107916.666666667,1105.33333333333,91.6666666666667
"10379","31314","2019",10,10,0,166506.9,1204,134.7
"10380","31315","2019",10,10,0,99195,1017.2,96.5
"10381","31316","2019",7,7,0,117026.142857143,1144,114.714285714286
"10382","31317","2019",6,6,0,197180.666666667,1483.83333333333,139.166666666667
"10383","31318","2019",3,3,0,214890,1860,116.333333333333
"10384","31319","2019",2,2,0,119500,1232.5,95.5
"10385","31320","2019",9,9,0,200496,2161.33333333333,94.2222222222222
"10386","31321","2019",1,1,0,150000,1705,88
"10387","31322","2019",1,1,0,85000,1000,85
"10388","31324","2019",35,30,5,142395,1541.48571428571,94.5428571428571
"10389","31325","2019",1,1,0,90000,1125,80
"10390","31326","2019",1,1,0,120000,2000,60
"10391","31327","2019",3,3,0,139250,941,131.666666666667
"10392","31328","2019",5,5,0,218920,1543.2,143.2
"10393","31329","2019",1,1,0,213810,2017,106
"10394","31330","2019",10,9,1,152587.5,1603,97.6
"10395","31331","2019",1,1,0,232530,2584,90
"10396","31332","2019",2,2,0,127500,1062.5,120
"10397","31333","2019",1,0,1,221615,1847,120
"10398","31334","2019",15,15,0,245392.666666667,2240.93333333333,113.6
"10399","31336","2019",11,11,0,144542.727272727,1336.81818181818,111.454545454545
"10400","31337","2019",3,3,0,74000,723.333333333333,102.333333333333
"10401","31338","2019",6,6,0,288520,2417.33333333333,116.666666666667
"10402","31339","2019",7,7,0,338945.714285714,2601,136.142857142857
"10403","31340","2019",2,2,0,465433.5,3123,149
"10404","31341","2019",101,64,37,202847.920792079,2232.35643564356,89.1980198019802
"10405","31342","2019",2,2,0,141500,1093.5,130.5
"10406","31343","2019",1,1,0,171000,1196,143
"10407","31344","2019",5,5,0,67160,734.8,91.4
"10408","31345","2019",39,37,2,230350.384615385,2165.84615384615,108.74358974359
"10409","31346","2019",13,13,0,240894.461538462,2743.53846153846,101.307692307692
"10410","31347","2019",1,1,0,116700,1006,116
"10411","31348","2019",1,1,0,89550,1079,83
"10412","31349","2019",11,11,0,167653.636363636,1421.72727272727,121.545454545455
"10413","31350","2019",2,2,0,77500,760.5,100
"10414","31351","2019",107,45,62,186601.672897196,2392.23364485981,74.981308411215
"10415","31353","2019",1,1,0,350200,1401,250
"10416","31355","2019",8,8,0,301168.75,2611,125.25
"10417","31356","2019",24,24,0,319663.875,2385.29166666667,135.083333333333
"10418","31357","2019",2,2,0,43693.5,489,87
"10419","31358","2019",56,52,4,251857.946428571,2374.60714285714,107.357142857143
"10420","31360","2019",7,5,2,246015.714285714,2239.42857142857,105
"10421","31361","2019",7,7,0,235014.285714286,1907.14285714286,137.428571428571
"10422","31362","2019",4,4,0,110250,1612.75,69.75
"10423","31363","2019",1,1,0,65000,591,110
"10424","31364","2019",29,26,3,264439.379310345,2708.24137931034,97.7241379310345
"10425","31365","2019",10,10,0,79440,960.1,84.6
"10426","31366","2019",7,7,0,324998.571428571,2495.42857142857,131.142857142857
"10427","31368","2019",3,3,0,243500,1996,127
"10428","31369","2019",1,1,0,121000,1090,111
"10429","31370","2019",2,2,0,134115,1294,97
"10430","31371","2019",1,1,0,205000,1708,120
"10431","31372","2019",5,5,0,92900,1162.2,85.6
"10432","31373","2019",4,4,0,155750,1406,112
"10433","31374","2019",12,12,0,239143.166666667,2217.5,110
"10434","31375","2019",46,43,3,152760.173913043,1467.60869565217,106.847826086957
"10435","31376","2019",2,2,0,151000,1290,116.5
"10436","31377","2019",4,4,0,244025,2369,100.75
"10437","31378","2019",2,2,0,175000,1321,153.5
"10438","31379","2019",1,1,0,152000,1520,100
"10439","31380","2019",1,1,0,140000,1591,88
"10440","31381","2019",34,32,2,260845.764705882,2569.85294117647,104.147058823529
"10441","31382","2019",2,2,0,359037,1871.5,192
"10442","31383","2019",15,15,0,266255.933333333,2462,109.333333333333
"10443","31384","2019",14,14,0,264174.428571429,2813,98.8571428571429
"10444","31385","2019",3,3,0,160000,1582.33333333333,96
"10445","31386","2019",1,1,0,196550,1739,113
"10446","31387","2019",1,1,0,210000,1522,138
"10447","31388","2019",2,2,0,385175,2529.5,154.5
"10448","31389","2019",45,30,15,275412.822222222,2819.06666666667,99.9777777777778
"10449","31390","2019",29,20,9,102793.965517241,958.344827586207,114.51724137931
"10450","31391","2019",2,2,0,61500,861.5,70.5
"10451","31393","2019",3,3,0,191533.333333333,1361.33333333333,172
"10452","31394","2019",3,2,1,148333.333333333,1473.33333333333,99
"10453","31395","2019",341,190,151,174248.841642229,2151.76539589443,81.375366568915
"10454","31396","2019",84,52,32,173956.976190476,1834.34523809524,88.0595238095238
"10455","31399","2019",27,27,0,212249.62962963,1862.03703703704,114.407407407407
"10456","31400","2019",1,1,0,178000,1745,102
"10457","31401","2019",4,4,0,279168.75,2198.5,126.25
"10458","31402","2019",7,7,0,360737.142857143,2820.14285714286,130.142857142857
"10459","31403","2019",11,11,0,180324.727272727,1775.36363636364,100.909090909091
"10460","31405","2019",2,2,0,105500,744.5,143
"10461","31406","2019",13,12,1,154659.846153846,1383.61538461538,111.461538461538
"10462","31407","2019",14,12,2,233035,2533.35714285714,95.1428571428571
"10463","31409","2019",49,22,27,191732.306122449,2499.87755102041,76.3469387755102
"10464","31410","2019",57,48,9,228403.263157895,2459.66666666667,92.1052631578947
"10465","31411","2019",4,4,0,587451.25,3459,169.75
"10466","31412","2019",3,3,0,119668.333333333,1038,120.666666666667
"10467","31413","2019",8,8,0,178190,1757.625,111.875
"10468","31416","2019",8,8,0,234827.5,2033.375,116
"10469","31417","2019",94,75,19,339536.70212766,2970.79787234043,113.053191489362
"10470","31418","2019",1,1,0,477000,4077,117
"10471","31419","2019",2,2,0,121500,1149.5,102
"10472","31420","2019",28,21,7,205353.285714286,2294.14285714286,91.3214285714286
"10473","31421","2019",41,31,10,211012.073170732,2260.90243902439,87.5609756097561
"10474","31422","2019",3,3,0,105033.333333333,1143.33333333333,94
"10475","31423","2019",5,5,0,220720,1600.8,137.4
"10476","31424","2019",221,172,49,254251.398190045,2643.78733031674,95.6515837104072
"10477","31425","2019",9,9,0,84822.2222222222,968.222222222222,93.3333333333333
"10478","31426","2019",6,6,0,152996.666666667,1491.16666666667,102
"10479","31427","2019",6,6,0,157056.666666667,1430.5,110.166666666667
"10480","31428","2019",1,1,0,35000,389,90
"10481","31429","2019",26,13,13,265906.346153846,2700.61538461538,95.4230769230769
"10482","31430","2019",4,4,0,163000,1618.25,101
"10483","31431","2019",5,5,0,87660,965.2,96.2
"10484","31433","2019",103,70,33,213872.893203883,2342.74757281553,90.4660194174757
"10485","31435","2019",9,9,0,232847.777777778,1966.77777777778,118.777777777778
"10486","31436","2019",5,5,0,236898,1568.2,151.8
"10487","31439","2019",5,5,0,399220,2401.8,180.8
"10488","31441","2019",2,2,0,363150,1745,223.5
"10489","31442","2019",6,6,0,234483.333333333,1822.66666666667,130.166666666667
"10490","31443","2019",3,3,0,120433.333333333,937.666666666667,134.333333333333
"10491","31444","2019",2,2,0,232500.5,2053.5,113
"10492","31445","2019",52,37,15,322850.576923077,3222.44230769231,102.769230769231
"10493","31446","2019",227,64,163,205663.938325991,2737.59471365639,75.9295154185022
"10494","31447","2019",1,1,0,58000,1115,52
"10495","31448","2019",7,7,0,395761.428571429,2955.57142857143,133.428571428571
"10496","31450","2019",6,6,0,250605.833333333,2300.66666666667,111.666666666667
"10497","31451","2019",150,128,22,159471.18,1640.67333333333,99.9533333333333
"10498","31452","2019",1,1,0,115000,935,123
"10499","31453","2019",2,2,0,147250,1117,137.5
"10500","31454","2019",51,42,9,157223.333333333,1595.07843137255,99.5686274509804
"10501","31455","2019",23,23,0,170858.565217391,1747.52173913043,99.7391304347826
"10502","31456","2019",1,1,0,35000,350,100
"10503","31457","2019",8,8,0,146687.5,1167.125,138.75
"10504","31458","2019",59,47,12,227436.220338983,2769.52542372881,84.2881355932203
"10505","31459","2019",8,8,0,274287.875,2414.125,113.5
"10506","31460","2019",33,31,2,278597.272727273,2756.15151515152,102.757575757576
"10507","31461","2019",3,3,0,111461.666666667,1223.66666666667,94
"10508","31462","2019",36,21,15,374049.166666667,3503.66666666667,101.305555555556
"10509","31463","2019",3,3,0,188026.666666667,1740,108
"10510","31464","2019",4,4,0,162875,1566.5,109.5
"10511","31466","2019",6,6,0,296081.166666667,2834.5,116.166666666667
"10512","31467","2019",68,45,23,217679.455882353,2474.83823529412,87
"10513","31468","2019",5,5,0,156409,1420.4,115
"10514","31469","2019",2,2,0,148555,1635,89.5
"10515","31470","2019",6,2,4,74103.5,1837,45
"10516","31471","2019",11,10,1,104220.909090909,1087.27272727273,96.7272727272727
"10517","31472","2019",4,4,0,133750,1254,108.25
"10518","31473","2019",3,2,1,222213.333333333,1984,109.333333333333
"10519","31474","2019",2,2,0,166300,1112.5,141
"10520","31475","2019",15,13,2,207815.666666667,2287.6,94.0666666666667
"10521","31476","2019",11,11,0,190474.090909091,1764.90909090909,111.727272727273
"10522","31478","2019",21,21,0,191234.761904762,1783.7619047619,116.952380952381
"10523","31479","2019",1,1,0,120000,1154,104
"10524","31480","2019",23,19,4,318209.695652174,3012.34782608696,109.217391304348
"10525","31481","2019",27,21,6,205107.851851852,2003.81481481481,102.148148148148
"10526","31482","2019",1,1,0,60000,429,140
"10527","31483","2019",204,103,101,85690.818627451,1066.00980392157,79.5196078431373
"10528","31484","2019",12,12,0,372020.833333333,3191.25,118.5
"10529","31486","2019",17,14,3,204796.647058824,2213.52941176471,91.5294117647059
"10530","31488","2019",164,91,73,236832.536585366,2920.32926829268,80.4573170731707
"10531","31489","2019",2,2,0,380050,2936,129.5
"10532","31490","2019",70,63,7,218571.271428571,2431.37142857143,91.0857142857143
"10533","31491","2019",5,4,1,215400,1773.2,145.4
"10534","31492","2019",6,6,0,161811.666666667,1906.83333333333,87.5
"10535","31494","2019",7,7,0,119257.142857143,1017.42857142857,147
"10536","31495","2019",5,5,0,301249,2816.4,106.6
"10537","31496","2019",1,1,0,303000,1870,162
"10538","31497","2019",21,21,0,293374.047619048,2586.14285714286,118.142857142857
"10539","31498","2019",1,1,0,179999,1125,160
"10540","31499","2019",145,98,47,184849.268965517,2127.42068965517,85.6689655172414
"10541","31500","2019",31,17,14,141882.225806452,2288.93548387097,69.4838709677419
"10542","31501","2019",5,5,0,229986,1858,127
"10543","31502","2019",6,6,0,126166.666666667,1387.66666666667,95
"10544","31503","2019",11,9,2,98363.6363636364,1007.36363636364,98.7272727272727
"10545","31504","2019",1,1,0,139000,1350,103
"10546","31505","2019",4,4,0,106250,1677,64.75
"10547","31506","2019",214,121,93,257132.280373832,2934.59813084112,85.9392523364486
"10548","31507","2019",38,20,18,171066.578947368,2038.60526315789,80.5789473684211
"10549","31508","2019",3,2,1,157600,1310.33333333333,116.333333333333
"10550","31510","2019",1,1,0,155000,1192,130
"10551","31511","2019",1,1,0,270000,1942,139
"10552","31512","2019",10,10,0,283007,2340.7,124.5
"10553","31513","2019",4,4,0,99375,1025.75,97.25
"10554","31514","2019",1,1,0,415000,3517,118
"10555","31515","2019",8,8,0,238452.5,1965,120.875
"10556","31516","2019",24,21,3,243487.916666667,2125.625,109.958333333333
"10557","31517","2019",20,19,1,193539.5,1769.1,113.85
"10558","31518","2019",8,8,0,305959.75,1941,160.625
"10559","31520","2019",2,2,0,145000,961.5,150
"10560","31521","2019",5,5,0,136640,1605.4,114.8
"10561","31523","2019",11,10,1,139852.272727273,1484.27272727273,98.9090909090909
"10562","31525","2019",8,8,0,245956.25,2022,123.875
"10563","31526","2019",120,83,37,226041.108333333,2582.76666666667,87.5
"10564","31527","2019",1,1,0,220000,4400,50
"10565","31528","2019",1,1,0,150000,1500,100
"10566","31529","2019",1,1,0,131000,2382,55
"10567","31530","2019",1,1,0,156000,1773,88
"10568","31531","2019",1,1,0,210000,1135,185
"10569","31532","2019",1,1,0,90000,947,95
"10570","31533","2019",21,20,1,257993.428571429,2426.04761904762,106.428571428571
"10571","31534","2019",1,1,0,345100,2950,117
"10572","31535","2019",7,7,0,131657.142857143,1095.28571428571,113.714285714286
"10573","31536","2019",3,3,0,110366.666666667,865.333333333333,128.333333333333
"10574","31537","2019",4,4,0,220500,1658.75,133.75
"10575","31538","2019",1,1,0,240000,2243,107
"10576","31539","2019",2,2,0,195635,1160,170
"10577","31540","2019",6,6,0,297583.333333333,2544.66666666667,136.5
"10578","31541","2019",71,17,54,215061.408450704,2883.91549295775,71.6197183098592
"10579","31542","2019",2,2,0,120750,1361.5,84.5
"10580","31543","2019",2,2,0,142500,1475.5,97
"10581","31544","2019",8,8,0,87437.5,1075.125,91.875
"10582","31545","2019",2,2,0,204750,1194,167
"10583","31546","2019",1,1,0,192600,2751,70
"10584","31547","2019",96,70,26,211291.541666667,2254.07291666667,95.75
"10585","31550","2019",5,5,0,90832,1075.6,87.6
"10586","31551","2019",2,2,0,364900,3087.5,116.5
"10587","31552","2019",1,1,0,40000,333,120
"10588","31553","2019",23,18,5,201604.565217391,1990.26086956522,98.3913043478261
"10589","31554","2019",2,2,0,129687.5,787.5,157
"10590","31555","2019",9065,1321,7744,198151.793491451,3167.7638168781,63.3249862107005
"10591","31556","2019",4,4,0,174712.5,1562.75,119.75
"10592","31557","2019",341,208,133,287642.66568915,2931.42521994135,94.2551319648094
"10593","31558","2019",4,4,0,221096.5,2005,107
"10594","31560","2019",3,3,0,169116.666666667,1615.66666666667,106
"10595","31561","2019",138,104,34,295202.927536232,3029.19565217391,97.7391304347826
"10596","31562","2019",1,1,0,265500,781,340
"10597","31563","2019",9,9,0,245759.888888889,1894.66666666667,140.222222222222
"10598","31564","2019",1,1,0,171500,1491,115
"10599","31565","2019",9,9,0,84705.5555555556,848.111111111111,98.1111111111111
"10600","31566","2019",3,3,0,205280,1873.33333333333,115
"10601","31567","2019",3,3,0,277483.333333333,2617,105
"10602","31569","2019",1,1,0,222000,1965,113
"10603","31570","2019",2,2,0,97500,1555,62.5
"10604","31571","2019",5,5,0,222220,2118.4,104
"10605","31572","2019",32,32,0,214860.71875,2462.34375,86.875
"10606","31573","2019",45,37,8,231698.755555556,2227.93333333333,100.622222222222
"10607","31574","2019",34,31,3,235111.794117647,2405.82352941176,97.9411764705882
"10608","31575","2019",14,11,3,578873.571428571,3432.92857142857,194.642857142857
"10609","31576","2019",3,3,0,199546.666666667,1654.33333333333,107
"10610","31577","2019",2,2,0,166500,1796.5,94.5
"10611","31578","2019",12,12,0,522136.166666667,3177.16666666667,164.583333333333
"10612","31579","2019",12,12,0,263958.333333333,2296.75,115.416666666667
"10613","31580","2019",14,12,2,237107.142857143,2293.78571428571,102.571428571429
"10614","31581","2019",16,16,0,259191.875,2011.8125,138.25
"10615","31582","2019",63,57,6,183535.015873016,1952.77777777778,98.1111111111111
"10616","31583","2019",10,10,0,224616.2,2238.2,111
"10617","31584","2019",95,74,21,146801.063157895,1672.42105263158,87.6842105263158
"10618","31585","2019",13,11,2,215744.230769231,2455.38461538462,106.692307692308
"10619","31586","2019",3,3,0,149000,1285.66666666667,121.666666666667
"10620","31587","2019",15,15,0,253542.666666667,2101.86666666667,124.666666666667
"10621","31588","2019",105,74,31,211042,2481.78095238095,85.5142857142857
"10622","31589","2019",18,16,2,197063.333333333,1959.38888888889,104.055555555556
"10623","31592","2019",25,25,0,244107.8,2114.6,115.24
"10624","32001","2019",16,15,1,100675,1086.5,103.125
"10625","32003","2019",1,1,0,333000,1586,210
"10626","32004","2019",1,1,0,32500,903,36
"10627","32005","2019",4,4,0,148250,1163.5,128
"10628","32007","2019",2,2,0,206237.5,2140,96.5
"10629","32008","2019",1,1,0,105000,1312,80
"10630","32012","2019",15,15,0,158467.933333333,1466.33333333333,109.333333333333
"10631","32013","2019",370,193,177,124806.583783784,1555.79189189189,79.1243243243243
"10632","32014","2019",2,2,0,187610,1652.5,120.5
"10633","32016","2019",5,5,0,224550,2018.4,119
"10634","32017","2019",4,4,0,163325,1043,157.75
"10635","32018","2019",2,2,0,107500,1182.5,81.5
"10636","32019","2019",5,5,0,200200,1786.4,117.6
"10637","32020","2019",1,1,0,85000,525,162
"10638","32021","2019",1,1,0,211000,1758,120
"10639","32022","2019",3,3,0,140000,1069.33333333333,131.666666666667
"10640","32025","2019",2,2,0,233270,1756,157.5
"10641","32027","2019",26,23,3,124028.846153846,1348.26923076923,95.7307692307692
"10642","32029","2019",5,5,0,178092,1282,142.2
"10643","32031","2019",3,3,0,226527,1362,169.666666666667
"10644","32032","2019",6,6,0,62416.6666666667,713.666666666667,91.6666666666667
"10645","32033","2019",1,1,0,190000,731,260
"10646","32035","2019",4,4,0,159403.25,1535.25,96.25
"10647","32036","2019",6,6,0,114450,1103.83333333333,105.166666666667
"10648","32037","2019",2,2,0,203000,1041,177.5
"10649","32038","2019",1,1,0,383940,3147,122
"10650","32039","2019",2,2,0,117466.5,898.5,111
"10651","32040","2019",4,4,0,208387.5,2134.75,101.25
"10652","32041","2019",1,1,0,56100,510,110
"10653","32042","2019",1,1,0,220000,1222,180
"10654","32043","2019",2,2,0,232000,1358,185
"10655","32045","2019",6,6,0,169494.333333333,1629.5,109
"10656","32046","2019",1,1,0,207300,1582,131
"10657","32047","2019",2,2,0,412035,2472.5,168
"10658","32048","2019",1,1,0,162600,1414,115
"10659","32049","2019",1,1,0,130000,747,174
"10660","32050","2019",3,3,0,120333.333333333,597,209.666666666667
"10661","32051","2019",2,2,0,267325,2486,107.5
"10662","32052","2019",3,3,0,111833.333333333,965,106.333333333333
"10663","32053","2019",2,2,0,193552.5,1408.5,136
"10664","32054","2019",6,6,0,184016.666666667,1837.66666666667,119.333333333333
"10665","32057","2019",4,4,0,218250,1862.75,124.5
"10666","32059","2019",2,2,0,281805,1715.5,156
"10667","32060","2019",3,3,0,193966.666666667,1681,124.666666666667
"10668","32061","2019",1,1,0,79460,1088,73
"10669","32062","2019",3,3,0,237006.666666667,1926.33333333333,129.333333333333
"10670","32063","2019",2,2,0,207727.5,1269,160
"10671","32064","2019",6,6,0,140135,1154.5,128.166666666667
"10672","32065","2019",6,6,0,144500,979.5,153.333333333333
"10673","32066","2019",3,3,0,181133.333333333,1555.33333333333,124
"10674","32067","2019",1,1,0,85000,914,93
"10675","32068","2019",2,2,0,169000,1430,124
"10676","32069","2019",4,4,0,207334,1698.5,128.75
"10677","32070","2019",2,2,0,115000,1031.5,121.5
"10678","32071","2019",1,1,0,382000,2122,180
"10679","32075","2019",6,6,0,169501.666666667,1612,107.333333333333
"10680","32076","2019",9,9,0,192706.666666667,1576.11111111111,119
"10681","32077","2019",1,1,0,45000,750,60
"10682","32078","2019",2,2,0,80250,1706,50.5
"10683","32079","2019",14,14,0,114347,1090.14285714286,104.571428571429
"10684","32080","2019",1,1,0,230000,1353,170
"10685","32081","2019",1,1,0,335000,1362,246
"10686","32082","2019",3,3,0,247333.333333333,1299.66666666667,177.333333333333
"10687","32083","2019",10,8,2,189176.8,1456.9,118.3
"10688","32084","2019",3,3,0,123833.333333333,1108.66666666667,112
"10689","32085","2019",1,1,0,160000,1000,160
"10690","32086","2019",1,1,0,202000,1530,132
"10691","32087","2019",2,2,0,85500,1105.5,70
"10692","32088","2019",5,5,0,196640,1412.4,138.4
"10693","32089","2019",5,5,0,153000,1151.4,134
"10694","32090","2019",6,6,0,280841.666666667,2174.66666666667,131.333333333333
"10695","32091","2019",4,4,0,321577.5,2032.5,153.5
"10696","32093","2019",3,3,0,183868.333333333,1340,126
"10697","32094","2019",3,3,0,96666.6666666667,1049.33333333333,129
"10698","32095","2019",7,7,0,154185.857142857,1075.28571428571,137.571428571429
"10699","32096","2019",69,20,49,58246.9565217391,1145.13043478261,55.8695652173913
"10700","32098","2019",3,3,0,263048,1952,150.666666666667
"10701","32099","2019",2,2,0,193500,1046,187.5
"10702","32100","2019",2,2,0,82115,1130.5,78.5
"10703","32101","2019",1,1,0,111000,1110,100
"10704","32102","2019",3,3,0,154166.666666667,1393,112.333333333333
"10705","32103","2019",4,4,0,139762.5,1203.25,114.5
"10706","32104","2019",1,1,0,210000,1680,125
"10707","32106","2019",12,11,1,157865.333333333,1585.5,104.166666666667
"10708","32107","2019",98,89,9,132524.06122449,1285.82653061224,104.857142857143
"10709","32108","2019",1,1,0,160000,627,255
"10710","32109","2019",3,3,0,195333.333333333,1364,141
"10711","32110","2019",3,3,0,143800,1916.66666666667,74.3333333333333
"10712","32111","2019",1,1,0,540000,1459,370
"10713","32112","2019",4,4,0,130875,1131.75,116
"10714","32113","2019",1,1,0,45000,391,115
"10715","32114","2019",2,2,0,139500,1756,77.5
"10716","32115","2019",4,4,0,99475,1076.75,97
"10717","32116","2019",1,1,0,80000,400,200
"10718","32117","2019",11,11,0,187828.636363636,1974.36363636364,95.7272727272727
"10719","32119","2019",48,44,4,139545.0625,1434.20833333333,99.3333333333333
"10720","32120","2019",7,7,0,195411.428571429,1598.14285714286,123.142857142857
"10721","32121","2019",10,10,0,328680,2121.8,167
"10722","32122","2019",2,2,0,177250,1346.5,153.5
"10723","32123","2019",3,3,0,206000,1908.66666666667,120
"10724","32124","2019",2,2,0,152850,1317.5,116
"10725","32125","2019",1,1,0,200400,1698,118
"10726","32126","2019",5,5,0,147749,1023.4,159.4
"10727","32127","2019",10,10,0,90453.8,1062.6,93.1
"10728","32128","2019",2,2,0,241600,1636.5,146
"10729","32129","2019",1,1,0,379510,2530,150
"10730","32130","2019",2,2,0,191750,1878.5,95
"10731","32131","2019",2,2,0,195250,961,149.5
"10732","32132","2019",100,88,12,117098.5,1264.37,99.08
"10733","32133","2019",4,4,0,150875,954.5,157.75
"10734","32134","2019",3,3,0,227433.333333333,1822,126.666666666667
"10735","32135","2019",1,1,0,46000,597,77
"10736","32136","2019",2,2,0,184400,1401.5,135
"10737","32138","2019",1,1,0,175000,761,230
"10738","32139","2019",2,2,0,73750,467.5,157.5
"10739","32140","2019",5,5,0,220446,2197.2,101.2
"10740","32142","2019",1,1,0,118000,7375,16
"10741","32143","2019",3,3,0,284666.666666667,1126.66666666667,209.666666666667
"10742","32144","2019",1,1,0,85000,607,140
"10743","32145","2019",1,1,0,183800,1955,94
"10744","32146","2019",1,1,0,55000,797,69
"10745","32147","2019",39,35,4,133178.769230769,1518.15384615385,92.1282051282051
"10746","32149","2019",16,15,1,114903.75,1076.5,111.3125
"10747","32150","2019",2,2,0,163000,1524.5,108.5
"10748","32151","2019",3,3,0,181666.666666667,1461.66666666667,138.333333333333
"10749","32152","2019",1,1,0,110000,1310,84
"10750","32153","2019",1,1,0,210800,1757,120
"10751","32154","2019",2,2,0,137000,991.5,135
"10752","32155","2019",10,10,0,125440,1261.9,120.5
"10753","32156","2019",1,1,0,251353,1561,161
"10754","32158","2019",2,2,0,108750,971,110.5
"10755","32159","2019",9,9,0,102677.777777778,1067,107
"10756","32160","2019",139,88,51,181691.151079137,2067.45323741007,85.7625899280576
"10757","32162","2019",14,14,0,117300,1023.14285714286,119.714285714286
"10758","32163","2019",7,7,0,146528.571428571,1194.42857142857,124
"10759","32164","2019",1,1,0,176600,1083,163
"10760","32165","2019",2,2,0,176900,1582,115.5
"10761","32166","2019",2,2,0,85000,1308.5,64
"10762","32167","2019",8,8,0,105750,1124.25,93.625
"10763","32169","2019",1,1,0,226000,1614,140
"10764","32170","2019",3,3,0,140066.666666667,1166.33333333333,121
"10765","32171","2019",2,2,0,231792.5,2054,119.5
"10766","32172","2019",3,3,0,158666.666666667,1091.33333333333,161.666666666667
"10767","32173","2019",1,1,0,260000,3059,85
"10768","32174","2019",4,4,0,116387.5,958.75,126.5
"10769","32175","2019",1,1,0,291850,1145,255
"10770","32176","2019",2,2,0,95500,821,116.5
"10771","32180","2019",10,10,0,162572.9,1081.1,147
"10772","32181","2019",3,3,0,146666.666666667,1149,142
"10773","32182","2019",2,2,0,100800,950,106
"10774","32183","2019",3,3,0,258983.333333333,2015.33333333333,130
"10775","32185","2019",1,1,0,215800,1635,132
"10776","32187","2019",1,1,0,2e+05,1389,144
"10777","32188","2019",1,1,0,78500,1869,42
"10778","32189","2019",3,3,0,120366.666666667,827,153.666666666667
"10779","32190","2019",7,7,0,119700,995.142857142857,119.571428571429
"10780","32191","2019",2,2,0,186039.5,1473.5,126.5
"10781","32192","2019",3,3,0,148733.333333333,1489.66666666667,114.333333333333
"10782","32193","2019",5,5,0,139188,1377,97.6
"10783","32194","2019",3,3,0,367556.666666667,2093.66666666667,168.666666666667
"10784","32195","2019",2,1,1,111500,573,169.5
"10785","32196","2019",2,2,0,260247.5,1170.5,193.5
"10786","32197","2019",1,1,0,280000,1818,154
"10787","32198","2019",1,1,0,70000,933,75
"10788","32199","2019",5,5,0,206814,1332,147.2
"10789","32200","2019",3,3,0,218500,1635.33333333333,132.666666666667
"10790","32201","2019",2,2,0,180800,1485.5,123
"10791","32202","2019",2,2,0,107500,1146,95.5
"10792","32203","2019",1,1,0,57500,1917,30
"10793","32204","2019",5,5,0,175908.8,2030.2,89
"10794","32205","2019",2,2,0,179250,1551,118
"10795","32206","2019",3,3,0,179680,1448.33333333333,137.666666666667
"10796","32207","2019",4,4,0,185950,1513,119.75
"10797","32208","2019",63,52,11,150612.222222222,1620.5873015873,98.4285714285714
"10798","32209","2019",3,3,0,159049.666666667,1822,92.3333333333333
"10799","32210","2019",2,2,0,289500,3645.5,79
"10800","32211","2019",1,1,0,160000,1702,94
"10801","32212","2019",2,2,0,153500,861.5,165
"10802","32213","2019",54,51,3,149054.277777778,1504.59259259259,103.259259259259
"10803","32215","2019",2,2,0,117500,1120.5,111
"10804","32217","2019",1,1,0,269000,1978,136
"10805","32219","2019",4,4,0,200825,934.25,221.5
"10806","32220","2019",3,3,0,144666.666666667,1494.33333333333,91
"10807","32221","2019",1,1,0,185000,2056,90
"10808","32222","2019",2,2,0,61000,408.5,135
"10809","32224","2019",1,1,0,180000,1475,122
"10810","32226","2019",1,1,0,130000,977,133
"10811","32227","2019",11,11,0,108103.636363636,1282.27272727273,104
"10812","32228","2019",2,2,0,132500,865.5,149.5
"10813","32229","2019",3,3,0,239953.333333333,1323.33333333333,190
"10814","32231","2019",4,4,0,114250,1085,104
"10815","32233","2019",13,8,5,85002.3076923077,1317.15384615385,60.4615384615385
"10816","32234","2019",3,3,0,355933.333333333,2111.33333333333,169.333333333333
"10817","32235","2019",1,1,0,115000,865,133
"10818","32236","2019",1,1,0,148800,1329,112
"10819","32237","2019",8,8,0,187093.125,1676.125,113.875
"10820","32239","2019",9,9,0,339020,2099.66666666667,145.777777777778
"10821","32241","2019",2,2,0,108935,948,97.5
"10822","32242","2019",24,21,3,120822.916666667,1187.75,105.083333333333
"10823","32244","2019",3,3,0,141000,1330.33333333333,133.666666666667
"10824","32246","2019",3,3,0,130000,1076.66666666667,116.333333333333
"10825","32248","2019",2,2,0,288470,1643,165
"10826","32249","2019",34,32,2,160539.617647059,1556,100.382352941176
"10827","32252","2019",25,25,0,134769.96,1101.6,123.6
"10828","32253","2019",5,5,0,128779,1108.8,143.6
"10829","32254","2019",4,4,0,182650,1389.25,137.75
"10830","32255","2019",2,2,0,138000,1175.5,119
"10831","32256","2019",37,37,0,118628,1201.83783783784,99.3243243243243
"10832","32257","2019",1,1,0,303900,950,320
"10833","32258","2019",5,5,0,126338.4,1215.8,105.6
"10834","32260","2019",2,2,0,455072.5,2386,182
"10835","32262","2019",4,4,0,274919,1258.5,263.5
"10836","32263","2019",3,3,0,114000,990,116.333333333333
"10837","32266","2019",3,3,0,202000,1626.66666666667,119.333333333333
"10838","32268","2019",7,6,1,250935.714285714,2479.57142857143,101.428571428571
"10839","32269","2019",4,4,0,160242.5,1497,107.5
"10840","32271","2019",4,4,0,85275,1275.5,70.5
"10841","32274","2019",3,3,0,112633.333333333,1584.66666666667,71.6666666666667
"10842","32275","2019",1,1,0,255000,1645,155
"10843","32276","2019",1,1,0,187600,1513,124
"10844","32277","2019",1,1,0,203040,2603,78
"10845","32278","2019",1,1,0,180365,2122,85
"10846","32279","2019",3,3,0,124166.666666667,827.666666666667,136.333333333333
"10847","32280","2019",1,1,0,625000,1562,400
"10848","32281","2019",2,2,0,133500,1038,124.5
"10849","32282","2019",7,7,0,199442.857142857,1919.14285714286,107
"10850","32283","2019",5,5,0,157918.6,838.4,183.4
"10851","32284","2019",1,1,0,135000,1274,106
"10852","32285","2019",7,7,0,144751.428571429,1171,128.428571428571
"10853","32286","2019",4,4,0,127250,1361.25,97.75
"10854","32287","2019",2,2,0,40000,482,83
"10855","32288","2019",2,2,0,192550,1329,144.5
"10856","32289","2019",3,3,0,166856.666666667,1500.66666666667,117.666666666667
"10857","32290","2019",19,19,0,149995.894736842,1358.57894736842,124.894736842105
"10858","32291","2019",4,4,0,165125,1358.75,127
"10859","32292","2019",7,7,0,119428.571428571,1266.71428571429,102.571428571429
"10860","32293","2019",2,2,0,71000,1021,70
"10861","32295","2019",4,4,0,182645,2245,89.75
"10862","32296","2019",32,30,2,103126.5625,1158.875,96.9375
"10863","32297","2019",3,3,0,147333.333333333,1214.66666666667,121.666666666667
"10864","32298","2019",3,3,0,155333.333333333,1178,133
"10865","32300","2019",3,3,0,197000,1680.33333333333,116.666666666667
"10866","32301","2019",7,7,0,188035.714285714,1709.71428571429,114
"10867","32302","2019",3,3,0,160233.333333333,1498.33333333333,116
"10868","32303","2019",1,1,0,98000,754,130
"10869","32304","2019",2,2,0,180000,2052,88
"10870","32305","2019",4,4,0,104042,821.75,125.5
"10871","32306","2019",5,5,0,344569.2,2468.4,135.6
"10872","32307","2019",33,30,3,156169.878787879,1634.69696969697,97.8787878787879
"10873","32308","2019",1,1,0,167950,1527,110
"10874","32309","2019",2,2,0,212000,2475.5,86
"10875","32310","2019",2,2,0,114000,1037,116
"10876","32311","2019",4,4,0,229300,1653.75,137.25
"10877","32312","2019",5,3,2,141780,1617.8,83
"10878","32313","2019",1,1,0,247500,1650,150
"10879","32315","2019",1,1,0,70000,389,180
"10880","32316","2019",2,2,0,172525,1404.5,132.5
"10881","32319","2019",19,19,0,113683.736842105,995.842105263158,113.631578947368
"10882","32321","2019",3,3,0,108000,1004,119.666666666667
"10883","32322","2019",4,4,0,150154.75,1357.75,106
"10884","32323","2019",1,1,0,220000,1257,175
"10885","32324","2019",1,1,0,225000,1415,159
"10886","32325","2019",2,2,0,145000,1033.5,143
"10887","32326","2019",3,3,0,162666.666666667,1172.66666666667,136.666666666667
"10888","32328","2019",3,3,0,210678.333333333,1096.66666666667,167.666666666667
"10889","32329","2019",1,1,0,202930,1879,108
"10890","32330","2019",4,4,0,153650,1580.75,118
"10891","32331","2019",17,11,6,133961.764705882,1461.88235294118,86.0588235294118
"10892","32332","2019",3,3,0,230000,2786,124
"10893","32333","2019",6,6,0,149745,1413.33333333333,115.333333333333
"10894","32334","2019",21,20,1,271478.571428571,2596.19047619048,108.571428571429
"10895","32335","2019",7,7,0,162514.285714286,1303.57142857143,126.571428571429
"10896","32337","2019",1,1,0,130000,730,178
"10897","32338","2019",1,1,0,97000,1293,75
"10898","32339","2019",2,2,0,206100,1969,107.5
"10899","32340","2019",3,3,0,158133.333333333,1558,105
"10900","32341","2019",2,2,0,120500,651.5,183
"10901","32342","2019",2,2,0,131500,1697.5,77.5
"10902","32343","2019",1,1,0,67000,753,89
"10903","32344","2019",23,23,0,127537.434782609,1227.69565217391,107.782608695652
"10904","32345","2019",9,9,0,222161.111111111,1770.66666666667,116.666666666667
"10905","32346","2019",3,3,0,262833.333333333,3924.66666666667,96
"10906","32347","2019",4,4,0,128775,1480.25,86
"10907","32348","2019",11,11,0,190204.545454545,1835.45454545455,116.090909090909
"10908","32349","2019",2,2,0,296170,2449,121
"10909","32351","2019",1,1,0,71648,702,102
"10910","32352","2019",3,3,0,196333.333333333,1494,139.333333333333
"10911","32354","2019",1,1,0,92000,920,100
"10912","32355","2019",2,2,0,317869.5,1178,280
"10913","32356","2019",1,1,0,230000,2371,97
"10914","32358","2019",2,2,0,113350,1139.5,96
"10915","32360","2019",3,3,0,109333.333333333,1055,101.666666666667
"10916","32362","2019",4,4,0,134250,1014.5,132.25
"10917","32363","2019",1,1,0,91800,600,153
"10918","32364","2019",2,2,0,162500,1879,85
"10919","32365","2019",4,4,0,169947.5,1827,98.75
"10920","32366","2019",1,1,0,180000,706,255
"10921","32369","2019",4,4,0,83500,981,85.75
"10922","32370","2019",19,18,1,131013.157894737,1066.31578947368,125.736842105263
"10923","32371","2019",1,1,0,117000,585,200
"10924","32372","2019",6,6,0,185050,1853,99.3333333333333
"10925","32373","2019",2,2,0,94000,1271,90
"10926","32374","2019",3,3,0,231333.333333333,1455.33333333333,161
"10927","32376","2019",1,1,0,125000,893,140
"10928","32377","2019",4,4,0,189371.25,1523,140.5
"10929","32378","2019",1,1,0,122000,1544,79
"10930","32379","2019",5,5,0,216767.8,2171.4,107.2
"10931","32380","2019",1,1,0,67000,670,100
"10932","32381","2019",3,3,0,130466.666666667,1496.66666666667,106
"10933","32382","2019",5,5,0,137000,1244.8,111.6
"10934","32383","2019",3,3,0,165170,1179.33333333333,141.666666666667
"10935","32384","2019",5,5,0,184600,1579.8,113.6
"10936","32385","2019",2,2,0,295000,2414,125
"10937","32387","2019",1,1,0,168350,1603,105
"10938","32388","2019",3,3,0,192166.666666667,1513.66666666667,128
"10939","32389","2019",3,3,0,159983.333333333,1495.66666666667,94.3333333333333
"10940","32390","2019",2,2,0,121500,1148,105.5
"10941","32391","2019",1,1,0,109767,1372,80
"10942","32392","2019",3,3,0,167138.333333333,1001.33333333333,172
"10943","32393","2019",1,1,0,79000,338,234
"10944","32394","2019",1,1,0,103000,730,141
"10945","32395","2019",1,1,0,177750,1279,139
"10946","32396","2019",2,2,0,359000,2095.5,160
"10947","32397","2019",3,3,0,155666.666666667,846.666666666667,185
"10948","32398","2019",1,1,0,140000,824,170
"10949","32399","2019",1,1,0,105000,1312,80
"10950","32400","2019",2,2,0,127500,1401,83.5
"10951","32402","2019",1,1,0,178900,1234,145
"10952","32404","2019",3,3,0,361500,1989,186
"10953","32405","2019",1,1,0,164000,1291,127
"10954","32406","2019",5,5,0,128120,1153.2,126.8
"10955","32407","2019",2,2,0,232265,1832.5,129.5
"10956","32408","2019",2,2,0,203498.5,1649,128.5
"10957","32409","2019",1,1,0,85000,607,140
"10958","32410","2019",36,35,1,185831.388888889,1680.80555555556,116.916666666667
"10959","32412","2019",18,18,0,123156.666666667,1427.55555555556,92.4444444444444
"10960","32414","2019",3,3,0,152500,1639,110
"10961","32416","2019",10,10,0,149871,1631.2,103.6
"10962","32417","2019",7,7,0,164800,1114.42857142857,144
"10963","32418","2019",5,5,0,139680,915,160.4
"10964","32421","2019",2,2,0,206500,1938.5,117
"10965","32423","2019",1,1,0,115000,2347,49
"10966","32424","2019",1,1,0,150000,1765,85
"10967","32425","2019",20,20,0,257136.35,2321.4,114.65
"10968","32426","2019",15,15,0,131938.666666667,1173.4,120.8
"10969","32429","2019",7,7,0,169313.857142857,1600.57142857143,110.285714285714
"10970","32432","2019",1,1,0,197000,1642,120
"10971","32433","2019",9,9,0,139166.666666667,1280.44444444444,108.111111111111
"10972","32434","2019",1,1,0,79000,658,120
"10973","32435","2019",1,1,0,529100,3890,136
"10974","32436","2019",5,5,0,115700,1145.2,115.4
"10975","32437","2019",2,2,0,86500,867.5,108
"10976","32438","2019",1,1,0,60000,451,133
"10977","32439","2019",4,4,0,114375,2879.25,107.75
"10978","32440","2019",2,2,0,140025,1090.5,133
"10979","32442","2019",5,5,0,230292,1679.6,144.8
"10980","32443","2019",8,8,0,111177.5,882.125,121.25
"10981","32444","2019",1,1,0,311100,1874,166
"10982","32446","2019",4,4,0,131405,1406.25,91
"10983","32448","2019",5,5,0,150026,1219.4,122.4
"10984","32449","2019",1,1,0,1e+05,833,120
"10985","32450","2019",1,1,0,75000,469,160
"10986","32452","2019",2,2,0,52750,598.5,82
"10987","32453","2019",1,1,0,75000,573,131
"10988","32454","2019",1,1,0,350345,2098,167
"10989","32455","2019",3,3,0,152500,878.666666666667,174
"10990","32457","2019",1,1,0,270000,1800,150
"10991","32458","2019",4,4,0,84000,997.5,82
"10992","32459","2019",13,13,0,120200.846153846,1106.69230769231,104.384615384615
"10993","32460","2019",5,5,0,256100,1547,150.8
"10994","32461","2019",1,1,0,133000,532,250
"10995","32462","2019",54,53,1,119435.62962963,1140.31481481481,99.5555555555556
"10996","32463","2019",12,12,0,97612.5,999.333333333333,101.75
"10997","32464","2019",7,7,0,170750,1359.14285714286,123.428571428571
"10998","32465","2019",2,2,0,301085,2446.5,126
"10999","32466","2019",1,1,0,158000,1436,110
"11000","32467","2019",1,1,0,209800,2037,103
"11001","32468","2019",1,1,0,87200,513,170
"11002","33001","2019",26,26,0,146987.884615385,1404.76923076923,112.076923076923
"11003","33002","2019",9,9,0,249478.333333333,1413,185.444444444444
"11004","33003","2019",179,157,22,226190.206703911,2581.63687150838,92.1843575418994
"11005","33004","2019",41,39,2,168396.43902439,1831.80487804878,96.4634146341463
"11006","33005","2019",244,189,55,365279.446721311,4500.84836065574,85.5819672131148
"11007","33006","2019",14,14,0,123042.857142857,1374.14285714286,101.214285714286
"11008","33007","2019",15,15,0,256261.333333333,2439.46666666667,105.333333333333
"11009","33008","2019",6,6,0,183337.666666667,1784.33333333333,103.5
"11010","33009","2019",602,161,441,432209.07807309,6420.33388704319,66.4435215946844
"11011","33010","2019",13,13,0,214874.615384615,2125,98.9230769230769
"11012","33011","2019",153,119,34,315374.745098039,3988.24183006536,80.4640522875817
"11013","33012","2019",38,38,0,296146.763157895,2702.44736842105,109.789473684211
"11014","33013","2019",105,79,26,288822.6,3025.95238095238,95.8857142857143
"11015","33014","2019",11,11,0,197340.909090909,2108,93.7272727272727
"11016","33015","2019",20,19,1,199650,2253.65,89.7
"11017","33016","2019",7,7,0,224444.285714286,2012.14285714286,142.714285714286
"11018","33017","2019",4,4,0,165000,1488.25,104.5
"11019","33018","2019",44,41,3,205630.409090909,1968.63636363636,111.159090909091
"11020","33019","2019",161,122,39,272823.900621118,3098.39130434783,89.5527950310559
"11021","33021","2019",16,15,1,189278.4375,1904,107.6875
"11022","33022","2019",53,49,4,238655.094339623,2431.52830188679,98.9433962264151
"11023","33023","2019",11,11,0,281518.181818182,2511.18181818182,117.818181818182
"11024","33024","2019",4,4,0,152250,1411.25,115.5
"11025","33025","2019",6,6,0,205501.666666667,1885.33333333333,116.833333333333
"11026","33026","2019",11,11,0,164772.727272727,1674.36363636364,101.727272727273
"11027","33027","2019",4,4,0,221125,1333,176.75
"11028","33028","2019",9,9,0,298000,2651.88888888889,112.888888888889
"11029","33029","2019",82,60,22,253189.585365854,2710.79268292683,93.8780487804878
"11030","33030","2019",43,40,3,142988.372093023,1513.27906976744,97.046511627907
"11031","33031","2019",1,1,0,339000,1237,274
"11032","33032","2019",58,43,15,212499.103448276,2904.93103448276,75.4137931034483
"11033","33033","2019",12,12,0,325150,3467.08333333333,96.25
"11034","33034","2019",4,4,0,150125,1352.5,117
"11035","33035","2019",12,12,0,131345.833333333,1382.83333333333,91.75
"11036","33036","2019",61,56,5,178967.590163934,1702.86885245902,107.114754098361
"11037","33037","2019",26,24,2,254131.346153846,2820.15384615385,90.3461538461538
"11038","33038","2019",11,11,0,191949.727272727,1591.54545454545,134.363636363636
"11039","33039","2019",435,231,204,269632.620689655,3632.73103448276,74.0252873563218
"11040","33040","2019",20,20,0,144750.1,1394.35,104.8
"11041","33042","2019",76,72,4,250804.907894737,2445.86842105263,103.907894736842
"11042","33043","2019",3,3,0,152450,1702,96.6666666666667
"11043","33045","2019",2,2,0,120000,1155.5,114
"11044","33046","2019",14,14,0,154969.642857143,1416.85714285714,122.357142857143
"11045","33047","2019",16,16,0,139830.75,1433.3125,101.625
"11046","33048","2019",1,1,0,136000,764,178
"11047","33049","2019",29,29,0,250986.379310345,2479.89655172414,104.655172413793
"11048","33050","2019",3,3,0,189500,2284.33333333333,89
"11049","33051","2019",173,124,49,259037.485549133,3138.85549132948,83.4450867052023
"11050","33052","2019",20,10,10,139685,1791,77.1
"11051","33053","2019",3,3,0,303802.666666667,2599.66666666667,129.333333333333
"11052","33054","2019",4,4,0,194250,1043.25,181.25
"11053","33055","2019",8,8,0,194681.25,1789.75,106.625
"11054","33056","2019",179,117,62,273724.497206704,3175.6312849162,86.5586592178771
"11055","33057","2019",10,10,0,138802,1248.9,110.7
"11056","33058","2019",98,79,19,127409.744897959,1401.40816326531,92.5
"11057","33059","2019",1,1,0,258000,2580,100
"11058","33060","2019",4,4,0,213000,1862,113.5
"11059","33061","2019",17,17,0,320191.176470588,2559.23529411765,128.529411764706
"11060","33062","2019",8,8,0,186371.75,1622.125,118.875
"11061","33063","2019",4818,1245,3573,322258.134288086,4628.70112079701,70.3246160232462
"11062","33065","2019",39,39,0,461624.358974359,3392.69230769231,142.948717948718
"11063","33067","2019",27,24,3,155885.925925926,1406.14814814815,113.074074074074
"11064","33069","2019",399,199,200,385417.929824561,4253.67418546366,88.874686716792
"11065","33070","2019",11,11,0,270090.909090909,2329.81818181818,123.272727272727
"11066","33071","2019",14,14,0,176425,1728.42857142857,107.785714285714
"11067","33072","2019",3,3,0,206900,2040.66666666667,103
"11068","33073","2019",21,21,0,115627,1126.71428571429,102.619047619048
"11069","33074","2019",1,1,0,295000,2543,116
"11070","33075","2019",336,149,187,275685.270833333,3501.09523809524,78.2678571428571
"11071","33076","2019",6,6,0,202400,1928,103.666666666667
"11072","33077","2019",31,31,0,262869.35483871,2441,108.193548387097
"11073","33078","2019",10,10,0,159581.9,1631.5,102.4
"11074","33079","2019",5,5,0,340549,2238.2,161.6
"11075","33080","2019",75,62,13,299743.106666667,3193.06666666667,94.5733333333333
"11076","33081","2019",39,28,11,164458.333333333,2079.23076923077,91.7692307692308
"11077","33082","2019",8,8,0,229512.5,2261.375,103.25
"11078","33083","2019",12,12,0,297970.833333333,2100.08333333333,147
"11079","33084","2019",29,25,4,243351.689655172,2661.48275862069,95.3793103448276
"11080","33085","2019",35,34,1,346714.428571429,2827.94285714286,116.571428571429
"11081","33086","2019",8,8,0,284781.25,3044.125,92.75
"11082","33087","2019",6,6,0,103440.833333333,869.5,127.166666666667
"11083","33088","2019",13,13,0,149117.692307692,1599.15384615385,96.3076923076923
"11084","33089","2019",6,6,0,119591.666666667,1255.5,96.1666666666667
"11085","33090","2019",65,61,4,354480.015384615,3502.44615384615,103.184615384615
"11086","33093","2019",9,9,0,236398.888888889,2213.55555555556,108.444444444444
"11087","33094","2019",4,4,0,339725,1575.5,160.25
"11088","33095","2019",26,26,0,124613.461538462,1265.65384615385,107.423076923077
"11089","33096","2019",107,63,44,221154.485981308,3183.78504672897,80.8411214953271
"11090","33097","2019",129,64,65,180070.534883721,3212.06201550388,59.8837209302326
"11091","33098","2019",2,2,0,201000,1511,128.5
"11092","33099","2019",35,35,0,358859.142857143,3286.11428571429,110.628571428571
"11093","33100","2019",16,15,1,122482.8125,1146.875,121.4375
"11094","33101","2019",16,16,0,147608.75,1241.8125,121.75
"11095","33102","2019",5,5,0,203426,1480,126.8
"11096","33103","2019",3,3,0,113833.333333333,1109,101.666666666667
"11097","33104","2019",83,62,21,191568.939759036,2262.95180722892,88.1084337349398
"11098","33105","2019",3,3,0,158770.666666667,1234,129.666666666667
"11099","33106","2019",24,24,0,155308.458333333,1415.75,113.5
"11100","33108","2019",41,41,0,113167.829268293,1234.53658536585,97
"11101","33109","2019",30,30,0,240903.5,2525.2,98.5333333333333
"11102","33111","2019",23,23,0,133275.217391304,1205,116.304347826087
"11103","33112","2019",1,1,0,195000,1560,125
"11104","33114","2019",53,39,14,149244.377358491,1673.35849056604,90.6792452830189
"11105","33115","2019",3,3,0,252666.666666667,1446.33333333333,181.666666666667
"11106","33116","2019",6,6,0,181511.666666667,1748.83333333333,106.666666666667
"11107","33117","2019",4,4,0,257684.25,1528.25,147.75
"11108","33118","2019",28,28,0,351741.392857143,3062.85714285714,116.142857142857
"11109","33119","2019",303,138,165,207221.062706271,3028.30693069307,69.5082508250825
"11110","33120","2019",25,25,0,187431.56,1807,105.04
"11111","33121","2019",5,5,0,194400,2052.8,96.8
"11112","33122","2019",158,150,8,370786.487341772,3411.32278481013,112.981012658228
"11113","33123","2019",42,41,1,183532.547619048,1698.21428571429,111.761904761905
"11114","33124","2019",12,12,0,136018.75,1322.66666666667,102
"11115","33125","2019",29,29,0,178145.793103448,1798.55172413793,98.6551724137931
"11116","33126","2019",7,7,0,137722.857142857,1414.71428571429,96.8571428571429
"11117","33127","2019",2,2,0,201500,1462,127
"11118","33128","2019",12,12,0,222374.166666667,1955.91666666667,108.166666666667
"11119","33129","2019",3,3,0,134558.666666667,1259.66666666667,107
"11120","33130","2019",12,12,0,263491.833333333,2025.33333333333,132.916666666667
"11121","33131","2019",4,4,0,163125,1379.25,141.75
"11122","33132","2019",6,6,0,160016.666666667,1745.66666666667,98.5
"11123","33134","2019",3,3,0,243383.333333333,1821,134.666666666667
"11124","33136","2019",3,3,0,283293.333333333,1408.33333333333,210.333333333333
"11125","33137","2019",1,1,0,208375,1555,134
"11126","33138","2019",150,117,33,133930.813333333,1516.68666666667,89.8466666666667
"11127","33140","2019",102,75,27,185634.039215686,2315.86274509804,79.8529411764706
"11128","33141","2019",9,9,0,289503.333333333,2418.55555555556,118.666666666667
"11129","33142","2019",21,20,1,196625.761904762,1829.42857142857,106.380952380952
"11130","33143","2019",20,19,1,204480.75,2011.45,113.4
"11131","33144","2019",9,9,0,167000,1400.11111111111,123.666666666667
"11132","33145","2019",4,4,0,241265.5,2543.25,97.5
"11133","33146","2019",31,31,0,193540.419354839,1833.93548387097,109.096774193548
"11134","33147","2019",4,4,0,236818.75,2431.5,104.5
"11135","33148","2019",1,1,0,90000,500,180
"11136","33149","2019",1,1,0,480000,2857,168
"11137","33150","2019",4,4,0,135625,1141,123
"11138","33151","2019",11,11,0,103190.909090909,1366.18181818182,87.0909090909091
"11139","33152","2019",1,1,0,108000,1440,75
"11140","33153","2019",8,8,0,139114.375,1553,96.375
"11141","33154","2019",28,27,1,101278.678571429,1188.57142857143,86.8214285714286
"11142","33155","2019",1,1,0,210000,1296,162
"11143","33156","2019",2,2,0,310893,2209,141
"11144","33157","2019",2,2,0,302500,2577,114.5
"11145","33158","2019",2,2,0,195500,1648,120
"11146","33159","2019",24,21,3,100236.25,1149.04166666667,86.1666666666667
"11147","33160","2019",9,9,0,114953.666666667,1223.77777777778,91
"11148","33161","2019",10,10,0,112990.2,1168.2,93
"11149","33162","2019",307,176,131,274878.267100977,3363.51791530945,81.0228013029316
"11150","33163","2019",5,5,0,158850,1421.8,121.8
"11151","33164","2019",21,21,0,186462.095238095,1848.33333333333,106.571428571429
"11152","33165","2019",60,30,30,242389.866666667,3009.91666666667,80.75
"11153","33166","2019",10,10,0,141709.7,1439.3,96
"11154","33167","2019",170,105,65,247005.558823529,3284.44705882353,77.8764705882353
"11155","33168","2019",8,8,0,165800,1455.625,109
"11156","33169","2019",1,1,0,220000,2157,102
"11157","33170","2019",10,10,0,180010,1949.5,95.7
"11158","33171","2019",2,2,0,347175,1361,201.5
"11159","33172","2019",5,5,0,186612,2198.6,85.8
"11160","33173","2019",2,2,0,190947.5,1517.5,125.5
"11161","33174","2019",19,19,0,261377.315789474,1948.05263157895,117
"11162","33175","2019",12,12,0,140177.5,1539.75,95.75
"11163","33176","2019",5,5,0,121381.6,1327,109.6
"11164","33177","2019",31,31,0,181339.322580645,1890.09677419355,108.483870967742
"11165","33178","2019",5,5,0,217579,2211.8,94.4
"11166","33179","2019",42,35,7,179088.904761905,1990.21428571429,91.3095238095238
"11167","33180","2019",1,1,0,230000,3108,74
"11168","33181","2019",8,7,1,174277.625,1457.625,115.125
"11169","33182","2019",11,11,0,181354.545454545,1680.09090909091,111.909090909091
"11170","33183","2019",20,20,0,205895.3,1981.85,111.2
"11171","33184","2019",5,5,0,163800,1396.8,118.4
"11172","33185","2019",21,15,6,170680.952380952,1818.61904761905,102.571428571429
"11173","33186","2019",13,13,0,151085,1044.46153846154,137.923076923077
"11174","33187","2019",14,13,1,116607.5,1258.07142857143,97.6428571428571
"11175","33188","2019",3,3,0,183400,1595.66666666667,115
"11176","33189","2019",6,6,0,198933.333333333,1997.33333333333,100.666666666667
"11177","33190","2019",2,2,0,167750,1131.5,158
"11178","33191","2019",10,10,0,102237,1159.7,88.8
"11179","33192","2019",332,159,173,263354.876506024,3424.42168674699,78.1686746987952
"11180","33193","2019",27,27,0,188026.074074074,2117.96296296296,91.1111111111111
"11181","33194","2019",14,13,1,199942.142857143,2163.71428571429,101.928571428571
"11182","33195","2019",22,20,2,130604.545454545,1247.54545454545,113.409090909091
"11183","33196","2019",3,3,0,143333.333333333,1199.33333333333,122
"11184","33197","2019",8,8,0,184206.25,1769.875,107.5
"11185","33198","2019",27,23,4,126075.925925926,1415.07407407407,90.6296296296296
"11186","33199","2019",441,330,111,343652.188208617,3974.49659863946,86.6961451247166
"11187","33200","2019",120,78,42,294104.491666667,3490.61666666667,84.075
"11188","33201","2019",19,16,3,176622.631578947,2085.36842105263,81.6315789473684
"11189","33202","2019",19,19,0,189011.105263158,2249.57894736842,85.5263157894737
"11190","33203","2019",147,106,41,174875.217687075,2651.44897959184,69.0884353741497
"11191","33204","2019",8,8,0,124952.5,1093.125,117.125
"11192","33205","2019",16,16,0,234084.375,1947.125,112.375
"11193","33206","2019",11,10,1,224516.363636364,2084.18181818182,110.636363636364
"11194","33207","2019",92,91,1,228373.097826087,2290.34782608696,102.076086956522
"11195","33208","2019",22,22,0,120867.636363636,1345.59090909091,90.6363636363636
"11196","33209","2019",2,2,0,71500,946,76
"11197","33210","2019",1,1,0,130000,765,170
"11198","33211","2019",8,8,0,208448.75,1941.125,109.25
"11199","33212","2019",2,2,0,206000,1581.5,126.5
"11200","33213","2019",50,46,4,371454.54,3198.8,117.8
"11201","33214","2019",339,206,133,237085.646017699,3941.7197640118,61.1504424778761
"11202","33215","2019",1,1,0,15000,375,40
"11203","33216","2019",2,2,0,160410,1226.5,130
"11204","33218","2019",29,29,0,149290.310344828,1519.13793103448,100.689655172414
"11205","33219","2019",31,25,6,202473.870967742,2120.12903225806,96.4838709677419
"11206","33220","2019",24,23,1,171264.791666667,1816.125,97.375
"11207","33221","2019",15,15,0,123601.8,1122.26666666667,111.066666666667
"11208","33222","2019",7,7,0,249171.428571429,2350,118.714285714286
"11209","33223","2019",1,1,0,90000,1200,75
"11210","33224","2019",2,2,0,170000,984,166.5
"11211","33225","2019",31,29,2,206910.677419355,1945.12903225806,108.354838709677
"11212","33226","2019",40,33,7,193875.9,2147.7,97.075
"11213","33227","2019",139,83,56,152679.899280576,1791.40287769784,86.0215827338129
"11214","33228","2019",10,10,0,205044,1776.2,116.4
"11215","33229","2019",142,113,29,327058.436619718,3999.66197183099,84.8661971830986
"11216","33230","2019",5,5,0,154460,1595.4,110
"11217","33231","2019",1,1,0,165000,2062,80
"11218","33232","2019",1,1,0,152000,1583,96
"11219","33233","2019",47,47,0,181779.787234043,1625.97872340426,116.574468085106
"11220","33234","2019",49,44,5,446734.081632653,3673.81632653061,126.244897959184
"11221","33235","2019",1,1,0,1e+05,1124,89
"11222","33236","2019",223,180,43,732363.883408072,7587.94618834081,99.2825112107623
"11223","33237","2019",11,11,0,185759.090909091,1559.72727272727,123.363636363636
"11224","33238","2019",99,94,5,343371.191919192,3277.0505050505,105.030303030303
"11225","33239","2019",6,6,0,129516.666666667,1393.16666666667,109.333333333333
"11226","33240","2019",137,100,37,129245.313868613,1512.74452554745,88.6423357664234
"11227","33241","2019",11,11,0,152323.181818182,1762.36363636364,97.9090909090909
"11228","33242","2019",5,5,0,152400,1758.6,91.8
"11229","33243","2019",458,258,200,166080.862445415,2147.78602620087,78.1244541484716
"11230","33244","2019",3,3,0,233541.666666667,2173.33333333333,116.666666666667
"11231","33245","2019",7,7,0,386714.285714286,3150.71428571429,126.142857142857
"11232","33246","2019",1,1,0,215000,1344,160
"11233","33248","2019",33,33,0,211536,2166.57575757576,99.9393939393939
"11234","33249","2019",203,85,118,194624.167487685,2608.20689655172,74.2512315270936
"11235","33250","2019",4,4,0,174500,1233,141.75
"11236","33251","2019",7,7,0,213121.428571429,1864.42857142857,115.428571428571
"11237","33252","2019",8,8,0,289062.5,2831,108.375
"11238","33253","2019",11,10,1,221488.636363636,1931,118.363636363636
"11239","33254","2019",3,3,0,141000,1121.33333333333,123.333333333333
"11240","33255","2019",4,4,0,127462.5,1483.75,86.75
"11241","33256","2019",87,72,15,257694.954022989,2754.14942528736,97.6666666666667
"11242","33257","2019",6,6,0,247401.833333333,2028.66666666667,122.333333333333
"11243","33259","2019",19,19,0,196367.315789474,2034.10526315789,98.5263157894737
"11244","33260","2019",14,14,0,255513.785714286,2173,118.285714285714
"11245","33261","2019",18,18,0,193322.555555556,2155.5,101
"11246","33262","2019",61,59,2,217652.114754098,2501.91803278689,93.2131147540984
"11247","33263","2019",5,5,0,328202,2511.2,130.4
"11248","33264","2019",11,11,0,163222.727272727,1638.09090909091,108.909090909091
"11249","33266","2019",8,8,0,242171.25,1984.625,133.375
"11250","33268","2019",40,39,1,217642.45,2255.625,94.025
"11251","33269","2019",1,1,0,55000,688,80
"11252","33270","2019",1,1,0,130000,1757,74
"11253","33271","2019",2,2,0,157750,1345,119.5
"11254","33272","2019",20,20,0,195916.05,1811.2,112.9
"11255","33273","2019",75,60,15,305336.786666667,3402.78666666667,91.4933333333333
"11256","33274","2019",34,30,4,304203.588235294,2893.26470588235,106.441176470588
"11257","33275","2019",1,1,0,72000,800,90
"11258","33276","2019",3,3,0,242616.666666667,1217,210.333333333333
"11259","33277","2019",2,2,0,227500,2403,92.5
"11260","33278","2019",5,5,0,121572,1313.6,93.8
"11261","33279","2019",6,6,0,204000,2142.33333333333,100.5
"11262","33280","2019",6,6,0,140150,1264.83333333333,118.833333333333
"11263","33281","2019",1129,417,712,263507.927369353,3424.21700620018,76.5615589016829
"11264","33282","2019",4,4,0,247500,1782.75,137.75
"11265","33283","2019",2,2,0,202950,1485,140
"11266","33284","2019",153,141,12,300756.895424837,2973.88235294118,103
"11267","33285","2019",5,5,0,204300,1601.8,123.8
"11268","33287","2019",7,7,0,93271.4285714286,937.428571428571,102.285714285714
"11269","33288","2019",3,3,0,221666.666666667,1587,144.666666666667
"11270","33289","2019",19,17,2,137929.157894737,1206.57894736842,110.052631578947
"11271","33290","2019",18,17,1,239952.777777778,1784.38888888889,129.944444444444
"11272","33291","2019",1,1,0,92000,1643,56
"11273","33293","2019",32,29,3,265006.5,2527.3125,106.09375
"11274","33294","2019",4,4,0,128500,1339.75,94.75
"11275","33295","2019",1,1,0,160000,1667,96
"11276","33296","2019",11,11,0,148377.272727273,1406.18181818182,101.727272727273
"11277","33297","2019",25,24,1,202837.4,1893.36,112.6
"11278","33298","2019",12,12,0,245335.416666667,1777.41666666667,133.416666666667
"11279","33299","2019",4,4,0,166775,1659.5,102.5
"11280","33300","2019",12,12,0,196002.916666667,2379.75,87.25
"11281","33301","2019",9,9,0,224019.444444444,1956.33333333333,119.444444444444
"11282","33302","2019",2,1,1,172250,1774,104.5
"11283","33303","2019",6,6,0,246883.166666667,2276.16666666667,127.666666666667
"11284","33305","2019",8,8,0,146687.5,1557.875,93.75
"11285","33306","2019",3,3,0,104683.333333333,1293.33333333333,83
"11286","33307","2019",22,22,0,171475,1646.22727272727,108.454545454545
"11287","33308","2019",3,3,0,230833.333333333,2733.33333333333,87.6666666666667
"11288","33309","2019",7,7,0,113700,1154.71428571429,94.4285714285714
"11289","33310","2019",3,3,0,148333.333333333,1234.33333333333,136.333333333333
"11290","33311","2019",21,19,2,202119.333333333,1722.42857142857,118.333333333333
"11291","33312","2019",137,93,44,264396.832116788,3141.71532846715,83.9051094890511
"11292","33314","2019",74,67,7,138944,1458.14864864865,97.554054054054
"11293","33315","2019",17,17,0,133546.470588235,1260.23529411765,109.588235294118
"11294","33316","2019",13,13,0,107707.692307692,1091.84615384615,101.923076923077
"11295","33317","2019",15,15,0,192809.4,1845.26666666667,110.666666666667
"11296","33318","2019",759,468,291,307989.910408432,3669.55467720685,84.4624505928854
"11297","33319","2019",7,7,0,194551.428571429,1388.57142857143,147.857142857143
"11298","33320","2019",6,6,0,132083.333333333,1366.83333333333,95.6666666666667
"11299","33321","2019",24,24,0,216591.791666667,2235.16666666667,99.9166666666667
"11300","33322","2019",90,89,1,318785.622222222,3042.56666666667,108.366666666667
"11301","33323","2019",9,9,0,191659.444444444,1770,108
"11302","33324","2019",67,50,17,107946,1242.92537313433,85.6567164179104
"11303","33325","2019",10,10,0,145382.7,1650.9,89.7
"11304","33326","2019",6,6,0,93833.3333333333,1352.5,65
"11305","33327","2019",36,34,2,188816.972222222,2007.55555555556,98.1666666666667
"11306","33328","2019",8,8,0,203256.25,1846.75,115.375
"11307","33329","2019",1,1,0,178500,2746,65
"11308","33330","2019",34,30,4,397559.705882353,3108.5,125.441176470588
"11309","33331","2019",3,3,0,136621.333333333,1464.66666666667,90.3333333333333
"11310","33332","2019",19,19,0,143872.947368421,1300.57894736842,109.894736842105
"11311","33333","2019",34,34,0,304030.882352941,3010.91176470588,102.705882352941
"11312","33334","2019",28,26,2,234364.642857143,2250.75,110.035714285714
"11313","33335","2019",8,8,0,276468.75,3072,91.625
"11314","33336","2019",26,26,0,148466.923076923,1367.96153846154,116.192307692308
"11315","33337","2019",31,30,1,168785.483870968,1572.1935483871,120.838709677419
"11316","33339","2019",23,23,0,175810.869565217,1785.47826086957,101
"11317","33341","2019",32,31,1,172392.3125,1930.875,96.28125
"11318","33342","2019",13,13,0,280530.769230769,2577.30769230769,133.307692307692
"11319","33343","2019",13,13,0,181648.923076923,1655.38461538462,118.076923076923
"11320","33344","2019",14,14,0,161482.142857143,1696.71428571429,101.071428571429
"11321","33345","2019",6,6,0,153916.666666667,1262.16666666667,123.833333333333
"11322","33346","2019",9,9,0,201347,1360.55555555556,138.555555555556
"11323","33347","2019",3,3,0,146666.666666667,1214.33333333333,115
"11324","33348","2019",19,19,0,164481.578947368,1664.42105263158,100.842105263158
"11325","33349","2019",27,26,1,306892.592592593,2576.48148148148,121.518518518519
"11326","33350","2019",17,16,1,137274.352941176,1485.41176470588,89.6470588235294
"11327","33351","2019",16,16,0,141206.25,1236.9375,111.1875
"11328","33352","2019",53,51,2,123375.018867925,1213.20754716981,101.358490566038
"11329","33353","2019",4,4,0,133325,974,131.5
"11330","33355","2019",28,27,1,205427.071428571,1743.10714285714,117.25
"11331","33356","2019",2,1,1,135000,1340.5,102
"11332","33357","2019",19,19,0,259655.263157895,2271.36842105263,115.842105263158
"11333","33358","2019",5,5,0,177460,1644.6,126
"11334","33359","2019",6,6,0,179491.666666667,1172.83333333333,163
"11335","33360","2019",1,1,0,78000,1026,76
"11336","33361","2019",5,5,0,196718,1741.6,108.4
"11337","33362","2019",15,15,0,142453.333333333,1614.33333333333,92.6
"11338","33363","2019",53,52,1,261475.396226415,2559.43396226415,104.867924528302
"11339","33364","2019",1,1,0,295000,2950,100
"11340","33365","2019",2,2,0,336100,2549.5,130
"11341","33366","2019",176,139,37,198920.755681818,2245.36931818182,90.7272727272727
"11342","33367","2019",4,4,0,145250,1197.5,118
"11343","33369","2019",10,10,0,168087,1224.5,136.1
"11344","33370","2019",9,9,0,136166.666666667,1319.55555555556,103.222222222222
"11345","33373","2019",11,11,0,101909.090909091,942,106.454545454545
"11346","33374","2019",6,6,0,150291.666666667,1060.83333333333,138.166666666667
"11347","33375","2019",6,6,0,250862.833333333,1922.66666666667,126.333333333333
"11348","33376","2019",80,69,11,417296.1625,3450.95,123.3125
"11349","33378","2019",18,18,0,131648.5,1559.77777777778,88.3333333333333
"11350","33380","2019",16,16,0,129601.6875,1345.5,111.0625
"11351","33381","2019",38,37,1,288590.842105263,2796.84210526316,107.052631578947
"11352","33382","2019",21,21,0,145959.523809524,1415.42857142857,111.52380952381
"11353","33383","2019",9,9,0,218572.222222222,1662.44444444444,112.333333333333
"11354","33384","2019",4,4,0,419257.5,2140.25,169.75
"11355","33385","2019",5,5,0,190412.2,1351.8,135.4
"11356","33386","2019",1,1,0,83000,976,85
"11357","33387","2019",14,14,0,174739.285714286,1587.28571428571,112.714285714286
"11358","33388","2019",11,11,0,173927.272727273,1644.45454545455,109.272727272727
"11359","33389","2019",50,50,0,109265.06,1159.9,95.96
"11360","33390","2019",6,6,0,135166.666666667,1596.16666666667,87.1666666666667
"11361","33391","2019",3,3,0,183503.333333333,1650.66666666667,110.333333333333
"11362","33392","2019",13,13,0,169685.769230769,1541.84615384615,114.538461538462
"11363","33393","2019",85,74,11,179429.058823529,1743.44705882353,108.152941176471
"11364","33394","2019",19,19,0,252492.105263158,2577.89473684211,106.894736842105
"11365","33395","2019",33,33,0,136815.363636364,1321.90909090909,102.757575757576
"11366","33396","2019",1,1,0,140000,1176,119
"11367","33397","2019",54,50,4,256954.277777778,2602.09259259259,101.148148148148
"11368","33398","2019",1,1,0,150000,2113,71
"11369","33399","2019",3,3,0,140000,1243.66666666667,106
"11370","33400","2019",2,2,0,150000,1007.5,144
"11371","33402","2019",33,24,9,83211.1515151515,799.939393939394,100.606060606061
"11372","33404","2019",3,3,0,200643.333333333,1358,160.666666666667
"11373","33405","2019",8,8,0,176087.5,1478.75,122
"11374","33406","2019",3,3,0,260666.666666667,1616,166
"11375","33407","2019",13,13,0,221498.307692308,2046.53846153846,109.846153846154
"11376","33408","2019",8,8,0,390000,2754.375,154.75
"11377","33409","2019",1,1,0,237460,1979,120
"11378","33412","2019",17,17,0,150705.882352941,1664.11764705882,90
"11379","33413","2019",26,26,0,235227.884615385,2295.19230769231,103.115384615385
"11380","33414","2019",7,7,0,170997.714285714,1596,104.571428571429
"11381","33415","2019",32,24,8,197849.03125,2042.0625,99.46875
"11382","33416","2019",8,8,0,107357.5,1196.375,100.75
"11383","33417","2019",27,26,1,258140.259259259,2546.14814814815,104.814814814815
"11384","33418","2019",2,2,0,180000,1552.5,114.5
"11385","33419","2019",1,1,0,190000,1044,182
"11386","33420","2019",1,1,0,153000,1485,103
"11387","33421","2019",9,8,1,189427.777777778,1496.44444444444,128.111111111111
"11388","33422","2019",92,69,23,335081.826086957,3560.80434782609,98.0978260869565
"11389","33423","2019",8,8,0,127700,1198.5,100.125
"11390","33424","2019",64,54,10,177497.796875,1871.421875,96.15625
"11391","33425","2019",15,15,0,218757.333333333,2378,96.3333333333333
"11392","33426","2019",2,2,0,132500,2348.5,56
"11393","33427","2019",7,7,0,151157.142857143,1427.85714285714,113.428571428571
"11394","33428","2019",1,1,0,212000,1643,129
"11395","33429","2019",6,6,0,164198.333333333,1528.83333333333,115.5
"11396","33431","2019",4,4,0,181750,1771.5,103.75
"11397","33432","2019",4,4,0,152332.5,1254.5,121.5
"11398","33433","2019",106,95,11,266338.433962264,2682.40566037736,100.688679245283
"11399","33434","2019",30,22,8,171701.466666667,2120.53333333333,82.5666666666667
"11400","33435","2019",32,25,7,158193.40625,1663.03125,101.28125
"11401","33436","2019",12,12,0,201791.666666667,1949.58333333333,106.333333333333
"11402","33437","2019",32,31,1,199805,1826.40625,108.65625
"11403","33438","2019",21,21,0,263468.095238095,2107.38095238095,114
"11404","33439","2019",20,17,3,162461.2,1565.25,109.9
"11405","33440","2019",3,3,0,158666.666666667,1415,129.333333333333
"11406","33441","2019",20,15,5,97183.75,1179.3,87.05
"11407","33442","2019",7,7,0,167192.857142857,1704,96.2857142857143
"11408","33444","2019",4,4,0,202508.25,1892.5,141.5
"11409","33445","2019",7,7,0,151557.142857143,1519,101
"11410","33446","2019",2,2,0,152500,987.5,154.5
"11411","33447","2019",40,39,1,133883.425,1315.825,100.55
"11412","33448","2019",29,28,1,342182.275862069,3304.34482758621,112.51724137931
"11413","33449","2019",366,277,89,301966.262295082,3334.07923497268,92.8743169398907
"11414","33450","2019",3,3,0,120333.333333333,1139,96.6666666666667
"11415","33451","2019",4,4,0,168625,1772,96.75
"11416","33452","2019",7,7,0,246485.714285714,2212.71428571429,115.857142857143
"11417","33453","2019",2,2,0,127397.5,895,154.5
"11418","33454","2019",21,21,0,312537.142857143,2576.09523809524,125.761904761905
"11419","33456","2019",9,9,0,120591.111111111,1345.88888888889,96.4444444444444
"11420","33457","2019",8,8,0,168250,1636.875,101.75
"11421","33458","2019",14,13,1,186578.571428571,1519.64285714286,123.5
"11422","33459","2019",4,4,0,139125,1412,115.25
"11423","33460","2019",11,11,0,116703.545454545,1252.09090909091,90.5454545454545
"11424","33461","2019",7,7,0,248500,1304.71428571429,192.285714285714
"11425","33462","2019",10,10,0,131900,1234,104.9
"11426","33463","2019",22,21,1,149390.909090909,1497.09090909091,107.636363636364
"11427","33464","2019",1,1,0,265800,2272,117
"11428","33465","2019",12,12,0,190026,1807.91666666667,108.833333333333
"11429","33466","2019",57,32,25,173224.894736842,2039.9649122807,80.4912280701754
"11430","33467","2019",2,2,0,171500,1618,111
"11431","33468","2019",4,4,0,152600,1201.25,119.25
"11432","33470","2019",11,11,0,221583.090909091,2113.72727272727,109.727272727273
"11433","33471","2019",21,21,0,170181.428571429,1769.28571428571,97.3809523809524
"11434","33472","2019",6,6,0,133666.666666667,1433.83333333333,92.3333333333333
"11435","33473","2019",34,30,4,138321.323529412,1449.14705882353,98.6176470588235
"11436","33474","2019",45,44,1,305952.4,2702.62222222222,117.088888888889
"11437","33475","2019",4,4,0,217250,1916.75,110.25
"11438","33476","2019",10,10,0,95497.1,1108.1,96.8
"11439","33477","2019",14,14,0,134790.714285714,1494.28571428571,102.357142857143
"11440","33478","2019",53,41,12,112401.264150943,1431.83018867925,77.7735849056604
"11441","33479","2019",2,2,0,307750,2377.5,125
"11442","33480","2019",10,10,0,199700,1730,111.1
"11443","33481","2019",3,3,0,107500,1027.33333333333,104.666666666667
"11444","33482","2019",3,3,0,187000,1397.33333333333,143
"11445","33483","2019",58,54,4,343431.586206897,2763.34482758621,123.01724137931
"11446","33484","2019",21,21,0,192047.619047619,1890.09523809524,104.047619047619
"11447","33485","2019",25,25,0,215883.2,1812,121.36
"11448","33486","2019",4,4,0,152625,1390.75,108.75
"11449","33487","2019",3,3,0,127000,1602,78.6666666666667
"11450","33488","2019",3,2,1,145800,1514,110.333333333333
"11451","33489","2019",7,7,0,115214.285714286,1231,94.1428571428571
"11452","33490","2019",33,31,2,169371.757575758,1721.90909090909,98.0909090909091
"11453","33491","2019",5,5,0,168451.2,1596,117
"11454","33492","2019",43,38,5,135319.813953488,1587.48837209302,84.1627906976744
"11455","33493","2019",6,6,0,114816.666666667,1176.66666666667,102
"11456","33494","2019",14,14,0,330687.857142857,3142.28571428571,106.642857142857
"11457","33496","2019",33,33,0,292789,2694.9696969697,112
"11458","33498","2019",114,105,9,291480.815789474,2696.79824561404,113.421052631579
"11459","33499","2019",3,3,0,123666.666666667,1044.33333333333,125
"11460","33500","2019",4,4,0,181112.5,2060,89.75
"11461","33501","2019",33,33,0,321644.484848485,2990.09090909091,108.151515151515
"11462","33502","2019",8,8,0,160875,1674.375,94.25
"11463","33503","2019",4,4,0,235000,2652.5,90.25
"11464","33504","2019",5,5,0,2e+05,1552.2,149.4
"11465","33505","2019",16,16,0,230663.75,1960.8125,117.1875
"11466","33506","2019",21,19,2,113074.571428571,1396.19047619048,80.7619047619048
"11467","33508","2019",11,11,0,152035.454545455,1579.18181818182,97.7272727272727
"11468","33509","2019",9,9,0,219655.555555556,1793.77777777778,121.555555555556
"11469","33510","2019",2,2,0,195625,1492.5,137
"11470","33511","2019",5,5,0,174760,1523.6,120.8
"11471","33512","2019",7,7,0,162571.428571429,1465.42857142857,110.428571428571
"11472","33513","2019",4,4,0,172162.5,2144.25,75
"11473","33514","2019",191,120,71,168523.842931937,2989.70157068063,59.8743455497382
"11474","33515","2019",3,3,0,206378.333333333,2211.66666666667,124.333333333333
"11475","33516","2019",3,3,0,183370.666666667,1202.33333333333,146
"11476","33517","2019",27,27,0,213496.037037037,2082.59259259259,105.518518518519
"11477","33518","2019",15,15,0,268843.066666667,2333.26666666667,123.4
"11478","33519","2019",114,105,9,332201.754385965,3413.49122807018,99.4824561403509
"11479","33520","2019",1,1,0,155000,1140,136
"11480","33521","2019",11,11,0,125104.545454545,1430.18181818182,88.0909090909091
"11481","33522","2019",719,240,479,238572.675938804,3989.26981919332,61.115438108484
"11482","33523","2019",19,16,3,168955.947368421,1722.84210526316,102.157894736842
"11483","33524","2019",4,4,0,176136.25,1827.5,102.5
"11484","33525","2019",21,21,0,174614.285714286,1878.38095238095,97.2380952380952
"11485","33526","2019",1,1,0,85000,2297,37
"11486","33527","2019",104,82,22,296349.384615385,3126.80769230769,94.8269230769231
"11487","33528","2019",8,8,0,291287.5,2210.25,137.125
"11488","33529","2019",545,388,157,434900.627522936,4701.79266055046,88.9137614678899
"11489","33530","2019",9,9,0,187922.222222222,1562.55555555556,126.111111111111
"11490","33531","2019",2,2,0,175000,1849,121.5
"11491","33532","2019",4,4,0,228950,1918.25,122.75
"11492","33533","2019",32,31,1,172547.03125,1909.96875,93.625
"11493","33534","2019",13,13,0,180853.846153846,2090.30769230769,90.1538461538462
"11494","33535","2019",47,47,0,321588.765957447,2985.76595744681,106.553191489362
"11495","33536","2019",4,4,0,153000,1896.25,80.25
"11496","33537","2019",9,9,0,211263.222222222,1821.77777777778,120.111111111111
"11497","33538","2019",7,7,0,207998.571428571,1685.71428571429,123.571428571429
"11498","33539","2019",56,51,5,208147,2075.42857142857,104.446428571429
"11499","33540","2019",71,70,1,197664.084507042,2409.69014084507,87.2253521126761
"11500","33541","2019",29,29,0,155230,1786.44827586207,91.2068965517241
"11501","33542","2019",11,10,1,198147.727272727,1742.81818181818,111.727272727273
"11502","33543","2019",13,12,1,172217.692307692,1604.76923076923,115.230769230769
"11503","33544","2019",77,32,45,103737.766233766,1691.93506493506,62.5454545454545
"11504","33545","2019",14,14,0,156237.5,1478.14285714286,112.857142857143
"11505","33546","2019",4,4,0,189600,1733.75,116.25
"11506","33547","2019",12,12,0,177675,1701.58333333333,112.333333333333
"11507","33548","2019",19,19,0,203267.105263158,1737.84210526316,126.263157894737
"11508","33549","2019",2,2,0,188250,2037,92.5
"11509","33550","2019",463,316,147,273962.060475162,3285.69114470842,83.1231101511879
"11510","33551","2019",5,4,1,116070,1120.6,110
"11511","33552","2019",7,7,0,160500,1970.85714285714,82.5714285714286
"11512","33553","2019",9,9,0,220555.555555556,1965.44444444444,117.111111111111
"11513","33554","2019",22,21,1,289783.181818182,2826.45454545455,105.227272727273
"11514","33555","2019",61,52,9,262495.737704918,2860.34426229508,95.6885245901639
"11515","34001","2019",34,33,1,188745.235294118,1920.35294117647,100.147058823529
"11516","34002","2019",19,19,0,175495.263157895,1985.52631578947,86.9473684210526
"11517","34003","2019",1856,433,1423,133563.392780172,3246.078125,43.2871767241379
"11518","34004","2019",4,4,0,151117.25,1414.25,104.75
"11519","34005","2019",2,2,0,296375,2338.5,126.5
"11520","34006","2019",6,6,0,184866.666666667,1760.33333333333,110.5
"11521","34007","2019",7,7,0,99357.1428571429,905.857142857143,105.428571428571
"11522","34008","2019",12,12,0,126116.666666667,1555.66666666667,81.4166666666667
"11523","34009","2019",25,24,1,173733.4,1848.92,93.16
"11524","34010","2019",32,31,1,228137.5,2400.125,100.8125
"11525","34012","2019",18,18,0,244220,2619.94444444444,93.9444444444444
"11526","34013","2019",40,39,1,166314.6,1825.275,90.525
"11527","34014","2019",15,15,0,625383.333333333,3678.33333333333,173.2
"11528","34015","2019",12,12,0,111817.916666667,1678.83333333333,68.5
"11529","34016","2019",7,7,0,235485.714285714,2636,94.8571428571429
"11530","34017","2019",7,7,0,250260,2196.28571428571,114.142857142857
"11531","34018","2019",23,22,1,159560.869565217,1622.95652173913,99.0434782608696
"11532","34019","2019",9,8,1,60832.2222222222,1525.44444444444,46.5555555555556
"11533","34020","2019",14,14,0,104278.571428571,1386.07142857143,89.2142857142857
"11534","34021","2019",5,5,0,103713,882,111.8
"11535","34022","2019",105,72,33,318484.561904762,3130.2,99.5619047619048
"11536","34023","2019",256,64,192,167310.25,3763.671875,50.12109375
"11537","34024","2019",40,35,5,318881.625,3090.575,106.7
"11538","34025","2019",29,28,1,207838,2024.10344827586,97.5172413793103
"11539","34026","2019",2,2,0,44650,777,58
"11540","34027","2019",19,19,0,322957.368421053,2847.84210526316,114.684210526316
"11541","34028","2019",93,61,32,105825.591397849,1350.63440860215,81.5698924731183
"11542","34029","2019",9,9,0,223701.666666667,2040.44444444444,115.222222222222
"11543","34030","2019",1,1,0,118000,634,186
"11544","34031","2019",64,58,6,153278.96875,1819.796875,83.96875
"11545","34032","2019",1250,501,749,124960.2768,1591.896,78.2096
"11546","34033","2019",23,20,3,283582.173913043,3032.17391304348,98.4782608695652
"11547","34035","2019",13,13,0,298248.461538462,2681.15384615385,113.153846153846
"11548","34036","2019",28,27,1,226451.25,2300.03571428571,93.3571428571429
"11549","34037","2019",33,27,6,182634.242424242,2073,87.1818181818182
"11550","34038","2019",19,17,2,112340.526315789,1272.47368421053,86.6842105263158
"11551","34039","2019",31,21,10,262379.193548387,2777.03225806452,86.7741935483871
"11552","34040","2019",2,2,0,102500,1198,80
"11553","34041","2019",11,10,1,256831.818181818,2613.54545454545,94.8181818181818
"11554","34042","2019",8,8,0,217946.25,2143.75,115
"11555","34043","2019",7,6,1,364563.571428571,2816.14285714286,127.285714285714
"11556","34044","2019",6,6,0,130535,1670.33333333333,82.6666666666667
"11557","34045","2019",4,3,1,200675,1930,99
"11558","34047","2019",12,12,0,147900,1538.16666666667,95.25
"11559","34048","2019",3,3,0,193250,2818.66666666667,73.6666666666667
"11560","34049","2019",11,11,0,95049.0909090909,1061.81818181818,90.0909090909091
"11561","34050","2019",21,16,5,264844.714285714,2709,98.1428571428571
"11562","34051","2019",54,54,0,216845.166666667,2188,98.7407407407407
"11563","34052","2019",52,48,4,139778.192307692,1613.03846153846,92.3076923076923
"11564","34053","2019",1,1,0,65000,433,150
"11565","34055","2019",6,6,0,54333.3333333333,539.333333333333,101.833333333333
"11566","34056","2019",16,15,1,154796.5625,1661.875,94.5625
"11567","34057","2019",349,146,203,285329.699140401,3413.54154727794,81.567335243553
"11568","34059","2019",3,3,0,103833.333333333,1082,91.6666666666667
"11569","34060","2019",4,4,0,130500,1752.5,72.75
"11570","34061","2019",5,5,0,177192,1665.4,106.8
"11571","34062","2019",1,1,0,318371,2108,151
"11572","34063","2019",50,50,0,212941.12,1864.18,109.66
"11573","34064","2019",5,4,1,70500,1214.8,62.4
"11574","34065","2019",9,9,0,143444.444444444,1413.66666666667,103
"11575","34066","2019",1,1,0,861120,2674,322
"11576","34067","2019",28,24,4,178241.821428571,1940.25,95.25
"11577","34068","2019",9,9,0,88827.7777777778,1110,79
"11578","34069","2019",82,74,8,153944.573170732,1516.12195121951,100.756097560976
"11579","34070","2019",14,14,0,158590.714285714,1405.5,103.357142857143
"11580","34071","2019",4,4,0,103375,1174.25,82
"11581","34072","2019",1,1,0,50000,833,60
"11582","34073","2019",38,35,3,209783.342105263,2188.13157894737,96.4210526315789
"11583","34074","2019",38,37,1,163960.263157895,1677.89473684211,96.2105263157895
"11584","34075","2019",7,7,0,203557.857142857,1820.57142857143,104.857142857143
"11585","34076","2019",15,13,2,167240.4,1857.06666666667,92.6666666666667
"11586","34077","2019",69,49,20,317342.623188406,3239.21739130435,94.8260869565217
"11587","34078","2019",21,20,1,263788.19047619,2595.71428571429,104.47619047619
"11588","34079","2019",125,65,60,152547.68,1864.152,80.024
"11589","34080","2019",6,6,0,172660.666666667,1889,92
"11590","34081","2019",37,33,4,224155.405405405,2123.21621621622,108.837837837838
"11591","34082","2019",15,14,1,394344.8,3158.2,120.6
"11592","34083","2019",4,4,0,144093.25,1570.25,85.75
"11593","34084","2019",23,22,1,202486.260869565,2010.08695652174,101.695652173913
"11594","34085","2019",4,4,0,323130,2148.5,156.5
"11595","34086","2019",12,12,0,98297.5,1161.83333333333,86.5
"11596","34087","2019",55,42,13,220852.145454545,2537,88.3090909090909
"11597","34088","2019",103,86,17,219983.631067961,2383.57281553398,93.4854368932039
"11598","34089","2019",21,21,0,147117.19047619,1559.42857142857,94.0952380952381
"11599","34090","2019",135,93,42,293761.325925926,3350.11111111111,91
"11600","34092","2019",14,14,0,130861.428571429,1326,97.6428571428571
"11601","34093","2019",4,4,0,109250,1009.75,106
"11602","34094","2019",16,16,0,205025,2007.4375,105.125
"11603","34095","2019",122,86,36,254238.901639344,2870.73770491803,90.1967213114754
"11604","34096","2019",9,9,0,85472.2222222222,1047,83
"11605","34097","2019",10,10,0,128693,1299.5,96.6
"11606","34098","2019",3,3,0,64866.6666666667,1139.33333333333,60.3333333333333
"11607","34099","2019",2,2,0,417145,1950.5,218.5
"11608","34100","2019",3,3,0,66266.6666666667,1247.33333333333,57.3333333333333
"11609","34101","2019",72,68,4,155256.416666667,2058.88888888889,79.7777777777778
"11610","34102","2019",5,5,0,366409,3143,119
"11611","34103","2019",16,15,1,177388,1900.75,98.9375
"11612","34104","2019",2,2,0,140200,1978.5,70
"11613","34105","2019",6,6,0,169919.166666667,1685,97.8333333333333
"11614","34106","2019",11,11,0,193409.090909091,2123.90909090909,100.727272727273
"11615","34107","2019",16,15,1,107885.625,1067.8125,93.5
"11616","34108","2019",477,263,214,192842.679245283,2948.91404612159,69.0230607966457
"11617","34109","2019",25,25,0,150279.48,1692.28,97.36
"11618","34110","2019",7,7,0,305092.857142857,2140,156.571428571429
"11619","34111","2019",51,17,34,104143.039215686,1395.21568627451,73.7254901960784
"11620","34112","2019",2,2,0,481100,2083.5,231
"11621","34113","2019",91,76,15,212164.263736264,2521.48351648352,84.2417582417582
"11622","34114","2019",83,78,5,221453.855421687,2265.22891566265,97.4457831325301
"11623","34115","2019",2,2,0,110000,883,113.5
"11624","34116","2019",159,57,102,208485.836477987,2819.25157232704,69.559748427673
"11625","34117","2019",7,2,5,40507.8571428571,484.714285714286,81.5714285714286
"11626","34118","2019",2,2,0,636750,3600.5,181.5
"11627","34119","2019",17,15,2,140462.352941176,1702,90.8823529411765
"11628","34120","2019",70,54,16,310759.557142857,3325.11428571429,93.8142857142857
"11629","34121","2019",5,5,0,135561,1257.4,106.2
"11630","34122","2019",2,2,0,247500,2094,110.5
"11631","34123","2019",166,106,60,273729.427710843,2993.90361445783,92.855421686747
"11632","34124","2019",2,2,0,232500,1807.5,124
"11633","34125","2019",1,1,0,2e+05,2817,71
"11634","34126","2019",79,27,52,110919.594936709,1803.82278481013,66.4810126582279
"11635","34127","2019",45,42,3,253933.555555556,2583,97.8888888888889
"11636","34128","2019",27,25,2,185856.481481481,1786.88888888889,102
"11637","34129","2019",277,120,157,310371.732851986,3814.74368231047,82
"11638","34130","2019",27,26,1,181500.444444444,1874,94.8148148148148
"11639","34131","2019",5,5,0,396632,3212.8,123.6
"11640","34132","2019",2,2,0,106425,1128.5,87
"11641","34134","2019",25,20,5,296553.76,3080.4,98.92
"11642","34135","2019",53,50,3,138991.754716981,1577.47169811321,89.3018867924528
"11643","34136","2019",32,31,1,184316.53125,1886.46875,95.21875
"11644","34137","2019",2,2,0,392400,3163.5,124.5
"11645","34138","2019",4,4,0,176500,1661.75,100
"11646","34139","2019",19,18,1,172399.736842105,1573.10526315789,104
"11647","34140","2019",33,33,0,232181,2122.63636363636,109.333333333333
"11648","34141","2019",9,9,0,210785.444444444,1630.33333333333,113.777777777778
"11649","34142","2019",94,58,36,135820.457446809,1646.28723404255,84.3510638297872
"11650","34143","2019",47,40,7,186532.553191489,2667.97872340426,76.8723404255319
"11651","34144","2019",4,4,0,106875,984.75,103.5
"11652","34145","2019",429,253,176,168796.354312354,2115.5034965035,80.1678321678322
"11653","34146","2019",52,46,6,227209.115384615,2713.75,89.2115384615385
"11654","34147","2019",59,57,2,208129.305084746,2018.64406779661,99.2203389830509
"11655","34148","2019",59,56,3,179907.779661017,1782.1186440678,106.610169491525
"11656","34149","2019",14,14,0,192967.857142857,1816.64285714286,109.642857142857
"11657","34150","2019",340,179,161,168955.488235294,3189.81176470588,56.4264705882353
"11658","34151","2019",110,88,22,196798.218181818,2435.83636363636,83.1636363636364
"11659","34152","2019",3,3,0,301926.666666667,2453.66666666667,123
"11660","34153","2019",15,13,2,310110,2839.2,108.733333333333
"11661","34154","2019",421,149,272,222344.054631829,3729.71021377672,62.2137767220903
"11662","34155","2019",35,35,0,187869.742857143,1928.37142857143,99.8571428571429
"11663","34156","2019",1,1,0,4e+05,2548,157
"11664","34157","2019",246,171,75,224606.75203252,2824.05691056911,80.650406504065
"11665","34158","2019",2,2,0,184500,1440,136.5
"11666","34159","2019",52,41,11,235968.846153846,3142.46153846154,78.9230769230769
"11667","34160","2019",13,12,1,149507.692307692,1371.92307692308,117.923076923077
"11668","34161","2019",62,62,0,206450.661290323,2035.83870967742,101.145161290323
"11669","34162","2019",74,58,16,154900.797297297,1763.12162162162,89.2297297297297
"11670","34163","2019",47,42,5,296688.765957447,2982.02127659574,100.382978723404
"11671","34164","2019",6,6,0,421051.666666667,2768.5,152.166666666667
"11672","34165","2019",39,31,8,227699.641025641,2431.4358974359,100.794871794872
"11673","34166","2019",35,34,1,173920.542857143,1835,89.5428571428571
"11674","34167","2019",3,3,0,275513.333333333,1650.33333333333,159.333333333333
"11675","34168","2019",1,1,0,336000,2100,160
"11676","34169","2019",33,27,6,448617.181818182,3757.36363636364,123.030303030303
"11677","34170","2019",4,3,1,162562.5,1412.5,93.75
"11678","34171","2019",1,1,0,193500,1935,100
"11679","34172","2019",5379,606,4773,179670.855735267,2986.90834727645,61.2855549358617
"11680","34173","2019",17,15,2,264569.705882353,2876.47058823529,90.7058823529412
"11681","34174","2019",12,11,1,214068.333333333,2544.58333333333,110.666666666667
"11682","34175","2019",1,1,0,115000,1438,80
"11683","34176","2019",40,28,12,264906.425,2844.05,94.325
"11684","34177","2019",4,4,0,230837.5,2473.5,99
"11685","34178","2019",33,33,0,157843.333333333,1708.42424242424,94.2727272727273
"11686","34179","2019",10,9,1,368769,3278.7,105.5
"11687","34180","2019",28,28,0,173037.571428571,1735.96428571429,101.464285714286
"11688","34181","2019",21,20,1,221102.619047619,1938.7619047619,110.904761904762
"11689","34182","2019",28,27,1,197107.928571429,1962.03571428571,100.392857142857
"11690","34183","2019",60,57,3,160717.066666667,1694.63333333333,93.3166666666667
"11691","34184","2019",16,16,0,223015.125,2275.125,105.875
"11692","34185","2019",4,4,0,299371.25,2394.25,127.5
"11693","34186","2019",4,4,0,220190,1908.25,115.75
"11694","34187","2019",6,6,0,139910,1622.66666666667,83.8333333333333
"11695","34188","2019",1,1,0,169000,1300,130
"11696","34189","2019",42,38,4,116822.619047619,1331.5,90.1190476190476
"11697","34190","2019",2,2,0,57672.5,434.5,133
"11698","34191","2019",8,8,0,134206.25,1305.75,96.375
"11699","34192","2019",306,47,259,202361.696078431,4528.26797385621,45.0653594771242
"11700","34193","2019",11,11,0,170361.818181818,1392.36363636364,114.181818181818
"11701","34194","2019",51,47,4,174452.058823529,1990,88.6470588235294
"11702","34195","2019",1,1,0,123900,983,126
"11703","34196","2019",5,5,0,127700,1438,98.2
"11704","34197","2019",21,20,1,163682.142857143,1683.14285714286,96.0476190476191
"11705","34198","2019",162,132,30,342530.25308642,3723.30864197531,93.5432098765432
"11706","34199","2019",114,66,48,161877.938596491,2003.55263157895,80.5964912280702
"11707","34200","2019",7,7,0,92928.5714285714,1157.14285714286,83.8571428571429
"11708","34201","2019",8,8,0,142098.375,1559,93.375
"11709","34202","2019",100,71,29,248349.21,2791.32,88.68
"11710","34203","2019",22,20,2,174877.272727273,1885.81818181818,97.5
"11711","34204","2019",15,14,1,191359,1882.93333333333,102.333333333333
"11712","34205","2019",7,6,1,185528.571428571,1885.57142857143,103.571428571429
"11713","34206","2019",8,6,2,164231.875,1876.625,87
"11714","34207","2019",50,47,3,155070.88,1962.04,79.36
"11715","34208","2019",3,3,0,216633.333333333,2053.33333333333,105.333333333333
"11716","34209","2019",133,120,13,162025.984962406,2956.84962406015,59.7293233082707
"11717","34210","2019",41,37,4,179629.634146341,2047.21951219512,85.3658536585366
"11718","34211","2019",14,12,2,126449.642857143,1312.85714285714,86.2142857142857
"11719","34212","2019",3,3,0,77666.6666666667,1307.33333333333,54.6666666666667
"11720","34213","2019",94,74,20,244078.893617021,2469.1914893617,97.3617021276596
"11721","34214","2019",21,21,0,187067.095238095,1747.71428571429,114.190476190476
"11722","34215","2019",10,9,1,173122,1989.3,89.5
"11723","34216","2019",3,3,0,112000,1276,87
"11724","34217","2019",97,61,36,272087.670103093,3227.13402061856,86.0618556701031
"11725","34218","2019",7,7,0,196987.142857143,2012.14285714286,104.714285714286
"11726","34219","2019",10,10,0,141833,1457.2,94.5
"11727","34220","2019",2,2,0,185850,2815,69
"11728","34221","2019",7,6,1,164113,1807.85714285714,88.4285714285714
"11729","34222","2019",9,9,0,283605.555555556,2148.88888888889,128.111111111111
"11730","34223","2019",14,13,1,248945,2022.35714285714,127.785714285714
"11731","34224","2019",34,32,2,198011.264705882,1867.58823529412,97.3823529411765
"11732","34225","2019",64,61,3,148705.734375,1582.640625,93.5
"11733","34226","2019",31,30,1,142104.838709677,1553.87096774194,94.0322580645161
"11734","34227","2019",26,21,5,270008.038461538,2678.69230769231,106.961538461538
"11735","34228","2019",1,1,0,64500,1697,38
"11736","34229","2019",14,13,1,99122.1428571429,1150.78571428571,88.6428571428571
"11737","34230","2019",4,4,0,96000,1112.25,94.75
"11738","34231","2019",1,1,0,87630,1826,48
"11739","34232","2019",10,9,1,165750,2085.1,85.8
"11740","34234","2019",2,2,0,63250,930.5,74
"11741","34235","2019",6,6,0,75416.6666666667,1907.83333333333,50.6666666666667
"11742","34236","2019",1,0,1,161381,2211,73
"11743","34237","2019",36,34,2,157841.444444444,1644.13888888889,96.8055555555556
"11744","34238","2019",1,1,0,79000,929,85
"11745","34239","2019",105,94,11,178530.161904762,2133.71428571429,85.2761904761905
"11746","34240","2019",44,31,13,305370.909090909,3297.20454545455,92.0227272727273
"11747","34241","2019",10,10,0,150630,1689.9,89.1
"11748","34242","2019",7,7,0,329400,2722.14285714286,119
"11749","34243","2019",28,27,1,198424.071428571,2080.75,95.9285714285714
"11750","34244","2019",53,29,24,246315.396226415,2824.54716981132,83.9622641509434
"11751","34245","2019",36,33,3,119521.138888889,1443.33333333333,83.5555555555556
"11752","34246","2019",24,21,3,268533.333333333,2852.91666666667,96.6666666666667
"11753","34247","2019",61,50,11,457401.885245902,3578.7868852459,134.081967213115
"11754","34248","2019",8,8,0,391463.375,3318.875,118.5
"11755","34249","2019",35,26,9,278922,2755.4,97.4
"11756","34250","2019",4,4,0,76500,1098.25,63
"11757","34251","2019",10,10,0,165962,1807.6,97.5
"11758","34252","2019",4,1,3,27855,559,49.75
"11759","34254","2019",13,13,0,175686.153846154,1869.61538461538,92.0769230769231
"11760","34255","2019",127,109,18,416114.968503937,3466.24409448819,116.086614173228
"11761","34256","2019",21,20,1,378949.142857143,3141.09523809524,124.380952380952
"11762","34257","2019",1,1,0,18000,692,26
"11763","34258","2019",24,24,0,243780.125,2020.79166666667,112.416666666667
"11764","34259","2019",66,41,25,242489.136363636,2534.40909090909,92.8484848484848
"11765","34260","2019",11,11,0,170722.272727273,1792.36363636364,94.9090909090909
"11766","34261","2019",8,6,2,173056.25,2462.625,77.25
"11767","34262","2019",4,4,0,310875,2657.25,122
"11768","34263","2019",5,5,0,405094,3003.8,143.2
"11769","34264","2019",2,2,0,203200,1817,108.5
"11770","34265","2019",4,4,0,475962.5,2696,173.75
"11771","34266","2019",4,4,0,622242.5,3584.5,181.5
"11772","34267","2019",24,21,3,191818.708333333,2052.45833333333,92.1666666666667
"11773","34268","2019",6,5,1,147696.666666667,1495.16666666667,94.1666666666667
"11774","34269","2019",6,6,0,163945,2055.83333333333,82.8333333333333
"11775","34270","2019",135,89,46,309063,3368.62962962963,92.3851851851852
"11776","34271","2019",5,4,1,75400,926.8,82.4
"11777","34272","2019",29,29,0,280455.931034483,2603.10344827586,108.689655172414
"11778","34273","2019",3,3,0,251128.333333333,2409.66666666667,110.333333333333
"11779","34274","2019",41,40,1,266722.585365854,2622.53658536585,102.682926829268
"11780","34276","2019",58,47,11,294682.310344828,2990.03448275862,100.379310344828
"11781","34277","2019",4,4,0,97750,1654.75,69.5
"11782","34278","2019",2,2,0,106500,1702,63
"11783","34279","2019",8,8,0,72825,1066.25,74.75
"11784","34280","2019",8,8,0,305320.625,2604.75,123.875
"11785","34281","2019",51,47,4,179773.078431373,1824.41176470588,93.9411764705882
"11786","34282","2019",19,16,3,286887.421052632,3076.94736842105,98.4210526315789
"11787","34283","2019",1,1,0,265000,2366,112
"11788","34284","2019",23,22,1,79679,1108.34782608696,76.304347826087
"11789","34285","2019",14,14,0,187606.071428571,1855.07142857143,100
"11790","34286","2019",4,3,1,137625,1782.5,81.5
"11791","34287","2019",1,1,0,145100,1612,90
"11792","34288","2019",8,6,2,321500,3358.25,109.875
"11793","34289","2019",59,58,1,182259.813559322,2152.72881355932,88.1525423728814
"11794","34290","2019",6,6,0,367800,3015.83333333333,128.666666666667
"11795","34291","2019",4,4,0,143767.5,1305.25,102.5
"11796","34292","2019",3,2,1,330800,3283.33333333333,105.333333333333
"11797","34293","2019",36,35,1,97571,1389.63888888889,70.7222222222222
"11798","34294","2019",12,10,2,193072.5,2313.83333333333,80.1666666666667
"11799","34295","2019",21,18,3,255364.095238095,2496.7619047619,100.52380952381
"11800","34296","2019",13,13,0,280573.846153846,2667.61538461538,117
"11801","34297","2019",5,5,0,332736,2663.2,115
"11802","34298","2019",84,80,4,227067.904761905,2398.94047619048,95.8690476190476
"11803","34299","2019",115,99,16,206881.391304348,2345.44347826087,87.7478260869565
"11804","34300","2019",105,101,4,183240.952380952,1812.41904761905,98.2952380952381
"11805","34301","2019",1315,192,1123,176341.205323194,2827.91102661597,60.1429657794677
"11806","34302","2019",16,15,1,144438.5625,1318.0625,114.1875
"11807","34303","2019",1,1,0,132000,2276,58
"11808","34304","2019",14,12,2,199704,2092.5,94.2142857142857
"11809","34305","2019",6,5,1,72808.3333333333,1352.5,65.6666666666667
"11810","34306","2019",3,3,0,135000,1783.33333333333,73.3333333333333
"11811","34307","2019",29,23,6,331451.724137931,3019.1724137931,112.793103448276
"11812","34308","2019",11,8,3,105523.454545455,1481,66.2727272727273
"11813","34309","2019",37,33,4,383928.783783784,3609.75675675676,105.756756756757
"11814","34310","2019",41,41,0,164025.609756098,1612.85365853659,101.317073170732
"11815","34311","2019",27,27,0,197434,2038.7037037037,90.1851851851852
"11816","34312","2019",18,18,0,157255,1608.77777777778,97.5555555555556
"11817","34313","2019",5,5,0,133031.4,1588.6,82.8
"11818","34314","2019",6,5,1,318718.333333333,3288.83333333333,98.3333333333333
"11819","34315","2019",6,6,0,194217,1822.33333333333,101.166666666667
"11820","34316","2019",2,2,0,228765,2275,100
"11821","34317","2019",4,4,0,67750,714.75,91
"11822","34318","2019",11,11,0,271029.090909091,2322.72727272727,116.545454545455
"11823","34319","2019",5,4,1,236680,2157.8,102.6
"11824","34320","2019",23,22,1,347133.130434783,2881.78260869565,123.04347826087
"11825","34321","2019",29,26,3,274707.24137931,2762.55172413793,101.689655172414
"11826","34322","2019",7,7,0,264278.571428571,2668.28571428571,98.7142857142857
"11827","34324","2019",298,102,196,138725.922818792,3013.04697986577,47.3993288590604
"11828","34325","2019",16,16,0,189823.125,1920.9375,97
"11829","34326","2019",2,2,0,164250,1369,120
"11830","34327","2019",66,58,8,327525.878787879,3322.0303030303,101.212121212121
"11831","34328","2019",12,12,0,202658.333333333,1948.41666666667,104.166666666667
"11832","34329","2019",74,64,10,170296.851351351,2927.27027027027,65.2972972972973
"11833","34331","2019",5,5,0,122365,974.8,121
"11834","34332","2019",146,125,21,138200.746575342,2355.02739726027,63.527397260274
"11835","34333","2019",98,96,2,165327.173469388,4470.78571428571,44.8163265306122
"11836","34335","2019",7,7,0,147485.714285714,1318.28571428571,109.714285714286
"11837","34336","2019",85,66,19,156334.152941176,1939.55294117647,78.7058823529412
"11838","34337","2019",92,76,16,286071.934782609,3155.57608695652,92.0217391304348
"11839","34339","2019",3,3,0,219520,1671.66666666667,123
"11840","34340","2019",22,22,0,357582.954545455,3337.09090909091,110.863636363636
"11841","34341","2019",46,46,0,220183.326086957,2205.02173913043,98.9782608695652
"11842","34342","2019",3,1,2,224333.333333333,2569.66666666667,78
"11843","34343","2019",12,11,1,295879.583333333,2826.66666666667,103.833333333333
"11844","34344","2019",935,61,874,164854.126203209,4244.89304812834,37.9614973262032
"11845","35001","2019",76,47,29,232900.065789474,2376.73684210526,97.6578947368421
"11846","35002","2019",18,18,0,181977.777777778,1865.16666666667,97.4444444444444
"11847","35003","2019",8,8,0,181812.5,1584.75,129.25
"11848","35004","2019",54,53,1,120989.351851852,1167.90740740741,105.648148148148
"11849","35005","2019",2,2,0,115500,1119,102.5
"11850","35006","2019",54,51,3,157636.722222222,1517.18518518519,103.925925925926
"11851","35007","2019",7,7,0,162100,1811.28571428571,91.2857142857143
"11852","35008","2019",7,7,0,166142.857142857,1330.57142857143,123.285714285714
"11853","35009","2019",34,32,2,137861.882352941,1527.70588235294,94.5294117647059
"11854","35010","2019",25,24,1,164540.92,1510.84,109.6
"11855","35012","2019",95,82,13,161130.578947368,1660.10526315789,97.2947368421053
"11856","35013","2019",44,44,0,148121.977272727,1313.54545454545,112.545454545455
"11857","35014","2019",31,28,3,150805.451612903,1580.25806451613,100.032258064516
"11858","35015","2019",24,24,0,141225,1375.5,101.083333333333
"11859","35016","2019",26,26,0,174916.576923077,1719.76923076923,103.884615384615
"11860","35017","2019",5,5,0,156312,1578,100.2
"11861","35018","2019",11,11,0,120588.181818182,1105.27272727273,105.727272727273
"11862","35019","2019",31,29,2,106042.096774194,1038.32258064516,101.870967741935
"11863","35021","2019",12,12,0,133875,1347.91666666667,94.4166666666667
"11864","35022","2019",4,3,1,180592.5,1808.25,97.5
"11865","35023","2019",64,53,11,181879.53125,1857.015625,98.8125
"11866","35024","2019",164,97,67,257636.12195122,2718.06097560976,94.5670731707317
"11867","35025","2019",10,10,0,166690,1583.4,104
"11868","35026","2019",1,1,0,55000,655,84
"11869","35027","2019",14,14,0,135560.357142857,1533.92857142857,87.1428571428571
"11870","35028","2019",7,7,0,165957.142857143,1491.14285714286,114.857142857143
"11871","35029","2019",32,32,0,125127.5625,1493.3125,86.5625
"11872","35030","2019",12,12,0,122983.333333333,1288.08333333333,95.3333333333333
"11873","35031","2019",65,56,9,165429.676923077,1724.64615384615,95.8615384615385
"11874","35032","2019",100,74,26,209109.77,2120.17,99.62
"11875","35033","2019",38,34,4,182829.5,1995.55263157895,99.2894736842105
"11876","35034","2019",14,14,0,95107.1428571429,1039.14285714286,95.9285714285714
"11877","35035","2019",9,9,0,176533.333333333,1815.88888888889,98.2222222222222
"11878","35037","2019",86,57,29,185983.488372093,2081.02325581395,90.2325581395349
"11879","35038","2019",12,12,0,118440.166666667,1235.41666666667,93.4166666666667
"11880","35039","2019",22,18,4,184905.545454545,1886.77272727273,98.7727272727273
"11881","35040","2019",35,26,9,183852.657142857,2037.71428571429,93.8
"11882","35041","2019",5,5,0,187337,1792,111.6
"11883","35042","2019",6,6,0,74363.6666666667,819.833333333333,88
"11884","35044","2019",7,7,0,100928.571428571,1326,80
"11885","35045","2019",11,11,0,74270.9090909091,1006.45454545455,76.0909090909091
"11886","35046","2019",6,6,0,142150,1248,112.166666666667
"11887","35047","2019",293,140,153,211955.259385666,2520.13651877133,85.5665529010239
"11888","35049","2019",154,111,43,256689.902597403,2872.53246753247,91.3116883116883
"11889","35050","2019",3,3,0,131400,1644,89
"11890","35051","2019",227,103,124,288413.594713656,3186.28193832599,90.5506607929515
"11891","35052","2019",10,9,1,139540.1,1570.2,88.8
"11892","35054","2019",26,26,0,177044.461538462,1757.38461538462,109.615384615385
"11893","35055","2019",174,66,108,204898.465517241,2566.77011494253,80.0977011494253
"11894","35056","2019",7,7,0,141759,1231.71428571429,114.142857142857
"11895","35057","2019",20,18,2,120957,1531.95,76.65
"11896","35058","2019",16,16,0,224770.1875,1742.8125,121.875
"11897","35059","2019",54,34,20,236505.5,2748.98148148148,90.8333333333333
"11898","35060","2019",17,17,0,160161,1582.70588235294,102.117647058824
"11899","35061","2019",9,9,0,160888.888888889,1647.77777777778,103.444444444444
"11900","35062","2019",13,13,0,98719.0769230769,1235.46153846154,83.0769230769231
"11901","35063","2019",5,5,0,153300,1337.8,115
"11902","35064","2019",25,25,0,78499.44,937.96,81.76
"11903","35065","2019",27,24,3,178787.074074074,1973.44444444444,93.7037037037037
"11904","35066","2019",139,66,73,192379.568345324,2442.31654676259,78.4028776978417
"11905","35067","2019",23,23,0,201793.47826087,1874.86956521739,107.130434782609
"11906","35068","2019",93,65,28,180777.569892473,1998.37634408602,93.010752688172
"11907","35069","2019",150,107,43,220886.853333333,2255.38,98.7066666666667
"11908","35070","2019",38,37,1,171659.447368421,1627.5,104.710526315789
"11909","35071","2019",6,6,0,126250,1131.5,109.5
"11910","35072","2019",14,14,0,110177.142857143,1158.14285714286,103.642857142857
"11911","35075","2019",9,9,0,133255.555555556,1407.33333333333,92.7777777777778
"11912","35076","2019",51,28,23,180808.745098039,2121.35294117647,86.8235294117647
"11913","35077","2019",3,3,0,128000,846.666666666667,152
"11914","35078","2019",15,15,0,176700,1716.13333333333,110.933333333333
"11915","35079","2019",25,24,1,235152.88,2273.96,106.48
"11916","35080","2019",38,33,5,188544.473684211,1874.10526315789,103.473684210526
"11917","35081","2019",7,7,0,152146.571428571,1783,85.8571428571429
"11918","35082","2019",19,18,1,130723.526315789,1156.36842105263,110.473684210526
"11919","35084","2019",11,11,0,120359.818181818,1226.18181818182,92.7272727272727
"11920","35085","2019",81,69,12,152672.098765432,1664.75308641975,93.3333333333333
"11921","35086","2019",7,7,0,120528.571428571,1064.28571428571,111
"11922","35087","2019",7,7,0,137652.714285714,1245.14285714286,116.142857142857
"11923","35088","2019",47,36,11,176681.340425532,1821.42553191489,101.978723404255
"11924","35089","2019",6,6,0,111416.666666667,1378.33333333333,79.8333333333333
"11925","35090","2019",48,41,7,161917.354166667,1752.25,93.1666666666667
"11926","35091","2019",6,6,0,144382.666666667,1110.33333333333,131.833333333333
"11927","35092","2019",9,9,0,110428.888888889,1158.44444444444,89.8888888888889
"11928","35093","2019",393,165,228,286954.918575064,4111.12977099237,69.0483460559796
"11929","35094","2019",17,17,0,120406.235294118,1302.35294117647,92.7058823529412
"11930","35095","2019",109,68,41,155685.311926606,1889.67889908257,90.4311926605505
"11931","35096","2019",36,30,6,174531.944444444,1631.97222222222,110.75
"11932","35097","2019",23,23,0,153995.652173913,1477.4347826087,111.826086956522
"11933","35098","2019",18,18,0,102501.722222222,1068.61111111111,96.1111111111111
"11934","35099","2019",41,31,10,225261.804878049,2310.07317073171,97.5609756097561
"11935","35101","2019",11,11,0,165651.272727273,1586.09090909091,111
"11936","35102","2019",6,6,0,119633.333333333,1282.33333333333,93.1666666666667
"11937","35103","2019",2,2,0,118000,737.5,156.5
"11938","35104","2019",21,21,0,142573.80952381,1731.71428571429,84.2380952380952
"11939","35105","2019",11,11,0,161027.272727273,1572.81818181818,103.363636363636
"11940","35106","2019",23,22,1,130640,1308.04347826087,102
"11941","35107","2019",22,22,0,200665.227272727,1718.04545454545,116.181818181818
"11942","35108","2019",6,6,0,122000,1721.66666666667,80
"11943","35109","2019",31,26,5,187202.903225806,1801.09677419355,106.806451612903
"11944","35110","2019",15,15,0,139990,1411.86666666667,107.2
"11945","35111","2019",8,8,0,91062.5,1046.75,107.75
"11946","35112","2019",10,10,0,104750,1014.6,103.5
"11947","35114","2019",6,6,0,70833.3333333333,909.666666666667,80.3333333333333
"11948","35115","2019",354,182,172,113336.378531073,1366.70338983051,82.7175141242938
"11949","35116","2019",45,44,1,169341.111111111,1697.46666666667,102.066666666667
"11950","35117","2019",27,25,2,89288.8888888889,888.111111111111,98.1481481481482
"11951","35118","2019",13,13,0,148014.615384615,1432.46153846154,95.7692307692308
"11952","35119","2019",10,10,0,156007.4,1773.6,111.3
"11953","35120","2019",56,41,15,211528.357142857,2284.85714285714,92.8035714285714
"11954","35121","2019",21,21,0,198995.238095238,1966.28571428571,111.285714285714
"11955","35122","2019",28,26,2,172929.392857143,1899.92857142857,92.2142857142857
"11956","35123","2019",54,45,9,178157.611111111,1877.7037037037,95.7777777777778
"11957","35124","2019",30,30,0,136291.433333333,1270.86666666667,109.266666666667
"11958","35125","2019",59,51,8,104990.101694915,1221.08474576271,88.7796610169491
"11959","35126","2019",120,99,21,190402.5,2013.19166666667,95.675
"11960","35127","2019",55,51,4,160823.072727273,1632.27272727273,102.109090909091
"11961","35128","2019",23,23,0,164931.782608696,1750.47826086957,94.9130434782609
"11962","35130","2019",30,26,4,175885.666666667,1880.3,99.7333333333333
"11963","35131","2019",53,31,22,194922.679245283,2220.58490566038,89.811320754717
"11964","35132","2019",24,24,0,171996.875,1708.25,105.541666666667
"11965","35133","2019",54,51,3,154176.462962963,1616.44444444444,96.3888888888889
"11966","35134","2019",3,3,0,159000,1262,124.666666666667
"11967","35135","2019",26,25,1,173283.269230769,1836.46153846154,103.730769230769
"11968","35136","2019",137,88,49,166172.284671533,1810.89781021898,93.2262773722628
"11969","35137","2019",15,15,0,118966.666666667,1248.93333333333,99.8
"11970","35138","2019",11,11,0,176136.363636364,1664,103.181818181818
"11971","35139","2019",66,53,13,226630.348484848,2137.39393939394,110
"11972","35140","2019",8,8,0,121820,1278.875,112.625
"11973","35141","2019",5,5,0,178819,1304.4,139.2
"11974","35142","2019",13,13,0,126500,1218.92307692308,101.384615384615
"11975","35143","2019",10,10,0,175330,1551.2,128.5
"11976","35144","2019",11,11,0,174777.272727273,1805.27272727273,94.4545454545455
"11977","35145","2019",27,27,0,109755.740740741,1130.40740740741,97.9259259259259
"11978","35146","2019",8,8,0,153794.25,1529.75,100.375
"11979","35148","2019",1,1,0,137000,901,152
"11980","35149","2019",17,17,0,206769.588235294,1849.05882352941,111.705882352941
"11981","35150","2019",33,33,0,165983.454545455,1488.75757575758,111.090909090909
"11982","35151","2019",8,8,0,70001.375,1077,69.5
"11983","35152","2019",108,81,27,203066.287037037,2237.63888888889,93.1666666666667
"11984","35153","2019",5,5,0,155360,1417.2,106.2
"11985","35154","2019",20,20,0,148853.75,1486.9,99.75
"11986","35155","2019",4,4,0,138125,1281,101.25
"11987","35156","2019",4,4,0,129500,1269.25,112.5
"11988","35157","2019",7,7,0,96500,1052,93.2857142857143
"11989","35159","2019",4,4,0,173808.75,1660.5,103.5
"11990","35160","2019",5,5,0,118718,1223.4,88.4
"11991","35161","2019",32,32,0,139097.28125,1453.1875,94.28125
"11992","35162","2019",49,49,0,96838.8775510204,1076.65306122449,90.0408163265306
"11993","35163","2019",17,17,0,104602.941176471,1167.35294117647,88.7058823529412
"11994","35164","2019",13,13,0,98153.8461538462,1126.46153846154,84.2307692307692
"11995","35165","2019",12,12,0,118208.333333333,1144.91666666667,106.25
"11996","35166","2019",8,8,0,170179.875,1398.5,117.25
"11997","35167","2019",36,32,4,110194.444444444,1175.02777777778,94.7777777777778
"11998","35168","2019",67,66,1,123721.567164179,1262.85074626866,97.0298507462687
"11999","35169","2019",26,26,0,134225.384615385,1403.30769230769,99.9230769230769
"12000","35170","2019",7,7,0,136854.285714286,1508.42857142857,98.1428571428571
"12001","35171","2019",19,19,0,136147.368421053,1253.15789473684,102.684210526316
"12002","35172","2019",20,20,0,132735.9,1666.75,84.35
"12003","35173","2019",93,66,27,244034.408602151,2439.38709677419,100.505376344086
"12004","35174","2019",5,5,0,111140,1096.8,101.4
"12005","35175","2019",19,19,0,109991.789473684,1203.42105263158,90.7894736842105
"12006","35176","2019",84,79,5,121150.857142857,1416.94047619048,86.7142857142857
"12007","35177","2019",81,43,38,216659.62962963,2455.37037037037,86.4691358024691
"12008","35178","2019",29,29,0,161920.827586207,1520.31034482759,106.310344827586
"12009","35179","2019",68,61,7,160570.264705882,1796.01470588235,94.8088235294118
"12010","35180","2019",4,4,0,117250,1339.5,89.25
"12011","35181","2019",30,30,0,295512.4,2800.7,109.7
"12012","35183","2019",9,9,0,179957.444444444,1349.44444444444,134.444444444444
"12013","35184","2019",59,50,9,182174.423728814,1713.96610169492,107.627118644068
"12014","35185","2019",4,4,0,140080,1086.5,124.25
"12015","35186","2019",18,18,0,149190.444444444,1699.27777777778,87.9444444444444
"12016","35187","2019",12,12,0,144755.666666667,1520.16666666667,92.5
"12017","35188","2019",84,62,22,188344.916666667,1936.95238095238,99.4404761904762
"12018","35189","2019",53,25,28,222702.641509434,2622.52830188679,85.1132075471698
"12019","35190","2019",4,4,0,92750,826,124.25
"12020","35191","2019",17,17,0,102605.882352941,1102.47058823529,90.9411764705882
"12021","35192","2019",5,5,0,130498,1450.6,91.2
"12022","35193","2019",35,35,0,201200.142857143,1878.82857142857,108.028571428571
"12023","35194","2019",12,12,0,175208.333333333,1638.16666666667,112.833333333333
"12024","35195","2019",28,28,0,173567.785714286,1844.60714285714,94.25
"12025","35196","2019",139,67,72,177305.208633094,2198.25179856115,82.0071942446043
"12026","35197","2019",19,19,0,251878.315789474,2073.78947368421,122.315789473684
"12027","35198","2019",10,10,0,146850,1285.4,112.2
"12028","35199","2019",2,2,0,108750,899.5,129.5
"12029","35200","2019",6,6,0,99916.6666666667,953.833333333333,100.333333333333
"12030","35201","2019",12,12,0,114125,1299.91666666667,82.75
"12031","35202","2019",8,7,1,109872.25,1129.375,108.375
"12032","35203","2019",2,2,0,239950,2163,117
"12033","35204","2019",27,25,2,230684.259259259,2128.62962962963,110.111111111111
"12034","35205","2019",4,4,0,104719.25,1354,74.5
"12035","35206","2019",93,52,41,222863.860215054,2507.51612903226,89.0967741935484
"12036","35207","2019",52,34,18,246658.942307692,2507.30769230769,100.711538461538
"12037","35208","2019",76,60,16,193309.578947368,2067.57894736842,95.2368421052632
"12038","35210","2019",164,95,69,243311.146341463,2495.0243902439,98.6707317073171
"12039","35211","2019",21,21,0,115076.19047619,1350.61904761905,85.8095238095238
"12040","35212","2019",17,17,0,124290.764705882,1206.94117647059,103.294117647059
"12041","35214","2019",8,8,0,184550,1734.25,110.875
"12042","35215","2019",7,7,0,114100,1060,104.857142857143
"12043","35216","2019",30,23,7,215415.666666667,2088.86666666667,104.366666666667
"12044","35217","2019",18,18,0,135644.444444444,1258.27777777778,106
"12045","35218","2019",11,11,0,180121.181818182,1792,100.818181818182
"12046","35219","2019",39,34,5,98346.0256410256,1202.82051282051,81.4102564102564
"12047","35220","2019",51,48,3,173946.666666667,1685.64705882353,104.294117647059
"12048","35221","2019",33,33,0,147012.727272727,1547.87878787879,92.4848484848485
"12049","35222","2019",39,39,0,104393.230769231,1176.41025641026,90.2307692307692
"12050","35223","2019",47,39,8,163838.319148936,1760.27659574468,96.9787234042553
"12051","35224","2019",36,36,0,181686.388888889,1787.72222222222,103.722222222222
"12052","35225","2019",11,11,0,124636.363636364,1363,90.0909090909091
"12053","35226","2019",24,20,4,123770.833333333,1502.04166666667,89.0833333333333
"12054","35227","2019",49,30,19,171913.12244898,1969.9387755102,89.3265306122449
"12055","35228","2019",144,82,62,193488.465277778,2159.43055555556,88.8472222222222
"12056","35229","2019",21,20,1,194217.952380952,1733.61904761905,115.666666666667
"12057","35230","2019",1,1,0,33000,559,59
"12058","35231","2019",11,9,2,143000,1634.18181818182,84.6363636363636
"12059","35232","2019",10,10,0,112886,1237,91.6
"12060","35233","2019",14,14,0,197306.142857143,1746,112.642857142857
"12061","35234","2019",11,11,0,105226.545454545,1070.90909090909,99.7272727272727
"12062","35235","2019",14,14,0,112457.428571429,1117.85714285714,110.5
"12063","35236","2019",164,91,73,126938.140243902,1532.13414634146,85.3780487804878
"12064","35237","2019",17,17,0,88848.8235294118,1113.52941176471,80.1764705882353
"12065","35238","2019",3931,567,3364,207234.08318494,3134.00814042228,66.562961078606
"12066","35239","2019",61,57,4,141615.37704918,1589.47540983607,91.1147540983606
"12067","35240","2019",147,70,77,196940.755102041,2281.46258503401,87.8707482993197
"12068","35241","2019",41,32,9,236159.585365854,2385.19512195122,103.609756097561
"12069","35242","2019",9,9,0,98722.2222222222,1102,93.6666666666667
"12070","35243","2019",25,25,0,154709.92,1377.52,115.32
"12071","35244","2019",1,1,0,248500,2672,93
"12072","35245","2019",48,41,7,191539.270833333,1886.9375,102.395833333333
"12073","35246","2019",13,13,0,162026.923076923,1785.76923076923,99.2307692307692
"12074","35247","2019",17,14,3,99177.9411764706,1709.11764705882,74.2941176470588
"12075","35248","2019",16,16,0,94625,924.5,102.6875
"12076","35249","2019",12,11,1,107450,1077.75,99.75
"12077","35250","2019",32,18,14,166126.1875,2035.59375,83.40625
"12078","35251","2019",51,33,18,172650.980392157,1926.96078431373,89.6078431372549
"12079","35252","2019",13,13,0,131553.846153846,1378.15384615385,94.5384615384615
"12080","35253","2019",8,8,0,198612.5,1559.625,125.75
"12081","35255","2019",18,17,1,199680.944444444,2048.72222222222,95.5
"12082","35256","2019",50,43,7,393946.18,3835.66,100.9
"12083","35257","2019",49,46,3,130707.142857143,1296.20408163265,103.408163265306
"12084","35258","2019",3,3,0,142666.666666667,1783.33333333333,82.6666666666667
"12085","35259","2019",15,15,0,120941.933333333,1507.73333333333,84.3333333333333
"12086","35260","2019",10,10,0,125997.5,1466.2,97.8
"12087","35261","2019",1,1,0,40500,506,80
"12088","35262","2019",2,2,0,179750,1378.5,132
"12089","35263","2019",42,41,1,321670.380952381,2929.04761904762,112.119047619048
"12090","35264","2019",19,19,0,208065.263157895,1810,115.368421052632
"12091","35265","2019",36,34,2,158504.583333333,1720.11111111111,91.6111111111111
"12092","35266","2019",60,33,27,190615.316666667,2189.33333333333,87.3666666666667
"12093","35268","2019",2,2,0,134995,917.5,137
"12094","35270","2019",7,7,0,119257.142857143,1259.14285714286,97.1428571428571
"12095","35271","2019",15,15,0,114280,906.266666666667,121.2
"12096","35272","2019",5,5,0,146000,1537.8,109.6
"12097","35273","2019",20,20,0,137635,1337.35,104.25
"12098","35274","2019",11,10,1,173954.545454545,2278.45454545455,87.4545454545455
"12099","35275","2019",80,50,30,204334.2625,2246.7375,92.5125
"12100","35276","2019",9,9,0,219938.888888889,1775.55555555556,126.888888888889
"12101","35277","2019",4,4,0,99100,1225.25,82.25
"12102","35278","2019",150,82,68,326597.673333333,3071.52666666667,105.7
"12103","35279","2019",20,20,0,191596.5,1675.6,119.05
"12104","35280","2019",11,11,0,118309.545454545,1149.54545454545,100.909090909091
"12105","35281","2019",326,81,245,172695.380368098,2468.24233128834,69.5153374233129
"12106","35282","2019",39,39,0,141677.076923077,1429.02564102564,98.1794871794872
"12107","35283","2019",13,11,2,136295.076923077,1692.23076923077,80.9230769230769
"12108","35284","2019",29,25,4,236375.172413793,2715.72413793103,90.2758620689655
"12109","35285","2019",19,19,0,99175.3157894737,1265.52631578947,81.4210526315789
"12110","35286","2019",3,3,0,189156.666666667,1201.66666666667,156
"12111","35287","2019",64,54,10,386010.234375,3745.5625,105.953125
"12112","35288","2019",1116,396,720,257531.347670251,3640.80286738351,72.5358422939068
"12113","35289","2019",16,16,0,106964.0625,1282.25,83.125
"12114","35290","2019",9,9,0,90455.5555555556,1158.66666666667,75.2222222222222
"12115","35291","2019",10,10,0,107814,1191.2,92.7
"12116","35292","2019",15,15,0,73080,818.2,86.8666666666667
"12117","35294","2019",42,42,0,124366.761904762,1312.90476190476,94.5238095238095
"12118","35295","2019",9,8,1,101833.333333333,1198.11111111111,93
"12119","35296","2019",22,21,1,168693,1951.04545454545,94.8181818181818
"12120","35297","2019",64,49,15,110606.71875,1277.640625,89.625
"12121","35299","2019",66,54,12,216230.803030303,2344.19696969697,95.8181818181818
"12122","35300","2019",19,19,0,135044.684210526,1423.10526315789,95.6315789473684
"12123","35302","2019",15,15,0,103829.6,1244.4,82.6666666666667
"12124","35304","2019",20,20,0,133585,1306.2,98.75
"12125","35305","2019",3,3,0,156630,1327.33333333333,106
"12126","35306","2019",24,24,0,212996.75,2006,105.25
"12127","35307","2019",7,7,0,136017.142857143,1429.71428571429,95.1428571428571
"12128","35308","2019",63,62,1,148070.587301587,1433.69841269841,102.904761904762
"12129","35309","2019",9,9,0,140426.666666667,1344,101.333333333333
"12130","35310","2019",13,13,0,162122.307692308,1423.30769230769,114.076923076923
"12131","35311","2019",12,12,0,102608.333333333,1215,86.5833333333333
"12132","35312","2019",28,28,0,124740.714285714,1512.60714285714,81.9285714285714
"12133","35314","2019",17,16,1,281330.588235294,2904.47058823529,102
"12134","35315","2019",14,14,0,221856.428571429,2078.21428571429,109
"12135","35316","2019",13,13,0,100905.615384615,1090.46153846154,90.7692307692308
"12136","35317","2019",9,9,0,146593.444444444,1624.66666666667,89.6666666666667
"12137","35318","2019",9,9,0,186151.111111111,2369.88888888889,102.222222222222
"12138","35319","2019",29,26,3,173350.379310345,1793.68965517241,100.103448275862
"12139","35320","2019",9,9,0,173016.666666667,1542.55555555556,124.222222222222
"12140","35321","2019",6,6,0,152270,1505,95.5
"12141","35322","2019",20,20,0,149174.95,1426.55,110.85
"12142","35324","2019",3,3,0,83333.3333333333,1011.33333333333,75.6666666666667
"12143","35325","2019",1,1,0,124000,1181,105
"12144","35326","2019",32,32,0,156353.125,1413.25,107.03125
"12145","35327","2019",50,40,10,171899,1977.84,88.74
"12146","35328","2019",29,29,0,101398.310344828,1076.65517241379,95.8965517241379
"12147","35329","2019",6,6,0,95500,784.5,114.666666666667
"12148","35330","2019",11,11,0,110395,1212.81818181818,91.7272727272727
"12149","35331","2019",29,29,0,176884.689655172,1694.89655172414,104.344827586207
"12150","35332","2019",18,18,0,105389.444444444,1112.72222222222,99.0555555555556
"12151","35333","2019",21,21,0,170326.571428571,1708.2380952381,97.7142857142857
"12152","35334","2019",97,63,34,262987.81443299,2647.94845360825,99.6701030927835
"12153","35335","2019",10,10,0,116270,1061.9,107.5
"12154","35336","2019",3,3,0,95000,1652.33333333333,59.3333333333333
"12155","35337","2019",53,46,7,155623.018867925,1726.03773584906,91.8301886792453
"12156","35338","2019",14,14,0,135435.714285714,1380.07142857143,94.5714285714286
"12157","35339","2019",12,12,0,101811.666666667,1142.25,103.333333333333
"12158","35340","2019",7,7,0,163285.714285714,1646.14285714286,104.428571428571
"12159","35342","2019",2,2,0,100500,1629,57.5
"12160","35343","2019",18,18,0,121737.777777778,1278.61111111111,99.8888888888889
"12161","35345","2019",15,15,0,145190.266666667,1304.4,105.4
"12162","35346","2019",2,2,0,140175,1362,102.5
"12163","35347","2019",34,33,1,168347.294117647,1830.17647058824,98
"12164","35350","2019",6,6,0,148981.333333333,1490.16666666667,97.6666666666667
"12165","35351","2019",19,19,0,169763.157894737,1591.42105263158,113.157894736842
"12166","35352","2019",138,89,49,234837.97826087,2410.8768115942,96.9130434782609
"12167","35353","2019",91,38,53,206681.527472527,2298.51648351648,89.4395604395604
"12168","35355","2019",29,29,0,127595.172413793,1349.10344827586,92.6551724137931
"12169","35356","2019",19,18,1,246687.263157895,1969.52631578947,125.894736842105
"12170","35357","2019",5,5,0,128400,1202.4,119.8
"12171","35358","2019",21,21,0,240022.142857143,2081.33333333333,116.571428571429
"12172","35359","2019",12,12,0,130302.416666667,1222.41666666667,105.083333333333
"12173","35360","2019",235,146,89,186365.965957447,2104.36595744681,90.2340425531915
"12174","35361","2019",25,25,0,187750.6,1783.8,107.72
"12175","35362","2019",14,14,0,181456,1705.28571428571,110.5
"12176","35363","2019",57,32,25,196849.596491228,2198.19298245614,91.4736842105263
"12177","36001","2019",14,14,0,68464.2857142857,790.571428571429,94.4285714285714
"12178","36002","2019",3,3,0,96166.6666666667,659,153.333333333333
"12179","36003","2019",10,10,0,98200,1006.1,92
"12180","36004","2019",5,5,0,109000,1177.6,101.6
"12181","36005","2019",53,53,0,124734.641509434,1219.09433962264,99.6981132075472
"12182","36006","2019",58,56,2,100290.672413793,1154.86206896552,92.4827586206897
"12183","36007","2019",2,2,0,99465,1164,83
"12184","36009","2019",14,14,0,130107.142857143,1116.07142857143,114.142857142857
"12185","36010","2019",12,12,0,83839.1666666667,760,106.75
"12186","36011","2019",3,3,0,102600,2109,56.6666666666667
"12187","36012","2019",2,2,0,93250,867.5,106.5
"12188","36013","2019",4,4,0,84500,779.75,110.25
"12189","36014","2019",2,2,0,80000,878.5,91.5
"12190","36015","2019",2,2,0,85000,656,128.5
"12191","36016","2019",18,18,0,88465.7222222222,743,114.722222222222
"12192","36017","2019",5,5,0,52300,662.4,78
"12193","36018","2019",65,59,6,92597.8769230769,934.861538461538,97.9384615384615
"12194","36019","2019",2,2,0,67500,917,71.5
"12195","36020","2019",1,1,0,159000,883,180
"12196","36021","2019",6,6,0,128650,1256.5,105.333333333333
"12197","36022","2019",8,8,0,73757.125,777,96.625
"12198","36023","2019",5,5,0,78800,832.6,93.8
"12199","36024","2019",1,1,0,195000,661,295
"12200","36025","2019",12,12,0,104443.083333333,911.416666666667,104.25
"12201","36026","2019",4,4,0,74000,772.75,87.25
"12202","36027","2019",1,1,0,185000,1682,110
"12203","36028","2019",5,5,0,34900,451.4,76.4
"12204","36029","2019",3,3,0,52333.3333333333,867.333333333333,60
"12205","36030","2019",1,1,0,40771,416,98
"12206","36031","2019",52,52,0,87927.4038461538,999.538461538462,88.9615384615385
"12207","36032","2019",7,7,0,85996.7142857143,980.714285714286,89.7142857142857
"12208","36033","2019",8,8,0,80937.5,698.125,112.375
"12209","36034","2019",33,33,0,116759.696969697,1276.09090909091,83.4848484848485
"12210","36035","2019",12,12,0,60529.1666666667,658.083333333333,90.75
"12211","36036","2019",2,2,0,198750,1201,132.5
"12212","36037","2019",1,1,0,30000,462,65
"12213","36038","2019",1,1,0,130000,1733,75
"12214","36042","2019",2,2,0,96500,1369,71
"12215","36043","2019",14,14,0,92189.4285714286,1065.07142857143,88.2857142857143
"12216","36044","2019",641,426,215,102782.911076443,1216.78471138846,85.0436817472699
"12217","36045","2019",23,23,0,93158.2608695652,970.652173913043,108.434782608696
"12218","36046","2019",53,44,9,83358.0943396226,969.301886792453,89.377358490566
"12219","36047","2019",9,9,0,78060.1111111111,791.777777777778,102
"12220","36048","2019",5,5,0,62441.6,767.2,82.4
"12221","36049","2019",3,3,0,81100,955.666666666667,77.6666666666667
"12222","36050","2019",10,10,0,82892.7,873,97.3
"12223","36051","2019",1,1,0,124900,1135,110
"12224","36052","2019",1,1,0,88000,989,89
"12225","36053","2019",5,5,0,89590,1011.4,82.6
"12226","36054","2019",5,5,0,167907.8,1735.6,101
"12227","36055","2019",13,13,0,73386,1147.53846153846,67.2307692307692
"12228","36056","2019",7,7,0,88928.5714285714,921.857142857143,101.285714285714
"12229","36057","2019",7,7,0,133933.285714286,1197.57142857143,102.428571428571
"12230","36058","2019",6,6,0,160483.333333333,1143,147.5
"12231","36059","2019",2,2,0,129750,1307,103
"12232","36060","2019",10,10,0,65513.9,805.8,81.3
"12233","36061","2019",7,7,0,36200,659.571428571429,56.1428571428571
"12234","36062","2019",10,10,0,92839.6,1175.1,75.2
"12235","36063","2019",114,112,2,114850.535087719,1235.58771929825,93.2368421052632
"12236","36064","2019",3,3,0,107666.666666667,961.666666666667,102
"12237","36066","2019",7,7,0,58700,816.285714285714,74.5714285714286
"12238","36067","2019",3,3,0,50333.3333333333,602,83.3333333333333
"12239","36068","2019",12,12,0,80673.5,735.25,109
"12240","36069","2019",16,16,0,74125,835.875,92.375
"12241","36070","2019",31,31,0,80251.2580645161,1059.70967741935,79.3870967741936
"12242","36071","2019",8,8,0,144862.875,1239.125,113
"12243","36073","2019",5,5,0,103630,1646,71.8
"12244","36074","2019",9,9,0,77711.1111111111,872.666666666667,91.7777777777778
"12245","36076","2019",4,4,0,59025,790,72.75
"12246","36077","2019",3,3,0,71266.6666666667,885.333333333333,77
"12247","36078","2019",8,8,0,80579.125,815.125,99.375
"12248","36079","2019",1,1,0,139000,818,170
"12249","36080","2019",2,2,0,83000,905.5,89
"12250","36081","2019",6,6,0,68741.6666666667,1033.5,77
"12251","36082","2019",3,3,0,69833.3333333333,1158,59
"12252","36083","2019",1,1,0,82000,617,133
"12253","36084","2019",1,1,0,67250,975,69
"12254","36085","2019",4,4,0,71600,891.75,77.25
"12255","36086","2019",8,8,0,88771.25,1009.25,86.25
"12256","36087","2019",4,4,0,74250,846.25,78
"12257","36088","2019",123,117,6,91099.8130081301,1121.94308943089,87.2439024390244
"12258","36089","2019",7,7,0,123071.428571429,1262.71428571429,101.142857142857
"12259","36090","2019",1,1,0,25000,581,43
"12260","36091","2019",6,6,0,95537.8333333333,1146.66666666667,84.1666666666667
"12261","36092","2019",2,2,0,250000,3462,89.5
"12262","36093","2019",30,30,0,92190.7666666667,914.333333333333,99.5333333333333
"12263","36094","2019",7,7,0,80642.8571428571,813.571428571429,103.857142857143
"12264","36095","2019",3,3,0,59676.6666666667,656.666666666667,89.3333333333333
"12265","36096","2019",7,7,0,152130,1575.42857142857,91.8571428571429
"12266","36097","2019",5,5,0,213407.4,1442.6,119
"12267","36098","2019",2,2,0,80000,884.5,97.5
"12268","36099","2019",9,9,0,71522.2222222222,933.777777777778,93.4444444444444
"12269","36100","2019",1,1,0,150000,1471,102
"12270","36101","2019",14,14,0,99575,1120,88.7142857142857
"12271","36102","2019",1,1,0,115000,1139,101
"12272","36103","2019",21,20,1,95836.0476190476,895.666666666667,94.2380952380952
"12273","36104","2019",1,1,0,81000,415,195
"12274","36106","2019",5,5,0,57800,676,84.8
"12275","36107","2019",6,6,0,102653.333333333,1204.33333333333,85.5
"12276","36108","2019",3,3,0,94000,1002.33333333333,88
"12277","36109","2019",10,10,0,91090,1311.8,71.3
"12278","36110","2019",3,3,0,69272.3333333333,734,89.3333333333333
"12279","36111","2019",2,2,0,123500,1258.5,97
"12280","36112","2019",9,9,0,102433.333333333,1114.11111111111,91.1111111111111
"12281","36113","2019",8,8,0,73387.5,790.75,92.25
"12282","36114","2019",1,1,0,120000,1379,87
"12283","36115","2019",1,1,0,1e+05,1493,67
"12284","36116","2019",3,3,0,60000,778.666666666667,76.6666666666667
"12285","36117","2019",8,7,1,87500,2299.375,65.25
"12286","36118","2019",6,6,0,84000,735,109.333333333333
"12287","36119","2019",9,9,0,74456.6666666667,764.666666666667,88.5555555555556
"12288","36120","2019",9,9,0,90700,971.222222222222,103.333333333333
"12289","36121","2019",2,2,0,113500,896.5,145
"12290","36122","2019",2,2,0,76500,892,82
"12291","36123","2019",11,11,0,79674.0909090909,778.818181818182,95.3636363636364
"12292","36125","2019",2,2,0,108400,866.5,115
"12293","36126","2019",8,8,0,75362.5,827.875,97.25
"12294","36127","2019",19,19,0,103800,1193.05263157895,96.4210526315789
"12295","36128","2019",15,15,0,106251.866666667,1055.66666666667,105.133333333333
"12296","36129","2019",11,11,0,64515,903.454545454545,69.9090909090909
"12297","36131","2019",1,1,0,60000,566,106
"12298","36133","2019",3,3,0,74500,991,77.6666666666667
"12299","36134","2019",2,2,0,98750,1223,78.5
"12300","36135","2019",2,2,0,82500,855.5,98
"12301","36136","2019",1,1,0,90000,1000,90
"12302","36137","2019",5,5,0,89660,1029,90
"12303","36138","2019",3,3,0,36933.3333333333,592,61.6666666666667
"12304","36139","2019",6,6,0,128146.666666667,1042.33333333333,120.666666666667
"12305","36140","2019",18,18,0,93294.4444444444,1127.22222222222,85.2222222222222
"12306","36141","2019",12,12,0,79875,932.5,80.5833333333333
"12307","36142","2019",20,20,0,91263.95,1072.4,82.8
"12308","36143","2019",8,8,0,71250,781.75,96.625
"12309","36144","2019",3,3,0,127018.666666667,1001.66666666667,121.666666666667
"12310","36145","2019",4,4,0,50875,601.75,91.5
"12311","36146","2019",9,9,0,56611.1111111111,561.777777777778,96.1111111111111
"12312","36147","2019",1,1,0,96788,2689,36
"12313","36148","2019",1,1,0,88000,677,130
"12314","36149","2019",7,7,0,70655.1428571429,1160.57142857143,67.2857142857143
"12315","36150","2019",8,8,0,66750,653.375,95.75
"12316","36152","2019",3,3,0,60833.3333333333,696.333333333333,89.3333333333333
"12317","36153","2019",3,3,0,90516.6666666667,1216,83
"12318","36154","2019",24,24,0,100936.833333333,1045.83333333333,97.3333333333333
"12319","36155","2019",4,4,0,36500,607.75,60
"12320","36156","2019",8,8,0,54937.5,682.5,79.375
"12321","36157","2019",1,1,0,90000,1023,88
"12322","36158","2019",20,19,1,80145,888.7,96.1
"12323","36159","2019",48,48,0,152573.0625,1555.27083333333,99.6666666666667
"12324","36160","2019",5,5,0,59142.8,870.6,74.8
"12325","36161","2019",12,11,1,82316.6666666667,1030.08333333333,80
"12326","36162","2019",18,18,0,82420.8333333333,980.055555555556,86.8888888888889
"12327","36163","2019",10,10,0,84907,861.3,97.6
"12328","36164","2019",4,4,0,98612,1271.75,80.5
"12329","36165","2019",8,8,0,90262.5,1194.25,83.25
"12330","36166","2019",2,2,0,109952.5,1019.5,123
"12331","36167","2019",2,2,0,87500,1061,78.5
"12332","36168","2019",9,9,0,59977.7777777778,717.777777777778,85.4444444444444
"12333","36169","2019",7,7,0,98928.5714285714,1007.85714285714,107.285714285714
"12334","36171","2019",31,30,1,75525.8064516129,849.193548387097,84.6451612903226
"12335","36172","2019",8,8,0,84731.25,904.125,92.5
"12336","36173","2019",7,7,0,235071.428571429,2721.14285714286,92.4285714285714
"12337","36174","2019",2,2,0,52358.5,642,81.5
"12338","36175","2019",7,7,0,77500,1131.28571428571,81
"12339","36176","2019",7,7,0,78449.2857142857,917,102.857142857143
"12340","36177","2019",4,4,0,62903.75,887.75,74.5
"12341","36178","2019",1,1,0,54000,406,133
"12342","36180","2019",11,11,0,78175.3636363636,1184,65.9090909090909
"12343","36181","2019",1,1,0,152270,1171,130
"12344","36182","2019",6,6,0,59313.3333333333,773.833333333333,71
"12345","36184","2019",6,6,0,81866.6666666667,903.333333333333,88
"12346","36185","2019",3,3,0,78500,813,91.6666666666667
"12347","36186","2019",1,1,0,87000,879,99
"12348","36187","2019",3,3,0,51013.3333333333,544.666666666667,87
"12349","36188","2019",3,3,0,142871.333333333,1149.33333333333,128.333333333333
"12350","36189","2019",8,8,0,64437.5,926.5,71.25
"12351","36190","2019",3,3,0,99633.3333333333,1038,96
"12352","36191","2019",5,5,0,86100,875.6,96.4
"12353","36192","2019",14,14,0,82133.5714285714,862.928571428571,92.4285714285714
"12354","36193","2019",6,6,0,94416.6666666667,1028.33333333333,99.8333333333333
"12355","36194","2019",22,22,0,69781.8181818182,882.590909090909,83
"12356","36195","2019",7,7,0,128071.428571429,1216.85714285714,105.857142857143
"12357","36196","2019",2,2,0,87555,1085,93
"12358","36197","2019",4,4,0,99000,1099.25,93.5
"12359","36198","2019",5,5,0,125780,1163.8,111
"12360","36199","2019",11,11,0,141045.454545455,1248.81818181818,113
"12361","36200","2019",29,29,0,85747.6896551724,938.827586206897,91.7931034482759
"12362","36202","2019",26,26,0,153261.538461538,1325.42307692308,117
"12363","36203","2019",2,2,0,91800,1303.5,59
"12364","36204","2019",5,5,0,271972,2557.4,111
"12365","36207","2019",11,11,0,68684.5454545455,695,95
"12366","36208","2019",1,1,0,68000,680,100
"12367","36209","2019",1,1,0,128000,837,153
"12368","36210","2019",3,3,0,87233.3333333333,1074.33333333333,80.6666666666667
"12369","36211","2019",2,2,0,170000,1401,122
"12370","36212","2019",1,1,0,67000,447,150
"12371","36213","2019",4,4,0,94030,1105.25,76.5
"12372","36214","2019",6,6,0,94833.3333333333,798.666666666667,112.166666666667
"12373","36215","2019",10,10,0,105473.2,1089.5,96.2
"12374","36216","2019",1,1,0,19500,513,38
"12375","36217","2019",2,2,0,65500,785,79.5
"12376","36218","2019",3,3,0,103200,934.666666666667,106.333333333333
"12377","36219","2019",10,10,0,100720,1062.8,100.6
"12378","36220","2019",7,7,0,59451.4285714286,722.857142857143,83.7142857142857
"12379","36221","2019",2,2,0,83250,726,108.5
"12380","36222","2019",3,3,0,74500,845.333333333333,88.6666666666667
"12381","36223","2019",1,1,0,27000,386,70
"12382","36224","2019",11,11,0,69291.1818181818,870.636363636364,83
"12383","36225","2019",1,1,0,379482,4413,86
"12384","36226","2019",6,6,0,77166.6666666667,871.333333333333,86.1666666666667
"12385","36227","2019",4,4,0,83000,852.25,94.75
"12386","36228","2019",36,34,2,108862.416666667,1054.58333333333,95.3333333333333
"12387","36229","2019",14,14,0,67503.5714285714,936.142857142857,80.5714285714286
"12388","36230","2019",28,27,1,99010.5357142857,1012.57142857143,93.3571428571429
"12389","36231","2019",8,8,0,116875,1330.25,90.375
"12390","36232","2019",17,17,0,73534.7058823529,919.235294117647,80.2352941176471
"12391","36233","2019",11,11,0,81354.5454545455,1072.63636363636,85
"12392","36234","2019",1,1,0,88752,785,113
"12393","36235","2019",3,3,0,51433.3333333333,683,70
"12394","36236","2019",4,4,0,50750,673.25,68.5
"12395","36237","2019",10,10,0,67660,790.8,84.2
"12396","36238","2019",1,1,0,57000,1036,55
"12397","36239","2019",5,5,0,104600,796,140.2
"12398","36240","2019",4,4,0,103105,1037.25,109
"12399","36241","2019",21,21,0,80352.3809523809,907.571428571429,92.9523809523809
"12400","36243","2019",6,6,0,92680.5,963.666666666667,98.5
"12401","36244","2019",18,18,0,81278.1666666667,843.555555555556,102.5
"12402","36246","2019",3,3,0,94625,1111.66666666667,82.3333333333333
"12403","36247","2019",18,18,0,132738.888888889,1189.61111111111,118.111111111111
"12404","36248","2019",2,2,0,105000,1213,86
"12405","37001","2019",14,14,0,94817.8571428571,1071.14285714286,88
"12406","37002","2019",27,27,0,203436.962962963,1909,105.666666666667
"12407","37003","2019",229,159,70,186977.458515284,2080.25327510917,91.7379912663755
"12408","37004","2019",6,6,0,148437.5,1315.33333333333,109.333333333333
"12409","37005","2019",5,5,0,79400,813.4,102.2
"12410","37006","2019",33,32,1,199649.666666667,1826.15151515152,114.181818181818
"12411","37007","2019",4,4,0,137512.5,1166.75,117
"12412","37008","2019",41,41,0,171328.292682927,1806.12195121951,101.439024390244
"12413","37009","2019",5,5,0,190000,1494.6,133.4
"12414","37010","2019",27,27,0,126833.62962963,1481.44444444444,90.5925925925926
"12415","37011","2019",24,17,7,132570.833333333,2074.58333333333,84.375
"12416","37012","2019",6,6,0,141166.666666667,1390,104.333333333333
"12417","37013","2019",6,6,0,157955,1648,95
"12418","37014","2019",67,58,9,179023.328358209,1922.55223880597,94.0746268656716
"12419","37015","2019",50,50,0,218595.54,1930.96,119.42
"12420","37016","2019",12,12,0,135250,1428.41666666667,97
"12421","37018","2019",108,76,32,237668.814814815,2454.80555555556,97.3148148148148
"12422","37019","2019",9,9,0,87194.4444444444,1080.66666666667,87
"12423","37020","2019",25,25,0,124232,1371.12,87.4
"12424","37021","2019",22,22,0,177821.818181818,1703.90909090909,114.545454545455
"12425","37022","2019",36,36,0,157666.833333333,1453.77777777778,106.444444444444
"12426","37023","2019",5,5,0,221177.4,1475,154.8
"12427","37024","2019",16,16,0,130718.75,1472.1875,94.375
"12428","37025","2019",16,16,0,206622.5,2218.25,95.375
"12429","37026","2019",9,8,1,69044.4444444444,721.666666666667,95.4444444444444
"12430","37027","2019",73,67,6,179511.945205479,1878.53424657534,97.2191780821918
"12431","37028","2019",9,9,0,83144.4444444444,868.888888888889,96.7777777777778
"12432","37029","2019",5,5,0,161500,1398.4,117.2
"12433","37030","2019",15,15,0,151505.8,1577.2,105.266666666667
"12434","37031","2019",57,55,2,148348.122807018,1459.98245614035,103.754385964912
"12435","37032","2019",7,7,0,105331.428571429,1225.28571428571,94.8571428571429
"12436","37033","2019",3,3,0,139933.333333333,1147.33333333333,114
"12437","37034","2019",7,7,0,132716.428571429,941.857142857143,126
"12438","37035","2019",3,3,0,162666.666666667,1018,158.333333333333
"12439","37036","2019",1,1,0,145000,1036,140
"12440","37037","2019",5,5,0,116904,1605.4,82.4
"12441","37038","2019",10,10,0,175850,1462.3,123.4
"12442","37039","2019",3,3,0,97000,880.666666666667,116
"12443","37040","2019",2,2,0,88060.5,885,94.5
"12444","37041","2019",2,2,0,88750,849,130
"12445","37042","2019",4,4,0,284125,1523.75,169.25
"12446","37043","2019",9,9,0,170404.444444444,1544.66666666667,101.444444444444
"12447","37044","2019",6,6,0,100565,818.5,123.666666666667
"12448","37045","2019",7,7,0,91571.4285714286,977.285714285714,93
"12449","37046","2019",7,7,0,102000,1073.42857142857,105.142857142857
"12450","37047","2019",4,4,0,228060,1882.25,128
"12451","37048","2019",5,5,0,95400,719,118
"12452","37049","2019",17,17,0,140535.294117647,1506.11764705882,97.5882352941177
"12453","37050","2019",214,109,105,185544.808411215,2262.78504672897,82.0794392523364
"12454","37051","2019",8,8,0,109949.125,987.375,112.25
"12455","37052","2019",13,13,0,135423.076923077,1581,97.6153846153846
"12456","37053","2019",1,1,0,341750,1356,252
"12457","37054","2019",32,31,1,216982.96875,2300.71875,97.15625
"12458","37055","2019",13,13,0,139884.615384615,1345.69230769231,102.230769230769
"12459","37056","2019",10,10,0,153266.7,1553.8,101.1
"12460","37057","2019",11,11,0,156613.636363636,1382.27272727273,122.363636363636
"12461","37058","2019",20,19,1,126250,1284.25,101.7
"12462","37059","2019",15,15,0,409500,2647.86666666667,132.666666666667
"12463","37060","2019",16,16,0,197915.625,1903.625,106.1875
"12464","37061","2019",7,7,0,85085.7142857143,806.285714285714,99.8571428571429
"12465","37062","2019",27,27,0,119074.074074074,1339.18518518519,95.7037037037037
"12466","37063","2019",55,50,5,113579.636363636,1152.69090909091,96.6909090909091
"12467","37064","2019",3,3,0,60266.6666666667,1082.33333333333,63.3333333333333
"12468","37065","2019",8,8,0,181720.75,1258.625,127.875
"12469","37066","2019",9,9,0,128588.888888889,1556.22222222222,84.5555555555556
"12470","37067","2019",18,18,0,236030.333333333,2122.83333333333,115.555555555556
"12471","37068","2019",8,8,0,120437.5,1062.625,117.25
"12472","37069","2019",5,5,0,112600,1160.2,116.4
"12473","37070","2019",6,6,0,247500,3267,97.8333333333333
"12474","37071","2019",2,2,0,85000,640.5,136
"12475","37072","2019",132,101,31,138989.28030303,1522.16666666667,93.75
"12476","37073","2019",12,12,0,119333.333333333,1426,82.6666666666667
"12477","37074","2019",41,41,0,110734.780487805,1203.53658536585,95.609756097561
"12478","37075","2019",7,7,0,159857.142857143,1256.42857142857,133.285714285714
"12479","37076","2019",4,4,0,153835,1273.5,123.5
"12480","37077","2019",44,43,1,176007.090909091,1781,101.454545454545
"12481","37078","2019",2,2,0,136500,1384.5,103.5
"12482","37079","2019",27,27,0,154676.296296296,1570.92592592593,102.333333333333
"12483","37080","2019",4,4,0,145114.25,1446.75,121.25
"12484","37081","2019",24,24,0,163695.208333333,1463.95833333333,111.708333333333
"12485","37082","2019",8,8,0,73318.75,945.125,76
"12486","37083","2019",27,25,2,146083.518518519,1586.18518518519,96.3703703703704
"12487","37084","2019",5,5,0,133980,1724,64.8
"12488","37085","2019",14,14,0,210488.857142857,1504.21428571429,141.142857142857
"12489","37086","2019",7,7,0,115500,1267,91.7142857142857
"12490","37087","2019",3,3,0,273776.333333333,1065,232.666666666667
"12491","37088","2019",1,1,0,180000,1216,148
"12492","37089","2019",8,8,0,113250,1101.875,106.125
"12493","37091","2019",37,37,0,168463.513513514,1893.78378378378,94.6486486486486
"12494","37092","2019",6,6,0,201866.666666667,1799.83333333333,115.333333333333
"12495","37093","2019",10,10,0,126192.2,1203.2,95.3
"12496","37094","2019",4,4,0,104489.25,960,117.5
"12497","37095","2019",6,6,0,176166.666666667,1477.33333333333,122.666666666667
"12498","37096","2019",9,9,0,148888.888888889,1564.77777777778,96.8888888888889
"12499","37097","2019",10,10,0,179519.5,1910.1,103.9
"12500","37098","2019",8,8,0,129062.5,1516.25,88.75
"12501","37099","2019",7,7,0,260664.857142857,2466.14285714286,113.571428571429
"12502","37100","2019",7,7,0,170071.428571429,1494,112.857142857143
"12503","37101","2019",2,2,0,82514,1566.5,55.5
"12504","37103","2019",4,4,0,46500,622.25,71.75
"12505","37104","2019",62,61,1,216894.709677419,2115.16129032258,103.225806451613
"12506","37105","2019",1,1,0,25000,500,50
"12507","37106","2019",7,7,0,126300,1135.85714285714,106.571428571429
"12508","37107","2019",4,4,0,83250,1088,83
"12509","37108","2019",9,9,0,178605.555555556,1662.33333333333,108.333333333333
"12510","37109","2019",130,119,11,280004.938461538,2477.05384615385,114.176923076923
"12511","37110","2019",20,20,0,199638.5,1725,115.05
"12512","37111","2019",25,25,0,115281.56,1275.28,95.8
"12513","37112","2019",4,4,0,126750,1433.25,102
"12514","37113","2019",18,18,0,86024.0555555556,1065.66666666667,82.0555555555556
"12515","37114","2019",2,2,0,35500,569,58.5
"12516","37115","2019",52,49,3,81838.4615384615,1018.28846153846,77.4038461538462
"12517","37116","2019",8,8,0,80250,1164.375,68.5
"12518","37117","2019",7,6,1,149785.714285714,1279.85714285714,114.571428571429
"12519","37118","2019",23,23,0,120065.652173913,1357.91304347826,91.5652173913043
"12520","37119","2019",24,24,0,118256.25,1126.70833333333,105.291666666667
"12521","37121","2019",3,3,0,68160,778.333333333333,87
"12522","37122","2019",596,282,314,144736.593959732,1939.02013422819,74.3758389261745
"12523","37123","2019",60,58,2,166730.383333333,1695.96666666667,98.6166666666667
"12524","37124","2019",32,32,0,259504.28125,2506.96875,102.375
"12525","37125","2019",3,3,0,170600,1358.33333333333,119.666666666667
"12526","37126","2019",4,4,0,114750,1161.5,96.25
"12527","37127","2019",1,1,0,65000,1300,50
"12528","37128","2019",19,19,0,153950.526315789,1580.31578947368,103.631578947368
"12529","37129","2019",16,16,0,133105.25,1264.375,104.875
"12530","37130","2019",31,30,1,114308.064516129,1150.1935483871,97.6774193548387
"12531","37131","2019",23,23,0,144351.739130435,1584.08695652174,96.8695652173913
"12532","37132","2019",85,70,15,127968.082352941,1569.63529411765,84.6117647058824
"12533","37133","2019",8,8,0,79525,947.375,89.5
"12534","37134","2019",10,10,0,138156,1491.3,96.8
"12535","37136","2019",6,6,0,186150,1576.66666666667,120.333333333333
"12536","37137","2019",1,1,0,55000,387,142
"12537","37138","2019",16,16,0,209962.5625,1936.3125,110.1875
"12538","37139","2019",63,57,6,219050.650793651,2199.46031746032,103.492063492063
"12539","37140","2019",3,3,0,133000,1148,123.666666666667
"12540","37141","2019",16,16,0,138128.125,1559.125,94.1875
"12541","37142","2019",4,4,0,157712.5,1946.5,91.25
"12542","37143","2019",12,12,0,125515,1185.08333333333,113.416666666667
"12543","37144","2019",5,5,0,122100,1212.6,102.6
"12544","37145","2019",2,2,0,90000,1423.5,66.5
"12545","37146","2019",2,2,0,236375,2535.5,107
"12546","37147","2019",12,12,0,137875,1377.83333333333,104.583333333333
"12547","37148","2019",4,4,0,115964.5,938.25,117.75
"12548","37149","2019",13,13,0,153076.923076923,1769.46153846154,99.3076923076923
"12549","37150","2019",14,14,0,174889.285714286,1726.5,103.214285714286
"12550","37151","2019",40,40,0,298600.625,2594.55,123.325
"12551","37152","2019",25,25,0,249229.84,2296.88,112.6
"12552","37153","2019",56,55,1,190188.571428571,2020.03571428571,97.5892857142857
"12553","37154","2019",57,53,4,228643.543859649,2409.57894736842,99.2456140350877
"12554","37155","2019",8,8,0,106625,1334.125,79.75
"12555","37156","2019",136,124,12,203870.125,2179.24264705882,99.375
"12556","37157","2019",4,4,0,113766.25,1675,67
"12557","37158","2019",6,6,0,192666.666666667,1445.66666666667,137.5
"12558","37159","2019",93,81,12,194704.139784946,2011.82795698925,98.8817204301075
"12559","37160","2019",2,2,0,99000,1386,66.5
"12560","37161","2019",12,12,0,138251.666666667,1778.25,79.5833333333333
"12561","37162","2019",3,3,0,118666.666666667,1123,107
"12562","37163","2019",53,53,0,172110.79245283,1878,94.8490566037736
"12563","37165","2019",1,1,0,86000,2048,42
"12564","37166","2019",12,12,0,161379.166666667,2415.58333333333,92.5
"12565","37167","2019",25,25,0,183495.8,2135.48,98
"12566","37168","2019",9,9,0,96355.4444444444,1412,67.2222222222222
"12567","37169","2019",8,8,0,105475,1290,84.125
"12568","37170","2019",20,19,1,175330,1737.55,101.55
"12569","37171","2019",21,21,0,173567.142857143,1912.14285714286,96.6190476190476
"12570","37172","2019",49,44,5,220014.755102041,2252.0612244898,100.571428571429
"12571","37173","2019",11,11,0,69159.0909090909,893.545454545455,74.8181818181818
"12572","37174","2019",11,11,0,186804.545454545,1352.90909090909,128.727272727273
"12573","37175","2019",9,9,0,184444.444444444,2050.22222222222,96.6666666666667
"12574","37176","2019",14,14,0,168932.142857143,1694.07142857143,101.571428571429
"12575","37177","2019",11,11,0,64727.2727272727,799.090909090909,79.3636363636364
"12576","37178","2019",10,10,0,150959.8,1376.9,89.9
"12577","37179","2019",25,25,0,241395.2,2608.24,93.64
"12578","37180","2019",9,9,0,129960.222222222,1568.77777777778,96.5555555555556
"12579","37181","2019",5,5,0,79600,678.2,119.8
"12580","37182","2019",16,16,0,210291.875,2171.0625,97.25
"12581","37183","2019",15,14,1,279477.733333333,2381.86666666667,104.2
"12582","37184","2019",5,5,0,67200,1031,66.2
"12583","37185","2019",16,16,0,249285.9375,2150.1875,114.625
"12584","37186","2019",20,20,0,196592.2,1914.65,106.25
"12585","37187","2019",4,4,0,148750,950,154.25
"12586","37188","2019",10,10,0,117415,1265.7,93.3
"12587","37189","2019",11,11,0,79090.9090909091,896.090909090909,86
"12588","37190","2019",1,1,0,70000,753,93
"12589","37191","2019",1,1,0,55000,430,128
"12590","37192","2019",13,13,0,144584.615384615,1568.23076923077,93.8461538461538
"12591","37193","2019",17,17,0,157485.294117647,1386.29411764706,113.117647058824
"12592","37194","2019",20,19,1,167290,1752.25,97.4
"12593","37195","2019",204,57,147,158949.740196078,2318.11274509804,70.8039215686274
"12594","37196","2019",22,21,1,108538.818181818,1174.40909090909,86.3636363636364
"12595","37197","2019",8,8,0,152871.25,1527.625,104
"12596","37198","2019",10,9,1,107867,1089.4,85.8
"12597","37199","2019",8,8,0,89239.875,923.5,99.75
"12598","37200","2019",9,9,0,114666.666666667,1107.55555555556,99.5555555555556
"12599","37201","2019",8,8,0,178600.875,1552.375,118.375
"12600","37202","2019",6,6,0,167766.666666667,1760.66666666667,101.833333333333
"12601","37203","2019",42,38,4,259677.023809524,2901.54761904762,93.7857142857143
"12602","37204","2019",13,13,0,214742.538461538,1860.15384615385,114.076923076923
"12603","37205","2019",16,16,0,167824.375,1744.5625,100.3125
"12604","37206","2019",29,27,2,214011.896551724,1858,116.206896551724
"12605","37207","2019",7,7,0,86419.7142857143,1021,98.7142857142857
"12606","37208","2019",208,155,53,261157.572115385,2515.02403846154,107.067307692308
"12607","37210","2019",11,11,0,168415.454545455,1684.72727272727,101
"12608","37211","2019",36,36,0,189875.833333333,1809.55555555556,108.305555555556
"12609","37212","2019",10,10,0,161350.1,1392.4,114.7
"12610","37213","2019",13,13,0,128853.846153846,1492.84615384615,87.3846153846154
"12611","37214","2019",355,153,202,224787.909859155,2594.58028169014,84.2338028169014
"12612","37216","2019",20,20,0,152305,1403.2,104.55
"12613","37217","2019",19,19,0,170309.789473684,1788,100.947368421053
"12614","37218","2019",14,14,0,80830.7857142857,919.714285714286,84.7142857142857
"12615","37219","2019",13,13,0,196200,2038.53846153846,102.538461538462
"12616","37220","2019",7,7,0,126285.714285714,1204.57142857143,109.714285714286
"12617","37221","2019",5,5,0,103028,1290.6,81.6
"12618","37222","2019",8,8,0,165500,1914.375,95.625
"12619","37223","2019",4,4,0,107000,1565.5,81.25
"12620","37224","2019",12,12,0,119641.666666667,1377.75,85.1666666666667
"12621","37225","2019",46,45,1,170783.760869565,1942.45652173913,91.5
"12622","37226","2019",47,46,1,142570.829787234,1521.14893617021,100.872340425532
"12623","37228","2019",12,12,0,165133.333333333,2278.75,96.8333333333333
"12624","37229","2019",6,6,0,167198.333333333,1661.16666666667,103.666666666667
"12625","37230","2019",14,14,0,187800,1819.35714285714,107.928571428571
"12626","37231","2019",24,24,0,119692.083333333,1310.29166666667,91.3333333333333
"12627","37232","2019",35,35,0,162348.514285714,1463.2,114.571428571429
"12628","37233","2019",180,115,65,150945.127777778,1929.74444444444,79.5944444444444
"12629","37234","2019",5,5,0,156940,1388.2,122.2
"12630","37236","2019",7,7,0,218928.571428571,2160.71428571429,107.571428571429
"12631","37237","2019",18,17,1,233255.555555556,2346.33333333333,100.333333333333
"12632","37238","2019",3,3,0,112666.666666667,1185,95.3333333333333
"12633","37240","2019",9,9,0,134323.333333333,1294.88888888889,109.111111111111
"12634","37241","2019",14,14,0,127489.285714286,1338.64285714286,93.0714285714286
"12635","37242","2019",12,12,0,137319.416666667,1468.5,94.5
"12636","37243","2019",40,39,1,236510.975,2526.175,97.05
"12637","37244","2019",2,2,0,167500,1570,96.5
"12638","37245","2019",30,30,0,204205.133333333,1973.8,110.533333333333
"12639","37247","2019",12,12,0,114653.083333333,1220.83333333333,98.4166666666667
"12640","37248","2019",6,6,0,151666.666666667,1384,106.666666666667
"12641","37249","2019",12,12,0,144995.833333333,1461.91666666667,98.5833333333333
"12642","37250","2019",32,32,0,179746.5625,2008.59375,91.40625
"12643","37251","2019",12,12,0,169508.333333333,2020.66666666667,92.6666666666667
"12644","37252","2019",8,8,0,159812.5,1452.625,110.5
"12645","37253","2019",2,2,0,258500,1722,167
"12646","37254","2019",22,22,0,151923.954545455,1593,101.136363636364
"12647","37255","2019",5,5,0,234700,1720,131.8
"12648","37256","2019",1,1,0,235400,1177,200
"12649","37257","2019",16,16,0,219040.625,1981.5625,111.5625
"12650","37258","2019",4,4,0,161125,1453,117.75
"12651","37259","2019",4,4,0,70375,1158,75.75
"12652","37260","2019",6,6,0,101583.333333333,1064,93.5
"12653","37261","2019",2510,586,1924,167327.005976096,2523.74501992032,66.0641434262948
"12654","37262","2019",7,7,0,114328.571428571,1248.42857142857,93.4285714285714
"12655","37263","2019",33,33,0,172241.212121212,1839.72727272727,94
"12656","37264","2019",17,17,0,214011.352941176,2016.11764705882,113.117647058824
"12657","37265","2019",1,1,0,150000,1154,130
"12658","37266","2019",81,80,1,233821.24691358,2219.98765432099,109.604938271605
"12659","37267","2019",55,54,1,247982.581818182,2216.52727272727,114.509090909091
"12660","37268","2019",2,2,0,128000,1684,87.5
"12661","37269","2019",5,5,0,93430,1431.8,91.6
"12662","37270","2019",33,33,0,231827.727272727,2190.90909090909,109.818181818182
"12663","37271","2019",16,16,0,131562.5,1606.375,86.8125
"12664","37272","2019",14,14,0,198511.428571429,1808.35714285714,113.5
"12665","37273","2019",53,48,5,197435.471698113,2368.98113207547,91.9245283018868
"12666","37274","2019",3,3,0,109666.666666667,1344,78.3333333333333
"12667","37276","2019",14,14,0,158282.857142857,2001,92.6428571428571
"12668","37277","2019",9,9,0,116355.555555556,983.777777777778,124.333333333333
"12669","37278","2019",14,14,0,154035.714285714,1601,102.5
"12670","37279","2019",19,19,0,105842.105263158,1284.15789473684,86.1052631578947
"12671","37280","2019",5,5,0,170080,1347.4,115.2
"12672","37281","2019",38,32,6,244225,2146.71052631579,114.894736842105
"12673","37282","2019",14,14,0,78562.8571428571,953.071428571429,87.3571428571429
"12674","38001","2019",135,103,32,165362.711111111,1818.35555555556,92.0666666666667
"12675","38002","2019",54,6,48,93914.2962962963,2476.7037037037,37.0185185185185
"12676","38003","2019",13,13,0,167073.076923077,1475,113.846153846154
"12677","38004","2019",10,9,1,192297.7,1880.9,104.9
"12678","38005","2019",32,21,11,200822.6875,2274.15625,89.84375
"12679","38006","2019",97,40,57,129223.206185567,1872.9175257732,66.1237113402062
"12680","38008","2019",1,1,0,155000,1722,90
"12681","38009","2019",6,6,0,177958.333333333,2233.66666666667,79.5
"12682","38010","2019",7,7,0,184285.714285714,2692.57142857143,73.1428571428571
"12683","38011","2019",12,8,4,264726.666666667,3190,86.5
"12684","38012","2019",64,43,21,150226.609375,1822.5625,82.53125
"12685","38013","2019",41,37,4,205205.12195122,2152.14634146341,97.5853658536585
"12686","38015","2019",17,17,0,174223.529411765,1880.94117647059,99.7647058823529
"12687","38017","2019",29,27,2,185612.275862069,1713,109.241379310345
"12688","38018","2019",1,1,0,145000,1726,84
"12689","38019","2019",25,17,8,177356,1839.44,96.36
"12690","38020","2019",34,1,33,66670.2352941177,2197.08823529412,30.1764705882353
"12691","38022","2019",119,95,24,163567.050420168,1753.44537815126,96.9243697478992
"12692","38023","2019",2,2,0,206000,1882.5,114.5
"12693","38026","2019",15,15,0,210893.666666667,2038.73333333333,104.533333333333
"12694","38027","2019",32,28,4,233499.875,2358.78125,98.4375
"12695","38029","2019",30,30,0,200166.5,1992.5,109.666666666667
"12696","38030","2019",15,14,1,220319.333333333,2127.53333333333,108.933333333333
"12697","38031","2019",1,1,0,40000,1481,27
"12698","38032","2019",6,6,0,166397.833333333,1673.16666666667,99.1666666666667
"12699","38033","2019",2,2,0,325000,2562.5,123.5
"12700","38034","2019",64,56,8,162251.390625,1534.359375,108.96875
"12701","38035","2019",22,20,2,224028.636363636,2123.36363636364,113.045454545455
"12702","38037","2019",10,10,0,177940,1599.1,119.3
"12703","38038","2019",6,6,0,185216.666666667,2020.83333333333,89.3333333333333
"12704","38039","2019",28,16,12,310882.964285714,3285.89285714286,96.5
"12705","38040","2019",3,2,1,94500,2014,46
"12706","38041","2019",1,0,1,35000,479,73
"12707","38042","2019",11,11,0,220867.272727273,2147.72727272727,105
"12708","38043","2019",20,19,1,224491.35,1888.45,122.3
"12709","38044","2019",13,13,0,179884,1851.30769230769,104.230769230769
"12710","38045","2019",23,21,2,501547.826086957,4357.60869565217,118.04347826087
"12711","38046","2019",17,17,0,189583.529411765,1802.94117647059,107.823529411765
"12712","38047","2019",1,1,0,79999,1194,67
"12713","38048","2019",12,11,1,209613.333333333,2010.33333333333,106.583333333333
"12714","38049","2019",4,4,0,175175,1520,115.75
"12715","38050","2019",9,9,0,170357.888888889,1536.55555555556,116.333333333333
"12716","38051","2019",19,19,0,204834.210526316,1827.84210526316,116.526315789474
"12717","38052","2019",50,31,19,176738.16,2306.48,79.18
"12718","38053","2019",501,147,354,159297.407185629,2141.87425149701,74.7385229540918
"12719","38054","2019",17,17,0,164305.294117647,1823.41176470588,90.8823529411765
"12720","38055","2019",8,8,0,199312.5,1792,111.375
"12721","38056","2019",1,1,0,205000,3417,60
"12722","38057","2019",13,11,2,369190.384615385,3011.46153846154,123.923076923077
"12723","38058","2019",26,24,2,204520.884615385,1942.15384615385,112.538461538462
"12724","38059","2019",23,16,7,400770.52173913,3346.04347826087,119.173913043478
"12725","38060","2019",2,2,0,189000,1709.5,111
"12726","38061","2019",63,47,16,277216.523809524,2717.88888888889,101.52380952381
"12727","38062","2019",12,12,0,240550,2256.75,110.75
"12728","38063","2019",10,9,1,204400,1715.6,128.3
"12729","38064","2019",47,44,3,191101.914893617,1870.76595744681,106.127659574468
"12730","38065","2019",24,21,3,164992.916666667,1712.75,99.6666666666667
"12731","38066","2019",2,2,0,190000,2500,76
"12732","38067","2019",28,21,7,282171.964285714,2435.67857142857,115.892857142857
"12733","38068","2019",12,12,0,423010.583333333,3851.16666666667,115.833333333333
"12734","38069","2019",20,16,4,169295,1773.15,96.7
"12735","38070","2019",9,5,4,239332.333333333,2366.33333333333,98
"12736","38071","2019",31,23,8,223956.774193548,2635.35483870968,85.5483870967742
"12737","38072","2019",29,26,3,169080,1739.93103448276,101.827586206897
"12738","38073","2019",1,1,0,190000,1638,116
"12739","38074","2019",6,6,0,214450,2190.33333333333,102.333333333333
"12740","38075","2019",37,30,7,257410.810810811,2547.43243243243,107.135135135135
"12741","38076","2019",25,24,1,218778.76,2042.76,112.72
"12742","38077","2019",7,7,0,263257.142857143,1935.28571428571,138.571428571429
"12743","38078","2019",6,6,0,218231.5,1868.66666666667,116.833333333333
"12744","38080","2019",9,8,1,186494.666666667,1910.77777777778,99.3333333333333
"12745","38081","2019",24,24,0,231534.75,2353.95833333333,101.125
"12746","38082","2019",31,27,4,178459.709677419,1867.90322580645,100.032258064516
"12747","38083","2019",5,5,0,231054.4,1899.6,122
"12748","38084","2019",15,15,0,253664,1981.26666666667,126.4
"12749","38085","2019",136,117,19,229174.102941176,2471.36029411765,95.5294117647059
"12750","38086","2019",3,2,1,101225.666666667,1439.66666666667,76.3333333333333
"12751","38087","2019",67,56,11,253572.537313433,2554.26865671642,97
"12752","38089","2019",2,2,0,208500,1561,133
"12753","38090","2019",3,3,0,140500,1580,92.3333333333333
"12754","38091","2019",6,6,0,241750,2079,110.833333333333
"12755","38092","2019",2,2,0,129500,1240.5,98
"12756","38093","2019",4,3,1,155262.5,1579.5,103.75
"12757","38094","2019",28,26,2,173624.714285714,1913.03571428571,94.3928571428571
"12758","38095","2019",25,24,1,180730.48,1764.96,103.92
"12759","38097","2019",67,55,12,235240.28358209,2594.98507462687,93.1791044776119
"12760","38098","2019",6,6,0,208237.5,1977.66666666667,109.333333333333
"12761","38099","2019",9,8,1,213229.666666667,2070.33333333333,108.222222222222
"12762","38100","2019",20,16,4,240281.85,2472.6,99.45
"12763","38101","2019",11,11,0,253565,2102.45454545455,115.909090909091
"12764","38102","2019",3,3,0,324833.333333333,2514,134
"12765","38103","2019",5,4,1,130260,1330.2,111.6
"12766","38104","2019",16,16,0,201868.375,1857.1875,105.75
"12767","38105","2019",32,31,1,232954.4375,2023.75,117.09375
"12768","38106","2019",2,2,0,117500,1229,90
"12769","38107","2019",20,16,4,217000.95,2016.45,107.4
"12770","38108","2019",3,3,0,154333.333333333,1506.66666666667,103.333333333333
"12771","38109","2019",6,6,0,336502.5,2549.33333333333,140.333333333333
"12772","38110","2019",27,23,4,273439.259259259,2667.33333333333,107.037037037037
"12773","38111","2019",93,58,35,321734.247311828,3168.39784946237,102.47311827957
"12774","38112","2019",1,1,0,135000,2250,60
"12775","38113","2019",8,8,0,187138,1941.375,97
"12776","38114","2019",20,20,0,225496.75,2044.5,110.95
"12777","38115","2019",4,4,0,278187.5,2387.5,119
"12778","38117","2019",7,7,0,148614.285714286,1392.57142857143,109.285714285714
"12779","38118","2019",18,18,0,218257.888888889,2311.77777777778,98.1111111111111
"12780","38120","2019",7,7,0,272637.142857143,2506.57142857143,111.428571428571
"12781","38124","2019",27,26,1,186372.592592593,1799.07407407407,106.666666666667
"12782","38126","2019",54,37,17,499948.351851852,3831.42592592593,135.351851851852
"12783","38128","2019",10,9,1,112814.5,1265.2,88.2
"12784","38129","2019",31,6,25,136994.64516129,2906,43.9032258064516
"12785","38130","2019",74,53,21,151622.027027027,1672.13513513514,93.3648648648649
"12786","38131","2019",22,20,2,288174.590909091,2389.36363636364,122.5
"12787","38132","2019",2,2,0,1e+05,1355.5,81.5
"12788","38133","2019",65,49,16,297236.061538462,2948.27692307692,103.923076923077
"12789","38134","2019",14,14,0,257021.571428571,2156.71428571429,124.214285714286
"12790","38135","2019",23,23,0,173976.52173913,1779.47826086957,104.130434782609
"12791","38136","2019",3,3,0,245816.666666667,2334.33333333333,109.666666666667
"12792","38137","2019",2,2,0,200500,2145,86.5
"12793","38138","2019",89,32,57,188988.674157303,2531.69662921348,76.4719101123596
"12794","38139","2019",26,23,3,162418.923076923,1678.76923076923,100.038461538462
"12795","38140","2019",86,60,26,305850.930232558,3315.6976744186,94.6162790697674
"12796","38141","2019",7,7,0,246457.142857143,2286.28571428571,105.571428571429
"12797","38144","2019",21,17,4,211846.19047619,2326.09523809524,94.5238095238095
"12798","38146","2019",8,7,1,288762.5,2456.375,131
"12799","38147","2019",11,11,0,192287.272727273,1470.18181818182,132.454545454545
"12800","38148","2019",47,43,4,208029.255319149,1924.40425531915,110.31914893617
"12801","38149","2019",19,18,1,261077.894736842,2261.36842105263,114.473684210526
"12802","38150","2019",82,22,60,184805.768292683,2474.68292682927,74.7560975609756
"12803","38151","2019",441,60,381,141474.476190476,1907.82766439909,75.312925170068
"12804","38152","2019",26,26,0,183809.230769231,1748.76923076923,103.769230769231
"12805","38153","2019",4,4,0,326680,2161,153.25
"12806","38154","2019",3,3,0,167833.333333333,1596,107
"12807","38155","2019",19,18,1,176822.631578947,2241.78947368421,89.5789473684211
"12808","38156","2019",15,15,0,203306.666666667,2192.6,92.4
"12809","38157","2019",42,40,2,242932.785714286,2199.80952380952,114.595238095238
"12810","38158","2019",157,30,127,217539.49044586,2845.84076433121,76.7006369426752
"12811","38159","2019",8,8,0,179383.75,1735.875,105.875
"12812","38160","2019",23,21,2,195140.869565217,2002.69565217391,95.1739130434783
"12813","38161","2019",15,14,1,181312.266666667,1360.8,127.666666666667
"12814","38162","2019",15,15,0,200596.666666667,1838.4,117.2
"12815","38163","2019",32,13,19,80745.15625,1735.28125,47.53125
"12816","38166","2019",5,4,1,273874,2464.6,112
"12817","38167","2019",7,7,0,189035.714285714,1808.71428571429,105.285714285714
"12818","38169","2019",300,46,254,139899.52,2023.54666666667,67.84
"12819","38170","2019",46,11,35,226470.543478261,3038.02173913043,74.0652173913043
"12820","38171","2019",3,3,0,201236.666666667,1562.66666666667,127.333333333333
"12821","38172","2019",15,13,2,237348,2493.93333333333,98.6666666666667
"12822","38173","2019",2,1,1,93500,1277.5,81
"12823","38174","2019",17,16,1,175254.705882353,1769.88235294118,108.705882352941
"12824","38175","2019",42,19,23,231799.285714286,2751.35714285714,92.9761904761905
"12825","38176","2019",12,12,0,276153.5,2409.08333333333,117.75
"12826","38177","2019",2,0,2,88000,1146,76
"12827","38179","2019",102,32,70,220791.892156863,3096.56862745098,72.3137254901961
"12828","38180","2019",15,15,0,185633.333333333,1757.26666666667,105.533333333333
"12829","38181","2019",38,22,16,190900.315789474,2360.39473684211,81.7894736842105
"12830","38182","2019",34,25,9,179468.794117647,1800.20588235294,98.9411764705882
"12831","38183","2019",7,6,1,225168.571428571,2484.85714285714,98.2857142857143
"12832","38184","2019",25,19,6,243910.04,2581.68,96.8
"12833","38185","2019",3116,93,3023,148475.352053915,2419.13575096277,63.214377406932
"12834","38186","2019",55,11,44,78371.1636363636,1780.49090909091,42.8909090909091
"12835","38187","2019",27,19,8,216400.37037037,2374.74074074074,88.4814814814815
"12836","38188","2019",21,15,6,329601.428571429,3072.28571428571,105.619047619048
"12837","38189","2019",58,42,16,232552.482758621,2495.39655172414,93.7931034482759
"12838","38190","2019",15,12,3,171769.466666667,2247.26666666667,81.1333333333333
"12839","38191","2019",240,7,233,182579.233333333,4824.08333333333,35.2166666666667
"12840","38192","2019",6,5,1,248713.333333333,3139.5,83.3333333333333
"12841","38193","2019",229,144,85,179582.017467249,2200.49781659389,82.3973799126638
"12842","38194","2019",19,15,4,186345.526315789,2161,97.1578947368421
"12843","38195","2019",9,8,1,176003.333333333,1878.22222222222,99.1111111111111
"12844","38197","2019",27,21,6,276814.074074074,2656.88888888889,105.851851851852
"12845","38198","2019",16,16,0,156074.0625,1541.8125,104.125
"12846","38199","2019",16,12,4,289834.375,2821,104.8125
"12847","38200","2019",37,21,16,248670.459459459,2688.51351351351,93.8378378378378
"12848","38203","2019",11,8,3,197366.363636364,2279.18181818182,94.5454545454545
"12849","38204","2019",3,3,0,133166.666666667,1506.33333333333,89.3333333333333
"12850","38205","2019",53,29,24,225590.20754717,3429.66037735849,73.3018867924528
"12851","38206","2019",9,7,2,188584.444444444,2513.55555555556,74.4444444444444
"12852","38207","2019",3,2,1,91666.6666666667,1398,70.3333333333333
"12853","38208","2019",3,3,0,228333.333333333,1758.66666666667,114.333333333333
"12854","38209","2019",2,2,0,259500,2300.5,122
"12855","38210","2019",7,7,0,218600,2376.71428571429,92.7142857142857
"12856","38211","2019",2,2,0,222500,2556,89
"12857","38212","2019",13,10,3,108557.153846154,1394.23076923077,90.8461538461538
"12858","38213","2019",5,5,0,181450,1521.6,121.4
"12859","38214","2019",24,17,7,294769.166666667,3060.54166666667,95.875
"12860","38215","2019",28,26,2,304195.178571429,2846.64285714286,111.642857142857
"12861","38216","2019",1,1,0,112000,2036,55
"12862","38217","2019",1,1,0,30000,500,60
"12863","38218","2019",16,15,1,166815.625,1574.5,107.4375
"12864","38219","2019",10,10,0,180624,1631.6,112.4
"12865","38222","2019",11,11,0,153659.090909091,1513.27272727273,107.272727272727
"12866","38223","2019",25,16,9,280297.68,2625.44,105.32
"12867","38224","2019",1,1,0,130000,1512,86
"12868","38225","2019",63,26,37,161757.349206349,2631.1746031746,64.3492063492064
"12869","38226","2019",15,14,1,139321.466666667,1383.73333333333,118.666666666667
"12870","38228","2019",11,11,0,191909.090909091,1717.81818181818,113
"12871","38229","2019",240,50,190,287377.666666667,3283.17916666667,85.5
"12872","38230","2019",12,12,0,251367.5,2262.75,111.5
"12873","38231","2019",14,14,0,175787.857142857,1741.85714285714,109
"12874","38232","2019",23,21,2,193561.086956522,1731.60869565217,109.521739130435
"12875","38235","2019",5,5,0,146906.4,1408.2,99
"12876","38236","2019",19,14,5,213092.684210526,2356.73684210526,100.736842105263
"12877","38237","2019",2,1,1,173000,1627,113
"12878","38238","2019",25,23,2,223400,2080.76,110
"12879","38239","2019",108,77,31,199159.092592593,2253.01851851852,88.0555555555556
"12880","38240","2019",4,3,1,151250,1667.5,93.25
"12881","38241","2019",1,1,0,150000,2113,71
"12882","38242","2019",25,22,3,180274.84,1933.8,95.84
"12883","38243","2019",4,2,2,78750,1097.25,87.5
"12884","38244","2019",6,6,0,217895,2105.83333333333,103.5
"12885","38245","2019",3,3,0,311540,2118.33333333333,142
"12886","38246","2019",13,13,0,198975.384615385,2078.23076923077,96.6153846153846
"12887","38247","2019",63,48,15,134304,1663.11111111111,80.6825396825397
"12888","38248","2019",3,3,0,234216.666666667,1884.66666666667,114.333333333333
"12889","38249","2019",58,25,33,348701.896551724,3992.75862068966,86.7068965517241
"12890","38250","2019",7,7,0,192142.857142857,1792.85714285714,106.857142857143
"12891","38252","2019",6,5,1,312446.666666667,2626.33333333333,126.666666666667
"12892","38253","2019",326,8,318,121762.613496933,3351.96625766871,35.0153374233129
"12893","38254","2019",9,9,0,244430.888888889,2848.55555555556,86.7777777777778
"12894","38255","2019",1,1,0,83000,1092,76
"12895","38256","2019",26,25,1,205764.038461538,2032.92307692308,102
"12896","38257","2019",2,2,0,191590,1903,105
"12897","38258","2019",1,1,0,320000,7442,43
"12898","38259","2019",15,15,0,207214,2036.6,100.8
"12899","38260","2019",7,7,0,268747.142857143,2969.71428571429,94.7142857142857
"12900","38261","2019",74,52,22,163146.540540541,1817.64864864865,92.7297297297297
"12901","38263","2019",3,3,0,250950,2235,122
"12902","38264","2019",23,6,17,102798.260869565,2330.82608695652,43.3913043478261
"12903","38265","2019",26,21,5,123882.692307692,1579.5,78.1153846153846
"12904","38266","2019",4,4,0,128000,1607.5,86
"12905","38267","2019",7,7,0,246220.714285714,2351.85714285714,120.428571428571
"12906","38268","2019",4,4,0,159935,2168.75,66.5
"12907","38269","2019",67,37,30,112176.910447761,1463.62686567164,75.1940298507463
"12908","38270","2019",28,22,6,220602.785714286,2248.46428571429,100.642857142857
"12909","38271","2019",4,4,0,423973.75,3758.5,113.75
"12910","38272","2019",4,4,0,118500,1114.25,102.5
"12911","38273","2019",6,6,0,176550,1636,106.833333333333
"12912","38275","2019",2,2,0,191500,1250.5,140
"12913","38276","2019",41,23,18,174931.219512195,2007.39024390244,87.4878048780488
"12914","38277","2019",7,7,0,246235,2388.57142857143,107.142857142857
"12915","38278","2019",6,5,1,154666.666666667,1718.33333333333,83.3333333333333
"12916","38279","2019",17,15,2,242148.470588235,2621.64705882353,94.3529411764706
"12917","38280","2019",8,8,0,147662.5,1477,113.875
"12918","38281","2019",29,19,10,241107.344827586,2308.8275862069,106.068965517241
"12919","38282","2019",7,7,0,199185.714285714,1969,101.857142857143
"12920","38283","2019",2,2,0,102000,1095,97
"12921","38284","2019",10,10,0,240297,1819.7,128
"12922","38285","2019",1,1,0,45000,1607,28
"12923","38287","2019",11,10,1,174773.636363636,1739.81818181818,105.090909090909
"12924","38288","2019",22,19,3,269717.272727273,2563.63636363636,104.818181818182
"12925","38289","2019",19,6,13,144621.684210526,3278.47368421053,47.8947368421053
"12926","38290","2019",9,9,0,156262.222222222,1587.33333333333,98.7777777777778
"12927","38291","2019",9,9,0,201291.111111111,1912.22222222222,104.222222222222
"12928","38292","2019",23,19,4,186171.739130435,2037.52173913043,95.3913043478261
"12929","38294","2019",12,12,0,305252.5,2539.16666666667,124.833333333333
"12930","38295","2019",11,11,0,168948.454545455,1749.72727272727,99.6363636363636
"12931","38296","2019",9,9,0,223115.555555556,1758.66666666667,122.666666666667
"12932","38297","2019",29,28,1,192591.448275862,1979,95.3448275862069
"12933","38298","2019",104,66,38,137288.730769231,1764.04807692308,79.5865384615385
"12934","38299","2019",3,3,0,97000,1157.33333333333,101.333333333333
"12935","38300","2019",4,4,0,182750,1447.5,134.75
"12936","38303","2019",6,6,0,202382.166666667,2508.16666666667,83.1666666666667
"12937","38304","2019",19,16,3,158826.894736842,1661.84210526316,95.8421052631579
"12938","38307","2019",9,9,0,158138.888888889,1468.55555555556,107.444444444444
"12939","38308","2019",5,5,0,88800,743.8,117.8
"12940","38309","2019",26,22,4,301663.461538462,3176.23076923077,95.2307692307692
"12941","38310","2019",10,10,0,226592,1975.9,115.7
"12942","38311","2019",10,10,0,192440,1712.7,112.3
"12943","38313","2019",2,2,0,263500,2008,131.5
"12944","38314","2019",84,48,36,185712.523809524,2272.79761904762,83.8452380952381
"12945","38315","2019",64,41,23,144541.25,1752.171875,80.609375
"12946","38316","2019",102,29,73,145479.411764706,2051.36274509804,71.3921568627451
"12947","38317","2019",136,15,121,113991.492647059,1743.55147058824,64.7794117647059
"12948","38318","2019",78,35,43,164503.461538462,1973.05128205128,81.6410256410256
"12949","38319","2019",5,5,0,116547,1334.8,92.8
"12950","38320","2019",22,21,1,194280.818181818,1856.90909090909,106.045454545455
"12951","38321","2019",2,2,0,90000,1281.5,71.5
"12952","38322","2019",1,1,0,68000,883,77
"12953","38323","2019",13,13,0,205461.538461538,2372.53846153846,89.7692307692308
"12954","38324","2019",6,5,1,249128.5,2142.83333333333,125.5
"12955","38325","2019",4,4,0,181600,2381,79.75
"12956","38326","2019",1,1,0,214000,1672,128
"12957","38328","2019",6,6,0,414283.333333333,3587.66666666667,124.833333333333
"12958","38329","2019",2,2,0,82000,682.5,118.5
"12959","38330","2019",1,1,0,217350,2241,97
"12960","38331","2019",12,10,2,283438.166666667,2431.58333333333,113.25
"12961","38332","2019",38,25,13,169236.394736842,1957.42105263158,87.6842105263158
"12962","38333","2019",10,7,3,170931,1733.2,96.8
"12963","38334","2019",6,6,0,376883.333333333,5246.16666666667,85
"12964","38335","2019",11,11,0,154760,1609.09090909091,97.5454545454545
"12965","38336","2019",27,23,4,274500.37037037,2441.88888888889,113.037037037037
"12966","38337","2019",85,30,55,166474.858823529,1952.29411764706,83.6588235294118
"12967","38338","2019",13,12,1,183654.076923077,1721,108.384615384615
"12968","38339","2019",22,20,2,233983.272727273,2250.59090909091,109.454545454545
"12969","38340","2019",23,13,10,177821.52173913,2098.52173913043,86.3478260869565
"12970","38341","2019",7,7,0,260087.571428571,2302.14285714286,118.285714285714
"12971","38342","2019",2,1,1,206250,2655,81
"12972","38343","2019",20,20,0,242687.5,2091.4,119.95
"12973","38344","2019",115,80,35,155392.365217391,1623.62608695652,95.1304347826087
"12974","38345","2019",5,5,0,202100,1903.2,106.2
"12975","38346","2019",1,1,0,250000,2451,102
"12976","38347","2019",5,5,0,159208,1295,121.6
"12977","38348","2019",58,55,3,282617.896551724,2508.6724137931,113.689655172414
"12978","38349","2019",28,26,2,161191.964285714,1756.53571428571,95.0357142857143
"12979","38350","2019",6,6,0,314450,3699.16666666667,92
"12980","38351","2019",16,15,1,201925,2206,96.25
"12981","38352","2019",32,31,1,267643.28125,2543.0625,106.78125
"12982","38353","2019",6,6,0,172605.833333333,2270.83333333333,86.6666666666667
"12983","38354","2019",3,3,0,128050,1682.33333333333,78.3333333333333
"12984","38355","2019",3,3,0,248076.666666667,2119.66666666667,120.666666666667
"12985","38356","2019",2,2,0,175250,2275,88
"12986","38357","2019",29,29,0,194275.275862069,1926.65517241379,102.379310344828
"12987","38358","2019",4,4,0,208000,2228,90
"12988","38359","2019",7,7,0,199485,1909.14285714286,110.285714285714
"12989","38360","2019",6,6,0,247175,1751.66666666667,134.333333333333
"12990","38361","2019",1,1,0,260000,2826,92
"12991","38362","2019",8,8,0,283345,2392.125,120.25
"12992","38363","2019",8,6,2,193856.875,2367.875,107.625
"12993","38364","2019",4,4,0,120243.75,1459.5,83.25
"12994","38365","2019",21,21,0,187598.333333333,1734.85714285714,112.285714285714
"12995","38366","2019",6,6,0,170139.666666667,1923.16666666667,93.3333333333333
"12996","38368","2019",11,9,2,268051.363636364,2244.18181818182,110.818181818182
"12997","38369","2019",14,13,1,170060.357142857,1916.42857142857,89
"12998","38370","2019",9,9,0,168783.333333333,1589,111.444444444444
"12999","38372","2019",12,12,0,189268.75,1697.5,119.25
"13000","38373","2019",9,8,1,203735.555555556,2020,110.444444444444
"13001","38374","2019",50,44,6,229683.9,2214.84,105.1
"13002","38376","2019",6,6,0,142291.666666667,1564,96.5
"13003","38377","2019",63,44,19,158954.428571429,1768.1746031746,90
"13004","38378","2019",41,36,5,227380.365853659,2250.19512195122,102.439024390244
"13005","38379","2019",3,3,0,179233.333333333,1587.66666666667,120.666666666667
"13006","38380","2019",2,2,0,165000,1763,95.5
"13007","38381","2019",26,26,0,211266.423076923,1939.23076923077,108.576923076923
"13008","38382","2019",259,85,174,228544.335907336,2745.23166023166,81.2393822393822
"13009","38383","2019",24,19,5,256773.25,2466.25,104.833333333333
"13010","38384","2019",38,25,13,160608.342105263,1749.76315789474,93.7105263157895
"13011","38386","2019",24,23,1,176561.958333333,1815.125,101.958333333333
"13012","38387","2019",8,5,3,142820,1942,79.125
"13013","38388","2019",31,25,6,255595.161290323,2432.48387096774,104.645161290323
"13014","38389","2019",34,33,1,244536.882352941,2426.85294117647,98.7647058823529
"13015","38390","2019",4,4,0,192240,1843,98
"13016","38391","2019",1,1,0,275500,1413,195
"13017","38392","2019",8,8,0,309395.75,2299.25,133.375
"13018","38393","2019",19,19,0,204838.157894737,1879.10526315789,115.842105263158
"13019","38394","2019",21,20,1,186911.666666667,1921.47619047619,99.7619047619048
"13020","38395","2019",32,21,11,196893.8125,2386.8125,83.40625
"13021","38396","2019",10,4,6,104714.5,1257.3,74.2
"13022","38397","2019",80,58,22,471548.4,3912.575,122.7375
"13023","38398","2019",13,13,0,208076.923076923,2065.53846153846,104.076923076923
"13024","38399","2019",74,60,14,179555.283783784,1985.2972972973,97.4189189189189
"13025","38400","2019",42,36,6,266554.571428571,2450.09523809524,108.738095238095
"13026","38401","2019",12,11,1,226671.666666667,2360.75,100.25
"13027","38402","2019",5,5,0,184040,1743.8,104
"13028","38403","2019",10,9,1,169682,1519.9,121.3
"13029","38404","2019",3,3,0,302866.666666667,3664.66666666667,88.3333333333333
"13030","38405","2019",10,9,1,215887.1,1809.2,120.3
"13031","38407","2019",11,10,1,214535.909090909,2375.54545454545,88.2727272727273
"13032","38408","2019",25,20,5,265864.64,2709.28,101.8
"13033","38409","2019",15,13,2,214030.4,2034.33333333333,109.666666666667
"13034","38410","2019",10,10,0,219516.7,1742.1,127.7
"13035","38412","2019",71,57,14,168347.718309859,1810.11267605634,92.0845070422535
"13036","38413","2019",9,9,0,147461.111111111,1478.11111111111,99.8888888888889
"13037","38415","2019",14,14,0,350351.428571429,3151.71428571429,117.285714285714
"13038","38416","2019",161,67,94,139917.254658385,1753.00621118012,81.8447204968944
"13039","38417","2019",5,4,1,217440,2268.2,115
"13040","38418","2019",2,2,0,292710,2244.5,131
"13041","38419","2019",1,1,0,60000,1500,40
"13042","38420","2019",1,1,0,177000,1609,110
"13043","38421","2019",512,57,455,148979.53125,2239.26171875,66.525390625
"13044","38422","2019",71,39,32,294841.408450704,3057.97183098592,97.5774647887324
"13045","38423","2019",83,23,60,205985.843373494,2466.65060240964,79.7951807228916
"13046","38425","2019",56,52,4,188823.910714286,1985.21428571429,100.982142857143
"13047","38426","2019",6,5,1,206700,2392.5,85.6666666666667
"13048","38427","2019",1,1,0,220000,1606,137
"13049","38428","2019",1,1,0,158705,928,171
"13050","38429","2019",10,9,1,177034,1902,112.4
"13051","38430","2019",1,1,0,250000,4464,56
"13052","38431","2019",37,24,13,347144.108108108,3415.32432432432,103.081081081081
"13053","38432","2019",6,5,1,273775,2375.16666666667,119.666666666667
"13054","38433","2019",21,11,10,281992.380952381,2766.85714285714,105.142857142857
"13055","38434","2019",6,6,0,194825,1662.5,122.166666666667
"13056","38436","2019",29,20,9,325802.137931034,2968.51724137931,111.689655172414
"13057","38437","2019",5,5,0,233900,1852.8,121.8
"13058","38438","2019",4,4,0,213118.75,1826.75,118.75
"13059","38439","2019",43,35,8,194830.534883721,2259.79069767442,86.8139534883721
"13060","38440","2019",8,7,1,180781.25,1958.125,96
"13061","38442","2019",32,18,14,155005.3125,2182.6875,73.25
"13062","38443","2019",6,6,0,154225.833333333,2266.16666666667,87
"13063","38444","2019",2,2,0,162375,2364,69
"13064","38445","2019",5,5,0,258400,2447.4,103
"13065","38446","2019",12,11,1,207960.416666667,2342.08333333333,110.083333333333
"13066","38448","2019",15,12,3,248349.333333333,2323.2,106.733333333333
"13067","38449","2019",60,51,9,208712.916666667,2310.9,91.7333333333333
"13068","38450","2019",11,11,0,256924.545454545,2585.09090909091,99.9090909090909
"13069","38451","2019",34,31,3,253069.235294118,2796.35294117647,93.7941176470588
"13070","38452","2019",5,5,0,109545.6,1338.8,86.8
"13071","38453","2019",15,14,1,163324.533333333,1802.26666666667,92.2
"13072","38454","2019",27,27,0,196539.037037037,1970,100.592592592593
"13073","38455","2019",59,55,4,259329.101694915,2527.1186440678,103.423728813559
"13074","38456","2019",6,6,0,172166.666666667,1900,84.3333333333333
"13075","38457","2019",40,34,6,174604.5,1691.4,103.6
"13076","38458","2019",17,17,0,160651.470588235,1874.82352941176,87.4117647058823
"13077","38459","2019",8,8,0,321885,2197.625,139.75
"13078","38460","2019",3,3,0,203050.666666667,3133.66666666667,78.6666666666667
"13079","38462","2019",7,7,0,202600,2189.71428571429,95.7142857142857
"13080","38463","2019",16,15,1,207615.625,2179.5625,103.375
"13081","38464","2019",24,20,4,191165.916666667,2036.79166666667,95.1666666666667
"13082","38465","2019",15,14,1,186104.666666667,1642.13333333333,114.6
"13083","38466","2019",18,16,2,256403.611111111,2302.38888888889,109.388888888889
"13084","38467","2019",21,21,0,232321.571428571,2144.66666666667,108.904761904762
"13085","38468","2019",51,39,12,174506.333333333,1839.54901960784,94.4313725490196
"13086","38470","2019",2,2,0,180950,1706,120.5
"13087","38471","2019",9,7,2,273722.222222222,3204.22222222222,91.8888888888889
"13088","38472","2019",1,1,0,482000,3766,128
"13089","38473","2019",24,21,3,154292.25,1430,112.208333333333
"13090","38474","2019",168,53,115,195622.166666667,2535.33333333333,75.9404761904762
"13091","38475","2019",33,25,8,254250.515151515,2631.75757575758,98.7575757575758
"13092","38476","2019",11,11,0,223930,2188.09090909091,103.363636363636
"13093","38478","2019",11,10,1,219154.545454545,2340.90909090909,93.8181818181818
"13094","38479","2019",26,26,0,166269.807692308,1719,100.461538461538
"13095","38480","2019",44,26,18,196518,2377.79545454545,92.6363636363636
"13096","38481","2019",3,3,0,272553.333333333,2030.33333333333,135.666666666667
"13097","38483","2019",11,10,1,215690.909090909,2170.63636363636,101.272727272727
"13098","38484","2019",36,28,8,258571.666666667,2668.16666666667,98
"13099","38485","2019",194,32,162,174375.804123711,2286.43298969072,73.6134020618557
"13100","38486","2019",99,34,65,295924.393939394,3232.86868686869,89.8888888888889
"13101","38487","2019",24,22,2,316466.25,2781.125,117
"13102","38488","2019",5,5,0,302250,2415,123.8
"13103","38489","2019",2,2,0,165250,1305.5,128
"13104","38490","2019",18,15,3,199799.444444444,1943.44444444444,102.555555555556
"13105","38492","2019",3,3,0,325290,2734,121.333333333333
"13106","38494","2019",15,15,0,229752.266666667,2305.66666666667,100.866666666667
"13107","38495","2019",11,10,1,212868.181818182,1844.36363636364,118.636363636364
"13108","38496","2019",17,17,0,210530.882352941,2376.17647058824,107.176470588235
"13109","38498","2019",6,6,0,206216.666666667,2068.66666666667,98.6666666666667
"13110","38499","2019",13,11,2,132145.384615385,1612.07692307692,85.9230769230769
"13111","38500","2019",6,6,0,195022.5,1548.33333333333,122.833333333333
"13112","38501","2019",48,25,23,211718.541666667,2645.58333333333,78.75
"13113","38503","2019",25,17,8,262211.2,2875.28,89.88
"13114","38504","2019",18,17,1,264053.055555556,2820.77777777778,101.444444444444
"13115","38505","2019",10,10,0,146841.8,1172.2,130
"13116","38507","2019",96,82,14,240227.333333333,2592.28125,95.8020833333333
"13117","38508","2019",15,15,0,189110.2,1980.66666666667,98.3333333333333
"13118","38509","2019",111,50,61,129341.063063063,1657.43243243243,78.1981981981982
"13119","38511","2019",44,23,21,237128.022727273,2662.88636363636,86.4545454545455
"13120","38512","2019",8,8,0,251946,2516,110.625
"13121","38513","2019",3,3,0,247000,2292.33333333333,98.3333333333333
"13122","38514","2019",5,4,1,119720,1193,104
"13123","38515","2019",22,21,1,191562.363636364,2063.72727272727,94.7727272727273
"13124","38516","2019",95,24,71,280032.905263158,3158.46315789474,88.1894736842105
"13125","38517","2019",70,43,27,172973.742857143,2091.38571428571,83.4714285714286
"13126","38518","2019",4,4,0,98500,1794,58
"13127","38519","2019",35,26,9,290149.857142857,2872.71428571429,101.485714285714
"13128","38520","2019",6,6,0,240413.333333333,2063.16666666667,114.833333333333
"13129","38522","2019",3,3,0,79000,1118.66666666667,76.3333333333333
"13130","38523","2019",12,12,0,180647.083333333,1605.16666666667,118.083333333333
"13131","38524","2019",74,40,34,298872.121621622,3216.43243243243,93.9864864864865
"13132","38525","2019",7,7,0,178194.571428571,1961,90.5714285714286
"13133","38526","2019",6,6,0,224163.333333333,1734.16666666667,132
"13134","38527","2019",13,3,10,321996.923076923,4783.23076923077,65.2307692307692
"13135","38528","2019",10,10,0,338842,3271.8,103.7
"13136","38529","2019",76,44,32,259364.171052632,2905.92105263158,88.7368421052632
"13137","38530","2019",37,24,13,229528.243243243,2415.13513513513,100.405405405405
"13138","38531","2019",9,9,0,183877.777777778,1957.11111111111,97.3333333333333
"13139","38532","2019",6,6,0,289325,2869.5,107.166666666667
"13140","38533","2019",7,7,0,336180,3360.71428571429,110.714285714286
"13141","38535","2019",4,4,0,247600,2499.75,99
"13142","38536","2019",18,17,1,209852.5,1898.38888888889,108.833333333333
"13143","38537","2019",97,51,46,183447.731958763,2380.59793814433,78.6082474226804
"13144","38538","2019",53,35,18,271236.981132075,3060.98113207547,88.6415094339623
"13145","38539","2019",9,9,0,189152.222222222,1833.77777777778,99.4444444444444
"13146","38540","2019",8,6,2,272525,2458.25,115
"13147","38542","2019",9,9,0,305599.111111111,2727.66666666667,112.111111111111
"13148","38543","2019",33,33,0,156516.696969697,1625.9696969697,96.8787878787879
"13149","38544","2019",444,114,330,166539.333333333,2015.18243243243,80.768018018018
"13150","38545","2019",110,62,48,252268.836363636,2970.5,85.9727272727273
"13151","38546","2019",17,17,0,209560.588235294,1831.17647058824,115.941176470588
"13152","38547","2019",102,36,66,192985.774509804,2548.6862745098,75.4803921568627
"13153","38548","2019",285,24,261,116126.403508772,2549.48421052632,42.7122807017544
"13154","38549","2019",2,2,0,84535,1835,55
"13155","38550","2019",5,2,3,319216,2732.4,144
"13156","38552","2019",3,3,0,105816.666666667,1071,85.3333333333333
"13157","38553","2019",174,135,39,185984.971264368,2089.82183908046,89.2241379310345
"13158","38554","2019",35,30,5,247455.371428571,2479.14285714286,100.542857142857
"13159","38555","2019",10,10,0,210542,1910.2,113.4
"13160","38556","2019",18,15,3,156539.833333333,1904.77777777778,98
"13161","38557","2019",54,39,15,310026.87037037,3110.18518518519,101.87037037037
"13162","38558","2019",21,17,4,349176.047619048,2991.38095238095,115.047619047619
"13163","38559","2019",66,37,29,156613.46969697,1869.65151515152,82.9393939393939
"13164","38560","2019",18,15,3,144542.222222222,1549.94444444444,98.1666666666667
"13165","38561","2019",17,15,2,151911.764705882,1745.41176470588,92.5294117647059
"13166","38562","2019",113,43,70,157949.734513274,2136.76991150442,73.3274336283186
"13167","38563","2019",359,79,280,167312.573816156,2249.28969359331,73.3036211699164
"13168","38565","2019",111,59,52,219723.063063063,2562.18018018018,84.8738738738739
"13169","38566","2019",16,14,2,228005.6875,2270.5,111.3125
"13170","38567","2019",128,3,125,77852.5,2210.6015625,35.4140625
"13171","39001","2019",17,15,2,171325.058823529,1623.17647058824,105.882352941176
"13172","39004","2019",1,1,0,120000,1200,100
"13173","39006","2019",1,1,0,272420,2003,136
"13174","39007","2019",1,1,0,213750,1425,150
"13175","39008","2019",2,1,1,112975,1158.5,83
"13176","39009","2019",8,8,0,120047,1073.125,121.375
"13177","39010","2019",5,5,0,94260,856,117.6
"13178","39011","2019",1,1,0,60000,500,120
"13179","39013","2019",41,29,12,122645.414634146,1305.41463414634,93.2926829268293
"13180","39014","2019",3,3,0,113166.666666667,1017,124
"13181","39016","2019",8,7,1,117837.5,1206.625,91.625
"13182","39017","2019",8,8,0,151918.75,1372.875,111
"13183","39018","2019",7,7,0,144617.142857143,1199.14285714286,111.714285714286
"13184","39019","2019",3,3,0,159033.333333333,1399.66666666667,107.333333333333
"13185","39020","2019",3,3,0,115833.333333333,660.333333333333,176.666666666667
"13186","39021","2019",6,6,0,83916.6666666667,958.5,87.6666666666667
"13187","39022","2019",6,6,0,157750,1428.16666666667,118.833333333333
"13188","39024","2019",4,4,0,135750,1544,94.75
"13189","39025","2019",7,7,0,117071.428571429,942.142857142857,104.857142857143
"13190","39026","2019",3,1,2,241333.333333333,1292.66666666667,170.666666666667
"13191","39027","2019",3,3,0,111600,969.666666666667,118
"13192","39028","2019",2,1,1,87500,682.5,128.5
"13193","39029","2019",1,1,0,135000,1667,81
"13194","39030","2019",6,6,0,163750,1420.5,114
"13195","39031","2019",2,2,0,126500,1029.5,115.5
"13196","39032","2019",1,1,0,217475,2788,78
"13197","39034","2019",2,2,0,143250,1199.5,122
"13198","39035","2019",3,3,0,85833.3333333333,875.333333333333,89.6666666666667
"13199","39037","2019",1,1,0,89500,1421,63
"13200","39038","2019",6,6,0,277601.666666667,1756,160.5
"13201","39039","2019",3,3,0,163100,2048,80
"13202","39040","2019",1,1,0,136000,971,140
"13203","39041","2019",2,2,0,85000,1100,80
"13204","39042","2019",4,4,0,186250,1461.75,118.75
"13205","39043","2019",20,20,0,133284.5,1292.35,112.85
"13206","39045","2019",4,4,0,129878.75,1394,97.25
"13207","39046","2019",2,2,0,237500,2812.5,90
"13208","39047","2019",10,8,2,229803.5,2464.7,95
"13209","39048","2019",2,2,0,181000,1358.5,133
"13210","39050","2019",1,1,0,84000,840,100
"13211","39051","2019",7,7,0,139750,1128.85714285714,122.714285714286
"13212","39052","2019",1,1,0,104150,956,109
"13213","39053","2019",2,2,0,170000,1028,171
"13214","39056","2019",16,12,4,139103.75,1389.1875,104.0625
"13215","39059","2019",35,9,26,171594.342857143,2256.25714285714,74.6857142857143
"13216","39060","2019",1,1,0,676000,2513,269
"13217","39063","2019",5,3,2,138600,1705.4,84
"13218","39065","2019",2,2,0,107500,984,117.5
"13219","39066","2019",2,2,0,95000,985.5,94.5
"13220","39068","2019",8,8,0,155687.5,1603.75,109.25
"13221","39070","2019",1,0,1,156700,739,212
"13222","39072","2019",8,8,0,94600,1159.375,81.125
"13223","39073","2019",3,3,0,169000,1118,154
"13224","39076","2019",2,2,0,167500,1535,110
"13225","39078","2019",10,10,0,154623,1500.8,105.4
"13226","39079","2019",3,3,0,139250,1301.33333333333,116.333333333333
"13227","39081","2019",8,8,0,167756.25,1446.75,115.25
"13228","39083","2019",3,2,1,209106.666666667,1357,157.666666666667
"13229","39084","2019",2,2,0,114000,1417.5,80
"13230","39085","2019",1,1,0,130000,1781,73
"13231","39086","2019",3,3,0,61666.6666666667,612.333333333333,105.666666666667
"13232","39088","2019",2,2,0,153500,985.5,128
"13233","39090","2019",1,1,0,188350,1460,129
"13234","39091","2019",1,1,0,75000,1087,69
"13235","39092","2019",2,2,0,171750,1570.5,108
"13236","39093","2019",7,6,1,133157.142857143,1378.85714285714,114.285714285714
"13237","39095","2019",1,1,0,201758,1079,187
"13238","39096","2019",7,7,0,137285.714285714,1451.71428571429,94.2857142857143
"13239","39097","2019",125,49,76,112044.632,1343.04,81.712
"13240","39099","2019",2,2,0,163000,1494.5,116.5
"13241","39100","2019",2,2,0,148125,1155.5,130
"13242","39101","2019",17,16,1,131434.117647059,1572.23529411765,90.5294117647059
"13243","39102","2019",2,2,0,51250,687,75
"13244","39103","2019",2,2,0,145800,1301,109.5
"13245","39104","2019",13,13,0,139791,1478.53846153846,100.538461538462
"13246","39106","2019",5,4,1,231930,3028,80
"13247","39110","2019",1,1,0,67000,2680,25
"13248","39112","2019",1,1,0,80000,1143,70
"13249","39114","2019",5,5,0,248700,1849.6,127.2
"13250","39117","2019",2,2,0,136000,845,170
"13251","39118","2019",1,1,0,80000,762,105
"13252","39119","2019",3,3,0,134200,1118.66666666667,135.333333333333
"13253","39120","2019",3,3,0,109833.333333333,1140,94
"13254","39121","2019",4,4,0,173975,1523.25,121.75
"13255","39122","2019",2,2,0,82000,875.5,92
"13256","39124","2019",6,6,0,77150,781,101.166666666667
"13257","39126","2019",4,4,0,94997.5,1224,73.5
"13258","39127","2019",1,1,0,210000,1963,107
"13259","39128","2019",19,18,1,142860.526315789,1317.73684210526,113.526315789474
"13260","39129","2019",4,4,0,154550,1369,113
"13261","39130","2019",5,4,1,137260,1221.4,121
"13262","39131","2019",9,8,1,157367.777777778,1596.22222222222,94.2222222222222
"13263","39134","2019",3,3,0,170263,1743,95.6666666666667
"13264","39136","2019",1,1,0,162000,1157,140
"13265","39137","2019",3,3,0,56666.6666666667,868.333333333333,66.6666666666667
"13266","39138","2019",7,7,0,91744.5714285714,1010.42857142857,91
"13267","39140","2019",1,1,0,205000,1464,140
"13268","39141","2019",3,3,0,291666.666666667,1518,227.666666666667
"13269","39145","2019",5,5,0,143960,1403.2,94.8
"13270","39146","2019",9,9,0,165066.666666667,1582.66666666667,109.888888888889
"13271","39147","2019",2,2,0,120200,983.5,122
"13272","39149","2019",3,3,0,175853.333333333,1429.66666666667,122.333333333333
"13273","39150","2019",16,12,4,138406.25,1415.8125,101.875
"13274","39151","2019",1,1,0,214000,2119,101
"13275","39153","2019",5,5,0,164750,1621.2,101.2
"13276","39154","2019",16,13,3,164865.3125,1728.5625,98.0625
"13277","39155","2019",3,3,0,72333.3333333333,698.666666666667,108.333333333333
"13278","39156","2019",3,3,0,82016.6666666667,842.666666666667,98.3333333333333
"13279","39159","2019",5,5,0,102468,874.2,111.8
"13280","39160","2019",9,9,0,157600,1525.44444444444,101
"13281","39162","2019",1,1,0,60000,811,74
"13282","39164","2019",13,12,1,128926.923076923,1270.15384615385,96.2307692307692
"13283","39165","2019",2,2,0,180500,1400.5,133.5
"13284","39166","2019",5,5,0,115950,1029.8,105.4
"13285","39167","2019",5,5,0,161960,1365.2,124.8
"13286","39168","2019",2,2,0,87500,1577,57.5
"13287","39169","2019",11,10,1,134345.454545455,1434.81818181818,95.4545454545455
"13288","39170","2019",6,6,0,181068.333333333,1750.83333333333,107
"13289","39171","2019",10,9,1,152850,1640.1,94.5
"13290","39172","2019",2,2,0,191400,1445.5,126.5
"13291","39173","2019",18,17,1,115650,1203.77777777778,97.9444444444444
"13292","39175","2019",1,1,0,88000,1443,61
"13293","39176","2019",2,1,1,201250,2222,90.5
"13294","39177","2019",3,3,0,113333.333333333,1351.66666666667,82.3333333333333
"13295","39178","2019",2,2,0,182300,1815,98.5
"13296","39179","2019",2,2,0,89820,793.5,117.5
"13297","39180","2019",4,4,0,59750,844.75,73.75
"13298","39182","2019",5,5,0,168900,1926,94.6
"13299","39183","2019",8,8,0,152299.375,1434.375,104.75
"13300","39184","2019",3,2,1,203666.666666667,1501.33333333333,134.666666666667
"13301","39185","2019",4,4,0,84145,890.5,87.75
"13302","39187","2019",1,1,0,241420,1500,161
"13303","39188","2019",6,6,0,109478.333333333,1119.33333333333,92.6666666666667
"13304","39189","2019",22,22,0,121175,1411.13636363636,84.2272727272727
"13305","39190","2019",15,14,1,172686.666666667,1502.8,126.733333333333
"13306","39192","2019",2,2,0,73600,1153,64.5
"13307","39193","2019",10,10,0,142780,1338.6,108.5
"13308","39194","2019",4,4,0,175350,1704.25,104
"13309","39197","2019",3,3,0,164833.333333333,1594.66666666667,102.666666666667
"13310","39198","2019",357,144,213,124986.630252101,1473.79271708683,85.406162464986
"13311","39199","2019",10,9,1,153070,1422.1,107.7
"13312","39200","2019",3,3,0,151803.333333333,1606,99
"13313","39201","2019",10,7,3,107400,1142.3,96.4
"13314","39205","2019",4,4,0,114125,1242.5,84.5
"13315","39206","2019",1,1,0,99000,825,120
"13316","39207","2019",2,2,0,59840,653.5,95
"13317","39208","2019",1,1,0,90000,1475,61
"13318","39209","2019",6,6,0,143600,1265,133.333333333333
"13319","39210","2019",5,5,0,195090,1366,143
"13320","39211","2019",4,4,0,138625,1321.25,107
"13321","39214","2019",5,5,0,269432.6,1895,174.6
"13322","39216","2019",9,3,6,75261.1111111111,1003,86.1111111111111
"13323","39217","2019",10,9,1,176647.5,1271.1,142
"13324","39218","2019",7,7,0,161255.714285714,2734.42857142857,87.8571428571429
"13325","39219","2019",4,4,0,115362.5,1269.5,87.5
"13326","39220","2019",2,2,0,188850,1749.5,109.5
"13327","39222","2019",1,1,0,163000,2063,79
"13328","39225","2019",3,3,0,243333.333333333,1520.66666666667,156.666666666667
"13329","39227","2019",5,3,2,167400,1759,99.8
"13330","39228","2019",23,19,4,176706.826086957,1929.69565217391,99.4347826086957
"13331","39229","2019",1,1,0,257450,1542,167
"13332","39230","2019",2,2,0,135825,1158,116
"13333","39232","2019",9,9,0,85497.7777777778,1343.77777777778,81.2222222222222
"13334","39233","2019",38,27,11,141333.552631579,1587.65789473684,88.3157894736842
"13335","39234","2019",1,1,0,65000,802,81
"13336","39235","2019",13,8,5,114648.461538462,1170.61538461538,98.8461538461538
"13337","39236","2019",1,1,0,274760,2181,126
"13338","39238","2019",4,4,0,89782,729.25,125.5
"13339","39239","2019",1,1,0,150000,2000,75
"13340","39240","2019",2,2,0,273950,2105,123
"13341","39241","2019",5,5,0,148594,1409.8,105
"13342","39244","2019",2,2,0,182110,1724.5,104
"13343","39245","2019",3,3,0,169000,1201,144.333333333333
"13344","39246","2019",7,6,1,130025.714285714,1112.71428571429,114
"13345","39247","2019",2,2,0,83500,816.5,107
"13346","39250","2019",1,1,0,123000,1025,120
"13347","39252","2019",8,7,1,112368.75,1116.625,103
"13348","39253","2019",6,6,0,89000,850.333333333333,113
"13349","39254","2019",1,1,0,259210,1490,174
"13350","39255","2019",1,1,0,143000,1100,130
"13351","39258","2019",3,3,0,173773.333333333,1542.33333333333,113.666666666667
"13352","39259","2019",1,1,0,179500,1340,134
"13353","39261","2019",2,2,0,78700,515,150.5
"13354","39262","2019",1,1,0,182000,1701,107
"13355","39263","2019",2,2,0,74000,780.5,98
"13356","39265","2019",1,1,0,135000,2077,65
"13357","39266","2019",7,7,0,122385.714285714,959.571428571429,126.428571428571
"13358","39268","2019",1,1,0,125000,1136,110
"13359","39269","2019",3,3,0,130000,1292,114
"13360","39270","2019",7,7,0,171235.714285714,1427.42857142857,127
"13361","39271","2019",2,1,1,127700,1918.5,69.5
"13362","39272","2019",1,1,0,2e+05,1316,152
"13363","39273","2019",4,4,0,124542.5,944,126.5
"13364","39274","2019",4,0,4,98199.5,1963.5,50.5
"13365","39275","2019",21,13,8,154017.380952381,2072.14285714286,80.4761904761905
"13366","39278","2019",1,1,0,85000,944,90
"13367","39279","2019",7,7,0,125646.428571429,1095,108.857142857143
"13368","39280","2019",2,2,0,121500,955.5,126
"13369","39282","2019",1,1,0,230000,2473,93
"13370","39283","2019",6,6,0,171419.166666667,1845.16666666667,108.333333333333
"13371","39285","2019",5,5,0,183760,1650,121.4
"13372","39286","2019",15,14,1,130953.333333333,1409.46666666667,93.2
"13373","39288","2019",4,4,0,134737.5,1526,92
"13374","39289","2019",3,3,0,107333.333333333,1182.33333333333,89.6666666666667
"13375","39290","2019",4,4,0,176500,1602.25,110.25
"13376","39291","2019",4,4,0,113175,1133.25,101.5
"13377","39292","2019",2,2,0,171259,2114.5,81
"13378","39293","2019",2,2,0,120000,880,125.5
"13379","39295","2019",3,3,0,68666.6666666667,694.333333333333,106
"13380","39296","2019",6,6,0,171716.5,1318,140.333333333333
"13381","39297","2019",12,8,4,167282.5,1619.16666666667,103.666666666667
"13382","39299","2019",5,5,0,74500,925.4,76.8
"13383","39300","2019",239,60,179,120241.158995816,1412.7949790795,83.9121338912134
"13384","39301","2019",2,2,0,117350,987,123
"13385","39302","2019",3,3,0,155960,1149.66666666667,143.333333333333
"13386","39304","2019",2,2,0,222950,1853,122.5
"13387","39305","2019",4,4,0,161075,1573.5,102.75
"13388","39306","2019",13,11,2,167806.538461538,1805.38461538462,94.8461538461538
"13389","39307","2019",5,5,0,214852,2492.8,93
"13390","39308","2019",4,4,0,170837.5,1338.25,129.5
"13391","39310","2019",9,9,0,117318.888888889,1140.77777777778,117.555555555556
"13392","39312","2019",1,1,0,76100,1001,76
"13393","39313","2019",2,2,0,88000,1402,77.5
"13394","39315","2019",1,1,0,148000,1805,82
"13395","39317","2019",4,4,0,116237.5,1260.75,87
"13396","39318","2019",3,2,1,97500,1374.33333333333,71
"13397","39319","2019",2,2,0,157350,1646.5,99
"13398","39320","2019",5,5,0,102010,905.2,116.6
"13399","39321","2019",3,3,0,160000,1234.33333333333,121
"13400","39322","2019",1,1,0,197230,1761,112
"13401","39323","2019",3,3,0,70190,875.666666666667,89.3333333333333
"13402","39325","2019",8,6,2,76312.5,774.125,108.75
"13403","39327","2019",6,6,0,125118.833333333,1445.16666666667,86.1666666666667
"13404","39328","2019",3,3,0,109183.333333333,1174,92.3333333333333
"13405","39329","2019",1,1,0,151370,964,157
"13406","39330","2019",1,1,0,120000,1043,115
"13407","39331","2019",5,5,0,230740,1456.2,161.8
"13408","39333","2019",18,10,8,115500,1106.44444444444,100.777777777778
"13409","39334","2019",2,2,0,145500,1142.5,125.5
"13410","39335","2019",8,8,0,68562.5,761,90.75
"13411","39336","2019",2,2,0,149250,1889,84
"13412","39337","2019",2,1,1,97400,799,114
"13413","39338","2019",2,2,0,112000,1164.5,92.5
"13414","39339","2019",6,6,0,128750,1226.66666666667,108.833333333333
"13415","39342","2019",1,1,0,91000,1071,85
"13416","39344","2019",2,2,0,159000,1600,105
"13417","39345","2019",1,1,0,173785,1687,103
"13418","39346","2019",2,2,0,127500,919,141.5
"13419","39348","2019",10,10,0,118900.8,1337.6,89.6
"13420","39349","2019",6,6,0,225408.333333333,1822.66666666667,129.833333333333
"13421","39350","2019",7,7,0,131857.142857143,1766.14285714286,90.7142857142857
"13422","39351","2019",1,1,0,161000,2012,80
"13423","39352","2019",1,1,0,227800,1964,116
"13424","39353","2019",3,3,0,62333.3333333333,716.666666666667,101
"13425","39354","2019",4,4,0,128275,1301,100.75
"13426","39355","2019",2,2,0,62500,755.5,82
"13427","39356","2019",1,1,0,85000,525,162
"13428","39360","2019",2,2,0,117000,839,135
"13429","39361","2019",3,3,0,98333.3333333333,916.333333333333,99
"13430","39362","2019",45,30,15,113802.777777778,1376.13333333333,87.1555555555556
"13431","39363","2019",2,2,0,137500,1091.5,122
"13432","39364","2019",2,2,0,156125,1697.5,92.5
"13433","39365","2019",14,13,1,121692.857142857,1186.57142857143,106.5
"13434","39366","2019",5,5,0,98250,819.2,125.4
"13435","39367","2019",33,23,10,219933.454545455,2050.54545454545,108.272727272727
"13436","39368","2019",64,11,53,96074.21875,1209.625,77.21875
"13437","39370","2019",4,4,0,131875,1204.5,110.25
"13438","39373","2019",1,1,0,330000,2870,115
"13439","39375","2019",1,1,0,138200,1152,120
"13440","39377","2019",6,6,0,97716.6666666667,1001.33333333333,95.1666666666667
"13441","39378","2019",12,12,0,116079.166666667,984.916666666667,111.833333333333
"13442","39379","2019",12,12,0,146851.416666667,1477.41666666667,108
"13443","39381","2019",1,1,0,188150,2352,80
"13444","39385","2019",3,3,0,137266.666666667,1126.66666666667,121.666666666667
"13445","39386","2019",2,2,0,60475,658,89.5
"13446","39387","2019",4,4,0,124335,1149,109.75
"13447","39388","2019",4,4,0,115000,1262.25,98.5
"13448","39389","2019",4,3,1,160675,1755.75,93.5
"13449","39390","2019",3,3,0,94666.6666666667,945,94.6666666666667
"13450","39391","2019",5,4,1,130700,1048.6,123
"13451","39392","2019",2,1,1,117500,1087,103.5
"13452","39394","2019",1,1,0,50000,505,99
"13453","39396","2019",13,10,3,121238.461538462,1235.53846153846,95.1538461538462
"13454","39397","2019",19,17,2,102650,1039.21052631579,104.578947368421
"13455","39398","2019",8,8,0,146265,1289.5,118.625
"13456","39399","2019",1,1,0,6e+05,1765,340
"13457","39400","2019",2,2,0,152050,953.5,161.5
"13458","39401","2019",2,2,0,242485,2265,125
"13459","39402","2019",6,5,1,151533.333333333,1035,160.833333333333
"13460","39403","2019",2,2,0,132250,1069,128.5
"13461","39404","2019",5,5,0,147780,1338,116.4
"13462","39405","2019",4,4,0,197622.5,1826,111.5
"13463","39406","2019",2,2,0,125500,1309.5,97
"13464","39407","2019",4,4,0,181175,1337,131.5
"13465","39408","2019",2,2,0,1e+05,1306.5,74.5
"13466","39409","2019",2,2,0,133000,948,118.5
"13467","39411","2019",16,12,4,126783.9375,1488.6875,91
"13468","39412","2019",3,3,0,158666.666666667,1379.66666666667,121
"13469","39413","2019",10,9,1,181469,1921,103.3
"13470","39415","2019",13,13,0,100436.692307692,1199.69230769231,86.1538461538462
"13471","39418","2019",1,1,0,154500,1188,130
"13472","39421","2019",2,2,0,149750,1384.5,108
"13473","39422","2019",8,8,0,166668.75,1700.5,101.875
"13474","39424","2019",2,2,0,372640,2042,178
"13475","39425","2019",1,1,0,269500,1123,240
"13476","39426","2019",2,2,0,115500,663.5,165
"13477","39429","2019",5,5,0,94800,1221.4,79.8
"13478","39430","2019",2,2,0,163050,1708.5,99.5
"13479","39431","2019",6,6,0,153466.666666667,1687,90.1666666666667
"13480","39434","2019",43,33,10,128469.465116279,1351,102.790697674419
"13481","39435","2019",11,7,4,105445.454545455,1219.09090909091,87.3636363636364
"13482","39436","2019",3,3,0,150250,1282.33333333333,117
"13483","39437","2019",3,2,1,77266.6666666667,827.666666666667,97.3333333333333
"13484","39439","2019",9,9,0,156294.444444444,1257.77777777778,126
"13485","39441","2019",41,20,21,183286.609756098,2984.34146341463,61
"13486","39443","2019",1,1,0,289000,1741,166
"13487","39445","2019",2,2,0,114500,1344.5,85
"13488","39446","2019",4,4,0,197500,1252.25,157
"13489","39447","2019",2,2,0,125000,1533.5,81
"13490","39448","2019",10,10,0,166125,1525.2,110.4
"13491","39449","2019",4,4,0,182325,1495.25,127.5
"13492","39451","2019",5,5,0,130290,1696,77.6
"13493","39452","2019",10,9,1,149268.1,1376.1,120.8
"13494","39453","2019",5,2,3,93000,936.8,96.2
"13495","39454","2019",2,2,0,57500,707,80
"13496","39456","2019",4,4,0,171750,1674.75,104.5
"13497","39457","2019",1,1,0,147000,1690,87
"13498","39458","2019",5,5,0,125540,989.6,118.4
"13499","39460","2019",2,2,0,66125,1051,62.5
"13500","39461","2019",1,1,0,265000,1656,160
"13501","39462","2019",10,10,0,141060,1436.9,101.7
"13502","39463","2019",1,1,0,140000,1522,92
"13503","39464","2019",3,3,0,129000,1499.66666666667,94
"13504","39465","2019",1,1,0,163300,1737,94
"13505","39466","2019",4,4,0,102812.5,899.25,113.25
"13506","39468","2019",3,3,0,136090,1036.33333333333,132
"13507","39469","2019",1,1,0,3e+05,2000,150
"13508","39470","2019",11,5,6,200513.636363636,2573.36363636364,103.727272727273
"13509","39471","2019",10,10,0,119638,1194,99.7
"13510","39473","2019",3,3,0,131333.333333333,1010,124
"13511","39474","2019",1,1,0,44000,524,84
"13512","39475","2019",22,20,2,117995.454545455,1238.18181818182,95.6363636363636
"13513","39476","2019",23,21,2,118173.913043478,1386.13043478261,88.4347826086957
"13514","39477","2019",2,2,0,140000,1596.5,87
"13515","39478","2019",76,22,54,86565.1315789474,1067.47368421053,86.8289473684211
"13516","39479","2019",5,5,0,161571,1305.8,127.4
"13517","39480","2019",2,2,0,155910,1209,135
"13518","39481","2019",2,2,0,180500,1858,97
"13519","39485","2019",8,8,0,118937.5,1183.5,111
"13520","39487","2019",34,24,10,161873.588235294,1804.91176470588,97.7352941176471
"13521","39489","2019",5,5,0,214012,1550.6,128.4
"13522","39490","2019",1,1,0,172900,1218,142
"13523","39491","2019",17,15,2,152701.705882353,1534.52941176471,99.1764705882353
"13524","39493","2019",2,2,0,141500,1252,114.5
"13525","39494","2019",2,2,0,185500,4301,52.5
"13526","39497","2019",1,1,0,177500,1224,145
"13527","39498","2019",2,2,0,167950,1836,95
"13528","39499","2019",1,1,0,165300,1777,93
"13529","39500","2019",35,21,14,104723.571428571,1230.17142857143,86.6
"13530","39501","2019",24,22,2,167612.5,1593.25,107
"13531","39502","2019",1,1,0,176000,1760,100
"13532","39503","2019",6,6,0,217798.333333333,1831.16666666667,118
"13533","39504","2019",5,5,0,95040,1057.6,86.6
"13534","39505","2019",1,1,0,20000,833,24
"13535","39507","2019",1,1,0,176950,1752,101
"13536","39508","2019",11,11,0,101400,907.818181818182,115.545454545455
"13537","39510","2019",16,15,1,187786.25,2181.625,90.4375
"13538","39513","2019",1,1,0,118750,1153,103
"13539","39517","2019",1,1,0,73500,942,78
"13540","39518","2019",1,1,0,49000,845,58
"13541","39519","2019",4,4,0,167600,1306.5,133
"13542","39520","2019",3,2,1,143000,1284.66666666667,112.666666666667
"13543","39522","2019",5,5,0,109000,1173.8,89.8
"13544","39523","2019",1,1,0,75000,1667,45
"13545","39525","2019",1,1,0,109500,1288,85
"13546","39526","2019",42,35,7,121560.476190476,1331.97619047619,95.9761904761905
"13547","39527","2019",4,4,0,159750,1118,137.75
"13548","39528","2019",5,5,0,87700,811,103.4
"13549","39530","2019",12,12,0,145864.583333333,1513.16666666667,95.75
"13550","39531","2019",2,2,0,121875,1391.5,92.5
"13551","39533","2019",2,2,0,79500,1097.5,72.5
"13552","39534","2019",3,3,0,105000,881.333333333333,96
"13553","39535","2019",6,5,1,121641.666666667,1064.33333333333,110.666666666667
"13554","39537","2019",7,7,0,166205.714285714,1442.28571428571,118
"13555","39539","2019",5,5,0,114967,1064,98.8
"13556","39540","2019",3,3,0,100400,1019.33333333333,108.666666666667
"13557","39543","2019",1,1,0,290000,1278,227
"13558","39546","2019",6,6,0,171468.333333333,1243.33333333333,143.166666666667
"13559","39547","2019",5,5,0,158374,1281.4,128.8
"13560","39548","2019",2,2,0,126500,1822,69.5
"13561","39550","2019",1,1,0,79950,2665,30
"13562","39551","2019",1,1,0,72500,1422,51
"13563","39552","2019",5,4,1,92820,1455.2,70.2
"13564","39553","2019",1,1,0,165000,1100,150
"13565","39554","2019",1,1,0,44000,537,82
"13566","39555","2019",3,3,0,102500,1194.33333333333,82.3333333333333
"13567","39556","2019",3,3,0,98666.6666666667,1165.33333333333,71.6666666666667
"13568","39557","2019",2,2,0,115000,1457,109
"13569","39558","2019",3,3,0,196366.666666667,1783,111.333333333333
"13570","39559","2019",7,7,0,135714.285714286,1333.14285714286,106.714285714286
"13571","39560","2019",3,2,1,233333.333333333,1512.33333333333,163.333333333333
"13572","39561","2019",4,3,1,127145,1026.75,135.25
"13573","39567","2019",2,2,0,238000,1922.5,125
"13574","39569","2019",5,5,0,134499.4,1143.2,115.2
"13575","39570","2019",3,3,0,84333.3333333333,527,160.333333333333
"13576","39571","2019",5,5,0,172880,1412.6,117.4
"13577","39572","2019",7,7,0,139195.714285714,1418.28571428571,95.2857142857143
"13578","39573","2019",11,8,3,129122.727272727,1350.90909090909,96.0909090909091
"13579","39574","2019",7,7,0,118338.571428571,1156.28571428571,99.8571428571429
"13580","39575","2019",2,2,0,134000,1606.5,90.5
"13581","39576","2019",15,15,0,159133.6,1541.53333333333,102.133333333333
"13582","39579","2019",8,8,0,183900,1369,130.25
"13583","39581","2019",1,1,0,147000,1301,113
"13584","39582","2019",9,8,1,100422.222222222,1175.66666666667,81.5555555555556
"13585","39583","2019",3,3,0,78600,1196,78.3333333333333
"13586","39584","2019",1,1,0,194550,1247,156
"13587","40001","2019",121,90,31,113443.363636364,1385.39669421488,86.7190082644628
"13588","40002","2019",16,15,1,125094.375,1290.8125,100.75
"13589","40004","2019",43,27,16,327689.209302326,3445.46511627907,97.1860465116279
"13590","40005","2019",2,2,0,116750,1065.5,115
"13591","40006","2019",8,8,0,161312.5,1484.75,110.25
"13592","40007","2019",1,1,0,129500,1599,81
"13593","40011","2019",1,1,0,194000,1630,119
"13594","40012","2019",1,1,0,125000,954,131
"13595","40014","2019",3,3,0,288666.666666667,2697.66666666667,108
"13596","40015","2019",2,2,0,115000,4071.5,75
"13597","40016","2019",1,1,0,126500,1012,125
"13598","40017","2019",5,5,0,146802,1116.2,131
"13599","40018","2019",5,5,0,139400,1487.6,94
"13600","40019","2019",31,25,6,184216.451612903,2204.25806451613,85.6451612903226
"13601","40020","2019",6,6,0,204475.833333333,1703,120.666666666667
"13602","40021","2019",21,20,1,222225.476190476,2603.57142857143,86.7619047619048
"13603","40022","2019",8,8,0,162993.75,1446,113
"13604","40023","2019",2,2,0,186000,1707,109.5
"13605","40024","2019",3,3,0,155333.333333333,1551.33333333333,100.666666666667
"13606","40025","2019",15,15,0,178186.666666667,1675.06666666667,100.866666666667
"13607","40026","2019",4,4,0,162935,1570.75,105.75
"13608","40027","2019",1,1,0,119900,882,136
"13609","40028","2019",3,3,0,152370.333333333,1304.66666666667,115
"13610","40029","2019",3,3,0,136796.666666667,1063,144.666666666667
"13611","40030","2019",2,2,0,135000,1189,110.5
"13612","40031","2019",15,15,0,172863.333333333,1645.2,103.866666666667
"13613","40032","2019",2,2,0,148500,1927.5,90.5
"13614","40033","2019",3,3,0,134333.333333333,888.666666666667,157
"13615","40034","2019",6,6,0,250033.333333333,1819.83333333333,135.833333333333
"13616","40035","2019",10,10,0,213141.4,1891.3,124.7
"13617","40036","2019",41,33,8,275170.853658537,2975.43902439024,97.5853658536585
"13618","40037","2019",14,14,0,190352.571428571,1938.21428571429,100.857142857143
"13619","40038","2019",1,1,0,165000,1044,158
"13620","40040","2019",8,8,0,131277.5,1349.625,103.125
"13621","40041","2019",2,2,0,152500,1060,147.5
"13622","40042","2019",5,5,0,305910,2407.2,130.8
"13623","40043","2019",36,26,10,125396.388888889,1892.52777777778,67.2222222222222
"13624","40044","2019",11,11,0,338080,2978.90909090909,128.090909090909
"13625","40046","2019",462,247,215,239526.201298701,3280.84199134199,76.4372294372294
"13626","40047","2019",4,4,0,139000,1241.25,133.25
"13627","40049","2019",1,1,0,192125,1685,114
"13628","40050","2019",6,6,0,193583.333333333,1667.33333333333,120.333333333333
"13629","40051","2019",6,6,0,204506.666666667,1901.83333333333,109.166666666667
"13630","40052","2019",3,3,0,120340.333333333,1158.33333333333,118.666666666667
"13631","40053","2019",7,7,0,118670,1175.28571428571,109.714285714286
"13632","40054","2019",3,3,0,167533.333333333,886,196.666666666667
"13633","40055","2019",13,11,2,185759.230769231,1867.15384615385,95.3846153846154
"13634","40056","2019",10,10,0,150389.5,1304.5,127.2
"13635","40057","2019",3,3,0,110725,1190.33333333333,95
"13636","40058","2019",3,3,0,132166.666666667,1550,85.3333333333333
"13637","40059","2019",10,10,0,164123.4,1410.3,115
"13638","40060","2019",3,3,0,150166.666666667,1098.66666666667,155
"13639","40061","2019",17,15,2,168690,1542.94117647059,114.117647058824
"13640","40062","2019",6,6,0,165255.333333333,1573.66666666667,107
"13641","40063","2019",13,12,1,209245.307692308,1977,110.538461538462
"13642","40064","2019",1,1,0,170000,1889,90
"13643","40065","2019",376,150,226,285490.824468085,4791.21808510638,62.3218085106383
"13644","40066","2019",4,4,0,171309.5,1491.75,119.75
"13645","40067","2019",9,9,0,136205.555555556,1491.44444444444,94.2222222222222
"13646","40068","2019",7,7,0,207395.857142857,1864.42857142857,119.857142857143
"13647","40069","2019",3,3,0,114666.666666667,1100.66666666667,108
"13648","40070","2019",7,7,0,241516.428571429,1658.42857142857,146.428571428571
"13649","40071","2019",10,10,0,142525.1,1294.9,118.5
"13650","40072","2019",2,2,0,101187.5,1211,98
"13651","40073","2019",3,3,0,163155,1031.66666666667,164.333333333333
"13652","40074","2019",8,8,0,158775.375,1381,120.25
"13653","40075","2019",30,29,1,225177.6,2105.86666666667,110.733333333333
"13654","40076","2019",2,2,0,140125,1855.5,84.5
"13655","40077","2019",6,6,0,188633.333333333,2157.16666666667,92
"13656","40078","2019",5,5,0,226400,1428.6,152.2
"13657","40080","2019",17,17,0,132850,1375.70588235294,100.176470588235
"13658","40081","2019",9,9,0,156011.111111111,1753,92.2222222222222
"13659","40082","2019",1,1,0,150000,4054,37
"13660","40083","2019",4,4,0,152850,1113.5,135.5
"13661","40084","2019",9,9,0,181011.222222222,1580.11111111111,112.444444444444
"13662","40085","2019",6,6,0,185225,1980.83333333333,96.1666666666667
"13663","40086","2019",9,9,0,146781.222222222,1209.22222222222,129.111111111111
"13664","40087","2019",4,4,0,179525,870.75,200.25
"13665","40088","2019",560,176,384,130162.344642857,2020.31428571429,66.5321428571429
"13666","40089","2019",8,7,1,108002.5,1160.75,95
"13667","40090","2019",6,6,0,120294,1177.33333333333,109
"13668","40091","2019",9,9,0,126519.444444444,1077.55555555556,128.555555555556
"13669","40092","2019",5,5,0,177192.2,1610.8,119
"13670","40093","2019",1,1,0,110000,1134,97
"13671","40094","2019",10,10,0,184870,1940.1,102.8
"13672","40095","2019",8,7,1,173282.5,1593.875,112.25
"13673","40096","2019",1,1,0,76000,817,93
"13674","40097","2019",10,2,8,95329,2592.1,45.5
"13675","40098","2019",1,1,0,220000,1913,115
"13676","40099","2019",4,4,0,188967.5,1578.25,119.25
"13677","40100","2019",5,5,0,180610,2070.2,95.6
"13678","40101","2019",3,3,0,266333.333333333,1698,166.333333333333
"13679","40102","2019",15,15,0,88433.3333333333,987,91.8
"13680","40103","2019",9,9,0,205611.111111111,1989.66666666667,111.666666666667
"13681","40104","2019",20,19,1,180041.5,1560.2,115.25
"13682","40105","2019",7,7,0,129385.714285714,975,140.714285714286
"13683","40108","2019",12,12,0,200433.416666667,2179.5,92.8333333333333
"13684","40109","2019",5,5,0,144842.4,1261,122
"13685","40110","2019",8,8,0,137625,1234,115.625
"13686","40111","2019",11,11,0,162600,1503.09090909091,102.363636363636
"13687","40112","2019",1,1,0,65200,825,79
"13688","40113","2019",4,4,0,188472.75,1883.25,113.25
"13689","40114","2019",2,2,0,167500,1542.5,102
"13690","40115","2019",3,3,0,281429.333333333,2181.33333333333,125.333333333333
"13691","40116","2019",6,6,0,181300,1329.5,148.333333333333
"13692","40117","2019",29,27,2,137378.965517241,1317.96551724138,108.275862068966
"13693","40118","2019",20,18,2,149491,1300.05,119.95
"13694","40119","2019",62,55,7,144029.016129032,1340.96774193548,113.145161290323
"13695","40120","2019",5,5,0,149600,1353.8,114.8
"13696","40121","2019",3,3,0,127873.333333333,1360.33333333333,109.333333333333
"13697","40122","2019",14,14,0,195204,1692.21428571429,115.142857142857
"13698","40123","2019",9,9,0,260378.666666667,2146.55555555556,120.111111111111
"13699","40124","2019",1,1,0,50000,435,115
"13700","40125","2019",15,15,0,231530.666666667,2045.73333333333,120
"13701","40126","2019",29,28,1,184663.448275862,1928.79310344828,99.7241379310345
"13702","40127","2019",7,7,0,148542.857142857,1505.28571428571,96.1428571428571
"13703","40128","2019",6,6,0,140250,1400.33333333333,103.5
"13704","40129","2019",9,9,0,228277.777777778,2104.66666666667,114.666666666667
"13705","40130","2019",4,4,0,115935,1078.25,110
"13706","40131","2019",9,9,0,149561.111111111,1225.88888888889,127.666666666667
"13707","40132","2019",15,15,0,170752.266666667,1529.6,119.6
"13708","40133","2019",131,81,50,275481.893129771,3351.52671755725,83.1526717557252
"13709","40134","2019",26,26,0,156138.846153846,1581.96153846154,101.576923076923
"13710","40135","2019",10,10,0,149099,1415.8,106.7
"13711","40136","2019",2,2,0,102000,1105.5,115.5
"13712","40137","2019",3,3,0,164133.333333333,1556.33333333333,107.666666666667
"13713","40138","2019",6,6,0,165687.833333333,1692.5,97.6666666666667
"13714","40139","2019",2,2,0,103750,1841,57
"13715","40140","2019",5,5,0,125600,1195.6,99.8
"13716","40141","2019",3,3,0,167442,1830.33333333333,89.6666666666667
"13717","40142","2019",14,14,0,171728.571428571,1773.14285714286,99.2142857142857
"13718","40143","2019",2,2,0,146500,1486.5,104.5
"13719","40144","2019",1,1,0,81000,675,120
"13720","40145","2019",5,5,0,129200,1298,100
"13721","40147","2019",1,1,0,90000,874,103
"13722","40149","2019",13,13,0,157000,1309.23076923077,123
"13723","40150","2019",85,50,35,164876.788235294,2247.4,72.4941176470588
"13724","40151","2019",8,8,0,158525,1473.5,108
"13725","40152","2019",13,13,0,205410,1912,114.076923076923
"13726","40153","2019",1,1,0,96100,971,99
"13727","40154","2019",5,5,0,201400,1631.8,124.6
"13728","40155","2019",25,23,2,222078.8,2389.56,93.88
"13729","40156","2019",2,2,0,144000,2020.5,71.5
"13730","40157","2019",44,26,18,185393.636363636,2324.29545454545,76.6363636363636
"13731","40158","2019",3,3,0,90166.6666666667,753,137
"13732","40159","2019",2,1,1,151900,1878.5,79.5
"13733","40160","2019",3,3,0,140066.666666667,2004.33333333333,75.3333333333333
"13734","40161","2019",1,1,0,1e+05,943,106
"13735","40162","2019",7,7,0,164781.428571429,1866.28571428571,92.1428571428571
"13736","40163","2019",8,8,0,189835.75,2816.125,72.25
"13737","40164","2019",3,3,0,109166.666666667,1434.66666666667,75.6666666666667
"13738","40165","2019",11,11,0,152083.636363636,1660.27272727273,100.363636363636
"13739","40167","2019",11,11,0,132125.454545455,1065,126.363636363636
"13740","40168","2019",27,26,1,225854.703703704,2226.96296296296,105.592592592593
"13741","40169","2019",2,2,0,283000,2092,140
"13742","40170","2019",4,4,0,134150,1166.25,113
"13743","40171","2019",7,7,0,223042.857142857,1757.14285714286,122.571428571429
"13744","40172","2019",1,1,0,175000,1750,100
"13745","40175","2019",1,1,0,241042,1545,156
"13746","40177","2019",5,5,0,148407.4,1534.8,98.2
"13747","40178","2019",6,6,0,212895,1857.83333333333,122.666666666667
"13748","40179","2019",17,16,1,206791.176470588,2107.11764705882,109.941176470588
"13749","40180","2019",17,17,0,165970.588235294,1466.05882352941,118.294117647059
"13750","40181","2019",17,17,0,340122.294117647,2810.88235294118,125.647058823529
"13751","40182","2019",17,17,0,219421,2260.29411764706,94.2941176470588
"13752","40183","2019",14,14,0,191000.714285714,1635.28571428571,126.857142857143
"13753","40184","2019",197,120,77,186265.609137056,2751.22335025381,72.9593908629442
"13754","40185","2019",4,4,0,145537.5,1454.75,104
"13755","40186","2019",6,6,0,176672.5,1466.83333333333,119
"13756","40187","2019",145,67,78,184946,3250.5724137931,57.0758620689655
"13757","40188","2019",1,1,0,82200,956,86
"13758","40190","2019",4,4,0,225000,1470,134.75
"13759","40191","2019",12,12,0,143252.75,1328.41666666667,108
"13760","40192","2019",544,310,234,134621.498161765,1777.34191176471,78.2316176470588
"13761","40194","2019",21,17,4,156635.476190476,1414.04761904762,125.714285714286
"13762","40195","2019",2,1,1,177375,1605,135.5
"13763","40196","2019",7,7,0,186936.428571429,1468.71428571429,138.142857142857
"13764","40197","2019",70,68,2,143801.214285714,1583.12857142857,94.0285714285714
"13765","40198","2019",2,2,0,195000,1304,149.5
"13766","40199","2019",4,4,0,204950,2054,111
"13767","40200","2019",18,18,0,159782,1958.16666666667,83.4444444444444
"13768","40201","2019",14,14,0,105214.285714286,1080.71428571429,105
"13769","40202","2019",36,33,3,201519.555555556,1958.66666666667,102.138888888889
"13770","40203","2019",4,4,0,154750,1322.75,119.75
"13771","40204","2019",1,1,0,76000,1027,74
"13772","40205","2019",4,3,1,120000,1054,112
"13773","40206","2019",5,5,0,206541,1844.8,119
"13774","40207","2019",12,11,1,207431.666666667,1943.08333333333,110.833333333333
"13775","40208","2019",6,6,0,168722.833333333,1386.83333333333,126.833333333333
"13776","40209","2019",125,75,50,269217.24,3326.792,82.672
"13777","40210","2019",14,13,1,207945.071428571,1859.64285714286,115.857142857143
"13778","40211","2019",4,4,0,213817.5,1508.75,144.25
"13779","40212","2019",16,15,1,209396,1973.125,110.5
"13780","40213","2019",3,3,0,323116,2720.33333333333,120.333333333333
"13781","40214","2019",10,10,0,169080,1452.1,124
"13782","40215","2019",3,3,0,143333.333333333,1524.66666666667,94.3333333333333
"13783","40216","2019",3,3,0,125000,1633.66666666667,79.6666666666667
"13784","40217","2019",146,103,43,206460.178082192,2243.93150684932,94.8082191780822
"13785","40218","2019",5,4,1,90000,981.6,97.8
"13786","40219","2019",3,3,0,88300,917.333333333333,98
"13787","40220","2019",2,2,0,116000,1595,75
"13788","40221","2019",4,4,0,147500,1428.5,101.5
"13789","40222","2019",3,3,0,211934.333333333,2140,100
"13790","40223","2019",2,2,0,127050,1312,97.5
"13791","40224","2019",57,48,9,202725.403508772,1869.49122807018,110.19298245614
"13792","40227","2019",29,29,0,202461.206896552,1954.24137931034,105.172413793103
"13793","40228","2019",10,7,3,151990,1310.2,110.4
"13794","40229","2019",29,26,3,206462.068965517,2028.62068965517,103.241379310345
"13795","40230","2019",33,31,2,202741.939393939,2034.75757575758,104.787878787879
"13796","40231","2019",20,20,0,220000,2178.25,108.4
"13797","40232","2019",1,1,0,85000,616,138
"13798","40233","2019",32,32,0,175477.875,1465.125,120.40625
"13799","40234","2019",5,5,0,202200,1522.6,130.6
"13800","40235","2019",9,8,1,164450.333333333,1527.66666666667,110.777777777778
"13801","40236","2019",7,7,0,174842.857142857,1770.85714285714,98.8571428571429
"13802","40237","2019",6,6,0,154750,1366.5,118.666666666667
"13803","40238","2019",8,8,0,174837.5,1432.125,125.5
"13804","40240","2019",5,5,0,123770,1123.2,117
"13805","40243","2019",39,35,4,134456.025641026,1401.4358974359,97.8205128205128
"13806","40245","2019",30,29,1,117376.666666667,1194.83333333333,112.333333333333
"13807","40246","2019",18,18,0,171568.888888889,1563.27777777778,114.666666666667
"13808","40247","2019",1,1,0,165509,1561,106
"13809","40248","2019",25,25,0,283752,2640.04,107.84
"13810","40249","2019",8,8,0,147516.25,1293.125,124
"13811","40250","2019",5,5,0,208200,2159.2,99.8
"13812","40251","2019",2,2,0,247500,1468,168.5
"13813","40252","2019",5,5,0,143892,1424.2,103.6
"13814","40253","2019",2,2,0,127870,1257,100.5
"13815","40254","2019",4,4,0,187500,1436.75,140.75
"13816","40255","2019",8,8,0,154375,1433.75,112.75
"13817","40256","2019",7,7,0,215371.428571429,2056.57142857143,108.857142857143
"13818","40257","2019",21,21,0,213365.761904762,2075.57142857143,109.142857142857
"13819","40258","2019",6,6,0,153690,1396.66666666667,107.5
"13820","40259","2019",4,4,0,175175,1457.75,125
"13821","40260","2019",4,4,0,165875,1319.5,135
"13822","40261","2019",48,47,1,230295.5,2389.375,99.0416666666667
"13823","40262","2019",2,2,0,168000,2022,83
"13824","40263","2019",3,3,0,183500,1790.66666666667,103.333333333333
"13825","40264","2019",18,17,1,240371.111111111,2089.05555555556,122.944444444444
"13826","40265","2019",1,1,0,30000,789,38
"13827","40266","2019",48,24,24,186031.25,2594.91666666667,75.2916666666667
"13828","40267","2019",14,14,0,190386.428571429,1520.14285714286,122.285714285714
"13829","40268","2019",7,7,0,362080,2268.14285714286,164.714285714286
"13830","40269","2019",11,10,1,234354.545454545,1692.45454545455,146.363636363636
"13831","40270","2019",10,10,0,146950,1108.7,137
"13832","40271","2019",14,14,0,238821.428571429,2196.14285714286,117.214285714286
"13833","40272","2019",23,18,5,219656.086956522,2209.60869565217,99.8260869565217
"13834","40273","2019",90,50,40,276580.066666667,2797.64444444444,104.233333333333
"13835","40274","2019",17,17,0,191037.058823529,1765.41176470588,110.705882352941
"13836","40275","2019",5,5,0,149200,1615,93.4
"13837","40276","2019",11,11,0,253559.181818182,2746.36363636364,103.727272727273
"13838","40277","2019",7,7,0,227899.714285714,1859.28571428571,122.428571428571
"13839","40278","2019",9,9,0,217056.555555556,2276.55555555556,94.3333333333333
"13840","40279","2019",356,167,189,146767.867977528,2075.64887640449,71.8904494382023
"13841","40280","2019",44,20,24,137466.431818182,1788.5,75.2045454545455
"13842","40281","2019",197,108,89,137387.624365482,1842.21827411168,73.5685279187817
"13843","40282","2019",65,55,10,151423.338461538,1476.98461538462,108.046153846154
"13844","40283","2019",38,34,4,195171.631578947,2032.81578947368,97.5789473684211
"13845","40284","2019",191,92,99,184323.120418848,2393.73298429319,78.1256544502618
"13846","40285","2019",14,14,0,176585.714285714,1478.35714285714,120.785714285714
"13847","40286","2019",13,13,0,159136.384615385,1491.61538461538,109.384615384615
"13848","40287","2019",77,63,14,295883.87012987,3158.1038961039,99.3116883116883
"13849","40288","2019",12,12,0,158095.833333333,1401,117
"13850","40289","2019",2,2,0,163000,1872,96
"13851","40291","2019",33,31,2,317039.909090909,3064.93939393939,100.969696969697
"13852","40292","2019",22,20,2,354547.318181818,2830.68181818182,128.772727272727
"13853","40293","2019",12,12,0,210012.5,1864.91666666667,122.833333333333
"13854","40294","2019",22,21,1,208539.909090909,2104.5,102.636363636364
"13855","40295","2019",18,17,1,187041.666666667,1701.38888888889,115.722222222222
"13856","40296","2019",223,90,133,294028.246636771,4130,68.5919282511211
"13857","40298","2019",6,6,0,158340.166666667,1402.83333333333,119.666666666667
"13858","40299","2019",3,3,0,171833.333333333,1566.33333333333,112
"13859","40300","2019",11,11,0,260336.363636364,2100.81818181818,126.636363636364
"13860","40301","2019",1,1,0,208400,2084,100
"13861","40303","2019",5,5,0,192822,2726.8,81
"13862","40304","2019",162,97,65,629195.592592593,6130.73456790123,97.9567901234568
"13863","40305","2019",5,5,0,106580,826,137
"13864","40306","2019",14,14,0,149264.285714286,1556.07142857143,103.928571428571
"13865","40307","2019",13,13,0,135423.076923077,1218.92307692308,119.461538461538
"13866","40308","2019",11,11,0,206320.909090909,1768.81818181818,122.636363636364
"13867","40309","2019",10,10,0,127790,1124.6,119.2
"13868","40310","2019",198,120,78,225026.398989899,3101.27777777778,74.6262626262626
"13869","40311","2019",12,12,0,233865,1960.16666666667,118.833333333333
"13870","40312","2019",197,104,93,244728.634517767,3058.7614213198,81.243654822335
"13871","40313","2019",10,9,1,141100,1475.8,96.2
"13872","40314","2019",18,15,3,215803.555555556,1856,115
"13873","40315","2019",5,5,0,193390,1885,102.8
"13874","40316","2019",8,8,0,170893.75,1392.625,117.25
"13875","40317","2019",61,54,7,295565.754098361,3241.22950819672,95.5081967213115
"13876","40318","2019",2,2,0,184123.5,2344.5,79
"13877","40319","2019",11,11,0,152218.181818182,1599.27272727273,100.818181818182
"13878","40320","2019",6,6,0,214333.333333333,1682.33333333333,129.333333333333
"13879","40321","2019",4,4,0,108945.25,1029.5,106
"13880","40322","2019",6,6,0,217050,2025.5,107.666666666667
"13881","40323","2019",3,3,0,121633.333333333,1069.66666666667,137.333333333333
"13882","40324","2019",5,5,0,164200,1666,98.6
"13883","40325","2019",2,2,0,137700,1017.5,154
"13884","40326","2019",44,37,7,235342.045454545,2534.34090909091,94.2954545454545
"13885","40327","2019",3,3,0,133666.666666667,1453,94.6666666666667
"13886","40328","2019",112,35,77,198179.25,4009.11607142857,51.4017857142857
"13887","40329","2019",4,4,0,193837.5,1411.75,138.5
"13888","40330","2019",5,5,0,169080,1632.8,106
"13889","40331","2019",43,41,2,128267.279069767,1379.04651162791,97.8604651162791
"13890","40332","2019",27,27,0,220660.37037037,2395.44444444444,95.7407407407407
"13891","40333","2019",14,14,0,159915.071428571,1772,107.642857142857
"13892","40334","2019",5,5,0,178600,1841.8,94.6
"13893","41001","2019",3,3,0,134333.333333333,1141,123.333333333333
"13894","41002","2019",14,14,0,163335.714285714,1324.07142857143,115.5
"13895","41003","2019",4,4,0,92000,1161.75,79.5
"13896","41004","2019",3,3,0,69333.3333333333,1062,62.3333333333333
"13897","41006","2019",3,3,0,287866.666666667,1467.66666666667,145
"13898","41007","2019",8,8,0,125848.25,1254.25,101.875
"13899","41008","2019",10,10,0,153395,1262.7,121.4
"13900","41009","2019",5,5,0,170000,1423.6,119.6
"13901","41010","2019",7,7,0,124700.714285714,1272.28571428571,98
"13902","41012","2019",4,4,0,111250,923.75,116.75
"13903","41013","2019",1,1,0,84000,622,135
"13904","41014","2019",2,2,0,101500,824.5,141.5
"13905","41016","2019",13,13,0,109078.461538462,1043.76923076923,103.615384615385
"13906","41017","2019",6,6,0,123083.333333333,1702.66666666667,81.3333333333333
"13907","41018","2019",686,257,429,115186.45335277,1556.63556851312,74.332361516035
"13908","41020","2019",6,6,0,80166.6666666667,764.833333333333,105.5
"13909","41022","2019",5,5,0,85080,1152.6,75.6
"13910","41024","2019",3,3,0,41766.6666666667,634.333333333333,66.6666666666667
"13911","41025","2019",16,15,1,134865,1344.0625,101.75
"13912","41026","2019",4,4,0,97750,1187.5,84.5
"13913","41027","2019",2,2,0,126250,1470.5,87.5
"13914","41028","2019",7,7,0,111557.142857143,1014.71428571429,104.285714285714
"13915","41029","2019",18,18,0,138344.444444444,1366.72222222222,101.611111111111
"13916","41030","2019",4,4,0,89550,857.25,96.5
"13917","41031","2019",30,29,1,195651.333333333,1802.06666666667,116.2
"13918","41032","2019",29,29,0,193878.620689655,1707.62068965517,114.413793103448
"13919","41035","2019",9,9,0,134857.777777778,1296.55555555556,106
"13920","41036","2019",7,7,0,147457.142857143,1414.14285714286,104.428571428571
"13921","41037","2019",3,3,0,107166.666666667,1605.66666666667,70
"13922","41038","2019",3,3,0,113333.333333333,1227,95.3333333333333
"13923","41039","2019",13,13,0,157734.461538462,1411.30769230769,116.153846153846
"13924","41040","2019",10,10,0,127069.9,1147.9,113.6
"13925","41041","2019",1,1,0,140000,1120,125
"13926","41042","2019",8,8,0,115943,1266.75,91.625
"13927","41043","2019",22,22,0,110098.181818182,1096.31818181818,96.1363636363636
"13928","41044","2019",22,22,0,92156.3636363636,915.590909090909,103.681818181818
"13929","41045","2019",12,11,1,201165,1359.66666666667,146.583333333333
"13930","41046","2019",18,18,0,192472.222222222,1727.66666666667,112.5
"13931","41047","2019",58,34,24,143067.068965517,1694.12068965517,84.0344827586207
"13932","41048","2019",4,4,0,57225,946.5,60.25
"13933","41049","2019",18,18,0,120390.055555556,1349.5,90.1666666666667
"13934","41050","2019",12,12,0,172205.666666667,1581,110.666666666667
"13935","41051","2019",14,14,0,108996.428571429,1156.07142857143,93.4285714285714
"13936","41052","2019",14,14,0,202422.142857143,1797.42857142857,111.214285714286
"13937","41053","2019",8,8,0,99790,1060.875,92.625
"13938","41054","2019",8,8,0,111003.75,1219.125,97.375
"13939","41055","2019",27,25,2,178538.037037037,1896.74074074074,117.444444444444
"13940","41057","2019",3,3,0,140833.333333333,1003,128
"13941","41058","2019",5,5,0,91880,918.2,99.8
"13942","41059","2019",87,86,1,149201.597701149,1501.95402298851,101.183908045977
"13943","41060","2019",8,8,0,67312.5,888.125,84.375
"13944","41061","2019",13,13,0,161024.615384615,1639.07692307692,99.0769230769231
"13945","41062","2019",9,9,0,139841.666666667,1307.22222222222,110.888888888889
"13946","41063","2019",8,8,0,71010.25,817.625,86.75
"13947","41065","2019",9,9,0,149985.555555556,1299.88888888889,114.777777777778
"13948","41066","2019",10,10,0,107540,1258.8,84.1
"13949","41067","2019",33,33,0,161955.757575758,1726.87878787879,94.8181818181818
"13950","41068","2019",3,3,0,110500,1327.33333333333,82.6666666666667
"13951","41069","2019",6,6,0,140266.666666667,1343.83333333333,103.5
"13952","41070","2019",8,8,0,89500,942.125,93.25
"13953","41071","2019",7,6,1,185288.571428571,1122.28571428571,139.428571428571
"13954","41072","2019",6,6,0,92666.6666666667,1248.16666666667,82.3333333333333
"13955","41073","2019",9,9,0,88500,1014.77777777778,85.3333333333333
"13956","41074","2019",20,20,0,169172.5,1446.3,104.25
"13957","41075","2019",10,10,0,71460,909.8,88.7
"13958","41077","2019",2,2,0,81950,1066.5,79
"13959","41078","2019",8,8,0,90875,763.125,116.375
"13960","41079","2019",2,2,0,107500,1286,106
"13961","41080","2019",21,21,0,160684.619047619,1603.57142857143,101.52380952381
"13962","41081","2019",1,1,0,808020,7279,111
"13963","41083","2019",9,9,0,116166.666666667,1078.22222222222,101.666666666667
"13964","41084","2019",17,17,0,97908.8235294118,962.647058823529,100.411764705882
"13965","41085","2019",11,11,0,152724.545454545,1326.72727272727,133.818181818182
"13966","41086","2019",5,5,0,139400,1191.2,119.8
"13967","41087","2019",6,6,0,83815.8333333333,1033.83333333333,78
"13968","41088","2019",5,5,0,115000,1471.2,83.2
"13969","41089","2019",7,7,0,92857.1428571429,924.714285714286,88.5714285714286
"13970","41090","2019",2,2,0,79575,1152,65
"13971","41091","2019",7,7,0,160985.571428571,1804.57142857143,90.4285714285714
"13972","41093","2019",1,1,0,35700,744,48
"13973","41094","2019",9,9,0,145055.555555556,1233.88888888889,116.777777777778
"13974","41095","2019",11,11,0,90190.9090909091,1028.27272727273,82.9090909090909
"13975","41096","2019",9,9,0,124793.333333333,1331.33333333333,103.111111111111
"13976","41097","2019",27,27,0,101875.555555556,1046.81481481481,102.037037037037
"13977","41098","2019",2,2,0,150050,1288,118.5
"13978","41099","2019",6,6,0,98633.3333333333,1256.33333333333,78.6666666666667
"13979","41100","2019",4,4,0,148875,1558.25,103.25
"13980","41101","2019",14,14,0,141256.428571429,1547.5,101.642857142857
"13981","41102","2019",7,7,0,123428.571428571,1244.42857142857,112.285714285714
"13982","41103","2019",6,6,0,133533.333333333,1071.66666666667,123
"13983","41104","2019",26,26,0,159211.538461538,1629.19230769231,101.307692307692
"13984","41105","2019",13,13,0,129635.384615385,1141,107.153846153846
"13985","41106","2019",47,47,0,143058.510638298,1654.31914893617,90.936170212766
"13986","41107","2019",12,12,0,156188.333333333,1456.33333333333,114.833333333333
"13987","41108","2019",3,3,0,138000,1443.66666666667,105.333333333333
"13988","41109","2019",11,11,0,153762.727272727,1539.72727272727,102
"13989","41110","2019",17,17,0,121257.176470588,1195.05882352941,106.647058823529
"13990","41112","2019",3,3,0,187433.333333333,1271,150.333333333333
"13991","41113","2019",6,6,0,142700,1347.5,101.333333333333
"13992","41114","2019",1,1,0,172000,1720,100
"13993","41115","2019",7,7,0,103642.857142857,1026,103.285714285714
"13994","41116","2019",3,3,0,194000,1591.66666666667,124.666666666667
"13995","41118","2019",2,2,0,141400,731,192.5
"13996","41119","2019",5,5,0,137800,1484,95.8
"13997","41120","2019",17,17,0,93671.1764705882,1089.23529411765,84.3529411764706
"13998","41121","2019",2,2,0,141750,1057.5,135.5
"13999","41122","2019",2,2,0,130000,1361,92
"14000","41123","2019",10,10,0,102420,892.4,125.1
"14001","41124","2019",2,2,0,151000,1302.5,117.5
"14002","41125","2019",11,11,0,127494.636363636,1093.36363636364,107.454545454545
"14003","41126","2019",22,22,0,104545.727272727,1133.04545454545,94.5
"14004","41127","2019",5,5,0,185660,1692.4,112.8
"14005","41128","2019",6,6,0,135666.666666667,1578.66666666667,86.3333333333333
"14006","41129","2019",9,9,0,190327.777777778,1693.88888888889,117
"14007","41130","2019",12,12,0,99804.1666666667,1077,94.9166666666667
"14008","41131","2019",10,10,0,117600,1159,103.5
"14009","41132","2019",6,6,0,128008.333333333,1418.33333333333,93.6666666666667
"14010","41134","2019",12,12,0,159495.833333333,1399.91666666667,125.75
"14011","41135","2019",12,12,0,104307.083333333,1161.83333333333,84.8333333333333
"14012","41136","2019",72,67,5,136149.069444444,1524.48611111111,93.4722222222222
"14013","41137","2019",7,7,0,110507.142857143,1224.57142857143,88.4285714285714
"14014","41138","2019",4,4,0,121657.5,1395.75,89.75
"14015","41139","2019",20,20,0,91630.05,1180.15,81.45
"14016","41140","2019",5,5,0,96400,1299.6,69.6
"14017","41141","2019",3,3,0,75333.3333333333,941,86.6666666666667
"14018","41142","2019",22,22,0,181623.636363636,1497.27272727273,120.863636363636
"14019","41143","2019",18,18,0,81777.7777777778,833.166666666667,96.6666666666667
"14020","41144","2019",21,21,0,128902.142857143,1366,93.9523809523809
"14021","41145","2019",5,5,0,133160,1513,99.2
"14022","41146","2019",11,11,0,97457.2727272727,1252.18181818182,75.8181818181818
"14023","41147","2019",24,24,0,139772.458333333,1417.70833333333,99.5416666666667
"14024","41148","2019",17,17,0,148467.647058824,1544,101.647058823529
"14025","41149","2019",60,58,2,103092.166666667,1116.55,89.75
"14026","41150","2019",33,32,1,153527.575757576,1782.39393939394,98.0606060606061
"14027","41151","2019",62,52,10,112377.129032258,1323.08064516129,85.2096774193548
"14028","41152","2019",7,7,0,136314.285714286,1124,111.142857142857
"14029","41153","2019",5,5,0,124000,1312.6,98
"14030","41154","2019",23,23,0,74733.1739130435,854.434782608696,92.6521739130435
"14031","41155","2019",25,25,0,134461,1385.68,102.08
"14032","41156","2019",5,5,0,211300,1755.2,115.4
"14033","41157","2019",14,13,1,124195.142857143,1767.14285714286,81.0714285714286
"14034","41158","2019",31,29,2,171196.290322581,1531.54838709677,115.451612903226
"14035","41159","2019",11,10,1,91727.2727272727,1096.45454545455,85.1818181818182
"14036","41160","2019",4,4,0,78500,986.75,80.25
"14037","41161","2019",26,26,0,171403.846153846,1479.76923076923,110.769230769231
"14038","41163","2019",2,2,0,85000,1876.5,44.5
"14039","41164","2019",14,14,0,98714.2857142857,979.142857142857,101.214285714286
"14040","41166","2019",4,4,0,133450,1225,111.25
"14041","41167","2019",48,47,1,116478.270833333,1308.20833333333,88.5833333333333
"14042","41168","2019",1,1,0,88200,1297,68
"14043","41171","2019",21,21,0,99180,1070.90476190476,96.7619047619048
"14044","41172","2019",8,8,0,90887.5,995,90.5
"14045","41173","2019",54,53,1,113898.425925926,1139.01851851852,102.537037037037
"14046","41174","2019",4,4,0,98000,926.25,109
"14047","41175","2019",23,23,0,100276.086956522,1112.60869565217,92.6086956521739
"14048","41176","2019",11,11,0,169867.636363636,1663,97.6363636363636
"14049","41177","2019",4,4,0,96225,1073.5,93.75
"14050","41179","2019",4,4,0,84500,747,108.5
"14051","41180","2019",4,4,0,178750,1958.5,98.75
"14052","41181","2019",17,17,0,96058.8235294118,1122.41176470588,90.6470588235294
"14053","41182","2019",3,3,0,106500,1270,83.3333333333333
"14054","41184","2019",11,11,0,130200,1348.09090909091,94.5454545454545
"14055","41185","2019",30,30,0,145363.366666667,1299.7,109.6
"14056","41186","2019",3,3,0,165333.333333333,1421.66666666667,129.333333333333
"14057","41187","2019",3,3,0,111333.333333333,1085.66666666667,106.666666666667
"14058","41188","2019",1,1,0,127000,799,159
"14059","41189","2019",7,7,0,133285.714285714,1030,127.285714285714
"14060","41190","2019",2,2,0,130920,1405.5,88
"14061","41192","2019",8,8,0,49062.5,748,72.75
"14062","41193","2019",1,1,0,27000,500,54
"14063","41194","2019",226,201,25,101321.084070796,1192.59292035398,85.9867256637168
"14064","41195","2019",5,5,0,116749,981.2,113
"14065","41196","2019",1,1,0,65000,722,90
"14066","41198","2019",43,38,5,103783.255813953,1059.04651162791,97.7906976744186
"14067","41199","2019",19,19,0,118822.105263158,1340.68421052632,95.3684210526316
"14068","41201","2019",1,1,0,105000,1544,68
"14069","41203","2019",6,6,0,118083.333333333,1565.33333333333,80.1666666666667
"14070","41204","2019",16,15,1,202184.375,1672.75,122.25
"14071","41205","2019",1,1,0,27000,386,70
"14072","41206","2019",8,8,0,290687.5,1865.625,161.25
"14073","41207","2019",20,20,0,194521.25,1637.75,111.65
"14074","41208","2019",2,2,0,47500,508,99
"14075","41209","2019",3,3,0,66922.6666666667,843.333333333333,79
"14076","41211","2019",36,36,0,131817.972222222,1408.25,99.4444444444444
"14077","41212","2019",40,39,1,178570.25,1858.3,98.025
"14078","41213","2019",2,2,0,115044.5,1601.5,68
"14079","41214","2019",5,5,0,104800,953.4,111.2
"14080","41215","2019",1,1,0,95000,699,136
"14081","41216","2019",8,8,0,98250,1230,81.875
"14082","41217","2019",14,14,0,105642.857142857,1150.64285714286,92.0714285714286
"14083","41218","2019",11,11,0,120590.909090909,1664,76.4545454545455
"14084","41219","2019",6,6,0,106241.666666667,1086.33333333333,105
"14085","41220","2019",46,46,0,130124.826086957,1443.4347826087,94.1739130434783
"14086","41221","2019",8,8,0,99375,955.25,101.125
"14087","41222","2019",6,6,0,100416.666666667,1113,92.3333333333333
"14088","41223","2019",5,5,0,154570,1531.6,106.6
"14089","41224","2019",4,4,0,214849.5,1482.25,132
"14090","41225","2019",5,5,0,112700,1038,104.2
"14091","41226","2019",31,31,0,142768.387096774,1443.87096774194,98.6129032258064
"14092","41228","2019",4,4,0,101375,1060.25,95.5
"14093","41229","2019",6,6,0,103916.666666667,1030,102
"14094","41230","2019",19,19,0,168157.894736842,1670.47368421053,104.263157894737
"14095","41231","2019",16,16,0,131871.875,1163,115.25
"14096","41232","2019",64,64,0,102278.9375,1082.78125,87.59375
"14097","41233","2019",15,15,0,161964.666666667,1246.13333333333,127.4
"14098","41235","2019",13,13,0,140875.769230769,1041.76923076923,127.461538461538
"14099","41236","2019",3,3,0,137000,1161.66666666667,112.666666666667
"14100","41237","2019",13,13,0,120466.923076923,1405.46153846154,91.7692307692308
"14101","41238","2019",32,29,3,98335.96875,1285.5625,89.84375
"14102","41239","2019",17,17,0,139932.058823529,1298,103
"14103","41241","2019",12,12,0,146808.333333333,1288.75,94.9166666666667
"14104","41242","2019",67,64,3,92986.7462686567,1053.10447761194,87.0746268656716
"14105","41243","2019",4,4,0,166797.5,1520.75,119.5
"14106","41245","2019",3,3,0,89233.3333333333,1092.33333333333,91
"14107","41246","2019",5,5,0,151800,1412.4,109.6
"14108","41247","2019",21,20,1,139524.761904762,1634.19047619048,97.1428571428571
"14109","41248","2019",14,14,0,113203.571428571,1223.85714285714,90.0714285714286
"14110","41249","2019",25,25,0,145042.84,1493.88,92.8
"14111","41250","2019",11,11,0,116054.545454545,988.181818181818,114.363636363636
"14112","41251","2019",5,5,0,133800,1528.8,89
"14113","41252","2019",22,22,0,150514.090909091,1615.40909090909,98.2727272727273
"14114","41253","2019",3,3,0,179166.666666667,1271,142.666666666667
"14115","41254","2019",3,3,0,42666.6666666667,620,68
"14116","41255","2019",3,3,0,90666.6666666667,985,89.6666666666667
"14117","41256","2019",17,17,0,125622.058823529,1415.29411764706,84.1176470588235
"14118","41258","2019",21,21,0,107888.761904762,1231.85714285714,89.5714285714286
"14119","41259","2019",6,6,0,121200.833333333,1162.33333333333,110.166666666667
"14120","41260","2019",3,3,0,99666.6666666667,1301.66666666667,72.3333333333333
"14121","41261","2019",2,2,0,115000,1006.5,110.5
"14122","41262","2019",16,16,0,186209.375,1718.0625,111.75
"14123","41265","2019",9,8,1,94176.6666666667,1298.22222222222,91.3333333333333
"14124","41266","2019",1,1,0,87097,806,108
"14125","41267","2019",16,16,0,183779.5,2168.375,101.875
"14126","41268","2019",3,3,0,234141.333333333,2286.33333333333,83
"14127","41269","2019",230,143,87,132523.352173913,1554.75652173913,85.104347826087
"14128","41271","2019",14,14,0,133568.571428571,1189.07142857143,108.714285714286
"14129","41273","2019",7,7,0,120142.857142857,1129.57142857143,101.571428571429
"14130","41274","2019",2,2,0,79500,939,78
"14131","41275","2019",14,14,0,116834.285714286,1153.42857142857,98.7857142857143
"14132","41276","2019",24,20,4,162926.458333333,1569.79166666667,104.708333333333
"14133","41277","2019",2,2,0,96737,880,125
"14134","41278","2019",6,6,0,105583.333333333,1203.66666666667,90
"14135","41279","2019",8,8,0,117200,1321.5,89.25
"14136","41280","2019",46,46,0,101884.239130435,1174.41304347826,87.4782608695652
"14137","41281","2019",6,6,0,130838.333333333,1253.83333333333,103.666666666667
"14138","41282","2019",4,4,0,106500,961,110.75
"14139","41283","2019",4,4,0,117750,1105,112.75
"14140","41284","2019",1,1,0,29000,518,56
"14141","41285","2019",10,10,0,133657.5,1195.4,115.1
"14142","41287","2019",6,6,0,155050,1534.66666666667,99.3333333333333
"14143","41288","2019",2,2,0,188000,1439,119.5
"14144","41289","2019",5,5,0,116640,796.4,144.4
"14145","41290","2019",1,1,0,126000,1050,120
"14146","41291","2019",2,2,0,172500,1609,105.5
"14147","41292","2019",5,5,0,108300,995,99.8
"14148","41293","2019",3,3,0,106333.333333333,1057,104.666666666667
"14149","41294","2019",15,14,1,123243.666666667,1378.13333333333,98.7333333333333
"14150","41295","2019",93,90,3,192195.301075269,1909.2688172043,105
"14151","41296","2019",24,24,0,186997.916666667,1897.75,104.125
"14152","41297","2019",16,16,0,131948.75,1412.5,92.1875
"14153","42001","2019",7,7,0,141071.428571429,1281,111.142857142857
"14154","42002","2019",1,1,0,150000,1103,136
"14155","42003","2019",24,24,0,159564.166666667,1426.45833333333,111.791666666667
"14156","42005","2019",131,67,64,174042.267175573,1930.50381679389,90.9847328244275
"14157","42006","2019",4,4,0,194345.25,1651.75,107.25
"14158","42007","2019",3,3,0,91166.6666666667,887.333333333333,98.3333333333333
"14159","42008","2019",3,3,0,103966.666666667,926.333333333333,97.6666666666667
"14160","42009","2019",6,6,0,151987.666666667,1439.5,106.166666666667
"14161","42010","2019",17,15,2,257121.764705882,2952.29411764706,89.4117647058823
"14162","42011","2019",8,7,1,130511.875,1731.625,88.75
"14163","42012","2019",6,6,0,182231.666666667,1852.33333333333,98.1666666666667
"14164","42013","2019",19,18,1,149913.157894737,1587.52631578947,93.6315789473684
"14165","42014","2019",11,11,0,108745.454545455,1339.27272727273,87.3636363636364
"14166","42015","2019",17,17,0,97625.8823529412,934.764705882353,107.882352941176
"14167","42016","2019",5,5,0,155094,1202.2,116.4
"14168","42017","2019",6,6,0,170000,1578.16666666667,121
"14169","42018","2019",8,8,0,185170,1654.75,123.25
"14170","42019","2019",39,30,9,106387.179487179,1153.12820512821,90.7435897435897
"14171","42020","2019",21,20,1,198911.904761905,1940.28571428571,101.380952380952
"14172","42021","2019",13,13,0,188453.846153846,1925.69230769231,98.9230769230769
"14173","42022","2019",41,40,1,223785.12195122,2054.12195121951,112.219512195122
"14174","42023","2019",19,13,6,134572.210526316,1367.94736842105,92.9473684210526
"14175","42025","2019",1,1,0,120000,800,150
"14176","42026","2019",7,7,0,147142.857142857,1432.42857142857,106.285714285714
"14177","42027","2019",3,3,0,133166.666666667,1699.66666666667,85.3333333333333
"14178","42028","2019",3,3,0,145403.333333333,1123.66666666667,128.666666666667
"14179","42029","2019",13,13,0,137734.615384615,1194.15384615385,119.230769230769
"14180","42030","2019",4,4,0,117250,1272.25,98
"14181","42031","2019",4,4,0,266750,2477.25,105
"14182","42032","2019",14,14,0,249573.571428571,2117.78571428571,120.357142857143
"14183","42033","2019",8,8,0,114871.25,975.875,119.625
"14184","42035","2019",1,1,0,174000,1891,92
"14185","42036","2019",3,3,0,218333.333333333,1581.33333333333,124.666666666667
"14186","42037","2019",5,5,0,199910,1982.2,103.8
"14187","42038","2019",12,12,0,168361.666666667,1742.75,102.583333333333
"14188","42039","2019",8,8,0,144326.25,1169.875,120.125
"14189","42040","2019",1,1,0,18000,450,40
"14190","42041","2019",13,13,0,173307.692307692,1570.15384615385,113.307692307692
"14191","42042","2019",7,7,0,188785.714285714,2130.57142857143,89.8571428571429
"14192","42043","2019",15,14,1,237403.266666667,2069.73333333333,115.533333333333
"14193","42044","2019",109,65,44,125875.95412844,1449.55963302752,86.8165137614679
"14194","42045","2019",1,1,0,59000,602,98
"14195","42046","2019",22,20,2,157489.090909091,1689.54545454545,95.5909090909091
"14196","42047","2019",5,5,0,68500,756.4,91.8
"14197","42048","2019",14,14,0,149217.857142857,1527.57142857143,102.285714285714
"14198","42049","2019",6,6,0,112941.666666667,1334,92.1666666666667
"14199","42051","2019",2,2,0,277355,2443,117
"14200","42052","2019",50,25,25,97603.14,1110.88,89.88
"14201","42053","2019",6,6,0,220300,2252.5,101.666666666667
"14202","42054","2019",3,3,0,197565.666666667,1882.66666666667,104.666666666667
"14203","42056","2019",39,36,3,188696.923076923,1941.17948717949,98.025641025641
"14204","42058","2019",2,2,0,107500,1408,77.5
"14205","42059","2019",65,44,21,129943.692307692,1538.10769230769,87.4615384615385
"14206","42060","2019",9,9,0,128394.444444444,1306.66666666667,109.111111111111
"14207","42061","2019",6,5,1,99941.6666666667,999.666666666667,113.833333333333
"14208","42062","2019",11,10,1,189834.090909091,1740.27272727273,107.818181818182
"14209","42063","2019",6,6,0,129175,1188,106.833333333333
"14210","42064","2019",5,5,0,234320,1840.6,119.2
"14211","42065","2019",7,7,0,161128.571428571,1798.85714285714,94.7142857142857
"14212","42066","2019",6,6,0,163308.333333333,1697.33333333333,98.5
"14213","42067","2019",4,3,1,84500,896,90.25
"14214","42068","2019",5,5,0,195160,1567.4,128.6
"14215","42069","2019",31,31,0,188271.387096774,1709.58064516129,113.935483870968
"14216","42070","2019",21,21,0,122726.19047619,1201.61904761905,101.714285714286
"14217","42071","2019",116,39,77,103152.353448276,1258.24137931034,80.1206896551724
"14218","42073","2019",10,10,0,177605,1308.7,133.5
"14219","42074","2019",12,12,0,109741.666666667,1148.58333333333,96.3333333333333
"14220","42075","2019",13,13,0,155090.769230769,1830.46153846154,84.3846153846154
"14221","42076","2019",5,5,0,60120,787.2,83
"14222","42077","2019",5,5,0,142927,1181.6,121.8
"14223","42078","2019",5,5,0,102900,949,107.4
"14224","42079","2019",17,17,0,100182.352941176,932.058823529412,108.588235294118
"14225","42081","2019",7,6,1,206764.285714286,2052,102.857142857143
"14226","42083","2019",3,3,0,358266.666666667,2692.33333333333,130.666666666667
"14227","42084","2019",3,3,0,135333.333333333,950.333333333333,143.333333333333
"14228","42085","2019",9,8,1,146361.111111111,1512.66666666667,91.8888888888889
"14229","42086","2019",4,4,0,131475,941.75,140
"14230","42087","2019",13,13,0,182853.076923077,1726.15384615385,115.384615384615
"14231","42088","2019",6,6,0,155341.666666667,1576.16666666667,99
"14232","42089","2019",4,4,0,163452.5,1543.75,99.5
"14233","42090","2019",4,4,0,101875,972,109.75
"14234","42091","2019",8,7,1,97958.125,1115.625,90.25
"14235","42092","2019",26,17,9,237158.576923077,2483.38461538462,92.0769230769231
"14236","42093","2019",8,7,1,236614.625,2349.75,98.5
"14237","42094","2019",122,65,57,131398.852459016,1602.87704918033,83.6147540983606
"14238","42095","2019",140,53,87,109777.892857143,1257.32857142857,86.7357142857143
"14239","42096","2019",6,6,0,171633.333333333,1601.33333333333,105.5
"14240","42097","2019",56,40,16,197942.142857143,1916.55357142857,103.357142857143
"14241","42098","2019",7,7,0,71522.8571428571,863.428571428571,78.2857142857143
"14242","42099","2019",40,25,15,155589.55,1625.625,90.875
"14243","42102","2019",6,5,1,104833.333333333,961.666666666667,106.5
"14244","42103","2019",32,16,16,164490.5625,1918.21875,90.28125
"14245","42104","2019",10,10,0,122591.7,1142.1,102.1
"14246","42105","2019",2,2,0,170500,2000.5,83.5
"14247","42106","2019",2,2,0,79500,869.5,88.5
"14248","42107","2019",2,2,0,142500,890.5,160
"14249","42108","2019",12,12,0,197305.833333333,2041.66666666667,99.9166666666667
"14250","42109","2019",4,4,0,93125,853,113
"14251","42110","2019",43,30,13,181228.604651163,1958.04651162791,94.3023255813954
"14252","42112","2019",3,3,0,152416.666666667,1211.33333333333,150.333333333333
"14253","42113","2019",3,3,0,161000,1631.66666666667,99.6666666666667
"14254","42115","2019",16,14,2,154700,1366.1875,110.9375
"14255","42116","2019",4,4,0,89158.75,967,93.5
"14256","42118","2019",6,6,0,157383.333333333,1390.66666666667,108.333333333333
"14257","42119","2019",4,4,0,112265,1403.25,82.75
"14258","42120","2019",24,24,0,179557.916666667,1651.70833333333,107.083333333333
"14259","42121","2019",1,1,0,147700,1555,95
"14260","42122","2019",13,13,0,175846.153846154,1738.30769230769,99.9230769230769
"14261","42123","2019",56,29,27,165017.303571429,1913.78571428571,86.9821428571429
"14262","42124","2019",6,6,0,177675,1899.66666666667,94.1666666666667
"14263","42125","2019",2,2,0,107500,1125.5,82
"14264","42126","2019",17,16,1,132929.235294118,1579.58823529412,87.7647058823529
"14265","42127","2019",72,68,4,139643.194444444,1583.73611111111,91.5555555555556
"14266","42128","2019",2,1,1,92425,1052.5,86.5
"14267","42129","2019",17,16,1,161369.705882353,1833.29411764706,100.705882352941
"14268","42130","2019",8,8,0,187533.25,1767.25,107.875
"14269","42131","2019",1,1,0,63000,900,70
"14270","42132","2019",10,10,0,163651,1725.9,95.2
"14271","42133","2019",8,8,0,144572.5,1729.375,86.125
"14272","42134","2019",15,14,1,131853.333333333,1340.8,98.6666666666667
"14273","42135","2019",3,3,0,181346.666666667,1843.33333333333,99
"14274","42136","2019",9,9,0,198916.666666667,1690.11111111111,122.333333333333
"14275","42137","2019",7,6,1,131285.714285714,1431.42857142857,96.2857142857143
"14276","42138","2019",5,5,0,143000,1272.2,107.8
"14277","42139","2019",14,12,2,126642.857142857,1522.78571428571,88.5
"14278","42140","2019",5,5,0,214528,1525.4,142.4
"14279","42141","2019",6,6,0,106816.666666667,1014.33333333333,104
"14280","42142","2019",3,3,0,139910,1515.66666666667,90
"14281","42143","2019",2,2,0,320250,2405,133.5
"14282","42145","2019",13,13,0,135543.846153846,1117.15384615385,122
"14283","42146","2019",1,1,0,28000,467,60
"14284","42147","2019",239,112,127,132853.887029289,1706.04184100418,79.0251046025105
"14285","42148","2019",8,8,0,96288.75,1085.875,89.375
"14286","42149","2019",82,56,26,170985.243902439,1819,94.5975609756098
"14287","42150","2019",17,17,0,166442.352941176,1758.41176470588,94.2941176470588
"14288","42151","2019",4,4,0,140875,1382.5,98.25
"14289","42152","2019",6,6,0,139975,1160,124.833333333333
"14290","42153","2019",6,6,0,197558.333333333,1129.16666666667,167.666666666667
"14291","42154","2019",6,6,0,71250,828.333333333333,86.3333333333333
"14292","42155","2019",18,18,0,109619.166666667,1065.05555555556,103.666666666667
"14293","42156","2019",12,12,0,82954.1666666667,867.916666666667,98.1666666666667
"14294","42157","2019",11,11,0,97259.0909090909,1054.90909090909,92.7272727272727
"14295","42158","2019",3,3,0,123986.666666667,971,118.666666666667
"14296","42159","2019",8,6,2,75937.5,950.125,87.375
"14297","42160","2019",1,1,0,62000,620,100
"14298","42161","2019",5,5,0,150878,1361.8,104.2
"14299","42162","2019",15,15,0,157383.333333333,1449.86666666667,109.533333333333
"14300","42163","2019",12,12,0,89459.5833333333,995.25,90.0833333333333
"14301","42164","2019",1,1,0,35000,500,70
"14302","42165","2019",37,34,3,121979.432432432,1295.02702702703,91.8918918918919
"14303","42166","2019",6,6,0,153783.333333333,1384.66666666667,107.666666666667
"14304","42167","2019",4,3,1,224087.5,2493.25,95.75
"14305","42168","2019",37,26,11,172968.783783784,1869.27027027027,99
"14306","42169","2019",20,20,0,113495,1553.85,69
"14307","42170","2019",19,18,1,185290,1812.73684210526,113.842105263158
"14308","42171","2019",3,3,0,80833.3333333333,992.666666666667,77.6666666666667
"14309","42172","2019",15,12,3,221553.333333333,2165.13333333333,100.666666666667
"14310","42173","2019",2,2,0,75000,903,85
"14311","42174","2019",13,13,0,179953.846153846,1697.61538461538,110.076923076923
"14312","42175","2019",9,9,0,166688.888888889,1651.44444444444,96.5555555555556
"14313","42176","2019",26,26,0,169502.692307692,1660.53846153846,103.884615384615
"14314","42177","2019",30,30,0,124330.833333333,1211.06666666667,104.5
"14315","42178","2019",5,5,0,151620,1480,98
"14316","42179","2019",5,5,0,168210,1476.6,123.2
"14317","42180","2019",10,10,0,213804,1821.1,119
"14318","42181","2019",18,14,4,106136.111111111,1249.72222222222,84.6111111111111
"14319","42182","2019",34,29,5,161217.411764706,1464.05882352941,110.294117647059
"14320","42183","2019",49,23,26,98907,1093.51020408163,82.8979591836735
"14321","42184","2019",192,134,58,125986.677083333,1423.671875,89.7708333333333
"14322","42185","2019",8,7,1,265436.25,2314.375,112.125
"14323","42186","2019",123,76,47,160304.674796748,1743.56097560976,90.1788617886179
"14324","42187","2019",672,167,505,89355.1889880952,1148.16517857143,77.0059523809524
"14325","42188","2019",2,2,0,120777.5,777,139
"14326","42189","2019",124,67,57,142492.782258065,1760.83064516129,79.8306451612903
"14327","42191","2019",13,10,3,160593.846153846,1706.23076923077,90.8461538461538
"14328","42192","2019",7,7,0,104814.285714286,1214.71428571429,89.7142857142857
"14329","42193","2019",18,18,0,162507.777777778,1528.11111111111,109.555555555556
"14330","42194","2019",6,6,0,174416.666666667,1297,134.333333333333
"14331","42195","2019",16,16,0,89616.875,1003.75,89.25
"14332","42197","2019",9,9,0,150577.777777778,1568.77777777778,97.4444444444444
"14333","42198","2019",12,11,1,146458.333333333,1469.33333333333,100.916666666667
"14334","42199","2019",26,26,0,156971.153846154,1341.03846153846,117.692307692308
"14335","42200","2019",13,13,0,186511.538461538,1984.69230769231,97.0769230769231
"14336","42201","2019",9,9,0,183188.888888889,1687.11111111111,106
"14337","42202","2019",4,4,0,152375,1458.25,109
"14338","42203","2019",8,8,0,67990,1206.75,60.125
"14339","42204","2019",15,12,3,107536.666666667,1434.26666666667,79.4
"14340","42205","2019",5,5,0,84910,879.6,98.8
"14341","42206","2019",19,19,0,372597.368421053,2571.21052631579,148.210526315789
"14342","42207","2019",334,130,204,140581.284431138,1519.84131736527,90.559880239521
"14343","42208","2019",15,14,1,215306.666666667,2012.4,108.4
"14344","42209","2019",3,3,0,109133.333333333,981,123
"14345","42210","2019",3,3,0,242283.333333333,2234,110
"14346","42211","2019",31,27,4,223097.741935484,2158.70967741935,106.774193548387
"14347","42212","2019",11,11,0,176668.181818182,1852.72727272727,96.5454545454545
"14348","42213","2019",4,4,0,123610,1014.25,117.5
"14349","42214","2019",16,16,0,219256.25,2220.75,105
"14350","42215","2019",11,11,0,103566.363636364,1027.27272727273,100.363636363636
"14351","42216","2019",6,6,0,144333.333333333,1729.66666666667,84.8333333333333
"14352","42217","2019",4,4,0,63637,679.25,95
"14353","42218","2019",2764,244,2520,82976.3585383502,1134.07995658466,71.9822720694645
"14354","42219","2019",9,9,0,145783.333333333,1732.44444444444,88
"14355","42220","2019",2,2,0,145000,1393.5,106.5
"14356","42221","2019",2,2,0,220000,1802,128
"14357","42222","2019",67,40,27,203808.656716418,2096.07462686567,97.5970149253731
"14358","42223","2019",73,47,26,203522.054794521,2028.28767123288,100.657534246575
"14359","42224","2019",36,26,10,194521.111111111,1585.58333333333,121.055555555556
"14360","42225","2019",35,28,7,179979.371428571,1895.88571428571,94.4857142857143
"14361","42226","2019",3,3,0,142275,943,158.666666666667
"14362","42227","2019",5,5,0,71557,902.4,83.8
"14363","42228","2019",21,21,0,185378.80952381,1741.71428571429,111.142857142857
"14364","42229","2019",3,3,0,134080,1331.33333333333,108.333333333333
"14365","42230","2019",16,15,1,104130.4375,1001.9375,100.6875
"14366","42231","2019",17,17,0,138364.705882353,1419.17647058824,95.4705882352941
"14367","42232","2019",5,5,0,112463.2,1290,91.8
"14368","42233","2019",15,15,0,147950.666666667,1399.73333333333,107.866666666667
"14369","42234","2019",42,31,11,220680,1994.66666666667,106.857142857143
"14370","42235","2019",2,2,0,140000,1175,125
"14371","42236","2019",10,9,1,171180,1189,142.8
"14372","42237","2019",54,39,15,202061.240740741,2102.98148148148,94.7037037037037
"14373","42238","2019",3,3,0,120000,1435.33333333333,109.333333333333
"14374","42239","2019",8,8,0,153375,1434.875,105.125
"14375","42240","2019",5,5,0,100700,946.6,104.6
"14376","42241","2019",4,4,0,73850,897.5,86.75
"14377","42242","2019",26,26,0,187006.153846154,2062.69230769231,93.5384615384615
"14378","42243","2019",4,4,0,112075,980.25,107.75
"14379","42245","2019",4,4,0,76875,923.25,82
"14380","42246","2019",10,9,1,176875,1275.4,123.4
"14381","42247","2019",3,3,0,78833.3333333333,1095.66666666667,73.6666666666667
"14382","42248","2019",10,10,0,101100,979.3,101.6
"14383","42249","2019",17,17,0,100552.235294118,1030.35294117647,97.4705882352941
"14384","42251","2019",6,6,0,212000,1840.16666666667,124.166666666667
"14385","42252","2019",2,2,0,78000,752,103
"14386","42253","2019",11,11,0,180618.181818182,1655.45454545455,115.272727272727
"14387","42254","2019",8,8,0,91050,1006.25,86.75
"14388","42255","2019",5,5,0,126220,1415.2,87.2
"14389","42256","2019",59,55,4,186250.457627119,1895.94915254237,100.508474576271
"14390","42257","2019",9,9,0,86466.6666666667,962,91.3333333333333
"14391","42259","2019",42,41,1,239365.5,2361.95238095238,100.309523809524
"14392","42260","2019",13,12,1,134946.153846154,1381.46153846154,100
"14393","42261","2019",12,11,1,145900,1186.41666666667,131.166666666667
"14394","42262","2019",26,24,2,132594.230769231,1454.96153846154,88
"14395","42264","2019",12,11,1,207880.833333333,1767.08333333333,125.666666666667
"14396","42265","2019",14,13,1,247757.142857143,2388.35714285714,108.571428571429
"14397","42266","2019",6,6,0,178858.333333333,1623.33333333333,112.333333333333
"14398","42267","2019",13,13,0,176298.461538462,1430.84615384615,130
"14399","42268","2019",9,9,0,96069.5555555556,982.222222222222,109.666666666667
"14400","42269","2019",2,2,0,129500,863.5,150
"14401","42270","2019",18,13,5,231366.666666667,1807.22222222222,124.333333333333
"14402","42271","2019",45,34,11,231904.777777778,2140.88888888889,109.711111111111
"14403","42272","2019",28,22,6,159660.714285714,1654.35714285714,97.3928571428571
"14404","42273","2019",8,8,0,167278,1732.625,107.875
"14405","42274","2019",4,3,1,114662.5,988.25,127.75
"14406","42275","2019",114,44,70,187334.754385965,2115.69298245614,86.0614035087719
"14407","42276","2019",8,8,0,85975,781.25,100.625
"14408","42277","2019",4,4,0,244475,2237.25,110.25
"14409","42278","2019",2,2,0,109300,1122.5,90.5
"14410","42279","2019",214,146,68,198060.434579439,2165.2523364486,93.0046728971963
"14411","42280","2019",7,7,0,173714.285714286,1290.57142857143,131
"14412","42281","2019",3,3,0,113933.333333333,1214.66666666667,93.3333333333333
"14413","42282","2019",3,3,0,126833.333333333,1211,108
"14414","42283","2019",5,5,0,183470,2894.2,117
"14415","42284","2019",14,14,0,181796.428571429,1598.71428571429,108.214285714286
"14416","42285","2019",60,53,7,167290.616666667,1735.76666666667,96.6
"14417","42286","2019",5,4,1,127400,1763.6,79.2
"14418","42287","2019",7,7,0,122285.714285714,1379.14285714286,85.5714285714286
"14419","42288","2019",8,8,0,116937.5,1013,130
"14420","42289","2019",16,15,1,142620.9375,1331.25,119.6875
"14421","42290","2019",6,6,0,164600,2212.33333333333,75.8333333333333
"14422","42293","2019",19,19,0,172821.052631579,1791.73684210526,97.5263157894737
"14423","42294","2019",12,12,0,190795.833333333,1566.66666666667,123.333333333333
"14424","42295","2019",4,4,0,107825,1366.5,79.25
"14425","42296","2019",4,4,0,172112.5,1585.25,107
"14426","42297","2019",7,7,0,173800,1617.42857142857,107.285714285714
"14427","42298","2019",5,5,0,97400,1010.6,95.4
"14428","42299","2019",36,25,11,178766.944444444,1812.69444444444,96.6388888888889
"14429","42300","2019",4,4,0,117275,1110.75,104.5
"14430","42301","2019",8,6,2,153437.5,1239.875,129.75
"14431","42302","2019",77,58,19,233215.727272727,2393.46753246753,96.948051948052
"14432","42303","2019",4,3,1,79212.5,865.75,86.5
"14433","42304","2019",95,91,4,169922.947368421,1821.17894736842,94.8
"14434","42305","2019",73,40,33,194527.520547945,2305.76712328767,86.2328767123288
"14435","42306","2019",9,8,1,203678.222222222,2192.77777777778,91.8888888888889
"14436","42307","2019",9,9,0,312158.888888889,3323.66666666667,95.5555555555556
"14437","42308","2019",9,6,3,179431.666666667,1699.33333333333,104.888888888889
"14438","42310","2019",2,2,0,71250,1160,62
"14439","42311","2019",20,18,2,275837.5,2099.1,127.05
"14440","42312","2019",9,9,0,155588.888888889,1574,96.7777777777778
"14441","42313","2019",6,6,0,125630,1355.66666666667,90.8333333333333
"14442","42314","2019",2,2,0,84500,800.5,99
"14443","42315","2019",6,6,0,229341.666666667,1935.33333333333,121.666666666667
"14444","42316","2019",79,56,23,153337.417721519,1669.78481012658,89.4050632911392
"14445","42317","2019",1,1,0,34000,607,56
"14446","42318","2019",12,12,0,104236.666666667,1065.75,106.583333333333
"14447","42319","2019",4,4,0,183787.5,1619.5,107.75
"14448","42320","2019",6,6,0,171068.333333333,1736.33333333333,102.5
"14449","42321","2019",2,2,0,159000,1023,139.5
"14450","42322","2019",12,11,1,157691.666666667,1468.33333333333,112.666666666667
"14451","42323","2019",110,78,32,203545.281818182,2275.41818181818,90.8454545454545
"14452","42324","2019",10,10,0,216160,2217.4,100.1
"14453","42325","2019",6,6,0,171600,1566.5,113.5
"14454","42326","2019",13,13,0,159840.769230769,1667.30769230769,97.3076923076923
"14455","42327","2019",7,5,2,162548.714285714,1757.71428571429,102.428571428571
"14456","42328","2019",10,10,0,101720.4,1099.6,93
"14457","42329","2019",5,5,0,157000,1687.8,90.8
"14458","42330","2019",128,31,97,118857.609375,1350.4140625,84.8203125
"14459","42331","2019",9,8,1,128911.111111111,1194.77777777778,112.888888888889
"14460","42332","2019",57,56,1,163041.929824561,1578.64912280702,104.701754385965
"14461","42333","2019",3,3,0,78250,1109,64.3333333333333
"14462","42334","2019",22,21,1,143746.363636364,1579.27272727273,91.9090909090909
"14463","42335","2019",7,7,0,149002.857142857,1465.57142857143,107.142857142857
"14464","42336","2019",7,7,0,183442.857142857,1670.42857142857,105.285714285714
"14465","42337","2019",6,6,0,110185,882.5,116.833333333333
"14466","42338","2019",10,9,1,136715,1309.7,108.4
"14467","42339","2019",2,2,0,57800,595,95
"14468","43001","2019",2,2,0,43500,466.5,95
"14469","43002","2019",22,14,8,126705.681818182,1465.5,82.7727272727273
"14470","43003","2019",8,8,0,80412.5,791.25,106.25
"14471","43004","2019",2,2,0,145500,1850.5,79
"14472","43005","2019",2,1,1,30142.5,446,68
"14473","43006","2019",1,1,0,35000,427,82
"14474","43007","2019",8,7,1,138312.5,1512.75,92.625
"14475","43008","2019",1,1,0,85000,1545,55
"14476","43010","2019",12,11,1,164197.416666667,1370,117.416666666667
"14477","43011","2019",2,2,0,74000,491,160.5
"14478","43012","2019",78,64,14,163279.102564103,1718.80769230769,95.2820512820513
"14479","43013","2019",2,2,0,51000,724,88
"14480","43015","2019",1,1,0,71200,1017,70
"14481","43016","2019",12,12,0,115250,970,121.25
"14482","43017","2019",4,4,0,124000,1474.5,92.75
"14483","43018","2019",9,9,0,142700,1213.44444444444,114
"14484","43019","2019",1,1,0,60000,923,65
"14485","43020","2019",41,37,4,153149.292682927,1678.29268292683,96.4878048780488
"14486","43021","2019",8,8,0,134318.75,1204,121.125
"14487","43022","2019",6,6,0,141527.5,1255.33333333333,110.166666666667
"14488","43024","2019",7,7,0,93885.7142857143,1323,68.1428571428571
"14489","43025","2019",39,37,2,112078.205128205,1353.97435897436,81.4615384615385
"14490","43026","2019",9,9,0,80780,936.111111111111,90.4444444444444
"14491","43027","2019",2,2,0,124000,767.5,153.5
"14492","43028","2019",3,3,0,161450,1924.66666666667,89.3333333333333
"14493","43030","2019",1,1,0,218100,1983,110
"14494","43031","2019",2,2,0,34010,378,90
"14495","43032","2019",16,16,0,185565.625,1712.875,109.3125
"14496","43033","2019",1,1,0,59000,504,117
"14497","43034","2019",6,6,0,122741.666666667,956,110.666666666667
"14498","43035","2019",1,1,0,70000,769,91
"14499","43036","2019",3,3,0,120500,1074,102.333333333333
"14500","43038","2019",7,7,0,88635.7142857143,1047.85714285714,89.8571428571429
"14501","43039","2019",7,7,0,98071.4285714286,1075.57142857143,102.714285714286
"14502","43040","2019",83,61,22,111238.674698795,1247.28915662651,90.1807228915663
"14503","43041","2019",64,38,26,147296.5625,1612.265625,91.015625
"14504","43042","2019",4,4,0,80422.5,1007,76.5
"14505","43043","2019",2,2,0,125580,868,119
"14506","43044","2019",4,4,0,74500,930.75,88.25
"14507","43045","2019",4,4,0,105525,1075.25,96.5
"14508","43046","2019",28,20,8,137730,1385.21428571429,103.285714285714
"14509","43047","2019",2,2,0,101500,855.5,111.5
"14510","43048","2019",7,7,0,79857.1428571429,843.857142857143,98.5714285714286
"14511","43049","2019",4,4,0,33625,660.5,53.5
"14512","43050","2019",1,1,0,77300,703,110
"14513","43051","2019",57,39,18,145831.333333333,1343.68421052632,109.912280701754
"14514","43052","2019",4,4,0,95337.5,1091.5,91.25
"14515","43053","2019",3,3,0,115166.666666667,1879.33333333333,66.6666666666667
"14516","43054","2019",2,2,0,40500,505.5,80
"14517","43056","2019",2,2,0,138000,1039.5,172.5
"14518","43058","2019",2,2,0,173500,1545.5,112.5
"14519","43059","2019",3,3,0,69666.6666666667,946.333333333333,75.6666666666667
"14520","43060","2019",2,2,0,51750,535.5,97.5
"14521","43061","2019",8,8,0,196843.75,1734.625,113.125
"14522","43062","2019",8,8,0,154049.25,1457.625,99
"14523","43063","2019",3,3,0,111031,1209.66666666667,92
"14524","43064","2019",3,3,0,59250,819,72.3333333333333
"14525","43065","2019",2,2,0,80000,739,114
"14526","43066","2019",3,3,0,107386.666666667,1342.33333333333,96
"14527","43067","2019",2,2,0,153365,1431,108
"14528","43069","2019",6,6,0,83850,881.166666666667,90.3333333333333
"14529","43070","2019",2,2,0,128750,1543.5,92
"14530","43071","2019",3,3,0,116000,1343.33333333333,84
"14531","43072","2019",2,2,0,69000,713,95.5
"14532","43073","2019",2,2,0,95990,867,110.5
"14533","43074","2019",8,8,0,204012.5,2280.875,94.125
"14534","43077","2019",6,6,0,102042.333333333,1015.33333333333,92.1666666666667
"14535","43078","2019",23,22,1,168282.130434783,1531.26086956522,107.739130434783
"14536","43079","2019",1,1,0,2e+05,1600,125
"14537","43080","2019",33,30,3,110600.757575758,992.333333333333,107.939393939394
"14538","43082","2019",2,2,0,73000,859.5,78
"14539","43084","2019",8,8,0,163012.5,1596.75,103.375
"14540","43086","2019",1,1,0,58000,725,80
"14541","43087","2019",28,24,4,122396.321428571,1190.14285714286,103.142857142857
"14542","43089","2019",57,30,27,132492.771929825,1294.40350877193,100.315789473684
"14543","43090","2019",2,2,0,42500,602.5,67.5
"14544","43091","2019",4,3,1,171500,2448.25,93
"14545","43092","2019",4,4,0,128762.5,1455,88
"14546","43093","2019",4,4,0,77750,775.25,102.75
"14547","43094","2019",1,1,0,131700,878,150
"14548","43095","2019",2,2,0,47500,579,81.5
"14549","43096","2019",5,5,0,182339.8,1406.4,128.4
"14550","43097","2019",3,3,0,94863.3333333333,1125.33333333333,100.333333333333
"14551","43098","2019",1,1,0,31500,1050,30
"14552","43099","2019",10,8,2,97838.9,1128.1,87.2
"14553","43100","2019",4,4,0,162282.5,1260,123.75
"14554","43102","2019",14,14,0,121287.428571429,1338.5,92.5
"14555","43104","2019",3,3,0,105416.666666667,1082,98
"14556","43105","2019",1,1,0,1e+05,606,165
"14557","43108","2019",9,9,0,65722.2222222222,768.888888888889,88.3333333333333
"14558","43109","2019",4,4,0,113750,998,112.25
"14559","43110","2019",6,6,0,134891.666666667,1522.83333333333,85.1666666666667
"14560","43111","2019",7,6,1,83557.1428571429,1003.85714285714,84.8571428571429
"14561","43112","2019",52,44,8,91755.7692307692,1018.84615384615,95.5961538461538
"14562","43113","2019",9,7,2,121788.888888889,1101.22222222222,123.777777777778
"14563","43114","2019",9,8,1,130481.666666667,1613.33333333333,84.5555555555556
"14564","43115","2019",8,8,0,100450,1007.875,90
"14565","43116","2019",4,4,0,80842.5,975.25,87.25
"14566","43117","2019",1,1,0,185250,1243,149
"14567","43118","2019",6,6,0,76170.8333333333,902.333333333333,88.1666666666667
"14568","43119","2019",9,9,0,113712.777777778,1364,84.5555555555556
"14569","43120","2019",10,10,0,90283.7,1165.4,79.2
"14570","43121","2019",4,4,0,139405,1436.25,93.5
"14571","43122","2019",2,2,0,112500,1071.5,95
"14572","43123","2019",2,2,0,131160,1260.5,103.5
"14573","43124","2019",7,7,0,119147.142857143,1232.28571428571,97.7142857142857
"14574","43126","2019",9,8,1,139724.111111111,1282.55555555556,106.333333333333
"14575","43127","2019",12,12,0,177716.333333333,1692.33333333333,101.083333333333
"14576","43128","2019",4,4,0,41250,673.25,63.5
"14577","43129","2019",4,4,0,120625,1072.5,120
"14578","43130","2019",16,16,0,121259,1187.9375,101
"14579","43131","2019",6,6,0,75625,778.5,98.5
"14580","43132","2019",13,13,0,130978.461538462,1217.92307692308,107.153846153846
"14581","43133","2019",3,3,0,96490,625.333333333333,158.666666666667
"14582","43134","2019",1,1,0,225000,1510,149
"14583","43135","2019",21,19,2,117580.571428571,1155.2380952381,103.095238095238
"14584","43136","2019",2,2,0,96377.5,859,111
"14585","43137","2019",99,80,19,170383.03030303,1778.28282828283,95.6969696969697
"14586","43138","2019",6,6,0,74786.6666666667,814.666666666667,93.1666666666667
"14587","43140","2019",4,4,0,114125,1590.75,79
"14588","43141","2019",13,11,2,118733.846153846,1137.30769230769,102.538461538462
"14589","43142","2019",5,5,0,111336.8,1470.4,74.8
"14590","43143","2019",3,3,0,94000,1120.33333333333,83.3333333333333
"14591","43144","2019",3,3,0,169800,2336.66666666667,91.6666666666667
"14592","43145","2019",1,1,0,65000,1585,41
"14593","43147","2019",8,8,0,105783.75,1042.25,104.875
"14594","43148","2019",4,4,0,83875,863.5,97.25
"14595","43149","2019",2,2,0,59000,645,90
"14596","43150","2019",6,6,0,111833.333333333,1419.83333333333,78.6666666666667
"14597","43151","2019",4,4,0,110975,850,106.5
"14598","43152","2019",14,14,0,218264.428571429,1582.21428571429,141.785714285714
"14599","43153","2019",16,11,5,157305,1498.5625,107.6875
"14600","43154","2019",5,5,0,137600,1412,97.4
"14601","43155","2019",1,1,0,72000,800,90
"14602","43156","2019",3,3,0,164566.666666667,2228.33333333333,68.6666666666667
"14603","43157","2019",332,57,275,108290.524096386,1372.33734939759,79.3102409638554
"14604","43158","2019",5,5,0,106800,1341.2,85.4
"14605","43159","2019",5,5,0,96432.2,1240.4,75.6
"14606","43160","2019",4,4,0,62750,765.5,82.5
"14607","43162","2019",33,29,4,115336.060606061,1211.06060606061,101.878787878788
"14608","43163","2019",12,11,1,126741.666666667,1255.58333333333,95.5
"14609","43164","2019",13,12,1,67676.9230769231,953.692307692308,72.5384615384615
"14610","43165","2019",16,15,1,92887.5,1023.75,90.8125
"14611","43166","2019",7,7,0,55642.8571428571,887.714285714286,63.8571428571429
"14612","43167","2019",3,3,0,108333.333333333,1283,83.3333333333333
"14613","43168","2019",3,3,0,68800,1193.66666666667,72
"14614","43170","2019",3,3,0,119453.333333333,1458.66666666667,76.6666666666667
"14615","43171","2019",6,6,0,57333.3333333333,764.5,78.1666666666667
"14616","43173","2019",2,2,0,91500,977,93
"14617","43174","2019",9,9,0,125088.888888889,1362.88888888889,101.333333333333
"14618","43177","2019",32,24,8,146211.5625,1423.28125,100.375
"14619","43178","2019",2,2,0,48952.5,1016.5,49
"14620","43181","2019",9,9,0,104355.555555556,1114.77777777778,94
"14621","43183","2019",3,3,0,50000,739,70.6666666666667
"14622","43184","2019",23,18,5,156423.130434783,1788.86956521739,88.4782608695652
"14623","43185","2019",44,41,3,112979.409090909,1213.88636363636,93.75
"14624","43186","2019",12,10,2,90656.25,1245.66666666667,78.5
"14625","43187","2019",2,2,0,49300,666.5,76
"14626","43188","2019",3,3,0,75700,585.666666666667,125
"14627","43189","2019",2,2,0,111835,1189,83
"14628","43190","2019",30,29,1,165852.5,1766.5,95.3333333333333
"14629","43191","2019",3,3,0,119600,1203.33333333333,95.3333333333333
"14630","43192","2019",4,4,0,50875,751.25,64.25
"14631","43194","2019",4,4,0,152100,1327.25,107.75
"14632","43195","2019",4,4,0,66425,945,66.25
"14633","43196","2019",4,4,0,102000,1107.25,108.5
"14634","43197","2019",4,4,0,74375,746.5,101.25
"14635","43198","2019",5,5,0,95500,1007,97
"14636","43199","2019",11,11,0,142159.545454545,1667.90909090909,90.6363636363636
"14637","43200","2019",21,20,1,132806.19047619,1400.33333333333,96.1428571428571
"14638","43201","2019",3,3,0,164283.333333333,918.666666666667,160.666666666667
"14639","43203","2019",6,6,0,134145,1440.33333333333,97.3333333333333
"14640","43204","2019",1,1,0,58000,725,80
"14641","43205","2019",47,42,5,163242.553191489,1687.34042553191,103.127659574468
"14642","43206","2019",1,1,0,44000,657,67
"14643","43207","2019",5,5,0,107074,1174.2,88.4
"14644","43210","2019",7,7,0,59714.2857142857,917.714285714286,72
"14645","43211","2019",30,29,1,166428.6,1547.16666666667,111.933333333333
"14646","43212","2019",15,15,0,87968,1286.26666666667,85.4666666666667
"14647","43213","2019",16,13,3,132609.4375,1157.8125,113.5625
"14648","43214","2019",2,2,0,67500,546.5,123
"14649","43215","2019",8,8,0,62373.75,1254.75,65.875
"14650","43216","2019",29,29,0,143212.965517241,1297.51724137931,108.551724137931
"14651","43217","2019",6,6,0,76500,705.833333333333,116.5
"14652","43218","2019",17,16,1,141050,1460.64705882353,93.3529411764706
"14653","43220","2019",2,2,0,56500,664,84
"14654","43221","2019",3,3,0,77833.3333333333,854.333333333333,101.333333333333
"14655","43223","2019",7,7,0,131114.285714286,1294.42857142857,102.142857142857
"14656","43224","2019",56,50,6,134385.714285714,1513.91071428571,90.2678571428571
"14657","43225","2019",2,2,0,72500,1041.5,70
"14658","43226","2019",3,3,0,144800,1167,145.666666666667
"14659","43227","2019",6,4,2,148116.666666667,1440.66666666667,101
"14660","43228","2019",1,1,0,63650,1632,39
"14661","43229","2019",6,6,0,107484.5,987.5,97.1666666666667
"14662","43230","2019",7,7,0,121899.285714286,1119,108.142857142857
"14663","43231","2019",5,5,0,128801.8,1365.8,100
"14664","43232","2019",3,3,0,109333.333333333,1004.33333333333,113
"14665","43233","2019",6,6,0,169210.833333333,1435.33333333333,115.666666666667
"14666","43234","2019",18,17,1,110810.555555556,1146.22222222222,99.1666666666667
"14667","43236","2019",17,9,8,104538.235294118,1174.88235294118,92.9411764705882
"14668","43237","2019",3,3,0,74250,715.333333333333,104.666666666667
"14669","43238","2019",2,2,0,120250,1237.5,95.5
"14670","43239","2019",11,11,0,60231.6363636364,628.181818181818,94.5454545454545
"14671","43240","2019",5,5,0,84040,976,94.2
"14672","43241","2019",8,8,0,104862.5,1050.875,103.5
"14673","43244","2019",37,33,4,92144.2702702703,1118.21621621622,89.1351351351351
"14674","43245","2019",1,1,0,50000,581,86
"14675","43246","2019",4,4,0,137500,1795.5,80.75
"14676","43247","2019",1,1,0,157000,1744,90
"14677","43249","2019",3,3,0,86033.3333333333,954.666666666667,87.3333333333333
"14678","43251","2019",36,13,23,130032.25,1320.94444444444,93.75
"14679","43253","2019",7,7,0,95770.1428571429,1062,92.4285714285714
"14680","43254","2019",2,2,0,35000,388.5,90.5
"14681","43256","2019",3,3,0,76833.3333333333,788.333333333333,116
"14682","43257","2019",4,4,0,125275,1060.25,116.5
"14683","43258","2019",29,29,0,107663.793103448,1105.72413793103,97.1724137931034
"14684","43259","2019",4,4,0,149062.5,1507.75,98.5
"14685","43260","2019",1,1,0,135000,1125,120
"14686","43261","2019",1,1,0,67000,670,100
"14687","43262","2019",11,9,2,95772.7272727273,986.363636363636,97.4545454545455
"14688","43263","2019",3,3,0,68166.6666666667,1231.66666666667,70
"14689","43264","2019",6,6,0,77313.3333333333,1062,89.8333333333333
"14690","43265","2019",17,17,0,139450,1378.29411764706,103.823529411765
"14691","43267","2019",18,17,1,79716.3333333333,1012.88888888889,77.1111111111111
"14692","43268","2019",63,57,6,140444.047619048,1500.06349206349,96.6190476190476
"14693","44001","2019",32,32,0,139237.5,1400.8125,106.375
"14694","44002","2019",42,36,6,198823.80952381,2308.52380952381,91.3095238095238
"14695","44003","2019",90,60,30,182905.088888889,2066.64444444444,91
"14696","44005","2019",105,102,3,188021.733333333,1991.45714285714,97
"14697","44006","2019",34,34,0,180677.235294118,2345.20588235294,82.1764705882353
"14698","44007","2019",40,40,0,127426.975,1350.425,97.125
"14699","44009","2019",107,94,13,334683.598130841,3103.63551401869,109.738317757009
"14700","44010","2019",131,99,32,253302.595419847,3715.45801526718,73.5572519083969
"14701","44012","2019",91,74,17,242451.571428571,3331.34065934066,75.0879120879121
"14702","44013","2019",31,31,0,178169.35483871,1741.96774193548,104.096774193548
"14703","44014","2019",46,46,0,237794.02173913,2357.17391304348,101.95652173913
"14704","44015","2019",110,95,15,170508.5,1786.48181818182,97.1
"14705","44016","2019",10,10,0,188319,1829.8,103.5
"14706","44018","2019",121,96,25,237449.694214876,2582.65289256198,93.3471074380165
"14707","44019","2019",2,2,0,168250,2024.5,80.5
"14708","44020","2019",283,205,78,222649.229681979,2702.06713780919,85.6996466431095
"14709","44021","2019",95,95,0,163124.852631579,1950.90526315789,92.3263157894737
"14710","44022","2019",35,35,0,161308.828571429,1449.51428571429,113.885714285714
"14711","44023","2019",28,27,1,168698.571428571,1712.28571428571,100.428571428571
"14712","44024","2019",25,24,1,221271.64,2243,101.48
"14713","44025","2019",46,45,1,162074.913043478,1895.30434782609,89.5434782608696
"14714","44026","2019",266,173,93,290362.80075188,2923.36090225564,98.3872180451128
"14715","44027","2019",33,33,0,247292.121212121,2177.39393939394,115.666666666667
"14716","44028","2019",55,53,2,235928.727272727,2071.23636363636,114.054545454545
"14717","44029","2019",89,88,1,218335.584269663,2068.85393258427,109.337078651685
"14718","44030","2019",66,64,2,150140.151515152,1594.89393939394,96.0606060606061
"14719","44031","2019",12,12,0,96402.0833333333,945.083333333333,102.916666666667
"14720","44032","2019",34,33,1,220753.794117647,2270.32352941176,97.5588235294118
"14721","44033","2019",26,26,0,225630.769230769,1944.03846153846,116.346153846154
"14722","44035","2019",232,165,67,294123.961206897,3117.99137931034,95.1422413793103
"14723","44036","2019",190,154,36,123515,1494.01578947368,86.2157894736842
"14724","44038","2019",66,66,0,179505.590909091,1955.19696969697,92.0909090909091
"14725","44039","2019",20,20,0,235508.5,2434.35,100
"14726","44041","2019",92,88,4,230349.891304348,2326.23913043478,100.532608695652
"14727","44043","2019",79,67,12,250568.518987342,2511.46835443038,99.3670886075949
"14728","44044","2019",14,14,0,100900,1051.92857142857,95.1428571428571
"14729","44045","2019",53,53,0,233429.509433962,2128.54716981132,111.132075471698
"14730","44046","2019",35,35,0,215248.571428571,2208.45714285714,96.8
"14731","44047","2019",279,222,57,234955.903225806,2665.59856630824,89.6523297491039
"14732","44048","2019",28,28,0,166930.892857143,1633,104.964285714286
"14733","44049","2019",209,89,120,209373.995215311,3257.62200956938,67.1578947368421
"14734","44050","2019",42,42,0,159667.857142857,1595,100.880952380952
"14735","44051","2019",39,39,0,123461.128205128,1296.51282051282,100.179487179487
"14736","44052","2019",102,99,3,148888.235294118,1755.62745098039,87.3921568627451
"14737","44053","2019",26,26,0,157591.153846154,1615.19230769231,97.3461538461538
"14738","44054","2019",41,41,0,139330,1276.36585365854,111.073170731707
"14739","44055","2019",896,306,590,336279.279017857,4753.03125,72.7678571428571
"14740","44056","2019",48,47,1,207077.083333333,1894.27083333333,111.833333333333
"14741","44057","2019",28,28,0,114678.928571429,1327.71428571429,87
"14742","44058","2019",4,4,0,126250,1068.5,116.75
"14743","44061","2019",53,52,1,179975.679245283,1825.18867924528,106.358490566038
"14744","44062","2019",20,20,0,155292.5,1761.55,96.9
"14745","44063","2019",42,40,2,169581.857142857,1753.83333333333,99.9761904761905
"14746","44064","2019",46,44,2,226739,2229.19565217391,101.978260869565
"14747","44065","2019",8,8,0,88625,914.25,99.125
"14748","44066","2019",74,71,3,248034.540540541,2444.16216216216,104.067567567568
"14749","44067","2019",76,74,2,117623.684210526,1280.40789473684,96.4605263157895
"14750","44068","2019",44,44,0,128234.090909091,1446.72727272727,90.8863636363636
"14751","44069","2019",303,239,64,261664.171617162,2713.39273927393,100.481848184818
"14752","44070","2019",48,46,2,237500.291666667,2519.04166666667,95.6041666666667
"14753","44071","2019",69,67,2,306476.405797101,3011.76811594203,104.478260869565
"14754","44072","2019",95,94,1,198454.136842105,1942.28421052632,103.484210526316
"14755","44073","2019",78,75,3,222010.512820513,2115.88461538462,109.448717948718
"14756","44074","2019",83,66,17,206185.614457831,2704.14457831325,77.1807228915663
"14757","44075","2019",18,18,0,85447.2222222222,991.666666666667,88.2222222222222
"14758","44076","2019",26,26,0,141954.230769231,1464.11538461538,99.7692307692308
"14759","44077","2019",37,36,1,152185.567567568,1646.05405405405,93.5135135135135
"14760","44078","2019",5,5,0,152040,1304.6,121.6
"14761","44079","2019",27,27,0,190808.518518519,2074.33333333333,97.1481481481482
"14762","44080","2019",12,12,0,151750,1771.33333333333,91.9166666666667
"14763","44081","2019",73,73,0,143348.643835616,1590.84931506849,94.9315068493151
"14764","44082","2019",53,53,0,200234.320754717,2108.20754716981,96.8679245283019
"14765","44083","2019",46,46,0,159138.869565217,1772.23913043478,94.4347826086957
"14766","44084","2019",95,88,7,222192.936842105,2333.89473684211,97.8
"14767","44085","2019",14,14,0,117642.857142857,1096.42857142857,107
"14768","44086","2019",13,13,0,107715.384615385,1053.38461538462,103.153846153846
"14769","44087","2019",117,106,11,173060,1893.79487179487,95.2991452991453
"14770","44088","2019",37,37,0,197210.189189189,1992.56756756757,101.459459459459
"14771","44089","2019",56,55,1,202792.803571429,2105.69642857143,100.678571428571
"14772","44090","2019",19,19,0,187326.315789474,1982.31578947368,98.1578947368421
"14773","44091","2019",20,20,0,140924.5,1341.9,109.55
"14774","44092","2019",14,14,0,103178.571428571,918.785714285714,120.642857142857
"14775","44094","2019",44,42,2,259628.227272727,2468.75,104.977272727273
"14776","44095","2019",29,29,0,105857.896551724,1201.10344827586,87.9310344827586
"14777","44096","2019",55,54,1,165859.8,1771,101.872727272727
"14778","44097","2019",84,74,10,293365.964285714,2955.85714285714,101.559523809524
"14779","44098","2019",90,90,0,133536.933333333,1580.16666666667,86.4666666666667
"14780","44099","2019",26,26,0,128623.076923077,1399,98.0384615384615
"14781","44100","2019",35,35,0,200844.6,1943.34285714286,105.285714285714
"14782","44101","2019",105,98,7,223910.028571429,2707.90476190476,88.5142857142857
"14783","44102","2019",41,41,0,200697.56097561,1933.53658536585,104
"14784","44103","2019",93,71,22,153863.172043011,1894.10752688172,85.6236559139785
"14785","44104","2019",15,15,0,151820,1468.66666666667,103.933333333333
"14786","44105","2019",4,4,0,104425,1035.75,105.25
"14787","44106","2019",47,45,2,266046.914893617,2886.12765957447,94.3191489361702
"14788","44107","2019",25,25,0,166440,1758.4,100.68
"14789","44108","2019",29,29,0,195657.413793103,1962.51724137931,100.448275862069
"14790","44109","2019",6241,1362,4879,236222.289536933,3451.92773593975,67.5218714949527
"14791","44110","2019",106,98,8,199823.113207547,2156.43396226415,94.4433962264151
"14792","44111","2019",30,30,0,194503.333333333,1980.6,104.3
"14793","44112","2019",9,9,0,145333.333333333,1477.22222222222,105.333333333333
"14794","44113","2019",61,56,5,162413.93442623,1699.72131147541,97.8032786885246
"14795","44114","2019",450,243,207,269696.468888889,2915.29333333333,91.6777777777778
"14796","44115","2019",55,54,1,212851.763636364,2151.67272727273,101.636363636364
"14797","44116","2019",13,6,7,97963.0769230769,1403.92307692308,71.6923076923077
"14798","44117","2019",54,49,5,199824.074074074,2100.68518518519,98.1481481481482
"14799","44118","2019",21,21,0,144078.952380952,1355.52380952381,111.238095238095
"14800","44119","2019",22,22,0,138324.363636364,1524.18181818182,91.9545454545455
"14801","44120","2019",84,68,16,205840.321428571,2300.42857142857,88.7261904761905
"14802","44121","2019",13,13,0,108946.153846154,1175,101
"14803","44122","2019",36,36,0,224611.666666667,2062.94444444444,109.666666666667
"14804","44123","2019",19,19,0,108910.473684211,1122.05263157895,96.5789473684211
"14805","44124","2019",9,9,0,151000,1113,142.333333333333
"14806","44125","2019",80,72,8,259133.35,3520.5875,80.55
"14807","44126","2019",140,135,5,228162.564285714,3069.79285714286,79.8214285714286
"14808","44127","2019",29,29,0,172142.75862069,1725.72413793103,102.48275862069
"14809","44128","2019",80,80,0,143844.125,1525.8125,94.9875
"14810","44129","2019",151,122,29,152636.072847682,1766.13907284768,88.4503311258278
"14811","44130","2019",67,65,2,254732.985074627,2707.92537313433,96.2537313432836
"14812","44131","2019",411,337,74,296985.459854015,3458.09732360097,89.2919708029197
"14813","44132","2019",425,159,266,281943.724705882,4333.92705882353,68.4470588235294
"14814","44133","2019",51,44,7,201825.215686275,2281.13725490196,92.5490196078431
"14815","44134","2019",12,12,0,196706.666666667,1727.91666666667,116.333333333333
"14816","44135","2019",235,129,106,278356.387234043,3878.45957446809,72.2255319148936
"14817","44136","2019",51,45,6,282932.843137255,3503.88235294118,86.3529411764706
"14818","44137","2019",43,43,0,186469.069767442,1936.79069767442,98.953488372093
"14819","44138","2019",15,15,0,150566.666666667,1488.6,102.666666666667
"14820","44139","2019",27,27,0,146643.962962963,1406.55555555556,106.111111111111
"14821","44140","2019",20,20,0,152311.85,1622.4,93.95
"14822","44141","2019",21,21,0,178886.714285714,1827.28571428571,105.190476190476
"14823","44142","2019",22,21,1,172359.090909091,1741.63636363636,98.1818181818182
"14824","44143","2019",790,372,418,205387.878481013,2784.63924050633,74.3417721518987
"14825","44144","2019",38,38,0,116654.605263158,1223.65789473684,99.4736842105263
"14826","44145","2019",28,28,0,204025,2141.42857142857,99.3571428571429
"14827","44146","2019",28,28,0,104375,967.107142857143,109.107142857143
"14828","44148","2019",9,9,0,86041.1111111111,937.444444444444,91.2222222222222
"14829","44149","2019",57,56,1,175779.649122807,1744.24561403509,105.421052631579
"14830","44150","2019",50,50,0,261207,2419.48,110.78
"14831","44151","2019",104,98,6,256193.865384615,2348.64423076923,109.423076923077
"14832","44152","2019",36,36,0,166418.777777778,1722.11111111111,97.2777777777778
"14833","44153","2019",19,19,0,102988.526315789,1010.84210526316,101.631578947368
"14834","44154","2019",380,264,116,222195.297368421,3108.90789473684,73.3421052631579
"14835","44155","2019",37,37,0,147787.216216216,1755.32432432432,89.7567567567568
"14836","44156","2019",47,47,0,143517.021276596,1674.40425531915,86.9148936170213
"14837","44157","2019",28,28,0,142357.142857143,1691.67857142857,86.6071428571429
"14838","44158","2019",90,83,7,268591.833333333,2633.08888888889,102.533333333333
"14839","44159","2019",13,13,0,255407.692307692,2374.76923076923,114
"14840","44161","2019",42,41,1,137083.333333333,1520.2619047619,94.2857142857143
"14841","44162","2019",901,318,583,196415.437291898,2506.06326304107,78.3551609322975
"14842","44163","2019",62,60,2,152799.241935484,1511.77419354839,103.564516129032
"14843","44164","2019",37,37,0,197756.756756757,2010.43243243243,98.6486486486486
"14844","44165","2019",17,17,0,176874.117647059,1808.70588235294,101.176470588235
"14845","44166","2019",68,66,2,225469.176470588,2499.70588235294,93.3235294117647
"14846","44168","2019",67,67,0,135678.432835821,1589.79104477612,86.9701492537313
"14847","44169","2019",118,87,31,193209.559322034,2346.4406779661,86.1525423728814
"14848","44170","2019",4,4,0,58250,702.25,78.5
"14849","44171","2019",21,20,1,237764.428571429,2268.80952380952,106.52380952381
"14850","44172","2019",190,146,44,274811.926315789,3041.38421052632,93.3105263157895
"14851","44173","2019",23,23,0,182036.956521739,1742.26086956522,105.95652173913
"14852","44174","2019",27,27,0,186498.703703704,1711.55555555556,110.703703703704
"14853","44175","2019",68,68,0,226845.147058824,2023.69117647059,114.235294117647
"14854","44176","2019",40,39,1,154128.325,1850.975,86.8
"14855","44178","2019",28,28,0,184919.642857143,1982.96428571429,93.3571428571429
"14856","44179","2019",55,55,0,250205.454545455,2376.85454545455,108.418181818182
"14857","44180","2019",38,35,3,142790.105263158,1577.31578947368,94.2105263157895
"14858","44182","2019",138,106,32,211553.152173913,3198.91304347826,69.7391304347826
"14859","44183","2019",39,39,0,236551.794871795,2307.05128205128,104.641025641026
"14860","44184","2019",1420,644,776,171447.15915493,2327.46267605634,75.0577464788732
"14861","44185","2019",53,46,7,115514.226415094,1376.05660377358,88.5094339622642
"14862","44186","2019",105,102,3,207039.819047619,2319.79047619048,90.152380952381
"14863","44187","2019",75,70,5,184256.68,2009.90666666667,91.32
"14864","44188","2019",90,83,7,212988.8,2179.04444444444,103.122222222222
"14865","44189","2019",23,22,1,134908.695652174,1511.91304347826,92.1739130434783
"14866","44190","2019",452,272,180,235108.347345133,2972.98672566372,80.0575221238938
"14867","44192","2019",43,42,1,183836.627906977,1894.27906976744,101.186046511628
"14868","44193","2019",24,24,0,102575,1045.70833333333,99.3333333333333
"14869","44194","2019",100,78,22,351614.85,3147.18,115.45
"14870","44195","2019",118,105,13,196666.694915254,2156.57627118644,94.1440677966102
"14871","44196","2019",37,37,0,138024.594594595,1367.2972972973,103.918918918919
"14872","44197","2019",19,19,0,106410.526315789,1077,100.631578947368
"14873","44198","2019",110,84,26,263729.463636364,2866.2,91.8090909090909
"14874","44199","2019",33,33,0,104478.787878788,1087.54545454545,101.454545454545
"14875","44200","2019",7,7,0,70421.8571428571,802.428571428571,81.8571428571429
"14876","44201","2019",31,31,0,415078.935483871,3198.35483870968,135.548387096774
"14877","44202","2019",23,23,0,141217.391304348,1479.17391304348,98.9565217391304
"14878","44203","2019",26,26,0,207957.692307692,2070.23076923077,104.269230769231
"14879","44204","2019",116,89,27,266962.25862069,2755.30172413793,99.8793103448276
"14880","44205","2019",32,30,2,165378.75,1761.3125,97.6875
"14881","44206","2019",25,25,0,122985,1424.84,88.08
"14882","44207","2019",12,12,0,133537.5,1382.5,95.6666666666667
"14883","44208","2019",17,17,0,120682.352941176,1139.64705882353,109.705882352941
"14884","44209","2019",123,108,15,279550.138211382,2618.74796747967,107.577235772358
"14885","44210","2019",123,108,15,145312.674796748,1827.85365853659,81.9756097560976
"14886","44211","2019",159,112,47,225066.34591195,3123.40251572327,79.4654088050314
"14887","44212","2019",136,125,11,211299.970588235,2183.99264705882,100.139705882353
"14888","44213","2019",110,106,4,134440.836363636,1355.53636363636,100.336363636364
"14889","44214","2019",27,26,1,150155.925925926,1654.14814814815,97.6296296296296
"14890","44215","2019",364,288,76,284079.626373626,3070.91483516484,93.1648351648352
"14891","44216","2019",63,62,1,159649.492063492,1607.85714285714,102.333333333333
"14892","44217","2019",73,72,1,252529.876712329,2256.43835616438,115.561643835616
"14893","44218","2019",6,6,0,106733.333333333,922.833333333333,110.166666666667
"14894","44220","2019",24,24,0,215038.25,2079.20833333333,107.666666666667
"14895","44221","2019",23,23,0,169913.043478261,1647.34782608696,108.869565217391
"14896","44222","2019",20,20,0,157375,1663.65,95.35
"14897","44223","2019",57,47,10,184841.157894737,2077.26315789474,88.859649122807
"14898","44224","2019",31,30,1,143719.35483871,1611.06451612903,90
"14899","45002","2019",2,2,0,172500,1135.5,143
"14900","45004","2019",174,160,14,135059.718390805,1507.64942528736,93.2701149425287
"14901","45005","2019",4,4,0,234500,2405.75,101
"14902","45006","2019",19,13,6,251432.105263158,2571,98.6842105263158
"14903","45008","2019",19,18,1,127836.842105263,1362.26315789474,98.8421052631579
"14904","45009","2019",21,21,0,134740.476190476,1440.90476190476,98.8095238095238
"14905","45010","2019",10,10,0,145444.8,1931.7,77.3
"14906","45011","2019",4,4,0,184875,1620.25,114
"14907","45013","2019",3,3,0,154212.333333333,1306.66666666667,99.6666666666667
"14908","45014","2019",3,3,0,148000,1551,96
"14909","45015","2019",9,9,0,225483.333333333,2510.66666666667,113.333333333333
"14910","45016","2019",13,12,1,110765.384615385,1156.23076923077,92.1538461538462
"14911","45017","2019",8,8,0,145312.5,1114.875,136
"14912","45018","2019",15,15,0,109908.666666667,1108.06666666667,108.666666666667
"14913","45019","2019",11,11,0,193081.818181818,1578.54545454545,125.636363636364
"14914","45020","2019",9,9,0,198122.222222222,1738.66666666667,118.111111111111
"14915","45021","2019",4,4,0,138850,1312.5,116.5
"14916","45022","2019",3,3,0,136333.333333333,1651.66666666667,84
"14917","45023","2019",1,1,0,60000,500,120
"14918","45024","2019",32,32,0,183256.28125,1619.875,111.78125
"14919","45025","2019",17,17,0,132200,1410.05882352941,100.705882352941
"14920","45026","2019",10,10,0,99054.6,1202.1,87
"14921","45027","2019",9,9,0,130272.222222222,1163.11111111111,110.555555555556
"14922","45028","2019",141,96,45,138600.411347518,1571.6170212766,88.5957446808511
"14923","45029","2019",32,32,0,86247.5,958.625,90.4375
"14924","45030","2019",27,27,0,117698.148148148,1233.44444444444,91.3703703703704
"14925","45031","2019",20,19,1,103268.75,1284.95,85.15
"14926","45032","2019",7,7,0,104642.857142857,1134.28571428571,95.1428571428571
"14927","45033","2019",12,12,0,168579.166666667,1526.08333333333,119.416666666667
"14928","45034","2019",18,18,0,200019.722222222,1936.88888888889,107.055555555556
"14929","45035","2019",14,13,1,98330,1318.71428571429,81.2857142857143
"14930","45036","2019",7,7,0,108962.142857143,1097.14285714286,100.428571428571
"14931","45037","2019",8,8,0,169805.625,1872,97
"14932","45038","2019",6,6,0,151833.333333333,1493,103.5
"14933","45039","2019",10,10,0,133300.1,1327,105.5
"14934","45040","2019",25,24,1,109240,1107.56,100.88
"14935","45041","2019",3,3,0,114316.666666667,984.666666666667,133.333333333333
"14936","45042","2019",15,15,0,119015.333333333,1492.73333333333,85.4666666666667
"14937","45043","2019",16,15,1,204400,1872.125,114.0625
"14938","45044","2019",2,2,0,220500,1961.5,112
"14939","45045","2019",5,5,0,153800,1429.2,120.2
"14940","45046","2019",5,4,1,185580,1851,96.6
"14941","45047","2019",3,3,0,134400,1291,100
"14942","45049","2019",18,18,0,177170.111111111,1636.72222222222,112.777777777778
"14943","45050","2019",17,17,0,124697.058823529,1250.94117647059,110.411764705882
"14944","45051","2019",24,24,0,137372.916666667,1441.45833333333,95.2083333333333
"14945","45052","2019",1,1,0,275000,3929,70
"14946","45053","2019",58,57,1,115504.137931034,1320.03448275862,89.7586206896552
"14947","45054","2019",7,7,0,156721.428571429,1602.57142857143,98.8571428571429
"14948","45055","2019",4,4,0,160875,1615.25,95.25
"14949","45056","2019",5,5,0,137140,1178.4,116.2
"14950","45058","2019",1,1,0,180000,2169,83
"14951","45059","2019",1,1,0,220870,2254,98
"14952","45060","2019",6,6,0,131700,1446,92
"14953","45061","2019",34,34,0,108110.294117647,1387.47058823529,83.3529411764706
"14954","45062","2019",25,22,3,195929.6,1930.6,111.24
"14955","45063","2019",11,11,0,91819.0909090909,1462,67.7272727272727
"14956","45064","2019",9,9,0,98544.4444444444,1052.11111111111,99.1111111111111
"14957","45065","2019",3,2,1,158333.333333333,1393,113
"14958","45066","2019",13,13,0,109269.230769231,1534.69230769231,77.6153846153846
"14959","45067","2019",46,45,1,206822.152173913,1858.15217391304,110.130434782609
"14960","45068","2019",114,103,11,98618.1754385965,1371.70175438596,74.0701754385965
"14961","45069","2019",13,13,0,162346.153846154,1500,109.846153846154
"14962","45070","2019",1,1,0,30000,682,44
"14963","45072","2019",14,8,6,189758.571428571,1845.64285714286,105.428571428571
"14964","45073","2019",10,9,1,162023,1428.8,113.3
"14965","45075","2019",132,87,45,166397.143939394,1791.64393939394,93.4015151515152
"14966","45076","2019",3,3,0,104333.333333333,1442,68
"14967","45077","2019",12,12,0,117406.5,1479.25,84.4166666666667
"14968","45078","2019",1,1,0,279650,1032,271
"14969","45079","2019",3,3,0,85000,908.666666666667,96
"14970","45080","2019",7,7,0,182650,1332,149.285714285714
"14971","45081","2019",9,9,0,115166.666666667,1118.88888888889,100.444444444444
"14972","45082","2019",112,88,24,151807.464285714,1687.07142857143,93.0357142857143
"14973","45083","2019",27,26,1,97221.4814814815,1080.62962962963,92.2222222222222
"14974","45084","2019",4,4,0,141250,1389.5,98.75
"14975","45085","2019",40,40,0,97878.05,1045.875,92.775
"14976","45086","2019",4,4,0,105250,1269.25,84.75
"14977","45087","2019",44,41,3,92952.2727272727,1110.97727272727,84.9545454545455
"14978","45088","2019",3,3,0,125666.666666667,1330.33333333333,96.3333333333333
"14979","45089","2019",130,109,21,189586.446153846,2006.87692307692,95.1307692307692
"14980","45091","2019",3,3,0,178316.666666667,1278.66666666667,133.666666666667
"14981","45092","2019",24,24,0,169514.583333333,1829.5,100.25
"14982","45093","2019",28,27,1,161230.357142857,1746.92857142857,99.5
"14983","45094","2019",3,3,0,134000,1673.33333333333,85.3333333333333
"14984","45095","2019",29,28,1,148527.586206897,1493,103.551724137931
"14985","45096","2019",12,12,0,106358.333333333,1299.75,82.8333333333333
"14986","45097","2019",16,16,0,109483.9375,1098.5625,109.1875
"14987","45098","2019",41,41,0,199317.56097561,1853.75609756098,109.634146341463
"14988","45099","2019",6,6,0,153683.333333333,1574.5,94.8333333333333
"14989","45100","2019",9,9,0,295622.222222222,2107.44444444444,146.333333333333
"14990","45101","2019",4,4,0,154900,1689,104.25
"14991","45102","2019",5,5,0,239056,1631.4,151.4
"14992","45103","2019",13,13,0,106019.230769231,1325,80.7692307692308
"14993","45104","2019",29,29,0,132863.793103448,1539.10344827586,90.2068965517241
"14994","45105","2019",1,1,0,321000,2126,151
"14995","45108","2019",22,22,0,113619.090909091,1299.27272727273,88.7272727272727
"14996","45109","2019",6,6,0,163041.666666667,1535.33333333333,114.5
"14997","45110","2019",4,4,0,92250,1004,102.5
"14998","45111","2019",3,3,0,179833.333333333,1732.33333333333,112.666666666667
"14999","45112","2019",3,3,0,225000,1959.33333333333,110
"15000","45113","2019",5,5,0,91562.2,813.2,124.4
"15001","45114","2019",1,1,0,278150,927,300
"15002","45115","2019",73,72,1,128950.547945205,1392.31506849315,95.4794520547945
"15003","45116","2019",6,6,0,131333.333333333,1122.83333333333,117
"15004","45118","2019",3,3,0,172266.666666667,1668,104
"15005","45119","2019",35,35,0,163029.714285714,1632.88571428571,104.657142857143
"15006","45120","2019",2,2,0,71500,957,90.5
"15007","45121","2019",13,13,0,94092.3076923077,1001.92307692308,91.5384615384615
"15008","45122","2019",15,15,0,123744.333333333,1390.6,92.6
"15009","45123","2019",30,30,0,186318.2,2044.43333333333,97.0666666666667
"15010","45124","2019",2,2,0,174500,1059,141.5
"15011","45125","2019",1,1,0,85123,608,140
"15012","45126","2019",13,13,0,228784.615384615,1809.61538461538,136.615384615385
"15013","45127","2019",43,42,1,146493.906976744,1572.90697674419,94.8139534883721
"15014","45129","2019",21,21,0,102195.238095238,1227.80952380952,89.0476190476191
"15015","45130","2019",14,14,0,180555.142857143,1491.14285714286,124.785714285714
"15016","45131","2019",10,10,0,157866.6,1372.9,122
"15017","45132","2019",4,4,0,145015,1380,112
"15018","45133","2019",7,7,0,147142.857142857,1508.85714285714,104.714285714286
"15019","45134","2019",24,24,0,130064.583333333,1490.54166666667,91.375
"15020","45135","2019",7,7,0,177566.714285714,1680.14285714286,108.714285714286
"15021","45136","2019",17,17,0,118735.294117647,1404.35294117647,87
"15022","45137","2019",9,9,0,121722.222222222,1280.33333333333,110.111111111111
"15023","45139","2019",10,10,0,170562,1505.5,123.7
"15024","45141","2019",1,1,0,116000,1064,109
"15025","45142","2019",58,56,2,173714.051724138,1834.41379310345,100.603448275862
"15026","45144","2019",13,13,0,189430.769230769,1902,103.230769230769
"15027","45145","2019",56,53,3,137545.178571429,1530.08928571429,92.0357142857143
"15028","45146","2019",112,106,6,175497.875,1827.4375,98.0089285714286
"15029","45147","2019",303,185,118,154955.825082508,1873.84818481848,83.006600660066
"15030","45148","2019",23,23,0,131972.173913043,1434.04347826087,100.652173913043
"15031","45149","2019",5,5,0,99200,1272,84.2
"15032","45150","2019",3,3,0,186000,1824,120.333333333333
"15033","45151","2019",7,7,0,121421.428571429,1274.57142857143,92.2857142857143
"15034","45152","2019",3,3,0,180000,1354.66666666667,135.333333333333
"15035","45153","2019",5,5,0,232160,1737.8,134.4
"15036","45154","2019",19,19,0,222474.736842105,1990.26315789474,114.263157894737
"15037","45155","2019",157,102,55,94766.8152866242,1137.71974522293,83.7324840764331
"15038","45156","2019",4,4,0,126387.5,1090,115.25
"15039","45157","2019",7,7,0,135551.428571429,1449.14285714286,97.5714285714286
"15040","45158","2019",4,4,0,135250,1387.75,103.5
"15041","45159","2019",4,4,0,156500,1466.5,111.25
"15042","45160","2019",7,7,0,134500,1454.42857142857,97.2857142857143
"15043","45161","2019",8,8,0,186732.5,1556.25,120.125
"15044","45162","2019",7,7,0,190988.571428571,2077.42857142857,103.142857142857
"15045","45164","2019",5,5,0,119769,1335.4,96.4
"15046","45165","2019",8,8,0,180989.625,2291.75,84.25
"15047","45166","2019",1,1,0,175000,2011,87
"15048","45167","2019",27,27,0,164055.555555556,1675.66666666667,103.111111111111
"15049","45168","2019",9,9,0,176277.777777778,1719.88888888889,107.444444444444
"15050","45169","2019",90,83,7,195040.433333333,2156.36666666667,94.8111111111111
"15051","45171","2019",8,8,0,104900,990,112.625
"15052","45173","2019",52,45,7,171147.480769231,1798.73076923077,99.5
"15053","45174","2019",1,1,0,65000,1204,54
"15054","45175","2019",14,14,0,257300,2124.28571428571,133.5
"15055","45176","2019",6,6,0,120850,1008.83333333333,123.666666666667
"15056","45177","2019",3,3,0,128789.666666667,1171.66666666667,122.666666666667
"15057","45178","2019",17,17,0,134929.411764706,1241.58823529412,108.058823529412
"15058","45179","2019",40,39,1,166054.5,1653.225,103.725
"15059","45180","2019",1,1,0,86400,807,107
"15060","45181","2019",1,1,0,126000,1400,90
"15061","45182","2019",14,14,0,167365.785714286,1654.5,102.428571428571
"15062","45183","2019",3,3,0,167866.666666667,1383,128.333333333333
"15063","45184","2019",8,8,0,177375,3115.875,71
"15064","45185","2019",1,1,0,150000,1685,89
"15065","45186","2019",5,5,0,85700,1411.2,64
"15066","45187","2019",46,46,0,108417.934782609,1283.45652173913,89.0869565217391
"15067","45188","2019",24,24,0,181110.416666667,1853.375,98.125
"15068","45189","2019",4,4,0,149375,1405,116.5
"15069","45191","2019",109,87,22,150989.688073394,1733.84403669725,90.1009174311927
"15070","45193","2019",26,25,1,193510.461538462,2015.53846153846,101
"15071","45194","2019",34,34,0,217591.588235294,2146.91176470588,104.676470588235
"15072","45195","2019",8,8,0,140012.5,1355.625,103.75
"15073","45196","2019",8,6,2,163300,1517.875,105.875
"15074","45197","2019",16,16,0,234273.125,2115.4375,114.5
"15075","45198","2019",5,5,0,163700,1827.2,88.2
"15076","45199","2019",8,8,0,88987.5,1397.125,64.5
"15077","45200","2019",19,19,0,219063.526315789,1983.31578947368,110.894736842105
"15078","45201","2019",4,4,0,140250,1367.25,104.25
"15079","45202","2019",12,11,1,162958.333333333,1477.58333333333,114.166666666667
"15080","45203","2019",85,76,9,165249.741176471,1758.23529411765,95.6823529411765
"15081","45204","2019",6,6,0,234133.333333333,1606.16666666667,150.666666666667
"15082","45205","2019",2,2,0,95000,572,164.5
"15083","45206","2019",3,3,0,98666.6666666667,1372.33333333333,74.3333333333333
"15084","45207","2019",8,8,0,137387.5,1614.375,92.75
"15085","45208","2019",254,96,158,98235.7204724409,1381.3937007874,73.8346456692913
"15086","45209","2019",5,5,0,110798,1006.2,108.2
"15087","45210","2019",18,18,0,109261.111111111,1068.38888888889,107.333333333333
"15088","45212","2019",21,21,0,129853.80952381,1444.09523809524,89.9047619047619
"15089","45213","2019",7,7,0,123714.285714286,1266.85714285714,98
"15090","45214","2019",8,8,0,145100,1393.25,103
"15091","45215","2019",3,3,0,134333.333333333,955,138.666666666667
"15092","45217","2019",2,2,0,152500,1323.5,118
"15093","45219","2019",5,5,0,123660,1028,124
"15094","45220","2019",8,8,0,110225,1300.5,95.25
"15095","45222","2019",22,22,0,138152.272727273,1416.5,99.7272727272727
"15096","45223","2019",5,5,0,169450,1489,107.6
"15097","45224","2019",55,49,6,160351.2,1563.67272727273,107.163636363636
"15098","45225","2019",8,8,0,121500,1353.5,82.75
"15099","45226","2019",27,27,0,143342.814814815,1661.37037037037,82.037037037037
"15100","45227","2019",15,15,0,129751,1160.06666666667,121.6
"15101","45228","2019",16,16,0,214044.6875,1951.8125,117.25
"15102","45229","2019",36,36,0,96267.9722222222,1269.08333333333,79.3055555555556
"15103","45230","2019",15,15,0,131336.666666667,1264.13333333333,102.733333333333
"15104","45231","2019",3,3,0,161666.666666667,2218,76.6666666666667
"15105","45232","2019",321,161,160,192216.028037383,2233.28660436137,85.9968847352025
"15106","45233","2019",2,2,0,172500,1469,117.5
"15107","45234","2019",2129,503,1626,147551.49084077,2186.45138562706,68.6496007515265
"15108","45235","2019",39,38,1,234405.41025641,2169.46153846154,110.025641025641
"15109","45237","2019",2,2,0,222285,2853.5,78
"15110","45238","2019",9,9,0,148745.666666667,1127.22222222222,126
"15111","45239","2019",9,9,0,155383.333333333,1567.55555555556,101
"15112","45240","2019",23,23,0,146580.434782609,1489.04347826087,104.086956521739
"15113","45241","2019",13,13,0,144659.230769231,1299.92307692308,116.153846153846
"15114","45242","2019",2,2,0,90000,1008.5,87.5
"15115","45243","2019",2,2,0,131465,930.5,144
"15116","45244","2019",44,43,1,125897.068181818,1394.63636363636,97.0454545454545
"15117","45245","2019",11,11,0,123372.727272727,1159.63636363636,119
"15118","45247","2019",42,42,0,140981.30952381,1462.7619047619,98.9523809523809
"15119","45248","2019",29,29,0,142151.655172414,1346.96551724138,115.48275862069
"15120","45249","2019",10,10,0,184665,1351.5,150.7
"15121","45250","2019",2,2,0,121000,1003.5,120
"15122","45251","2019",10,10,0,77087,957.8,86.1
"15123","45252","2019",67,44,23,106460.28358209,1422.44776119403,76.4179104477612
"15124","45253","2019",16,16,0,158731.25,1546.4375,104.75
"15125","45254","2019",32,32,0,103821.65625,1156.40625,89
"15126","45255","2019",3,3,0,62333.3333333333,845.333333333333,82.6666666666667
"15127","45256","2019",4,4,0,174455,1470,125.5
"15128","45257","2019",6,6,0,95216.6666666667,1140,88.5
"15129","45258","2019",43,42,1,127336.511627907,1675.83720930233,87.4883720930233
"15130","45259","2019",15,15,0,148926.666666667,1357.4,106.2
"15131","45260","2019",4,4,0,146725,1459.5,117.25
"15132","45261","2019",19,19,0,202293.421052632,1680.10526315789,122.894736842105
"15133","45262","2019",1,1,0,60000,769,78
"15134","45263","2019",5,4,1,194217,2132.4,92.8
"15135","45264","2019",5,5,0,232300,1938.6,120.4
"15136","45265","2019",6,6,0,93833.3333333333,1436.5,73.3333333333333
"15137","45266","2019",3,3,0,151000,1259.33333333333,118.666666666667
"15138","45268","2019",9,9,0,116107.444444444,1528.22222222222,79.7777777777778
"15139","45269","2019",53,52,1,195444.943396226,1934.15094339623,104.924528301887
"15140","45270","2019",27,26,1,168788.037037037,1689.59259259259,105.925925925926
"15141","45271","2019",17,17,0,114108.823529412,1116.52941176471,100.470588235294
"15142","45272","2019",28,27,1,256311.071428571,2363.03571428571,112.392857142857
"15143","45273","2019",41,36,5,145468.780487805,1638.41463414634,94.4146341463415
"15144","45274","2019",78,71,7,264710.051282051,2437.20512820513,110.448717948718
"15145","45275","2019",12,12,0,130392.5,1509.25,91.8333333333333
"15146","45276","2019",8,8,0,82912.5,1181,66.125
"15147","45277","2019",9,9,0,115777.777777778,1418.44444444444,86.2222222222222
"15148","45278","2019",13,13,0,126964.615384615,1171.53846153846,100.538461538462
"15149","45279","2019",31,31,0,113526.290322581,1261.74193548387,95.7741935483871
"15150","45280","2019",17,17,0,151107.647058824,1337.64705882353,110.058823529412
"15151","45281","2019",22,22,0,105590,1265.09090909091,85.5
"15152","45282","2019",45,38,7,213665.622222222,2220.6,99
"15153","45283","2019",2,2,0,186500,1528.5,118.5
"15154","45284","2019",303,135,168,157917.161716172,1945.85148514851,80.8250825082508
"15155","45285","2019",207,127,80,143591.647342995,1858.2077294686,77.3188405797101
"15156","45286","2019",141,67,74,173987.865248227,2024.87234042553,85.4184397163121
"15157","45288","2019",3,3,0,132666.666666667,1444,92.3333333333333
"15158","45289","2019",26,26,0,182288.461538462,1801.15384615385,106.269230769231
"15159","45290","2019",22,22,0,171949.318181818,1674.31818181818,104.681818181818
"15160","45291","2019",14,14,0,128375,1316.71428571429,102.714285714286
"15161","45292","2019",10,10,0,166495,1319.9,113
"15162","45293","2019",15,15,0,168456.666666667,1639.93333333333,98.5333333333333
"15163","45294","2019",3,3,0,205333.333333333,1930,105.333333333333
"15164","45296","2019",10,10,0,190825,1937.3,102
"15165","45297","2019",9,8,1,138125.555555556,2229.88888888889,75.1111111111111
"15166","45298","2019",60,53,7,238984.1,2459.56666666667,100.033333333333
"15167","45299","2019",3,3,0,135333.333333333,1282.66666666667,112.666666666667
"15168","45300","2019",47,46,1,222731.70212766,2093.74468085106,108.276595744681
"15169","45301","2019",11,11,0,152065.454545455,1382.54545454545,108
"15170","45302","2019",173,131,42,172573.369942197,1980.67630057803,88.9075144508671
"15171","45303","2019",9,9,0,162000,1154.77777777778,139
"15172","45305","2019",1,1,0,106390,2086,51
"15173","45306","2019",11,11,0,143703.636363636,1384.27272727273,109.454545454545
"15174","45307","2019",17,17,0,138554.117647059,1312.70588235294,117.823529411765
"15175","45308","2019",30,30,0,221381.5,2141.06666666667,108.533333333333
"15176","45309","2019",7,7,0,165523.571428571,1437.57142857143,125.571428571429
"15177","45310","2019",21,21,0,138510.952380952,1506.61904761905,98.2380952380952
"15178","45311","2019",13,13,0,218419.230769231,1721.92307692308,130.230769230769
"15179","45312","2019",8,8,0,159675.75,1219,126.625
"15180","45313","2019",7,7,0,158985.714285714,1547.85714285714,106.571428571429
"15181","45314","2019",7,7,0,151269.714285714,1416.14285714286,106
"15182","45315","2019",57,55,2,125080.701754386,1407.94736842105,93.719298245614
"15183","45316","2019",11,11,0,142716.454545455,1673.54545454545,88
"15184","45317","2019",13,12,1,180931.923076923,1624.53846153846,110
"15185","45320","2019",5,5,0,149780,1451.6,107.6
"15186","45321","2019",6,6,0,114500,1447.83333333333,79
"15187","45322","2019",3,3,0,141000,1392.66666666667,98
"15188","45323","2019",7,7,0,73785.7142857143,810,91.2857142857143
"15189","45324","2019",26,26,0,192405,1638.03846153846,119.538461538462
"15190","45325","2019",7,7,0,125150,1099.28571428571,120.142857142857
"15191","45326","2019",4,4,0,178250,1320.5,146.75
"15192","45327","2019",37,37,0,215968.648648649,1876.64864864865,120.405405405405
"15193","45328","2019",5,5,0,160800,1609.2,103.4
"15194","45329","2019",27,27,0,91151.9259259259,1096.92592592593,85.2962962962963
"15195","45330","2019",4,4,0,150000,1479.75,125.25
"15196","45331","2019",13,13,0,184853.461538462,1765.30769230769,118
"15197","45332","2019",26,26,0,140429.230769231,1428.11538461538,103.653846153846
"15198","45333","2019",19,18,1,205142,1844.89473684211,114.789473684211
"15199","45334","2019",9,9,0,125360,1106.88888888889,112.777777777778
"15200","45335","2019",15,15,0,169613.333333333,1559.73333333333,112.6
"15201","45336","2019",14,14,0,134514.285714286,1433.28571428571,95.7857142857143
"15202","45337","2019",6,6,0,118668.333333333,1182,99.5
"15203","45338","2019",3,3,0,139666.666666667,1356.33333333333,111
"15204","45339","2019",6,6,0,166166.666666667,1714.83333333333,101
"15205","45340","2019",3,3,0,193333.333333333,1374,139.333333333333
"15206","45341","2019",2,2,0,102500,994.5,99
"15207","45342","2019",8,8,0,156537.5,1470,109.125
"15208","45343","2019",2,2,0,103150,1031,98.5
"15209","45344","2019",14,13,1,145778.571428571,1521.64285714286,97.8571428571429
"15210","45345","2019",13,13,0,156455,1353.61538461538,112.538461538462
"15211","45346","2019",31,29,2,144075.806451613,1623.22580645161,90.0967741935484
"15212","45347","2019",8,8,0,139886.875,1554.75,90.25
"15213","45348","2019",7,6,1,154428.571428571,1425.57142857143,108.714285714286
"15214","46001","2019",7,7,0,126445.714285714,1385.14285714286,87.5714285714286
"15215","46002","2019",1,1,0,255000,2742,93
"15216","46003","2019",9,9,0,111317.888888889,1281.88888888889,88.2222222222222
"15217","46004","2019",2,2,0,100800,2195.5,57.5
"15218","46005","2019",4,4,0,123500,1043.25,124.5
"15219","46006","2019",4,4,0,221568.75,2017,109.25
"15220","46007","2019",16,16,0,132612.1875,1288.5,102.0625
"15221","46008","2019",6,6,0,165116.666666667,1224,121
"15222","46009","2019",4,4,0,116750,1304.5,97.5
"15223","46010","2019",1,1,0,180000,923,195
"15224","46011","2019",4,4,0,76125,1132,67
"15225","46012","2019",12,12,0,128981.166666667,1296.33333333333,96.9166666666667
"15226","46013","2019",2,2,0,215630,1617,137
"15227","46015","2019",15,15,0,106333.333333333,993.533333333333,109.133333333333
"15228","46016","2019",6,5,1,146416.666666667,1559.83333333333,98.6666666666667
"15229","46017","2019",1,1,0,97000,882,110
"15230","46018","2019",6,6,0,136604.5,1241,117.833333333333
"15231","46021","2019",9,8,1,155288.888888889,1703,103.222222222222
"15232","46022","2019",4,4,0,243025,2024.5,113.75
"15233","46023","2019",3,3,0,272333.333333333,1839,147
"15234","46024","2019",3,3,0,101666.666666667,1388.33333333333,71.3333333333333
"15235","46026","2019",5,5,0,138700,1944.8,80.2
"15236","46027","2019",1,1,0,120450,1204,100
"15237","46028","2019",18,18,0,128902.777777778,1345.44444444444,94.8888888888889
"15238","46029","2019",14,14,0,103985.714285714,1242.14285714286,86.9285714285714
"15239","46030","2019",10,10,0,147150,1397.1,110.1
"15240","46031","2019",2,2,0,180500,1933.5,85
"15241","46032","2019",6,6,0,167674.166666667,1472.5,109.5
"15242","46033","2019",4,4,0,113250,1373.75,82.75
"15243","46034","2019",4,3,1,191525,2380.25,94.5
"15244","46035","2019",7,7,0,179214.285714286,1545,113.857142857143
"15245","46037","2019",2,2,0,131000,1449.5,98
"15246","46038","2019",9,8,1,133472.222222222,1393.77777777778,107.777777777778
"15247","46040","2019",4,3,1,143500,1440.75,121.25
"15248","46041","2019",2,2,0,85000,948.5,86
"15249","46042","2019",328,166,162,109031.411585366,1391.7987804878,78.3841463414634
"15250","46044","2019",8,7,1,117690,1213.875,98.75
"15251","46045","2019",22,22,0,143544.409090909,1563.31818181818,97.1818181818182
"15252","46046","2019",5,5,0,115320,1291.2,89.4
"15253","46047","2019",5,5,0,151610,1464.4,115
"15254","46049","2019",5,5,0,196420,1503.2,126.8
"15255","46050","2019",2,2,0,214000,1897.5,106.5
"15256","46051","2019",6,6,0,164083.333333333,1677.16666666667,96
"15257","46052","2019",2,2,0,119490,1478,96
"15258","46053","2019",4,4,0,126750,1208.75,107.25
"15259","46054","2019",7,7,0,143414.285714286,1697.57142857143,84.5714285714286
"15260","46055","2019",15,15,0,122202.666666667,1417.06666666667,83.1333333333333
"15261","46056","2019",2,2,0,220750,1578,147
"15262","46057","2019",19,19,0,124953.947368421,1411.36842105263,85.3684210526316
"15263","46058","2019",14,14,0,109641.428571429,1396,81.0714285714286
"15264","46060","2019",2,2,0,178250,1559.5,114.5
"15265","46061","2019",2,2,0,253254.5,2393.5,99.5
"15266","46062","2019",8,8,0,154075.875,1468.5,113
"15267","46063","2019",14,13,1,158649.285714286,1488.78571428571,103.785714285714
"15268","46064","2019",12,9,3,99310,925.916666666667,103
"15269","46065","2019",5,5,0,199855,1433.6,140.6
"15270","46066","2019",15,15,0,138336.933333333,1546.66666666667,91.3333333333333
"15271","46068","2019",3,3,0,119000,1796.66666666667,72.3333333333333
"15272","46069","2019",1,1,0,80000,1176,68
"15273","46070","2019",12,12,0,150285.833333333,1498.58333333333,102.583333333333
"15274","46072","2019",5,5,0,170934,1346.8,128.2
"15275","46073","2019",6,6,0,125633.333333333,1247,99.8333333333333
"15276","46074","2019",5,5,0,181440,2241.4,94.2
"15277","46075","2019",4,4,0,183500,1654.25,110.75
"15278","46076","2019",3,3,0,203200,1849.33333333333,128
"15279","46078","2019",2,2,0,125300,2170.5,65
"15280","46079","2019",1,1,0,172000,1720,100
"15281","46080","2019",12,12,0,139595,1310,106
"15282","46081","2019",1,1,0,150000,1402,107
"15283","46082","2019",5,5,0,162850,1539,118.2
"15284","46083","2019",9,8,1,139233.333333333,1449.88888888889,113.222222222222
"15285","46084","2019",3,3,0,77011.3333333333,1185.66666666667,66
"15286","46085","2019",6,6,0,125575,1585.5,101.5
"15287","46086","2019",9,9,0,214555.555555556,1999,117.111111111111
"15288","46087","2019",5,5,0,257264,1640,140.2
"15289","46088","2019",14,13,1,140072.142857143,1288.35714285714,110.928571428571
"15290","46089","2019",15,15,0,125710,1442.86666666667,84.3333333333333
"15291","46090","2019",1,1,0,15000,429,35
"15292","46091","2019",1,1,0,173500,1446,120
"15293","46092","2019",6,6,0,176152.666666667,1766.66666666667,102
"15294","46093","2019",4,4,0,103875,1727,64.25
"15295","46094","2019",5,5,0,153357,2404,70.4
"15296","46095","2019",9,9,0,130567.555555556,1555.88888888889,84.5555555555556
"15297","46096","2019",1,1,0,208500,1448,144
"15298","46097","2019",1,1,0,48500,591,82
"15299","46098","2019",6,6,0,159816.666666667,2002.66666666667,82.5
"15300","46100","2019",12,12,0,174406.833333333,1557,107.666666666667
"15301","46101","2019",6,6,0,101599.166666667,1398.83333333333,77.6666666666667
"15302","46102","2019",154,95,59,120798.032467532,1461.28571428571,84.4675324675325
"15303","46103","2019",13,13,0,251923.615384615,1630.92307692308,142.846153846154
"15304","46104","2019",2,2,0,106575,1982,52
"15305","46105","2019",3,3,0,210000,1701.66666666667,120
"15306","46106","2019",5,5,0,65220,1206.2,52.2
"15307","46107","2019",4,4,0,197382.5,2679,74.5
"15308","46108","2019",4,4,0,170750,1163.5,139.75
"15309","46109","2019",7,7,0,164890,1409.14285714286,123.428571428571
"15310","46111","2019",3,3,0,232333.333333333,2394.66666666667,106
"15311","46112","2019",1,1,0,85000,472,180
"15312","46113","2019",8,8,0,93187.5,1526.375,81.375
"15313","46114","2019",9,8,1,205075.888888889,1435.55555555556,151.222222222222
"15314","46115","2019",3,3,0,150000,1558,101.333333333333
"15315","46116","2019",1,1,0,108150,1931,56
"15316","46117","2019",9,9,0,125365.555555556,1554.44444444444,81.6666666666667
"15317","46118","2019",7,7,0,143214.285714286,1416.28571428571,105.142857142857
"15318","46119","2019",5,5,0,152401.6,1463,109.6
"15319","46120","2019",4,4,0,89250,1195.25,82.25
"15320","46121","2019",4,4,0,158067.5,1694.25,90.5
"15321","46122","2019",1,1,0,261750,2337,112
"15322","46123","2019",2,2,0,144500,1404,103
"15323","46124","2019",1,1,0,140000,1167,120
"15324","46125","2019",3,3,0,41666.6666666667,809.333333333333,63
"15325","46126","2019",3,3,0,179166.666666667,2004.66666666667,140.333333333333
"15326","46127","2019",58,51,7,125579.534482759,1373.34482758621,91.7413793103448
"15327","46128","2019",41,37,4,122415.219512195,1357.46341463415,90.5121951219512
"15328","46129","2019",6,6,0,135033.333333333,1316.66666666667,113.833333333333
"15329","46130","2019",2,2,0,164000,1247,100.5
"15330","46131","2019",2,2,0,140650,1025,129.5
"15331","46132","2019",4,4,0,144375,1515.25,95
"15332","46133","2019",2,2,0,140750,1562.5,91
"15333","46134","2019",6,6,0,146026.666666667,1443.33333333333,105
"15334","46135","2019",1,1,0,143000,1192,120
"15335","46136","2019",3,3,0,179760,1552,117.333333333333
"15336","46137","2019",8,7,1,180120.125,1877.25,93.625
"15337","46138","2019",17,16,1,132151.470588235,1272.29411764706,111.294117647059
"15338","46140","2019",4,4,0,233912.5,1583,154.5
"15339","46142","2019",1,1,0,113000,1177,96
"15340","46143","2019",12,12,0,112004.583333333,1193.33333333333,99.25
"15341","46144","2019",3,3,0,154166.666666667,1852.66666666667,85.6666666666667
"15342","46145","2019",15,15,0,132606.533333333,1440.93333333333,89.3333333333333
"15343","46146","2019",4,4,0,73330.5,1191.5,60
"15344","46147","2019",2,2,0,179500,2344.5,83
"15345","46148","2019",23,23,0,200745,1668.34782608696,118.130434782609
"15346","46149","2019",9,9,0,141261.111111111,1295.33333333333,109.888888888889
"15347","46152","2019",5,5,0,157800,1779.2,80.8
"15348","46153","2019",4,4,0,193725,1784,111.75
"15349","46154","2019",6,6,0,143623.333333333,1358.16666666667,108.166666666667
"15350","46155","2019",3,3,0,111000,2164.33333333333,60.6666666666667
"15351","46156","2019",17,17,0,151250,1229.35294117647,117.705882352941
"15352","46157","2019",2,2,0,176575,1770.5,101
"15353","46159","2019",5,5,0,90932,1068.2,84.8
"15354","46160","2019",4,3,1,66800,738.25,86
"15355","46161","2019",2,2,0,95250,714.5,142.5
"15356","46162","2019",4,4,0,101716,957,113
"15357","46163","2019",5,5,0,60260,863,75
"15358","46164","2019",4,4,0,211475,1771,121.5
"15359","46165","2019",4,4,0,129250,1046.5,120.5
"15360","46167","2019",4,4,0,121000,1000.25,126.25
"15361","46168","2019",3,3,0,90833.3333333333,1029.66666666667,89
"15362","46169","2019",2,2,0,261140,2251,135
"15363","46170","2019",5,5,0,86569.2,1011.2,89
"15364","46171","2019",1,1,0,352381,2175,162
"15365","46172","2019",4,4,0,110550,1169.25,92.5
"15366","46173","2019",18,18,0,135888.888888889,1312.77777777778,108.222222222222
"15367","46174","2019",7,7,0,139928.571428571,1645.71428571429,85.8571428571429
"15368","46175","2019",10,10,0,151700,1507.2,116.2
"15369","46176","2019",11,10,1,121932.727272727,1531.90909090909,82.3636363636364
"15370","46177","2019",8,8,0,135062.5,1408.125,103.125
"15371","46178","2019",2,2,0,149725,1242,119.5
"15372","46179","2019",5,5,0,165500,1499,119.8
"15373","46180","2019",7,7,0,207000,1894.42857142857,110.857142857143
"15374","46181","2019",3,3,0,119333.333333333,1123.66666666667,104.333333333333
"15375","46182","2019",27,27,0,139749.888888889,1428.62962962963,97.8148148148148
"15376","46183","2019",5,5,0,142084,1710.6,87.8
"15377","46184","2019",4,4,0,152762.5,713.25,183.75
"15378","46185","2019",16,14,2,163853.125,1765.6875,99.75
"15379","46186","2019",3,3,0,171800,1777,101.333333333333
"15380","46187","2019",9,9,0,131077.777777778,1121.11111111111,119.888888888889
"15381","46188","2019",2,2,0,78500,933,94
"15382","46189","2019",6,6,0,122075,1337.5,98.3333333333333
"15383","46190","2019",4,4,0,200637.5,1546,125.25
"15384","46191","2019",5,5,0,128200,1497.4,90.4
"15385","46192","2019",6,6,0,117907.833333333,1305.83333333333,95.8333333333333
"15386","46193","2019",3,3,0,112666.666666667,1154,114.666666666667
"15387","46194","2019",5,5,0,176025,1486.2,117.6
"15388","46195","2019",1,1,0,96740,864,112
"15389","46196","2019",2,2,0,146000,1524,96.5
"15390","46197","2019",5,5,0,262378.4,2490.8,116.2
"15391","46198","2019",2,2,0,133500,1793,61.5
"15392","46199","2019",5,5,0,204230,1501.4,130.6
"15393","46200","2019",4,4,0,84596.25,1354.5,69.5
"15394","46201","2019",30,29,1,147633.866666667,1535.96666666667,99.7333333333333
"15395","46202","2019",3,3,0,141860,1519.33333333333,91.3333333333333
"15396","46203","2019",1,1,0,180000,2022,89
"15397","46204","2019",5,5,0,149718,1065.8,139.2
"15398","46205","2019",9,9,0,134221.111111111,1393,95.1111111111111
"15399","46206","2019",1,1,0,112700,1238,91
"15400","46207","2019",1,1,0,215000,1536,140
"15401","46208","2019",4,4,0,62875,1224.5,52
"15402","46209","2019",7,7,0,195985.714285714,1911.42857142857,106.857142857143
"15403","46210","2019",3,3,0,116877.333333333,1662.66666666667,70.6666666666667
"15404","46211","2019",3,3,0,159656.666666667,1417,99
"15405","46212","2019",2,2,0,77575,909,84.5
"15406","46213","2019",4,4,0,198450,3171.75,86.5
"15407","46214","2019",2,2,0,120000,1301,107.5
"15408","46215","2019",6,6,0,112333.333333333,1138.5,98.8333333333333
"15409","46216","2019",4,4,0,195750,1508.25,132
"15410","46218","2019",1,1,0,65000,1048,62
"15411","46219","2019",5,5,0,197952,1996.2,99.2
"15412","46220","2019",13,13,0,195901.153846154,1915.92307692308,110.307692307692
"15413","46221","2019",7,7,0,120027.142857143,1360.14285714286,93.4285714285714
"15414","46222","2019",5,5,0,188600,1574,115.8
"15415","46223","2019",2,2,0,87500,1706.5,51
"15416","46224","2019",54,38,16,137642.407407407,1516.61111111111,90.0185185185185
"15417","46225","2019",35,34,1,147982.771428571,1749.74285714286,87.4857142857143
"15418","46226","2019",1,1,0,110000,833,132
"15419","46227","2019",4,4,0,105500,1613.75,65.5
"15420","46228","2019",7,7,0,138950,1472.71428571429,96.8571428571429
"15421","46229","2019",10,10,0,100937.5,1019.2,95.5
"15422","46231","2019",26,26,0,89911.9230769231,1096.69230769231,86.8461538461538
"15423","46232","2019",16,16,0,131562.5,1229.4375,111.6875
"15424","46233","2019",3,3,0,70000,1069,67
"15425","46234","2019",1,1,0,237550,1980,120
"15426","46236","2019",1,1,0,135000,1107,122
"15427","46237","2019",8,8,0,134372.5,1474.75,87.375
"15428","46238","2019",4,4,0,97500,889.75,105.5
"15429","46239","2019",3,3,0,99533.3333333333,1257,74
"15430","46240","2019",7,6,1,172771.428571429,2856.85714285714,98.2857142857143
"15431","46241","2019",3,3,0,168766.666666667,1470,121.333333333333
"15432","46242","2019",2,2,0,121000,1307,93
"15433","46243","2019",5,5,0,134790.4,2005,66.6
"15434","46244","2019",1,1,0,128000,1280,100
"15435","46245","2019",2,2,0,104600,1283,76
"15436","46246","2019",3,3,0,123333.333333333,1783.33333333333,66.3333333333333
"15437","46247","2019",3,3,0,206666.666666667,2229.66666666667,103
"15438","46249","2019",1,1,0,107500,2194,49
"15439","46251","2019",39,36,3,116269.666666667,1239.33333333333,93.3076923076923
"15440","46252","2019",3,3,0,137333.333333333,1614.33333333333,89
"15441","46253","2019",4,4,0,88250,1115.75,73.25
"15442","46255","2019",1,1,0,120000,1319,91
"15443","46256","2019",4,4,0,185037.5,2369.75,78.5
"15444","46257","2019",2,2,0,90000,1547.5,77
"15445","46258","2019",1,1,0,64000,1143,56
"15446","46259","2019",2,2,0,115500,1555.5,76
"15447","46260","2019",4,4,0,153607.5,1764.5,85
"15448","46262","2019",6,6,0,242658.333333333,2033.16666666667,126.666666666667
"15449","46263","2019",7,7,0,174985.714285714,1444.42857142857,116.428571428571
"15450","46264","2019",3,3,0,56166.6666666667,1301,57.6666666666667
"15451","46265","2019",8,8,0,233350,2359.5,106.625
"15452","46266","2019",5,5,0,109500,1265.4,90
"15453","46267","2019",10,10,0,127502,1303.2,102
"15454","46268","2019",12,12,0,126807.916666667,1277.16666666667,106.583333333333
"15455","46269","2019",1,1,0,80000,1143,70
"15456","46270","2019",2,2,0,142500,1493.5,91.5
"15457","46271","2019",1,1,0,133000,1873,71
"15458","46272","2019",5,5,0,109280,1654.6,66.6
"15459","46273","2019",5,4,1,123136,1402.4,87
"15460","46276","2019",2,2,0,139000,1742.5,77.5
"15461","46277","2019",1,1,0,90000,900,100
"15462","46280","2019",2,2,0,135750,1491,101
"15463","46281","2019",3,3,0,142166.666666667,1614.66666666667,89.3333333333333
"15464","46283","2019",2,2,0,45510,550,75
"15465","46284","2019",3,2,1,168323.333333333,1504.33333333333,123.333333333333
"15466","46286","2019",2,2,0,119000,956,118.5
"15467","46288","2019",2,2,0,1e+05,1040,92.5
"15468","46289","2019",6,6,0,122233.333333333,1097.16666666667,107.5
"15469","46290","2019",4,4,0,98800,1303.5,81
"15470","46292","2019",2,2,0,243000,1672,145
"15471","46293","2019",12,12,0,130508.333333333,1358.75,99.5833333333333
"15472","46294","2019",2,2,0,120000,2389,64.5
"15473","46295","2019",2,2,0,140850,1496.5,95
"15474","46296","2019",6,6,0,118483.333333333,1421,85.3333333333333
"15475","46297","2019",22,22,0,157575.454545455,1326.45454545455,115.045454545455
"15476","46299","2019",3,3,0,76666.6666666667,1370.33333333333,78
"15477","46301","2019",4,4,0,142500,1353.75,101.75
"15478","46303","2019",1,1,0,75000,1630,46
"15479","46304","2019",1,1,0,90000,1385,65
"15480","46305","2019",4,4,0,203750,2042.5,105
"15481","46306","2019",1,1,0,27200,555,49
"15482","46307","2019",3,3,0,190966.666666667,1481.33333333333,126.333333333333
"15483","46308","2019",6,6,0,125141.666666667,1086.83333333333,115.666666666667
"15484","46309","2019",66,51,15,116777.681818182,1329.57575757576,94.8939393939394
"15485","46310","2019",2,2,0,203050,2309,90
"15486","46311","2019",10,10,0,86594.1,833.8,105.9
"15487","46312","2019",3,3,0,173833.333333333,1521,118.333333333333
"15488","46313","2019",9,9,0,149800,1359.77777777778,116
"15489","46314","2019",2,2,0,50000,1072.5,50.5
"15490","46315","2019",2,2,0,177600,1835,94.5
"15491","46316","2019",2,2,0,63000,682.5,91.5
"15492","46317","2019",7,7,0,106571.428571429,1319.28571428571,84.1428571428571
"15493","46318","2019",3,3,0,85833.3333333333,1151.66666666667,102
"15494","46319","2019",3,3,0,105666.666666667,939.666666666667,107.333333333333
"15495","46320","2019",4,4,0,206500,1818.75,106.5
"15496","46321","2019",3,3,0,139333.333333333,1688.66666666667,102.333333333333
"15497","46322","2019",6,6,0,191641.666666667,1475.5,127.5
"15498","46323","2019",1,1,0,70000,583,120
"15499","46324","2019",1,1,0,30000,375,80
"15500","46328","2019",3,3,0,117320.333333333,1147.33333333333,90.6666666666667
"15501","46329","2019",3,3,0,157666.666666667,1686.33333333333,98
"15502","46330","2019",21,21,0,96604.0476190476,1084.33333333333,86.7619047619048
"15503","46332","2019",2,2,0,174000,1662.5,104.5
"15504","46333","2019",2,2,0,131500,1069,125
"15505","46334","2019",24,24,0,164275,1386.33333333333,115.75
"15506","46335","2019",4,4,0,132437.5,1552.25,92
"15507","46336","2019",4,4,0,275750,2064,123
"15508","46337","2019",3,3,0,319500,2368.66666666667,154.666666666667
"15509","46338","2019",1,1,0,60000,638,94
"15510","46339","2019",4,4,0,151086.25,1321.75,111
"15511","46340","2019",2,2,0,160000,1437.5,121.5
"15512","47001","2019",781,270,511,103293.790012804,1417.69526248399,73.4775928297055
"15513","47003","2019",8,8,0,232016.25,1649.25,145.375
"15514","47004","2019",63,56,7,109706.349206349,1112.07936507937,99.5396825396825
"15515","47005","2019",9,9,0,148311.444444444,1297.22222222222,126.777777777778
"15516","47006","2019",5,5,0,154600,1696.2,94.4
"15517","47007","2019",4,4,0,154160.25,1576.75,107
"15518","47008","2019",2,2,0,214000,1142,190
"15519","47009","2019",4,4,0,174250,988.5,196
"15520","47010","2019",2,2,0,77500,581,140.5
"15521","47011","2019",2,2,0,153500,1534,97
"15522","47012","2019",1,1,0,220000,1667,132
"15523","47013","2019",5,5,0,267460,1759.8,159.2
"15524","47014","2019",2,2,0,103409,1636.5,62.5
"15525","47015","2019",22,20,2,135414.772727273,1326.22727272727,106.409090909091
"15526","47016","2019",12,12,0,211990,1823.33333333333,115.166666666667
"15527","47017","2019",8,8,0,164948.75,1283.25,135.25
"15528","47018","2019",3,3,0,108000,730,136
"15529","47019","2019",10,10,0,154780,1636.8,94.3
"15530","47020","2019",1,1,0,236000,1513,156
"15531","47021","2019",23,23,0,145829.913043478,1434.91304347826,101.391304347826
"15532","47022","2019",4,4,0,162749.25,1624.5,101.75
"15533","47023","2019",7,7,0,163925.714285714,1344.57142857143,120.714285714286
"15534","47024","2019",17,17,0,177508.235294118,1577.70588235294,113.176470588235
"15535","47025","2019",7,7,0,104894.428571429,1001.28571428571,103.428571428571
"15536","47026","2019",8,8,0,183217.75,1771.75,103.125
"15537","47027","2019",46,46,0,131280.456521739,1331.89130434783,99.0869565217391
"15538","47028","2019",6,6,0,137096.833333333,1104,115.166666666667
"15539","47029","2019",9,9,0,101850,1167.88888888889,92.6666666666667
"15540","47030","2019",3,3,0,91333.3333333333,1770.33333333333,60
"15541","47031","2019",75,67,8,154657.213333333,1599.29333333333,97.6133333333333
"15542","47032","2019",75,67,8,173667.533333333,1770.05333333333,101.893333333333
"15543","47033","2019",4,4,0,178380,1420.5,120.5
"15544","47034","2019",5,5,0,117080,1244.6,90
"15545","47035","2019",9,9,0,142759.555555556,1490.22222222222,107.555555555556
"15546","47036","2019",6,6,0,180150,1317,127
"15547","47037","2019",5,5,0,123000,920.6,131.8
"15548","47038","2019",3,3,0,127000,955.666666666667,136.666666666667
"15549","47040","2019",25,25,0,204514.2,2061.96,101.4
"15550","47041","2019",10,10,0,115178,1199,94.4
"15551","47042","2019",2,2,0,142500,1113.5,131.5
"15552","47043","2019",19,19,0,94110.5263157895,960.105263157895,100.684210526316
"15553","47044","2019",4,4,0,136500,1649,81.25
"15554","47045","2019",8,7,1,191250,1601,117.875
"15555","47046","2019",8,8,0,117512.5,1158.875,109.5
"15556","47047","2019",3,3,0,345936.666666667,2211,184
"15557","47048","2019",15,14,1,89966.6666666667,997.533333333333,97.5333333333333
"15558","47049","2019",32,31,1,109730.84375,1129.25,100.3125
"15559","47051","2019",26,22,4,158346.538461538,1697.73076923077,93.5384615384615
"15560","47052","2019",72,60,12,118700.666666667,1323.59722222222,92.0416666666667
"15561","47053","2019",6,6,0,247741.666666667,2572.83333333333,104.5
"15562","47054","2019",15,13,2,117012,1020.13333333333,115.133333333333
"15563","47055","2019",14,11,3,114382.142857143,1357.85714285714,87.7142857142857
"15564","47056","2019",8,8,0,161581.25,1566,101.375
"15565","47057","2019",21,21,0,102364.285714286,1091.90476190476,107.714285714286
"15566","47058","2019",3,3,0,53333.3333333333,911,64.6666666666667
"15567","47059","2019",4,4,0,200162.5,2281,109.5
"15568","47060","2019",14,14,0,129710.714285714,1290.28571428571,97
"15569","47061","2019",14,14,0,101178.571428571,1124.07142857143,94.7142857142857
"15570","47062","2019",6,6,0,141878,1338.66666666667,105
"15571","47063","2019",2,2,0,64000,626,125.5
"15572","47064","2019",3,3,0,98166.6666666667,1146,93.6666666666667
"15573","47065","2019",26,25,1,158838.269230769,1390.46153846154,115.538461538462
"15574","47066","2019",4,4,0,181750,1366.75,135.25
"15575","47067","2019",2,2,0,114500,1054,107.5
"15576","47068","2019",13,13,0,98419.2307692308,965.461538461538,106.384615384615
"15577","47069","2019",46,44,2,146136.956521739,1420.91304347826,104.652173913043
"15578","47070","2019",12,12,0,143897.5,1270.08333333333,111.916666666667
"15579","47071","2019",5,5,0,108318.8,1072.6,99.6
"15580","47072","2019",3,3,0,305209,2976.33333333333,132.333333333333
"15581","47073","2019",2,2,0,235225,1775.5,135
"15582","47074","2019",6,6,0,72166.6666666667,953.666666666667,81.1666666666667
"15583","47075","2019",15,15,0,160260,1544.06666666667,106.4
"15584","47076","2019",4,4,0,125825,1421.75,88.75
"15585","47077","2019",11,11,0,117636.363636364,1172.09090909091,101.545454545455
"15586","47078","2019",14,14,0,110189.285714286,971.785714285714,115.785714285714
"15587","47079","2019",10,10,0,131500,1240,113
"15588","47080","2019",2,2,0,240500,1867,117.5
"15589","47081","2019",15,15,0,167539.333333333,1572.6,110
"15590","47082","2019",3,3,0,162182,1621.66666666667,106
"15591","47084","2019",3,3,0,114833.333333333,1372.66666666667,83.6666666666667
"15592","47085","2019",4,4,0,128535,1230.5,105.5
"15593","47086","2019",30,29,1,155228.566666667,1509.03333333333,112.466666666667
"15594","47087","2019",1,1,0,231350,1928,120
"15595","47088","2019",9,9,0,101049.444444444,1054.88888888889,100.666666666667
"15596","47089","2019",2,2,0,166350,1257,133
"15597","47090","2019",2,2,0,192500,1069.5,180
"15598","47091","2019",33,21,12,163594.575757576,1753.75757575758,88.2121212121212
"15599","47092","2019",6,6,0,220333.333333333,1956.16666666667,112.5
"15600","47093","2019",10,10,0,111224.8,1153,96.1
"15601","47094","2019",5,5,0,101700,1409.2,75.2
"15602","47095","2019",7,7,0,108142.857142857,1445.42857142857,87.2857142857143
"15603","47096","2019",3,3,0,102666.666666667,874.666666666667,115.666666666667
"15604","47097","2019",11,11,0,123647.272727273,1232.45454545455,112.636363636364
"15605","47098","2019",3,3,0,166142.333333333,1397,126.333333333333
"15606","47099","2019",7,7,0,117200,1172,101
"15607","47100","2019",59,55,4,205621.576271186,1916.86440677966,110.610169491525
"15608","47101","2019",18,18,0,182357.388888889,1466.27777777778,121.111111111111
"15609","47102","2019",9,9,0,109800,1040.44444444444,128.777777777778
"15610","47103","2019",2,2,0,379950,1954,210
"15611","47104","2019",3,3,0,274185,1888.66666666667,136.333333333333
"15612","47105","2019",3,3,0,194185.666666667,2213,89.6666666666667
"15613","47106","2019",83,80,3,92205.7469879518,1000.61445783133,91.2771084337349
"15614","47107","2019",3,3,0,142333.333333333,2096,77.3333333333333
"15615","47108","2019",1,1,0,160000,800,200
"15616","47109","2019",2,2,0,181500,1754,105
"15617","47110","2019",16,16,0,137715.5625,1292.3125,110.25
"15618","47111","2019",9,9,0,119555.555555556,1244.77777777778,98.2222222222222
"15619","47112","2019",5,5,0,110100,1240.8,95.4
"15620","47113","2019",1,1,0,70000,814,86
"15621","47114","2019",1,1,0,149000,1935,77
"15622","47115","2019",5,5,0,139581.8,1321.2,114.6
"15623","47117","2019",8,8,0,148618.75,1361.375,112.375
"15624","47118","2019",2,2,0,117080,1440,82.5
"15625","47119","2019",13,13,0,92500,1136.92307692308,85.7692307692308
"15626","47120","2019",3,3,0,85750,809,108.666666666667
"15627","47121","2019",4,4,0,121500,1188.75,114
"15628","47122","2019",1,1,0,125000,1059,118
"15629","47123","2019",7,7,0,98635.7142857143,802.142857142857,132.571428571429
"15630","47124","2019",4,4,0,155911.25,1854,90.75
"15631","47125","2019",5,5,0,133516.4,1140,140.6
"15632","47126","2019",1,1,0,424529,2123,200
"15633","47127","2019",6,6,0,133883.333333333,1580.5,87.6666666666667
"15634","47128","2019",23,17,6,131300.173913043,1456.26086956522,88.7391304347826
"15635","47129","2019",4,4,0,139670.5,1074.5,132.25
"15636","47130","2019",4,4,0,143162.5,1105,128.75
"15637","47131","2019",10,10,0,176810,1596.8,110.4
"15638","47132","2019",4,4,0,189450,1448.75,144.75
"15639","47133","2019",7,6,1,116714.285714286,1062.28571428571,116.714285714286
"15640","47134","2019",7,7,0,102428.571428571,1012.28571428571,104.857142857143
"15641","47135","2019",6,6,0,108491.666666667,977.166666666667,117.5
"15642","47136","2019",2,2,0,283490,1887.5,154
"15643","47137","2019",8,8,0,108575,1092.75,96
"15644","47138","2019",23,22,1,158722.565217391,1350.52173913043,113.913043478261
"15645","47139","2019",2,2,0,222000,1049.5,221.5
"15646","47140","2019",4,4,0,114750,1778.5,65.25
"15647","47141","2019",5,5,0,171424,1498,106.8
"15648","47142","2019",20,20,0,164929.75,1358.7,117.6
"15649","47143","2019",39,39,0,106928.512820513,1033.48717948718,107.282051282051
"15650","47144","2019",5,5,0,114712,1049.2,94.2
"15651","47145","2019",64,47,17,126719,1439.515625,96.09375
"15652","47146","2019",15,15,0,176532.733333333,1618.6,110
"15653","47147","2019",4,4,0,157012.5,1045.75,123.5
"15654","47148","2019",1,1,0,60000,750,80
"15655","47150","2019",5,5,0,126746,1193.6,106.6
"15656","47151","2019",10,10,0,177254.7,1593.6,125.1
"15657","47152","2019",6,6,0,117916.666666667,1501.83333333333,82.6666666666667
"15658","47154","2019",5,5,0,263100,2035,124.8
"15659","47155","2019",7,7,0,167064.285714286,1688.85714285714,109.285714285714
"15660","47156","2019",8,8,0,142718.75,1313.375,118.5
"15661","47157","2019",316,232,84,117149.71835443,1352.43670886076,87.753164556962
"15662","47158","2019",1,1,0,486470,2317,210
"15663","47159","2019",20,20,0,112578,1075.9,107.75
"15664","47160","2019",2,2,0,391300,1763,185.5
"15665","47161","2019",2,2,0,132500,1195.5,122
"15666","47162","2019",4,4,0,135970,1104,122.5
"15667","47163","2019",6,6,0,156233.333333333,1450,123.5
"15668","47164","2019",1,1,0,5e+05,1894,264
"15669","47165","2019",16,16,0,122959.375,1174.5,108.625
"15670","47167","2019",14,14,0,109442.571428571,1020.57142857143,97.1428571428571
"15671","47168","2019",41,40,1,77113.8048780488,973.90243902439,79.780487804878
"15672","47169","2019",10,10,0,205224,1715,131.5
"15673","47170","2019",8,8,0,117937.5,1283.125,99.5
"15674","47171","2019",4,4,0,109025,1533.75,77
"15675","47172","2019",5,5,0,212583,2085.8,101.8
"15676","47173","2019",16,16,0,112768.75,1094,109.9375
"15677","47174","2019",9,9,0,180175.555555556,1111.77777777778,153.888888888889
"15678","47175","2019",37,34,3,139640.756756757,1371.51351351351,99.2972972972973
"15679","47176","2019",2,2,0,135000,1089.5,131.5
"15680","47177","2019",3,2,1,171333.333333333,1975.66666666667,77
"15681","47178","2019",6,6,0,146055,1199.33333333333,123.166666666667
"15682","47179","2019",22,22,0,87927.2727272727,913.136363636364,93.4545454545455
"15683","47180","2019",9,9,0,134596,1289.33333333333,114.666666666667
"15684","47181","2019",3,3,0,232933.333333333,2165,107.666666666667
"15685","47182","2019",2,2,0,103500,1096.5,90
"15686","47184","2019",4,4,0,184473.75,1516,118.5
"15687","47185","2019",40,40,0,102393.325,1172.475,87.7
"15688","47186","2019",12,12,0,157841.666666667,1416.08333333333,112.5
"15689","47187","2019",4,4,0,240577.5,1934.5,127.25
"15690","47188","2019",3,3,0,130666.666666667,1069,130.666666666667
"15691","47189","2019",2,2,0,155000,998.5,161
"15692","47190","2019",8,8,0,203481.25,1800.5,118.875
"15693","47191","2019",8,8,0,171487.5,1419.375,114.5
"15694","47194","2019",8,8,0,125787.5,1335.125,97.625
"15695","47195","2019",102,89,13,131339.568627451,1343.06862745098,98.578431372549
"15696","47196","2019",3,3,0,83938.3333333333,925.666666666667,87.6666666666667
"15697","47198","2019",1,1,0,222000,2289,97
"15698","47199","2019",4,4,0,124169.75,1154.5,121.5
"15699","47200","2019",2,2,0,152500,868,164
"15700","47201","2019",170,137,33,126929.6,1544.21176470588,82.5058823529412
"15701","47202","2019",1,1,0,509600,1503,339
"15702","47203","2019",48,46,2,129268.083333333,1307.52083333333,98.6041666666667
"15703","47204","2019",3,3,0,278143.333333333,1032.66666666667,257.333333333333
"15704","47205","2019",2,2,0,91516.5,1095,78
"15705","47206","2019",8,8,0,155481.25,1199.875,145
"15706","47207","2019",1,1,0,138000,1353,102
"15707","47208","2019",2,2,0,126327.5,1250.5,104
"15708","47209","2019",44,41,3,146233.863636364,1654.09090909091,86.4090909090909
"15709","47210","2019",19,19,0,102572.631578947,1044.63157894737,95.7894736842105
"15710","47211","2019",5,5,0,94600,895.6,108.2
"15711","47212","2019",2,2,0,285000,2632.5,114.5
"15712","47213","2019",9,9,0,196766.666666667,1586,127.222222222222
"15713","47214","2019",13,13,0,190807.692307692,1574.92307692308,118.923076923077
"15714","47215","2019",50,47,3,145734.28,1451.64,100.02
"15715","47216","2019",7,7,0,151367.285714286,1316.28571428571,117.571428571429
"15716","47217","2019",17,15,2,124109.411764706,1162.47058823529,105.352941176471
"15717","47218","2019",2,2,0,172615,1377.5,123.5
"15718","47219","2019",2,2,0,101000,1113,90.5
"15719","47220","2019",3,3,0,110000,1388.66666666667,83.3333333333333
"15720","47221","2019",7,7,0,116200,974.571428571429,116.428571428571
"15721","47222","2019",5,5,0,168300,1417.2,114
"15722","47223","2019",3,3,0,205071.666666667,1825.33333333333,110
"15723","47224","2019",3,3,0,82000,1054.66666666667,79
"15724","47225","2019",28,28,0,200651.785714286,1980.17857142857,103.964285714286
"15725","47226","2019",10,10,0,125950,1471.6,83.7
"15726","47227","2019",6,6,0,115516.666666667,1255.66666666667,90.3333333333333
"15727","47228","2019",12,12,0,159942.166666667,1563.25,94
"15728","47229","2019",4,4,0,130250,1482.5,108.5
"15729","47230","2019",4,4,0,103750,1042.5,112.25
"15730","47232","2019",3,3,0,104413.333333333,1057,97
"15731","47233","2019",43,43,0,148859.418604651,1411.48837209302,107.837209302326
"15732","47234","2019",4,4,0,224462.5,1769.25,123.25
"15733","47235","2019",5,5,0,240548.8,1738.8,138.2
"15734","47236","2019",4,4,0,323260,1816.25,167
"15735","47237","2019",7,7,0,123882.285714286,1233.85714285714,103.142857142857
"15736","47238","2019",8,8,0,236706.25,2080.375,123.875
"15737","47239","2019",15,14,1,167494,1524.13333333333,109.533333333333
"15738","47240","2019",3,3,0,123333.333333333,1441.33333333333,85
"15739","47241","2019",7,7,0,193607.142857143,1269,161.857142857143
"15740","47242","2019",4,4,0,135250,1361.75,100
"15741","47244","2019",2,2,0,147750,1284,106
"15742","47245","2019",1,1,0,158000,1254,126
"15743","47246","2019",21,21,0,158067.619047619,1517.95238095238,103.952380952381
"15744","47247","2019",2,1,1,110000,1232,87
"15745","47248","2019",3,3,0,105366.666666667,1492.33333333333,95.3333333333333
"15746","47249","2019",4,4,0,172237.5,1353,130
"15747","47250","2019",2,2,0,91000,966.5,117
"15748","47251","2019",2,2,0,130000,1000,125
"15749","47252","2019",89,87,2,121323.561797753,1212.23595505618,100.876404494382
"15750","47253","2019",6,6,0,125166.666666667,1692.5,78.5
"15751","47254","2019",5,5,0,188400,1288.8,152
"15752","47255","2019",1,1,0,67500,900,75
"15753","47257","2019",3,3,0,134045,1390.33333333333,123.333333333333
"15754","47258","2019",5,5,0,142200,1307.6,117.6
"15755","47259","2019",1,1,0,131000,1310,100
"15756","47260","2019",6,6,0,167112.666666667,1328.16666666667,127.166666666667
"15757","47262","2019",2,2,0,94000,991.5,93
"15758","47263","2019",6,6,0,142600,1166.16666666667,116.666666666667
"15759","47264","2019",29,29,0,112851.103448276,1356.20689655172,85.1379310344828
"15760","47265","2019",6,6,0,87950,697.333333333333,124.5
"15761","47266","2019",2,2,0,203490,2543.5,86.5
"15762","47269","2019",10,10,0,147045,1374,110.4
"15763","47271","2019",5,5,0,166198,1461.4,112.6
"15764","47272","2019",2,2,0,117500,964.5,100.5
"15765","47273","2019",1,1,0,130000,650,200
"15766","47274","2019",5,5,0,160734,1455,118.4
"15767","47275","2019",2,2,0,87500,980.5,81.5
"15768","47276","2019",7,7,0,109857.142857143,1238.28571428571,89.1428571428571
"15769","47277","2019",5,5,0,170600,1411.8,115.4
"15770","47278","2019",8,8,0,223201.25,1913.125,121.375
"15771","47279","2019",6,6,0,134766.666666667,1356,109.833333333333
"15772","47280","2019",31,30,1,143251.612903226,1485.64516129032,97.5806451612903
"15773","47281","2019",1,1,0,90000,750,120
"15774","47282","2019",1,1,0,190000,2235,85
"15775","47283","2019",13,13,0,111832.615384615,1230.23076923077,90.3076923076923
"15776","47284","2019",3,3,0,188066.666666667,1618.33333333333,122.333333333333
"15777","47285","2019",4,4,0,148923,1235,129.75
"15778","47286","2019",1,1,0,190000,1188,160
"15779","47287","2019",1,1,0,161000,1830,88
"15780","47288","2019",7,7,0,134650,1500.71428571429,97
"15781","47289","2019",10,10,0,188840.8,1626.2,113.6
"15782","47290","2019",9,9,0,181604.333333333,1280,128.222222222222
"15783","47291","2019",5,5,0,104200,1032.8,111
"15784","47292","2019",12,12,0,157833.333333333,1352,111.916666666667
"15785","47293","2019",4,4,0,159500,1278,126.25
"15786","47295","2019",3,3,0,373500,1752,179.666666666667
"15787","47296","2019",3,3,0,143000,1135,135.666666666667
"15788","47297","2019",2,2,0,145000,1591.5,91.5
"15789","47298","2019",2,2,0,95500,1042,81.5
"15790","47299","2019",2,2,0,118750,952,131.5
"15791","47300","2019",13,13,0,135706.153846154,1617.61538461538,85.7692307692308
"15792","47301","2019",12,12,0,118175,1138.66666666667,104.833333333333
"15793","47302","2019",11,11,0,107363.636363636,1044.27272727273,105.636363636364
"15794","47303","2019",2,2,0,146603.5,1334.5,102
"15795","47304","2019",1,1,0,155000,1006,154
"15796","47305","2019",4,4,0,90425,1137,93
"15797","47306","2019",11,11,0,201727.272727273,1565.63636363636,124.181818181818
"15798","47307","2019",3,3,0,185158.333333333,1912,114
"15799","47309","2019",5,5,0,94030,855.2,121
"15800","47310","2019",128,98,30,101914.9921875,1156.359375,93.1171875
"15801","47311","2019",3,3,0,151783.333333333,1318,116.333333333333
"15802","47312","2019",10,10,0,86560,990,98.4
"15803","47313","2019",4,4,0,131750,1113.75,122
"15804","47314","2019",9,9,0,194805.555555556,1535,142.222222222222
"15805","47315","2019",11,11,0,157740,1179.72727272727,127.727272727273
"15806","47316","2019",8,8,0,162062.5,1412.5,117.75
"15807","47317","2019",6,6,0,128743.333333333,1333.33333333333,96.1666666666667
"15808","47318","2019",15,14,1,139712.133333333,1364.13333333333,106.333333333333
"15809","47320","2019",3,3,0,206000,1247.33333333333,164.333333333333
"15810","47321","2019",3,3,0,113358.333333333,1024.66666666667,122.333333333333
"15811","47323","2019",381,312,69,109679.94488189,1223.46194225722,89.8398950131234
"15812","47324","2019",26,23,3,136614.615384615,1417.15384615385,93.9615384615385
"15813","47325","2019",5,5,0,119717.6,1283.8,89.6
"15814","47326","2019",14,14,0,176124.285714286,1370.71428571429,131.928571428571
"15815","47327","2019",2,2,0,126625,1330.5,93.5
"15816","47328","2019",3,3,0,113333.333333333,1296.33333333333,89
"15817","48001","2019",3,3,0,106166.666666667,810.666666666667,117.666666666667
"15818","48002","2019",3,3,0,114333.333333333,1058.33333333333,105.333333333333
"15819","48003","2019",3,3,0,128066.666666667,1388.33333333333,94
"15820","48004","2019",1,1,0,135000,1286,105
"15821","48005","2019",2,1,1,123959,1074,123
"15822","48008","2019",2,2,0,96000,925.5,100
"15823","48009","2019",26,26,0,112801.038461538,1202.53846153846,94.4615384615385
"15824","48010","2019",5,5,0,141191,1446.4,100
"15825","48012","2019",4,4,0,101300,1179.25,89.25
"15826","48013","2019",6,3,3,156811.666666667,1587.5,95.1666666666667
"15827","48015","2019",4,4,0,176770.5,1738.75,99
"15828","48016","2019",1,1,0,154000,1711,90
"15829","48017","2019",14,13,1,106739.5,1194.42857142857,91.5
"15830","48018","2019",12,12,0,178810,2340,84.9166666666667
"15831","48019","2019",1,1,0,110000,1222,90
"15832","48020","2019",2,1,1,74000,887.5,90
"15833","48021","2019",4,4,0,103750,1364.75,92.5
"15834","48026","2019",2,2,0,75760,1875.5,48
"15835","48027","2019",16,13,3,79025.6875,1131.375,73.125
"15836","48028","2019",2,2,0,45000,822.5,55
"15837","48030","2019",1,1,0,241400,2118,114
"15838","48032","2019",3,3,0,132200,1236,112.666666666667
"15839","48034","2019",16,14,2,86601.875,961.875,99.75
"15840","48036","2019",1,1,0,80000,1379,58
"15841","48037","2019",4,4,0,124137.5,1461.75,88
"15842","48038","2019",5,4,1,91206,1161.8,77.4
"15843","48039","2019",9,7,2,109154.444444444,1233.88888888889,90.4444444444444
"15844","48041","2019",1,1,0,160000,1600,100
"15845","48042","2019",7,6,1,314571.428571429,2500,140.428571428571
"15846","48043","2019",3,3,0,93000,817.333333333333,116.333333333333
"15847","48044","2019",1,1,0,5e+05,4132,121
"15848","48045","2019",2,2,0,76500,1075.5,71
"15849","48046","2019",1,1,0,73000,811,90
"15850","48048","2019",2,2,0,64800,621,103
"15851","48050","2019",6,5,1,132121.666666667,1248.66666666667,98.1666666666667
"15852","48051","2019",10,8,2,125159,1545,79.8
"15853","48053","2019",6,6,0,79816.6666666667,1189.33333333333,68
"15854","48056","2019",5,5,0,125976.2,1167,106.4
"15855","48058","2019",1,1,0,245000,1944,126
"15856","48059","2019",3,3,0,84096.6666666667,716.333333333333,136.333333333333
"15857","48061","2019",27,21,6,103863.592592593,1318.96296296296,82.6296296296296
"15858","48063","2019",1,1,0,55000,500,110
"15859","48064","2019",6,6,0,81416.6666666667,1041.33333333333,80.6666666666667
"15860","48068","2019",1,1,0,285000,2615,109
"15861","48070","2019",7,7,0,92428.5714285714,903.857142857143,99.8571428571429
"15862","48071","2019",1,1,0,1e+05,1190,84
"15863","48072","2019",3,3,0,116100,1732.66666666667,60
"15864","48073","2019",2,2,0,73975,1085.5,71
"15865","48074","2019",3,3,0,210000,2182.66666666667,90.3333333333333
"15866","48075","2019",7,7,0,101142.857142857,1372.71428571429,93.4285714285714
"15867","48079","2019",3,3,0,59016.6666666667,683.333333333333,84
"15868","48080","2019",31,27,4,103879.032258065,1191.41935483871,89.1935483870968
"15869","48081","2019",3,3,0,187333.333333333,1810.33333333333,106.333333333333
"15870","48082","2019",3,3,0,106666.666666667,1017.33333333333,96.3333333333333
"15871","48086","2019",1,1,0,50000,403,124
"15872","48087","2019",5,5,0,103518.2,1088.2,103.8
"15873","48088","2019",4,4,0,71250,1474.5,52
"15874","48089","2019",7,7,0,89688.5714285714,986.285714285714,81
"15875","48090","2019",8,7,1,143278,1281.375,109.25
"15876","48092","2019",51,26,25,125615.235294118,1352.21568627451,90.6078431372549
"15877","48094","2019",17,16,1,133143.823529412,1858.52941176471,80.2941176470588
"15878","48095","2019",96,43,53,145649.114583333,1717.375,85.7708333333333
"15879","48096","2019",5,5,0,89100,1158.4,80.2
"15880","48097","2019",2,2,0,141000,1039,187.5
"15881","48098","2019",1,1,0,120000,1538,78
"15882","48099","2019",16,16,0,133627.0625,1397.25,110.5625
"15883","48100","2019",3,3,0,112833.333333333,1095,98.6666666666667
"15884","48103","2019",10,10,0,154434,1356.1,108.5
"15885","48104","2019",6,6,0,144528.333333333,1044.66666666667,151.333333333333
"15886","48105","2019",2,2,0,177434,1736,103.5
"15887","48106","2019",2,2,0,26850,625.5,53
"15888","48108","2019",1,1,0,135000,2045,66
"15889","48110","2019",3,3,0,51386.6666666667,598,90
"15890","48111","2019",1,1,0,89000,927,96
"15891","48112","2019",3,3,0,90333.3333333333,983.333333333333,103.333333333333
"15892","48115","2019",5,5,0,146790,2418.8,73.4
"15893","48116","2019",10,9,1,82208,1128.2,82
"15894","48117","2019",4,4,0,80801,1498.75,63.25
"15895","48119","2019",3,2,1,75193.3333333333,1771,46.6666666666667
"15896","48121","2019",1,1,0,30000,375,80
"15897","48123","2019",1,1,0,110000,982,112
"15898","48124","2019",1,1,0,25000,410,61
"15899","48126","2019",3,3,0,79813.3333333333,1229.66666666667,70.6666666666667
"15900","48127","2019",17,16,1,123444.705882353,1345.82352941176,102.352941176471
"15901","48128","2019",7,7,0,92260.7142857143,955.142857142857,90.7142857142857
"15902","48129","2019",3,2,1,85333.3333333333,866,93.6666666666667
"15903","48131","2019",2,0,2,167500,5181.5,37
"15904","48132","2019",21,20,1,111739.142857143,1230.2380952381,90
"15905","48135","2019",1,1,0,1e+05,2000,50
"15906","48136","2019",5,5,0,123567.8,1563.6,74.8
"15907","48137","2019",4,4,0,163425,1947.5,82.5
"15908","48140","2019",29,24,5,140139.655172414,1494.62068965517,93.551724137931
"15909","48141","2019",1,1,0,47553,528,90
"15910","48144","2019",3,3,0,97400,1182.66666666667,91
"15911","48145","2019",7,7,0,86428.5714285714,961.714285714286,91.1428571428571
"15912","48146","2019",20,18,2,103806.7,1333.2,79.85
"15913","48147","2019",2,2,0,134500,1342,101.5
"15914","48148","2019",8,8,0,157731.25,2258.375,75
"15915","48150","2019",1,1,0,45000,1125,40
"15916","48152","2019",4,4,0,151432.5,2464.75,72.5
"15917","48153","2019",1,1,0,149640,1496,100
"15918","48155","2019",3,3,0,210000,3090.33333333333,76.6666666666667
"15919","48156","2019",7,7,0,173864.285714286,1856.85714285714,112.571428571429
"15920","48158","2019",3,3,0,105000,1702.33333333333,75
"15921","48160","2019",2,1,1,130375,1327.5,96
"15922","48163","2019",2,2,0,136572.5,2319,58.5
"15923","48165","2019",4,4,0,133250,1472.5,90.75
"15924","48166","2019",1,1,0,89000,1171,76
"15925","48167","2019",2,2,0,51840,728.5,71
"15926","48168","2019",1,1,0,15000,500,30
"15927","48169","2019",6,6,0,79750,877.333333333333,88.6666666666667
"15928","48170","2019",2,2,0,110000,1292.5,83.5
"15929","48171","2019",1,1,0,173850,1792,97
"15930","48173","2019",2,2,0,215000,2155,100
"15931","48174","2019",3,3,0,61666.6666666667,742,84.3333333333333
"15932","48175","2019",2,2,0,69500,1571,52
"15933","48176","2019",2,2,0,57800,1085.5,53
"15934","48178","2019",7,7,0,99350,1282.57142857143,84.2857142857143
"15935","48182","2019",2,2,0,198500,2081,91
"15936","48185","2019",3,3,0,79293.3333333333,1035,86.6666666666667
"15937","48187","2019",2,2,0,105000,1125,90
"15938","48188","2019",1,1,0,180000,978,184
"15939","48190","2019",2,2,0,78500,1338,67
"15940","48193","2019",1,1,0,35000,2059,17
"15941","48194","2019",11,10,1,133051.818181818,1980.45454545455,71.1818181818182
"15942","48198","2019",11,8,3,76105.4545454545,1313.27272727273,66.8181818181818
"15943","49002","2019",35,35,0,150994.285714286,1442.62857142857,100.628571428571
"15944","49003","2019",19,19,0,169628.947368421,1398.47368421053,119.789473684211
"15945","49007","2019",2905,730,2175,161795.779345955,2288.06230636833,70.9779690189329
"15946","49008","2019",17,17,0,126705.882352941,1043.64705882353,122.470588235294
"15947","49009","2019",12,12,0,89550,892.75,102.25
"15948","49010","2019",3,3,0,131666.666666667,1155,113.333333333333
"15949","49011","2019",3,3,0,160666.666666667,1473.66666666667,112
"15950","49012","2019",2,2,0,152000,1555,98.5
"15951","49015","2019",207,121,86,211795.140096618,2374.28019323672,91.1884057971015
"15952","49017","2019",18,18,0,115886.277777778,1152.44444444444,104.055555555556
"15953","49018","2019",154,152,2,126927.246753247,1203.18181818182,105.909090909091
"15954","49020","2019",72,71,1,264783.180555556,2303.94444444444,115.555555555556
"15955","49021","2019",72,69,3,147910,1422.86111111111,107.763888888889
"15956","49022","2019",14,14,0,172678.571428571,1398.57142857143,132.642857142857
"15957","49023","2019",257,239,18,132398.649805447,1420.05836575875,95.408560311284
"15958","49026","2019",21,20,1,169428.571428571,1648.47619047619,110.333333333333
"15959","49027","2019",27,27,0,135433.333333333,1439.07407407407,96.8888888888889
"15960","49028","2019",3,3,0,275666.666666667,2220,117.333333333333
"15961","49029","2019",15,15,0,202433.333333333,1593.93333333333,130.266666666667
"15962","49030","2019",8,8,0,104350,1186.875,88
"15963","49035","2019",74,70,4,296157.594594595,2501.21621621622,117.635135135135
"15964","49036","2019",13,13,0,127115.230769231,1120.53846153846,112.538461538462
"15965","49038","2019",2,2,0,101624,957,102.5
"15966","49041","2019",25,25,0,162084.24,1398.24,127.88
"15967","49045","2019",7,7,0,132357.142857143,1134.85714285714,107.857142857143
"15968","49048","2019",33,31,2,207742.424242424,1837.81818181818,116.090909090909
"15969","49050","2019",150,144,6,184439.533333333,1665.36666666667,111.94
"15970","49053","2019",4,4,0,113750,1270.25,89
"15971","49054","2019",38,34,4,107210.526315789,1186.60526315789,97.8157894736842
"15972","49055","2019",28,28,0,226092.857142857,2102.89285714286,109.607142857143
"15973","49056","2019",5,5,0,134800,1142,102.2
"15974","49057","2019",2,2,0,98500,1202.5,82
"15975","49058","2019",13,13,0,126310.153846154,1297.07692307692,98.5384615384615
"15976","49060","2019",37,35,2,127305.405405405,1292.97297297297,96.8378378378378
"15977","49061","2019",6,6,0,156666.666666667,1229.66666666667,142.833333333333
"15978","49063","2019",84,69,15,171968.952380952,1827.58333333333,98.1190476190476
"15979","49064","2019",5,5,0,161585,1390.2,119.8
"15980","49067","2019",5,4,1,165980,1758.4,97.2
"15981","49068","2019",21,21,0,139804.666666667,1346.71428571429,110.190476190476
"15982","49069","2019",201,200,1,160176.845771144,1709.26865671642,96.3532338308458
"15983","49070","2019",7,7,0,132857.142857143,1287.42857142857,104
"15984","49076","2019",7,7,0,205427.142857143,1946.71428571429,116.428571428571
"15985","49080","2019",91,85,6,141621.406593407,1335.01098901099,109.769230769231
"15986","49082","2019",12,12,0,148558.333333333,1300.91666666667,113.166666666667
"15987","49086","2019",46,44,2,147144.565217391,1493.15217391304,102.760869565217
"15988","49089","2019",16,16,0,136972,1348.625,103.6875
"15989","49090","2019",26,25,1,136067.115384615,1352.42307692308,100.923076923077
"15990","49092","2019",209,208,1,138270.320574163,1378.86602870813,100.995215311005
"15991","49099","2019",969,650,319,141360.052631579,1673.96388028896,84.6357069143447
"15992","49100","2019",4,4,0,144375,1454,101.5
"15993","49102","2019",1,1,0,146000,912,160
"15994","49107","2019",5,5,0,196290,1417.6,133.2
"15995","49109","2019",20,20,0,120910,1173.05,107.75
"15996","49110","2019",25,25,0,162291.4,1573.28,103.52
"15997","49112","2019",7,7,0,163928.571428571,1318.71428571429,118.714285714286
"15998","49113","2019",7,7,0,155000,1342.85714285714,118.714285714286
"15999","49114","2019",4,4,0,91330,724.75,121.5
"16000","49120","2019",18,17,1,183386.111111111,1719.22222222222,111.611111111111
"16001","49121","2019",7,7,0,145857.142857143,1197.57142857143,114.285714285714
"16002","49123","2019",18,18,0,167709.055555556,1539.16666666667,107.444444444444
"16003","49125","2019",122,118,4,143285.368852459,1445.41803278689,102.991803278689
"16004","49127","2019",46,45,1,117116.130434783,1157.17391304348,100.869565217391
"16005","49129","2019",45,43,2,219319.777777778,2137.57777777778,104.311111111111
"16006","49130","2019",10,10,0,201550,1853.8,111.5
"16007","49131","2019",8,8,0,109811.5,1239.375,103.125
"16008","49132","2019",23,23,0,160171.130434783,1538.39130434783,106.260869565217
"16009","49135","2019",3,3,0,197833.333333333,1274.66666666667,152.333333333333
"16010","49138","2019",38,37,1,143665.026315789,1405.57894736842,105.052631578947
"16011","49140","2019",23,23,0,94491.347826087,1031,91.0434782608696
"16012","49155","2019",16,16,0,253369,1622.625,150.875
"16013","49160","2019",32,31,1,132743.25,1478.78125,89.71875
"16014","49161","2019",8,8,0,113525,1506,93.25
"16015","49163","2019",49,48,1,128337.142857143,1379.85714285714,95.3469387755102
"16016","49167","2019",63,63,0,252189.46031746,2009.1746031746,124.396825396825
"16017","49170","2019",16,16,0,129138.875,1609.625,84.5
"16018","49171","2019",1,1,0,87200,1090,80
"16019","49174","2019",17,17,0,122294.117647059,1150.17647058824,106.352941176471
"16020","49176","2019",62,58,4,184951.435483871,1860.61290322581,103.387096774194
"16021","49178","2019",12,12,0,106458.333333333,993.583333333333,112
"16022","49180","2019",63,60,3,128902.111111111,1301.03174603175,102.285714285714
"16023","49182","2019",6,6,0,161666.666666667,1719.66666666667,101.333333333333
"16024","49183","2019",61,61,0,137912.459016393,1422.45901639344,99.0491803278689
"16025","49188","2019",8,8,0,150917.25,1518.25,114.5
"16026","49192","2019",33,33,0,178400.909090909,1945.30303030303,104.545454545455
"16027","49193","2019",61,61,0,127416.393442623,1345.68852459016,95.4098360655738
"16028","49194","2019",105,94,11,169930.247619048,1857.07619047619,106.6
"16029","49195","2019",9,9,0,195722.222222222,1794.44444444444,108.777777777778
"16030","49200","2019",73,71,2,184069.808219178,1887.58904109589,101.068493150685
"16031","49201","2019",17,17,0,150720,1349.88235294118,111.176470588235
"16032","49205","2019",12,12,0,136396.666666667,1194.5,105.75
"16033","49209","2019",1,1,0,245000,1109,221
"16034","49211","2019",7,7,0,132714.285714286,1337.42857142857,103.714285714286
"16035","49214","2019",88,69,19,219311.113636364,2114.5,102.363636363636
"16036","49215","2019",48,47,1,117331.229166667,1235.875,100.666666666667
"16037","49216","2019",6,6,0,177000,1871.83333333333,91.5
"16038","49217","2019",11,11,0,163955.454545455,1399.45454545455,117.545454545455
"16039","49218","2019",179,178,1,119827.30726257,1234.54189944134,100.832402234637
"16040","49219","2019",7,7,0,139507.571428571,1366.42857142857,100.714285714286
"16041","49220","2019",55,55,0,121985.8,1165.87272727273,105.654545454545
"16042","49221","2019",15,15,0,116373.333333333,945.8,124.2
"16043","49222","2019",37,37,0,209807.567567568,1846.37837837838,113.324324324324
"16044","49223","2019",71,59,12,230379.61971831,2112.19718309859,110.042253521127
"16045","49224","2019",11,11,0,126081.818181818,1180.54545454545,110.909090909091
"16046","49228","2019",81,80,1,87619.7283950617,932.234567901235,95.320987654321
"16047","49231","2019",18,18,0,142222.222222222,1615.11111111111,92.8333333333333
"16048","49235","2019",9,9,0,119511.111111111,1388.22222222222,87.4444444444444
"16049","49236","2019",6,6,0,79083.3333333333,1012.83333333333,83.6666666666667
"16050","49237","2019",6,6,0,173166.666666667,1209.33333333333,148.166666666667
"16051","49240","2019",13,13,0,118346.153846154,1143.23076923077,106.384615384615
"16052","49241","2019",44,43,1,221207.954545455,2013.40909090909,110.477272727273
"16053","49244","2019",164,160,4,138852.768292683,1401.50609756098,99.9939024390244
"16054","49246","2019",137,117,20,208364.532846715,2276.89051094891,95.6788321167883
"16055","49247","2019",22,22,0,209892.727272727,1767.54545454545,121.545454545455
"16056","49248","2019",111,110,1,116799.846846847,1029.30630630631,111.72972972973
"16057","49253","2019",13,12,1,124730.769230769,1395,95.9230769230769
"16058","49257","2019",6,6,0,141993.5,1426.5,101.166666666667
"16059","49259","2019",31,29,2,190961.290322581,1872.51612903226,104.41935483871
"16060","49260","2019",18,18,0,125269.444444444,1316.83333333333,96.6666666666667
"16061","49261","2019",107,104,3,151440.196261682,1413.32710280374,107.96261682243
"16062","49262","2019",7,7,0,215142.857142857,1686.85714285714,128.714285714286
"16063","49266","2019",16,16,0,160665.125,1494.3125,111.9375
"16064","49267","2019",91,63,28,182311.032967033,2099.32967032967,88.0659340659341
"16065","49269","2019",29,29,0,164346.551724138,1734.55172413793,95.1034482758621
"16066","49271","2019",35,35,0,188514.285714286,1958.45714285714,100.114285714286
"16067","49272","2019",18,18,0,122802.777777778,1195.55555555556,101.055555555556
"16068","49278","2019",47,35,12,207087.446808511,2102.76595744681,98.2765957446808
"16069","49283","2019",30,30,0,185780,1838.8,102.733333333333
"16070","49284","2019",16,16,0,161560.75,1508.5625,106.9375
"16071","49288","2019",3,3,0,118500,1071,124.666666666667
"16072","49291","2019",4,4,0,106500,956.5,103.25
"16073","49292","2019",48,48,0,153707.75,1503.1875,102.666666666667
"16074","49294","2019",33,33,0,256949,2020.09090909091,132.424242424242
"16075","49298","2019",31,31,0,233683.870967742,2119.35483870968,112.032258064516
"16076","49299","2019",24,24,0,181312.5,1710.16666666667,107.333333333333
"16077","49301","2019",291,288,3,145115.164948454,1534.71134020619,97.085910652921
"16078","49302","2019",5,5,0,117190,1262.2,92
"16079","49306","2019",24,24,0,204672.833333333,1934.79166666667,105.5
"16080","49307","2019",191,189,2,198763.952879581,1859.85340314136,109.204188481675
"16081","49308","2019",20,20,0,271730,2058.6,134.25
"16082","49310","2019",8,8,0,84450,817.25,100.125
"16083","49311","2019",12,12,0,152600,1388.66666666667,112
"16084","49321","2019",5,5,0,196420,1753.4,111.6
"16085","49323","2019",72,64,8,212236.125,2089.13888888889,102.194444444444
"16086","49326","2019",8,8,0,189500,1757.75,110.375
"16087","49328","2019",486,277,209,129649.565843621,1442.52880658436,88.7798353909465
"16088","49329","2019",19,19,0,254101.105263158,2155.78947368421,124.368421052632
"16089","49330","2019",17,17,0,171755.882352941,1627.41176470588,109.529411764706
"16090","49331","2019",240,219,21,123872.266666667,1253.65,97.6583333333333
"16091","49332","2019",43,43,0,179089.930232558,1650.58139534884,108.581395348837
"16092","49333","2019",51,48,3,143765.68627451,1358.64705882353,110.254901960784
"16093","49336","2019",8,8,0,97625,880,107.5
"16094","49338","2019",24,24,0,228735.791666667,2029.375,113.666666666667
"16095","49339","2019",16,16,0,165970,1674.1875,103
"16096","49341","2019",12,12,0,176632.916666667,1559.83333333333,111.75
"16097","49343","2019",37,36,1,154301.810810811,1603.83783783784,96.4594594594595
"16098","49344","2019",13,13,0,212175,1738,124.230769230769
"16099","49345","2019",70,70,0,147534.357142857,1457.21428571429,104.671428571429
"16100","49347","2019",14,14,0,227928.571428571,1915.78571428571,125.928571428571
"16101","49352","2019",15,15,0,179360.733333333,1642.53333333333,116.8
"16102","49353","2019",207,184,23,186165.449275362,2062.69565217391,92.0869565217391
"16103","49355","2019",36,36,0,136694.444444444,1294.5,104.361111111111
"16104","49358","2019",10,10,0,209428.2,1681.6,137.3
"16105","49359","2019",8,8,0,138625,1099.125,121.375
"16106","49361","2019",15,15,0,144345.666666667,1646.93333333333,99.8666666666667
"16107","49362","2019",18,18,0,191044.444444444,1535.33333333333,130
"16108","49364","2019",18,18,0,124219.444444444,1124.05555555556,108.555555555556
"16109","49367","2019",66,66,0,140216.666666667,1410.09090909091,100.69696969697
"16110","49368","2019",24,24,0,116399.291666667,1064.625,109.666666666667
"16111","49369","2019",12,12,0,122497.916666667,1284.91666666667,105.833333333333
"16112","49370","2019",4,4,0,174750,1440,117.25
"16113","49371","2019",18,18,0,132766.666666667,1322.16666666667,105.555555555556
"16114","49373","2019",82,82,0,101103.170731707,1009.23170731707,101.414634146341
"16115","49374","2019",16,16,0,151683.875,1294.375,119.125
"16116","49377","2019",64,64,0,202466.171875,1835.375,113.59375
"16117","49378","2019",38,33,5,131786.842105263,1461.5,88.7631578947368
"16118","49381","2019",26,26,0,154192.307692308,1464.34615384615,106.115384615385
"16119","50002","2019",72,63,9,146391.722222222,1449.88888888889,103
"16120","50003","2019",76,68,8,264228.026315789,3180.90789473684,89.1052631578947
"16121","50004","2019",5,5,0,101100,1231.2,80
"16122","50008","2019",5,5,0,208641.8,1555.6,129.8
"16123","50013","2019",11,11,0,164443.090909091,1519.09090909091,108.272727272727
"16124","50015","2019",3,2,1,123000,1431,89.6666666666667
"16125","50016","2019",6,6,0,95500,2507.5,76
"16126","50019","2019",6,6,0,110615,1284.5,93.5
"16127","50021","2019",1,1,0,225000,1772,127
"16128","50022","2019",2,2,0,77500,682.5,106.5
"16129","50023","2019",6,6,0,63333.3333333333,549.833333333333,104.666666666667
"16130","50024","2019",5,5,0,97523.2,886,105.2
"16131","50025","2019",147,87,60,143401.319727891,1628.02721088435,90.7823129251701
"16132","50026","2019",2,2,0,134100,1940.5,67.5
"16133","50027","2019",12,12,0,135133.333333333,1452.41666666667,90.8333333333333
"16134","50028","2019",1,1,0,20000,800,25
"16135","50029","2019",16,16,0,74365.625,916.25,82.8125
"16136","50030","2019",26,24,2,198900.769230769,2588.76923076923,85.8461538461538
"16137","50031","2019",112,88,24,180169.482142857,2350.08035714286,76.7410714285714
"16138","50032","2019",7,7,0,169528.571428571,1457.42857142857,116
"16139","50033","2019",1,1,0,220000,1410,156
"16140","50034","2019",4,4,0,219300,1665.75,132
"16141","50036","2019",7,7,0,113145.571428571,998,101.285714285714
"16142","50038","2019",4,4,0,125050,1292.5,99.75
"16143","50039","2019",1,1,0,90000,692,130
"16144","50040","2019",4,4,0,73125,746.75,91
"16145","50041","2019",119,118,1,176513.81512605,1774.54621848739,102.932773109244
"16146","50042","2019",3,3,0,134333.333333333,1735,80
"16147","50044","2019",1,1,0,116000,2522,46
"16148","50045","2019",12,12,0,224208.333333333,1824.66666666667,122.083333333333
"16149","50046","2019",11,11,0,137420.454545455,1114.18181818182,120.727272727273
"16150","50048","2019",6,6,0,107471.666666667,1075.5,91.8333333333333
"16151","50049","2019",9,9,0,121944.444444444,1340.77777777778,92.7777777777778
"16152","50050","2019",1,1,0,77130,907,85
"16153","50052","2019",5,5,0,106830,1008,103.8
"16154","50054","2019",2,2,0,132500,807.5,164.5
"16155","50055","2019",2,2,0,142500,1380.5,109
"16156","50058","2019",33,33,0,185907.575757576,1894.30303030303,99.2121212121212
"16157","50059","2019",7,7,0,137428.571428571,1423.57142857143,96
"16158","50060","2019",4,4,0,95187.5,1166.75,83.25
"16159","50062","2019",1,1,0,131000,1871,70
"16160","50064","2019",2,2,0,173000,985.5,175.5
"16161","50066","2019",73,58,15,218287.493150685,2713.15068493151,86.6164383561644
"16162","50069","2019",2,2,0,102500,1175.5,79
"16163","50070","2019",2,2,0,88326,805.5,128.5
"16164","50072","2019",2,2,0,119000,934,127.5
"16165","50074","2019",16,16,0,116372.0625,1377.25,85.0625
"16166","50076","2019",69,62,7,204178.014492754,2253.14492753623,95.9275362318841
"16167","50077","2019",19,19,0,206147.368421053,1983.05263157895,104.947368421053
"16168","50078","2019",16,16,0,127636.875,1873.625,80.5
"16169","50079","2019",8,8,0,147831.25,1520.625,104.25
"16170","50081","2019",15,15,0,311126.666666667,2453.73333333333,124.733333333333
"16171","50082","2019",71,69,2,131084.830985915,1335.2676056338,100.211267605634
"16172","50083","2019",6,6,0,164283.333333333,1435.16666666667,114.166666666667
"16173","50084","2019",6,6,0,164613.333333333,1711.5,106
"16174","50085","2019",17,17,0,170382.352941176,2050.94117647059,84.8823529411765
"16175","50086","2019",5,5,0,179360,1894.8,102.6
"16176","50087","2019",15,15,0,169383.333333333,1712.26666666667,100.2
"16177","50088","2019",5,5,0,40400,552,69.6
"16178","50090","2019",10,10,0,68570,993.4,75.6
"16179","50092","2019",6,6,0,148583.333333333,1347.33333333333,107.166666666667
"16180","50093","2019",8,8,0,70312.5,866.5,82.625
"16181","50094","2019",7,7,0,115142.857142857,1047.14285714286,115.428571428571
"16182","50095","2019",22,22,0,123800,1173.09090909091,109.409090909091
"16183","50096","2019",1,1,0,47000,522,90
"16184","50097","2019",4,4,0,103375,1367.5,82.5
"16185","50098","2019",9,9,0,106222.222222222,1018.44444444444,105.222222222222
"16186","50099","2019",128,110,18,141124.515625,1460.8984375,98.6328125
"16187","50101","2019",2,2,0,170000,1828,95
"16188","50102","2019",33,31,2,226324.636363636,2189.78787878788,105.69696969697
"16189","50105","2019",6,6,0,75916.6666666667,917.666666666667,92.8333333333333
"16190","50106","2019",4,4,0,119125,1180.75,90.75
"16191","50108","2019",5,5,0,136900,1483.6,99.6
"16192","50109","2019",24,23,1,129776.041666667,1390.58333333333,93.3333333333333
"16193","50110","2019",16,16,0,120544.375,1146.3125,108.5
"16194","50111","2019",13,13,0,80738.4615384615,839.692307692308,99.1538461538462
"16195","50112","2019",4,4,0,80000,1046.5,89
"16196","50115","2019",2,2,0,131500,1541,85
"16197","50117","2019",13,10,3,177115.384615385,2089.46153846154,88
"16198","50118","2019",6,6,0,351883.333333333,3163.5,106.166666666667
"16199","50120","2019",3,3,0,160833.333333333,1009.33333333333,157.333333333333
"16200","50121","2019",6,6,0,137581.666666667,1185.5,115.666666666667
"16201","50124","2019",3,3,0,78333.3333333333,809.333333333333,96.6666666666667
"16202","50126","2019",2,2,0,117250,1587,75.5
"16203","50129","2019",1012,662,350,142935.537549407,1750.11561264822,83.7262845849802
"16204","50130","2019",14,14,0,125050,1346.21428571429,99.2857142857143
"16205","50135","2019",4,4,0,191750,1780.25,111.5
"16206","50137","2019",9,9,0,145026.666666667,1085.44444444444,131.666666666667
"16207","50138","2019",3,3,0,85000,1196,72
"16208","50139","2019",36,36,0,134079.722222222,1431.55555555556,97.6111111111111
"16209","50142","2019",18,18,0,141969.166666667,1548.16666666667,106.666666666667
"16210","50143","2019",6,6,0,153166.666666667,1525.33333333333,93
"16211","50144","2019",11,11,0,58000,971.727272727273,62.5454545454545
"16212","50145","2019",7,7,0,144228.571428571,1093.71428571429,131.857142857143
"16213","50146","2019",3,3,0,145000,1281.66666666667,111.666666666667
"16214","50147","2019",108,67,41,116201.185185185,1385.06481481481,85.0462962962963
"16215","50148","2019",14,14,0,129889.357142857,1053.85714285714,127.428571428571
"16216","50149","2019",9,9,0,202000,1760.88888888889,117.222222222222
"16217","50150","2019",4,4,0,92500,1216.75,83.5
"16218","50151","2019",22,20,2,117126.545454545,1505.18181818182,78.2727272727273
"16219","50152","2019",4,4,0,79375,798.5,98.25
"16220","50155","2019",1,1,0,75000,743,101
"16221","50158","2019",10,10,0,82257.7,869.8,96.6
"16222","50159","2019",9,9,0,112611.111111111,1296.33333333333,99.4444444444444
"16223","50161","2019",6,6,0,130525,1128.16666666667,117.5
"16224","50162","2019",19,18,1,206873.684210526,1891.52631578947,115.210526315789
"16225","50164","2019",15,15,0,111646.6,1056.66666666667,107.933333333333
"16226","50165","2019",78,41,37,192128.128205128,2568.38461538462,75.2564102564103
"16227","50166","2019",2,2,0,85000,984,92.5
"16228","50167","2019",12,12,0,127583.333333333,1943.75,75.75
"16229","50168","2019",35,34,1,117930.2,1330.65714285714,90.0285714285714
"16230","50169","2019",1,1,0,23000,767,30
"16231","50172","2019",4,4,0,142143.75,1586.75,94
"16232","50174","2019",4,4,0,129087,1647.25,83.25
"16233","50175","2019",4,4,0,117100,995.25,120.25
"16234","50176","2019",3,3,0,114666.666666667,1207.66666666667,103.333333333333
"16235","50177","2019",3,3,0,152700,1983.66666666667,80
"16236","50178","2019",27,27,0,158518.518518519,1702.40740740741,98.3703703703704
"16237","50181","2019",3,3,0,95666.6666666667,1023.33333333333,89.3333333333333
"16238","50182","2019",7,7,0,119371.428571429,1080.28571428571,106.571428571429
"16239","50183","2019",6,6,0,91770,1051.83333333333,98.6666666666667
"16240","50184","2019",20,20,0,128892,1632.8,84.85
"16241","50185","2019",13,13,0,150662,2064.30769230769,93.4615384615385
"16242","50186","2019",1,1,0,2e+05,1681,119
"16243","50188","2019",18,18,0,128904.722222222,1374.27777777778,97.5
"16244","50190","2019",2,2,0,147025,1326.5,107
"16245","50192","2019",2,2,0,105000,786.5,129
"16246","50193","2019",3,3,0,71808.3333333333,724.666666666667,91.6666666666667
"16247","50194","2019",12,12,0,97416.6666666667,1137.58333333333,95.25
"16248","50195","2019",8,8,0,90556.25,1070,86.875
"16249","50196","2019",12,12,0,189104.166666667,1891.33333333333,97.5833333333333
"16250","50197","2019",33,33,0,106391.666666667,1336.21212121212,85.969696969697
"16251","50198","2019",2,2,0,116000,1973.5,59
"16252","50199","2019",13,13,0,180323.076923077,1839.15384615385,105
"16253","50200","2019",15,15,0,80893.3333333333,977.6,89.4
"16254","50205","2019",2,2,0,110000,1443.5,76.5
"16255","50207","2019",1,1,0,141000,922,153
"16256","50208","2019",4,4,0,148000,1122,124.75
"16257","50209","2019",26,26,0,156914.615384615,1607.11538461538,100.615384615385
"16258","50210","2019",5,5,0,99000,1356.6,77
"16259","50214","2019",6,6,0,107334.333333333,936.333333333333,111.666666666667
"16260","50215","2019",60,60,0,179861.5,1769.83333333333,104.7
"16261","50216","2019",8,8,0,102527.5,901.875,132.875
"16262","50217","2019",8,8,0,100998.75,1301.5,80
"16263","50218","2019",394,150,244,178956.423857868,2754.54822335025,67.2994923857868
"16264","50219","2019",7,7,0,144857.142857143,1597.85714285714,91.5714285714286
"16265","50221","2019",3,3,0,68333.3333333333,1126.66666666667,68.3333333333333
"16266","50222","2019",1,1,0,280000,3636,77
"16267","50225","2019",3,3,0,100046.666666667,965.333333333333,95.3333333333333
"16268","50227","2019",2,2,0,96500,1066,91.5
"16269","50228","2019",24,24,0,96368.125,1043.83333333333,93.0416666666667
"16270","50229","2019",2,2,0,105985,1077.5,100.5
"16271","50230","2019",5,5,0,186441,1883,100.8
"16272","50231","2019",27,25,2,175725.925925926,2378.44444444444,80.8518518518518
"16273","50232","2019",4,4,0,103750,828.75,129.75
"16274","50233","2019",1,1,0,171000,1727,99
"16275","50235","2019",3,3,0,133666.666666667,1505,86
"16276","50236","2019",69,66,3,133144.782608696,1508.44927536232,92.9275362318841
"16277","50237","2019",25,25,0,126878,1479.68,90.48
"16278","50238","2019",5,5,0,153700,1531.6,98
"16279","50239","2019",12,12,0,135533.333333333,1229.91666666667,110.583333333333
"16280","50240","2019",5,5,0,205160,1792.8,116.8
"16281","50241","2019",4,4,0,166250,1365,128.75
"16282","50243","2019",8,8,0,214312.5,1924.875,118.75
"16283","50246","2019",1,1,0,550000,2140,257
"16284","50247","2019",1,1,0,185000,2126,87
"16285","50251","2019",6,6,0,188075,1690,114.666666666667
"16286","50252","2019",20,20,0,159177.4,1647,100.05
"16287","50253","2019",6,6,0,126998.333333333,1440.83333333333,94.5
"16288","50256","2019",44,44,0,114030.136363636,1203.90909090909,98.8863636363636
"16289","50258","2019",1,1,0,166000,1908,87
"16290","50259","2019",8,8,0,102416.5,1021.75,97.625
"16291","50260","2019",23,23,0,80867.6086956522,1059.86956521739,81.4782608695652
"16292","50261","2019",1,1,0,44600,892,50
"16293","50262","2019",11,11,0,119590.909090909,1146,103.636363636364
"16294","50263","2019",3,3,0,108333.333333333,1282.66666666667,82.6666666666667
"16295","50265","2019",3,3,0,167233.333333333,1084.33333333333,147.333333333333
"16296","50266","2019",11,11,0,119090.909090909,1293.54545454545,90.0909090909091
"16297","50267","2019",31,31,0,119540.322580645,1284.09677419355,90.4838709677419
"16298","50268","2019",4,4,0,117875,1531.25,79.75
"16299","50269","2019",5,5,0,151400,1545.2,100.2
"16300","50270","2019",4,4,0,154000,1597,97.75
"16301","50272","2019",17,17,0,179405.882352941,1769.52941176471,106.941176470588
"16302","50273","2019",21,21,0,90061.9047619048,862.190476190476,105
"16303","50274","2019",7,7,0,103269.285714286,1117.85714285714,93.4285714285714
"16304","50275","2019",4,4,0,62500,861.25,70.75
"16305","50276","2019",9,9,0,125611.111111111,1457.77777777778,93
"16306","50277","2019",8,8,0,194480,1675.125,107.75
"16307","50278","2019",3,3,0,117166.666666667,1109.33333333333,96.3333333333333
"16308","50279","2019",7,7,0,179157.142857143,1336.71428571429,135.428571428571
"16309","50281","2019",9,9,0,84055.5555555556,1008.66666666667,85.3333333333333
"16310","50282","2019",2,2,0,95500,1142,81.5
"16311","50283","2019",1,1,0,115000,1045,110
"16312","50285","2019",6,6,0,138250,972.333333333333,136.833333333333
"16313","50288","2019",10,10,0,183125,1880.4,99.4
"16314","50289","2019",10,10,0,132755,1210.9,116.4
"16315","50290","2019",6,6,0,82750,817.166666666667,95.3333333333333
"16316","50291","2019",2,2,0,95314.5,1156,84
"16317","50292","2019",30,30,0,121174.6,1119.63333333333,107.233333333333
"16318","50294","2019",19,19,0,187263.157894737,1987.15789473684,103.210526315789
"16319","50295","2019",3,3,0,104433.333333333,820.666666666667,114.333333333333
"16320","50296","2019",2,2,0,292500,2218,131
"16321","50297","2019",17,17,0,128352.941176471,1083.41176470588,121.882352941176
"16322","50298","2019",6,6,0,181350,1245,155.5
"16323","50299","2019",1,1,0,70000,583,120
"16324","50300","2019",4,4,0,49250,594,85.25
"16325","50302","2019",4,4,0,166500,1360,121.5
"16326","50304","2019",2,2,0,154000,1626,94.5
"16327","50305","2019",6,6,0,196316.666666667,2065,96.6666666666667
"16328","50311","2019",8,8,0,153250,1248.25,126.75
"16329","50312","2019",6,6,0,46500,863,56
"16330","50315","2019",3,3,0,71366.6666666667,1120.66666666667,62.3333333333333
"16331","50317","2019",4,4,0,92375,936.5,101.75
"16332","50321","2019",6,6,0,189400,1310.5,134
"16333","50326","2019",4,4,0,119500,1150.5,103.5
"16334","50327","2019",1,1,0,180000,1364,132
"16335","50328","2019",13,13,0,105536.153846154,1174.38461538462,90.7692307692308
"16336","50332","2019",8,8,0,147784.375,1608.375,91
"16337","50334","2019",3,3,0,73666.6666666667,796.333333333333,88.3333333333333
"16338","50335","2019",9,9,0,134666.666666667,1404.22222222222,106.777777777778
"16339","50336","2019",4,4,0,141200,1509,90.5
"16340","50338","2019",3,3,0,95596.3333333333,1207.33333333333,78.3333333333333
"16341","50340","2019",1,1,0,92000,968,95
"16342","50341","2019",20,19,1,123420,1393.2,96.35
"16343","50342","2019",10,10,0,151900,1571.8,96.3
"16344","50345","2019",7,7,0,117571.428571429,1055.85714285714,107
"16345","50347","2019",4,4,0,71950,882.5,94.5
"16346","50349","2019",29,28,1,179457.655172414,1754.44827586207,107.034482758621
"16347","50350","2019",11,11,0,99765.9090909091,952.636363636364,118.909090909091
"16348","50351","2019",2,2,0,138000,1266,109.5
"16349","50352","2019",7,7,0,116142.857142857,1317.71428571429,91.2857142857143
"16350","50356","2019",13,13,0,98330.7692307692,945.307692307692,103.615384615385
"16351","50359","2019",41,36,5,97510.9756097561,895.146341463415,109.634146341463
"16352","50360","2019",4,4,0,147000,1659,95.25
"16353","50362","2019",2,2,0,111000,1036,106.5
"16354","50363","2019",16,16,0,106484.375,1045.625,97.875
"16355","50364","2019",11,11,0,92215.8181818182,1260,71.3636363636364
"16356","50365","2019",7,7,0,183578.571428571,1471.57142857143,122.428571428571
"16357","50368","2019",3,3,0,301979,3743.33333333333,102.666666666667
"16358","50369","2019",10,10,0,164715.5,1801.3,96.4
"16359","50370","2019",11,11,0,99936.3636363636,1301.18181818182,85.7272727272727
"16360","50371","2019",5,5,0,81492,972.4,83.8
"16361","50372","2019",4,4,0,105500,817.5,122
"16362","50373","2019",1,1,0,132000,1941,68
"16363","50374","2019",1,1,0,115000,1691,68
"16364","50376","2019",6,6,0,121116.666666667,1340.33333333333,89.6666666666667
"16365","50378","2019",5,5,0,100880,1247,80.6
"16366","50379","2019",5,5,0,139560,1054.2,128.4
"16367","50382","2019",4,4,0,136450,1468.75,88
"16368","50387","2019",8,8,0,123088.375,1342.875,88.75
"16369","50388","2019",15,15,0,124104.6,1241.2,106.733333333333
"16370","50389","2019",9,9,0,123477.777777778,1180.77777777778,109.555555555556
"16371","50390","2019",1,1,0,185500,1072,173
"16372","50391","2019",37,34,3,100975.756756757,1127.10810810811,89.5405405405405
"16373","50393","2019",34,34,0,113234.176470588,1020.26470588235,108.470588235294
"16374","50394","2019",31,28,3,90888.7096774193,1096.48387096774,88.8709677419355
"16375","50395","2019",5,5,0,130280,1282,111.8
"16376","50397","2019",7,7,0,135121.428571429,1409.28571428571,103.857142857143
"16377","50400","2019",52,52,0,109966.673076923,1237.32692307692,93
"16378","50401","2019",14,14,0,164292.142857143,1612.57142857143,99.7857142857143
"16379","50402","2019",36,35,1,220267,2314.19444444444,98.5
"16380","50403","2019",44,43,1,150220.454545455,2035.56818181818,76.0227272727273
"16381","50405","2019",3,3,0,83500,1092.33333333333,82.6666666666667
"16382","50407","2019",9,9,0,103486,1257,81.6666666666667
"16383","50408","2019",8,8,0,100109.625,1181.875,82
"16384","50409","2019",34,29,5,105288.529411765,1053.73529411765,99.2352941176471
"16385","50410","2019",73,67,6,105199.246575342,1114.2602739726,95.2739726027397
"16386","50411","2019",2,2,0,213500,1925,112.5
"16387","50412","2019",65,65,0,170903.230769231,2080.64615384615,85.6461538461539
"16388","50413","2019",9,9,0,121521.555555556,1125.77777777778,102.777777777778
"16389","50417","2019",26,25,1,164082.692307692,1744.38461538462,91.3461538461538
"16390","50419","2019",33,33,0,133803.03030303,1290.54545454545,109.969696969697
"16391","50420","2019",12,12,0,135166.666666667,1140.33333333333,128.666666666667
"16392","50421","2019",12,12,0,170866.666666667,2254.16666666667,82.6666666666667
"16393","50422","2019",5,5,0,164200,1327.4,121.2
"16394","50423","2019",2,2,0,219000,1200,181
"16395","50425","2019",10,10,0,180385,1557.9,124.9
"16396","50426","2019",5,5,0,125200,1064.6,120.8
"16397","50428","2019",7,7,0,101557.142857143,970.571428571429,107.857142857143
"16398","50429","2019",14,14,0,252571.428571429,2214.85714285714,113.714285714286
"16399","50431","2019",14,14,0,75214.2857142857,810.714285714286,94.3571428571429
"16400","50433","2019",26,24,2,182111.269230769,2072.34615384615,87.1538461538462
"16401","50435","2019",6,6,0,174928.333333333,1555,111.833333333333
"16402","50436","2019",17,17,0,117255.882352941,1623.58823529412,85.2941176470588
"16403","50437","2019",16,16,0,95670.75,959.3125,111.875
"16404","50442","2019",4,4,0,152375,2233.5,71
"16405","50443","2019",3,3,0,106166.666666667,1562.66666666667,75.3333333333333
"16406","50444","2019",27,27,0,141959.555555556,1216.14814814815,116.888888888889
"16407","50445","2019",6,6,0,118166.666666667,833.5,141.833333333333
"16408","50446","2019",3,3,0,231166.666666667,2066.33333333333,116
"16409","50447","2019",8,8,0,229861,1906,118.875
"16410","50448","2019",9,9,0,107025,1468.66666666667,73
"16411","50450","2019",2,2,0,89000,792,110.5
"16412","50451","2019",3,3,0,179666.666666667,1137.66666666667,153
"16413","50452","2019",6,6,0,110600,1062.83333333333,112.5
"16414","50453","2019",13,13,0,130692.307692308,1224.61538461538,107.846153846154
"16415","50454","2019",5,5,0,175000,2071,91.8
"16416","50455","2019",7,7,0,116428.571428571,1432.57142857143,79.8571428571429
"16417","50456","2019",11,11,0,90536.3636363636,876.181818181818,102.272727272727
"16418","50457","2019",4,4,0,149750,1270.5,116
"16419","50461","2019",4,4,0,124000,1189.5,108.5
"16420","50462","2019",6,6,0,74208.3333333333,754.333333333333,88.8333333333333
"16421","50463","2019",11,11,0,151290.909090909,1482.90909090909,98.1818181818182
"16422","50464","2019",11,11,0,103299.090909091,1135.72727272727,94.7272727272727
"16423","50467","2019",6,6,0,185475,1593.83333333333,114.5
"16424","50468","2019",7,7,0,98146.5714285714,1032,98
"16425","50471","2019",7,7,0,130142.857142857,1511.85714285714,85.7142857142857
"16426","50472","2019",2,2,0,131500,1455,90.5
"16427","50473","2019",2,2,0,77500,899,87
"16428","50474","2019",9,9,0,66501.1111111111,820.777777777778,81.2222222222222
"16429","50475","2019",17,17,0,155125.823529412,1549.52941176471,98.2352941176471
"16430","50476","2019",1,1,0,90000,703,128
"16431","50478","2019",6,6,0,124466.666666667,1016,120.166666666667
"16432","50479","2019",2,2,0,121250,873.5,137
"16433","50480","2019",15,15,0,179384.866666667,1775.86666666667,105.066666666667
"16434","50481","2019",41,41,0,158297.56097561,2039.9512195122,84.4390243902439
"16435","50482","2019",1,1,0,60000,1111,54
"16436","50483","2019",9,9,0,149522.222222222,1293.22222222222,115.111111111111
"16437","50484","2019",67,63,4,105352.731343284,1135.10447761194,92.5671641791045
"16438","50486","2019",12,12,0,96133.3333333333,1247.91666666667,77.0833333333333
"16439","50487","2019",59,57,2,106466.93220339,1086.96610169492,100.186440677966
"16440","50488","2019",8,8,0,122812.5,1208.125,113.375
"16441","50489","2019",9,9,0,112005.555555556,1308.22222222222,92.7777777777778
"16442","50490","2019",6,5,1,222796.666666667,2320.66666666667,109.666666666667
"16443","50491","2019",4,4,0,129875,1363.5,98
"16444","50492","2019",31,31,0,132762.903225806,1361.58064516129,99.3225806451613
"16445","50493","2019",27,27,0,176262.962962963,1880.62962962963,99.5925925925926
"16446","50495","2019",1,1,0,178000,1369,130
"16447","50496","2019",15,13,2,152340,1669.6,102.8
"16448","50498","2019",5,5,0,121200,1733.4,75.2
"16449","50499","2019",7,7,0,87285.7142857143,937.285714285714,93
"16450","50500","2019",3,3,0,39000,523.666666666667,81.6666666666667
"16451","50502","2019",271,152,119,113748.597785978,1356.67896678967,82.0885608856089
"16452","50504","2019",4,4,0,127625,1126.5,113.25
"16453","50505","2019",6,6,0,188985,1444.66666666667,129.666666666667
"16454","50506","2019",10,10,0,168395,1743.6,102.2
"16455","50507","2019",13,13,0,161330.769230769,1852.61538461538,98.6923076923077
"16456","50509","2019",8,8,0,120687.5,1188.125,105.875
"16457","50510","2019",4,4,0,78750,951,80.25
"16458","50511","2019",2,2,0,154000,1297,127.5
"16459","50512","2019",6,6,0,160033.333333333,1526.83333333333,109.333333333333
"16460","50514","2019",3,3,0,70833.3333333333,934.333333333333,69
"16461","50517","2019",4,4,0,265375,2430.75,104.75
"16462","50518","2019",1,1,0,30000,1071,28
"16463","50519","2019",6,6,0,191850,1638.66666666667,122
"16464","50521","2019",2,2,0,47000,659.5,69
"16465","50522","2019",1,1,0,112500,1324,85
"16466","50523","2019",39,37,2,119033.846153846,1473.48717948718,87.4102564102564
"16467","50525","2019",5,5,0,77800,826.4,81.6
"16468","50528","2019",8,8,0,126682.875,1206.625,100.25
"16469","50529","2019",2,2,0,98250,1015,97.5
"16470","50531","2019",15,15,0,100561.266666667,1053.4,95.7333333333333
"16471","50532","2019",107,80,27,193654.560747664,2821.34579439252,73.0747663551402
"16472","50533","2019",5,5,0,127000,1192.6,106
"16473","50535","2019",18,18,0,124972.222222222,1298.33333333333,99.7777777777778
"16474","50537","2019",4,4,0,191750,1806.25,107
"16475","50538","2019",6,6,0,187716.666666667,1608,116.666666666667
"16476","50539","2019",23,23,0,135800,1479,99.8695652173913
"16477","50540","2019",7,7,0,209428.571428571,1919.71428571429,107.285714285714
"16478","50541","2019",23,23,0,197560.869565217,1951.26086956522,104.434782608696
"16479","50542","2019",8,8,0,133125,1215.375,98.5
"16480","50543","2019",15,15,0,129595,1451.6,89.3333333333333
"16481","50546","2019",38,38,0,126758.105263158,1096.52631578947,115.789473684211
"16482","50548","2019",3,3,0,76666.6666666667,1022.66666666667,76.3333333333333
"16483","50549","2019",8,8,0,167150,1726.75,100
"16484","50550","2019",43,43,0,105727.906976744,1138.58139534884,91.0232558139535
"16485","50551","2019",28,28,0,126116.071428571,1325.39285714286,98.2142857142857
"16486","50552","2019",4,4,0,93500,1110.25,82
"16487","50553","2019",4,4,0,97000,1083,87.75
"16488","50554","2019",19,19,0,184534.473684211,1773.10526315789,104.315789473684
"16489","50556","2019",9,9,0,155444.444444444,1456.44444444444,111
"16490","50562","2019",47,42,5,164237.957446809,1897.46808510638,87.5744680851064
"16491","50563","2019",4,4,0,84875,836.25,87.25
"16492","50564","2019",17,17,0,103670.588235294,1027.47058823529,101.882352941176
"16493","50565","2019",23,22,1,201508.695652174,2096.86956521739,101.913043478261
"16494","50567","2019",7,7,0,126857.142857143,1476.28571428571,89
"16495","50568","2019",6,6,0,89833.3333333333,1174.5,88.8333333333333
"16496","50569","2019",4,4,0,122500,1264.25,88.75
"16497","50570","2019",7,7,0,79268.5714285714,901.142857142857,88
"16498","50572","2019",4,4,0,143375,1605,88.5
"16499","50574","2019",3,3,0,76000,877.666666666667,88.6666666666667
"16500","50575","2019",9,9,0,196366.666666667,1754.66666666667,114.777777777778
"16501","50576","2019",16,14,2,148558.75,1848.25,84
"16502","50577","2019",9,9,0,114333.333333333,1284.11111111111,96.7777777777778
"16503","50578","2019",1,1,0,122000,1470,83
"16504","50579","2019",16,16,0,175625,1690.25,107.875
"16505","50580","2019",3,3,0,144666.666666667,1562,94
"16506","50582","2019",42,41,1,82205,917.761904761905,87.5952380952381
"16507","50584","2019",7,7,0,170728.571428571,1799.14285714286,87.2857142857143
"16508","50585","2019",15,15,0,135080,1875.46666666667,77.4
"16509","50588","2019",10,10,0,170574.4,1811.5,94.4
"16510","50589","2019",3,3,0,81333.3333333333,967.666666666667,82.6666666666667
"16511","50590","2019",4,4,0,184250,2058.5,116
"16512","50591","2019",22,22,0,66629.5454545455,796.5,79.5454545454545
"16513","50592","2019",17,16,1,90010.8823529412,948.352941176471,97.7058823529412
"16514","50593","2019",4,4,0,122750,1089.5,115.5
"16515","50594","2019",8,8,0,199596.875,1956.375,104.5
"16516","50596","2019",5,5,0,116000,1176.2,109.4
"16517","50597","2019",11,11,0,138818.181818182,1423.36363636364,97.3636363636364
"16518","50598","2019",5,5,0,136000,1350.6,95.2
"16519","50599","2019",12,12,0,216490.833333333,2084,103.083333333333
"16520","50601","2019",43,43,0,125001.976744186,1217.48837209302,110.093023255814
"16521","50603","2019",10,9,1,138620,1647.5,89.8
"16522","50604","2019",7,7,0,185142.857142857,1991.42857142857,97.5714285714286
"16523","50606","2019",9,9,0,124250,1145,108.333333333333
"16524","50607","2019",6,6,0,99100,1045.16666666667,92.3333333333333
"16525","50609","2019",1,1,0,127000,1165,109
"16526","50612","2019",18,18,0,166432.5,2076.94444444444,97.8333333333333
"16527","50613","2019",9,9,0,126805.555555556,1444.22222222222,96.5555555555556
"16528","50615","2019",98,85,13,150640.142857143,1711.75510204082,94.1122448979592
"16529","50616","2019",26,26,0,191478.846153846,1805.07692307692,106.384615384615
"16530","50617","2019",4,4,0,79750,1082,80.5
"16531","50618","2019",2,2,0,2e+05,1696.5,126.5
"16532","50619","2019",7,7,0,100071.428571429,1263,79.8571428571429
"16533","50621","2019",2,2,0,103500,1406,73.5
"16534","50624","2019",4,4,0,162750,1763,92
"16535","50626","2019",6,6,0,234266.666666667,1996.16666666667,98.1666666666667
"16536","50628","2019",1,1,0,128000,1855,69
"16537","50629","2019",13,13,0,94192.3076923077,1150.69230769231,79.3076923076923
"16538","50633","2019",2,2,0,167500,1570.5,107
"16539","50634","2019",1,1,0,282000,865,326
"16540","50637","2019",7,7,0,82648.5714285714,866,91.1428571428571
"16541","50639","2019",62,52,10,102123.483870968,1346.87096774194,81.1129032258064
"16542","50641","2019",3,3,0,155000,1240.66666666667,126.666666666667
"16543","50643","2019",8,8,0,174811.25,1819.625,102.375
"16544","50647","2019",20,20,0,209843.5,2026.4,107.6
"16545","50648","2019",16,16,0,146100.625,1402.0625,108.125
"16546","51001","2019",1,1,0,175100,1621,108
"16547","51002","2019",16,16,0,144458.125,1332.6875,104.3125
"16548","51003","2019",5,5,0,173160,1936.6,92.6
"16549","51005","2019",3,3,0,116833.333333333,1522.66666666667,77
"16550","51007","2019",12,12,0,170495.833333333,1691.41666666667,111.75
"16551","51008","2019",7,7,0,156371.428571429,1300.85714285714,121.714285714286
"16552","51009","2019",7,7,0,106821.428571429,1246.42857142857,91.1428571428571
"16553","51010","2019",2,2,0,94995,744,127
"16554","51012","2019",1,1,0,156000,1228,127
"16555","51014","2019",4,4,0,184250,1457.25,129.75
"16556","51015","2019",1,1,0,117000,696,168
"16557","51016","2019",6,6,0,81250,865.5,82.6666666666667
"16558","51018","2019",9,9,0,149970,1638.11111111111,98.3333333333333
"16559","51019","2019",2,2,0,185600,1657.5,112.5
"16560","51022","2019",2,2,0,197700,1766.5,114
"16561","51023","2019",4,4,0,87750,1167.5,76
"16562","51025","2019",12,12,0,185760.416666667,1914.16666666667,96.8333333333333
"16563","51027","2019",4,4,0,136750,1087.5,121.75
"16564","51028","2019",12,11,1,128287.5,1376.91666666667,90.5833333333333
"16565","51029","2019",17,17,0,173453.411764706,1596.52941176471,109.294117647059
"16566","51030","2019",48,44,4,172179.833333333,2018.22916666667,93.9375
"16567","51031","2019",1,1,0,235850,2509,94
"16568","51032","2019",6,6,0,104966.666666667,1142.66666666667,99.8333333333333
"16569","51033","2019",5,5,0,97200,991.4,98.4
"16570","51035","2019",2,2,0,109450,1293,85
"16571","51036","2019",7,7,0,91857.1428571429,1016.28571428571,83.4285714285714
"16572","51037","2019",4,4,0,141325,1145,113.25
"16573","51038","2019",2,2,0,78744,924.5,110
"16574","51039","2019",1,1,0,234000,1560,150
"16575","51040","2019",1,1,0,291700,1458,200
"16576","51041","2019",2,2,0,125400,637,184
"16577","51042","2019",4,4,0,62247.5,847.75,70.25
"16578","51043","2019",23,23,0,182879.130434783,1921.5652173913,100.217391304348
"16579","51044","2019",8,8,0,270587.5,2073.125,132.5
"16580","51045","2019",2,2,0,63750,715,81.5
"16581","51046","2019",7,7,0,219000,1916.14285714286,120.428571428571
"16582","51048","2019",1,1,0,275000,3819,72
"16583","51049","2019",7,7,0,225967.142857143,1479.28571428571,156.714285714286
"16584","51050","2019",3,3,0,43166.6666666667,1061.66666666667,39.6666666666667
"16585","51051","2019",1,1,0,158000,2257,70
"16586","51052","2019",5,5,0,276019,2429.2,119.4
"16587","51053","2019",1,1,0,60000,536,112
"16588","51054","2019",15,15,0,152980.666666667,1274.6,133.733333333333
"16589","51055","2019",84,65,19,197954.226190476,2128.46428571429,93.9285714285714
"16590","51056","2019",5,5,0,87600,907,119.4
"16591","51057","2019",1,1,0,206500,1465,141
"16592","51058","2019",26,18,8,333690.730769231,2815.96153846154,120.615384615385
"16593","51059","2019",3,3,0,81900,1033.33333333333,86.3333333333333
"16594","51060","2019",4,4,0,146200,1174,128.25
"16595","51061","2019",1,1,0,213605,1751,122
"16596","51062","2019",1,1,0,61000,513,119
"16597","51063","2019",2,2,0,103750,696.5,125
"16598","51065","2019",8,8,0,106525,1201.625,87.75
"16599","51066","2019",3,3,0,98966.6666666667,1348.66666666667,73.6666666666667
"16600","51068","2019",1,1,0,101000,1031,98
"16601","51069","2019",1,1,0,214000,1476,145
"16602","51070","2019",2,2,0,92500,1529,61
"16603","51071","2019",5,5,0,144340,1627.8,92.8
"16604","51072","2019",2,2,0,185750,1441.5,118
"16605","51073","2019",4,4,0,180500,2016.75,106
"16606","51074","2019",20,18,2,178029.5,1803.6,101.6
"16607","51075","2019",15,15,0,231640,1859.53333333333,127.266666666667
"16608","51076","2019",5,5,0,141900,1575,89.6
"16609","51077","2019",6,6,0,231466.666666667,1433.5,172
"16610","51078","2019",2,2,0,184000,1707,106.5
"16611","51079","2019",9,9,0,158127.777777778,1614.11111111111,102.888888888889
"16612","51081","2019",6,6,0,248515.666666667,2466.33333333333,104.666666666667
"16613","51082","2019",1,1,0,198000,1868,106
"16614","51083","2019",2,2,0,124500,1391.5,84.5
"16615","51084","2019",1,1,0,35000,614,57
"16616","51085","2019",3,3,0,108666.666666667,1198,90.3333333333333
"16617","51086","2019",2,2,0,164675,1452,110.5
"16618","51087","2019",2,2,0,178377.5,1498,121.5
"16619","51088","2019",8,8,0,290712.5,2290.5,129.125
"16620","51089","2019",2,2,0,180500,1504,120
"16621","51090","2019",5,5,0,124880,1017.6,123.8
"16622","51091","2019",2,2,0,86500,583,150.5
"16623","51092","2019",3,3,0,107666.666666667,1068.66666666667,104.333333333333
"16624","51093","2019",4,4,0,243362.5,2212.25,116.5
"16625","51094","2019",4,4,0,104875,969.75,126.5
"16626","51097","2019",2,2,0,98200,1184,81.5
"16627","51098","2019",1,1,0,30000,500,60
"16628","51099","2019",2,2,0,158565,1455,111.5
"16629","51100","2019",2,2,0,91000,1206,75
"16630","51101","2019",5,5,0,256600,2145.8,125
"16631","51102","2019",4,4,0,231555.25,2437.75,122.75
"16632","51103","2019",1,1,0,105000,1346,78
"16633","51104","2019",1,1,0,70000,875,80
"16634","51105","2019",8,8,0,262102.5,2167.25,122.625
"16635","51106","2019",1,1,0,95500,723,132
"16636","51107","2019",6,6,0,184991.666666667,1425.66666666667,129.5
"16637","51108","2019",518,227,291,116220.613899614,1417.7528957529,82.3783783783784
"16638","51109","2019",3,3,0,285733.333333333,1939.33333333333,154.666666666667
"16639","51111","2019",3,3,0,222666.666666667,1536.66666666667,147.333333333333
"16640","51112","2019",2,2,0,341500,2193.5,168
"16641","51115","2019",5,5,0,334417.4,2353.8,149.4
"16642","51116","2019",5,5,0,106400,1252.2,84.2
"16643","51118","2019",17,17,0,411077.058823529,2590.70588235294,155.823529411765
"16644","51119","2019",4,4,0,272500,2526.75,114.5
"16645","51121","2019",3,3,0,179000,1703,95.6666666666667
"16646","51122","2019",1,1,0,140000,1284,109
"16647","51124","2019",1,1,0,2e+05,1000,200
"16648","51125","2019",2,2,0,145475,1013.5,144.5
"16649","51127","2019",1,1,0,138000,1200,115
"16650","51128","2019",1,1,0,140000,1707,82
"16651","51129","2019",5,5,0,113400,1260.6,89.8
"16652","51130","2019",7,7,0,74081.4285714286,806.571428571429,90.4285714285714
"16653","51132","2019",3,3,0,68666.6666666667,807.333333333333,87
"16654","51133","2019",1,1,0,95000,633,150
"16655","51134","2019",2,2,0,189500,1977.5,108
"16656","51136","2019",11,10,1,139772.727272727,1360.27272727273,104.818181818182
"16657","51137","2019",3,3,0,127533.333333333,1518.33333333333,106.666666666667
"16658","51139","2019",1,1,0,174700,1197,146
"16659","51140","2019",3,3,0,197333.333333333,1728.66666666667,116.333333333333
"16660","51141","2019",12,12,0,104836.083333333,1067.91666666667,103.416666666667
"16661","51142","2019",2,2,0,105000,948.5,117.5
"16662","51144","2019",4,4,0,82000,760.5,106.25
"16663","51145","2019",2,2,0,386000,1833.5,172.5
"16664","51146","2019",1,1,0,164900,1472,112
"16665","51147","2019",5,5,0,138019.6,1226.8,118
"16666","51148","2019",1,1,0,137000,1079,127
"16667","51149","2019",8,8,0,186031.625,1473.75,128.125
"16668","51150","2019",2,2,0,150000,1488.5,95
"16669","51151","2019",3,3,0,187400,1491.66666666667,135.666666666667
"16670","51152","2019",8,8,0,267250,1795.25,144.875
"16671","51153","2019",10,10,0,180900,1565.3,115
"16672","51154","2019",1,1,0,88000,765,115
"16673","51155","2019",5,5,0,94192.4,1253.4,90.4
"16674","51158","2019",2,2,0,159500,1545.5,103
"16675","51160","2019",13,13,0,140453,1461.15384615385,96.3846153846154
"16676","51161","2019",6,6,0,130400,1316.33333333333,106
"16677","51162","2019",7,7,0,85571.4285714286,1119,78.4285714285714
"16678","51163","2019",7,7,0,132785.714285714,1353,102.428571428571
"16679","51164","2019",3,3,0,151000,1087.33333333333,138.666666666667
"16680","51165","2019",7,7,0,121678.571428571,1165.57142857143,112.714285714286
"16681","51166","2019",1,1,0,40000,800,50
"16682","51167","2019",1,1,0,80000,1000,80
"16683","51168","2019",2,2,0,182000,1183.5,151.5
"16684","51169","2019",1,1,0,105000,1167,90
"16685","51170","2019",1,1,0,70000,875,80
"16686","51171","2019",14,14,0,212979.285714286,1996.85714285714,110.285714285714
"16687","51172","2019",81,61,20,246908.62962963,2695.24691358025,94.9506172839506
"16688","51174","2019",3,3,0,1003333.33333333,4870.33333333333,180.333333333333
"16689","51175","2019",2,2,0,189575,1656,124
"16690","51176","2019",1,1,0,106000,546,194
"16691","51178","2019",2,2,0,160500,945.5,169.5
"16692","51179","2019",3,3,0,114322.333333333,1071.66666666667,103.333333333333
"16693","51181","2019",4,4,0,329392.5,2281.75,140
"16694","51182","2019",1,1,0,30000,385,78
"16695","51183","2019",10,10,0,203539,1961.6,112.1
"16696","51184","2019",6,6,0,159358.333333333,1514.83333333333,108.666666666667
"16697","51185","2019",2,2,0,161500,1224.5,136.5
"16698","51187","2019",2,2,0,131000,1341.5,101.5
"16699","51192","2019",5,5,0,125200,1612.6,78.8
"16700","51193","2019",27,26,1,186925.444444444,1572.37037037037,122.740740740741
"16701","51194","2019",8,8,0,159362.5,1442.375,119.5
"16702","51195","2019",9,9,0,131633.333333333,1296.66666666667,104.444444444444
"16703","51196","2019",3,3,0,141033.333333333,1312.66666666667,110.333333333333
"16704","51197","2019",1,1,0,150000,1515,99
"16705","51198","2019",9,9,0,164159.111111111,1586.33333333333,101.444444444444
"16706","51199","2019",5,5,0,115600,1391.8,79.2
"16707","51200","2019",6,6,0,165333.333333333,1505.83333333333,105.333333333333
"16708","51201","2019",1,1,0,137550,1677,82
"16709","51202","2019",13,10,3,135269.230769231,1591.46153846154,86.2307692307692
"16710","51203","2019",1,1,0,145000,1908,76
"16711","51204","2019",18,18,0,206883.333333333,1990.72222222222,109.055555555556
"16712","51205","2019",1,1,0,190000,1397,136
"16713","51206","2019",1,1,0,53500,569,94
"16714","51210","2019",18,14,4,171088.888888889,1806.33333333333,93.6111111111111
"16715","51211","2019",2,2,0,68500,905.5,85
"16716","51212","2019",4,4,0,134250,1046.75,131
"16717","51213","2019",2,2,0,87150,808,113.5
"16718","51214","2019",2,2,0,97409,803,121
"16719","51215","2019",1,1,0,150000,1304,115
"16720","51216","2019",3,3,0,155500,1605.33333333333,96.6666666666667
"16721","51217","2019",41,40,1,148192.682926829,1647.56097560976,92.5609756097561
"16722","51219","2019",3,3,0,139000,1146.33333333333,152
"16723","51222","2019",2,2,0,69250,860.5,87
"16724","51223","2019",2,2,0,128500,1303.5,99.5
"16725","51224","2019",1,1,0,75000,1154,65
"16726","51225","2019",4,4,0,210000,1569,125
"16727","51227","2019",1,1,0,290000,2197,132
"16728","51228","2019",1,1,0,70000,1400,50
"16729","51229","2019",1,1,0,1e+05,800,125
"16730","51230","2019",348,160,188,129918.985632184,1685.0316091954,76.4770114942529
"16731","51231","2019",3,3,0,219433.333333333,3554.66666666667,84.6666666666667
"16732","51234","2019",13,13,0,97065.3846153846,1148.23076923077,86.6153846153846
"16733","51235","2019",6,6,0,114686.666666667,1376.33333333333,84.5
"16734","51236","2019",4,4,0,85204,1126.5,79
"16735","51237","2019",14,14,0,113148.857142857,1530.28571428571,79.7142857142857
"16736","51238","2019",6,6,0,142483.333333333,1630.33333333333,88.3333333333333
"16737","51239","2019",1,1,0,119750,1261,95
"16738","51240","2019",2,2,0,129000,1054.5,121.5
"16739","51242","2019",41,34,7,140965.853658537,1452.73170731707,96.0487804878049
"16740","51243","2019",4,4,0,120500,1047.5,120
"16741","51244","2019",1,1,0,173000,1236,140
"16742","51245","2019",9,9,0,227611.111111111,1820.66666666667,132.666666666667
"16743","51246","2019",4,4,0,137450,919,150
"16744","51248","2019",30,28,2,136963.1,1513,102.533333333333
"16745","51249","2019",2,2,0,113500,1584.5,73
"16746","51250","2019",58,47,11,126734.775862069,1521.8275862069,82.2931034482759
"16747","51252","2019",4,4,0,144800,1517,101
"16748","51253","2019",3,3,0,49333.3333333333,662.666666666667,92
"16749","51254","2019",6,6,0,78416.6666666667,776.166666666667,95.1666666666667
"16750","51256","2019",4,4,0,271500,1942.75,136.75
"16751","51258","2019",1,1,0,87000,1208,72
"16752","51260","2019",1,1,0,197000,1187,166
"16753","51262","2019",23,23,0,141686.956521739,1355.65217391304,104.086956521739
"16754","51263","2019",5,5,0,126800,1140,117
"16755","51264","2019",12,12,0,111916.666666667,1323.08333333333,86.9166666666667
"16756","51265","2019",6,6,0,92000,1116,83
"16757","51266","2019",8,8,0,197750,1695.375,116.75
"16758","51267","2019",5,5,0,301300,2119.8,137.6
"16759","51268","2019",2,2,0,99250,436,240
"16760","51269","2019",8,8,0,122355,2319.25,57.5
"16761","51270","2019",2,2,0,85000,764,109
"16762","51272","2019",3,3,0,105000,1117.33333333333,95.6666666666667
"16763","51274","2019",1,1,0,40000,494,81
"16764","51275","2019",2,2,0,107500,1118.5,89
"16765","51276","2019",1,1,0,104500,1244,84
"16766","51277","2019",1,1,0,90000,1304,69
"16767","51278","2019",3,3,0,258195.666666667,1781.66666666667,147.333333333333
"16768","51279","2019",6,6,0,115333.333333333,1148,102.666666666667
"16769","51281","2019",9,9,0,202777.777777778,1821.77777777778,117.222222222222
"16770","51282","2019",19,19,0,372063.473684211,2647.68421052632,151.736842105263
"16771","51283","2019",3,3,0,125333.333333333,1251.66666666667,115
"16772","51284","2019",5,5,0,109636,1002.6,115.4
"16773","51285","2019",4,4,0,127750,1155,130
"16774","51286","2019",6,6,0,152421.666666667,1050.5,144.833333333333
"16775","51287","2019",8,8,0,198643.75,1710.75,113.625
"16776","51289","2019",5,5,0,73734,761.8,94.4
"16777","51290","2019",7,7,0,75857.1428571429,1004,78
"16778","51291","2019",16,16,0,259496.875,2256.5625,131.1875
"16779","51293","2019",6,6,0,164044.666666667,1778.5,94.5
"16780","51294","2019",2,2,0,155250,1205,128
"16781","51295","2019",2,2,0,115000,966,116.5
"16782","51298","2019",4,4,0,149000,1432,104.5
"16783","51299","2019",12,12,0,256916.666666667,1936.16666666667,135.083333333333
"16784","51303","2019",3,2,1,179733.333333333,1714.66666666667,103
"16785","51304","2019",3,3,0,131233.333333333,1168.66666666667,109
"16786","51305","2019",2,2,0,459500,2229.5,221
"16787","51306","2019",3,3,0,160000,1278.33333333333,126
"16788","51307","2019",4,4,0,166975,1290.75,132.75
"16789","51308","2019",25,25,0,226519,2233.44,100.16
"16790","51309","2019",2,2,0,235000,2088,113
"16791","51310","2019",2,2,0,215750,2034.5,120
"16792","51311","2019",2,2,0,73000,1076,66.5
"16793","51312","2019",5,5,0,183600,1660,112.4
"16794","51313","2019",4,4,0,145087.5,1197.75,116.25
"16795","51314","2019",4,4,0,188662.5,2018.25,93
"16796","51316","2019",2,2,0,133550,983,135.5
"16797","51318","2019",7,7,0,297568.571428571,2262.42857142857,138.571428571429
"16798","51320","2019",8,8,0,153500.875,1397.625,118.375
"16799","51321","2019",1,1,0,230659,2218,104
"16800","51324","2019",3,3,0,141613.333333333,1208.66666666667,108.666666666667
"16801","51325","2019",2,2,0,161750,2853.5,68
"16802","51326","2019",20,20,0,183210.5,1788.8,101.95
"16803","51327","2019",2,2,0,117000,755,159.5
"16804","51328","2019",12,12,0,129468.333333333,1193.91666666667,109
"16805","51329","2019",19,19,0,259075.789473684,2349.78947368421,111.105263157895
"16806","51333","2019",7,7,0,181605.714285714,2181.85714285714,86
"16807","51334","2019",2,2,0,119000,1205.5,101.5
"16808","51337","2019",1,1,0,188500,1714,110
"16809","51338","2019",12,12,0,335825,2271.41666666667,139.916666666667
"16810","51339","2019",4,4,0,170925,1420,130.75
"16811","51340","2019",4,4,0,128212.5,1342.25,99
"16812","51341","2019",1,1,0,43000,538,80
"16813","51342","2019",1,1,0,274950,1964,140
"16814","51343","2019",12,12,0,110542,939.916666666667,121.666666666667
"16815","51344","2019",12,12,0,151441.666666667,1766.25,89.25
"16816","51345","2019",2,2,0,211000,2284.5,91
"16817","51346","2019",17,17,0,138109.529411765,1479,95.3529411764706
"16818","51348","2019",1,1,0,149000,1284,116
"16819","51349","2019",3,3,0,116666.666666667,985.666666666667,122
"16820","51350","2019",2,2,0,110000,1009,118
"16821","51352","2019",11,11,0,116110,1165.81818181818,97.6363636363636
"16822","51354","2019",4,4,0,168462.5,1803.75,103.5
"16823","51355","2019",1,1,0,90000,714,126
"16824","51357","2019",5,5,0,175900,1755.8,105.8
"16825","51358","2019",4,3,1,79682.5,1065.25,77
"16826","51359","2019",2,2,0,226412.5,1705.5,138.5
"16827","51360","2019",4,4,0,145495,1290.75,111.75
"16828","51361","2019",1,1,0,1e+05,1099,91
"16829","51362","2019",10,10,0,236780,1831.8,129.1
"16830","51363","2019",1,1,0,80000,842,95
"16831","51364","2019",1,1,0,356000,2825,126
"16832","51365","2019",12,12,0,259533.333333333,2177.75,123
"16833","51367","2019",14,14,0,174964.285714286,1666.71428571429,110.857142857143
"16834","51369","2019",5,5,0,138080,1612,99.2
"16835","51370","2019",3,3,0,139833.333333333,874.333333333333,139
"16836","51372","2019",7,7,0,175257.142857143,1582,112.142857142857
"16837","51373","2019",2,2,0,76500,659.5,143.5
"16838","51375","2019",5,5,0,256340,2505,110.4
"16839","51376","2019",1,1,0,160000,1322,121
"16840","51377","2019",1,1,0,68000,1097,62
"16841","51378","2019",5,5,0,106740,1477.2,73.8
"16842","51379","2019",7,7,0,170021.428571429,1568.57142857143,105.857142857143
"16843","51380","2019",42,42,0,128805.476190476,1262.95238095238,106.190476190476
"16844","51381","2019",7,7,0,166646.428571429,2491.57142857143,83
"16845","51382","2019",2,2,0,57500,1239.5,55
"16846","51384","2019",2,2,0,108617,1019.5,117
"16847","51387","2019",4,4,0,186625,1419.25,139.25
"16848","51388","2019",29,28,1,172860.517241379,1696.13793103448,104.310344827586
"16849","51389","2019",9,9,0,152966.666666667,1579.11111111111,99.4444444444444
"16850","51390","2019",11,11,0,192274.545454545,2001.45454545455,100.272727272727
"16851","51391","2019",20,19,1,222679.45,2268.65,105.65
"16852","51393","2019",4,4,0,208500,1217,174.25
"16853","51395","2019",2,2,0,74500,1522.5,51
"16854","51397","2019",2,2,0,62500,650.5,97
"16855","51398","2019",2,2,0,214000,2049,104.5
"16856","51399","2019",6,6,0,81083.3333333333,1016.33333333333,80.8333333333333
"16857","51402","2019",5,5,0,147900,1649.4,88.8
"16858","51403","2019",6,6,0,240833.333333333,2347.5,101
"16859","51404","2019",1,1,0,111500,1239,90
"16860","51407","2019",2,2,0,37000,777,49
"16861","51409","2019",7,6,1,182528.571428571,1600.57142857143,117.142857142857
"16862","51410","2019",4,4,0,204332.5,1540.75,130.25
"16863","51412","2019",1,1,0,1e+05,1667,60
"16864","51413","2019",7,7,0,217885.714285714,2055.42857142857,108.714285714286
"16865","51414","2019",1,1,0,214100,1034,207
"16866","51415","2019",3,3,0,166086.666666667,1447.66666666667,111
"16867","51416","2019",6,6,0,100083.333333333,910.833333333333,106.166666666667
"16868","51417","2019",3,3,0,108333.333333333,878.666666666667,122.333333333333
"16869","51418","2019",3,3,0,299150,2069.33333333333,138.333333333333
"16870","51419","2019",1,1,0,132000,910,145
"16871","51422","2019",6,5,1,309301.666666667,2717.83333333333,124.5
"16872","51423","2019",17,17,0,78500,894.647058823529,91.2941176470588
"16873","51424","2019",2,2,0,57500,734.5,72.5
"16874","51425","2019",6,5,1,137500,1616.66666666667,98.5
"16875","51428","2019",7,7,0,164444.285714286,1664,102.428571428571
"16876","51429","2019",5,5,0,236740,1958.4,114.6
"16877","51430","2019",1,1,0,198275,1525,130
"16878","51431","2019",8,8,0,198291.25,2051.875,98.625
"16879","51432","2019",11,11,0,113480.909090909,1096.18181818182,107.909090909091
"16880","51433","2019",1,1,0,199500,1348,148
"16881","51434","2019",7,7,0,182785.714285714,1912.28571428571,103.857142857143
"16882","51435","2019",3,3,0,119000,754,153.333333333333
"16883","51436","2019",8,8,0,172012.5,1409.75,130.375
"16884","51438","2019",2,2,0,170000,1383,118.5
"16885","51439","2019",6,6,0,239646.666666667,2009.83333333333,122.333333333333
"16886","51440","2019",20,20,0,173827.5,1521.2,120.7
"16887","51441","2019",2,2,0,117000,1394.5,83.5
"16888","51442","2019",2,2,0,67000,569,114.5
"16889","51443","2019",1,1,0,118000,1180,100
"16890","51444","2019",4,4,0,174700,1811.5,95.5
"16891","51445","2019",1,1,0,298450,2030,147
"16892","51446","2019",9,9,0,126600,1326.44444444444,103.888888888889
"16893","51447","2019",3,3,0,177333.333333333,1732.66666666667,101.666666666667
"16894","51448","2019",12,12,0,146233.333333333,1886.41666666667,86.75
"16895","51449","2019",16,16,0,187700,1983.5625,100.9375
"16896","51450","2019",4,4,0,423875,3196,138
"16897","51451","2019",3,3,0,160663.333333333,1242.66666666667,131
"16898","51453","2019",7,7,0,178588.571428571,1937.42857142857,93
"16899","51454","2019",2757,634,2123,162059.837504534,2303.49764236489,70.3032281465361
"16900","51455","2019",2,2,0,137500,1442,96
"16901","51457","2019",2,2,0,112500,1083.5,85
"16902","51459","2019",3,3,0,137000,1414.66666666667,103.666666666667
"16903","51460","2019",4,4,0,106250,1311.5,81.5
"16904","51461","2019",8,5,3,109757.5,1260.375,83.625
"16905","51463","2019",1,1,0,136850,1955,70
"16906","51464","2019",6,6,0,145916.666666667,1733.16666666667,101.666666666667
"16907","51465","2019",3,3,0,258883.333333333,2015,143.333333333333
"16908","51468","2019",5,5,0,438230,2446.4,173
"16909","51469","2019",4,4,0,176750,1792,104.5
"16910","51471","2019",2,2,0,266825,2141.5,133.5
"16911","51472","2019",13,13,0,165772.307692308,1278.69230769231,137.384615384615
"16912","51473","2019",2,2,0,191500,2122,108
"16913","51474","2019",21,18,3,229693.523809524,2285.38095238095,100
"16914","51475","2019",1,1,0,88000,672,131
"16915","51476","2019",14,13,1,210906.857142857,1727.5,128.857142857143
"16916","51477","2019",4,4,0,161450,1447.25,111.5
"16917","51478","2019",2,2,0,175500,1544,116.5
"16918","51480","2019",1,1,0,285000,2591,110
"16919","51482","2019",6,6,0,166866.666666667,1502.33333333333,115.166666666667
"16920","51483","2019",5,5,0,145000,1198.4,127.4
"16921","51484","2019",2,2,0,123000,1199.5,102.5
"16922","51485","2019",4,4,0,188375,1645.75,117
"16923","51487","2019",2,2,0,196750,1285.5,157.5
"16924","51488","2019",3,3,0,289333.333333333,3700,82.3333333333333
"16925","51489","2019",1,1,0,67500,689,98
"16926","51490","2019",1,1,0,190000,1900,100
"16927","51492","2019",24,24,0,94286.4166666667,1054.75,86.875
"16928","51493","2019",1,1,0,363000,4271,85
"16929","51495","2019",1,1,0,18000,375,48
"16930","51496","2019",1,1,0,155000,1192,130
"16931","51497","2019",1,1,0,49500,596,83
"16932","51498","2019",2,2,0,144500,1512,97.5
"16933","51499","2019",3,3,0,212926.666666667,1669.66666666667,128
"16934","51500","2019",2,2,0,58000,667,85.5
"16935","51501","2019",4,4,0,140725,1110.5,127.25
"16936","51502","2019",1,1,0,104500,804,130
"16937","51503","2019",1,1,0,90000,703,128
"16938","51504","2019",9,8,1,160377.777777778,1855.77777777778,91.1111111111111
"16939","51505","2019",9,9,0,259307.222222222,2198.77777777778,114.555555555556
"16940","51506","2019",54,38,16,153891.092592593,1619.53703703704,94.6481481481482
"16941","51507","2019",45,32,13,96186.7777777778,1001.11111111111,94.7777777777778
"16942","51508","2019",2,2,0,182500,1047,158.5
"16943","51509","2019",3,3,0,71666.6666666667,662.666666666667,124
"16944","51510","2019",3,3,0,125333.333333333,1345.33333333333,94.6666666666667
"16945","51511","2019",1,1,0,135000,1195,113
"16946","51513","2019",5,5,0,131000,940.2,134
"16947","51515","2019",5,5,0,149688,1410,110
"16948","51518","2019",1,1,0,169000,2086,81
"16949","51521","2019",3,3,0,112666.666666667,958.666666666667,118
"16950","51523","2019",5,5,0,240610,2161,106
"16951","51524","2019",3,3,0,118000,990,123.333333333333
"16952","51525","2019",20,19,1,172562.5,1754.7,99.4
"16953","51526","2019",5,5,0,92498,1221.6,73
"16954","51527","2019",1,1,0,262600,1931,136
"16955","51528","2019",1,1,0,124000,984,126
"16956","51529","2019",3,3,0,183666.666666667,1236.33333333333,158.666666666667
"16957","51530","2019",9,9,0,169911.111111111,1973.44444444444,92.3333333333333
"16958","51531","2019",18,18,0,74754.8333333333,848.777777777778,87.1666666666667
"16959","51532","2019",7,7,0,272397.142857143,2782.57142857143,104
"16960","51534","2019",2,2,0,127750,1346.5,101.5
"16961","51535","2019",52,45,7,132965.538461538,1450.25,92.6538461538462
"16962","51536","2019",19,16,3,249221.052631579,2522.94736842105,104.736842105263
"16963","51537","2019",2,2,0,78750,786,100
"16964","51538","2019",1,1,0,295000,2458,120
"16965","51542","2019",2,2,0,174250,1658,104.5
"16966","51543","2019",1,1,0,115000,1278,90
"16967","51544","2019",6,6,0,124166.666666667,1323.16666666667,96.8333333333333
"16968","51545","2019",1,1,0,146565,1647,89
"16969","51546","2019",4,4,0,136600,1312.75,106.25
"16970","51548","2019",7,7,0,167148.571428571,1558.42857142857,115.285714285714
"16971","51549","2019",3,3,0,97623,1122,86.6666666666667
"16972","51550","2019",2,2,0,124050,1050.5,119.5
"16973","51552","2019",3,3,0,92333.3333333333,793.333333333333,114.333333333333
"16974","51553","2019",3,3,0,203033.333333333,1555,137
"16975","51555","2019",2,2,0,37125,508.5,80.5
"16976","51556","2019",4,4,0,137500,1145.25,122.25
"16977","51557","2019",4,4,0,106475,1235.5,85.25
"16978","51559","2019",24,22,2,128683.75,1326.41666666667,98.4583333333333
"16979","51560","2019",1,1,0,53000,1767,30
"16980","51562","2019",26,26,0,314209.230769231,2410.53846153846,132.038461538462
"16981","51563","2019",1,1,0,120000,1263,95
"16982","51564","2019",4,4,0,165581.75,1414.25,119
"16983","51566","2019",1,1,0,160000,1839,87
"16984","51567","2019",6,6,0,123161.666666667,1353.83333333333,92
"16985","51568","2019",3,3,0,324033.333333333,2235.66666666667,136.333333333333
"16986","51569","2019",5,5,0,290852,2348.2,121.8
"16987","51570","2019",3,3,0,157733.333333333,1303.33333333333,139.333333333333
"16988","51571","2019",10,10,0,202230,1744.3,114.4
"16989","51572","2019",4,4,0,168687.5,1467.75,117.5
"16990","51573","2019",116,73,43,201750.732758621,2349.13793103448,87.1724137931034
"16991","51576","2019",9,9,0,207673.333333333,2266.88888888889,91.8888888888889
"16992","51579","2019",6,6,0,132908.333333333,1613.5,81
"16993","51580","2019",2,2,0,66500,1065,65
"16994","51581","2019",1,1,0,260000,2016,129
"16995","51582","2019",7,7,0,249369,2000,133.714285714286
"16996","51583","2019",1,1,0,149000,1284,116
"16997","51584","2019",1,1,0,257000,2142,120
"16998","51585","2019",8,8,0,105900,1234.625,85.875
"16999","51586","2019",1,1,0,252000,2211,114
"17000","51587","2019",3,3,0,180058.666666667,1404.33333333333,133.666666666667
"17001","51589","2019",3,3,0,93283.3333333333,884.333333333333,114
"17002","51590","2019",1,1,0,65000,369,176
"17003","51591","2019",1,1,0,170000,2500,68
"17004","51592","2019",3,3,0,147833.333333333,1161.66666666667,132.666666666667
"17005","51595","2019",1,1,0,157000,809,194
"17006","51596","2019",9,9,0,152803.888888889,1385,112.555555555556
"17007","51597","2019",1,1,0,137000,1330,103
"17008","51598","2019",7,7,0,102392.857142857,1232.57142857143,79.8571428571429
"17009","51599","2019",2,2,0,86750,1499,57.5
"17010","51601","2019",2,2,0,207425,1143,183.5
"17011","51602","2019",1,1,0,190000,1462,130
"17012","51604","2019",3,3,0,194900,1695.33333333333,119.666666666667
"17013","51605","2019",3,3,0,134333.333333333,1756,82.3333333333333
"17014","51607","2019",2,2,0,185000,1989.5,93.5
"17015","51609","2019",9,9,0,141055.555555556,1461.77777777778,100.555555555556
"17016","51610","2019",4,4,0,95800,908,104
"17017","51611","2019",2,2,0,127500,1393,91.5
"17018","51612","2019",28,28,0,147433.928571429,1418.96428571429,106.571428571429
"17019","51613","2019",7,7,0,174872.571428571,2035.85714285714,93.1428571428571
"17020","51614","2019",15,15,0,220216.666666667,1897.66666666667,122.266666666667
"17021","51616","2019",3,3,0,196033.333333333,1775.33333333333,126
"17022","51617","2019",9,9,0,165711.111111111,1587.55555555556,107.666666666667
"17023","51618","2019",4,4,0,139125,1112.25,148.75
"17024","51619","2019",2,2,0,73000,460,158.5
"17025","51620","2019",2,2,0,32000,492.5,65
"17026","51621","2019",2,2,0,46000,482.5,88.5
"17027","51622","2019",4,4,0,157000,1458.75,131.75
"17028","51623","2019",2,2,0,262650,1958.5,135
"17029","51624","2019",10,10,0,204145.6,2045.8,97.5
"17030","51625","2019",4,4,0,120250,1365.75,120.75
"17031","51626","2019",2,2,0,72500,1675,45
"17032","51629","2019",6,6,0,253500,2171.16666666667,150
"17033","51630","2019",4,4,0,185750,1666.75,130.25
"17034","51631","2019",5,5,0,278062.6,2247,129
"17035","51633","2019",8,8,0,307056.25,2104.5,156.25
"17036","51634","2019",3,3,0,127666.666666667,1385.33333333333,97
"17037","51635","2019",2,2,0,252000,1538.5,158.5
"17038","51636","2019",11,11,0,183936.363636364,1549.54545454545,123.727272727273
"17039","51637","2019",2,2,0,199000,1918,105
"17040","51639","2019",1,1,0,25000,893,28
"17041","51640","2019",3,3,0,91666.6666666667,850.333333333333,110.666666666667
"17042","51641","2019",1,1,0,161000,2236,72
"17043","51642","2019",3,3,0,118000,1992.66666666667,74.6666666666667
"17044","51643","2019",6,6,0,192458.333333333,2218.66666666667,85.1666666666667
"17045","51644","2019",3,3,0,101666.666666667,1313.66666666667,76.3333333333333
"17046","51645","2019",1,1,0,130000,1300,100
"17047","51647","2019",10,10,0,120200,1059,119.8
"17048","51648","2019",4,4,0,165625,1902.75,89
"17049","51649","2019",97,67,30,82486.9072164948,946.948453608247,88.020618556701
"17050","51654","2019",3,3,0,159166.666666667,1738.66666666667,90
"17051","51655","2019",4,4,0,175612.5,1430,124.5
"17052","51656","2019",3,3,0,129666.666666667,1319.66666666667,111.666666666667
"17053","51657","2019",1,1,0,528000,5500,96
"17054","51660","2019",43,43,0,202776.325581395,1897.81395348837,108.837209302326
"17055","51662","2019",57,44,13,204874.912280702,2068.21052631579,101.035087719298
"17056","51663","2019",20,15,5,165522.5,2026.7,82
"17057","52001","2019",2,2,0,92500,1108,85
"17058","52006","2019",7,7,0,81907.1428571429,1062.57142857143,75.2857142857143
"17059","52007","2019",1,1,0,103000,1873,55
"17060","52008","2019",7,7,0,75857.1428571429,779,89.7142857142857
"17061","52014","2019",2,2,0,90000,549,160
"17062","52016","2019",1,1,0,43000,347,124
"17063","52017","2019",4,3,1,94525,787.5,123
"17064","52019","2019",1,1,0,227000,962,236
"17065","52021","2019",2,2,0,115350,1186,95.5
"17066","52023","2019",1,1,0,46500,574,81
"17067","52027","2019",1,1,0,75000,915,82
"17068","52029","2019",1,1,0,72000,867,83
"17069","52030","2019",1,1,0,31000,534,58
"17070","52031","2019",3,3,0,91000,609.333333333333,139.333333333333
"17071","52034","2019",1,1,0,71500,753,95
"17072","52035","2019",3,3,0,99400,1010.66666666667,98.6666666666667
"17073","52037","2019",4,4,0,70532.5,749.75,93.25
"17074","52038","2019",1,1,0,80000,593,135
"17075","52039","2019",1,1,0,90000,1000,90
"17076","52040","2019",1,1,0,60000,750,80
"17077","52042","2019",2,2,0,104900,791.5,126
"17078","52044","2019",5,5,0,58400,721.8,78.8
"17079","52045","2019",27,27,0,133911.481481481,1469.37037037037,98.8148148148148
"17080","52050","2019",12,12,0,97041.6666666667,995.25,99
"17081","52055","2019",1,1,0,250000,2232,112
"17082","52056","2019",1,1,0,62500,735,85
"17083","52057","2019",1,1,0,55000,688,80
"17084","52058","2019",18,18,0,101422.222222222,971.333333333333,110.444444444444
"17085","52059","2019",1,1,0,40000,500,80
"17086","52060","2019",28,26,2,72825,764.678571428571,101.678571428571
"17087","52061","2019",4,4,0,45750,836.25,72.75
"17088","52064","2019",6,6,0,116873.333333333,1231.33333333333,97.5
"17089","52065","2019",1,1,0,45000,643,70
"17090","52069","2019",1,1,0,110000,1341,82
"17091","52070","2019",1,1,0,126000,712,177
"17092","52072","2019",2,2,0,137500,1394,95.5
"17093","52074","2019",4,4,0,78875,728.25,114.75
"17094","52075","2019",2,2,0,89500,1065,85.5
"17095","52076","2019",2,2,0,137500,1489.5,91
"17096","52079","2019",7,7,0,77834.2857142857,866.142857142857,88
"17097","52083","2019",5,5,0,63900,548.4,111.4
"17098","52087","2019",1,1,0,227200,1136,200
"17099","52088","2019",5,5,0,121760,1345.4,90
"17100","52092","2019",3,3,0,82666.6666666667,654.333333333333,129
"17101","52093","2019",28,26,2,91142.8571428571,1028.85714285714,89.9285714285714
"17102","52094","2019",3,3,0,52666.6666666667,700.666666666667,76
"17103","52095","2019",2,2,0,125800,1110.5,110
"17104","52097","2019",4,4,0,57375,614.25,90.25
"17105","52099","2019",12,12,0,105375,1180.41666666667,90.3333333333333
"17106","52102","2019",6,6,0,147026.666666667,1466.66666666667,101.5
"17107","52104","2019",9,9,0,143777.777777778,1414.66666666667,106.222222222222
"17108","52107","2019",4,4,0,75000,914.75,89.75
"17109","52108","2019",3,3,0,101996.666666667,1462.66666666667,95
"17110","52110","2019",2,2,0,74500,690,108
"17111","52113","2019",3,3,0,91000,934,94.6666666666667
"17112","52114","2019",11,10,1,75272.7272727273,731,105.181818181818
"17113","52118","2019",2,2,0,47000,426.5,108.5
"17114","52119","2019",3,3,0,64333.3333333333,615.666666666667,92.6666666666667
"17115","52121","2019",276,173,103,108645.59057971,1212.17753623188,90.0615942028985
"17116","52123","2019",12,12,0,112925,1012.91666666667,120.083333333333
"17117","52125","2019",8,8,0,144815,1432.375,98.875
"17118","52126","2019",2,2,0,70000,717.5,98
"17119","52127","2019",1,1,0,129000,1344,96
"17120","52131","2019",2,2,0,70000,794,90
"17121","52132","2019",3,3,0,155149.333333333,832.333333333333,185
"17122","52134","2019",2,2,0,130000,990.5,127
"17123","52140","2019",8,8,0,101562.5,1026.25,95.375
"17124","52141","2019",7,7,0,116057.142857143,1217.57142857143,101.142857142857
"17125","52145","2019",3,3,0,55833.3333333333,531.666666666667,106
"17126","52147","2019",3,3,0,85250,783.666666666667,110.666666666667
"17127","52149","2019",2,2,0,67500,582.5,123.5
"17128","52151","2019",1,1,0,20000,333,60
"17129","52155","2019",6,6,0,117000,1141.16666666667,96.6666666666667
"17130","52156","2019",3,3,0,60000,1068.33333333333,50.3333333333333
"17131","52158","2019",3,3,0,77833.3333333333,654.333333333333,117
"17132","52160","2019",2,2,0,113600,759.5,149.5
"17133","52161","2019",1,1,0,50000,556,90
"17134","52163","2019",7,7,0,76571.4285714286,901,99.7142857142857
"17135","52165","2019",2,2,0,90000,666.5,128
"17136","52167","2019",2,2,0,187275,1644,114
"17137","52169","2019",1,1,0,60000,500,120
"17138","52170","2019",1,1,0,130000,833,156
"17139","52171","2019",3,3,0,52161.6666666667,523,98
"17140","52172","2019",1,1,0,30000,353,85
"17141","52175","2019",1,1,0,42000,636,66
"17142","52177","2019",8,8,0,72750,702,106.25
"17143","52178","2019",5,5,0,65280,585.4,114.8
"17144","52179","2019",1,1,0,85000,904,94
"17145","52182","2019",17,16,1,120793.764705882,1257.23529411765,97.8235294117647
"17146","52183","2019",1,1,0,53000,582,91
"17147","52187","2019",2,2,0,194000,3201,96
"17148","52189","2019",1,1,0,120000,750,160
"17149","52190","2019",3,3,0,75666.6666666667,807.333333333333,100
"17150","52193","2019",1,1,0,127000,1588,80
"17151","52194","2019",25,25,0,95510.4,1051.04,90.88
"17152","52196","2019",1,1,0,67000,573,117
"17153","52203","2019",1,1,0,75000,1230,61
"17154","52205","2019",3,3,0,46500,968.666666666667,59
"17155","52211","2019",14,11,3,55750,774.642857142857,77.9285714285714
"17156","52212","2019",4,4,0,76125,776.5,103.5
"17157","52216","2019",1,1,0,30000,345,87
"17158","52218","2019",1,1,0,17000,370,46
"17159","52230","2019",2,2,0,40000,507,79
"17160","52232","2019",2,2,0,109000,937,118
"17161","52235","2019",1,1,0,80000,825,97
"17162","52237","2019",3,3,0,67883.3333333333,759,95.3333333333333
"17163","52240","2019",3,3,0,85000,930,90.3333333333333
"17164","52243","2019",1,1,0,30000,341,88
"17165","52244","2019",6,6,0,130581.666666667,1206.16666666667,113.5
"17166","52246","2019",7,7,0,97285.7142857143,997.428571428571,98.4285714285714
"17167","52247","2019",2,2,0,101900,714.5,141
"17168","52248","2019",10,10,0,111305,1021.3,111.1
"17169","52250","2019",29,27,2,94913.7931034483,1064.96551724138,94.7931034482759
"17170","52251","2019",11,11,0,121500,1212,100.454545454545
"17171","52253","2019",2,2,0,108350,600,191.5
"17172","52254","2019",1,1,0,90000,1125,80
"17173","52258","2019",2,2,0,86250,750,115.5
"17174","52260","2019",3,3,0,129666.666666667,1065.66666666667,121.666666666667
"17175","52265","2019",15,15,0,100526.666666667,1106.4,93.2666666666667
"17176","52267","2019",3,3,0,165000,1513,110.333333333333
"17177","52269","2019",79,48,31,94490.9240506329,1064.06329113924,90.6455696202532
"17178","52271","2019",1,1,0,50000,476,105
"17179","52272","2019",2,2,0,58500,675,74.5
"17180","52274","2019",5,5,0,73900,667.8,116.6
"17181","52276","2019",2,2,0,85000,914.5,82
"17182","52280","2019",2,2,0,71000,752,96
"17183","52282","2019",1,1,0,120000,923,130
"17184","52286","2019",1,1,0,99000,448,221
"17185","52287","2019",1,1,0,37000,474,78
"17186","52289","2019",5,5,0,51700,562.8,88.8
"17187","52291","2019",1,1,0,33000,340,97
"17188","52292","2019",9,8,1,107105.555555556,944.888888888889,115.111111111111
"17189","52294","2019",8,8,0,123562.5,1203.25,103.75
"17190","52295","2019",2,2,0,35500,374.5,96.5
"17191","52297","2019",4,4,0,122500,943.75,123.75
"17192","52298","2019",2,2,0,76500,445,174
"17193","52300","2019",1,1,0,35000,412,85
"17194","52302","2019",2,2,0,67750,574.5,111.5
"17195","52305","2019",5,5,0,106060,1040,96
"17196","52306","2019",4,4,0,98250,878,107.25
"17197","52307","2019",4,4,0,85540,776.25,101.25
"17198","52308","2019",6,6,0,106386.666666667,1043.33333333333,102.5
"17199","52313","2019",1,1,0,172000,1055,163
"17200","52315","2019",9,9,0,122561.111111111,914.666666666667,135.333333333333
"17201","52316","2019",1,1,0,50000,413,121
"17202","52320","2019",2,2,0,87500,620,129.5
"17203","52321","2019",1,1,0,56000,700,80
"17204","52325","2019",1,1,0,107000,947,113
"17205","52327","2019",7,7,0,122771.428571429,1240.85714285714,102.142857142857
"17206","52331","2019",20,19,1,128435,1388.75,102.9
"17207","52332","2019",14,14,0,104071.428571429,978.642857142857,116.142857142857
"17208","52336","2019",1,1,0,30000,349,86
"17209","52337","2019",1,1,0,111000,1037,107
"17210","52341","2019",1,1,0,160000,1013,158
"17211","52346","2019",1,1,0,94600,1017,93
"17212","52347","2019",3,3,0,61666.6666666667,870.666666666667,68.3333333333333
"17213","52348","2019",5,5,0,86550,875.6,106.8
"17214","52349","2019",2,2,0,73000,994,74.5
"17215","52353","2019",30,27,3,82935,886.733333333333,94.3333333333333
"17216","52354","2019",1,1,0,142000,1578,90
"17217","52355","2019",2,2,0,85000,836.5,101.5
"17218","52357","2019",1,1,0,15000,395,38
"17219","52359","2019",1,1,0,50000,500,100
"17220","52362","2019",1,1,0,95000,540,176
"17221","52363","2019",4,4,0,69936.75,718.5,101.75
"17222","52364","2019",1,1,0,84150,1185,71
"17223","52365","2019",5,5,0,1e+05,926.2,106.4
"17224","52366","2019",2,2,0,66750,588,119
"17225","52367","2019",2,2,0,51750,792.5,67
"17226","52369","2019",1,1,0,55000,387,142
"17227","52370","2019",2,2,0,59500,828,66
"17228","52371","2019",3,3,0,93666.6666666667,919,97.3333333333333
"17229","52372","2019",1,1,0,35000,365,96
"17230","52373","2019",2,2,0,79000,766.5,101
"17231","52374","2019",2,2,0,107050,977,107
"17232","52376","2019",1,1,0,43000,606,71
"17233","52380","2019",6,6,0,152500,1717.83333333333,95.3333333333333
"17234","52383","2019",3,3,0,143133.333333333,1547,91.3333333333333
"17235","52384","2019",1,1,0,95000,848,112
"17236","52386","2019",5,5,0,95800,853.8,121.2
"17237","52391","2019",1,1,0,151450,1942,78
"17238","52395","2019",1,1,0,74590,678,110
"17239","52396","2019",1,1,0,45000,900,50
"17240","52398","2019",6,6,0,106000,967.333333333333,112.166666666667
"17241","52399","2019",2,2,0,69975,719.5,98
"17242","52401","2019",3,3,0,77500,720.666666666667,113
"17243","52403","2019",1,1,0,62000,653,95
"17244","52405","2019",3,3,0,95000,1175.66666666667,96
"17245","52407","2019",4,4,0,87000,879.75,103
"17246","52411","2019",19,19,0,94855.7894736842,1028.21052631579,91.8421052631579
"17247","52414","2019",6,6,0,90648.1666666667,983.833333333333,85.5
"17248","52419","2019",1,1,0,80000,656,122
"17249","52421","2019",3,3,0,122333.333333333,1150.66666666667,110.333333333333
"17250","52422","2019",3,3,0,97666.6666666667,831,125.666666666667
"17251","52423","2019",2,2,0,137500,1073,128.5
"17252","52424","2019",1,1,0,86000,989,87
"17253","52425","2019",4,4,0,92521.25,946.5,103.25
"17254","52429","2019",10,10,0,102470,904.6,108
"17255","52432","2019",19,19,0,91813.1578947368,792.368421052632,118.105263157895
"17256","52433","2019",1,1,0,52700,405,130
"17257","52440","2019",3,3,0,92666.6666666667,854,101.333333333333
"17258","52442","2019",6,6,0,94683.3333333333,926.333333333333,107.833333333333
"17259","52444","2019",1,1,0,45000,600,75
"17260","52445","2019",3,3,0,62333.3333333333,609.333333333333,101.333333333333
"17261","52446","2019",1,1,0,360000,1915,188
"17262","52447","2019",4,4,0,52500,763.75,80.25
"17263","52448","2019",260,190,70,96075.8615384615,1161.38846153846,83.9807692307692
"17264","52449","2019",10,10,0,152589,1216.9,125.6
"17265","52453","2019",1,1,0,213650,1272,168
"17266","52456","2019",3,3,0,68666.6666666667,764,95.3333333333333
"17267","52461","2019",3,3,0,85000,901.333333333333,92.6666666666667
"17268","52464","2019",1,1,0,50000,427,117
"17269","52469","2019",3,3,0,120000,1364.66666666667,88
"17270","52473","2019",2,2,0,111800,833,133
"17271","52476","2019",2,2,0,114000,878.5,106
"17272","52479","2019",4,4,0,82875,827.75,136
"17273","52480","2019",7,7,0,127000,891.285714285714,152.142857142857
"17274","52482","2019",2,2,0,43957.5,395.5,110
"17275","52484","2019",3,3,0,84066.6666666667,715,118.333333333333
"17276","52488","2019",1,1,0,1e+05,806,124
"17277","52489","2019",1,1,0,95500,955,100
"17278","52490","2019",11,11,0,76863.6363636364,897.272727272727,90.5454545454545
"17279","52492","2019",10,10,0,75900,1015.5,75.3
"17280","52494","2019",1,1,0,92070,1151,80
"17281","52497","2019",4,4,0,114675,1073.5,107.75
"17282","52499","2019",1,1,0,47000,553,85
"17283","52500","2019",8,8,0,137793.75,1185.875,109.25
"17284","52510","2019",6,6,0,89833.3333333333,1346.66666666667,97.1666666666667
"17285","52512","2019",3,3,0,113916.666666667,1196.33333333333,100.333333333333
"17286","52514","2019",2,2,0,160500,1504,107
"17287","52515","2019",2,2,0,117500,1143,103
"17288","52517","2019",1,1,0,55000,379,145
"17289","52518","2019",2,2,0,132500,1274.5,111
"17290","52519","2019",1,1,0,35000,389,90
"17291","52520","2019",3,3,0,63850,627,96.6666666666667
"17292","52522","2019",3,3,0,85050,977,85.6666666666667
"17293","52524","2019",2,2,0,37500,379,98.5
"17294","52525","2019",1,1,0,45000,714,63
"17295","52526","2019",1,1,0,85000,1062,80
"17296","52529","2019",5,5,0,65600,757.4,89.6
"17297","52534","2019",13,13,0,137857.692307692,1328.30769230769,103
"17298","52535","2019",8,8,0,90437.5,1054.125,87.125
"17299","52538","2019",3,3,0,138933.333333333,1141.66666666667,122.333333333333
"17300","52541","2019",1,1,0,51000,586,87
"17301","52542","2019",1,1,0,50000,342,146
"17302","52547","2019",1,1,0,197340,1316,150
"17303","52548","2019",1,1,0,85000,644,132
"17304","52550","2019",32,31,1,93901.71875,989.09375,94.0625
"17305","53001","2019",19,19,0,157532.631578947,1581.31578947368,102.631578947368
"17306","53002","2019",6,6,0,129500,1366.66666666667,99.3333333333333
"17307","53003","2019",26,26,0,107059.615384615,998.384615384615,105.730769230769
"17308","53005","2019",32,31,1,111742.5625,1213.15625,89.375
"17309","53007","2019",26,26,0,150180.692307692,1483.88461538462,100.692307692308
"17310","53008","2019",22,22,0,146218.727272727,1422.95454545455,101.227272727273
"17311","53009","2019",8,8,0,99925.5,1120.625,86.875
"17312","53010","2019",3,3,0,112250,1069,103.666666666667
"17313","53011","2019",8,8,0,141509.875,1851.5,97
"17314","53012","2019",8,8,0,133016.75,965.875,141.625
"17315","53013","2019",6,6,0,75000,764.666666666667,96.1666666666667
"17316","53015","2019",20,20,0,113834.5,1131.25,96.85
"17317","53016","2019",16,15,1,90843.75,1034.5625,85.5625
"17318","53017","2019",13,13,0,94230.7692307692,933.230769230769,117.769230769231
"17319","53018","2019",23,23,0,81060.8695652174,964.95652173913,83.9130434782609
"17320","53019","2019",2,2,0,65500,534,142
"17321","53021","2019",9,9,0,162927.777777778,1530,106.555555555556
"17322","53022","2019",5,5,0,107097.8,827,131.2
"17323","53023","2019",6,6,0,145416.666666667,1236.83333333333,110.333333333333
"17324","53025","2019",9,9,0,113500,1234.88888888889,89.4444444444444
"17325","53026","2019",2,2,0,1e+05,1092,94
"17326","53027","2019",3,3,0,121233.333333333,984,127
"17327","53028","2019",11,11,0,117045.454545455,1186.54545454545,97.5454545454545
"17328","53029","2019",14,14,0,97559.2857142857,1073.42857142857,90.8571428571429
"17329","53030","2019",1,1,0,130000,1354,96
"17330","53031","2019",7,7,0,151714.285714286,1482.85714285714,111.285714285714
"17331","53033","2019",1,1,0,2e+05,1600,125
"17332","53034","2019",77,75,2,185504.662337662,1756.03896103896,105.74025974026
"17333","53035","2019",6,6,0,181333.333333333,1830.5,96
"17334","53036","2019",9,9,0,109834.444444444,1042.44444444444,119.555555555556
"17335","53037","2019",3,3,0,189833.333333333,1862.66666666667,99.3333333333333
"17336","53038","2019",1,1,0,152000,1322,115
"17337","53039","2019",24,22,2,108142.291666667,1177.125,97.25
"17338","53040","2019",8,8,0,92214.875,857.5,112.375
"17339","53041","2019",1,1,0,1e+05,709,141
"17340","53042","2019",15,15,0,94938.6666666667,886.8,102.6
"17341","53043","2019",7,7,0,98642.8571428571,1231.42857142857,92.1428571428571
"17342","53045","2019",12,12,0,161091.666666667,1267.83333333333,123.916666666667
"17343","53046","2019",3,3,0,143333.333333333,1152.33333333333,138
"17344","53047","2019",1,1,0,187400,1388,135
"17345","53048","2019",14,13,1,135746.428571429,1457.42857142857,97.6428571428571
"17346","53049","2019",9,9,0,106005.333333333,1030.11111111111,102.111111111111
"17347","53051","2019",9,9,0,64838.8888888889,824,84.6666666666667
"17348","53052","2019",4,4,0,132500,995,112
"17349","53053","2019",3,3,0,49500,792.333333333333,62.3333333333333
"17350","53054","2019",67,65,2,226032.462686567,1973.70149253731,117.477611940299
"17351","53055","2019",9,9,0,86246.1111111111,834.444444444444,102.555555555556
"17352","53056","2019",11,11,0,168889.090909091,1542.90909090909,106.818181818182
"17353","53057","2019",6,6,0,90333.3333333333,1041.16666666667,79.3333333333333
"17354","53058","2019",1,1,0,103500,2029,51
"17355","53059","2019",3,3,0,190666.666666667,1520.33333333333,127.333333333333
"17356","53061","2019",7,7,0,77571.4285714286,884.857142857143,100
"17357","53062","2019",250,216,34,143818.744,1505.616,95.428
"17358","53063","2019",9,9,0,105122.222222222,1397.88888888889,79.8888888888889
"17359","53064","2019",13,13,0,83311.5384615385,841.153846153846,91.1538461538462
"17360","53066","2019",16,16,0,153326.25,1351.5625,113.625
"17361","53067","2019",7,7,0,113180,1217.14285714286,96.4285714285714
"17362","53068","2019",1,1,0,92000,1394,66
"17363","53069","2019",5,5,0,77554.2,679.2,118.2
"17364","53071","2019",8,8,0,95005.25,1102.875,86
"17365","53072","2019",15,15,0,113930.133333333,1155.53333333333,98.4666666666667
"17366","53073","2019",8,8,0,61843.75,692.5,94.375
"17367","53074","2019",7,7,0,101605.714285714,1020,99.4285714285714
"17368","53075","2019",4,4,0,75000,829.75,90.5
"17369","53076","2019",10,10,0,111842.3,1157.2,98.6
"17370","53077","2019",40,39,1,98818.65,1082.9,89.775
"17371","53078","2019",7,7,0,119129.285714286,1154.85714285714,100
"17372","53079","2019",13,13,0,70535.3846153846,846.692307692308,94.9230769230769
"17373","53080","2019",3,2,1,93333.3333333333,794.333333333333,111
"17374","53082","2019",8,8,0,151762.5,1341.375,113.25
"17375","53083","2019",11,11,0,84862.5454545455,923.090909090909,91.8181818181818
"17376","53084","2019",61,55,6,112647.540983607,1191.91803278689,90.5573770491803
"17377","53085","2019",2,2,0,273595,1491.5,169
"17378","53086","2019",6,6,0,131833.333333333,1184.33333333333,118.833333333333
"17379","53087","2019",2,2,0,62250,611.5,103
"17380","53088","2019",12,12,0,118125,1206,103.5
"17381","53089","2019",10,10,0,109940,1084.6,102.6
"17382","53090","2019",3,3,0,140163.333333333,1376.33333333333,105.666666666667
"17383","53091","2019",7,7,0,90478.5714285714,1044.85714285714,95.1428571428571
"17384","53093","2019",2,2,0,65000,730,87
"17385","53094","2019",32,30,2,123678.125,1382,92.8125
"17386","53096","2019",72,72,0,100585.986111111,1073.05555555556,92.7361111111111
"17387","53097","2019",116,106,10,104042.181034483,1192.96551724138,89.2931034482759
"17388","53098","2019",6,6,0,136633.333333333,1324.5,103.5
"17389","53099","2019",14,14,0,191785.642857143,1740.07142857143,120.357142857143
"17390","53100","2019",14,14,0,75982.1428571429,861.357142857143,89.2142857142857
"17391","53101","2019",5,5,0,129100,1215.4,110.2
"17392","53102","2019",1,1,0,72000,1091,66
"17393","53103","2019",20,20,0,138921.05,1335.35,100.5
"17394","53104","2019",12,12,0,149641.833333333,1417.16666666667,98.75
"17395","53105","2019",4,4,0,123750,1282.75,90.75
"17396","53106","2019",4,4,0,81028.75,848.5,111.75
"17397","53107","2019",24,24,0,92689.5833333333,911.416666666667,99.8333333333333
"17398","53108","2019",6,6,0,141466.666666667,1226.83333333333,133
"17399","53109","2019",10,10,0,121800,1012.3,109.3
"17400","53110","2019",10,10,0,112384.6,997.5,116.4
"17401","53111","2019",4,4,0,153818.75,1190.5,125
"17402","53112","2019",4,4,0,64487.5,684.75,94.25
"17403","53113","2019",11,11,0,125681.818181818,1109.72727272727,111.727272727273
"17404","53114","2019",3,3,0,36666.6666666667,509,77.3333333333333
"17405","53115","2019",6,6,0,74698.3333333333,736.666666666667,95.5
"17406","53116","2019",7,7,0,66285.8571428571,837.857142857143,81.5714285714286
"17407","53117","2019",5,5,0,95200,925.4,96.2
"17408","53118","2019",2,2,0,81000,864.5,96
"17409","53119","2019",37,37,0,191808.432432432,1817.75675675676,107.675675675676
"17410","53120","2019",9,9,0,67806.7777777778,949.777777777778,73.6666666666667
"17411","53121","2019",10,10,0,68800,875.6,85.5
"17412","53122","2019",9,9,0,81378.5555555556,1049.11111111111,77.8888888888889
"17413","53123","2019",18,18,0,89542,1008.55555555556,84.9444444444444
"17414","53124","2019",16,16,0,129468.75,1204.9375,105.5625
"17415","53125","2019",20,20,0,85272.5,863.95,97.1
"17416","53126","2019",4,4,0,97425,1098.75,90
"17417","53127","2019",28,28,0,86689.6785714286,975.071428571429,91.25
"17418","53128","2019",7,7,0,87000,1249.85714285714,77
"17419","53129","2019",7,7,0,114964.285714286,1156.71428571429,92.7142857142857
"17420","53130","2019",883,447,436,136040.50396376,1723.02831257078,78.3318233295583
"17421","53131","2019",2,2,0,64950,534.5,121.5
"17422","53132","2019",8,8,0,86565.875,868,107
"17423","53133","2019",4,4,0,87950,997.25,97.5
"17424","53134","2019",1,1,0,2e+05,1980,101
"17425","53135","2019",12,12,0,104083.333333333,1054.33333333333,100.416666666667
"17426","53136","2019",15,15,0,129377.466666667,1351.46666666667,94.1333333333333
"17427","53137","2019",34,34,0,143998.529411765,1497,97.5588235294118
"17428","53139","2019",5,5,0,73760,1019,66.4
"17429","53140","2019",43,40,3,161692.023255814,1689.18604651163,95.8837209302326
"17430","53141","2019",14,14,0,139181.428571429,1484.07142857143,91.2142857142857
"17431","53142","2019",6,6,0,92250,874.333333333333,106.166666666667
"17432","53143","2019",8,8,0,114937.5,1043.5,114.375
"17433","53144","2019",12,12,0,115138.333333333,1125,101.666666666667
"17434","53145","2019",9,9,0,97944.4444444444,1156.77777777778,81
"17435","53146","2019",18,18,0,141122.222222222,1493.33333333333,92.6666666666667
"17436","53147","2019",188,145,43,119462.909574468,1339.66489361702,93.281914893617
"17437","53148","2019",1,1,0,185000,1516,122
"17438","53150","2019",12,12,0,134541.666666667,1145.41666666667,111.666666666667
"17439","53151","2019",7,7,0,99285.7142857143,1024.71428571429,107.714285714286
"17440","53152","2019",33,27,6,110793.939393939,1452.84848484848,92.3333333333333
"17441","53153","2019",3,3,0,80850,1220.66666666667,64
"17442","53154","2019",11,11,0,89854.5454545455,988.181818181818,90.9090909090909
"17443","53155","2019",15,15,0,102040,1209.46666666667,83.1333333333333
"17444","53156","2019",3,3,0,88033.3333333333,1139.66666666667,77
"17445","53157","2019",14,14,0,156425.5,1476.07142857143,110.357142857143
"17446","53158","2019",23,23,0,97045.652173913,1002.08695652174,97.2173913043478
"17447","53160","2019",6,6,0,86755,1113.33333333333,76.3333333333333
"17448","53161","2019",35,35,0,99522.8571428571,1092.65714285714,95
"17449","53162","2019",21,10,11,98884.7619047619,1317.52380952381,71.9047619047619
"17450","53163","2019",2,2,0,101000,1003,109.5
"17451","53164","2019",5,5,0,49600,711.6,77.4
"17452","53165","2019",7,7,0,107808.571428571,979.857142857143,114.285714285714
"17453","53168","2019",16,15,1,133506.6875,1302.125,102.4375
"17454","53169","2019",9,9,0,129043.333333333,1197.11111111111,113
"17455","53170","2019",12,12,0,66499.1666666667,1010.08333333333,68.6666666666667
"17456","53172","2019",7,7,0,172330.142857143,1350.42857142857,148.714285714286
"17457","53173","2019",4,4,0,47875,825.5,56.25
"17458","53174","2019",9,9,0,147092,1401.66666666667,101.333333333333
"17459","53175","2019",13,13,0,146592.846153846,1278.23076923077,112.384615384615
"17460","53176","2019",10,10,0,51210,687.1,76.6
"17461","53177","2019",4,4,0,110904.5,1086.75,104.75
"17462","53178","2019",2,2,0,55500,913,56
"17463","53179","2019",4,4,0,38100,528.5,72.75
"17464","53180","2019",9,9,0,84933.3333333333,911.111111111111,91.8888888888889
"17465","53181","2019",8,8,0,82087.5,912.625,96.125
"17466","53182","2019",38,37,1,96212.1315789474,1137.81578947368,82.3421052631579
"17467","53184","2019",3,3,0,83333.3333333333,1004.66666666667,78.6666666666667
"17468","53185","2019",36,36,0,77680.5555555556,940.583333333333,82.3611111111111
"17469","53186","2019",22,22,0,126727.272727273,1294.09090909091,96.3181818181818
"17470","53187","2019",2,2,0,133150,1096,117
"17471","53188","2019",32,32,0,68029.09375,776.71875,84.1875
"17472","53189","2019",1,1,0,75000,1071,70
"17473","53190","2019",3,2,1,26533.3333333333,498.333333333333,53.3333333333333
"17474","53191","2019",8,8,0,97375,852.375,120.25
"17475","53192","2019",3,3,0,92166.6666666667,698,130.666666666667
"17476","53193","2019",6,6,0,135333.333333333,1388.33333333333,92.6666666666667
"17477","53195","2019",7,7,0,152971.428571429,1424.28571428571,99.2857142857143
"17478","53196","2019",2,2,0,60000,923.5,64.5
"17479","53197","2019",13,13,0,82235.8461538462,788.076923076923,100
"17480","53198","2019",7,7,0,52935.7142857143,658.428571428571,84
"17481","53199","2019",6,6,0,120033.333333333,1728.33333333333,109.333333333333
"17482","53200","2019",9,9,0,163533.333333333,1593.33333333333,106.555555555556
"17483","53201","2019",98,93,5,179335.683673469,1730.97959183673,107.581632653061
"17484","53202","2019",11,11,0,99474.5454545455,906.454545454545,117.545454545455
"17485","53203","2019",7,7,0,143975.714285714,983.857142857143,139.571428571429
"17486","53204","2019",4,4,0,88632.5,1013.25,85.5
"17487","53206","2019",5,5,0,71700,803,85.2
"17488","53208","2019",11,11,0,91636.3636363636,768.909090909091,127.181818181818
"17489","53209","2019",5,5,0,51609.6,853.2,59.2
"17490","53210","2019",16,16,0,108411.5625,1145.4375,96.875
"17491","53211","2019",17,17,0,84870.5882352941,1149.23529411765,72
"17492","53212","2019",5,5,0,160832,1557.8,103.2
"17493","53213","2019",6,6,0,93333.3333333333,831,109.5
"17494","53214","2019",4,4,0,79075,1006,89
"17495","53216","2019",12,10,2,100141.666666667,1165.75,92.4166666666667
"17496","53218","2019",15,15,0,144713,1123.53333333333,113.933333333333
"17497","53219","2019",21,18,3,95500,917.619047619048,101.285714285714
"17498","53220","2019",4,4,0,118350,1084.25,116.75
"17499","53221","2019",3,3,0,75706.6666666667,1065,75
"17500","53222","2019",7,7,0,110785.714285714,1021.42857142857,105.428571428571
"17501","53223","2019",4,4,0,71375,820.75,84.5
"17502","53224","2019",9,9,0,144222.222222222,1332.44444444444,112.666666666667
"17503","53225","2019",5,4,1,142466.8,1471.4,98.8
"17504","53226","2019",8,8,0,103437.5,1089.375,91.125
"17505","53228","2019",10,9,1,84400,777.4,106.3
"17506","53229","2019",21,21,0,159114.285714286,1540.80952380952,101.904761904762
"17507","53230","2019",5,5,0,60142,798.6,78.8
"17508","53232","2019",1,1,0,521906,6778,77
"17509","53233","2019",5,5,0,88600,972.4,93.4
"17510","53234","2019",8,8,0,80875,927.25,83.25
"17511","53235","2019",3,3,0,46166.6666666667,632.666666666667,75
"17512","53236","2019",2,2,0,66000,588.5,111
"17513","53237","2019",4,4,0,97900,1172.75,89
"17514","53238","2019",6,6,0,78747.8333333333,655.333333333333,121.5
"17515","53240","2019",9,9,0,92811.1111111111,862,103.555555555556
"17516","53242","2019",4,4,0,98500,1458.5,83.75
"17517","53243","2019",21,21,0,136922.619047619,1390.80952380952,101
"17518","53245","2019",17,16,1,75389.0588235294,983,74.4117647058823
"17519","53246","2019",25,25,0,96472.48,1069.96,91.76
"17520","53247","2019",30,30,0,126620,1466.53333333333,86.0666666666667
"17521","53248","2019",2,2,0,59000,984,87.5
"17522","53249","2019",10,10,0,78052,1110.8,77.8
"17523","53250","2019",7,7,0,98128.5714285714,993.428571428571,101.285714285714
"17524","53251","2019",5,5,0,73698.8,798.4,93.2
"17525","53253","2019",3,3,0,143400,1127,131
"17526","53255","2019",21,21,0,83318.0952380952,956.809523809524,89
"17527","53256","2019",3,3,0,56666.6666666667,805,71.6666666666667
"17528","53257","2019",3,3,0,59233.3333333333,785.666666666667,85.6666666666667
"17529","53258","2019",11,11,0,99150,892.545454545455,105.909090909091
"17530","53259","2019",2,2,0,131000,1282.5,102
"17531","53260","2019",9,9,0,120744.444444444,1262.33333333333,95.3333333333333
"17532","53261","2019",1,1,0,160000,1270,126
"17533","53262","2019",7,7,0,150740.142857143,1392.71428571429,110.857142857143
"17534","53263","2019",3,3,0,91600,940.333333333333,92.3333333333333
"17535","53264","2019",5,5,0,117475.4,1255.2,94.6
"17536","53265","2019",11,11,0,109454.545454545,1070,94.3636363636364
"17537","53266","2019",2,2,0,46500,606,82
"17538","53267","2019",16,16,0,105394.375,1049.375,99.4375
"17539","53269","2019",8,8,0,91041.625,989.625,111.5
"17540","53270","2019",2,2,0,26000,371.5,69
"17541","53271","2019",27,27,0,93581.4814814815,909.185185185185,102.074074074074
"17542","53273","2019",15,14,1,140466.666666667,1502.93333333333,96.9333333333333
"17543","53276","2019",7,7,0,56621.4285714286,752.142857142857,69.8571428571429
"17544","54002","2019",2,2,0,94000,659.5,143
"17545","54003","2019",1,1,0,46000,657,70
"17546","54004","2019",2,2,0,235500,1587,150
"17547","54005","2019",3,3,0,156166.666666667,1307.33333333333,136
"17548","54006","2019",2,2,0,121500,1645,84.5
"17549","54007","2019",11,11,0,151795.454545455,1491.36363636364,104.090909090909
"17550","54008","2019",2,2,0,139825,1519,93
"17551","54009","2019",2,2,0,137612.5,1342.5,120.5
"17552","54010","2019",13,13,0,113984.615384615,1316.84615384615,86.0769230769231
"17553","54011","2019",3,2,1,106666.666666667,1093.66666666667,97.3333333333333
"17554","54012","2019",7,7,0,214642.142857143,1801.42857142857,133.857142857143
"17555","54013","2019",1,1,0,70000,1111,63
"17556","54014","2019",3,3,0,68666.6666666667,743.333333333333,91
"17557","54015","2019",3,3,0,155666.666666667,1777.66666666667,92
"17558","54016","2019",2,2,0,172000,1378,126
"17559","54018","2019",3,1,2,61666.6666666667,568,117.333333333333
"17560","54019","2019",3,3,0,175000,1021.33333333333,197.666666666667
"17561","54020","2019",2,2,0,99700,1181,85
"17562","54021","2019",2,2,0,159650,1062.5,145
"17563","54022","2019",7,7,0,141395.285714286,1392.57142857143,98.4285714285714
"17564","54023","2019",2,2,0,142000,1018,140.5
"17565","54024","2019",1,1,0,125000,812,154
"17566","54025","2019",23,16,7,173641.739130435,1834.65217391304,97.3913043478261
"17567","54026","2019",3,3,0,116333.333333333,1202,100
"17568","54027","2019",8,8,0,213116.25,1855.375,116.375
"17569","54028","2019",46,32,14,104514.782608696,1281.89130434783,80.1304347826087
"17570","54029","2019",41,33,8,178727.341463415,1720.17073170732,105.975609756098
"17571","54031","2019",4,4,0,139400,1558.75,90.75
"17572","54032","2019",2,2,0,266740,1279,213
"17573","54033","2019",2,2,0,118675,898.5,137
"17574","54034","2019",4,4,0,119046.5,1128.25,103
"17575","54035","2019",5,5,0,95540,1003.4,95.4
"17576","54036","2019",12,11,1,206586.666666667,1653,117.916666666667
"17577","54037","2019",5,5,0,267810,2338,114.8
"17578","54038","2019",5,5,0,106870,1171,90.4
"17579","54039","2019",40,35,5,92085.125,981.225,95
"17580","54040","2019",12,10,2,78011.6666666667,870.083333333333,93.3333333333333
"17581","54042","2019",8,8,0,111387.875,1144.875,98
"17582","54043","2019",11,11,0,176575,1701.09090909091,110.181818181818
"17583","54045","2019",9,9,0,130691.666666667,1284.11111111111,104.777777777778
"17584","54046","2019",7,7,0,156782,1269,137.857142857143
"17585","54047","2019",2,2,0,205625,1623.5,129.5
"17586","54048","2019",2,2,0,130000,1666.5,75
"17587","54049","2019",6,5,1,127750,1368.33333333333,89.6666666666667
"17588","54051","2019",15,14,1,156086.666666667,1793.4,86.2666666666667
"17589","54052","2019",4,4,0,105850,810.5,150.5
"17590","54053","2019",2,2,0,66500,630.5,104.5
"17591","54054","2019",19,17,2,125326.842105263,1276.57894736842,99.6842105263158
"17592","54055","2019",6,5,1,129247.5,1141.33333333333,118.666666666667
"17593","54056","2019",2,2,0,145500,1421,114
"17594","54059","2019",15,15,0,130044.666666667,1249.4,108.533333333333
"17595","54060","2019",22,22,0,128881.363636364,1496.22727272727,94.9545454545455
"17596","54061","2019",9,9,0,163377.777777778,1323.44444444444,125.333333333333
"17597","54062","2019",6,6,0,183547.166666667,1396.5,131.166666666667
"17598","54064","2019",3,3,0,122666.666666667,1018.66666666667,133.666666666667
"17599","54065","2019",10,10,0,106602.1,1092.3,102.9
"17600","54066","2019",7,7,0,181737.142857143,1841.71428571429,106.285714285714
"17601","54067","2019",7,6,1,169557.142857143,1536,121.714285714286
"17602","54068","2019",1,1,0,52000,525,99
"17603","54069","2019",8,8,0,293758.125,2658,113.5
"17604","54070","2019",4,4,0,173400,2124,93.75
"17605","54071","2019",2,2,0,103602.5,986,103.5
"17606","54072","2019",4,4,0,139600,1396.25,107.75
"17607","54073","2019",12,12,0,128912.5,1055.33333333333,120.916666666667
"17608","54075","2019",4,4,0,112369.25,1111,91.75
"17609","54076","2019",39,35,4,141061.538461538,1474.15384615385,98.8974358974359
"17610","54077","2019",9,8,1,87083.3333333333,830.777777777778,105.777777777778
"17611","54079","2019",40,30,10,138033.625,1569.4,90.8
"17612","54080","2019",15,15,0,111853,1093.66666666667,108.2
"17613","54081","2019",7,7,0,122337.285714286,1359.28571428571,89.2857142857143
"17614","54082","2019",2,2,0,70500,674.5,102.5
"17615","54083","2019",3,3,0,124333.333333333,1070,116.333333333333
"17616","54084","2019",16,16,0,100155,1016.375,97.125
"17617","54085","2019",1,1,0,118750,913,130
"17618","54086","2019",5,5,0,97060,750.8,134.6
"17619","54087","2019",1,1,0,130000,929,140
"17620","54088","2019",1,1,0,63000,630,100
"17621","54089","2019",17,17,0,208644.235294118,1830.94117647059,115.705882352941
"17622","54090","2019",50,42,8,161888,1743.52,93.8
"17623","54091","2019",3,3,0,331478.333333333,2191.33333333333,165
"17624","54092","2019",3,3,0,50000,865.666666666667,62.6666666666667
"17625","54093","2019",3,3,0,143866.666666667,1047.33333333333,164.333333333333
"17626","54094","2019",2,2,0,193000,2315,79.5
"17627","54095","2019",1,1,0,141600,1161,122
"17628","54096","2019",2,2,0,122500,1221,102
"17629","54097","2019",3,3,0,68666.6666666667,757.666666666667,98
"17630","54099","2019",137,86,51,129167.299270073,1460.3503649635,88.6058394160584
"17631","54100","2019",10,10,0,195195,1548.5,139.7
"17632","54101","2019",2,2,0,81875,637,123
"17633","54102","2019",4,2,2,132237.5,1351.75,108.5
"17634","54103","2019",2,2,0,250250,1921.5,132
"17635","54104","2019",4,4,0,168075,1443.25,110
"17636","54105","2019",7,7,0,138714.285714286,1291.28571428571,107.285714285714
"17637","54107","2019",1,1,0,87000,554,157
"17638","54108","2019",1,1,0,40000,714,56
"17639","54109","2019",10,10,0,145467,1702.3,97.5
"17640","54110","2019",8,8,0,182080,1652.125,115.625
"17641","54111","2019",40,37,3,147478.375,1593.25,93.3
"17642","54112","2019",6,6,0,119883.333333333,1233.83333333333,98.1666666666667
"17643","54113","2019",19,16,3,188398.315789474,1935.84210526316,101.263157894737
"17644","54114","2019",2,2,0,144060,1703,85.5
"17645","54115","2019",75,41,34,133159.906666667,1556.85333333333,86.2
"17646","54116","2019",21,20,1,159380.952380952,1609.14285714286,101.714285714286
"17647","54118","2019",7,7,0,138900,1052.57142857143,136.714285714286
"17648","54119","2019",3,3,0,167016.666666667,1227,132.666666666667
"17649","54121","2019",4,4,0,207750,1838.5,119
"17650","54122","2019",7,7,0,210375.714285714,1672,144.857142857143
"17651","54123","2019",23,22,1,172454.130434783,1694.69565217391,107.869565217391
"17652","54125","2019",4,4,0,107462.5,1048.75,107.5
"17653","54126","2019",1,1,0,145750,1695,86
"17654","54127","2019",8,8,0,183390,1626,119.25
"17655","54128","2019",9,8,1,143247.777777778,1200.22222222222,121.888888888889
"17656","54129","2019",16,15,1,105318.75,977.125,114.1875
"17657","54131","2019",4,4,0,225592.5,1658.25,136.5
"17658","54132","2019",1,1,0,145000,1835,79
"17659","54133","2019",1,1,0,116500,832,140
"17660","54134","2019",3,3,0,52666.6666666667,628.666666666667,86.6666666666667
"17661","54135","2019",12,11,1,147904.166666667,1346.16666666667,109.916666666667
"17662","54136","2019",44,34,10,137891.818181818,1652.31818181818,84.0909090909091
"17663","54137","2019",7,7,0,100392.857142857,826.428571428571,123
"17664","54138","2019",41,29,12,216768.731707317,2213.92682926829,101.09756097561
"17665","54139","2019",3,3,0,211533.333333333,1705.33333333333,129
"17666","54140","2019",1,1,0,118000,1269,93
"17667","54141","2019",3,3,0,193333.333333333,1266,150
"17668","54142","2019",1,1,0,210000,2333,90
"17669","54143","2019",3,3,0,110666.666666667,1124.66666666667,104.333333333333
"17670","54144","2019",4,4,0,161303.75,1482.75,110.25
"17671","54145","2019",14,14,0,160740.714285714,1204.14285714286,136.857142857143
"17672","54146","2019",1,1,0,140000,2000,70
"17673","54148","2019",5,4,1,105300,1124.6,87.4
"17674","54149","2019",25,25,0,189367.6,1933.76,93.88
"17675","54150","2019",47,39,8,167106.914893617,1950.08510638298,87.7021276595745
"17676","54151","2019",19,17,2,183926.315789474,1893.94736842105,97.5789473684211
"17677","54152","2019",35,34,1,146403.114285714,1515.11428571429,98.6
"17678","54153","2019",2,2,0,104500,873.5,129
"17679","54154","2019",7,7,0,98657.1428571429,905.142857142857,115.571428571429
"17680","54155","2019",1,1,0,88400,940,94
"17681","54156","2019",8,8,0,114897.625,1054,112.375
"17682","54157","2019",60,53,7,137198.283333333,1491.76666666667,94.0166666666667
"17683","54158","2019",1,1,0,165290,1777,93
"17684","54159","2019",134,125,9,137751.902985075,1453.02985074627,96.1641791044776
"17685","54160","2019",2,2,0,96000,946.5,88
"17686","54161","2019",3,3,0,141433.333333333,904,161.333333333333
"17687","54162","2019",20,20,0,120747.5,1076.15,111.95
"17688","54163","2019",3,3,0,60500,566.666666666667,107.666666666667
"17689","54164","2019",2,2,0,34500,530.5,59.5
"17690","54165","2019",9,9,0,420022.222222222,2945.88888888889,155.777777777778
"17691","54166","2019",1,1,0,65000,1000,65
"17692","54167","2019",30,28,2,161260.2,1504.23333333333,110
"17693","54168","2019",3,3,0,195303.333333333,1465,121
"17694","54170","2019",1,1,0,150000,1181,127
"17695","54171","2019",13,13,0,172223.076923077,1583.23076923077,111.230769230769
"17696","54172","2019",6,6,0,147150,1464.16666666667,105.833333333333
"17697","54173","2019",1,1,0,45000,625,72
"17698","54174","2019",56,47,9,164968.357142857,1591.03571428571,101.910714285714
"17699","54175","2019",6,6,0,128010.5,1293,97.6666666666667
"17700","54176","2019",9,8,1,110444.444444444,957.555555555556,119.222222222222
"17701","54179","2019",4,4,0,170450,1432.75,118.75
"17702","54180","2019",2,2,0,247000,1384.5,192
"17703","54181","2019",10,10,0,167187,1755.5,94.4
"17704","54182","2019",1,1,0,125000,1136,110
"17705","54183","2019",1,1,0,137000,913,150
"17706","54184","2019",136,58,78,169090.661764706,1972.39705882353,86.0955882352941
"17707","54185","2019",1,1,0,123000,879,140
"17708","54186","2019",11,11,0,217570.909090909,1883.72727272727,113.818181818182
"17709","54187","2019",1,1,0,172100,860,200
"17710","54188","2019",14,10,4,147210,1397.92857142857,108.5
"17711","54189","2019",6,6,0,139333.333333333,979.666666666667,156
"17712","54191","2019",3,3,0,80000,819,100.333333333333
"17713","54192","2019",8,8,0,170825,1703.75,110.25
"17714","54194","2019",7,7,0,145764.285714286,1094,129.714285714286
"17715","54195","2019",2,1,1,164050,2426,78
"17716","54196","2019",14,12,2,181282.142857143,1928.85714285714,93.6428571428571
"17717","54197","2019",22,20,2,214451.636363636,2049.27272727273,104.545454545455
"17718","54198","2019",4,4,0,177500,1500,121.75
"17719","54199","2019",3,3,0,86833.3333333333,801,109.666666666667
"17720","54200","2019",1,1,0,132700,1029,129
"17721","54201","2019",3,3,0,115933.333333333,909.333333333333,137.666666666667
"17722","54202","2019",2,2,0,217870,1740.5,130.5
"17723","54203","2019",2,2,0,242505,1381.5,177
"17724","54205","2019",37,36,1,100782.432432432,1150.45945945946,89.4594594594595
"17725","54206","2019",5,5,0,117160,952.2,139.6
"17726","54208","2019",2,1,1,144500,1510,125
"17727","54209","2019",1,1,0,50000,495,101
"17728","54211","2019",6,6,0,104016.666666667,927,123.166666666667
"17729","54212","2019",3,3,0,114000,1264,98
"17730","54213","2019",2,2,0,163750,907.5,185
"17731","54214","2019",6,6,0,121426.833333333,1277.66666666667,85.1666666666667
"17732","54215","2019",82,64,18,140800.682926829,1702.5243902439,85.3170731707317
"17733","54216","2019",2,2,0,134000,1016,140.5
"17734","54217","2019",1,1,0,163340,939,174
"17735","54218","2019",1,1,0,235000,987,238
"17736","54220","2019",1,1,0,80000,650,123
"17737","54221","2019",4,4,0,122442.5,1641.75,81.5
"17738","54222","2019",13,13,0,111025,1087.92307692308,107.076923076923
"17739","54223","2019",1,1,0,214000,955,224
"17740","54225","2019",3,3,0,113000,1664,86.6666666666667
"17741","54227","2019",18,18,0,102755.555555556,1208,82.7222222222222
"17742","54228","2019",1,1,0,44000,427,103
"17743","54229","2019",4,4,0,74387.75,744.25,91
"17744","54231","2019",1,1,0,133800,1029,130
"17745","54232","2019",34,32,2,200281.5,1754.29411764706,116.470588235294
"17746","54234","2019",44,40,4,184237.659090909,1883.61363636364,98.2272727272727
"17747","54235","2019",7,7,0,147428.571428571,1243.14285714286,120.285714285714
"17748","54236","2019",2,2,0,237500,1421,173.5
"17749","54237","2019",1,1,0,32000,405,79
"17750","54238","2019",2,2,0,115500,705.5,150
"17751","54242","2019",1,1,0,205000,1281,160
"17752","54243","2019",2,2,0,65775,782.5,92.5
"17753","54246","2019",3,3,0,121333.333333333,820.333333333333,135.666666666667
"17754","54247","2019",4,4,0,132537.5,1364.75,96
"17755","54249","2019",6,6,0,112041.666666667,1119.66666666667,104.833333333333
"17756","54250","2019",6,6,0,192116.666666667,1767.16666666667,112.166666666667
"17757","54252","2019",5,4,1,112200,1188,92.6
"17758","54253","2019",8,5,3,110472.5,1160,96.375
"17759","54254","2019",28,26,2,165803.571428571,1781.14285714286,91.1428571428571
"17760","54255","2019",1,1,0,213000,2130,100
"17761","54256","2019",3,3,0,132340,963,126.333333333333
"17762","54257","2019",50,45,5,235121.96,2225.84,105.88
"17763","54258","2019",4,4,0,149537.5,1092.75,143.75
"17764","54259","2019",1,1,0,185350,842,220
"17765","54260","2019",8,7,1,167150,1521.25,124
"17766","54261","2019",74,53,21,134749.081081081,1537.09459459459,85.1081081081081
"17767","54262","2019",2,2,0,229500,1142.5,193
"17768","54263","2019",101,83,18,92209.0495049505,1120.43564356436,80.6534653465347
"17769","54264","2019",3,3,0,126950,1289.33333333333,89
"17770","54265","2019",25,22,3,262207.88,2289.68,120.04
"17771","54266","2019",6,6,0,137583.333333333,1164.83333333333,130
"17772","54268","2019",5,5,0,106790,775.2,143
"17773","54269","2019",2,2,0,166000,1636,105.5
"17774","54270","2019",58,42,16,147603.965517241,1802.06896551724,85.7758620689655
"17775","54271","2019",1,1,0,55000,809,68
"17776","54272","2019",5,5,0,210935,1689.6,130
"17777","54273","2019",104,82,22,115282.634615385,1377.93269230769,85.875
"17778","54274","2019",127,46,81,119352.094488189,1648.33858267717,72.8582677165354
"17779","54275","2019",3,3,0,164877.333333333,1231,136.666666666667
"17780","54276","2019",8,8,0,140468.75,1495.75,94.375
"17781","54277","2019",4,3,1,108487.5,1248,86.5
"17782","54278","2019",1,1,0,149000,756,197
"17783","54279","2019",10,9,1,170410.5,1678.4,107
"17784","54280","2019",110,75,35,77484.5636363636,972.863636363636,80.3545454545455
"17785","54281","2019",10,10,0,150120,1485.1,107.6
"17786","54282","2019",2,2,0,121250,874,131
"17787","54283","2019",5,5,0,265051.2,1817.2,149.6
"17788","54284","2019",15,15,0,67517.4666666667,696.4,94.3333333333333
"17789","54285","2019",1,1,0,73800,2109,35
"17790","54286","2019",19,17,2,179914.315789474,1543.63157894737,113.578947368421
"17791","54288","2019",4,4,0,118850,1238.75,88.5
"17792","54289","2019",6,5,1,181258.333333333,1490.66666666667,132.666666666667
"17793","54291","2019",1,1,0,51000,1020,50
"17794","54292","2019",4,4,0,143650,1108.5,120.5
"17795","54293","2019",1,1,0,98100,490,200
"17796","54294","2019",4,4,0,168462.5,1759,90.5
"17797","54295","2019",19,14,5,107643.157894737,1099.89473684211,93.3684210526316
"17798","54297","2019",2,2,0,64250,779.5,75
"17799","54298","2019",1,1,0,206150,1085,190
"17800","54299","2019",5,5,0,168380,1482,114
"17801","54300","2019",87,48,39,168394.126436782,2006.70114942529,88.7471264367816
"17802","54301","2019",1,1,0,150000,1852,81
"17803","54302","2019",9,9,0,168400,1522.88888888889,119.888888888889
"17804","54303","2019",2,2,0,154500,1773,87.5
"17805","54304","2019",187,52,135,175171.77540107,2007.13903743316,86.9572192513369
"17806","54305","2019",17,15,2,252908.235294118,2213.47058823529,121.764705882353
"17807","54306","2019",2,2,0,108850,1430,76.5
"17808","54307","2019",2,2,0,164587.5,1274.5,141
"17809","54308","2019",2,2,0,76500,750.5,102
"17810","54309","2019",10,10,0,140117.5,1529.1,98.1
"17811","54311","2019",8,8,0,232418.75,1821,127.25
"17812","54312","2019",1,1,0,142000,1614,88
"17813","54313","2019",6,6,0,152066.666666667,1323.33333333333,120.833333333333
"17814","54314","2019",46,42,4,226124.239130435,2280.78260869565,101.869565217391
"17815","54315","2019",8,7,1,135097.5,1328.375,103.375
"17816","54316","2019",1,1,0,114000,877,130
"17817","54317","2019",1,1,0,95000,731,130
"17818","54318","2019",75,67,8,146806.56,1475.93333333333,101.106666666667
"17819","54320","2019",2,2,0,177875,1986.5,110.5
"17820","54321","2019",26,19,7,158303.807692308,1896.07692307692,85.6153846153846
"17821","54322","2019",92,62,30,114065.043478261,1303.05434782609,88.8369565217391
"17822","54323","2019",174,106,68,126878.057471264,1435.01149425287,90.4885057471264
"17823","54324","2019",1,1,0,40000,571,70
"17824","54326","2019",2,2,0,168225,2153,78
"17825","54327","2019",5,5,0,134400,1072.6,129.4
"17826","54328","2019",68,58,10,226192.617647059,2252.88235294118,99.8382352941177
"17827","54329","2019",224,116,108,106215.174107143,1142.29017857143,92.8482142857143
"17828","54330","2019",6,6,0,264687.666666667,1765,150.333333333333
"17829","54331","2019",1,1,0,80000,615,130
"17830","54332","2019",27,20,7,134472.222222222,1543.48148148148,88.6296296296296
"17831","54333","2019",3,3,0,174066.666666667,1813.33333333333,95.3333333333333
"17832","54334","2019",7,7,0,133564.285714286,1494.57142857143,91.2857142857143
"17833","54335","2019",6,4,2,100600,1374.16666666667,75.6666666666667
"17834","54336","2019",14,14,0,182989.285714286,1434.14285714286,130.928571428571
"17835","54337","2019",3,3,0,161333.333333333,938.666666666667,160
"17836","54338","2019",13,13,0,197903.846153846,1891.23076923077,103.307692307692
"17837","54339","2019",111,64,47,170687.126126126,1910.47747747748,88.8918918918919
"17838","54340","2019",5,5,0,203198,1433.2,138
"17839","54343","2019",6,6,0,113421.666666667,885,129.833333333333
"17840","54344","2019",2,2,0,138000,1321.5,102.5
"17841","54345","2019",4,4,0,194412.5,1905.75,103.5
"17842","54346","2019",4,4,0,161250,1104.75,158.75
"17843","54348","2019",4,4,0,139500,1409.25,104.75
"17844","54349","2019",2,2,0,126000,1032.5,141.5
"17845","54350","2019",12,12,0,136883.333333333,1237.91666666667,116.333333333333
"17846","54351","2019",25,23,2,135079.32,1546.12,94.08
"17847","54352","2019",10,10,0,126325,1409.6,85.7
"17848","54353","2019",17,17,0,155335.294117647,1564.41176470588,110.882352941176
"17849","54355","2019",1,1,0,37750,1348,28
"17850","54356","2019",2,2,0,124225,874.5,142.5
"17851","54357","2019",86,46,40,140734.360465116,1688.70930232558,82.9883720930233
"17852","54358","2019",1,1,0,123500,1625,76
"17853","54359","2019",1,1,0,102600,1140,90
"17854","54360","2019",4,4,0,231500,1535.5,162.5
"17855","54362","2019",14,14,0,115255.571428571,1315.57142857143,86.8571428571429
"17856","54363","2019",4,4,0,162221.25,1308.75,132
"17857","54364","2019",18,18,0,185586.111111111,2050.38888888889,95.7222222222222
"17858","54365","2019",1,1,0,65000,765,85
"17859","54366","2019",18,18,0,222325,2003.33333333333,110.5
"17860","54367","2019",45,39,6,184742.733333333,1978.33333333333,93.7111111111111
"17861","54368","2019",2,2,0,85750,794,110
"17862","54369","2019",4,4,0,233353.75,2027,116.75
"17863","54370","2019",2,2,0,73000,492,155
"17864","54371","2019",10,9,1,203600.5,1779.4,112.2
"17865","54372","2019",8,8,0,171402.5,1724.75,109.25
"17866","54373","2019",10,9,1,163850,1693.2,95.3
"17867","54374","2019",1,1,0,203000,1650,123
"17868","54375","2019",18,17,1,154278.333333333,1411.38888888889,110.055555555556
"17869","54376","2019",2,2,0,227500,4340.5,61
"17870","54377","2019",1,1,0,80000,348,230
"17871","54378","2019",7,7,0,193957.142857143,1537.28571428571,123.142857142857
"17872","54379","2019",1,1,0,110000,880,125
"17873","54380","2019",6,6,0,159283.333333333,1281.16666666667,122.166666666667
"17874","54382","2019",71,51,20,147179.577464789,1720.18309859155,89.0281690140845
"17875","54383","2019",13,13,0,150130.769230769,1573.69230769231,94.8461538461538
"17876","54385","2019",3,3,0,154333.333333333,2061.66666666667,76
"17877","54387","2019",1,1,0,85000,773,110
"17878","54388","2019",3,3,0,140000,1177.66666666667,133.333333333333
"17879","54389","2019",1,1,0,167000,1777,94
"17880","54390","2019",3,3,0,129000,1465,83.3333333333333
"17881","54391","2019",21,20,1,87869.0476190476,1024.7619047619,82.0952380952381
"17882","54392","2019",3,3,0,136666.666666667,1259.66666666667,117.666666666667
"17883","54393","2019",3,3,0,38000,1989.33333333333,26.3333333333333
"17884","54395","2019",2223,236,1987,137003.997750787,2038.79442195232,67.025641025641
"17885","54396","2019",4,4,0,87250,840.75,106.5
"17886","54397","2019",80,63,17,139977.8375,1568.6375,92.3625
"17887","54399","2019",1,1,0,43000,406,106
"17888","54400","2019",7,7,0,158592.857142857,1297.85714285714,110.571428571429
"17889","54402","2019",2,2,0,151500,1771.5,84
"17890","54403","2019",8,7,1,149200.625,1815.125,92.875
"17891","54404","2019",7,7,0,106000,843.142857142857,126.142857142857
"17892","54405","2019",5,5,0,118800,950.4,127.2
"17893","54406","2019",3,2,1,95783.3333333333,819,129.666666666667
"17894","54408","2019",2,2,0,123500,1158,107
"17895","54409","2019",1,1,0,154050,1400,110
"17896","54410","2019",7,7,0,122228.571428571,1138.71428571429,102.571428571429
"17897","54411","2019",2,2,0,175500,1882,92.5
"17898","54413","2019",2,2,0,204225,922,241.5
"17899","54414","2019",2,2,0,108500,1065,101.5
"17900","54415","2019",38,29,9,148713.368421053,1442.05263157895,104.526315789474
"17901","54417","2019",4,4,0,89925,915.25,96
"17902","54418","2019",3,3,0,141716.666666667,1435.33333333333,92
"17903","54419","2019",1,1,0,58000,362,160
"17904","54421","2019",3,3,0,82466.6666666667,1057.66666666667,79
"17905","54422","2019",1,1,0,153800,967,159
"17906","54423","2019",4,4,0,77125,649.75,112.25
"17907","54425","2019",30,29,1,114617.333333333,1198.43333333333,98.2333333333333
"17908","54426","2019",11,11,0,122100,1222.81818181818,103.454545454545
"17909","54427","2019",2,2,0,73500,557.5,171.5
"17910","54428","2019",13,11,2,125680.769230769,1371.69230769231,93.5384615384615
"17911","54429","2019",2,2,0,204000,1549.5,165.5
"17912","54430","2019",68,51,17,119402.941176471,1424.48529411765,84.2205882352941
"17913","54431","2019",181,96,85,132545.624309392,1545.10497237569,89.2375690607735
"17914","54432","2019",50,33,17,111604.84,1377.74,85.18
"17915","54433","2019",3,3,0,150000,1450.33333333333,104.666666666667
"17916","54434","2019",4,4,0,138000,1060.75,128.5
"17917","54435","2019",2,2,0,114100,1124,107.5
"17918","54436","2019",4,4,0,174778.75,1394.25,133.5
"17919","54437","2019",13,13,0,125756.923076923,1472,86.3846153846154
"17920","54438","2019",3,3,0,68000,552,125
"17921","54439","2019",78,41,37,166818.525641026,1821.14102564103,90.2307692307692
"17922","54441","2019",6,6,0,148945,1266.66666666667,128
"17923","54442","2019",1,1,0,103550,1090,95
"17924","54443","2019",1,1,0,66465,950,70
"17925","54444","2019",4,4,0,133225,1199.25,110.5
"17926","54446","2019",1,1,0,60000,923,65
"17927","54449","2019",11,11,0,151218.272727273,1416.72727272727,106.545454545455
"17928","54451","2019",56,46,10,140170.357142857,1517.73214285714,94.5
"17929","54453","2019",1,1,0,109440,855,128
"17930","54455","2019",3,3,0,148333.333333333,776.666666666667,194.333333333333
"17931","54456","2019",6,6,0,181863.333333333,1608.66666666667,110.833333333333
"17932","54457","2019",1,1,0,80000,889,90
"17933","54458","2019",1,1,0,195000,1639,119
"17934","54459","2019",19,17,2,213711.052631579,2108.26315789474,104.684210526316
"17935","54460","2019",2,2,0,65825,512.5,129.5
"17936","54461","2019",2,2,0,185400,1832,101.5
"17937","54462","2019",35,28,7,137482.942857143,1405.94285714286,97.0285714285714
"17938","54463","2019",2,2,0,140000,1254.5,113
"17939","54464","2019",1,1,0,180000,1698,106
"17940","54465","2019",5,4,1,166800,1544.8,106.8
"17941","54466","2019",1,1,0,43600,436,100
"17942","54467","2019",2,2,0,97000,572.5,175
"17943","54468","2019",2,2,0,272150,1828,144
"17944","54469","2019",8,8,0,178113.75,1675.25,120.875
"17945","54471","2019",1,1,0,76000,613,124
"17946","54472","2019",6,6,0,128483.333333333,1141.33333333333,117.5
"17947","54473","2019",2,2,0,124650,978.5,109
"17948","54474","2019",2,2,0,155075,969,134
"17949","54475","2019",1,1,0,182000,1000,182
"17950","54476","2019",3,2,1,102483.333333333,1132,90.3333333333333
"17951","54477","2019",3,3,0,207063.333333333,1716.33333333333,120.666666666667
"17952","54481","2019",4,4,0,76025,528,147.5
"17953","54482","2019",152,44,108,132209.335526316,1688.42105263158,77.2960526315789
"17954","54483","2019",101,75,26,142362.227722772,1593.23762376238,89.6435643564356
"17955","54484","2019",1,1,0,140000,1373,102
"17956","54485","2019",2,2,0,116000,1175,96
"17957","54486","2019",6,6,0,139516.666666667,1486.16666666667,94.8333333333333
"17958","54487","2019",2,2,0,119805,439.5,259.5
"17959","54488","2019",1,1,0,15000,357,42
"17960","54489","2019",1,1,0,95000,1188,80
"17961","54490","2019",22,19,3,170357.272727273,1465.27272727273,118.681818181818
"17962","54491","2019",6,6,0,185910.666666667,1432.66666666667,124.166666666667
"17963","54493","2019",51,38,13,124017.215686275,1460.92156862745,84.2352941176471
"17964","54494","2019",1,1,0,37500,595,63
"17965","54495","2019",49,47,2,194831.346938776,1946.04081632653,103.081632653061
"17966","54496","2019",6,6,0,115623.166666667,1184,97.6666666666667
"17967","54498","2019",55,51,4,195078.418181818,2028.92727272727,97.8545454545455
"17968","54500","2019",4,4,0,86812.5,904.75,91.5
"17969","54501","2019",2,2,0,148000,833.5,165.5
"17970","54502","2019",3,3,0,109333.333333333,1142.66666666667,95
"17971","54504","2019",14,10,4,183490.714285714,1597.92857142857,111.214285714286
"17972","54505","2019",12,12,0,159712.75,1530.91666666667,104.833333333333
"17973","54507","2019",1,1,0,30000,333,90
"17974","54509","2019",13,13,0,158472.307692308,1494.07692307692,111.769230769231
"17975","54510","2019",6,6,0,170441.666666667,1207.33333333333,137.833333333333
"17976","54511","2019",3,3,0,129100,1134.66666666667,118.666666666667
"17977","54512","2019",1,1,0,37500,833,45
"17978","54513","2019",2,2,0,76500,874,88.5
"17979","54514","2019",8,8,0,211037.625,1829.625,119.375
"17980","54515","2019",2,2,0,198249.5,1935.5,103.5
"17981","54518","2019",10,10,0,115282,1156.9,97.8
"17982","54519","2019",3,3,0,128430,1094.33333333333,117.333333333333
"17983","54520","2019",5,5,0,104100,1172.4,92.6
"17984","54521","2019",27,21,6,143312.592592593,1884.14814814815,76.1481481481482
"17985","54523","2019",5,4,1,102480.8,1074.4,96.8
"17986","54525","2019",2,2,0,378225,2205.5,165.5
"17987","54526","2019",129,84,45,161933.294573643,1914.48062015504,84.4341085271318
"17988","54527","2019",8,7,1,165012.5,1534.75,113.875
"17989","54528","2019",174,90,84,121260.83908046,1289.8275862069,95.7126436781609
"17990","54529","2019",1,1,0,40000,714,56
"17991","54530","2019",1,1,0,125000,1289,97
"17992","54531","2019",2,2,0,62500,498.5,124
"17993","54532","2019",3,3,0,137933.333333333,1070.66666666667,131.333333333333
"17994","54533","2019",52,46,6,137315.384615385,1466.11538461538,95.3076923076923
"17995","54534","2019",9,8,1,116143.111111111,1039.55555555556,120.555555555556
"17996","54535","2019",1,1,0,254000,1539,165
"17997","54536","2019",30,25,5,124870.233333333,1296.13333333333,93.3333333333333
"17998","54537","2019",6,6,0,280116.666666667,1959,147
"17999","54538","2019",5,5,0,93200,714,136.8
"18000","54539","2019",1,1,0,60000,667,90
"18001","54540","2019",6,6,0,87000,787.833333333333,112.5
"18002","54541","2019",1,1,0,138000,701,197
"18003","54542","2019",35,33,2,143981.085714286,1531.28571428571,92.8
"18004","54544","2019",3,3,0,234087.333333333,1307.66666666667,179
"18005","54545","2019",5,5,0,102070,1000.2,109.2
"18006","54546","2019",11,8,3,149689.909090909,1142.54545454545,126.181818181818
"18007","54547","2019",318,87,231,118008.06918239,1667.18553459119,71.2987421383648
"18008","54548","2019",7,6,1,80421.4285714286,704.571428571429,102.285714285714
"18009","54549","2019",50,40,10,120689.56,1497.26,81.02
"18010","54550","2019",1,1,0,264800,1558,170
"18011","54552","2019",1,1,0,114000,1140,100
"18012","54553","2019",3,3,0,110000,1021.66666666667,111
"18013","54554","2019",2,2,0,94000,626,141
"18014","54556","2019",2,2,0,133250,817.5,166.5
"18015","54557","2019",23,23,0,262244.913043478,2042.5652173913,129.652173913043
"18016","54558","2019",1,1,0,1e+05,1053,95
"18017","54559","2019",4,4,0,185300,1666,124.25
"18018","54561","2019",2,2,0,72500,1396.5,56.5
"18019","54562","2019",1,1,0,95000,1557,61
"18020","54563","2019",13,13,0,127092.307692308,1333.84615384615,98
"18021","54565","2019",4,4,0,138587.5,1355.5,102.75
"18022","54566","2019",3,1,2,106666.666666667,1182.66666666667,86.3333333333333
"18023","54567","2019",6,6,0,128830,976.833333333333,132.666666666667
"18024","54568","2019",9,9,0,106574.444444444,1121.55555555556,95.8888888888889
"18025","54569","2019",1,1,0,108000,1161,93
"18026","54570","2019",5,5,0,119770,1307.4,92.8
"18027","54571","2019",2,2,0,245550,1743.5,142
"18028","54572","2019",16,16,0,169281.875,1640.75,105.5625
"18029","54573","2019",3,3,0,151330.666666667,1285.33333333333,122.333333333333
"18030","54574","2019",5,5,0,279936,2137.6,134.2
"18031","54575","2019",7,4,3,210158.571428571,2162.85714285714,98.4285714285714
"18032","54577","2019",2,2,0,73000,1216.5,60
"18033","54578","2019",220,109,111,177457.259090909,2047.18181818182,87.25
"18034","54579","2019",3,3,0,153733.333333333,1363.66666666667,114
"18035","54580","2019",194,146,48,133499.75257732,1688.95360824742,79.3505154639175
"18036","54581","2019",1,1,0,128000,842,152
"18037","54582","2019",1,1,0,110000,1068,103
"18038","54583","2019",4,4,0,146608,1141.75,141.75
"18039","54584","2019",10,9,1,186302.6,1616.1,116.3
"18040","54585","2019",7,7,0,122085.714285714,1169.85714285714,97
"18041","54586","2019",9,9,0,135848.888888889,1436.77777777778,93.2222222222222
"18042","54587","2019",2,2,0,123400,1281.5,96
"18043","54588","2019",3,3,0,179666.666666667,1742.66666666667,103
"18044","54589","2019",3,3,0,138333.333333333,1664.33333333333,94.6666666666667
"18045","54590","2019",9,9,0,158633.333333333,1381,120
"18046","54591","2019",6,6,0,101666.666666667,942,100.166666666667
"18047","54592","2019",7,7,0,210907.142857143,1508.57142857143,148.428571428571
"18048","54593","2019",7,7,0,123109.714285714,1370.42857142857,90.7142857142857
"18049","54594","2019",3,3,0,129446.666666667,998.666666666667,129.333333333333
"18050","54595","2019",2,2,0,139125,918,162.5
"18051","54596","2019",14,13,1,184620,1678.78571428571,113.785714285714
"18052","54597","2019",5,5,0,157660,1095.4,143.4
"18053","54598","2019",4,4,0,105750,917.25,126.5
"18054","54599","2019",2,2,0,137200,896.5,181.5
"18055","54600","2019",2,2,0,128625,760,170
"18056","54601","2019",1,1,0,117500,1306,90
"18057","55001","2019",3,3,0,61333.3333333333,752.666666666667,83
"18058","55002","2019",1,1,0,90000,726,124
"18059","55005","2019",1,1,0,64500,1290,50
"18060","55007","2019",2,2,0,164000,1056,199
"18061","55008","2019",1,1,0,148000,987,150
"18062","55009","2019",8,8,0,89884.625,955.625,93.375
"18063","55010","2019",32,31,1,104465.3125,1108.1875,97.65625
"18064","55011","2019",3,3,0,59900,529.666666666667,111.333333333333
"18065","55012","2019",5,5,0,93464,946.6,115.4
"18066","55013","2019",5,5,0,147260,1218.4,117.6
"18067","55014","2019",5,5,0,76720,751.4,101.2
"18068","55015","2019",2,2,0,147000,1414,104
"18069","55017","2019",4,4,0,64699.5,648,104.5
"18070","55021","2019",1,1,0,45000,417,108
"18071","55022","2019",1,1,0,70008,1167,60
"18072","55023","2019",1,1,0,17000,362,47
"18073","55024","2019",3,3,0,64766.6666666667,607.666666666667,115
"18074","55025","2019",4,4,0,83500,908.25,90
"18075","55027","2019",2,2,0,60000,757,68
"18076","55029","2019",198,126,72,108245.904040404,1135.72222222222,97.8686868686869
"18077","55031","2019",6,6,0,129180,1273,105.666666666667
"18078","55033","2019",1,1,0,1e+05,885,113
"18079","55034","2019",1,1,0,157000,1619,97
"18080","55035","2019",2,2,0,53750,552,100
"18081","55037","2019",1,1,0,26500,353,75
"18082","55038","2019",2,2,0,94300,749.5,129.5
"18083","55040","2019",1,1,0,44000,733,60
"18084","55041","2019",9,9,0,132945.555555556,1304.88888888889,98.3333333333333
"18085","55042","2019",3,3,0,124396.333333333,968,126
"18086","55043","2019",38,27,11,127999.052631579,1438.81578947368,90.8421052631579
"18087","55044","2019",1,1,0,30000,375,80
"18088","55045","2019",6,4,2,139000,1224.83333333333,115.5
"18089","55046","2019",1,1,0,55000,355,155
"18090","55047","2019",2,2,0,134500,1184.5,115
"18091","55048","2019",1,1,0,80000,667,120
"18092","55049","2019",4,4,0,76757.5,893.5,78
"18093","55051","2019",2,2,0,137500,623,184
"18094","55053","2019",7,7,0,86945.7142857143,838.285714285714,99.8571428571429
"18095","55058","2019",6,6,0,113250,1097.33333333333,107.5
"18096","55060","2019",7,7,0,132618.571428571,896.428571428571,137.285714285714
"18097","55061","2019",4,4,0,72925,838.75,95.75
"18098","55062","2019",2,2,0,42500,600,75
"18099","55063","2019",45,43,2,77209.2666666667,846.133333333333,87.3777777777778
"18100","55064","2019",2,2,0,52416.5,589,92
"18101","55066","2019",1,1,0,45000,346,130
"18102","55067","2019",1,1,0,58000,682,85
"18103","55068","2019",2,2,0,65412.5,826,81
"18104","55069","2019",2,2,0,115000,909.5,132
"18105","55070","2019",1,1,0,150000,1429,105
"18106","55071","2019",5,5,0,110220,903.6,140.4
"18107","55072","2019",1,1,0,66667,501,133
"18108","55073","2019",9,9,0,155888.888888889,1594.44444444444,104
"18109","55075","2019",2,2,0,98500,1280,76.5
"18110","55076","2019",1,1,0,45000,360,125
"18111","55077","2019",3,3,0,120000,992.666666666667,115.666666666667
"18112","55078","2019",2,2,0,36250,542.5,69
"18113","55079","2019",12,12,0,145261.083333333,1041.66666666667,149.333333333333
"18114","55080","2019",2,2,0,34000,363.5,94
"18115","55081","2019",2,2,0,127650,1013.5,125
"18116","55082","2019",2,2,0,61000,672.5,90
"18117","55083","2019",3,3,0,95166.6666666667,711.666666666667,140.333333333333
"18118","55084","2019",1,1,0,136000,971,140
"18119","55085","2019",6,6,0,161658.333333333,1135.33333333333,144
"18120","55087","2019",3,3,0,106028,664,160
"18121","55093","2019",9,9,0,76000,687.666666666667,108.111111111111
"18122","55094","2019",10,10,0,97582,1011.2,104.3
"18123","55096","2019",2,2,0,115000,986,130
"18124","55097","2019",4,4,0,93875,842,112.25
"18125","55099","2019",2,2,0,99500,804.5,103
"18126","55100","2019",2,2,0,158000,888.5,183.5
"18127","55101","2019",5,5,0,69800,675.4,101
"18128","55102","2019",7,7,0,183678.571428571,1591.42857142857,116.428571428571
"18129","55104","2019",1,1,0,40000,494,81
"18130","55105","2019",1,1,0,15000,429,35
"18131","55109","2019",1,1,0,198000,1385,143
"18132","55110","2019",1,1,0,265000,1373,193
"18133","55111","2019",6,6,0,100149.166666667,1034.5,94.6666666666667
"18134","55113","2019",4,4,0,65300,591,95.75
"18135","55114","2019",1,1,0,181556,1452,125
"18136","55117","2019",9,9,0,102944.444444444,1065,97.5555555555556
"18137","55118","2019",1,1,0,185400,843,220
"18138","55119","2019",3,3,0,114566.666666667,1038.33333333333,105.666666666667
"18139","55120","2019",10,10,0,124415.5,1094.5,116.5
"18140","55121","2019",1,1,0,213750,1155,185
"18141","55122","2019",54,42,12,96590.8518518519,1009.59259259259,97.7962962962963
"18142","55123","2019",3,3,0,158066.666666667,939,168
"18143","55124","2019",3,3,0,122666.666666667,881.333333333333,138
"18144","55125","2019",6,6,0,97783.3333333333,1016.33333333333,98.1666666666667
"18145","55127","2019",1,1,0,101500,1015,100
"18146","55129","2019",1,1,0,54500,336,162
"18147","55132","2019",23,22,1,110953.913043478,1025.34782608696,104.478260869565
"18148","55138","2019",4,4,0,71275,905.75,92
"18149","55141","2019",2,2,0,147500,1250,120
"18150","55142","2019",3,3,0,49666.6666666667,553.333333333333,93.6666666666667
"18151","55144","2019",7,7,0,84835.7142857143,855.428571428571,104.857142857143
"18152","55145","2019",7,7,0,98000,1157.28571428571,87.4285714285714
"18153","55146","2019",2,2,0,80000,667,120
"18154","55148","2019",5,5,0,64210,715.2,87
"18155","55149","2019",1,1,0,86000,1178,73
"18156","55150","2019",5,5,0,61100,592.6,104.6
"18157","55153","2019",4,4,0,130777.5,1328.75,99.5
"18158","55154","2019",11,11,0,118800,1236.63636363636,100.636363636364
"18159","55155","2019",1,1,0,283000,1119,253
"18160","55156","2019",2,2,0,35000,649.5,55.5
"18161","55157","2019",1,1,0,25000,403,62
"18162","55158","2019",9,8,1,119377.777777778,1074,116.222222222222
"18163","55159","2019",3,3,0,88333.3333333333,838,107.333333333333
"18164","55163","2019",1,1,0,40000,800,50
"18165","55165","2019",7,7,0,79000,774.142857142857,95.2857142857143
"18166","55166","2019",15,15,0,117249,1173.53333333333,105.933333333333
"18167","55167","2019",7,7,0,80299,1035.57142857143,76.5714285714286
"18168","55169","2019",8,7,1,119625,1269.375,96
"18169","55170","2019",2,2,0,50500,642,81
"18170","55171","2019",6,6,0,133491.666666667,1153.33333333333,110.833333333333
"18171","55174","2019",1,1,0,45000,378,119
"18172","55178","2019",3,3,0,120666.666666667,682.666666666667,172
"18173","55179","2019",2,2,0,43500,436,103.5
"18174","55181","2019",36,36,0,110653.555555556,1024.41666666667,110.111111111111
"18175","55182","2019",4,4,0,139937.5,1000.25,147.25
"18176","55183","2019",2,2,0,87000,649.5,134
"18177","55184","2019",16,16,0,107720.75,957.4375,108.25
"18178","55185","2019",1,1,0,92000,920,100
"18179","55186","2019",23,23,0,127524.956521739,1322.26086956522,97.9130434782609
"18180","55191","2019",2,2,0,65000,1278.5,53.5
"18181","55193","2019",1,1,0,1e+05,5000,20
"18182","55195","2019",1,1,0,182300,1139,160
"18183","55196","2019",1,1,0,60000,1000,60
"18184","55197","2019",6,6,0,108150,932.166666666667,126.5
"18185","55198","2019",14,14,0,147182.142857143,1080.71428571429,133.714285714286
"18186","55199","2019",4,4,0,76500,803,95.75
"18187","55201","2019",1,1,0,134578,903,149
"18188","55202","2019",2,2,0,132250,1147,124
"18189","55204","2019",4,4,0,108544.5,1758,67.75
"18190","55206","2019",5,5,0,95000,859.4,118.8
"18191","55207","2019",1,1,0,77000,1283,60
"18192","55211","2019",1,1,0,240000,2353,102
"18193","55214","2019",2,2,0,36700,586.5,62.5
"18194","55215","2019",8,8,0,78231.25,679.25,113.5
"18195","55217","2019",2,2,0,62500,427.5,146
"18196","55220","2019",1,1,0,130000,1140,114
"18197","55221","2019",3,3,0,128666.666666667,1266.33333333333,103.333333333333
"18198","55224","2019",6,6,0,102611.166666667,792.666666666667,120
"18199","55226","2019",1,1,0,50000,532,94
"18200","55228","2019",7,7,0,67857.1428571429,597.714285714286,105.571428571429
"18201","55229","2019",2,2,0,61500,727.5,82
"18202","55232","2019",1,1,0,86366,467,185
"18203","55236","2019",9,9,0,164380,1349.22222222222,117.444444444444
"18204","55237","2019",1,1,0,135170,1229,110
"18205","55243","2019",2,2,0,133500,1347.5,97.5
"18206","55244","2019",2,2,0,72000,610.5,136
"18207","55245","2019",2,2,0,110450,1067,92
"18208","55246","2019",2,2,0,68500,385,178.5
"18209","55247","2019",1,1,0,30000,500,60
"18210","55248","2019",2,2,0,61500,591,109
"18211","55250","2019",2,2,0,101040,824,121
"18212","55251","2019",1,1,0,75000,750,100
"18213","55253","2019",9,9,0,91611.1111111111,911.666666666667,99.6666666666667
"18214","55255","2019",1,1,0,106000,1060,100
"18215","55256","2019",4,4,0,95025,797,130.5
"18216","55257","2019",3,3,0,60333.3333333333,532.333333333333,107
"18217","55258","2019",13,13,0,106289.076923077,771.769230769231,142.692307692308
"18218","55261","2019",2,2,0,66500,658.5,99
"18219","55262","2019",1,1,0,1e+05,654,153
"18220","55263","2019",2,2,0,90000,576,143.5
"18221","55264","2019",7,6,1,85285.7142857143,1016.71428571429,83.7142857142857
"18222","55265","2019",2,2,0,67500,562.5,120
"18223","55266","2019",2,2,0,96500,585.5,156.5
"18224","55267","2019",5,5,0,70460,1221.6,63
"18225","55268","2019",4,4,0,135000,1112,104.25
"18226","55271","2019",3,3,0,120056.666666667,879.666666666667,163.666666666667
"18227","55272","2019",6,6,0,115941.666666667,1115.5,107.833333333333
"18228","55274","2019",1,1,0,64500,806,80
"18229","55275","2019",2,2,0,73250,553.5,133
"18230","55276","2019",2,2,0,89500,910.5,103.5
"18231","55278","2019",3,3,0,127666.666666667,1348.66666666667,95
"18232","55279","2019",3,3,0,60666.6666666667,665.333333333333,96.3333333333333
"18233","55280","2019",1,1,0,95100,602,158
"18234","55281","2019",1,1,0,94765,1373,69
"18235","55284","2019",1,1,0,84000,1585,53
"18236","55285","2019",1,0,1,109250,874,125
"18237","55286","2019",1,1,0,135000,1134,119
"18238","55288","2019",21,21,0,93819.0476190476,959.142857142857,97.1428571428571
"18239","55290","2019",1,1,0,141000,887,159
"18240","55291","2019",35,30,5,93043.1428571429,976.2,96.4
"18241","55292","2019",3,3,0,83083.3333333333,618,146.666666666667
"18242","55293","2019",4,4,0,52500,753.75,69.5
"18243","55296","2019",8,8,0,82708.75,911.75,96.625
"18244","55297","2019",1,1,0,267000,1526,175
"18245","55299","2019",1,1,0,70000,1148,61
"18246","55300","2019",2,2,0,118925,1006.5,131
"18247","55301","2019",3,3,0,67333.3333333333,526.666666666667,126.666666666667
"18248","55302","2019",15,13,2,121446.666666667,1280.6,95.1333333333333
"18249","55303","2019",1,1,0,70000,493,142
"18250","55304","2019",1,1,0,156400,931,168
"18251","55306","2019",3,3,0,124225,1135.66666666667,101
"18252","55312","2019",1,1,0,35000,350,100
"18253","55313","2019",1,1,0,75000,560,134
"18254","55315","2019",3,3,0,84500,641,139
"18255","55316","2019",5,5,0,89900,852.2,111.8
"18256","55317","2019",1,1,0,130000,1238,105
"18257","55320","2019",1,1,0,75000,721,104
"18258","55321","2019",1,1,0,275000,1185,232
"18259","55324","2019",7,7,0,120742.857142857,1147.42857142857,113.142857142857
"18260","55326","2019",2,2,0,108330,647.5,170
"18261","55327","2019",6,6,0,88666.6666666667,774.666666666667,122.833333333333
"18262","55328","2019",1,1,0,75000,1000,75
"18263","55329","2019",5,5,0,110870,973.6,111.4
"18264","55330","2019",2,2,0,57500,772,75
"18265","55332","2019",1,1,0,115000,983,117
"18266","55333","2019",1,1,0,121500,694,175
"18267","55334","2019",3,3,0,88166.6666666667,644.333333333333,145
"18268","55335","2019",4,4,0,123000,992,118.5
"18269","55336","2019",3,3,0,108000,750.333333333333,142.666666666667
"18270","55338","2019",2,2,0,53500,498.5,106.5
"18271","55340","2019",4,4,0,99775,794.5,130.25
"18272","55341","2019",1,1,0,40000,500,80
"18273","55343","2019",1,1,0,76000,1382,55
"18274","55344","2019",1,1,0,195000,1696,115
"18275","55345","2019",3,3,0,96133.3333333333,1311.33333333333,75.6666666666667
"18276","55346","2019",4,4,0,62412.5,1137,77.25
"18277","55347","2019",4,4,0,116250,1093,100.25
"18278","55348","2019",4,4,0,62000,639.25,116.75
"18279","55349","2019",3,3,0,43166.6666666667,483.666666666667,89.6666666666667
"18280","55351","2019",16,13,3,94825.1875,1056.6875,97.25
"18281","55352","2019",2,2,0,87500,772.5,112.5
"18282","55353","2019",1,1,0,114345,1204,95
"18283","55355","2019",2,2,0,115000,1116,107
"18284","55356","2019",2,2,0,152000,1049,140
"18285","55357","2019",1,1,0,55000,809,68
"18286","55358","2019",2,2,0,32600,412,86
"18287","55360","2019",2,2,0,77000,878,88.5
"18288","55361","2019",3,3,0,43000,507.666666666667,88.6666666666667
"18289","55362","2019",2,2,0,94400,942,93
"18290","55363","2019",1,1,0,139000,1463,95
"18291","55364","2019",3,3,0,100166.666666667,935.333333333333,103
"18292","55365","2019",1,1,0,144000,1067,135
"18293","55366","2019",16,16,0,143960.125,1250.1875,120.3125
"18294","55369","2019",5,5,0,129920,1204.2,105.6
"18295","55370","2019",1,1,0,211000,1172,180
"18296","55372","2019",3,3,0,103666.666666667,722.333333333333,153.333333333333
"18297","55373","2019",2,2,0,92500,912.5,101
"18298","55374","2019",2,2,0,33750,381,88
"18299","55377","2019",1,1,0,220000,884,249
"18300","55378","2019",2,2,0,79250,1405.5,81.5
"18301","55381","2019",1,1,0,130000,1083,120
"18302","55382","2019",2,2,0,90750,747.5,118.5
"18303","55383","2019",4,4,0,78100,711.25,101.5
"18304","55384","2019",4,4,0,51500,601.25,88.25
"18305","55385","2019",6,6,0,109083.333333333,1158,91.8333333333333
"18306","55386","2019",2,2,0,125670,1105.5,117.5
"18307","55388","2019",1,1,0,117000,983,119
"18308","55389","2019",3,3,0,94000,942.333333333333,100.666666666667
"18309","55391","2019",4,4,0,114750,893.75,127
"18310","55396","2019",1,1,0,129500,814,159
"18311","55397","2019",3,3,0,55233.3333333333,673,88.3333333333333
"18312","55398","2019",8,8,0,169852.5,1506,120.75
"18313","55399","2019",1,1,0,110000,1222,90
"18314","55400","2019",1,1,0,64600,646,100
"18315","55401","2019",5,5,0,158082,1052.2,148.6
"18316","55404","2019",1,1,0,30000,390,77
"18317","55405","2019",3,3,0,94333.3333333333,953,104.666666666667
"18318","55406","2019",3,3,0,76710.3333333333,655,108.333333333333
"18319","55407","2019",4,4,0,90250,982.5,91.75
"18320","55408","2019",4,4,0,44750,564.25,79.75
"18321","55409","2019",1,1,0,136000,1236,110
"18322","55410","2019",1,1,0,54000,1080,50
"18323","55411","2019",1,1,0,81315,630,129
"18324","55414","2019",2,2,0,83250,1318,100
"18325","55415","2019",2,2,0,78150,548.5,141
"18326","55416","2019",2,2,0,63500,513,122.5
"18327","55421","2019",2,2,0,137000,595,230
"18328","55422","2019",1,1,0,177700,1367,130
"18329","55423","2019",3,3,0,45333.3333333333,527.666666666667,85.6666666666667
"18330","55424","2019",1,1,0,96500,869,111
"18331","55425","2019",1,1,0,65000,903,72
"18332","55426","2019",1,1,0,110000,880,125
"18333","55427","2019",28,28,0,101991.785714286,977.964285714286,106.035714285714
"18334","55428","2019",2,2,0,49062.5,642.5,78
"18335","55430","2019",1,1,0,38500,713,54
"18336","55431","2019",1,1,0,145000,967,150
"18337","55433","2019",8,8,0,150093.75,1021.875,146.5
"18338","55435","2019",11,11,0,100229.090909091,1165.54545454545,87.8181818181818
"18339","55438","2019",1,1,0,40000,667,60
"18340","55439","2019",1,1,0,125000,571,219
"18341","55442","2019",3,3,0,73250,709.666666666667,97.6666666666667
"18342","55443","2019",3,3,0,1e+05,1202.33333333333,103
"18343","55444","2019",3,3,0,110000,918,121.333333333333
"18344","55445","2019",3,3,0,117500,967,126.666666666667
"18345","55447","2019",6,6,0,98762.6666666667,867.5,118.666666666667
"18346","55449","2019",3,2,1,47500,495.666666666667,92.3333333333333
"18347","55454","2019",2,2,0,144125,1126.5,126.5
"18348","55456","2019",3,3,0,71000,495.333333333333,143.333333333333
"18349","55457","2019",4,4,0,149750,973.25,158
"18350","55458","2019",5,5,0,124484,1067,117.8
"18351","55459","2019",3,3,0,60000,811.333333333333,80.3333333333333
"18352","55461","2019",5,5,0,131000,1959.8,93.6
"18353","55462","2019",11,11,0,108995.454545455,919.363636363636,120.272727272727
"18354","55463","2019",31,28,3,84312.9032258065,827.58064516129,107.645161290323
"18355","55465","2019",2,2,0,138750,955.5,146
"18356","55466","2019",3,3,0,114866.666666667,1052,119.333333333333
"18357","55467","2019",8,8,0,115632.75,1003.5,124.375
"18358","55468","2019",1,1,0,119000,1653,72
"18359","55469","2019",3,3,0,62500,692.666666666667,100.333333333333
"18360","55473","2019",1,1,0,120000,690,174
"18361","55474","2019",3,3,0,73666.6666666667,684.333333333333,111.333333333333
"18362","55476","2019",4,4,0,71050,832.75,87.75
"18363","55477","2019",1,1,0,182500,1313,139
"18364","55482","2019",1,1,0,284624,2033,140
"18365","55485","2019",1,1,0,90250,902,100
"18366","55487","2019",2,2,0,65000,801,105
"18367","55488","2019",1,1,0,115000,1250,92
"18368","55489","2019",3,3,0,105366.666666667,1033.66666666667,111.666666666667
"18369","55490","2019",6,6,0,114050,836.666666666667,139.5
"18370","55492","2019",7,7,0,94042.8571428571,840.857142857143,113.571428571429
"18371","55493","2019",5,5,0,81500,790.4,96.2
"18372","55494","2019",6,6,0,71416.6666666667,774.666666666667,92.5
"18373","55496","2019",13,13,0,113623.076923077,1072.61538461538,107.384615384615
"18374","55497","2019",7,7,0,90285.7142857143,935.285714285714,106.142857142857
"18375","55498","2019",5,5,0,144909.2,909.4,161.4
"18376","55500","2019",10,10,0,129208.3,1038.8,126.1
"18377","55501","2019",12,12,0,102094.166666667,982.5,105.583333333333
"18378","55502","2019",16,15,1,94281.25,1022.4375,95.375
"18379","55504","2019",7,7,0,115385.714285714,939.142857142857,122.857142857143
"18380","55505","2019",37,34,3,138951.432432432,1446.21621621622,98.6216216216216
"18381","55507","2019",5,5,0,92100,827.2,115.8
"18382","55508","2019",5,5,0,139180,1518.2,101.8
"18383","55509","2019",3,3,0,62666.6666666667,738.666666666667,88.3333333333333
"18384","55510","2019",3,3,0,106866.666666667,989.333333333333,106.333333333333
"18385","55511","2019",1,1,0,195000,975,200
"18386","55512","2019",8,8,0,124125,1249.625,105.25
"18387","55514","2019",4,4,0,76467.5,559,130
"18388","55515","2019",1,1,0,70000,1489,47
"18389","55516","2019",6,6,0,82058.3333333333,784.5,109.666666666667
"18390","55517","2019",3,3,0,65466.6666666667,576.666666666667,113.333333333333
"18391","55518","2019",2,2,0,82250,675.5,122.5
"18392","55519","2019",17,17,0,116318.823529412,1162.41176470588,100.470588235294
"18393","55520","2019",7,7,0,76614.2857142857,711.142857142857,107.142857142857
"18394","55521","2019",1,1,0,83000,954,87
"18395","55523","2019",2,2,0,252500,1573,177.5
"18396","55525","2019",1,1,0,83000,474,175
"18397","55526","2019",3,3,0,106166.666666667,932.666666666667,113.333333333333
"18398","55527","2019",9,9,0,104061.111111111,911.777777777778,112.222222222222
"18399","55528","2019",1,1,0,131800,1108,119
"18400","55531","2019",1,1,0,126500,1265,100
"18401","55532","2019",4,4,0,72025,720.5,102.5
"18402","55533","2019",24,24,0,98942.0833333333,1019.66666666667,95.7916666666667
"18403","55535","2019",1,1,0,45000,978,46
"18404","55537","2019",1,1,0,148200,1703,87
"18405","55540","2019",1,1,0,104500,1077,97
"18406","55541","2019",5,5,0,80300,686.2,111.4
"18407","55543","2019",11,11,0,123226.363636364,1260.81818181818,104.181818181818
"18408","55545","2019",214,127,87,116846.439252336,1366.3738317757,86.6028037383178
"18409","55546","2019",1,1,0,40000,364,110
"18410","55547","2019",1,1,0,144000,720,200
"18411","55549","2019",1,1,0,60000,522,115
"18412","55551","2019",21,21,0,121635.047619048,1048,114.142857142857
"18413","55552","2019",1,1,0,40000,816,49
"18414","55553","2019",16,15,1,125075,1131.5,108
"18415","55554","2019",6,6,0,179666.5,1471.83333333333,131.5
"18416","55559","2019",2,2,0,77250,854.5,90.5
"18417","55560","2019",2,2,0,130762.5,564.5,250.5
"18418","55566","2019",6,6,0,114607.333333333,980,123.166666666667
"18419","55567","2019",3,3,0,116907.333333333,862.666666666667,139.666666666667
"18420","55568","2019",2,2,0,78750,613,150
"18421","55569","2019",1,1,0,50000,500,100
"18422","55570","2019",1,1,0,75000,556,135
"18423","55571","2019",7,7,0,60000,788.571428571429,81.5714285714286
"18424","55573","2019",16,16,0,88031.25,797.9375,115.25
"18425","55574","2019",1,1,0,28000,560,50
"18426","55577","2019",1,1,0,79000,840,94
"18427","55578","2019",3,3,0,120006.666666667,794,150
"18428","55579","2019",3,3,0,94000,1193.33333333333,87
"18429","55580","2019",1,1,0,161975,1396,116
"18430","55582","2019",1,1,0,1e+05,500,200
"18431","55583","2019",3,3,0,141000,1065,145
"18432","55584","2019",1,1,0,165000,1755,94
"18433","55586","2019",3,3,0,60766.6666666667,677.666666666667,91
"18434","56001","2019",42,41,1,143296.19047619,1319.19047619048,105.809523809524
"18435","56002","2019",47,43,4,190108.085106383,2066.21276595745,92.3191489361702
"18436","56003","2019",96,67,29,364662.989583333,3279.67708333333,110.833333333333
"18437","56004","2019",37,35,2,144515.054054054,1811.32432432432,85.054054054054
"18438","56005","2019",151,82,69,301514.549668874,3976.70860927152,75.0331125827815
"18439","56006","2019",7,7,0,92900,1012.57142857143,99
"18440","56007","2019",285,117,168,206037.09122807,2597.30526315789,77.7964912280702
"18441","56008","2019",80,70,10,453484.9875,3597.3375,117.525
"18442","56009","2019",23,23,0,299346.826086957,3221.91304347826,103
"18443","56010","2019",103,88,15,132127.54368932,1473.8640776699,93.0388349514563
"18444","56011","2019",34,34,0,111029.264705882,1292.35294117647,93.4411764705882
"18445","56012","2019",19,19,0,187642.105263158,1556.73684210526,119.315789473684
"18446","56013","2019",54,51,3,231379.62962963,2266.31481481481,102.592592592593
"18447","56014","2019",26,25,1,120819.269230769,1136.53846153846,107.230769230769
"18448","56015","2019",33,32,1,172447.575757576,1746.09090909091,101.606060606061
"18449","56017","2019",28,26,2,147945.357142857,1357.10714285714,106.142857142857
"18450","56018","2019",21,17,4,213081.666666667,2407.57142857143,88.0476190476191
"18451","56019","2019",9,9,0,87086.6666666667,1305.33333333333,79.7777777777778
"18452","56020","2019",15,15,0,125752,1252.26666666667,100.6
"18453","56021","2019",8,8,0,166875,1925,93.375
"18454","56022","2019",19,19,0,140597.894736842,1732.47368421053,88.2631578947368
"18455","56023","2019",85,73,12,235590.941176471,2099.92941176471,112.670588235294
"18456","56024","2019",24,24,0,106026.25,1041.29166666667,98.8333333333333
"18457","56025","2019",2,2,0,59000,756,71.5
"18458","56026","2019",48,47,1,105178.541666667,1115.5,99.5625
"18459","56027","2019",6,6,0,84100,929.666666666667,87.5
"18460","56028","2019",30,30,0,143081.233333333,1412.96666666667,97
"18461","56029","2019",13,13,0,204615.384615385,1669.23076923077,123.307692307692
"18462","56030","2019",16,16,0,164875,2002.6875,89.5
"18463","56031","2019",47,46,1,145945.531914894,1506.95744680851,95.5531914893617
"18464","56032","2019",35,35,0,116080.571428571,1215.05714285714,95
"18465","56033","2019",47,46,1,106093.787234043,1078.91489361702,98.8297872340426
"18466","56034","2019",253,113,140,288646.09486166,4139.77075098814,73.6877470355731
"18467","56035","2019",9,9,0,118888.888888889,1290.44444444444,90.7777777777778
"18468","56036","2019",67,59,8,191178.164179104,1851.38805970149,106.55223880597
"18469","56039","2019",25,25,0,153432.8,1445.64,111.04
"18470","56040","2019",29,29,0,154637.931034483,1536.24137931034,100.137931034483
"18471","56041","2019",40,40,0,110635,1151.675,97.825
"18472","56042","2019",20,20,0,111900,1225.5,94.7
"18473","56043","2019",14,14,0,96582.1428571429,862,112.857142857143
"18474","56044","2019",8,8,0,109000,1128.375,99.125
"18475","56045","2019",11,11,0,117227.272727273,1448.81818181818,83.1818181818182
"18476","56046","2019",40,40,0,289811.425,2620.775,112.125
"18477","56047","2019",17,17,0,112362.647058824,1067.94117647059,102.823529411765
"18478","56048","2019",23,23,0,76514,850.347826086957,88.5217391304348
"18479","56050","2019",7,7,0,147497.142857143,1464.28571428571,102.571428571429
"18480","56051","2019",12,12,0,130677.5,1342.91666666667,93.3333333333333
"18481","56052","2019",120,77,43,226570.933333333,3525.58333333333,70.3666666666667
"18482","56053","2019",78,71,7,199337.051282051,1795.14102564103,111.294871794872
"18483","56054","2019",94,72,22,209460.20212766,2527.08510638298,84.9787234042553
"18484","56055","2019",57,36,21,223489.473684211,2835.42105263158,85.8771929824561
"18485","56056","2019",5,5,0,96990,1018.4,94.8
"18486","56057","2019",49,45,4,98449.7551020408,1196.59183673469,85.265306122449
"18487","56058","2019",49,48,1,169724.489795918,1678.28571428571,101.224489795918
"18488","56060","2019",14,14,0,125766.785714286,1185.5,108.857142857143
"18489","56061","2019",57,57,0,117252.543859649,1284.64912280702,91.6666666666667
"18490","56062","2019",24,22,2,204715.833333333,2214,92.75
"18491","56063","2019",27,26,1,230542.777777778,2031.59259259259,113.074074074074
"18492","56065","2019",8,8,0,164662.5,1340.75,124.25
"18493","56066","2019",72,71,1,86839.4444444444,957.555555555556,91.8611111111111
"18494","56067","2019",62,61,1,227801.774193548,2017.53225806452,117.177419354839
"18495","56068","2019",3,3,0,113966.666666667,942.666666666667,128.666666666667
"18496","56069","2019",91,85,6,224306.054945055,3071.98901098901,80.7142857142857
"18497","56070","2019",41,41,0,115635.609756098,1144.65853658537,98.219512195122
"18498","56071","2019",9,9,0,85013.1111111111,1245.33333333333,76.1111111111111
"18499","56072","2019",9,9,0,73733.3333333333,1104.88888888889,73.4444444444444
"18500","56073","2019",27,27,0,83885.5555555556,859.851851851852,98.0740740740741
"18501","56074","2019",19,19,0,114417.210526316,1287.47368421053,96.4210526315789
"18502","56075","2019",81,65,16,107563.827160494,1288.58024691358,85.5555555555556
"18503","56076","2019",16,16,0,92118.75,1008.5,92.125
"18504","56077","2019",8,8,0,146914.125,1871,81.5
"18505","56078","2019",201,139,62,213133.07960199,2530.00995024876,89.681592039801
"18506","56079","2019",20,20,0,106780.1,1173.55,88.45
"18507","56080","2019",30,30,0,79300.1666666667,946.233333333333,89.1666666666667
"18508","56081","2019",31,31,0,87271.1935483871,958.806451612903,93.9032258064516
"18509","56082","2019",4,4,0,74750,873.25,80.25
"18510","56083","2019",268,174,94,143251.526119403,1747.08582089552,82.1268656716418
"18511","56084","2019",24,24,0,261721.083333333,2294.91666666667,114.041666666667
"18512","56085","2019",1,1,0,250000,7812,32
"18513","56086","2019",3,3,0,449166.666666667,4701,96.6666666666667
"18514","56087","2019",18,16,2,539410.555555556,4231.16666666667,118.222222222222
"18515","56088","2019",8,8,0,260937.5,3994.25,68.75
"18516","56089","2019",27,27,0,133571.296296296,1288.2962962963,102.962962962963
"18517","56090","2019",83,78,5,152001.927710843,1637.39759036145,95.9036144578313
"18518","56091","2019",43,40,3,143794.88372093,1398.32558139535,103.186046511628
"18519","56092","2019",13,13,0,97107.6923076923,1073.76923076923,85.1538461538462
"18520","56093","2019",10,10,0,115995,1132,104.6
"18521","56094","2019",73,66,7,244225.643835616,2136.90410958904,119.780821917808
"18522","56096","2019",11,11,0,233505.454545455,2393.27272727273,103.272727272727
"18523","56097","2019",45,41,4,166840.422222222,1825.2,92.2222222222222
"18524","56098","2019",312,230,82,148695.211538462,1730.74358974359,87.5480769230769
"18525","56099","2019",9,9,0,65500,766.333333333333,84.8888888888889
"18526","56100","2019",40,40,0,91217.25,1173.425,91
"18527","56101","2019",118,101,17,154013.262711864,1700.44915254237,93.7203389830509
"18528","56102","2019",29,29,0,94778.6206896552,1048.55172413793,92.7241379310345
"18529","56103","2019",7,7,0,99571.4285714286,1021.28571428571,98.7142857142857
"18530","56104","2019",9,9,0,136250,1561.44444444444,86.3333333333333
"18531","56105","2019",28,28,0,73910.6785714286,884.285714285714,84.0714285714286
"18532","56106","2019",28,22,6,340617.178571429,4519.14285714286,78.3214285714286
"18533","56107","2019",153,89,64,335962.431372549,3554.11111111111,98.5882352941177
"18534","56108","2019",22,22,0,133890.909090909,1517.45454545455,90.6818181818182
"18535","56109","2019",17,17,0,209076.470588235,1804.94117647059,117.823529411765
"18536","56110","2019",15,15,0,67033.3333333333,829.2,82.4
"18537","56111","2019",40,39,1,151405.675,1358.825,110.975
"18538","56112","2019",13,13,0,115119.230769231,1226.84615384615,95.3846153846154
"18539","56113","2019",10,10,0,91020,982.4,94.9
"18540","56114","2019",31,31,0,247661.290322581,3636.32258064516,71.8387096774194
"18541","56115","2019",18,18,0,212388.888888889,1917.88888888889,114.722222222222
"18542","56116","2019",39,34,5,318883.333333333,3465.89743589744,95.2307692307692
"18543","56117","2019",76,56,20,120762.026315789,1462.53947368421,84.6710526315789
"18544","56118","2019",104,79,25,172652.596153846,2129.39423076923,83.4519230769231
"18545","56119","2019",43,42,1,263422.093023256,2288.23255813953,117.953488372093
"18546","56120","2019",17,17,0,185813.352941176,1793.88235294118,103.117647058824
"18547","56121","2019",1174,368,806,137586.714650767,1824.91567291312,75.1524701873935
"18548","56122","2019",33,33,0,128129.303030303,1323.51515151515,97.4545454545455
"18549","56123","2019",25,25,0,137948.4,1339.72,109.12
"18550","56124","2019",31,22,9,112210,1450,81.741935483871
"18551","56125","2019",18,18,0,132116.388888889,1311.77777777778,100.944444444444
"18552","56126","2019",39,39,0,180266.666666667,1892.76923076923,100.897435897436
"18553","56127","2019",43,39,4,91467.6279069767,1046.95348837209,91.6511627906977
"18554","56128","2019",30,30,0,107950,1290.06666666667,85
"18555","56129","2019",23,23,0,88997.6086956522,998,87.3913043478261
"18556","56130","2019",23,23,0,200697.826086957,1830.5652173913,110.086956521739
"18557","56131","2019",39,39,0,123664.102564103,1297.92307692308,96.7435897435897
"18558","56132","2019",23,23,0,192560.52173913,2014.26086956522,98.2173913043478
"18559","56133","2019",11,11,0,147347.545454545,1455.36363636364,101.909090909091
"18560","56134","2019",22,22,0,89021.5909090909,827.863636363636,106.954545454545
"18561","56135","2019",16,16,0,137038.125,1289.3125,106.875
"18562","56136","2019",7,7,0,125485.714285714,1093.14285714286,113.857142857143
"18563","56137","2019",51,47,4,212493.411764706,1909.54901960784,110.686274509804
"18564","56139","2019",4,4,0,1e+05,960.25,105.25
"18565","56140","2019",41,41,0,125970.512195122,1272,102.853658536585
"18566","56141","2019",32,32,0,151029.59375,1567.96875,105.65625
"18567","56143","2019",101,94,7,203554.811881188,2001.23762376238,103.950495049505
"18568","56144","2019",53,53,0,96992.4528301887,1083.1320754717,88.3018867924528
"18569","56145","2019",20,20,0,108979.5,970,105
"18570","56146","2019",12,12,0,80464.75,952,84
"18571","56147","2019",60,60,0,195587.5,1815.06666666667,107.383333333333
"18572","56148","2019",15,15,0,287230,2589.6,99.7333333333333
"18573","56149","2019",34,34,0,155220,1544.14705882353,104.411764705882
"18574","56151","2019",51,51,0,126369.745098039,1279.54901960784,102.803921568627
"18575","56152","2019",68,47,21,215776.514705882,2980.05882352941,74.3970588235294
"18576","56153","2019",47,45,2,163291.595744681,1466.59574468085,111.978723404255
"18577","56154","2019",29,28,1,112584.344827586,1199.55172413793,88.0689655172414
"18578","56155","2019",101,91,10,193579.504950495,2761.58415841584,74.2376237623762
"18579","56156","2019",6,6,0,71550,829.166666666667,85.8333333333333
"18580","56157","2019",29,29,0,215644.310344828,1669.65517241379,119.172413793103
"18581","56158","2019",77,46,31,202973.051948052,2345.42857142857,85.1428571428571
"18582","56159","2019",14,14,0,130966.071428571,1158.64285714286,120.5
"18583","56160","2019",13,13,0,113349.153846154,1349.15384615385,92.2307692307692
"18584","56161","2019",67,51,16,224345.268656716,2313.71641791045,100.34328358209
"18585","56162","2019",280,221,59,270191.553571429,2852.09285714286,98.4214285714286
"18586","56163","2019",25,25,0,103202.64,1019.56,108.2
"18587","56164","2019",120,92,28,267750.533333333,2538.75833333333,105.333333333333
"18588","56165","2019",174,137,37,143982.695402299,1598.74137931034,92.1896551724138
"18589","56166","2019",44,41,3,149140.909090909,1609.31818181818,91.6136363636364
"18590","56167","2019",23,22,1,245475.391304348,2327.21739130435,107.739130434783
"18591","56168","2019",34,30,4,288494.647058824,2820.94117647059,102.558823529412
"18592","56169","2019",86,79,7,242025.581395349,2344.79069767442,103.96511627907
"18593","56170","2019",15,15,0,90534.3333333333,1097.73333333333,80.9333333333333
"18594","56171","2019",32,32,0,138544.6875,1576.21875,97.6875
"18595","56172","2019",44,44,0,131027.272727273,1314.29545454545,99.1818181818182
"18596","56173","2019",74,74,0,117625.243243243,1247.37837837838,100.527027027027
"18597","56174","2019",32,32,0,135301.78125,1495.53125,95.875
"18598","56175","2019",49,45,4,208860.918367347,2035.22448979592,105.265306122449
"18599","56176","2019",113,83,30,190631.707964602,2216.59292035398,91.2477876106195
"18600","56177","2019",150,127,23,173981.36,1806.33333333333,96.4333333333333
"18601","56178","2019",269,157,112,105208.096654275,1274.67657992565,82.9442379182156
"18602","56179","2019",43,40,3,179208.837209302,1844.60465116279,102.395348837209
"18603","56180","2019",9,9,0,81888.8888888889,990.111111111111,79.8888888888889
"18604","56181","2019",60,43,17,209377.166666667,2364.65,89.8666666666667
"18605","56182","2019",20,20,0,84549.95,940,87.7
"18606","56184","2019",101,89,12,161600.940594059,1733.83168316832,96.7029702970297
"18607","56185","2019",102,101,1,204553.921568627,1962.63725490196,107.117647058824
"18608","56186","2019",267,110,157,248434.179775281,4007.01498127341,65.8689138576779
"18609","56188","2019",26,26,0,122157.692307692,1252.30769230769,92.0384615384615
"18610","56189","2019",14,14,0,95567.8571428571,885,106.642857142857
"18611","56190","2019",22,21,1,111568.181818182,1186.95454545455,97.3636363636364
"18612","56191","2019",14,14,0,96553.5714285714,1077.21428571429,88.9285714285714
"18613","56193","2019",83,82,1,187718.240963855,1969.85542168675,96.1084337349398
"18614","56194","2019",32,32,0,119796.84375,1303.34375,95.125
"18615","56195","2019",25,12,13,137676,1810.4,78.8
"18616","56196","2019",21,19,2,140145.238095238,1464.61904761905,94.5714285714286
"18617","56197","2019",31,31,0,106576.774193548,1274.45161290323,82.6129032258064
"18618","56198","2019",16,16,0,81287.5,898.625,89.4375
"18619","56199","2019",16,16,0,75161.875,849.5,85.8125
"18620","56200","2019",23,23,0,111760,1069,105.086956521739
"18621","56201","2019",13,13,0,85880.3846153846,1013.23076923077,92.5384615384615
"18622","56202","2019",9,9,0,98785.5555555556,1147.33333333333,86.6666666666667
"18623","56203","2019",16,16,0,114329.5,1259.8125,94.125
"18624","56204","2019",10,10,0,99326.6,1243.5,86.6
"18625","56205","2019",18,18,0,289423.333333333,3281.33333333333,93.6111111111111
"18626","56206","2019",143,112,31,240517.636363636,2397.86013986014,101.41958041958
"18627","56207","2019",21,21,0,133856.666666667,1340.80952380952,102.857142857143
"18628","56208","2019",6,6,0,60166.6666666667,971.333333333333,78.8333333333333
"18629","56209","2019",3,3,0,134166.666666667,1337,99.3333333333333
"18630","56210","2019",12,12,0,100854.166666667,800.333333333333,121.25
"18631","56211","2019",15,15,0,110077.333333333,1067.33333333333,102.133333333333
"18632","56212","2019",36,36,0,113716.666666667,1239.97222222222,92.3611111111111
"18633","56213","2019",4,4,0,138000,1239.5,110.5
"18634","56214","2019",79,73,6,304747.202531646,3436.3164556962,92.3924050632911
"18635","56215","2019",10,10,0,114270,1343.7,87.3
"18636","56216","2019",4,4,0,93750,1192.75,70.75
"18637","56218","2019",18,18,0,107401.111111111,1329.05555555556,85.1111111111111
"18638","56219","2019",24,24,0,164252.5,1511.54166666667,110.875
"18639","56220","2019",18,18,0,228222.222222222,2243.5,108.333333333333
"18640","56221","2019",25,25,0,94022.8,1051.56,87.68
"18641","56222","2019",35,34,1,143419.942857143,1519.22857142857,95.6285714285714
"18642","56223","2019",21,21,0,166983.80952381,1446.80952380952,115.761904761905
"18643","56224","2019",2,2,0,90000,1150,77.5
"18644","56225","2019",2,2,0,57000,584,92
"18645","56226","2019",10,10,0,91551,998.4,91
"18646","56227","2019",13,13,0,81370,850.923076923077,97.3846153846154
"18647","56228","2019",9,9,0,180255.555555556,1610.77777777778,121.222222222222
"18648","56229","2019",13,13,0,90156.2307692308,921.153846153846,97.3846153846154
"18649","56230","2019",10,10,0,113126.6,1793.2,82.7
"18650","56231","2019",58,55,3,233773.431034483,1957.13793103448,119.879310344828
"18651","56232","2019",8,8,0,110594.75,1228.625,88.5
"18652","56233","2019",53,37,16,316051.679245283,3576.96226415094,89.2264150943396
"18653","56234","2019",69,60,9,335638.913043478,3810.88405797101,87.231884057971
"18654","56236","2019",10,10,0,111187,1215.5,94.9
"18655","56237","2019",21,20,1,123737.619047619,1228,98.2857142857143
"18656","56238","2019",9,9,0,61703.8888888889,863.333333333333,77.3333333333333
"18657","56239","2019",21,21,0,134705.238095238,1349.66666666667,99
"18658","56240","2019",306,223,83,259434.320261438,3096.19607843137,86.8888888888889
"18659","56241","2019",19,18,1,222022.421052632,3109.78947368421,79.3157894736842
"18660","56242","2019",15,15,0,117234.666666667,1191.2,102.666666666667
"18661","56243","2019",153,80,73,242950.529411765,2899.50326797386,80.7450980392157
"18662","56244","2019",38,38,0,113048.421052632,1349.26315789474,85.6578947368421
"18663","56245","2019",10,10,0,55899,716.7,77
"18664","56246","2019",13,13,0,132537.692307692,1266.84615384615,102.615384615385
"18665","56247","2019",49,49,0,215093.265306122,2051.67346938776,108.632653061224
"18666","56248","2019",55,52,3,248931.545454545,2421.01818181818,107.018181818182
"18667","56249","2019",28,28,0,134377.928571429,1320.03571428571,103.178571428571
"18668","56250","2019",7,7,0,122214.285714286,1528.71428571429,83.4285714285714
"18669","56251","2019",114,97,17,245533.51754386,2403.4298245614,103.175438596491
"18670","56252","2019",29,29,0,332539.655172414,2720.20689655172,122.379310344828
"18671","56253","2019",12,12,0,80830.3333333333,1064.16666666667,79.5
"18672","56254","2019",23,23,0,169100.217391304,1573.4347826087,108.391304347826
"18673","56255","2019",29,23,6,180534.482758621,2094.06896551724,90.551724137931
"18674","56256","2019",1,1,0,115000,1278,90
"18675","56257","2019",16,16,0,74894.9375,746.6875,104.5
"18676","56258","2019",80,39,41,384126.775,4575.475,78.5
"18677","56259","2019",22,22,0,193052.409090909,2078.09090909091,93.1363636363636
"18678","56260","2019",1307,345,962,202468.280030604,2797.41469013007,71.1392501912777
"18679","56261","2019",19,19,0,178364.842105263,1695.63157894737,111.052631578947
"18680","56262","2019",43,37,6,283377.976744186,2981.11627906977,97.7674418604651
"18681","56263","2019",46,42,4,219649.869565217,1973.47826086957,113.478260869565
"18682","56264","2019",3,3,0,111000,1141,96
"18683","57009","2019",1,1,0,314050,1256,250
"18684","58002","2019",16,16,0,72387.5,885.1875,83.5625
"18685","58003","2019",12,12,0,87791.6666666667,936.833333333333,92.25
"18686","58004","2019",8,8,0,84043.75,1222.125,72.25
"18687","58005","2019",2,2,0,53000,799.5,71
"18688","58006","2019",5,5,0,114500,918.2,122
"18689","58007","2019",5,5,0,120040,1081.8,122
"18690","58009","2019",4,4,0,47600,450,100.5
"18691","58010","2019",11,11,0,90463.6363636364,1244.27272727273,58.3636363636364
"18692","58011","2019",4,4,0,68625,564.75,105.25
"18693","58012","2019",11,11,0,126818.181818182,907.909090909091,131
"18694","58013","2019",3,3,0,48208.3333333333,606,78.3333333333333
"18695","58014","2019",1,1,0,37000,440,84
"18696","58015","2019",1,1,0,35000,648,54
"18697","58016","2019",1,1,0,58000,460,126
"18698","58017","2019",5,5,0,68800,712.8,87
"18699","58018","2019",1,1,0,157500,1212,130
"18700","58019","2019",1,1,0,95000,950,100
"18701","58023","2019",3,3,0,83333.3333333333,1437.33333333333,62.3333333333333
"18702","58024","2019",5,5,0,101632.8,1206,85.4
"18703","58025","2019",1,1,0,150000,1261,119
"18704","58026","2019",1,1,0,15000,625,24
"18705","58028","2019",2,2,0,82750,662.5,128
"18706","58029","2019",2,2,0,29000,551.5,53.5
"18707","58030","2019",6,6,0,58333.3333333333,576.833333333333,105
"18708","58031","2019",6,6,0,70833.3333333333,657,107.5
"18709","58032","2019",8,8,0,65715.625,637.5,104.625
"18710","58033","2019",5,5,0,70700,877,78
"18711","58034","2019",2,2,0,82250,602.5,140
"18712","58035","2019",2,2,0,65600,533.5,127.5
"18713","58036","2019",12,12,0,88208.3333333333,1129.33333333333,87.9166666666667
"18714","58037","2019",14,14,0,91857.6428571429,990.285714285714,92.0714285714286
"18715","58039","2019",4,4,0,77375,687,111.25
"18716","58040","2019",2,2,0,38750,458,85
"18717","58041","2019",4,4,0,76875,759,95
"18718","58043","2019",2,2,0,125000,1617.5,119.5
"18719","58044","2019",15,15,0,77133.3333333333,1029.93333333333,78.0666666666667
"18720","58045","2019",2,2,0,59900,441,144
"18721","58046","2019",21,20,1,77341.6190476191,858.904761904762,91.0476190476191
"18722","58047","2019",11,11,0,52918.1818181818,638.090909090909,82
"18723","58048","2019",4,4,0,114725,1023.25,108.25
"18724","58049","2019",1,1,0,47500,1696,28
"18725","58050","2019",2,2,0,113000,729.5,153.5
"18726","58051","2019",17,17,0,111273.529411765,1421.35294117647,80.8823529411765
"18727","58052","2019",1,1,0,115000,1307,88
"18728","58053","2019",2,2,0,62500,616,96.5
"18729","58055","2019",17,17,0,99411.7647058823,1155.58823529412,86.1764705882353
"18730","58056","2019",6,5,1,90930,1096.83333333333,85.5
"18731","58057","2019",17,17,0,86725.8823529412,971.117647058824,86.6470588235294
"18732","58058","2019",7,7,0,75214.2857142857,962.714285714286,85.1428571428571
"18733","58059","2019",79,65,14,81010.9620253165,976.291139240506,84.0126582278481
"18734","58060","2019",6,6,0,125666.666666667,868.333333333333,140.166666666667
"18735","58061","2019",3,3,0,57000,772.333333333333,67.6666666666667
"18736","58062","2019",12,11,1,86100,994.916666666667,87.25
"18737","58063","2019",4,4,0,94000,946.25,93.5
"18738","58064","2019",9,9,0,70833.3333333333,865.888888888889,82.5555555555556
"18739","58065","2019",10,10,0,66090,700.3,92.5
"18740","58066","2019",4,4,0,85695.75,874,90.25
"18741","58067","2019",20,20,0,115025,1161.65,102.35
"18742","58068","2019",4,4,0,70250,1622.25,47.75
"18743","58069","2019",4,4,0,66125,1002.25,63
"18744","58070","2019",2,2,0,69900,594.5,117.5
"18745","58071","2019",2,2,0,65000,966,67
"18746","58072","2019",7,7,0,112142.857142857,1320.71428571429,88.1428571428571
"18747","58074","2019",6,6,0,64083.3333333333,937.166666666667,68.8333333333333
"18748","58075","2019",2,2,0,93250,1004,95.5
"18749","58077","2019",5,5,0,98600,841.8,111.8
"18750","58079","2019",27,23,4,80209.2592592593,909.592592592593,87
"18751","58080","2019",2,2,0,69500,1370.5,50.5
"18752","58081","2019",8,8,0,109312.5,1230.5,98
"18753","58082","2019",6,6,0,72333.3333333333,764.5,100.833333333333
"18754","58083","2019",17,16,1,83411.7647058823,1037.23529411765,83.6470588235294
"18755","58084","2019",6,6,0,59473.3333333333,738,83.3333333333333
"18756","58085","2019",9,9,0,77444.4444444444,913.777777777778,98.1111111111111
"18757","58086","2019",140,118,22,97851,1121.13571428571,87.9785714285714
"18758","58087","2019",10,10,0,76298.2,1126.5,70.3
"18759","58088","2019",37,36,1,132474.054054054,1358.78378378378,97.5405405405405
"18760","58089","2019",4,4,0,67500,589,120.75
"18761","58090","2019",2,2,0,68500,615,99
"18762","58092","2019",9,9,0,107284.444444444,950.444444444444,116.888888888889
"18763","58093","2019",1,1,0,30000,625,48
"18764","58094","2019",8,8,0,84787.5,1014,78.75
"18765","58095","2019",54,39,15,84607.7962962963,1052.27777777778,80.7407407407407
"18766","58096","2019",5,5,0,90100,1047.4,94.6
"18767","58098","2019",1,1,0,58000,617,94
"18768","58099","2019",4,4,0,84400,1003.5,79.5
"18769","58101","2019",3,3,0,115666.666666667,774,131
"18770","58102","2019",30,29,1,86210,857.433333333333,102.333333333333
"18771","58103","2019",7,7,0,106000,1271,95.1428571428571
"18772","58104","2019",14,14,0,103800.142857143,1109.78571428571,94.8571428571429
"18773","58106","2019",13,13,0,127226.923076923,1123,114.230769230769
"18774","58107","2019",6,6,0,33916.6666666667,591.333333333333,58
"18775","58108","2019",1,1,0,195000,1083,180
"18776","58109","2019",8,8,0,75875,829.125,86.875
"18777","58110","2019",2,2,0,99000,1026,105
"18778","58111","2019",5,5,0,101600,941.8,111.8
"18779","58112","2019",5,5,0,98400,1080,90.2
"18780","58113","2019",2,2,0,74000,997.5,74.5
"18781","58115","2019",3,3,0,91333.3333333333,1136.33333333333,79.3333333333333
"18782","58117","2019",48,41,7,91894.7708333333,1034.27083333333,88.125
"18783","58118","2019",7,7,0,54857.1428571429,724.428571428571,78.8571428571429
"18784","58119","2019",1,1,0,265000,1167,227
"18785","58120","2019",3,3,0,63966.6666666667,720,94.3333333333333
"18786","58121","2019",36,32,4,96872.5277777778,1154.27777777778,84.8055555555556
"18787","58122","2019",5,5,0,75000,937.4,87.4
"18788","58124","2019",12,12,0,122266.666666667,972.583333333333,122.5
"18789","58125","2019",2,2,0,132105,680,212.5
"18790","58126","2019",3,2,1,62166.6666666667,738,85.3333333333333
"18791","58127","2019",4,4,0,82900,926.75,89
"18792","58128","2019",2,2,0,33250,634.5,49
"18793","58129","2019",7,7,0,57714.2857142857,723.571428571429,78.5714285714286
"18794","58130","2019",2,2,0,90000,793.5,113.5
"18795","58131","2019",28,28,0,96089.2857142857,1109.39285714286,87.5
"18796","58132","2019",4,4,0,57500,627.75,86.25
"18797","58133","2019",2,2,0,44250,515,86
"18798","58134","2019",30,28,2,73841,919.966666666667,80.7333333333333
"18799","58135","2019",2,2,0,85750,918.5,82.5
"18800","58138","2019",6,6,0,95333.3333333333,917.666666666667,111.833333333333
"18801","58139","2019",5,5,0,77980,935,89.2
"18802","58140","2019",3,3,0,31033.3333333333,624,52
"18803","58142","2019",2,2,0,41250,691.5,70
"18804","58143","2019",1,1,0,77000,906,85
"18805","58144","2019",18,18,0,86133.3333333333,892.722222222222,105.277777777778
"18806","58145","2019",20,19,1,68976.9,874.8,79.85
"18807","58146","2019",14,14,0,96935.7142857143,879.142857142857,110.5
"18808","58147","2019",6,6,0,57400,691.5,85
"18809","58148","2019",8,8,0,73500,781.375,95.625
"18810","58149","2019",30,28,2,95340.3333333333,1209.2,80.4
"18811","58150","2019",1,1,0,233150,1586,147
"18812","58151","2019",61,60,1,59770.4918032787,804.049180327869,75
"18813","58152","2019",12,12,0,113633.333333333,1094.08333333333,100
"18814","58155","2019",7,7,0,83042.8571428571,985.571428571429,89.5714285714286
"18815","58156","2019",6,6,0,68933.3333333333,671.5,104.666666666667
"18816","58157","2019",5,5,0,74400,1002.8,74.6
"18817","58158","2019",5,5,0,117180,785,154.2
"18818","58159","2019",2,2,0,90000,735.5,124.5
"18819","58160","2019",44,40,4,139497.227272727,1565.43181818182,90.1136363636364
"18820","58161","2019",5,5,0,82400,881.6,94.6
"18821","58162","2019",2,2,0,122500,1102.5,98.5
"18822","58163","2019",4,4,0,103750,744.75,145
"18823","58164","2019",6,6,0,103383.333333333,923.166666666667,104.333333333333
"18824","58165","2019",1,1,0,20000,333,60
"18825","58166","2019",13,13,0,83027.6923076923,1052.38461538462,89.6923076923077
"18826","58168","2019",9,9,0,85997.2222222222,1077.22222222222,77.1111111111111
"18827","58170","2019",6,6,0,49166.6666666667,509.833333333333,99.1666666666667
"18828","58171","2019",3,3,0,63833.3333333333,1064.66666666667,61.3333333333333
"18829","58172","2019",1,1,0,125000,1116,112
"18830","58173","2019",2,2,0,71000,958.5,72.5
"18831","58174","2019",2,2,0,29000,531,56
"18832","58175","2019",1,1,0,90000,1000,90
"18833","58176","2019",3,3,0,127666.666666667,894,134.333333333333
"18834","58177","2019",9,9,0,111754.444444444,1182.55555555556,99.4444444444444
"18835","58178","2019",3,3,0,223333.333333333,3104.66666666667,52.6666666666667
"18836","58179","2019",5,5,0,63800,711,85
"18837","58180","2019",12,12,0,100266.666666667,1306,80.0833333333333
"18838","58181","2019",3,3,0,52666.6666666667,625.333333333333,92.6666666666667
"18839","58182","2019",12,12,0,94000,918.5,108.916666666667
"18840","58183","2019",5,5,0,71800,909.4,79.2
"18841","58184","2019",2,2,0,46500,1114.5,45.5
"18842","58185","2019",14,14,0,105817.142857143,1424.85714285714,83.8571428571429
"18843","58186","2019",5,5,0,135000,1597.4,85
"18844","58187","2019",4,4,0,122750,1030.75,108.75
"18845","58188","2019",4,4,0,54500,981,66.75
"18846","58189","2019",8,7,1,98750,1208.625,82.75
"18847","58190","2019",1,1,0,48000,960,50
"18848","58191","2019",3,3,0,104566.666666667,1410.66666666667,89
"18849","58192","2019",4,4,0,32075,501.25,62.5
"18850","58193","2019",13,13,0,83115.3846153846,942.692307692308,89.5384615384615
"18851","58194","2019",473,203,270,87168.8372093023,1075.18604651163,79.3171247357294
"18852","58195","2019",1,1,0,210000,1438,146
"18853","58196","2019",2,2,0,47000,783.5,60
"18854","58197","2019",5,5,0,117000,1118.2,102.6
"18855","58198","2019",6,6,0,99933.3333333333,1114.16666666667,96.6666666666667
"18856","58199","2019",6,6,0,55416.6666666667,669.666666666667,92.3333333333333
"18857","58200","2019",1,1,0,77000,1000,77
"18858","58201","2019",5,5,0,99430,1034.4,110
"18859","58202","2019",3,3,0,56440.6666666667,667.666666666667,82
"18860","58203","2019",3,3,0,47400,591,81
"18861","58204","2019",6,6,0,140833.333333333,1434.16666666667,98
"18862","58205","2019",15,15,0,73973.3333333333,1039.26666666667,70.7333333333333
"18863","58206","2019",1,1,0,69990,753,93
"18864","58207","2019",16,16,0,125156.25,1208.8125,100.125
"18865","58208","2019",9,9,0,45611.1111111111,570.777777777778,85.3333333333333
"18866","58209","2019",3,3,0,76666.6666666667,1254.33333333333,65.6666666666667
"18867","58210","2019",8,8,0,56168.75,798.5,69
"18868","58211","2019",3,3,0,94166.6666666667,823.333333333333,117
"18869","58212","2019",6,6,0,79833.3333333333,746.833333333333,107.833333333333
"18870","58213","2019",4,4,0,121475,1152,104.5
"18871","58214","2019",31,31,0,100310.838709677,1106.1935483871,89.8709677419355
"18872","58215","2019",28,28,0,71750,910.321428571429,78.8928571428571
"18873","58216","2019",2,2,0,29140,458,63
"18874","58217","2019",2,2,0,42000,566,69
"18875","58218","2019",19,19,0,76747.8947368421,897,86.2105263157895
"18876","58219","2019",2,2,0,54250,968.5,56.5
"18877","58220","2019",7,7,0,100285.714285714,1094.28571428571,91.2857142857143
"18878","58221","2019",2,2,0,81000,1098,70.5
"18879","58222","2019",5,5,0,79200,901.4,81.4
"18880","58223","2019",6,6,0,85666.6666666667,691,126.333333333333
"18881","58224","2019",2,2,0,42500,720.5,58.5
"18882","58225","2019",6,5,1,171166.666666667,1080.66666666667,113.833333333333
"18883","58226","2019",3,3,0,94000,1292,73
"18884","58227","2019",21,21,0,106038.095238095,1052.47619047619,107.333333333333
"18885","58228","2019",6,5,1,176416.666666667,1523.5,90.3333333333333
"18886","58229","2019",6,6,0,52461.6666666667,717.666666666667,74.1666666666667
"18887","58230","2019",3,3,0,74333.3333333333,819,92.3333333333333
"18888","58231","2019",5,5,0,78900,798.2,93.4
"18889","58232","2019",10,10,0,89150,1022.5,83.4
"18890","58233","2019",5,5,0,76245,1011.8,76.6
"18891","58235","2019",8,8,0,85000,1074,82.875
"18892","58236","2019",7,7,0,126857.142857143,1291,94.5714285714286
"18893","58238","2019",20,20,0,149208.4,1529.25,99.25
"18894","58239","2019",3,3,0,95333.3333333333,765.666666666667,122.666666666667
"18895","58240","2019",1,1,0,66000,1535,43
"18896","58241","2019",5,5,0,263400,2189.8,161.8
"18897","58242","2019",1,1,0,44000,376,117
"18898","58243","2019",1,1,0,80000,952,84
"18899","58244","2019",1,1,0,145000,1859,78
"18900","58245","2019",1,1,0,75000,1000,75
"18901","58246","2019",19,17,2,73192.6315789474,905.947368421053,82.0526315789474
"18902","58247","2019",5,5,0,82800,934.8,87
"18903","58248","2019",2,2,0,93500,1610,58
"18904","58249","2019",6,6,0,96325.3333333333,1155.66666666667,93.6666666666667
"18905","58250","2019",29,27,2,78362.0689655172,965.310344827586,80.3103448275862
"18906","58251","2019",11,11,0,79227.2727272727,807.090909090909,100.545454545455
"18907","58252","2019",1,1,0,170000,1000,170
"18908","58253","2019",2,2,0,75799.5,916,78
"18909","58254","2019",9,9,0,178888.888888889,1583.77777777778,116.111111111111
"18910","58255","2019",6,6,0,88483.5,870.333333333333,104
"18911","58256","2019",5,5,0,92148.2,1402.6,64
"18912","58257","2019",3,3,0,67333.3333333333,564.333333333333,116.666666666667
"18913","58258","2019",1,1,0,33500,1117,30
"18914","58259","2019",1,1,0,65000,3250,20
"18915","58260","2019",22,22,0,101126.318181818,1042.40909090909,95.5454545454545
"18916","58261","2019",17,17,0,94869.4117647059,963.529411764706,100.470588235294
"18917","58263","2019",3,3,0,66166.6666666667,898.333333333333,78.3333333333333
"18918","58264","2019",10,9,1,98700,1008.3,95.4
"18919","58265","2019",2,2,0,54500,513,100.5
"18920","58266","2019",3,3,0,32620.6666666667,661.666666666667,50.6666666666667
"18921","58267","2019",2,2,0,52500,535,99
"18922","58268","2019",7,7,0,71171.4285714286,762.571428571429,85.1428571428571
"18923","58269","2019",3,3,0,112333.333333333,1252,96.3333333333333
"18924","58270","2019",6,6,0,79000,871.833333333333,86.6666666666667
"18925","58271","2019",4,4,0,80500,777,96
"18926","58273","2019",15,15,0,117972.133333333,1142.93333333333,104.8
"18927","58274","2019",1,1,0,59895,1274,47
"18928","58275","2019",3,3,0,36333.3333333333,626.333333333333,56.6666666666667
"18929","58276","2019",7,7,0,54216.5714285714,729.428571428571,74
"18930","58277","2019",2,2,0,99750,1833.5,56
"18931","58278","2019",15,15,0,130266.666666667,1267.6,105.6
"18932","58280","2019",9,9,0,118388.888888889,1271.77777777778,91
"18933","58281","2019",17,17,0,101992.588235294,1091.82352941176,97.0588235294118
"18934","58282","2019",3,3,0,93333.3333333333,948.333333333333,89.3333333333333
"18935","58283","2019",1,1,0,35000,538,65
"18936","58285","2019",1,1,0,26500,576,46
"18937","58286","2019",4,4,0,93293.75,1145.75,81.25
"18938","58287","2019",5,5,0,44200,898.4,55.8
"18939","58288","2019",2,2,0,92500,2306.5,63.5
"18940","58289","2019",4,4,0,86487.5,1012.75,87.25
"18941","58291","2019",1,1,0,121000,968,125
"18942","58292","2019",6,6,0,65950.8333333333,814.666666666667,90.3333333333333
"18943","58293","2019",5,5,0,90400,1069.8,85.8
"18944","58295","2019",13,13,0,97846.1538461538,1134.46153846154,96.3076923076923
"18945","58296","2019",2,2,0,114000,1790.5,65.5
"18946","58297","2019",1,1,0,72000,837,86
"18947","58299","2019",4,4,0,46250,573,78.25
"18948","58300","2019",16,16,0,104061.875,1203.3125,88.875
"18949","58301","2019",5,5,0,135300,1142.2,118
"18950","58302","2019",8,8,0,93625,1035.875,90.75
"18951","58303","2019",99,90,9,108684.04040404,1329.09090909091,82.4343434343434
"18952","58304","2019",13,10,3,68811.5384615385,825.307692307692,91.2307692307692
"18953","58305","2019",4,4,0,71500,968.75,74.25
"18954","58306","2019",1,1,0,51000,850,60
"18955","58307","2019",1,1,0,38000,345,110
"18956","58309","2019",15,15,0,64678.3333333333,989.133333333333,70.8
"18957","58311","2019",4,4,0,80500,935,86.25
"18958","58312","2019",3,3,0,58333.3333333333,726,78.6666666666667
"18959","58313","2019",3,3,0,169046.666666667,2532.33333333333,92.6666666666667
"18960","59001","2019",6,6,0,155968.333333333,1547.66666666667,99.6666666666667
"18961","59002","2019",40,39,1,128984.6,1235.575,108.875
"18962","59003","2019",4,4,0,127270,1084.5,123
"18963","59004","2019",8,8,0,288224.5,2204,141.125
"18964","59005","2019",42,42,0,172963.928571429,1695.54761904762,101.047619047619
"18965","59006","2019",1,1,0,220000,2075,106
"18966","59007","2019",9,9,0,106666.666666667,1036.55555555556,97.7777777777778
"18967","59008","2019",110,110,0,110238.5,1141.50909090909,96.4636363636364
"18968","59009","2019",620,418,202,245591.75,2749.78548387097,88.858064516129
"18969","59010","2019",4,4,0,147460,1318.75,124.75
"18970","59011","2019",146,126,20,178480.691780822,1972.54109589041,92.3835616438356
"18971","59012","2019",38,38,0,94846.3157894737,1068.18421052632,88.1578947368421
"18972","59013","2019",22,22,0,250693.409090909,2743.09090909091,92.1363636363636
"18973","59014","2019",155,134,21,90079.0387096774,1134.22580645161,82.8258064516129
"18974","59015","2019",23,23,0,147902.47826087,1513.08695652174,97.8695652173913
"18975","59016","2019",23,23,0,178237.826086957,1780.78260869565,105.782608695652
"18976","59017","2019",463,355,108,131851.198704104,1668.38228941685,81.3736501079914
"18977","59018","2019",16,16,0,144998.875,1326.125,106.4375
"18978","59019","2019",14,14,0,166485.714285714,1653.28571428571,102.214285714286
"18979","59021","2019",17,17,0,131158.823529412,1358.41176470588,102.529411764706
"18980","59022","2019",28,28,0,235665.714285714,2212.35714285714,107.178571428571
"18981","59023","2019",6,6,0,165500,1763.33333333333,93.8333333333333
"18982","59024","2019",82,80,2,118119.268292683,1194.62195121951,100.426829268293
"18983","59025","2019",25,24,1,315240,2480.96,130.92
"18984","59026","2019",12,12,0,150562.5,1498.5,101.916666666667
"18985","59027","2019",25,25,0,174588.6,1606.08,108.24
"18986","59028","2019",48,48,0,115682.625,1317.5625,88.9791666666667
"18987","59029","2019",19,19,0,293210,2003.36842105263,146.473684210526
"18988","59031","2019",2,2,0,159525,1442,105
"18989","59032","2019",64,62,2,142840.21875,1419.0625,97.15625
"18990","59033","2019",82,78,4,95311.8902439024,1136.85365853659,85.6219512195122
"18991","59034","2019",33,29,4,307792.121212121,2720.66666666667,117.363636363636
"18992","59035","2019",22,21,1,118498.636363636,1184.90909090909,104.681818181818
"18993","59036","2019",29,29,0,87227.5862068966,879.241379310345,103.310344827586
"18994","59037","2019",55,55,0,97536.3636363636,1013.23636363636,94.9818181818182
"18995","59038","2019",17,17,0,162086.470588235,1278.47058823529,125.823529411765
"18996","59039","2019",13,13,0,213689.230769231,1686.61538461538,137.230769230769
"18997","59041","2019",22,22,0,116085.5,1272.63636363636,95.2272727272727
"18998","59042","2019",25,25,0,315368.8,2830.68,116.32
"18999","59043","2019",190,144,46,186789.163157895,2027.17894736842,94.9947368421053
"19000","59044","2019",68,65,3,263265.926470588,2519.92647058824,105.191176470588
"19001","59045","2019",1,1,0,155000,2214,70
"19002","59046","2019",14,14,0,153614.285714286,1491.07142857143,104.857142857143
"19003","59047","2019",4,4,0,88825,1121.75,77.25
"19004","59048","2019",4,4,0,150166.5,1436,105
"19005","59049","2019",7,7,0,115114.285714286,1172,104.571428571429
"19006","59050","2019",8,8,0,126025,1339.75,94
"19007","59051","2019",90,84,6,153300.111111111,1764.8,90.1888888888889
"19008","59052","2019",69,68,1,168605.15942029,1758.11594202899,97.5507246376812
"19009","59053","2019",41,40,1,120520.609756098,1225.58536585366,100.09756097561
"19010","59054","2019",17,16,1,139614.176470588,1380.94117647059,105.764705882353
"19011","59055","2019",6,6,0,101336.666666667,830.333333333333,120.5
"19012","59056","2019",9,9,0,289077.777777778,2438,119.222222222222
"19013","59057","2019",8,8,0,103230.625,1627.875,77.875
"19014","59058","2019",14,14,0,164716.071428571,1352.85714285714,123.214285714286
"19015","59059","2019",5,5,0,70700,860.6,81.6
"19016","59061","2019",2,2,0,70000,724,97
"19017","59062","2019",3,3,0,113333.333333333,1343,96
"19018","59063","2019",32,31,1,102232.6875,1108.15625,90.8125
"19019","59064","2019",14,14,0,131597.642857143,1589.14285714286,84.7142857142857
"19020","59065","2019",5,5,0,222660,1618.8,129.6
"19021","59067","2019",45,39,6,154481.177777778,1730.55555555556,92.4666666666667
"19022","59068","2019",51,51,0,100757.588235294,1112.8431372549,92.5882352941177
"19023","59069","2019",6,6,0,178590,1726,103.666666666667
"19024","59070","2019",1,1,0,1e+05,1111,90
"19025","59071","2019",32,32,0,250461.71875,2275.59375,114.53125
"19026","59072","2019",6,6,0,115713.333333333,1105.66666666667,98.8333333333333
"19027","59073","2019",6,6,0,272166.666666667,2504.5,111.5
"19028","59074","2019",35,35,0,101210.571428571,920.914285714286,113.914285714286
"19029","59075","2019",12,12,0,131241.666666667,1154.33333333333,109.416666666667
"19030","59076","2019",4,4,0,124512.5,1183.25,105.5
"19031","59077","2019",2,2,0,220380,1660,129.5
"19032","59078","2019",2,2,0,157000,1727.5,93.5
"19033","59079","2019",57,52,5,114126.403508772,1364.77192982456,86.9122807017544
"19034","59080","2019",31,31,0,195214.129032258,1921.58064516129,103.451612903226
"19035","59081","2019",5,5,0,125200,1480.2,85.6
"19036","59082","2019",18,18,0,179672.5,1930.27777777778,93.2777777777778
"19037","59083","2019",3,3,0,274583.333333333,1818.33333333333,157
"19038","59084","2019",21,21,0,200726.80952381,1795.47619047619,115.47619047619
"19039","59085","2019",8,8,0,141662.5,1263,117.625
"19040","59086","2019",24,24,0,202716.25,1916.70833333333,108.041666666667
"19041","59087","2019",9,9,0,174911.111111111,1833.11111111111,92.6666666666667
"19042","59088","2019",22,22,0,223259.454545455,2224.13636363636,102.318181818182
"19043","59089","2019",14,14,0,124442.857142857,1356,107.928571428571
"19044","59090","2019",127,120,7,442088.614173228,3551.75590551181,122.40157480315
"19045","59091","2019",7,7,0,235207.142857143,2059.71428571429,112
"19046","59092","2019",45,43,2,132892.555555556,1444.6,97.1111111111111
"19047","59093","2019",4,4,0,152500,1197.75,135
"19048","59094","2019",84,79,5,128284.047619048,1403.52380952381,93.0476190476191
"19049","59096","2019",21,21,0,305910.095238095,2673.33333333333,113.809523809524
"19050","59097","2019",2,2,0,185281,1179,157.5
"19051","59098","2019",49,48,1,274363.775510204,2335,117.469387755102
"19052","59099","2019",18,18,0,114060,1087.66666666667,102.888888888889
"19053","59100","2019",1,1,0,230000,2091,110
"19054","59101","2019",3,3,0,84246.6666666667,1128.66666666667,82.3333333333333
"19055","59102","2019",5,5,0,85500,1063.6,82.6
"19056","59103","2019",9,9,0,193025,1616.33333333333,122.444444444444
"19057","59104","2019",31,31,0,105737.419354839,1082,96.1935483870968
"19058","59105","2019",17,17,0,216767.647058824,2142.11764705882,106.352941176471
"19059","59106","2019",12,12,0,305833.333333333,2655.33333333333,125.333333333333
"19060","59107","2019",141,66,75,159548.588652482,2631.84397163121,69.5460992907801
"19061","59108","2019",6,6,0,100741.666666667,999.166666666667,101.666666666667
"19062","59109","2019",6,6,0,248181,1827.16666666667,139.5
"19063","59110","2019",19,19,0,198086.842105263,1782.63157894737,114.105263157895
"19064","59111","2019",3,3,0,190450,1878,103
"19065","59112","2019",123,123,0,111566.991869919,1187.84552845528,94.3739837398374
"19066","59113","2019",18,18,0,136825,1483.11111111111,95.3888888888889
"19067","59114","2019",19,18,1,193877.210526316,1766.63157894737,110.210526315789
"19068","59115","2019",8,8,0,157395.125,1672.625,91
"19069","59116","2019",4,4,0,114375,1329.75,87.75
"19070","59117","2019",10,10,0,134336.8,1461.6,100.4
"19071","59118","2019",32,32,0,71120.3125,781.15625,88.46875
"19072","59119","2019",10,10,0,149540,1434.7,105.9
"19073","59120","2019",25,24,1,189117.2,1824.92,111.84
"19074","59121","2019",13,13,0,156257.692307692,1322.69230769231,120
"19075","59122","2019",451,318,133,117660.425720621,1324.70509977827,90.4434589800443
"19076","59123","2019",22,22,0,234040.636363636,2204.72727272727,107.090909090909
"19077","59124","2019",21,21,0,389165.238095238,2923.47619047619,137.142857142857
"19078","59125","2019",5,5,0,108174,1367.6,83
"19079","59126","2019",6,6,0,160916.666666667,1579.66666666667,98.1666666666667
"19080","59127","2019",1,1,0,63000,778,81
"19081","59128","2019",22,21,1,253750.454545455,2589.77272727273,95.9090909090909
"19082","59129","2019",20,20,0,215031.85,2049.4,106.1
"19083","59130","2019",12,12,0,192166.666666667,1799.5,108.75
"19084","59131","2019",101,100,1,149198.811881188,1682.27722772277,88.9108910891089
"19085","59132","2019",13,13,0,111723.076923077,1202.61538461538,99.9230769230769
"19086","59133","2019",14,14,0,261744.285714286,2184,120.928571428571
"19087","59134","2019",9,9,0,118222.222222222,1075.33333333333,111.555555555556
"19088","59135","2019",33,32,1,189391.363636364,1829.72727272727,104.606060606061
"19089","59136","2019",89,87,2,75345.5730337079,831.033707865169,91.0224719101124
"19090","59137","2019",6,6,0,80500,742,114
"19091","59138","2019",8,8,0,105837.5,1011.5,106.5
"19092","59139","2019",155,139,16,87139.4258064516,984.993548387097,92.4967741935484
"19093","59140","2019",10,10,0,128380,1310.8,98.6
"19094","59141","2019",4,4,0,120000,1109.25,109.5
"19095","59142","2019",3,3,0,124741.666666667,1166.33333333333,112
"19096","59143","2019",115,106,9,207452.260869565,2123.21739130435,97.0782608695652
"19097","59144","2019",14,13,1,210250,1826.78571428571,119.785714285714
"19098","59145","2019",14,14,0,226471.428571429,2267.85714285714,101.285714285714
"19099","59146","2019",56,51,5,304081.946428571,2792.14285714286,108.642857142857
"19100","59148","2019",4,4,0,120000,1287.75,91.5
"19101","59149","2019",17,17,0,108761.764705882,1055.29411764706,106.411764705882
"19102","59150","2019",6,6,0,293248.333333333,2684.16666666667,109.166666666667
"19103","59151","2019",10,10,0,112950,1211.8,95.2
"19104","59152","2019",153,141,12,214266.522875817,2151.62745098039,98.6535947712418
"19105","59153","2019",64,62,2,116358.84375,1253.453125,97.765625
"19106","59155","2019",278,253,25,131854.370503597,1518.67985611511,88.8057553956834
"19107","59156","2019",33,27,6,146762.121212121,1710.09090909091,89.3030303030303
"19108","59157","2019",19,19,0,99390.7894736842,1062.10526315789,93.8947368421053
"19109","59158","2019",46,46,0,247854.391304348,2033.26086956522,119.369565217391
"19110","59159","2019",9,9,0,215255.555555556,1918.55555555556,114.111111111111
"19111","59160","2019",54,54,0,114611.37037037,1209.2037037037,94.6481481481482
"19112","59161","2019",5,5,0,138940,1430.8,96.2
"19113","59162","2019",7,7,0,184652.857142857,1953.28571428571,92.2857142857143
"19114","59163","2019",397,291,106,242404.035264484,2440.31234256927,93.5642317380353
"19115","59164","2019",6,6,0,172407.5,1365.66666666667,130.333333333333
"19116","59165","2019",72,71,1,148723.5,1569.27777777778,94.0277777777778
"19117","59166","2019",13,13,0,147779.307692308,1703.07692307692,81.3846153846154
"19118","59167","2019",2,2,0,149200,1880,79
"19119","59168","2019",86,77,9,285869.88372093,2576.91860465116,109.639534883721
"19120","59169","2019",3,3,0,146000,1246.66666666667,134.333333333333
"19121","59170","2019",38,38,0,109434.210526316,1160.21052631579,94.6315789473684
"19122","59171","2019",1,1,0,133000,964,138
"19123","59172","2019",180,175,5,76516.7611111111,948.911111111111,83.0833333333333
"19124","59173","2019",37,37,0,236836.216216216,2413.56756756757,102.324324324324
"19125","59174","2019",3,3,0,104500,1391.33333333333,73.6666666666667
"19126","59175","2019",2,2,0,176240,1476.5,119
"19127","59177","2019",6,6,0,126916.666666667,1317.16666666667,100.5
"19128","59178","2019",516,314,202,124808.476744186,1448.14147286822,89.1705426356589
"19129","59179","2019",99,98,1,114233.373737374,1251.17171717172,93.5252525252525
"19130","59180","2019",15,15,0,233213.333333333,2026.53333333333,119.8
"19131","59181","2019",8,8,0,111975,1086.5,103.125
"19132","59182","2019",2,2,0,82466,1038,83
"19133","59183","2019",1169,714,455,144435.796407186,1731.8374679213,85.4747647562019
"19134","59184","2019",7,7,0,197900,1672.14285714286,117.428571428571
"19135","59185","2019",17,17,0,122659.411764706,1392.05882352941,90
"19136","59187","2019",3,3,0,132412.666666667,1126,115.333333333333
"19137","59188","2019",2,2,0,195975,1958.5,100
"19138","59189","2019",19,19,0,206331.578947368,1582.63157894737,128.052631578947
"19139","59190","2019",8,8,0,214218.75,1710.125,135.875
"19140","59191","2019",9,9,0,82199.6666666667,836.333333333333,97.1111111111111
"19141","59192","2019",5,4,1,142620,1298.6,109.8
"19142","59193","2019",35,34,1,247742.857142857,2375.08571428571,105.971428571429
"19143","59194","2019",21,21,0,123032,1160.95238095238,110.809523809524
"19144","59195","2019",11,11,0,294695.454545455,2827.18181818182,105.909090909091
"19145","59196","2019",12,12,0,380867.5,2934.75,125.833333333333
"19146","59197","2019",25,25,0,272467,2564.4,111.36
"19147","59198","2019",4,4,0,94550,1119.75,82
"19148","59199","2019",15,15,0,117827.333333333,1179.2,96
"19149","59200","2019",9,9,0,162955.555555556,1405.22222222222,114.222222222222
"19150","59201","2019",6,6,0,385833.333333333,3317.83333333333,125.166666666667
"19151","59202","2019",76,67,9,176152.368421053,2041.21052631579,86.3552631578947
"19152","59203","2019",16,16,0,133725,1350.875,98.3125
"19153","59204","2019",9,9,0,141055.555555556,1090.66666666667,129.333333333333
"19154","59205","2019",92,89,3,99864.6413043478,1142.52173913043,88.7391304347826
"19155","59206","2019",52,52,0,124326.019230769,1212.05769230769,101.846153846154
"19156","59207","2019",19,19,0,102482.105263158,1263.68421052632,83
"19157","59208","2019",7,7,0,338535.714285714,2779.71428571429,120.714285714286
"19158","59209","2019",11,11,0,122502.727272727,1183.09090909091,101.272727272727
"19159","59210","2019",20,20,0,163536.5,1663.6,104.75
"19160","59211","2019",10,10,0,235565.4,1797.9,124.7
"19161","59212","2019",89,82,7,172925.674157303,1818.38202247191,98.6067415730337
"19162","59213","2019",4,4,0,117100,1768.25,70.25
"19163","59214","2019",8,8,0,156768.75,1673.75,91.25
"19164","59215","2019",11,11,0,197818.181818182,1715,117.909090909091
"19165","59216","2019",2,2,0,124500,1689,78
"19166","59217","2019",4,4,0,242375,1796.75,135.75
"19167","59218","2019",11,11,0,115327.272727273,1206.09090909091,94.9090909090909
"19168","59219","2019",4,4,0,180625,1670.25,113.75
"19169","59220","2019",280,218,62,181046.164285714,2219.475,83.8357142857143
"19170","59221","2019",35,21,14,119462.571428571,1753.14285714286,73.2
"19171","59222","2019",21,21,0,271953.761904762,2179.42857142857,122.47619047619
"19172","59223","2019",7,7,0,110030.285714286,832.714285714286,131.857142857143
"19173","59224","2019",22,22,0,118973.045454545,1212.36363636364,98.7272727272727
"19174","59225","2019",72,72,0,122134.513888889,1200.93055555556,100.833333333333
"19175","59226","2019",7,7,0,110000,1058,103.285714285714
"19176","59227","2019",55,55,0,132795.909090909,1511.43636363636,87.3090909090909
"19177","59228","2019",19,19,0,190623.684210526,1754.15789473684,109.052631578947
"19178","59229","2019",8,8,0,121046.25,1179.625,101.5
"19179","59230","2019",81,73,8,106992.975308642,1559.0987654321,88.3086419753086
"19180","59231","2019",5,5,0,86937.6,963.2,85.4
"19181","59232","2019",6,6,0,151375,2036.83333333333,73
"19182","59233","2019",1,1,0,80000,870,92
"19183","59234","2019",48,48,0,135358.0625,1394.66666666667,95.125
"19184","59236","2019",3,3,0,167550,1211,136
"19185","59237","2019",11,11,0,168012.272727273,1672.72727272727,102.090909090909
"19186","59238","2019",22,22,0,192454.545454545,1484.81818181818,128.363636363636
"19187","59239","2019",42,42,0,189797.619047619,1673.02380952381,115.880952380952
"19188","59240","2019",2,2,0,81500,761,95
"19189","59241","2019",7,7,0,128928.571428571,1395.71428571429,94.2857142857143
"19190","59242","2019",4,4,0,113625,1270.25,88.25
"19191","59243","2019",15,15,0,125691,1247.13333333333,102.6
"19192","59244","2019",24,24,0,188400,1509.125,123.541666666667
"19193","59246","2019",5,5,0,150986,1098,141.4
"19194","59247","2019",24,23,1,236647.083333333,2529.58333333333,94.875
"19195","59249","2019",110,102,8,91951.0545454545,1061.62727272727,93.1818181818182
"19196","59250","2019",26,22,4,252793.038461538,2409.38461538462,101.961538461538
"19197","59251","2019",5,5,0,205340,1477,134.4
"19198","59252","2019",26,22,4,258676.884615385,2626.65384615385,97.8846153846154
"19199","59253","2019",63,61,2,94493.0952380952,1042.53968253968,90.6190476190476
"19200","59254","2019",17,17,0,128909.117647059,1290.11764705882,99.7058823529412
"19201","59255","2019",4,4,0,175750,1503,114
"19202","59256","2019",52,51,1,222290.865384615,2399.67307692308,94.5961538461538
"19203","59257","2019",12,12,0,320092.916666667,2389.33333333333,135.5
"19204","59258","2019",20,20,0,298880.55,2661,112.15
"19205","59259","2019",5,5,0,155664.6,1311,119.8
"19206","59260","2019",66,65,1,197237.984848485,2110.30303030303,97.9393939393939
"19207","59261","2019",15,15,0,71300,908.2,76.5333333333333
"19208","59262","2019",26,26,0,207391.653846154,1709.73076923077,123.423076923077
"19209","59263","2019",12,12,0,159314.5,1588.5,108.916666666667
"19210","59264","2019",6,6,0,94666.6666666667,1192.16666666667,78.8333333333333
"19211","59265","2019",23,23,0,169926.086956522,1445.86956521739,120.826086956522
"19212","59266","2019",51,51,0,263170.117647059,2403.25490196078,115.862745098039
"19213","59267","2019",4,4,0,108750,1371.25,83
"19214","59268","2019",82,74,8,169222.292682927,1846.51219512195,95.3414634146341
"19215","59269","2019",19,19,0,140565.789473684,1403.15789473684,101.157894736842
"19216","59270","2019",5,5,0,129600,972.2,143.8
"19217","59271","2019",121,106,15,131655.049586777,1427.78512396694,92.9090909090909
"19218","59272","2019",67,66,1,122779.119402985,1461.46268656716,84.7611940298507
"19219","59273","2019",136,114,22,151951.036764706,1568.88235294118,98.2352941176471
"19220","59274","2019",8,8,0,116625,1039.5,107.625
"19221","59275","2019",12,12,0,416333.333333333,3022.75,134.666666666667
"19222","59276","2019",45,45,0,127368.155555556,1414.28888888889,92.2222222222222
"19223","59277","2019",2,2,0,97500,759.5,121.5
"19224","59278","2019",55,48,7,222790.509090909,2454.27272727273,93.3090909090909
"19225","59279","2019",285,250,35,185672.877192982,2045.07719298246,91.6666666666667
"19226","59280","2019",9,9,0,241226.111111111,1497,165.555555555556
"19227","59281","2019",16,16,0,223909.1875,2139.875,104.375
"19228","59282","2019",3,3,0,155666.666666667,1773.66666666667,89
"19229","59283","2019",4,4,0,191175,1633.25,111.5
"19230","59284","2019",61,54,7,180535.147540984,1702.04918032787,104.819672131148
"19231","59285","2019",42,42,0,113064.047619048,1204.52380952381,95.2619047619048
"19232","59286","2019",227,164,63,162947.656387665,2049.44052863436,82.1057268722467
"19233","59287","2019",1,1,0,145000,1933,75
"19234","59288","2019",22,22,0,117071.136363636,1288.40909090909,86.2272727272727
"19235","59289","2019",17,17,0,111105.882352941,1181.52941176471,94.7058823529412
"19236","59290","2019",3,3,0,131566.666666667,1349.33333333333,98.6666666666667
"19237","59291","2019",147,146,1,89737.0952380952,1014.94557823129,90.0952380952381
"19238","59292","2019",27,27,0,107090.37037037,1262.74074074074,84.2222222222222
"19239","59293","2019",22,22,0,189999,1735.72727272727,117.590909090909
"19240","59294","2019",4,4,0,135000,1226.25,108.75
"19241","59295","2019",290,253,37,165072.324137931,1819.56206896552,91.8413793103448
"19242","59296","2019",3,3,0,142500,1237.33333333333,105
"19243","59297","2019",24,24,0,135712.5,1395.33333333333,93.5416666666667
"19244","59299","2019",224,214,10,254013.879464286,2421.04464285714,101.852678571429
"19245","59300","2019",9,9,0,159411.111111111,1255.66666666667,129.111111111111
"19246","59301","2019",44,44,0,164018.181818182,1625.38636363636,102.636363636364
"19247","59302","2019",40,40,0,119032.5,1315.925,91.275
"19248","59303","2019",21,21,0,255352.619047619,2280,110.333333333333
"19249","59304","2019",5,5,0,212770,2017.2,107
"19250","59305","2019",19,19,0,173601.052631579,1526.05263157895,117.157894736842
"19251","59306","2019",1,1,0,99900,1110,90
"19252","59307","2019",6,6,0,115666.666666667,1289.5,91
"19253","59308","2019",10,10,0,206360,1741.7,123.6
"19254","59309","2019",38,38,0,172605.131578947,1638.39473684211,107.5
"19255","59310","2019",9,9,0,154191.666666667,1326.77777777778,114.444444444444
"19256","59311","2019",8,8,0,97925,1063.5,92.125
"19257","59312","2019",10,10,0,68045,739.8,91.3
"19258","59313","2019",15,15,0,133190,1279.66666666667,106.933333333333
"19259","59314","2019",28,28,0,139265.178571429,1471.60714285714,95.6785714285714
"19260","59315","2019",11,11,0,137355.454545455,1496.81818181818,101
"19261","59316","2019",48,48,0,233331.895833333,2314.5,99.9375
"19262","59317","2019",124,119,5,159735.580645161,1936.56451612903,81.0322580645161
"19263","59318","2019",15,15,0,172876.2,1718.06666666667,110.466666666667
"19264","59319","2019",37,37,0,219930.513513514,1934.27027027027,114.72972972973
"19265","59320","2019",29,29,0,196900.482758621,2054.1724137931,96.7241379310345
"19266","59321","2019",8,7,1,73343.75,1042.125,76.375
"19267","59322","2019",43,41,2,122231.186046512,1180.6976744186,105.348837209302
"19268","59323","2019",11,11,0,183638.636363636,1495.63636363636,121.818181818182
"19269","59324","2019",89,86,3,82976.8876404494,965.865168539326,89.1123595505618
"19270","59325","2019",17,17,0,179113.235294118,1483.76470588235,134.705882352941
"19271","59326","2019",14,14,0,140738.071428571,1324.57142857143,111.285714285714
"19272","59327","2019",50,50,0,138513.6,1427.06,99.04
"19273","59328","2019",534,330,204,246112.365168539,2948.734082397,82.2059925093633
"19274","59329","2019",41,37,4,135119.073170732,1554.19512195122,86.0243902439024
"19275","59330","2019",36,36,0,229190.694444444,2120.16666666667,113.5
"19276","59331","2019",41,40,1,95669.0487804878,1061.78048780488,93
"19277","59332","2019",38,24,14,136579.736842105,1848.44736842105,73.3684210526316
"19278","59333","2019",3,3,0,204137.666666667,1773,114.666666666667
"19279","59334","2019",17,17,0,168517.647058824,1623,102
"19280","59335","2019",37,37,0,243331.621621622,1944.43243243243,126.216216216216
"19281","59336","2019",23,23,0,98650.4347826087,1094.26086956522,86.3913043478261
"19282","59337","2019",5,5,0,176100,1666.4,117
"19283","59338","2019",8,7,1,174125,1920.375,90.625
"19284","59339","2019",137,132,5,227057.569343066,2262.42335766423,100.912408759124
"19285","59340","2019",49,45,4,210718.06122449,2081.42857142857,100.897959183673
"19286","59341","2019",5,5,0,90447.4,897,90.8
"19287","59342","2019",5,5,0,127000,1025,111.8
"19288","59343","2019",93,86,7,223858.666666667,2465.0752688172,92.6129032258064
"19289","59344","2019",18,18,0,99379.1666666667,1185.27777777778,86.6666666666667
"19290","59345","2019",23,21,2,144548.347826087,1463.21739130435,97.6521739130435
"19291","59346","2019",47,47,0,219392.255319149,2486.46808510638,87.7234042553192
"19292","59347","2019",7,7,0,102507.142857143,1048.42857142857,95.1428571428571
"19293","59348","2019",4,4,0,225125,2007.5,117.75
"19294","59349","2019",17,16,1,124898.823529412,1269.70588235294,101.588235294118
"19295","59350","2019",4430,1223,3207,191878.662528217,3125.46230248307,65.3322799097065
"19296","59351","2019",3,3,0,117280,1515,83.6666666666667
"19297","59352","2019",110,97,13,278820.409090909,2548.73636363636,107.509090909091
"19298","59353","2019",5,5,0,160200,1585.8,121.8
"19299","59354","2019",9,9,0,141435.111111111,1575.33333333333,93.5555555555556
"19300","59356","2019",29,29,0,387772.413793103,3299.06896551724,121
"19301","59357","2019",19,19,0,142304.736842105,1406.52631578947,104.105263157895
"19302","59358","2019",20,20,0,171150,1655.1,107.15
"19303","59359","2019",78,77,1,147752.307692308,1549.66666666667,95.6025641025641
"19304","59360","2019",295,177,118,145055.701694915,2147.44406779661,70.9186440677966
"19305","59361","2019",24,21,3,85048.125,1145.04166666667,75.7916666666667
"19306","59363","2019",19,19,0,157215.789473684,1382.26315789474,116.368421052632
"19307","59364","2019",19,19,0,291913.157894737,2591.52631578947,118.210526315789
"19308","59365","2019",41,34,7,86790.0975609756,1028.9756097561,82.8292682926829
"19309","59366","2019",16,16,0,158945.625,1793.0625,100.1875
"19310","59367","2019",225,180,45,184245.551111111,2100.65777777778,88.6844444444444
"19311","59368","2019",538,178,360,225804.470260223,2969.91821561338,75.8884758364312
"19312","59369","2019",42,42,0,143975.333333333,1330.14285714286,106.428571428571
"19313","59370","2019",5,5,0,138700,1343.8,120
"19314","59371","2019",8,8,0,308437.5,2972.5,104
"19315","59372","2019",4,4,0,137000,1457,101
"19316","59374","2019",2,2,0,65000,746,87
"19317","59375","2019",70,70,0,172211.085714286,1769.54285714286,101.185714285714
"19318","59377","2019",25,25,0,146977.64,1262.96,120.68
"19319","59378","2019",718,427,291,314366.506963788,3303.52506963788,92.7325905292479
"19320","59379","2019",8,8,0,132000,1208.5,107
"19321","59381","2019",13,13,0,125692.307692308,1212.92307692308,105.307692307692
"19322","59382","2019",22,22,0,94905.4545454545,992.318181818182,102.5
"19323","59383","2019",128,124,4,125620.1484375,1403.6640625,88.7890625
"19324","59384","2019",11,11,0,116690.909090909,1117.63636363636,108.545454545455
"19325","59385","2019",28,28,0,82453.9285714286,933.107142857143,89.5357142857143
"19326","59386","2019",132,116,16,232973.848484848,2701.7196969697,86.9924242424242
"19327","59387","2019",20,20,0,111662.75,1183.6,99.25
"19328","59388","2019",21,21,0,208835.714285714,1958.57142857143,104.380952380952
"19329","59389","2019",47,47,0,122125.893617021,1141.85106382979,106.191489361702
"19330","59390","2019",21,19,2,109578.714285714,1155.85714285714,91.9047619047619
"19331","59391","2019",12,12,0,154770.833333333,1494.08333333333,105.583333333333
"19332","59392","2019",305,216,89,90500.4918032787,1064.40327868852,86.8229508196721
"19333","59393","2019",7,7,0,160085.714285714,1820.71428571429,87
"19334","59394","2019",4,4,0,113000,1189.75,104
"19335","59395","2019",5,5,0,95266.2,1434.2,73
"19336","59396","2019",11,11,0,190731.363636364,1632.45454545455,121.909090909091
"19337","59397","2019",13,13,0,167828.461538462,1650.30769230769,106.153846153846
"19338","59398","2019",52,52,0,453322.711538462,2988.44230769231,148.846153846154
"19339","59399","2019",16,16,0,265595.5,1925.5625,139.5
"19340","59400","2019",121,119,2,140174.595041322,1476.70247933884,95.6942148760331
"19341","59401","2019",27,26,1,190129.62962963,1825.59259259259,112.851851851852
"19342","59402","2019",11,11,0,164698.909090909,1507.63636363636,115.090909090909
"19343","59403","2019",7,7,0,162008.571428571,1767.42857142857,85.7142857142857
"19344","59405","2019",8,8,0,129712.5,1300,98.875
"19345","59406","2019",4,4,0,117000,952.75,113.25
"19346","59407","2019",3,3,0,226666.666666667,1712.33333333333,133.333333333333
"19347","59408","2019",16,16,0,182464.0625,1814.5625,108
"19348","59409","2019",32,32,0,116746.0625,1197.8125,102.96875
"19349","59410","2019",270,160,110,165610.818518519,2103.35925925926,75.962962962963
"19350","59411","2019",22,22,0,270964.954545455,2669.22727272727,102.909090909091
"19351","59412","2019",4,4,0,93500,850,108
"19352","59413","2019",9,9,0,103555.555555556,1013.55555555556,100.555555555556
"19353","59414","2019",36,36,0,129720.111111111,1419.30555555556,92.8888888888889
"19354","59416","2019",25,25,0,154749.52,1423.44,107.52
"19355","59418","2019",17,17,0,147597.647058824,1304.47058823529,111.647058823529
"19356","59419","2019",24,24,0,261612.083333333,2175.91666666667,123.083333333333
"19357","59420","2019",2,2,0,225500,1853.5,166.5
"19358","59421","2019",240,187,53,288689.720833333,2930.88333333333,95.825
"19359","59422","2019",6,6,0,93933.3333333333,888.333333333333,106.333333333333
"19360","59423","2019",15,15,0,217093.333333333,2035.66666666667,108.133333333333
"19361","59424","2019",12,10,2,79329.1666666667,903.25,92.6666666666667
"19362","59425","2019",1,1,0,158000,1699,93
"19363","59426","2019",127,117,10,211837.393700787,2344.84251968504,91.511811023622
"19364","59427","2019",9,8,1,389296.666666667,2955.88888888889,122.888888888889
"19365","59428","2019",48,48,0,114694.791666667,1297.625,88.5416666666667
"19366","59429","2019",43,43,0,106324.651162791,1146.53488372093,93.4418604651163
"19367","59430","2019",19,19,0,105521.052631579,1027.94736842105,102.631578947368
"19368","59431","2019",91,88,3,205833.956043956,2142.64835164835,99
"19369","59432","2019",3,3,0,74733.3333333333,796.333333333333,94
"19370","59433","2019",16,16,0,126159.375,1420.8125,91.4375
"19371","59434","2019",19,19,0,188382.105263158,1729.10526315789,110.631578947368
"19372","59435","2019",29,29,0,252117.482758621,2089.13793103448,121.620689655172
"19373","59436","2019",13,13,0,168496.153846154,1433.30769230769,114.615384615385
"19374","59437","2019",6,6,0,339180,3093.66666666667,110.333333333333
"19375","59438","2019",8,8,0,126575,1455,88.375
"19376","59439","2019",2,2,0,156500,1402.5,111.5
"19377","59440","2019",13,13,0,122076.153846154,1236.30769230769,98.1538461538462
"19378","59441","2019",8,8,0,180702.5,1472.125,124.25
"19379","59442","2019",5,5,0,153500,1369,111.8
"19380","59443","2019",6,6,0,225579.833333333,1561.33333333333,152.333333333333
"19381","59444","2019",6,6,0,107250,1250.5,84.5
"19382","59445","2019",13,13,0,96036.9230769231,1266.53846153846,84.9230769230769
"19383","59446","2019",12,11,1,205647.5,1616.83333333333,120.583333333333
"19384","59447","2019",99,99,0,122981.141414141,1378.89898989899,90.5050505050505
"19385","59448","2019",7,7,0,124614.285714286,1263.85714285714,104.571428571429
"19386","59449","2019",122,106,16,179761.237704918,2015.12295081967,91.9426229508197
"19387","59450","2019",5,5,0,161000,1568.6,102.6
"19388","59451","2019",7,7,0,216100,1703.14285714286,138.571428571429
"19389","59452","2019",56,56,0,159453.303571429,1728.46428571429,96.5
"19390","59453","2019",15,15,0,163774,1571.53333333333,106.4
"19391","59454","2019",6,6,0,217250.5,2161,98.1666666666667
"19392","59455","2019",12,12,0,146707.083333333,1223,117.416666666667
"19393","59456","2019",33,32,1,135257.727272727,1585.87878787879,87.2424242424242
"19394","59457","2019",125,119,6,207738.432,2281.488,92.96
"19395","59458","2019",13,13,0,330913.769230769,3015.69230769231,109.538461538462
"19396","59459","2019",57,52,5,125402.473684211,1341.0701754386,95.0701754385965
"19397","59461","2019",2,2,0,130500,1473.5,100.5
"19398","59462","2019",78,70,8,214685.102564103,2173.02564102564,100.397435897436
"19399","59463","2019",15,15,0,159698.333333333,1410.13333333333,116.866666666667
"19400","59464","2019",12,12,0,86179.1666666667,981.083333333333,86.6666666666667
"19401","59465","2019",10,10,0,122883,1259.6,97.5
"19402","59466","2019",35,28,7,224328.942857143,2532.14285714286,90.5428571428571
"19403","59467","2019",39,39,0,112909.743589744,1121,98.1025641025641
"19404","59468","2019",2,2,0,137000,1287.5,102.5
"19405","59469","2019",3,3,0,261166.666666667,2160.66666666667,122.333333333333
"19406","59470","2019",29,29,0,274480.310344828,2512.93103448276,110.793103448276
"19407","59471","2019",38,37,1,171507.894736842,1669.26315789474,100.947368421053
"19408","59472","2019",13,13,0,85878.3846153846,926.076923076923,89.9230769230769
"19409","59473","2019",5,5,0,177450,1525,115.6
"19410","59474","2019",14,13,1,128446.428571429,1133.71428571429,118.071428571429
"19411","59475","2019",25,24,1,151010,1509.72,102.12
"19412","59476","2019",32,32,0,175766.21875,1580.8125,105.84375
"19413","59477","2019",74,71,3,169590.054054054,1755.78378378378,99.8918918918919
"19414","59478","2019",14,14,0,240675,2005.78571428571,128.785714285714
"19415","59479","2019",41,41,0,146766.219512195,1576.0243902439,92.4146341463415
"19416","59480","2019",10,10,0,205425,2030.7,102.7
"19417","59481","2019",45,45,0,127112.755555556,1404.02222222222,93.4888888888889
"19418","59482","2019",96,94,2,274738.177083333,2594.14583333333,106.416666666667
"19419","59484","2019",48,46,2,106959.479166667,1216.04166666667,89.7916666666667
"19420","59485","2019",29,29,0,121753.448275862,1126.03448275862,110.896551724138
"19421","59486","2019",37,37,0,149184.594594595,1620.40540540541,101.702702702703
"19422","59487","2019",19,18,1,428849.631578947,2890.42105263158,148.052631578947
"19423","59488","2019",33,32,1,121730.303030303,1310.30303030303,93.3636363636364
"19424","59489","2019",53,53,0,184447.169811321,1800.16981132075,103.056603773585
"19425","59490","2019",2,2,0,91000,801,112
"19426","59491","2019",120,116,4,109276,1223.93333333333,88.8416666666667
"19427","59492","2019",7,6,1,139614.285714286,1379.85714285714,103.714285714286
"19428","59493","2019",4,4,0,80500,717,113.5
"19429","59494","2019",3,3,0,84000,887.666666666667,93.3333333333333
"19430","59495","2019",24,24,0,104930.833333333,1176.95833333333,90.5416666666667
"19431","59496","2019",3,3,0,115833.333333333,1375.33333333333,83
"19432","59497","2019",20,20,0,165278.5,1605.35,106.35
"19433","59498","2019",6,6,0,94611.3333333333,906.5,102.333333333333
"19434","59499","2019",17,17,0,164697.647058824,1589.52941176471,108.647058823529
"19435","59500","2019",5,5,0,104300,1162.8,94.2
"19436","59501","2019",13,13,0,138234.461538462,1383.15384615385,98.2307692307692
"19437","59502","2019",18,18,0,107133.333333333,1073.83333333333,101.944444444444
"19438","59503","2019",2,2,0,97950,965,88
"19439","59504","2019",35,35,0,102823.114285714,1192.71428571429,93.8857142857143
"19440","59505","2019",7,7,0,135928.571428571,1507.57142857143,88.5714285714286
"19441","59506","2019",6,6,0,133333.333333333,1154.66666666667,127
"19442","59507","2019",267,194,73,181930.086142322,2199.67790262172,84.6741573033708
"19443","59508","2019",180,157,23,259863.588888889,2552.26111111111,100.227777777778
"19444","59509","2019",57,57,0,141871.947368421,1498.78947368421,95.1228070175439
"19445","59511","2019",14,14,0,246321.428571429,2157.71428571429,120.571428571429
"19446","59512","2019",948,656,292,133975.553797468,1522.64451476793,90.6392405063291
"19447","59513","2019",5,5,0,264660,1942.6,140.2
"19448","59514","2019",65,54,11,118201.030769231,1202.78461538462,95.0461538461538
"19449","59515","2019",6,6,0,120546.666666667,1234.33333333333,94.5
"19450","59516","2019",11,11,0,160736.363636364,1544.27272727273,111.727272727273
"19451","59517","2019",9,9,0,138919.444444444,1277.55555555556,113
"19452","59518","2019",4,4,0,178050.75,1062.5,172.75
"19453","59519","2019",16,16,0,237003.125,1864.375,132.8125
"19454","59520","2019",16,16,0,114752.375,1383.625,86.125
"19455","59521","2019",12,12,0,119583.333333333,1323.75,88.4166666666667
"19456","59522","2019",22,22,0,263407.818181818,2553.63636363636,100.954545454545
"19457","59523","2019",32,32,0,345644.6875,3013.625,116.25
"19458","59524","2019",89,86,3,197090.101123595,2231.77528089888,89.1573033707865
"19459","59525","2019",38,35,3,79907.8947368421,899.736842105263,89.5526315789474
"19460","59526","2019",181,176,5,137246.29281768,1483.33149171271,92.0718232044199
"19461","59527","2019",191,101,90,193517.617801047,2693.43455497382,72.9319371727749
"19462","59528","2019",29,29,0,105160.344827586,977.620689655172,110.172413793103
"19463","59529","2019",3,3,0,104000,962,112
"19464","59531","2019",10,10,0,111500,1101.4,104.3
"19465","59532","2019",1,1,0,72000,1440,50
"19466","59533","2019",27,27,0,117262.962962963,1160.40740740741,101.074074074074
"19467","59534","2019",7,7,0,127945.714285714,1241,108.714285714286
"19468","59535","2019",24,24,0,211687.5,2032.45833333333,106.916666666667
"19469","59536","2019",13,13,0,250088.461538462,2186.46153846154,117.846153846154
"19470","59537","2019",10,10,0,133826.5,1550.7,85.1
"19471","59538","2019",3,3,0,91066.6666666667,1010.33333333333,79.3333333333333
"19472","59539","2019",13,13,0,146923.076923077,1830,90.6153846153846
"19473","59541","2019",20,19,1,95617.5,1055.45,90.25
"19474","59542","2019",7,7,0,142892.857142857,1154,123.857142857143
"19475","59543","2019",10,10,0,80820,978.1,83.6
"19476","59544","2019",158,124,34,162026.569620253,1716.48101265823,93.7405063291139
"19477","59545","2019",15,15,0,60923.3333333333,817.2,72.7333333333333
"19478","59546","2019",9,9,0,214455.555555556,1648.22222222222,130
"19479","59547","2019",19,19,0,93880.5263157895,1114.78947368421,85.8947368421053
"19480","59548","2019",9,9,0,140500,1458.44444444444,98.1111111111111
"19481","59549","2019",2,2,0,121000,1013,123
"19482","59550","2019",44,44,0,173814.318181818,1825.22727272727,97.3636363636364
"19483","59551","2019",22,22,0,300468.636363636,2241.77272727273,137.909090909091
"19484","59552","2019",2,2,0,121250,901,131
"19485","59553","2019",67,65,2,239717.985074627,2176.35820895522,111.059701492537
"19486","59554","2019",9,9,0,267600,2341.11111111111,121.888888888889
"19487","59555","2019",11,11,0,148790.090909091,1208.27272727273,121.363636363636
"19488","59556","2019",1,1,0,60000,779,77
"19489","59557","2019",30,27,3,175581,1979.16666666667,94
"19490","59558","2019",22,22,0,157712.272727273,1370.5,118.863636363636
"19491","59559","2019",24,24,0,274357.166666667,2040.33333333333,136.541666666667
"19492","59560","2019",178,145,33,181429.994382022,2208.95505617978,84.6741573033708
"19493","59562","2019",3,3,0,141000,1401.33333333333,99
"19494","59563","2019",2,2,0,224735,1825,123.5
"19495","59564","2019",27,25,2,106640.740740741,1102.55555555556,101
"19496","59565","2019",9,9,0,198945.888888889,1790.66666666667,116.777777777778
"19497","59566","2019",57,52,5,193969.298245614,2270.89473684211,87.280701754386
"19498","59567","2019",7,7,0,170861.428571429,1461.71428571429,118.571428571429
"19499","59568","2019",1,1,0,190000,2065,92
"19500","59569","2019",178,163,15,114258.123595506,1290.75280898876,86.9044943820225
"19501","59570","2019",12,12,0,302112.916666667,2208.25,134.833333333333
"19502","59571","2019",52,51,1,99876.7307692308,1008.65384615385,103.019230769231
"19503","59572","2019",31,31,0,101508.709677419,1057.41935483871,97.3548387096774
"19504","59573","2019",3,3,0,132433.333333333,1311,109
"19505","59574","2019",115,111,4,118259.330434783,1307.84347826087,94.9478260869565
"19506","59575","2019",10,10,0,163060.7,1429.1,115.7
"19507","59576","2019",14,14,0,210700.5,1799.07142857143,122.857142857143
"19508","59577","2019",6,6,0,176383.333333333,1500.5,113.666666666667
"19509","59578","2019",14,14,0,156960.714285714,1487.92857142857,112.642857142857
"19510","59579","2019",23,23,0,181634.652173913,1743.04347826087,101.652173913043
"19511","59580","2019",58,53,5,171067.620689655,1741.96551724138,100.913793103448
"19512","59581","2019",25,25,0,223692.72,1968.2,118.28
"19513","59582","2019",9,9,0,181216.666666667,1710.55555555556,106.777777777778
"19514","59583","2019",10,10,0,99000,849.1,116.8
"19515","59584","2019",13,13,0,130384.538461538,1120.69230769231,115.230769230769
"19516","59585","2019",62,57,5,206704.016129032,2359.77419354839,86.9677419354839
"19517","59586","2019",76,73,3,235435.657894737,2429.26315789474,96.6973684210526
"19518","59587","2019",7,7,0,231485.714285714,1888.42857142857,116.428571428571
"19519","59588","2019",96,94,2,228300.78125,2004.15625,116.479166666667
"19520","59589","2019",33,33,0,141973.484848485,1463.21212121212,94.4242424242424
"19521","59590","2019",8,8,0,174213.75,1773.625,107.125
"19522","59591","2019",2,2,0,127000,1167.5,109.5
"19523","59592","2019",60,55,5,215632.6,2052.08333333333,103.45
"19524","59593","2019",11,11,0,213833.636363636,1889,114.090909090909
"19525","59594","2019",13,13,0,181703.846153846,1596.76923076923,108.846153846154
"19526","59595","2019",5,5,0,187812,1372.8,150.6
"19527","59596","2019",8,8,0,203800,1721.375,120.125
"19528","59597","2019",4,4,0,193000,1711.75,111.25
"19529","59598","2019",57,57,0,243777.105263158,2350.85964912281,105.614035087719
"19530","59599","2019",1389,987,402,137884.954643629,1645.93304535637,85.5946724262059
"19531","59600","2019",13,13,0,312353.846153846,2467.76923076923,126.384615384615
"19532","59601","2019",30,30,0,102506.666666667,992.133333333333,102.533333333333
"19533","59602","2019",22,22,0,313384.090909091,3024.63636363636,104.136363636364
"19534","59603","2019",65,59,6,114651.476923077,1336.38461538462,86.7692307692308
"19535","59604","2019",9,9,0,116566.666666667,1016.55555555556,115.444444444444
"19536","59605","2019",17,17,0,203358.823529412,2102.88235294118,99.3529411764706
"19537","59606","2019",757,394,363,123902.412153236,1671.60237780713,77.1519154557464
"19538","59607","2019",6,6,0,134011.666666667,1400.83333333333,107
"19539","59608","2019",15,15,0,156776.666666667,1377.06666666667,120.133333333333
"19540","59609","2019",27,21,6,197188.925925926,1983.74074074074,101.777777777778
"19541","59610","2019",9,9,0,194949.444444444,1634.22222222222,117.777777777778
"19542","59611","2019",33,33,0,357010.515151515,3126.09090909091,116.242424242424
"19543","59612","2019",6,6,0,106083.333333333,1063.83333333333,103
"19544","59613","2019",14,14,0,143134.642857143,1479.07142857143,99.0714285714286
"19545","59614","2019",14,14,0,106065.714285714,1053.14285714286,98.1428571428571
"19546","59615","2019",37,37,0,185267.297297297,1747.56756756757,114.108108108108
"19547","59616","2019",92,91,1,115779.717391304,1231.75,98.0326086956522
"19548","59617","2019",8,8,0,183807.5,1592.5,121.875
"19549","59618","2019",10,10,0,144190,1051,137.9
"19550","59619","2019",11,11,0,247781.818181818,1721.90909090909,139.181818181818
"19551","59620","2019",14,14,0,142497.857142857,1416.42857142857,104.928571428571
"19552","59622","2019",19,19,0,128097.368421053,1305.10526315789,93.4210526315789
"19553","59623","2019",8,8,0,113800,963.5,109.375
"19554","59624","2019",24,24,0,109604.75,989.958333333333,106.291666666667
"19555","59625","2019",10,10,0,134940,1267.6,114.5
"19556","59626","2019",18,18,0,177932.944444444,1449.44444444444,123.277777777778
"19557","59627","2019",6,6,0,100232.333333333,1267.83333333333,87.1666666666667
"19558","59628","2019",7,7,0,183732.142857143,1546.42857142857,117.285714285714
"19559","59629","2019",24,24,0,158252.083333333,1571.20833333333,103.791666666667
"19560","59630","2019",44,44,0,180107.727272727,1903.52272727273,91.9772727272727
"19561","59631","2019",35,35,0,86054.2857142857,895.142857142857,96.9142857142857
"19562","59632","2019",46,46,0,154520,1507.58695652174,107.717391304348
"19563","59633","2019",3,3,0,146333.333333333,1172,125.666666666667
"19564","59634","2019",8,8,0,251487.5,1856.75,132.25
"19565","59635","2019",5,5,0,140000,1309.6,101
"19566","59636","2019",139,108,31,263714.755395683,2840.46762589928,94.568345323741
"19567","59637","2019",16,16,0,182800,1718.8125,109.1875
"19568","59638","2019",16,16,0,261715.625,2534.25,104.5625
"19569","59639","2019",8,8,0,229493.75,1992.375,112.75
"19570","59640","2019",9,9,0,188710.333333333,1673.66666666667,111.444444444444
"19571","59641","2019",31,31,0,210314.193548387,1665.77419354839,127.096774193548
"19572","59642","2019",7,7,0,196908.571428571,1500.42857142857,126.857142857143
"19573","59643","2019",3,3,0,160250,1488,99.6666666666667
"19574","59645","2019",10,10,0,115881,1585.5,87.2
"19575","59646","2019",336,264,72,267079.324404762,2809.34523809524,93.0654761904762
"19576","59647","2019",33,33,0,110231.818181818,1227.09090909091,92.1515151515152
"19577","59648","2019",182,107,75,184637.565934066,2140.53296703297,85.3516483516484
"19578","59649","2019",3,3,0,106703.666666667,988.333333333333,109.666666666667
"19579","59650","2019",507,457,50,146448.1617357,1741.44970414201,86.1617357001972
"19580","59651","2019",16,16,0,91672.25,950.875,99.875
"19581","59652","2019",2,2,0,93750,1191.5,78.5
"19582","59653","2019",99,95,4,191125.484848485,2135.07070707071,89.7575757575758
"19583","59654","2019",50,50,0,97336.78,1148.2,87.86
"19584","59655","2019",2,2,0,200660,2018,105
"19585","59656","2019",57,50,7,286548.596491228,2663.01754385965,106.614035087719
"19586","59657","2019",8,8,0,204395,1863.25,115.875
"19587","59658","2019",9,9,0,287211.111111111,2056.33333333333,139.777777777778
"19588","59659","2019",28,28,0,96691.3928571429,969.714285714286,102.821428571429
"19589","59660","2019",50,46,4,234444.6,2356.38,102.08
"19590","59662","2019",9,9,0,161146.111111111,1754.33333333333,97.4444444444444
"19591","59663","2019",54,50,4,167997.444444444,1720.25925925926,99.7037037037037
"19592","59664","2019",5,5,0,170983,1550.4,108
"19593","59665","2019",5,5,0,197200,1816.2,111.8
"19594","59666","2019",18,18,0,189686.833333333,1601.05555555556,125.833333333333
"19595","59667","2019",3,3,0,146916.666666667,1485.33333333333,101.333333333333
"19596","59668","2019",18,13,5,225511.111111111,2945.94444444444,86.2777777777778
"19597","59669","2019",9,9,0,196838.888888889,1745.66666666667,124
"19598","59670","2019",15,14,1,224442.866666667,2044.66666666667,116.333333333333
"19599","60001","2019",7,7,0,95785.7142857143,1080.71428571429,93.1428571428571
"19600","60002","2019",12,12,0,205308.75,2086.66666666667,105.333333333333
"19601","60003","2019",8,8,0,201350.75,1690.625,123.875
"19602","60004","2019",6,6,0,149866.666666667,1818,81.8333333333333
"19603","60005","2019",21,21,0,178319.523809524,2018.28571428571,91.5714285714286
"19604","60006","2019",14,14,0,194050,2574.42857142857,78.1428571428571
"19605","60007","2019",41,41,0,249865.512195122,2246.63414634146,114.780487804878
"19606","60008","2019",4,4,0,180250,1829,98
"19607","60009","2019",17,17,0,190883.764705882,1908.41176470588,103.588235294118
"19608","60010","2019",33,31,2,217818.181818182,2507.06060606061,91.9090909090909
"19609","60011","2019",5,5,0,180814,2220.8,107.4
"19610","60012","2019",51,49,2,192800.68627451,2269.41176470588,90.7450980392157
"19611","60013","2019",20,19,1,209333.5,1970.45,108.4
"19612","60014","2019",1,1,0,130000,2031,64
"19613","60015","2019",19,13,6,148804.105263158,1959.05263157895,79.3684210526316
"19614","60016","2019",4,3,1,231250,2434,96.25
"19615","60017","2019",14,14,0,112225,1275.28571428571,89.2142857142857
"19616","60019","2019",5,5,0,161000,1633.6,97.8
"19617","60020","2019",2,2,0,91500,1204,76
"19618","60021","2019",5,5,0,129509.8,1200.2,108.4
"19619","60022","2019",6,6,0,347825,2769.16666666667,127
"19620","60024","2019",10,10,0,230526,2291.6,107.1
"19621","60025","2019",21,20,1,152628.571428571,1906.19047619048,88.5238095238095
"19622","60026","2019",4,4,0,191500,2298.75,114.5
"19623","60028","2019",14,13,1,429669.285714286,3497.85714285714,128.071428571429
"19624","60029","2019",29,29,0,181334.482758621,1881,102.51724137931
"19625","60030","2019",6,6,0,141166.666666667,1759,85.5
"19626","60031","2019",6,6,0,195655.333333333,1628.5,121
"19627","60032","2019",10,9,1,174200,1543.3,115.2
"19628","60033","2019",15,13,2,303861.333333333,3382.46666666667,100.933333333333
"19629","60034","2019",17,17,0,186823.529411765,2154.05882352941,90.5294117647059
"19630","60035","2019",1,1,0,78500,1402,56
"19631","60036","2019",3,3,0,218500,2125.66666666667,103
"19632","60037","2019",11,11,0,102102.272727273,1118.36363636364,91.9090909090909
"19633","60039","2019",7,7,0,96271.4285714286,1008.14285714286,102.571428571429
"19634","60040","2019",11,11,0,191181.727272727,1653,129.454545454545
"19635","60041","2019",20,19,1,175065,1972.3,90.85
"19636","60042","2019",22,21,1,205618.045454545,2065.09090909091,101.181818181818
"19637","60043","2019",7,7,0,163200,1652.85714285714,104.428571428571
"19638","60044","2019",32,30,2,154731.25,1891.375,85.3125
"19639","60045","2019",8,6,2,207000,2843.625,73
"19640","60046","2019",2,2,0,250090,3094.5,82.5
"19641","60047","2019",9,9,0,262041.555555556,2594.66666666667,104
"19642","60049","2019",1,1,0,165000,1179,140
"19643","60050","2019",3,3,0,190666.666666667,2466.66666666667,75.3333333333333
"19644","60051","2019",1,1,0,138000,1683,82
"19645","60052","2019",1,1,0,95000,848,112
"19646","60053","2019",5,5,0,120935.4,1274.4,96.4
"19647","60054","2019",17,17,0,201373.823529412,1877.70588235294,123.470588235294
"19648","60055","2019",7,7,0,108171.428571429,1258,87.4285714285714
"19649","60057","2019",656,303,353,130855.030487805,1839.82164634146,72.672256097561
"19650","60059","2019",2,2,0,107500,1245.5,85.5
"19651","60060","2019",9,9,0,226450,2835,81.8888888888889
"19652","60061","2019",1,1,0,241265,1436,168
"19653","60062","2019",1,1,0,155000,1520,102
"19654","60063","2019",18,18,0,216816.666666667,2349.27777777778,94.8333333333333
"19655","60064","2019",7,7,0,184406.714285714,2042.71428571429,89.2857142857143
"19656","60065","2019",15,15,0,178723.333333333,2101.6,87.5333333333333
"19657","60066","2019",3,3,0,222666.666666667,1709,138.333333333333
"19658","60067","2019",16,16,0,177087.5,2353.25,89.1875
"19659","60068","2019",49,43,6,159060.408163265,2046.9387755102,84.3061224489796
"19660","60069","2019",13,10,3,201692.307692308,2135.76923076923,96.4615384615385
"19661","60070","2019",1,1,0,120000,1875,64
"19662","60071","2019",3,3,0,121000,1493.33333333333,81.3333333333333
"19663","60072","2019",7,7,0,150857.142857143,2275.57142857143,74.1428571428571
"19664","60073","2019",7,7,0,153885,1858.14285714286,86.5714285714286
"19665","60074","2019",19,19,0,241531.578947368,2439.68421052632,103.157894736842
"19666","60075","2019",1,1,0,96000,1067,90
"19667","60076","2019",6,6,0,146833.333333333,1410.33333333333,103
"19668","60077","2019",5,5,0,164160,1453.2,120.6
"19669","60078","2019",2,2,0,193500,1374,140.5
"19670","60079","2019",14,12,2,202523.714285714,2339.5,89.7857142857143
"19671","60081","2019",8,8,0,161500,1749,95.625
"19672","60082","2019",6,6,0,151666.666666667,1342.83333333333,114.333333333333
"19673","60083","2019",18,17,1,191634.5,1711.66666666667,112.166666666667
"19674","60084","2019",1,1,0,130000,1340,97
"19675","60085","2019",2,2,0,186500,1299.5,149
"19676","60086","2019",29,24,5,242606.896551724,2622.03448275862,96.3448275862069
"19677","60087","2019",2,2,0,477725,3741,129
"19678","60088","2019",68,55,13,220407.617647059,2564.11764705882,91.3235294117647
"19679","60089","2019",13,13,0,254682.307692308,2360.23076923077,116.230769230769
"19680","60090","2019",4,4,0,175512.5,2292.5,83.5
"19681","60091","2019",5,4,1,240400,2026.8,132.4
"19682","60092","2019",2,2,0,218000,2268,98
"19683","60093","2019",11,11,0,114620.909090909,1441.09090909091,81
"19684","60094","2019",6,6,0,186333.333333333,1726.66666666667,122.166666666667
"19685","60095","2019",7,7,0,268642.857142857,2599,111.714285714286
"19686","60097","2019",4,4,0,216075,1911.75,120.5
"19687","60098","2019",3,3,0,211453.333333333,1230.66666666667,173.666666666667
"19688","60099","2019",3,3,0,217873.333333333,1947.66666666667,114.666666666667
"19689","60100","2019",3,3,0,311800,2593.33333333333,128.333333333333
"19690","60101","2019",13,13,0,195376.923076923,2357.53846153846,86.8461538461538
"19691","60102","2019",27,27,0,194988.814814815,1870.2962962963,107.074074074074
"19692","60103","2019",39,39,0,174377.564102564,1997.89743589744,91.0769230769231
"19693","60104","2019",48,47,1,119096.729166667,1403.29166666667,87.75
"19694","60105","2019",5,5,0,119580,1348.2,86.4
"19695","60106","2019",21,21,0,191785.714285714,2313.85714285714,90.4761904761905
"19696","60107","2019",38,37,1,199565.789473684,2381.86842105263,87
"19697","60108","2019",3,3,0,105666.666666667,1496,75
"19698","60109","2019",3,3,0,157833.333333333,1532,106.666666666667
"19699","60110","2019",3,3,0,104333.333333333,921.333333333333,127.666666666667
"19700","60111","2019",1,1,0,80000,1000,80
"19701","60112","2019",3,3,0,143580.666666667,1552.33333333333,97
"19702","60113","2019",4,4,0,87250,948.5,84.25
"19703","60115","2019",9,9,0,177600,1778.77777777778,101
"19704","60116","2019",41,39,2,177987.804878049,2007.43902439024,90.5853658536585
"19705","60117","2019",4,4,0,130350,1224.75,104.25
"19706","60118","2019",1,1,0,57000,2280,25
"19707","60119","2019",19,19,0,166275.263157895,2094.52631578947,82.3684210526316
"19708","60120","2019",13,13,0,196938.769230769,2099.15384615385,101
"19709","60121","2019",1,1,0,122000,1245,98
"19710","60122","2019",14,14,0,129292.857142857,1348.92857142857,94.9285714285714
"19711","60123","2019",4,4,0,114250,1465.75,82.5
"19712","60124","2019",5,5,0,141080,1224.6,120.4
"19713","60125","2019",8,8,0,273152.75,3184.125,86.125
"19714","60126","2019",4,4,0,177625,1458.75,121
"19715","60127","2019",6,5,1,147666.666666667,2024.83333333333,78
"19716","60128","2019",8,8,0,141693.75,1789.25,82
"19717","60129","2019",23,23,0,140212.173913043,1460.5652173913,104.869565217391
"19718","60130","2019",12,12,0,183275,2620.25,77.25
"19719","60132","2019",4,4,0,213430,1561.5,123
"19720","60133","2019",6,6,0,167825,1524.5,113.5
"19721","60134","2019",31,30,1,194820.967741935,2252.12903225806,87.1612903225806
"19722","60135","2019",18,18,0,192142.777777778,2354.33333333333,85.8888888888889
"19723","60136","2019",6,6,0,134833.333333333,1567.33333333333,92.5
"19724","60137","2019",8,8,0,157086.125,1689.375,95.125
"19725","60138","2019",10,10,0,268888,3340.1,85.6
"19726","60139","2019",125,72,53,204873.68,2861.28,74.408
"19727","60140","2019",10,10,0,204705,2399.5,87
"19728","60141","2019",236,26,210,246290.050847458,3813.09745762712,66.5254237288136
"19729","60142","2019",59,29,30,232219.983050847,3097.47457627119,77.5762711864407
"19730","60143","2019",35,32,3,205866.142857143,2385.91428571429,95.0857142857143
"19731","60144","2019",2,2,0,243100,1982,132
"19732","60145","2019",16,16,0,196762.5,1819.9375,109.6875
"19733","60146","2019",3,3,0,105333.333333333,1076.33333333333,109.666666666667
"19734","60147","2019",8,8,0,192937.5,1559.375,128
"19735","60148","2019",3,2,1,206901.333333333,2080.33333333333,99.3333333333333
"19736","60149","2019",24,24,0,181059.166666667,2025.125,97.7916666666667
"19737","60150","2019",9,8,1,156944.444444444,1601.44444444444,97.5555555555556
"19738","60151","2019",41,40,1,213936.536585366,2092.53658536585,102.463414634146
"19739","60152","2019",3,3,0,195000,1813.66666666667,105.666666666667
"19740","60153","2019",2,2,0,121500,1285.5,91.5
"19741","60154","2019",22,21,1,235040.909090909,2513.04545454545,95.6363636363636
"19742","60155","2019",50,38,12,183552,2108.34,89.38
"19743","60156","2019",38,38,0,204517.973684211,2345.89473684211,89.9736842105263
"19744","60157","2019",127,77,50,139096.023622047,2048.28346456693,71.4566929133858
"19745","60158","2019",3,3,0,123333.333333333,1451.33333333333,98
"19746","60159","2019",590,144,446,179219.940677966,2367.53220338983,75.0661016949153
"19747","60160","2019",7,7,0,145732.857142857,1635,88.4285714285714
"19748","60161","2019",2,2,0,117500,1035.5,113.5
"19749","60162","2019",7,7,0,263428.571428571,2599.57142857143,106.285714285714
"19750","60163","2019",6,6,0,150858.333333333,1474,104.5
"19751","60164","2019",6,6,0,164500,1763.5,110.166666666667
"19752","60165","2019",11,11,0,242818.181818182,2117.54545454545,122.909090909091
"19753","60166","2019",15,15,0,211133.333333333,1852.2,118.133333333333
"19754","60167","2019",7,7,0,127871.428571429,1612.42857142857,85.1428571428571
"19755","60168","2019",1,1,0,216000,1701,127
"19756","60169","2019",12,12,0,176874.083333333,2037.75,94
"19757","60170","2019",7,7,0,376367.142857143,2906.85714285714,116.142857142857
"19758","60171","2019",3,3,0,85000,1425.33333333333,70
"19759","60172","2019",89,52,37,292199.426966292,3335.13483146067,90.314606741573
"19760","60173","2019",8,5,3,140500,2039,73.5
"19761","60174","2019",2,2,0,95000,1094,86.5
"19762","60175","2019",196,56,140,116638.066326531,1929.43367346939,61.0204081632653
"19763","60176","2019",178,106,72,190426.898876405,2655.64606741573,75.4213483146067
"19764","60177","2019",5,5,0,230400,1921.4,122.6
"19765","60178","2019",44,36,8,143311.318181818,1645.75,89
"19766","60179","2019",2,2,0,140500,1489,95
"19767","60180","2019",4,4,0,169250,1450.5,117
"19768","60181","2019",6,6,0,126000,1666.66666666667,77.6666666666667
"19769","60182","2019",2,2,0,120000,1356,88.5
"19770","60183","2019",2,2,0,97500,1023,105
"19771","60185","2019",11,11,0,244242.181818182,2141,114
"19772","60186","2019",3,3,0,112000,2216,49
"19773","60187","2019",17,17,0,127114.588235294,1492.29411764706,85.0588235294118
"19774","60188","2019",21,19,2,143138.095238095,1821.33333333333,81.3333333333333
"19775","60189","2019",2,2,0,152000,1644,99
"19776","60190","2019",5,5,0,190400,2143.6,96.6
"19777","60191","2019",11,11,0,148454.545454545,1653.45454545455,96.9090909090909
"19778","60192","2019",3,3,0,85666.6666666667,1394.66666666667,65.3333333333333
"19779","60193","2019",2,2,0,130475,2061,65.5
"19780","60194","2019",3,3,0,123333.333333333,1236,106.333333333333
"19781","60195","2019",8,7,1,194150,2164.625,92.125
"19782","60196","2019",18,18,0,234153.333333333,2346.94444444444,108.388888888889
"19783","60197","2019",18,18,0,218250,2757.38888888889,83.6111111111111
"19784","60198","2019",4,4,0,141025,1558.25,90
"19785","60200","2019",1,1,0,119000,1082,110
"19786","60201","2019",7,7,0,119502.857142857,1351.28571428571,99.5714285714286
"19787","60203","2019",8,6,2,264768.75,1882.375,127.625
"19788","60204","2019",3,3,0,136333.333333333,1056.66666666667,129.333333333333
"19789","60206","2019",7,7,0,187571.428571429,2021.85714285714,100.714285714286
"19790","60207","2019",2,2,0,272000,2493,109
"19791","60208","2019",3,3,0,287526.666666667,2811.66666666667,102.666666666667
"19792","60209","2019",4,4,0,218770,2419.25,96.75
"19793","60210","2019",4,4,0,156250,1793.75,85.5
"19794","60211","2019",7,7,0,172285.714285714,1753,105
"19795","60212","2019",17,17,0,201082.352941176,2471.23529411765,88.7058823529412
"19796","60213","2019",4,3,1,399575,2511.25,180.5
"19797","60214","2019",3,3,0,117333.333333333,997.333333333333,111.666666666667
"19798","60215","2019",4,4,0,189450,1930,100
"19799","60216","2019",4,2,2,120500,1397,83.75
"19800","60217","2019",3,3,0,170563,1447,118.333333333333
"19801","60218","2019",21,21,0,218230.80952381,2418.33333333333,92.4285714285714
"19802","60219","2019",2,2,0,156000,1540,112.5
"19803","60220","2019",9,9,0,167428.777777778,1679.66666666667,102.666666666667
"19804","60221","2019",5,5,0,97400,874.6,114
"19805","60222","2019",1,1,0,163000,1918,85
"19806","60223","2019",40,40,0,181247,2074.45,91.175
"19807","60224","2019",1,1,0,292000,1825,160
"19808","60225","2019",7,7,0,121357.142857143,1892.85714285714,72.7142857142857
"19809","60226","2019",3,2,1,400333.333333333,3574.33333333333,123.333333333333
"19810","60227","2019",3,3,0,99972.6666666667,954.666666666667,101.666666666667
"19811","60228","2019",10,9,1,216600,2389.7,96.9
"19812","60230","2019",5,5,0,212440,2098.4,105.8
"19813","60231","2019",5,5,0,252030,2313.8,117.8
"19814","60232","2019",5,4,1,139400,1772.4,82.4
"19815","60233","2019",20,20,0,106650,1179.4,99.7
"19816","60234","2019",35,31,4,177220.571428571,2077.14285714286,85.4
"19817","60235","2019",17,17,0,164680.588235294,1697,109.352941176471
"19818","60236","2019",2,2,0,112550,916,129
"19819","60238","2019",21,20,1,274988.80952381,3056.80952380952,94.5714285714286
"19820","60239","2019",9,9,0,199624.444444444,2082.66666666667,99.8888888888889
"19821","60240","2019",6,6,0,114406.666666667,1311.66666666667,95.5
"19822","60242","2019",6,6,0,131000,1461.66666666667,112.166666666667
"19823","60243","2019",2,2,0,209000,1862,116
"19824","60244","2019",8,8,0,157443.75,1589.125,107.5
"19825","60245","2019",26,26,0,149323.192307692,1569.15384615385,96.6153846153846
"19826","60247","2019",4,4,0,146992.5,1592.25,100.5
"19827","60248","2019",2,2,0,49400,587,82.5
"19828","60249","2019",2,2,0,166915,1366.5,116
"19829","60250","2019",7,7,0,217557.142857143,1762,129.714285714286
"19830","60251","2019",3,3,0,160617.666666667,1461.33333333333,115
"19831","60252","2019",5,5,0,162187.6,1523.2,116.2
"19832","60253","2019",12,12,0,177125,1537.83333333333,113.333333333333
"19833","60254","2019",3,3,0,164666.666666667,1995.33333333333,81
"19834","60255","2019",13,13,0,111453.846153846,1178.84615384615,96.3846153846154
"19835","60256","2019",30,30,0,184543.533333333,1957,96.4666666666667
"19836","60257","2019",8,8,0,205160,2324,92.5
"19837","60258","2019",2,2,0,105000,933.5,113
"19838","60259","2019",8,8,0,247625,2088.375,122.875
"19839","60260","2019",11,11,0,222681.818181818,2090.63636363636,110.727272727273
"19840","60261","2019",5,4,1,249000,2211.8,117.6
"19841","60262","2019",4,4,0,113750,1317.75,86
"19842","60263","2019",5,5,0,144200,1383,111.6
"19843","60264","2019",5,5,0,186800,1547.2,121.2
"19844","60265","2019",10,10,0,128150,1323.1,100.5
"19845","60267","2019",3,3,0,102666.666666667,1130.66666666667,83
"19846","60268","2019",7,7,0,110371.428571429,1267.14285714286,85.4285714285714
"19847","60269","2019",8,8,0,122625,1225.75,102.375
"19848","60270","2019",1,1,0,218000,2396,91
"19849","60271","2019",5,5,0,263260,2696.4,102.6
"19850","60272","2019",12,12,0,183611,2245.25,86.0833333333333
"19851","60273","2019",4,4,0,120000,1733.75,68.5
"19852","60274","2019",5,5,0,273000,2041.8,132.4
"19853","60275","2019",1,1,0,265000,2978,89
"19854","60276","2019",3,3,0,128666.666666667,1496,90
"19855","60277","2019",14,13,1,215488.357142857,2091.14285714286,109.071428571429
"19856","60278","2019",4,4,0,52500,674,78.25
"19857","60279","2019",7,7,0,207428.571428571,2322,90.7142857142857
"19858","60280","2019",3,3,0,143333.333333333,1683,87
"19859","60281","2019",13,13,0,158026.923076923,1951.46153846154,91.9230769230769
"19860","60282","2019",150,98,52,326279.493333333,3399.30666666667,100.786666666667
"19861","60284","2019",28,28,0,216789.285714286,2075.46428571429,107.142857142857
"19862","60285","2019",6,6,0,170000,1585.16666666667,109.666666666667
"19863","60286","2019",29,29,0,151921.551724138,1508.89655172414,103.413793103448
"19864","60287","2019",4,4,0,143875,1126.25,126
"19865","60288","2019",6,6,0,110416.666666667,1303,85.5
"19866","60289","2019",2,2,0,151000,1859.5,82
"19867","60290","2019",3,3,0,125333.333333333,1963.66666666667,68.3333333333333
"19868","60291","2019",15,15,0,102433.333333333,1231,91.4666666666667
"19869","60292","2019",4,4,0,180250,1646.25,113.25
"19870","60293","2019",8,8,0,306991,2238.875,136.125
"19871","60294","2019",2,2,0,269300,2427.5,94
"19872","60295","2019",2,2,0,44000,822,54
"19873","60297","2019",2,2,0,148000,2762.5,58
"19874","60298","2019",6,6,0,154083.333333333,1979,90.3333333333333
"19875","60299","2019",6,6,0,110500,1459,78.6666666666667
"19876","60301","2019",1,1,0,197000,1349,146
"19877","60302","2019",6,6,0,173250,2124.33333333333,90.1666666666667
"19878","60303","2019",1,1,0,148000,1682,88
"19879","60304","2019",3,3,0,156666.666666667,1282.66666666667,126.666666666667
"19880","60305","2019",5,5,0,163450,2439.6,71.2
"19881","60306","2019",3,3,0,187333.333333333,1663.66666666667,122.333333333333
"19882","60307","2019",10,10,0,185450,2081.4,100.4
"19883","60308","2019",4,4,0,203550,1925.5,121.75
"19884","60309","2019",12,12,0,233439.583333333,2686.16666666667,89.5833333333333
"19885","60310","2019",7,7,0,152085.714285714,1562.71428571429,102.285714285714
"19886","60311","2019",9,9,0,142182.222222222,1532.11111111111,93.3333333333333
"19887","60312","2019",3,3,0,104000,941.666666666667,121.666666666667
"19888","60313","2019",21,20,1,171707.142857143,1947.66666666667,94.3809523809524
"19889","60314","2019",5,5,0,148200,1496.8,115.4
"19890","60315","2019",7,7,0,149105.428571429,1558.14285714286,96
"19891","60316","2019",3,3,0,150666.666666667,2144.66666666667,68
"19892","60317","2019",18,18,0,205082.055555556,2069.77777777778,104.666666666667
"19893","60318","2019",4,4,0,233162.5,1913.75,129.25
"19894","60319","2019",15,15,0,165333.333333333,1668.33333333333,103.066666666667
"19895","60320","2019",6,6,0,171666.666666667,1945.33333333333,91.6666666666667
"19896","60321","2019",21,20,1,193678.571428571,2345.2380952381,91
"19897","60322","2019",9,9,0,205144.444444444,2232.33333333333,97.1111111111111
"19898","60323","2019",11,11,0,124909.090909091,1878,66.4545454545455
"19899","60324","2019",9,9,0,139722.222222222,1660.66666666667,90
"19900","60325","2019",20,18,2,216680.05,2127.05,111.45
"19901","60327","2019",15,15,0,174388.466666667,1618.46666666667,115.066666666667
"19902","60328","2019",1,1,0,238000,2404,99
"19903","60329","2019",2,2,0,125307,900,126
"19904","60330","2019",16,14,2,190818.75,2065.0625,94.75
"19905","60331","2019",11,11,0,188819.818181818,2050.45454545455,100.818181818182
"19906","60332","2019",5,5,0,216400,2840,83.4
"19907","60333","2019",18,17,1,193700,1993.11111111111,97.4444444444444
"19908","60334","2019",11,11,0,263327.272727273,2216.45454545455,123
"19909","60335","2019",3,3,0,158050,2145.66666666667,70
"19910","60336","2019",2,2,0,130000,1299,105
"19911","60337","2019",8,7,1,234550,1829.75,126.5
"19912","60338","2019",62,55,7,212275.790322581,2212.83870967742,98.4838709677419
"19913","60339","2019",2,2,0,142500,1423,101.5
"19914","60340","2019",1,1,0,45000,549,82
"19915","60341","2019",25,24,1,291785.48,2731.16,112.56
"19916","60342","2019",65,56,9,178053.615384615,2106.6,87.8615384615385
"19917","60343","2019",9,9,0,143055.555555556,1970.66666666667,74
"19918","60344","2019",6,6,0,146150,1360.16666666667,106.166666666667
"19919","60345","2019",4,4,0,105000,1300.5,83.25
"19920","60346","2019",142,107,35,414740.542253521,3399.97183098592,126.69014084507
"19921","60347","2019",3,3,0,168000,2077.33333333333,93.6666666666667
"19922","60348","2019",2,2,0,120530,791,164.5
"19923","60350","2019",21,21,0,172771.952380952,1832.61904761905,98.1904761904762
"19924","60351","2019",2,2,0,154500,2007,80.5
"19925","60352","2019",4,4,0,220250,2800,85.25
"19926","60353","2019",4,4,0,91100,975.75,107
"19927","60354","2019",1,1,0,180000,604,298
"19928","60355","2019",17,17,0,167101.176470588,2066.47058823529,86.6470588235294
"19929","60356","2019",13,13,0,225840.384615385,2159.07692307692,114.076923076923
"19930","60357","2019",1,1,0,220000,1375,160
"19931","60358","2019",13,9,4,195038.461538462,2356,87.3846153846154
"19932","60359","2019",1,1,0,172000,1496,115
"19933","60360","2019",75,60,15,142605.333333333,1904.77333333333,78.7066666666667
"19934","60361","2019",11,11,0,199873.818181818,1997.63636363636,109.454545454545
"19935","60362","2019",1,1,0,1e+05,893,112
"19936","60363","2019",7,7,0,260595.714285714,2163.28571428571,132.714285714286
"19937","60364","2019",9,8,1,153555.555555556,1792.44444444444,93
"19938","60365","2019",10,10,0,133894.4,1388.7,93.9
"19939","60366","2019",4,4,0,156928.75,1276.5,121
"19940","60367","2019",6,6,0,227606.666666667,2415.5,96.8333333333333
"19941","60368","2019",32,31,1,159981.25,1818.15625,88.5625
"19942","60369","2019",17,16,1,195937.882352941,2058.52941176471,95.3529411764706
"19943","60370","2019",14,13,1,227857.142857143,2241.78571428571,110.357142857143
"19944","60371","2019",1,1,0,86000,589,146
"19945","60372","2019",8,8,0,154758.125,1852,98.125
"19946","60373","2019",11,11,0,190524.909090909,1823.45454545455,107.818181818182
"19947","60374","2019",32,28,4,116432.71875,1522.4375,80.84375
"19948","60375","2019",5,5,0,177640,2221.6,84.6
"19949","60376","2019",6,6,0,174083.333333333,1530.16666666667,114.833333333333
"19950","60377","2019",5,5,0,124200,1708.8,71.8
"19951","60378","2019",2,2,0,216850,1776.5,122
"19952","60379","2019",9,9,0,181886.222222222,1545.33333333333,118.555555555556
"19953","60380","2019",27,23,4,171703.703703704,2101.25925925926,86.8888888888889
"19954","60381","2019",1,1,0,130000,1300,100
"19955","60382","2019",145,78,67,167308.068965517,2416.97931034483,71
"19956","60383","2019",5,5,0,204000,1743,117.2
"19957","60385","2019",8,8,0,133625,1381,94.125
"19958","60386","2019",7,7,0,162285.714285714,1711.14285714286,101.142857142857
"19959","60387","2019",6,6,0,136416.666666667,1915.5,75.1666666666667
"19960","60388","2019",1,1,0,115000,1533,75
"19961","60389","2019",3,3,0,132500,871,148
"19962","60390","2019",7,7,0,145428.571428571,2008.42857142857,86.5714285714286
"19963","60391","2019",4,4,0,169000,1874.75,82.25
"19964","60392","2019",13,13,0,158169.230769231,1903.61538461538,82.3076923076923
"19965","60393","2019",16,14,2,166253,1815.5625,93.9375
"19966","60395","2019",136,113,23,182609.051470588,2132.07352941176,89.4264705882353
"19967","60396","2019",6,6,0,133666.666666667,1441.83333333333,98.6666666666667
"19968","60397","2019",3,3,0,133666.666666667,1707.33333333333,85
"19969","60398","2019",43,29,14,230329.697674419,2867.46511627907,81.6511627906977
"19970","60400","2019",2,2,0,76000,758,95.5
"19971","60401","2019",10,10,0,188435.8,1685.4,125.9
"19972","60403","2019",28,26,2,112446.428571429,1442.82142857143,75.75
"19973","60404","2019",13,13,0,186900,2201.07692307692,88.6923076923077
"19974","60405","2019",10,10,0,129600,1341.8,100
"19975","60406","2019",9,9,0,203946.666666667,2068.11111111111,106.111111111111
"19976","60407","2019",9,9,0,95363.7777777778,857.333333333333,116.111111111111
"19977","60408","2019",11,11,0,163227.272727273,1696.81818181818,107.545454545455
"19978","60409","2019",24,23,1,181620.833333333,2093.54166666667,87.6666666666667
"19979","60410","2019",3,3,0,132666.666666667,1210,137
"19980","60411","2019",13,13,0,241432,2452.92307692308,103.846153846154
"19981","60412","2019",11,11,0,229863.636363636,2332.90909090909,100.181818181818
"19982","60414","2019",86,60,26,137749.906976744,1927.1976744186,74.3255813953488
"19983","60415","2019",2,2,0,505750,2720,186
"19984","60416","2019",1,1,0,120000,1000,120
"19985","60418","2019",10,10,0,160660,1587.9,108
"19986","60420","2019",10,10,0,229500,2359.5,107.6
"19987","60421","2019",2,2,0,497000,2805,178
"19988","60422","2019",3,3,0,237166.666666667,2305.33333333333,104
"19989","60423","2019",20,20,0,183200,2154.9,97.8
"19990","60424","2019",2,2,0,181500,1967.5,91.5
"19991","60425","2019",10,10,0,143000,1664.7,87.8
"19992","60426","2019",1,1,0,240000,1446,166
"19993","60427","2019",4,4,0,222788.25,2877.5,81
"19994","60428","2019",8,8,0,283875,2093.625,130.25
"19995","60429","2019",5,4,1,233500,3106.4,82
"19996","60430","2019",14,14,0,211861.428571429,2178,100.071428571429
"19997","60431","2019",7,7,0,127757.142857143,1301.28571428571,103.285714285714
"19998","60432","2019",15,8,7,211965.333333333,2543.66666666667,83.6
"19999","60433","2019",21,21,0,254447.619047619,2430.09523809524,114.809523809524
"20000","60434","2019",5,5,0,188738,1610.8,121.6
"20001","60435","2019",2,2,0,215000,2756,82.5
"20002","60436","2019",3,3,0,157000,1509.66666666667,107
"20003","60438","2019",2,2,0,161500,1406.5,115
"20004","60439","2019",72,57,15,135959.583333333,1832.52777777778,79.6944444444444
"20005","60440","2019",12,12,0,144041.666666667,1954.5,90.25
"20006","60441","2019",8,8,0,211150,2095.375,111.875
"20007","60443","2019",8,8,0,151437.5,1357.875,123.75
"20008","60444","2019",1,1,0,157000,1353,116
"20009","60445","2019",5,5,0,132600,1456.2,88.4
"20010","60446","2019",63,41,22,199481.523809524,2367.7619047619,90.1587301587302
"20011","60447","2019",9,8,1,268600,2056.55555555556,130.777777777778
"20012","60448","2019",8,8,0,198625,2068,100.625
"20013","60449","2019",2,2,0,179975,2012,92.5
"20014","60450","2019",62,53,9,219574.193548387,2499.87096774194,91.2741935483871
"20015","60451","2019",21,20,1,175410.714285714,2155.47619047619,86.0476190476191
"20016","60452","2019",6,6,0,232150,2349.16666666667,105.166666666667
"20017","60454","2019",11,11,0,198690.909090909,2132.09090909091,104.272727272727
"20018","60456","2019",13,13,0,173057.692307692,1941.15384615385,89.9230769230769
"20019","60457","2019",2,2,0,133500,1557,87
"20020","60458","2019",3,3,0,118333.333333333,1634.66666666667,80
"20021","60459","2019",6,6,0,162250,1619.16666666667,100
"20022","60460","2019",3,3,0,176471.666666667,1291.66666666667,135.666666666667
"20023","60462","2019",35,33,2,174499.142857143,1876.34285714286,104.371428571429
"20024","60463","2019",183,105,78,136690.224043716,1739.50819672131,78.4754098360656
"20025","60464","2019",18,18,0,187238.888888889,2269.11111111111,90.7777777777778
"20026","60465","2019",2,2,0,195000,1756.5,109.5
"20027","60466","2019",4,4,0,196875,2242,95
"20028","60468","2019",6,6,0,160871.666666667,1290,120.5
"20029","60469","2019",7,7,0,289471.428571429,2454,131
"20030","60470","2019",7,7,0,157370.714285714,1678.57142857143,102
"20031","60471","2019",126,95,31,118426.142857143,1364.25396825397,88.2936507936508
"20032","60472","2019",1,1,0,55000,859,64
"20033","60473","2019",2,2,0,159500,2158,77.5
"20034","60477","2019",7,7,0,218825.714285714,2310.85714285714,93.4285714285714
"20035","60478","2019",3,2,1,202833.333333333,2058,104.333333333333
"20036","60479","2019",8,8,0,218250,1832.5,118.375
"20037","60480","2019",9,8,1,143944.444444444,1611.77777777778,100.111111111111
"20038","60481","2019",8,8,0,177937.5,1913.75,92.875
"20039","60482","2019",58,48,10,285504.689655172,3226.51724137931,91.8275862068966
"20040","60483","2019",6,6,0,153000,2098.16666666667,77
"20041","60484","2019",6,6,0,189258.333333333,1837.16666666667,102.666666666667
"20042","60485","2019",1,1,0,121000,1407,86
"20043","60486","2019",5,5,0,138940,1707.4,81
"20044","60487","2019",3,3,0,238933.333333333,2347.33333333333,112.333333333333
"20045","60488","2019",3,3,0,119666.666666667,1768,67.6666666666667
"20046","60489","2019",19,17,2,233070.526315789,2533.36842105263,93.9473684210526
"20047","60490","2019",3,3,0,170666.666666667,1966.33333333333,86.3333333333333
"20048","60491","2019",28,18,10,172578.571428571,2213.32142857143,78.75
"20049","60492","2019",10,10,0,114997,1377.8,82.2
"20050","60493","2019",4,4,0,176640,1670.25,111
"20051","60494","2019",21,18,3,277241.666666667,3211.33333333333,94.9523809523809
"20052","60495","2019",4,4,0,147250,1849.5,79.5
"20053","60496","2019",4,4,0,107750,1098.25,99
"20054","60498","2019",5,5,0,130000,1613.8,86
"20055","60499","2019",3,3,0,171666.666666667,1450,136.666666666667
"20056","60500","2019",53,28,25,209168.264150943,2991.03773584906,75.0566037735849
"20057","60501","2019",26,26,0,175702.692307692,2062.19230769231,86.6153846153846
"20058","60503","2019",2,2,0,101750,1057.5,98.5
"20059","60504","2019",16,16,0,178405,2009.9375,92.0625
"20060","60505","2019",12,7,5,249200.416666667,3135.5,79.4166666666667
"20061","60506","2019",6,6,0,125400,1661.16666666667,86.6666666666667
"20062","60507","2019",4,4,0,83150,951.75,83.25
"20063","60508","2019",41,34,7,225698,2268.24390243902,100.414634146341
"20064","60509","2019",159,99,60,155128.459119497,2137.95597484277,75.0566037735849
"20065","60510","2019",7,7,0,209842.857142857,2818,95.8571428571429
"20066","60511","2019",3,3,0,145000,1405.66666666667,105.666666666667
"20067","60512","2019",1,1,0,229000,2082,110
"20068","60513","2019",44,39,5,273402.727272727,2930.95454545455,97.1590909090909
"20069","60514","2019",2,2,0,151500,1154,147
"20070","60515","2019",7,7,0,157761.857142857,1987,91.7142857142857
"20071","60516","2019",4,4,0,161250,1702.25,97.75
"20072","60517","2019",12,12,0,238875,2409.08333333333,101.416666666667
"20073","60518","2019",2,2,0,382500,1636,235
"20074","60519","2019",3,3,0,116483.333333333,1436,78.3333333333333
"20075","60520","2019",2,2,0,134500,1731,78
"20076","60521","2019",5,5,0,109603,1091.4,98
"20077","60522","2019",2,2,0,158500,1469.5,108.5
"20078","60523","2019",17,17,0,169088.235294118,1836.88235294118,91.6470588235294
"20079","60524","2019",35,16,19,137601.142857143,2014.91428571429,68.0857142857143
"20080","60526","2019",13,13,0,116460,1519.61538461538,83.6153846153846
"20081","60527","2019",2,2,0,245000,2568.5,96
"20082","60528","2019",2,2,0,287260,1869,146
"20083","60529","2019",2,2,0,138850,1371.5,101
"20084","60530","2019",2,2,0,170500,1722,100
"20085","60533","2019",24,24,0,159281.75,1795.91666666667,92.875
"20086","60534","2019",12,12,0,231808.333333333,2068.5,121.5
"20087","60535","2019",1,1,0,123000,1118,110
"20088","60536","2019",1,1,0,233000,4854,48
"20089","60537","2019",37,33,4,142135.135135135,1773.72972972973,82.7297297297297
"20090","60538","2019",3,3,0,151553.333333333,1402.66666666667,106
"20091","60539","2019",22,18,4,194108,2104.22727272727,97.7272727272727
"20092","60541","2019",4,4,0,164258.5,1593.75,111.75
"20093","60542","2019",9,9,0,177911.111111111,2082.11111111111,99.1111111111111
"20094","60543","2019",1,1,0,350000,1944,180
"20095","60545","2019",3,3,0,67000,1252,56.3333333333333
"20096","60546","2019",3,3,0,296770,2454.33333333333,133
"20097","60547","2019",14,14,0,2e+05,2103.07142857143,100.357142857143
"20098","60548","2019",9,9,0,206057.222222222,2423.55555555556,92.6666666666667
"20099","60549","2019",5,5,0,171800,1415.2,126.6
"20100","60550","2019",1,1,0,163000,1358,120
"20101","60551","2019",7,7,0,277178.571428571,2285.28571428571,124.428571428571
"20102","60552","2019",3,3,0,244816.666666667,3114.33333333333,79.3333333333333
"20103","60553","2019",3,3,0,249000,1575.33333333333,171
"20104","60554","2019",7,7,0,194284.285714286,2678.57142857143,75.4285714285714
"20105","60556","2019",3,3,0,133666.666666667,1517.66666666667,88
"20106","60557","2019",5,5,0,133900,1217.2,105.2
"20107","60558","2019",5,5,0,134400,1562.4,88.8
"20108","60559","2019",14,14,0,175025.714285714,1674.92857142857,107.142857142857
"20109","60560","2019",10,10,0,246275,3389.7,87
"20110","60561","2019",2,2,0,249000,2185,119.5
"20111","60562","2019",23,20,3,185347.826086957,2012.13043478261,96.6521739130435
"20112","60563","2019",2,2,0,268500,2118.5,127.5
"20113","60564","2019",1,1,0,152000,1520,100
"20114","60565","2019",7,7,0,89714.2857142857,1112.71428571429,82.7142857142857
"20115","60566","2019",1,1,0,154500,2088,74
"20116","60567","2019",13,13,0,136346.153846154,1678.84615384615,80
"20117","60568","2019",5,5,0,170200,2048.6,84.8
"20118","60569","2019",5,5,0,259800,2272.2,115.6
"20119","60570","2019",23,23,0,210778.826086957,2294.65217391304,101.434782608696
"20120","60572","2019",4,4,0,127171,1175.25,133
"20121","60573","2019",5,5,0,149762.4,1534,108.2
"20122","60574","2019",8,8,0,198300,1968.375,109.375
"20123","60575","2019",52,47,5,187064.807692308,2119.55769230769,91.2692307692308
"20124","60576","2019",8,8,0,216975,2048.5,107.5
"20125","60577","2019",24,24,0,136906.666666667,1597.04166666667,86.9583333333333
"20126","60578","2019",11,11,0,153213.636363636,2015.09090909091,76
"20127","60579","2019",10,10,0,254262,2811.4,100.7
"20128","60581","2019",70,46,24,115427.928571429,1622.31428571429,74.0857142857143
"20129","60582","2019",11,10,1,171881.818181818,1672.36363636364,96.7272727272727
"20130","60583","2019",3,3,0,182666.666666667,2189.33333333333,90
"20131","60584","2019",48,34,14,207370.208333333,2693.25,84.5833333333333
"20132","60586","2019",11,11,0,180974.909090909,2011.81818181818,91.8181818181818
"20133","60587","2019",18,17,1,173136.444444444,2266.88888888889,78.1666666666667
"20134","60588","2019",6,6,0,113686.666666667,1889.5,69.5
"20135","60589","2019",45,33,12,219835.666666667,2415.44444444444,95.6666666666667
"20136","60590","2019",9,9,0,134666.666666667,1655.66666666667,89.1111111111111
"20137","60591","2019",17,17,0,246764.705882353,2405.70588235294,106.647058823529
"20138","60592","2019",16,16,0,138176,1457.5,97.5625
"20139","60593","2019",1,1,0,166350,1715,97
"20140","60594","2019",5,5,0,182410,1454,134.2
"20141","60595","2019",5,5,0,169600,1744,102
"20142","60596","2019",4,4,0,70250,1070,63.75
"20143","60597","2019",23,23,0,207314.782608696,2396.26086956522,93.7391304347826
"20144","60598","2019",10,10,0,159570.5,1780,101.8
"20145","60599","2019",2,2,0,71250,762.5,94
"20146","60600","2019",6,6,0,233666.666666667,2556.5,91.8333333333333
"20147","60601","2019",15,13,2,162666.666666667,1952.73333333333,85.6
"20148","60603","2019",5,5,0,146700,1482,111.4
"20149","60604","2019",2,2,0,122500,1119,107.5
"20150","60605","2019",5,5,0,99600,1395.2,72.6
"20151","60608","2019",2,2,0,119000,1001,118
"20152","60609","2019",4,4,0,219225,1528.75,148
"20153","60610","2019",10,10,0,134900,1296.9,110.1
"20154","60611","2019",6,6,0,151536.666666667,1724.16666666667,87.5
"20155","60612","2019",256,107,149,270939.16796875,3194.47265625,84.6875
"20156","60613","2019",7,7,0,198606,1822.28571428571,119
"20157","60614","2019",4,4,0,349062.5,2635,132
"20158","60615","2019",3,3,0,115333.333333333,1510.66666666667,75
"20159","60616","2019",39,38,1,153381.794871795,1823.20512820513,87.9230769230769
"20160","60618","2019",5,5,0,193780,1816.4,106.8
"20161","60619","2019",25,22,3,239956,2631.76,97.6
"20162","60620","2019",7,7,0,185085.714285714,2485,81
"20163","60621","2019",2,2,0,141000,1518.5,99.5
"20164","60622","2019",3,3,0,113166.666666667,1197.66666666667,96
"20165","60623","2019",12,11,1,114766.666666667,1567.58333333333,79.4166666666667
"20166","60624","2019",2,2,0,155700,1701.5,113.5
"20167","60625","2019",8,8,0,154121.25,1365.375,114.5
"20168","60626","2019",8,8,0,164300,1684.75,98.625
"20169","60627","2019",2,2,0,109000,1062,102
"20170","60628","2019",16,16,0,205543.75,2049.4375,100.3125
"20171","60629","2019",4,4,0,133500,1821.25,77.75
"20172","60630","2019",2,2,0,241370,2689,92.5
"20173","60631","2019",18,17,1,275699.333333333,2841.05555555556,105.222222222222
"20174","60632","2019",11,11,0,123995.454545455,1395.18181818182,92.3636363636364
"20175","60633","2019",4,4,0,159125,1654,96.75
"20176","60634","2019",4,4,0,153250,1804.25,98.25
"20177","60635","2019",12,9,3,161115,2608.66666666667,68
"20178","60636","2019",49,46,3,154643.265306122,1866.91836734694,84.8571428571429
"20179","60637","2019",6,6,0,177833.333333333,2042.16666666667,86.5
"20180","60638","2019",7,7,0,207828.571428571,2640,80.4285714285714
"20181","60639","2019",17,17,0,169492.647058824,2105.58823529412,84.2941176470588
"20182","60640","2019",4,4,0,240250,3108.75,76.75
"20183","60641","2019",25,23,2,154186.8,1788.52,89.68
"20184","60642","2019",12,12,0,162183.333333333,1999.33333333333,82
"20185","60643","2019",15,14,1,131666.666666667,1593.4,86.0666666666667
"20186","60644","2019",39,34,5,189948.256410256,2253.46153846154,92.1282051282051
"20187","60645","2019",9,9,0,183555.555555556,1954.77777777778,98.2222222222222
"20188","60646","2019",12,12,0,235675,2247.5,108.583333333333
"20189","60647","2019",27,26,1,160004.814814815,1844.37037037037,92.1851851851852
"20190","60650","2019",4,4,0,262125,1836.5,142.75
"20191","60651","2019",40,39,1,210368.75,2066.175,106.825
"20192","60652","2019",29,26,3,181285.551724138,2113.06896551724,90.448275862069
"20193","60653","2019",2,2,0,154000,2207,68
"20194","60654","2019",1,1,0,105000,1842,57
"20195","60655","2019",4,4,0,125500,1726.75,74.75
"20196","60656","2019",4,4,0,178250,1797.25,98.5
"20197","60657","2019",2,2,0,125000,1392.5,87
"20198","60658","2019",9,9,0,189542.222222222,2148.11111111111,94.2222222222222
"20199","60659","2019",4,4,0,305500,2505.25,123.75
"20200","60660","2019",8,8,0,188562.5,1921.875,93.25
"20201","60661","2019",12,9,3,173795.833333333,2287.83333333333,76.5
"20202","60662","2019",8,8,0,180262.5,1933.25,96.625
"20203","60663","2019",3,3,0,161666.666666667,2499,68.6666666666667
"20204","60664","2019",4,4,0,55025,770.5,71
"20205","60665","2019",36,25,11,175507.527777778,2314.11111111111,76.7777777777778
"20206","60666","2019",16,16,0,324937.5,3037.3125,113.9375
"20207","60667","2019",60,39,21,158170.666666667,2161.88333333333,76.1833333333333
"20208","60668","2019",9,9,0,207841.666666667,1717.77777777778,124.444444444444
"20209","60669","2019",4,3,1,127700,1389.75,87.75
"20210","60670","2019",59,50,9,243591.694915254,2502.86440677966,102.033898305085
"20211","60671","2019",6,6,0,249191.666666667,2482.16666666667,101.5
"20212","60672","2019",2,2,0,107500,1362.5,79
"20213","60673","2019",2,2,0,130000,1282.5,106
"20214","60674","2019",10,10,0,271557.5,3107.1,105
"20215","60675","2019",8,8,0,162250,1707.625,103.5
"20216","60676","2019",3,3,0,112000,1006.33333333333,119.333333333333
"20217","60677","2019",1,1,0,290000,5273,55
"20218","60678","2019",16,14,2,208506.125,2367.9375,93.0625
"20219","60679","2019",6,6,0,173416.666666667,2141.83333333333,81.1666666666667
"20220","60681","2019",3,3,0,211000,1900,133.666666666667
"20221","60682","2019",4,4,0,382137.5,3552.5,115.5
"20222","60683","2019",8,8,0,225125,2169.75,114.75
"20223","60684","2019",60,48,12,179519.633333333,2127,85.0666666666667
"20224","60685","2019",11,11,0,176486.363636364,2000.72727272727,90.9090909090909
"20225","60686","2019",37,30,7,240963.513513514,2815.32432432432,88
"20226","60687","2019",3,3,0,169233.333333333,1845,89
"20227","60688","2019",3,3,0,206666.666666667,1919.66666666667,117
"20228","60689","2019",16,16,0,217841.875,1859.4375,119.5
"20229","60691","2019",1,1,0,205000,1708,120
"20230","60692","2019",1,1,0,170000,1133,150
"20231","60693","2019",8,8,0,105944.75,1125.375,93.625
"20232","60695","2019",22,17,5,328000.909090909,3623.18181818182,93.9545454545455
"20233","60698","2019",9,9,0,147511.111111111,2035.33333333333,79
"20234","60700","2019",15,15,0,230376.666666667,2229.06666666667,109.466666666667
"20235","60701","2019",15,15,0,133200,1502.86666666667,89.6666666666667
"20236","60702","2019",1,1,0,140100,1401,100
"20237","60703","2019",10,10,0,181470,2178.2,90.6
"20238","61001","2019",332,183,149,97005.7831325301,1260.96385542169,78.3253012048193
"20239","61002","2019",5,5,0,125400,1078.8,119.4
"20240","61005","2019",3,3,0,220833.333333333,1304,152.666666666667
"20241","61006","2019",136,107,29,101701.544117647,1286.33823529412,82.0367647058823
"20242","61007","2019",50,47,3,100705.4,1093.4,95.2
"20243","61008","2019",23,23,0,80037.8260869565,1100,76.8695652173913
"20244","61010","2019",3,3,0,109000,1204,89.6666666666667
"20245","61011","2019",4,4,0,133775,1073.5,137.25
"20246","61012","2019",2,2,0,104500,1468,71
"20247","61013","2019",2,2,0,178000,1568,94
"20248","61014","2019",5,5,0,143395,1193.6,113.2
"20249","61015","2019",2,2,0,207500,876.5,203.5
"20250","61017","2019",2,2,0,242675,2779,74
"20251","61018","2019",2,2,0,50500,867.5,58
"20252","61020","2019",2,2,0,96631,875.5,117
"20253","61021","2019",3,3,0,70927.6666666667,776,94.3333333333333
"20254","61023","2019",11,11,0,131786.363636364,1109.45454545455,119
"20255","61024","2019",8,8,0,75268.5,917.375,78.25
"20256","61026","2019",6,6,0,74833.3333333333,1145.66666666667,78.1666666666667
"20257","61028","2019",5,5,0,109600,1226,92.6
"20258","61029","2019",13,13,0,134353.846153846,1447.38461538462,101.692307692308
"20259","61030","2019",1,1,0,65000,650,100
"20260","61032","2019",5,5,0,110600,1431.8,86.2
"20261","61034","2019",1,1,0,76000,1118,68
"20262","61035","2019",1,1,0,130000,1262,103
"20263","61036","2019",3,3,0,180629,1351.66666666667,127.333333333333
"20264","61037","2019",4,4,0,155250,1265.5,113.25
"20265","61038","2019",34,33,1,111764.117647059,1262.26470588235,85.6176470588235
"20266","61039","2019",4,4,0,60875,757.5,90.75
"20267","61040","2019",6,6,0,89583.3333333333,807.666666666667,102.666666666667
"20268","61041","2019",8,8,0,108375,1201.625,86.625
"20269","61043","2019",17,15,2,104500,1461.35294117647,71.2352941176471
"20270","61044","2019",6,6,0,107475,1017.5,104.5
"20271","61046","2019",2,2,0,416000,2763,151
"20272","61048","2019",6,6,0,70833.3333333333,1032.5,85
"20273","61050","2019",13,13,0,162550,1666.92307692308,96.8461538461538
"20274","61051","2019",8,8,0,123562.5,1221.75,104.75
"20275","61052","2019",1,1,0,119000,1035,115
"20276","61053","2019",2,2,0,203425,2046.5,129.5
"20277","61054","2019",6,6,0,152833.333333333,1230.66666666667,125.333333333333
"20278","61055","2019",5,5,0,92900,967.4,99.4
"20279","61056","2019",1,1,0,280000,1379,203
"20280","61060","2019",1,1,0,144000,1171,123
"20281","61061","2019",28,28,0,126842.857142857,1397.35714285714,95.0714285714286
"20282","61062","2019",2,2,0,74000,603,122.5
"20283","61063","2019",19,19,0,78105.2631578947,894.368421052632,90.2105263157895
"20284","61064","2019",7,7,0,99000,1097.28571428571,103.428571428571
"20285","61066","2019",2,2,0,147200,1408.5,101.5
"20286","61068","2019",1,1,0,52000,867,60
"20287","61069","2019",2,2,0,74000,1045,75.5
"20288","61070","2019",12,11,1,104135.416666667,1052.83333333333,102.083333333333
"20289","61071","2019",8,8,0,169542.625,1635.75,96.625
"20290","61072","2019",5,5,0,96220,972.2,97
"20291","61074","2019",7,7,0,74928.5714285714,874.571428571429,80.4285714285714
"20292","61075","2019",18,18,0,62396.1111111111,730.666666666667,84.8333333333333
"20293","61077","2019",16,16,0,117360.375,1342.4375,88.8125
"20294","61078","2019",8,7,1,84500,964,85.125
"20295","61079","2019",18,18,0,116177.222222222,1212.27777777778,99.5555555555556
"20296","61081","2019",10,10,0,106350,1107.8,93.1
"20297","61084","2019",3,3,0,77666.6666666667,916.333333333333,84.6666666666667
"20298","61085","2019",1,1,0,75050,750,100
"20299","61086","2019",6,6,0,138800,1457.66666666667,102.5
"20300","61087","2019",9,9,0,133866.666666667,1239,125.888888888889
"20301","61089","2019",1,1,0,1e+05,444,225
"20302","61091","2019",14,14,0,93142.8571428571,1116.07142857143,89
"20303","61092","2019",8,8,0,137875,1275.125,107.5
"20304","61093","2019",10,10,0,82870,846.4,86.7
"20305","61094","2019",5,5,0,75640,784.8,93
"20306","61095","2019",6,6,0,126696.666666667,1373,92.5
"20307","61096","2019",28,28,0,83247.8571428571,1062.28571428571,79.2142857142857
"20308","61097","2019",11,11,0,178637.272727273,1856.27272727273,105.636363636364
"20309","61098","2019",5,5,0,132100,1456.2,98.8
"20310","61099","2019",5,5,0,213000,1730.6,111.4
"20311","61100","2019",4,4,0,104875,1206.5,86.75
"20312","61101","2019",2,2,0,135000,1767,77.5
"20313","61102","2019",2,2,0,160000,1545.5,103.5
"20314","61103","2019",3,3,0,91333.3333333333,1092,82.6666666666667
"20315","61104","2019",1,1,0,145000,1318,110
"20316","61105","2019",2,2,0,141828,1287.5,116
"20317","61107","2019",5,5,0,104860,1039.4,103.2
"20318","61108","2019",3,3,0,188333.333333333,1088,168.666666666667
"20319","61111","2019",1,1,0,175000,1636,107
"20320","61113","2019",4,4,0,177855,1436.5,126.75
"20321","61114","2019",3,3,0,157916.666666667,2156.66666666667,73.6666666666667
"20322","61116","2019",34,33,1,122192.647058824,1263.17647058824,97.8529411764706
"20323","61117","2019",23,19,4,143064.347826087,1510.60869565217,96.7826086956522
"20324","61118","2019",3,3,0,123296.666666667,1421,85
"20325","61120","2019",1,1,0,50000,595,84
"20326","61121","2019",4,4,0,194750,2007,92.5
"20327","61122","2019",2,2,0,82500,1099,71
"20328","61123","2019",1,1,0,183500,1147,160
"20329","61124","2019",9,9,0,75040.6666666667,913.222222222222,80
"20330","61126","2019",11,11,0,141236.363636364,1235,117.454545454545
"20331","61129","2019",7,7,0,116571.428571429,1145.42857142857,100
"20332","61130","2019",8,8,0,158031.25,1796.625,104
"20333","61133","2019",10,10,0,112580.1,1084.2,111.8
"20334","61137","2019",7,7,0,125316.714285714,1353.28571428571,88.1428571428571
"20335","61139","2019",6,6,0,131333.333333333,1140.33333333333,118.833333333333
"20336","61140","2019",10,10,0,119300,1317.2,89.2
"20337","61141","2019",1,1,0,138000,1113,124
"20338","61142","2019",3,3,0,122906.666666667,1015,121.333333333333
"20339","61143","2019",29,25,4,118002.586206897,1494.75862068966,84.7586206896552
"20340","61145","2019",34,31,3,88041.4705882353,964.882352941176,94.5294117647059
"20341","61146","2019",4,4,0,47776,756.75,70.5
"20342","61148","2019",2,2,0,158400,1423,115.5
"20343","61149","2019",3,3,0,59666.6666666667,819.333333333333,76.6666666666667
"20344","61150","2019",8,8,0,106500,1276,89.625
"20345","61151","2019",2,2,0,128000,1503.5,85
"20346","61153","2019",29,29,0,121062.24137931,1179.62068965517,103.448275862069
"20347","61156","2019",7,7,0,128785.714285714,914.428571428571,135.428571428571
"20348","61160","2019",5,5,0,171800,2372.8,67.8
"20349","61162","2019",2,2,0,149000,1568.5,105
"20350","61163","2019",15,15,0,86990.4,917.8,93.6
"20351","61164","2019",4,4,0,131250,951,135.75
"20352","61165","2019",4,4,0,147862.5,1695.25,91.75
"20353","61166","2019",6,6,0,157573.333333333,1183.33333333333,133.333333333333
"20354","61167","2019",65,65,0,115751.184615385,1226.52307692308,95.5846153846154
"20355","61168","2019",37,33,4,88444.3243243243,986.702702702703,90.1351351351351
"20356","61169","2019",8,8,0,126875,1270.875,97.125
"20357","61170","2019",2,2,0,107500,995,109
"20358","61176","2019",3,3,0,206166.666666667,1330.33333333333,161.666666666667
"20359","61178","2019",1,1,0,320000,1641,195
"20360","61180","2019",2,2,0,153250,1877.5,81.5
"20361","61181","2019",19,16,3,77302.6315789474,1016.63157894737,77.8421052631579
"20362","61182","2019",2,2,0,23525,524.5,43.5
"20363","61183","2019",3,3,0,58333.3333333333,806.333333333333,72.6666666666667
"20364","61187","2019",3,3,0,99000,1816,55.6666666666667
"20365","61189","2019",3,3,0,88500,768.666666666667,115.333333333333
"20366","61190","2019",3,3,0,232666.666666667,2369.33333333333,95.6666666666667
"20367","61193","2019",1,1,0,35000,449,78
"20368","61194","2019",8,8,0,134931.25,1105.25,127.625
"20369","61195","2019",3,3,0,78500,929.666666666667,92.3333333333333
"20370","61196","2019",34,34,0,131378.235294118,1424.08823529412,96.7058823529412
"20371","61197","2019",1,1,0,84000,913,92
"20372","61198","2019",1,1,0,86854,1086,80
"20373","61199","2019",8,8,0,90500,1058.5,94.375
"20374","61202","2019",5,5,0,129934,1074.2,115.2
"20375","61203","2019",9,9,0,151586.666666667,1200.88888888889,128.333333333333
"20376","61206","2019",9,9,0,114284.222222222,1216.33333333333,88.5555555555556
"20377","61207","2019",6,6,0,133166.666666667,961.833333333333,124.833333333333
"20378","61208","2019",8,8,0,111812.5,1348.875,84.625
"20379","61209","2019",4,4,0,87325,867.75,120.75
"20380","61210","2019",2,2,0,122000,1147.5,104
"20381","61211","2019",20,20,0,75542.1,841.95,89.55
"20382","61213","2019",2,2,0,42500,908,63
"20383","61214","2019",91,74,17,101158.065934066,1257.20879120879,82.6263736263736
"20384","61215","2019",10,10,0,139311.3,1333.2,92.9
"20385","61216","2019",5,5,0,104400,997,99.6
"20386","61217","2019",2,2,0,149450,1574.5,120
"20387","61218","2019",24,24,0,71387.5,1021.125,72.5
"20388","61219","2019",3,3,0,118900,1096,120
"20389","61221","2019",7,7,0,122187.142857143,1323.71428571429,95.2857142857143
"20390","61222","2019",8,8,0,107430,1078.625,102.625
"20391","61224","2019",8,8,0,158568.75,1513.75,106.625
"20392","61225","2019",1,1,0,73000,4867,15
"20393","61227","2019",1,1,0,141000,1343,105
"20394","61228","2019",10,10,0,98386.2,972.1,104.8
"20395","61230","2019",56,56,0,132586.642857143,1527.75,93.1607142857143
"20396","61232","2019",14,14,0,93174.2857142857,808.785714285714,115.714285714286
"20397","61233","2019",3,3,0,70333.3333333333,901,78
"20398","61234","2019",4,4,0,145000,1463,100.25
"20399","61237","2019",2,2,0,88000,769,105.5
"20400","61240","2019",4,4,0,160250,1722.75,87.75
"20401","61241","2019",4,4,0,109250,1182.75,88.75
"20402","61242","2019",7,7,0,77128.5714285714,1053.42857142857,88.1428571428571
"20403","61243","2019",12,12,0,176029.166666667,1372,99.6666666666667
"20404","61244","2019",1,1,0,614350,8084,76
"20405","61248","2019",10,10,0,71400,842,85.3
"20406","61251","2019",5,5,0,110520,979.4,112.6
"20407","61252","2019",1,1,0,555000,3227,172
"20408","61255","2019",10,10,0,102426,969.9,96.2
"20409","61257","2019",2,2,0,27500,667.5,42
"20410","61258","2019",11,11,0,103706.727272727,1027.45454545455,98.5454545454545
"20411","61260","2019",7,7,0,58500,858.428571428571,69.1428571428571
"20412","61261","2019",1,1,0,50000,500,100
"20413","61262","2019",3,3,0,53900,515.333333333333,95.6666666666667
"20414","61263","2019",5,5,0,109000,1320.4,88.2
"20415","61264","2019",1,1,0,55000,764,72
"20416","61265","2019",3,3,0,86733.3333333333,1001,81.6666666666667
"20417","61266","2019",4,4,0,182386,1173.25,154.25
"20418","61267","2019",2,2,0,75000,1669,52
"20419","61268","2019",3,3,0,96950,1273.33333333333,79.6666666666667
"20420","61269","2019",5,5,0,119015,903.2,134.2
"20421","61274","2019",1,1,0,142000,1511,94
"20422","61275","2019",6,6,0,62166.6666666667,707.333333333333,75.5
"20423","61276","2019",8,8,0,130363.125,1330.625,104.5
"20424","61277","2019",1,1,0,150000,1220,123
"20425","61278","2019",30,30,0,104132.633333333,1235.93333333333,84.2333333333333
"20426","61279","2019",5,5,0,150300,1913.8,87.8
"20427","61281","2019",6,6,0,79730.1666666667,933.666666666667,86.5
"20428","61283","2019",1,1,0,40000,500,80
"20429","61284","2019",2,2,0,82500,638,132
"20430","61286","2019",1,1,0,220000,2200,100
"20431","61287","2019",6,6,0,59626.6666666667,902.666666666667,66.1666666666667
"20432","61288","2019",4,4,0,116850,1239.25,93.25
"20433","61289","2019",1,1,0,170000,1532,111
"20434","61290","2019",2,2,0,142200,1110,128.5
"20435","61292","2019",8,8,0,88468.75,1035.625,83.5
"20436","61293","2019",62,54,8,108894.983870968,1335.22580645161,86.9677419354839
"20437","61294","2019",12,12,0,110991.666666667,1022.58333333333,109.333333333333
"20438","61295","2019",1,1,0,186000,1488,125
"20439","61297","2019",10,10,0,78050,955.7,88.6
"20440","61298","2019",7,7,0,118557.142857143,1184.42857142857,97.7142857142857
"20441","61300","2019",12,12,0,141443.333333333,1413.08333333333,105.916666666667
"20442","61301","2019",2,2,0,49500,686.5,71
"20443","61302","2019",1,1,0,39000,975,40
"20444","61303","2019",11,11,0,123465.454545455,1140.90909090909,111.636363636364
"20445","61304","2019",4,4,0,102651.5,962.75,101.75
"20446","61307","2019",6,6,0,148143.333333333,1330.5,105.333333333333
"20447","61308","2019",1,1,0,120000,1667,72
"20448","61309","2019",33,33,0,171424.454545455,1558.9696969697,103.606060606061
"20449","61310","2019",6,6,0,112583.333333333,936.166666666667,137
"20450","61314","2019",5,5,0,124200,1205.2,109.6
"20451","61316","2019",1,1,0,50000,388,129
"20452","61319","2019",2,2,0,51500,725.5,69.5
"20453","61321","2019",5,5,0,131500,1261.8,108
"20454","61322","2019",3,3,0,86333.3333333333,836.666666666667,84.3333333333333
"20455","61323","2019",1,1,0,120000,923,130
"20456","61324","2019",15,15,0,109040,1128.33333333333,93.8666666666667
"20457","61326","2019",7,7,0,105781.428571429,875.142857142857,116.571428571429
"20458","61327","2019",6,6,0,58343.3333333333,794.333333333333,75.1666666666667
"20459","61328","2019",3,3,0,101666.666666667,1277.66666666667,80
"20460","61329","2019",5,5,0,143772.4,1346,117.8
"20461","61330","2019",2,2,0,105487.5,998.5,100.5
"20462","61331","2019",3,3,0,166333.333333333,1902,87.3333333333333
"20463","61332","2019",2,2,0,48000,927,55.5
"20464","61333","2019",4,4,0,115110.25,1119.75,95.75
"20465","61336","2019",2,2,0,122750,1341.5,88
"20466","61339","2019",39,39,0,85820.5128205128,1010.53846153846,85.2564102564103
"20467","61341","2019",17,16,1,128318.823529412,1404.94117647059,93.8235294117647
"20468","61342","2019",14,14,0,96759.2857142857,1098.57142857143,84.2857142857143
"20469","61344","2019",16,16,0,91734.375,907.6875,95.875
"20470","61345","2019",45,43,2,123172.666666667,1222.93333333333,109.711111111111
"20471","61346","2019",7,7,0,186341,1673.71428571429,116.714285714286
"20472","61347","2019",9,9,0,99000,971.444444444444,102.111111111111
"20473","61348","2019",4,4,0,252375,1558.5,120
"20474","61349","2019",2,2,0,89302.5,1163,82
"20475","61350","2019",5,5,0,106000,1093.2,97.6
"20476","61351","2019",5,5,0,160600,1515.8,102.6
"20477","61352","2019",1,1,0,107000,1189,90
"20478","61357","2019",6,6,0,63390,818,86.8333333333333
"20479","61358","2019",2,2,0,322500,1491,164
"20480","61360","2019",1,1,0,156000,1357,115
"20481","61361","2019",2,2,0,81800,742,100.5
"20482","61362","2019",5,5,0,115860,1265.2,91.4
"20483","61363","2019",1,1,0,131000,1871,70
"20484","61365","2019",6,6,0,171333.333333333,1231.16666666667,141.333333333333
"20485","61366","2019",1,1,0,69000,841,82
"20486","61367","2019",3,3,0,192333.333333333,1902.66666666667,96.3333333333333
"20487","61369","2019",8,8,0,117862.5,1194.875,99.75
"20488","61370","2019",3,3,0,132488.333333333,825,183
"20489","61371","2019",4,4,0,87025,1187.5,73.25
"20490","61372","2019",1,1,0,160000,1212,132
"20491","61373","2019",5,5,0,126610,1098,123.6
"20492","61374","2019",1,1,0,86000,632,136
"20493","61375","2019",16,16,0,93956.25,1050,84.75
"20494","61376","2019",9,9,0,73877.7777777778,809.222222222222,89.5555555555556
"20495","61379","2019",2,2,0,131950,1586,80
"20496","61381","2019",2,2,0,225500,1693.5,133.5
"20497","61382","2019",11,11,0,170816.818181818,1309.90909090909,108.727272727273
"20498","61384","2019",3,3,0,131666.666666667,1613,83.6666666666667
"20499","61385","2019",9,9,0,110994.888888889,1410.55555555556,81.8888888888889
"20500","61386","2019",5,5,0,152800,1255,124
"20501","61387","2019",6,6,0,60366.6666666667,666.666666666667,89.8333333333333
"20502","61388","2019",4,4,0,202000,1660,115.75
"20503","61389","2019",19,19,0,87484.2105263158,982.157894736842,92.8947368421053
"20504","61390","2019",1,1,0,68950,472,146
"20505","61391","2019",38,35,3,121663.684210526,1179.5,95.9210526315789
"20506","61392","2019",4,4,0,109000,1054.25,102.25
"20507","61393","2019",4,4,0,139075,1616,93.5
"20508","61394","2019",12,12,0,111000,1206.75,90.3333333333333
"20509","61395","2019",5,5,0,144400,1119.6,126
"20510","61396","2019",1,1,0,140282,1231,114
"20511","61397","2019",35,34,1,144221.142857143,1476.91428571429,100.371428571429
"20512","61398","2019",2,2,0,103500,941.5,105
"20513","61399","2019",3,3,0,131000,1631.33333333333,85.3333333333333
"20514","61400","2019",2,2,0,135500,930.5,145.5
"20515","61402","2019",4,4,0,124843.75,1289.75,98.75
"20516","61404","2019",5,5,0,185009,1435.4,128.8
"20517","61405","2019",6,6,0,115166.666666667,1310.83333333333,91.1666666666667
"20518","61406","2019",8,8,0,104187.5,1217.75,98.875
"20519","61407","2019",14,14,0,103335.714285714,1343.57142857143,86.5
"20520","61408","2019",6,6,0,69083.3333333333,960,69
"20521","61411","2019",3,3,0,102239,883,112.333333333333
"20522","61412","2019",5,4,1,95440,1167.4,79.2
"20523","61413","2019",4,4,0,121375,1264.5,118
"20524","61414","2019",12,11,1,118179.166666667,1244.33333333333,96.5833333333333
"20525","61415","2019",6,6,0,132250,1162.66666666667,111.166666666667
"20526","61416","2019",1,1,0,610000,4067,150
"20527","61418","2019",7,7,0,147171.428571429,1789.85714285714,86
"20528","61419","2019",6,6,0,67250,588.5,106.5
"20529","61420","2019",1,1,0,75500,910,83
"20530","61421","2019",9,9,0,86400,903.222222222222,92.2222222222222
"20531","61422","2019",9,9,0,114873.888888889,1269.44444444444,95.2222222222222
"20532","61423","2019",4,4,0,181433.5,1510.5,126.25
"20533","61424","2019",5,5,0,70660,1048.4,70.8
"20534","61425","2019",1,1,0,305000,1121,272
"20535","61426","2019",6,6,0,115471.666666667,1446.5,78
"20536","61429","2019",21,21,0,98561.9047619048,1017.52380952381,99.9047619047619
"20537","61432","2019",5,5,0,81400,1129,76.4
"20538","61433","2019",6,6,0,174042.833333333,1529.66666666667,113.833333333333
"20539","61435","2019",1,1,0,1e+05,2222,45
"20540","61436","2019",2,2,0,81900,938.5,85
"20541","61438","2019",3,3,0,164000,2624.66666666667,68
"20542","61439","2019",1,1,0,62600,894,70
"20543","61440","2019",11,11,0,113300,1137,106
"20544","61442","2019",1,1,0,60000,1111,54
"20545","61443","2019",9,9,0,117327.777777778,1184.55555555556,104.777777777778
"20546","61444","2019",3,3,0,107466.666666667,1070.66666666667,100.666666666667
"20547","61445","2019",7,7,0,91743.1428571429,901,95.8571428571429
"20548","61446","2019",4,4,0,133000,2294.75,59.5
"20549","61447","2019",16,15,1,103478.125,1187.625,81.5625
"20550","61448","2019",2,2,0,195000,1277,145.5
"20551","61451","2019",5,4,1,105828,1216.8,85.8
"20552","61452","2019",4,4,0,131750,2101,75.25
"20553","61453","2019",5,5,0,93100,979.8,96.8
"20554","61454","2019",11,11,0,92247.0909090909,1070.18181818182,86.4545454545455
"20555","61456","2019",22,22,0,131982.272727273,1196.5,119.363636363636
"20556","61457","2019",12,12,0,107833.333333333,1235.66666666667,84.75
"20557","61459","2019",2,2,0,116500,1247,92
"20558","61460","2019",13,13,0,99898.7692307692,913.846153846154,108.076923076923
"20559","61461","2019",1,1,0,66000,805,82
"20560","61462","2019",8,8,0,119112.5,1370.625,90.5
"20561","61463","2019",12,12,0,82951.6666666667,949.583333333333,85.25
"20562","61464","2019",42,37,5,99930.5476190476,1060.90476190476,93.7857142857143
"20563","61466","2019",15,15,0,113220.733333333,1259.26666666667,90.3333333333333
"20564","61467","2019",4,4,0,119650,1114.5,107.75
"20565","61472","2019",4,4,0,123975,1288,92.75
"20566","61473","2019",6,6,0,91900,1212.33333333333,74.5
"20567","61474","2019",43,43,0,114626.604651163,1115.67441860465,104.53488372093
"20568","61475","2019",8,8,0,76765,1003.75,74.25
"20569","61476","2019",4,4,0,161125,1165,136.5
"20570","61479","2019",1,1,0,60000,500,120
"20571","61480","2019",4,4,0,81500,945.25,104
"20572","61481","2019",1,1,0,67000,705,95
"20573","61482","2019",4,4,0,189250,1388.75,132.5
"20574","61483","2019",97,33,64,86056.824742268,1443.74226804124,64.3298969072165
"20575","61484","2019",37,36,1,109036.783783784,1117.40540540541,93.5945945945946
"20576","61485","2019",2,2,0,101500,925,113.5
"20577","61486","2019",58,58,0,82918.2586206897,837.189655172414,101
"20578","61487","2019",6,6,0,83750,920.166666666667,86.5
"20579","61488","2019",2,2,0,97500,1010,95
"20580","61490","2019",3,3,0,81333.3333333333,980.333333333333,81
"20581","61491","2019",50,50,0,110761.18,1091.52,100.08
"20582","61492","2019",2,2,0,65000,787,79.5
"20583","61493","2019",2,2,0,277500,2076.5,127.5
"20584","61494","2019",17,17,0,91147.0588235294,1071.94117647059,85.5882352941177
"20585","61497","2019",18,18,0,152761.111111111,1536.5,99.9444444444444
"20586","61499","2019",2,2,0,155000,1652.5,99
"20587","61500","2019",2,2,0,116900,1320.5,88
"20588","61501","2019",6,6,0,195750,1583,134.666666666667
"20589","61503","2019",5,5,0,76848,1243.6,69.4
"20590","61505","2019",1,1,0,160000,1951,82
"20591","61507","2019",3,3,0,167666.666666667,1271,125.333333333333
"20592","61508","2019",38,33,5,83786.7368421053,943.052631578947,85.8157894736842
"20593","61510","2019",3,3,0,136333.333333333,1311,106
"20594","61512","2019",2,2,0,48500,676,68
"20595","62001","2019",25,25,0,203838,1972.36,103
"20596","62002","2019",2,2,0,98650,1211.5,85
"20597","62003","2019",6,5,1,130333.333333333,1529.33333333333,86
"20598","62004","2019",91,87,4,153261.483516484,1691.92307692308,90.4945054945055
"20599","62005","2019",6,6,0,158326.666666667,1356.33333333333,127.5
"20600","62006","2019",4,4,0,99250,1098.75,94
"20601","62007","2019",6,6,0,238116.666666667,2099.83333333333,118.666666666667
"20602","62008","2019",10,10,0,151629.5,1372.7,110.9
"20603","62009","2019",4,4,0,179383.75,1534.75,120.5
"20604","62010","2019",1,1,0,140000,1308,107
"20605","62011","2019",8,8,0,247825.375,1766.875,153.5
"20606","62012","2019",4,4,0,220800,1594.25,140.25
"20607","62013","2019",26,26,0,152761.538461538,1562.15384615385,95.5
"20608","62014","2019",107,102,5,128041.439252336,1330.91588785047,99.5794392523364
"20609","62015","2019",5,5,0,187400,1897,101.2
"20610","62016","2019",2,2,0,170000,2547,66.5
"20611","62017","2019",1,1,0,40000,727,55
"20612","62018","2019",3,3,0,158500,1326.66666666667,137.666666666667
"20613","62019","2019",36,32,4,141521.388888889,1553.08333333333,92.0277777777778
"20614","62020","2019",9,9,0,186931.111111111,1497.88888888889,129.777777777778
"20615","62021","2019",4,4,0,157500,1647.5,94.5
"20616","62022","2019",1,1,0,120000,822,146
"20617","62023","2019",33,32,1,139488.727272727,1417.81818181818,101.727272727273
"20618","62024","2019",2,2,0,167500,1806,92
"20619","62025","2019",41,37,4,238213.365853659,2438.21951219512,101.365853658537
"20620","62026","2019",2,2,0,136000,1102.5,127.5
"20621","62027","2019",1,1,0,176000,1796,98
"20622","62028","2019",9,9,0,111974.444444444,1130.44444444444,103.555555555556
"20623","62029","2019",2,2,0,101500,810,106.5
"20624","62030","2019",3,3,0,138333.333333333,1764,80
"20625","62031","2019",16,16,0,177750,1585.9375,115.375
"20626","62032","2019",28,28,0,155090.535714286,1608.35714285714,98.0357142857143
"20627","62033","2019",42,42,0,125740.166666667,1543.7619047619,83.6666666666667
"20628","62034","2019",19,18,1,148852.578947368,1387.31578947368,106.052631578947
"20629","62035","2019",75,75,0,145665.6,1395.65333333333,103.84
"20630","62036","2019",8,8,0,107500,1041.375,108.375
"20631","62037","2019",44,40,4,210057.227272727,1982,105.431818181818
"20632","62038","2019",36,36,0,161038.611111111,1713.91666666667,98.3055555555556
"20633","62039","2019",8,8,0,225347.125,1833.25,128.75
"20634","62040","2019",117,111,6,127921.777777778,1435.62393162393,92.1282051282051
"20635","62041","2019",726,324,402,140164.986225895,1885.97107438017,76.4765840220386
"20636","62042","2019",10,10,0,187592.5,1418.7,127.9
"20637","62043","2019",36,36,0,154623.611111111,1570.77777777778,98.3333333333333
"20638","62044","2019",10,10,0,176110,1846.7,100.7
"20639","62045","2019",12,12,0,162508.333333333,1648.91666666667,101
"20640","62046","2019",5,5,0,110450,1155,94.4
"20641","62047","2019",2,2,0,97500,1100.5,86.5
"20642","62048","2019",111,105,6,91660.5495495496,1072.71171171171,87.1711711711712
"20643","62049","2019",10,10,0,139558,1276.2,115.6
"20644","62050","2019",8,8,0,91187.5,935.125,110.625
"20645","62051","2019",51,51,0,155085.960784314,1685.58823529412,91.8823529411765
"20646","62052","2019",3,3,0,235000,2781,96
"20647","62053","2019",7,7,0,127857.142857143,1372.85714285714,92.1428571428571
"20648","62054","2019",20,16,4,206573.5,2481.4,84.7
"20649","62055","2019",5,5,0,170140,1767.6,104.6
"20650","62056","2019",15,13,2,253779,3348.33333333333,83.5333333333333
"20651","62057","2019",59,59,0,158438.983050847,1593.83050847458,101.898305084746
"20652","62058","2019",3,3,0,166333.333333333,1235.66666666667,139.666666666667
"20653","62059","2019",4,4,0,263000,1654.75,160.25
"20654","62060","2019",22,22,0,77777.2727272727,893.454545454545,85.6818181818182
"20655","62061","2019",2,2,0,107500,1272.5,85
"20656","62063","2019",20,20,0,125456.7,1251.65,102.55
"20657","62064","2019",1,1,0,164000,1281,128
"20658","62065","2019",146,135,11,115955.109589041,1334.51369863014,88.4794520547945
"20659","62067","2019",4,4,0,153750,1205.75,135.75
"20660","62068","2019",3,3,0,154666.666666667,1333,131.333333333333
"20661","62069","2019",2,2,0,129000,1044,125
"20662","62071","2019",3,3,0,143600,1387.66666666667,105.333333333333
"20663","62072","2019",1,1,0,140000,1628,86
"20664","62073","2019",18,18,0,183660.666666667,1856.27777777778,102.611111111111
"20665","62074","2019",3,3,0,199333.333333333,1316,146.333333333333
"20666","62075","2019",12,12,0,226797.916666667,2002.66666666667,116.333333333333
"20667","62076","2019",3,3,0,164170.666666667,1548.33333333333,118.333333333333
"20668","62077","2019",5,5,0,186643.6,1460.4,141
"20669","62078","2019",14,14,0,140357.142857143,1738.71428571429,83.7857142857143
"20670","62080","2019",33,32,1,141864.363636364,1285.9696969697,106.757575757576
"20671","62081","2019",3,3,0,141000,1199.66666666667,118
"20672","62082","2019",7,7,0,183621.428571429,1264.28571428571,153.714285714286
"20673","62083","2019",46,46,0,116777.065217391,1304.65217391304,89.5434782608696
"20674","62085","2019",2,2,0,467950,1947.5,232.5
"20675","62086","2019",3,3,0,163510,1543,108.333333333333
"20676","62087","2019",12,12,0,141265.416666667,1523.83333333333,93.0833333333333
"20677","62088","2019",4,4,0,165800,1357.25,122
"20678","62089","2019",7,7,0,280764.285714286,2300.57142857143,119.714285714286
"20679","62090","2019",3,3,0,147200,1800.33333333333,90.3333333333333
"20680","62091","2019",1,1,0,211892,1926,110
"20681","62092","2019",2,2,0,137600,1102.5,122.5
"20682","62093","2019",1,1,0,35000,547,64
"20683","62094","2019",6,6,0,145500,1406.16666666667,128.166666666667
"20684","62095","2019",2,2,0,84000,805.5,124
"20685","62096","2019",5,5,0,82900,708.8,106.6
"20686","62097","2019",12,11,1,169614.583333333,1751.33333333333,99.5
"20687","62099","2019",61,54,7,180867.295081967,1970.93442622951,94.1311475409836
"20688","62100","2019",15,15,0,123645,1460.8,84.8666666666667
"20689","62102","2019",3,3,0,145000,1888.66666666667,93
"20690","62103","2019",1,1,0,25000,676,37
"20691","62104","2019",6,6,0,173628.333333333,2076.83333333333,89
"20692","62105","2019",4,4,0,212750,1827.5,119.25
"20693","62106","2019",1,1,0,144000,1125,128
"20694","62107","2019",4,4,0,213625,1773.5,119
"20695","62108","2019",455,177,278,121651.997802198,2319.14505494506,58.1208791208791
"20696","62109","2019",1,1,0,113000,1215,93
"20697","62111","2019",3,3,0,177866.666666667,1326,150.666666666667
"20698","62112","2019",11,11,0,137400,1336.36363636364,107.454545454545
"20699","62113","2019",5,5,0,164438,1504.8,106.8
"20700","62114","2019",3,3,0,115166.666666667,846,139.333333333333
"20701","62115","2019",7,7,0,144085.714285714,1404.14285714286,106
"20702","62116","2019",3,3,0,203850,1505,135
"20703","62117","2019",12,12,0,131250,1165,117.916666666667
"20704","62118","2019",2,2,0,222350,1872.5,120.5
"20705","62119","2019",372,241,131,113350.177419355,1444.16666666667,80.2043010752688
"20706","62120","2019",2,2,0,118750,1150,114
"20707","62121","2019",1,1,0,239100,2717,88
"20708","62122","2019",8,8,0,111812.5,1088.625,105.625
"20709","62123","2019",7,7,0,136571.428571429,1460.85714285714,85.2857142857143
"20710","62124","2019",2,2,0,194750,1858,108
"20711","62125","2019",6,6,0,170000,1690,101
"20712","62126","2019",106,96,10,122560.867924528,1396.07547169811,89.3490566037736
"20713","62127","2019",5,5,0,288400,2176,116
"20714","62128","2019",39,38,1,130191.538461538,1512.17948717949,87.4358974358974
"20715","62129","2019",1,1,0,204920,1314,156
"20716","62130","2019",11,11,0,115407.909090909,1190.63636363636,106.090909090909
"20717","62131","2019",4,4,0,140750,1318.25,106.75
"20718","62132","2019",56,56,0,164488.892857143,1717.25,95.4821428571429
"20719","62133","2019",69,66,3,108730.101449275,1222.08695652174,91.1739130434783
"20720","62134","2019",2,2,0,123750,1372,97.5
"20721","62135","2019",4,4,0,132875,1049.75,123.25
"20722","62137","2019",1,1,0,110000,797,138
"20723","62138","2019",8,8,0,101000,1134.25,87.875
"20724","62139","2019",69,69,0,125507.550724638,1373.98550724638,92.0724637681159
"20725","62140","2019",6,6,0,158750,1198.83333333333,135.166666666667
"20726","62141","2019",12,12,0,179581.666666667,1570.16666666667,117.166666666667
"20727","62142","2019",3,3,0,118333.333333333,1029.33333333333,111.333333333333
"20728","62143","2019",2,2,0,70500,590,119.5
"20729","62144","2019",5,5,0,151530,1570.2,95.4
"20730","62145","2019",2,2,0,115500,992.5,127
"20731","62146","2019",4,4,0,180487.5,1855,102.5
"20732","62147","2019",4,4,0,117525,1787.75,65.75
"20733","62148","2019",12,12,0,171737.5,1662.33333333333,100.333333333333
"20734","62149","2019",3,3,0,156983.333333333,1337,119.333333333333
"20735","62150","2019",3,3,0,121666.666666667,1421.33333333333,86.6666666666667
"20736","62151","2019",7,7,0,119142.857142857,1273.42857142857,105.285714285714
"20737","62152","2019",4,4,0,173125,1455.75,127.5
"20738","62153","2019",6,6,0,124483.333333333,1050.5,119.666666666667
"20739","62154","2019",8,8,0,100362.5,893.875,114.125
"20740","62155","2019",9,9,0,141888.888888889,1365.55555555556,105
"20741","62156","2019",10,10,0,210886,1933,103.1
"20742","62158","2019",5,5,0,165400,2110.6,81.4
"20743","62160","2019",451,228,223,109433.713968958,1416.59423503326,79.0709534368071
"20744","62161","2019",10,10,0,150800,1256.3,120.1
"20745","62162","2019",4,4,0,137750,1442.25,92.5
"20746","62163","2019",1,1,0,40000,727,55
"20747","62164","2019",12,12,0,136087.5,1274.33333333333,110.75
"20748","62165","2019",1,1,0,60000,923,65
"20749","62166","2019",8,8,0,134499.375,1280.25,105.125
"20750","62167","2019",1,1,0,169710,2496,68
"20751","62168","2019",11,11,0,141000,1261.63636363636,110.272727272727
"20752","62169","2019",6,6,0,183691.666666667,1552.83333333333,122.833333333333
"20753","62170","2019",26,26,0,167218.846153846,1571.53846153846,109.192307692308
"20754","62171","2019",3,3,0,173533.333333333,1551,116.666666666667
"20755","62172","2019",8,8,0,152193.75,1636.625,96.125
"20756","62173","2019",79,78,1,165508.037974684,1626.63291139241,100.164556962025
"20757","62174","2019",13,13,0,181092.307692308,1619.69230769231,114.307692307692
"20758","62175","2019",5,5,0,158400,1514.6,107.6
"20759","62176","2019",10,10,0,213760,1837.3,120.2
"20760","62177","2019",8,8,0,107550,1305.125,90.875
"20761","62178","2019",162,148,14,102541.228395062,1136.9012345679,92.4074074074074
"20762","62179","2019",4,4,0,193000,1888.25,107.5
"20763","62180","2019",3,3,0,154150,1262,126.666666666667
"20764","62181","2019",17,17,0,146991.176470588,1544.88235294118,98.5882352941177
"20765","62182","2019",3,3,0,86433.3333333333,1073.33333333333,76.6666666666667
"20766","62183","2019",4,4,0,104500,1160.5,87.25
"20767","62184","2019",3,3,0,113333.333333333,1547,82.3333333333333
"20768","62186","2019",124,120,4,123830.927419355,1413.54838709677,88.241935483871
"20769","62187","2019",1,1,0,146000,1404,104
"20770","62188","2019",40,40,0,89193.875,1185.9,75.85
"20771","62189","2019",1,1,0,150224,1549,97
"20772","62190","2019",10,10,0,164577.7,1707,95.1
"20773","62191","2019",3,3,0,121033.333333333,1534.33333333333,85.6666666666667
"20774","62192","2019",2,2,0,83925,1162,71.5
"20775","62193","2019",913,725,188,114350.021905805,1402.64293537788,84.750273822563
"20776","62194","2019",32,32,0,107670.46875,1222.09375,91.78125
"20777","62195","2019",20,20,0,173558,1729.95,103.3
"20778","62196","2019",9,9,0,204111.111111111,1943.55555555556,108.333333333333
"20779","62197","2019",18,18,0,143194.444444444,1259.83333333333,115.666666666667
"20780","62199","2019",7,7,0,200244.714285714,1726.57142857143,124.571428571429
"20781","62200","2019",16,15,1,171671.875,1431.8125,128.0625
"20782","62201","2019",176,99,77,115729.238636364,2416.85227272727,51.9147727272727
"20783","62202","2019",7,7,0,100395.714285714,985.857142857143,110
"20784","62203","2019",4,4,0,171100,1407.5,124.25
"20785","62205","2019",10,10,0,230130,1571.7,146.4
"20786","62206","2019",5,5,0,218000,2059.2,104.2
"20787","62207","2019",6,6,0,254166.666666667,1837.83333333333,133.166666666667
"20788","62209","2019",1,1,0,125000,1042,120
"20789","62211","2019",1,1,0,3e+05,1478,203
"20790","62212","2019",4,4,0,124187.5,1143,114.5
"20791","62213","2019",8,8,0,217685,1766.75,125.375
"20792","62214","2019",8,8,0,211250,1843,120.25
"20793","62215","2019",218,211,7,145868.646788991,1558.26146788991,94.7339449541284
"20794","62216","2019",8,8,0,147783.75,1375.5,110.375
"20795","62217","2019",24,23,1,115756.208333333,1301.16666666667,90.8333333333333
"20796","62218","2019",4,4,0,161475,1502,108.25
"20797","62219","2019",5,5,0,85257.2,700,128.4
"20798","62220","2019",8,8,0,114875,1075.375,106.875
"20799","62221","2019",3,3,0,109666.666666667,1208,90.6666666666667
"20800","62222","2019",2,2,0,176000,1762,104
"20801","62223","2019",3,3,0,145400,1386.33333333333,104.333333333333
"20802","62224","2019",45,44,1,120364.444444444,1323.51111111111,97.6666666666667
"20803","62225","2019",11,11,0,191109.090909091,1614.72727272727,124.181818181818
"20804","62227","2019",1,1,0,142000,1154,123
"20805","62228","2019",3,3,0,191000,1742,114.666666666667
"20806","62229","2019",10,10,0,163630,1578.1,103.8
"20807","62230","2019",6,6,0,174350,1428.66666666667,126.833333333333
"20808","62231","2019",3,3,0,161000,1637.33333333333,103.666666666667
"20809","62232","2019",7,7,0,160577.142857143,1426.14285714286,114.857142857143
"20810","62233","2019",15,15,0,180566.666666667,1615.46666666667,112.266666666667
"20811","62234","2019",3,3,0,156466.666666667,1011,152.333333333333
"20812","62235","2019",32,32,0,285255.9375,2254.6875,129.4375
"20813","62236","2019",5,5,0,123000,1291,98.4
"20814","62237","2019",3,3,0,196966.666666667,1585.33333333333,124
"20815","62238","2019",1,1,0,185000,1381,134
"20816","62239","2019",21,17,4,164532.380952381,1829.61904761905,95.0476190476191
"20817","62240","2019",23,23,0,131250.826086957,1281.65217391304,103.608695652174
"20818","62241","2019",4,4,0,78500,1134.75,68
"20819","62242","2019",2,2,0,105500,1006,102.5
"20820","62243","2019",1,1,0,305000,1271,240
"20821","62244","2019",71,67,4,145761.126760563,1651.67605633803,89.5211267605634
"20822","62245","2019",10,10,0,148811.5,1672.1,96
"20823","62247","2019",7,7,0,101857.142857143,1040.85714285714,104.571428571429
"20824","62248","2019",9,9,0,127685.555555556,1382.22222222222,100.777777777778
"20825","62249","2019",96,96,0,139390.34375,1543.73958333333,92.4375
"20826","62250","2019",89,85,4,149791.426966292,1574.68539325843,97.1348314606742
"20827","62251","2019",6,6,0,166316.666666667,1681.33333333333,102.5
"20828","62252","2019",21,21,0,225506.19047619,1789.95238095238,128.52380952381
"20829","62254","2019",4,4,0,152087.5,1324,120.25
"20830","62255","2019",7,7,0,206057.142857143,1487,140.285714285714
"20831","62257","2019",9,9,0,103277.777777778,997.777777777778,104.555555555556
"20832","62258","2019",2,2,0,107500,1263,87
"20833","62259","2019",14,14,0,138021.428571429,1450.78571428571,95.7142857142857
"20834","62260","2019",2,2,0,173158.5,1062,159
"20835","62261","2019",255,115,140,185065.843137255,3036.74117647059,63.6117647058824
"20836","62262","2019",23,23,0,164869.565217391,1697.17391304348,98.0434782608696
"20837","62263","2019",73,69,4,178841.054794521,1929.17808219178,93.4657534246575
"20838","62264","2019",15,15,0,133381.6,1505,93.4
"20839","62265","2019",9,9,0,155405.555555556,1273.11111111111,123.555555555556
"20840","62266","2019",1,1,0,135000,1098,123
"20841","62267","2019",8,8,0,88687.5,910,101
"20842","62268","2019",73,71,2,105237.191780822,1183.13698630137,93.5068493150685
"20843","62269","2019",7,7,0,85914.2857142857,853.285714285714,99.5714285714286
"20844","62270","2019",48,44,4,112519.166666667,1336.70833333333,86.7083333333333
"20845","62271","2019",5,5,0,151380,1424.8,110.6
"20846","62272","2019",3,3,0,142333.333333333,1787.66666666667,80.3333333333333
"20847","62273","2019",9,9,0,213428.333333333,1973.88888888889,114.333333333333
"20848","62274","2019",55,55,0,138879.272727273,1391.4,99.3818181818182
"20849","62275","2019",2,2,0,107500,892.5,116
"20850","62276","2019",73,70,3,151470.068493151,1511.56164383562,101.356164383562
"20851","62277","2019",29,29,0,163045.517241379,1631.37931034483,102.724137931034
"20852","62278","2019",5,5,0,231200,1612.6,134.8
"20853","62279","2019",21,21,0,418884.333333333,2560.42857142857,167.095238095238
"20854","62280","2019",1,1,0,177400,1199,148
"20855","62281","2019",5,5,0,223300,2192.4,108
"20856","62284","2019",22,22,0,155323.954545455,1510.45454545455,108.863636363636
"20857","62285","2019",8,8,0,189805,1219,158.125
"20858","62286","2019",7,7,0,146200,1415.42857142857,108.857142857143
"20859","62288","2019",19,19,0,162379.157894737,1606.36842105263,104.421052631579
"20860","62289","2019",9,9,0,139633.333333333,1532.33333333333,92.2222222222222
"20861","62290","2019",4,4,0,323344.25,2511.75,129.5
"20862","62291","2019",31,27,4,120441.838709677,1381.35483870968,87.5806451612903
"20863","62292","2019",11,11,0,137920.272727273,1509.54545454545,90.5454545454545
"20864","62293","2019",5,5,0,95300,797.6,123
"20865","62295","2019",16,16,0,132835.9375,1370.9375,97.25
"20866","62296","2019",4,4,0,111250,1048.5,107.25
"20867","62297","2019",36,36,0,154389.638888889,1598.77777777778,98.4166666666667
"20868","62298","2019",6,5,1,125500,1281.83333333333,104.833333333333
"20869","62299","2019",2,2,0,120525,1232,94
"20870","62300","2019",27,26,1,161038.148148148,1942.74074074074,87.962962962963
"20871","62301","2019",2,2,0,55250,636,89.5
"20872","62302","2019",4,4,0,118500,1243.75,98.25
"20873","62303","2019",2,2,0,134500,1335.5,101
"20874","62304","2019",3,3,0,124433.333333333,1235.66666666667,99.3333333333333
"20875","62306","2019",8,8,0,117365,1162.375,103.625
"20876","62307","2019",4,4,0,263437.5,2742.75,93.75
"20877","62308","2019",4,4,0,192000,1850,111.5
"20878","62309","2019",30,30,0,137802.966666667,1277.2,109.066666666667
"20879","62310","2019",21,21,0,164532.142857143,1444.95238095238,112.47619047619
"20880","62311","2019",19,19,0,151281.578947368,1725.52631578947,88.8947368421053
"20881","62312","2019",1,1,0,133000,1127,118
"20882","62313","2019",13,13,0,137864.615384615,1151.15384615385,112.461538461538
"20883","62314","2019",4,4,0,156425,1472.75,93.25
"20884","62315","2019",3,3,0,194466.666666667,2012.33333333333,101.666666666667
"20885","62316","2019",3,3,0,122333.333333333,1316,86
"20886","62317","2019",4,4,0,160375,1211.25,137.5
"20887","62318","2019",147,135,12,161625.462585034,1895.48979591837,85.8571428571429
"20888","62319","2019",4,4,0,199068.25,1613.5,125.75
"20889","62320","2019",6,6,0,150125,1636.66666666667,90.1666666666667
"20890","62321","2019",45,45,0,147644.777777778,1562.48888888889,96.4
"20891","62322","2019",2,2,0,46250,427.5,111
"20892","62323","2019",22,22,0,207070.727272727,1834.54545454545,111.181818181818
"20893","62324","2019",7,7,0,187446.428571429,1498,129
"20894","62325","2019",9,9,0,91397.2222222222,857.666666666667,106.777777777778
"20895","62326","2019",2,2,0,133500,1785,76
"20896","62327","2019",6,6,0,108243.333333333,1154.83333333333,98.8333333333333
"20897","62328","2019",9,9,0,112111.111111111,1111.77777777778,102.666666666667
"20898","62329","2019",12,12,0,144939.75,1359.25,104.416666666667
"20899","62330","2019",16,16,0,213050,1974.0625,111.0625
"20900","62331","2019",11,11,0,137781.818181818,1778.36363636364,79.4545454545455
"20901","62332","2019",4,4,0,144494.5,1504.75,91.5
"20902","62333","2019",1,1,0,135000,1350,100
"20903","62334","2019",6,6,0,136375,1444.16666666667,104
"20904","62335","2019",7,7,0,124285.714285714,1131.57142857143,123.714285714286
"20905","62336","2019",7,7,0,90357.1428571429,1223.14285714286,80
"20906","62337","2019",6,6,0,77600,978.666666666667,90.8333333333333
"20907","62338","2019",33,33,0,297061.03030303,2194.09090909091,137.575757575758
"20908","62339","2019",4,4,0,77125,982.5,78.75
"20909","62340","2019",17,17,0,153370.588235294,1379.35294117647,110.176470588235
"20910","62341","2019",7,6,1,152257.142857143,1285.28571428571,125.142857142857
"20911","62343","2019",3,3,0,117333.333333333,971.666666666667,118.666666666667
"20912","62345","2019",1,1,0,56000,475,118
"20913","62346","2019",1,1,0,110000,991,111
"20914","62347","2019",2,2,0,133500,1866.5,73.5
"20915","62348","2019",1,1,0,116000,1055,110
"20916","62349","2019",15,15,0,115920,1457.2,81.2666666666667
"20917","62350","2019",8,8,0,179932.5,1703.375,115.5
"20918","62351","2019",69,67,2,125490.333333333,1396.65217391304,92.2608695652174
"20919","62352","2019",1,1,0,107000,1259,85
"20920","62354","2019",9,9,0,187644.444444444,1604,123.777777777778
"20921","62355","2019",10,10,0,217464.8,1702,125.6
"20922","62356","2019",9,9,0,120815.555555556,1378.55555555556,93
"20923","62357","2019",1,1,0,95000,1357,70
"20924","62358","2019",1,1,0,198000,2106,94
"20925","62359","2019",6,6,0,167500,1660.83333333333,119.5
"20926","62360","2019",8,8,0,179093.75,1969.875,89.625
"20927","62361","2019",24,24,0,69804.1666666667,803.041666666667,89
"20928","62362","2019",1,1,0,140000,1037,135
"20929","62363","2019",4,4,0,127750,1389,91.75
"20930","62364","2019",23,23,0,74682.347826087,844.913043478261,91.304347826087
"20931","62365","2019",8,8,0,93874.875,1031.875,99.875
"20932","62366","2019",4,4,0,154718.75,1432.75,108
"20933","62367","2019",3,3,0,105666.666666667,1198.66666666667,87.6666666666667
"20934","62368","2019",1,1,0,32000,508,63
"20935","62369","2019",6,6,0,236545.833333333,1692.83333333333,140
"20936","62370","2019",1,1,0,105000,847,124
"20937","62371","2019",34,33,1,159136.941176471,1588.32352941176,99.9411764705882
"20938","62372","2019",1,1,0,128000,1280,100
"20939","62373","2019",6,6,0,200833.333333333,1820.16666666667,113
"20940","62374","2019",1,1,0,128000,928,138
"20941","62375","2019",1,1,0,120000,1263,95
"20942","62376","2019",30,30,0,185037.7,1687.16666666667,109.2
"20943","62377","2019",8,8,0,143927.875,1312.125,107.5
"20944","62378","2019",3,3,0,205333.333333333,1824,113
"20945","62379","2019",4,4,0,112175,1653.25,69.25
"20946","62380","2019",5,5,0,204468,2014,112.2
"20947","62381","2019",3,3,0,217333.333333333,1541.33333333333,145.666666666667
"20948","62382","2019",8,8,0,138000,1359.625,114.25
"20949","62383","2019",11,11,0,159550,1556.45454545455,101.272727272727
"20950","62384","2019",12,12,0,186520.833333333,1157.33333333333,160.833333333333
"20951","62385","2019",4,4,0,127225,875.5,147.75
"20952","62386","2019",39,39,0,126515.051282051,1345.33333333333,99.1538461538462
"20953","62387","2019",1,1,0,165000,1179,140
"20954","62388","2019",2,2,0,141025,1313,108.5
"20955","62390","2019",26,26,0,175907.730769231,2133.84615384615,87.4230769230769
"20956","62391","2019",8,8,0,93818.75,1022.125,89.25
"20957","62392","2019",7,7,0,168314.285714286,1600,107.857142857143
"20958","62393","2019",8,8,0,133937.5,1727.5,74.625
"20959","62397","2019",59,58,1,129383.271186441,1507.42372881356,86.7118644067797
"20960","62398","2019",5,5,0,139780,1196.4,114.6
"20961","62399","2019",9,9,0,124444.444444444,1321.11111111111,90.2222222222222
"20962","62400","2019",36,36,0,114567.777777778,1279.38888888889,91.1944444444444
"20963","62401","2019",62,62,0,153451.129032258,1688.48387096774,92.1612903225806
"20964","62402","2019",4,4,0,162525,1993,89.75
"20965","62403","2019",11,11,0,111586.818181818,1240.36363636364,91.5454545454545
"20966","62404","2019",3,3,0,97666.6666666667,1141,84.6666666666667
"20967","62405","2019",6,6,0,166520,1664.83333333333,103.166666666667
"20968","62406","2019",3,3,0,158650,1751.66666666667,94
"20969","62407","2019",11,11,0,133531.818181818,1388.90909090909,97
"20970","62408","2019",9,9,0,197222.222222222,1923.77777777778,112.222222222222
"20971","62409","2019",3,3,0,104000,1297,76.3333333333333
"20972","62410","2019",1,1,0,82500,1086,76
"20973","62412","2019",22,22,0,179067.5,1751.13636363636,105.181818181818
"20974","62413","2019",128,121,7,126201.6875,1387.234375,91.59375
"20975","62414","2019",4,4,0,111875,1098.25,102
"20976","62415","2019",3,3,0,218333.333333333,1890.66666666667,116
"20977","62416","2019",2,2,0,153500,1482.5,108
"20978","62418","2019",5,5,0,181478,1442.6,120.2
"20979","62419","2019",1,1,0,176200,1532,115
"20980","62421","2019",4,4,0,102125,1003.25,102.5
"20981","62422","2019",8,8,0,136087.5,1288.375,106.75
"20982","62423","2019",14,14,0,170364.285714286,1486.21428571429,112.357142857143
"20983","62424","2019",2,2,0,119375,1687.5,81
"20984","62425","2019",1,1,0,185500,1364,136
"20985","62427","2019",304,284,20,118326.519736842,1308.30592105263,92.6644736842105
"20986","62428","2019",4,4,0,175222.5,1535.5,112
"20987","62429","2019",4,4,0,179812.5,1798.75,99.5
"20988","62430","2019",3,3,0,78733.3333333333,1305,58
"20989","62432","2019",4,4,0,107750,965,98.75
"20990","62433","2019",1,1,0,208000,1518,137
"20991","62434","2019",1,1,0,208700,1304,160
"20992","62435","2019",1,1,0,205000,1708,120
"20993","62436","2019",1,1,0,101380,573,177
"20994","62437","2019",4,4,0,101569,1242.75,90
"20995","62438","2019",5,5,0,160800,1404.4,107.8
"20996","62439","2019",6,6,0,165308.166666667,1677,98.6666666666667
"20997","62440","2019",12,12,0,97283.3333333333,791.666666666667,117.916666666667
"20998","62441","2019",4,4,0,104000,1148.25,91
"20999","62442","2019",6,6,0,131300,1385.83333333333,95
"21000","62443","2019",73,73,0,130662.328767123,1313.2602739726,100.452054794521
"21001","62444","2019",8,8,0,303712.5,2845.125,110.875
"21002","62445","2019",11,11,0,148631.818181818,1452.81818181818,95.1818181818182
"21003","62446","2019",5,5,0,145680,1360.8,114.4
"21004","62447","2019",37,29,8,88989.7567567568,1125.62162162162,92.5405405405405
"21005","62448","2019",23,23,0,208400.52173913,2063.13043478261,103.478260869565
"21006","62449","2019",1,1,0,30000,429,70
"21007","62450","2019",2,2,0,106300,812,106
"21008","62451","2019",7,7,0,133285.714285714,1351.42857142857,115.142857142857
"21009","62452","2019",14,14,0,216001.571428571,1764.71428571429,119
"21010","62453","2019",2,2,0,120000,1426,95
"21011","62454","2019",30,30,0,198214.366666667,1731.93333333333,117
"21012","62455","2019",2,2,0,85550,1069.5,80
"21013","62456","2019",7,7,0,148760,1521.71428571429,100
"21014","62457","2019",49,49,0,125297.734693878,1288.16326530612,99.3877551020408
"21015","62458","2019",10,10,0,172655,1762.4,104.4
"21016","62459","2019",2,2,0,87500,861.5,101
"21017","62460","2019",3,3,0,122666.666666667,1491.33333333333,80
"21018","62461","2019",6,6,0,109308.333333333,1291.33333333333,98
"21019","62463","2019",8,8,0,142937.5,1232.5,126.125
"21020","62464","2019",25,25,0,190320,1710.36,112.12
"21021","62465","2019",5,5,0,142300,1433.4,100.8
"21022","62466","2019",1,1,0,180000,2022,89
"21023","62467","2019",2,2,0,117500,1438.5,82
"21024","62468","2019",1,1,0,1e+05,1471,68
"21025","62469","2019",3,3,0,93166.6666666667,879.333333333333,108.333333333333
"21026","62470","2019",1,1,0,78000,772,101
"21027","62471","2019",5,5,0,135500,1133.4,122.2
"21028","62472","2019",4,4,0,212275,1601.5,147
"21029","62473","2019",110,103,7,99883.7909090909,1149.99090909091,88.1363636363636
"21030","62474","2019",11,11,0,176870.454545455,1784.54545454545,101.272727272727
"21031","62475","2019",2,2,0,189350,1453.5,130.5
"21032","62476","2019",14,14,0,161430.071428571,1648.42857142857,106.285714285714
"21033","62477","2019",3,3,0,182466.666666667,1603,115
"21034","62478","2019",8,8,0,147162.5,1498.375,102.75
"21035","62479","2019",18,18,0,148228.555555556,1423.33333333333,106.333333333333
"21036","62480","2019",33,33,0,172005.757575758,1582.66666666667,106.878787878788
"21037","62481","2019",5,5,0,119060,1232.6,96.4
"21038","62483","2019",6,6,0,125833.333333333,1493,83.8333333333333
"21039","62484","2019",7,7,0,114928.571428571,1158.85714285714,102.714285714286
"21040","62485","2019",4,4,0,125500,1226.5,100.75
"21041","62486","2019",13,13,0,118126.923076923,1357,86.8461538461538
"21042","62487","2019",12,12,0,190958.333333333,1650.16666666667,118.75
"21043","62488","2019",4,4,0,200750,1817,107.75
"21044","62489","2019",51,51,0,132961.764705882,1311,102.705882352941
"21045","62490","2019",1,1,0,330000,2200,150
"21046","62491","2019",76,74,2,218368.421052632,1971.65789473684,111.973684210526
"21047","62492","2019",1,1,0,75000,750,100
"21048","62493","2019",2,2,0,118175,976,130
"21049","62495","2019",1,1,0,278400,1609,173
"21050","62496","2019",9,9,0,209608.333333333,2155.22222222222,108
"21051","62497","2019",64,64,0,151344.09375,1697.53125,91.59375
"21052","62498","2019",272,196,76,112755.676470588,1472.58088235294,83.3639705882353
"21053","62499","2019",3,3,0,105333.333333333,1609.66666666667,77.3333333333333
"21054","62500","2019",4,4,0,184875,1471,122.25
"21055","62501","2019",4,4,0,207750,1558.25,135.5
"21056","62502","2019",50,50,0,195824.54,1841.32,111.24
"21057","62503","2019",4,4,0,218750,4484.25,63.5
"21058","62504","2019",1,1,0,217000,1391,156
"21059","62505","2019",9,9,0,156032.888888889,1634,97.6666666666667
"21060","62506","2019",13,13,0,142681,1450.92307692308,106.846153846154
"21061","62507","2019",5,5,0,176780,1389.2,128.8
"21062","62508","2019",1,1,0,105000,705,149
"21063","62509","2019",7,7,0,157610,1199.57142857143,135.428571428571
"21064","62510","2019",262,243,19,119332.328244275,1314.39312977099,91.618320610687
"21065","62511","2019",3,3,0,189216.666666667,1893.33333333333,109
"21066","62512","2019",10,10,0,132960,1190.2,111.6
"21067","62513","2019",3,3,0,163166.666666667,1309.66666666667,121.666666666667
"21068","62514","2019",4,4,0,109825,1141,96.25
"21069","62515","2019",8,8,0,105512.5,1214.625,89.125
"21070","62516","2019",120,118,2,103001.616666667,1112.225,90.7333333333333
"21071","62517","2019",3,3,0,163000,1441.33333333333,112
"21072","62518","2019",1,1,0,70000,583,120
"21073","62519","2019",6,6,0,98032.5,1053,101.5
"21074","62520","2019",18,18,0,163379.944444444,1636.22222222222,101.722222222222
"21075","62521","2019",3,3,0,69083.3333333333,1142.33333333333,58.6666666666667
"21076","62522","2019",3,3,0,130000,1308.66666666667,101.666666666667
"21077","62523","2019",52,52,0,121078.788461538,1441.09615384615,86.3846153846154
"21078","62524","2019",17,16,1,129585.058823529,1375.17647058824,100.705882352941
"21079","62525","2019",110,98,12,150999.818181818,1645.24545454545,93.3
"21080","62526","2019",2,2,0,260417,2054.5,132.5
"21081","62527","2019",8,8,0,155228,1482.25,111.875
"21082","62528","2019",56,56,0,156871.214285714,1449.41071428571,106.607142857143
"21083","62529","2019",22,22,0,265940.909090909,2100.86363636364,130.909090909091
"21084","62530","2019",7,7,0,171008.571428571,1510,132
"21085","62531","2019",11,11,0,135891.363636364,1487.54545454545,93.5454545454545
"21086","62532","2019",11,11,0,99350,1174.63636363636,82.0909090909091
"21087","62533","2019",2,2,0,119035,936,132
"21088","62534","2019",33,33,0,126716.666666667,1302.9696969697,98.8181818181818
"21089","62535","2019",1,1,0,160000,2162,74
"21090","62536","2019",5,5,0,194480,1687.2,118
"21091","62537","2019",2,2,0,90750,1300.5,70.5
"21092","62538","2019",2,2,0,111000,1579,75
"21093","62539","2019",3,3,0,131643.666666667,952,146.666666666667
"21094","62540","2019",15,15,0,166180,1572.6,106.133333333333
"21095","62541","2019",2,2,0,118500,1163.5,103
"21096","62542","2019",5,5,0,158940,1237.8,136
"21097","62543","2019",12,12,0,144995.833333333,1479.5,95.9166666666667
"21098","62544","2019",1,1,0,180000,1161,155
"21099","62546","2019",5,5,0,277381.8,2231.6,123
"21100","62547","2019",2,2,0,160500,1430.5,103
"21101","62548","2019",118,114,4,175677.381355932,1761.45762711864,102.093220338983
"21102","62549","2019",15,15,0,112116.666666667,1202.13333333333,101
"21103","62550","2019",9,9,0,100407.111111111,1140.33333333333,87.7777777777778
"21104","62551","2019",5,5,0,108400,1034.8,112
"21105","62552","2019",8,8,0,113500,1282.75,94.625
"21106","62553","2019",2,2,0,92000,1189,79
"21107","62555","2019",32,32,0,101290.5625,1153.34375,88.40625
"21108","62556","2019",5,5,0,124660,1335.4,94.4
"21109","62557","2019",31,31,0,195997.032258065,1712.51612903226,115.838709677419
"21110","62558","2019",1,1,0,60000,619,97
"21111","62559","2019",11,10,1,153827.272727273,1347.63636363636,116.363636363636
"21112","62560","2019",69,67,2,138967.942028986,1582.65217391304,92.1159420289855
"21113","62561","2019",1,1,0,80000,851,94
"21114","62562","2019",2,2,0,116500,1172,99.5
"21115","62563","2019",54,54,0,141509.055555556,1463.77777777778,101.333333333333
"21116","62564","2019",5,5,0,163440,1273.8,128.2
"21117","62565","2019",1,1,0,120000,1017,118
"21118","62566","2019",8,8,0,177825,1867.375,100.375
"21119","62567","2019",6,6,0,170683.333333333,1461.83333333333,117.5
"21120","62568","2019",5,5,0,229698,2194.6,107.4
"21121","62569","2019",8,8,0,172125,1454.25,134.5
"21122","62570","2019",97,97,0,121505.257731959,1414.23711340206,85.8969072164948
"21123","62571","2019",236,130,106,161918.597457627,2760.35593220339,63.6101694915254
"21124","62572","2019",9,9,0,93111.1111111111,1004.88888888889,95.7777777777778
"21125","62573","2019",48,45,3,146228.541666667,1671.85416666667,88.2291666666667
"21126","62574","2019",4,4,0,113250,1208.5,101
"21127","62579","2019",5,5,0,109850,926.8,113.2
"21128","62580","2019",5,5,0,125700,1278.2,98.4
"21129","62581","2019",3,3,0,106166.666666667,1027.66666666667,108
"21130","62582","2019",14,14,0,194982.857142857,1502.85714285714,133.571428571429
"21131","62583","2019",13,13,0,98061.5384615385,1042.84615384615,99.6153846153846
"21132","62584","2019",14,14,0,168383.571428571,1879.57142857143,95.5714285714286
"21133","62585","2019",10,10,0,207400,2268.2,107.4
"21134","62586","2019",6,6,0,261213.166666667,1541.83333333333,171
"21135","62587","2019",75,68,7,117046.906666667,1336.48,86.4533333333333
"21136","62588","2019",38,31,7,196605.263157895,2236.97368421053,93.1578947368421
"21137","62589","2019",11,10,1,188338.181818182,1801.18181818182,112.090909090909
"21138","62590","2019",3,3,0,307735,4186.66666666667,105.666666666667
"21139","62591","2019",3,3,0,126500,1126,110
"21140","62592","2019",6,6,0,141816.666666667,1372.16666666667,106.5
"21141","62593","2019",1,1,0,170000,1006,169
"21142","62594","2019",8,8,0,101453.125,1099.875,85.125
"21143","62595","2019",7,7,0,161921.428571429,1567.28571428571,109.714285714286
"21144","62597","2019",1,1,0,195000,1741,112
"21145","62598","2019",8,8,0,121975,1073.5,105
"21146","62599","2019",1,1,0,203600,2994,68
"21147","62600","2019",1,1,0,166600,1851,90
"21148","62601","2019",2,2,0,122575,1189.5,97.5
"21149","62602","2019",5,5,0,144600,1250,111.8
"21150","62603","2019",15,15,0,130371,1525.66666666667,88.5333333333333
"21151","62604","2019",202,90,112,279450.202970297,3418.20297029703,87.3168316831683
"21152","62606","2019",11,11,0,227363.636363636,1903.90909090909,122.090909090909
"21153","62607","2019",1,1,0,68000,553,123
"21154","62608","2019",3,3,0,82500,821.333333333333,117
"21155","62609","2019",23,23,0,211199.260869565,1967.5652173913,106
"21156","62610","2019",12,12,0,113750,1909.83333333333,82.3333333333333
"21157","62611","2019",8,8,0,185368.75,1547.125,119.25
"21158","62612","2019",5,5,0,171221,1618.8,105.2
"21159","62613","2019",9,9,0,109601.111111111,1110,99.1111111111111
"21160","62614","2019",5,5,0,148000,1406.2,112.2
"21161","62615","2019",2,2,0,270000,2037.5,131
"21162","62617","2019",137,131,6,127600.01459854,1395.51094890511,93.0948905109489
"21163","62618","2019",12,12,0,165120.833333333,1663,105.5
"21164","62620","2019",13,13,0,135573.846153846,1282.53846153846,111.538461538462
"21165","62621","2019",14,14,0,174210.714285714,1689.85714285714,105.857142857143
"21166","62622","2019",3,3,0,124666.666666667,1207.66666666667,111.333333333333
"21167","62623","2019",4,4,0,196350,1756.75,106.5
"21168","62624","2019",46,45,1,144851.695652174,1555.04347826087,94.195652173913
"21169","62625","2019",1,1,0,2e+05,1818,110
"21170","62626","2019",13,13,0,162453.846153846,1687.30769230769,97.3846153846154
"21171","62627","2019",10,10,0,245409.9,1827.7,138.9
"21172","62628","2019",53,52,1,125417.132075472,1365.50943396226,93.6603773584906
"21173","62629","2019",2,2,0,205750,1867.5,117
"21174","62630","2019",4,4,0,271166.5,1512.75,183
"21175","62631","2019",6,6,0,108000,922.5,125.5
"21176","62632","2019",2,2,0,60000,1043.5,62.5
"21177","62633","2019",5,5,0,97000,1171.2,99
"21178","62634","2019",12,12,0,175658.333333333,1517.41666666667,116.666666666667
"21179","62635","2019",3,3,0,106666.666666667,1105,94.6666666666667
"21180","62636","2019",3,3,0,229666.666666667,2012,118
"21181","62637","2019",85,77,8,145377.835294118,1628.23529411765,91.0352941176471
"21182","62638","2019",15,15,0,107396.666666667,1141.26666666667,97.7333333333333
"21183","62639","2019",3,3,0,143193.333333333,2105,84.6666666666667
"21184","62640","2019",6,6,0,86500,903.833333333333,93.3333333333333
"21185","62641","2019",5,5,0,93900,876.4,105.6
"21186","62642","2019",4,4,0,163250,1326.75,132.5
"21187","62643","2019",128,121,7,126750.46875,1380.453125,93.2109375
"21188","62644","2019",8,8,0,122088.875,1210.25,97.125
"21189","62645","2019",72,72,0,166554.625,1659.73611111111,105.083333333333
"21190","62646","2019",7,7,0,130257.142857143,1473.42857142857,88.7142857142857
"21191","62647","2019",5,5,0,183000,1429.4,132.8
"21192","62648","2019",6,6,0,148833.333333333,1336.66666666667,118.166666666667
"21193","62649","2019",7,7,0,90882.1428571429,1056,91.2857142857143
"21194","62650","2019",8,8,0,155436.25,1327.375,116.75
"21195","62651","2019",5,5,0,159800,1417.8,113.2
"21196","62652","2019",27,27,0,114625.925925926,1163.77777777778,100.259259259259
"21197","62653","2019",3,3,0,295385.666666667,1989,155.333333333333
"21198","62654","2019",7,7,0,182385.714285714,1695.71428571429,117.142857142857
"21199","62655","2019",3,3,0,181333.333333333,1853,104.333333333333
"21200","62656","2019",12,12,0,159933.333333333,1456.75,111.25
"21201","62657","2019",1,1,0,189770,1356,140
"21202","62658","2019",1,1,0,177000,2058,86
"21203","62659","2019",2,2,0,121500,1198.5,103.5
"21204","62660","2019",5,5,0,158220,1372,117
"21205","62661","2019",3,3,0,129333.333333333,1219,113
"21206","62662","2019",8,8,0,120783.75,1504,78.5
"21207","62663","2019",5,5,0,123900,1281.2,103
"21208","62664","2019",4,4,0,130075,1110.25,114.25
"21209","62665","2019",3,3,0,83333.3333333333,1229,69.6666666666667
"21210","62666","2019",37,37,0,127781.621621622,1484,86.8648648648649
"21211","62667","2019",112,85,27,118011.723214286,1366.16071428571,89.125
"21212","62668","2019",2,2,0,111500,1014,109.5
"21213","62669","2019",3,3,0,122000,1090,105.666666666667
"21214","62670","2019",2,2,0,140000,1203.5,112.5
"21215","62671","2019",2,2,0,89500,1059.5,90.5
"21216","62672","2019",5,5,0,94800,1002.6,97.2
"21217","62673","2019",5,5,0,142644,1306,116.6
"21218","62674","2019",5,5,0,113800,1286.4,87.4
"21219","62675","2019",3,3,0,118222.333333333,1041.66666666667,112
"21220","62676","2019",5,5,0,168888,1647.4,101.6
"21221","62677","2019",3,3,0,141220,1464.66666666667,102.333333333333
"21222","62678","2019",6,6,0,153659,1371.66666666667,115.5
"21223","62679","2019",4,4,0,131875,1146.5,111
"21224","62680","2019",6,6,0,188166.666666667,1597.83333333333,118.333333333333
"21225","62681","2019",6,6,0,227065,2135,108.166666666667
"21226","62683","2019",5,5,0,87000,898.8,95.8
"21227","62684","2019",30,30,0,135074.5,1451.33333333333,93.6333333333333
"21228","62685","2019",4,4,0,132962.5,1156.5,116
"21229","62686","2019",1,1,0,427170,1951,219
"21230","62688","2019",51,50,1,159965.254901961,1921.1568627451,84.1372549019608
"21231","62689","2019",1,1,0,206500,1291,160
"21232","62690","2019",5,5,0,80800,922.8,103.6
"21233","62691","2019",9,9,0,146133.333333333,1430.66666666667,101.777777777778
"21234","62692","2019",1,1,0,158300,1666,95
"21235","62693","2019",13,13,0,189093.461538462,1514.07692307692,124.538461538462
"21236","62694","2019",3,3,0,89000,1246.66666666667,76.3333333333333
"21237","62695","2019",1,1,0,125000,1136,110
"21238","62696","2019",1,1,0,232000,2109,110
"21239","62697","2019",3,3,0,176000,1945.66666666667,98.3333333333333
"21240","62698","2019",3,3,0,260466.666666667,1643,161
"21241","62699","2019",12,12,0,181795.833333333,1844.16666666667,98.25
"21242","62700","2019",3,3,0,91666.6666666667,984,94
"21243","62701","2019",4,4,0,159017.5,1129.5,137
"21244","62702","2019",2,2,0,111400,1285.5,88
"21245","62703","2019",5,5,0,170700,1598.4,113.6
"21246","62704","2019",8,8,0,139412.5,1276.875,108.25
"21247","62705","2019",20,18,2,184805.55,1874.9,103.8
"21248","62706","2019",20,20,0,222142.5,2028.7,114.25
"21249","62708","2019",1,1,0,60000,690,87
"21250","62709","2019",1,1,0,135000,1646,82
"21251","62710","2019",1,1,0,156000,1061,147
"21252","62711","2019",38,38,0,134582.263157895,1439.18421052632,97.4736842105263
"21253","62712","2019",10,10,0,171604,1570.6,114.1
"21254","62713","2019",7,7,0,167714.285714286,1522,122.142857142857
"21255","62714","2019",13,13,0,232238.461538462,2097.61538461538,113.769230769231
"21256","62715","2019",3,3,0,129815,1038.66666666667,136.333333333333
"21257","62716","2019",6,6,0,169235,1440.83333333333,114
"21258","62717","2019",6,6,0,134800,1051.33333333333,132.166666666667
"21259","62718","2019",16,16,0,161886.25,1681.0625,98.0625
"21260","62719","2019",5,5,0,137900,1582.4,96
"21261","62721","2019",11,11,0,178222.727272727,1621.63636363636,113.363636363636
"21262","62722","2019",2,2,0,95000,791.5,120
"21263","62723","2019",5,5,0,140200,1472.8,94.4
"21264","62724","2019",70,70,0,130911.242857143,1481.72857142857,89.3285714285714
"21265","62725","2019",2,2,0,155000,1274,132.5
"21266","62726","2019",1,1,0,153000,1987,77
"21267","62727","2019",15,15,0,140367.533333333,1416,100.4
"21268","62728","2019",6,6,0,136750,1188.16666666667,122.666666666667
"21269","62729","2019",4,4,0,118118.75,989,131.25
"21270","62730","2019",25,25,0,132458,1358.04,100.76
"21271","62731","2019",1,1,0,51000,729,70
"21272","62732","2019",1,1,0,177000,1321,134
"21273","62733","2019",4,4,0,145625,1315.5,115.25
"21274","62734","2019",9,9,0,151611.111111111,1531.66666666667,101.222222222222
"21275","62735","2019",26,26,0,156504.923076923,1635.19230769231,97.3461538461538
"21276","62736","2019",53,52,1,187135.716981132,1847.7358490566,104.943396226415
"21277","62737","2019",56,54,2,125360.892857143,1417.46428571429,89.25
"21278","62738","2019",4,4,0,125750,1117,114.5
"21279","62739","2019",5,5,0,115480,1275.4,94.6
"21280","62740","2019",2,2,0,90000,774.5,118.5
"21281","62741","2019",1,1,0,105000,1050,100
"21282","62742","2019",7,7,0,304928.571428571,2332.57142857143,137.571428571429
"21283","62744","2019",59,49,10,221583.813559322,2116.62711864407,110.559322033898
"21284","62745","2019",8,8,0,125562.5,1250.625,100.125
"21285","62746","2019",66,66,0,154090.348484848,1656.19696969697,94.8636363636364
"21286","62747","2019",9,9,0,192477.777777778,1524.11111111111,124.555555555556
"21287","62748","2019",22,22,0,159127.727272727,1591.54545454545,101.545454545455
"21288","62749","2019",5,5,0,147200,1211.4,119.2
"21289","62750","2019",10,10,0,114130,1230.7,96.4
"21290","62751","2019",9,9,0,169160.666666667,1657.88888888889,99.1111111111111
"21291","62752","2019",21,21,0,315373.80952381,2165.09523809524,150.142857142857
"21292","62753","2019",86,65,21,148939.825581395,1769.90697674419,87.2093023255814
"21293","62754","2019",4,4,0,91000,883.25,105.5
"21294","62755","2019",52,50,2,157977.557692308,1616.07692307692,96.8653846153846
"21295","62756","2019",17,17,0,171062.941176471,1620.64705882353,110.588235294118
"21296","62757","2019",62,55,7,155585.887096774,1673.01612903226,94.8709677419355
"21297","62758","2019",141,104,37,148191.191489362,1694.30496453901,88.4326241134752
"21298","62759","2019",7,7,0,172166.142857143,1243,140
"21299","62760","2019",5,5,0,119600,1155.4,110.4
"21300","62761","2019",1,1,0,195100,1894,103
"21301","62762","2019",1,1,0,143000,1986,72
"21302","62763","2019",7,7,0,165642.857142857,1475.42857142857,102.857142857143
"21303","62764","2019",51,50,1,143326.960784314,1510.09803921569,94.9803921568627
"21304","62765","2019",197,123,74,121052.324873096,1448.5076142132,87.4619289340101
"21305","62766","2019",6,6,0,126833.333333333,1733.66666666667,74.8333333333333
"21306","62767","2019",50,45,5,93939,1011.86,98.46
"21307","62768","2019",4,4,0,164000,1226.5,137.25
"21308","62769","2019",10,10,0,216817,2006,110.1
"21309","62770","2019",34,33,1,128902.352941176,1423.47058823529,96.1764705882353
"21310","62771","2019",51,49,2,109650.490196078,1332.27450980392,85.5294117647059
"21311","62772","2019",6,6,0,140531.666666667,1691.16666666667,83.1666666666667
"21312","62773","2019",60,60,0,142766.133333333,1598.66666666667,92.3666666666667
"21313","62774","2019",53,45,8,202847.301886792,2028.84905660377,102.094339622642
"21314","62775","2019",1,1,0,1e+05,781,128
"21315","62776","2019",1,1,0,43000,2048,21
"21316","62777","2019",3,3,0,121986.666666667,1424,95
"21317","62779","2019",5,5,0,90434.6,1135.2,82.4
"21318","62780","2019",5,5,0,107630,1084,104
"21319","62781","2019",3,3,0,137916.666666667,1363.33333333333,93
"21320","62782","2019",1,1,0,147000,2450,60
"21321","62783","2019",4,4,0,136750,1688.75,80.75
"21322","62784","2019",9,9,0,123450,1264.22222222222,98.3333333333333
"21323","62785","2019",11,8,3,154636.363636364,1388.27272727273,113.909090909091
"21324","62786","2019",3,3,0,125933.333333333,1491.66666666667,83
"21325","62787","2019",4,4,0,104750,1089.75,102.25
"21326","62788","2019",4,4,0,154875,1723.5,92
"21327","62789","2019",5,5,0,158700,1859.2,87.6
"21328","62790","2019",2,2,0,132940,943,159.5
"21329","62791","2019",2,2,0,128500,1665.5,76
"21330","62792","2019",18,18,0,127230.555555556,1725.55555555556,76.1666666666667
"21331","62793","2019",10,10,0,187250,1683.2,109.8
"21332","62794","2019",13,13,0,98950,1097.84615384615,91.4615384615385
"21333","62795","2019",1,1,0,68465,1292,53
"21334","62796","2019",6,6,0,175350,1695.16666666667,109.333333333333
"21335","62797","2019",3,3,0,149000,1277.33333333333,116.333333333333
"21336","62798","2019",1,1,0,173000,1573,110
"21337","62799","2019",8,8,0,213562.5,1762.25,122.5
"21338","62800","2019",4,4,0,85287.5,702.25,132
"21339","62801","2019",28,26,2,175185.535714286,1849.64285714286,95.6785714285714
"21340","62802","2019",1,1,0,15000,455,33
"21341","62803","2019",1,1,0,120000,1379,87
"21342","62804","2019",4,4,0,109775,1174.5,100.5
"21343","62805","2019",1,1,0,48000,762,63
"21344","62806","2019",2,2,0,360500,2258.5,161
"21345","62808","2019",6,6,0,127083.333333333,1019.5,124.5
"21346","62809","2019",1,1,0,167000,988,169
"21347","62810","2019",13,13,0,231550,1832.92307692308,126.692307692308
"21348","62811","2019",9,9,0,167386.777777778,1405.66666666667,119
"21349","62812","2019",10,10,0,138510,1172.5,117.6
"21350","62813","2019",6,6,0,173091.666666667,1706.83333333333,103.166666666667
"21351","62814","2019",1,1,0,159700,939,170
"21352","62815","2019",2,2,0,111000,1526.5,83
"21353","62816","2019",1,1,0,227800,2170,105
"21354","62817","2019",18,16,2,153633.722222222,1580,104.888888888889
"21355","62818","2019",1,1,0,91500,622,147
"21356","62819","2019",14,14,0,158814.285714286,1737.14285714286,103
"21357","62820","2019",4,4,0,158250,1483.25,114.75
"21358","62821","2019",2,2,0,120725,1063.5,163.5
"21359","62822","2019",2,2,0,87564,1103,82
"21360","62823","2019",2,2,0,75000,891,95
"21361","62824","2019",3,3,0,99916.6666666667,1233.66666666667,84.3333333333333
"21362","62825","2019",10,10,0,169304,1717.9,110.1
"21363","62826","2019",507,143,364,382942.75739645,5637.13017751479,69.4063116370809
"21364","62827","2019",14,14,0,146707.142857143,1274,110
"21365","62828","2019",3,3,0,70266.6666666667,998.333333333333,73.3333333333333
"21366","62829","2019",7,7,0,117428.571428571,1226.42857142857,105.142857142857
"21367","62830","2019",6,6,0,144716.666666667,1020.83333333333,130
"21368","62831","2019",1,1,0,126900,628,202
"21369","62832","2019",7,7,0,190205.571428571,1602.71428571429,116.428571428571
"21370","62833","2019",1,1,0,28000,700,40
"21371","62834","2019",1,1,0,140000,1522,92
"21372","62835","2019",4,4,0,183500,1969.5,99.25
"21373","62836","2019",20,20,0,206570.5,1682.15,122.9
"21374","62837","2019",5,5,0,154086.2,1482.2,103.8
"21375","62838","2019",1,1,0,88000,1257,70
"21376","62839","2019",13,13,0,120563.076923077,994.461538461538,122.461538461538
"21377","62840","2019",1,1,0,55000,714,77
"21378","62841","2019",25,25,0,125694,1396.64,90.92
"21379","62842","2019",82,81,1,163408.865853659,1716.67073170732,96.390243902439
"21380","62843","2019",4,4,0,99000,784.5,130.5
"21381","62844","2019",3,3,0,132166.666666667,1341.66666666667,101.333333333333
"21382","62845","2019",2,2,0,193000,2217,87.5
"21383","62846","2019",44,43,1,150008.636363636,1492.29545454545,104.295454545455
"21384","62847","2019",25,25,0,163242,1693.68,98.48
"21385","62848","2019",30,28,2,140439.2,1619.83333333333,92.0666666666667
"21386","62849","2019",26,24,2,179375.461538462,1967.84615384615,91.5384615384615
"21387","62850","2019",7,7,0,134635.714285714,1006.85714285714,134.857142857143
"21388","62851","2019",8,8,0,179937.5,1550.75,115.625
"21389","62852","2019",16,16,0,165134.375,1624.25,104.5
"21390","62853","2019",4,4,0,92625,1045.75,86.75
"21391","62854","2019",6,6,0,166550,1555.33333333333,106.833333333333
"21392","62856","2019",2,2,0,177500,1131,151.5
"21393","62858","2019",2,2,0,123200,1288.5,97.5
"21394","62859","2019",2,2,0,84750,747,125
"21395","62860","2019",3,3,0,131000,1012.66666666667,131.666666666667
"21396","62861","2019",58,57,1,172632.068965517,1671.51724137931,103.741379310345
"21397","62862","2019",2,2,0,90000,1012.5,74.5
"21398","62863","2019",5,5,0,192480,1349.2,145.2
"21399","62864","2019",9,9,0,169511.555555556,1314.77777777778,132.777777777778
"21400","62865","2019",40,40,0,168518.875,1668.925,102.1
"21401","62866","2019",6,6,0,138500,1475,93.1666666666667
"21402","62867","2019",1,1,0,465000,1890,246
"21403","62868","2019",5,5,0,202500,1531.8,138
"21404","62869","2019",7,7,0,200909.285714286,2055.71428571429,105
"21405","62870","2019",15,15,0,216814.666666667,1824.66666666667,123.333333333333
"21406","62871","2019",5,5,0,175388,1242.2,140.8
"21407","62872","2019",2,2,0,114000,1226,116
"21408","62873","2019",4,4,0,153612.5,1450.75,102.25
"21409","62874","2019",11,11,0,145063.636363636,1310.09090909091,106.454545454545
"21410","62875","2019",12,12,0,153844.166666667,1352.41666666667,123.666666666667
"21411","62876","2019",3,3,0,177133.333333333,1428.66666666667,133.333333333333
"21412","62877","2019",1,1,0,73500,980,75
"21413","62878","2019",7,7,0,200007.142857143,1474.14285714286,133.142857142857
"21414","62880","2019",2,2,0,156000,1185,129
"21415","62881","2019",3,3,0,109666.666666667,591.666666666667,187.666666666667
"21416","62882","2019",8,8,0,114437.5,1356.625,84.875
"21417","62883","2019",1,1,0,160978,1643,98
"21418","62885","2019",2,2,0,87500,1061.5,78.5
"21419","62886","2019",4,4,0,132025,1064.5,139
"21420","62888","2019",1,1,0,80000,769,104
"21421","62889","2019",9,9,0,213152.444444444,2131.11111111111,111.444444444444
"21422","62890","2019",3,3,0,115666.666666667,967,121.666666666667
"21423","62891","2019",4,4,0,92875,1133.75,88
"21424","62892","2019",4,3,1,143000.5,1572.5,86
"21425","62893","2019",185,89,96,242980.540540541,3399.55675675676,79.2324324324324
"21426","62894","2019",40,40,0,192183.125,1988.05,96.7
"21427","62895","2019",94,90,4,128898.840425532,1500.64893617021,88.8723404255319
"21428","62896","2019",3,3,0,187133.333333333,1956.33333333333,99.6666666666667
"21429","62897","2019",2,2,0,72250,1044,69
"21430","62898","2019",2,2,0,745000,4026,159.5
"21431","62899","2019",41,28,13,286483.609756098,3878.19512195122,85.8536585365854
"21432","62900","2019",6,6,0,131658.333333333,1210.83333333333,99.5
"21433","62901","2019",10,10,0,153285,1461,109
"21434","62902","2019",35,35,0,125135.142857143,1329.91428571429,94.4857142857143
"21435","62903","2019",4,4,0,88750,918,91.5
"21436","62904","2019",3,3,0,145666.666666667,1297.33333333333,113.666666666667
"21437","62905","2019",14,14,0,178999.071428571,1482.57142857143,122.714285714286
"21438","62906","2019",13,13,0,176882,1581.38461538462,116.692307692308
"21439","62907","2019",53,52,1,140918.471698113,1554.58490566038,91.3584905660377
"21440","62908","2019",21,21,0,208011.904761905,1943,112.809523809524
"21441","62909","2019",5,5,0,98440,1095.8,95.2
"21442","63001","2019",23,23,0,144519.782608696,1404.04347826087,108.260869565217
"21443","63003","2019",72,62,10,102443.958333333,1137.52777777778,95.6388888888889
"21444","63004","2019",18,17,1,96693.3333333333,1036.66666666667,93.1111111111111
"21445","63005","2019",2,2,0,147150,1227,110
"21446","63007","2019",2,2,0,72500,937,78
"21447","63008","2019",7,7,0,84571.4285714286,786.714285714286,127.285714285714
"21448","63009","2019",8,8,0,81868.75,851.375,97.25
"21449","63010","2019",23,22,1,79617.7826086956,798,102.782608695652
"21450","63011","2019",1,1,0,50000,431,116
"21451","63012","2019",6,6,0,153041.166666667,1149.16666666667,133
"21452","63013","2019",16,16,0,191073.75,2038.6875,100.375
"21453","63014","2019",98,62,36,184946.867346939,2300.65306122449,80.5816326530612
"21454","63016","2019",9,9,0,95040,768.111111111111,122.111111111111
"21455","63017","2019",2,2,0,127000,1220.5,108.5
"21456","63019","2019",42,35,7,154952.761904762,1854,87.6666666666667
"21457","63020","2019",2,2,0,138300,1136.5,114.5
"21458","63021","2019",7,7,0,166764.285714286,1259.71428571429,135.428571428571
"21459","63022","2019",37,37,0,92343.7837837838,1058.40540540541,87.8918918918919
"21460","63023","2019",5,5,0,71240,1038.2,73
"21461","63024","2019",3,3,0,126400,1104.66666666667,106
"21462","63025","2019",2,2,0,145000,1312.5,110.5
"21463","63026","2019",22,22,0,208969.318181818,2199.40909090909,116.636363636364
"21464","63027","2019",2,2,0,118750,952,141.5
"21465","63028","2019",6,6,0,57450.6666666667,1067,55.5
"21466","63029","2019",3,3,0,111466.666666667,1126,102.333333333333
"21467","63030","2019",6,6,0,195833.333333333,1697.16666666667,120.833333333333
"21468","63031","2019",2,2,0,102000,1327.5,76
"21469","63032","2019",195,81,114,164588.194871795,2030,79.5794871794872
"21470","63033","2019",3,3,0,140200,1257.66666666667,121
"21471","63034","2019",13,13,0,133590,1575,88.2307692307692
"21472","63035","2019",7,6,1,186060,1904.14285714286,96.2857142857143
"21473","63036","2019",2,2,0,128100,1464.5,87.5
"21474","63037","2019",11,11,0,96840.9090909091,1018.27272727273,106.727272727273
"21475","63038","2019",107,19,88,97245.9158878505,2207.73831775701,46.7570093457944
"21476","63039","2019",8,8,0,53276.25,610.75,94.25
"21477","63040","2019",49,44,5,174429.142857143,1611.22448979592,106.224489795918
"21478","63041","2019",6,6,0,98066.6666666667,679.666666666667,144
"21479","63042","2019",38,34,4,205021.842105263,2200.44736842105,90
"21480","63043","2019",6,6,0,167821.666666667,1298.83333333333,138.166666666667
"21481","63044","2019",4,4,0,189950,1299.5,147
"21482","63045","2019",8,8,0,109956.75,1147.625,103.875
"21483","63046","2019",1,1,0,62500,1116,56
"21484","63047","2019",107,29,78,73803.9813084112,1226.3738317757,69.9906542056075
"21485","63048","2019",15,14,1,92476.8,1038.93333333333,90.8
"21486","63049","2019",5,5,0,128940,1388.4,97
"21487","63050","2019",57,57,0,105770.263157895,1167.42105263158,94.1052631578947
"21488","63051","2019",4,4,0,183100,1363.75,139
"21489","63052","2019",9,9,0,115083.333333333,1177.11111111111,92.3333333333333
"21490","63053","2019",3,3,0,93500,1003.33333333333,93.3333333333333
"21491","63054","2019",8,8,0,137131.25,1677.875,81
"21492","63055","2019",9,8,1,118740,1157.66666666667,97.2222222222222
"21493","63056","2019",5,5,0,61596,791.8,74
"21494","63057","2019",6,6,0,72203.3333333333,914.166666666667,80
"21495","63058","2019",8,8,0,182718.75,1628.875,112.75
"21496","63059","2019",3,3,0,151466.666666667,1581.66666666667,92.6666666666667
"21497","63060","2019",2,2,0,85250,861.5,93.5
"21498","63061","2019",4,4,0,208712.5,1472,146.25
"21499","63062","2019",1,1,0,149000,1355,110
"21500","63063","2019",103,90,13,209305.184466019,2091.12621359223,102.21359223301
"21501","63065","2019",3,3,0,139250,772.666666666667,171.333333333333
"21502","63066","2019",20,20,0,76802,891.55,88.6
"21503","63067","2019",1,1,0,170000,1069,159
"21504","63069","2019",56,46,10,192069.285714286,2048.82142857143,94.7321428571429
"21505","63070","2019",72,64,8,256833.847222222,2472.56944444444,101.958333333333
"21506","63071","2019",6,6,0,176112.5,1595.33333333333,110.833333333333
"21507","63072","2019",9,9,0,128780.222222222,1257.77777777778,101.444444444444
"21508","63073","2019",2,2,0,233250,2225,106
"21509","63074","2019",3,3,0,122233.333333333,1397,76.3333333333333
"21510","63075","2019",450,68,382,166995.784444444,2180.70888888889,72.2844444444444
"21511","63076","2019",1,1,0,65000,1000,65
"21512","63077","2019",13,9,4,144972.307692308,2119.30769230769,70.5384615384615
"21513","63079","2019",4,4,0,80625,757.25,109.5
"21514","63080","2019",16,13,3,93663.4375,1273.25,75.375
"21515","63081","2019",3,3,0,81600,860.333333333333,92.3333333333333
"21516","63082","2019",9,9,0,107380,1270.33333333333,91.6666666666667
"21517","63083","2019",6,6,0,187590,2243.83333333333,97.6666666666667
"21518","63084","2019",19,19,0,212572.421052632,2152.94736842105,121.578947368421
"21519","63085","2019",7,7,0,116185.714285714,1377.28571428571,78.2857142857143
"21520","63086","2019",3,3,0,44500,651,75.6666666666667
"21521","63087","2019",2,2,0,98358,1216.5,80.5
"21522","63088","2019",4,4,0,149742.5,839,175.5
"21523","63089","2019",17,17,0,166357.882352941,1873.52941176471,94.8823529411765
"21524","63090","2019",7,7,0,200068.571428571,1628.71428571429,127.285714285714
"21525","63091","2019",11,11,0,82936.3636363636,1053.72727272727,75.7272727272727
"21526","63092","2019",23,22,1,163660.869565217,1511.21739130435,111.478260869565
"21527","63093","2019",8,8,0,99431.25,1107.5,95.25
"21528","63094","2019",4,4,0,63250,808.75,77.25
"21529","63095","2019",2,2,0,107505,1394,78
"21530","63096","2019",6,6,0,138833.333333333,1578.66666666667,89.1666666666667
"21531","63098","2019",7,6,1,85018.8571428571,1070.57142857143,87.2857142857143
"21532","63099","2019",33,29,4,163135.151515152,1870.51515151515,84.1212121212121
"21533","63100","2019",3,3,0,125933.333333333,1102.66666666667,112
"21534","63102","2019",8,8,0,105601.5,1164.125,91.75
"21535","63103","2019",88,61,27,165805.147727273,1848.46590909091,89.4431818181818
"21536","63104","2019",5,5,0,152580,1645.4,101.2
"21537","63106","2019",18,18,0,197338.277777778,1859.44444444444,112.777777777778
"21538","63107","2019",7,7,0,206127.714285714,1459.28571428571,134.428571428571
"21539","63108","2019",6,6,0,212034.166666667,1643.16666666667,135.166666666667
"21540","63109","2019",8,8,0,230206.25,2180,118.625
"21541","63110","2019",2,2,0,107020,1464,78.5
"21542","63111","2019",2,2,0,39500,789.5,51
"21543","63112","2019",6,6,0,197398.333333333,1651.16666666667,120.666666666667
"21544","63113","2019",2460,422,2038,131381.450406504,1957.58536585366,67.219512195122
"21545","63114","2019",2,2,0,207500,1625.5,127.5
"21546","63115","2019",3,3,0,68193.3333333333,750.666666666667,88
"21547","63116","2019",27,27,0,144119.851851852,1594.74074074074,89.7777777777778
"21548","63117","2019",2,2,0,51500,1392.5,40
"21549","63118","2019",2,2,0,42500,505.5,83.5
"21550","63119","2019",2,2,0,48335,422,114
"21551","63120","2019",13,13,0,136717.692307692,1655.30769230769,81.4615384615385
"21552","63121","2019",21,20,1,159263.333333333,1684.57142857143,91.7619047619048
"21553","63122","2019",1,1,0,33000,825,40
"21554","63123","2019",4,4,0,187300,1793,101.5
"21555","63124","2019",254,162,92,181684.204724409,2106.17716535433,85.507874015748
"21556","63125","2019",53,48,5,100724.433962264,1112,88.811320754717
"21557","63126","2019",16,16,0,184496.875,1832.125,99.75
"21558","63128","2019",9,9,0,137595.555555556,1676.33333333333,94.2222222222222
"21559","63130","2019",6,6,0,61648.3333333333,791.333333333333,77.5
"21560","63131","2019",9,9,0,135245.555555556,1182.22222222222,111.444444444444
"21561","63132","2019",11,11,0,84730,1131.18181818182,78
"21562","63134","2019",2,2,0,63750,637.5,100
"21563","63135","2019",9,9,0,207696.666666667,1911.44444444444,108.333333333333
"21564","63136","2019",9,9,0,90044.4444444444,1104.11111111111,97.6666666666667
"21565","63137","2019",4,4,0,95425,1249,93.25
"21566","63138","2019",7,7,0,116645.571428571,1234.57142857143,98.4285714285714
"21567","63139","2019",12,11,1,73516.6666666667,1076.75,67.0833333333333
"21568","63140","2019",5,5,0,64370.8,815,78.2
"21569","63141","2019",22,21,1,214522.727272727,2207.40909090909,91.4090909090909
"21570","63142","2019",4,4,0,96487.5,1666.5,60.25
"21571","63143","2019",11,11,0,170553.636363636,1515.54545454545,114.909090909091
"21572","63144","2019",8,8,0,83642.5,1276.375,63.125
"21573","63145","2019",2,2,0,70450,1654.5,42.5
"21574","63146","2019",9,9,0,139932.222222222,1393.22222222222,103.333333333333
"21575","63147","2019",3,3,0,61000,904.333333333333,68
"21576","63148","2019",20,20,0,208197.25,1985.65,106.7
"21577","63149","2019",9,9,0,165082.222222222,1951.55555555556,85.6666666666667
"21578","63150","2019",16,16,0,190040,1899.3125,101.375
"21579","63151","2019",7,7,0,155271.428571429,1227.28571428571,120.285714285714
"21580","63152","2019",2,2,0,34500,487,68.5
"21581","63153","2019",2,2,0,54200,525,97
"21582","63154","2019",6,6,0,131925.666666667,1112.33333333333,114
"21583","63155","2019",8,8,0,199131.25,1573.75,124
"21584","63156","2019",2,2,0,96507.5,970.5,96
"21585","63157","2019",5,5,0,130410,1236.8,110.4
"21586","63158","2019",1,1,0,70000,933,75
"21587","63159","2019",1,1,0,65000,500,130
"21588","63160","2019",8,7,1,200746.25,1479,123.875
"21589","63161","2019",1,1,0,32000,492,65
"21590","63162","2019",5,5,0,55400,901.2,69
"21591","63163","2019",8,8,0,96331.25,1117,83.125
"21592","63164","2019",101,68,33,163685.851485149,1878.71287128713,87.1782178217822
"21593","63165","2019",7,7,0,45662.1428571429,632.571428571429,69.8571428571429
"21594","63166","2019",1,1,0,129900,1755,74
"21595","63167","2019",4,4,0,154507.25,1494.5,102.5
"21596","63168","2019",6,6,0,232666.666666667,1933.16666666667,123.333333333333
"21597","63170","2019",7,7,0,77753.5714285714,1453.28571428571,66.1428571428571
"21598","63171","2019",2,2,0,38000,451,84
"21599","63173","2019",2,2,0,86000,1173.5,71.5
"21600","63174","2019",2,2,0,28500,509,58
"21601","63175","2019",5,5,0,49320,583.8,95.4
"21602","63177","2019",7,7,0,99736.4285714286,1081.28571428571,88.1428571428571
"21603","63178","2019",212,117,95,140920.051886792,1773.28301886792,80.9716981132076
"21604","63179","2019",17,17,0,117688.235294118,1502.88235294118,80.5882352941177
"21605","63180","2019",10,10,0,157290,1582,99.1
"21606","63181","2019",9,9,0,149801.222222222,1589.55555555556,96.1111111111111
"21607","63182","2019",10,10,0,102546,987.1,95.5
"21608","63183","2019",2,2,0,71825,917.5,78.5
"21609","63184","2019",6,6,0,73341.6666666667,914.166666666667,81.3333333333333
"21610","63185","2019",7,7,0,124857.142857143,1209.14285714286,103.428571428571
"21611","63186","2019",2,2,0,100725,1320.5,76
"21612","63187","2019",8,8,0,75562.5,892.5,91.25
"21613","63188","2019",6,6,0,175301.666666667,1957.33333333333,87.1666666666667
"21614","63189","2019",2,2,0,55500,855.5,64
"21615","63190","2019",9,9,0,79540,857.333333333333,84.6666666666667
"21616","63191","2019",4,4,0,77400,698,109.5
"21617","63192","2019",9,7,2,57662.2222222222,937,64.3333333333333
"21618","63193","2019",85,68,17,163404.105882353,2043.6,79.4705882352941
"21619","63194","2019",2,2,0,187900,1542.5,121
"21620","63195","2019",67,66,1,140008.074626866,1467.98507462687,96.9701492537313
"21621","63196","2019",4,4,0,121000,1088.25,113.75
"21622","63197","2019",2,2,0,174870,1138,163
"21623","63198","2019",18,18,0,166867.777777778,1772.72222222222,98.7777777777778
"21624","63199","2019",10,10,0,152640,1456.5,104.3
"21625","63200","2019",2,2,0,131500,1824,74
"21626","63201","2019",9,9,0,112305.555555556,1001.77777777778,104.333333333333
"21627","63202","2019",3,3,0,159578.333333333,1636.66666666667,96
"21628","63203","2019",15,15,0,254161.333333333,2059.93333333333,120.466666666667
"21629","63204","2019",12,11,1,156482.5,1643.16666666667,98.9166666666667
"21630","63205","2019",3,3,0,131833.333333333,1317.33333333333,99.6666666666667
"21631","63206","2019",13,13,0,134310,1296.61538461538,110.538461538462
"21632","63207","2019",12,11,1,134700,1489.58333333333,86.3333333333333
"21633","63208","2019",7,7,0,140942.857142857,1376,101.857142857143
"21634","63209","2019",5,5,0,86690,828.8,108.4
"21635","63210","2019",38,36,2,131674.552631579,1303.42105263158,104.263157894737
"21636","63211","2019",16,15,1,86596.875,1078.25,87.5625
"21637","63212","2019",22,21,1,250659.090909091,1943.18181818182,129.5
"21638","63213","2019",18,17,1,212408.333333333,1999.94444444444,108.555555555556
"21639","63214","2019",47,41,6,163843.319148936,1791.89361702128,90.1702127659574
"21640","63215","2019",8,8,0,208068.75,1728.875,126.75
"21641","63216","2019",4,4,0,68749,1083.75,62
"21642","63218","2019",1,1,0,184100,1787,103
"21643","63219","2019",5,5,0,139060,1388,104.8
"21644","63221","2019",4,4,0,105125,917,141
"21645","63222","2019",3,3,0,140900,1275.66666666667,104.666666666667
"21646","63223","2019",6,6,0,83983.3333333333,920.666666666667,92.5
"21647","63224","2019",14,13,1,196508.642857143,1996.64285714286,97.2142857142857
"21648","63225","2019",15,14,1,69461.2,793.066666666667,91.0666666666667
"21649","63226","2019",35,35,0,172643.885714286,1795.42857142857,97.1142857142857
"21650","63227","2019",27,26,1,222366.888888889,1894.55555555556,116.888888888889
"21651","63228","2019",7,7,0,124588.571428571,1210,118.142857142857
"21652","63229","2019",19,19,0,156535.789473684,1580.15789473684,95.2631578947368
"21653","63230","2019",3,3,0,66666.6666666667,754.666666666667,74
"21654","63231","2019",8,7,1,67641.25,627.75,108
"21655","63232","2019",11,11,0,118813.636363636,1402.27272727273,85
"21656","63233","2019",7,7,0,88039.7142857143,1036.71428571429,95.2857142857143
"21657","63234","2019",12,12,0,105974.75,1138.5,92.3333333333333
"21658","63235","2019",12,12,0,157819.166666667,1584.75,99.4166666666667
"21659","63236","2019",106,17,89,92968.2641509434,2010.49056603774,53.5188679245283
"21660","63237","2019",4,4,0,107600,1035.5,107.25
"21661","63238","2019",1,1,0,147450,1715,86
"21662","63239","2019",7,7,0,130842.857142857,1653.14285714286,76.8571428571429
"21663","63240","2019",5,5,0,197310,1625.4,119
"21664","63241","2019",4,4,0,232500,1822,129.25
"21665","63242","2019",3,3,0,151500,1338,113.333333333333
"21666","63243","2019",3,3,0,129833.333333333,2116.66666666667,72
"21667","63244","2019",21,21,0,193714.428571429,1815.80952380952,104.047619047619
"21668","63245","2019",46,44,2,172229.956521739,1950.73913043478,86.9130434782609
"21669","63246","2019",8,6,2,61471.25,1425,46.125
"21670","63247","2019",22,16,6,110695.5,1720.36363636364,67.2727272727273
"21671","63248","2019",11,10,1,166287.272727273,1608.18181818182,100.909090909091
"21672","63249","2019",6,6,0,130225,1319.83333333333,97.5
"21673","63250","2019",14,14,0,155484.642857143,1833,83.4285714285714
"21674","63251","2019",3,3,0,127941.666666667,1693.33333333333,88.3333333333333
"21675","63252","2019",5,5,0,199390,1638.6,117
"21676","63253","2019",2,2,0,106250,896.5,114
"21677","63254","2019",22,22,0,210892.272727273,2270.13636363636,95.1818181818182
"21678","63255","2019",12,12,0,152902.916666667,1765.5,97.25
"21679","63256","2019",1,1,0,146960,1563,94
"21680","63257","2019",10,9,1,187903.1,1578.3,124.7
"21681","63258","2019",7,7,0,49464.2857142857,543.714285714286,86.4285714285714
"21682","63259","2019",4,4,0,111281.25,1601.25,76.5
"21683","63260","2019",3,3,0,51500,902,57.3333333333333
"21684","63261","2019",11,11,0,160129.090909091,1655.81818181818,94.7272727272727
"21685","63262","2019",32,32,0,226405.46875,2190.59375,104.15625
"21686","63263","2019",30,29,1,235314,2067.96666666667,111.966666666667
"21687","63264","2019",2,2,0,62150,1015,64.5
"21688","63265","2019",19,18,1,174979.473684211,1617.36842105263,111.894736842105
"21689","63267","2019",5,5,0,76500,1033,69.4
"21690","63268","2019",1,1,0,227700,1752,130
"21691","63269","2019",4,4,0,200882.5,1888,101.75
"21692","63271","2019",10,10,0,132342,1377.6,97.1
"21693","63272","2019",35,35,0,256270.514285714,2372.34285714286,109.2
"21694","63273","2019",16,15,1,217291.875,2187.25,97.625
"21695","63274","2019",3,3,0,44333.3333333333,764.333333333333,61
"21696","63275","2019",12,12,0,141404.166666667,1356.25,106.083333333333
"21697","63276","2019",23,20,3,131160.434782609,1398.04347826087,95.304347826087
"21698","63277","2019",1,1,0,60000,706,85
"21699","63278","2019",6,6,0,213558.333333333,2026.33333333333,108.166666666667
"21700","63279","2019",11,10,1,96705.4545454545,1303.09090909091,72.2727272727273
"21701","63280","2019",6,6,0,195806.666666667,1932,105.166666666667
"21702","63281","2019",10,10,0,96170.5,877.7,96.9
"21703","63282","2019",15,15,0,165656.666666667,1715.06666666667,92.4666666666667
"21704","63283","2019",7,6,1,71714.2857142857,1042.42857142857,79.2857142857143
"21705","63284","2019",141,132,9,182504.829787234,1913.78723404255,95.4609929078014
"21706","63285","2019",8,8,0,104321.25,1167.875,92.625
"21707","63286","2019",4,4,0,77450,2117.5,59.75
"21708","63287","2019",5,5,0,178920,1486,126.2
"21709","63288","2019",5,4,1,161076,1485.4,109.4
"21710","63289","2019",3,3,0,68200,939.333333333333,90
"21711","63290","2019",1,1,0,95000,1484,64
"21712","63291","2019",32,30,2,127032.15625,1175.46875,109.25
"21713","63294","2019",4,4,0,73000,793,95.5
"21714","63295","2019",22,22,0,106272.681818182,1029.81818181818,105.454545454545
"21715","63296","2019",10,10,0,155161.8,1545.1,98.5
"21716","63297","2019",3,3,0,125000,1252.33333333333,99.3333333333333
"21717","63298","2019",1,1,0,81950,1413,58
"21718","63299","2019",2,2,0,250645,1483.5,194.5
"21719","63300","2019",272,158,114,161457.283088235,1857.82720588235,85.6213235294118
"21720","63301","2019",8,8,0,99787.5,1006.875,106
"21721","63302","2019",32,31,1,244464.6875,2387.28125,103.5625
"21722","63305","2019",9,7,2,103132.333333333,1722.55555555556,71.2222222222222
"21723","63306","2019",10,10,0,194051,1753.1,111.8
"21724","63307","2019",85,67,18,203669.917647059,2156.01176470588,94.2705882352941
"21725","63308","2019",113,38,75,159547.716814159,2088.97345132743,69.0265486725664
"21726","63309","2019",6,6,0,93833.3333333333,1209.83333333333,87
"21727","63311","2019",3,3,0,152516.666666667,1513.66666666667,103.333333333333
"21728","63312","2019",2,2,0,73235,956,81
"21729","63313","2019",1,1,0,40000,465,86
"21730","63314","2019",7,7,0,103378.571428571,875.428571428571,112.142857142857
"21731","63315","2019",25,25,0,196426.84,1894.44,106.88
"21732","63317","2019",9,9,0,155022.222222222,1365.33333333333,113.111111111111
"21733","63318","2019",2,2,0,116100,926.5,129.5
"21734","63319","2019",15,15,0,67945.3333333333,1244.53333333333,60.4666666666667
"21735","63321","2019",15,15,0,155878.666666667,1402.66666666667,108.466666666667
"21736","63322","2019",29,27,2,197464.827586207,2058.79310344828,99.4137931034483
"21737","63323","2019",4,4,0,60110,796.75,76.75
"21738","63324","2019",6,6,0,73016.6666666667,1100.33333333333,69.6666666666667
"21739","63325","2019",5,5,0,152880,1657,92.2
"21740","63326","2019",5,5,0,90240,1550.4,56.4
"21741","63327","2019",17,14,3,182418.529411765,1784.11764705882,100.176470588235
"21742","63328","2019",2,2,0,93500,918,88.5
"21743","63329","2019",1,1,0,84000,1312,64
"21744","63330","2019",3,3,0,299103.333333333,2378,118.333333333333
"21745","63331","2019",4,4,0,66613.25,1003.25,63
"21746","63332","2019",5,5,0,136962.4,1215.6,109
"21747","63333","2019",4,4,0,161392.5,1470.25,106.25
"21748","63334","2019",11,11,0,98172.7272727273,1018.72727272727,99.5454545454545
"21749","63335","2019",2,2,0,127500,776.5,223.5
"21750","63336","2019",3,3,0,73500,1275,56
"21751","63338","2019",42,39,3,63102.7857142857,842.02380952381,75.8333333333333
"21752","63340","2019",4,4,0,111550,1109.5,98
"21753","63341","2019",8,8,0,106251,1315.25,84.75
"21754","63342","2019",3,3,0,188800,3066.33333333333,89.6666666666667
"21755","63343","2019",5,5,0,101470,1195.8,88.6
"21756","63344","2019",5,5,0,73540,1729.4,67.8
"21757","63345","2019",30,30,0,206563.833333333,1926.23333333333,106.233333333333
"21758","63347","2019",5,5,0,155605.8,1452.8,103.4
"21759","63348","2019",6,6,0,110750,1127.16666666667,99.5
"21760","63349","2019",22,21,1,121638.181818182,1208.27272727273,106.136363636364
"21761","63350","2019",17,17,0,199907.058823529,1936.05882352941,106.823529411765
"21762","63352","2019",11,11,0,84954.5454545455,1199.72727272727,86
"21763","63353","2019",9,9,0,82125.3333333333,878,102.222222222222
"21764","63354","2019",11,11,0,109316.363636364,1057.36363636364,107
"21765","63355","2019",3,3,0,60116.6666666667,768,79
"21766","63356","2019",3,3,0,138166.666666667,1150.33333333333,131.666666666667
"21767","63357","2019",1,1,0,266900,920,290
"21768","63358","2019",6,6,0,109678.333333333,1237.83333333333,83.8333333333333
"21769","63359","2019",1,1,0,68000,850,80
"21770","63360","2019",1,1,0,47000,588,80
"21771","63362","2019",10,10,0,185590.8,1574.8,117.5
"21772","63363","2019",5,5,0,97056,895.4,119
"21773","63364","2019",2,2,0,132450,1833.5,73
"21774","63365","2019",9,9,0,98255.4444444444,1109.11111111111,97.2222222222222
"21775","63366","2019",4,4,0,65700,713.25,84.25
"21776","63367","2019",1,1,0,28000,431,65
"21777","63368","2019",4,4,0,191975,1810,107.75
"21778","63369","2019",1,1,0,40000,533,75
"21779","63370","2019",7,7,0,122143.571428571,1409,101.285714285714
"21780","63371","2019",2,2,0,64400,849.5,74
"21781","63372","2019",6,6,0,157400,1925.16666666667,86.3333333333333
"21782","63373","2019",2,2,0,165000,1342.5,130
"21783","63374","2019",5,5,0,54660,653.8,80
"21784","63375","2019",1,1,0,173000,2162,80
"21785","63377","2019",5,5,0,61169,685.4,98.4
"21786","63378","2019",9,9,0,155727.777777778,1603.55555555556,97.7777777777778
"21787","63379","2019",6,6,0,165831.666666667,1758,89.8333333333333
"21788","63380","2019",15,12,3,113580,1348.26666666667,81.3333333333333
"21789","63381","2019",20,18,2,126905,1654.85,84.3
"21790","63382","2019",5,5,0,94110,1532.2,63.6
"21791","63383","2019",7,7,0,125641.428571429,1248.28571428571,103.714285714286
"21792","63384","2019",4,4,0,75912.5,1031.5,76.25
"21793","63385","2019",3,3,0,165733.333333333,1929.33333333333,86
"21794","63386","2019",10,10,0,135365.3,1367.3,96.1
"21795","63387","2019",13,13,0,166811.538461538,1170,142
"21796","63388","2019",4,4,0,91925,1008.25,91.5
"21797","63390","2019",3,3,0,140666.666666667,1048,139.333333333333
"21798","63391","2019",4,4,0,75500,758.75,92.25
"21799","63392","2019",4,4,0,140957.5,1492.75,87
"21800","63393","2019",28,26,2,84046.4285714286,1070.85714285714,81.1428571428571
"21801","63394","2019",3,3,0,50000,769.666666666667,62.6666666666667
"21802","63395","2019",10,10,0,212931.1,1844,115.1
"21803","63396","2019",14,14,0,170805.714285714,1716.85714285714,90.4285714285714
"21804","63397","2019",10,9,1,103085,1198.7,91.2
"21805","63399","2019",4,4,0,37000,777,52
"21806","63400","2019",14,14,0,135289.285714286,1322,100.071428571429
"21807","63401","2019",6,5,1,84233.3333333333,1379,55.5
"21808","63402","2019",3,3,0,93333.3333333333,1075,90.3333333333333
"21809","63403","2019",6,6,0,157953.333333333,1445.66666666667,105.5
"21810","63404","2019",4,4,0,133892.5,1687,66.75
"21811","63405","2019",7,7,0,172700,1840.57142857143,96.4285714285714
"21812","63406","2019",4,4,0,153337.5,1494,121
"21813","63409","2019",4,4,0,124512.5,1138.25,113.5
"21814","63410","2019",1,1,0,63000,450,140
"21815","63411","2019",8,8,0,155252.125,1502.875,112.25
"21816","63412","2019",6,6,0,110018.333333333,997.333333333333,120.166666666667
"21817","63413","2019",12,12,0,200316.25,1855.5,103.25
"21818","63414","2019",8,8,0,164600.625,1448.125,108.875
"21819","63415","2019",21,20,1,135413.904761905,1349.28571428571,96.7142857142857
"21820","63416","2019",1,1,0,38500,1100,35
"21821","63417","2019",32,32,0,204748.5,2155.6875,94.1875
"21822","63418","2019",5,5,0,81670,807.2,95.2
"21823","63419","2019",12,12,0,88982.5,948.916666666667,99.3333333333333
"21824","63420","2019",14,14,0,158816.428571429,1647.28571428571,92.5714285714286
"21825","63421","2019",4,4,0,104262.5,1068.5,95.25
"21826","63422","2019",4,4,0,110462.5,997.75,110.75
"21827","63423","2019",12,12,0,135684.166666667,1531.08333333333,101.416666666667
"21828","63424","2019",5,5,0,171300,1324,125.8
"21829","63425","2019",18,18,0,259097.222222222,2208.44444444444,119.944444444444
"21830","63426","2019",6,6,0,125006.666666667,1406.83333333333,91.6666666666667
"21831","63427","2019",8,8,0,167012.5,1716.75,102.375
"21832","63428","2019",5,5,0,94600,764.4,132.6
"21833","63430","2019",104,79,25,88967.5961538462,1004.61538461538,87.7211538461538
"21834","63431","2019",6,5,1,86400,847.166666666667,111
"21835","63432","2019",4,4,0,101740,1139,86.75
"21836","63434","2019",3,3,0,35500,794,45
"21837","63435","2019",2,2,0,74000,1228.5,60
"21838","63436","2019",1,1,0,90000,600,150
"21839","63437","2019",2,1,1,46500,532.5,86.5
"21840","63438","2019",3,3,0,80000,877.333333333333,109.333333333333
"21841","63439","2019",1,1,0,142500,1096,130
"21842","63440","2019",1,1,0,64000,582,110
"21843","63441","2019",5,5,0,48600,674.4,64.4
"21844","63443","2019",3,3,0,150358.333333333,1597,83
"21845","63444","2019",3,3,0,221243.333333333,2158.33333333333,102
"21846","63445","2019",1,1,0,44700,596,75
"21847","63446","2019",6,6,0,120750,1661.33333333333,81.5
"21848","63448","2019",14,14,0,101507.142857143,976.285714285714,102.142857142857
"21849","63449","2019",5,5,0,125641,1595.2,85
"21850","63450","2019",2,2,0,55250,683.5,105.5
"21851","63451","2019",3,3,0,85410,912.666666666667,99
"21852","63452","2019",2,2,0,90500,818,110.5
"21853","63453","2019",40,37,3,171827.375,1698.525,102.675
"21854","63454","2019",12,12,0,91583.3333333333,807.333333333333,113.25
"21855","63455","2019",37,35,2,238534.945945946,2023.35135135135,113.351351351351
"21856","63456","2019",2,2,0,132500,1216,97
"21857","63457","2019",61,57,4,171665.737704918,1732.22950819672,97.8360655737705
"21858","63458","2019",1,1,0,152455,1270,120
"21859","63459","2019",4,4,0,229437.5,1374,158.75
"21860","63460","2019",2,2,0,124000,1102.5,132
"21861","63461","2019",4,4,0,132080,1217.75,104
"21862","63462","2019",3,3,0,85666.6666666667,1035.66666666667,88.6666666666667
"21863","63463","2019",1,1,0,50000,667,75
"21864","63464","2019",4,4,0,114792.5,1135.5,108
"21865","63465","2019",5,5,0,40200,828.2,47.4
"21866","63466","2019",3,3,0,179666.666666667,1772,103
"21867","63468","2019",7,6,1,114270,1541.85714285714,86.1428571428571
"21868","63469","2019",5,5,0,40660,891.4,52.2
"21869","63470","2019",55,52,3,143845.472727273,1708.16363636364,85
"21870","63471","2019",11,11,0,59705.5454545455,682.454545454545,81.8181818181818
"21871","63472","2019",9,9,0,165922.222222222,1528.66666666667,103.444444444444
"21872","63473","2019",3,3,0,134733.333333333,2191.33333333333,62.3333333333333
"21873","64001","2019",1,1,0,35000,921,38
"21874","64003","2019",1,1,0,201500,1901,106
"21875","64004","2019",3,3,0,171316.666666667,1293.66666666667,126
"21876","64005","2019",4,4,0,223872.5,1717.75,129
"21877","64006","2019",10,9,1,130990,1272.1,100.6
"21878","64007","2019",9,9,0,225475.333333333,1841.44444444444,124.888888888889
"21879","64008","2019",3,3,0,255000,1581.66666666667,160.666666666667
"21880","64009","2019",29,19,10,446173.896551724,3840.79310344828,116.275862068966
"21881","64010","2019",4,4,0,197705,1733.5,125
"21882","64012","2019",1,1,0,66000,611,108
"21883","64014","2019",3,2,1,3e+05,2695.66666666667,111
"21884","64015","2019",1,1,0,95000,960,99
"21885","64017","2019",2,2,0,51000,690.5,71.5
"21886","64018","2019",4,3,1,272301.5,1962,148
"21887","64021","2019",7,7,0,265528.571428571,1606.71428571429,171.857142857143
"21888","64023","2019",7,7,0,222918.857142857,2084.14285714286,111.285714285714
"21889","64024","2019",900,245,655,341941.04,4498.14111111111,73.32
"21890","64025","2019",1,1,0,185000,1276,145
"21891","64026","2019",2,2,0,216000,1971,109.5
"21892","64027","2019",2,2,0,188425,1840,103
"21893","64029","2019",4,4,0,306750,2283.75,112.5
"21894","64031","2019",1,1,0,91800,585,157
"21895","64032","2019",1,1,0,70000,496,141
"21896","64034","2019",1,1,0,210000,2143,98
"21897","64035","2019",26,20,6,636985.115384615,4420.96153846154,133.884615384615
"21898","64037","2019",11,11,0,179931.818181818,1738.63636363636,98.6363636363636
"21899","64038","2019",55,39,16,568721.945454545,4253.58181818182,134.181818181818
"21900","64040","2019",34,15,19,78536.2647058823,1642.20588235294,53.3529411764706
"21901","64041","2019",9,8,1,194548.888888889,1541.33333333333,117.222222222222
"21902","64042","2019",5,5,0,153664,982.8,150.8
"21903","64043","2019",1,1,0,187000,2671,70
"21904","64046","2019",1,1,0,55000,932,59
"21905","64047","2019",2,1,1,159197.5,1623.5,119.5
"21906","64049","2019",3,3,0,109100,776.333333333333,146.666666666667
"21907","64050","2019",2,1,1,111250,1056,109
"21908","64051","2019",3,2,1,211350,1821.33333333333,117.333333333333
"21909","64052","2019",2,2,0,66850,801.5,95.5
"21910","64053","2019",1,1,0,338000,1837,184
"21911","64054","2019",3,3,0,163333.333333333,1581.33333333333,101.666666666667
"21912","64056","2019",3,3,0,89333.3333333333,972.333333333333,99
"21913","64057","2019",23,20,3,140893.913043478,1447.26086956522,100.826086956522
"21914","64058","2019",3,3,0,108200,937.333333333333,125.666666666667
"21915","64059","2019",12,12,0,245865.833333333,2118.16666666667,115.25
"21916","64060","2019",21,18,3,253111.238095238,2296.04761904762,115.047619047619
"21917","64061","2019",30,25,5,158180.1,1762.43333333333,94.5666666666667
"21918","64062","2019",33,29,4,141601.818181818,1419.54545454545,102.757575757576
"21919","64063","2019",14,14,0,137304.571428571,1159.5,114.428571428571
"21920","64064","2019",2,1,1,85500,518,171.5
"21921","64065","2019",67,44,23,443017.223880597,3692.79104477612,118.791044776119
"21922","64066","2019",5,5,0,185400,2056,91
"21923","64067","2019",24,24,0,191200.416666667,1721.45833333333,115.166666666667
"21924","64068","2019",17,16,1,162876.058823529,1582.35294117647,102.764705882353
"21925","64069","2019",8,8,0,89592.5,1305.25,70.875
"21926","64070","2019",4,4,0,187800,1513.75,125.5
"21927","64071","2019",4,4,0,255519.25,1410.5,181.25
"21928","64072","2019",5,5,0,206585.2,1962.6,100.2
"21929","64074","2019",1,1,0,62000,456,136
"21930","64075","2019",1,1,0,78000,520,150
"21931","64078","2019",5,5,0,170400,1187,142.4
"21932","64080","2019",7,7,0,202661.142857143,1962.14285714286,109.142857142857
"21933","64081","2019",1,1,0,80000,455,176
"21934","64083","2019",2,2,0,98500,797.5,96.5
"21935","64085","2019",2,2,0,149300,1668,91
"21936","64086","2019",9,7,2,241944.444444444,2204,117.444444444444
"21937","64087","2019",12,12,0,192383.333333333,1930.66666666667,105.333333333333
"21938","64088","2019",4,4,0,190397.5,1390.5,148
"21939","64090","2019",1,1,0,187000,1731,108
"21940","64091","2019",6,6,0,201320,1719,116.333333333333
"21941","64092","2019",4,4,0,76485,740.5,109.75
"21942","64093","2019",3,3,0,121533.333333333,989,120
"21943","64094","2019",16,14,2,270734.375,2282.75,119.4375
"21944","64095","2019",4,4,0,195850,1463.5,137.25
"21945","64096","2019",3,3,0,138333.333333333,1044,135.666666666667
"21946","64097","2019",2,2,0,178890,1708.5,107.5
"21947","64099","2019",1,1,0,39000,1300,30
"21948","64100","2019",54,35,19,419858.074074074,3885.68518518519,105.611111111111
"21949","64101","2019",5,4,1,179366,1931.2,96.4
"21950","64102","2019",1080,116,964,214057.34537037,3244.79814814815,65.9231481481481
"21951","64104","2019",5,5,0,123690,1540.4,84.8
"21952","64105","2019",5,5,0,134570,818.8,164
"21953","64106","2019",7,7,0,152142.857142857,1536.42857142857,106.285714285714
"21954","64108","2019",9,9,0,132125.555555556,1353.33333333333,97.3333333333333
"21955","64109","2019",16,16,0,151586.875,1423.125,115
"21956","64110","2019",5,5,0,157206,1562.2,110.2
"21957","64112","2019",4,4,0,173125,1156.5,145.25
"21958","64113","2019",3,3,0,155000,1120,143.666666666667
"21959","64114","2019",9,9,0,239105.555555556,2101.22222222222,116.222222222222
"21960","64115","2019",1,1,0,225398,1878,120
"21961","64116","2019",1,1,0,329000,4062,81
"21962","64117","2019",2,2,0,171000,1383,118.5
"21963","64119","2019",8,8,0,179706.625,1257.75,140.25
"21964","64120","2019",7,7,0,197060,1364.42857142857,137.142857142857
"21965","64122","2019",916,146,770,401438.030567686,5951.09934497817,67.82096069869
"21966","64123","2019",18,13,5,205826.444444444,1789.61111111111,122.722222222222
"21967","64124","2019",2,2,0,525000,3351,160
"21968","64125","2019",166,52,114,370426.331325301,5005.11445783133,74.6024096385542
"21969","64126","2019",20,18,2,137201.65,1368,103.15
"21970","64127","2019",6,5,1,180100,1143.16666666667,165.166666666667
"21971","64128","2019",4,4,0,148375,1121.5,141.75
"21972","64129","2019",309,68,241,120590.310679612,1798.15857605178,68.7443365695793
"21973","64130","2019",12,4,8,247925.416666667,2625.91666666667,96.9166666666667
"21974","64131","2019",4,4,0,164250,1793,93.75
"21975","64132","2019",57,39,18,216337.280701754,1918.63157894737,111.298245614035
"21976","64133","2019",12,11,1,180837.333333333,1875.25,96.8333333333333
"21977","64134","2019",1,1,0,263000,2711,97
"21978","64135","2019",6,6,0,179565.333333333,1068.33333333333,160.666666666667
"21979","64137","2019",7,7,0,213266.428571429,1603.71428571429,141.142857142857
"21980","64138","2019",25,25,0,187799.2,1663.28,113.16
"21981","64139","2019",15,15,0,241638.666666667,2164.4,109.666666666667
"21982","64140","2019",144,68,76,243909.736111111,3098.17361111111,79.3888888888889
"21983","64141","2019",2,2,0,115500,1103,105
"21984","64142","2019",5,5,0,164600,1471.2,114.2
"21985","64145","2019",4,4,0,160940,1632.5,95
"21986","64146","2019",2,2,0,214425,1640,131
"21987","64147","2019",46,29,17,261507.826086957,2700.97826086957,97.2608695652174
"21988","64148","2019",13,13,0,168761.538461538,1161.61538461538,154.230769230769
"21989","64152","2019",25,22,3,297833.8,1961.88,158.88
"21990","64153","2019",1,1,0,275000,1923,143
"21991","64156","2019",4,4,0,78125,1049.25,97.75
"21992","64157","2019",9,9,0,163818.888888889,1525.77777777778,105
"21993","64158","2019",1,1,0,178400,1450,123
"21994","64160","2019",117,35,82,184601.547008547,2840.64102564103,69.2564102564103
"21995","64161","2019",4,4,0,197100,1726.25,110.75
"21996","64165","2019",3,3,0,139493.333333333,1369.33333333333,111.666666666667
"21997","64166","2019",2,2,0,215805,1432,138.5
"21998","64167","2019",2,2,0,132600,1497,97
"21999","64168","2019",7,7,0,147928.571428571,1184.42857142857,135.857142857143
"22000","64170","2019",1,1,0,252900,1390,182
"22001","64171","2019",5,5,0,283780,2039.6,135.2
"22002","64172","2019",6,6,0,109000,1524,72.3333333333333
"22003","64174","2019",1,1,0,133219,1074,124
"22004","64175","2019",2,2,0,90950,1205,75.5
"22005","64176","2019",1,1,0,170000,2179,78
"22006","64177","2019",3,3,0,133000,1222.66666666667,115
"22007","64178","2019",8,8,0,164750,1290.75,136.875
"22008","64179","2019",3,3,0,177000,1060.66666666667,153
"22009","64180","2019",2,2,0,122000,731,167
"22010","64181","2019",2,2,0,187000,1067.5,174
"22011","64182","2019",2,2,0,140650,1622.5,87
"22012","64183","2019",5,5,0,99710,1257.2,85
"22013","64184","2019",8,8,0,199443.75,1529.375,136.875
"22014","64185","2019",3,3,0,142000,1494,99.3333333333333
"22015","64186","2019",2,2,0,112000,906.5,110
"22016","64187","2019",4,4,0,128712.5,892,136.75
"22017","64188","2019",5,5,0,148630,1136.6,154.2
"22018","64189","2019",203,31,172,315413.866995074,4730.41379310345,67.3694581280788
"22019","64190","2019",1,1,0,164000,1355,121
"22020","64191","2019",25,25,0,187945.2,1702.88,113.4
"22021","64192","2019",2,2,0,182650,1209.5,166
"22022","64193","2019",1,1,0,66000,1320,50
"22023","64194","2019",1,1,0,157000,1688,93
"22024","64195","2019",1,1,0,177000,1264,140
"22025","64197","2019",1,1,0,273000,2022,135
"22026","64198","2019",15,15,0,215284,1902.53333333333,112.866666666667
"22027","64199","2019",3,3,0,120536.666666667,848.333333333333,155
"22028","64200","2019",3,3,0,126666.666666667,1668,76.6666666666667
"22029","64202","2019",5,5,0,150500,1331,135.2
"22030","64203","2019",1,1,0,235000,1808,130
"22031","64204","2019",66,6,60,57565.9090909091,1681.80303030303,37.5
"22032","64205","2019",4,4,0,123000,890.5,144.5
"22033","64206","2019",3,3,0,82166.6666666667,1630.33333333333,50.3333333333333
"22034","64207","2019",4,4,0,170580,1529,111
"22035","64208","2019",4,4,0,153055,1410.5,113
"22036","64209","2019",2,2,0,120100,1796.5,66.5
"22037","64210","2019",2,2,0,165500,1769.5,96
"22038","64211","2019",6,6,0,151883.333333333,1608.5,92.3333333333333
"22039","64212","2019",1,1,0,161000,915,176
"22040","64213","2019",25,18,7,320370.92,2712.92,126.2
"22041","64214","2019",4,4,0,127033,1095.75,116
"22042","64215","2019",1,1,0,186000,1101,169
"22043","64216","2019",8,7,1,248523.75,1737.875,171.5
"22044","64217","2019",4,4,0,179712.5,1575.25,112.25
"22045","64218","2019",1,1,0,138000,979,141
"22046","64219","2019",3,3,0,148183.333333333,1296,116.666666666667
"22047","64220","2019",3,3,0,180000,1443.33333333333,131.666666666667
"22048","64223","2019",5,5,0,92778,1280.4,82.8
"22049","64224","2019",14,14,0,185800.714285714,1618.5,121.357142857143
"22050","64225","2019",7,7,0,181985.714285714,1411.28571428571,134.571428571429
"22051","64227","2019",6,6,0,232391.666666667,1913.5,121.166666666667
"22052","64228","2019",1,1,0,584171,1826,320
"22053","64229","2019",1,0,1,180000,1208,149
"22054","64230","2019",50,47,3,215207,1849,116.42
"22055","64231","2019",3,3,0,96666.6666666667,838.333333333333,116.333333333333
"22056","64232","2019",2,2,0,242660,1607,148
"22057","64233","2019",16,15,1,166943.75,1287,132.625
"22058","64234","2019",5,5,0,154530,1448.2,112.6
"22059","64235","2019",2,2,0,228500,1694.5,133
"22060","64236","2019",1,1,0,145000,1066,136
"22061","64237","2019",38,26,12,201637.894736842,1871.89473684211,107.289473684211
"22062","64238","2019",15,15,0,196780.666666667,1601,126.466666666667
"22063","64239","2019",3,3,0,142900,1259,126.666666666667
"22064","64240","2019",4,4,0,122700,1425.5,82.5
"22065","64241","2019",6,6,0,175866.666666667,1359.33333333333,146.666666666667
"22066","64243","2019",3,3,0,141166.666666667,1400.33333333333,112.666666666667
"22067","64244","2019",5,5,0,179812.4,1528,129.8
"22068","64245","2019",5,5,0,121087.4,1454,80.6
"22069","64246","2019",1,1,0,208000,1600,130
"22070","64247","2019",1,1,0,139000,813,171
"22071","64249","2019",39,9,30,364706.128205128,5800.41025641026,66.0512820512821
"22072","64250","2019",10,10,0,242915,2355.1,110.8
"22073","64251","2019",1,1,0,242000,2420,100
"22074","64252","2019",9,9,0,193950,1901.33333333333,108.666666666667
"22075","64253","2019",5,5,0,186200,1512.8,149
"22076","64254","2019",4,4,0,157345,1211.5,136.25
"22077","64255","2019",4,4,0,279580,2557.5,117.75
"22078","64256","2019",94,45,49,217501.574468085,2459.5,89.8297872340426
"22079","64257","2019",2,2,0,175300,1377.5,128
"22080","64259","2019",2,2,0,237755,2656,92
"22081","64260","2019",507,84,423,208854.976331361,3654.2899408284,59.4043392504931
"22082","64261","2019",3,3,0,140666.666666667,1620,87
"22083","64262","2019",1,1,0,3e+05,1500,200
"22084","64263","2019",1,1,0,125000,1042,120
"22085","64265","2019",1,1,0,163989,1038,158
"22086","64266","2019",3,3,0,224433.333333333,1783.33333333333,126.666666666667
"22087","64267","2019",1,1,0,188000,1044,180
"22088","64268","2019",1,1,0,70000,673,104
"22089","64269","2019",58,51,7,298201.448275862,2082.94827586207,141.862068965517
"22090","64270","2019",9,9,0,190857.777777778,1647.33333333333,122.777777777778
"22091","64273","2019",3,3,0,198500,1509.66666666667,134
"22092","64274","2019",1,1,0,225000,2446,92
"22093","64275","2019",2,2,0,159000,1067.5,197.5
"22094","64276","2019",2,2,0,198500,1881.5,112
"22095","64277","2019",3,3,0,228123.333333333,2205,103.666666666667
"22096","64279","2019",13,8,5,300280.769230769,3212.92307692308,95.3076923076923
"22097","64280","2019",4,4,0,157150,1687.75,93.75
"22098","64281","2019",1,1,0,287820,2116,136
"22099","64282","2019",10,10,0,381155.1,2723.1,144.2
"22100","64284","2019",100,49,51,196465.44,1811.93,105.2
"22101","64286","2019",2,2,0,123500,1427.5,90
"22102","64287","2019",3,3,0,129448.333333333,1320.33333333333,100.333333333333
"22103","64288","2019",2,2,0,156950,1329.5,109.5
"22104","64289","2019",7,5,2,360317.142857143,2624.28571428571,155
"22105","64290","2019",4,4,0,221137.5,1706,132.25
"22106","64291","2019",1,1,0,129000,1418,91
"22107","64292","2019",2,2,0,109500,833,120.5
"22108","64293","2019",3,3,0,123966.666666667,1004.66666666667,117
"22109","64294","2019",1,1,0,226600,2832,80
"22110","64295","2019",1,1,0,127860,947,135
"22111","64296","2019",2,2,0,145147.5,1163,122
"22112","64297","2019",1,0,1,110000,786,140
"22113","64298","2019",2,2,0,111500,1197.5,102.5
"22114","64300","2019",2,2,0,191625,1558.5,122.5
"22115","64301","2019",9,9,0,130500,1263.33333333333,113.666666666667
"22116","64302","2019",3,3,0,194333.333333333,1680,115.333333333333
"22117","64304","2019",37,18,19,264759.216216216,3086.02702702703,86.7027027027027
"22118","64305","2019",3,3,0,177493.333333333,1856.66666666667,103.333333333333
"22119","64306","2019",5,5,0,199360,1659.4,123.2
"22120","64307","2019",3,3,0,276800,1827.66666666667,153.333333333333
"22121","64308","2019",4,4,0,170625,1444,122.75
"22122","64309","2019",1,1,0,165000,842,196
"22123","64310","2019",4,4,0,114425,1085.25,110
"22124","64312","2019",2,2,0,158000,1327.5,112.5
"22125","64313","2019",5,5,0,161138,1001.6,163
"22126","64314","2019",3,1,2,66666.6666666667,897.333333333333,75
"22127","64315","2019",5,5,0,218981,2275,98
"22128","64316","2019",2,2,0,114535,1105,129
"22129","64317","2019",27,18,9,257441.37037037,2877.07407407407,94.5925925925926
"22130","64318","2019",3,3,0,166900,1376,134
"22131","64319","2019",1,1,0,224671,2080,108
"22132","64320","2019",31,14,17,87221.6129032258,1632.35483870968,62.5483870967742
"22133","64321","2019",1,1,0,181300,1813,100
"22134","64322","2019",5,4,1,140680,1181.8,123.2
"22135","64324","2019",15,15,0,206908.333333333,1599.6,129.533333333333
"22136","64326","2019",2,2,0,157500,1030,160
"22137","64327","2019",7,7,0,239042.428571429,1612.85714285714,147
"22138","64328","2019",10,10,0,161700,1620,100.8
"22139","64329","2019",8,8,0,307432.375,2178.625,140.625
"22140","64330","2019",2,2,0,87500,583,150
"22141","64331","2019",13,13,0,127106,1022.15384615385,125.076923076923
"22142","64335","2019",91,68,23,225014.164835165,2117.50549450549,107.054945054945
"22143","64336","2019",3,3,0,87333.3333333333,1595.33333333333,54.6666666666667
"22144","64337","2019",1,1,0,124600,1187,105
"22145","64338","2019",1,1,0,135000,1849,73
"22146","64339","2019",9,7,2,136917.222222222,1062.44444444444,133.666666666667
"22147","64341","2019",1,1,0,165000,2062,80
"22148","64342","2019",1,1,0,159000,1500,106
"22149","64343","2019",5,4,1,174728,1716.2,105
"22150","64344","2019",8,8,0,203090,1458.75,143.75
"22151","64345","2019",1,1,0,202600,1558,130
"22152","64346","2019",3,3,0,190500,1536,132.333333333333
"22153","64347","2019",1,1,0,66000,611,108
"22154","64348","2019",194,120,74,192581.056701031,2036.44845360825,92.3917525773196
"22155","64349","2019",8,8,0,161818.125,1405.125,115.625
"22156","64350","2019",7,5,2,268047.142857143,2690.14285714286,107.142857142857
"22157","64351","2019",2,2,0,120500,2704,84.5
"22158","64352","2019",3,3,0,157666.666666667,1362.66666666667,115.333333333333
"22159","64353","2019",16,15,1,191106.5,1595.9375,129.875
"22160","64354","2019",4,4,0,99870,1401,74.25
"22161","64356","2019",2,2,0,237500,1965.5,121
"22162","64357","2019",1,1,0,153080,1392,110
"22163","64359","2019",6,6,0,182631.333333333,1189.5,155.833333333333
"22164","64360","2019",5,5,0,146000,1460.6,127.8
"22165","64361","2019",1,1,0,227315,1612,141
"22166","64362","2019",1,1,0,258000,1527,169
"22167","64363","2019",3,3,0,157076.666666667,1055.66666666667,156
"22168","64364","2019",3,3,0,269416.666666667,2133.33333333333,123.333333333333
"22169","64365","2019",6,5,1,137888.666666667,1398,117.333333333333
"22170","64366","2019",1,1,0,210000,1419,148
"22171","64367","2019",10,9,1,152611.5,1581.3,98.5
"22172","64368","2019",1,1,0,171500,953,180
"22173","64369","2019",5,5,0,119992,1051,111.2
"22174","64370","2019",7,7,0,235635.714285714,2033.14285714286,117.571428571429
"22175","64371","2019",37,28,9,107901.081081081,1153.83783783784,98.8108108108108
"22176","64372","2019",1,1,0,47700,712,67
"22177","64373","2019",17,17,0,206743.529411765,1951.82352941176,106.529411764706
"22178","64374","2019",9,9,0,240944.444444444,2708.66666666667,119.555555555556
"22179","64375","2019",1,1,0,150171,1329,113
"22180","64376","2019",6,6,0,185786.666666667,1911.33333333333,121.333333333333
"22181","64377","2019",7,7,0,188207.142857143,2037.42857142857,106.142857142857
"22182","64378","2019",2,2,0,196750,1256.5,163
"22183","64379","2019",1,1,0,135000,1262,107
"22184","64380","2019",2,2,0,220250,1300,169.5
"22185","64381","2019",1,1,0,93000,1476,63
"22186","64382","2019",4,4,0,188500,1364,127.75
"22187","64383","2019",1,1,0,116250,1067,109
"22188","64385","2019",2,2,0,183700,1740.5,106.5
"22189","64386","2019",17,16,1,162858.764705882,1609.11764705882,102.294117647059
"22190","64387","2019",3,3,0,231766.666666667,1993.66666666667,117.666666666667
"22191","64389","2019",1,1,0,167000,1740,96
"22192","64390","2019",1,1,0,158000,790,200
"22193","64391","2019",5,5,0,182448,1328.8,140
"22194","64392","2019",2,2,0,131500,1030.5,128
"22195","64393","2019",38,35,3,182308.842105263,1482.21052631579,120.552631578947
"22196","64395","2019",2,2,0,131500,1064.5,130.5
"22197","64396","2019",11,11,0,147195.545454545,1376.09090909091,114.363636363636
"22198","64397","2019",4,4,0,123137.5,1221,114.75
"22199","64398","2019",8,8,0,142612.5,1192.25,116.125
"22200","64399","2019",24,24,0,267277.916666667,2256.25,119
"22201","64400","2019",8,8,0,135393.25,1146.25,126.5
"22202","64403","2019",4,4,0,150000,1291,115.75
"22203","64404","2019",2,2,0,74000,428,171
"22204","64405","2019",37,35,2,222738.378378378,1808.05405405405,125.189189189189
"22205","64406","2019",8,8,0,204749.375,1768.125,120.375
"22206","64407","2019",49,38,11,343638.265306122,3451.12244897959,101.530612244898
"22207","64409","2019",8,8,0,160562.5,1350.125,119.125
"22208","64410","2019",69,46,23,104359.52173913,1215.20289855072,85.3768115942029
"22209","64411","2019",3,3,0,104333.333333333,970.333333333333,107.333333333333
"22210","64412","2019",1,1,0,70000,833,84
"22211","64413","2019",12,11,1,190338.166666667,1977.16666666667,97
"22212","64415","2019",25,25,0,228688.48,1917.96,120.72
"22213","64416","2019",18,16,2,200321.5,1550.11111111111,140.666666666667
"22214","64417","2019",41,29,12,147095.609756098,1503.78048780488,100.80487804878
"22215","64419","2019",20,18,2,186577.4,1649.15,111.25
"22216","64420","2019",2,2,0,182500,1289.5,137.5
"22217","64421","2019",6,6,0,148603.5,1502.66666666667,103.166666666667
"22218","64422","2019",186,101,85,102079.037634409,1247.0376344086,86.7688172043011
"22219","64423","2019",1,1,0,92000,1095,84
"22220","64424","2019",2,2,0,103330,1125.5,103
"22221","64425","2019",3,2,1,155932,1197.66666666667,119.333333333333
"22222","64426","2019",3,3,0,113666.666666667,1286,91.3333333333333
"22223","64427","2019",1,1,0,263000,1547,170
"22224","64428","2019",1,1,0,145000,1115,130
"22225","64430","2019",176,93,83,115682.8125,1337.4375,87.6363636363636
"22226","64431","2019",3,3,0,183833.333333333,1740,106
"22227","64432","2019",1,1,0,145000,967,150
"22228","64433","2019",1,1,0,205000,1507,136
"22229","64434","2019",1,1,0,108000,991,109
"22230","64435","2019",1,1,0,47000,547,86
"22231","64436","2019",5,5,0,281890,2246.8,129.8
"22232","64437","2019",2,1,1,108000,1052,108
"22233","64438","2019",4,4,0,190625,1506,127
"22234","64439","2019",22,22,0,224544.454545455,1922.40909090909,118.727272727273
"22235","64440","2019",3,3,0,230333.333333333,1705.66666666667,133.333333333333
"22236","64441","2019",1,1,0,141021,893,158
"22237","64443","2019",15,15,0,164087.866666667,1562.06666666667,106.666666666667
"22238","64444","2019",3,3,0,164166.666666667,1766,103
"22239","64445","2019",2017,283,1734,119411.842340109,1747.41249380268,68.2825979176995
"22240","64446","2019",1,1,0,175050,1137,154
"22241","64448","2019",18,18,0,226071.666666667,2132.55555555556,109.611111111111
"22242","64449","2019",1,1,0,155000,1069,145
"22243","64450","2019",1,1,0,226132,1809,125
"22244","64452","2019",5,5,0,154740,1197,130
"22245","64453","2019",21,19,2,129860.714285714,1256.04761904762,106.809523809524
"22246","64454","2019",1,1,0,199000,1809,110
"22247","64455","2019",5,5,0,105500,1198,92.2
"22248","64457","2019",1,1,0,82500,1269,65
"22249","64458","2019",1,1,0,120000,1519,79
"22250","64459","2019",1,1,0,119000,856,139
"22251","64460","2019",3,3,0,152086.333333333,1057,141
"22252","64461","2019",16,16,0,168469.25,1433.5625,125.5
"22253","64462","2019",3,3,0,215373.333333333,2279.33333333333,102.333333333333
"22254","64463","2019",7,7,0,151757.142857143,1454.85714285714,117.714285714286
"22255","64465","2019",1,1,0,251000,2510,100
"22256","64466","2019",2,2,0,87775,987,100.5
"22257","64467","2019",9,8,1,159372.222222222,1682,98.8888888888889
"22258","64469","2019",2,2,0,192500,1386.5,149.5
"22259","64471","2019",9,9,0,138305.555555556,1151,123
"22260","64472","2019",6,6,0,238866.666666667,1860.16666666667,142.5
"22261","64473","2019",2,2,0,151000,1011,149
"22262","64474","2019",1,1,0,122000,871,140
"22263","64475","2019",2,2,0,57500,729,78
"22264","64476","2019",4,4,0,233271.5,2299.75,107.25
"22265","64477","2019",6,6,0,172760.833333333,1486.16666666667,122.333333333333
"22266","64478","2019",5,5,0,164250,1530,112.4
"22267","64480","2019",2,2,0,95000,1388,68
"22268","64482","2019",6,6,0,172200,1676.16666666667,108
"22269","64483","2019",360,60,300,379118.230555556,5378.05833333333,69.7611111111111
"22270","64484","2019",4,3,1,189770,1477.25,129
"22271","64485","2019",10,4,6,142908.8,2139.7,74.2
"22272","64487","2019",3,3,0,116666.666666667,1391.66666666667,100.333333333333
"22273","64488","2019",3,3,0,224779.333333333,1646,136.666666666667
"22274","64490","2019",6,6,0,239100,1618.66666666667,142
"22275","64491","2019",1,1,0,130000,909,143
"22276","64493","2019",25,17,8,154286,1765.24,101.36
"22277","64494","2019",3,3,0,153300,1721.33333333333,93
"22278","64495","2019",39,12,27,223514.333333333,2867.28205128205,78.974358974359
"22279","64496","2019",73,36,37,276259.02739726,3208.04109589041,86.027397260274
"22280","64498","2019",3,3,0,101666.666666667,857,113
"22281","64499","2019",93,75,18,159430.322580645,1588.98924731183,103.301075268817
"22282","64500","2019",3,3,0,205560,1357,166.333333333333
"22283","64501","2019",4,4,0,124325,1106.75,109.75
"22284","64502","2019",10,10,0,131945,1565.2,76.3
"22285","64503","2019",2,2,0,308000,1925,152.5
"22286","64504","2019",20,11,9,300819.5,3251.4,92.3
"22287","64505","2019",3,3,0,152333.333333333,1623.66666666667,110.666666666667
"22288","64506","2019",3,3,0,96200,933,98.3333333333333
"22289","64507","2019",3,3,0,170516.666666667,1409.66666666667,124
"22290","64509","2019",3,3,0,104458.333333333,905,116
"22291","64510","2019",12,12,0,144500,1462.33333333333,98.9166666666667
"22292","64511","2019",41,40,1,230605.682926829,1832.80487804878,128.243902439024
"22293","64512","2019",6,6,0,125833.333333333,1173,113.5
"22294","64513","2019",17,15,2,149390.294117647,1414.47058823529,111.882352941176
"22295","64515","2019",3,3,0,184863.333333333,1888,97.3333333333333
"22296","64516","2019",2,2,0,177000,1234,151
"22297","64518","2019",15,15,0,248330.666666667,1935.2,136
"22298","64519","2019",48,46,2,238241.020833333,2164.9375,109.875
"22299","64520","2019",3,3,0,323916.666666667,2237.66666666667,147.666666666667
"22300","64521","2019",6,6,0,169225.5,1385.66666666667,126.333333333333
"22301","64522","2019",2,2,0,113500,1031,107
"22302","64523","2019",6,6,0,182188.333333333,1563.5,126.166666666667
"22303","64524","2019",7,7,0,130857.142857143,1466.85714285714,88.4285714285714
"22304","64525","2019",4,4,0,226729.75,1893.75,120.75
"22305","64526","2019",25,24,1,198137.2,1772.84,115.36
"22306","64527","2019",9,4,5,179333.333333333,2536.88888888889,72.4444444444444
"22307","64528","2019",1,1,0,352000,3259,108
"22308","64529","2019",2,2,0,95000,1555,63.5
"22309","64530","2019",1,1,0,214770,1368,157
"22310","64532","2019",1,1,0,87000,544,160
"22311","64533","2019",7,7,0,111028.571428571,1118.42857142857,115
"22312","64535","2019",3,3,0,125500,1295.66666666667,100
"22313","64536","2019",11,11,0,199971.818181818,1574.90909090909,127.727272727273
"22314","64537","2019",2,2,0,56500,1159.5,48.5
"22315","64538","2019",17,6,11,120555.941176471,2278.23529411765,54.7647058823529
"22316","64539","2019",1,1,0,223500,2829,79
"22317","64540","2019",31,23,8,280552.548387097,2718.83870967742,106.645161290323
"22318","64541","2019",2,2,0,164144.5,1327,120.5
"22319","64542","2019",4,4,0,88287.5,1109,90.5
"22320","64543","2019",1,1,0,70000,560,125
"22321","64544","2019",2,2,0,235000,1599.5,148
"22322","64545","2019",150,67,83,360681.386666667,3789.43333333333,93.4333333333333
"22323","64546","2019",42,34,8,286986.285714286,2604.7380952381,116.547619047619
"22324","64547","2019",97,47,50,266787.742268041,3029.29896907217,90.7319587628866
"22325","64548","2019",1,1,0,226600,1295,175
"22326","64549","2019",12,12,0,214357.25,1964.33333333333,110.75
"22327","64550","2019",8,8,0,219187.5,1889.75,112.25
"22328","64554","2019",2,2,0,136525,986,129
"22329","64555","2019",3,3,0,143833.333333333,1233.66666666667,116
"22330","64556","2019",3,3,0,171666.666666667,1163.33333333333,143.333333333333
"22331","64557","2019",5,5,0,181120,1701.4,107.2
"22332","64558","2019",24,19,5,377281.166666667,2864.04166666667,130
"22333","64559","2019",6,6,0,142500,1115.66666666667,133
"22334","64560","2019",3,3,0,174900,1425.66666666667,123.666666666667
"22335","65001","2019",3,3,0,182333.333333333,1974.66666666667,93
"22336","65002","2019",10,8,2,150488.5,1491.6,97.2
"22337","65003","2019",5,1,4,37400,981.6,40.8
"22338","65004","2019",7,5,2,128591.714285714,1211.28571428571,111
"22339","65005","2019",3,3,0,199380,1458.33333333333,135.333333333333
"22340","65006","2019",5,5,0,145908,2043.4,71.2
"22341","65007","2019",25,25,0,165024.4,1574.04,108.12
"22342","65011","2019",1,1,0,118100,1712,69
"22343","65012","2019",1,1,0,105000,1207,87
"22344","65014","2019",1,1,0,1e+05,1053,95
"22345","65016","2019",1,1,0,240000,2143,112
"22346","65017","2019",32,3,29,67511.34375,1818.15625,36.53125
"22347","65018","2019",3,3,0,154233.333333333,1890.66666666667,78.6666666666667
"22348","65019","2019",7,7,0,206714.285714286,1633.57142857143,138
"22349","65020","2019",1,1,0,187450,1874,100
"22350","65021","2019",5,5,0,239898,1822.8,136.6
"22351","65022","2019",2,2,0,135077,1489.5,127.5
"22352","65024","2019",1,1,0,111000,1442,77
"22353","65025","2019",58,24,34,140842.931034483,1980.3275862069,77.7586206896552
"22354","65029","2019",8,8,0,177233.75,1868.5,93.125
"22355","65031","2019",23,11,12,109697.608695652,1578.78260869565,75.1739130434783
"22356","65032","2019",16,14,2,149368.75,1695.9375,96
"22357","65033","2019",3,3,0,103638.333333333,979.666666666667,88.3333333333333
"22358","65034","2019",1,1,0,137000,2015,68
"22359","65035","2019",6,6,0,132598,1118.83333333333,122.666666666667
"22360","65036","2019",2,1,1,228934.5,2155.5,114
"22361","65039","2019",3,3,0,63050,1018.66666666667,65
"22362","65040","2019",1,1,0,228100,1629,140
"22363","65041","2019",1,1,0,175000,1215,144
"22364","65042","2019",10,10,0,156445,1406.3,117.7
"22365","65044","2019",6,6,0,182100,1477.33333333333,121.666666666667
"22366","65045","2019",11,9,2,151434.272727273,2156.09090909091,74.1818181818182
"22367","65046","2019",2,2,0,207175,1733,116
"22368","65047","2019",99,69,30,120788.737373737,1469.18181818182,87.8888888888889
"22369","65048","2019",6,6,0,161363.833333333,1536.33333333333,105
"22370","65049","2019",3,3,0,175500,1848.33333333333,117
"22371","65051","2019",3,3,0,113833.333333333,1071.66666666667,101.333333333333
"22372","65052","2019",1,1,0,23000,371,62
"22373","65053","2019",2,2,0,94600,1160,81
"22374","65054","2019",5,5,0,82100,1085,79.2
"22375","65055","2019",2,0,2,94000,1908.5,48.5
"22376","65056","2019",1,1,0,456000,2214,206
"22377","65057","2019",4,4,0,186314.25,1721.75,105.25
"22378","65058","2019",1,1,0,317380,1856,171
"22379","65059","2019",204,54,150,92470.3823529412,1702.14705882353,59.328431372549
"22380","65060","2019",4,4,0,84125,804.5,107.75
"22381","65062","2019",32,32,0,150270.875,1529.5,99.28125
"22382","65064","2019",3,3,0,185606.666666667,1531.66666666667,130
"22383","65065","2019",2,2,0,123375,1140,114
"22384","65066","2019",1,1,0,165000,1162,142
"22385","65069","2019",12,12,0,145630.833333333,1413.58333333333,108.416666666667
"22386","65070","2019",6,6,0,241883.333333333,1688,139.666666666667
"22387","65071","2019",1,1,0,155000,1845,84
"22388","65072","2019",18,18,0,156251.666666667,1630.38888888889,97.7777777777778
"22389","65073","2019",1,1,0,185000,634,292
"22390","65074","2019",2,2,0,155350,1102,141
"22391","65075","2019",1,1,0,145000,1422,102
"22392","65077","2019",3,3,0,221500,2469.33333333333,89.6666666666667
"22393","65078","2019",6,5,1,110250,1144.66666666667,95.3333333333333
"22394","65079","2019",2,2,0,129000,1557.5,82.5
"22395","65081","2019",1,1,0,230000,1855,124
"22396","65082","2019",1,1,0,124500,1046,119
"22397","65083","2019",4,4,0,188162.5,1476.75,132.25
"22398","65085","2019",3,3,0,182700,1445.66666666667,125.333333333333
"22399","65087","2019",1,1,0,160000,1758,91
"22400","65088","2019",1,1,0,66000,943,70
"22401","65090","2019",1,1,0,112000,438,256
"22402","65092","2019",5,5,0,133820,1691.4,79.4
"22403","65093","2019",2,2,0,64000,438,144
"22404","65094","2019",3,3,0,134833.333333333,1449.33333333333,116.333333333333
"22405","65095","2019",1,1,0,45000,643,70
"22406","65096","2019",1,1,0,101870,1273,80
"22407","65097","2019",1,1,0,120000,736,163
"22408","65098","2019",2,2,0,179500,2167,84
"22409","65099","2019",5,1,4,134100.2,2252.4,70.2
"22410","65100","2019",51,46,5,144360.098039216,1506.66666666667,100.098039215686
"22411","65101","2019",10,10,0,143725,1317.2,110
"22412","65104","2019",3,3,0,250833.333333333,2071.66666666667,122
"22413","65105","2019",2,2,0,88490,924.5,93
"22414","65106","2019",7,4,3,189344.285714286,2630.71428571429,93.2857142857143
"22415","65107","2019",1,1,0,282500,2140,132
"22416","65108","2019",8,8,0,195993.75,1588.75,138.875
"22417","65109","2019",1,1,0,144240,1826,79
"22418","65110","2019",1,1,0,166930,1855,90
"22419","65111","2019",2,2,0,115625,1006,121
"22420","65112","2019",4,4,0,193375,1915,109.75
"22421","65113","2019",4,4,0,127100,1818.5,81.25
"22422","65114","2019",4,4,0,88375,853.5,109
"22423","65115","2019",5,5,0,178100,1478.8,118.6
"22424","65116","2019",6,5,1,114416.666666667,1446.83333333333,83.3333333333333
"22425","65117","2019",1,1,0,194000,2230,87
"22426","65118","2019",1,1,0,93060,2585,36
"22427","65119","2019",5,5,0,139830,991.8,154.8
"22428","65120","2019",8,8,0,183133,1484.875,125.625
"22429","65121","2019",4,4,0,106300,1126.25,90.5
"22430","65123","2019",59,41,18,116571.084745763,1635.52542372881,81.4745762711864
"22431","65125","2019",4,4,0,96750,1268.5,90.25
"22432","65126","2019",3,3,0,138666.666666667,1088,118.333333333333
"22433","65127","2019",32,21,11,103398.4375,1310.53125,79.90625
"22434","65129","2019",6,5,1,129583.333333333,1426.5,87.6666666666667
"22435","65130","2019",10,10,0,118823.5,964.1,124
"22436","65131","2019",5,5,0,174980,1164.2,151.2
"22437","65133","2019",5,5,0,137051.8,1323.8,111.6
"22438","65137","2019",1,1,0,127000,694,183
"22439","65138","2019",225,16,209,90171.3066666667,2564.16444444444,35.6755555555556
"22440","65140","2019",1,1,0,3e+05,4000,75
"22441","65142","2019",3,3,0,151003.333333333,1092,136
"22442","65143","2019",3,3,0,59000,812.666666666667,83.6666666666667
"22443","65144","2019",2,2,0,181000,2470.5,73.5
"22444","65145","2019",1,1,0,33700,784,43
"22445","65147","2019",4,4,0,188250,2193.25,87.25
"22446","65148","2019",1,1,0,255000,1821,140
"22447","65149","2019",1,1,0,80000,571,140
"22448","65150","2019",5,5,0,165580,1553.4,100
"22449","65151","2019",4,4,0,166937.5,1387.25,121.75
"22450","65154","2019",1,1,0,105000,2100,50
"22451","65156","2019",3,3,0,136666.666666667,1283.33333333333,109.666666666667
"22452","65158","2019",1,1,0,25000,532,47
"22453","65159","2019",3,3,0,146666.666666667,1638.33333333333,92.3333333333333
"22454","65161","2019",2,2,0,122200,1045,116
"22455","65162","2019",2,2,0,155000,1653,94
"22456","65165","2019",6,6,0,168550.833333333,2109.66666666667,94.5
"22457","65166","2019",1,1,0,130000,1182,110
"22458","65168","2019",26,10,16,122294.384615385,2405.80769230769,55.1923076923077
"22459","65169","2019",1,1,0,65000,433,150
"22460","65170","2019",2,2,0,139750,1058.5,136
"22461","65172","2019",3,3,0,157333.333333333,2156.33333333333,73.3333333333333
"22462","65173","2019",9,5,4,110177.777777778,2031.11111111111,63.8888888888889
"22463","65174","2019",2,2,0,141875,916,163.5
"22464","65175","2019",3,3,0,68083.3333333333,1151.33333333333,61
"22465","65176","2019",2,2,0,122350,1702.5,89.5
"22466","65177","2019",1,1,0,160000,1280,125
"22467","65181","2019",2,2,0,203000,1677.5,121
"22468","65182","2019",2,2,0,225500,1965,115
"22469","65183","2019",4,4,0,66750,711,113.25
"22470","65184","2019",2,2,0,125500,1467.5,93
"22471","65185","2019",2,2,0,176000,1236.5,142.5
"22472","65186","2019",1,1,0,185500,1496,124
"22473","65189","2019",3,3,0,143833.333333333,1122.66666666667,121.666666666667
"22474","65190","2019",1,1,0,172000,2915,59
"22475","65191","2019",6,6,0,141016.666666667,1661.66666666667,92.8333333333333
"22476","65192","2019",11,6,5,103337.454545455,1752.27272727273,65.6363636363636
"22477","65193","2019",1,1,0,88000,1100,80
"22478","65195","2019",3,2,1,106333.333333333,2637,42.6666666666667
"22479","65197","2019",4,4,0,198750,1503.5,140.25
"22480","65198","2019",13,13,0,145545.461538462,1398.15384615385,109.923076923077
"22481","65199","2019",24,0,24,98499.5833333333,2159.33333333333,44.75
"22482","65200","2019",5,5,0,156314,1728.8,89.6
"22483","65202","2019",2,1,1,150400,1707,89.5
"22484","65206","2019",2,2,0,131750,936,141.5
"22485","65207","2019",2,2,0,146051,1711.5,93.5
"22486","65208","2019",1,1,0,4e+05,2857,140
"22487","65210","2019",2,2,0,194500,2583,81.5
"22488","65211","2019",3,3,0,256666.666666667,2150,121
"22489","65212","2019",7,3,4,115142.857142857,1576.57142857143,69.4285714285714
"22490","65213","2019",4,4,0,215650,1195.75,177
"22491","65215","2019",1,1,0,80500,706,114
"22492","65216","2019",2,2,0,202012.5,2520,97.5
"22493","65217","2019",2,2,0,172500,1635.5,107
"22494","65218","2019",10,10,0,124565,1255.7,100
"22495","65220","2019",4,4,0,204087.5,1343.75,152.75
"22496","65221","2019",3,3,0,271333.333333333,2043.66666666667,125.666666666667
"22497","65222","2019",1,1,0,256000,2133,120
"22498","65223","2019",14,14,0,268843.571428571,2167.92857142857,129.928571428571
"22499","65224","2019",4,4,0,95350,1176,80.75
"22500","65226","2019",32,29,3,191453.53125,2002.78125,100.71875
"22501","65228","2019",2,2,0,42500,431,97
"22502","65230","2019",2,2,0,185040,1750,101.5
"22503","65231","2019",1,1,0,88500,1196,74
"22504","65232","2019",1,1,0,209000,1817,115
"22505","65233","2019",2,2,0,173902.5,1089.5,160.5
"22506","65234","2019",2,1,1,149750,2563,69
"22507","65235","2019",29,29,0,184100.655172414,1762.93103448276,107.448275862069
"22508","65236","2019",3,3,0,189000,1333,142.666666666667
"22509","65237","2019",1,1,0,40000,476,84
"22510","65238","2019",7,7,0,172478.571428571,2080.14285714286,76.5714285714286
"22511","65239","2019",3,3,0,108333.333333333,1406.66666666667,128
"22512","65240","2019",3,3,0,90000,646.333333333333,167.333333333333
"22513","65241","2019",3,3,0,124766.666666667,1498,92
"22514","65242","2019",3,3,0,121360.333333333,1056,126
"22515","65243","2019",7,7,0,136328.571428571,1223.57142857143,115.571428571429
"22516","65244","2019",4,4,0,199375,1576.25,128.5
"22517","65245","2019",3,3,0,151241.666666667,1258.33333333333,116.333333333333
"22518","65247","2019",3,3,0,150933.333333333,2245.66666666667,102
"22519","65248","2019",2,2,0,220275,1480,149
"22520","65249","2019",1,1,0,188545,1571,120
"22521","65251","2019",20,16,4,137621.5,1508.15,93.65
"22522","65252","2019",10,10,0,162197,1624.3,111.4
"22523","65254","2019",3,3,0,129933.333333333,1310.66666666667,95.3333333333333
"22524","65256","2019",1,1,0,130000,1102,118
"22525","65257","2019",4,4,0,229237.5,1779.75,139.5
"22526","65258","2019",81,62,19,101241.259259259,1282.59259259259,87.7160493827161
"22527","65259","2019",2,2,0,147300,1370,117
"22528","65260","2019",1,1,0,141000,1424,99
"22529","65261","2019",2,2,0,204000,1536,132
"22530","65262","2019",6,6,0,117472,1006.5,121.166666666667
"22531","65263","2019",1,1,0,240000,2143,112
"22532","65264","2019",1,1,0,83000,638,130
"22533","65265","2019",3,3,0,217688.333333333,1171.33333333333,168.666666666667
"22534","65267","2019",5,5,0,164240,1676.8,99.6
"22535","65268","2019",2,2,0,219150,1591.5,138
"22536","65269","2019",1,1,0,166000,1804,92
"22537","65271","2019",1,1,0,361000,1604,225
"22538","65272","2019",1,1,0,275000,1058,260
"22539","65274","2019",1,1,0,180000,1091,165
"22540","65276","2019",1,1,0,180350,2173,83
"22541","65277","2019",1,1,0,125000,1389,90
"22542","65278","2019",1,1,0,70000,1111,63
"22543","65279","2019",7,6,1,126856.428571429,2327.85714285714,97.7142857142857
"22544","65280","2019",3,3,0,185666.666666667,1126.33333333333,171.333333333333
"22545","65281","2019",6,6,0,167725,1362.66666666667,125.833333333333
"22546","65282","2019",3,3,0,267050,2178.66666666667,124.666666666667
"22547","65283","2019",1,1,0,270000,2411,112
"22548","65284","2019",6,6,0,227383.333333333,1864,120
"22549","65285","2019",1,1,0,155000,1632,95
"22550","65286","2019",239,92,147,93410,1162.16736401674,83.2887029288703
"22551","65287","2019",7,7,0,89000,948.571428571429,97
"22552","65288","2019",2,2,0,96500,1077.5,89.5
"22553","65289","2019",1,1,0,216000,1785,121
"22554","65290","2019",1,1,0,129000,2150,60
"22555","65291","2019",3,3,0,115000,1111.33333333333,100.333333333333
"22556","65292","2019",4,4,0,140500,1342.75,102.25
"22557","65294","2019",2,2,0,174150,1336,135
"22558","65295","2019",59,11,48,90140.5084745763,1985.03389830508,48.6440677966102
"22559","65296","2019",5,5,0,148250,1161.2,110.2
"22560","65297","2019",1,1,0,60000,600,100
"22561","65298","2019",1,1,0,257000,1016,253
"22562","65299","2019",3,3,0,86160,1059.66666666667,82.3333333333333
"22563","65300","2019",2,2,0,202687.5,1628,121.5
"22564","65301","2019",4,4,0,157061.25,1502.5,104
"22565","65303","2019",4,4,0,231075,1911.75,121
"22566","65304","2019",31,31,0,112306.451612903,1078.32258064516,110.548387096774
"22567","65305","2019",4,4,0,90437.5,897.25,100
"22568","65307","2019",4,4,0,113750,1010.5,123
"22569","65308","2019",3,3,0,113500,925.666666666667,122
"22570","65310","2019",3,3,0,165641.333333333,1477,112
"22571","65311","2019",2,2,0,227125.5,1269,175.5
"22572","65313","2019",4,4,0,163150,1468.75,111.25
"22573","65314","2019",3,3,0,204200,1302.66666666667,141.666666666667
"22574","65315","2019",9,9,0,103777.777777778,895.666666666667,109.777777777778
"22575","65316","2019",2,2,0,58000,525.5,112.5
"22576","65319","2019",2,2,0,61750,780.5,76
"22577","65320","2019",6,6,0,182416.666666667,1463.16666666667,138.333333333333
"22578","65321","2019",1,1,0,176100,1935,91
"22579","65323","2019",1,1,0,70000,1186,59
"22580","65324","2019",3,3,0,159166.666666667,1164.33333333333,139.333333333333
"22581","65325","2019",1,1,0,246085,1282,192
"22582","65327","2019",6,6,0,99300,785,134.666666666667
"22583","65328","2019",3,3,0,186263.333333333,1688.33333333333,137.333333333333
"22584","65329","2019",4,4,0,109125,1308.75,82.25
"22585","65330","2019",2,2,0,182750,1852,98.5
"22586","65331","2019",36,36,0,176468.416666667,1529.86111111111,119.527777777778
"22587","65332","2019",2,2,0,203500,1429,161
"22588","65333","2019",1,1,0,180000,1636,110
"22589","65334","2019",1,1,0,265000,1893,140
"22590","65335","2019",4,4,0,205750,1990.5,112.5
"22591","65336","2019",1,1,0,65000,722,90
"22592","65338","2019",1,1,0,232500,1062,219
"22593","65340","2019",19,18,1,167536.842105263,1612.15789473684,105.421052631579
"22594","65341","2019",2,2,0,142600,1184,112.5
"22595","65342","2019",1,1,0,164000,1547,106
"22596","65343","2019",1,1,0,82000,1000,82
"22597","65344","2019",29,29,0,146806.379310345,1493.44827586207,103.758620689655
"22598","65346","2019",1,1,0,160000,2078,77
"22599","65347","2019",1,1,0,120000,1538,78
"22600","65348","2019",1,1,0,41000,586,70
"22601","65350","2019",14,14,0,209592.857142857,1688.28571428571,127.785714285714
"22602","65351","2019",1,1,0,155000,1107,140
"22603","65356","2019",1,1,0,95000,1583,60
"22604","65357","2019",3,3,0,150333.333333333,964,144.666666666667
"22605","65358","2019",2,2,0,175000,1184.5,142.5
"22606","65360","2019",4,4,0,181840,1675.75,107.5
"22607","65361","2019",1,1,0,137000,1202,114
"22608","65362","2019",18,12,6,159233.333333333,1718.94444444444,92.0555555555556
"22609","65363","2019",2,2,0,120000,1357,90.5
"22610","65366","2019",8,7,1,106168.75,1377.25,84.125
"22611","65367","2019",1,1,0,191630,1666,115
"22612","65369","2019",6,6,0,222125,1641,138.833333333333
"22613","65370","2019",8,8,0,144827.5,1612.5,98.25
"22614","65371","2019",2,2,0,73750,705,107.5
"22615","65372","2019",7,7,0,156357.142857143,1206.28571428571,133.285714285714
"22616","65373","2019",3,3,0,116000,917,124
"22617","65374","2019",2,2,0,241797.5,1063,228
"22618","65375","2019",18,17,1,117196.333333333,1221.55555555556,109
"22619","65376","2019",2,2,0,170200,1387.5,107.5
"22620","65377","2019",4,4,0,206250,1404.5,150
"22621","65380","2019",2,2,0,171500,1301.5,130.5
"22622","65382","2019",3,3,0,70973.3333333333,943.333333333333,69.3333333333333
"22623","65383","2019",1,1,0,216095,1441,150
"22624","65384","2019",3,3,0,221246.666666667,3097.33333333333,82.3333333333333
"22625","65387","2019",4,4,0,100250,832,122
"22626","65388","2019",187,9,178,107127.299465241,2620,40.1978609625668
"22627","65389","2019",11,11,0,116813.636363636,1227.72727272727,95.9090909090909
"22628","65390","2019",6,6,0,126875,1047,120.333333333333
"22629","65391","2019",1,1,0,191100,1911,100
"22630","65392","2019",4,4,0,246753.25,1958,146
"22631","65393","2019",3,3,0,138983.333333333,2168,68.6666666666667
"22632","65394","2019",6,6,0,114858.166666667,1174.16666666667,96.3333333333333
"22633","65395","2019",10,8,2,117555,1086.2,113.4
"22634","65396","2019",5,3,2,155500,3041.4,66
"22635","65397","2019",2,2,0,65316.5,573.5,130
"22636","65398","2019",11,11,0,118304.454545455,1311.81818181818,96.9090909090909
"22637","65399","2019",2,1,1,102000,2514,41
"22638","65400","2019",2,2,0,147500,1318.5,121.5
"22639","65401","2019",2,2,0,97500,1110.5,85.5
"22640","65403","2019",1,1,0,190000,1652,115
"22641","65404","2019",2,2,0,162000,1774,95
"22642","65406","2019",3,3,0,113433.333333333,1058,100.666666666667
"22643","65407","2019",1,1,0,132000,1065,124
"22644","65408","2019",7,6,1,105821.428571429,1158.42857142857,99.5714285714286
"22645","65409","2019",5,5,0,102860,1013.8,102.6
"22646","65410","2019",1,1,0,190700,1149,166
"22647","65412","2019",4,4,0,149475,1216.5,127.5
"22648","65413","2019",6,5,1,129409.166666667,2104.83333333333,67.5
"22649","65415","2019",5,5,0,156822,2158,85.4
"22650","65417","2019",64,58,6,138419.90625,1609.078125,88.46875
"22651","65418","2019",2,2,0,127038,1113.5,113
"22652","65419","2019",2,2,0,115000,955.5,117.5
"22653","65422","2019",1,1,0,210000,1500,140
"22654","65423","2019",1,1,0,204000,1774,115
"22655","65425","2019",6,6,0,132483.333333333,1473.83333333333,93.6666666666667
"22656","65427","2019",2,2,0,83000,1148.5,76
"22657","65428","2019",1,1,0,144000,1200,120
"22658","65429","2019",3,3,0,106000,1178.33333333333,93.3333333333333
"22659","65430","2019",1,1,0,188000,1039,181
"22660","65431","2019",2,2,0,63500,653,95
"22661","65432","2019",1,1,0,54500,1009,54
"22662","65433","2019",31,25,6,131541.290322581,1500.77419354839,87.258064516129
"22663","65435","2019",5,5,0,80146,1705.4,63
"22664","65436","2019",3,3,0,233833.333333333,2144,106.333333333333
"22665","65437","2019",4,4,0,69300,793.75,90.75
"22666","65439","2019",2,2,0,166300,1235,135.5
"22667","65440","2019",800,221,579,95203.32375,1304.795,73.4575
"22668","65441","2019",4,4,0,116462.5,1574.75,79
"22669","65442","2019",5,5,0,149800,1641.2,113.4
"22670","65444","2019",4,4,0,126562.5,850.75,154.25
"22671","65445","2019",1,1,0,175000,1636,107
"22672","65446","2019",2,2,0,128750,1059.5,131.5
"22673","65447","2019",13,13,0,150835.769230769,1547.38461538462,98.3076923076923
"22674","65448","2019",1,1,0,160000,2133,75
"22675","65449","2019",1,1,0,68000,496,137
"22676","65450","2019",4,4,0,125500,2314.5,85.75
"22677","65451","2019",10,9,1,145951,1661.2,98.2
"22678","65452","2019",8,8,0,124375,1045.625,147.75
"22679","65453","2019",1,1,0,65000,929,70
"22680","65455","2019",4,4,0,162850,1110.25,161
"22681","65460","2019",62,52,10,115928.790322581,1305.43548387097,95.6935483870968
"22682","65461","2019",1,1,0,138000,939,147
"22683","65462","2019",2,2,0,132000,1320,99
"22684","65463","2019",3,3,0,150386.666666667,2928.33333333333,50.6666666666667
"22685","65464","2019",2,2,0,199935,2163.5,93.5
"22686","65465","2019",28,7,21,143644.642857143,2541.53571428571,55.2142857142857
"22687","65466","2019",1,1,0,266000,3205,83
"22688","65467","2019",3,3,0,197333.333333333,2031,100.333333333333
"22689","65469","2019",2,2,0,143500,2720,53
"22690","65470","2019",2,2,0,183750,2178,82
"22691","65471","2019",19,8,11,162675.789473684,3252.42105263158,50.3684210526316
"22692","65473","2019",7,7,0,178357.142857143,1907.71428571429,104.857142857143
"22693","65476","2019",1,1,0,215000,2108,102
"22694","65478","2019",1,1,0,110000,1222,90
"22695","65479","2019",2,2,0,166000,1527,113.5
"22696","65481","2019",15,0,15,82176.6666666667,2761.06666666667,28.2666666666667
"22697","65482","2019",4,4,0,113687.5,776.25,156.25
"22698","66002","2019",62,54,8,222434.016129032,2275.72580645161,101.193548387097
"22699","66003","2019",202,27,175,72075.2722772277,1325.68811881188,51.8069306930693
"22700","66004","2019",130,19,111,89082.2230769231,2215.29230769231,38.0615384615385
"22701","66005","2019",7,6,1,154428.571428571,2003.57142857143,78.8571428571429
"22702","66006","2019",1,0,1,42900,660,65
"22703","66007","2019",4,4,0,91532.5,1049.25,83.75
"22704","66008","2019",437,163,274,150216.185354691,2844.74828375286,56.279176201373
"22705","66009","2019",46,37,9,167030,1898.5652173913,90.3260869565217
"22706","66011","2019",61,59,2,193667.31147541,1977.40983606557,100.131147540984
"22707","66012","2019",51,43,8,179282.549019608,1897.90196078431,94.7254901960784
"22708","66013","2019",5,5,0,100913.6,1476.4,66.2
"22709","66014","2019",49,48,1,123629.918367347,1436.87755102041,85.9183673469388
"22710","66015","2019",28,26,2,144739.642857143,1628.10714285714,88.4642857142857
"22711","66016","2019",115,38,77,172281.139130435,2769.81739130435,63.9652173913043
"22712","66017","2019",542,127,415,101266.669741697,2728.70664206642,37.479704797048
"22713","66018","2019",2,2,0,148540,1712,72.5
"22714","66019","2019",1,1,0,59900,998,60
"22715","66020","2019",116,37,79,115051.137931034,2499.52586206897,44.9568965517241
"22716","66021","2019",82,78,4,199613.182926829,2002.12195121951,101.292682926829
"22717","66023","2019",21,20,1,117000.952380952,1429.04761904762,77.7142857142857
"22718","66024","2019",97,66,31,147405.773195876,1871.92783505155,78.5567010309278
"22719","66025","2019",24,8,16,139500.791666667,2080.33333333333,70.625
"22720","66026","2019",29,28,1,229927.793103448,2180.24137931034,102.551724137931
"22721","66027","2019",7,7,0,196855,2446.85714285714,87
"22722","66028","2019",125,108,17,233184.704,2198.664,106.264
"22723","66029","2019",1,1,0,270000,1525,177
"22724","66030","2019",2,1,1,121000,1217.5,102
"22725","66033","2019",6,6,0,248916.666666667,2221.33333333333,99.1666666666667
"22726","66034","2019",4,4,0,52375,802.5,68.5
"22727","66036","2019",2,2,0,98500,2033.5,42.5
"22728","66037","2019",574,161,413,157660.111498258,3048.51045296167,53.2526132404181
"22729","66038","2019",116,111,5,204833.706896552,1983.34482758621,103.887931034483
"22730","66039","2019",3,3,0,63833.3333333333,792.666666666667,80
"22731","66041","2019",15,15,0,157408.666666667,1794.2,86.4666666666667
"22732","66042","2019",10,10,0,117250,1346.2,86.8
"22733","66043","2019",4,4,0,98500,1127.5,83.25
"22734","66044","2019",2,2,0,91000,1007.5,71.5
"22735","66045","2019",6,6,0,144416.666666667,2002.66666666667,81.6666666666667
"22736","66046","2019",18,18,0,109254.444444444,1039.88888888889,109.611111111111
"22737","66047","2019",2,2,0,98612.5,1689,56.5
"22738","66048","2019",32,10,22,126150.3125,2278.53125,61.40625
"22739","66049","2019",137,104,33,205313.094890511,2270.97080291971,92.4671532846715
"22740","66050","2019",67,62,5,171587.373134328,1826.92537313433,93.1641791044776
"22741","66051","2019",3,3,0,213700,2366.33333333333,102
"22742","66052","2019",7,6,1,110594.285714286,1006.57142857143,106.571428571429
"22743","66053","2019",103,17,86,226679.805825243,4230.77669902913,58.2038834951456
"22744","66054","2019",1,1,0,138830,1543,90
"22745","66055","2019",11,11,0,189440.454545455,2109.81818181818,95.9090909090909
"22746","66056","2019",15,13,2,150390,1774.26666666667,85.6
"22747","66057","2019",7,7,0,159450,1659.14285714286,98.8571428571429
"22748","66058","2019",23,23,0,152751.217391304,1985.34782608696,86.8260869565217
"22749","66059","2019",74,68,6,146855.040540541,1473.31081081081,101.540540540541
"22750","66060","2019",6,6,0,270166.666666667,2092.33333333333,109.333333333333
"22751","66061","2019",4,4,0,66712.5,1005.5,58.75
"22752","66062","2019",4,2,2,169125,2726.25,63
"22753","66063","2019",10,10,0,263267.3,2262,119.7
"22754","66064","2019",6,3,3,198383.333333333,2322.5,76.6666666666667
"22755","66065","2019",129,102,27,155998.031007752,1978.08527131783,82.7209302325581
"22756","66066","2019",16,8,8,143382.9375,2104.0625,67.3125
"22757","66067","2019",16,9,7,152808.875,2338.3125,69.5625
"22758","66068","2019",1,1,0,70000,909,77
"22759","66069","2019",29,28,1,162339.344827586,1726.75862068966,93.0344827586207
"22760","66070","2019",6,6,0,180918.333333333,1578.16666666667,108.166666666667
"22761","66071","2019",46,42,4,133267.782608696,1586.73913043478,78.5217391304348
"22762","66072","2019",22,15,7,170235.909090909,2675,66.4545454545455
"22763","66073","2019",5,5,0,103000,1183.4,85.6
"22764","66074","2019",8,7,1,180968.75,2157.625,90.75
"22765","66075","2019",19,12,7,97762.1052631579,2223.84210526316,47.4210526315789
"22766","66076","2019",2,2,0,209500,1571,130
"22767","66078","2019",7,6,1,119052.857142857,1378.71428571429,82.5714285714286
"22768","66079","2019",4,4,0,214742.25,1988.75,113
"22769","66080","2019",6,6,0,70964.1666666667,1225.5,63
"22770","66081","2019",3,3,0,102666.666666667,1803.66666666667,56.6666666666667
"22771","66082","2019",28,16,12,154705.785714286,2269.39285714286,68.9285714285714
"22772","66083","2019",2,2,0,71500,1824.5,39.5
"22773","66084","2019",18,18,0,188016.666666667,1788.22222222222,109.277777777778
"22774","66085","2019",10,10,0,237000,1643.3,150.8
"22775","66088","2019",76,69,7,126264.802631579,1488.67105263158,87.4078947368421
"22776","66089","2019",4,4,0,61750,1002.5,65.25
"22777","66090","2019",2,2,0,130750,1060,104.5
"22778","66091","2019",2,1,1,25450,492,51
"22779","66092","2019",1,1,0,60280,563,107
"22780","66093","2019",53,52,1,287860.679245283,2707.77358490566,110.471698113208
"22781","66094","2019",49,48,1,231324.040816327,2389.55102040816,97.1836734693878
"22782","66095","2019",10,5,5,117600,1951.1,70.6
"22783","66096","2019",13,13,0,139942.307692308,1476,90.4615384615385
"22784","66097","2019",4,4,0,83550,906,93
"22785","66098","2019",3,2,1,185963.333333333,2960.66666666667,62.6666666666667
"22786","66099","2019",11,11,0,212909.090909091,1893.27272727273,113.818181818182
"22787","66101","2019",29,29,0,212328.103448276,2269.55172413793,94.4137931034483
"22788","66102","2019",1,1,0,109000,1730,63
"22789","66103","2019",9,8,1,121688,1585.22222222222,80.3333333333333
"22790","66104","2019",19,19,0,180728.947368421,1555.94736842105,122.157894736842
"22791","66105","2019",8,6,2,190196.25,2993.25,68.5
"22792","66106","2019",43,40,3,177305.534883721,1985.81395348837,90.3023255813954
"22793","66107","2019",21,21,0,71026.1904761905,763.190476190476,91.6666666666667
"22794","66108","2019",63,59,4,151394.365079365,1677.98412698413,90.6507936507936
"22795","66109","2019",2,2,0,161267.5,2592.5,62
"22796","66111","2019",2,2,0,98000,1368,85
"22797","66112","2019",4,4,0,306750,2343,132.25
"22798","66113","2019",3,3,0,199666.666666667,1592.66666666667,116.666666666667
"22799","66114","2019",20,20,0,231172,2161.05,100.75
"22800","66115","2019",41,39,2,253155.585365854,2086.56097560976,119.80487804878
"22801","66116","2019",4,4,0,222875,2543.25,94.25
"22802","66117","2019",4,1,3,66265,917.5,81.5
"22803","66118","2019",7,7,0,163142.857142857,1872.28571428571,71.1428571428571
"22804","66119","2019",6,6,0,69609.3333333333,1150.5,58.6666666666667
"22805","66120","2019",1,1,0,240000,2243,107
"22806","66121","2019",27,27,0,142331.481481481,1584.62962962963,85.4074074074074
"22807","66122","2019",3,3,0,76533.3333333333,1353,61.6666666666667
"22808","66124","2019",182,20,162,87850.489010989,1971.35714285714,45.6043956043956
"22809","66125","2019",8,7,1,65250,796,83.75
"22810","66126","2019",12,12,0,207291.666666667,2004.83333333333,106.083333333333
"22811","66127","2019",14,14,0,150884.071428571,1547.14285714286,102.285714285714
"22812","66128","2019",1,1,0,60000,1500,40
"22813","66129","2019",38,36,2,172916.842105263,1667.73684210526,99.6842105263158
"22814","66130","2019",26,8,18,172758.884615385,2368.26923076923,74.2692307692308
"22815","66132","2019",10,5,5,191362,2827.4,67.2
"22816","66133","2019",58,54,4,181677.775862069,2011.08620689655,92.3103448275862
"22817","66134","2019",20,19,1,166297.5,1736.8,94.4
"22818","66136","2019",2236,627,1609,114950.313506261,1495.8908765653,75.5272808586762
"22819","66137","2019",5,4,1,121200,1153.8,95.2
"22820","66138","2019",21,21,0,126698.523809524,1392.7619047619,92.5714285714286
"22821","66140","2019",52,52,0,168120.961538462,1960.05769230769,87.5
"22822","66141","2019",206,200,6,132632.155339806,1471.1067961165,87.8592233009709
"22823","66144","2019",85,77,8,220739.917647059,2178.04705882353,101.682352941176
"22824","66145","2019",47,43,4,202774.659574468,2020.29787234043,97.3404255319149
"22825","66146","2019",6,5,1,134083.333333333,1723.33333333333,76.3333333333333
"22826","66147","2019",6,3,3,71772,1335.16666666667,51.8333333333333
"22827","66148","2019",75,21,54,174554.946666667,2863.96,64.1733333333333
"22828","66149","2019",86,59,27,133420.162790698,1518.91860465116,88.1511627906977
"22829","66150","2019",28,19,9,84026.25,1153.57142857143,73.25
"22830","66151","2019",1,1,0,50000,459,109
"22831","66152","2019",3,3,0,35143.3333333333,526,67.3333333333333
"22832","66154","2019",17,13,4,86349.4117647059,1891.76470588235,47.8235294117647
"22833","66155","2019",1,1,0,48500,1276,38
"22834","66156","2019",3,3,0,33000,589.666666666667,62.3333333333333
"22835","66158","2019",5,5,0,97476.2,1263.4,93.6
"22836","66159","2019",5,4,1,128578,1412.8,92.4
"22837","66160","2019",22,20,2,237157.272727273,2200.22727272727,105.136363636364
"22838","66161","2019",15,14,1,146954.666666667,1451.8,107.666666666667
"22839","66162","2019",17,17,0,191618.529411765,1717.82352941176,116.823529411765
"22840","66164","2019",98,77,21,146990.102040816,1788.05102040816,84.7142857142857
"22841","66165","2019",14,14,0,176666.285714286,1895.42857142857,95.5
"22842","66166","2019",3,3,0,65666.6666666667,1127.33333333333,57.3333333333333
"22843","66167","2019",30,20,10,176681.2,2253.73333333333,81.4333333333333
"22844","66168","2019",60,53,7,206842.25,2422.43333333333,87.0333333333333
"22845","66169","2019",3,3,0,158333.333333333,1530.33333333333,105.333333333333
"22846","66170","2019",4,4,0,388363.75,2498.5,161
"22847","66171","2019",597,313,284,156586.179229481,3076.06867671692,54.9179229480737
"22848","66172","2019",190,126,64,163987.642105263,1877.15789473684,86.5631578947368
"22849","66173","2019",12,12,0,198577.666666667,1928.83333333333,102.25
"22850","66174","2019",40,40,0,154077.05,1654.325,91.175
"22851","66175","2019",76,73,3,191816.223684211,2052.51315789474,94.0263157894737
"22852","66176","2019",52,52,0,190289.076923077,2015.67307692308,89.9807692307692
"22853","66177","2019",26,25,1,196211.5,1925.84615384615,102.423076923077
"22854","66178","2019",28,27,1,210300.142857143,1943.60714285714,107.75
"22855","66179","2019",24,16,8,70624.5833333333,979.625,77
"22856","66180","2019",171,148,23,178524.801169591,2118.63742690058,84.7485380116959
"22857","66181","2019",21,10,11,135679.523809524,2406.90476190476,52.6190476190476
"22858","66182","2019",150,127,23,177544.206666667,2949.14,66.3466666666667
"22859","66183","2019",4,4,0,114250,1508.75,80
"22860","66184","2019",2,2,0,217000,2501,116
"22861","66186","2019",52,47,5,180370.865384615,1936.94230769231,92.9230769230769
"22862","66187","2019",22,19,3,94177.7272727273,1035.09090909091,86.5
"22863","66188","2019",25,10,15,82051.88,1683.36,50.92
"22864","66189","2019",82,75,7,250920.390243902,2361.87804878049,105.817073170732
"22865","66190","2019",45,42,3,144980.444444444,1681.97777777778,86.1333333333333
"22866","66191","2019",1,0,1,40000,506,79
"22867","66192","2019",1,1,0,46500,969,48
"22868","66193","2019",9,9,0,102277.777777778,1258.55555555556,82.7777777777778
"22869","66194","2019",7,7,0,127571.428571429,1334.85714285714,98.4285714285714
"22870","66195","2019",113,103,10,198782.079646018,2031.51327433628,97.858407079646
"22871","66196","2019",73,70,3,219381.917808219,2503.49315068493,90.8493150684932
"22872","66198","2019",3,3,0,94000,992.333333333333,114
"22873","66199","2019",3,3,0,524000,2969,179.333333333333
"22874","66202","2019",6,1,5,101606.666666667,2121.5,52
"22875","66203","2019",6,6,0,107930,1272.16666666667,85.8333333333333
"22876","66204","2019",5,5,0,188600,1785.6,111
"22877","66205","2019",15,14,1,77200,932.466666666667,81.2
"22878","66207","2019",9,8,1,164346.111111111,1773.55555555556,97.8888888888889
"22879","66208","2019",25,24,1,197935.04,2005.96,99.48
"22880","66209","2019",1,1,0,48000,960,50
"22881","66210","2019",102,83,19,189804.774509804,2195.42156862745,89.6078431372549
"22882","66211","2019",2,2,0,152500,2347.5,75
"22883","66212","2019",109,98,11,157953.330275229,2314.14678899083,71.743119266055
"22884","66213","2019",122,101,21,181026.680327869,1864.0737704918,96.1393442622951
"22885","66214","2019",20,19,1,197155.4,1995.3,98.1
"22886","66215","2019",4,4,0,78500,1147,78.25
"22887","66216","2019",1,1,0,172000,1162,148
"22888","66217","2019",38,37,1,143381.289473684,1693.76315789474,83.4210526315789
"22889","66218","2019",8,7,1,175375,1675.625,103.875
"22890","66219","2019",2,2,0,105937,1642,59
"22891","66220","2019",1,1,0,103000,1515,68
"22892","66221","2019",2,2,0,100900,930,110
"22893","66222","2019",74,26,48,84191.7297297297,1337.7027027027,58.3378378378378
"22894","66223","2019",4,3,1,48000,772.5,73.25
"22895","66224","2019",44,41,3,145785,1634.36363636364,89.6363636363636
"22896","66225","2019",47,43,4,182361.127659574,2039.27659574468,92.5106382978723
"22897","66226","2019",16,15,1,161768.75,1909.8125,85.875
"22898","66227","2019",73,72,1,235813.150684932,2239.45205479452,108
"22899","66228","2019",21,21,0,156045.80952381,1715,98.8571428571429
"22900","66230","2019",28,25,3,118904.642857143,1664.25,82.5
"22901","66231","2019",14,13,1,132121.428571429,1232.92857142857,96.1428571428571
"22902","66232","2019",1,1,0,68000,1214,56
"22903","66233","2019",2,1,1,122750,1377,77
"22904","66234","2019",3,2,1,77663.3333333333,1062,76.3333333333333
"22905","69001","2019",1,1,0,138000,1453,95
"22906","69002","2019",3,3,0,112666.666666667,1330,87
"22907","69003","2019",32,14,18,263535.03125,2917.34375,88.15625
"22908","69004","2019",13,11,2,245489.692307692,2673.30769230769,96
"22909","69005","2019",9,8,1,282698.444444444,2575.33333333333,119.777777777778
"22910","69006","2019",44,30,14,138840.045454545,1525.90909090909,91.75
"22911","69007","2019",25,17,8,218041.48,2122.52,105.32
"22912","69008","2019",6,6,0,178861.166666667,2141.33333333333,78.6666666666667
"22913","69009","2019",111,70,41,237361.468468468,2676.69369369369,90.7027027027027
"22914","69010","2019",87,31,56,200005.459770115,2494.93103448276,78.9310344827586
"22915","69012","2019",6,6,0,158427.833333333,1281,118.833333333333
"22916","69013","2019",52,37,15,257273.038461538,2460,106.173076923077
"22917","69014","2019",7,7,0,212820.142857143,1967.57142857143,110
"22918","69016","2019",1,1,0,123000,1447,85
"22919","69017","2019",10,10,0,314039,2678.9,126
"22920","69018","2019",29,25,4,151375.862068966,1591.89655172414,96.8620689655172
"22921","69019","2019",203,125,78,178715.832512315,2049.5960591133,89.423645320197
"22922","69020","2019",12,6,6,182146,2201.83333333333,85.1666666666667
"22923","69021","2019",24,21,3,219439.166666667,2270.04166666667,95.3333333333333
"22924","69022","2019",7,7,0,250882.857142857,2529,103.857142857143
"22925","69023","2019",24,23,1,251624.958333333,2155.58333333333,120.791666666667
"22926","69024","2019",75,46,29,237616.84,2237.32,114.066666666667
"22927","69026","2019",8,8,0,250047.5,2161.125,134.75
"22928","69027","2019",151,59,92,276001.649006622,3299.15894039735,85.2582781456954
"22929","69028","2019",88,66,22,378392.863636364,3482.75,112.784090909091
"22930","69029","2019",492,103,389,228504.107723577,2924.81300813008,76.3780487804878
"22931","69030","2019",5,4,1,142744,1420.2,99.4
"22932","69031","2019",14,12,2,178992.857142857,1780.14285714286,97.3571428571429
"22933","69032","2019",23,15,8,257906.52173913,2401.86956521739,106.826086956522
"22934","69033","2019",30,26,4,515727.666666667,4212.66666666667,132.366666666667
"22935","69034","2019",777,98,679,302912.087516088,3794.21621621622,78.5740025740026
"22936","69035","2019",8,8,0,233720,1870.75,126.75
"22937","69036","2019",12,11,1,183946.083333333,2071.5,91.1666666666667
"22938","69037","2019",11,11,0,148282.272727273,1296.63636363636,117.090909090909
"22939","69038","2019",14,14,0,147079.285714286,1493.64285714286,98
"22940","69039","2019",14,13,1,192262.857142857,1648.07142857143,110.928571428571
"22941","69040","2019",107,28,79,324812.794392523,3728.3738317757,87.5514018691589
"22942","69042","2019",4,4,0,277410,2133.25,140.5
"22943","69043","2019",106,72,34,402527.471698113,3730.92452830189,108.207547169811
"22944","69044","2019",80,33,47,450777.125,4327.8375,103.825
"22945","69045","2019",19,16,3,223436.315789474,1953,118.526315789474
"22946","69046","2019",59,49,10,415581.966101695,3855.84745762712,109.966101694915
"22947","69047","2019",9,9,0,382876.666666667,2805.66666666667,135
"22948","69049","2019",39,24,15,345243.153846154,3458.76923076923,100.512820512821
"22949","69050","2019",26,22,4,298973.307692308,2848.30769230769,105.192307692308
"22950","69051","2019",15,15,0,311885.666666667,3271.26666666667,104.2
"22951","69052","2019",56,43,13,324648.392857143,3114,105.446428571429
"22952","69053","2019",7,7,0,134778.571428571,1852.71428571429,76.7142857142857
"22953","69054","2019",11,11,0,127124.363636364,1779.54545454545,75.3636363636364
"22954","69055","2019",27,18,9,266661.111111111,2757.44444444444,96.4444444444444
"22955","69056","2019",33,27,6,268361.818181818,2800.81818181818,97.9090909090909
"22956","69057","2019",9,9,0,200866.666666667,2674.44444444444,73.1111111111111
"22957","69058","2019",10,10,0,195308.7,2024.2,94
"22958","69059","2019",24,18,6,337949.75,3556.375,96.5833333333333
"22959","69060","2019",8,8,0,107625,1064.375,98.75
"22960","69061","2019",9,8,1,349153.777777778,2643.44444444444,135.111111111111
"22961","69062","2019",5,5,0,324860,2744.2,129.6
"22962","69063","2019",74,39,35,457879.486486487,3984.47297297297,113.148648648649
"22963","69064","2019",64,32,32,165766.421875,2037,82.625
"22964","69065","2019",9,9,0,190773.111111111,2033.11111111111,94.4444444444444
"22965","69066","2019",45,40,5,103043.311111111,1036.73333333333,101.066666666667
"22966","69067","2019",16,14,2,124378.125,1485.4375,82.6875
"22967","69068","2019",45,29,16,362058.955555556,3883.28888888889,93.4222222222222
"22968","69069","2019",190,78,112,309872.210526316,3637.41578947368,83.9
"22969","69070","2019",25,24,1,117116.6,1111.32,104.64
"22970","69071","2019",23,15,8,355990.086956522,3547.04347826087,101.173913043478
"22971","69072","2019",96,62,34,443805.239583333,3764.20833333333,113.583333333333
"22972","69074","2019",20,19,1,268882,2345.4,115.15
"22973","69075","2019",2,2,0,132400,1317.5,99.5
"22974","69076","2019",30,24,6,418097.5,3779.03333333333,114.966666666667
"22975","69077","2019",13,13,0,193049.230769231,1788.84615384615,108.384615384615
"22976","69078","2019",8,8,0,190055,1805.875,111.5
"22977","69080","2019",16,13,3,262572.0625,2424.1875,111.625
"22978","69081","2019",256,54,202,366534.5625,3835.51171875,91.19140625
"22979","69082","2019",4,4,0,161075,1761.5,98.25
"22980","69083","2019",12,11,1,360130.416666667,3139.33333333333,117.416666666667
"22981","69084","2019",12,11,1,107846.5,1294.83333333333,85.8333333333333
"22982","69085","2019",15,11,4,283868.666666667,3089.8,89.4666666666667
"22983","69086","2019",32,25,7,334108.75,3064.03125,111.65625
"22984","69087","2019",44,31,13,465940.340909091,4156.38636363636,110.409090909091
"22985","69088","2019",163,22,141,249859.374233129,3126.06134969325,78.3803680981595
"22986","69089","2019",219,75,144,314947.593607306,3539.04566210046,86.8767123287671
"22987","69090","2019",7,7,0,348279.285714286,2686.14285714286,131.571428571429
"22988","69091","2019",209,100,109,156804.090909091,1839.64593301435,86.4688995215311
"22989","69092","2019",81,41,40,198966.358024691,2197.7037037037,87.3703703703704
"22990","69093","2019",18,18,0,125536.944444444,1401.38888888889,92.1666666666667
"22991","69094","2019",93,49,44,310940.806451613,3479.21505376344,93.2903225806452
"22992","69095","2019",14,13,1,163426.785714286,1789.78571428571,96.9285714285714
"22993","69096","2019",176,81,95,178737.176136364,2229.23863636364,79.9375
"22994","69097","2019",7,7,0,219113.428571429,1973.42857142857,109.857142857143
"22995","69098","2019",4,4,0,238030,1867.25,132.5
"22996","69099","2019",16,16,0,177765.1875,1747.0625,104.625
"22997","69100","2019",107,52,55,286156.588785047,3145.31775700935,93.411214953271
"22998","69102","2019",10,10,0,190094,1720,105.6
"22999","69103","2019",13,13,0,178796.153846154,1655.61538461538,105.384615384615
"23000","69104","2019",9,9,0,152655.555555556,2126.77777777778,71
"23001","69105","2019",9,8,1,252846.111111111,2028.55555555556,131.222222222222
"23002","69106","2019",18,16,2,351213.333333333,3045.83333333333,118.5
"23003","69107","2019",10,8,2,162599,1551.8,109.5
"23004","69108","2019",20,20,0,213730.4,2063.6,105.7
"23005","69109","2019",11,11,0,270109.090909091,1765,143.454545454545
"23006","69110","2019",23,22,1,148338.695652174,1425.30434782609,107.652173913043
"23007","69111","2019",14,10,4,220801.071428571,1965.21428571429,112.785714285714
"23008","69112","2019",60,37,23,315960.866666667,3285.45,99.8666666666667
"23009","69113","2019",12,11,1,213479.166666667,1918.33333333333,112.666666666667
"23010","69115","2019",75,43,32,243225.653333333,2470.2,96.3466666666667
"23011","69116","2019",47,33,14,520329.106382979,4197.82978723404,127.042553191489
"23012","69117","2019",38,31,7,414365,3490.36842105263,121.789473684211
"23013","69118","2019",26,19,7,201263.461538462,2321.38461538462,87.8461538461538
"23014","69119","2019",6,6,0,208911.166666667,1790.33333333333,125
"23015","69120","2019",10,10,0,124926,1506.2,87.3
"23016","69121","2019",48,33,15,301550.229166667,3264.16666666667,94.3125
"23017","69122","2019",26,20,6,319253.769230769,2963.73076923077,117.076923076923
"23018","69123","2019",8177,205,7972,285507.378378378,4377.38033508622,66.2101015042192
"23019","69124","2019",7,7,0,123514.285714286,1430.71428571429,80
"23020","69125","2019",11,10,1,383897.272727273,3197.09090909091,119.909090909091
"23021","69126","2019",6,6,0,393738.333333333,3253.83333333333,121
"23022","69127","2019",28,18,10,402127.607142857,3862.10714285714,102.071428571429
"23023","69130","2019",7,7,0,143278.571428571,1452,115.714285714286
"23024","69131","2019",46,28,18,266616.543478261,2737.36956521739,98.4130434782609
"23025","69132","2019",9,9,0,174412.666666667,1827.44444444444,95.3333333333333
"23026","69134","2019",1,1,0,324000,2492,130
"23027","69135","2019",23,20,3,96084.7826086956,989.869565217391,98.4347826086957
"23028","69136","2019",35,28,7,310714.857142857,3279.6,95.5714285714286
"23029","69137","2019",5,4,1,283080.8,2488.8,112.8
"23030","69138","2019",6,6,0,239018.333333333,2360.83333333333,102.166666666667
"23031","69139","2019",13,12,1,182929.461538462,1824.30769230769,100.076923076923
"23032","69140","2019",25,19,6,335922.8,3012.92,113.52
"23033","69141","2019",68,34,34,248559.455882353,3090.95588235294,80.5735294117647
"23034","69142","2019",150,10,140,210046.693333333,2985.07333333333,69.64
"23035","69143","2019",117,34,83,247468.282051282,3040.99145299145,79.9487179487179
"23036","69145","2019",10,8,2,174556.2,2015.3,86.8
"23037","69148","2019",40,34,6,393350.8,3448.125,116.925
"23038","69149","2019",442,62,380,211632.746606335,2931.69909502262,72.9864253393665
"23039","69151","2019",20,20,0,237473.65,2199.5,114.6
"23040","69152","2019",141,43,98,202344.042553191,2803.23404255319,71.2695035460993
"23041","69153","2019",20,20,0,493461.9,3947.2,131.8
"23042","69154","2019",63,31,32,296782.317460317,3239.98412698413,91.2380952380952
"23043","69155","2019",4,4,0,208750,1710.75,132
"23044","69156","2019",36,28,8,337486.611111111,2931.66666666667,120.583333333333
"23045","69157","2019",48,38,10,220341.041666667,2258.27083333333,101.354166666667
"23046","69159","2019",55,44,11,260065.472727273,2477.25454545455,105.781818181818
"23047","69160","2019",6,6,0,120833.333333333,1099.5,133.333333333333
"23048","69161","2019",7,7,0,83171.4285714286,1027,89.4285714285714
"23049","69162","2019",16,15,1,186282.8125,1621.1875,117.875
"23050","69163","2019",38,32,6,313711.578947368,3141.42105263158,101.763157894737
"23051","69164","2019",10,10,0,151939,1444.9,106.8
"23052","69165","2019",15,15,0,224293.666666667,1995.73333333333,115.8
"23053","69166","2019",8,7,1,195333.75,2319.375,90.75
"23054","69167","2019",9,9,0,254511.111111111,2220.22222222222,113.888888888889
"23055","69168","2019",20,14,6,330069.1,3596,93.9
"23056","69169","2019",8,8,0,154065,1278.875,118
"23057","69170","2019",14,14,0,247727.5,2599.78571428571,103.428571428571
"23058","69171","2019",31,23,8,205811.419354839,2246.25806451613,92.2903225806452
"23059","69172","2019",10,9,1,209595,2269.5,92
"23060","69173","2019",8,7,1,287635.125,2568.125,117.125
"23061","69174","2019",4,4,0,157198.75,1670.5,94.5
"23062","69175","2019",19,17,2,252875.263157895,2368.05263157895,110.947368421053
"23063","69176","2019",57,45,12,319250.614035088,3132.45614035088,101.666666666667
"23064","69177","2019",23,21,2,286875.173913043,2757.69565217391,104.347826086957
"23065","69178","2019",11,11,0,156768.181818182,1735.27272727273,88.3636363636364
"23066","69179","2019",51,45,6,289993.039215686,2833.29411764706,103.078431372549
"23067","69180","2019",4,4,0,171140,1678,113
"23068","69181","2019",4,4,0,164675,1547.5,104.5
"23069","69182","2019",6,6,0,81891.6666666667,736,102.5
"23070","69183","2019",7,7,0,117857.142857143,1238.71428571429,105.571428571429
"23071","69184","2019",16,15,1,211187.5,2095.4375,105.125
"23072","69186","2019",3,3,0,113833.333333333,1199.66666666667,108
"23073","69187","2019",8,8,0,170271.25,1382.875,130.25
"23074","69188","2019",16,14,2,182133,1742.9375,103.375
"23075","69189","2019",34,8,26,224874.264705882,2432.32352941176,90.2058823529412
"23076","69190","2019",47,26,21,317867.106382979,3400.06382978723,94.2127659574468
"23077","69191","2019",97,60,37,633321.979381443,5050.84536082474,121.134020618557
"23078","69192","2019",1,1,0,384800,2872,134
"23079","69193","2019",19,19,0,383150.315789474,3195.21052631579,132.736842105263
"23080","69194","2019",85,53,32,682014.282352941,4843.75294117647,137.258823529412
"23081","69196","2019",10,8,2,139664.1,1351,116.7
"23082","69197","2019",25,24,1,247997.6,2260.88,110.6
"23083","69198","2019",8,8,0,224168.75,2129.5,102.625
"23084","69199","2019",166,53,113,158898.560240964,2318.14457831325,70.8132530120482
"23085","69200","2019",8,6,2,218200,1872.25,110.625
"23086","69201","2019",12,6,6,129383.75,2332.66666666667,73.4166666666667
"23087","69202","2019",343,50,293,317375.586005831,3388.00583090379,87.7084548104956
"23088","69203","2019",12,9,3,140111.333333333,1522.75,92.6666666666667
"23089","69204","2019",289,121,168,307236.875432526,3435.24221453287,87.522491349481
"23090","69205","2019",69,47,22,321409.768115942,3500.34782608696,94.0289855072464
"23091","69206","2019",68,39,29,221151.573529412,2345.91176470588,96.0735294117647
"23092","69207","2019",35,23,12,329078.085714286,3610.97142857143,93.1428571428571
"23093","69208","2019",21,21,0,397205.476190476,3138.7619047619,136.285714285714
"23094","69209","2019",6,6,0,117333.333333333,782.666666666667,133.333333333333
"23095","69212","2019",5,5,0,418284,3200,131.2
"23096","69214","2019",8,7,1,118711.125,1062,111.125
"23097","69215","2019",11,9,2,250431.818181818,2372.09090909091,108.363636363636
"23098","69216","2019",7,6,1,251000,1910.71428571429,127.571428571429
"23099","69217","2019",12,12,0,127845.833333333,1323.08333333333,104.75
"23100","69218","2019",17,14,3,181943.411764706,2079.88235294118,92.4705882352941
"23101","69219","2019",29,25,4,282192.413793103,2914.8275862069,101.689655172414
"23102","69220","2019",24,20,4,169874.166666667,1795.375,102.958333333333
"23103","69225","2019",3,3,0,202833.333333333,1835,106
"23104","69227","2019",30,26,4,256645.433333333,2662.53333333333,95.8666666666667
"23105","69228","2019",42,37,5,264273.785714286,2662.83333333333,99.7619047619048
"23106","69229","2019",8,8,0,168369.75,1373.5,120.125
"23107","69230","2019",2,2,0,207350,1689.5,108.5
"23108","69231","2019",27,18,9,281907.037037037,2705.74074074074,103.148148148148
"23109","69233","2019",11,8,3,327487.909090909,3551.81818181818,95.4545454545455
"23110","69234","2019",15,15,0,282702,2611.8,115.133333333333
"23111","69235","2019",34,10,24,184414.558823529,2289.5,81.5
"23112","69236","2019",8,8,0,196781.25,2176.5,94.375
"23113","69238","2019",49,32,17,154818.387755102,2019.24489795918,84.8571428571429
"23114","69239","2019",14,12,2,312471.071428571,2366.92857142857,129.285714285714
"23115","69240","2019",13,13,0,93876.9230769231,917.846153846154,100.461538461538
"23116","69241","2019",38,24,14,313046.105263158,3406.76315789474,94.1052631578947
"23117","69242","2019",10,10,0,229784.3,2429.7,99.4
"23118","69243","2019",112,39,73,136452.508928571,1551.22321428571,87.7142857142857
"23119","69244","2019",435,77,358,310976.809195402,3762.57701149425,80.8137931034483
"23120","69245","2019",8,8,0,282865,3056.75,101.875
"23121","69246","2019",12,12,0,215500.333333333,2245.16666666667,98.9166666666667
"23122","69248","2019",48,37,11,103411.729166667,1113.625,97.2291666666667
"23123","69249","2019",32,27,5,301706.25,3058.3125,98
"23124","69250","2019",71,45,26,414287.197183099,3906.50704225352,109.169014084507
"23125","69252","2019",10,10,0,253110,2275.7,106.1
"23126","69253","2019",6,6,0,331048.333333333,3191.66666666667,159.666666666667
"23127","69254","2019",12,12,0,147173.75,1642.83333333333,92.4166666666667
"23128","69255","2019",56,42,14,323015.267857143,3230.03571428571,100.232142857143
"23129","69256","2019",487,122,365,169644.798767967,2432.81724845996,69.4681724845996
"23130","69257","2019",15,11,4,183696.666666667,1723.46666666667,102.133333333333
"23131","69258","2019",4,4,0,192580,1415.25,135
"23132","69259","2019",588,121,467,165297.954081633,2337.03571428571,71.4659863945578
"23133","69260","2019",85,43,42,308250.529411765,3439.07058823529,89.2117647058824
"23134","69261","2019",1,1,0,20000,400,50
"23135","69263","2019",18,17,1,181427.777777778,1778.44444444444,108.166666666667
"23136","69264","2019",675,132,543,158318.973333333,2106.89925925926,74.9185185185185
"23137","69265","2019",10,9,1,244470.5,2568.3,98.3
"23138","69266","2019",2738,136,2602,205865.003652301,3329.43170197224,63.2136596055515
"23139","69267","2019",36,35,1,226684.722222222,2030.61111111111,114.972222222222
"23140","69268","2019",60,38,22,436234.133333333,4006.76666666667,107.25
"23141","69269","2019",11,6,5,213764.090909091,2082.18181818182,112.545454545455
"23142","69270","2019",58,38,20,367670.224137931,3578.39655172414,105.551724137931
"23143","69271","2019",117,69,48,356359.367521368,3873.15384615385,94.1196581196581
"23144","69272","2019",53,43,10,294230.622641509,2988.56603773585,99.0943396226415
"23145","69273","2019",138,67,71,246489.963768116,2908.77536231884,83.6231884057971
"23146","69275","2019",389,104,285,206605.588688946,2909.7557840617,72.2287917737789
"23147","69276","2019",131,73,58,220383.58778626,2630.35114503817,83.3435114503817
"23148","69277","2019",147,115,32,405590.027210884,3923.8843537415,106.802721088435
"23149","69278","2019",69,49,20,295435.768115942,2995.85507246377,97.8115942028985
"23150","69279","2019",53,48,5,328400.943396226,3395.7358490566,98.2830188679245
"23151","69280","2019",14,14,0,305972.857142857,2939.64285714286,104.5
"23152","69281","2019",26,17,9,326085.153846154,3051.53846153846,112.346153846154
"23153","69282","2019",396,198,198,259614.449494949,3288.81818181818,79.3282828282828
"23154","69283","2019",130,87,43,273322.384615385,3143.84615384615,88.5769230769231
"23155","69284","2019",31,25,6,384147.806451613,3668.67741935484,110.645161290323
"23156","69285","2019",55,49,6,306669.709090909,3173.87272727273,97.7818181818182
"23157","69286","2019",290,109,181,262405.755172414,2926.6,88.3896551724138
"23158","69287","2019",101,70,31,336093.445544554,3230.42574257426,106.29702970297
"23159","69288","2019",62,40,22,278975.387096774,3110.04838709677,94.0645161290323
"23160","69289","2019",54,41,13,274806.018518519,3225.01851851852,89.6666666666667
"23161","69290","2019",645,149,496,200743.742635659,2656.29302325581,76.0263565891473
"23162","69291","2019",72,41,31,258850.194444444,3042.88888888889,86.1388888888889
"23163","69292","2019",59,13,46,262532.711864407,3132,83.1016949152542
"23164","69293","2019",36,26,10,456494.666666667,3716.52777777778,120.305555555556
"23165","69294","2019",51,22,29,244255.62745098,2897.50980392157,85.1764705882353
"23166","69295","2019",23,13,10,290539.130434783,2995.08695652174,101.695652173913
"23167","69296","2019",35,31,4,326886.228571429,3257.74285714286,101.2
"23168","69297","2019",62,55,7,320598.064516129,3326.3064516129,98.2096774193548
"23169","69298","2019",35,23,12,298378.428571429,3116.91428571429,97.8571428571429
"23170","69299","2019",30,26,4,281953.866666667,2879,103.666666666667
"23171","70001","2019",1,1,0,1e+05,833,120
"23172","70002","2019",1,1,0,28000,337,83
"23173","70004","2019",3,3,0,97033.3333333333,766.666666666667,122.666666666667
"23174","70005","2019",4,4,0,71500,905.75,80.75
"23175","70006","2019",9,8,1,94677.7777777778,947.555555555556,107.888888888889
"23176","70010","2019",3,3,0,89000,1200.66666666667,72.6666666666667
"23177","70011","2019",3,3,0,168133.333333333,974.666666666667,183.333333333333
"23178","70012","2019",5,5,0,79120,744.8,107.6
"23179","70014","2019",3,3,0,125733.333333333,823.333333333333,143
"23180","70015","2019",4,4,0,67125,635.5,98.25
"23181","70016","2019",3,3,0,83666.6666666667,946,85.3333333333333
"23182","70018","2019",1,0,1,218600,2277,96
"23183","70019","2019",1,1,0,58000,460,126
"23184","70020","2019",5,5,0,111730,1209.6,93
"23185","70021","2019",3,3,0,126833.333333333,1022.66666666667,125.666666666667
"23186","70022","2019",3,3,0,75283.3333333333,638,116.666666666667
"23187","70023","2019",4,4,0,116500,1498.25,76
"23188","70024","2019",3,3,0,79016.6666666667,1023.66666666667,74
"23189","70025","2019",4,4,0,49095,747.5,71
"23190","70026","2019",22,19,3,111379.136363636,1022.04545454545,111.090909090909
"23191","70029","2019",1,1,0,40000,421,95
"23192","70031","2019",3,3,0,88883.3333333333,719,126.666666666667
"23193","70035","2019",2,2,0,162025,1033,171
"23194","70036","2019",3,3,0,104425,1448.33333333333,75.6666666666667
"23195","70037","2019",4,4,0,116037.5,1440.75,89.25
"23196","70038","2019",4,4,0,120165,1177.5,108.5
"23197","70039","2019",3,3,0,160333.333333333,1189,122.333333333333
"23198","70040","2019",2,2,0,140650,1220.5,114
"23199","70043","2019",3,3,0,100216.666666667,1087.33333333333,85.6666666666667
"23200","70044","2019",3,3,0,319146.666666667,1753,173.666666666667
"23201","70045","2019",4,4,0,176500,1614.75,120.75
"23202","70046","2019",3,3,0,101666.666666667,995,104.333333333333
"23203","70047","2019",2,2,0,117150,972,116
"23204","70050","2019",1,1,0,166000,1456,114
"23205","70051","2019",2,2,0,63250,683.5,90
"23206","70052","2019",1,1,0,155000,775,200
"23207","70053","2019",1,1,0,130000,684,190
"23208","70054","2019",2,2,0,151025,1387.5,110
"23209","70055","2019",3,3,0,107666.666666667,1053.33333333333,103
"23210","70056","2019",5,5,0,75600,715.6,107.6
"23211","70058","2019",11,11,0,101072.727272727,948.545454545455,120.909090909091
"23212","70059","2019",4,4,0,122750,1334,89.5
"23213","70060","2019",3,3,0,246500,1802,133.666666666667
"23214","70061","2019",3,3,0,98971.6666666667,1567,84.3333333333333
"23215","70062","2019",2,2,0,123250,1330.5,95
"23216","70063","2019",1,1,0,90000,833,108
"23217","70066","2019",1,1,0,29000,558,52
"23218","70067","2019",1,1,0,177250,928,191
"23219","70069","2019",1,1,0,112700,777,145
"23220","70071","2019",3,3,0,175333.333333333,2680,92.6666666666667
"23221","70074","2019",2,2,0,62750,589,105
"23222","70075","2019",4,4,0,211587.5,1881.25,122.25
"23223","70076","2019",2,2,0,213175,1246.5,168.5
"23224","70077","2019",3,3,0,98278.3333333333,933.333333333333,107
"23225","70079","2019",4,4,0,130005,925.25,138.75
"23226","70080","2019",5,4,1,99650,1083,94.2
"23227","70081","2019",2,2,0,178250,1463.5,121.5
"23228","70082","2019",3,3,0,134458.333333333,1267.66666666667,111
"23229","70083","2019",7,7,0,98550,1019.57142857143,89.7142857142857
"23230","70084","2019",5,5,0,199362.2,2414.2,102.2
"23231","70085","2019",3,3,0,158126.666666667,1190.33333333333,128.666666666667
"23232","70086","2019",1,1,0,175300,1069,164
"23233","70087","2019",3,2,1,88133.3333333333,907.666666666667,99.6666666666667
"23234","70088","2019",1,1,0,193000,1287,150
"23235","70091","2019",1,1,0,95000,792,120
"23236","70092","2019",1,1,0,15000,536,28
"23237","70093","2019",8,8,0,85037.5,736.25,120.875
"23238","70095","2019",10,10,0,116250,1004,121.7
"23239","70096","2019",6,5,1,127488.333333333,1564.33333333333,83.5
"23240","70097","2019",3,3,0,71000,908,81
"23241","70098","2019",2,2,0,65625,672,99.5
"23242","70100","2019",4,4,0,121775,929.25,128.75
"23243","70101","2019",10,10,0,122203,921.7,130.3
"23244","70102","2019",3,3,0,171931.666666667,1631,101.666666666667
"23245","70103","2019",2,2,0,162100,1626,99.5
"23246","70104","2019",3,2,1,101666.666666667,1093.66666666667,93.6666666666667
"23247","70105","2019",2,2,0,70000,902,78.5
"23248","70106","2019",3,3,0,64000,605.666666666667,112.666666666667
"23249","70107","2019",8,8,0,151293.75,1351.75,114.625
"23250","70109","2019",1,1,0,81400,831,98
"23251","70111","2019",1,0,1,131900,1466,90
"23252","70112","2019",3,3,0,64333.3333333333,651.333333333333,103.333333333333
"23253","70113","2019",2,2,0,74000,1145,67
"23254","70114","2019",1,1,0,40000,381,105
"23255","70115","2019",4,4,0,142562.5,1220.5,137
"23256","70116","2019",7,6,1,131584,1323.14285714286,97.5714285714286
"23257","70117","2019",16,15,1,173458.75,1607.25,111.5
"23258","70118","2019",5,5,0,133280,1341,103.2
"23259","70119","2019",8,8,0,140787.5,1665.375,98.875
"23260","70120","2019",40,39,1,126545.4,1367.525,94.9
"23261","70121","2019",6,6,0,148650,1360.66666666667,105.666666666667
"23262","70122","2019",27,26,1,106900.481481481,924.592592592593,109.592592592593
"23263","70125","2019",2,2,0,95200,1106,86.5
"23264","70126","2019",1,1,0,155500,1808,86
"23265","70128","2019",6,6,0,94600,940.666666666667,100.5
"23266","70129","2019",1,1,0,177500,1207,147
"23267","70130","2019",4,4,0,146675,1376.25,108.25
"23268","70132","2019",3,3,0,125600,870.333333333333,139
"23269","70133","2019",4,4,0,66482.5,761.25,82.75
"23270","70134","2019",3,3,0,99466.6666666667,943,110.666666666667
"23271","70135","2019",1,1,0,54000,659,82
"23272","70136","2019",6,3,3,118391.666666667,1064.83333333333,117.166666666667
"23273","70137","2019",1,1,0,147000,1531,96
"23274","70138","2019",1,1,0,157000,1570,100
"23275","70142","2019",2,2,0,116500,881.5,131.5
"23276","70143","2019",1,1,0,110195,735,150
"23277","70145","2019",3,3,0,213571.333333333,1788.66666666667,124.666666666667
"23278","70147","2019",2,2,0,162175,1838,89.5
"23279","70148","2019",3,3,0,190733.333333333,1506.66666666667,126.666666666667
"23280","70149","2019",6,6,0,167908.333333333,1383.66666666667,118.666666666667
"23281","70150","2019",1,1,0,230000,1150,200
"23282","70152","2019",6,6,0,111666.666666667,1244.83333333333,90.5
"23283","70153","2019",2,2,0,39750,422,96
"23284","70154","2019",4,4,0,105250,841.5,118.75
"23285","70155","2019",4,4,0,71262.5,1324.25,71.25
"23286","70156","2019",1,1,0,307000,2362,130
"23287","70157","2019",4,4,0,68875,760.5,101
"23288","70159","2019",2,2,0,85500,947,90.5
"23289","70162","2019",6,6,0,169217.5,1300.83333333333,133
"23290","70163","2019",1,1,0,168000,1273,132
"23291","70164","2019",1,1,0,64000,492,130
"23292","70165","2019",8,8,0,91343.75,708,128.25
"23293","70166","2019",5,5,0,111389,1416.4,96.8
"23294","70167","2019",10,10,0,94646.6,951.2,99.9
"23295","70168","2019",4,4,0,141825,1220.5,108
"23296","70169","2019",1,1,0,34000,395,86
"23297","70170","2019",1,1,0,85000,2931,29
"23298","70171","2019",11,8,3,127090.909090909,1141.63636363636,115.454545454545
"23299","70174","2019",4,4,0,181125,1242.25,161
"23300","70176","2019",3,3,0,83600,801,102.333333333333
"23301","70177","2019",6,6,0,98378.3333333333,881.5,107.166666666667
"23302","70178","2019",8,8,0,100903.125,1135.625,90.5
"23303","70179","2019",3,3,0,159100,967,160.666666666667
"23304","70180","2019",7,7,0,121520,1010.85714285714,121.714285714286
"23305","70181","2019",2,2,0,184500,1513.5,126.5
"23306","70183","2019",1,1,0,60000,429,140
"23307","70184","2019",13,7,6,119353.846153846,1359.84615384615,83.6923076923077
"23308","70187","2019",1,1,0,265000,1432,185
"23309","70189","2019",1,1,0,165500,1655,100
"23310","70190","2019",2,2,0,72500,628,114
"23311","70192","2019",1,1,0,205000,1213,169
"23312","70193","2019",1,1,0,127000,1549,82
"23313","70194","2019",1,1,0,83000,912,91
"23314","70195","2019",3,2,1,81000,1004.33333333333,83
"23315","70196","2019",2,2,0,71100,764,86
"23316","70197","2019",8,8,0,96125,921.625,108
"23317","70198","2019",9,9,0,112644.444444444,1033.55555555556,112.777777777778
"23318","70199","2019",1,1,0,180800,1738,104
"23319","70201","2019",1,1,0,29000,806,36
"23320","70203","2019",3,3,0,119666.666666667,1126,109.666666666667
"23321","70205","2019",1,1,0,132000,1808,73
"23322","70206","2019",5,5,0,231320,1761.2,137.8
"23323","70207","2019",40,30,10,119978,1378.45,84.75
"23324","70208","2019",1,1,0,83700,507,165
"23325","70210","2019",3,3,0,181666.666666667,1407.33333333333,121.333333333333
"23326","70211","2019",1,1,0,116500,752,155
"23327","70214","2019",1,1,0,50000,833,60
"23328","70215","2019",3,3,0,177900,2252,104.666666666667
"23329","70216","2019",3,3,0,153423.333333333,1690.66666666667,90
"23330","70217","2019",2,2,0,140000,1622.5,115
"23331","70218","2019",2,2,0,150000,1060.5,141
"23332","70219","2019",5,5,0,93420,945,98.6
"23333","70220","2019",5,5,0,119800,837.8,145
"23334","70221","2019",3,3,0,93333.3333333333,935,99
"23335","70224","2019",6,5,1,170208.333333333,1606.33333333333,102.833333333333
"23336","70225","2019",2,2,0,73000,648,117
"23337","70226","2019",2,2,0,84825,1047.5,87.5
"23338","70227","2019",5,5,0,149080,1614.8,127.2
"23339","70228","2019",7,5,2,63707.4285714286,605.285714285714,96.1428571428571
"23340","70229","2019",9,9,0,93888.8888888889,1386.22222222222,89.1111111111111
"23341","70233","2019",2,2,0,75000,897.5,80
"23342","70234","2019",2,2,0,159500,1225,134.5
"23343","70237","2019",1,1,0,105000,750,140
"23344","70238","2019",3,3,0,113666.666666667,734,146
"23345","70239","2019",3,3,0,158000,1276,123.333333333333
"23346","70240","2019",6,6,0,70816.6666666667,807.5,83.5
"23347","70242","2019",4,4,0,69500,522.75,142
"23348","70243","2019",6,6,0,73016.6666666667,879.5,88.3333333333333
"23349","70244","2019",1,1,0,95500,936,102
"23350","70245","2019",24,23,1,93221.6666666667,859.416666666667,109
"23351","70247","2019",3,3,0,63583.3333333333,489.333333333333,128
"23352","70248","2019",1,1,0,20000,1000,20
"23353","70250","2019",9,9,0,174064.666666667,1389.66666666667,147.777777777778
"23354","70251","2019",2,2,0,70000,794,90
"23355","70252","2019",1,1,0,28000,359,78
"23356","70253","2019",4,4,0,109000,981.5,121.5
"23357","70254","2019",3,3,0,155700,1434,106
"23358","70255","2019",2,2,0,59500,520.5,113.5
"23359","70256","2019",8,8,0,63162.5,708.875,93.125
"23360","70257","2019",5,5,0,144700,1540.4,95.8
"23361","70258","2019",24,24,0,98363.3333333333,915.791666666667,117.375
"23362","70259","2019",4,4,0,165452.5,1504.25,111
"23363","70260","2019",4,4,0,91625,1115.25,82
"23364","70261","2019",14,14,0,155991.071428571,1468.35714285714,106.357142857143
"23365","70262","2019",2,2,0,98000,1154.5,83.5
"23366","70263","2019",1,1,0,150900,1755,86
"23367","70264","2019",1,1,0,211000,1407,150
"23368","70265","2019",1,1,0,79000,465,170
"23369","70267","2019",6,6,0,168625,1010.5,148.5
"23370","70271","2019",6,6,0,124733.333333333,1325,97.1666666666667
"23371","70272","2019",3,3,0,75543.3333333333,462,153.666666666667
"23372","70274","2019",1,1,0,67000,344,195
"23373","70275","2019",1,1,0,179000,1065,168
"23374","70276","2019",2,2,0,106435,1122.5,94
"23375","70277","2019",3,3,0,150666.666666667,1418.33333333333,99.3333333333333
"23376","70278","2019",5,5,0,129060,1508.6,89.6
"23377","70279","2019",64,31,33,96992.1875,1017.703125,99.375
"23378","70280","2019",13,13,0,114123.076923077,1153.69230769231,103
"23379","70282","2019",7,6,1,97214.2857142857,1036.28571428571,101
"23380","70283","2019",5,5,0,83200,883.4,94.8
"23381","70284","2019",2,2,0,70950,659,107.5
"23382","70285","2019",124,81,43,117441.580645161,1329.63709677419,89.2903225806452
"23383","70286","2019",3,3,0,140811.666666667,1202.33333333333,115
"23384","70289","2019",4,4,0,131050,1333.75,98.5
"23385","70290","2019",2,2,0,100450,754,128.5
"23386","70292","2019",12,12,0,62791.6666666667,603.416666666667,101.416666666667
"23387","70294","2019",4,4,0,126250,1267.25,108.75
"23388","70295","2019",2,2,0,127500,2370.5,66
"23389","70296","2019",1,1,0,159000,1574,101
"23390","70297","2019",2,2,0,62500,498.5,123.5
"23391","70298","2019",2,2,0,112000,913.5,123
"23392","70299","2019",4,4,0,69250,744.5,88.75
"23393","70302","2019",1,1,0,118000,781,151
"23394","70303","2019",1,1,0,137000,919,149
"23395","70304","2019",1,0,1,40000,460,87
"23396","70305","2019",2,2,0,77500,771,113
"23397","70306","2019",4,4,0,144706.25,1075,137.75
"23398","70307","2019",1,1,0,86500,577,150
"23399","70308","2019",1,1,0,61000,526,116
"23400","70309","2019",4,4,0,149356.25,1587.25,93.5
"23401","70310","2019",77,49,28,123322.233766234,1434.14285714286,93.8701298701299
"23402","70311","2019",87,36,51,77964.8045977011,936.908045977012,82.3908045977011
"23403","70312","2019",10,10,0,139319,1530.2,99.9
"23404","70313","2019",3,3,0,110666.666666667,1042.66666666667,108.666666666667
"23405","70314","2019",2,2,0,118250,1079,109.5
"23406","70315","2019",4,4,0,121712.5,1036,124.5
"23407","70316","2019",1,1,0,45000,692,65
"23408","70317","2019",1,1,0,131500,1429,92
"23409","70318","2019",3,3,0,102666.666666667,1212.66666666667,75.6666666666667
"23410","70320","2019",1,1,0,100800,1867,54
"23411","70321","2019",10,10,0,135377,1469.2,89.9
"23412","70322","2019",4,4,0,67000,990.5,108
"23413","70323","2019",1,1,0,119270,986,121
"23414","70324","2019",4,3,1,136100,1307.5,104.25
"23415","70325","2019",2,2,0,174000,1747.5,100.5
"23416","70326","2019",2,2,0,218380,1695.5,129.5
"23417","70327","2019",3,3,0,100156.666666667,1214.33333333333,83.6666666666667
"23418","70328","2019",6,6,0,107750,955.833333333333,111.666666666667
"23419","70329","2019",1,1,0,55000,420,131
"23420","70330","2019",1,1,0,265000,1755,151
"23421","70331","2019",6,6,0,79629.1666666667,912.833333333333,87.6666666666667
"23422","70334","2019",11,11,0,135460,1115.45454545455,117.090909090909
"23423","70336","2019",4,4,0,89062.5,981.25,95
"23424","70339","2019",17,17,0,109835.882352941,1215.76470588235,98.5294117647059
"23425","70340","2019",6,6,0,122938.5,945.833333333333,134.666666666667
"23426","70341","2019",1,1,0,94000,1146,82
"23427","70342","2019",1,1,0,90000,508,177
"23428","70343","2019",1,0,1,25000,1000,25
"23429","70344","2019",4,4,0,80370.75,700.25,109.5
"23430","70347","2019",3,3,0,136666.666666667,1055,128.666666666667
"23431","70348","2019",7,7,0,138357.142857143,1540.85714285714,93.8571428571429
"23432","70349","2019",3,3,0,70000,760.333333333333,93.6666666666667
"23433","70352","2019",2,2,0,104500,2911.5,43.5
"23434","70353","2019",6,6,0,115933.333333333,976.333333333333,128.333333333333
"23435","70355","2019",6,6,0,129666.666666667,1591,83.5
"23436","70356","2019",2,2,0,185000,1216.5,150
"23437","70357","2019",6,5,1,101333.333333333,1110.5,99.5
"23438","70359","2019",4,4,0,90375,699,128.25
"23439","70360","2019",2,2,0,56995,436,139.5
"23440","70362","2019",2,2,0,69562.5,920.5,76
"23441","70363","2019",5,5,0,127960,1316.4,98.6
"23442","70364","2019",1,1,0,60000,414,145
"23443","70368","2019",4,4,0,90200,946.25,109
"23444","70373","2019",4,4,0,50625,589.75,91.25
"23445","70376","2019",2,2,0,130000,1214,111.5
"23446","70378","2019",16,11,5,118293.75,1332.625,89
"23447","70380","2019",1,1,0,66000,660,100
"23448","70381","2019",1,1,0,161450,1774,91
"23449","70383","2019",2,2,0,199500,1678.5,118
"23450","70385","2019",3,3,0,147833.333333333,1327,116
"23451","70386","2019",2,2,0,55250,582,95
"23452","70387","2019",6,6,0,123691.666666667,1520.33333333333,90.3333333333333
"23453","70388","2019",25,22,3,133793.2,1365.72,96.4
"23454","70389","2019",1,1,0,106000,1128,94
"23455","70390","2019",3,3,0,143966.666666667,1118,129.333333333333
"23456","70392","2019",2,2,0,57000,548.5,103
"23457","70393","2019",8,8,0,153467.5,1629.375,91
"23458","70395","2019",2,2,0,103000,928.5,115
"23459","70396","2019",1,1,0,65000,707,92
"23460","70399","2019",3,3,0,61166.6666666667,772,79.3333333333333
"23461","70400","2019",1,1,0,85000,1133,75
"23462","70401","2019",1,1,0,50000,476,105
"23463","70402","2019",3,3,0,106333.333333333,802,131.333333333333
"23464","70403","2019",4,4,0,148437.5,1533.75,106.25
"23465","70404","2019",5,5,0,66420,838,79.2
"23466","70405","2019",1,1,0,145000,906,160
"23467","70406","2019",3,3,0,57333.3333333333,786,73
"23468","70407","2019",5,5,0,176460,1714.4,108
"23469","70408","2019",16,16,0,110122.1875,1267.6875,92.375
"23470","70410","2019",8,8,0,186838.125,1702,116.125
"23471","70411","2019",1,1,0,65500,504,130
"23472","70413","2019",25,24,1,127198.6,1305.76,98.48
"23473","70414","2019",16,14,2,110153.125,1133.875,101.4375
"23474","70415","2019",5,5,0,104580,969,111
"23475","70416","2019",2,2,0,155000,1268.5,175
"23476","70417","2019",1,1,0,37000,336,110
"23477","70418","2019",7,7,0,63392.8571428571,753.428571428571,77
"23478","70419","2019",2,2,0,142500,1109.5,127
"23479","70420","2019",1,1,0,120000,1333,90
"23480","70421","2019",41,34,7,110174.146341463,1181.65853658537,98.1463414634146
"23481","70422","2019",6,6,0,146350,1067.66666666667,136.5
"23482","70423","2019",1,1,0,83000,638,130
"23483","70425","2019",1,1,0,55000,1019,54
"23484","70426","2019",1,1,0,195000,1083,180
"23485","70427","2019",5,5,0,85300,1025.2,88.2
"23486","70428","2019",16,16,0,186437.5,1509.5,126.5625
"23487","70429","2019",3,3,0,145766.666666667,1165.33333333333,131.333333333333
"23488","70430","2019",1,1,0,130200,930,140
"23489","70432","2019",3,3,0,133733.333333333,1207.66666666667,111.333333333333
"23490","70433","2019",15,14,1,156699.666666667,1440.73333333333,107.266666666667
"23491","70435","2019",7,7,0,126428.571428571,946.285714285714,129.428571428571
"23492","70436","2019",2,2,0,57450,512,108.5
"23493","70438","2019",6,6,0,149344,930.666666666667,137.833333333333
"23494","70439","2019",6,6,0,78750,941,89.6666666666667
"23495","70441","2019",3,3,0,113166.666666667,1229,105
"23496","70444","2019",1,1,0,185000,1568,118
"23497","70445","2019",1,1,0,90000,1500,60
"23498","70446","2019",3,3,0,120666.666666667,1160.33333333333,104.666666666667
"23499","70447","2019",14,11,3,151360.714285714,1497.14285714286,99.5
"23500","70449","2019",2,2,0,123250,1203.5,101.5
"23501","70451","2019",20,18,2,99002.5,998.3,102.9
"23502","70452","2019",2,2,0,65500,525,125
"23503","70453","2019",4,4,0,139050,2544.75,67.75
"23504","70454","2019",1,1,0,1e+05,645,155
"23505","70455","2019",14,14,0,114760.714285714,1311.21428571429,94
"23506","70456","2019",1,1,0,159000,1871,85
"23507","70457","2019",3,3,0,44960,584,78.3333333333333
"23508","70459","2019",9,9,0,128432.222222222,1116.11111111111,111.111111111111
"23509","70460","2019",4,4,0,85000,1255,83.5
"23510","70461","2019",1,1,0,140000,1186,118
"23511","70462","2019",1,1,0,139000,1562,89
"23512","70463","2019",2,2,0,133625,1265.5,106
"23513","70464","2019",15,14,1,129166.666666667,1295.46666666667,99.3333333333333
"23514","70467","2019",17,16,1,66340.5882352941,950.588235294118,82.9411764705882
"23515","70469","2019",3,3,0,156766.666666667,1231,126
"23516","70470","2019",1,1,0,131600,947,139
"23517","70471","2019",1,1,0,106000,774,137
"23518","70472","2019",1,1,0,67000,399,168
"23519","70473","2019",15,13,2,95366.6666666667,960.333333333333,103.666666666667
"23520","70474","2019",1,1,0,48000,436,110
"23521","70477","2019",5,5,0,141313.4,1228.2,122.8
"23522","70478","2019",8,6,2,104203.75,1012,104.625
"23523","70479","2019",2,2,0,88685,937.5,132
"23524","70480","2019",6,6,0,65268.3333333333,602.833333333333,109.5
"23525","70481","2019",2,2,0,83310,544,131.5
"23526","70482","2019",24,23,1,116360.416666667,1110.33333333333,106.916666666667
"23527","70483","2019",2,2,0,163500,1091,151
"23528","70485","2019",3,3,0,57083.3333333333,650.333333333333,85
"23529","70487","2019",4,4,0,163050,1450,116.25
"23530","70488","2019",3,3,0,69866.6666666667,701.666666666667,102
"23531","70489","2019",7,7,0,109671.428571429,943.857142857143,119.428571428571
"23532","70490","2019",3,3,0,102333.333333333,854.333333333333,119
"23533","70492","2019",7,7,0,79234.2857142857,786.714285714286,99.1428571428571
"23534","70493","2019",5,5,0,212840,1588.2,135
"23535","70494","2019",2,2,0,109925,1065.5,91.5
"23536","70498","2019",7,7,0,152744.285714286,1064,136.285714285714
"23537","70500","2019",2,2,0,170000,1546,106.5
"23538","70501","2019",3,3,0,72500,512.333333333333,145
"23539","70504","2019",6,6,0,100500,1396.33333333333,91.1666666666667
"23540","70505","2019",4,4,0,125277.5,859.25,141.5
"23541","70506","2019",4,4,0,153145,1326.5,114.25
"23542","70507","2019",1,1,0,179500,2137,84
"23543","70510","2019",2,2,0,132500,932,150.5
"23544","70511","2019",3,3,0,74666.6666666667,765,97.3333333333333
"23545","70512","2019",1,1,0,44000,550,80
"23546","70513","2019",26,25,1,149803.461538462,1513.46153846154,104.961538461538
"23547","70514","2019",6,5,1,107666.666666667,1032.33333333333,110.333333333333
"23548","70515","2019",1,1,0,251400,1612,156
"23549","70516","2019",1,1,0,120000,1429,84
"23550","70517","2019",1,1,0,282000,1880,150
"23551","70518","2019",1,1,0,148000,796,186
"23552","70522","2019",1,1,0,60000,545,110
"23553","70523","2019",2,2,0,131000,1071,132.5
"23554","70525","2019",4,4,0,151663.5,1181,136.5
"23555","70526","2019",7,6,1,69267.1428571429,616.285714285714,118
"23556","70528","2019",3,3,0,66666.6666666667,917.666666666667,72.6666666666667
"23557","70529","2019",3,3,0,92166.6666666667,946.666666666667,89
"23558","70530","2019",1,1,0,173500,1886,92
"23559","70532","2019",6,6,0,180294.166666667,1230,138.833333333333
"23560","70533","2019",2,2,0,71000,762.5,94.5
"23561","70534","2019",2,2,0,49000,735.5,66.5
"23562","70535","2019",1,1,0,123610,1104,112
"23563","70537","2019",1,1,0,73150,938,78
"23564","70539","2019",3,3,0,71250,643.666666666667,110
"23565","70541","2019",1,1,0,103880,1367,76
"23566","70545","2019",2,2,0,69500,691.5,99
"23567","70546","2019",3,3,0,64633.3333333333,537,126.666666666667
"23568","70547","2019",2,2,0,120000,998.5,118
"23569","70550","2019",210,63,147,95288.6428571429,1192.41428571429,78.9380952380952
"23570","70552","2019",1,1,0,120000,1237,97
"23571","70553","2019",1,1,0,60000,779,77
"23572","70554","2019",2,2,0,62750,588,109
"23573","70555","2019",3,3,0,116140,915.333333333333,118.666666666667
"23574","70557","2019",1,1,0,184716,1454,127
"23575","70559","2019",2,2,0,139700,1147.5,139.5
"23576","70560","2019",1,1,0,65000,1083,60
"23577","70561","2019",14,11,3,127589.285714286,1327.71428571429,102.5
"23578","70562","2019",1,1,0,170000,1753,97
"23579","70563","2019",1,1,0,194000,1169,166
"23580","70564","2019",2,2,0,71000,917.5,77.5
"23581","70565","2019",1,1,0,70000,795,88
"23582","70566","2019",1,1,0,179000,1455,123
"23583","70567","2019",2,2,0,142000,1279.5,112
"23584","70568","2019",2,2,0,45800,573.5,82
"23585","70569","2019",1,1,0,127400,1169,109
"23586","70572","2019",5,5,0,84200,655.2,125.2
"23587","70573","2019",2,2,0,162500,865,183.5
"23588","70574","2019",1,1,0,109000,741,147
"23589","70575","2019",10,9,1,171850,1703.8,104
"23590","70576","2019",1,1,0,110000,764,144
"23591","70577","2019",1,1,0,152000,760,200
"23592","70578","2019",1,1,0,195000,1950,100
"23593","70579","2019",5,4,1,211191.2,1680.6,128.4
"23594","70580","2019",3,3,0,125050,1046.33333333333,124.333333333333
"23595","70581","2019",6,5,1,88416.6666666667,1032.66666666667,92.1666666666667
"23596","71001","2019",9,9,0,147461.111111111,1169.22222222222,122.666666666667
"23597","71002","2019",13,13,0,141247.692307692,1249.30769230769,114.923076923077
"23598","71003","2019",9,9,0,143777.777777778,1223.33333333333,115.555555555556
"23599","71004","2019",12,12,0,188041.666666667,1822.83333333333,105.916666666667
"23600","71005","2019",10,10,0,145100,1484.4,92.3
"23601","71006","2019",3,3,0,157483.333333333,1457,125.666666666667
"23602","71007","2019",3,3,0,62333.3333333333,727.333333333333,84.3333333333333
"23603","71008","2019",3,3,0,63676.6666666667,1749,56.6666666666667
"23604","71009","2019",11,10,1,113400.181818182,1252.81818181818,107.545454545455
"23605","71010","2019",11,11,0,107438.181818182,1160.09090909091,95.6363636363636
"23606","71011","2019",7,7,0,92171.4285714286,1285.71428571429,90.1428571428571
"23607","71012","2019",2,2,0,201500,1049.5,186.5
"23608","71013","2019",5,5,0,113790,769,158.8
"23609","71014","2019",124,65,59,97050.4758064516,993.935483870968,92.1048387096774
"23610","71015","2019",12,12,0,132113.75,1295.08333333333,105
"23611","71016","2019",10,10,0,174433.5,1636.1,110.5
"23612","71017","2019",2,2,0,115850,864.5,134.5
"23613","71018","2019",5,5,0,112300,1094.8,107.8
"23614","71020","2019",1,1,0,41000,745,55
"23615","71021","2019",3,3,0,156856.666666667,1154,140
"23616","71022","2019",4,4,0,108750,1037,104
"23617","71023","2019",9,9,0,113183.333333333,1086.11111111111,98.8888888888889
"23618","71024","2019",5,5,0,112200,1132.2,107.6
"23619","71025","2019",8,8,0,106175,964.75,130.25
"23620","71027","2019",8,8,0,132856.25,1282.25,107.25
"23621","71028","2019",2,2,0,107350,1461,78
"23622","71029","2019",5,5,0,119880,1286.8,93.8
"23623","71030","2019",6,6,0,224935,1413.66666666667,183.666666666667
"23624","71032","2019",9,7,2,235772.222222222,1990.77777777778,118.555555555556
"23625","71033","2019",5,5,0,163806,1354.6,111.8
"23626","71034","2019",5,5,0,115000,1405,82.2
"23627","71035","2019",1,1,0,64800,648,100
"23628","71036","2019",3,3,0,61966.6666666667,1354,47
"23629","71037","2019",2,2,0,264000,1619,169.5
"23630","71038","2019",2,2,0,138425,1487.5,93
"23631","71039","2019",3,3,0,213900,2144.66666666667,101.666666666667
"23632","71040","2019",38,37,1,104463.157894737,1173.5,87.6842105263158
"23633","71041","2019",2,2,0,71000,980.5,91
"23634","71043","2019",2,2,0,67500,607.5,113
"23635","71044","2019",7,7,0,126071.428571429,1452.42857142857,93.4285714285714
"23636","71045","2019",4,4,0,108915,1244.5,86.5
"23637","71046","2019",1,1,0,74000,622,119
"23638","71047","2019",51,49,2,81721.0784313725,1063.98039215686,82.9803921568627
"23639","71048","2019",3,3,0,89650,787.666666666667,102
"23640","71050","2019",3,3,0,288233.333333333,2440.66666666667,122
"23641","71051","2019",3,3,0,257300,2034.33333333333,126.666666666667
"23642","71052","2019",7,7,0,128142.857142857,1236.71428571429,108.714285714286
"23643","71054","2019",9,9,0,131555.555555556,1508.22222222222,98.5555555555556
"23644","71056","2019",37,35,2,111167.567567568,1141.08108108108,98.2432432432432
"23645","71057","2019",3,2,1,143266.666666667,1239.33333333333,115.333333333333
"23646","71058","2019",4,4,0,226775,1858.5,122.75
"23647","71059","2019",45,45,0,129615,1304.26666666667,100.177777777778
"23648","71060","2019",1,1,0,68000,944,72
"23649","71061","2019",9,9,0,132000,1216.88888888889,120.333333333333
"23650","71062","2019",9,9,0,117177.777777778,1030.11111111111,119.333333333333
"23651","71063","2019",11,11,0,87868.1818181818,979.090909090909,84.4545454545455
"23652","71064","2019",8,8,0,161750,1426.5,111.125
"23653","71065","2019",2,2,0,158500,1420.5,114
"23654","71066","2019",3,3,0,181791.666666667,1191.33333333333,148.333333333333
"23655","71067","2019",2,2,0,52708,1718.5,31
"23656","71069","2019",8,7,1,185755.625,1792.625,105
"23657","71070","2019",29,27,2,167085.862068966,1668.93103448276,102.620689655172
"23658","71071","2019",9,9,0,91398.8888888889,882.444444444444,104.222222222222
"23659","71072","2019",3,3,0,182016.666666667,1279.33333333333,135
"23660","71073","2019",59,49,10,147453.389830508,1625.86440677966,91.6271186440678
"23661","71074","2019",13,13,0,224665.384615385,2136.23076923077,112.153846153846
"23662","71075","2019",7,5,2,87785.7142857143,759.142857142857,105
"23663","71076","2019",724,115,609,90853.8936464088,1204.82872928177,74.4544198895028
"23664","71077","2019",7,7,0,84257.1428571429,827.428571428571,103.142857142857
"23665","71078","2019",2,2,0,33000,516,66
"23666","71079","2019",9,8,1,108450.333333333,1192.88888888889,98.2222222222222
"23667","71081","2019",26,21,5,141810,1479.11538461538,98.3076923076923
"23668","71082","2019",2,2,0,161000,1171,143
"23669","71084","2019",11,10,1,215881.818181818,2021.18181818182,110.818181818182
"23670","71085","2019",5,5,0,138756,1084.2,117.6
"23671","71086","2019",7,7,0,149428.571428571,1386.71428571429,101.142857142857
"23672","71087","2019",3,3,0,206900,1630.33333333333,128
"23673","71088","2019",5,5,0,77738.8,915.8,99.4
"23674","71089","2019",4,4,0,89747.5,1182.25,71.75
"23675","71090","2019",49,42,7,182591.408163265,1832.73469387755,100.69387755102
"23676","71091","2019",5,5,0,166840,1662.6,101.8
"23677","71092","2019",7,7,0,120728.571428571,1001,119.714285714286
"23678","71093","2019",14,14,0,117270.071428571,1287.85714285714,97
"23679","71094","2019",2,2,0,124900,1317,99.5
"23680","71095","2019",4,4,0,51175,705.25,83.25
"23681","71096","2019",3,3,0,110000,1092,93.6666666666667
"23682","71097","2019",13,12,1,125225.769230769,1531.38461538462,89.6923076923077
"23683","71098","2019",3,3,0,52715.3333333333,1253.33333333333,51
"23684","71099","2019",2,2,0,367400,2400.5,154.5
"23685","71100","2019",3,3,0,228666.666666667,1039.33333333333,190
"23686","71101","2019",8,8,0,136831.25,1282.625,107.625
"23687","71102","2019",9,9,0,169464.444444444,1689.22222222222,99
"23688","71103","2019",2,2,0,157350,1243,130
"23689","71104","2019",7,7,0,83857.1428571429,1036.28571428571,86
"23690","71105","2019",132,68,64,180159.636363636,1998.58333333333,89.5075757575758
"23691","71106","2019",29,21,8,109673.655172414,1151.51724137931,95.6896551724138
"23692","71107","2019",4,4,0,195375,1537.5,123
"23693","71109","2019",7,7,0,143664.285714286,1514.71428571429,98.4285714285714
"23694","71110","2019",7,7,0,144210,1157.14285714286,131.142857142857
"23695","71111","2019",1,1,0,110000,659,167
"23696","71112","2019",4,3,1,191597.5,1491,124.25
"23697","71115","2019",1,1,0,170600,1236,138
"23698","71116","2019",2,2,0,57500,784.5,81.5
"23699","71117","2019",18,17,1,184263.111111111,1731.55555555556,107.611111111111
"23700","71118","2019",98,83,15,142426.734693878,1603.9693877551,89.6938775510204
"23701","71119","2019",13,13,0,176473,1582.61538461538,107.615384615385
"23702","71120","2019",56,43,13,91125.8928571429,1079.19642857143,84.8214285714286
"23703","71121","2019",2,2,0,88100,1372.5,63.5
"23704","71122","2019",7,7,0,101875,1462.85714285714,73.4285714285714
"23705","71123","2019",7,7,0,144799.142857143,1286.42857142857,115.285714285714
"23706","71124","2019",4,4,0,138000,1239.5,105.25
"23707","71126","2019",6,6,0,330608,2136.66666666667,157
"23708","71127","2019",1,1,0,42000,400,105
"23709","71128","2019",2,2,0,226000,1877.5,135
"23710","71129","2019",7,7,0,102132.857142857,1106,99.2857142857143
"23711","71130","2019",4,4,0,109398.75,853.25,126.25
"23712","71131","2019",7,7,0,158260,1519.14285714286,106.714285714286
"23713","71132","2019",28,26,2,85952.3214285714,1011.03571428571,87.0357142857143
"23714","71133","2019",19,15,4,99958.9473684211,1109.36842105263,93.8947368421053
"23715","71134","2019",13,13,0,127093.846153846,1253.15384615385,109
"23716","71135","2019",7,7,0,175015,1740.28571428571,103.285714285714
"23717","71136","2019",2,2,0,165000,1194,125
"23718","71137","2019",56,40,16,159597.696428571,1759.51785714286,95.2142857142857
"23719","71139","2019",6,6,0,84696.6666666667,1158.83333333333,76
"23720","71140","2019",2,2,0,152800,1540,100
"23721","71141","2019",10,10,0,144568,1534.6,101.2
"23722","71142","2019",2,2,0,208500,1568.5,129
"23723","71143","2019",10,10,0,126190,1249.8,98.8
"23724","71144","2019",2,2,0,178000,1612,112
"23725","71145","2019",7,6,1,161304.285714286,1836.42857142857,97.1428571428571
"23726","71146","2019",4,4,0,130575,1438.25,77
"23727","71147","2019",6,6,0,153123.333333333,1744.5,90.1666666666667
"23728","71148","2019",7,7,0,102000,1039.42857142857,103.285714285714
"23729","71149","2019",19,19,0,102747.631578947,1079.68421052632,90.3684210526316
"23730","71150","2019",26,21,5,182450.038461538,1788.80769230769,104.346153846154
"23731","71151","2019",2,2,0,77550,925.5,74.5
"23732","71152","2019",1,1,0,70000,897,78
"23733","71153","2019",191,110,81,85906.9267015707,1116.19895287958,81.4607329842932
"23734","71154","2019",25,25,0,179356,1610.08,109.28
"23735","71155","2019",4,4,0,35375,517.25,66
"23736","71156","2019",5,5,0,109680,1104.8,97.2
"23737","71157","2019",18,18,0,98430.4444444444,1244.61111111111,81
"23738","71158","2019",19,18,1,119140.526315789,1435.57894736842,89.3157894736842
"23739","71159","2019",4,4,0,140500,1476.75,92.5
"23740","71160","2019",3,3,0,43000,803,53
"23741","71161","2019",6,6,0,87158.3333333333,804.333333333333,112.166666666667
"23742","71162","2019",9,9,0,80866.6666666667,1025.33333333333,77.3333333333333
"23743","71163","2019",4,4,0,158550,1363.75,115.25
"23744","71164","2019",4,4,0,61153.25,1202.75,52.5
"23745","71165","2019",11,11,0,104395.909090909,1146.81818181818,88.9090909090909
"23746","71166","2019",1,1,0,117000,468,250
"23747","71167","2019",6,5,1,108000,1299.5,86.8333333333333
"23748","71168","2019",3,3,0,138833.333333333,1853.33333333333,74.6666666666667
"23749","71169","2019",6,6,0,260116.666666667,1798.33333333333,142.333333333333
"23750","71170","2019",19,18,1,170793.684210526,1751.94736842105,101.052631578947
"23751","71171","2019",5,5,0,71220,727.4,95.6
"23752","71172","2019",1,1,0,128000,1882,68
"23753","71173","2019",7,7,0,122785.714285714,1106.14285714286,116.571428571429
"23754","71174","2019",1,1,0,30000,857,35
"23755","71175","2019",7,7,0,145857.142857143,1445.57142857143,104.857142857143
"23756","71176","2019",96,71,25,74993.2291666667,923.3125,82.1666666666667
"23757","71177","2019",4,4,0,52250,714,69.25
"23758","71178","2019",11,10,1,124869.545454545,1235.72727272727,102.454545454545
"23759","71181","2019",1,1,0,960000,7559,127
"23760","71182","2019",13,13,0,246562.307692308,1963.23076923077,129.076923076923
"23761","71183","2019",3,3,0,92900,1051.66666666667,79.6666666666667
"23762","71184","2019",1,1,0,150100,888,169
"23763","71185","2019",1,1,0,180500,1517,119
"23764","71186","2019",2,2,0,102432,894.5,106
"23765","71187","2019",17,16,1,94176.4705882353,1137.70588235294,82.8235294117647
"23766","71188","2019",1,1,0,85000,1149,74
"23767","71189","2019",24,24,0,148605,1501.29166666667,99.375
"23768","71190","2019",20,20,0,98001.75,991.45,99.3
"23769","71191","2019",4,4,0,165750,1453,112
"23770","71192","2019",16,16,0,97775,1002.6875,102.4375
"23771","71193","2019",16,16,0,172702.5,1562,113.8125
"23772","71194","2019",4,4,0,259627.5,1812.25,149
"23773","71195","2019",2,2,0,169365,1496.5,113
"23774","71196","2019",16,16,0,134468.75,1261.5,106.5
"23775","71198","2019",10,10,0,100200,1017.5,104.3
"23776","71199","2019",2,2,0,103748,754.5,148
"23777","71200","2019",9,9,0,140490,1121.33333333333,121.888888888889
"23778","71201","2019",3,3,0,178416.666666667,1364,133.333333333333
"23779","71202","2019",20,17,3,179851.85,1711.15,109.35
"23780","71204","2019",8,8,0,188597.5,1833,104.875
"23781","71205","2019",9,9,0,124100,1228.66666666667,101
"23782","71206","2019",3,3,0,155316.666666667,1677.33333333333,92.3333333333333
"23783","71207","2019",5,5,0,48400,671.2,77.2
"23784","71208","2019",4,4,0,90500,923,99.25
"23785","71209","2019",12,12,0,94725,1218.5,89.4166666666667
"23786","71210","2019",2,2,0,196250,1639.5,103.5
"23787","71212","2019",12,11,1,79250.25,1080.5,69.4166666666667
"23788","71213","2019",13,13,0,145880.769230769,1617.38461538462,106.538461538462
"23789","71214","2019",9,9,0,144991.111111111,1519.66666666667,93
"23790","71215","2019",4,4,0,192885,1725.25,116.5
"23791","71216","2019",1,1,0,128000,1684,76
"23792","71218","2019",6,6,0,116392.333333333,1049.33333333333,96.3333333333333
"23793","71219","2019",7,7,0,93842.8571428571,1317.42857142857,99.4285714285714
"23794","71220","2019",6,6,0,63083.3333333333,705.666666666667,84
"23795","71221","2019",42,40,2,211030.30952381,1931.35714285714,111.547619047619
"23796","71222","2019",13,13,0,144630,1194.61538461538,123.769230769231
"23797","71223","2019",5,5,0,96000,1504.8,70.4
"23798","71224","2019",1,1,0,140000,1273,110
"23799","71225","2019",7,7,0,177107.142857143,1562.42857142857,115.857142857143
"23800","71227","2019",7,7,0,62608.5714285714,735,87.4285714285714
"23801","71228","2019",4,4,0,127375,1195.5,108.25
"23802","71229","2019",5,5,0,81586.2,1335,75.2
"23803","71230","2019",69,59,10,77444.8405797101,876.391304347826,86.1739130434783
"23804","71231","2019",8,8,0,155755.375,1354,118.625
"23805","71232","2019",1,1,0,165000,1213,136
"23806","71233","2019",5,5,0,167360,1296.4,115.4
"23807","71234","2019",8,8,0,150500,1342.625,108.625
"23808","71235","2019",12,9,3,198163,1974.66666666667,102.833333333333
"23809","71236","2019",14,13,1,177036,1698.14285714286,119.928571428571
"23810","71237","2019",3,3,0,211833.333333333,2184,96.6666666666667
"23811","71238","2019",17,17,0,124798.529411765,1122.88235294118,113.294117647059
"23812","71239","2019",6,6,0,106462.5,979.333333333333,107.333333333333
"23813","71240","2019",11,11,0,130418.181818182,1770.18181818182,67.6363636363636
"23814","71241","2019",8,8,0,142625,1745.25,96
"23815","71242","2019",8,7,1,120937.5,1358.625,99.875
"23816","71243","2019",8,8,0,131881.25,1228.375,109.125
"23817","71244","2019",9,9,0,118000,1058.88888888889,112
"23818","71245","2019",3,3,0,104480,944,102.666666666667
"23819","71246","2019",2,2,0,95000,1584,62
"23820","71247","2019",2,2,0,107600,1298,80.5
"23821","71248","2019",7,7,0,138957.142857143,1402.28571428571,101.142857142857
"23822","71249","2019",12,12,0,170338.333333333,1554.33333333333,108.166666666667
"23823","71250","2019",13,13,0,171025.384615385,1656.15384615385,106.153846153846
"23824","71251","2019",3,3,0,141666.666666667,1335.66666666667,107.333333333333
"23825","71252","2019",3,3,0,144333.333333333,1450.66666666667,109.666666666667
"23826","71253","2019",12,12,0,178770,1565.16666666667,112.416666666667
"23827","71254","2019",5,5,0,69831.4,882.4,84.4
"23828","71255","2019",2,2,0,132750,1172,104.5
"23829","71256","2019",6,6,0,140891.666666667,1215.5,120.333333333333
"23830","71257","2019",8,8,0,197325,1786.375,114.875
"23831","71258","2019",6,6,0,347805.833333333,3454.66666666667,114.666666666667
"23832","71259","2019",3,3,0,157333.333333333,1016,156.666666666667
"23833","71261","2019",10,10,0,101850.1,1123.9,86.4
"23834","71262","2019",2,2,0,66127,1087,60.5
"23835","71263","2019",116,82,34,126935.387931034,1295.78448275862,99.0258620689655
"23836","71264","2019",3,3,0,119000,1075.33333333333,112.666666666667
"23837","71266","2019",9,9,0,110527.777777778,841.111111111111,135.222222222222
"23838","71267","2019",9,9,0,140666.666666667,1409.22222222222,100.555555555556
"23839","71269","2019",25,16,9,121048.04,1465.56,87
"23840","71270","2019",472,126,346,121610.625,1584.5,76.635593220339
"23841","71271","2019",3,3,0,186583.333333333,975.333333333333,178.666666666667
"23842","71272","2019",6,6,0,145183.333333333,1491.16666666667,79.1666666666667
"23843","71273","2019",3,3,0,101166.666666667,1106.66666666667,105.333333333333
"23844","71274","2019",5,5,0,113340,1011.6,107.6
"23845","71275","2019",23,23,0,111033.043478261,988.565217391304,110.04347826087
"23846","71276","2019",1,1,0,40000,1333,30
"23847","71277","2019",13,13,0,124534.615384615,1122.69230769231,114.538461538462
"23848","71279","2019",16,16,0,129846.4375,1150.875,108.5
"23849","71280","2019",1,1,0,100820,1505,67
"23850","71281","2019",4,4,0,99000,943.5,100.5
"23851","71282","2019",12,12,0,101746.75,1026.5,107.25
"23852","71283","2019",9,9,0,169325,1377.55555555556,126.777777777778
"23853","71284","2019",3,3,0,179146.666666667,1775.66666666667,95
"23854","71285","2019",7,7,0,137514.285714286,1565.28571428571,96.5714285714286
"23855","71286","2019",3,3,0,183200,1697.66666666667,100.333333333333
"23856","71287","2019",8,8,0,101850,980.25,110.75
"23857","71289","2019",5,5,0,97108.4,1534,76.8
"23858","71290","2019",8,8,0,151357.125,1327.125,109
"23859","71291","2019",10,10,0,100633.2,1104.2,90.9
"23860","71292","2019",17,17,0,190791.058823529,1507.58823529412,126.588235294118
"23861","71293","2019",9,9,0,139394.444444444,1377.88888888889,105.222222222222
"23862","71294","2019",8,7,1,163830.25,1631.375,99.875
"23863","71295","2019",18,18,0,113358.333333333,1036.44444444444,113.222222222222
"23864","71296","2019",12,11,1,159455.833333333,1580.33333333333,106.25
"23865","71297","2019",9,9,0,133222.222222222,1294.66666666667,107.888888888889
"23866","71299","2019",5,5,0,229010,2181,109.8
"23867","71300","2019",6,6,0,112833.333333333,1113,103.5
"23868","71301","2019",3,3,0,144966.666666667,1348.33333333333,103.666666666667
"23869","71302","2019",5,5,0,183030,1722,105.8
"23870","71303","2019",9,9,0,174967.333333333,1576.33333333333,101.777777777778
"23871","71305","2019",11,9,2,171887.272727273,1413.81818181818,143.454545454545
"23872","71306","2019",150,112,38,85352.0266666667,962.926666666667,87.3733333333333
"23873","71307","2019",6,6,0,128410,1125.33333333333,110
"23874","71308","2019",1,1,0,110000,1236,89
"23875","71309","2019",19,17,2,120569.473684211,1187.10526315789,102.894736842105
"23876","71310","2019",46,39,7,104864.782608696,1225.32608695652,83.5652173913043
"23877","71311","2019",4,4,0,101875,885.5,114.75
"23878","71312","2019",1,1,0,96000,1143,84
"23879","71313","2019",2,2,0,175000,1510,117
"23880","71314","2019",2,2,0,66500,711,88
"23881","71315","2019",1,1,0,109000,1124,97
"23882","71316","2019",6,6,0,100416.666666667,1259.16666666667,80.3333333333333
"23883","71317","2019",2,2,0,125000,1152.5,112.5
"23884","71318","2019",23,22,1,131653.043478261,1390.21739130435,96.9130434782609
"23885","71319","2019",6,6,0,117750,1204.83333333333,94.3333333333333
"23886","71320","2019",4,4,0,186445,1769.5,100.75
"23887","71321","2019",2,2,0,60000,1015.5,67
"23888","71322","2019",2,2,0,559000,8042.5,88
"23889","71323","2019",5,5,0,95097.2,926.6,99.6
"23890","71324","2019",3,3,0,221633.333333333,1963.33333333333,137.333333333333
"23891","71325","2019",14,14,0,108973.214285714,1023.14285714286,98.9285714285714
"23892","71326","2019",10,10,0,74770,806.9,94.2
"23893","71327","2019",5,5,0,125780,1019.8,131.8
"23894","71328","2019",11,11,0,128567.636363636,1439.18181818182,91.5454545454545
"23895","71329","2019",7,7,0,79871.4285714286,801.857142857143,106.714285714286
"23896","71330","2019",6,6,0,74816.6666666667,995.166666666667,78.5
"23897","71332","2019",11,11,0,100282.727272727,1137.63636363636,89.1818181818182
"23898","71333","2019",16,16,0,158312.5,1621.625,96.9375
"23899","71334","2019",3,3,0,71666.6666666667,856.333333333333,83.3333333333333
"23900","71335","2019",4,4,0,54000,747.25,89.25
"23901","71336","2019",22,22,0,165666.363636364,1566.18181818182,111.909090909091
"23902","71337","2019",4,4,0,190650,1334,139.25
"23903","71338","2019",5,5,0,176666,1691,108.8
"23904","71339","2019",4,4,0,120550,1373.5,92.25
"23905","71340","2019",22,21,1,96822.1363636364,977.681818181818,101.136363636364
"23906","71341","2019",3,3,0,171500,1655.66666666667,105.666666666667
"23907","71342","2019",134,76,58,104116.156716418,1452.52985074627,78.0597014925373
"23908","71343","2019",8,8,0,181694,1337.125,145.25
"23909","71344","2019",1,1,0,51000,567,90
"23910","71345","2019",9,9,0,177465.444444444,1578,116.111111111111
"23911","71346","2019",16,15,1,101361.6875,1067.375,92.4375
"23912","71347","2019",9,9,0,96073.3333333333,1199.55555555556,77.5555555555556
"23913","71348","2019",4,4,0,66000,742.25,80.75
"23914","71349","2019",1,1,0,34000,630,54
"23915","71350","2019",4,3,1,262957.5,2556,111.5
"23916","71351","2019",33,32,1,113583.03030303,1118.09090909091,102.393939393939
"23917","71353","2019",7,7,0,137600,1582.42857142857,90.2857142857143
"23918","71354","2019",6,6,0,87490,1028.5,88
"23919","71355","2019",4,4,0,89487.5,1029.75,89.5
"23920","71356","2019",16,16,0,128483.125,1159.625,108.6875
"23921","71357","2019",4,4,0,94012.5,870.75,114.25
"23922","71358","2019",8,8,0,183450,1845.375,105
"23923","71359","2019",8,8,0,158951.25,1628.375,95.625
"23924","71360","2019",18,17,1,209318.777777778,1648.16666666667,131.833333333333
"23925","71361","2019",1,1,0,591640,2233,265
"23926","71362","2019",2,2,0,222500,2199.5,102
"23927","71363","2019",2,2,0,98250,1176,91
"23928","71364","2019",3,3,0,122533.333333333,1248.33333333333,117
"23929","71365","2019",6,6,0,102283.333333333,1066.33333333333,90.1666666666667
"23930","71366","2019",3,3,0,93666.6666666667,859.666666666667,99.3333333333333
"23931","71367","2019",6,6,0,110333.333333333,1362.5,79
"23932","71368","2019",3,3,0,104110,978.666666666667,108
"23933","71369","2019",2,2,0,55000,833.5,58.5
"23934","71370","2019",9,9,0,110267.444444444,926.666666666667,126.666666666667
"23935","71371","2019",9,9,0,158961.111111111,1543.55555555556,106.222222222222
"23936","71372","2019",14,14,0,177960.714285714,2037.35714285714,100.428571428571
"23937","71373","2019",13,13,0,131300,1171.61538461538,112.769230769231
"23938","71374","2019",1,1,0,485191,2958,164
"23939","71376","2019",4,4,0,85000,1042,82.5
"23940","71377","2019",2,2,0,149500,1643.5,104.5
"23941","71378","2019",14,14,0,138017.857142857,1489.78571428571,94.5
"23942","71379","2019",18,18,0,133425,1073.94444444444,125.777777777778
"23943","71380","2019",14,14,0,162392.857142857,1451.35714285714,110.428571428571
"23944","71381","2019",1,1,0,200900,1168,172
"23945","71382","2019",11,10,1,83327.2727272727,991.636363636364,87.3636363636364
"23946","71383","2019",6,6,0,160551.666666667,1572,106.333333333333
"23947","71384","2019",3,3,0,138156.666666667,1384,99.6666666666667
"23948","71385","2019",7,7,0,200450,1616.28571428571,120.285714285714
"23949","71386","2019",1,1,0,149000,968,154
"23950","71387","2019",3,3,0,77366.6666666667,1050,77.6666666666667
"23951","71388","2019",6,6,0,92883.3333333333,965.166666666667,94.1666666666667
"23952","71389","2019",2,2,0,73850,702,104
"23953","71390","2019",8,8,0,95475,1061.75,88.25
"23954","71391","2019",11,11,0,94363.6363636364,1062.18181818182,87
"23955","71392","2019",4,4,0,119175,1456.25,85
"23956","71393","2019",4,4,0,72125,761.5,101.5
"23957","71394","2019",8,8,0,131852.5,1223.375,105.875
"23958","71395","2019",6,6,0,135833.333333333,1190.5,118.5
"23959","71396","2019",12,12,0,88041.6666666667,1008.25,92
"23960","71397","2019",1,1,0,240000,2857,84
"23961","71398","2019",10,10,0,142420,1395.7,104.9
"23962","71399","2019",11,10,1,138857.272727273,1062.27272727273,124.545454545455
"23963","71400","2019",2,2,0,173500,1904,88.5
"23964","71401","2019",12,12,0,108191.666666667,1371.91666666667,84.1666666666667
"23965","71402","2019",4,4,0,154725,1387.75,111.75
"23966","71403","2019",3,3,0,110000,1592.33333333333,72
"23967","71404","2019",17,16,1,129453.529411765,1419.41176470588,92
"23968","71405","2019",2,2,0,115500,1066,112.5
"23969","71406","2019",2,2,0,119950,1236,110.5
"23970","71407","2019",4,4,0,58750,1024.5,61.5
"23971","71408","2019",6,5,1,122083.333333333,1232.16666666667,105.666666666667
"23972","71409","2019",4,4,0,59372.5,627.25,94.75
"23973","71410","2019",7,7,0,136135.714285714,1300.28571428571,99.5714285714286
"23974","71411","2019",3,3,0,73666.6666666667,1099.66666666667,63
"23975","71412","2019",6,6,0,149891.666666667,1401,105.833333333333
"23976","71413","2019",6,6,0,133062.166666667,1313.33333333333,98
"23977","71414","2019",7,7,0,133467,1260,107.428571428571
"23978","71415","2019",1,1,0,50000,549,91
"23979","71416","2019",6,6,0,72000,1771.66666666667,60.1666666666667
"23980","71417","2019",18,17,1,87977.7777777778,983.277777777778,91.5
"23981","71419","2019",36,34,2,146270.833333333,1382.08333333333,104.861111111111
"23982","71420","2019",24,22,2,148186.25,1492.33333333333,107.166666666667
"23983","71421","2019",2,2,0,89600,981,91.5
"23984","71422","2019",3,3,0,179206.666666667,1620.33333333333,110.666666666667
"23985","71423","2019",9,9,0,174922.222222222,1417.55555555556,132.444444444444
"23986","71424","2019",4,4,0,162375,990,168.5
"23987","71425","2019",4,3,1,81750,946.25,85.25
"23988","71426","2019",4,4,0,185730,1618.5,103.5
"23989","71427","2019",2,2,0,95000,732.5,135
"23990","71428","2019",5,5,0,100140,1107,97.4
"23991","71430","2019",11,11,0,208183.636363636,1563.81818181818,133.818181818182
"23992","71431","2019",7,7,0,102271.428571429,1073,102.857142857143
"23993","71433","2019",2,2,0,82750,1052.5,80
"23994","71434","2019",7,7,0,82714.2857142857,775.857142857143,107.714285714286
"23995","71435","2019",3,3,0,63666.6666666667,684,96.6666666666667
"23996","71436","2019",7,7,0,142571.428571429,1442.85714285714,98.8571428571429
"23997","71437","2019",5,5,0,149290,991.8,130
"23998","71438","2019",7,7,0,101182.857142857,1029.85714285714,102.857142857143
"23999","71439","2019",3,3,0,146366.666666667,1416,106
"24000","71440","2019",5,4,1,68800,813.6,90.4
"24001","71441","2019",1,1,0,94000,1119,84
"24002","71442","2019",16,16,0,122674.375,1382.625,89.125
"24003","71443","2019",16,15,1,169883.875,1671.5,106.125
"24004","71444","2019",10,10,0,170715,1482.2,115.1
"24005","71445","2019",77,57,20,135445.038961039,1539.97402597403,87.3116883116883
"24006","71446","2019",2,2,0,214150,1240,162.5
"24007","71447","2019",5,5,0,159020,1286.2,122
"24008","71448","2019",15,15,0,168681.666666667,1832.93333333333,95.4666666666667
"24009","71449","2019",2,2,0,228775,2241,106.5
"24010","71450","2019",1,1,0,29340,524,56
"24011","71452","2019",7,7,0,123278.571428571,1350.71428571429,92.8571428571429
"24012","71453","2019",2,2,0,95750,835,112
"24013","71454","2019",5,5,0,144300,1404.6,103
"24014","71455","2019",1,1,0,29500,656,45
"24015","71456","2019",16,16,0,126288.3125,1199,104.8125
"24016","71457","2019",2,2,0,85500,917.5,77.5
"24017","71459","2019",3,2,1,120723.333333333,738.666666666667,161
"24018","71460","2019",6,6,0,255520,1976,126.333333333333
"24019","71462","2019",7,7,0,109545.714285714,1047.57142857143,99.8571428571429
"24020","71463","2019",7,7,0,124283.857142857,1364.42857142857,94.8571428571429
"24021","71464","2019",3,3,0,178450,1650,106.666666666667
"24022","71465","2019",6,6,0,119149.333333333,874.833333333333,132
"24023","71466","2019",1,1,0,155000,1033,150
"24024","71468","2019",6,6,0,150333.333333333,1417,97.6666666666667
"24025","71469","2019",4,4,0,99135,1073.75,90.75
"24026","71470","2019",2,2,0,72300,727,114
"24027","71471","2019",1,1,0,220000,1746,126
"24028","71472","2019",1,1,0,84500,768,110
"24029","71473","2019",7,7,0,99804.7142857143,1107.85714285714,118.571428571429
"24030","71474","2019",3,3,0,76333.3333333333,958.666666666667,84.3333333333333
"24031","71475","2019",71,58,13,147465.591549296,1642.87323943662,92.6901408450704
"24032","71477","2019",5,5,0,165548,1489.8,120.2
"24033","71479","2019",22,22,0,116105.454545455,1309.36363636364,94.6363636363636
"24034","71480","2019",7,7,0,86554.2857142857,1051.14285714286,83.1428571428571
"24035","71481","2019",21,21,0,167220.714285714,1748.2380952381,95.6190476190476
"24036","71482","2019",5,4,1,115300,1280,88.6
"24037","71483","2019",5,5,0,180780,1503,128
"24038","71484","2019",24,24,0,129411.25,1200.83333333333,106.416666666667
"24039","71485","2019",5,5,0,130750,1165.8,117.8
"24040","71486","2019",109,103,6,104835.348623853,1163.42201834862,91.3577981651376
"24041","71487","2019",1,0,1,253000,5060,50
"24042","71488","2019",2,2,0,161500,1408.5,99.5
"24043","71489","2019",7,7,0,106857.142857143,1167.28571428571,87.2857142857143
"24044","71490","2019",9,9,0,143916.666666667,979.666666666667,139.777777777778
"24045","71491","2019",11,11,0,130433.636363636,987.272727272727,123.363636363636
"24046","71492","2019",6,6,0,100467.5,1092.5,99.1666666666667
"24047","71493","2019",5,5,0,84300,1041.6,84.8
"24048","71494","2019",6,6,0,146974.166666667,1567.16666666667,91.5
"24049","71495","2019",11,10,1,155690.909090909,1641.45454545455,98
"24050","71496","2019",4,4,0,53312.5,788.5,77
"24051","71497","2019",16,12,4,211826.25,1812.5625,115.4375
"24052","71498","2019",1,1,0,38000,633,60
"24053","71499","2019",48,48,0,92457.3333333333,968.458333333333,95.1458333333333
"24054","71500","2019",2,2,0,60000,543.5,112
"24055","71501","2019",6,6,0,165175,1785,96
"24056","71502","2019",12,12,0,164341.666666667,1553.66666666667,111.583333333333
"24057","71504","2019",5,5,0,118800,1221.6,118
"24058","71506","2019",18,18,0,137886.111111111,1365.44444444444,106.777777777778
"24059","71507","2019",4,4,0,94250,1066.25,87.25
"24060","71508","2019",5,4,1,124500,1234.2,97.8
"24061","71509","2019",6,5,1,78583.3333333333,954,83.8333333333333
"24062","71510","2019",5,5,0,94300,913.2,106.8
"24063","71512","2019",25,21,4,140316.24,1454.12,100.4
"24064","71513","2019",19,19,0,222793.157894737,1879.94736842105,119.263157894737
"24065","71514","2019",7,7,0,98642.8571428571,1139.42857142857,89.8571428571429
"24066","71515","2019",1,1,0,122600,1264,97
"24067","71516","2019",6,6,0,154333.333333333,1367.16666666667,118
"24068","71517","2019",1,1,0,93000,1162,80
"24069","71518","2019",5,5,0,167370,2378.4,87
"24070","71520","2019",8,8,0,165618.75,1652.375,110.5
"24071","71521","2019",2,2,0,84500,1015.5,80
"24072","71522","2019",23,23,0,156854.782608696,1274.82608695652,120.434782608696
"24073","71523","2019",15,15,0,110273.333333333,1276.2,89.1333333333333
"24074","71524","2019",3,3,0,134533.333333333,1941,70.3333333333333
"24075","71525","2019",7,7,0,206221.428571429,1942.42857142857,118.428571428571
"24076","71526","2019",1,1,0,375000,5515,68
"24077","71527","2019",5,5,0,71600,866.8,90.2
"24078","71528","2019",28,28,0,119267.392857143,1240.28571428571,97.6071428571429
"24079","71529","2019",5,5,0,156200,1694,85.6
"24080","71530","2019",7,7,0,79857.1428571429,918.142857142857,93
"24081","71531","2019",8,7,1,92587.5,1223.625,72.5
"24082","71533","2019",2,2,0,104000,1175.5,88
"24083","71535","2019",5,5,0,84000,1029,80
"24084","71538","2019",9,9,0,142222.222222222,1461.11111111111,93.4444444444444
"24085","71540","2019",8,8,0,134313.75,1385.375,102.875
"24086","71541","2019",6,6,0,58283.3333333333,904.166666666667,72.6666666666667
"24087","71542","2019",16,16,0,73413.625,1122.1875,91.9375
"24088","71543","2019",78,47,31,107815.192307692,1149.12820512821,93.974358974359
"24089","71544","2019",3,3,0,131966.666666667,1306,97.3333333333333
"24090","71545","2019",14,14,0,114622.142857143,1321.35714285714,89
"24091","71546","2019",7,7,0,116757.142857143,1352,92.5714285714286
"24092","71547","2019",8,8,0,132510.125,1202.25,107.375
"24093","71548","2019",4,4,0,139823.75,1388.5,99.75
"24094","71549","2019",2,2,0,86000,833.5,104
"24095","71550","2019",10,10,0,126981,1306.4,107.7
"24096","71551","2019",3,3,0,146666.666666667,1268.66666666667,84.3333333333333
"24097","71552","2019",5,5,0,95580,1252.6,94.8
"24098","71553","2019",1,1,0,70000,1750,40
"24099","71554","2019",2,2,0,114500,533.5,208.5
"24100","71555","2019",20,17,3,161038.15,1532.9,106.25
"24101","71556","2019",4,4,0,158750,1832.5,91.5
"24102","71557","2019",7,7,0,146285.714285714,1371.28571428571,105
"24103","71558","2019",10,9,1,121470,1219.6,94.6
"24104","71559","2019",3,3,0,73333.3333333333,1013.66666666667,72.3333333333333
"24105","71561","2019",3,3,0,107220,1122,92.3333333333333
"24106","71562","2019",1,1,0,110000,1038,106
"24107","71563","2019",1,1,0,50000,417,120
"24108","71564","2019",9,9,0,108611.111111111,1167.55555555556,92.6666666666667
"24109","71565","2019",4,4,0,55750,524.5,115.25
"24110","71566","2019",16,13,3,82583.75,981.75,87.1875
"24111","71568","2019",1,1,0,154000,1339,115
"24112","71570","2019",5,5,0,111400,1215.8,91
"24113","71571","2019",6,6,0,157903.5,1374.33333333333,114
"24114","71572","2019",2,2,0,277680,2087.5,132
"24115","71573","2019",3,3,0,115833.333333333,896.333333333333,137.666666666667
"24116","71574","2019",7,6,1,190376.142857143,1835.71428571429,106.142857142857
"24117","71576","2019",2,2,0,99500,1131,88.5
"24118","71577","2019",2,2,0,202500,1597,152.5
"24119","71578","2019",8,8,0,127812.5,1291.375,102.75
"24120","71580","2019",3,3,0,110333.333333333,1123.33333333333,95
"24121","71581","2019",4,4,0,168931.75,1407,97
"24122","71582","2019",8,8,0,230695,1719.75,129.375
"24123","71583","2019",6,6,0,184475,1834,101.666666666667
"24124","71584","2019",15,15,0,157711.333333333,1452.4,107.866666666667
"24125","71585","2019",14,14,0,217289.285714286,1608.78571428571,132.5
"24126","71586","2019",6,6,0,146500,1233.33333333333,114.833333333333
"24127","71588","2019",10,10,0,105750,1208.5,90.1
"24128","71589","2019",2,2,0,58750,887.5,75
"24129","71590","2019",2,2,0,181000,1802.5,99.5
"24130","71591","2019",7,6,1,120364.285714286,1660.42857142857,71
"24131","72001","2019",7,7,0,188892.571428571,1949.71428571429,97.7142857142857
"24132","72002","2019",3,3,0,107540,941,114.666666666667
"24133","72003","2019",98,72,26,119803.663265306,1358.89795918367,86.7448979591837
"24134","72004","2019",9,9,0,124221.111111111,1373.55555555556,98.3333333333333
"24135","72005","2019",10,10,0,107148,1048.3,110.2
"24136","72006","2019",20,20,0,157830,1675.2,95.7
"24137","72007","2019",1,1,0,204000,1291,158
"24138","72008","2019",74,73,1,148525.540540541,1604.37837837838,95.472972972973
"24139","72009","2019",5,5,0,111902,1226.6,87.8
"24140","72010","2019",8,8,0,157100,1441.25,93.875
"24141","72011","2019",13,13,0,92243.5384615385,1241.92307692308,80.3076923076923
"24142","72012","2019",7,7,0,87701.4285714286,1236.71428571429,81.2857142857143
"24143","72013","2019",43,43,0,78226.023255814,936.325581395349,84.2790697674419
"24144","72015","2019",3,3,0,44333.3333333333,399.666666666667,115
"24145","72016","2019",23,23,0,114264.434782609,1214.86956521739,99.2173913043478
"24146","72017","2019",3,3,0,154000,1777,94.6666666666667
"24147","72018","2019",2,2,0,147500,1245.5,118.5
"24148","72019","2019",5,5,0,118000,928.8,127.2
"24149","72020","2019",10,10,0,136650,1566.3,90.6
"24150","72021","2019",2,2,0,47500,773,61
"24151","72022","2019",23,23,0,124479.130434783,1155.65217391304,104.434782608696
"24152","72023","2019",38,38,0,105959.421052632,1092.68421052632,96.7368421052632
"24153","72024","2019",38,38,0,165821.657894737,1576.5,106.289473684211
"24154","72025","2019",30,30,0,141899.666666667,1245.56666666667,115.133333333333
"24155","72026","2019",21,21,0,130569.761904762,1390.52380952381,95.3333333333333
"24156","72027","2019",3,3,0,116666.666666667,1015,109
"24157","72028","2019",12,12,0,89741.6666666667,1258.33333333333,91.5
"24158","72029","2019",31,30,1,123271.612903226,1377.35483870968,93.1612903225806
"24159","72031","2019",11,11,0,90340,1044.81818181818,85
"24160","72032","2019",4,4,0,133250,1036.5,126.25
"24161","72034","2019",3,3,0,195000,1798.66666666667,119.666666666667
"24162","72035","2019",33,31,2,74584.8484848485,867,83.6969696969697
"24163","72036","2019",6,6,0,143300,1349.83333333333,111.833333333333
"24164","72037","2019",3,3,0,95166.6666666667,1087.66666666667,84.6666666666667
"24165","72038","2019",13,13,0,106000,973.923076923077,105.153846153846
"24166","72039","2019",66,64,2,93831.7121212121,1026.45454545455,89.6515151515152
"24167","72040","2019",1,1,0,115500,1069,108
"24168","72041","2019",6,6,0,125730,1291,95.3333333333333
"24169","72042","2019",30,30,0,105134.6,1150,89.6
"24170","72043","2019",7,7,0,71642.8571428571,930.571428571429,77.8571428571429
"24171","72044","2019",7,7,0,134357.142857143,1170.71428571429,113.428571428571
"24172","72045","2019",5,5,0,134800,1843.8,82.2
"24173","72046","2019",20,20,0,112075,1286.15,85.15
"24174","72047","2019",17,17,0,154729.411764706,1585.41176470588,96.7058823529412
"24175","72048","2019",11,11,0,132971.818181818,1192.09090909091,115.090909090909
"24176","72049","2019",3,3,0,84966.6666666667,1302.33333333333,62.3333333333333
"24177","72050","2019",22,22,0,98436.1818181818,1025.45454545455,98.0454545454545
"24178","72051","2019",51,51,0,142067.843137255,1387.50980392157,104.392156862745
"24179","72052","2019",16,16,0,87056.25,1139.625,88
"24180","72053","2019",15,15,0,140620,1669.06666666667,98
"24181","72054","2019",31,30,1,144631.838709677,1519.8064516129,94.3225806451613
"24182","72056","2019",11,11,0,127940.909090909,1189,106.545454545455
"24183","72058","2019",65,64,1,206145.953846154,1783.83076923077,119.246153846154
"24184","72059","2019",6,6,0,129997.5,1249.16666666667,114.5
"24185","72060","2019",4,4,0,76750,736,98.75
"24186","72061","2019",28,28,0,145182.142857143,1358.25,108.178571428571
"24187","72062","2019",10,10,0,93200,1084.3,87.4
"24188","72064","2019",3,3,0,75666.6666666667,662.666666666667,121.666666666667
"24189","72065","2019",34,34,0,192511.205882353,1931.20588235294,101.676470588235
"24190","72066","2019",8,8,0,146687.5,1380.125,105.25
"24191","72067","2019",17,17,0,106284.705882353,1193,94.5294117647059
"24192","72068","2019",20,20,0,97986.25,1051.05,90.35
"24193","72070","2019",2,2,0,58500,655,86
"24194","72071","2019",85,83,2,99381.0941176471,1084.22352941176,91.5411764705882
"24195","72072","2019",2,2,0,139500,1082.5,129.5
"24196","72073","2019",8,8,0,153250,1548.25,102.75
"24197","72074","2019",3,3,0,85000,1230.33333333333,66.6666666666667
"24198","72075","2019",10,10,0,95230,1086,83
"24199","72076","2019",4,4,0,94325,1124.5,78.75
"24200","72077","2019",4,4,0,136177.5,1148.5,115.75
"24201","72078","2019",4,4,0,109877.5,1088.25,101
"24202","72079","2019",3,3,0,139183.333333333,1337,102.333333333333
"24203","72080","2019",24,24,0,198335.041666667,2010.83333333333,99.5833333333333
"24204","72083","2019",3,3,0,96666.6666666667,1049.33333333333,82.3333333333333
"24205","72084","2019",25,25,0,124845.88,1195.88,107
"24206","72085","2019",1,1,0,130000,1083,120
"24207","72086","2019",3,3,0,139666.666666667,1098.33333333333,133
"24208","72087","2019",6,6,0,89083.3333333333,808.333333333333,107.833333333333
"24209","72088","2019",1,1,0,159500,1218,131
"24210","72089","2019",31,31,0,141058.387096774,1335.09677419355,106.548387096774
"24211","72090","2019",41,40,1,107251.707317073,1322.34146341463,86.1707317073171
"24212","72091","2019",1,1,0,65700,738,89
"24213","72093","2019",11,11,0,117500,1300.63636363636,86.5454545454545
"24214","72094","2019",9,9,0,74666.6666666667,807.111111111111,94
"24215","72095","2019",67,48,19,151120.746268657,1653.88059701493,91.5223880597015
"24216","72096","2019",24,24,0,150369.375,1370.20833333333,110.375
"24217","72098","2019",5,5,0,85128,642.8,133.2
"24218","72099","2019",6,6,0,120658.333333333,1244.16666666667,94.5
"24219","72100","2019",4,4,0,131375,938,160.5
"24220","72101","2019",12,12,0,95284.8333333333,1002.83333333333,103.25
"24221","72102","2019",5,5,0,152400,1337.4,119.8
"24222","72103","2019",8,8,0,109250,1120,107.625
"24223","72104","2019",8,8,0,90212.5,977.375,107.5
"24224","72105","2019",9,9,0,144666.666666667,1360.77777777778,99.8888888888889
"24225","72106","2019",14,14,0,148542.857142857,1415,110.428571428571
"24226","72107","2019",7,7,0,206071.428571429,1416.85714285714,145.857142857143
"24227","72109","2019",3,3,0,136666.666666667,1027,134.666666666667
"24228","72110","2019",14,14,0,105971.428571429,1204.64285714286,86.0714285714286
"24229","72111","2019",4,4,0,133750,1216.75,109.75
"24230","72112","2019",13,13,0,112386.923076923,1111.53846153846,100.461538461538
"24231","72113","2019",12,12,0,142548.333333333,1540.58333333333,92.3333333333333
"24232","72114","2019",2,2,0,112000,881.5,111
"24233","72115","2019",7,7,0,95000,1042.28571428571,94.5714285714286
"24234","72118","2019",29,29,0,129893.103448276,1215.51724137931,109.310344827586
"24235","72119","2019",15,15,0,135342,1386.66666666667,96.2
"24236","72120","2019",2,2,0,132250,1223.5,108
"24237","72121","2019",4,4,0,100113.75,1232.25,95
"24238","72122","2019",16,16,0,128687.5,1213.9375,107.625
"24239","72124","2019",83,81,2,125112.180722892,1382.77108433735,92.1204819277108
"24240","72125","2019",5,5,0,75810,1005.2,73.6
"24241","72126","2019",7,7,0,136657.714285714,1378.57142857143,112
"24242","72127","2019",17,17,0,179674.705882353,1655.82352941176,111.764705882353
"24243","72128","2019",7,7,0,119335.142857143,1271.71428571429,93.2857142857143
"24244","72129","2019",4,4,0,181612.5,1613.25,113.75
"24245","72130","2019",10,10,0,192660,1668.5,115.1
"24246","72131","2019",8,8,0,134375,1446.625,96.25
"24247","72132","2019",2,2,0,107500,1252,84.5
"24248","72133","2019",22,22,0,163466.363636364,1666.54545454545,101
"24249","72134","2019",10,10,0,100546.5,961.8,106.4
"24250","72135","2019",8,8,0,118072.5,1267.5,90
"24251","72136","2019",3,3,0,104166.666666667,1104.33333333333,98.6666666666667
"24252","72137","2019",27,27,0,112725.555555556,1135.81481481481,103.481481481481
"24253","72138","2019",35,34,1,77803.1428571429,857.571428571429,92.0857142857143
"24254","72139","2019",8,8,0,137762.5,1458.625,95.5
"24255","72141","2019",2,2,0,114000,1378,83
"24256","72142","2019",2,2,0,136250,1274.5,108.5
"24257","72143","2019",18,18,0,111161.944444444,970.666666666667,113.666666666667
"24258","72144","2019",8,8,0,70061.25,983.375,81.5
"24259","72145","2019",1,1,0,128000,1267,101
"24260","72146","2019",38,37,1,180826.315789474,1625,115.868421052632
"24261","72147","2019",19,19,0,164578.947368421,1509.47368421053,113.210526315789
"24262","72148","2019",2,2,0,125500,1485.5,85
"24263","72149","2019",4,4,0,82650,961,77.75
"24264","72150","2019",11,11,0,155014.545454545,1462.90909090909,104
"24265","72151","2019",14,14,0,137157.142857143,1194.35714285714,115.785714285714
"24266","72152","2019",6,6,0,137333.333333333,1284.16666666667,105.666666666667
"24267","72153","2019",16,16,0,88593.75,949.75,95.125
"24268","72154","2019",203,184,19,140957.581280788,1419.41379310345,102.463054187192
"24269","72155","2019",17,17,0,186100.941176471,1570.23529411765,122.529411764706
"24270","72156","2019",13,13,0,114543.076923077,1132.15384615385,99.9230769230769
"24271","72157","2019",12,11,1,202451.666666667,1988.16666666667,112.75
"24272","72158","2019",16,16,0,104913.75,1177.9375,92.375
"24273","72160","2019",10,10,0,109560,1274.4,85.6
"24274","72161","2019",11,11,0,74490.9090909091,982.636363636364,84.3636363636364
"24275","72163","2019",5,5,0,111063,1149.2,96.2
"24276","72165","2019",22,22,0,153707.727272727,1408.90909090909,110.272727272727
"24277","72166","2019",4,4,0,81338,953.25,89.75
"24278","72167","2019",5,5,0,132500,1166.2,122.2
"24279","72168","2019",32,32,0,107570.46875,1087.75,95.6875
"24280","72169","2019",19,19,0,165081.105263158,1690.68421052632,98.8947368421053
"24281","72170","2019",5,5,0,85000,862.6,93.4
"24282","72171","2019",1,1,0,45000,592,76
"24283","72172","2019",4,4,0,118712.5,1073.25,129.5
"24284","72173","2019",11,11,0,144363.636363636,1388.27272727273,98
"24285","72174","2019",3,3,0,73500,819,88.6666666666667
"24286","72175","2019",24,24,0,114966.666666667,1126.875,108.166666666667
"24287","72176","2019",45,44,1,87414.8888888889,892.644444444444,93.0444444444445
"24288","72177","2019",5,5,0,173700,1313.4,131.6
"24289","72178","2019",3,3,0,112833.333333333,1095.66666666667,103.666666666667
"24290","72179","2019",26,25,1,89538.4615384615,947.384615384615,94.0384615384615
"24291","72180","2019",52,49,3,87226.9230769231,882.519230769231,103.596153846154
"24292","72181","2019",2659,1288,1371,124846.48176006,1671.03196690485,73.1090635577285
"24293","72182","2019",13,13,0,93448.4615384615,1342.38461538462,79.0769230769231
"24294","72183","2019",20,20,0,104627.5,1082.5,94.2
"24295","72184","2019",5,5,0,322699.6,3305.2,119.4
"24296","72185","2019",13,13,0,115400,1145.92307692308,105.076923076923
"24297","72186","2019",10,10,0,104409,1074.3,93.3
"24298","72187","2019",19,19,0,122242.105263158,1224.78947368421,97.3157894736842
"24299","72188","2019",1,1,0,102000,1259,81
"24300","72189","2019",17,17,0,102117.647058824,1140.64705882353,91.2352941176471
"24301","72190","2019",4,4,0,118000,1074.5,111.75
"24302","72191","2019",56,56,0,114108.035714286,1225.30357142857,96.5
"24303","72192","2019",3,3,0,56000,641.666666666667,90.6666666666667
"24304","72193","2019",5,5,0,83840,825.4,95.8
"24305","72194","2019",3,3,0,87000,1142,75.3333333333333
"24306","72195","2019",22,21,1,107250,1330.5,84.8181818181818
"24307","72196","2019",14,14,0,101660.714285714,1067.07142857143,97.0714285714286
"24308","72197","2019",8,8,0,114673.625,1120.25,100.625
"24309","72198","2019",34,34,0,206921.852941176,1940.17647058824,109.558823529412
"24310","72199","2019",3,3,0,101776.666666667,1141,101.666666666667
"24311","72200","2019",31,31,0,170181.129032258,1682.06451612903,103.451612903226
"24312","72201","2019",5,5,0,112800,1313.8,90.6
"24313","72202","2019",4,4,0,139000,1381.5,92.75
"24314","72204","2019",7,7,0,93285.7142857143,932.714285714286,101.714285714286
"24315","72205","2019",25,25,0,133686.8,1376.64,94.76
"24316","72208","2019",10,10,0,151506.9,1099,132.3
"24317","72209","2019",5,5,0,91600,903.4,109.6
"24318","72210","2019",7,7,0,88021.4285714286,930.285714285714,93.7142857142857
"24319","72211","2019",9,9,0,87197.6666666667,789.555555555556,112.444444444444
"24320","72212","2019",4,4,0,84000,1408.25,55.75
"24321","72213","2019",52,48,4,157494.884615385,1952.96153846154,90.7884615384615
"24322","72214","2019",1,1,0,90500,754,120
"24323","72215","2019",11,11,0,101278.181818182,1179.81818181818,82.8181818181818
"24324","72216","2019",14,14,0,142182.857142857,1304.92857142857,111.357142857143
"24325","72217","2019",21,21,0,199396.666666667,1730.66666666667,117
"24326","72218","2019",2,2,0,164000,1327,151.5
"24327","72219","2019",7,7,0,119694.285714286,1173.85714285714,105.428571428571
"24328","72220","2019",8,8,0,118625,1134.75,101.75
"24329","72221","2019",4,4,0,102000,1262.5,77.5
"24330","72223","2019",32,31,1,110187.5,1229.9375,90.5
"24331","72224","2019",6,6,0,116333.333333333,1200.16666666667,97.8333333333333
"24332","72225","2019",9,9,0,119833.333333333,1247.55555555556,101.666666666667
"24333","72226","2019",20,20,0,129932,1308.9,97.4
"24334","72228","2019",28,28,0,133592.857142857,1192.42857142857,108.357142857143
"24335","72229","2019",2,2,0,62000,731.5,84
"24336","72230","2019",12,12,0,201018.75,1642.25,122.583333333333
"24337","72231","2019",56,56,0,162319.375,1652.42857142857,99.1964285714286
"24338","72232","2019",9,9,0,104533.555555556,1073.77777777778,99.2222222222222
"24339","72233","2019",3,3,0,100166.666666667,1222.33333333333,82.6666666666667
"24340","72234","2019",4,4,0,114750,1416,91.75
"24341","72235","2019",8,8,0,120708.75,1268,99.5
"24342","72236","2019",2,2,0,137000,802,140
"24343","72237","2019",3,3,0,127666.666666667,1048.66666666667,121.333333333333
"24344","72238","2019",1,1,0,80000,656,122
"24345","72239","2019",10,10,0,120700,1180.7,111.7
"24346","72241","2019",36,36,0,138619.444444444,1327.88888888889,105.611111111111
"24347","72243","2019",17,17,0,120839.294117647,1132.88235294118,113.235294117647
"24348","72244","2019",33,32,1,124921.212121212,1344.15151515152,96.2424242424242
"24349","72245","2019",5,5,0,137000,1473.4,95.2
"24350","72246","2019",4,4,0,149250,1371.25,103.25
"24351","72247","2019",16,16,0,231908.9375,1791,129.8125
"24352","72248","2019",12,12,0,83666.6666666667,986.916666666667,83
"24353","72249","2019",14,14,0,150365.928571429,1404.92857142857,111.571428571429
"24354","72250","2019",4,4,0,66798.75,673.25,98
"24355","72251","2019",2,2,0,107250,851,119.5
"24356","72252","2019",11,11,0,125161.818181818,1226.45454545455,100.272727272727
"24357","72253","2019",13,13,0,166962.307692308,1344.92307692308,116.384615384615
"24358","72254","2019",4,4,0,89430,868.75,108.5
"24359","72255","2019",13,13,0,96186.9230769231,924.230769230769,105.384615384615
"24360","72256","2019",10,10,0,79501,817.4,101
"24361","72257","2019",22,22,0,261815.909090909,1974.04545454545,136.409090909091
"24362","72259","2019",4,4,0,120000,988,124.5
"24363","72260","2019",52,43,9,186799.615384615,1748.26923076923,104.923076923077
"24364","72261","2019",3,3,0,61250,1051.66666666667,60
"24365","72262","2019",36,36,0,101684.166666667,1020.94444444444,95.9444444444444
"24366","72264","2019",121,97,24,120295.776859504,1439.05785123967,90.7520661157025
"24367","72265","2019",2,2,0,1e+05,1020.5,101.5
"24368","72266","2019",9,9,0,108466.666666667,1520,90.8888888888889
"24369","72267","2019",12,12,0,125208.333333333,1227.58333333333,105
"24370","72268","2019",11,10,1,105734.545454545,1201.90909090909,86.2727272727273
"24371","72269","2019",24,24,0,86460.4166666667,972.916666666667,83.375
"24372","72270","2019",2,2,0,113500,1260,90
"24373","72271","2019",8,8,0,113581.25,1275.5,92.5
"24374","72272","2019",5,5,0,61500,619.6,99.8
"24375","72273","2019",2,2,0,100350,1182.5,76
"24376","72274","2019",4,4,0,109250,996.5,111.75
"24377","72275","2019",16,16,0,171566.875,1576.6875,112.5
"24378","72276","2019",20,20,0,89587.85,1074.9,80.8
"24379","72277","2019",2,2,0,85000,928.5,92.5
"24380","72278","2019",8,8,0,70657.5,821.875,78.875
"24381","72279","2019",6,6,0,83000,873.666666666667,94.1666666666667
"24382","72280","2019",18,18,0,182209.722222222,1663.05555555556,117.5
"24383","72281","2019",1,1,0,180000,1800,100
"24384","72282","2019",2,2,0,55000,801,67.5
"24385","72283","2019",6,6,0,150916.666666667,1268.33333333333,128.666666666667
"24386","72286","2019",3,3,0,118000,1012,114.333333333333
"24387","72287","2019",25,25,0,188140,1723.88,111.88
"24388","72289","2019",22,22,0,134909.090909091,1518.90909090909,89.0909090909091
"24389","72290","2019",20,20,0,119943.3,1299.25,97.1
"24390","72291","2019",11,11,0,95272.7272727273,1091.27272727273,91
"24391","72292","2019",1,1,0,40000,488,82
"24392","72293","2019",8,8,0,107450,1131.625,90.25
"24393","72294","2019",9,9,0,105588.888888889,1015.11111111111,107
"24394","72295","2019",5,5,0,176500,917.6,185.4
"24395","72296","2019",7,7,0,143142.857142857,1270.28571428571,103.571428571429
"24396","72297","2019",10,10,0,145734,1383.6,107.8
"24397","72298","2019",12,12,0,106014.166666667,1159.33333333333,88.25
"24398","72299","2019",36,36,0,123189.027777778,1208.44444444444,99.8611111111111
"24399","72300","2019",38,38,0,139567.473684211,1477.18421052632,94.2105263157895
"24400","72302","2019",2,2,0,169000,1480,113
"24401","72303","2019",13,13,0,112115.384615385,1074.30769230769,103.615384615385
"24402","72305","2019",7,7,0,112071.428571429,1147.71428571429,97
"24403","72306","2019",11,11,0,163954.545454545,1438.54545454545,116.545454545455
"24404","72307","2019",1,1,0,206000,1776,116
"24405","72308","2019",21,21,0,138080.952380952,1380.61904761905,98.2857142857143
"24406","72309","2019",8,8,0,85875,1013.625,88.875
"24407","72310","2019",23,23,0,250086.086956522,2212.13043478261,114.304347826087
"24408","72311","2019",3,3,0,99640,1245.33333333333,80.6666666666667
"24409","72312","2019",4,4,0,86077.5,839.75,99
"24410","72313","2019",2,2,0,246500,1644,151.5
"24411","72314","2019",8,8,0,135191.25,1321.625,100.125
"24412","72315","2019",11,11,0,88772.7272727273,926.818181818182,90.6363636363636
"24413","72316","2019",12,12,0,100083.333333333,969.916666666667,101.583333333333
"24414","72317","2019",6,6,0,102283.333333333,1253.33333333333,86.5
"24415","72319","2019",14,14,0,175096.785714286,1592.85714285714,118.285714285714
"24416","72320","2019",28,27,1,255884.464285714,2165.5,119.142857142857
"24417","72321","2019",7,7,0,106692.857142857,1114.28571428571,100.571428571429
"24418","72322","2019",3,3,0,87000,1325,74
"24419","72323","2019",7,7,0,104314.285714286,1122.14285714286,97.7142857142857
"24420","72324","2019",9,9,0,110783.333333333,1039.88888888889,105.444444444444
"24421","72325","2019",9,9,0,106666.666666667,1056.66666666667,102.444444444444
"24422","72327","2019",2,2,0,165000,1112.5,159.5
"24423","72328","2019",42,42,0,248046.547619048,2108.35714285714,120.166666666667
"24424","72329","2019",46,46,0,161371.086956522,1662.91304347826,98.4130434782609
"24425","72330","2019",13,13,0,96302.6923076923,1041.53846153846,88.8461538461538
"24426","72331","2019",9,9,0,99388.8888888889,1146.88888888889,83.2222222222222
"24427","72332","2019",13,13,0,101000,893.923076923077,111.384615384615
"24428","72333","2019",8,8,0,79251.25,911,83.875
"24429","72334","2019",27,27,0,86481.4814814815,969.148148148148,87.6296296296296
"24430","72335","2019",19,19,0,146721.052631579,1494.73684210526,94.7894736842105
"24431","72336","2019",22,22,0,141457.272727273,1534.40909090909,93.3181818181818
"24432","72337","2019",12,12,0,87749.1666666667,999.083333333333,89.8333333333333
"24433","72338","2019",3,3,0,197333.333333333,1585,128
"24434","72339","2019",7,7,0,149400,1311,116.428571428571
"24435","72340","2019",18,18,0,143355.277777778,1508.33333333333,98.8888888888889
"24436","72341","2019",11,11,0,162409.090909091,1376.09090909091,121
"24437","72342","2019",1,1,0,193310,1499,129
"24438","72343","2019",6,6,0,99082.1666666667,865.333333333333,107.166666666667
"24439","72344","2019",42,42,0,185415.261904762,1807.64285714286,101.5
"24440","72345","2019",3,3,0,110000,1123,88.6666666666667
"24441","72346","2019",44,42,2,121629.840909091,1705.70454545455,83
"24442","72347","2019",1,1,0,155000,1396,111
"24443","72348","2019",3,3,0,131605.333333333,1325,99.6666666666667
"24444","72349","2019",10,10,0,105267,1119.7,94.1
"24445","72350","2019",48,48,0,165552.083333333,1498.47916666667,112.875
"24446","72351","2019",6,6,0,87243.3333333333,1192.83333333333,74.3333333333333
"24447","72352","2019",1,1,0,134000,1031,130
"24448","72353","2019",4,4,0,62875,847.25,78.5
"24449","72354","2019",1,1,0,119030,1337,89
"24450","72355","2019",2,2,0,72250,700.5,99.5
"24451","72356","2019",7,7,0,106214.285714286,1106.85714285714,95
"24452","72357","2019",20,20,0,128071.5,1187.9,107.7
"24453","72358","2019",8,8,0,114062.5,1315.125,83.75
"24454","72359","2019",22,22,0,123227.272727273,1238.09090909091,98.2272727272727
"24455","72360","2019",14,14,0,208714.285714286,2013.42857142857,106.428571428571
"24456","72361","2019",8,8,0,105651.25,880.5,110.875
"24457","72362","2019",2,2,0,165750,1574.5,114.5
"24458","72363","2019",22,22,0,115658.863636364,1195.18181818182,95.1818181818182
"24459","72364","2019",29,29,0,69672.3793103448,868.448275862069,80.551724137931
"24460","72366","2019",4,4,0,68250,853,74.25
"24461","72367","2019",12,12,0,134675.666666667,1032.75,129.25
"24462","72368","2019",5,5,0,80800,964,84.8
"24463","72369","2019",6,6,0,89150,894.833333333333,98.3333333333333
"24464","72370","2019",6,6,0,123183.333333333,1162.66666666667,108.666666666667
"24465","72372","2019",1,1,0,96000,1043,92
"24466","72373","2019",26,26,0,90730.7692307692,981.307692307692,87.1923076923077
"24467","72374","2019",2,2,0,117500,645.5,182.5
"24468","72375","2019",6,6,0,135425,1654,84.8333333333333
"24469","72376","2019",6,6,0,84083.3333333333,997.833333333333,83.8333333333333
"24470","72377","2019",13,13,0,113838.461538462,1184.38461538462,93.5384615384615
"24471","72378","2019",6,6,0,149500,1618.33333333333,92.3333333333333
"24472","72379","2019",6,6,0,84333.3333333333,670,115.833333333333
"24473","72380","2019",6,6,0,130083.333333333,1023.33333333333,125.166666666667
"24474","72381","2019",10,10,0,162079,1907.7,93
"24475","72382","2019",9,9,0,119669.444444444,1170,102.666666666667
"24476","72383","2019",1,1,0,127500,1159,110
"24477","72385","2019",14,14,0,108641.428571429,1272.21428571429,88.7857142857143
"24478","72386","2019",43,43,0,217781.395348837,1824.67441860465,118.302325581395
"24479","73001","2019",8,3,5,133714.375,2429,59
"24480","73003","2019",54,17,37,143969.462962963,2076.09259259259,73.8333333333333
"24481","73004","2019",23,10,13,102466.869565217,2479.47826086957,43.8695652173913
"24482","73005","2019",4,3,1,105000,1453.5,71
"24483","73006","2019",132,26,106,144897.181818182,3032.12121212121,50.3257575757576
"24484","73007","2019",15,12,3,164118.066666667,1827.33333333333,93.6
"24485","73008","2019",775,114,661,205457.123870968,3393.75096774194,62.4025806451613
"24486","73010","2019",99,70,29,270822.505050505,2822.82828282828,104.373737373737
"24487","73011","2019",344,56,288,128471.308139535,1854.42441860465,70.2180232558139
"24488","73012","2019",3,2,1,84000,1053.66666666667,70
"24489","73013","2019",19,3,16,81771.5789473684,2126.89473684211,40.9473684210526
"24490","73014","2019",1,1,0,60000,938,64
"24491","73015","2019",171,10,161,365035.760233918,7568.54385964912,47.0877192982456
"24492","73017","2019",6,5,1,319383.333333333,3524.66666666667,90.6666666666667
"24493","73018","2019",8,5,3,166636.875,2246.5,75.625
"24494","73019","2019",13,12,1,145239.230769231,1599.76923076923,88.0769230769231
"24495","73020","2019",4,4,0,235750,2746.25,89.5
"24496","73021","2019",12,11,1,199301.666666667,2090.25,98.6666666666667
"24497","73022","2019",5,5,0,261630,2447,112.8
"24498","73023","2019",26,1,25,125025.653846154,2786.34615384615,45.1923076923077
"24499","73024","2019",94,7,87,121194.606382979,3587.86170212766,36.0106382978723
"24500","73025","2019",3,3,0,258783.333333333,2387,109
"24501","73026","2019",8,6,2,146275,1327.375,103.125
"24502","73027","2019",8,8,0,297562.5,2438.25,120.125
"24503","73028","2019",2,2,0,64700,958,77
"24504","73029","2019",59,24,35,250641.762711864,2851.13559322034,87.3559322033898
"24505","73030","2019",40,11,29,219024.125,2747.75,82.05
"24506","73031","2019",72,15,57,220929.847222222,2843.44444444444,81.0138888888889
"24507","73032","2019",19,17,2,185572.105263158,2172.89473684211,94.2105263157895
"24508","73033","2019",8,7,1,177295,1786.625,100.5
"24509","73034","2019",40,11,29,207784.85,3569.15,63.2
"24510","73036","2019",5,5,0,279815,2406,113.2
"24511","73039","2019",9,9,0,196688.888888889,1946.77777777778,101.333333333333
"24512","73040","2019",17,4,13,179385.588235294,3169.58823529412,55.1764705882353
"24513","73041","2019",4,4,0,292442.5,3561.5,99.25
"24514","73042","2019",2,2,0,293295,2983,93.5
"24515","73043","2019",21,15,6,274516.047619048,2705.28571428571,105.190476190476
"24516","73047","2019",6,1,5,126094.166666667,4219.33333333333,31.1666666666667
"24517","73048","2019",3,3,0,163286.666666667,1871,89.3333333333333
"24518","73049","2019",2,2,0,124418,1846.5,55
"24519","73050","2019",2,1,1,539275,5892,87.5
"24520","73051","2019",56,20,36,251710.517857143,3421.28571428571,76.1607142857143
"24521","73052","2019",5,5,0,171110,2696.6,72.4
"24522","73053","2019",9,9,0,228443.333333333,2113.44444444444,109.666666666667
"24523","73054","2019",335,28,307,165503.456716418,3714.93432835821,45.8805970149254
"24524","73055","2019",30,14,16,271517.2,3525.6,77.6666666666667
"24525","73057","2019",41,6,35,176268.43902439,3885.9756097561,46.8536585365854
"24526","73058","2019",10,7,3,154860,1448.2,105.5
"24527","73059","2019",29,22,7,449873,4508.48275862069,104.413793103448
"24528","73061","2019",5,5,0,171644,1786.8,106.2
"24529","73063","2019",3,3,0,97000,1250,76
"24530","73064","2019",76,26,50,219127.776315789,2811.93421052632,78.5394736842105
"24531","73065","2019",1002,111,891,170370.814371257,2430.92415169661,70.6786427145709
"24532","73067","2019",11,4,7,148546.363636364,1725.45454545455,88.6363636363636
"24533","73068","2019",4,4,0,246162.5,2546.75,96.5
"24534","73069","2019",13,12,1,189358.846153846,2111.61538461538,88.1538461538462
"24535","73070","2019",19,18,1,165664.210526316,1698.31578947368,100.157894736842
"24536","73071","2019",30,8,22,273721.033333333,4429.43333333333,62.1
"24537","73072","2019",1,1,0,245000,2882,85
"24538","73073","2019",9,9,0,260698.555555556,2809.44444444444,92.7777777777778
"24539","73074","2019",4,4,0,139587.5,1564.5,80.25
"24540","73075","2019",8,8,0,201793.75,2175.25,95.5
"24541","73076","2019",1,1,0,55000,1146,48
"24542","73077","2019",2,1,1,230200,2230.5,86
"24543","73079","2019",11,9,2,219297.363636364,2058.54545454545,105.727272727273
"24544","73081","2019",8,4,4,159353.25,1551.5,106.875
"24545","73082","2019",8,7,1,321162.5,2510.875,130.375
"24546","73083","2019",4,4,0,127725,1952.75,61.75
"24547","73084","2019",3,3,0,277433.333333333,2527.33333333333,110.333333333333
"24548","73085","2019",26,22,4,237634.230769231,2799.84615384615,81.8076923076923
"24549","73086","2019",2,2,0,187500,1334,126
"24550","73087","2019",72,16,56,197248.486111111,2616.375,77.8194444444444
"24551","73088","2019",22,3,19,201429.545454545,3655.31818181818,51.0909090909091
"24552","73089","2019",13,11,2,212456.153846154,2059.23076923077,103.461538461538
"24553","73090","2019",3,3,0,142366.666666667,2199.33333333333,71.3333333333333
"24554","73091","2019",2,2,0,293685.5,3072,105
"24555","73092","2019",4,4,0,201646.25,1694,112.75
"24556","73094","2019",23,7,16,287938.826086957,4408.65217391304,64.8260869565217
"24557","73095","2019",2,2,0,78050,1035.5,77
"24558","73096","2019",17,15,2,266640,2885.64705882353,94.4117647058823
"24559","73097","2019",5,4,1,210760,2414.6,88.6
"24560","73098","2019",23,15,8,194486,2772.21739130435,76.4782608695652
"24561","73099","2019",6,4,2,200941.666666667,1721.66666666667,117.5
"24562","73100","2019",26,22,4,191265.576923077,1777.96153846154,109.076923076923
"24563","73101","2019",1,1,0,265000,1710,155
"24564","73103","2019",49,16,33,278878.367346939,3297.85714285714,83.8571428571429
"24565","73104","2019",7,7,0,185035.714285714,1961.14285714286,99.5714285714286
"24566","73105","2019",16,9,7,135043.75,1650.3125,81.3125
"24567","73106","2019",3,3,0,152096.666666667,1449,98.3333333333333
"24568","73107","2019",14,12,2,207597.857142857,2162.28571428571,98.5714285714286
"24569","73109","2019",7,7,0,120451.428571429,1250.28571428571,95.1428571428571
"24570","73110","2019",7,7,0,198838.571428571,1909.42857142857,102.142857142857
"24571","73113","2019",1,1,0,181650,1873,97
"24572","73114","2019",17,1,16,145442.058823529,3256.70588235294,44.2352941176471
"24573","73116","2019",99,7,92,98073.3333333333,2768.9797979798,34.1010101010101
"24574","73117","2019",11,2,9,95199.9090909091,1149.63636363636,81.6363636363636
"24575","73119","2019",1,0,1,88195,1729,51
"24576","73120","2019",2,2,0,178000,1565.5,124
"24577","73121","2019",16,8,8,168412,2110.75,79.625
"24578","73122","2019",4,3,1,308981.25,2716.75,114
"24579","73123","2019",21,6,15,262634.19047619,3833.09523809524,61.5714285714286
"24580","73124","2019",27,24,3,202415.555555556,2041.44444444444,99.1851851851852
"24581","73128","2019",49,25,24,287889.102040816,3096.79591836735,93.5918367346939
"24582","73129","2019",24,19,5,162701.25,1881.83333333333,94
"24583","73130","2019",15,11,4,204938.133333333,2145.26666666667,95.3333333333333
"24584","73131","2019",6,6,0,227676.666666667,2099.16666666667,111.166666666667
"24585","73132","2019",90,8,82,216962.488888889,5688.78888888889,38.9333333333333
"24586","73133","2019",3,3,0,235443.333333333,2372,98.3333333333333
"24587","73135","2019",15,12,3,147623.333333333,1682.66666666667,100.333333333333
"24588","73137","2019",52,11,41,218744.673076923,3085.32692307692,69.7884615384615
"24589","73138","2019",10,9,1,143320,2247,83.1
"24590","73139","2019",4,4,0,156000,1476.5,103
"24591","73140","2019",2,2,0,217800,1628.5,135
"24592","73141","2019",8,7,1,223930,2685,89.375
"24593","73142","2019",29,8,21,162327.103448276,3812.37931034483,44.9310344827586
"24594","73145","2019",6,6,0,291720,3858,81.8333333333333
"24595","73146","2019",12,12,0,213153.333333333,2760.33333333333,88.1666666666667
"24596","73147","2019",2,2,0,133505,1268.5,106.5
"24597","73149","2019",1,1,0,180000,1636,110
"24598","73150","2019",299,32,267,130128.43812709,3524.61204013378,37.1538461538462
"24599","73151","2019",26,17,9,293313.846153846,3222.84615384615,89.5384615384615
"24600","73152","2019",2,2,0,162500,1577,104
"24601","73153","2019",10,8,2,191667,2026.8,99.1
"24602","73154","2019",33,24,9,222682.333333333,2220.9696969697,106.484848484848
"24603","73155","2019",20,13,7,257785.95,2859.15,98.7
"24604","73156","2019",1,1,0,1e+05,699,143
"24605","73157","2019",99,9,90,73471.0202020202,1672.0404040404,48.6767676767677
"24606","73159","2019",4,4,0,205777.5,1887.75,108.75
"24607","73160","2019",10,7,3,286262.5,3073.2,89.6
"24608","73161","2019",7,6,1,156014.285714286,2420.42857142857,75.7142857142857
"24609","73162","2019",3,3,0,200160,1802.66666666667,121.666666666667
"24610","73164","2019",11,9,2,287321.909090909,3173.18181818182,104.363636363636
"24611","73166","2019",2,2,0,117025,1641.5,69.5
"24612","73170","2019",4,4,0,200775,2061,103.5
"24613","73171","2019",44,12,32,199516.886363636,2353.90909090909,84.9772727272727
"24614","73173","2019",5,5,0,128000,1508,88.2
"24615","73175","2019",2,2,0,59500,846.5,83.5
"24616","73176","2019",63,10,53,199775.015873016,4070.55555555556,47.6507936507937
"24617","73177","2019",1,1,0,75000,1172,64
"24618","73178","2019",6,6,0,162940,1863.66666666667,97.6666666666667
"24619","73179","2019",150,40,110,219223.626666667,2895.33333333333,75.3466666666667
"24620","73180","2019",5,5,0,137770,1623.6,80.8
"24621","73181","2019",42,1,41,107820.238095238,1784.33333333333,61.5952380952381
"24622","73182","2019",29,24,5,359256.206896552,3614.44827586207,103.689655172414
"24623","73183","2019",16,14,2,326615.625,3281.0625,104.375
"24624","73184","2019",8,7,1,201423.125,2208.5,99.5
"24625","73186","2019",55,9,46,199276.072727273,3993.29090909091,49.7454545454545
"24626","73187","2019",37,23,14,136566.27027027,2175.48648648649,68.1891891891892
"24627","73188","2019",12,11,1,195908.5,2205,79.9166666666667
"24628","73189","2019",4,3,1,208025,1908.75,105.75
"24629","73190","2019",9,5,4,124970,1894.44444444444,62.1111111111111
"24630","73191","2019",36,33,3,247966.527777778,2363.94444444444,105.5
"24631","73192","2019",3,3,0,137333.333333333,1197.66666666667,89
"24632","73193","2019",3,3,0,207583.333333333,2154.33333333333,96.6666666666667
"24633","73194","2019",13,2,11,98990.8461538462,1752.53846153846,58.9230769230769
"24634","73196","2019",10,7,3,201266.6,2865.2,86.3
"24635","73197","2019",37,7,30,209270.054054054,4051.62162162162,53.7837837837838
"24636","73200","2019",13,10,3,191437.692307692,1892.15384615385,102.076923076923
"24637","73201","2019",8,6,2,200636.25,2196.5,95
"24638","73202","2019",5,5,0,265600,2129,120.6
"24639","73204","2019",33,14,19,138523.333333333,1564.84848484848,86.6969696969697
"24640","73205","2019",1,1,0,190000,1900,100
"24641","73206","2019",55,4,51,154458.290909091,3676.8,40.5272727272727
"24642","73207","2019",3,3,0,205000,2524,83
"24643","73208","2019",15,9,6,379182.066666667,3408.8,106.733333333333
"24644","73210","2019",3,3,0,196516.666666667,2507.66666666667,78.3333333333333
"24645","73211","2019",17,17,0,218307.058823529,2409.52941176471,101.235294117647
"24646","73212","2019",18,13,5,148412.055555556,1839.94444444444,86.3888888888889
"24647","73213","2019",166,45,121,214605.65060241,2730.78313253012,78.5903614457831
"24648","73214","2019",2,2,0,250350,1625,156
"24649","73215","2019",46,34,12,184806.586956522,1952.91304347826,94.2826086956522
"24650","73216","2019",3,3,0,222843.333333333,2551.33333333333,87
"24651","73218","2019",13,12,1,220668.769230769,2240.07692307692,93.6153846153846
"24652","73219","2019",11,9,2,333239.090909091,2865.27272727273,109.545454545455
"24653","73220","2019",5,5,0,199497.6,2302.4,94.2
"24654","73222","2019",84,28,56,242224.666666667,2778.35714285714,87.5
"24655","73223","2019",5,4,1,114640,1266.6,91
"24656","73224","2019",14,12,2,153636.071428571,1864.57142857143,79.8571428571429
"24657","73225","2019",38,28,10,304693.552631579,2929.13157894737,102.368421052632
"24658","73226","2019",30,25,5,172096.5,1557.26666666667,109.4
"24659","73227","2019",139,24,115,384145.446043165,6680.95683453237,54.5755395683453
"24660","73228","2019",13,10,3,317093.846153846,2624.46153846154,124.307692307692
"24661","73229","2019",4,4,0,174162.5,2208,87.5
"24662","73230","2019",3,3,0,77090.6666666667,1128,69
"24663","73231","2019",16,13,3,89448.125,1464.3125,63.625
"24664","73232","2019",23,9,14,414467.608695652,4418.5652173913,88.304347826087
"24665","73234","2019",1,1,0,283295,1914,148
"24666","73235","2019",73,8,65,110028.123287671,2810.21917808219,38.7123287671233
"24667","73236","2019",38,29,9,175320.631578947,1747.84210526316,103.763157894737
"24668","73237","2019",11,11,0,101212.272727273,1435.09090909091,78.0909090909091
"24669","73240","2019",13,13,0,311082.307692308,2452.61538461538,128.384615384615
"24670","73241","2019",13,13,0,137430.769230769,1463.84615384615,97.0769230769231
"24671","73242","2019",27,5,22,101591.444444444,2259.7037037037,46.1111111111111
"24672","73243","2019",23,13,10,260747.826086957,2635.52173913043,101.260869565217
"24673","73245","2019",8,6,2,195411.875,2243.5,88.375
"24674","73246","2019",6,5,1,160620.833333333,2137,76.3333333333333
"24675","73247","2019",16,13,3,169884.6875,1634.5,115.3125
"24676","73248","2019",75,10,65,114436.706666667,1540.2,75.0666666666667
"24677","73249","2019",28,11,17,229236.607142857,2852.71428571429,81.1071428571429
"24678","73250","2019",17,15,2,100823.529411765,1345.41176470588,75.2941176470588
"24679","73252","2019",5,5,0,130150,1766.8,68.4
"24680","73253","2019",7,2,5,125922.857142857,1751,76.1428571428571
"24681","73254","2019",2,2,0,77500,919,84.5
"24682","73255","2019",6,6,0,147651.5,1619.16666666667,96.3333333333333
"24683","73256","2019",2,2,0,113750,1949,59
"24684","73257","2019",365,31,334,177146.057534247,5110.11780821918,34.5068493150685
"24685","73258","2019",12,11,1,122787.5,1501.58333333333,79.0833333333333
"24686","73259","2019",9,8,1,150171.111111111,1867.88888888889,82
"24687","73261","2019",36,21,15,107897.083333333,1336.02777777778,83.9166666666667
"24688","73262","2019",4,4,0,296125,2975.25,102.25
"24689","73263","2019",10,9,1,253605.5,2217.8,117.9
"24690","73265","2019",7,6,1,273621.428571429,2499.42857142857,110.857142857143
"24691","73267","2019",6,1,5,65466.6666666667,1354.16666666667,49.6666666666667
"24692","73268","2019",9,8,1,183855.555555556,2145.88888888889,94.5555555555556
"24693","73269","2019",8,8,0,238925,2982.125,94.875
"24694","73270","2019",34,22,12,187826.264705882,1940.88235294118,100.735294117647
"24695","73271","2019",6,6,0,268658.833333333,2216.66666666667,126.833333333333
"24696","73273","2019",9,6,3,320294.444444444,2230.55555555556,118.666666666667
"24697","73274","2019",10,10,0,166582.2,2030,94
"24698","73275","2019",4,4,0,220975.25,2027,123.25
"24699","73276","2019",4,4,0,297750,2126.25,136.75
"24700","73277","2019",4,4,0,230045,1966.5,118.25
"24701","73278","2019",15,15,0,133120.733333333,1612.13333333333,94.4
"24702","73280","2019",48,2,46,106409.895833333,2757.45833333333,38.0833333333333
"24703","73281","2019",10,10,0,353195.3,2644.1,140
"24704","73282","2019",8,8,0,233145,2421.625,107.875
"24705","73283","2019",5,3,2,213758,2065,101.6
"24706","73284","2019",21,5,16,126319.047619048,1863.47619047619,66.8095238095238
"24707","73285","2019",31,11,20,231790.870967742,2844.38709677419,85.8064516129032
"24708","73286","2019",22,19,3,220671.818181818,2089.04545454545,103.409090909091
"24709","73288","2019",23,16,7,322429.260869565,2786.4347826087,110.695652173913
"24710","73289","2019",8,8,0,145143.75,1751.875,90.125
"24711","73290","2019",76,12,64,138070.013157895,2949.52631578947,47.9736842105263
"24712","73292","2019",2,1,1,303605,2093.5,145.5
"24713","73293","2019",4,4,0,243192.25,2981.5,94.5
"24714","73294","2019",4,4,0,155000,1655.75,93.75
"24715","73296","2019",123,3,120,257642.300813008,5449.9918699187,41.5528455284553
"24716","73297","2019",5,4,1,450500,3596,156.8
"24717","73298","2019",3,3,0,225650,2603.33333333333,88
"24718","73299","2019",2,2,0,249250,2726.5,94.5
"24719","73300","2019",51,21,30,301071.215686275,3628.07843137255,83.2156862745098
"24720","73301","2019",9,7,2,371631.666666667,2802,135.666666666667
"24721","73302","2019",5,5,0,250308,1818.8,147.4
"24722","73303","2019",76,38,38,149944.934210526,1967.23684210526,77.6052631578947
"24723","73304","2019",89,1,88,347666,8932.4606741573,37.314606741573
"24724","73306","2019",87,6,81,192507.666666667,4029.52873563218,47.2413793103448
"24725","73307","2019",94,11,83,102963.35106383,2700.01063829787,37.0531914893617
"24726","73308","2019",1,1,0,304000,3663,83
"24727","73309","2019",1,1,0,181000,1775,102
"24728","73310","2019",4,4,0,348500,4030.75,93.25
"24729","73312","2019",11,11,0,174677.272727273,2108.54545454545,86.9090909090909
"24730","73313","2019",5,5,0,174026,1713.8,103.2
"24731","73314","2019",4,4,0,232012.5,2290.75,124
"24732","73315","2019",4,3,1,160422.5,1851.75,84
"24733","73316","2019",2,1,1,157015,1553.5,106.5
"24734","73317","2019",41,17,24,299370.853658537,4710.31707317073,64.6829268292683
"24735","73318","2019",111,1,110,51630.2702702703,1761.94594594595,27.4234234234234
"24736","73320","2019",9,6,3,149312.222222222,1544.66666666667,98
"24737","73322","2019",47,5,42,113495.234042553,2736.23404255319,44.7234042553191
"24738","73323","2019",5,2,3,200700,3548,67.2
"24739","73324","2019",1,1,0,226900,6674,34
"24740","73326","2019",32,25,7,310940.3125,2948.875,108.75
"24741","73327","2019",6,6,0,106650,1454.5,66.8333333333333
"24742","73328","2019",29,16,13,301216.482758621,3292.44827586207,99.0344827586207
"24743","73329","2019",19,12,7,288812.368421053,3281.63157894737,92.6315789473684
"24744","73330","2019",42,21,21,176180.023809524,2237.85714285714,76.7380952380952
"24745","74001","2019",45,13,32,176301.511111111,3089.51111111111,54.7777777777778
"24746","74002","2019",40,22,18,263194.95,2995.2,87.95
"24747","74003","2019",4,4,0,412350,4230.75,97.25
"24748","74004","2019",4,3,1,236098,2544.5,91.25
"24749","74005","2019",52,35,17,320249.423076923,3203.25,102.461538461538
"24750","74006","2019",27,5,22,313366.666666667,3706.7037037037,86.8518518518518
"24751","74007","2019",27,16,11,314309.037037037,3429.14814814815,98.9259259259259
"24752","74008","2019",108,13,95,221998.935185185,3401.13888888889,63.6666666666667
"24753","74009","2019",6,4,2,506845,3863.5,130.833333333333
"24754","74010","2019",2059,199,1860,304009.230694512,4318.18941233609,70.3210296260321
"24755","74012","2019",616,25,591,182748.316558442,2969.07792207792,62.4285714285714
"24756","74013","2019",30,20,10,415809.033333333,4143.66666666667,97.6666666666667
"24757","74014","2019",170,14,156,186382.276470588,4019.96470588235,43.1058823529412
"24758","74015","2019",10,9,1,317869,2990,110.1
"24759","74016","2019",52,21,31,419137.442307692,4240.86538461538,100.25
"24760","74018","2019",23,16,7,348212.52173913,3614.69565217391,97.2173913043478
"24761","74019","2019",36,10,26,347862.805555556,4604.69444444444,75.7777777777778
"24762","74020","2019",15,12,3,311274,3630.46666666667,86.2
"24763","74021","2019",20,14,6,342902.1,3319.9,107.35
"24764","74024","2019",20,14,6,302203.85,3056.15,98.3
"24765","74025","2019",21,18,3,431019.523809524,3655.71428571429,123.761904761905
"24766","74026","2019",80,31,49,297900.85,3705.2375,85.275
"24767","74027","2019",5,5,0,435431,3646.2,121.2
"24768","74029","2019",12,12,0,258144.583333333,2709.41666666667,97.3333333333333
"24769","74030","2019",8,6,2,224125,2728.25,87.125
"24770","74031","2019",42,20,22,398666.261904762,4272.90476190476,96.5238095238095
"24771","74032","2019",27,8,19,113141.814814815,2358.96296296296,47.2222222222222
"24772","74033","2019",46,13,33,158589.565217391,2725.13043478261,59.6521739130435
"24773","74034","2019",38,10,28,137139.736842105,2356.02631578947,49.8157894736842
"24774","74035","2019",6,5,1,235950,1902.83333333333,131.666666666667
"24775","74036","2019",5,2,3,622489,4961.8,125.6
"24776","74037","2019",28,16,12,269055.964285714,3080.57142857143,89.7857142857143
"24777","74038","2019",16,9,7,162507.5,2360.8125,63.4375
"24778","74040","2019",45,27,18,293115.377777778,3689.91111111111,83.2
"24779","74041","2019",1,1,0,95000,1979,48
"24780","74042","2019",226,60,166,203882.252212389,2682.8982300885,74.853982300885
"24781","74043","2019",79,48,31,302658.924050633,3481.45569620253,91.0632911392405
"24782","74044","2019",19,11,8,505533.842105263,5009.8947368421,104.578947368421
"24783","74045","2019",5,5,0,281082.2,3556,78.4
"24784","74046","2019",5,5,0,240380,2381.6,105.6
"24785","74048","2019",3,3,0,373833.333333333,3386,109.333333333333
"24786","74049","2019",4,4,0,224937.5,2318,96.75
"24787","74050","2019",10,10,0,260434.7,3417.5,82.3
"24788","74051","2019",12,8,4,276597.5,3590.75,76.25
"24789","74052","2019",10,9,1,502644,3513.8,153.2
"24790","74053","2019",14,14,0,313373.214285714,2993.78571428571,107.857142857143
"24791","74054","2019",5,5,0,348895,3222.6,107.6
"24792","74055","2019",11,9,2,189736.363636364,2165.27272727273,86.3636363636364
"24793","74056","2019",376,64,312,400862.843085106,7108.72074468085,55.9281914893617
"24794","74057","2019",9,8,1,293328,3802.66666666667,77.6666666666667
"24795","74058","2019",37,6,31,211382.459459459,4081.27027027027,49.8378378378378
"24796","74059","2019",3,3,0,301175.333333333,2449.66666666667,121.333333333333
"24797","74061","2019",10,4,6,303623.1,3729.4,83.8
"24798","74062","2019",15,5,10,311898.133333333,3759.93333333333,87.1333333333333
"24799","74063","2019",134,7,127,196546.71641791,4479.55223880597,42.4328358208955
"24800","74064","2019",14,14,0,299560.714285714,3589.64285714286,84.4285714285714
"24801","74065","2019",5,5,0,448388,2493.8,183
"24802","74066","2019",1,1,0,393000,4137,95
"24803","74067","2019",21,15,6,366848.952380952,4102.38095238095,92.3333333333333
"24804","74068","2019",5,5,0,370180.2,2662.8,145.2
"24805","74069","2019",17,5,12,341003.529411765,3624.94117647059,95.6470588235294
"24806","74070","2019",81,17,64,311582.740740741,3717.30864197531,82.8641975308642
"24807","74071","2019",3,3,0,249333.333333333,1612,144
"24808","74073","2019",7,5,2,200762.571428571,2171.28571428571,94.4285714285714
"24809","74074","2019",7,6,1,349814.285714286,3346.28571428571,105.142857142857
"24810","74075","2019",18,17,1,286584.166666667,2915.61111111111,103.055555555556
"24811","74076","2019",24,23,1,452654.791666667,3520.33333333333,137.958333333333
"24812","74077","2019",15,14,1,283113.333333333,3081.2,94
"24813","74078","2019",4,4,0,298535,2767.5,111
"24814","74079","2019",11,9,2,294680.909090909,3335.45454545455,79.7272727272727
"24815","74080","2019",95,20,75,462686.536842105,7510.08421052632,60.8421052631579
"24816","74081","2019",228,30,198,148080.640350877,2099.46929824561,71.0482456140351
"24817","74082","2019",72,29,43,374230.416666667,4233.36111111111,87.8888888888889
"24818","74083","2019",95,18,77,310710.473684211,4629.52631578947,57.0947368421053
"24819","74085","2019",90,21,69,215636.1,4183.78888888889,51.8555555555556
"24820","74086","2019",9,7,2,369283.333333333,3613.55555555556,105.111111111111
"24821","74087","2019",34,18,16,341931.470588235,3447.67647058824,99.5
"24822","74088","2019",11,7,4,401533.272727273,4368.09090909091,90.3636363636364
"24823","74089","2019",34,9,25,255780.970588235,3790.88235294118,67.0882352941177
"24824","74090","2019",17,9,8,270116.235294118,3008.58823529412,91.0588235294118
"24825","74091","2019",8,6,2,400662.5,4700.5,85.625
"24826","74094","2019",90,68,22,407043.888888889,3844.86666666667,108.177777777778
"24827","74095","2019",8,8,0,329734,3131.875,113
"24828","74096","2019",61,23,38,300968.868852459,3786.08196721311,78.2295081967213
"24829","74097","2019",22,21,1,355264.409090909,3217.22727272727,115.818181818182
"24830","74098","2019",16,12,4,465349.6875,4339.0625,106.3125
"24831","74099","2019",23,2,21,408890.652173913,5754.73913043478,50.5217391304348
"24832","74100","2019",10,10,0,245334,2806,94.8
"24833","74101","2019",10,6,4,353125,3787,101.7
"24834","74102","2019",14,11,3,340701.714285714,4169.92857142857,82.3571428571429
"24835","74103","2019",17,11,6,333333.058823529,3192.23529411765,100.235294117647
"24836","74104","2019",65,34,31,311699.815384615,3578.24615384615,91.4153846153846
"24837","74105","2019",130,61,69,302882.230769231,3521.6,86
"24838","74106","2019",13,13,0,342271.846153846,3670.53846153846,103.615384615385
"24839","74107","2019",3,3,0,249360,2103,119.666666666667
"24840","74108","2019",18,6,12,363309.722222222,5190.83333333333,80.9444444444444
"24841","74109","2019",7,6,1,265470,2626.71428571429,100.285714285714
"24842","74111","2019",5,3,2,201125.8,2588.6,75
"24843","74112","2019",115,26,89,332871.747826087,4318.33913043478,78.7826086956522
"24844","74114","2019",7,4,3,399757.142857143,4629.14285714286,84.4285714285714
"24845","74116","2019",18,16,2,433688.888888889,4443.22222222222,110.111111111111
"24846","74117","2019",6,5,1,291232.5,2867.16666666667,106.333333333333
"24847","74118","2019",32,8,24,251945.625,3706.15625,68.21875
"24848","74119","2019",216,35,181,268028.268518519,3920.16203703704,68.8333333333333
"24849","74121","2019",12,11,1,383625,4370.5,92
"24850","74122","2019",4,2,2,331125,4610.25,71.25
"24851","74123","2019",101,40,61,179279.099009901,2423.0198019802,76.5445544554455
"24852","74124","2019",21,15,6,467680,4424.28571428571,109.238095238095
"24853","74126","2019",11,11,0,396582.727272727,3624.45454545455,113.363636363636
"24854","74127","2019",9,8,1,274320,2885.66666666667,101.555555555556
"24855","74128","2019",43,34,9,325339.534883721,3235.44186046512,105.023255813953
"24856","74130","2019",8,8,0,207382.875,2550.5,88.25
"24857","74131","2019",22,13,9,247313.363636364,2603.72727272727,102.727272727273
"24858","74133","2019",180,26,154,203957.305555556,3188.61666666667,60.2722222222222
"24859","74134","2019",104,29,75,399556.942307692,6230.97115384615,63.0096153846154
"24860","74135","2019",13,3,10,137250.846153846,2308.38461538462,53.9230769230769
"24861","74136","2019",117,14,103,212377.435897436,5136.64957264957,41.5042735042735
"24862","74137","2019",38,20,18,369224.921052632,3943.73684210526,97.1842105263158
"24863","74138","2019",13,9,4,273575,3315.53846153846,84.1538461538462
"24864","74139","2019",18,15,3,287120,2836.61111111111,99.2222222222222
"24865","74140","2019",37,17,20,160633.783783784,2757.89189189189,55.8108108108108
"24866","74141","2019",11,10,1,287159.090909091,2591.36363636364,111.181818181818
"24867","74142","2019",7,6,1,280157.142857143,2603.57142857143,106.571428571429
"24868","74143","2019",146,42,104,320335.767123288,5428.27397260274,57.5753424657534
"24869","74144","2019",12,10,2,394505.333333333,3716.66666666667,108.666666666667
"24870","74145","2019",4,3,1,373550,3440.5,111
"24871","74146","2019",10,9,1,355455.1,3203.4,116.1
"24872","74147","2019",21,15,6,336441.19047619,3889.14285714286,98.4285714285714
"24873","74148","2019",3,2,1,193343.666666667,1947,104
"24874","74150","2019",15,13,2,416714.733333333,3465.53333333333,122.533333333333
"24875","74151","2019",8,8,0,243943.75,2911.875,87.125
"24876","74152","2019",10,7,3,365895.5,3371,112.4
"24877","74153","2019",22,21,1,437303.954545455,3865.81818181818,124.681818181818
"24878","74154","2019",57,35,22,276454.736842105,3471.47368421053,83.4912280701754
"24879","74155","2019",14,12,2,247498.5,3113.35714285714,82.5
"24880","74156","2019",3,2,1,386000,2977.33333333333,137.333333333333
"24881","74157","2019",18,17,1,318602.722222222,3814.55555555556,93.5555555555556
"24882","74158","2019",19,15,4,366505.263157895,3490.15789473684,106.578947368421
"24883","74159","2019",41,25,16,187427.073170732,2488.41463414634,78.5609756097561
"24884","74160","2019",68,10,58,135887.75,4101.11764705882,33.7941176470588
"24885","74161","2019",13,12,1,396278.923076923,3058,131.076923076923
"24886","74162","2019",3,3,0,466696.666666667,3497.66666666667,137
"24887","74163","2019",37,26,11,340453.594594595,3426.78378378378,101.648648648649
"24888","74164","2019",66,25,41,216822.46969697,2935.25757575758,74.5757575757576
"24889","74165","2019",7,6,1,404235.714285714,2756.85714285714,144.428571428571
"24890","74166","2019",30,20,10,334291.433333333,3268.8,102.9
"24891","74167","2019",25,17,8,221228.2,2412.76,91.36
"24892","74168","2019",6,5,1,454669.166666667,3938,118.833333333333
"24893","74169","2019",63,34,29,220462.936507937,2508.2380952381,89.5555555555556
"24894","74170","2019",12,10,2,244936.833333333,3040.41666666667,88.75
"24895","74171","2019",20,14,6,347935,3202.55,110.85
"24896","74172","2019",21,14,7,349554.142857143,3414.33333333333,98
"24897","74173","2019",187,22,165,582593.700534759,7876.93582887701,66.5935828877005
"24898","74174","2019",12,12,0,233585.25,2523.58333333333,99.3333333333333
"24899","74175","2019",16,8,8,201740,2482.1875,76.375
"24900","74176","2019",30,14,16,707609.833333333,6343.26666666667,104.566666666667
"24901","74177","2019",13,10,3,377788.846153846,3427.92307692308,113.769230769231
"24902","74178","2019",10,10,0,306331,2221.2,135.7
"24903","74179","2019",11,10,1,354826.363636364,3594.45454545455,110.090909090909
"24904","74180","2019",36,24,12,537740.555555556,4288.77777777778,121.583333333333
"24905","74183","2019",42,19,23,180827.333333333,2869.88095238095,66.2142857142857
"24906","74184","2019",15,9,6,291099.333333333,2953.8,102
"24907","74185","2019",27,20,7,369941.111111111,3599.37037037037,114.259259259259
"24908","74186","2019",8,6,2,431600,3510.625,120.875
"24909","74188","2019",27,8,19,328019.296296296,4252.96296296296,63.7037037037037
"24910","74189","2019",39,19,20,181777.794871795,2808.33333333333,66.4871794871795
"24911","74190","2019",69,6,63,141772.971014493,3450.46376811594,40.3913043478261
"24912","74191","2019",273,19,254,266018.091575092,5884.67399267399,43.6593406593407
"24913","74192","2019",15,15,0,302316.933333333,2742.66666666667,111.466666666667
"24914","74193","2019",12,6,6,240195.416666667,3120.08333333333,93
"24915","74194","2019",11,2,9,285003.454545455,3630.45454545455,77.7272727272727
"24916","74195","2019",3,3,0,341466.666666667,3399,101.333333333333
"24917","74196","2019",7,6,1,185571.428571429,3751.57142857143,60.2857142857143
"24918","74197","2019",32,12,20,235252.3125,3063.71875,71.5
"24919","74198","2019",10,7,3,448815,4287.2,111.9
"24920","74199","2019",8,4,4,493500,4514.125,105.75
"24921","74200","2019",54,28,26,386972.87037037,4161.92592592593,94.2777777777778
"24922","74201","2019",45,22,23,390219.311111111,4165.31111111111,100.377777777778
"24923","74202","2019",9,6,3,365862.222222222,3026.11111111111,128.555555555556
"24924","74203","2019",5,5,0,152552,2564.6,59.6
"24925","74205","2019",33,11,22,122924.848484848,2274.15151515152,53.7575757575758
"24926","74206","2019",7,6,1,319014.285714286,3461,96.5714285714286
"24927","74208","2019",134,55,79,235260.917910448,2877.91791044776,82.365671641791
"24928","74209","2019",17,17,0,378415.882352941,3299.64705882353,114.058823529412
"24929","74210","2019",27,16,11,245025.777777778,3039.51851851852,80.9259259259259
"24930","74211","2019",33,29,4,360387.545454545,3474.9696969697,112.969696969697
"24931","74212","2019",23,17,6,266884.913043478,2819.78260869565,95.8695652173913
"24932","74213","2019",94,29,65,327942.053191489,4209.86170212766,78.7765957446808
"24933","74215","2019",80,7,73,195205.7625,4078.175,44.9
"24934","74216","2019",12,3,9,346796.666666667,4069.5,85.75
"24935","74218","2019",124,67,57,319204.60483871,3883.72580645161,84.8709677419355
"24936","74219","2019",16,7,9,343285.6875,3145.4375,115.0625
"24937","74220","2019",108,34,74,277952.009259259,3549.84259259259,81.4166666666667
"24938","74221","2019",5,2,3,170438,1964,89.6
"24939","74222","2019",8,4,4,239199,2496.5,96.875
"24940","74223","2019",8,7,1,198550,3988.75,74
"24941","74224","2019",160,47,113,272756.825,3222.03125,83.2625
"24942","74225","2019",205,46,159,175492.385365854,2444.7756097561,71.8682926829268
"24943","74226","2019",8,8,0,216713.75,2384.375,92
"24944","74228","2019",8,3,5,301384.875,3854.75,79.625
"24945","74229","2019",32,20,12,316673.40625,3612.8125,92.3125
"24946","74231","2019",5,4,1,288739.2,2535.6,113.2
"24947","74232","2019",2,1,1,236300,3983,60
"24948","74233","2019",38,17,21,230534.789473684,2943.07894736842,81.1578947368421
"24949","74234","2019",10,7,3,208148,2820.2,81.1
"24950","74235","2019",7,6,1,292628.571428571,2988.85714285714,102.714285714286
"24951","74236","2019",289,49,240,227466.934256055,3846.49480968858,55.1903114186851
"24952","74237","2019",20,5,15,204957,3266.1,63.8
"24953","74238","2019",69,22,47,209820.217391304,3508.57971014493,55.8115942028985
"24954","74239","2019",39,17,22,380103.461538462,4973.84615384615,76.4615384615385
"24955","74240","2019",13,12,1,313803.846153846,2699.53846153846,126
"24956","74241","2019",51,17,34,164482.156862745,2592.6862745098,63.9411764705882
"24957","74242","2019",101,56,45,445471.405940594,4418.24752475248,99.7722772277228
"24958","74243","2019",229,26,203,312286.109170306,3994.8384279476,78.4541484716157
"24959","74244","2019",11,8,3,300814.090909091,3625.27272727273,101.818181818182
"24960","74249","2019",29,15,14,314418.965517241,3594.75862068966,91.1034482758621
"24961","74250","2019",86,44,42,277030.534883721,3366.23255813953,83.6744186046512
"24962","74252","2019",7,7,0,260790,2888.71428571429,86.7142857142857
"24963","74253","2019",16,16,0,346547.9375,3268.6875,117.3125
"24964","74254","2019",6,6,0,184710.666666667,2527.83333333333,82.6666666666667
"24965","74255","2019",32,27,5,316309.8125,3037.34375,105.53125
"24966","74256","2019",289,40,249,182054.858131488,2894.36332179931,63.1730103806228
"24967","74257","2019",9,7,2,260615,2809.66666666667,100.444444444444
"24968","74258","2019",129,21,108,220929.023255814,4392.41085271318,46.7751937984496
"24969","74259","2019",6,6,0,413666.666666667,2855,137.833333333333
"24970","74260","2019",12,11,1,396640.666666667,3424.75,130.416666666667
"24971","74261","2019",4,3,1,264250,3062.5,102.25
"24972","74262","2019",16,12,4,260113.125,2563.5,104.4375
"24973","74263","2019",121,90,31,379504.239669422,3764.71900826446,101.190082644628
"24974","74264","2019",116,44,72,183077.99137931,2285.04310344828,81.3620689655172
"24975","74265","2019",9,7,2,222394.444444444,2785.11111111111,91.2222222222222
"24976","74266","2019",16,7,9,273129.4375,3913.25,71.3125
"24977","74267","2019",60,33,27,466898.85,4543.78333333333,104.5
"24978","74269","2019",29,14,15,190069.310344828,2375.37931034483,79.4137931034483
"24979","74271","2019",5,4,1,337940,3731.6,96
"24980","74272","2019",25,11,14,300568.2,3931.2,78.48
"24981","74273","2019",11,9,2,282940.909090909,3468.45454545455,80
"24982","74275","2019",46,25,21,519536.260869565,4756.76086956522,105.347826086957
"24983","74276","2019",85,23,62,212180.164705882,3558.17647058824,59.0470588235294
"24984","74278","2019",102,32,70,223808.068627451,2677.75490196078,84.0588235294118
"24985","74279","2019",76,21,55,145108.131578947,3017.10526315789,46.6315789473684
"24986","74280","2019",83,31,52,271311.228915663,3920.30120481928,71.3975903614458
"24987","74281","2019",677,100,577,214385.723781388,3070.04431314623,69.341211225997
"24988","74282","2019",121,75,46,359595.26446281,3753.38842975207,98.1570247933884
"24989","74283","2019",17,16,1,317971.176470588,2984.64705882353,106.294117647059
"24990","74284","2019",14,7,7,219928.571428571,2743.42857142857,78.2857142857143
"24991","74285","2019",7,7,0,256541.714285714,2552.42857142857,101
"24992","74286","2019",13,6,7,256310,2667.69230769231,105.461538461538
"24993","74287","2019",12,9,3,164414.333333333,2635.08333333333,65.3333333333333
"24994","74288","2019",102,47,55,299187.470588235,3515.92156862745,85.2254901960784
"24995","74289","2019",37,28,9,271600,2840.02702702703,100.378378378378
"24996","74290","2019",5,4,1,447920.2,5080.4,83.4
"24997","74291","2019",5,5,0,207200,2550,92
"24998","74292","2019",3,3,0,275583.666666667,2913.66666666667,92.6666666666667
"24999","74293","2019",76,33,43,365746.144736842,3927.57894736842,93.1184210526316
"25000","74294","2019",24,21,3,254106.375,3576.41666666667,72.5833333333333
"25001","74295","2019",4,4,0,178750,2184.75,80.25
"25002","74296","2019",8,4,4,332902.375,3370.625,98.875
"25003","74297","2019",10,8,2,319517,2799.2,110.3
"25004","74298","2019",151,70,81,335016.470198676,3833.76821192053,84.7615894039735
"25005","74299","2019",58,35,23,966190.431034483,7287.81034482759,129.551724137931
"25006","74301","2019",9,5,4,200488.888888889,3004.55555555556,72.4444444444444
"25007","74302","2019",13,6,7,278514.384615385,4534.46153846154,59.3846153846154
"25008","74303","2019",50,22,28,414790.3,4589,90.48
"25009","74304","2019",8,4,4,249870,2522.625,112.5
"25010","74305","2019",98,31,67,298649.224489796,3710.10204081633,78.4591836734694
"25011","74306","2019",8,6,2,340722.5,2938.5,117.25
"25012","74307","2019",16,7,9,383888.75,4130.5,93.5625
"25013","74308","2019",11,10,1,284327.272727273,3151.18181818182,92.3636363636364
"25014","74309","2019",58,27,31,341510.448275862,3867.13793103448,87.9827586206897
"25015","74310","2019",11,7,4,328061.363636364,3814.90909090909,90.2727272727273
"25016","74311","2019",66,36,30,271694.257575758,3092.07575757576,91.4545454545455
"25017","74312","2019",17,11,6,260356.470588235,2603.35294117647,101.882352941176
"25018","74313","2019",7,5,2,339785.714285714,3235,111.285714285714
"25019","74314","2019",16,13,3,375809.6875,3621,103.125
"25020","74315","2019",11,8,3,320880.909090909,4747,67.7272727272727
"25021","75056","2019",30536,104,30432,523267.241878439,9863.22131254912,52.4817264867697
"25022","76001","2019",10,10,0,198928.3,1645.9,121.9
"25023","76002","2019",7,7,0,148121.428571429,1531.57142857143,106.428571428571
"25024","76004","2019",8,8,0,157562.5,1344.625,105.875
"25025","76005","2019",40,36,4,159950.25,1900.5,85.925
"25026","76007","2019",9,9,0,239514.222222222,1784.77777777778,138.444444444444
"25027","76008","2019",7,7,0,159985.714285714,1534.14285714286,106.285714285714
"25028","76009","2019",6,6,0,112533.333333333,1490.16666666667,79.6666666666667
"25029","76010","2019",6,6,0,200833.333333333,1710.66666666667,111.333333333333
"25030","76011","2019",2,2,0,197500,1750,108.5
"25031","76012","2019",5,5,0,163244.8,1368.2,117.4
"25032","76013","2019",15,15,0,140626.666666667,1592.4,90.6666666666667
"25033","76014","2019",13,13,0,212538.461538462,2036.76923076923,106.461538461538
"25034","76015","2019",5,5,0,188999.8,1544,129.4
"25035","76016","2019",1,1,0,134000,2792,48
"25036","76018","2019",17,17,0,153923.529411765,1778.70588235294,90.8823529411765
"25037","76019","2019",8,8,0,171816.25,1939,96
"25038","76020","2019",12,12,0,181375,1765.25,121.833333333333
"25039","76021","2019",5,5,0,149380,1499.4,106.8
"25040","76022","2019",3,3,0,172500,1398.33333333333,135.666666666667
"25041","76023","2019",7,7,0,127500,1291.57142857143,110.857142857143
"25042","76024","2019",2,2,0,99000,1306,76
"25043","76025","2019",7,7,0,80714.2857142857,1055.28571428571,77.5714285714286
"25044","76026","2019",33,29,4,135724.242424242,1699.06060606061,82.3030303030303
"25045","76028","2019",2,2,0,271800,2025.5,135
"25046","76029","2019",1,1,0,80000,1633,49
"25047","76030","2019",3,3,0,238066.666666667,1543.33333333333,154.666666666667
"25048","76032","2019",4,4,0,199812.5,2029,96.5
"25049","76033","2019",7,7,0,169014.285714286,2086.42857142857,81.2857142857143
"25050","76034","2019",25,25,0,153886,1495.64,103.24
"25051","76035","2019",22,20,2,116204.545454545,1149.09090909091,97.9545454545455
"25052","76036","2019",9,9,0,163961.111111111,1841.11111111111,92.2222222222222
"25053","76038","2019",3,3,0,193000,1760,120.333333333333
"25054","76039","2019",15,15,0,201578,1640.93333333333,113.333333333333
"25055","76040","2019",1,1,0,95000,990,96
"25056","76041","2019",11,11,0,265490.818181818,1979.81818181818,127.363636363636
"25057","76042","2019",2,2,0,125000,730.5,149
"25058","76043","2019",9,9,0,229377.777777778,2011.22222222222,114.222222222222
"25059","76045","2019",3,3,0,179600,1934.66666666667,92.3333333333333
"25060","76046","2019",8,8,0,190437.5,1775.125,108.375
"25061","76048","2019",4,3,1,168750,1813.75,93.25
"25062","76049","2019",6,6,0,71666.6666666667,1128.83333333333,63.1666666666667
"25063","76050","2019",8,8,0,135025,1330.875,101.625
"25064","76051","2019",20,19,1,119112.5,1436.55,83.45
"25065","76053","2019",2,2,0,145450,1420,102.5
"25066","76054","2019",7,7,0,122121.428571429,1107,109.428571428571
"25067","76055","2019",4,4,0,249050,1980.25,127.5
"25068","76056","2019",7,7,0,181957.142857143,1993.42857142857,95.4285714285714
"25069","76057","2019",117,108,9,149597.760683761,1889.35897435897,79.0683760683761
"25070","76058","2019",2,2,0,165500,1293.5,136.5
"25071","76059","2019",4,4,0,114022.5,1117.75,99.75
"25072","76060","2019",5,5,0,144400,1873,89.8
"25073","76062","2019",3,3,0,173033.333333333,1457.66666666667,130.333333333333
"25074","76063","2019",6,6,0,192783.333333333,1948.16666666667,98.6666666666667
"25075","76064","2019",6,6,0,166225,1688.33333333333,96
"25076","76065","2019",8,8,0,113500,1321.375,86.625
"25077","76066","2019",1,1,0,115000,1150,100
"25078","76067","2019",11,11,0,109499.090909091,1296.90909090909,87.4545454545455
"25079","76068","2019",11,11,0,162854.545454545,1416.45454545455,116.090909090909
"25080","76069","2019",35,34,1,280080,2412.54285714286,122.142857142857
"25081","76070","2019",12,12,0,111716.666666667,1239.5,99.5
"25082","76071","2019",4,4,0,138875,1491,98
"25083","76072","2019",11,11,0,192206.818181818,1716.72727272727,115.090909090909
"25084","76074","2019",1,1,0,176000,1158,152
"25085","76075","2019",3,3,0,226200,1745.66666666667,130.666666666667
"25086","76076","2019",1,1,0,244000,1452,168
"25087","76077","2019",6,6,0,208383.333333333,1612.16666666667,135.833333333333
"25088","76079","2019",4,4,0,199883.75,2300.25,87.5
"25089","76082","2019",7,7,0,167000,1136.71428571429,157.285714285714
"25090","76083","2019",2,2,0,148500,1750.5,91
"25091","76084","2019",3,3,0,191000,1680.66666666667,114.333333333333
"25092","76085","2019",4,4,0,190957.5,1542.25,128.75
"25093","76086","2019",4,4,0,137725,1688,87.25
"25094","76087","2019",4,4,0,158750,1473,110
"25095","76088","2019",10,10,0,141310,1594.7,90.6
"25096","76090","2019",9,9,0,149888.888888889,1673.22222222222,93.8888888888889
"25097","76091","2019",4,4,0,208752.5,1884.75,115.5
"25098","76092","2019",3,3,0,140666.666666667,1780,76
"25099","76093","2019",6,6,0,140166.666666667,1726.16666666667,96.8333333333333
"25100","76094","2019",5,4,1,193980,1710.8,111.6
"25101","76095","2019",127,68,59,206629.456692913,2020.28346456693,94.7165354330709
"25102","76096","2019",10,10,0,117500,1305.8,92.4
"25103","76099","2019",5,5,0,216700,1863,118.4
"25104","76100","2019",13,12,1,176273.076923077,1849.15384615385,102.230769230769
"25105","76101","2019",24,24,0,109687.5,1198.75,96.0416666666667
"25106","76103","2019",101,48,53,189600.396039604,2108.30693069307,89.7524752475248
"25107","76104","2019",7,7,0,173092.857142857,1794.42857142857,99
"25108","76105","2019",8,8,0,213962.5,2042.375,106.375
"25109","76106","2019",6,6,0,229500,1928,120.666666666667
"25110","76107","2019",5,5,0,166640,1801.8,94.8
"25111","76108","2019",293,152,141,275476.948805461,2639.81911262799,102.525597269625
"25112","76109","2019",4,4,0,178250,1815.75,102.75
"25113","76110","2019",1,1,0,75500,803,94
"25114","76111","2019",3,3,0,238450,1980,124
"25115","76112","2019",6,6,0,165666.666666667,1483.16666666667,103.5
"25116","76113","2019",4,4,0,175500,1444.75,134.75
"25117","76114","2019",152,126,26,89379.2236842105,1300.09868421053,70.7434210526316
"25118","76115","2019",8,8,0,144850,1703.125,85.75
"25119","76116","2019",47,47,0,212144.531914894,2038.97872340426,106.659574468085
"25120","76117","2019",13,13,0,250293.846153846,1958.38461538462,122.384615384615
"25121","76118","2019",4,4,0,191038.75,1434.5,131.5
"25122","76119","2019",3,3,0,146666.666666667,1569.33333333333,98.6666666666667
"25123","76120","2019",6,6,0,169770.5,1826.16666666667,97.1666666666667
"25124","76121","2019",2,2,0,171250,1837,93.5
"25125","76122","2019",3,3,0,92000,1098,84.6666666666667
"25126","76123","2019",16,16,0,226709.375,1942.3125,112.8125
"25127","76124","2019",10,10,0,143939.3,1605.2,99.3
"25128","76125","2019",22,21,1,160718.181818182,1757.5,95.0454545454545
"25129","76126","2019",4,4,0,138750,1288.75,97.25
"25130","76128","2019",8,8,0,142793.75,1786.625,84.875
"25131","76129","2019",4,4,0,135000,1700.25,93.75
"25132","76130","2019",1,1,0,142000,1420,100
"25133","76131","2019",7,5,2,111171.428571429,1383.71428571429,77.1428571428571
"25134","76132","2019",6,6,0,140550,1414.83333333333,106.833333333333
"25135","76133","2019",6,6,0,159925,1587.66666666667,97.5
"25136","76134","2019",6,6,0,177206.666666667,2387,81.6666666666667
"25137","76135","2019",17,17,0,222226.470588235,1715.11764705882,129.588235294118
"25138","76136","2019",11,11,0,118218.181818182,1375.18181818182,86.3636363636364
"25139","76138","2019",5,5,0,173290,1874.4,93.2
"25140","76139","2019",3,3,0,186100,1813,109
"25141","76140","2019",1,1,0,1e+05,909,110
"25142","76141","2019",18,18,0,176290.277777778,1620.38888888889,107.777777777778
"25143","76142","2019",3,3,0,124566.666666667,1490.66666666667,92
"25144","76143","2019",19,18,1,174057.894736842,1802.42105263158,101.473684210526
"25145","76144","2019",4,4,0,201824.25,1855.5,102.5
"25146","76146","2019",28,25,3,157998.071428571,1850.46428571429,90.1428571428571
"25147","76147","2019",13,13,0,144183.384615385,1542.84615384615,96
"25148","76148","2019",6,6,0,93277.8333333333,1506.83333333333,63.1666666666667
"25149","76149","2019",3,3,0,199000,1472.66666666667,135
"25150","76151","2019",2,2,0,132500,1341.5,97
"25151","76152","2019",7,7,0,183785.714285714,1889.42857142857,96.8571428571429
"25152","76153","2019",4,4,0,123750,1725.75,84.5
"25153","76154","2019",4,4,0,77700,985.75,73.75
"25154","76155","2019",2,2,0,66500,807.5,81
"25155","76156","2019",4,4,0,174962.5,1479,124.5
"25156","76157","2019",124,70,54,135572.725806452,1713.29032258065,78.6209677419355
"25157","76158","2019",7,7,0,164884.285714286,1299.57142857143,133.285714285714
"25158","76159","2019",34,33,1,128087.529411765,1445.05882352941,90.2058823529412
"25159","76160","2019",4,4,0,134337.5,1506.5,95.25
"25160","76161","2019",2,2,0,122000,1433.5,94.5
"25161","76162","2019",3,3,0,160133.333333333,1545,109.333333333333
"25162","76163","2019",9,9,0,206894.444444444,1809.33333333333,118.555555555556
"25163","76164","2019",58,46,12,159544.827586207,1782.10344827586,92.3793103448276
"25164","76165","2019",131,99,32,124348.389312977,1467.0534351145,86.1679389312977
"25165","76166","2019",8,8,0,124875,1094.875,116.125
"25166","76167","2019",20,20,0,271991.55,2313,125.65
"25167","76168","2019",1,1,0,50000,893,56
"25168","76169","2019",13,13,0,187307.692307692,1893.76923076923,103.846153846154
"25169","76170","2019",2,2,0,126250,1142.5,111.5
"25170","76172","2019",3,3,0,151333.333333333,1834,73.3333333333333
"25171","76173","2019",6,6,0,175666.666666667,1865.16666666667,99
"25172","76174","2019",6,6,0,179925,1654.83333333333,114.5
"25173","76175","2019",1,1,0,246000,1892,130
"25174","76176","2019",3,3,0,139000,1496.33333333333,91.6666666666667
"25175","76177","2019",1,1,0,71499,1192,60
"25176","76178","2019",27,27,0,156750.296296296,1626,96.962962962963
"25177","76179","2019",24,23,1,162112.083333333,1777.54166666667,92.0416666666667
"25178","76180","2019",2,2,0,189750,1641.5,125
"25179","76181","2019",1,1,0,155000,1292,120
"25180","76182","2019",3,3,0,171333.333333333,1429,122.666666666667
"25181","76183","2019",3,3,0,124166.666666667,1449.66666666667,79
"25182","76185","2019",5,5,0,175800,1592.2,111.6
"25183","76186","2019",2,2,0,104600,1232.5,82.5
"25184","76188","2019",4,4,0,130050,1764.75,72
"25185","76189","2019",4,4,0,163825,1627,92.25
"25186","76190","2019",3,3,0,123666.666666667,1101,103.666666666667
"25187","76192","2019",101,77,24,124769.683168317,1877.20792079208,73.6336633663366
"25188","76193","2019",5,5,0,141600,1588.6,91.2
"25189","76194","2019",6,6,0,161150.333333333,1782,92.3333333333333
"25190","76195","2019",3,3,0,85166.6666666667,1222.33333333333,69
"25191","76196","2019",3,2,1,229666.666666667,3497.33333333333,78
"25192","76197","2019",1,1,0,2e+05,1439,139
"25193","76198","2019",14,14,0,160916.428571429,1667.14285714286,99.5
"25194","76199","2019",8,8,0,118859.375,1169,107
"25195","76200","2019",7,7,0,214957.142857143,2398.85714285714,88.7142857142857
"25196","76201","2019",6,6,0,181183.333333333,1703,111.5
"25197","76202","2019",1,1,0,154000,2444,63
"25198","76203","2019",13,13,0,173290,1890.69230769231,94.4615384615385
"25199","76204","2019",3,3,0,105000,1292,86
"25200","76205","2019",4,4,0,117710,1116.5,100.25
"25201","76206","2019",4,4,0,257500,1945.75,133.75
"25202","76207","2019",1,1,0,284000,2606,109
"25203","76208","2019",6,6,0,194708.333333333,2111.5,91.3333333333333
"25204","76209","2019",9,9,0,162505.555555556,1524.22222222222,110.222222222222
"25205","76210","2019",7,7,0,130681.428571429,1338.14285714286,99.1428571428571
"25206","76211","2019",3,3,0,131133.333333333,1662,74.3333333333333
"25207","76212","2019",110,70,40,138303.681818182,1744.84545454545,78.8545454545455
"25208","76213","2019",6,6,0,228333.333333333,1583.66666666667,142
"25209","76214","2019",8,8,0,137606.25,1266.75,108.25
"25210","76216","2019",173,101,72,121241.375722543,1739.21965317919,70.5606936416185
"25211","76217","2019",525,199,326,120138.754285714,1742.4419047619,69.0590476190476
"25212","76218","2019",1,1,0,99000,1904,52
"25213","76219","2019",28,28,0,142175,1450.10714285714,94.75
"25214","76220","2019",2,2,0,97750,1909.5,56.5
"25215","76221","2019",5,5,0,175420,1476.8,123.6
"25216","76222","2019",47,38,9,165891.063829787,1873.65957446809,90.1914893617021
"25217","76223","2019",7,7,0,126719.857142857,1180,107.142857142857
"25218","76224","2019",16,16,0,194359.375,1711.125,118.9375
"25219","76225","2019",10,10,0,145923.6,1700.3,84.6
"25220","76226","2019",4,4,0,131350,1552.75,87
"25221","76227","2019",11,11,0,171268.181818182,1658.45454545455,104.454545454545
"25222","76228","2019",5,5,0,177930,1379.2,130.2
"25223","76229","2019",7,7,0,170000,1541.57142857143,127.142857142857
"25224","76230","2019",9,9,0,259461.111111111,1888.22222222222,136.333333333333
"25225","76231","2019",144,71,73,109679.520833333,1335.125,83.6666666666667
"25226","76232","2019",8,8,0,149243.75,1355.375,114.375
"25227","76234","2019",14,14,0,176742.857142857,1767.85714285714,102.785714285714
"25228","76235","2019",23,23,0,135173.913043478,1435.82608695652,91.3478260869565
"25229","76236","2019",4,4,0,154500,1736,89.75
"25230","76237","2019",8,8,0,197718.75,1647.375,134.5
"25231","76238","2019",35,35,0,200648.142857143,2304.57142857143,92.6285714285714
"25232","76239","2019",6,6,0,195833.333333333,1887.83333333333,106.5
"25233","76240","2019",11,11,0,168090.909090909,1748.81818181818,101.727272727273
"25234","76241","2019",4,4,0,169750,2639.75,71.25
"25235","76243","2019",4,4,0,163862.5,1652.25,99
"25236","76244","2019",2,2,0,98500,1149.5,85
"25237","76245","2019",19,19,0,214582.631578947,2029.21052631579,106.315789473684
"25238","76247","2019",8,8,0,129000,1287.5,104.125
"25239","76249","2019",8,8,0,193000,1762.5,107.125
"25240","76250","2019",11,11,0,205334,2102.63636363636,107.545454545455
"25241","76251","2019",2,2,0,117400,1631,77.5
"25242","76252","2019",15,15,0,171008,1605.86666666667,108.533333333333
"25243","76253","2019",11,11,0,171749.545454545,1611,108
"25244","76254","2019",52,37,15,185348.365384615,2595.73076923077,76.8846153846154
"25245","76255","2019",120,84,36,114623.316666667,1421.06666666667,80.4
"25246","76257","2019",4,4,0,101875,1408,63.75
"25247","76258","2019",42,39,3,145607.142857143,1509.95238095238,103.666666666667
"25248","76259","2019",300,174,126,127715.136666667,1732.47666666667,75.3966666666667
"25249","76260","2019",17,16,1,131076.470588235,1666.52941176471,79.7058823529412
"25250","76261","2019",6,6,0,163333.333333333,1517.83333333333,118.666666666667
"25251","76262","2019",1,1,0,183000,1307,140
"25252","76263","2019",17,16,1,159158.823529412,1464.88235294118,112.941176470588
"25253","76264","2019",2,2,0,159000,1637,99.5
"25254","76265","2019",3,3,0,27406.6666666667,598,49.3333333333333
"25255","76266","2019",2,2,0,113900,1330.5,84
"25256","76268","2019",3,3,0,152000,1561.33333333333,92.6666666666667
"25257","76269","2019",1,1,0,125000,1923,65
"25258","76270","2019",32,32,0,335714.84375,2756.5,126.03125
"25259","76271","2019",20,20,0,164622.05,1511.8,108.15
"25260","76272","2019",5,5,0,193000,1644,112.4
"25261","76273","2019",13,13,0,241442.307692308,2012,124.307692307692
"25262","76274","2019",1,1,0,116313,1368,85
"25263","76275","2019",17,17,0,221055.882352941,2321.88235294118,96.6470588235294
"25264","76276","2019",59,53,6,113347.084745763,1389.8813559322,87.3898305084746
"25265","76278","2019",8,8,0,74750,955.75,79.875
"25266","76279","2019",5,5,0,133660,1623.4,86.8
"25267","76280","2019",3,3,0,100266.666666667,1100.33333333333,91
"25268","76281","2019",29,25,4,158981.379310345,1782.93103448276,95.5862068965517
"25269","76282","2019",12,12,0,172008.333333333,1529.91666666667,115.916666666667
"25270","76283","2019",2,2,0,170000,1373,115
"25271","76284","2019",3,3,0,220866.666666667,1882.33333333333,113.666666666667
"25272","76285","2019",2,2,0,214000,1877,106.5
"25273","76286","2019",12,12,0,97475,1034.33333333333,101.916666666667
"25274","76287","2019",21,21,0,174840.238095238,1715.28571428571,104.047619047619
"25275","76288","2019",7,7,0,295685.714285714,2392.71428571429,106.285714285714
"25276","76289","2019",15,15,0,167014.266666667,1528.2,109.4
"25277","76290","2019",7,7,0,207357.142857143,1737.28571428571,119.142857142857
"25278","76291","2019",12,12,0,176400,1777.66666666667,106.25
"25279","76293","2019",6,6,0,115333.333333333,1231.83333333333,94.3333333333333
"25280","76294","2019",6,6,0,149098.833333333,1410.83333333333,108.5
"25281","76295","2019",14,14,0,92428.5714285714,1223.14285714286,76.6428571428571
"25282","76296","2019",21,20,1,200385.714285714,2044.7619047619,97.2857142857143
"25283","76297","2019",3,3,0,136283.333333333,1208.33333333333,113
"25284","76298","2019",8,8,0,130250,1440.75,87.25
"25285","76299","2019",9,9,0,138666.666666667,1491.11111111111,95.6666666666667
"25286","76300","2019",5,5,0,196000,1507.8,125
"25287","76302","2019",3,3,0,136500,1603.33333333333,63
"25288","76303","2019",8,8,0,177125,2074.125,90.875
"25289","76304","2019",4,4,0,159337.5,1278.5,138.5
"25290","76305","2019",68,67,1,164954.426470588,2054.02941176471,85
"25291","76306","2019",2,2,0,115672,1123.5,103
"25292","76307","2019",22,21,1,198895.454545455,2153.63636363636,92.1818181818182
"25293","76308","2019",8,8,0,154312.5,1368.75,114.875
"25294","76309","2019",3,3,0,220000,1740,130.666666666667
"25295","76311","2019",5,5,0,178720,1965.8,96.4
"25296","76312","2019",73,62,11,130030.410958904,1467.76712328767,95.972602739726
"25297","76313","2019",7,7,0,210535.714285714,2003.85714285714,109.857142857143
"25298","76314","2019",3,3,0,212333.333333333,2151.66666666667,119
"25299","76315","2019",9,9,0,156300,1696.33333333333,97.6666666666667
"25300","76316","2019",11,11,0,181868.181818182,1779.72727272727,109.909090909091
"25301","76317","2019",3,3,0,186833.333333333,1741.33333333333,109
"25302","76318","2019",12,12,0,199962.5,2209.83333333333,104.5
"25303","76319","2019",100,99,1,168523.85,1823,93.92
"25304","76320","2019",5,5,0,74433.4,912,85
"25305","76321","2019",22,22,0,124440.909090909,1433.31818181818,87.5454545454545
"25306","76322","2019",158,101,57,166459.778481013,2211.83544303797,75.1518987341772
"25307","76324","2019",6,6,0,193625,1948.16666666667,104.166666666667
"25308","76325","2019",4,4,0,130887.5,1467,108.75
"25309","76327","2019",6,6,0,152203.333333333,2140.5,81.3333333333333
"25310","76328","2019",5,5,0,177930,2007.8,106.8
"25311","76329","2019",38,33,5,138054.473684211,1535.10526315789,87.4736842105263
"25312","76330","2019",11,11,0,160713.636363636,1700.27272727273,103.454545454545
"25313","76331","2019",5,5,0,150600,1565.6,95.4
"25314","76332","2019",4,4,0,149862.5,1158,119
"25315","76333","2019",7,7,0,108107.142857143,1361.85714285714,78
"25316","76334","2019",7,7,0,106071.428571429,1295.71428571429,83.1428571428571
"25317","76335","2019",3,3,0,208000,1950,107.666666666667
"25318","76336","2019",4,4,0,132000,1388.25,96.75
"25319","76338","2019",4,4,0,159247.5,1626.25,99.25
"25320","76339","2019",3,3,0,144333.333333333,1583.33333333333,99.6666666666667
"25321","76340","2019",11,11,0,158545.454545455,1414.09090909091,121.545454545455
"25322","76341","2019",85,64,21,141515.341176471,1931.89411764706,76.1058823529412
"25323","76342","2019",2,2,0,224500,1528,150
"25324","76343","2019",2,2,0,111100,909.5,121
"25325","76344","2019",8,8,0,67500,913.375,83.875
"25326","76345","2019",4,4,0,119875,1691,77.5
"25327","76346","2019",7,7,0,149652.857142857,1679.28571428571,100.714285714286
"25328","76347","2019",4,4,0,196250,1991.5,100.25
"25329","76348","2019",6,6,0,149125,1888.83333333333,83.5
"25330","76349","2019",30,29,1,176826.666666667,2086.53333333333,83.3
"25331","76350","2019",1,1,0,240000,2376,101
"25332","76351","2019",2819,1025,1794,135798.444129124,1947.93969492728,69.3366442000709
"25333","76352","2019",5,5,0,155188,1724,97.2
"25334","76353","2019",2,2,0,118925,1117.5,105
"25335","76354","2019",3,3,0,353000,2505.33333333333,141
"25336","76355","2019",7,7,0,148442.857142857,1555.28571428571,96.2857142857143
"25337","76356","2019",3,3,0,162133.333333333,1041,153.666666666667
"25338","76357","2019",8,8,0,276875,2209.375,130.625
"25339","76358","2019",2,2,0,144100,1526,97.5
"25340","76359","2019",3,3,0,234000,4383,95.6666666666667
"25341","76360","2019",10,10,0,153285,1624.4,94.6
"25342","76361","2019",12,12,0,205409.583333333,2177.83333333333,98.9166666666667
"25343","76362","2019",4,4,0,110850,1451.5,73.5
"25344","76363","2019",6,6,0,82000,1014.16666666667,85.1666666666667
"25345","76364","2019",4,4,0,165875,1840.75,92.25
"25346","76365","2019",1,1,0,205000,1464,140
"25347","76366","2019",71,68,3,137918.309859155,1740.78873239437,82.9859154929577
"25348","76367","2019",46,46,0,264302.891304348,2180.84782608696,122.086956521739
"25349","76368","2019",8,8,0,227537.5,2200.5,112.125
"25350","76369","2019",4,4,0,167350,1523.5,111.75
"25351","76370","2019",6,6,0,161608.333333333,1485.83333333333,113.833333333333
"25352","76372","2019",6,6,0,126083.333333333,1133.5,125.166666666667
"25353","76373","2019",8,8,0,163891.25,1447.75,120
"25354","76374","2019",11,11,0,88545.4545454545,1300,68.0909090909091
"25355","76375","2019",3,3,0,199410,1264.33333333333,159.333333333333
"25356","76377","2019",54,52,2,290919.074074074,2418.72222222222,121.388888888889
"25357","76378","2019",16,16,0,179406.25,1708,108.625
"25358","76379","2019",3,3,0,160666.666666667,1657,105.666666666667
"25359","76380","2019",7,7,0,154328.571428571,1373.85714285714,114.714285714286
"25360","76381","2019",3,3,0,165000,1356.66666666667,110.666666666667
"25361","76382","2019",16,16,0,133956.25,1704.1875,81.375
"25362","76383","2019",1,1,0,144530,4517,32
"25363","76384","2019",88,76,12,108125.943181818,1440.375,77.1136363636364
"25364","76385","2019",7,6,1,160210.857142857,2056,87
"25365","76386","2019",7,7,0,213185.714285714,1886.57142857143,114
"25366","76387","2019",4,4,0,186187.5,1723.25,110
"25367","76388","2019",2,2,0,155500,1701.5,95.5
"25368","76389","2019",1,1,0,198500,2481,80
"25369","76390","2019",13,13,0,164204.615384615,1907,90.3846153846154
"25370","76391","2019",29,29,0,204460.344827586,1734.20689655172,123.862068965517
"25371","76392","2019",19,17,2,122789.473684211,1219.68421052632,107.684210526316
"25372","76394","2019",12,11,1,103000,1313.08333333333,84.6666666666667
"25373","76395","2019",5,5,0,130170,1448.2,92.2
"25374","76396","2019",5,5,0,204560,2194,104.2
"25375","76397","2019",12,12,0,118833.333333333,1530.08333333333,79.4166666666667
"25376","76398","2019",6,6,0,184916.666666667,1658,117
"25377","76399","2019",3,3,0,97233.3333333333,1070,88.6666666666667
"25378","76400","2019",25,24,1,162598.4,1532.48,108.72
"25379","76401","2019",34,34,0,143362.352941176,1337.08823529412,109
"25380","76402","2019",78,77,1,176471.282051282,1917.19230769231,95.5
"25381","76403","2019",2,2,0,104100,1141,92
"25382","76404","2019",21,20,1,227429.047619048,2329.52380952381,105.666666666667
"25383","76405","2019",1,1,0,155600,1511,103
"25384","76406","2019",6,4,2,135969.333333333,1695.16666666667,79.5
"25385","76407","2019",2,2,0,358500,2226,165
"25386","76408","2019",19,19,0,169034.210526316,1864.36842105263,92.5263157894737
"25387","76409","2019",8,7,1,203875,2141.625,99.125
"25388","76410","2019",133,61,72,105316.812030075,1526.64661654135,71.2406015037594
"25389","76411","2019",1,1,0,103000,1144,90
"25390","76412","2019",12,12,0,210045.833333333,1698.33333333333,127.666666666667
"25391","76413","2019",6,6,0,163666.666666667,1613.66666666667,101.666666666667
"25392","76414","2019",24,23,1,165169.166666667,1508.20833333333,111.291666666667
"25393","76415","2019",6,6,0,149250,1481.33333333333,109.833333333333
"25394","76416","2019",4,4,0,157250,1199.25,129.25
"25395","76417","2019",6,6,0,186183.333333333,1440.83333333333,139.833333333333
"25396","76418","2019",16,16,0,145255,1559.75,93.1875
"25397","76419","2019",2,2,0,122825,1760.5,70
"25398","76420","2019",6,6,0,128750,1550,86.8333333333333
"25399","76421","2019",12,12,0,204845,1992.33333333333,107.666666666667
"25400","76422","2019",2,2,0,133900,1558,86
"25401","76423","2019",7,7,0,123571.428571429,1178.85714285714,114
"25402","76424","2019",3,3,0,114166.666666667,1189,107.333333333333
"25403","76425","2019",3,3,0,241500,2112.66666666667,115.666666666667
"25404","76426","2019",4,4,0,91487.5,1289.25,69.75
"25405","76427","2019",7,7,0,136414.285714286,1627.42857142857,89.1428571428571
"25406","76429","2019",122,104,18,279415.655737705,2632.59836065574,107.803278688525
"25407","76431","2019",1,1,0,193000,1508,128
"25408","76432","2019",4,4,0,111950,1242,86.5
"25409","76433","2019",5,5,0,227300,2035.6,113.4
"25410","76434","2019",21,21,0,181111.428571429,1855.7619047619,100.761904761905
"25411","76435","2019",11,11,0,116954.545454545,1585.81818181818,78.2727272727273
"25412","76436","2019",4,4,0,213375,2093,105.25
"25413","76437","2019",9,9,0,133611.111111111,1259.55555555556,105.222222222222
"25414","76439","2019",2,2,0,87500,885,110
"25415","76440","2019",2,2,0,74800,1233,69.5
"25416","76441","2019",6,6,0,83865,985.5,87.3333333333333
"25417","76442","2019",8,8,0,140687.5,1419.5,90.625
"25418","76443","2019",14,14,0,210521.428571429,2009.85714285714,103.571428571429
"25419","76445","2019",9,9,0,172166.666666667,1632.55555555556,106.888888888889
"25420","76446","2019",15,15,0,299470,2335.86666666667,129.4
"25421","76447","2019",182,140,42,188189.038461538,2118.53296703297,90.5879120879121
"25422","76448","2019",24,24,0,215772.916666667,1949.125,111.875
"25423","76449","2019",5,5,0,171360,1721,115.2
"25424","76450","2019",2,2,0,169500,1679.5,101.5
"25425","76451","2019",333,132,201,236726.09009009,2366.83783783784,95.2522522522522
"25426","76452","2019",54,49,5,160578.240740741,1669.55555555556,94.2037037037037
"25427","76453","2019",13,13,0,180919.230769231,1745.23076923077,111
"25428","76454","2019",1,1,0,250000,2083,120
"25429","76455","2019",5,5,0,125760,1145.4,111
"25430","76456","2019",6,6,0,105833.333333333,1489.83333333333,78.3333333333333
"25431","76457","2019",18,14,4,151794.444444444,1631.05555555556,92.2777777777778
"25432","76459","2019",4,4,0,163250,1490.25,113.25
"25433","76460","2019",2,2,0,15400,342,45
"25434","76461","2019",1,1,0,187000,2011,93
"25435","76462","2019",55,40,15,112382.727272727,1420.34545454545,81.4545454545455
"25436","76463","2019",7,7,0,140214.285714286,1377.28571428571,108
"25437","76464","2019",23,23,0,232078.260869565,1925.52173913043,121.782608695652
"25438","76465","2019",6,6,0,114800,1534.33333333333,81.8333333333333
"25439","76467","2019",20,20,0,164392.5,1419.95,117.25
"25440","76468","2019",14,14,0,166678.571428571,1722.5,100.285714285714
"25441","76469","2019",5,5,0,92950,1194.4,85.8
"25442","76470","2019",7,7,0,149728.571428571,1604.57142857143,93.1428571428571
"25443","76471","2019",7,7,0,131071.428571429,1639.42857142857,79.1428571428571
"25444","76472","2019",9,9,0,130000,1456.66666666667,94.5555555555556
"25445","76473","2019",12,12,0,131912.5,1380.83333333333,100.75
"25446","76474","2019",67,62,5,163052.671641791,1843.80597014925,87.4179104477612
"25447","76475","2019",72,69,3,292611.111111111,2411.80555555556,124.027777777778
"25448","76476","2019",113,108,5,146043.398230088,1604.86725663717,95.1150442477876
"25449","76477","2019",7,7,0,172731.428571429,2201,81
"25450","76479","2019",1,1,0,45000,750,60
"25451","76480","2019",4,4,0,173050,2368.5,81.5
"25452","76481","2019",77,75,2,275837.025974026,2601.18181818182,111.571428571429
"25453","76482","2019",39,38,1,209084.538461538,2056.25641025641,107.512820512821
"25454","76483","2019",5,5,0,176600,1668.2,103.6
"25455","76484","2019",119,118,1,149940.033613445,1799.94957983193,83.9159663865546
"25456","76486","2019",18,18,0,115235.777777778,1437.38888888889,84.3333333333333
"25457","76487","2019",3,3,0,101666.666666667,1279.66666666667,75.6666666666667
"25458","76488","2019",1,1,0,138370,1457,95
"25459","76489","2019",5,5,0,237700,1734.4,147.8
"25460","76490","2019",14,14,0,123757.142857143,1336.21428571429,92.2142857142857
"25461","76491","2019",9,9,0,173911.111111111,1749.33333333333,103.777777777778
"25462","76492","2019",13,13,0,116665.384615385,1245,97.1538461538462
"25463","76493","2019",5,5,0,213758,2282,102.4
"25464","76494","2019",6,6,0,195750,1579.83333333333,130.333333333333
"25465","76495","2019",67,63,4,165305,1756.14925373134,92.955223880597
"25466","76497","2019",88,52,36,138416.477272727,1716.95454545455,79.3181818181818
"25467","76498","2019",320,191,129,110869.3375,1588.796875,69.778125
"25468","76499","2019",13,13,0,187896.923076923,1770.38461538462,103.692307692308
"25469","76500","2019",7,7,0,90378.5714285714,1089.85714285714,88
"25470","76501","2019",5,5,0,176300,1518,130.4
"25471","76502","2019",4,4,0,209455,1895,116.5
"25472","76503","2019",13,13,0,259382.692307692,1873.61538461538,140.461538461538
"25473","76504","2019",4,4,0,184800,1324.25,147
"25474","76506","2019",8,8,0,135062.5,1356.375,108
"25475","76507","2019",12,12,0,139348.166666667,1452.25,89.4166666666667
"25476","76508","2019",6,6,0,183500,2321,84
"25477","76509","2019",2,2,0,125500,1338,99
"25478","76510","2019",7,7,0,161500,1443.42857142857,110.714285714286
"25479","76511","2019",2,2,0,78500,991.5,78
"25480","76513","2019",5,5,0,321800,2082,147
"25481","76514","2019",3,3,0,274500,2229.33333333333,123.333333333333
"25482","76515","2019",17,16,1,158521.764705882,2367.70588235294,73.0588235294118
"25483","76516","2019",5,5,0,113400,1277.6,88
"25484","76517","2019",35,35,0,252733.857142857,2064.34285714286,127.542857142857
"25485","76518","2019",3,3,0,141666.666666667,1411.33333333333,97.3333333333333
"25486","76519","2019",1,1,0,235000,2043,115
"25487","76520","2019",10,10,0,93929.5,1270.6,77.5
"25488","76521","2019",3,3,0,121333.333333333,1412.33333333333,86.6666666666667
"25489","76522","2019",16,16,0,204625,2188,97.5
"25490","76523","2019",2,2,0,110100,969,121
"25491","76524","2019",4,4,0,136112.5,1602.25,90.5
"25492","76526","2019",4,4,0,123500,1551.75,84
"25493","76527","2019",7,7,0,78825.7142857143,1087,87.4285714285714
"25494","76528","2019",7,7,0,112957.142857143,1328.85714285714,88.4285714285714
"25495","76529","2019",4,4,0,208027.5,1954.25,109
"25496","76530","2019",3,3,0,131333.333333333,1445.33333333333,90
"25497","76531","2019",4,4,0,160375,1586.5,108
"25498","76532","2019",4,4,0,212970.25,1470.5,147.25
"25499","76533","2019",10,10,0,193950,2343.3,84.9
"25500","76534","2019",16,15,1,182293.75,1961.625,91.5
"25501","76535","2019",10,10,0,161650,1480.5,110.7
"25502","76536","2019",9,9,0,159975.777777778,1580.11111111111,103.888888888889
"25503","76537","2019",4,4,0,109000,1135.5,96.75
"25504","76538","2019",4,4,0,85875,1003.5,86.75
"25505","76540","2019",2406,459,1947,146024.728595179,2498.12884455528,60.5968412302577
"25506","76541","2019",15,15,0,217556.666666667,1962.33333333333,112
"25507","76542","2019",3,3,0,132000,1257.66666666667,103.333333333333
"25508","76543","2019",4,4,0,146600,1772,84.25
"25509","76544","2019",4,4,0,137875,1165.25,120
"25510","76545","2019",28,23,5,140041.071428571,1634.71428571429,85.7142857142857
"25511","76546","2019",1,1,0,168150,1529,110
"25512","76547","2019",6,6,0,240966.666666667,1635.83333333333,150.666666666667
"25513","76548","2019",4,4,0,159125,1798.5,93.5
"25514","76549","2019",4,4,0,151305.5,1674,94.75
"25515","76550","2019",6,6,0,214333.333333333,1605.83333333333,142
"25516","76551","2019",9,9,0,269733.333333333,2643.33333333333,106.444444444444
"25517","76552","2019",125,49,76,269311.28,2776.56,95.04
"25518","76553","2019",1,1,0,115000,1173,98
"25519","76554","2019",3,3,0,165816.666666667,1646,99.3333333333333
"25520","76555","2019",7,7,0,239498.571428571,2057.28571428571,125.571428571429
"25521","76556","2019",13,13,0,158223.076923077,1813.23076923077,95.7692307692308
"25522","76557","2019",11,11,0,149636.363636364,1422.36363636364,107.636363636364
"25523","76558","2019",19,19,0,220855.263157895,1976.52631578947,118.210526315789
"25524","76559","2019",7,7,0,177635.714285714,1787.71428571429,100
"25525","76560","2019",8,8,0,182512.5,2348,76
"25526","76561","2019",99,71,28,121033.464646465,1545.60606060606,80.9292929292929
"25527","76562","2019",12,12,0,211855.166666667,2210.83333333333,106.666666666667
"25528","76563","2019",21,21,0,219090.476190476,1993.61904761905,109.666666666667
"25529","76564","2019",5,5,0,143384,1974.4,73
"25530","76565","2019",13,12,1,171513.846153846,1737.46153846154,103.615384615385
"25531","76566","2019",2,2,0,87500,755.5,121
"25532","76567","2019",4,4,0,124500,1033.25,122.75
"25533","76568","2019",9,9,0,151060,1637.33333333333,95.3333333333333
"25534","76569","2019",1,1,0,127300,1414,90
"25535","76570","2019",3,3,0,131333.333333333,1084.66666666667,112.666666666667
"25536","76571","2019",11,11,0,175409.090909091,1511.18181818182,119.363636363636
"25537","76573","2019",5,5,0,203150,1693,127
"25538","76574","2019",6,6,0,128575,1083.83333333333,140.166666666667
"25539","76575","2019",283,228,55,144662.862190813,1712.29681978799,84.7243816254417
"25540","76576","2019",14,14,0,128350,1573.92857142857,79.2857142857143
"25541","76577","2019",2,2,0,211888,1790,118.5
"25542","76578","2019",1,1,0,70000,986,71
"25543","76580","2019",15,15,0,173466,1578.13333333333,114.466666666667
"25544","76581","2019",5,5,0,226300,1754.2,136.4
"25545","76582","2019",3,3,0,121000,1379.66666666667,90.6666666666667
"25546","76583","2019",5,5,0,178240,1942.8,93.8
"25547","76584","2019",2,2,0,85000,1093,77.5
"25548","76585","2019",4,4,0,138750,1841.5,77.75
"25549","76586","2019",13,13,0,189596.153846154,1753,113.461538461538
"25550","76587","2019",5,5,0,186390,1829.6,103.4
"25551","76588","2019",6,6,0,99983.3333333333,1528.5,66.1666666666667
"25552","76589","2019",2,2,0,99500,1103.5,83.5
"25553","76590","2019",4,4,0,134000,1285.25,124.5
"25554","76591","2019",33,33,0,221540.545454545,1998.42424242424,112.757575757576
"25555","76592","2019",13,13,0,149057.692307692,1708.15384615385,90.7692307692308
"25556","76593","2019",12,12,0,192975,1936.58333333333,99.4166666666667
"25557","76594","2019",18,18,0,220822.222222222,1926.11111111111,115.944444444444
"25558","76595","2019",39,38,1,196461.538461538,2009.92307692308,100.948717948718
"25559","76596","2019",20,20,0,249035,2716.5,90.7
"25560","76597","2019",9,8,1,135866.666666667,1396.77777777778,109.444444444444
"25561","76598","2019",4,4,0,85200,1228.75,79.25
"25562","76599","2019",45,43,2,184182.222222222,2055.31111111111,91.0444444444445
"25563","76600","2019",18,16,2,162783.333333333,2254.83333333333,85
"25564","76601","2019",6,6,0,142750,1548.16666666667,103.833333333333
"25565","76602","2019",7,7,0,150500,1584.14285714286,98.5714285714286
"25566","76603","2019",8,8,0,180271.25,1706.5,108.625
"25567","76604","2019",4,4,0,191075,1767.75,114.75
"25568","76605","2019",10,10,0,196855,2591.3,86.4
"25569","76608","2019",25,25,0,163464,1645.4,101.16
"25570","76609","2019",8,8,0,196662.5,2027.5,104
"25571","76610","2019",14,14,0,159727.714285714,1722.5,92.8571428571429
"25572","76611","2019",1,1,0,190000,2603,73
"25573","76612","2019",3,3,0,175556.666666667,1858,103.666666666667
"25574","76613","2019",20,18,2,139465,1496,92.45
"25575","76614","2019",30,30,0,273604.833333333,2156.8,129.5
"25576","76615","2019",8,8,0,215743.75,2039.125,107.875
"25577","76616","2019",28,28,0,253641.25,2186.57142857143,121.357142857143
"25578","76617","2019",28,28,0,379748.571428571,2537.14285714286,150.071428571429
"25579","76618","2019",85,85,0,152218.976470588,1590.09411764706,98.1411764705882
"25580","76619","2019",4,4,0,131000,1451,90.75
"25581","76620","2019",1,1,0,168000,2049,82
"25582","76621","2019",16,16,0,164187.5,1475.1875,112.5625
"25583","76622","2019",3,3,0,246666.666666667,2086,118.666666666667
"25584","76623","2019",1,1,0,70000,1129,62
"25585","76624","2019",40,39,1,131176.25,1440.325,91.925
"25586","76626","2019",7,7,0,162785.714285714,1471.42857142857,117.142857142857
"25587","76627","2019",19,19,0,196684.210526316,2009.05263157895,99.3684210526316
"25588","76628","2019",10,10,0,150285,1404.6,108.6
"25589","76629","2019",11,11,0,161404.545454545,1488.54545454545,111.090909090909
"25590","76630","2019",2,2,0,127000,1550,75
"25591","76631","2019",23,23,0,170372.130434783,1474.60869565217,116.260869565217
"25592","76632","2019",9,9,0,115577.777777778,1342.44444444444,85
"25593","76634","2019",13,13,0,204461.538461538,2084.15384615385,100.923076923077
"25594","76635","2019",2,2,0,57000,774,69
"25595","76636","2019",22,22,0,199318.545454545,1948.13636363636,104.545454545455
"25596","76637","2019",20,18,2,148150.65,1577.75,95.95
"25597","76638","2019",8,8,0,146036.5,1390.875,106.5
"25598","76640","2019",97,82,15,146797.958762887,1654.61855670103,89.4742268041237
"25599","76641","2019",1,1,0,145000,2417,60
"25600","76642","2019",3,3,0,75666.6666666667,1023,73.6666666666667
"25601","76644","2019",3,3,0,132966.666666667,1690.66666666667,79
"25602","76646","2019",5,5,0,142800,1766.8,96.8
"25603","76647","2019",71,45,26,167637.394366197,1882.83098591549,93.9295774647887
"25604","76648","2019",29,29,0,142486.206896552,1428.72413793103,100.965517241379
"25605","76649","2019",7,7,0,137657.142857143,1264.71428571429,113.714285714286
"25606","76650","2019",13,13,0,273207.153846154,1938.53846153846,155.461538461538
"25607","76651","2019",1,1,0,130000,1461,89
"25608","76652","2019",18,18,0,116997.388888889,1254.55555555556,94.6666666666667
"25609","76653","2019",9,9,0,191161.111111111,1405.33333333333,129
"25610","76654","2019",1,1,0,164000,1640,100
"25611","76655","2019",85,47,38,132148.235294118,1894.88235294118,72.8352941176471
"25612","76656","2019",7,7,0,149571.428571429,1756.57142857143,83.2857142857143
"25613","76657","2019",16,16,0,258037.5,2581.8125,109.125
"25614","76658","2019",11,11,0,197462.636363636,1669,119.363636363636
"25615","76660","2019",9,9,0,179888.888888889,2252,79.5555555555556
"25616","76662","2019",3,3,0,143333.333333333,1350.33333333333,113
"25617","76663","2019",20,20,0,127191.5,1532.35,82.7
"25618","76664","2019",5,5,0,210980,1593.6,127.4
"25619","76665","2019",9,9,0,162133.333333333,1524.77777777778,105
"25620","76666","2019",2,2,0,104500,1249.5,82.5
"25621","76667","2019",1,1,0,29500,369,80
"25622","76668","2019",2,2,0,177000,1454.5,122
"25623","76669","2019",8,8,0,191562.5,1715.25,114.875
"25624","76670","2019",18,18,0,185808.333333333,1780.61111111111,106.5
"25625","76671","2019",3,3,0,187116.666666667,1395,113.666666666667
"25626","76672","2019",14,14,0,100939.214285714,1151.14285714286,89.5714285714286
"25627","76673","2019",6,6,0,210100,1831.66666666667,113.666666666667
"25628","76675","2019",13,13,0,192565.384615385,1559.46153846154,123.769230769231
"25629","76676","2019",11,11,0,156086.363636364,1244.27272727273,130.363636363636
"25630","76677","2019",8,7,1,146099.875,1595.875,93
"25631","76678","2019",12,12,0,152800,1498.25,106.083333333333
"25632","76680","2019",2,2,0,103000,1020,101
"25633","76681","2019",415,294,121,141745.826506024,1909.56385542169,75.0240963855422
"25634","76682","2019",11,11,0,158418.181818182,1540.81818181818,96.7272727272727
"25635","76683","2019",4,4,0,193121.5,1406,138.5
"25636","76684","2019",19,19,0,163244.210526316,1998.63157894737,87.4736842105263
"25637","76685","2019",10,10,0,152200,1610.6,96.5
"25638","76686","2019",9,9,0,128592,1563.55555555556,82.3333333333333
"25639","76688","2019",10,10,0,184974,1470.3,127.5
"25640","76689","2019",5,5,0,204440,1616,118.4
"25641","76690","2019",3,3,0,163946.666666667,1886.66666666667,95.3333333333333
"25642","76691","2019",4,4,0,247180,2633.25,115.5
"25643","76692","2019",3,3,0,158466.666666667,1562.66666666667,100.666666666667
"25644","76693","2019",12,12,0,180916.666666667,2158.75,89.9166666666667
"25645","76694","2019",3,3,0,135950,1311,117.666666666667
"25646","76695","2019",4,4,0,200050,2139,94
"25647","76697","2019",7,7,0,153417.142857143,1688.14285714286,93.8571428571429
"25648","76698","2019",6,6,0,176733.333333333,1769.66666666667,98.5
"25649","76699","2019",3,3,0,182316.666666667,1837.33333333333,98.6666666666667
"25650","76700","2019",29,27,2,118000,1531.62068965517,82.5172413793103
"25651","76702","2019",4,4,0,145375,1311.25,114
"25652","76703","2019",1,1,0,135000,1731,78
"25653","76705","2019",25,24,1,183112.64,1772.04,110.76
"25654","76706","2019",5,5,0,185510,1818.2,108.8
"25655","76707","2019",18,18,0,148400,1587.44444444444,95.6666666666667
"25656","76708","2019",7,7,0,195907.142857143,1846.14285714286,107.571428571429
"25657","76709","2019",65,59,6,113970.523076923,1524.90769230769,79.3230769230769
"25658","76710","2019",1,1,0,135000,2500,54
"25659","76711","2019",170,83,87,82909.3,1592.11176470588,57.2294117647059
"25660","76712","2019",13,13,0,156451.307692308,1779.61538461538,91.2307692307692
"25661","76714","2019",13,13,0,249500,2088.53846153846,130
"25662","76715","2019",5,5,0,147600,1490.8,97.6
"25663","76716","2019",21,21,0,193023.80952381,1883.57142857143,105.142857142857
"25664","76717","2019",12,12,0,153266.666666667,2350.75,73.6666666666667
"25665","76718","2019",15,15,0,157790,1574.46666666667,107.133333333333
"25666","76719","2019",12,12,0,147520.833333333,1555.58333333333,97.3333333333333
"25667","76720","2019",17,17,0,315836.764705882,2212.05882352941,141.235294117647
"25668","76721","2019",2,2,0,149800,1373,130
"25669","76723","2019",8,8,0,175275,1728.75,101.625
"25670","76725","2019",7,7,0,148185.714285714,1543.71428571429,97.5714285714286
"25671","76726","2019",4,4,0,158125,1779.25,88.5
"25672","76727","2019",9,9,0,141344.444444444,1341.33333333333,104.444444444444
"25673","76728","2019",16,16,0,199920.3125,2077.75,99.875
"25674","76731","2019",2,2,0,85547,1299.5,65
"25675","76732","2019",5,5,0,152600,1471.2,102
"25676","76733","2019",3,3,0,102000,1068,93.6666666666667
"25677","76734","2019",1,1,0,164500,1828,90
"25678","76735","2019",28,23,5,200789.285714286,2166.82142857143,90.1428571428571
"25679","76736","2019",11,10,1,121890.909090909,2009.81818181818,67.2727272727273
"25680","76737","2019",7,7,0,169528.571428571,1635.42857142857,108.142857142857
"25681","76738","2019",8,8,0,195725,2106.375,96.75
"25682","76739","2019",5,5,0,117428,1120.4,102
"25683","76740","2019",7,7,0,223457.142857143,2000.14285714286,117
"25684","76741","2019",3,3,0,119566.666666667,1512.33333333333,74.6666666666667
"25685","76743","2019",27,27,0,172659.259259259,1775.59259259259,100.407407407407
"25686","76745","2019",1,1,0,117500,1382,85
"25687","76746","2019",1,1,0,140000,1458,96
"25688","76747","2019",4,4,0,136000,2128.25,68.5
"25689","76748","2019",9,9,0,123833.333333333,1180.11111111111,112.555555555556
"25690","76749","2019",5,5,0,99600,1472.8,72.4
"25691","76750","2019",12,12,0,133204.833333333,1580.08333333333,88
"25692","76751","2019",16,15,1,114000,1495,76.3125
"25693","76752","2019",34,32,2,137572.764705882,1612.08823529412,87.1764705882353
"25694","76753","2019",13,13,0,225211.538461538,1931.38461538462,121.846153846154
"25695","76754","2019",26,25,1,135848.846153846,2355.65384615385,63.1153846153846
"25696","76755","2019",5,5,0,123800,1258.6,98.8
"25697","76756","2019",1,1,0,195000,1773,110
"25698","76757","2019",7,7,0,155714.285714286,1338,123
"25699","76758","2019",168,105,63,145508.25,1864.61904761905,79.5773809523809
"25700","76759","2019",1,1,0,198000,1904,104
"25701","77001","2019",20,18,2,247985,2286.8,113.15
"25702","77002","2019",11,11,0,195655.090909091,2030.36363636364,99.6363636363636
"25703","77003","2019",5,5,0,233560,2003.8,117.4
"25704","77004","2019",7,6,1,223785.714285714,2502,95.4285714285714
"25705","77005","2019",53,40,13,293780.358490566,2993.50943396226,103.867924528302
"25706","77006","2019",16,15,1,267823.0625,3247.3125,101.375
"25707","77007","2019",5,5,0,299000,3120.8,99.4
"25708","77008","2019",17,17,0,235340,2271.29411764706,105.352941176471
"25709","77009","2019",2,2,0,117500,1758,72.5
"25710","77010","2019",8,8,0,202701.25,2350.375,93.25
"25711","77011","2019",5,4,1,186104,1649.2,111.6
"25712","77012","2019",1,1,0,125000,1471,85
"25713","77013","2019",6,6,0,226083.333333333,1820.83333333333,133.833333333333
"25714","77014","2019",240,60,180,199484.35,2807.35416666667,73.45
"25715","77015","2019",2,2,0,211500,1483,145
"25716","77016","2019",13,13,0,135322.307692308,1897.61538461538,76.1538461538462
"25717","77018","2019",126,74,52,329425.380952381,3770.60317460317,89.7301587301587
"25718","77019","2019",7,7,0,144285.714285714,1583.71428571429,97.8571428571429
"25719","77020","2019",15,15,0,203480,1830.4,120.266666666667
"25720","77021","2019",2,2,0,121000,1395,84.5
"25721","77022","2019",24,21,3,569186.875,3819.875,155.208333333333
"25722","77023","2019",3,3,0,179333.333333333,2444.33333333333,74.6666666666667
"25723","77024","2019",5,4,1,176400,1360.6,124.6
"25724","77025","2019",11,11,0,124168.181818182,1485.72727272727,87.8181818181818
"25725","77026","2019",3,3,0,223333.333333333,1550.66666666667,150.333333333333
"25726","77027","2019",24,24,0,101660.25,1199.08333333333,89.625
"25727","77030","2019",6,6,0,176666.666666667,1733,104.333333333333
"25728","77031","2019",16,16,0,333065.625,3390.75,93.3125
"25729","77032","2019",16,16,0,157743.75,1729.25,91.9375
"25730","77033","2019",2,2,0,190650,1974,96.5
"25731","77034","2019",5,5,0,293200,2419.4,120
"25732","77035","2019",13,13,0,198076.923076923,1418.38461538462,141.692307692308
"25733","77036","2019",3,3,0,190000,2086.66666666667,91.6666666666667
"25734","77037","2019",79,72,7,405450.126582278,3937.29113924051,108.088607594937
"25735","77038","2019",9,9,0,351660,2980.88888888889,123.555555555556
"25736","77039","2019",14,14,0,314078.571428571,3108,104.857142857143
"25737","77040","2019",31,28,3,309657.483870968,2705.87096774194,116.451612903226
"25738","77041","2019",4,4,0,274712.5,2137.75,136.5
"25739","77042","2019",60,60,0,211154.05,2218.55,99.5333333333333
"25740","77043","2019",6,6,0,195666.666666667,1697.5,121
"25741","77044","2019",11,11,0,217181.818181818,2277.36363636364,95.6363636363636
"25742","77045","2019",11,11,0,153636.363636364,1605.09090909091,103.181818181818
"25743","77046","2019",4,4,0,188750,2096.5,94.75
"25744","77047","2019",24,23,1,279286.041666667,3029.125,101.791666666667
"25745","77048","2019",22,21,1,266931.818181818,3286.40909090909,91.0454545454545
"25746","77049","2019",15,15,0,320463.333333333,2541.13333333333,128.266666666667
"25747","77050","2019",3,3,0,140666.666666667,1693.66666666667,82
"25748","77051","2019",20,19,1,122435,1553.55,80.8
"25749","77052","2019",8,8,0,208331.25,2745.125,80.25
"25750","77053","2019",323,133,190,214971.464396285,3227.95975232198,69.640866873065
"25751","77054","2019",3,3,0,218933.333333333,2048,107
"25752","77055","2019",81,21,60,196240.148148148,2921.22222222222,68.8271604938272
"25753","77056","2019",4,4,0,208500,1378.75,171.25
"25754","77057","2019",5,5,0,131275,1511.2,95.8
"25755","77058","2019",423,102,321,266702.108747045,3831.45626477541,72.8510638297872
"25756","77059","2019",7,7,0,531942.857142857,3315,170.285714285714
"25757","77060","2019",6,6,0,181772.5,2055.5,94.8333333333333
"25758","77061","2019",26,21,5,205801.423076923,2054.11538461538,100.230769230769
"25759","77062","2019",8,7,1,363075,2907.125,134.25
"25760","77063","2019",31,31,0,225365.774193548,2384.58064516129,103.548387096774
"25761","77065","2019",16,16,0,354848.3125,3021.875,123.8125
"25762","77066","2019",2,2,0,164000,1832,91.5
"25763","77067","2019",150,122,28,258056.706666667,2877.76666666667,93.6533333333333
"25764","77068","2019",4,4,0,181750,2063.75,93
"25765","77069","2019",29,28,1,256043.793103448,2485.27586206897,105.551724137931
"25766","77070","2019",15,15,0,191548.733333333,1884.06666666667,112.066666666667
"25767","77071","2019",15,15,0,168900,1537.2,116.333333333333
"25768","77072","2019",13,13,0,137462.846153846,1177.23076923077,120.307692307692
"25769","77073","2019",6,6,0,197500,1923.16666666667,104.166666666667
"25770","77075","2019",25,16,9,288768.8,3506.76,91.08
"25771","77076","2019",8,8,0,179562.5,1624,117.375
"25772","77077","2019",10,10,0,223250,2032.2,119.7
"25773","77078","2019",23,23,0,203532,2214.4347826087,97.1304347826087
"25774","77079","2019",64,43,21,161989.796875,2270.078125,75.046875
"25775","77080","2019",3,3,0,176333.333333333,2318,80.3333333333333
"25776","77081","2019",13,10,3,221038.461538462,2915.84615384615,84.2307692307692
"25777","77082","2019",18,11,7,189710.833333333,2576.38888888889,75.7222222222222
"25778","77083","2019",254,98,156,259400.039370079,3375.90157480315,79.8622047244095
"25779","77084","2019",24,23,1,212666.666666667,2358.5,91.25
"25780","77085","2019",53,39,14,367474.226415094,4005.69811320755,91.4528301886792
"25781","77086","2019",11,11,0,221515.181818182,2283.72727272727,100
"25782","77087","2019",2,2,0,251500,3329,80
"25783","77088","2019",29,22,7,199597.24137931,1999.27586206897,102.275862068966
"25784","77089","2019",14,14,0,199885.714285714,2042.28571428571,98.1428571428571
"25785","77090","2019",1,1,0,174800,1258,139
"25786","77091","2019",7,7,0,315407.142857143,3120.57142857143,110
"25787","77094","2019",5,3,2,219500,2074.4,115.4
"25788","77095","2019",20,18,2,302102.5,3023.95,106.5
"25789","77096","2019",52,41,11,276134.038461538,3080.94230769231,94.8461538461538
"25790","77097","2019",5,5,0,184080,1763.4,110
"25791","77098","2019",9,9,0,188783.333333333,1884,105
"25792","77099","2019",36,35,1,132763.194444444,1517.22222222222,92.2222222222222
"25793","77100","2019",53,47,6,210144.58490566,2499.43396226415,87.8490566037736
"25794","77101","2019",16,16,0,154518.75,1727.75,91.875
"25795","77102","2019",1,1,0,125000,1488,84
"25796","77103","2019",4,4,0,255810,2024.25,136.75
"25797","77104","2019",6,5,1,256833.333333333,2487.33333333333,98.3333333333333
"25798","77106","2019",19,19,0,168615.789473684,1855.36842105263,90.6842105263158
"25799","77107","2019",55,41,14,205127.763636364,2536.61818181818,86.2909090909091
"25800","77108","2019",798,356,442,235400.718045113,3264.1992481203,74.5714285714286
"25801","77109","2019",20,20,0,175192.5,1859.6,100.4
"25802","77110","2019",3,3,0,156273.333333333,1337.33333333333,117.333333333333
"25803","77111","2019",94,32,62,315260.617021277,4036.20212765957,81.0744680851064
"25804","77112","2019",4,4,0,278062.5,1886.25,158.5
"25805","77113","2019",19,19,0,209639.842105263,2026.26315789474,109.789473684211
"25806","77114","2019",51,39,12,336878.725490196,3355.50980392157,97.3725490196078
"25807","77115","2019",7,7,0,168857.142857143,1475,120.428571428571
"25808","77116","2019",27,27,0,200936.888888889,2002.33333333333,106.37037037037
"25809","77117","2019",17,16,1,137480.235294118,1558.11764705882,95.1764705882353
"25810","77118","2019",185,104,81,270043.827027027,3555.15675675676,79.6540540540541
"25811","77119","2019",1,1,0,172000,2150,80
"25812","77120","2019",7,7,0,215357.142857143,2114.42857142857,102.285714285714
"25813","77121","2019",32,20,12,291207.71875,3564.34375,86.25
"25814","77122","2019",292,157,135,217264.654109589,2789.21575342466,79.5479452054795
"25815","77123","2019",6,6,0,308666.666666667,2828,117.333333333333
"25816","77124","2019",15,15,0,410626.666666667,3467,119.4
"25817","77125","2019",37,36,1,301612.837837838,2810.10810810811,112.297297297297
"25818","77126","2019",30,28,2,221996.766666667,2624.53333333333,91
"25819","77127","2019",27,19,8,243039.481481481,3208.51851851852,80.4814814814815
"25820","77128","2019",23,22,1,292991.391304348,3248.13043478261,93.6086956521739
"25821","77129","2019",7,7,0,168965.571428571,1483.14285714286,127.571428571429
"25822","77130","2019",7,7,0,229098.714285714,2496,109.285714285714
"25823","77131","2019",212,113,99,187573.702830189,2511.81603773585,78.688679245283
"25824","77132","2019",35,28,7,327004.428571429,3309.05714285714,100.771428571429
"25825","77133","2019",1,1,0,207000,1725,120
"25826","77134","2019",2,2,0,300525,1507,212
"25827","77135","2019",24,24,0,247151.666666667,2356.70833333333,110.416666666667
"25828","77136","2019",2,2,0,228500,2313,102
"25829","77137","2019",6,6,0,109833.333333333,1293,105.166666666667
"25830","77138","2019",16,13,3,238285.6875,2926.5,88.625
"25831","77139","2019",91,85,6,302148.21978022,3197.71428571429,98.6483516483516
"25832","77140","2019",3,3,0,219333.333333333,1920.33333333333,116
"25833","77141","2019",14,13,1,271771.428571429,2878.57142857143,97.7857142857143
"25834","77142","2019",74,56,18,259825.364864865,2913.13513513513,96.0675675675676
"25835","77143","2019",51,40,11,229613.529411765,2889.86274509804,83.3333333333333
"25836","77144","2019",5,5,0,323772.6,2901,113
"25837","77145","2019",4,4,0,261110,2276.75,115
"25838","77146","2019",35,31,4,314671.371428571,3651.37142857143,87.8285714285714
"25839","77147","2019",14,13,1,185878.571428571,2003.28571428571,97.4285714285714
"25840","77148","2019",31,28,3,156538.580645161,1795.64516129032,91.0645161290323
"25841","77150","2019",6,5,1,195583.333333333,2319.83333333333,90.3333333333333
"25842","77151","2019",4,4,0,332125,2222.75,141
"25843","77152","2019",215,97,118,176056.079069767,2474.40930232558,72.9906976744186
"25844","77153","2019",174,97,77,219242.948275862,3049.01724137931,76.7758620689655
"25845","77154","2019",19,18,1,231984.473684211,2379.26315789474,103.578947368421
"25846","77155","2019",41,33,8,291772.268292683,3094.09756097561,99.6585365853659
"25847","77156","2019",6,6,0,195707.166666667,2169.5,94
"25848","77157","2019",4,4,0,187875,1858.75,102
"25849","77158","2019",1,1,0,99000,660,150
"25850","77159","2019",27,22,5,139494.851851852,1579.33333333333,88.1481481481482
"25851","77161","2019",10,10,0,215644,1923.4,112.5
"25852","77162","2019",21,21,0,178190.904761905,1797,103.714285714286
"25853","77163","2019",6,5,1,164750,2472.16666666667,67.8333333333333
"25854","77164","2019",15,15,0,205852,1880.13333333333,118.6
"25855","77165","2019",12,12,0,246506.666666667,2179.16666666667,116.916666666667
"25856","77167","2019",1,1,0,165000,1650,100
"25857","77168","2019",21,20,1,166369.571428571,1494.2380952381,113.904761904762
"25858","77169","2019",113,43,70,261286.681415929,3311.82300884956,82.1592920353982
"25859","77171","2019",138,92,46,236133.47826087,3370.60144927536,75.5
"25860","77172","2019",11,11,0,181909.090909091,2093.81818181818,89.3636363636364
"25861","77173","2019",11,11,0,202081.818181818,2247.18181818182,88.6363636363636
"25862","77174","2019",16,16,0,149125,1546,98.9375
"25863","77175","2019",44,43,1,318176.113636364,3054.77272727273,110.272727272727
"25864","77176","2019",55,50,5,211681.181818182,2548.21818181818,86.2909090909091
"25865","77177","2019",19,18,1,266205.263157895,2893.26315789474,97.6842105263158
"25866","77178","2019",11,11,0,191890,1612.72727272727,137.636363636364
"25867","77179","2019",15,15,0,296796.733333333,2901.06666666667,105.533333333333
"25868","77180","2019",8,8,0,446750,2993,155.5
"25869","77181","2019",49,29,20,322976.734693878,3931.97959183673,85.5714285714286
"25870","77182","2019",60,37,23,124741.116666667,1626.01666666667,76.8166666666667
"25871","77183","2019",145,84,61,156573.268965517,2215.6275862069,74.4275862068965
"25872","77184","2019",6,6,0,194336.666666667,1690.33333333333,115.333333333333
"25873","77185","2019",9,8,1,257966.666666667,3263,87.7777777777778
"25874","77186","2019",342,59,283,274855.046783626,3778.30409356725,71.5584795321637
"25875","77187","2019",8,8,0,129362.5,1260.25,102.25
"25876","77188","2019",21,18,3,309182.952380952,2880.85714285714,115.809523809524
"25877","77190","2019",5,5,0,161400,1743,97.6
"25878","77191","2019",8,8,0,234702.5,2220.875,109.375
"25879","77192","2019",78,50,28,226598.461538462,2702.76923076923,88.8974358974359
"25880","77193","2019",11,11,0,225681.818181818,2232.09090909091,101.090909090909
"25881","77194","2019",6,6,0,168166.666666667,2030.16666666667,84.6666666666667
"25882","77195","2019",6,6,0,280516.666666667,2797.16666666667,105.666666666667
"25883","77196","2019",20,17,3,274380.95,2867.3,99.8
"25884","77197","2019",3,3,0,178666.666666667,2422.33333333333,80
"25885","77198","2019",5,5,0,136210,1447,100.2
"25886","77199","2019",23,23,0,230958,2420.17391304348,100.695652173913
"25887","77200","2019",2,2,0,151500,1667,89.5
"25888","77201","2019",16,13,3,163458.0625,2083.625,82.8125
"25889","77202","2019",15,14,1,229365.333333333,2503.13333333333,106.733333333333
"25890","77203","2019",22,22,0,365668.181818182,2723.54545454545,141.181818181818
"25891","77204","2019",3,3,0,186166.666666667,1444.33333333333,129
"25892","77205","2019",1,1,0,285000,1887,151
"25893","77206","2019",1,1,0,120000,2791,43
"25894","77207","2019",4,4,0,163875,1608.5,115
"25895","77208","2019",11,11,0,110400,1353.45454545455,84.2727272727273
"25896","77209","2019",12,9,3,340794.333333333,3617,102.666666666667
"25897","77210","2019",37,37,0,191980.27027027,1955.45945945946,100.648648648649
"25898","77211","2019",12,12,0,162975,2028.33333333333,80.6666666666667
"25899","77212","2019",4,4,0,250750,1754.75,155.75
"25900","77214","2019",7,6,1,289968.285714286,2615.14285714286,124
"25901","77215","2019",98,64,34,266177.653061224,3452.79591836735,81.3367346938775
"25902","77216","2019",23,23,0,200794.565217391,2262.47826086957,91.695652173913
"25903","77217","2019",41,30,11,280650.853658537,2951.17073170732,100.439024390244
"25904","77218","2019",3,3,0,116333.333333333,1128.66666666667,108.333333333333
"25905","77219","2019",59,59,0,226014.93220339,2534.83050847458,94.271186440678
"25906","77220","2019",7,7,0,183207.142857143,1503.57142857143,122.857142857143
"25907","77221","2019",19,17,2,439323.684210526,4099.47368421053,116.631578947368
"25908","77222","2019",83,46,37,202503.915662651,2828.46987951807,74.0963855421687
"25909","77223","2019",13,13,0,170094.230769231,1405.53846153846,126.230769230769
"25910","77224","2019",2,2,0,213750,2109,133.5
"25911","77225","2019",5,5,0,310800,2118.6,144.8
"25912","77226","2019",45,40,5,255846.222222222,2884.42222222222,96.1111111111111
"25913","77227","2019",7,7,0,149094.285714286,1424.71428571429,108.142857142857
"25914","77228","2019",2,2,0,181500,1915,94
"25915","77229","2019",15,15,0,243366.666666667,2338.13333333333,111.666666666667
"25916","77230","2019",3,3,0,232333.333333333,1778.33333333333,138.333333333333
"25917","77231","2019",7,7,0,209357.142857143,2354.42857142857,107.285714285714
"25918","77232","2019",21,17,4,266085.238095238,3063.14285714286,95.0952380952381
"25919","77233","2019",8,8,0,276812.5,2893.875,100.375
"25920","77234","2019",7,7,0,323600,3189.85714285714,114.857142857143
"25921","77235","2019",5,5,0,213560,2225.4,99.4
"25922","77236","2019",1,1,0,119000,1630,73
"25923","77237","2019",4,4,0,432650,4226.75,91.75
"25924","77238","2019",41,39,2,174920.731707317,2020.14634146341,92.2439024390244
"25925","77239","2019",27,25,2,188801.333333333,2179.25925925926,90.8148148148148
"25926","77240","2019",33,31,2,165519.818181818,1956.15151515152,93.0909090909091
"25927","77241","2019",20,19,1,269196,2656.25,104.8
"25928","77242","2019",6,6,0,178270,1846.5,100.166666666667
"25929","77243","2019",302,104,198,243948.599337748,3658.64238410596,69.8311258278146
"25930","77244","2019",11,11,0,228820.636363636,2143.63636363636,118.818181818182
"25931","77245","2019",7,7,0,159714.285714286,1593.28571428571,110.571428571429
"25932","77246","2019",4,4,0,148362.5,1617.75,92.5
"25933","77247","2019",10,10,0,198470,1706.4,125.3
"25934","77248","2019",9,9,0,270995,2817,97
"25935","77249","2019",111,106,5,366466.63963964,3306.37837837838,112.468468468468
"25936","77250","2019",3,3,0,289383.333333333,2515.33333333333,128
"25937","77251","2019",181,71,110,201453.38121547,2967.86740331492,69.646408839779
"25938","77252","2019",6,6,0,359583.333333333,3162.5,116.333333333333
"25939","77253","2019",4,4,0,286400,3744.75,78.25
"25940","77254","2019",15,13,2,310726.666666667,2857.13333333333,115.6
"25941","77255","2019",20,20,0,267717.35,2816,96.25
"25942","77257","2019",43,30,13,144378.837209302,1883.72093023256,84.2093023255814
"25943","77258","2019",156,15,141,192195.019230769,3150.50641025641,63.6730769230769
"25944","77259","2019",30,19,11,230700,3116.43333333333,76.4
"25945","77260","2019",17,16,1,143264.705882353,1701.64705882353,87.2352941176471
"25946","77261","2019",20,18,2,171650,1690.15,101.6
"25947","77262","2019",9,9,0,180000,1404.22222222222,140.222222222222
"25948","77264","2019",24,24,0,281279.166666667,2085.25,151.375
"25949","77265","2019",19,10,9,136078.947368421,1715.73684210526,83.1052631578947
"25950","77266","2019",11,11,0,229450,2154.54545454545,117.545454545455
"25951","77267","2019",5,5,0,198200,1751.6,123
"25952","77268","2019",129,54,75,321892.302325581,3977.92248062016,83.2093023255814
"25953","77269","2019",21,19,2,255766.666666667,2854,98.2380952380952
"25954","77270","2019",15,14,1,258353.333333333,3254.46666666667,95.6
"25955","77271","2019",1,1,0,250000,3086,81
"25956","77272","2019",10,10,0,175500,2014.1,90.1
"25957","77273","2019",7,7,0,241714.285714286,2782.57142857143,87.1428571428571
"25958","77274","2019",14,9,5,211417.857142857,2698,79.2142857142857
"25959","77275","2019",3,3,0,161000,1343.66666666667,126.333333333333
"25960","77276","2019",25,21,4,291786.8,2857.8,111.28
"25961","77277","2019",20,14,6,264419,2764.75,98.8
"25962","77278","2019",6,6,0,188165,1417.16666666667,132
"25963","77279","2019",19,18,1,183868.421052632,2136.52631578947,88.7894736842105
"25964","77280","2019",13,10,3,176442.307692308,2106.53846153846,84.0769230769231
"25965","77281","2019",10,10,0,217010,1986.2,113
"25966","77282","2019",3,3,0,206666.666666667,3454,60.6666666666667
"25967","77283","2019",14,14,0,155846.428571429,1799.92857142857,87.9285714285714
"25968","77284","2019",690,177,513,182214.630434783,2799.45507246377,68.4927536231884
"25969","77285","2019",219,89,130,155545.867579909,1974.35616438356,79.5753424657534
"25970","77286","2019",3,3,0,162833.333333333,1737.33333333333,97
"25971","77287","2019",9,8,1,151583.222222222,1381.88888888889,113.111111111111
"25972","77288","2019",559,101,458,147367.373881932,2660.84436493739,58.6118067978533
"25973","77289","2019",10,10,0,146670,1515,111.1
"25974","77290","2019",16,16,0,172563.125,1934.625,101.125
"25975","77291","2019",7,7,0,563314.285714286,3471.57142857143,130.857142857143
"25976","77292","2019",17,11,6,252194.117647059,3039.94117647059,88.8823529411765
"25977","77293","2019",25,25,0,220576.8,2348.16,107.4
"25978","77294","2019",206,153,53,234915.684466019,3167.06796116505,78.6844660194175
"25979","77295","2019",13,13,0,309223.076923077,2833.76923076923,110.461538461538
"25980","77296","2019",232,109,123,201260.426724138,2748.93534482759,75.1853448275862
"25981","77297","2019",2,2,0,125000,1515.5,82.5
"25982","77298","2019",6,6,0,220500,1617.33333333333,137.666666666667
"25983","77300","2019",13,13,0,265615.384615385,2450.30769230769,110.230769230769
"25984","77301","2019",4,4,0,97500,982.5,113
"25985","77302","2019",20,18,2,195735,1913.55,107.05
"25986","77303","2019",2,2,0,142950,1316.5,113.5
"25987","77304","2019",1,1,0,330000,2426,136
"25988","77305","2019",182,60,122,126965.818681319,1925.77472527473,66.6318681318681
"25989","77306","2019",7,7,0,287500,2438,126.428571428571
"25990","77307","2019",279,59,220,245116.186379928,4088.91756272401,61.3082437275986
"25991","77308","2019",13,12,1,243615.384615385,2448.76923076923,103.153846153846
"25992","77309","2019",21,20,1,254680.952380952,2604.71428571429,100.571428571429
"25993","77310","2019",5,5,0,144374.8,1363.6,112.6
"25994","77311","2019",16,16,0,145700,1642.3125,97.5
"25995","77312","2019",58,51,7,261489.431034483,2705.27586206897,102.103448275862
"25996","77313","2019",3,3,0,287000,1987.33333333333,146
"25997","77314","2019",9,9,0,143906.333333333,1243.33333333333,116.333333333333
"25998","77315","2019",76,64,12,264161.513157895,3490.48684210526,79.8157894736842
"25999","77316","2019",225,178,47,211682.422222222,2614.80888888889,86.8311111111111
"26000","77317","2019",63,47,16,206668.777777778,2558.28571428571,82.6825396825397
"26001","77318","2019",28,22,6,219089.285714286,2366.57142857143,102.75
"26002","77319","2019",4,4,0,156475,1753.25,91
"26003","77320","2019",89,84,5,206871.04494382,2428.2808988764,89.2584269662921
"26004","77321","2019",9,8,1,137944.444444444,1182.33333333333,115.222222222222
"26005","77322","2019",31,29,2,282332.870967742,3150.32258064516,93.7096774193548
"26006","77323","2019",26,16,10,209971.923076923,2810.07692307692,79.0769230769231
"26007","77325","2019",8,8,0,139750,1829.125,81.375
"26008","77326","2019",64,44,20,231187.328125,2509.78125,94.796875
"26009","77327","2019",79,64,15,175912.797468354,2099.37974683544,89.2911392405063
"26010","77328","2019",5,5,0,206720,1905.4,114.2
"26011","77329","2019",11,11,0,222390.909090909,1501.36363636364,152.363636363636
"26012","77330","2019",96,69,27,217407.916666667,2707.05208333333,84.65625
"26013","77331","2019",6,5,1,145666.666666667,1575.83333333333,94
"26014","77332","2019",5,4,1,275400,2449.2,118
"26015","77333","2019",139,104,35,162110.417266187,1983.03597122302,87
"26016","77335","2019",32,30,2,272072.5,3147.96875,90.65625
"26017","77336","2019",17,13,4,305288.823529412,3077.88235294118,103.941176470588
"26018","77337","2019",144,51,93,230788.826388889,2983.59027777778,78.9513888888889
"26019","77338","2019",5,5,0,167800,1799.4,92.8
"26020","77339","2019",43,35,8,286971.720930233,2633.67441860465,123.627906976744
"26021","77340","2019",7,7,0,170250,1870.42857142857,102.285714285714
"26022","77341","2019",5,5,0,160200,1425.4,110.6
"26023","77342","2019",1,1,0,259300,1330,195
"26024","77343","2019",7,7,0,193285.714285714,1782,122.571428571429
"26025","77344","2019",35,31,4,274454.314285714,2721.45714285714,106.771428571429
"26026","77345","2019",10,10,0,157700,1459.2,108.8
"26027","77347","2019",15,15,0,135966.666666667,1562.8,89.6666666666667
"26028","77348","2019",5,5,0,253829.4,1824.8,133.6
"26029","77349","2019",102,87,15,246892.019607843,2700.02941176471,95.2254901960784
"26030","77350","2019",283,193,90,301939.643109541,3526.3074204947,89.3992932862191
"26031","77352","2019",25,23,2,260779.16,2511.88,109.4
"26032","77353","2019",8,8,0,215437.5,1910.5,125.75
"26033","77354","2019",9,9,0,208555.555555556,3202.11111111111,72.3333333333333
"26034","77355","2019",4,4,0,137758.75,1479.75,98.5
"26035","77357","2019",14,13,1,187294.642857143,2027.64285714286,99.0714285714286
"26036","77358","2019",12,9,3,228450,2446,93.5833333333333
"26037","77359","2019",15,15,0,301612.866666667,2656.4,115.933333333333
"26038","77360","2019",4,4,0,225500,1859.75,125
"26039","77361","2019",11,11,0,235798,2165.18181818182,118.181818181818
"26040","77363","2019",23,13,10,272304.565217391,3266.86956521739,84.5652173913043
"26041","77364","2019",1,1,0,2e+05,2222,90
"26042","77365","2019",11,11,0,267036.272727273,2475.54545454545,109.181818181818
"26043","77366","2019",4,4,0,228225,3144.5,74
"26044","77367","2019",6,6,0,187666.666666667,1441.66666666667,152
"26045","77368","2019",3,3,0,105036.666666667,1256.33333333333,79
"26046","77369","2019",6,6,0,224866.666666667,2879,78.8333333333333
"26047","77370","2019",12,12,0,160017.5,1763.16666666667,93.0833333333333
"26048","77371","2019",49,47,2,233123.673469388,2735.34693877551,91.3673469387755
"26049","77372","2019",67,29,38,328583.014925373,3711.64179104478,90.134328358209
"26050","77373","2019",492,241,251,253218.955284553,3670.36585365854,72.1219512195122
"26051","77374","2019",49,36,13,281763.163265306,3354.42857142857,87.3673469387755
"26052","77376","2019",11,10,1,274054.545454545,2977.54545454545,97.0909090909091
"26053","77377","2019",29,23,6,270983.793103448,3164.51724137931,89.3103448275862
"26054","77378","2019",46,23,23,235055.47826087,2776.97826086957,91.5869565217391
"26055","77379","2019",124,63,61,174101.088709677,2243.88709677419,82.5
"26056","77380","2019",2,2,0,250500,1740,162
"26057","77381","2019",10,10,0,188288.8,1520.3,123.6
"26058","77382","2019",100,87,13,272928.01,2980.29,96.61
"26059","77383","2019",20,19,1,167950.6,1811.95,99.65
"26060","77384","2019",20,20,0,252621,3223.55,84.7
"26061","77385","2019",29,26,3,177227.24137931,1809.93103448276,102.689655172414
"26062","77386","2019",6,6,0,313659.166666667,2145.83333333333,140
"26063","77387","2019",2,2,0,220900,1701,138
"26064","77388","2019",11,11,0,180131.818181818,2357.36363636364,76.6363636363636
"26065","77389","2019",48,28,20,268116.041666667,2754.02083333333,97.125
"26066","77390","2019",237,125,112,231419.932489451,3101.23628691983,77.2784810126582
"26067","77391","2019",6,6,0,152816.666666667,1699.83333333333,88.3333333333333
"26068","77392","2019",10,10,0,297980,3017.3,101.7
"26069","77393","2019",50,46,4,249908.96,2831.72,93.76
"26070","77394","2019",30,30,0,301831.433333333,2497.16666666667,123.533333333333
"26071","77395","2019",1,1,0,149500,1024,146
"26072","77396","2019",2,2,0,168470,1688.5,101
"26073","77397","2019",34,33,1,168591.176470588,1978.73529411765,87.8235294117647
"26074","77398","2019",13,13,0,143500,1805.92307692308,87.6153846153846
"26075","77400","2019",43,42,1,253098.139534884,2666.39534883721,103.395348837209
"26076","77401","2019",9,9,0,163000,1905.22222222222,85.5555555555556
"26077","77402","2019",4,4,0,164750,1509,115
"26078","77403","2019",10,10,0,173266,1779.5,100.1
"26079","77404","2019",16,16,0,163107.5,1742.8125,95.75
"26080","77405","2019",26,26,0,170267.538461538,1890.38461538462,93.5
"26081","77406","2019",12,12,0,189028.916666667,1713.41666666667,118.083333333333
"26082","77407","2019",232,145,87,231659.797413793,2784.65948275862,87.5431034482759
"26083","77408","2019",5,5,0,269660,2386.8,114.6
"26084","77409","2019",20,20,0,196665,1907.15,105.5
"26085","77410","2019",6,5,1,226041.666666667,2950.5,83.1666666666667
"26086","77411","2019",14,14,0,202830.571428571,1876,112.571428571429
"26087","77412","2019",5,4,1,270061.2,2362.6,118.4
"26088","77413","2019",54,43,11,274446.962962963,3329.75925925926,88.9259259259259
"26089","77414","2019",8,8,0,178837.5,1591.25,112.125
"26090","77415","2019",15,15,0,209993.333333333,2270.33333333333,95.6666666666667
"26091","77416","2019",8,8,0,191750,1810.625,112.875
"26092","77418","2019",11,11,0,146932.272727273,1706.36363636364,89.8181818181818
"26093","77419","2019",42,39,3,189432.666666667,2441,79.4761904761905
"26094","77420","2019",59,47,12,245607.203389831,3146.01694915254,81.6271186440678
"26095","77421","2019",3,3,0,173966.666666667,1652.66666666667,112
"26096","77423","2019",13,13,0,126207.692307692,1547.46153846154,85.6923076923077
"26097","77424","2019",2,2,0,134250,1436.5,99
"26098","77425","2019",5,5,0,523514,3737,150.2
"26099","77426","2019",6,6,0,209908.333333333,1981.83333333333,109.166666666667
"26100","77427","2019",3,3,0,396516.666666667,3040.33333333333,142.333333333333
"26101","77428","2019",12,12,0,218275,2362.66666666667,95.0833333333333
"26102","77429","2019",13,13,0,213621.153846154,2066.92307692308,107.153846153846
"26103","77430","2019",86,82,4,273848.546511628,2751.10465116279,103.895348837209
"26104","77431","2019",81,76,5,207580.135802469,2041.61728395062,105.098765432099
"26105","77432","2019",14,14,0,189392.857142857,1877.28571428571,101.428571428571
"26106","77433","2019",33,33,0,221197.272727273,2067.57575757576,116.969696969697
"26107","77434","2019",11,11,0,131460.909090909,2087,65.6363636363636
"26108","77435","2019",9,9,0,349590,2763.55555555556,130.555555555556
"26109","77436","2019",21,20,1,192076.19047619,1823.2380952381,109
"26110","77437","2019",43,39,4,253379.046511628,2703.79069767442,96.0697674418605
"26111","77438","2019",69,43,26,287469.666666667,3374.59420289855,86.2028985507246
"26112","77439","2019",19,19,0,180387.105263158,1968.31578947368,96.9473684210526
"26113","77440","2019",15,15,0,186233.266666667,2133.2,91.6666666666667
"26114","77441","2019",33,28,5,340113.636363636,3108.87878787879,113.939393939394
"26115","77442","2019",30,29,1,285116.6,2797.3,103.166666666667
"26116","77443","2019",3,3,0,251666.666666667,2896.33333333333,91
"26117","77444","2019",7,7,0,159557.142857143,1683.42857142857,114.428571428571
"26118","77445","2019",310,166,144,206377.629032258,2491.7935483871,84.0032258064516
"26119","77446","2019",11,11,0,161318.181818182,1530.09090909091,111.181818181818
"26120","77447","2019",31,30,1,389871.935483871,3397.8064516129,125.935483870968
"26121","77448","2019",5,3,2,181352,2085.8,86.6
"26122","77449","2019",105,31,74,290583.80952381,4278.71428571429,68.8571428571429
"26123","77450","2019",49,41,8,353503.469387755,3415.12244897959,107.857142857143
"26124","77451","2019",12,12,0,214133.333333333,1920.08333333333,113
"26125","77453","2019",19,19,0,253209.210526316,2782,106.473684210526
"26126","77454","2019",3,3,0,183666.666666667,1592.33333333333,116.666666666667
"26127","77455","2019",54,43,11,251005.407407407,2994.31481481481,89.2222222222222
"26128","77456","2019",13,13,0,128768.461538462,1426.76923076923,95.5384615384615
"26129","77457","2019",19,15,4,268775.526315789,2854.21052631579,99.8421052631579
"26130","77458","2019",57,48,9,147159.929824561,1647.12280701754,95.4385964912281
"26131","77459","2019",29,29,0,141809.172413793,1603.13793103448,91.0689655172414
"26132","77460","2019",2,2,0,98000,1293,68.5
"26133","77461","2019",3,3,0,161210,1422,111
"26134","77462","2019",22,16,6,204427.272727273,2843.09090909091,76
"26135","77463","2019",69,62,7,276254.173913043,2935.44927536232,103.260869565217
"26136","77464","2019",147,83,64,263577.394557823,3456.47619047619,80.0408163265306
"26137","77465","2019",14,14,0,175825.714285714,2026.64285714286,93
"26138","77466","2019",5,5,0,240000,2468.2,99.2
"26139","77467","2019",1,1,0,120000,1143,105
"26140","77468","2019",270,61,209,215449.685185185,3056.31851851852,72.8
"26141","77469","2019",18,15,3,212723.111111111,2282.61111111111,95.2222222222222
"26142","77470","2019",115,52,63,220683.617391304,3914.9652173913,67.7304347826087
"26143","77471","2019",7,7,0,273571.428571429,1975.85714285714,144.428571428571
"26144","77472","2019",7,7,0,219428.571428571,1985,128.714285714286
"26145","77473","2019",4,4,0,232400,1643.5,141
"26146","77474","2019",16,13,3,228459.375,3332.25,78.8125
"26147","77475","2019",73,67,6,229396.575342466,2723.72602739726,88.1780821917808
"26148","77476","2019",2,2,0,156000,1595,105.5
"26149","77477","2019",10,9,1,211455,2492.3,94.7
"26150","77478","2019",16,13,3,189353.75,1805.125,105.4375
"26151","77479","2019",167,85,82,275093.976047904,3608.22754491018,78.814371257485
"26152","77480","2019",13,13,0,172826.923076923,1957.76923076923,94.6153846153846
"26153","77481","2019",4,4,0,244750,2065,121.5
"26154","77482","2019",37,31,6,193664.567567568,2188.67567567568,89.8648648648649
"26155","77483","2019",28,25,3,227764.285714286,2467.57142857143,98.8571428571429
"26156","77484","2019",2,2,0,383000,2187,175.5
"26157","77485","2019",14,14,0,267232.142857143,2627.21428571429,107.857142857143
"26158","77486","2019",10,10,0,210600,2220.1,103
"26159","77487","2019",140,88,52,241214.678571429,2569.20714285714,96.7642857142857
"26160","77489","2019",3,3,0,149333.333333333,1627.33333333333,93.3333333333333
"26161","77490","2019",9,9,0,154933.333333333,1528.77777777778,124.444444444444
"26162","77492","2019",17,17,0,136552.941176471,1459.52941176471,99.1176470588235
"26163","77493","2019",36,29,7,248938.194444444,2594.33333333333,100.222222222222
"26164","77494","2019",37,36,1,211005.405405405,2219.05405405405,101.081081081081
"26165","77495","2019",105,85,20,245518.104761905,2840.77142857143,87.4380952380952
"26166","77496","2019",8,8,0,201375,1764,114
"26167","77498","2019",6,6,0,308675,3378.83333333333,95.6666666666667
"26168","77500","2019",10,10,0,156025,1409.9,119
"26169","77501","2019",13,13,0,216478.846153846,2179.69230769231,105.923076923077
"26170","77504","2019",20,20,0,208390,1713.35,128.6
"26171","77505","2019",3,3,0,267533.333333333,1957.66666666667,136.333333333333
"26172","77506","2019",7,7,0,212785.714285714,2185.85714285714,95.5714285714286
"26173","77507","2019",6,6,0,131333.333333333,1473.16666666667,87.5
"26174","77508","2019",26,24,2,323438.730769231,3182.92307692308,108.076923076923
"26175","77509","2019",10,10,0,158430,1323.8,127.7
"26176","77510","2019",18,17,1,355478.777777778,3621.33333333333,101.611111111111
"26177","77511","2019",10,6,4,190600,2967.3,62.9
"26178","77512","2019",11,11,0,168733.636363636,1412.81818181818,122.727272727273
"26179","77513","2019",88,51,37,214380.147727273,2989.04545454545,74.1136363636364
"26180","77514","2019",397,195,202,212936.176322418,3178.8161209068,70.375314861461
"26181","77515","2019",12,12,0,286750,2993.33333333333,97.4166666666667
"26182","77516","2019",15,13,2,220208.666666667,1966.66666666667,118.466666666667
"26183","77517","2019",20,18,2,275049.5,3238.55,96.3
"26184","77518","2019",1,1,0,409000,2764,148
"26185","77519","2019",13,13,0,140538.461538462,1467.15384615385,105.923076923077
"26186","77520","2019",13,13,0,252995,2116.92307692308,120.769230769231
"26187","77521","2019",44,39,5,240849.704545455,2842.47727272727,91.5454545454545
"26188","77522","2019",5,5,0,115512,1212.4,97.4
"26189","77523","2019",5,5,0,157600,1225.8,127.4
"26190","77524","2019",8,8,0,141956.25,1496.5,91.625
"26191","77525","2019",5,5,0,234690,2109.2,120
"26192","77526","2019",1,1,0,218000,2595,84
"26193","77527","2019",8,8,0,267500,2139.375,142.625
"26194","77528","2019",12,11,1,246575,2550.75,98.5
"26195","77529","2019",26,26,0,276155.923076923,2789.07692307692,107.653846153846
"26196","77530","2019",5,5,0,234720,1417.4,167
"26197","77531","2019",27,26,1,154640.740740741,1828.07407407407,91.3333333333333
"26198","77533","2019",36,36,0,286663.055555556,2934.08333333333,101.611111111111
"26199","77534","2019",14,14,0,306819.285714286,2819,118.214285714286
"26200","78003","2019",39,36,3,223917.435897436,2338.71794871795,100
"26201","78005","2019",209,77,132,249501.368421053,3461.58851674641,72.9904306220096
"26202","78006","2019",10,10,0,420024,2971.5,146.7
"26203","78007","2019",9,9,0,687580.111111111,4243.66666666667,165.333333333333
"26204","78009","2019",3,3,0,180033.333333333,2138,91.3333333333333
"26205","78010","2019",9,8,1,421356,4275.66666666667,100.888888888889
"26206","78013","2019",5,5,0,360190,2881.4,134.8
"26207","78015","2019",256,101,155,268768.515625,3266.98046875,83.78515625
"26208","78020","2019",11,11,0,309440.909090909,2523.63636363636,123.545454545455
"26209","78029","2019",156,75,81,194698.019230769,2601.92307692308,75.8076923076923
"26210","78030","2019",2,1,1,207250,2948,80
"26211","78031","2019",12,12,0,292907.5,2552.08333333333,123.333333333333
"26212","78033","2019",24,21,3,247875.416666667,2727.79166666667,96.625
"26213","78034","2019",12,12,0,320892,2847.41666666667,114.5
"26214","78036","2019",3,3,0,384600,2527.66666666667,153
"26215","78043","2019",51,18,33,424762.098039216,4192.1568627451,101.901960784314
"26216","78048","2019",18,16,2,313394.444444444,2981.27777777778,105.944444444444
"26217","78049","2019",30,27,3,344549,2913.66666666667,122.066666666667
"26218","78050","2019",8,8,0,433705.625,3361,135.625
"26219","78053","2019",7,7,0,373157.142857143,3002.14285714286,130.142857142857
"26220","78057","2019",24,23,1,180787.5,2316.625,88.5
"26221","78062","2019",87,58,29,260708.344827586,3073.85057471264,84.4827586206897
"26222","78068","2019",13,13,0,240546.153846154,2150.92307692308,132
"26223","78070","2019",4,4,0,219135,2132.25,115.25
"26224","78071","2019",11,11,0,209257.272727273,2377.27272727273,95.2727272727273
"26225","78072","2019",6,6,0,252250,2470.66666666667,103.166666666667
"26226","78073","2019",282,66,216,242835.925531915,3443.06028368794,70.4609929078014
"26227","78076","2019",5,5,0,277583.8,2764,97.4
"26228","78077","2019",8,8,0,257750,2147.75,128.75
"26229","78082","2019",4,3,1,295375,2497.25,113
"26230","78084","2019",12,12,0,296851.666666667,3379.5,89.4166666666667
"26231","78087","2019",30,23,7,259633.866666667,2966.4,90.6666666666667
"26232","78089","2019",48,38,10,191207.708333333,2482.41666666667,83.7916666666667
"26233","78090","2019",43,35,8,304252.325581395,3614.04651162791,91
"26234","78092","2019",139,45,94,448766.503597122,4820.53237410072,91.410071942446
"26235","78096","2019",3,3,0,519166.666666667,3215.33333333333,168.333333333333
"26236","78104","2019",10,9,1,275080,2415.9,120.8
"26237","78107","2019",32,32,0,285626.875,2489.5625,113.375
"26238","78108","2019",14,13,1,361504.071428571,3099.28571428571,117.428571428571
"26239","78113","2019",7,7,0,216423,2279.28571428571,97.2857142857143
"26240","78117","2019",70,27,43,442740.4,4872.72857142857,93.6428571428571
"26241","78118","2019",22,20,2,247253.636363636,2882.22727272727,89.5
"26242","78120","2019",27,24,3,311790.555555556,3130.18518518519,103.777777777778
"26243","78123","2019",252,97,155,225556.936507937,3310.96825396825,70.7857142857143
"26244","78124","2019",182,86,96,421100.318681319,4909.13186813187,85.510989010989
"26245","78125","2019",12,12,0,431472.5,2751.08333333333,159.833333333333
"26246","78126","2019",253,61,192,407111.015810277,4349.71146245059,88.9920948616601
"26247","78128","2019",21,19,2,349747.619047619,3388.61904761905,111.714285714286
"26248","78133","2019",90,38,52,469503.166666667,4047.1,113.055555555556
"26249","78138","2019",108,72,36,231935.240740741,2855.44444444444,83.3518518518518
"26250","78140","2019",25,25,0,364993.6,3110.64,125.32
"26251","78143","2019",32,21,11,417619.65625,3939.9375,105.03125
"26252","78146","2019",521,166,355,446362.913627639,5269.56813819578,81.5143953934741
"26253","78147","2019",3,3,0,183000,2158,86.3333333333333
"26254","78152","2019",23,21,2,592995,4412.5652173913,147.304347826087
"26255","78158","2019",283,62,221,491588.823321555,5615.55477031802,84.6113074204947
"26256","78160","2019",78,48,30,361132.448717949,3705.89743589744,103.833333333333
"26257","78162","2019",4,4,0,405500,3550,146
"26258","78163","2019",6,6,0,349933.333333333,2384.83333333333,162.333333333333
"26259","78164","2019",11,8,3,397975,3148.18181818182,116.818181818182
"26260","78165","2019",243,89,154,243477.205761317,3111.18106995885,78.9917695473251
"26261","78168","2019",32,21,11,304592.90625,3535.125,86.65625
"26262","78171","2019",1,1,0,182000,2600,70
"26263","78172","2019",568,294,274,263832.121478873,3525.68485915493,77.3028169014084
"26264","78185","2019",7,7,0,268414.285714286,2794.85714285714,101.571428571429
"26265","78188","2019",5,4,1,299900,1913.8,164.2
"26266","78189","2019",34,34,0,530987.529411765,3861.11764705882,144.088235294118
"26267","78190","2019",144,62,82,634615.986111111,6034.46527777778,101.645833333333
"26268","78192","2019",26,23,3,235018.384615385,2462.53846153846,105.153846153846
"26269","78193","2019",12,9,3,408919.166666667,3516.91666666667,126.166666666667
"26270","78194","2019",4,4,0,282275,2896.5,98.75
"26271","78196","2019",6,5,1,552749.5,3221.5,168.166666666667
"26272","78202","2019",9,9,0,279438.888888889,2417,121.888888888889
"26273","78206","2019",64,39,25,254218.4375,3056.828125,83.109375
"26274","78208","2019",475,155,320,221118.764210526,2895.19789473684,78.0063157894737
"26275","78209","2019",10,10,0,229588.7,2983.6,85.4
"26276","78217","2019",103,91,12,264558.233009709,2839.70873786408,96.0582524271845
"26277","78220","2019",108,82,26,303734.416666667,3078.12962962963,103.092592592593
"26278","78224","2019",73,47,26,552991.684931507,4873.21917808219,115.27397260274
"26279","78227","2019",12,10,2,235166.666666667,2693.25,88.6666666666667
"26280","78230","2019",10,8,2,221968.4,2635.3,87.6
"26281","78231","2019",2,2,0,415690,1567.5,266.5
"26282","78233","2019",30,29,1,626964.666666667,3977.7,160.6
"26283","78234","2019",2,2,0,172100,1627,107
"26284","78236","2019",5,5,0,434504.4,3734.6,121.8
"26285","78237","2019",3,3,0,297063.333333333,2652.33333333333,111.333333333333
"26286","78238","2019",38,33,5,257805,3094.39473684211,84.3947368421053
"26287","78239","2019",29,28,1,222490.75862069,2470.34482758621,96.5172413793103
"26288","78242","2019",161,45,116,247853.055900621,3348.74534161491,74.111801242236
"26289","78245","2019",6,6,0,349500,2348.66666666667,151
"26290","78246","2019",9,9,0,238150,2261.33333333333,108.666666666667
"26291","78255","2019",31,31,0,200910.322580645,2150.83870967742,98.3870967741936
"26292","78261","2019",7,7,0,310588.571428571,3264.57142857143,104.714285714286
"26293","78262","2019",16,16,0,389305.75,3823.5625,108.125
"26294","78263","2019",36,35,1,373917.777777778,3230.72222222222,123.611111111111
"26295","78264","2019",1,1,0,317500,1260,252
"26296","78265","2019",48,43,5,336159.541666667,3254.875,109.208333333333
"26297","78267","2019",107,89,18,231180.476635514,2679.42990654206,90.7383177570093
"26298","78269","2019",14,12,2,335414.285714286,3098.57142857143,117.571428571429
"26299","78276","2019",13,13,0,195538.461538462,2134.38461538462,94.6153846153846
"26300","78278","2019",4,4,0,308750,2245.25,140
"26301","78281","2019",9,8,1,239222.222222222,2450.66666666667,97.5555555555556
"26302","78283","2019",4,4,0,285212.5,2745.5,107.25
"26303","78285","2019",8,8,0,402001.25,2664.75,153.25
"26304","78289","2019",29,23,6,636072.931034483,4046.41379310345,155.034482758621
"26305","78290","2019",21,21,0,196829.047619048,2278.57142857143,87.9047619047619
"26306","78291","2019",27,26,1,267830.111111111,2687.51851851852,104.037037037037
"26307","78296","2019",10,10,0,314750,2451.3,129.7
"26308","78297","2019",278,82,196,307289.294964029,3778.3309352518,81.3201438848921
"26309","78299","2019",34,31,3,273851.352941176,2882.94117647059,100.617647058824
"26310","78300","2019",6,5,1,245000,2424,108.333333333333
"26311","78302","2019",2,2,0,591000,2648.5,223
"26312","78305","2019",6,6,0,421650,3466.66666666667,124.333333333333
"26313","78307","2019",22,22,0,298479.590909091,2372.04545454545,130.954545454545
"26314","78310","2019",61,28,33,209536.131147541,2841.24590163934,74.7868852459016
"26315","78311","2019",536,274,262,357021.78358209,5027.8078358209,73.1082089552239
"26316","78314","2019",63,53,10,220120.587301587,2427.46031746032,92.8095238095238
"26317","78317","2019",13,13,0,245313.846153846,2466.84615384615,106.615384615385
"26318","78320","2019",7,7,0,188728.571428571,1852.42857142857,105.857142857143
"26319","78321","2019",1,1,0,175000,2215,79
"26320","78322","2019",86,40,46,407328.081395349,4647.81395348837,86.7790697674419
"26321","78324","2019",9,8,1,248405.555555556,2191.77777777778,120.444444444444
"26322","78325","2019",6,6,0,238519,2411.5,92.3333333333333
"26323","78327","2019",62,54,8,265038.225806452,3051.79032258065,92.5967741935484
"26324","78329","2019",14,14,0,218264.285714286,2016.21428571429,113.928571428571
"26325","78334","2019",24,23,1,369048.041666667,3127.04166666667,121.875
"26326","78335","2019",169,115,54,180401.781065089,2218.79881656805,83.8224852071006
"26327","78337","2019",22,22,0,193863.636363636,2076.40909090909,99.3181818181818
"26328","78343","2019",18,12,6,587678.333333333,5278.16666666667,108.722222222222
"26329","78344","2019",13,13,0,232768.461538462,2613.76923076923,97.6153846153846
"26330","78346","2019",28,27,1,235871.428571429,2194.89285714286,112
"26331","78349","2019",5,5,0,245840,2447.6,102
"26332","78350","2019",93,23,70,489054.021505376,4557.63440860215,106.096774193548
"26333","78354","2019",57,52,5,238481,2663.63157894737,92.9473684210526
"26334","78356","2019",119,80,39,310333.672268908,3308.76470588235,94.8067226890756
"26335","78358","2019",429,111,318,486897.237762238,5650.18181818182,83.7226107226107
"26336","78361","2019",398,117,281,161016.625628141,2535.79396984925,65.5552763819096
"26337","78362","2019",221,146,75,183834.009049774,2360.09049773756,81.0497737556561
"26338","78364","2019",15,14,1,321173.333333333,3014.26666666667,119.733333333333
"26339","78366","2019",5,5,0,354446,2373.6,152.4
"26340","78367","2019",55,35,20,534075.781818182,4577.41818181818,120.018181818182
"26341","78368","2019",19,17,2,378098.473684211,2963.84210526316,131.789473684211
"26342","78372","2019",315,55,260,337099.219047619,4081.73333333333,79.4444444444444
"26343","78380","2019",84,72,12,312630,3218.40476190476,101.119047619048
"26344","78381","2019",15,14,1,330947.266666667,3325.66666666667,105.333333333333
"26345","78382","2019",66,51,15,330660.984848485,3687.83333333333,93.2424242424242
"26346","78383","2019",279,117,162,231528.129032258,2909.6523297491,81.4838709677419
"26347","78384","2019",15,14,1,370526,4023.13333333333,98.4
"26348","78385","2019",3,3,0,286333.333333333,2147.33333333333,140.666666666667
"26349","78389","2019",16,15,1,459780.625,3497.5625,137
"26350","78391","2019",7,7,0,204857.142857143,2535.85714285714,84
"26351","78396","2019",83,48,35,531469.722891566,4995.20481927711,104.192771084337
"26352","78397","2019",106,77,29,332866.811320755,3587.3679245283,98.7452830188679
"26353","78398","2019",15,15,0,529459.933333333,3474.2,156.933333333333
"26354","78401","2019",160,52,108,157425.34375,2455.9625,67.25
"26355","78402","2019",52,40,12,259675.673076923,2808.01923076923,95.3269230769231
"26356","78403","2019",30,30,0,283957,2857.46666666667,111
"26357","78406","2019",2,2,0,885000,4864,175
"26358","78407","2019",14,14,0,270269.357142857,2228.42857142857,134.428571428571
"26359","78410","2019",16,16,0,186656.875,2032.375,102.75
"26360","78413","2019",4,4,0,225800,2211.5,102.5
"26361","78415","2019",10,10,0,302000,2824.5,125
"26362","78416","2019",3,3,0,291266.666666667,3052,99.3333333333333
"26363","78417","2019",4,3,1,283325,2658.75,112.5
"26364","78418","2019",219,107,112,401406.200913242,4558.09589041096,88.0228310502283
"26365","78420","2019",47,36,11,586152.319148936,4092.74468085106,138.31914893617
"26366","78423","2019",462,140,322,306979.019480519,3789.06277056277,80.8181818181818
"26367","78431","2019",36,33,3,413075.222222222,3281.13888888889,130.444444444444
"26368","78437","2019",16,16,0,190875,2726.25,76.3125
"26369","78439","2019",2,2,0,422150,2345,183
"26370","78440","2019",236,111,125,155675.008474576,2127.90254237288,74.2584745762712
"26371","78442","2019",29,13,16,282191.620689655,3297.96551724138,88.448275862069
"26372","78443","2019",12,11,1,365592.5,3461.25,106.25
"26373","78444","2019",10,10,0,223700,2186.7,103.7
"26374","78451","2019",21,18,3,234839.523809524,2509.95238095238,98.6190476190476
"26375","78455","2019",80,48,32,511640.8875,4697.1625,112.4375
"26376","78460","2019",12,11,1,231181.666666667,2513.83333333333,90.75
"26377","78464","2019",15,15,0,269687.333333333,2511.2,111.866666666667
"26378","78465","2019",32,29,3,287301.03125,2763.46875,109.125
"26379","78466","2019",105,90,15,510573.619047619,4136.02857142857,126.390476190476
"26380","78470","2019",11,10,1,254495.454545455,2170.81818181818,125.636363636364
"26381","78472","2019",2,2,0,229650,2303.5,100
"26382","78474","2019",27,24,3,234266.296296296,2852.62962962963,88.3333333333333
"26383","78475","2019",8,8,0,280197.5,2327.25,123.5
"26384","78481","2019",269,55,214,350413.405204461,4546.57249070632,75.4684014869889
"26385","78484","2019",9,9,0,323544.444444444,2896,113.111111111111
"26386","78486","2019",114,80,34,288122.5,3259.0701754386,94.1140350877193
"26387","78490","2019",483,179,304,236500.422360248,3029.7701863354,79.7142857142857
"26388","78497","2019",14,14,0,510852.857142857,3288.78571428571,161.428571428571
"26389","78498","2019",475,110,365,252267.578947368,3751.87578947368,67.5157894736842
"26390","78499","2019",5,5,0,317732,2707,120.4
"26391","78501","2019",32,31,1,227581.15625,2487.09375,93.3125
"26392","78502","2019",72,11,61,273831.111111111,4213.5,64.4583333333333
"26393","78505","2019",4,4,0,310175,2967.75,108.5
"26394","78506","2019",3,3,0,329575,2382,139
"26395","78513","2019",30,18,12,263436,3612.06666666667,77.2333333333333
"26396","78516","2019",22,22,0,338109.090909091,2522.54545454545,136.227272727273
"26397","78517","2019",460,161,299,260720.569565217,3522.12391304348,75.8065217391304
"26398","78518","2019",1,1,0,458950,6287,73
"26399","78520","2019",15,14,1,306226.666666667,3232.46666666667,110.6
"26400","78522","2019",15,9,6,312100,2847.46666666667,111.133333333333
"26401","78528","2019",6,6,0,190666.666666667,2291.16666666667,84.8333333333333
"26402","78530","2019",8,8,0,291293.75,2860.375,112.375
"26403","78531","2019",94,79,15,205523.914893617,2280.55319148936,92.8723404255319
"26404","78536","2019",2,1,1,169640,2067,78.5
"26405","78537","2019",89,76,13,274070.011235955,2836.79775280899,100.23595505618
"26406","78545","2019",328,57,271,267221.463414634,4020.01219512195,67.5579268292683
"26407","78548","2019",6,6,0,667250,4497.16666666667,157.666666666667
"26408","78550","2019",23,20,3,362257.608695652,3751.04347826087,103.347826086957
"26409","78551","2019",686,145,541,493545.400874636,5919.21282798834,82.5889212827988
"26410","78557","2019",8,7,1,253437.5,2884.875,92.5
"26411","78558","2019",5,5,0,373600,2398.8,151.2
"26412","78559","2019",3,3,0,199900,2865,78.6666666666667
"26413","78561","2019",5,5,0,617200,3265.4,199.4
"26414","78562","2019",27,18,9,340196.851851852,3244.77777777778,109.444444444444
"26415","78564","2019",12,12,0,250100.833333333,2559.75,107.583333333333
"26416","78565","2019",3,3,0,331766.666666667,3363.33333333333,101
"26417","78567","2019",16,16,0,229536.25,2125.4375,110.75
"26418","78569","2019",14,14,0,278614.285714286,2367.21428571429,118
"26419","78571","2019",77,69,8,672825.298701299,4542.20779220779,154.909090909091
"26420","78575","2019",94,83,11,447002.223404255,3946.34042553192,119.531914893617
"26421","78576","2019",32,22,10,361992.03125,3268.1875,121.59375
"26422","78586","2019",696,269,427,283833.540229885,4143.31034482759,71.0818965517241
"26423","78588","2019",6,6,0,413149.333333333,2973.16666666667,146.5
"26424","78590","2019",4,4,0,460647.5,4015.5,115.5
"26425","78591","2019",33,30,3,252019.454545455,2549.75757575758,103
"26426","78597","2019",7,6,1,248142.857142857,2726.14285714286,93.5714285714286
"26427","78601","2019",25,20,5,290986.28,2955.88,108
"26428","78605","2019",13,13,0,267665.384615385,2674.76923076923,101.846153846154
"26429","78606","2019",1,1,0,250000,2294,109
"26430","78609","2019",12,12,0,315010.833333333,2911.83333333333,120.25
"26431","78615","2019",11,9,2,352390,4012.27272727273,93.4545454545455
"26432","78616","2019",17,17,0,284979.529411765,2706.17647058824,114.176470588235
"26433","78618","2019",2,2,0,315860,2919.5,105.5
"26434","78620","2019",4,4,0,453247.5,3492.25,136
"26435","78621","2019",222,49,173,181774.265765766,2665.90990990991,70.4414414414414
"26436","78623","2019",16,12,4,274298.1875,3068.9375,93.5
"26437","78624","2019",226,177,49,304677.172566372,3274.73008849558,97.5530973451327
"26438","78638","2019",87,74,13,292581.172413793,3226.06896551724,98.6666666666667
"26439","78640","2019",198,37,161,338732.808080808,4526.16666666667,73.4848484848485
"26440","78642","2019",215,105,110,287954.03255814,3361.41860465116,87.7209302325581
"26441","78643","2019",114,86,28,339809.51754386,3584.71929824561,99.3859649122807
"26442","78644","2019",25,13,12,203998.32,3309.44,65.36
"26443","78646","2019",1130,129,1001,492447.463716814,6537.39911504425,74.0141592920354
"26444","78647","2019",8,8,0,240100,2740.5,89.125
"26445","78650","2019",283,112,171,665969.840989399,6409.79858657244,100.04593639576
"26446","78653","2019",6,6,0,281075,2031.16666666667,147.666666666667
"26447","78655","2019",8,8,0,364012.5,3147.25,124.875
"26448","78668","2019",9,9,0,242886.666666667,2190.77777777778,115.222222222222
"26449","78672","2019",98,62,36,502441.520408163,4587.87755102041,111.326530612245
"26450","78674","2019",162,116,46,308194.049382716,3636.98148148148,85.6111111111111
"26451","78677","2019",5,5,0,212860,2130.6,108.8
"26452","78681","2019",16,16,0,336067.5,2728.1875,129.9375
"26453","78683","2019",41,36,5,332167.585365854,3845.31707317073,91.8780487804878
"26454","78686","2019",269,73,196,467144.795539033,6032.86617100372,75.542750929368
"26455","78688","2019",143,79,64,389792.363636364,4306.73426573427,92.1748251748252
"26456","79001","2019",20,20,0,72325,819.6,87.3
"26457","79002","2019",3,3,0,43666.6666666667,732,67
"26458","79003","2019",64,62,2,164256.796875,1470.828125,111.484375
"26459","79005","2019",34,33,1,102170.735294118,958.294117647059,97.1470588235294
"26460","79007","2019",8,8,0,104548.75,915.25,114.375
"26461","79008","2019",9,9,0,82959.1111111111,828.888888888889,98.8888888888889
"26462","79009","2019",4,4,0,92260,1034.75,89.25
"26463","79010","2019",19,19,0,102286.736842105,1340.52631578947,83.8421052631579
"26464","79012","2019",14,14,0,102071.428571429,930.357142857143,110
"26465","79013","2019",40,40,0,97360,881.05,114.85
"26466","79014","2019",34,34,0,107155.058823529,1029.73529411765,106.058823529412
"26467","79015","2019",1,1,0,315760,875,361
"26468","79016","2019",8,8,0,79062.5,876.625,84.5
"26469","79018","2019",4,4,0,75350,605,120.75
"26470","79019","2019",2,2,0,75100,885,79
"26471","79020","2019",13,13,0,144297.153846154,1203.84615384615,114.461538461538
"26472","79022","2019",1,1,0,192000,1280,150
"26473","79023","2019",3,3,0,89666.6666666667,927.666666666667,100.666666666667
"26474","79024","2019",28,28,0,137576.785714286,1317.64285714286,106.571428571429
"26475","79025","2019",10,10,0,88000,854.8,103.8
"26476","79029","2019",5,5,0,74500,715.4,102.8
"26477","79030","2019",7,7,0,125885.714285714,1280.14285714286,100.285714285714
"26478","79031","2019",29,24,5,119107.931034483,1166.79310344828,100.620689655172
"26479","79032","2019",5,5,0,117532,1021.4,109.4
"26480","79034","2019",28,27,1,189391.071428571,1668,112.321428571429
"26481","79038","2019",12,12,0,76347.5,804.25,95
"26482","79040","2019",2,2,0,183500,1212.5,150
"26483","79042","2019",4,4,0,107000,910.25,119
"26484","79046","2019",7,7,0,140785.714285714,1172.42857142857,126.714285714286
"26485","79047","2019",8,8,0,92015.625,971.25,98.875
"26486","79048","2019",71,71,0,147823.014084507,1410.98591549296,107.718309859155
"26487","79049","2019",219,204,15,126454.520547945,1256.68493150685,99.8767123287671
"26488","79050","2019",7,7,0,141714.285714286,1180.71428571429,120.714285714286
"26489","79056","2019",10,10,0,125230,1115.5,119.2
"26490","79057","2019",19,19,0,88881.5789473684,910.684210526316,100.315789473684
"26491","79058","2019",9,9,0,130822.222222222,1332.33333333333,100.333333333333
"26492","79059","2019",12,12,0,74496.6666666667,1088.91666666667,72.3333333333333
"26493","79060","2019",2,2,0,141500,1181,123.5
"26494","79061","2019",48,48,0,120203.208333333,1153.375,107.708333333333
"26495","79062","2019",57,54,3,102902.456140351,1083.73684210526,94.8771929824561
"26496","79063","2019",29,29,0,97246.2068965517,955.896551724138,100.379310344828
"26497","79064","2019",11,11,0,96500,851.181818181818,120.454545454545
"26498","79066","2019",29,29,0,104757.24137931,1049.24137931034,102.931034482759
"26499","79069","2019",7,7,0,94428.5714285714,1045.28571428571,91.5714285714286
"26500","79070","2019",5,5,0,160800,981.4,159.8
"26501","79071","2019",10,10,0,117560,1255.9,94.2
"26502","79074","2019",1,1,0,37500,577,65
"26503","79076","2019",18,18,0,103632.222222222,1019.16666666667,99.5
"26504","79077","2019",11,11,0,108787.090909091,1053,108.090909090909
"26505","79078","2019",10,10,0,138787.5,1056.2,130.9
"26506","79079","2019",110,109,1,123081.554545455,1186.86363636364,103.454545454545
"26507","79080","2019",31,31,0,104619.35483871,1041.25806451613,101.354838709677
"26508","79081","2019",96,92,4,185280.833333333,1786.78125,103
"26509","79083","2019",37,37,0,98873.3783783784,909.135135135135,116.459459459459
"26510","79084","2019",7,7,0,69528.5714285714,726.857142857143,88.1428571428571
"26511","79085","2019",2,2,0,76850,963.5,76.5
"26512","79086","2019",26,26,0,141505.576923077,1319.88461538462,114.038461538462
"26513","79087","2019",8,8,0,101187.5,925,116.5
"26514","79088","2019",10,10,0,91470,872.4,109
"26515","79089","2019",6,6,0,64633.3333333333,669.166666666667,93.6666666666667
"26516","79090","2019",10,10,0,95464.9,900,103.2
"26517","79091","2019",9,9,0,101666.666666667,924.555555555556,106.666666666667
"26518","79092","2019",4,4,0,95191.5,853.25,103.25
"26519","79094","2019",7,7,0,85257.1428571429,940.285714285714,99.1428571428571
"26520","79095","2019",6,6,0,166430.833333333,1105.83333333333,138.333333333333
"26521","79096","2019",13,13,0,122563.076923077,1167.69230769231,105.153846153846
"26522","79100","2019",36,36,0,164040.555555556,1533.16666666667,114.805555555556
"26523","79101","2019",37,37,0,125856.756756757,1114.40540540541,115.351351351351
"26524","79102","2019",12,12,0,99970,857.916666666667,116.75
"26525","79103","2019",40,40,0,96866,910.7,112.3
"26526","79104","2019",8,8,0,139025,1234.375,112.25
"26527","79105","2019",6,6,0,74915,797.666666666667,87.8333333333333
"26528","79106","2019",8,8,0,81875,844.375,101.25
"26529","79108","2019",4,4,0,46625,521,94
"26530","79109","2019",50,50,0,175279.1,1716.18,102.66
"26531","79111","2019",4,4,0,58464.5,623.25,101
"26532","79112","2019",17,17,0,152904.117647059,1420.76470588235,107.352941176471
"26533","79114","2019",22,21,1,140136.363636364,1335.81818181818,106.863636363636
"26534","79115","2019",7,7,0,110040,956.428571428571,124.857142857143
"26535","79116","2019",7,7,0,107000,1042.57142857143,96.5714285714286
"26536","79117","2019",8,8,0,143493.75,1262,120.875
"26537","79118","2019",7,7,0,82971.4285714286,919.571428571429,103.285714285714
"26538","79119","2019",7,7,0,108000,1039.28571428571,102.714285714286
"26539","79120","2019",15,15,0,82549.8,870.733333333333,98.1333333333333
"26540","79121","2019",7,7,0,106584.142857143,899.428571428571,127.142857142857
"26541","79122","2019",7,7,0,87357.1428571429,922.857142857143,96
"26542","79123","2019",25,25,0,105952,964.8,111.36
"26543","79124","2019",7,5,2,142465.857142857,1467.57142857143,95.1428571428571
"26544","79125","2019",22,22,0,148347.272727273,1349.86363636364,108.181818181818
"26545","79126","2019",10,10,0,125001,1136.3,113.8
"26546","79127","2019",9,9,0,166151.111111111,1216.33333333333,137.666666666667
"26547","79128","2019",10,10,0,203180,1515.6,135.1
"26548","79129","2019",19,19,0,184867.736842105,1490,126.210526315789
"26549","79130","2019",37,36,1,133253.243243243,1219.24324324324,109.351351351351
"26550","79131","2019",5,5,0,65800,734.8,87
"26551","79132","2019",2,2,0,100250,1095,99
"26552","79133","2019",13,13,0,154173.076923077,1379.30769230769,113.384615384615
"26553","79134","2019",7,7,0,84014.2857142857,773.571428571429,112.571428571429
"26554","79135","2019",15,15,0,110033.333333333,899.466666666667,122.466666666667
"26555","79136","2019",6,6,0,109241.666666667,991,108.666666666667
"26556","79137","2019",8,8,0,120812.5,1274.75,107.25
"26557","79139","2019",1,1,0,55000,579,95
"26558","79140","2019",14,14,0,101142.857142857,824.857142857143,124.142857142857
"26559","79141","2019",1,1,0,135000,692,195
"26560","79144","2019",6,6,0,143083.333333333,1331.5,117.5
"26561","79145","2019",11,11,0,84850.1818181818,837.454545454545,101
"26562","79147","2019",9,9,0,76222.2222222222,835.333333333333,90.5555555555556
"26563","79148","2019",21,20,1,93111.0476190476,953.095238095238,101.047619047619
"26564","79149","2019",1,1,0,65000,812,80
"26565","79150","2019",12,12,0,95594.1666666667,940.916666666667,118.583333333333
"26566","79152","2019",5,5,0,85464.8,732.2,128
"26567","79153","2019",4,4,0,88325,905.25,97.75
"26568","79154","2019",3,3,0,103666.666666667,629,170
"26569","79156","2019",7,7,0,56233.1428571429,689.571428571429,78.1428571428571
"26570","79157","2019",7,7,0,105785.714285714,1091.71428571429,100.142857142857
"26571","79158","2019",1,1,0,85000,966,88
"26572","79159","2019",5,5,0,160300,1232.2,133.2
"26573","79160","2019",3,3,0,45333.3333333333,691.666666666667,62.3333333333333
"26574","79161","2019",11,11,0,123856,1036.54545454545,126.818181818182
"26575","79162","2019",39,39,0,159466.025641026,1401.30769230769,114.666666666667
"26576","79163","2019",4,4,0,100222.5,910,121.5
"26577","79164","2019",3,3,0,95000,995.333333333333,90.3333333333333
"26578","79165","2019",2,2,0,196000,1150,163
"26579","79166","2019",9,9,0,134056.666666667,1212.33333333333,109
"26580","79167","2019",2,2,0,107775,1188.5,94.5
"26581","79170","2019",38,38,0,130471.315789474,1251.18421052632,110.473684210526
"26582","79172","2019",12,12,0,120183.333333333,1825.16666666667,101.083333333333
"26583","79174","2019",73,72,1,117165.082191781,1166,109.72602739726
"26584","79175","2019",9,9,0,89333.3333333333,662.777777777778,129.333333333333
"26585","79176","2019",14,14,0,105275,1074.64285714286,99.0714285714286
"26586","79177","2019",9,9,0,63555.5555555556,718.777777777778,94.2222222222222
"26587","79179","2019",55,55,0,102191.581818182,989.927272727273,105.018181818182
"26588","79180","2019",2,2,0,105000,1149,91
"26589","79183","2019",3,3,0,63333.3333333333,966.333333333333,66
"26590","79184","2019",26,26,0,85311.5384615385,839.576923076923,106.269230769231
"26591","79185","2019",44,44,0,135437.5,1218.25,114.659090909091
"26592","79189","2019",18,18,0,123222.222222222,1201.05555555556,103.611111111111
"26593","79190","2019",8,8,0,117937.5,772.875,153.125
"26594","79191","2019",1145,807,338,128864.405240175,1563.06200873362,82.8934497816594
"26595","79195","2019",60,60,0,106952.316666667,1025.45,105.583333333333
"26596","79196","2019",23,23,0,97495.4782608696,891.913043478261,110.521739130435
"26597","79197","2019",4,4,0,87211.75,1069,97.25
"26598","79198","2019",4,4,0,156904.75,1096,144.5
"26599","79200","2019",1,1,0,90000,918,98
"26600","79201","2019",29,29,0,85931.0344827586,892.827586206897,97.7586206896552
"26601","79202","2019",215,173,42,95912.8325581395,1062.28372093023,88.9581395348837
"26602","79203","2019",6,6,0,64083.3333333333,766.5,88.3333333333333
"26603","79204","2019",11,11,0,122727.272727273,1081.90909090909,113.727272727273
"26604","79207","2019",10,10,0,128700,1214.7,109.9
"26605","79208","2019",11,11,0,110161.090909091,882.454545454545,132.545454545455
"26606","79209","2019",4,4,0,70625,790.25,91.25
"26607","79210","2019",18,18,0,113861.111111111,1052.83333333333,109
"26608","79212","2019",5,5,0,65800,575.8,111.2
"26609","79213","2019",32,32,0,122997.90625,1081.125,113.59375
"26610","79215","2019",4,4,0,110325,823,151.25
"26611","79216","2019",21,21,0,131823.80952381,1378.90476190476,95.9047619047619
"26612","79217","2019",8,8,0,110698.5,957.5,120.25
"26613","79218","2019",3,3,0,108666.666666667,813,130.666666666667
"26614","79220","2019",6,6,0,188374.833333333,1696.5,110.833333333333
"26615","79225","2019",4,4,0,105125,855.5,124.25
"26616","79226","2019",2,2,0,106750,906,120.5
"26617","79229","2019",9,9,0,188578.222222222,1437.11111111111,133.888888888889
"26618","79230","2019",11,11,0,89722.7272727273,867.727272727273,108.272727272727
"26619","79231","2019",12,12,0,155708.333333333,1479.08333333333,105.916666666667
"26620","79235","2019",18,18,0,105192.777777778,963.388888888889,111.111111111111
"26621","79236","2019",5,5,0,127540,1147.8,111.4
"26622","79238","2019",8,8,0,108758.75,934.5,113.5
"26623","79239","2019",25,25,0,82479.4,840.8,98.64
"26624","79241","2019",5,5,0,121200,880.8,131.2
"26625","79242","2019",13,13,0,108623.076923077,881.307692307692,117.615384615385
"26626","79243","2019",5,5,0,73612,800.8,91.4
"26627","79244","2019",3,3,0,69000,858,82.6666666666667
"26628","79246","2019",3,3,0,107666.666666667,1051,105.666666666667
"26629","79249","2019",44,43,1,188620.454545455,1638.90909090909,120.181818181818
"26630","79250","2019",3,3,0,57333.3333333333,737.333333333333,81
"26631","79251","2019",8,8,0,112781.25,907.375,120.5
"26632","79252","2019",4,4,0,63775,707.75,86
"26633","79253","2019",13,13,0,95461.5384615385,1050,105
"26634","79254","2019",3,3,0,115000,898.333333333333,129.333333333333
"26635","79255","2019",4,4,0,62321,650,92
"26636","79256","2019",2,2,0,50000,478,91.5
"26637","79257","2019",28,28,0,120446.035714286,1119,110.892857142857
"26638","79258","2019",9,9,0,97333.3333333333,990.666666666667,94.8888888888889
"26639","79259","2019",19,19,0,125831.578947368,1251.42105263158,99.8421052631579
"26640","79263","2019",14,14,0,111214.285714286,980.928571428571,119
"26641","79265","2019",13,13,0,107238.461538462,1056.15384615385,102.076923076923
"26642","79267","2019",6,6,0,118675,1065.5,109.166666666667
"26643","79268","2019",10,10,0,65586.6,678.3,99.1
"26644","79269","2019",10,10,0,136850,1354.1,107.3
"26645","79270","2019",93,88,5,98703.8709677419,1018.56989247312,99.1290322580645
"26646","79271","2019",4,4,0,44737.5,650.25,79.5
"26647","79273","2019",14,14,0,113235.714285714,1102.71428571429,108
"26648","79274","2019",2,2,0,92500,708.5,140.5
"26649","79276","2019",10,10,0,160320,1471.1,108.1
"26650","79277","2019",10,10,0,97150,988.1,105.5
"26651","79278","2019",3,3,0,68000,735.666666666667,98
"26652","79280","2019",9,9,0,99222.2222222222,961.111111111111,104.666666666667
"26653","79281","2019",27,27,0,178937.777777778,1546.7037037037,120.62962962963
"26654","79283","2019",28,28,0,145372.5,1449.75,105.357142857143
"26655","79284","2019",13,13,0,129138.461538462,1196.23076923077,111.769230769231
"26656","79285","2019",27,27,0,111125.111111111,1032.7037037037,105.296296296296
"26657","79286","2019",7,7,0,126740.714285714,1008.71428571429,116.857142857143
"26658","79289","2019",22,22,0,135746.090909091,1149.22727272727,123.227272727273
"26659","79290","2019",15,15,0,111900,1065.8,106.4
"26660","79293","2019",15,15,0,156534.4,1479.26666666667,110.8
"26661","79294","2019",2,2,0,136002.5,956,155
"26662","79295","2019",7,7,0,104662.857142857,1022.28571428571,114
"26663","79297","2019",8,8,0,108902.5,1310.5,111.25
"26664","79298","2019",25,25,0,148481.2,1463.72,104.8
"26665","79299","2019",30,30,0,81350,898.8,88.7333333333333
"26666","79300","2019",22,22,0,92170.4545454545,926.636363636364,97.0454545454545
"26667","79301","2019",6,6,0,109646.5,1048.16666666667,108
"26668","79302","2019",20,19,1,121075,1171.1,107.4
"26669","79303","2019",4,4,0,113750,1183.75,95
"26670","79304","2019",15,15,0,182542,1667.2,120.133333333333
"26671","79306","2019",1,1,0,85000,567,150
"26672","79307","2019",28,28,0,74322.6071428571,841.142857142857,90.9285714285714
"26673","79308","2019",7,7,0,134500,1471.71428571429,85.2857142857143
"26674","79309","2019",10,10,0,117890,943.9,121
"26675","79310","2019",10,10,0,91999.8,816.2,111.1
"26676","79311","2019",21,21,0,90713.0952380952,863.619047619048,110.380952380952
"26677","79313","2019",8,8,0,96408.25,824.25,123.25
"26678","79316","2019",4,4,0,77500,875,88.75
"26679","79319","2019",8,8,0,147406.25,1041.125,136.625
"26680","79320","2019",10,10,0,154388,1092,136.6
"26681","79322","2019",33,32,1,120588.333333333,1071.81818181818,115.424242424242
"26682","79326","2019",11,11,0,71545.4545454545,695.727272727273,98.5454545454545
"26683","79329","2019",233,213,20,88452.5665236052,978.982832618026,89.7510729613734
"26684","79331","2019",1,1,0,160000,860,186
"26685","79332","2019",1,1,0,165000,1352,122
"26686","79334","2019",19,19,0,137619.105263158,1105.05263157895,124.578947368421
"26687","79335","2019",12,12,0,162358.333333333,1326.33333333333,136.5
"26688","79336","2019",4,4,0,110797.5,957.75,134.5
"26689","79337","2019",18,18,0,107071.944444444,958.388888888889,116.166666666667
"26690","79338","2019",2,2,0,74500,622.5,117.5
"26691","79339","2019",24,23,1,82116.6666666667,850.375,96.9166666666667
"26692","79340","2019",5,5,0,131400,1529.2,107
"26693","79341","2019",3,3,0,119333.333333333,1319,91.3333333333333
"26694","79342","2019",9,9,0,90979.4444444444,753.888888888889,129.333333333333
"26695","79343","2019",2,2,0,127600,1090.5,115.5
"26696","79345","2019",15,15,0,98821.3333333333,1031.26666666667,109.533333333333
"26697","79346","2019",3,3,0,130116.666666667,839.666666666667,147.666666666667
"26698","79347","2019",11,11,0,101102.727272727,919,112.727272727273
"26699","79348","2019",1,1,0,112000,675,166
"26700","79349","2019",5,5,0,72186,779,84.4
"26701","79350","2019",2,2,0,103000,862,120
"26702","79351","2019",24,24,0,146765.375,1313.83333333333,115.541666666667
"26703","79352","2019",3,3,0,91111,803.333333333333,109.666666666667
"26704","79354","2019",3,3,0,91333.3333333333,919.666666666667,99
"26705","79355","2019",58,57,1,170148.655172414,1566.68965517241,112.844827586207
"26706","79357","2019",5,5,0,123000,1678.8,99.8
"26707","80001","2019",256,194,62,114649.86328125,1435.21484375,83.05859375
"26708","80002","2019",2,2,0,147000,1479.5,98.5
"26709","80003","2019",8,8,0,100449.375,1112.75,88.125
"26710","80004","2019",7,7,0,104196.428571429,1273.85714285714,75.2857142857143
"26711","80005","2019",3,3,0,95333.3333333333,1291.66666666667,87
"26712","80006","2019",2,2,0,120000,864,135
"26713","80008","2019",9,9,0,104277.777777778,1152.33333333333,87.6666666666667
"26714","80009","2019",12,12,0,157653.166666667,1502.41666666667,106.833333333333
"26715","80010","2019",33,32,1,134425.696969697,1595.60606060606,88
"26716","80011","2019",41,41,0,139292.804878049,1653.24390243902,85.9756097560976
"26717","80013","2019",24,22,2,98541.6666666667,1130.58333333333,98.7916666666667
"26718","80016","2019",148,132,16,109436.195945946,1327.17567567568,84.6013513513514
"26719","80017","2019",3,3,0,131666.666666667,1257,103.666666666667
"26720","80018","2019",4,4,0,114625,1012.5,93.5
"26721","80019","2019",6,6,0,120101.666666667,1244,108.166666666667
"26722","80020","2019",10,10,0,254608,2210.2,114.9
"26723","80021","2019",1852,1011,841,148921.307235421,2182.20032397408,70.1522678185745
"26724","80022","2019",2,2,0,148500,1350,112.5
"26725","80023","2019",2,2,0,55000,1238,51.5
"26726","80024","2019",6,6,0,189213.333333333,1896.33333333333,97.5
"26727","80025","2019",6,6,0,199211.666666667,1594.16666666667,137.333333333333
"26728","80026","2019",1,1,0,119550,1220,98
"26729","80028","2019",3,3,0,137812.666666667,1297.66666666667,104.333333333333
"26730","80029","2019",5,5,0,116960,1484.4,81.2
"26731","80030","2019",6,6,0,130466.666666667,1454.5,87
"26732","80031","2019",3,3,0,65666.6666666667,899,76.6666666666667
"26733","80033","2019",3,3,0,121726.666666667,1144.66666666667,107.666666666667
"26734","80034","2019",10,10,0,99134.5,1033.1,94.6
"26735","80036","2019",3,3,0,220116.666666667,1708.66666666667,127.666666666667
"26736","80037","2019",1,1,0,135000,1000,135
"26737","80038","2019",3,3,0,153050.333333333,1021,149.666666666667
"26738","80039","2019",90,41,49,80233.0111111111,1474.47777777778,61.2333333333333
"26739","80040","2019",1,1,0,110000,2000,55
"26740","80041","2019",2,2,0,101987.5,1759.5,66
"26741","80042","2019",1,1,0,80000,930,86
"26742","80043","2019",5,5,0,134090,1170.2,108.8
"26743","80044","2019",2,2,0,164450,1449,114
"26744","80045","2019",2,2,0,165500,1174,135.5
"26745","80047","2019",5,5,0,135929,1599,88
"26746","80049","2019",1,1,0,153000,1645,93
"26747","80050","2019",2,2,0,270450,1975,136.5
"26748","80051","2019",5,5,0,90800,897.8,98.2
"26749","80052","2019",1,1,0,110000,1528,72
"26750","80055","2019",3,3,0,82666.6666666667,1323.33333333333,66.6666666666667
"26751","80056","2019",1,1,0,133000,1847,72
"26752","80058","2019",4,4,0,122562.5,1206.5,96.25
"26753","80059","2019",2,2,0,90000,947.5,100.5
"26754","80060","2019",3,3,0,116300,1259.66666666667,94.3333333333333
"26755","80061","2019",2,2,0,130000,1614,79.5
"26756","80062","2019",11,11,0,120318.181818182,1086.09090909091,107.909090909091
"26757","80063","2019",12,12,0,125583.333333333,1363.58333333333,88.6666666666667
"26758","80064","2019",4,4,0,211500,1407,152.5
"26759","80065","2019",1,1,0,106180,804,132
"26760","80066","2019",3,3,0,125800,1221.33333333333,106.333333333333
"26761","80067","2019",2,2,0,110000,839,133.5
"26762","80069","2019",3,3,0,137833.333333333,1344.33333333333,114.333333333333
"26763","80070","2019",8,8,0,87937.5,951.5,90.125
"26764","80071","2019",26,26,0,96366.1538461538,1066,91.2307692307692
"26765","80073","2019",3,3,0,208950,1731.66666666667,120.666666666667
"26766","80074","2019",1,1,0,140000,1687,83
"26767","80076","2019",3,3,0,91666.6666666667,1002.66666666667,92
"26768","80077","2019",3,3,0,174666.666666667,1572.33333333333,117.333333333333
"26769","80078","2019",7,7,0,163214.285714286,1731.85714285714,96.2857142857143
"26770","80079","2019",1,1,0,130000,1529,85
"26771","80080","2019",4,4,0,108325,962.5,111
"26772","80082","2019",10,10,0,143810,1487.7,94.5
"26773","80086","2019",10,9,1,175149.2,1699.1,115.1
"26774","80087","2019",1,1,0,149800,2305,65
"26775","80088","2019",8,8,0,123750,1070.5,119
"26776","80089","2019",1,1,0,65000,956,68
"26777","80092","2019",6,6,0,180900,1546.16666666667,127.833333333333
"26778","80093","2019",28,28,0,101338.214285714,1150.82142857143,87.5714285714286
"26779","80094","2019",4,4,0,163875,2398,77.75
"26780","80095","2019",2,2,0,77000,835,94
"26781","80096","2019",9,9,0,154055.555555556,1272.44444444444,110.777777777778
"26782","80097","2019",3,3,0,81166.6666666667,1015,77
"26783","80098","2019",1,1,0,144800,1931,75
"26784","80099","2019",1,1,0,115000,1917,60
"26785","80100","2019",5,5,0,158000,1751.4,103.2
"26786","80101","2019",10,10,0,138150,1196.3,112
"26787","80102","2019",3,3,0,279992,2199,117
"26788","80105","2019",2,2,0,148000,982,145.5
"26789","80106","2019",2,1,1,85500,1382,61.5
"26790","80107","2019",7,7,0,191642.857142857,1912.14285714286,99.7142857142857
"26791","80108","2019",3,3,0,91116.6666666667,1136.33333333333,78
"26792","80109","2019",6,6,0,89333.3333333333,970.833333333333,83
"26793","80110","2019",8,8,0,170912.5,1678.25,104.125
"26794","80112","2019",3,3,0,117933.333333333,1422.33333333333,86.6666666666667
"26795","80113","2019",1,1,0,166650,1389,120
"26796","80114","2019",3,3,0,187800,1413.66666666667,136.333333333333
"26797","80116","2019",4,4,0,117250,929.75,131
"26798","80117","2019",1,1,0,55000,611,90
"26799","80118","2019",2,2,0,147500,1207,123
"26800","80119","2019",4,4,0,158507.5,1155,140.25
"26801","80120","2019",6,6,0,103333.333333333,1071.16666666667,91.3333333333333
"26802","80122","2019",12,12,0,113845.833333333,1368.16666666667,83.5
"26803","80123","2019",4,4,0,145900,1840.75,83.75
"26804","80124","2019",10,10,0,129940,1275.5,101.1
"26805","80126","2019",4,4,0,105750,1350.25,81.5
"26806","80127","2019",10,10,0,117656,1480.8,81.4
"26807","80128","2019",3,3,0,105000,1181.66666666667,88.3333333333333
"26808","80129","2019",5,5,0,110500,1188.6,91.2
"26809","80130","2019",2,2,0,192990,1592.5,122
"26810","80131","2019",48,46,2,206880.875,2107.35416666667,95.1875
"26811","80132","2019",3,3,0,93166.6666666667,943.666666666667,100.333333333333
"26812","80133","2019",1,1,0,141000,1007,140
"26813","80135","2019",2,2,0,70250,2832.5,45.5
"26814","80136","2019",18,18,0,93350,1090.55555555556,88.1666666666667
"26815","80137","2019",4,4,0,202550,1715.75,120.5
"26816","80139","2019",1,1,0,145000,1835,79
"26817","80141","2019",3,3,0,79960,1017.33333333333,78.6666666666667
"26818","80142","2019",2,2,0,226366.5,1890.5,120.5
"26819","80144","2019",4,4,0,88325,1431.5,64.5
"26820","80145","2019",1,1,0,90000,667,135
"26821","80146","2019",2,2,0,214000,1572.5,123
"26822","80147","2019",5,5,0,139950,1697.2,89.6
"26823","80148","2019",6,6,0,97191.6666666667,1192,86.5
"26824","80149","2019",6,6,0,160372.5,2043.83333333333,79.5
"26825","80150","2019",4,4,0,96250,908.25,118.75
"26826","80151","2019",4,4,0,106500,1387,85.75
"26827","80153","2019",3,3,0,82666.6666666667,812.666666666667,96.3333333333333
"26828","80154","2019",3,3,0,107933.666666667,1094.33333333333,97.6666666666667
"26829","80155","2019",3,3,0,162666.666666667,1152.33333333333,142
"26830","80156","2019",3,3,0,250000,2086.33333333333,130.333333333333
"26831","80157","2019",1,1,0,114775,1290,89
"26832","80159","2019",1,1,0,171110,1923,89
"26833","80160","2019",11,11,0,220045.454545455,2173.81818181818,102.363636363636
"26834","80161","2019",1,1,0,65000,684,95
"26835","80162","2019",9,9,0,94894.6666666667,1329.22222222222,68.7777777777778
"26836","80163","2019",11,11,0,139681.818181818,1511,96.6363636363636
"26837","80164","2019",52,52,0,186361.730769231,1992.88461538462,95.0192307692308
"26838","80165","2019",3,3,0,71533.3333333333,697,114
"26839","80166","2019",6,6,0,130500,953,136.5
"26840","80167","2019",1,1,0,60000,458,131
"26841","80168","2019",11,11,0,115915,1060.09090909091,119.090909090909
"26842","80171","2019",9,9,0,166992.777777778,1652.11111111111,105.333333333333
"26843","80172","2019",8,8,0,105062.5,1178.125,99.75
"26844","80173","2019",4,4,0,214567.5,1760.5,121.25
"26845","80174","2019",1,1,0,135000,1467,92
"26846","80176","2019",5,5,0,95044.2,1141.4,90.6
"26847","80177","2019",6,6,0,136150,1249,108
"26848","80179","2019",4,4,0,157458.75,1249.25,141.5
"26849","80181","2019",1,1,0,185000,1028,180
"26850","80182","2019",115,71,44,113103.460869565,2049.66086956522,61.304347826087
"26851","80183","2019",4,4,0,160475,1360.5,130.25
"26852","80184","2019",4,4,0,112387.5,1281.5,90
"26853","80185","2019",1,1,0,120000,1348,89
"26854","80186","2019",19,19,0,116562.631578947,1275.52631578947,92.3684210526316
"26855","80187","2019",7,7,0,202807.142857143,1795.14285714286,120.285714285714
"26856","80188","2019",4,4,0,115000,1818.25,66
"26857","80189","2019",1,1,0,140000,1414,99
"26858","80190","2019",8,8,0,153718.75,1393.375,117
"26859","80191","2019",2,2,0,97500,889,110
"26860","80192","2019",2,2,0,68500,1337.5,61
"26861","80193","2019",1,1,0,177500,959,185
"26862","80194","2019",3,3,0,109750,899.666666666667,128
"26863","80195","2019",3,3,0,207666.666666667,1655,129.333333333333
"26864","80196","2019",3,3,0,77433.3333333333,1411,63.6666666666667
"26865","80197","2019",1,1,0,163950,1344,122
"26866","80198","2019",6,6,0,194560,1933.33333333333,108.166666666667
"26867","80199","2019",7,7,0,143757.142857143,1203.85714285714,111.285714285714
"26868","80200","2019",4,4,0,197250,1498.75,127
"26869","80201","2019",2,2,0,119600,1065,110
"26870","80202","2019",3,3,0,265970,2065.66666666667,129
"26871","80203","2019",2,2,0,161500,1691,98
"26872","80204","2019",8,8,0,88704.375,1047.625,84.375
"26873","80205","2019",16,16,0,95270.625,1370.125,78.625
"26874","80207","2019",3,3,0,171413.333333333,1720,100.333333333333
"26875","80208","2019",2,2,0,89250,1009.5,78
"26876","80210","2019",1,1,0,125000,1562,80
"26877","80211","2019",23,23,0,128169.130434783,1392.5652173913,95.5652173913043
"26878","80212","2019",67,57,10,149949.179104478,1591.91044776119,90.8805970149254
"26879","80213","2019",2,2,0,97500,1712,56
"26880","80214","2019",10,10,0,119200,1174.7,101.9
"26881","80215","2019",4,4,0,162500,1655.75,99
"26882","80216","2019",3,3,0,147166.666666667,1279.66666666667,114.333333333333
"26883","80217","2019",1,1,0,94000,969,97
"26884","80218","2019",1,1,0,177270,1248,142
"26885","80219","2019",1,1,0,67700,1231,55
"26886","80221","2019",2,2,0,167500,1471,116.5
"26887","80222","2019",15,15,0,116313.333333333,1305.86666666667,97.1333333333333
"26888","80223","2019",1,1,0,54000,720,75
"26889","80224","2019",1,1,0,75000,540,139
"26890","80225","2019",2,2,0,137400,1535,95
"26891","80226","2019",2,2,0,57000,489.5,115.5
"26892","80227","2019",8,8,0,154115,1576.5,100.375
"26893","80228","2019",84,63,21,189237.369047619,3201.02380952381,65.9880952380952
"26894","80229","2019",11,6,5,156509.090909091,1433.27272727273,107.909090909091
"26895","80230","2019",3,3,0,96069.3333333333,604,194
"26896","80231","2019",2,2,0,105400,2064.5,48.5
"26897","80232","2019",2,2,0,130000,1192,111.5
"26898","80233","2019",3,3,0,89666.6666666667,829.333333333333,110.666666666667
"26899","80234","2019",7,7,0,146378.571428571,1998.28571428571,75.7142857142857
"26900","80235","2019",12,12,0,110225,1321.75,82.6666666666667
"26901","80236","2019",6,6,0,98816.6666666667,1344.16666666667,89.5
"26902","80237","2019",2,2,0,163300,1342,128.5
"26903","80238","2019",3,3,0,159580,2122,98.6666666666667
"26904","80239","2019",2,2,0,95700,924.5,95.5
"26905","80240","2019",15,15,0,112146.666666667,1300.93333333333,87.0666666666667
"26906","80241","2019",11,10,1,140909.090909091,1151.81818181818,122.636363636364
"26907","80242","2019",4,4,0,215390,1772.25,119.75
"26908","80244","2019",4,4,0,114150,1241,91.5
"26909","80245","2019",3,3,0,186333.333333333,1065,152.666666666667
"26910","80246","2019",2,2,0,231885,1427,160.5
"26911","80247","2019",9,9,0,113274.444444444,1027.66666666667,111.444444444444
"26912","80248","2019",8,8,0,103140.625,1275.125,82.625
"26913","80249","2019",3,3,0,295000,1440.33333333333,186.666666666667
"26914","80250","2019",3,3,0,192333.333333333,1348,138
"26915","80251","2019",6,6,0,166050,1686.83333333333,99.1666666666667
"26916","80252","2019",1,1,0,80000,909,88
"26917","80253","2019",56,52,4,111148.75,1243.16071428571,90.0892857142857
"26918","80256","2019",24,23,1,171977.916666667,1989.58333333333,91.375
"26919","80259","2019",1,1,0,95000,792,120
"26920","80260","2019",12,12,0,196399.5,1739.41666666667,119.25
"26921","80261","2019",11,5,6,237697.272727273,2980.18181818182,87.0909090909091
"26922","80262","2019",6,6,0,113520.333333333,1587.33333333333,74.3333333333333
"26923","80263","2019",1,1,0,55000,1250,44
"26924","80264","2019",1,1,0,34000,694,49
"26925","80265","2019",5,5,0,86200,1205.6,66.8
"26926","80266","2019",5,5,0,96300,920.2,99.8
"26927","80267","2019",3,3,0,86750,1434,60
"26928","80268","2019",8,8,0,167562.5,1449.875,118.375
"26929","80269","2019",1,1,0,55000,917,60
"26930","80271","2019",7,7,0,72785.7142857143,785.285714285714,95.1428571428571
"26931","80272","2019",2,2,0,103500,937.5,106.5
"26932","80273","2019",3,3,0,106333.333333333,1559,66
"26933","80274","2019",21,21,0,83685.7142857143,1014.7619047619,86.1904761904762
"26934","80275","2019",5,5,0,96444,865.8,120.6
"26935","80276","2019",1,1,0,155000,1192,130
"26936","80278","2019",1,1,0,152860,1698,90
"26937","80279","2019",6,6,0,94833.3333333333,1006.66666666667,102
"26938","80280","2019",3,3,0,144680,1611.33333333333,91
"26939","80281","2019",2,2,0,137500,929.5,150
"26940","80282","2019",7,7,0,174014.285714286,1505.85714285714,114.428571428571
"26941","80284","2019",9,8,1,115777.777777778,1241.22222222222,98.6666666666667
"26942","80285","2019",9,9,0,197111.111111111,1682.11111111111,123.555555555556
"26943","80288","2019",3,3,0,149050,1542,104.666666666667
"26944","80290","2019",4,4,0,77975,844,97
"26945","80291","2019",2,2,0,275000,1660.5,166.5
"26946","80292","2019",1,1,0,75000,974,77
"26947","80293","2019",8,8,0,122226.25,1327.25,95.875
"26948","80295","2019",7,7,0,72357.1428571429,1234.42857142857,64.8571428571429
"26949","80296","2019",7,7,0,80714.2857142857,995.142857142857,80.5714285714286
"26950","80298","2019",12,12,0,105495.833333333,1008.58333333333,105.666666666667
"26951","80299","2019",3,3,0,119666.666666667,1453,84
"26952","80300","2019",3,3,0,129103.333333333,1127,121
"26953","80301","2019",3,3,0,149366.666666667,1497.66666666667,101.666666666667
"26954","80302","2019",1,1,0,223000,2230,100
"26955","80303","2019",8,8,0,196550,1978.75,103.75
"26956","80304","2019",2,2,0,129500,1315,98.5
"26957","80305","2019",5,5,0,144747,1798.2,93.2
"26958","80306","2019",3,3,0,104166.666666667,1396,74
"26959","80307","2019",1,1,0,162000,1952,83
"26960","80308","2019",20,20,0,116028.5,1353.9,84.3
"26961","80310","2019",7,7,0,148214.285714286,1415.57142857143,106.571428571429
"26962","80311","2019",1,1,0,170000,1667,102
"26963","80312","2019",7,7,0,163642.857142857,1195.71428571429,130.714285714286
"26964","80313","2019",2,2,0,112500,1219,92.5
"26965","80314","2019",3,3,0,67333.3333333333,873,79.3333333333333
"26966","80315","2019",6,6,0,175975,2157.33333333333,83.5
"26967","80316","2019",19,19,0,154267.894736842,1711.26315789474,93.1052631578947
"26968","80317","2019",2,2,0,79000,1058,81
"26969","80318","2019",34,33,1,128521.882352941,1274.47058823529,98.5588235294118
"26970","80319","2019",1,1,0,125000,1786,70
"26971","80320","2019",2,2,0,67500,880.5,77
"26972","80321","2019",3,3,0,161666.666666667,997.333333333333,145
"26973","80322","2019",2,2,0,117500,986.5,165
"26974","80325","2019",1,1,0,65000,739,88
"26975","80326","2019",4,4,0,82000,957,94.75
"26976","80327","2019",2,2,0,107000,1250.5,96
"26977","80328","2019",9,9,0,78387,1134,68.4444444444444
"26978","80329","2019",1,1,0,84000,933,90
"26979","80330","2019",1,1,0,97700,1051,93
"26980","80331","2019",2,2,0,73000,840.5,80.5
"26981","80332","2019",2,2,0,163700,1839,89
"26982","80333","2019",152,70,82,150456.184210526,3111.14473684211,51.0986842105263
"26983","80335","2019",6,6,0,90430,919.5,99.6666666666667
"26984","80337","2019",2,2,0,130175,1417,93
"26985","80338","2019",21,21,0,136438.380952381,1585.09523809524,83.7619047619048
"26986","80339","2019",2,2,0,106900,1621,65.5
"26987","80340","2019",4,4,0,179000,1700.75,102.5
"26988","80341","2019",1,1,0,90000,900,100
"26989","80342","2019",3,3,0,145333.333333333,1563.33333333333,92.6666666666667
"26990","80343","2019",1,1,0,118000,1934,61
"26991","80344","2019",3,3,0,206666.666666667,1635,128
"26992","80346","2019",4,4,0,154500,1100.25,139.75
"26993","80347","2019",3,3,0,68263.6666666667,894.333333333333,73
"26994","80348","2019",1,1,0,115000,1139,101
"26995","80350","2019",6,6,0,153333.333333333,1515.83333333333,109.166666666667
"26996","80352","2019",3,3,0,181000,1510.33333333333,118.666666666667
"26997","80353","2019",1,1,0,90000,1452,62
"26998","80354","2019",3,3,0,127000,1280.33333333333,103.333333333333
"26999","80355","2019",2,2,0,62850,949.5,72.5
"27000","80356","2019",1,1,0,155000,1667,93
"27001","80357","2019",3,3,0,185700,1722.33333333333,108.666666666667
"27002","80359","2019",3,3,0,124000,856.333333333333,151.666666666667
"27003","80360","2019",22,22,0,104238.636363636,1240.27272727273,87.0909090909091
"27004","80362","2019",1,1,0,70000,1429,49
"27005","80364","2019",12,11,1,131125,1465.16666666667,92.5
"27006","80365","2019",1,1,0,92000,876,105
"27007","80366","2019",3,3,0,103766.666666667,1395.66666666667,70.6666666666667
"27008","80367","2019",3,3,0,89400,1281.33333333333,79
"27009","80368","2019",56,47,9,89893.9642857143,1134.53571428571,78.7321428571429
"27010","80371","2019",2,2,0,145750,1432,102
"27011","80373","2019",22,21,1,81986.3636363636,1111.95454545455,73.8181818181818
"27012","80374","2019",3,3,0,118600,1091.66666666667,105.666666666667
"27013","80375","2019",5,5,0,138111.4,1406.4,97.6
"27014","80376","2019",11,11,0,186809.090909091,1758.63636363636,107.181818181818
"27015","80377","2019",4,4,0,411000,3366.25,100.5
"27016","80378","2019",1,1,0,126575,2182,58
"27017","80379","2019",5,5,0,219100,2060.6,106.2
"27018","80380","2019",5,5,0,103700,1246.2,83.2
"27019","80385","2019",4,4,0,175412.5,1974.5,89.75
"27020","80387","2019",2,2,0,268050,2358.5,116.5
"27021","80388","2019",1,1,0,149000,1307,114
"27022","80390","2019",6,6,0,122883.333333333,1135.66666666667,117.833333333333
"27023","80392","2019",2,2,0,67150,904,79
"27024","80393","2019",1,1,0,65000,1048,62
"27025","80395","2019",6,6,0,72833.3333333333,1020.16666666667,69.8333333333333
"27026","80396","2019",5,5,0,101200,1246.6,88
"27027","80399","2019",4,4,0,233422.75,2261,103.5
"27028","80400","2019",3,3,0,118766.666666667,997.666666666667,117.666666666667
"27029","80401","2019",3,3,0,107823.333333333,1091.66666666667,91
"27030","80403","2019",2,2,0,229125,3573.5,89
"27031","80405","2019",5,5,0,204454,2055,102.6
"27032","80406","2019",22,22,0,119138.636363636,1134.90909090909,105.681818181818
"27033","80407","2019",2,2,0,147500,1189.5,120
"27034","80408","2019",4,4,0,107000,1196.5,94.5
"27035","80409","2019",2,2,0,154100,1593,96.5
"27036","80410","2019",61,57,4,90788.7704918033,1012.7868852459,85.5245901639344
"27037","80411","2019",7,7,0,148714.285714286,1754,90.4285714285714
"27038","80412","2019",3,3,0,179436.666666667,1749.66666666667,99.6666666666667
"27039","80413","2019",1,1,0,113000,1018,111
"27040","80414","2019",2,2,0,222340,1997.5,109.5
"27041","80415","2019",17,16,1,128397.235294118,1450.35294117647,87.8235294117647
"27042","80416","2019",10,10,0,144525,1489.1,99.2
"27043","80417","2019",16,16,0,122316.25,1155.75,114.9375
"27044","80420","2019",4,4,0,83250,990.5,86.5
"27045","80421","2019",3,3,0,143666.666666667,1297,118.666666666667
"27046","80422","2019",6,6,0,138916.666666667,1682.33333333333,82.1666666666667
"27047","80423","2019",3,3,0,153166.666666667,1861.66666666667,83.3333333333333
"27048","80424","2019",8,8,0,267702.5,2300.25,115.875
"27049","80425","2019",1,1,0,172900,1218,142
"27050","80426","2019",5,5,0,157691,1755,93.6
"27051","80427","2019",1,1,0,140000,1795,78
"27052","80428","2019",3,3,0,61666.6666666667,1238.66666666667,51
"27053","80429","2019",5,5,0,133190,1646.4,86.8
"27054","80431","2019",6,6,0,177633.333333333,1673.66666666667,105.333333333333
"27055","80432","2019",4,4,0,145430,1185.75,142
"27056","80434","2019",4,4,0,141137.5,1055.5,131.25
"27057","80436","2019",7,7,0,138571.428571429,1486.28571428571,96.8571428571429
"27058","80437","2019",2,2,0,67500,819.5,82.5
"27059","80439","2019",2,2,0,90000,1060.5,85
"27060","80440","2019",1,1,0,45000,570,79
"27061","80442","2019",16,16,0,100539.5625,974.375,107.4375
"27062","80443","2019",21,21,0,105485.714285714,1196.90476190476,103.285714285714
"27063","80444","2019",5,5,0,194628.8,1521.4,130
"27064","80445","2019",5,5,0,84664,973.6,92.2
"27065","80446","2019",5,5,0,102568,927.2,116
"27066","80449","2019",1,1,0,110000,880,125
"27067","80450","2019",2,2,0,62785,1043,133
"27068","80452","2019",5,5,0,168800,1570.2,117.4
"27069","80453","2019",1,1,0,107000,1189,90
"27070","80455","2019",1,1,0,72000,1440,50
"27071","80456","2019",8,8,0,95707.5,1169,86.25
"27072","80458","2019",4,4,0,180025,1558,118.5
"27073","80461","2019",3,3,0,243933.333333333,1691,187.333333333333
"27074","80462","2019",5,5,0,120310,1125.8,101.4
"27075","80463","2019",14,14,0,165528.571428571,1801.28571428571,98.2142857142857
"27076","80464","2019",11,11,0,112373.636363636,1330.72727272727,85.8181818181818
"27077","80465","2019",2,2,0,105000,911,115
"27078","80467","2019",6,6,0,109833.333333333,1188,94
"27079","80469","2019",3,3,0,75000,1249.66666666667,59.3333333333333
"27080","80472","2019",5,5,0,83120,720.8,110.8
"27081","80473","2019",3,3,0,111600,957.666666666667,113.333333333333
"27082","80474","2019",3,3,0,99226.6666666667,1000.33333333333,108
"27083","80475","2019",3,3,0,104683.333333333,979,106.333333333333
"27084","80476","2019",4,4,0,105250,1136.75,96.25
"27085","80477","2019",1,1,0,95000,1583,60
"27086","80478","2019",1,1,0,97000,1386,70
"27087","80479","2019",5,5,0,101050,1322.8,74
"27088","80480","2019",1,1,0,87000,1359,64
"27089","80481","2019",2,2,0,72850,939.5,68
"27090","80482","2019",1,1,0,60000,690,87
"27091","80484","2019",4,4,0,87250,958.25,95.75
"27092","80485","2019",14,14,0,157519.642857143,1403.78571428571,110.5
"27093","80486","2019",8,8,0,96437.5,1146.25,87.375
"27094","80487","2019",2,2,0,78500,1104,74.5
"27095","80488","2019",25,25,0,104964.04,1432.12,75.2
"27096","80489","2019",54,43,11,165569.537037037,1928.05555555556,86.6851851851852
"27097","80490","2019",5,5,0,85840,819,116.4
"27098","80491","2019",1,1,0,134000,1288,104
"27099","80493","2019",7,7,0,123192.857142857,990.142857142857,127.571428571429
"27100","80494","2019",5,5,0,132600,1255.8,101
"27101","80495","2019",7,7,0,113342.857142857,991.428571428571,115.142857142857
"27102","80496","2019",4,4,0,130000,1314.25,108
"27103","80497","2019",2,2,0,197500,1969,99
"27104","80498","2019",13,13,0,123884.615384615,1112.38461538462,112.769230769231
"27105","80499","2019",2,2,0,131525,1370,96
"27106","80500","2019",4,4,0,90750,1299.75,78.25
"27107","80501","2019",4,4,0,127537.5,1245.5,104.5
"27108","80503","2019",4,4,0,98125,948.75,103.25
"27109","80505","2019",5,5,0,124600,1285,95
"27110","80507","2019",11,11,0,170526.727272727,2056.90909090909,90.0909090909091
"27111","80508","2019",1,1,0,62000,954,65
"27112","80509","2019",4,4,0,106380,1236.75,91.5
"27113","80511","2019",2,2,0,113750,1186.5,94.5
"27114","80512","2019",8,8,0,147200,1502.375,104.375
"27115","80513","2019",5,5,0,193437.6,2949.8,97.4
"27116","80514","2019",1,1,0,197000,1340,147
"27117","80515","2019",1,1,0,103000,2060,50
"27118","80516","2019",2,2,0,155500,1022.5,129.5
"27119","80517","2019",4,4,0,93250,1080.25,78.75
"27120","80518","2019",4,4,0,96750,1148.75,85.25
"27121","80519","2019",5,5,0,89220,974.6,87.6
"27122","80520","2019",2,2,0,83750,1530.5,59.5
"27123","80521","2019",3,3,0,145166.666666667,1226.33333333333,108.333333333333
"27124","80522","2019",1,1,0,140000,1284,109
"27125","80523","2019",15,15,0,127353.333333333,1487.46666666667,86.4
"27126","80524","2019",10,10,0,143691.5,1312.1,107.7
"27127","80525","2019",4,4,0,61500,1312.25,46.25
"27128","80526","2019",3,3,0,110333.333333333,1241,94.3333333333333
"27129","80527","2019",1,1,0,128400,1324,97
"27130","80530","2019",9,9,0,153192.666666667,2247.22222222222,90.6666666666667
"27131","80533","2019",99,48,51,101026.03030303,1757.77777777778,61.7777777777778
"27132","80536","2019",7,7,0,124582.857142857,1358.28571428571,95.2857142857143
"27133","80538","2019",1,1,0,35000,648,54
"27134","80540","2019",2,2,0,184850,1562.5,118
"27135","80541","2019",1,1,0,110000,1392,79
"27136","80542","2019",4,4,0,94250,1131.25,86.75
"27137","80543","2019",1,1,0,166050,2306,72
"27138","80544","2019",5,5,0,115820,1193.2,103.6
"27139","80545","2019",5,5,0,115600,1413.6,80.6
"27140","80546","2019",7,7,0,115028.571428571,1326.57142857143,80.5714285714286
"27141","80547","2019",3,3,0,124333.333333333,1009,120.666666666667
"27142","80548","2019",2,2,0,150000,1564,99
"27143","80549","2019",7,7,0,88857.1428571429,1003.42857142857,96.2857142857143
"27144","80552","2019",14,14,0,94642.8571428571,1123.21428571429,83.0714285714286
"27145","80553","2019",1,1,0,115000,1045,110
"27146","80554","2019",10,10,0,168050,1447.1,117.6
"27147","80555","2019",5,5,0,115270,1314.2,96.2
"27148","80556","2019",6,6,0,149650,1433.33333333333,99.3333333333333
"27149","80557","2019",10,10,0,114170,1101.1,99
"27150","80558","2019",1,1,0,90000,1286,70
"27151","80560","2019",4,4,0,132500,1384.25,91
"27152","80561","2019",70,66,4,118168.142857143,1384.48571428571,86.7714285714286
"27153","80565","2019",1,1,0,257000,1713,150
"27154","80566","2019",3,3,0,138233.333333333,1126.33333333333,113.666666666667
"27155","80568","2019",6,6,0,90750,879.333333333333,100.833333333333
"27156","80569","2019",7,7,0,109785.714285714,1258.42857142857,91.7142857142857
"27157","80570","2019",49,49,0,138199.183673469,1546.61224489796,89.8775510204082
"27158","80571","2019",4,4,0,103500,1281.25,84.5
"27159","80572","2019",9,9,0,158800,1385.33333333333,122.111111111111
"27160","80573","2019",5,5,0,96200,1396.8,76.6
"27161","80576","2019",4,4,0,102045,1217,105.75
"27162","80577","2019",3,3,0,128300,1674,76.6666666666667
"27163","80578","2019",10,10,0,129476,1394.4,98.9
"27164","80579","2019",12,12,0,144495.833333333,1561.08333333333,94.5833333333333
"27165","80580","2019",7,7,0,111715,1157.85714285714,104.142857142857
"27166","80582","2019",6,6,0,130333.333333333,1111.66666666667,110.833333333333
"27167","80583","2019",2,2,0,296900,2573,121.5
"27168","80584","2019",7,7,0,169463.571428571,1667.28571428571,107.857142857143
"27169","80585","2019",25,25,0,83429.6,1011.92,82.44
"27170","80588","2019",3,3,0,157333.333333333,1661.66666666667,95.3333333333333
"27171","80591","2019",1,1,0,239000,1258,190
"27172","80592","2019",12,12,0,75625,862.583333333333,88.6666666666667
"27173","80593","2019",6,6,0,100783.333333333,1319.83333333333,78.5
"27174","80595","2019",2,2,0,180550,1638.5,111
"27175","80596","2019",1,1,0,53000,589,90
"27176","80597","2019",7,7,0,143287.142857143,1425.42857142857,103.142857142857
"27177","80598","2019",11,11,0,129063.636363636,1573.90909090909,85.4545454545455
"27178","80599","2019",5,5,0,116460,1053.2,99.2
"27179","80600","2019",4,4,0,106875,1808.5,65.25
"27180","80601","2019",5,5,0,114300,1158.8,108.2
"27181","80602","2019",2,2,0,102000,1194.5,95.5
"27182","80603","2019",2,2,0,97000,1502.5,65.5
"27183","80605","2019",2,2,0,80000,667.5,116
"27184","80606","2019",6,6,0,99833.3333333333,1262.83333333333,78
"27185","80607","2019",3,3,0,157000,1383,112.666666666667
"27186","80609","2019",3,3,0,95700,1315.33333333333,83.3333333333333
"27187","80611","2019",11,9,2,147345.454545455,1701.36363636364,87
"27188","80613","2019",10,10,0,128900,1614.6,82.3
"27189","80614","2019",1,1,0,176000,1107,159
"27190","80615","2019",6,6,0,165525,1301.83333333333,134.333333333333
"27191","80616","2019",2,2,0,55000,860,60.5
"27192","80617","2019",4,4,0,110575,972.75,107.25
"27193","80618","2019",14,14,0,116207.142857143,1534.42857142857,78.2857142857143
"27194","80619","2019",6,6,0,154333.333333333,1317.5,117.333333333333
"27195","80620","2019",92,81,11,114953.554347826,1409.19565217391,83.7391304347826
"27196","80621","2019",6,6,0,83458.3333333333,939,89.3333333333333
"27197","80622","2019",12,12,0,132268.666666667,1470.41666666667,90.25
"27198","80623","2019",7,7,0,100428.571428571,1081.85714285714,96.1428571428571
"27199","80624","2019",5,5,0,116960,1644.4,79.8
"27200","80625","2019",19,19,0,128565.263157895,1430,94.7368421052632
"27201","80626","2019",2,2,0,174000,1735.5,99.5
"27202","80627","2019",12,12,0,203893.333333333,2083.25,102.083333333333
"27203","80628","2019",13,13,0,141911.538461538,1444.53846153846,101.230769230769
"27204","80629","2019",4,4,0,99975,1236.5,82.5
"27205","80630","2019",26,25,1,139865.961538462,1377.26923076923,104.384615384615
"27206","80631","2019",1,1,0,140000,805,174
"27207","80632","2019",25,25,0,250671.96,2004.16,121.64
"27208","80633","2019",6,6,0,171509.166666667,1877.83333333333,91.6666666666667
"27209","80634","2019",10,10,0,185641,1784.8,109.3
"27210","80635","2019",14,14,0,101885.714285714,1214.14285714286,80.8571428571429
"27211","80637","2019",2,2,0,136500,1057.5,133
"27212","80638","2019",1,1,0,106000,1082,98
"27213","80639","2019",15,15,0,201676.666666667,2159.26666666667,93.4666666666667
"27214","80640","2019",1,1,0,82000,497,165
"27215","80642","2019",5,5,0,108640,1134.6,100.6
"27216","80643","2019",8,8,0,227245,2016.25,115.25
"27217","80644","2019",19,19,0,100268.684210526,1158.15789473684,87.7894736842105
"27218","80645","2019",1,1,0,161000,3354,48
"27219","80646","2019",1,1,0,143000,1625,88
"27220","80647","2019",2,2,0,78000,740.5,102
"27221","80648","2019",1,1,0,132750,1383,96
"27222","80649","2019",92,61,31,152836.826086957,2447.84782608696,67.445652173913
"27223","80650","2019",3,3,0,240000,1853.66666666667,129.333333333333
"27224","80651","2019",4,4,0,80375,925.5,87.25
"27225","80652","2019",9,9,0,154188.888888889,1487.22222222222,106.777777777778
"27226","80654","2019",8,8,0,119917.5,1309.75,92.5
"27227","80655","2019",5,5,0,122540,1280.6,104.2
"27228","80656","2019",14,13,1,179229.285714286,1744.64285714286,108.785714285714
"27229","80657","2019",8,8,0,148375,1309.625,114.625
"27230","80658","2019",1,1,0,70000,648,108
"27231","80659","2019",1,1,0,175500,1272,138
"27232","80661","2019",11,11,0,170272.727272727,1597.90909090909,105.909090909091
"27233","80662","2019",1,1,0,85000,1049,81
"27234","80663","2019",4,4,0,95000,1104.25,86.25
"27235","80665","2019",1,1,0,105000,1615,65
"27236","80666","2019",1,1,0,80000,1333,60
"27237","80667","2019",2,2,0,117000,1356.5,87
"27238","80668","2019",4,4,0,92000,1133,84.75
"27239","80669","2019",2,2,0,135110,1542.5,90.5
"27240","80670","2019",8,8,0,171312.5,1764.875,98.125
"27241","80672","2019",7,7,0,133650,1379,98
"27242","80673","2019",3,3,0,148666.666666667,1638.66666666667,91
"27243","80674","2019",64,51,13,155168.484375,1975.71875,79.046875
"27244","80676","2019",2,2,0,147500,1052,147
"27245","80677","2019",16,16,0,76581.25,911.75,81.75
"27246","80678","2019",6,6,0,110861.666666667,1534.83333333333,71.6666666666667
"27247","80679","2019",9,9,0,99594.4444444444,1008.22222222222,99.8888888888889
"27248","80680","2019",34,34,0,121373.441176471,1312.32352941176,93.7058823529412
"27249","80681","2019",1,1,0,80000,1250,64
"27250","80682","2019",3,3,0,158666.666666667,1401.33333333333,133.333333333333
"27251","80683","2019",1,1,0,152000,1267,120
"27252","80684","2019",3,3,0,222666.666666667,1602,138
"27253","80685","2019",58,54,4,100411.896551724,1170.89655172414,86.1034482758621
"27254","80686","2019",7,7,0,202428.571428571,1975,125.714285714286
"27255","80688","2019",48,48,0,154488.708333333,1899.35416666667,86.375
"27256","80690","2019",4,4,0,267250,1916.25,141.25
"27257","80691","2019",7,7,0,171715.714285714,1748.14285714286,86
"27258","80692","2019",8,8,0,98062.5,1481.25,65.25
"27259","80693","2019",4,4,0,120625,1072,120.75
"27260","80694","2019",1,1,0,134000,1381,97
"27261","80695","2019",9,9,0,76116.6666666667,911.777777777778,79.2222222222222
"27262","80696","2019",10,10,0,280306,2286.4,121.9
"27263","80698","2019",3,3,0,82000,1435.33333333333,53.3333333333333
"27264","80700","2019",5,5,0,112515,1219.8,91.2
"27265","80701","2019",7,7,0,125319,1085.42857142857,107.285714285714
"27266","80702","2019",17,16,1,339830.294117647,2738.64705882353,124.764705882353
"27267","80703","2019",3,3,0,84666.6666666667,1187.33333333333,76.6666666666667
"27268","80704","2019",4,4,0,217387,1480.75,145.25
"27269","80706","2019",22,22,0,102986.818181818,1150.72727272727,89.5454545454545
"27270","80708","2019",2,2,0,126250,1303.5,89.5
"27271","80709","2019",3,3,0,54333.3333333333,773.333333333333,70.3333333333333
"27272","80710","2019",3,3,0,110583.333333333,1365,73
"27273","80711","2019",29,29,0,91506.8965517241,992.965517241379,91.6551724137931
"27274","80713","2019",6,6,0,156250,2058,75.8333333333333
"27275","80714","2019",13,13,0,135884.230769231,1473.61538461538,93.8461538461538
"27276","80716","2019",12,12,0,173916.666666667,1640.33333333333,106.416666666667
"27277","80717","2019",9,6,3,154534.444444444,1955.55555555556,78.8888888888889
"27278","80718","2019",13,13,0,135692.307692308,1540.61538461538,87.3846153846154
"27279","80721","2019",52,49,3,232284.615384615,3230.44230769231,74.7307692307692
"27280","80722","2019",6,6,0,176233.333333333,1684.16666666667,106.833333333333
"27281","80723","2019",2,2,0,159750,863.5,167
"27282","80724","2019",22,21,1,201975,2011.04545454545,99.4090909090909
"27283","80725","2019",38,24,14,187378.131578947,2312.86842105263,81.8947368421053
"27284","80726","2019",2,2,0,70000,511,131
"27285","80728","2019",2,2,0,140300,1712.5,82
"27286","80729","2019",1,1,0,127000,1323,96
"27287","80730","2019",13,13,0,247415.384615385,2063.53846153846,125
"27288","80732","2019",11,11,0,110377.272727273,1235.18181818182,92.6363636363636
"27289","80733","2019",1,1,0,125000,786,159
"27290","80734","2019",2,2,0,142575,1237,126.5
"27291","80735","2019",1,1,0,34500,986,35
"27292","80736","2019",2,2,0,108000,850.5,101
"27293","80737","2019",1,1,0,44750,414,108
"27294","80740","2019",1,1,0,110000,1294,85
"27295","80741","2019",3,3,0,134333.333333333,1306,109.666666666667
"27296","80742","2019",1,1,0,155000,1348,115
"27297","80743","2019",7,7,0,99585.7142857143,1027.85714285714,91.8571428571429
"27298","80746","2019",8,8,0,179646.25,1840.75,98.625
"27299","80747","2019",1,1,0,80000,1026,78
"27300","80748","2019",3,3,0,136836.666666667,1091,126.666666666667
"27301","80749","2019",3,3,0,112583.333333333,1073,100.666666666667
"27302","80750","2019",2,2,0,60000,888,71
"27303","80751","2019",10,10,0,189620,1748.6,108.1
"27304","80752","2019",9,9,0,217222.222222222,1882.77777777778,121.555555555556
"27305","80754","2019",3,3,0,89066.6666666667,929.333333333333,111.333333333333
"27306","80755","2019",4,4,0,75875,700.75,112.5
"27307","80756","2019",1,1,0,116300,1211,96
"27308","80759","2019",4,4,0,114575,1633.25,76
"27309","80760","2019",6,6,0,127166.666666667,1378.5,96
"27310","80762","2019",6,6,0,110166.666666667,1057,99.8333333333333
"27311","80763","2019",4,4,0,129550,1437.75,90
"27312","80764","2019",3,3,0,118833.333333333,1200.33333333333,97.6666666666667
"27313","80765","2019",3,3,0,68500,1085.33333333333,62
"27314","80766","2019",5,5,0,107120,1433.2,74.2
"27315","80767","2019",2,2,0,143125,1730,83
"27316","80769","2019",8,8,0,164961.25,1553.25,108.75
"27317","80770","2019",3,3,0,96000,1188.33333333333,80.3333333333333
"27318","80774","2019",6,6,0,145758.333333333,1443.33333333333,122.166666666667
"27319","80775","2019",8,8,0,104788.125,1092.5,90.625
"27320","80776","2019",4,4,0,139212.5,1223,115.5
"27321","80777","2019",1,1,0,75000,824,91
"27322","80778","2019",1,1,0,136000,1563,87
"27323","80779","2019",7,7,0,132642.857142857,1626.14285714286,81.8571428571429
"27324","80780","2019",4,4,0,114875,1502,75.75
"27325","80781","2019",3,3,0,132466.666666667,1177,116
"27326","80782","2019",1,1,0,50000,746,67
"27327","80784","2019",1,1,0,165000,1289,128
"27328","80785","2019",2,2,0,249000,1614,148
"27329","80786","2019",1,1,0,95000,683,139
"27330","80787","2019",1,1,0,293300,2205,133
"27331","80788","2019",2,2,0,148797.5,1989,75
"27332","80789","2019",4,4,0,124550,1157.25,114
"27333","80791","2019",11,11,0,213700,2059.72727272727,105.727272727273
"27334","80792","2019",2,2,0,157349.5,995.5,156
"27335","80793","2019",30,27,3,150157.333333333,1506.63333333333,101.966666666667
"27336","80795","2019",7,7,0,105523.857142857,1406.14285714286,80
"27337","80798","2019",8,8,0,232675.125,1990.875,130.125
"27338","80799","2019",56,54,2,161047.607142857,1759.69642857143,92.0178571428571
"27339","80800","2019",1,1,0,110000,1038,106
"27340","80801","2019",4,4,0,105237.5,827.75,123.75
"27341","80802","2019",7,7,0,73714.2857142857,882.571428571429,83.2857142857143
"27342","80805","2019",2,2,0,223050,1528.5,144.5
"27343","80806","2019",4,4,0,143750,1582.75,86.5
"27344","80807","2019",5,5,0,96291,2034.4,60.2
"27345","80808","2019",4,4,0,137750,1273.5,110
"27346","80809","2019",4,4,0,143700,1565,93
"27347","80810","2019",2,2,0,76500,1035,72.5
"27348","80811","2019",5,5,0,69400,1016.2,70.6
"27349","80812","2019",2,2,0,49000,1137,40
"27350","80814","2019",5,5,0,138910,1524.4,93
"27351","80815","2019",12,12,0,180867.75,1830.75,108.083333333333
"27352","80819","2019",1,1,0,135000,1452,93
"27353","80820","2019",7,7,0,196157.142857143,1637.14285714286,122.428571428571
"27354","80821","2019",1,1,0,193250,1351,143
"27355","80822","2019",4,4,0,1e+05,1142.75,96
"27356","80823","2019",2,2,0,65000,708.5,90
"27357","80824","2019",3,3,0,98666.6666666667,1166,93.3333333333333
"27358","80826","2019",16,11,5,96516.0625,2232.375,61.375
"27359","80827","2019",11,11,0,118350,1422.18181818182,84.7272727272727
"27360","80828","2019",1,1,0,140000,1667,84
"27361","80830","2019",3,3,0,136657.333333333,1011.33333333333,125.333333333333
"27362","80834","2019",4,4,0,103175,938,125.25
"27363","80835","2019",2,2,0,151350,1462.5,103.5
"27364","80836","2019",2,2,0,92500,864,105.5
"27365","81001","2019",1,1,0,275780,1532,180
"27366","81002","2019",32,32,0,113931.25,981.8125,118.90625
"27367","81003","2019",12,12,0,106484.166666667,1080.16666666667,105.666666666667
"27368","81004","2019",793,431,362,158793.058007566,1903.95460277427,86.8461538461538
"27369","81005","2019",6,6,0,54133.3333333333,702.333333333333,76.8333333333333
"27370","81006","2019",3,3,0,320225,1146,238
"27371","81007","2019",1,1,0,572500,2290,250
"27372","81008","2019",3,3,0,113500,1217.66666666667,95.3333333333333
"27373","81009","2019",1,1,0,50000,758,66
"27374","81010","2019",10,10,0,78052,979.5,77.8
"27375","81011","2019",8,8,0,228237.5,1565.875,147.5
"27376","81012","2019",4,4,0,257012.5,1877,125.5
"27377","81013","2019",3,3,0,151333.333333333,1058.33333333333,139.666666666667
"27378","81014","2019",4,4,0,118208.75,1507,103.5
"27379","81016","2019",8,8,0,59395,819.25,80
"27380","81017","2019",3,3,0,67550,1444.33333333333,59.3333333333333
"27381","81018","2019",32,32,0,165848.8125,1456.625,109.65625
"27382","81019","2019",1,1,0,45000,1125,40
"27383","81021","2019",71,66,5,115360,1126.9014084507,102.478873239437
"27384","81022","2019",2,2,0,244000,1965.5,122.5
"27385","81023","2019",3,3,0,93635,1157,71
"27386","81024","2019",2,2,0,252000,1448.5,232.5
"27387","81025","2019",1,1,0,210600,2025,104
"27388","81026","2019",3,3,0,119600,1194.33333333333,104.666666666667
"27389","81028","2019",1,1,0,75000,806,93
"27390","81029","2019",2,2,0,233325,2122,107.5
"27391","81030","2019",1,1,0,202425,2087,97
"27392","81031","2019",10,10,0,129470,1113.7,107.9
"27393","81032","2019",9,9,0,177596.222222222,1456.44444444444,127.777777777778
"27394","81033","2019",38,38,0,105293.157894737,1097.07894736842,97.6052631578947
"27395","81034","2019",6,5,1,84333.3333333333,812.333333333333,107
"27396","81035","2019",3,3,0,191333.333333333,2194.66666666667,82.3333333333333
"27397","81036","2019",13,13,0,123235.769230769,1254.76923076923,99.2307692307692
"27398","81037","2019",21,21,0,83581.2380952381,828,98.9523809523809
"27399","81038","2019",21,21,0,194607.619047619,1749.09523809524,110.190476190476
"27400","81039","2019",25,25,0,135792.8,1231.6,117.8
"27401","81040","2019",3,3,0,195000,1774.66666666667,113.333333333333
"27402","81042","2019",22,22,0,159736.590909091,1389.5,112.272727272727
"27403","81043","2019",5,5,0,192720,1742,113.4
"27404","81044","2019",3,3,0,225850,1859.33333333333,123.666666666667
"27405","81045","2019",8,8,0,143293.75,1779.125,84.75
"27406","81046","2019",13,13,0,185558.384615385,1650.53846153846,115.769230769231
"27407","81047","2019",5,5,0,46000,797,61.4
"27408","81048","2019",28,25,3,128999.214285714,1328.5,98.4642857142857
"27409","81049","2019",5,5,0,181057.2,1817,98.6
"27410","81050","2019",3,3,0,336833.333333333,2116.66666666667,160
"27411","81051","2019",20,20,0,191492.5,1509.35,127.6
"27412","81052","2019",19,19,0,209507.368421053,1898.36842105263,111.473684210526
"27413","81053","2019",5,5,0,48100,917.6,55.8
"27414","81054","2019",6,6,0,131500,1286.83333333333,100.5
"27415","81055","2019",6,6,0,81525,875.666666666667,98.5
"27416","81056","2019",5,5,0,189288,1311.6,143.4
"27417","81058","2019",2,2,0,208100,1683,124
"27418","81059","2019",5,5,0,196354,1730.4,122
"27419","81060","2019",125,122,3,100626.712,1053.76,101.152
"27420","81061","2019",1,1,0,296000,1558,190
"27421","81062","2019",11,11,0,108104.545454545,1041,104.363636363636
"27422","81063","2019",15,15,0,229714.666666667,1796.86666666667,124.8
"27423","81064","2019",9,9,0,214500,2001.55555555556,110.111111111111
"27424","81065","2019",618,439,179,126832.22815534,1361.7216828479,93.3236245954693
"27425","81066","2019",5,5,0,117400,1044.8,114.6
"27426","81067","2019",5,5,0,139200,1347.2,106.8
"27427","81068","2019",2,2,0,86000,1272.5,63
"27428","81069","2019",11,8,3,109454.545454545,1070.72727272727,108
"27429","81070","2019",40,39,1,200623.525,1771.25,121.5
"27430","81071","2019",1,1,0,52000,867,60
"27431","81073","2019",1,1,0,80000,1333,60
"27432","81074","2019",11,11,0,223528.909090909,1849,125.090909090909
"27433","81075","2019",3,3,0,131333.333333333,1717.33333333333,75.6666666666667
"27434","81076","2019",9,9,0,217162,1769.11111111111,135.222222222222
"27435","81077","2019",10,10,0,82643,804.9,105.5
"27436","81078","2019",11,11,0,131211.818181818,1244.09090909091,112.181818181818
"27437","81079","2019",6,6,0,196300,1786,110.833333333333
"27438","81081","2019",12,12,0,130026.25,1062.75,133.333333333333
"27439","81082","2019",1,1,0,35000,449,78
"27440","81083","2019",4,4,0,141595,1631.5,87
"27441","81084","2019",5,5,0,92700,911.6,101.6
"27442","81085","2019",1,1,0,100430,947,106
"27443","81086","2019",4,4,0,47937.5,638.25,78.25
"27444","81087","2019",4,4,0,270475,1825,148
"27445","81088","2019",4,4,0,143750,1305.75,109.25
"27446","81092","2019",13,13,0,194171.230769231,1650.61538461538,129
"27447","81093","2019",6,6,0,239166.666666667,1990.33333333333,132
"27448","81094","2019",2,2,0,69750,1888,55.5
"27449","81096","2019",7,7,0,170494.285714286,1390.42857142857,142.428571428571
"27450","81097","2019",10,10,0,177215.1,1859.8,92.7
"27451","81098","2019",3,3,0,232380,1834,128.666666666667
"27452","81099","2019",240,188,52,138532.3375,1520.7375,91.8875
"27453","81100","2019",3,3,0,186850,1607.33333333333,113.666666666667
"27454","81101","2019",16,16,0,141061.25,1385.25,102.6875
"27455","81102","2019",2,2,0,212000,2250.5,93
"27456","81103","2019",1,1,0,65800,997,66
"27457","81104","2019",12,12,0,180080,1435.83333333333,128.5
"27458","81105","2019",176,165,11,111048.102272727,1155.84090909091,98.1590909090909
"27459","81106","2019",4,4,0,220362.5,2058.5,108.5
"27460","81108","2019",3,3,0,199333.333333333,1461.33333333333,149.333333333333
"27461","81109","2019",1,1,0,55000,1038,53
"27462","81110","2019",4,4,0,111487,1004.75,118
"27463","81111","2019",4,4,0,183683.25,1275.75,148.75
"27464","81112","2019",9,9,0,229785.555555556,2130.55555555556,108.333333333333
"27465","81114","2019",6,6,0,166166.666666667,1472.83333333333,109.666666666667
"27466","81115","2019",26,25,1,59851.5384615385,678.769230769231,89.1153846153846
"27467","81116","2019",21,21,0,214137.333333333,1790.33333333333,120.619047619048
"27468","81117","2019",2,2,0,190000,1570.5,121.5
"27469","81118","2019",3,3,0,346683.333333333,1966.66666666667,175
"27470","81119","2019",7,7,0,136742.857142857,1531.14285714286,90.7142857142857
"27471","81120","2019",82,75,7,122683.646341463,1305.40243902439,93.9756097560976
"27472","81121","2019",6,6,0,102133.333333333,918.333333333333,97.3333333333333
"27473","81123","2019",2,2,0,180000,900,240
"27474","81124","2019",23,22,1,86483.0434782609,994.782608695652,86.0434782608696
"27475","81125","2019",8,8,0,85750,953.875,84.75
"27476","81128","2019",17,17,0,92076.6470588235,920.470588235294,107.294117647059
"27477","81129","2019",1,1,0,165000,855,193
"27478","81130","2019",17,11,6,122858.882352941,1365.70588235294,88.6470588235294
"27479","81131","2019",31,31,0,195975.838709677,1717.03225806452,113.451612903226
"27480","81132","2019",16,16,0,131355.0625,1234.875,114.6875
"27481","81134","2019",1,1,0,40000,444,90
"27482","81135","2019",2,2,0,99500,1045,94.5
"27483","81136","2019",1,1,0,238750,770,310
"27484","81137","2019",3,3,0,78000,898,89.3333333333333
"27485","81138","2019",8,8,0,138000,1585.625,89.75
"27486","81139","2019",13,13,0,178765.384615385,1894.92307692308,101.230769230769
"27487","81140","2019",155,111,44,162253.812903226,1717.15483870968,94.0064516129032
"27488","81142","2019",13,13,0,156380.615384615,1419.76923076923,108.307692307692
"27489","81143","2019",8,8,0,177830.375,1306,135
"27490","81144","2019",47,46,1,184066.29787234,1624.17021276596,114.553191489362
"27491","81145","2019",58,55,3,175298.620689655,1541.86206896552,118.120689655172
"27492","81147","2019",11,11,0,157955.818181818,1510.63636363636,108
"27493","81148","2019",1,1,0,136000,1511,90
"27494","81149","2019",5,5,0,220100,1596.2,141
"27495","81150","2019",3,3,0,300383.333333333,2097.66666666667,149
"27496","81151","2019",1,1,0,153675,1098,140
"27497","81152","2019",3,3,0,163666.666666667,2040.66666666667,81.3333333333333
"27498","81154","2019",2,2,0,139000,1093.5,127
"27499","81156","2019",47,47,0,172562.340425532,1832.53191489362,97.7659574468085
"27500","81158","2019",6,6,0,75854.3333333333,990.5,74.3333333333333
"27501","81159","2019",4,2,2,208762.5,1684.5,122.75
"27502","81160","2019",9,9,0,156390,1387.11111111111,130.888888888889
"27503","81163","2019",168,142,26,103313.125,1003.31547619048,105.107142857143
"27504","81164","2019",5,5,0,218520,2152.6,102
"27505","81165","2019",3,3,0,138683.333333333,1086,132
"27506","81166","2019",3,3,0,163465.666666667,1323.33333333333,126
"27507","81167","2019",1,1,0,1e+05,1562,64
"27508","81168","2019",11,11,0,166840.909090909,1835.72727272727,101.181818181818
"27509","81170","2019",17,17,0,109600,1176,94.4705882352941
"27510","81171","2019",16,16,0,177792.6875,1694.875,105.5
"27511","81173","2019",2,2,0,214921.5,1791,120
"27512","81174","2019",7,7,0,142475.571428571,1509,93.2857142857143
"27513","81175","2019",3,3,0,135863.333333333,1478.66666666667,93.6666666666667
"27514","81177","2019",3,3,0,359383.333333333,1995.66666666667,168.666666666667
"27515","81178","2019",4,4,0,223825,1477.5,154
"27516","81179","2019",4,4,0,178137.5,1562.25,120.75
"27517","81180","2019",2,2,0,150855,1489.5,111.5
"27518","81182","2019",25,25,0,112481.2,1068.64,117.16
"27519","81183","2019",2,2,0,181500,1769,98
"27520","81185","2019",4,4,0,161377.5,1565,92
"27521","81186","2019",2,2,0,77000,963,80
"27522","81188","2019",3,3,0,78333.3333333333,867,84
"27523","81189","2019",3,3,0,300750,2112.66666666667,146
"27524","81190","2019",6,6,0,124916.666666667,1164.83333333333,103.333333333333
"27525","81191","2019",3,3,0,129000,1006,126
"27526","81192","2019",15,15,0,90986.6666666667,1082.13333333333,97.4666666666667
"27527","81193","2019",16,16,0,123411.25,1461.875,88.75
"27528","81195","2019",5,5,0,197500,1718,114.6
"27529","81196","2019",5,5,0,124316,1213.6,95.4
"27530","81197","2019",1,1,0,95000,543,175
"27531","81198","2019",7,7,0,185300,1421.28571428571,151.571428571429
"27532","81199","2019",1,1,0,82000,410,200
"27533","81200","2019",1,1,0,223100,2047,109
"27534","81201","2019",18,18,0,119263.888888889,1077.16666666667,121.277777777778
"27535","81202","2019",8,8,0,251856.25,1975.75,129.625
"27536","81203","2019",2,2,0,73500,639.5,156
"27537","81204","2019",23,22,1,153836.956521739,1379.13043478261,111.739130434783
"27538","81205","2019",1,1,0,320000,1362,235
"27539","81206","2019",11,11,0,104752.727272727,1360,83.1818181818182
"27540","81207","2019",1,1,0,255000,2056,124
"27541","81208","2019",4,4,0,180750,1259.25,152.75
"27542","81209","2019",26,26,0,146768.076923077,1392.92307692308,104.884615384615
"27543","81210","2019",4,4,0,183675,1599,113
"27544","81213","2019",1,1,0,160000,727,220
"27545","81214","2019",1,1,0,78500,479,164
"27546","81215","2019",7,7,0,193514.285714286,1825.28571428571,106.571428571429
"27547","81216","2019",3,3,0,130166.666666667,1199,99.6666666666667
"27548","81217","2019",7,7,0,192237.285714286,1662.85714285714,124.285714285714
"27549","81218","2019",45,44,1,219856.355555556,1804.08888888889,122.022222222222
"27550","81219","2019",29,29,0,156718.965517241,1413.55172413793,119.586206896552
"27551","81220","2019",75,73,2,196124.133333333,1883.81333333333,109.853333333333
"27552","81221","2019",2,2,0,120000,2282,53
"27553","81222","2019",34,32,2,118553.088235294,1202.11764705882,107.823529411765
"27554","81223","2019",2,2,0,107500,1175.5,84.5
"27555","81224","2019",1,1,0,75000,2027,37
"27556","81225","2019",13,13,0,159839,1532.92307692308,103.153846153846
"27557","81227","2019",20,18,2,137050,1152.25,119.55
"27558","81228","2019",5,5,0,207400,1545.2,137
"27559","81229","2019",1,1,0,299800,1110,270
"27560","81230","2019",6,6,0,108000,1275.66666666667,85.8333333333333
"27561","81231","2019",5,5,0,64043,667.2,89.2
"27562","81232","2019",1,1,0,195550,1630,120
"27563","81233","2019",20,20,0,125864,1260.85,111.45
"27564","81234","2019",1,1,0,55000,500,110
"27565","81235","2019",6,6,0,170341.666666667,1483.66666666667,111
"27566","81236","2019",2,2,0,280000,1694,165
"27567","81237","2019",1,1,0,110000,714,154
"27568","81238","2019",27,26,1,95207.4074074074,1010.03703703704,94.7037037037037
"27569","81239","2019",7,7,0,109792.857142857,943.571428571429,111
"27570","81240","2019",2,2,0,26500,455,55.5
"27571","81242","2019",3,3,0,120000,1169,106.333333333333
"27572","81243","2019",4,4,0,159875,1176.75,148.5
"27573","81244","2019",19,19,0,100605.263157895,1043.26315789474,97.4736842105263
"27574","81245","2019",4,4,0,83250,1394.25,57
"27575","81247","2019",1,1,0,1e+05,667,150
"27576","81248","2019",8,8,0,219225,2334.875,93.625
"27577","81249","2019",13,13,0,123264.153846154,1123.61538461538,113
"27578","81250","2019",1,1,0,140000,1167,120
"27579","81251","2019",6,6,0,187333.333333333,1500.83333333333,135.833333333333
"27580","81252","2019",2,2,0,187500,1348.5,148
"27581","81253","2019",4,4,0,131750,1517,93.5
"27582","81255","2019",4,4,0,249659.5,2110.5,121.5
"27583","81256","2019",2,2,0,146000,1422.5,91.5
"27584","81257","2019",77,62,15,146973.441558442,1606.75324675325,93.2467532467532
"27585","81258","2019",5,5,0,181618,1775,123.8
"27586","81259","2019",1,1,0,164000,1783,92
"27587","81261","2019",11,11,0,260022.272727273,2224.90909090909,120.818181818182
"27588","81262","2019",2,2,0,66000,1070,60.5
"27589","81263","2019",4,4,0,203277.5,1800.25,100.5
"27590","81264","2019",1,1,0,60000,732,82
"27591","81266","2019",17,17,0,119194.588235294,1373.52941176471,84.2352941176471
"27592","81267","2019",6,6,0,86041.6666666667,896.166666666667,95.1666666666667
"27593","81268","2019",2,2,0,48000,1018,44.5
"27594","81269","2019",8,8,0,102569.375,1138.125,92.875
"27595","81270","2019",1,1,0,205832,1525,135
"27596","81271","2019",145,128,17,203021.544827586,2098.35862068966,97.1931034482759
"27597","81272","2019",2,2,0,107500,1266.5,95.5
"27598","81273","2019",34,34,0,158879.117647059,1602.97058823529,98.6470588235294
"27599","81274","2019",12,12,0,218759.25,2004,111.083333333333
"27600","81275","2019",3,3,0,183733.333333333,1243.66666666667,161
"27601","81276","2019",22,22,0,149459.090909091,1362.18181818182,111.727272727273
"27602","81277","2019",4,4,0,125500,1392.75,79.25
"27603","81278","2019",1,1,0,49400,1029,48
"27604","81279","2019",2,2,0,255000,2328,120.5
"27605","81280","2019",7,7,0,159541.428571429,885.428571428571,174.285714285714
"27606","81281","2019",19,19,0,147448.631578947,1301,113.157894736842
"27607","81282","2019",1,1,0,95500,1837,52
"27608","81283","2019",13,13,0,238796.153846154,1777.69230769231,134.153846153846
"27609","81284","2019",19,17,2,196876.315789474,2036.94736842105,100.631578947368
"27610","81286","2019",3,3,0,165566.666666667,1354.66666666667,123
"27611","81287","2019",2,2,0,178500,1009,166.5
"27612","81288","2019",42,34,8,150915.452380952,1500.59523809524,98.3809523809524
"27613","81289","2019",27,27,0,142996.296296296,1400,100.111111111111
"27614","81290","2019",5,5,0,208946.6,1416,150.2
"27615","81291","2019",7,7,0,154621.428571429,1467.14285714286,117.714285714286
"27616","81292","2019",4,4,0,134200,1057.25,131
"27617","81293","2019",6,6,0,222688.333333333,2015,112.5
"27618","81294","2019",12,12,0,194591.666666667,1509.5,144.583333333333
"27619","81295","2019",4,4,0,102500,849.5,116.25
"27620","81297","2019",10,10,0,227839.5,1849.7,128.8
"27621","81298","2019",7,7,0,319852.142857143,2186.57142857143,143.285714285714
"27622","81299","2019",5,5,0,224400,1667.2,135.8
"27623","81302","2019",1,1,0,87500,803,109
"27624","81303","2019",6,5,1,77160,1083.33333333333,73.3333333333333
"27625","81304","2019",3,3,0,130000,1057,101.666666666667
"27626","81305","2019",10,10,0,61850,765.8,82.4
"27627","81306","2019",3,3,0,155386.333333333,1348.66666666667,121
"27628","81307","2019",16,16,0,130799.625,1410.0625,93.125
"27629","81308","2019",5,5,0,119000,989.6,114.4
"27630","81309","2019",4,4,0,77250,878.75,91.5
"27631","81311","2019",5,5,0,167400,1259,126.4
"27632","81312","2019",9,9,0,138214.777777778,1439.55555555556,97.2222222222222
"27633","81313","2019",3,3,0,104000,974,104.333333333333
"27634","81314","2019",6,6,0,96633.3333333333,1257.16666666667,74.6666666666667
"27635","81315","2019",12,12,0,174756.666666667,1640,107.916666666667
"27636","81316","2019",4,4,0,178250,1803.5,94.25
"27637","81317","2019",13,13,0,155961.615384615,1526.61538461538,104.615384615385
"27638","81318","2019",1,1,0,232500,1722,135
"27639","81319","2019",3,3,0,188333.333333333,1553.66666666667,124.333333333333
"27640","81320","2019",2,2,0,390250,2439,160
"27641","81322","2019",6,6,0,176169.166666667,1476.83333333333,126.5
"27642","81323","2019",3,3,0,283455.666666667,1376,201.666666666667
"27643","81324","2019",1,1,0,196000,1463,134
"27644","81325","2019",20,20,0,159025,1302.15,125.75
"27645","81326","2019",3,3,0,235633.333333333,1358.66666666667,197
"27646","82001","2019",3,3,0,155950,1338.66666666667,115.333333333333
"27647","82002","2019",42,37,5,145782.357142857,1621.40476190476,93.5952380952381
"27648","82003","2019",1,1,0,98000,1225,80
"27649","82004","2019",1,1,0,138000,1266,109
"27650","82005","2019",15,15,0,164396.666666667,1953.73333333333,88.2
"27651","82007","2019",1,1,0,163000,2173,75
"27652","82008","2019",16,16,0,113108.4375,1108.6875,101.9375
"27653","82010","2019",2,2,0,98619,1366.5,73.5
"27654","82011","2019",13,13,0,154821.538461538,1463.92307692308,107
"27655","82012","2019",10,10,0,137079,1253.8,112.1
"27656","82013","2019",53,48,5,123003.905660377,1450.94339622642,93.9811320754717
"27657","82014","2019",7,7,0,180750.285714286,1658.85714285714,106.857142857143
"27658","82015","2019",4,4,0,199000,1829.25,107
"27659","82016","2019",2,2,0,187877.5,1570,125.5
"27660","82017","2019",19,19,0,195322.789473684,1822.36842105263,110.315789473684
"27661","82018","2019",14,14,0,177843.928571429,1472.35714285714,122.714285714286
"27662","82019","2019",10,10,0,162774,1276.6,120.5
"27663","82020","2019",11,11,0,146590.909090909,1197,142.090909090909
"27664","82021","2019",3,3,0,91666.6666666667,1134.33333333333,95
"27665","82022","2019",7,7,0,99362.2857142857,893,121.857142857143
"27666","82023","2019",12,12,0,125633.333333333,1141.66666666667,109.75
"27667","82024","2019",3,3,0,98833.3333333333,821.666666666667,111.333333333333
"27668","82025","2019",48,46,2,202812.5625,1953.97916666667,104.9375
"27669","82026","2019",14,14,0,180038.214285714,1670.64285714286,116.857142857143
"27670","82027","2019",16,16,0,209441.25,1912.25,110.625
"27671","82028","2019",12,12,0,168676.666666667,1663.33333333333,100.833333333333
"27672","82029","2019",3,3,0,118333.333333333,1719.66666666667,65.6666666666667
"27673","82030","2019",6,6,0,161716.666666667,1247,130.5
"27674","82031","2019",15,15,0,144460.066666667,1463.4,97.8666666666667
"27675","82032","2019",3,3,0,132166.666666667,1298.33333333333,97.6666666666667
"27676","82033","2019",176,142,34,128685.386363636,1390.01704545455,93.7159090909091
"27677","82035","2019",5,5,0,139251,1527.2,104
"27678","82036","2019",3,3,0,128666.666666667,1063,108
"27679","82037","2019",90,70,20,119649.666666667,1393.38888888889,86.5333333333333
"27680","82038","2019",29,29,0,128895.482758621,1232.68965517241,105.137931034483
"27681","82039","2019",5,5,0,181300,1673.4,114
"27682","82040","2019",3,3,0,164806.666666667,1988,95.3333333333333
"27683","82041","2019",2,2,0,228850,2551.5,101
"27684","82042","2019",9,9,0,155805,1401.77777777778,115.777777777778
"27685","82043","2019",3,3,0,266333.333333333,2240.66666666667,116.666666666667
"27686","82044","2019",23,21,2,183373.913043478,1606.4347826087,112.826086956522
"27687","82045","2019",2,2,0,84000,1028.5,91
"27688","82046","2019",1,1,0,152000,1810,84
"27689","82048","2019",26,25,1,173489.961538462,1559.15384615385,112.384615384615
"27690","82049","2019",12,12,0,147229.166666667,1136.5,141.083333333333
"27691","82050","2019",15,15,0,137149.333333333,1225.73333333333,116.333333333333
"27692","82051","2019",9,9,0,147858.333333333,1456.66666666667,101.222222222222
"27693","82052","2019",14,14,0,171186.071428571,1602.35714285714,111.714285714286
"27694","82053","2019",1,1,0,145000,1465,99
"27695","82054","2019",10,10,0,120120,996.9,116.7
"27696","82055","2019",2,2,0,125800,1241,106.5
"27697","82056","2019",1,1,0,1e+05,2500,40
"27698","82057","2019",5,5,0,283300,2036,140.8
"27699","82058","2019",2,2,0,198000,1121,188
"27700","82059","2019",5,5,0,129200,1183,112
"27701","82060","2019",5,5,0,184814,1125.6,156
"27702","82061","2019",4,4,0,84750,895.75,89.25
"27703","82062","2019",25,25,0,143631.44,1541.84,95.08
"27704","82063","2019",6,6,0,142595,1465.16666666667,104.666666666667
"27705","82064","2019",2,2,0,144315.5,1573,118.5
"27706","82065","2019",5,5,0,182500,1371.8,135.2
"27707","82066","2019",3,3,0,193166.666666667,1830,106.666666666667
"27708","82068","2019",1,1,0,30000,857,35
"27709","82069","2019",3,3,0,267022.666666667,1594,153
"27710","82070","2019",1,1,0,144000,1582,91
"27711","82072","2019",6,6,0,130833.333333333,1188.83333333333,108
"27712","82073","2019",3,3,0,109393.666666667,1060.66666666667,101.666666666667
"27713","82074","2019",3,3,0,278333.333333333,1907.33333333333,160.333333333333
"27714","82075","2019",59,49,10,164615.593220339,1771.03389830508,97.9491525423729
"27715","82076","2019",19,19,0,173750,1646.89473684211,106.789473684211
"27716","82077","2019",4,4,0,173250,1066.5,152.5
"27717","82078","2019",1,1,0,220000,1560,141
"27718","82079","2019",23,23,0,200261.086956522,1863.26086956522,110.695652173913
"27719","82080","2019",11,10,1,124871.818181818,1432.18181818182,87.9090909090909
"27720","82081","2019",3,3,0,141666.666666667,994,162.666666666667
"27721","82082","2019",2,2,0,172500,1609,105
"27722","82083","2019",3,3,0,238366.666666667,1678.66666666667,128.666666666667
"27723","82084","2019",3,3,0,155083.333333333,829.333333333333,185.333333333333
"27724","82085","2019",18,18,0,145446.555555556,1503.38888888889,101.666666666667
"27725","82086","2019",5,5,0,147180,1393.8,117.4
"27726","82087","2019",32,29,3,159300.3125,1412.59375,106.53125
"27727","82088","2019",11,11,0,86496.7272727273,1114.72727272727,78.1818181818182
"27728","82089","2019",19,18,1,124842.105263158,1169.31578947368,111.263157894737
"27729","82090","2019",7,7,0,249928.571428571,1847.57142857143,130
"27730","82091","2019",2,2,0,272041.5,2476.5,160
"27731","82092","2019",2,2,0,216350,1440,140
"27732","82093","2019",6,6,0,68416.5,820.833333333333,88
"27733","82094","2019",25,25,0,103597.4,1280.92,82.84
"27734","82096","2019",49,43,6,147094.918367347,1537.44897959184,96.4489795918367
"27735","82097","2019",17,17,0,126800,1208.47058823529,108.529411764706
"27736","82098","2019",10,10,0,244325,2011,119.6
"27737","82099","2019",4,4,0,141275,1149.25,120.25
"27738","82100","2019",3,3,0,234750,1969.33333333333,116.666666666667
"27739","82101","2019",15,15,0,116173.333333333,1013.46666666667,125.6
"27740","82102","2019",2,2,0,170000,1449,117.5
"27741","82104","2019",2,2,0,140000,1455.5,96
"27742","82105","2019",16,16,0,146100.25,1337.8125,107.4375
"27743","82106","2019",4,4,0,144500,1234.75,111.25
"27744","82108","2019",16,15,1,167049.5625,1663.8125,104.6875
"27745","82110","2019",7,7,0,108857.142857143,1298.14285714286,87.5714285714286
"27746","82111","2019",2,2,0,60124,856.5,79
"27747","82112","2019",160,131,29,122851.8375,1213.0375,101.5625
"27748","82113","2019",14,13,1,102351.285714286,1258.92857142857,80.9285714285714
"27749","82114","2019",11,11,0,189470.909090909,1761.81818181818,112.181818181818
"27750","82115","2019",26,26,0,138341.923076923,1295.65384615385,102.730769230769
"27751","82116","2019",3,3,0,162666.666666667,1717,105.333333333333
"27752","82117","2019",27,26,1,146683.148148148,1455.74074074074,110.851851851852
"27753","82118","2019",1,1,0,154000,1855,83
"27754","82119","2019",7,7,0,154452.857142857,1556,91.4285714285714
"27755","82120","2019",5,5,0,243800,1675,139.2
"27756","82121","2019",1030,553,477,148816.804854369,1724.49611650485,85.6067961165049
"27757","82122","2019",2,2,0,211163,1695.5,125
"27758","82123","2019",19,10,9,116031.578947368,1450.94736842105,79.8947368421053
"27759","82124","2019",84,57,27,135240.166666667,1580.27380952381,83.1309523809524
"27760","82125","2019",91,69,22,163700.505494505,1751.06593406593,94.8901098901099
"27761","82126","2019",22,21,1,149372.545454545,1502.45454545455,101.454545454545
"27762","82127","2019",12,11,1,161725.833333333,1197.91666666667,131.75
"27763","82129","2019",2,2,0,154885,906.5,188.5
"27764","82130","2019",2,2,0,50000,803.5,62
"27765","82131","2019",12,12,0,148951.666666667,1346.33333333333,110.083333333333
"27766","82132","2019",18,18,0,135848.333333333,1440.66666666667,93.8888888888889
"27767","82134","2019",72,64,8,152277.819444444,1555.19444444444,97
"27768","82135","2019",11,11,0,201547.727272727,2042.09090909091,107
"27769","82136","2019",15,15,0,200871.4,2014.73333333333,102.2
"27770","82137","2019",3,3,0,106233.333333333,1052.66666666667,89.3333333333333
"27771","82138","2019",1,1,0,107600,1708,63
"27772","82139","2019",1,1,0,87000,621,140
"27773","82140","2019",3,3,0,161791.666666667,1370.66666666667,105.333333333333
"27774","82141","2019",4,4,0,132750,1359.75,98.25
"27775","82142","2019",15,15,0,222594.333333333,2101.13333333333,105
"27776","82144","2019",5,5,0,174450,1710.6,102.8
"27777","82145","2019",5,5,0,222120,1931.8,116.2
"27778","82147","2019",6,6,0,136500,1600.83333333333,106.666666666667
"27779","82148","2019",13,13,0,141829.230769231,1061.30769230769,137.307692307692
"27780","82149","2019",25,23,2,125081.2,1186.44,108.8
"27781","82150","2019",8,8,0,171051.25,1497.625,135.5
"27782","82151","2019",9,9,0,187712.222222222,1510.77777777778,121.555555555556
"27783","82152","2019",2,2,0,130500,1744,75
"27784","82153","2019",5,5,0,181620,1426,127.4
"27785","82154","2019",6,6,0,208768.166666667,1361.33333333333,161
"27786","82155","2019",41,40,1,167539.975609756,1668.90243902439,102.951219512195
"27787","82156","2019",2,2,0,181625,1268.5,150
"27788","82157","2019",2,2,0,248900,1303,169.5
"27789","82158","2019",2,2,0,218000,1008,228.5
"27790","82159","2019",4,4,0,213500,1867.25,118.25
"27791","82160","2019",1,1,0,120000,2308,52
"27792","82161","2019",40,35,5,172479.5,1768.65,97.575
"27793","82162","2019",4,4,0,169000,1374,140.5
"27794","82164","2019",4,4,0,189565,1709.25,106.25
"27795","82165","2019",11,11,0,147457.181818182,1248.90909090909,121
"27796","82166","2019",6,6,0,124180.166666667,1054.16666666667,115.166666666667
"27797","82167","2019",14,13,1,180477.857142857,1546.64285714286,120.357142857143
"27798","82168","2019",4,4,0,109250,1873.5,63
"27799","82169","2019",20,20,0,130296.5,1223.7,110.8
"27800","82170","2019",2,2,0,104000,1364,70.5
"27801","82171","2019",19,19,0,151400.157894737,1313.84210526316,116
"27802","82172","2019",7,7,0,109771.428571429,1158.14285714286,97.7142857142857
"27803","82173","2019",22,22,0,146607.227272727,1524.90909090909,98.1363636363636
"27804","82174","2019",1,1,0,130000,1477,88
"27805","82175","2019",2,2,0,175000,1275,150
"27806","82176","2019",10,10,0,213717,1616.5,129.1
"27807","82177","2019",1,1,0,120000,2400,50
"27808","82178","2019",7,7,0,195592.857142857,1786,112
"27809","82179","2019",34,33,1,116148.970588235,1291.55882352941,94.1176470588235
"27810","82180","2019",3,3,0,150066.666666667,1464.33333333333,105
"27811","82181","2019",1,1,0,230000,2300,100
"27812","82182","2019",6,6,0,245075,1887.33333333333,130.833333333333
"27813","82183","2019",4,4,0,183007.5,1473.25,125
"27814","82184","2019",4,4,0,166375,1512.5,106.25
"27815","82185","2019",2,2,0,110000,1404,98.5
"27816","82186","2019",72,60,12,106904.055555556,1251.18055555556,91.0833333333333
"27817","82187","2019",17,17,0,113561.470588235,1162.88235294118,91.2941176470588
"27818","82188","2019",8,8,0,134421.875,1250.5,110.625
"27819","82189","2019",6,6,0,227408.333333333,2040.5,99.6666666666667
"27820","82190","2019",86,55,31,132971.38372093,1593.05813953488,85.7906976744186
"27821","82191","2019",13,13,0,140802.615384615,1439.61538461538,93.3076923076923
"27822","82192","2019",3,3,0,165710.666666667,1409.33333333333,114
"27823","82193","2019",1,1,0,134000,1241,108
"27824","82194","2019",21,20,1,192313.80952381,1653,121.095238095238
"27825","82195","2019",13,13,0,190457.692307692,1702.53846153846,114.307692307692
"27826","83001","2019",46,41,5,466940.652173913,3760.84782608696,119.891304347826
"27827","83002","2019",3,2,1,78666.6666666667,1380,58.3333333333333
"27828","83003","2019",21,18,3,187852.380952381,2190.28571428571,87.5714285714286
"27829","83004","2019",122,79,43,230594.090163934,2632.81147540984,86.3196721311475
"27830","83005","2019",7,7,0,178753,2334.14285714286,71.7142857142857
"27831","83007","2019",40,31,9,220244.75,2049.675,105.925
"27832","83008","2019",64,47,17,317357.59375,3439.3125,97.796875
"27833","83009","2019",429,85,344,315044.617715618,5451.63869463869,57.9440559440559
"27834","83010","2019",1,1,0,112000,2947,38
"27835","83011","2019",33,21,12,161205.818181818,1805.63636363636,85.030303030303
"27836","83012","2019",60,41,19,164645.066666667,2204.9,76.7166666666667
"27837","83013","2019",3,2,1,172616.666666667,2199,82.3333333333333
"27838","83014","2019",6,5,1,187855.666666667,2009.83333333333,92.8333333333333
"27839","83015","2019",6,4,2,172005.833333333,2150.83333333333,94.8333333333333
"27840","83016","2019",166,89,77,320906.373493976,3695.25903614458,85.6566265060241
"27841","83017","2019",37,27,10,265763.513513513,3153.16216216216,89.5945945945946
"27842","83018","2019",60,55,5,251555.983333333,2576.2,100.333333333333
"27843","83019","2019",280,105,175,322187.907142857,4934.59285714286,61.4607142857143
"27844","83020","2019",2,1,1,42500,1183,36
"27845","83021","2019",40,35,5,234377.75,2734.35,92.925
"27846","83023","2019",278,166,112,181219.183453237,2185.60431654676,83.7122302158273
"27847","83025","2019",23,17,6,220895.652173913,2701,81.695652173913
"27848","83026","2019",36,32,4,210279.166666667,2262.27777777778,92.6666666666667
"27849","83027","2019",58,51,7,559763.672413793,4819.65517241379,114.879310344828
"27850","83028","2019",38,28,10,234725.394736842,2740.63157894737,94.7894736842105
"27851","83029","2019",79,63,16,317133.620253165,3045.98734177215,105.341772151899
"27852","83030","2019",30,26,4,234594.733333333,2516.86666666667,92.3333333333333
"27853","83031","2019",68,48,20,240225.058823529,2526.80882352941,92.1911764705882
"27854","83032","2019",63,53,10,194925.587301587,2255.44444444444,86.9523809523809
"27855","83033","2019",12,12,0,200020.833333333,3355,68.8333333333333
"27856","83034","2019",207,87,120,451657.033816425,5098.97101449275,85.2753623188406
"27857","83035","2019",67,59,8,351986.253731343,4162.13432835821,85.5373134328358
"27858","83036","2019",362,99,263,309890.082872928,4818.27348066298,61.3812154696133
"27859","83037","2019",15,11,4,218840.133333333,2649.13333333333,86.8666666666667
"27860","83038","2019",4,4,0,170692.5,2293.75,77
"27861","83039","2019",3,3,0,176583.333333333,2018.33333333333,94
"27862","83041","2019",20,17,3,173125,2366.2,82.05
"27863","83042","2019",187,73,114,247614.229946524,3596.55614973262,67.5026737967914
"27864","83043","2019",7,6,1,149300.714285714,2565.71428571429,60.1428571428571
"27865","83044","2019",5,4,1,100200,1524.4,65.8
"27866","83045","2019",18,17,1,117983.333333333,1795.16666666667,71.9444444444444
"27867","83046","2019",59,48,11,307699.949152542,2662.35593220339,107.423728813559
"27868","83047","2019",199,151,48,327570.783919598,3567.4824120603,92.678391959799
"27869","83048","2019",161,68,93,453404.335403727,5704.91304347826,68.639751552795
"27870","83049","2019",195,116,79,220871.917948718,2804.07179487179,78.974358974359
"27871","83050","2019",632,230,402,174414.268987342,2127.81329113924,80.1645569620253
"27872","83051","2019",18,16,2,227252.777777778,2479.5,84.8888888888889
"27873","83052","2019",9,8,1,107635,1690.66666666667,56.8888888888889
"27874","83053","2019",26,20,6,314093.846153846,3349.46153846154,91.3461538461538
"27875","83054","2019",122,75,47,306823.409836066,3366.95901639344,90.8606557377049
"27876","83055","2019",130,104,26,287172.476923077,3250.16153846154,90.9923076923077
"27877","83056","2019",31,28,3,272295.322580645,2575.61290322581,104.451612903226
"27878","83057","2019",55,52,3,269657.145454545,2554.29090909091,105.745454545455
"27879","83058","2019",83,67,16,292065.481927711,2994.75903614458,96.8433734939759
"27880","83059","2019",42,37,5,249144.928571429,2672.40476190476,97.5238095238095
"27881","83060","2019",9,9,0,270157.222222222,2379,117.666666666667
"27882","83061","2019",1390,324,1066,237412.302877698,3606.19568345324,65.6705035971223
"27883","83062","2019",329,98,231,235584.896656535,3170.8632218845,75.0668693009118
"27884","83063","2019",39,31,8,412506.487179487,3401.15384615385,109.974358974359
"27885","83064","2019",97,86,11,281219.195876289,2929.31958762887,96.3917525773196
"27886","83065","2019",83,63,20,768463.036144578,6525.84337349398,98.2409638554217
"27887","83066","2019",32,29,3,198043.125,2390.46875,84.4375
"27888","83067","2019",66,49,17,192478.863636364,2539.36363636364,83.5454545454545
"27889","83068","2019",225,121,104,601365.128888889,6506.10222222222,89.3333333333333
"27890","83069","2019",1121,255,866,247321.142729706,3670.2774308653,66.5539696699376
"27891","83070","2019",306,64,242,303938.153594771,5398.18954248366,54.1013071895425
"27892","83071","2019",318,146,172,268935.833333333,4577.44339622641,62.7232704402516
"27893","83072","2019",202,154,48,299046.589108911,2813.74752475248,105.732673267327
"27894","83073","2019",162,122,40,210686.290123457,2378.14197530864,88.2901234567901
"27895","83074","2019",7,7,0,211150,2431.14285714286,103.428571428571
"27896","83075","2019",3,3,0,283333.333333333,3211.33333333333,93.6666666666667
"27897","83076","2019",21,21,0,211748.095238095,2420.61904761905,87.8571428571429
"27898","83077","2019",36,31,5,290086.027777778,2580.88888888889,122.972222222222
"27899","83078","2019",9,9,0,248560,2446.66666666667,101
"27900","83079","2019",19,10,9,276797.368421053,3373.10526315789,82.1052631578947
"27901","83080","2019",25,19,6,209750.16,2260.64,87.56
"27902","83081","2019",141,113,28,350176.865248227,3534.94326241135,103.127659574468
"27903","83082","2019",7,4,3,111934.285714286,1539.71428571429,69.5714285714286
"27904","83083","2019",28,26,2,204988.928571429,2095.96428571429,99.6785714285714
"27905","83084","2019",10,10,0,211594,2062.5,98
"27906","83085","2019",64,52,12,274062.65625,3123.734375,92.328125
"27907","83086","2019",144,95,49,232277.875,2572.52777777778,85.6736111111111
"27908","83087","2019",76,63,13,278461.684210526,3020.51315789474,94.1447368421053
"27909","83088","2019",42,38,4,274457.547619048,2626.30952380952,104.595238095238
"27910","83089","2019",8,8,0,300093.75,2991.625,91.75
"27911","83090","2019",151,82,69,315739.768211921,3672.74834437086,84.3443708609272
"27912","83091","2019",5,4,1,254360,2234.2,112.8
"27913","83092","2019",65,53,12,196206.476923077,2216.63076923077,93.5846153846154
"27914","83093","2019",31,20,11,252893.419354839,2754.32258064516,97.3548387096774
"27915","83094","2019",73,53,20,399667.424657534,3961.02739726027,101.520547945205
"27916","83095","2019",13,13,0,162139.230769231,1821.23076923077,80.4615384615385
"27917","83096","2019",31,27,4,244961.225806452,3228.87096774194,75.9032258064516
"27918","83097","2019",55,49,6,322010.454545455,3316.16363636364,99.2181818181818
"27919","83098","2019",201,74,127,280491.218905473,3823.48756218905,73.5820895522388
"27920","83099","2019",116,70,46,302359.836206897,3211.02586206897,90.7068965517241
"27921","83100","2019",75,63,12,222144.853333333,2528.45333333333,87.2933333333333
"27922","83101","2019",41,30,11,1170125,9139.70731707317,118.341463414634
"27923","83102","2019",58,49,9,196420.862068966,2322.39655172414,87.1896551724138
"27924","83103","2019",41,36,5,316278.512195122,3463.0487804878,93.9756097560976
"27925","83104","2019",87,79,8,225454.32183908,2409.83908045977,96
"27926","83106","2019",90,76,14,254920.944444444,2819.81111111111,91.4555555555555
"27927","83107","2019",451,284,167,360965.070953437,4068.9933481153,87.1441241685144
"27928","83108","2019",49,40,9,208711.755102041,2555.02040816327,86.5714285714286
"27929","83109","2019",2,1,1,1e+05,2119.5,46
"27930","83110","2019",31,26,5,201339.096774194,2788.64516129032,78
"27931","83111","2019",40,38,2,233007.6,2635.05,95.925
"27932","83112","2019",316,103,213,337211.873417722,4978.48101265823,67.2278481012658
"27933","83113","2019",56,54,2,185070.625,2224.16071428571,84.5178571428571
"27934","83114","2019",5,5,0,181588,2346.4,73.4
"27935","83115","2019",490,146,344,372051.557142857,4987.35306122449,68.7
"27936","83116","2019",242,177,65,266790.103305785,2949.19834710744,91.5867768595041
"27937","83117","2019",28,21,7,245813.571428571,2631.71428571429,101.75
"27938","83118","2019",1350,295,1055,303465.858518519,4133.16518518518,70.6637037037037
"27939","83119","2019",129,22,107,585265.07751938,7771.61240310077,68.8837209302326
"27940","83120","2019",65,42,23,290745.615384615,3215.93846153846,90.4153846153846
"27941","83121","2019",60,46,14,246660.866666667,2683.1,95.1666666666667
"27942","83122","2019",9,5,4,157844.444444444,2217,67.6666666666667
"27943","83123","2019",527,165,362,342327.40227704,5034.03605313093,68.3396584440228
"27944","83124","2019",68,58,10,370513.411764706,3263.98529411765,112.147058823529
"27945","83125","2019",43,36,7,258013,2921.6511627907,88.6046511627907
"27946","83126","2019",1072,247,825,188866.439365672,3002.71082089552,64.5764925373134
"27947","83127","2019",42,34,8,262198.69047619,3198.14285714286,86.1904761904762
"27948","83128","2019",19,17,2,235487.736842105,2245.57894736842,97.3157894736842
"27949","83129","2019",897,301,596,272595.545150502,4308.76254180602,64.8528428093645
"27950","83130","2019",184,110,74,250490.184782609,2991.11956521739,83.4076086956522
"27951","83131","2019",85,75,10,322260.670588235,3260.35294117647,99.2235294117647
"27952","83132","2019",38,34,4,347986.315789474,3554.92105263158,98.8947368421053
"27953","83133","2019",15,14,1,650077.666666667,3735.66666666667,155.2
"27954","83134","2019",43,39,4,265296.651162791,2826.97674418605,96.4186046511628
"27955","83135","2019",33,31,2,153809.424242424,1863.54545454545,81.0909090909091
"27956","83136","2019",45,43,2,300558.711111111,2940.91111111111,105.622222222222
"27957","83137","2019",3108,489,2619,177173.714285714,2628.24806949807,65.782175032175
"27958","83138","2019",57,51,6,363982.280701754,3841.17543859649,95.4736842105263
"27959","83139","2019",21,18,3,322018.761904762,2694.28571428571,108.952380952381
"27960","83140","2019",78,64,14,235251.666666667,2688.48717948718,88.2051282051282
"27961","83141","2019",118,89,29,235211.56779661,2545.38983050847,91.9745762711864
"27962","83142","2019",2,2,0,197400,2360.5,91.5
"27963","83143","2019",76,70,6,243214.144736842,2466.63157894737,98.2105263157895
"27964","83144","2019",408,106,302,210976.286764706,2943.87254901961,72.4705882352941
"27965","83145","2019",26,21,5,141169.230769231,2172.65384615385,67.8461538461538
"27966","83146","2019",41,39,2,209547.804878049,2204.73170731707,95.9512195121951
"27967","83148","2019",205,170,35,249885.078048781,2786.82926829268,91.7609756097561
"27968","83149","2019",32,21,11,224312.90625,2347.28125,89.4375
"27969","83150","2019",54,43,11,220823.518518519,2568.33333333333,90.3148148148148
"27970","83151","2019",16,16,0,159364.0625,2015,78.25
"27971","83152","2019",22,14,8,609694.863636364,5678.68181818182,110
"27972","83153","2019",200,30,170,182490.03,3845.93,46.73
"27973","83154","2019",12,12,0,324809.583333333,2682,118.916666666667
"27974","84001","2019",27,17,10,217732.259259259,2646.44444444444,84.2962962962963
"27975","84002","2019",10,9,1,537531.5,3808,138.6
"27976","84003","2019",143,87,56,170600.132867133,1848.7972027972,88.6153846153846
"27977","84004","2019",70,61,9,204390.171428571,2326.38571428571,88.4714285714286
"27978","84005","2019",1,0,1,81000,1000,81
"27979","84006","2019",1,1,0,3e+05,3093,97
"27980","84007","2019",1595,431,1164,141853.102821317,2215.42257053292,66.2708463949843
"27981","84008","2019",7,7,0,454158.571428571,3898.28571428571,109.714285714286
"27982","84009","2019",35,32,3,216103.485714286,2423.57142857143,88.0857142857143
"27983","84010","2019",16,16,0,349920.5,3064.5,120.5625
"27984","84011","2019",7,7,0,508221.714285714,4542,125
"27985","84012","2019",36,32,4,240021.944444444,2343.86111111111,102.694444444444
"27986","84013","2019",8,5,3,276831.25,2937.625,87.375
"27987","84014","2019",18,17,1,225838,2234.55555555556,101.888888888889
"27988","84015","2019",3,3,0,259333.333333333,3467,77.6666666666667
"27989","84016","2019",71,63,8,174931.464788732,1940.9014084507,91.4366197183099
"27990","84017","2019",60,54,6,274131.316666667,3079.88333333333,95.7
"27991","84018","2019",6,6,0,275916.666666667,2663.66666666667,87.3333333333333
"27992","84019","2019",166,146,20,151034.246987952,1595.06626506024,93.7831325301205
"27993","84020","2019",19,19,0,672717.368421053,4825.42105263158,133.368421052632
"27994","84021","2019",2,2,0,244775,3485.5,70.5
"27995","84022","2019",4,4,0,741950,3901,145
"27996","84023","2019",1,1,0,420000,3818,110
"27997","84024","2019",18,18,0,263944.444444444,2919.33333333333,95.0555555555556
"27998","84025","2019",29,27,2,590830.517241379,3828.10344827586,135.206896551724
"27999","84026","2019",71,53,18,245862.577464789,2920.64788732394,82.887323943662
"28000","84027","2019",27,26,1,242560.703703704,2246.2962962963,109.740740740741
"28001","84028","2019",11,9,2,201882,2040.90909090909,101.272727272727
"28002","84029","2019",74,74,0,175178.27027027,1665.05405405405,105.878378378378
"28003","84030","2019",51,44,7,188326.745098039,2075.6862745098,93.7254901960784
"28004","84031","2019",387,233,154,160471.227390181,1826.23772609819,87.5607235142119
"28005","84032","2019",7,7,0,273971.428571429,2837,103
"28006","84033","2019",1,1,0,147850,1344,110
"28007","84034","2019",61,52,9,214509.131147541,2291.83606557377,98
"28008","84035","2019",337,180,157,191273.623145401,2256.40356083086,83.6112759643917
"28009","84036","2019",38,34,4,259342.657894737,2294.94736842105,109.473684210526
"28010","84037","2019",21,14,7,279904.095238095,2777.19047619048,95.3333333333333
"28011","84038","2019",30,27,3,299054.333333333,2919,105
"28012","84039","2019",68,55,13,193426.867647059,2180.67647058824,92.4264705882353
"28013","84040","2019",2,2,0,365000,3915.5,102
"28014","84041","2019",1,1,0,150000,2083,72
"28015","84042","2019",30,25,5,348682.666666667,3258,105.133333333333
"28016","84043","2019",96,68,28,203220,2390.41666666667,84.21875
"28017","84044","2019",18,17,1,216431.222222222,2755.5,85.8888888888889
"28018","84045","2019",7,7,0,207042.857142857,2602.42857142857,79.7142857142857
"28019","84046","2019",4,4,0,222200,2126,103.75
"28020","84047","2019",53,53,0,249291.169811321,2553.56603773585,95.4905660377358
"28021","84049","2019",7,6,1,292699.857142857,2400.28571428571,131.285714285714
"28022","84050","2019",38,37,1,760412.368421053,5254.1052631579,150.026315789474
"28023","84051","2019",19,18,1,663849.473684211,4128.8947368421,152.157894736842
"28024","84052","2019",12,11,1,291101,2851.58333333333,107
"28025","84053","2019",14,14,0,259085.714285714,1927.35714285714,136.285714285714
"28026","84054","2019",344,202,142,242071.331395349,2982.31976744186,80.3226744186046
"28027","84055","2019",18,18,0,222498.055555556,1970.77777777778,109.277777777778
"28028","84056","2019",54,45,9,186453.074074074,2058.92592592593,91.6666666666667
"28029","84057","2019",8,8,0,301340,2817.5,110.125
"28030","84058","2019",11,11,0,578100,4326.90909090909,129.545454545455
"28031","84059","2019",1,1,0,50000,1000,50
"28032","84061","2019",1,1,0,241000,2510,96
"28033","84062","2019",26,25,1,285814.923076923,2686.5,110.538461538462
"28034","84063","2019",5,5,0,278495,3066,99
"28035","84064","2019",44,38,6,153612.181818182,1714.25,97.9318181818182
"28036","84065","2019",66,61,5,257065,2844.45454545455,93.5757575757576
"28037","84066","2019",8,8,0,434100,4060.5,109.375
"28038","84067","2019",29,29,0,221757.24137931,2562.13793103448,89.8620689655172
"28039","84068","2019",28,24,4,390894.214285714,4324.67857142857,93.1071428571429
"28040","84069","2019",35,30,5,235151.657142857,2398.05714285714,98.5428571428571
"28041","84070","2019",34,34,0,195311.058823529,1718.85294117647,110.294117647059
"28042","84071","2019",22,19,3,306652.318181818,3071.36363636364,106.545454545455
"28043","84072","2019",71,67,4,273489.014084507,2432.50704225352,107.605633802817
"28044","84073","2019",19,18,1,503818.315789474,4335.84210526316,126.105263157895
"28045","84074","2019",35,35,0,286798,2907.42857142857,101.4
"28046","84075","2019",7,7,0,238260,2321,89.7142857142857
"28047","84076","2019",24,23,1,260205.541666667,2401.83333333333,108.5
"28048","84077","2019",6,6,0,198666.666666667,2421.66666666667,90.8333333333333
"28049","84078","2019",39,30,9,181212.307692308,1929.69230769231,93.7179487179487
"28050","84079","2019",6,5,1,165000,2834.16666666667,59.1666666666667
"28051","84080","2019",129,99,30,200164.550387597,2318.06201550388,86.6511627906977
"28052","84081","2019",121,101,20,230673.380165289,2535.57024793388,93.3471074380165
"28053","84082","2019",31,28,3,227945.935483871,2164.06451612903,93.258064516129
"28054","84083","2019",26,24,2,153175.923076923,1467.30769230769,100.615384615385
"28055","84084","2019",17,14,3,326294.117647059,3286.23529411765,104.764705882353
"28056","84085","2019",7,7,0,439521.428571429,2997.28571428571,166.428571428571
"28057","84086","2019",17,15,2,526835.588235294,4351.76470588235,125
"28058","84087","2019",400,255,145,174915.1375,1985.67,88.2925
"28059","84088","2019",126,115,11,303907.031746032,2755.3253968254,110.603174603175
"28060","84089","2019",339,185,154,221046.463126844,2784.05309734513,80.9941002949852
"28061","84090","2019",16,16,0,219014.3125,2338.9375,92.5
"28062","84091","2019",78,72,6,165025.948717949,1606.33333333333,101.076923076923
"28063","84092","2019",212,128,84,153325.825471698,1909.77358490566,81.3915094339623
"28064","84093","2019",9,9,0,394868.888888889,3255.44444444444,119.666666666667
"28065","84094","2019",12,12,0,218234.166666667,2246,92.4166666666667
"28066","84095","2019",15,15,0,415654.333333333,3860.66666666667,114.8
"28067","84096","2019",11,11,0,301263.909090909,2645.54545454545,108.181818181818
"28068","84097","2019",11,10,1,238169.090909091,2087.36363636364,116.454545454545
"28069","84098","2019",8,8,0,239850,2466.125,93
"28070","84099","2019",54,50,4,331343.481481481,3089.57407407407,111.962962962963
"28071","84101","2019",6,6,0,224800,1910,113.5
"28072","84102","2019",25,24,1,349687.68,3374.4,112.68
"28073","84103","2019",8,7,1,183048.375,2212.625,86.25
"28074","84104","2019",15,12,3,139522.933333333,1892.4,75.4
"28075","84105","2019",21,21,0,349500,3289.71428571429,109.238095238095
"28076","84106","2019",35,26,9,195117.142857143,2131.62857142857,95.3714285714286
"28077","84107","2019",14,14,0,145303.571428571,1650.71428571429,83.9285714285714
"28078","84108","2019",46,41,5,255807.586956522,2331.82608695652,106.173913043478
"28079","84109","2019",1,1,0,916452,4724,194
"28080","84110","2019",1,1,0,135000,2045,66
"28081","84111","2019",4,4,0,330500,3156.25,108.25
"28082","84112","2019",8,7,1,284071.25,2345.375,116.625
"28083","84113","2019",16,14,2,326835,2951.5625,105.6875
"28084","84114","2019",2,2,0,231000,2826.5,84.5
"28085","84115","2019",5,5,0,333660,2770.6,126.6
"28086","84116","2019",8,8,0,224975,1765.375,123.375
"28087","84117","2019",6,6,0,167266.666666667,1703,94.5
"28088","84118","2019",46,46,0,387195,3253.23913043478,122.54347826087
"28089","84119","2019",66,48,18,229913.636363636,2487.93939393939,91.4545454545455
"28090","84121","2019",2,1,1,329432.5,3268,101.5
"28091","84122","2019",61,57,4,198506.836065574,2120.13114754098,95.1475409836066
"28092","84123","2019",22,22,0,148954.636363636,1697.54545454545,84.7727272727273
"28093","84124","2019",13,12,1,413619.230769231,3856.23076923077,109.307692307692
"28094","84125","2019",1,1,0,1e+05,1818,55
"28095","84126","2019",10,10,0,275560,2173.6,145.6
"28096","84127","2019",36,35,1,245179.138888889,2339.44444444444,105.138888888889
"28097","84129","2019",229,145,84,155897.772925764,1838.05240174672,83.8558951965066
"28098","84130","2019",2,2,0,336095,3751.5,85
"28099","84131","2019",24,24,0,368490.791666667,2713.16666666667,136.25
"28100","84132","2019",99,82,17,253615.777777778,2536.36363636364,100.323232323232
"28101","84133","2019",58,45,13,258583.103448276,2662.74137931034,96.0689655172414
"28102","84134","2019",5,5,0,248100,2567.2,98.8
"28103","84135","2019",20,20,0,322689.3,2515.9,128.9
"28104","84136","2019",7,6,1,221434.571428571,1901.28571428571,114.285714285714
"28105","84137","2019",107,65,42,215678.61682243,2594.98130841121,83.5046728971963
"28106","84138","2019",120,94,26,155205.308333333,1807.25833333333,86.1333333333333
"28107","84139","2019",2,1,1,178375,2290.5,75.5
"28108","84140","2019",11,11,0,377909.545454545,2925.09090909091,134.545454545455
"28109","84141","2019",130,113,17,226185.323076923,2523.13846153846,91.8
"28110","84142","2019",29,28,1,295678.482758621,2769.41379310345,107.103448275862
"28111","84143","2019",17,15,2,263801.176470588,2449.58823529412,112.117647058824
"28112","84144","2019",19,15,4,201106.578947368,2401.10526315789,85.1052631578947
"28113","84145","2019",12,12,0,297719.25,2995.75,105
"28114","84146","2019",12,12,0,253347.5,2348.83333333333,109.25
"28115","84147","2019",59,33,26,238640.711864407,2945.37288135593,82.7796610169491
"28116","84148","2019",26,26,0,173587.692307692,2100.65384615385,84
"28117","84149","2019",20,20,0,130072.5,1703.9,83.85
"28118","84150","2019",18,15,3,199510.555555556,1857.05555555556,100.833333333333
"28119","84151","2019",4,4,0,226238.75,2187,100.5
"28120","85001","2019",151,142,9,155685.794701987,2222.30463576159,74.9271523178808
"28121","85002","2019",52,52,0,148302.596153846,1925.76923076923,76.5576923076923
"28122","85003","2019",136,133,3,174380.110294118,1866.85294117647,94.8823529411765
"28123","85004","2019",91,90,1,166029.362637363,1981.06593406593,88.3296703296703
"28124","85005","2019",13,13,0,114466.384615385,1087.38461538462,111.307692307692
"28125","85006","2019",40,40,0,141351.8,1677.55,90.3
"28126","85008","2019",70,70,0,200297.614285714,1881.01428571429,107.785714285714
"28127","85009","2019",9,9,0,124777.777777778,1266.77777777778,97.7777777777778
"28128","85010","2019",33,33,0,133490.909090909,1649.18181818182,88.2424242424242
"28129","85011","2019",61,59,2,228240.950819672,3102.77049180328,77.7213114754098
"28130","85012","2019",92,70,22,164262.706521739,2256.79347826087,76.8586956521739
"28131","85013","2019",12,12,0,125833.333333333,1383.16666666667,91.6666666666667
"28132","85014","2019",19,19,0,90525.2105263158,826.789473684211,112.421052631579
"28133","85015","2019",14,14,0,166613.571428571,1779.5,94.2142857142857
"28134","85016","2019",35,35,0,170050,1633.6,102.257142857143
"28135","85017","2019",14,14,0,159789.285714286,1737.85714285714,93.5
"28136","85018","2019",76,76,0,153714.605263158,1756.31578947368,91.0657894736842
"28137","85019","2019",75,74,1,169421.133333333,1745.69333333333,97.5866666666667
"28138","85020","2019",45,45,0,145951.222222222,1353.93333333333,109.711111111111
"28139","85021","2019",20,20,0,187051.65,1589.6,117.4
"28140","85022","2019",35,35,0,169480.714285714,1784,97.0285714285714
"28141","85023","2019",6,6,0,224166.666666667,1514,141.833333333333
"28142","85024","2019",33,33,0,151854.696969697,1718.69696969697,89.2424242424242
"28143","85025","2019",39,39,0,146334.487179487,1494.5641025641,97.5897435897436
"28144","85026","2019",18,18,0,160680.555555556,1554.05555555556,104.277777777778
"28145","85028","2019",7,7,0,127992.857142857,1072,116.857142857143
"28146","85029","2019",58,58,0,151606.137931034,1672.93103448276,89.3620689655172
"28147","85031","2019",40,40,0,115202.25,1210.175,98.725
"28148","85033","2019",9,9,0,99431,1080,89.4444444444444
"28149","85034","2019",36,36,0,124778.75,1201.41666666667,104.611111111111
"28150","85035","2019",216,174,42,191628.375,3133.88425925926,66.6481481481482
"28151","85036","2019",15,15,0,124762.2,1296.86666666667,97.7333333333333
"28152","85037","2019",14,14,0,63692.8571428571,680.285714285714,95.8571428571429
"28153","85038","2019",38,38,0,143308.657894737,1464.05263157895,98.7631578947368
"28154","85039","2019",55,51,4,142191.327272727,1555.76363636364,95.3272727272727
"28155","85040","2019",13,13,0,109640,956.538461538462,121.230769230769
"28156","85042","2019",35,33,2,125199.428571429,1206.97142857143,107.028571428571
"28157","85045","2019",33,33,0,156078.060606061,2088.09090909091,75.8787878787879
"28158","85046","2019",46,45,1,157727.456521739,1708.97826086957,95.0434782608696
"28159","85047","2019",379,294,85,193367.583113456,2102.66754617414,92.7150395778364
"28160","85049","2019",32,32,0,142458.34375,1468.125,94.9375
"28161","85050","2019",38,38,0,133463.421052632,1529.34210526316,89.1315789473684
"28162","85051","2019",137,118,19,127368.540145985,1338.13138686131,98.2116788321168
"28163","85053","2019",1,1,0,41000,569,72
"28164","85054","2019",22,22,0,150201.181818182,1614.54545454545,95.2727272727273
"28165","85055","2019",15,15,0,160700,1640.86666666667,102.4
"28166","85056","2019",9,9,0,114688.888888889,1187.22222222222,100.111111111111
"28167","85058","2019",9,9,0,208025,1603.44444444444,121.888888888889
"28168","85059","2019",39,39,0,108660.256410256,1082.23076923077,100.435897435897
"28169","85061","2019",21,21,0,120055.380952381,1270.7619047619,95.8571428571429
"28170","85062","2019",20,20,0,179750,1751.6,101.55
"28171","85064","2019",40,40,0,146783.3,1456.225,105.125
"28172","85065","2019",46,46,0,132021.130434783,1268.78260869565,104.130434782609
"28173","85066","2019",15,15,0,87068,1013.06666666667,90.2
"28174","85067","2019",9,9,0,123194.444444444,1145.22222222222,105
"28175","85070","2019",82,81,1,175566.109756098,1863.57317073171,94.5731707317073
"28176","85071","2019",70,70,0,164656.7,1878.62857142857,89.7
"28177","85072","2019",16,16,0,141650,1436.5,99.25
"28178","85073","2019",11,11,0,129090.909090909,1270.45454545455,104.818181818182
"28179","85074","2019",1,1,0,106800,2670,40
"28180","85076","2019",50,50,0,192774.9,2009.18,93.02
"28181","85077","2019",13,13,0,84000,951,85.2307692307692
"28182","85078","2019",12,12,0,107488.416666667,1579,84
"28183","85080","2019",20,20,0,120131.4,1116.55,113.6
"28184","85081","2019",48,48,0,165308.395833333,1678.5,97.9375
"28185","85082","2019",30,30,0,137139.6,1583.16666666667,88.1666666666667
"28186","85083","2019",43,43,0,278658.395348837,3831.6976744186,77.8139534883721
"28187","85084","2019",112,110,2,145494.035714286,1454.72321428571,100.741071428571
"28188","85086","2019",24,24,0,135922.916666667,1412.875,97.2083333333333
"28189","85087","2019",2,2,0,24250,404,60
"28190","85088","2019",82,78,4,230648.609756098,2466.80487804878,96.1463414634146
"28191","85089","2019",67,66,1,164866.820895522,1663.31343283582,100.776119402985
"28192","85090","2019",67,67,0,113640.776119403,1337.22388059701,87.7313432835821
"28193","85092","2019",236,200,36,115659.347457627,1199.30508474576,96.9025423728814
"28194","85093","2019",23,23,0,128810.304347826,1247,104.478260869565
"28195","85094","2019",14,14,0,81135,967.928571428571,91.7857142857143
"28196","85095","2019",39,39,0,141507.692307692,1687.89743589744,91.7179487179487
"28197","85096","2019",71,71,0,191224.521126761,1851.11267605634,101.352112676056
"28198","85097","2019",23,22,1,160691.304347826,1493.17391304348,107.782608695652
"28199","85098","2019",22,22,0,178998.636363636,1807.45454545455,101.909090909091
"28200","85099","2019",23,23,0,168026.434782609,1475.69565217391,109.086956521739
"28201","85100","2019",27,27,0,197787.962962963,2549.18518518519,81.9259259259259
"28202","85101","2019",10,10,0,153860,1608.9,94.6
"28203","85102","2019",8,8,0,134812.5,1535.125,92.25
"28204","85103","2019",41,41,0,182447.317073171,1722.51219512195,110.951219512195
"28205","85104","2019",32,32,0,160956.5625,1788.90625,96.1875
"28206","85105","2019",13,13,0,123346.153846154,1230.53846153846,103.615384615385
"28207","85106","2019",60,59,1,253220.916666667,3269.11666666667,80.6833333333333
"28208","85108","2019",32,29,3,126158.90625,1426.0625,91.625
"28209","85109","2019",194,171,23,162099.896907216,1830.03608247423,91.9020618556701
"28210","85110","2019",11,11,0,112136.363636364,1006.09090909091,113.454545454545
"28211","85111","2019",33,33,0,111190.96969697,1231.57575757576,94.8787878787879
"28212","85112","2019",39,39,0,225662.948717949,2181.35897435897,104.666666666667
"28213","85113","2019",118,115,3,350269.322033898,4095.5,90.1864406779661
"28214","85114","2019",163,131,32,194865.601226994,2865.19631901841,72.4049079754601
"28215","85115","2019",6,6,0,69000,900.333333333333,80.3333333333333
"28216","85116","2019",7,7,0,154271.428571429,1633.42857142857,97.2857142857143
"28217","85117","2019",10,10,0,164280.5,1389,117.2
"28218","85118","2019",41,41,0,180531.097560976,1805.53658536585,101.121951219512
"28219","85119","2019",24,23,1,137125.875,1369.29166666667,99.5
"28220","85120","2019",29,29,0,192401.034482759,2338.86206896552,89.5172413793103
"28221","85121","2019",16,16,0,110912.5,1094.6875,110.25
"28222","85123","2019",3,3,0,90100,1006.66666666667,88.6666666666667
"28223","85125","2019",11,11,0,130636.363636364,1172.18181818182,116
"28224","85126","2019",13,13,0,130730.769230769,1279,104.692307692308
"28225","85127","2019",114,104,10,168549.877192982,2414.88596491228,74.7280701754386
"28226","85128","2019",177,152,25,127915.858757062,1465.24858757062,89.5988700564972
"28227","85129","2019",32,32,0,145690.625,1424.78125,102.59375
"28228","85130","2019",19,18,1,147272.631578947,1457.63157894737,104.157894736842
"28229","85131","2019",19,19,0,134284.210526316,1296.26315789474,103.842105263158
"28230","85132","2019",14,14,0,95667.9285714286,1009.57142857143,103.714285714286
"28231","85133","2019",21,21,0,118504.666666667,1295.80952380952,110.52380952381
"28232","85134","2019",7,7,0,120357.142857143,1297.71428571429,96
"28233","85135","2019",44,44,0,117988.863636364,1263.45454545455,95.0227272727273
"28234","85136","2019",1,1,0,124100,1128,110
"28235","85137","2019",9,9,0,115888.888888889,984.111111111111,118.222222222222
"28236","85138","2019",16,16,0,147883.125,1549.8125,95.0625
"28237","85139","2019",10,10,0,113050,1149.9,97.2
"28238","85140","2019",13,13,0,81346.1538461538,918.846153846154,85.5384615384615
"28239","85141","2019",7,7,0,92428.5714285714,928,101
"28240","85142","2019",18,18,0,218727.777777778,1669.61111111111,121.777777777778
"28241","85143","2019",22,22,0,109361.363636364,1183.68181818182,93.4545454545455
"28242","85144","2019",17,17,0,134361.764705882,1523.23529411765,87.8823529411765
"28243","85145","2019",10,10,0,137900,970.5,129.4
"28244","85146","2019",228,202,26,175310.75877193,1932.54824561404,91.8026315789474
"28245","85147","2019",25,25,0,113976,1105.8,101.76
"28246","85148","2019",5,5,0,125048,1195,106
"28247","85149","2019",5,5,0,142840,1282.8,111.2
"28248","85151","2019",57,55,2,158674.122807018,1544.9649122807,105.421052631579
"28249","85152","2019",80,79,1,180015.625,1869.8125,98.5
"28250","85153","2019",25,25,0,147609.44,1437.88,104.84
"28251","85154","2019",31,31,0,101435.451612903,1148.1935483871,91.7096774193548
"28252","85155","2019",75,75,0,221878.333333333,2044.66666666667,108.6
"28253","85156","2019",36,36,0,169848.861111111,1706.52777777778,102.583333333333
"28254","85157","2019",12,12,0,129458.333333333,1162.08333333333,116.416666666667
"28255","85158","2019",14,14,0,124642.857142857,1378.35714285714,93.2857142857143
"28256","85159","2019",29,29,0,128551.034482759,1203,107.862068965517
"28257","85160","2019",45,43,2,173751.4,1567.2,109.822222222222
"28258","85161","2019",39,39,0,136398.153846154,1462.02564102564,94.5641025641026
"28259","85162","2019",26,26,0,141432.615384615,1188,125.346153846154
"28260","85163","2019",168,140,28,321525.333333333,3928.07142857143,83.3630952380952
"28261","85164","2019",119,68,51,142605.890756303,2712.57983193277,58.2857142857143
"28262","85167","2019",13,13,0,145484.615384615,1406,102.076923076923
"28263","85169","2019",14,14,0,113214.285714286,1344.64285714286,87.1428571428571
"28264","85171","2019",8,8,0,96437.5,1023.875,95.75
"28265","85172","2019",31,31,0,159936.290322581,1757.09677419355,94.8064516129032
"28266","85174","2019",9,9,0,120922.222222222,1164.88888888889,108.444444444444
"28267","85175","2019",11,11,0,121590.909090909,1210.45454545455,100.090909090909
"28268","85176","2019",10,10,0,121020,1136.4,105
"28269","85177","2019",31,31,0,127920.967741935,1083.70967741935,119.032258064516
"28270","85178","2019",81,81,0,180745.493827161,1742.13580246914,104.308641975309
"28271","85179","2019",33,31,2,161940.696969697,1586.09090909091,104.484848484848
"28272","85181","2019",5,5,0,125600,978.8,141
"28273","85182","2019",75,73,2,111031.373333333,1115.66666666667,100.306666666667
"28274","85184","2019",8,8,0,75625,833.75,88.875
"28275","85185","2019",18,18,0,142356.944444444,1480,99.2777777777778
"28276","85186","2019",15,15,0,137527.933333333,1514.53333333333,94.2666666666667
"28277","85187","2019",12,12,0,97583.3333333333,1003.75,95.8333333333333
"28278","85188","2019",11,11,0,110765.454545455,975.181818181818,106.636363636364
"28279","85189","2019",32,32,0,198538.21875,2079.65625,92.875
"28280","85190","2019",51,47,4,172884.588235294,1735.76470588235,100.960784313725
"28281","85191","2019",1018,539,479,136351.995088409,1817.49410609037,76.5599214145383
"28282","85192","2019",7,7,0,117142.857142857,1231.28571428571,93.7142857142857
"28283","85193","2019",11,11,0,113172.727272727,1147.27272727273,98.1818181818182
"28284","85194","2019",1561,918,643,237320.588084561,3323.63292761051,74.1832158872518
"28285","85196","2019",26,26,0,131958.576923077,1352.19230769231,105.346153846154
"28286","85197","2019",53,53,0,174603.20754717,1622.22641509434,110.150943396226
"28287","85198","2019",19,19,0,130432.578947368,1337.84210526316,96.8947368421053
"28288","85199","2019",13,13,0,145684.615384615,1199.46153846154,117.769230769231
"28289","85200","2019",26,26,0,142388.461538462,1504.69230769231,96.1923076923077
"28290","85201","2019",12,12,0,119694,1310.58333333333,95
"28291","85202","2019",15,15,0,123642.4,1097.13333333333,109.266666666667
"28292","85204","2019",41,41,0,146569.12195122,1548.65853658537,96.5121951219512
"28293","85205","2019",7,7,0,110959.285714286,1042.42857142857,107.142857142857
"28294","85206","2019",10,10,0,72892,1080.2,69.1
"28295","85207","2019",10,10,0,122031,1231.9,98.6
"28296","85208","2019",22,22,0,154146.818181818,1560.72727272727,100
"28297","85209","2019",14,14,0,123031.428571429,1156.78571428571,110.285714285714
"28298","85210","2019",48,48,0,127538.75,1377.89583333333,92.9375
"28299","85211","2019",41,41,0,156407.317073171,1642.92682926829,94.7073170731707
"28300","85213","2019",56,55,1,151414.25,1454.55357142857,104.125
"28301","85214","2019",43,43,0,250771.860465116,2283.6511627907,110.46511627907
"28302","85215","2019",26,26,0,141650,1635.57692307692,86.5384615384615
"28303","85216","2019",24,24,0,164636.25,1629.875,101.791666666667
"28304","85218","2019",38,38,0,175003.947368421,1825,98.9473684210526
"28305","85220","2019",14,14,0,118218.571428571,1292.92857142857,91.3571428571429
"28306","85221","2019",43,43,0,154742.790697674,1660.76744186047,97.5813953488372
"28307","85222","2019",276,166,110,238469.032608696,3509.23913043478,71.4963768115942
"28308","85223","2019",47,46,1,111987.510638298,1066.44680851064,108.042553191489
"28309","85226","2019",589,300,289,153506.492359932,2572.30050933786,59.9796264855688
"28310","85227","2019",36,36,0,142247.611111111,1208.25,112.666666666667
"28311","85229","2019",13,13,0,93870.9230769231,883.615384615385,103.769230769231
"28312","85231","2019",13,13,0,157675.153846154,1732.46153846154,90.6923076923077
"28313","85232","2019",14,14,0,169592.857142857,1349.5,126.214285714286
"28314","85233","2019",8,8,0,142328.375,1417.75,102.125
"28315","85234","2019",559,232,327,145972.515205725,2528.10017889088,59.3488372093023
"28316","85235","2019",12,12,0,115708.333333333,980.833333333333,116.833333333333
"28317","85236","2019",8,8,0,226147.5,1765.875,131.75
"28318","85237","2019",8,8,0,123612.5,1081.375,111
"28319","85238","2019",34,33,1,158663.352941176,1561.91176470588,103.764705882353
"28320","85239","2019",26,26,0,163360.769230769,1750.92307692308,93.5384615384615
"28321","85240","2019",18,18,0,158056.111111111,1593.44444444444,100.277777777778
"28322","85242","2019",9,9,0,125500,1594.66666666667,82
"28323","85243","2019",87,87,0,203503.988505747,2388.2183908046,88.6896551724138
"28324","85244","2019",5,5,0,117500,1245.6,94.4
"28325","85245","2019",3,3,0,110333.333333333,1010.66666666667,113.666666666667
"28326","85246","2019",29,29,0,128493.793103448,1290.96551724138,97.1034482758621
"28327","85247","2019",8,8,0,151562.5,1463.375,103.5
"28328","85248","2019",4,4,0,88875,1090,88.5
"28329","85250","2019",47,47,0,209301.914893617,2149.27659574468,100.170212765957
"28330","85251","2019",9,9,0,118800,1157.33333333333,98.8888888888889
"28331","85252","2019",16,16,0,105250.0625,1012.1875,104
"28332","85254","2019",27,27,0,114729.62962963,1087.33333333333,103.814814814815
"28333","85255","2019",69,69,0,147666.811594203,1602.24637681159,97.8115942028985
"28334","85256","2019",18,18,0,125555.555555556,1181.33333333333,110.388888888889
"28335","85259","2019",11,10,1,139186.181818182,1308,102.454545454545
"28336","85260","2019",12,12,0,164575.916666667,1419.83333333333,116.583333333333
"28337","85261","2019",3,3,0,127666.666666667,1267.33333333333,105.666666666667
"28338","85262","2019",57,51,6,166234.035087719,1793.9649122807,94.6666666666667
"28339","85264","2019",16,16,0,112337.5,967.0625,123.9375
"28340","85265","2019",6,6,0,121943.333333333,1140.83333333333,103.666666666667
"28341","85266","2019",18,18,0,119807.222222222,1181.55555555556,98.8888888888889
"28342","85267","2019",15,15,0,130213.333333333,1255.46666666667,105.533333333333
"28343","85268","2019",20,20,0,180127,1899.55,97
"28344","85269","2019",4,4,0,103000,1070.5,93
"28345","85271","2019",5,5,0,127400,1105,125
"28346","85273","2019",30,30,0,169046.666666667,1795.86666666667,99.2
"28347","85274","2019",9,9,0,103666.666666667,1091.88888888889,105.444444444444
"28348","85276","2019",14,14,0,98442.8571428571,969.071428571429,98.8571428571429
"28349","85277","2019",25,25,0,153760,1632.16,103.24
"28350","85278","2019",92,78,14,169199.945652174,2831.92391304348,69.1847826086957
"28351","85280","2019",35,35,0,165240.571428571,1957.02857142857,90.9428571428571
"28352","85281","2019",15,15,0,120247.266666667,1153.46666666667,108.666666666667
"28353","85282","2019",8,8,0,113270.625,1116.625,96.5
"28354","85284","2019",74,74,0,181786.135135135,1994.32432432432,95.2162162162162
"28355","85285","2019",16,16,0,128262.5,1393.8125,91.125
"28356","85286","2019",10,10,0,103600,980.3,105
"28357","85287","2019",12,12,0,105237.5,1045.66666666667,106.583333333333
"28358","85288","2019",298,215,83,190048.781879195,2469.87583892617,78.003355704698
"28359","85289","2019",15,15,0,119220,1251.86666666667,103.666666666667
"28360","85290","2019",7,7,0,110321.428571429,996.285714285714,120.285714285714
"28361","85291","2019",28,25,3,123107.142857143,1209.75,102.678571428571
"28362","85292","2019",14,14,0,119365.357142857,1046.42857142857,113.5
"28363","85293","2019",17,17,0,150017.647058824,1465.41176470588,105.705882352941
"28364","85294","2019",207,178,29,176985.77294686,2926.18357487923,65.0628019323672
"28365","85295","2019",30,30,0,166164.966666667,1508.53333333333,109.9
"28366","85296","2019",13,13,0,128830.769230769,1191.92307692308,112.846153846154
"28367","85297","2019",28,27,1,103133.571428571,1183.64285714286,89.5357142857143
"28368","85298","2019",45,45,0,173468.422222222,1936.62222222222,90.2222222222222
"28369","85300","2019",57,57,0,186317.210526316,1729.21052631579,109.456140350877
"28370","85301","2019",10,10,0,135600,1263.3,113.3
"28371","85302","2019",58,57,1,156963.275862069,1558.06896551724,103.241379310345
"28372","85303","2019",22,22,0,130971.363636364,1147.72727272727,118.5
"28373","85304","2019",10,10,0,119370,1393.6,90.9
"28374","85305","2019",19,18,1,133989.421052632,1175.05263157895,114.157894736842
"28375","85306","2019",7,7,0,106571.428571429,908.857142857143,120.428571428571
"28376","86001","2019",7,7,0,67642.8571428571,781.714285714286,87.7142857142857
"28377","86002","2019",8,8,0,111237.5,1062,111.25
"28378","86003","2019",4,4,0,100125,992.25,100.75
"28379","86004","2019",6,6,0,87416.6666666667,978,93.8333333333333
"28380","86005","2019",9,9,0,72388.8888888889,715.333333333333,107
"28381","86006","2019",8,8,0,86675,743,112
"28382","86007","2019",14,14,0,155750,1403.92857142857,112.357142857143
"28383","86008","2019",4,4,0,88250,591.25,154
"28384","86009","2019",19,19,0,99007.8947368421,1038.36842105263,95.7368421052632
"28385","86010","2019",12,12,0,158453.333333333,1415.58333333333,119
"28386","86011","2019",2,2,0,59380,698.5,85
"28387","86012","2019",2,2,0,3e+05,1029.5,218.5
"28388","86014","2019",26,24,2,129615.384615385,1362.73076923077,94.9230769230769
"28389","86015","2019",22,21,1,105901.590909091,1029.86363636364,105.5
"28390","86016","2019",37,37,0,167003.162162162,1640.94594594595,105.594594594595
"28391","86017","2019",17,17,0,129226.647058824,1023.23529411765,127.588235294118
"28392","86018","2019",3,3,0,92666.6666666667,920.666666666667,103.333333333333
"28393","86019","2019",26,26,0,146573.076923077,1385.65384615385,106.846153846154
"28394","86020","2019",1,1,0,2e+05,1681,119
"28395","86022","2019",2,2,0,90500,810.5,119.5
"28396","86024","2019",21,21,0,178020.952380952,1590.7619047619,110.904761904762
"28397","86025","2019",3,3,0,75333.3333333333,827.333333333333,88
"28398","86026","2019",2,2,0,53500,712.5,73
"28399","86027","2019",27,27,0,199194.444444444,2015.92592592593,106.037037037037
"28400","86028","2019",13,13,0,172569.230769231,1704.23076923077,103.076923076923
"28401","86029","2019",17,17,0,77482.0588235294,953.176470588235,81.3529411764706
"28402","86031","2019",20,20,0,135837,1347.05,98
"28403","86032","2019",22,22,0,127697.909090909,1435.77272727273,91.4545454545455
"28404","86034","2019",9,9,0,72655.5555555556,817,92.6666666666667
"28405","86035","2019",3,3,0,37666.6666666667,522,70
"28406","86036","2019",7,7,0,137361.428571429,1589.14285714286,92.5714285714286
"28407","86037","2019",4,4,0,79032.5,675,102.25
"28408","86038","2019",1,1,0,48000,417,115
"28409","86039","2019",12,12,0,59313.5,654.083333333333,90.1666666666667
"28410","86040","2019",3,3,0,106333.333333333,1075.66666666667,102.333333333333
"28411","86041","2019",183,117,66,132421.808743169,1650.79781420765,79.7486338797814
"28412","86042","2019",11,11,0,78667.7272727273,970.545454545455,80.5454545454545
"28413","86044","2019",9,9,0,123883.333333333,1064.44444444444,117.333333333333
"28414","86045","2019",19,19,0,146392.105263158,1047.78947368421,135.789473684211
"28415","86046","2019",13,13,0,104461.538461538,1319.84615384615,78.3076923076923
"28416","86047","2019",3,3,0,107000,1236.66666666667,85.3333333333333
"28417","86048","2019",15,15,0,177457.133333333,1584.26666666667,111.866666666667
"28418","86049","2019",6,6,0,122666.666666667,1085.5,112.833333333333
"28419","86050","2019",5,5,0,82200,1032.6,81.2
"28420","86051","2019",3,3,0,130119.333333333,762,175.666666666667
"28421","86052","2019",16,16,0,89067.1875,991.6875,92.125
"28422","86053","2019",28,28,0,139567.857142857,1293.92857142857,110.285714285714
"28423","86054","2019",10,10,0,79149,687.9,115.2
"28424","86055","2019",8,8,0,105363.125,822.875,139.625
"28425","86058","2019",8,8,0,95355.625,1340.625,75.25
"28426","86059","2019",2,2,0,132000,1454,94
"28427","86061","2019",17,17,0,95335.8235294118,874.470588235294,109.294117647059
"28428","86062","2019",58,49,9,134109.465517241,1760.01724137931,82.4827586206897
"28429","86063","2019",3,3,0,143666.666666667,1289.66666666667,117
"28430","86064","2019",8,8,0,75345,635,120.5
"28431","86065","2019",10,10,0,141017,1314.6,118.8
"28432","86066","2019",451,374,77,102953.317073171,1212.64966740577,86.4013303769401
"28433","86068","2019",9,9,0,95555.5555555556,1097.33333333333,92.7777777777778
"28434","86069","2019",2,2,0,57250,658.5,82.5
"28435","86070","2019",93,89,4,125987.129032258,1275.62365591398,96.3655913978495
"28436","86072","2019",5,5,0,101000,1305,80.8
"28437","86073","2019",4,4,0,145000,1202.5,119.5
"28438","86074","2019",12,12,0,141816.666666667,1334.83333333333,103.25
"28439","86075","2019",9,9,0,98988.8888888889,963.555555555556,103.666666666667
"28440","86076","2019",36,36,0,168219.805555556,1568.58333333333,108.333333333333
"28441","86077","2019",13,13,0,95230.9230769231,1099.61538461538,94.8461538461538
"28442","86078","2019",45,44,1,100097.844444444,939.711111111111,104.822222222222
"28443","86079","2019",5,5,0,84616,797.6,103
"28444","86080","2019",5,5,0,134000,1207.4,118.6
"28445","86081","2019",10,10,0,119700,1263.3,91
"28446","86082","2019",52,51,1,90616.8076923077,935.442307692308,98.4038461538462
"28447","86083","2019",16,16,0,145388.9375,1500,101.5625
"28448","86084","2019",2,2,0,41400,490.5,84
"28449","86085","2019",7,7,0,107285.714285714,1015.28571428571,115.285714285714
"28450","86086","2019",4,4,0,70125,952.75,74
"28451","86087","2019",2,2,0,68000,557.5,121.5
"28452","86088","2019",10,8,2,161320,1701.6,93.5
"28453","86089","2019",6,6,0,109083.333333333,1118.5,100.833333333333
"28454","86090","2019",2,2,0,66464.5,752,87.5
"28455","86091","2019",8,8,0,75125,713.125,102.375
"28456","86092","2019",40,39,1,108747.25,1095.175,99.475
"28457","86094","2019",3,3,0,204216.666666667,1440.33333333333,144.666666666667
"28458","86095","2019",46,46,0,160882.086956522,1564.41304347826,105.695652173913
"28459","86096","2019",9,9,0,135000,1114.44444444444,120.333333333333
"28460","86097","2019",3,3,0,107220,762,144.666666666667
"28461","86098","2019",4,4,0,131750,1223.25,110.25
"28462","86099","2019",9,9,0,145044.444444444,1473.88888888889,95.4444444444444
"28463","86100","2019",52,46,6,178799.673076923,1776.59615384615,101.269230769231
"28464","86102","2019",7,7,0,153000,1406.28571428571,109.714285714286
"28465","86103","2019",22,22,0,97463.6363636364,1126.54545454545,85.9090909090909
"28466","86104","2019",11,11,0,91494.0909090909,860.181818181818,110.545454545455
"28467","86105","2019",8,8,0,101000,1144.25,87.625
"28468","86106","2019",2,2,0,112485,1015,111
"28469","86107","2019",8,8,0,52562.5,772.375,66
"28470","86108","2019",9,9,0,125833.333333333,1000.77777777778,127.333333333333
"28471","86109","2019",6,6,0,97357.1666666667,890.333333333333,107.333333333333
"28472","86110","2019",3,3,0,103333.333333333,884.333333333333,102.666666666667
"28473","86111","2019",18,18,0,118311.111111111,1249.72222222222,91.2777777777778
"28474","86112","2019",14,14,0,74667.1428571429,979,77.5
"28475","86113","2019",29,29,0,146365.517241379,1475,104.103448275862
"28476","86114","2019",9,9,0,162503.777777778,1550.22222222222,110.222222222222
"28477","86115","2019",90,79,11,141404.377777778,1617.64444444444,93
"28478","86116","2019",11,11,0,104863.636363636,1056.27272727273,105.272727272727
"28479","86117","2019",4,4,0,108500,1119.75,91.5
"28480","86118","2019",6,6,0,116666.666666667,829.666666666667,144.833333333333
"28481","86119","2019",7,7,0,71007.8571428571,805.428571428571,93
"28482","86120","2019",15,15,0,115333,1056.53333333333,108.2
"28483","86121","2019",18,18,0,93702.7777777778,911.5,101.111111111111
"28484","86123","2019",43,43,0,136078.302325581,1273.09302325581,109.720930232558
"28485","86124","2019",12,12,0,161148.333333333,1459.33333333333,115.833333333333
"28486","86125","2019",7,7,0,133092.857142857,1228.57142857143,109
"28487","86126","2019",8,8,0,111075,1500.5,88.75
"28488","86127","2019",3,3,0,82150.6666666667,697.333333333333,122.333333333333
"28489","86128","2019",21,21,0,109857.142857143,1202,91.3809523809524
"28490","86129","2019",7,7,0,107428.571428571,936.142857142857,113
"28491","86130","2019",2,2,0,83000,809,102
"28492","86131","2019",11,11,0,100813.636363636,969.636363636364,103.727272727273
"28493","86132","2019",4,4,0,40980.5,508.25,82.75
"28494","86133","2019",49,48,1,172803.897959184,1711.59183673469,106.428571428571
"28495","86134","2019",10,10,0,108152,836.7,135.8
"28496","86135","2019",5,4,1,179190,1884.6,100.4
"28497","86136","2019",4,4,0,97500,1129.25,84.75
"28498","86137","2019",91,84,7,102606.043956044,1056.18681318681,98.5494505494506
"28499","86138","2019",2,2,0,81750,742,117.5
"28500","86139","2019",38,38,0,116852.631578947,1168.94736842105,101.973684210526
"28501","86140","2019",22,21,1,89042.7272727273,900.590909090909,98.3181818181818
"28502","86141","2019",13,13,0,102538.461538462,1020.38461538462,97.7692307692308
"28503","86142","2019",8,8,0,119066.25,1010.375,125.625
"28504","86143","2019",1,1,0,45500,910,50
"28505","86144","2019",4,4,0,92500,1038.25,92.5
"28506","86145","2019",27,27,0,133509.62962963,1256.92592592593,106.444444444444
"28507","86147","2019",7,7,0,94214.2857142857,1400,71.7142857142857
"28508","86148","2019",6,6,0,109583.333333333,1229.33333333333,91.5
"28509","86149","2019",7,7,0,73400,656.714285714286,104.428571428571
"28510","86150","2019",5,5,0,96200,1086.2,87.2
"28511","86151","2019",2,2,0,119500,947,127.5
"28512","86152","2019",10,10,0,68296,1009.2,73.1
"28513","86153","2019",9,9,0,122106.666666667,1131.33333333333,110.222222222222
"28514","86154","2019",1,1,0,110000,982,112
"28515","86156","2019",1,1,0,210000,1364,154
"28516","86157","2019",45,38,7,181071.4,1992,91.5333333333333
"28517","86158","2019",75,75,0,182404.266666667,1658.6,112.226666666667
"28518","86159","2019",8,8,0,82687.5,798.75,116.5
"28519","86160","2019",18,17,1,80928.1666666667,889.277777777778,99.8888888888889
"28520","86161","2019",12,12,0,72847.5,953.333333333333,88.8333333333333
"28521","86162","2019",1,1,0,185000,1888,98
"28522","86163","2019",36,36,0,209859.5,1785.97222222222,117.111111111111
"28523","86164","2019",7,7,0,89428.5714285714,1213.71428571429,81.4285714285714
"28524","86165","2019",69,68,1,125988.115942029,1252.65217391304,98.5942028985507
"28525","86167","2019",5,4,1,122400,1150.8,99
"28526","86169","2019",5,5,0,118300,1094.8,108.4
"28527","86170","2019",4,4,0,110375,1046.25,99.25
"28528","86171","2019",2,2,0,62125,501,121
"28529","86173","2019",6,6,0,97750,1000.66666666667,108.833333333333
"28530","86174","2019",71,71,0,122106.056338028,1351.60563380282,91.4788732394366
"28531","86175","2019",2,2,0,50000,620.5,83.5
"28532","86176","2019",1,1,0,105000,972,108
"28533","86177","2019",98,80,18,155522.040816327,1606.68367346939,99.3775510204082
"28534","86178","2019",22,22,0,165146.136363636,1587.36363636364,106.818181818182
"28535","86180","2019",11,10,1,136430.909090909,1349.81818181818,106.181818181818
"28536","86182","2019",7,7,0,100114.285714286,849.857142857143,118.285714285714
"28537","86183","2019",17,17,0,129457.058823529,1227.05882352941,108
"28538","86184","2019",4,4,0,173005,1441.25,124.25
"28539","86186","2019",10,10,0,124946.8,1083.2,112
"28540","86187","2019",6,6,0,167962.666666667,1226.16666666667,136.833333333333
"28541","86189","2019",5,5,0,55500,588.6,98
"28542","86190","2019",12,12,0,83375,932.916666666667,92.8333333333333
"28543","86191","2019",3,3,0,124966.666666667,820,151.333333333333
"28544","86192","2019",3,3,0,150000,1160,126
"28545","86193","2019",14,14,0,64532.1428571429,985.928571428571,70.6428571428571
"28546","86194","2019",1630,596,1034,120001.009202454,1804.5245398773,69.0576687116564
"28547","86195","2019",4,4,0,114000,1043,107
"28548","86196","2019",2,2,0,36000,687.5,48.5
"28549","86197","2019",9,9,0,140938.888888889,992,135.444444444444
"28550","86198","2019",6,6,0,106083.333333333,1169.5,83.1666666666667
"28551","86200","2019",8,8,0,87423.75,1041,81.75
"28552","86201","2019",5,5,0,205600,1479.4,123.6
"28553","86202","2019",4,4,0,227750,1447.75,138.25
"28554","86203","2019",10,10,0,61770,935.3,73.9
"28555","86204","2019",26,26,0,187311.538461538,1564,123.538461538462
"28556","86205","2019",2,2,0,59500,716.5,80.5
"28557","86207","2019",45,34,11,109609.688888889,1360.31111111111,89.1111111111111
"28558","86209","2019",22,21,1,154800,1682.54545454545,92.9545454545455
"28559","86210","2019",8,8,0,119650,1212.625,110.375
"28560","86211","2019",14,14,0,78373.5714285714,722.142857142857,110.428571428571
"28561","86213","2019",38,38,0,96121.4736842105,1080.63157894737,89.8947368421053
"28562","86214","2019",104,78,26,164635.336538462,1924.51923076923,87.6730769230769
"28563","86217","2019",3,3,0,103333.333333333,1073.33333333333,94.3333333333333
"28564","86218","2019",9,9,0,92139.3333333333,787,113
"28565","86220","2019",2,2,0,1e+05,1104.5,90.5
"28566","86221","2019",14,14,0,100857.142857143,999.214285714286,103.142857142857
"28567","86222","2019",55,54,1,163867.490909091,1683,96.8
"28568","86223","2019",12,12,0,62286.0833333333,728.916666666667,93.0833333333333
"28569","86224","2019",20,20,0,128835.25,1109.15,117.45
"28570","86225","2019",22,22,0,114197.545454545,1119.27272727273,101.181818181818
"28571","86226","2019",27,27,0,164070.37037037,1475.77777777778,113.740740740741
"28572","86227","2019",2,2,0,70500,800,80.5
"28573","86228","2019",1,1,0,121000,1260,96
"28574","86229","2019",6,6,0,106070.333333333,862.833333333333,132.166666666667
"28575","86230","2019",1,1,0,18000,340,53
"28576","86231","2019",4,4,0,197725,1433.25,143.75
"28577","86233","2019",37,37,0,109794.405405405,1277.94594594595,84.8108108108108
"28578","86234","2019",8,8,0,79585.75,901.25,90.375
"28579","86235","2019",12,12,0,123658.333333333,1229.5,99
"28580","86236","2019",16,16,0,65632.0625,865.3125,85.5625
"28581","86237","2019",4,4,0,117900,942.5,126.25
"28582","86239","2019",4,4,0,106300,1078.75,96.5
"28583","86241","2019",5,5,0,120300,1306.8,90.8
"28584","86242","2019",10,10,0,81245,998.5,84.1
"28585","86244","2019",20,20,0,85118.95,760.4,109.55
"28586","86245","2019",17,17,0,147521,1314.70588235294,115.411764705882
"28587","86246","2019",12,12,0,73616.6666666667,888.5,88.1666666666667
"28588","86247","2019",5,5,0,86800,828.2,96.4
"28589","86248","2019",11,11,0,99772.7272727273,910.818181818182,100.272727272727
"28590","86249","2019",1,1,0,60000,659,91
"28591","86250","2019",4,4,0,121500,1073.25,117.5
"28592","86252","2019",9,9,0,106498.888888889,1020.55555555556,109
"28593","86253","2019",11,11,0,74863.6363636364,851.636363636364,88.0909090909091
"28594","86254","2019",13,13,0,110546.153846154,1114.38461538462,95.4615384615385
"28595","86255","2019",12,12,0,82840,929.5,88.1666666666667
"28596","86256","2019",13,13,0,152784.615384615,1479.61538461538,103.076923076923
"28597","86257","2019",5,5,0,88000,1066,84
"28598","86258","2019",25,25,0,113841.6,1139.2,103.88
"28599","86260","2019",5,5,0,130510,1031.2,128.2
"28600","86261","2019",17,17,0,213900,1867.23529411765,114.529411764706
"28601","86262","2019",4,4,0,134675,922.5,135.75
"28602","86263","2019",29,29,0,174328.965517241,1764.44827586207,103.103448275862
"28603","86264","2019",6,6,0,141544.333333333,1165.33333333333,118.166666666667
"28604","86265","2019",12,12,0,103500,963.166666666667,115.166666666667
"28605","86266","2019",5,5,0,125768,1074.2,116.2
"28606","86268","2019",26,26,0,145393.884615385,1427.26923076923,101.730769230769
"28607","86270","2019",4,4,0,57260,832,68.25
"28608","86271","2019",10,10,0,112550,1007.9,106.3
"28609","86272","2019",25,25,0,134235.6,1224.84,110.68
"28610","86273","2019",12,12,0,56541.6666666667,680.333333333333,78.6666666666667
"28611","86274","2019",17,17,0,111114.705882353,1047.23529411765,103.647058823529
"28612","86275","2019",8,8,0,107012.5,1025.125,105.375
"28613","86276","2019",11,11,0,93840.9090909091,907.181818181818,95
"28614","86279","2019",3,3,0,116133.333333333,1136,101.333333333333
"28615","86280","2019",4,4,0,139975,1011,116
"28616","86281","2019",73,73,0,157729.424657534,1423.46575342466,114.561643835616
"28617","86284","2019",7,7,0,160122.857142857,1420.71428571429,112.714285714286
"28618","86285","2019",9,9,0,114971.111111111,1346.77777777778,91.2222222222222
"28619","86286","2019",7,7,0,132542.857142857,1074.71428571429,122.714285714286
"28620","86287","2019",2,2,0,75250,1125.5,67.5
"28621","86288","2019",5,5,0,89900,936,104.8
"28622","86289","2019",15,15,0,88709,848.666666666667,93.2
"28623","86290","2019",16,15,1,145037.5,1390.5,113.25
"28624","86291","2019",1,1,0,26000,366,71
"28625","86292","2019",13,13,0,158919.384615385,1445.61538461538,111.692307692308
"28626","86293","2019",49,48,1,134007.142857143,1284.22448979592,103.775510204082
"28627","86294","2019",39,39,0,154498.717948718,1509.4358974359,105.025641025641
"28628","86295","2019",5,5,0,125600,912.2,138.2
"28629","86296","2019",5,5,0,149400,1571.4,97.8
"28630","86297","2019",71,71,0,196261.183098592,1769.87323943662,113.492957746479
"28631","86298","2019",29,21,8,116409.137931034,2290.93103448276,76.3793103448276
"28632","86299","2019",13,13,0,164621.923076923,1344.07692307692,124.615384615385
"28633","86300","2019",6,6,0,198333.333333333,1568.83333333333,127.666666666667
"28634","87001","2019",76,70,6,136580.342105263,1465.82894736842,96.2894736842105
"28635","87002","2019",61,60,1,139748.770491803,1393.18032786885,99.0655737704918
"28636","87003","2019",18,18,0,110686.333333333,826.277777777778,134.055555555556
"28637","87004","2019",3,3,0,101500,957,119.333333333333
"28638","87005","2019",10,10,0,166250,1364,117.3
"28639","87007","2019",2,2,0,91000,835,108.5
"28640","87008","2019",4,4,0,40342.5,564.75,71.5
"28641","87009","2019",6,6,0,149780,1552,109.666666666667
"28642","87011","2019",32,30,2,77102.6875,840.46875,89.3125
"28643","87012","2019",5,5,0,106600,1410.8,74
"28644","87013","2019",10,10,0,94197.7,1002.3,96.8
"28645","87014","2019",32,32,0,91124.6875,970.28125,97.65625
"28646","87015","2019",5,5,0,143300,1602.8,86
"28647","87016","2019",7,7,0,98000,1145.28571428571,89
"28648","87017","2019",8,8,0,77851.875,816,92.625
"28649","87018","2019",4,4,0,134472.5,1114,116.75
"28650","87019","2019",24,24,0,191872.083333333,1816.54166666667,105.875
"28651","87020","2019",15,15,0,165298,1654.2,106.2
"28652","87021","2019",32,32,0,153416.25,1486.375,103.1875
"28653","87022","2019",2,2,0,35500,507.5,66
"28654","87023","2019",4,4,0,124250,1203.5,93.5
"28655","87024","2019",25,25,0,103590.8,1048.52,102
"28656","87025","2019",12,11,1,162396.083333333,1447.5,113.833333333333
"28657","87027","2019",25,25,0,95375.2,1148.92,89.2
"28658","87028","2019",40,40,0,77095.75,945.75,83.725
"28659","87029","2019",8,8,0,68603.75,770.625,86.5
"28660","87030","2019",12,12,0,107904.166666667,1234.5,89.5
"28661","87031","2019",3,3,0,85916.6666666667,1301.33333333333,70.6666666666667
"28662","87032","2019",26,24,2,88621.1538461538,1266.61538461538,79.6923076923077
"28663","87033","2019",4,4,0,89450,1019.25,86.5
"28664","87034","2019",9,9,0,60304.4444444444,810.444444444444,79
"28665","87035","2019",11,11,0,100318.181818182,998.090909090909,103.909090909091
"28666","87036","2019",9,9,0,125988.888888889,1056.66666666667,113.333333333333
"28667","87037","2019",11,11,0,97845.4545454545,1194.81818181818,79.0909090909091
"28668","87038","2019",22,22,0,181584.090909091,1685.40909090909,108.5
"28669","87039","2019",14,14,0,99621.4285714286,1109.64285714286,93.3571428571429
"28670","87040","2019",19,19,0,90078.2631578947,967.052631578947,102
"28671","87041","2019",29,29,0,84365.5172413793,919.620689655172,90.7931034482759
"28672","87042","2019",1,1,0,125600,1322,95
"28673","87043","2019",6,6,0,94167.5,1074.66666666667,85.6666666666667
"28674","87044","2019",6,6,0,76750,1105.83333333333,98.6666666666667
"28675","87045","2019",11,11,0,97453.6363636364,1225.27272727273,77.2727272727273
"28676","87046","2019",24,23,1,97416.6666666667,1132.58333333333,86.25
"28677","87047","2019",17,17,0,124470.588235294,1293.23529411765,99.6470588235294
"28678","87048","2019",74,66,8,176210.337837838,1617.40540540541,111.054054054054
"28679","87049","2019",16,16,0,122720.3125,1345.375,91.75
"28680","87050","2019",88,79,9,173885.818181818,1717.29545454545,100.409090909091
"28681","87051","2019",7,7,0,72500,768.142857142857,93.4285714285714
"28682","87053","2019",5,5,0,113375.8,1337,80.2
"28683","87054","2019",14,14,0,99036.2142857143,1140.21428571429,90.8571428571429
"28684","87056","2019",5,5,0,167000,1123,144.6
"28685","87057","2019",7,7,0,58661.2857142857,813.285714285714,77
"28686","87058","2019",2,2,0,100700,1282,77.5
"28687","87059","2019",12,11,1,108587.333333333,943.416666666667,118.583333333333
"28688","87060","2019",16,15,1,79960.625,1188,85.0625
"28689","87061","2019",11,11,0,98345.6363636364,910.454545454545,106.181818181818
"28690","87062","2019",3,3,0,116000,1233,95
"28691","87063","2019",12,12,0,163695.833333333,1755.66666666667,93.6666666666667
"28692","87064","2019",29,25,4,77627.5862068966,1043.10344827586,75.1379310344828
"28693","87065","2019",64,62,2,162768.90625,1563.03125,102.984375
"28694","87066","2019",9,9,0,108176.111111111,1107.55555555556,106.555555555556
"28695","87067","2019",4,4,0,91170,666.5,136.25
"28696","87068","2019",1,1,0,140000,824,170
"28697","87069","2019",4,4,0,229219,1491.5,149
"28698","87070","2019",13,13,0,125265.384615385,1375.23076923077,87.7692307692308
"28699","87071","2019",3,3,0,143000,1068.66666666667,142.333333333333
"28700","87072","2019",6,6,0,115166.666666667,986.666666666667,117.5
"28701","87073","2019",7,7,0,152938.857142857,1194.28571428571,125
"28702","87074","2019",4,4,0,68125,1112.75,85.5
"28703","87075","2019",100,82,18,152673.29,1754.66,89.49
"28704","87076","2019",6,6,0,69883.3333333333,862.166666666667,82
"28705","87077","2019",7,7,0,124657.142857143,1072.85714285714,125
"28706","87078","2019",8,8,0,119168.75,1249.875,95.5
"28707","87079","2019",15,15,0,113180,1048,109.933333333333
"28708","87080","2019",3,3,0,193833.333333333,1191,121
"28709","87081","2019",9,9,0,164433.333333333,1514.77777777778,110.111111111111
"28710","87082","2019",20,20,0,93832.5,1023.7,95.55
"28711","87083","2019",6,6,0,74991.6666666667,962.833333333333,85.3333333333333
"28712","87084","2019",4,4,0,134879.5,1157,120.75
"28713","87085","2019",2168,630,1538,102739.917435424,1453.10055350554,69.7942804428044
"28714","87086","2019",15,15,0,70900,886.533333333333,85.6666666666667
"28715","87087","2019",8,8,0,76187.5,866.625,83.625
"28716","87088","2019",10,9,1,86750,934,98.7
"28717","87089","2019",16,16,0,74116.375,843.625,86.6875
"28718","87090","2019",8,8,0,75037.5,931.25,82.25
"28719","87091","2019",6,6,0,103666.666666667,1276,91.1666666666667
"28720","87092","2019",12,12,0,103300,1293.16666666667,94
"28721","87093","2019",1,1,0,75000,1210,62
"28722","87094","2019",12,12,0,154191,1415.41666666667,115.583333333333
"28723","87095","2019",16,16,0,110833.9375,1148.125,100.125
"28724","87096","2019",15,15,0,96966.6666666667,1187.2,97.8
"28725","87097","2019",20,20,0,81165,921.65,90.5
"28726","87099","2019",5,5,0,103400,982.2,108.2
"28727","87100","2019",5,5,0,90770,807,105.6
"28728","87101","2019",1,1,0,59740,548,109
"28729","87103","2019",14,14,0,85232.1428571429,974.142857142857,101.428571428571
"28730","87104","2019",11,11,0,71949.0909090909,951,77.7272727272727
"28731","87105","2019",8,8,0,123137.5,1064.25,114.75
"28732","87106","2019",27,26,1,118294.444444444,1252.88888888889,101.888888888889
"28733","87107","2019",19,19,0,152239.473684211,1401.84210526316,108.684210526316
"28734","87108","2019",5,4,1,111816.8,948.2,112.4
"28735","87109","2019",12,12,0,89321.75,890.916666666667,98.8333333333333
"28736","87110","2019",26,26,0,131482.115384615,1349.03846153846,102.923076923077
"28737","87111","2019",38,38,0,89974.4210526316,991.210526315789,91.0263157894737
"28738","87112","2019",12,12,0,94336.0833333333,959.833333333333,97.1666666666667
"28739","87113","2019",47,47,0,152073.744680851,1478.95744680851,106.212765957447
"28740","87114","2019",110,97,13,163108.036363636,1655.77272727273,100.018181818182
"28741","87115","2019",5,5,0,81726,950,91.2
"28742","87116","2019",15,15,0,94797.6666666667,1589.4,87.6666666666667
"28743","87117","2019",25,25,0,66626,853.28,78.52
"28744","87118","2019",17,17,0,110944.882352941,1096.17647058824,101.176470588235
"28745","87119","2019",20,19,1,93760,1075.3,90.15
"28746","87120","2019",12,12,0,100060,1085.25,94.3333333333333
"28747","87121","2019",7,7,0,85642.8571428571,990.571428571429,86
"28748","87122","2019",9,9,0,111177.777777778,1149.88888888889,99.5555555555556
"28749","87123","2019",3,3,0,106566.666666667,1323,74
"28750","87124","2019",3,3,0,71833.3333333333,1500.66666666667,48.6666666666667
"28751","87125","2019",42,42,0,172600.476190476,1708.09523809524,103.285714285714
"28752","87126","2019",52,50,2,96386.9615384615,1108.51923076923,87.9038461538462
"28753","87127","2019",14,14,0,128942.142857143,1338.28571428571,102.714285714286
"28754","87128","2019",27,27,0,101008.888888889,954,108.481481481481
"28755","87129","2019",7,7,0,166178.571428571,1363.42857142857,127
"28756","87130","2019",1,1,0,71000,612,116
"28757","87131","2019",14,14,0,77321.4285714286,949.357142857143,81.5714285714286
"28758","87132","2019",5,5,0,47500,597.2,73.8
"28759","87133","2019",10,10,0,73840,856.8,89.9
"28760","87134","2019",3,3,0,90666.6666666667,933.666666666667,101.666666666667
"28761","87135","2019",18,18,0,83569.0555555556,964.388888888889,89.6666666666667
"28762","87137","2019",4,3,1,127000,1605.75,118.5
"28763","87138","2019",10,10,0,108355,1066.9,115.1
"28764","87139","2019",8,8,0,104153,987.5,95.125
"28765","87140","2019",22,22,0,137330.090909091,1322.77272727273,99
"28766","87141","2019",12,12,0,126922.083333333,1159.5,122.25
"28767","87142","2019",7,7,0,123006.428571429,1123.71428571429,119.714285714286
"28768","87143","2019",25,24,1,143662.64,1461.24,97.84
"28769","87144","2019",8,8,0,133237.5,1337.375,98
"28770","87145","2019",3,3,0,100500,1156.33333333333,82
"28771","87146","2019",13,13,0,82953.8461538462,1009.84615384615,80.5384615384615
"28772","87148","2019",14,14,0,157002.214285714,1335.42857142857,115.357142857143
"28773","87149","2019",4,4,0,87773.75,1094,71
"28774","87150","2019",13,13,0,120162.307692308,1299.30769230769,95.3076923076923
"28775","87151","2019",3,3,0,115516.666666667,983,111
"28776","87152","2019",17,17,0,140435.294117647,1447.05882352941,99.0588235294118
"28777","87153","2019",7,7,0,76714.2857142857,914.571428571429,85.5714285714286
"28778","87154","2019",121,106,15,131119.603305785,1549.02479338843,90.1322314049587
"28779","87155","2019",3,3,0,38666.6666666667,447.333333333333,89.6666666666667
"28780","87156","2019",20,20,0,160750,1419.2,114.95
"28781","87157","2019",15,15,0,141714,1366.66666666667,105.666666666667
"28782","87158","2019",6,6,0,115870.833333333,962.666666666667,115.5
"28783","87159","2019",4,4,0,80750,960.25,93.75
"28784","87160","2019",8,8,0,118778.875,974.5,139.25
"28785","87161","2019",54,46,8,121620.055555556,1350.27777777778,93.8888888888889
"28786","87162","2019",3,3,0,116166.666666667,938.666666666667,128
"28787","87163","2019",2,2,0,80000,717,111.5
"28788","87164","2019",6,6,0,129845.333333333,1295,96.5
"28789","87165","2019",7,7,0,72557.2857142857,970.714285714286,77.7142857142857
"28790","87166","2019",5,5,0,130319,1152,127.6
"28791","87167","2019",8,8,0,102190,1356.25,77
"28792","87168","2019",12,12,0,92279.5,994.916666666667,95.1666666666667
"28793","87169","2019",10,10,0,156599.7,1618.5,100.2
"28794","87170","2019",8,8,0,70280.625,1113.125,71
"28795","87172","2019",1,1,0,160000,1240,129
"28796","87174","2019",13,13,0,122440.769230769,1175.15384615385,105.846153846154
"28797","87176","2019",9,9,0,115899.111111111,1132.66666666667,120.333333333333
"28798","87177","2019",15,15,0,141172,1469.8,93.8
"28799","87178","2019",47,45,2,132990.425531915,1444.93617021277,94.936170212766
"28800","87179","2019",3,3,0,213766.666666667,3346.33333333333,57.3333333333333
"28801","87180","2019",6,6,0,60333.3333333333,662.166666666667,95
"28802","87181","2019",11,11,0,58613.6363636364,724.636363636364,83.2727272727273
"28803","87182","2019",8,8,0,64464.375,785.875,89.875
"28804","87183","2019",9,9,0,123150,1194.44444444444,103.333333333333
"28805","87185","2019",27,27,0,128510,1203.2962962963,109.740740740741
"28806","87186","2019",9,9,0,102632.444444444,978.333333333333,110.777777777778
"28807","87187","2019",110,88,22,94058.9363636364,1118.07272727273,85.5727272727273
"28808","87188","2019",2,2,0,118465,1498,80.5
"28809","87189","2019",5,5,0,74216,982,82.6
"28810","87190","2019",10,10,0,94490,990.4,94.5
"28811","87191","2019",27,27,0,117419.444444444,1188.22222222222,98.962962962963
"28812","87192","2019",26,25,1,176140.384615385,1459.26923076923,117.230769230769
"28813","87193","2019",1,1,0,32000,444,72
"28814","87194","2019",3,3,0,115000,1014,101.333333333333
"28815","87197","2019",6,6,0,98008.3333333333,1147.83333333333,88.5
"28816","87198","2019",4,4,0,74250,1069.75,72
"28817","87199","2019",7,7,0,99207.1428571429,997.428571428571,127.714285714286
"28818","87200","2019",1,1,0,225000,2368,95
"28819","87201","2019",53,53,0,184541.735849057,1634.88679245283,115.660377358491
"28820","87202","2019",18,18,0,117161.722222222,1254.77777777778,94.0555555555556
"28821","87203","2019",12,12,0,116410,1140.16666666667,95.0833333333333
"28822","87204","2019",5,5,0,91373,1382.4,78.2
"28823","87205","2019",27,27,0,180142.185185185,1305.59259259259,141.333333333333
"28824","87206","2019",2,2,0,115000,1335.5,91.5
"28825","88002","2019",2,2,0,116000,836,142
"28826","88003","2019",2,2,0,134085,1145.5,122.5
"28827","88004","2019",2,2,0,72500,780,100
"28828","88005","2019",11,11,0,83354.5454545455,1024.45454545455,94.8181818181818
"28829","88006","2019",4,4,0,127437.5,1308.5,107.25
"28830","88007","2019",1,1,0,18000,450,40
"28831","88009","2019",43,37,6,125172.511627907,1360.41860465116,94.8604651162791
"28832","88010","2019",2,2,0,66250,1027,67.5
"28833","88011","2019",26,20,6,112232.576923077,1245.53846153846,94.6153846153846
"28834","88012","2019",15,14,1,111293.333333333,1151.93333333333,99.8666666666667
"28835","88013","2019",2,2,0,79550,793.5,100.5
"28836","88014","2019",1,1,0,330000,2946,112
"28837","88015","2019",4,4,0,94625,767.75,117.75
"28838","88016","2019",2,2,0,97250,612,146.5
"28839","88019","2019",2,2,0,110500,868.5,123.5
"28840","88020","2019",2,2,0,60000,488.5,122.5
"28841","88021","2019",3,3,0,100666.666666667,1319.33333333333,73
"28842","88023","2019",1,1,0,145000,858,169
"28843","88024","2019",1,1,0,160800,1608,100
"28844","88026","2019",10,7,3,140727.2,1108.1,119.7
"28845","88028","2019",3,3,0,110333.333333333,1223,94
"28846","88029","2019",22,21,1,106098.636363636,1026.45454545455,106.454545454545
"28847","88030","2019",3,3,0,55506.6666666667,1381.33333333333,54
"28848","88032","2019",18,18,0,128527.777777778,1239.72222222222,106.222222222222
"28849","88033","2019",7,7,0,91871.4285714286,1026.14285714286,96.2857142857143
"28850","88037","2019",9,8,1,144383.333333333,1910.88888888889,78.8888888888889
"28851","88039","2019",7,7,0,137323.857142857,1133.28571428571,121.857142857143
"28852","88040","2019",3,3,0,112300,868.333333333333,121
"28853","88043","2019",1,1,0,50000,455,110
"28854","88044","2019",3,3,0,62000,709.333333333333,85.6666666666667
"28855","88045","2019",1,1,0,65000,1444,45
"28856","88046","2019",4,4,0,93875,883.75,100.75
"28857","88047","2019",1,1,0,30000,500,60
"28858","88048","2019",5,5,0,168020,2294.2,99.6
"28859","88049","2019",1,1,0,66500,739,90
"28860","88050","2019",3,3,0,104666.666666667,689.666666666667,150
"28861","88051","2019",2,2,0,36500,467.5,82.5
"28862","88052","2019",1,1,0,70800,701,101
"28863","88053","2019",5,5,0,87040,769.6,99.6
"28864","88054","2019",3,3,0,91000,1030.66666666667,84.3333333333333
"28865","88056","2019",1,1,0,75000,743,101
"28866","88057","2019",2,2,0,96750,1375.5,74
"28867","88059","2019",3,3,0,148326.666666667,1069.33333333333,136
"28868","88061","2019",4,4,0,90562.5,918,113.25
"28869","88064","2019",1,1,0,26000,1000,26
"28870","88065","2019",2,2,0,1e+05,909,110
"28871","88066","2019",1,1,0,155000,824,188
"28872","88068","2019",14,14,0,126586.428571429,1256,99.7857142857143
"28873","88069","2019",2,2,0,68500,931.5,74
"28874","88070","2019",3,3,0,114350,1008,111
"28875","88071","2019",2,2,0,143625,934,206.5
"28876","88073","2019",1,1,0,276500,1676,165
"28877","88075","2019",124,42,82,126037.60483871,1980.02419354839,65.991935483871
"28878","88076","2019",3,3,0,89333.3333333333,1051,91.6666666666667
"28879","88077","2019",4,4,0,53500,489,104.75
"28880","88078","2019",38,29,9,88426.3157894737,944.342105263158,99.0526315789474
"28881","88079","2019",14,14,0,140675.071428571,1239.64285714286,115.5
"28882","88080","2019",2,2,0,143066,1291,119.5
"28883","88081","2019",29,25,4,107810.344827586,1288.62068965517,93.9655172413793
"28884","88082","2019",8,7,1,73450,1013,76.625
"28885","88083","2019",2,2,0,82250,786.5,104.5
"28886","88084","2019",3,3,0,64833.3333333333,662.666666666667,97.6666666666667
"28887","88086","2019",8,7,1,108781.25,985,113.875
"28888","88087","2019",61,42,19,140475.901639344,1579.47540983607,87.9180327868852
"28889","88088","2019",7,7,0,105328.571428571,904.857142857143,123
"28890","88089","2019",5,4,1,218577,1741.4,133.8
"28891","88090","2019",55,39,16,119331.181818182,1217.81818181818,97.6
"28892","88091","2019",5,5,0,119200,1191.4,116.4
"28893","88092","2019",10,10,0,113200,891.6,133.2
"28894","88094","2019",21,19,2,109588.571428571,1052.90476190476,99.8571428571429
"28895","88095","2019",13,12,1,83462.3076923077,943.461538461538,89.3846153846154
"28896","88096","2019",2,2,0,48750,510,95
"28897","88098","2019",2,2,0,126360,1128,120
"28898","88099","2019",16,15,1,132460,1368.5,96.0625
"28899","88101","2019",10,8,2,124915,1337.7,107.5
"28900","88102","2019",1,1,0,55000,1100,50
"28901","88103","2019",1,1,0,20000,500,40
"28902","88104","2019",1,1,0,32000,533,60
"28903","88105","2019",2,2,0,103000,816.5,130
"28904","88106","2019",27,27,0,145106.296296296,1741.74074074074,86.4814814814815
"28905","88108","2019",2,1,1,90000,728.5,120
"28906","88109","2019",4,4,0,197890,2025.75,94.5
"28907","88111","2019",2,2,0,184000,1053,160
"28908","88114","2019",36,31,5,90080.0833333333,951.277777777778,96.3055555555556
"28909","88115","2019",27,20,7,103538.888888889,1253.51851851852,86.1111111111111
"28910","88116","2019",40,29,11,107470,1229.4,92.125
"28911","88117","2019",1,1,0,65000,812,80
"28912","88118","2019",9,9,0,117066.666666667,1346.77777777778,89
"28913","88119","2019",2,2,0,102250,742.5,135
"28914","88120","2019",7,7,0,80785.7142857143,919,81.1428571428571
"28915","88121","2019",2,2,0,81345,517,157.5
"28916","88122","2019",2,1,1,105400,695.5,179
"28917","88123","2019",3,3,0,60000,746.666666666667,78.6666666666667
"28918","88124","2019",3,3,0,89833.3333333333,841.666666666667,122.333333333333
"28919","88126","2019",9,9,0,161255.555555556,1267.66666666667,120.666666666667
"28920","88128","2019",4,4,0,95500,968,96
"28921","88130","2019",1,1,0,182000,607,300
"28922","88131","2019",3,3,0,80833.3333333333,906.333333333333,90.6666666666667
"28923","88132","2019",10,10,0,198480,1728.5,117.5
"28924","88133","2019",3,3,0,187300,1555.33333333333,124.666666666667
"28925","88134","2019",6,5,1,136583.333333333,1406.33333333333,97.5
"28926","88135","2019",8,4,4,121057.5,1360,94.25
"28927","88136","2019",17,16,1,135092.352941176,1247,102.705882352941
"28928","88139","2019",1,1,0,15000,600,25
"28929","88140","2019",2,2,0,138175,919.5,146.5
"28930","88141","2019",4,4,0,95250,666.75,128.25
"28931","88142","2019",5,4,1,153350,1530.6,100
"28932","88143","2019",2,2,0,54000,599.5,90
"28933","88145","2019",1,1,0,1e+05,1299,77
"28934","88146","2019",1,1,0,70000,1029,68
"28935","88147","2019",3,3,0,145300,1299,118.333333333333
"28936","88148","2019",21,17,4,137509.523809524,1467.2380952381,101.190476190476
"28937","88150","2019",1,1,0,110000,786,140
"28938","88151","2019",10,8,2,121290.5,1107.7,117.3
"28939","88152","2019",1,1,0,30000,375,80
"28940","88153","2019",2,2,0,55500,643,85
"28941","88154","2019",3,3,0,58326.6666666667,434.666666666667,137
"28942","88155","2019",1,1,0,91000,892,102
"28943","88156","2019",2,2,0,110250,944,121
"28944","88157","2019",14,13,1,118446.428571429,1107.21428571429,110.928571428571
"28945","88158","2019",27,18,9,113150,1224.22222222222,92
"28946","88159","2019",3,3,0,171100,1501.66666666667,131.333333333333
"28947","88160","2019",514,192,322,106360.163424125,1233.85214007782,84.1556420233463
"28948","88161","2019",5,5,0,72540,1383,82.4
"28949","88163","2019",2,2,0,158250,1495,106
"28950","88165","2019",28,23,5,106199.464285714,1249,90.1428571428571
"28951","88166","2019",2,2,0,173719,1291.5,127.5
"28952","88167","2019",3,3,0,113650,1037.66666666667,105
"28953","88168","2019",1,1,0,70000,959,73
"28954","88169","2019",3,3,0,165000,1328.33333333333,129.666666666667
"28955","88170","2019",10,10,0,139567,1012.7,139.4
"28956","88172","2019",3,3,0,113433.333333333,856.666666666667,127.666666666667
"28957","88173","2019",5,5,0,110370,1189.8,92.8
"28958","88174","2019",1,1,0,112500,1051,107
"28959","88175","2019",5,5,0,138000,1145.2,120.6
"28960","88176","2019",8,8,0,98625,914,129.375
"28961","88177","2019",8,8,0,180877.5,1921,99.375
"28962","88178","2019",16,16,0,187316.125,1460.4375,123.9375
"28963","88179","2019",2,2,0,57000,745,65
"28964","88180","2019",4,4,0,60453,685,86.5
"28965","88181","2019",42,34,8,96769.5238095238,1080.30952380952,94.9761904761905
"28966","88182","2019",2,2,0,205425,1180,163
"28967","88183","2019",3,2,1,75000,712.333333333333,102.333333333333
"28968","88184","2019",3,3,0,175000,1460,129
"28969","88185","2019",1,1,0,30000,341,88
"28970","88188","2019",14,10,4,121521,1312.42857142857,89.5
"28971","88189","2019",2,2,0,146500,1467,101
"28972","88190","2019",2,2,0,92000,918.5,101.5
"28973","88193","2019",2,2,0,42500,568,73.5
"28974","88194","2019",3,3,0,97500,819.333333333333,112.666666666667
"28975","88195","2019",3,3,0,94766.6666666667,900,108.666666666667
"28976","88196","2019",236,88,148,167417.487288136,2237.97033898305,76.4491525423729
"28977","88197","2019",1,1,0,110000,902,122
"28978","88198","2019",12,12,0,176716.666666667,1473.25,127.75
"28979","88199","2019",1,1,0,98000,942,104
"28980","88201","2019",4,4,0,122025,1303.75,99.25
"28981","88202","2019",1,1,0,203513,2261,90
"28982","88203","2019",2,2,0,122000,791,153.5
"28983","88205","2019",3,3,0,144000,1296,113.333333333333
"28984","88206","2019",7,7,0,84928.5714285714,970.285714285714,89.4285714285714
"28985","88208","2019",1,1,0,245000,1531,160
"28986","88209","2019",107,63,44,122446.028037383,1351.65420560748,91.0373831775701
"28987","88210","2019",1,1,0,124000,1653,75
"28988","88212","2019",2,2,0,50500,555.5,92
"28989","88213","2019",3,3,0,119625,1235.66666666667,102
"28990","88214","2019",3,2,1,142100,1538.33333333333,136.333333333333
"28991","88215","2019",3,3,0,100696.666666667,714.333333333333,142.666666666667
"28992","88216","2019",5,5,0,117600,863.8,131.8
"28993","88218","2019",32,31,1,116897.34375,1390.3125,92.59375
"28994","88220","2019",1,1,0,37000,336,110
"28995","88221","2019",2,2,0,48500,594.5,100
"28996","88222","2019",1,1,0,79140,1276,62
"28997","88223","2019",3,3,0,79000,908.333333333333,85.6666666666667
"28998","88224","2019",5,5,0,130014,952,141.8
"28999","88225","2019",24,24,0,133740.833333333,1329.70833333333,105.375
"29000","88226","2019",1,1,0,30000,353,85
"29001","88228","2019",1,1,0,35000,368,95
"29002","88231","2019",1,1,0,75800,1024,74
"29003","88232","2019",3,3,0,98700,1031.33333333333,107
"29004","88233","2019",2,2,0,76500,1030.5,75
"29005","88236","2019",3,3,0,80933.3333333333,860.333333333333,105.333333333333
"29006","88237","2019",6,6,0,90666.6666666667,800.833333333333,112
"29007","88238","2019",5,5,0,90600,779.2,145.2
"29008","88239","2019",1,1,0,95000,798,119
"29009","88240","2019",3,3,0,104333.333333333,1220.33333333333,84.3333333333333
"29010","88241","2019",9,9,0,98711.1111111111,785.666666666667,129.888888888889
"29011","88243","2019",3,3,0,58333.3333333333,557,103.666666666667
"29012","88244","2019",7,3,4,66535.7142857143,947.142857142857,70.5714285714286
"29013","88245","2019",1,1,0,206000,1717,120
"29014","88246","2019",9,8,1,97866.6666666667,881.444444444444,109.555555555556
"29015","88247","2019",15,15,0,117933.333333333,1199.2,103.2
"29016","88248","2019",2,2,0,82500,555.5,160
"29017","88250","2019",4,3,1,102975,1013.25,101
"29018","88251","2019",9,9,0,95088.8888888889,821.777777777778,111.444444444444
"29019","88252","2019",2,2,0,130000,1094,119.5
"29020","88253","2019",6,4,2,134743.5,1223,100.666666666667
"29021","88254","2019",1,1,0,67500,703,96
"29022","88256","2019",2,2,0,138200,1747,83.5
"29023","88257","2019",2,2,0,430000,5268.5,113.5
"29024","88258","2019",4,4,0,67391.25,694,101.5
"29025","88259","2019",1,1,0,43000,391,110
"29026","88260","2019",4,4,0,87875,857,96.75
"29027","88261","2019",6,6,0,112908.333333333,913.833333333333,126.333333333333
"29028","88262","2019",8,6,2,72012.5,756.25,95.25
"29029","88263","2019",2,2,0,180000,1779.5,101
"29030","88266","2019",10,8,2,85500,825,104.3
"29031","88267","2019",5,5,0,82143,740.4,106.8
"29032","88269","2019",10,8,2,188975,2346.6,89.2
"29033","88270","2019",19,19,0,74070.7894736842,719,98.7894736842105
"29034","88271","2019",3,3,0,113130,1208.33333333333,93.6666666666667
"29035","88273","2019",2,1,1,140000,1410.5,101.5
"29036","88274","2019",3,3,0,90833.3333333333,818.666666666667,112.333333333333
"29037","88275","2019",12,11,1,87083.3333333333,877.666666666667,106.583333333333
"29038","88276","2019",4,4,0,97150,960.75,99.75
"29039","88277","2019",2,2,0,46700,585.5,77.5
"29040","88278","2019",1,1,0,30000,345,87
"29041","88280","2019",1,1,0,120000,1250,96
"29042","88281","2019",5,5,0,152160,1368.2,122.4
"29043","88284","2019",9,8,1,119657.333333333,1573.11111111111,85.4444444444444
"29044","88285","2019",3,3,0,140614,1363.33333333333,108
"29045","88286","2019",1,1,0,108000,1350,80
"29046","88289","2019",7,6,1,80871.4285714286,920.714285714286,89.7142857142857
"29047","88292","2019",3,3,0,85666.6666666667,911,88.3333333333333
"29048","88293","2019",2,2,0,61000,1071,66
"29049","88294","2019",2,2,0,165390,1260,131
"29050","88295","2019",6,6,0,110541.666666667,1115,90.1666666666667
"29051","88296","2019",2,2,0,100400,655,153.5
"29052","88297","2019",3,3,0,117866.666666667,1259,91.6666666666667
"29053","88299","2019",1,1,0,158000,1082,146
"29054","88300","2019",2,2,0,93946,909.5,100.5
"29055","88301","2019",2,2,0,79640,949,82.5
"29056","88302","2019",24,20,4,140021.666666667,1621.29166666667,98
"29057","88303","2019",5,5,0,66300,505.4,124.2
"29058","88304","2019",55,41,14,82715.2363636364,885.345454545455,95.7090909090909
"29059","88305","2019",1,1,0,48000,800,60
"29060","88306","2019",1,1,0,42000,600,70
"29061","88308","2019",2,2,0,122000,1456.5,85
"29062","88310","2019",4,4,0,88250,876.25,105
"29063","88311","2019",1,1,0,50000,610,82
"29064","88312","2019",8,8,0,80662.5,759,110.25
"29065","88313","2019",1,1,0,163700,1259,130
"29066","88314","2019",1,1,0,32000,457,70
"29067","88315","2019",6,6,0,124046.666666667,1147.83333333333,107.5
"29068","88317","2019",6,6,0,104162.5,960.333333333333,123.666666666667
"29069","88319","2019",32,30,2,86095.3125,895,93.5625
"29070","88320","2019",13,13,0,143792.384615385,1276.15384615385,111.615384615385
"29071","88321","2019",64,45,19,102168.59375,1047.296875,94.734375
"29072","88322","2019",4,4,0,151825,1507,106.25
"29073","88324","2019",2,1,1,85000,596,144
"29074","88325","2019",1,1,0,66000,815,81
"29075","88326","2019",5,5,0,152840,1328,108.6
"29076","88327","2019",16,16,0,106500,1084.75,100.375
"29077","88328","2019",4,4,0,135290,1254.75,113.5
"29078","88330","2019",3,3,0,100166.666666667,669.333333333333,155
"29079","88332","2019",1,0,1,2e+05,1818,110
"29080","88333","2019",1,1,0,68000,453,150
"29081","88334","2019",4,4,0,58597.5,899.25,73
"29082","88336","2019",1,1,0,30000,400,75
"29083","88340","2019",4,4,0,116250,910.25,127.5
"29084","88341","2019",7,7,0,117139.285714286,1077.85714285714,108.571428571429
"29085","88342","2019",3,3,0,161816.666666667,1531,107
"29086","88343","2019",3,3,0,91666.6666666667,878.333333333333,110.666666666667
"29087","88344","2019",3,3,0,82166.6666666667,652.333333333333,120.666666666667
"29088","88345","2019",3,3,0,180000,1462,115
"29089","88346","2019",4,3,1,35625,445.5,81.5
"29090","88347","2019",2,2,0,51000,444.5,108
"29091","88348","2019",2,2,0,143500,877.5,163
"29092","88349","2019",25,22,3,110394.12,1242.16,97
"29093","88351","2019",35,25,10,95706.2857142857,1012.97142857143,99.4285714285714
"29094","88352","2019",3,3,0,118883.333333333,920.666666666667,122.666666666667
"29095","88354","2019",3,3,0,104150,1353.66666666667,77.3333333333333
"29096","88355","2019",20,20,0,108038,1024.9,106.5
"29097","88356","2019",3,3,0,157200,1158,133.666666666667
"29098","88357","2019",6,6,0,84300,976.166666666667,86
"29099","88358","2019",21,17,4,118095.238095238,1224.09523809524,99.7142857142857
"29100","88359","2019",1,1,0,132000,943,140
"29101","88360","2019",1,1,0,92000,609,151
"29102","88361","2019",16,15,1,104258.3125,1262.5625,80.6875
"29103","88362","2019",1,1,0,135000,1015,133
"29104","88363","2019",2,2,0,86500,631.5,136
"29105","88366","2019",3,3,0,106000,756.333333333333,128
"29106","88367","2019",48,43,5,94538.125,914.979166666667,105.291666666667
"29107","88368","2019",2,2,0,62500,1395.5,75
"29108","88369","2019",11,11,0,125852.909090909,1140,114.545454545455
"29109","88371","2019",14,14,0,149064.857142857,1353.14285714286,118.357142857143
"29110","88372","2019",62,49,13,99429.6774193548,1020.77419354839,96
"29111","88373","2019",6,6,0,71500.3333333333,714.5,108
"29112","88375","2019",5,5,0,136620,1278,109
"29113","88376","2019",3,3,0,132200,920,146.333333333333
"29114","88377","2019",1,1,0,48000,1067,45
"29115","88379","2019",4,4,0,115015.5,1088.75,111.25
"29116","88380","2019",4,4,0,143250,1942.25,80
"29117","88381","2019",3,3,0,74523.3333333333,703.333333333333,114
"29118","88383","2019",142,43,99,93987.6408450704,1177.34507042254,82.5774647887324
"29119","88385","2019",5,5,0,71878,816,85.6
"29120","88386","2019",5,5,0,171200,1369.2,121.4
"29121","88387","2019",5,5,0,74700,887,89.2
"29122","88388","2019",1,1,0,320000,2038,157
"29123","88389","2019",1,1,0,19000,358,53
"29124","88390","2019",1,1,0,50000,543,92
"29125","88391","2019",14,12,2,147209.642857143,1468.92857142857,109.214285714286
"29126","88393","2019",2,2,0,146250,1491,94.5
"29127","88395","2019",3,3,0,107833.333333333,922.666666666667,111.333333333333
"29128","88398","2019",1,1,0,50000,376,133
"29129","88403","2019",1,1,0,116700,1122,104
"29130","88406","2019",1,1,0,131005,1248,105
"29131","88407","2019",1,1,0,77000,740,104
"29132","88408","2019",31,28,3,121271.064516129,1264,99.3225806451613
"29133","88409","2019",23,20,3,124900.434782609,1296,95.6086956521739
"29134","88410","2019",6,6,0,97698.3333333333,897,110
"29135","88412","2019",9,9,0,100041.111111111,922,115.444444444444
"29136","88413","2019",253,131,122,98422.2411067194,1072.20948616601,91.197628458498
"29137","88415","2019",26,18,8,122748.076923077,1317.92307692308,93.5
"29138","88418","2019",4,4,0,126250,1047.25,122.75
"29139","88419","2019",3,3,0,125333.333333333,1430.33333333333,86.6666666666667
"29140","88421","2019",1,1,0,15000,333,45
"29141","88423","2019",20,19,1,126992,1246.4,103.8
"29142","88424","2019",27,21,6,133756.666666667,1566.07407407407,87.4444444444444
"29143","88425","2019",2,2,0,53500,547.5,97.5
"29144","88426","2019",14,10,4,100785.714285714,1171.92857142857,89.3571428571429
"29145","88428","2019",19,16,3,120626.842105263,1267.84210526316,98.5789473684211
"29146","88429","2019",39,34,5,126538.871794872,1310.25641025641,95.6153846153846
"29147","88430","2019",2,2,0,87900,880.5,93.5
"29148","88432","2019",1,1,0,55000,545,101
"29149","88434","2019",1,1,0,144000,1309,110
"29150","88435","2019",7,7,0,152217.142857143,1411.85714285714,110.571428571429
"29151","88436","2019",2,2,0,169500,893.5,185
"29152","88438","2019",4,4,0,109205,969.25,114
"29153","88439","2019",12,12,0,170804.166666667,1812.75,98.1666666666667
"29154","88440","2019",3,3,0,63333.3333333333,640.333333333333,101.333333333333
"29155","88442","2019",4,3,1,98025,1030.25,107
"29156","88444","2019",7,6,1,85328.5714285714,980,108.428571428571
"29157","88445","2019",35,27,8,118277.857142857,1185.71428571429,96.8
"29158","88446","2019",3,3,0,133366.666666667,903.666666666667,157.333333333333
"29159","88447","2019",40,35,5,123180.5,1283.075,96.55
"29160","88449","2019",3,3,0,114333.333333333,1175.66666666667,106.333333333333
"29161","88450","2019",4,4,0,73719.75,643.75,106
"29162","88451","2019",25,21,4,75226.04,851.32,91.32
"29163","88454","2019",3,3,0,93666.6666666667,956.666666666667,91
"29164","88455","2019",2,2,0,91500,921.5,102.5
"29165","88457","2019",1,1,0,99000,1031,96
"29166","88458","2019",1,1,0,76000,1013,75
"29167","88459","2019",1,1,0,141100,1045,135
"29168","88460","2019",8,8,0,144110,1239.375,118.75
"29169","88461","2019",1,1,0,155000,1250,124
"29170","88462","2019",14,11,3,128517.857142857,1257.78571428571,100.357142857143
"29171","88463","2019",16,15,1,135457.1875,1349.375,104.5625
"29172","88464","2019",3,3,0,183596.666666667,1676.66666666667,108.333333333333
"29173","88465","2019",118,88,30,116148.262711864,1205.98305084746,95.6949152542373
"29174","88467","2019",5,4,1,102920,1137.4,89.8
"29175","88468","2019",26,19,7,115746.153846154,1497.80769230769,92.0769230769231
"29176","88470","2019",44,27,17,127394.636363636,1784.68181818182,76.0454545454545
"29177","88471","2019",1,1,0,32200,358,90
"29178","88472","2019",2,2,0,107000,1019,103.5
"29179","88473","2019",1,1,0,56000,596,94
"29180","88474","2019",2,2,0,51000,605,83
"29181","88475","2019",2,2,0,55000,516,105
"29182","88476","2019",1,1,0,24000,333,72
"29183","88477","2019",1,1,0,27000,375,72
"29184","88478","2019",1,1,0,43150,575,75
"29185","88479","2019",3,3,0,98000,512.333333333333,188.333333333333
"29186","88480","2019",1,1,0,175750,1264,139
"29187","88481","2019",19,18,1,130815.789473684,1207.05263157895,111.578947368421
"29188","88482","2019",2,2,0,67710,637.5,105
"29189","88483","2019",26,26,0,155719.807692308,1570.84615384615,98.3461538461538
"29190","88484","2019",10,10,0,111165,942.7,112
"29191","88485","2019",3,3,0,85333.3333333333,774.333333333333,131.333333333333
"29192","88486","2019",29,22,7,111765.517241379,1323.96551724138,87.2758620689655
"29193","88487","2019",39,34,5,114757.564102564,1095.17948717949,110.307692307692
"29194","88489","2019",2,2,0,118500,1548.5,76.5
"29195","88490","2019",2,2,0,97227,890.5,106.5
"29196","88491","2019",2,2,0,81750,674.5,122
"29197","88492","2019",5,5,0,137300,1401,98.2
"29198","88494","2019",1,1,0,95000,1319,72
"29199","88495","2019",1,1,0,244000,1574,155
"29200","88496","2019",3,3,0,135166.666666667,995.333333333333,125.666666666667
"29201","88497","2019",12,12,0,103545.833333333,951.333333333333,107
"29202","88498","2019",1,1,0,80000,1905,42
"29203","88499","2019",1,1,0,50000,667,75
"29204","88500","2019",27,20,7,144844.444444444,1733.44444444444,89.6296296296296
"29205","88501","2019",2,2,0,117500,926,117.5
"29206","88502","2019",1,1,0,69000,793,87
"29207","88503","2019",2,2,0,96950,1322,81
"29208","88504","2019",2,2,0,151250,1222.5,126
"29209","88505","2019",4,4,0,93727.5,1636.75,63.75
"29210","88506","2019",6,6,0,110116.666666667,967.166666666667,118.833333333333
"29211","88507","2019",2,2,0,77500,722,109.5
"29212","88508","2019",2,2,0,156500,1282,122.5
"29213","88511","2019",1,1,0,24000,429,56
"29214","88512","2019",1,1,0,118000,908,130
"29215","88513","2019",25,24,1,113246.92,1161.4,96
"29216","88515","2019",2,2,0,76425,827,91.5
"29217","88516","2019",89,45,44,106096.011235955,1239.58426966292,88.8314606741573
"29218","88517","2019",2,2,0,88250,1012.5,87
"29219","88519","2019",9,8,1,116888.888888889,1212.11111111111,98.6666666666667
"29220","88520","2019",5,5,0,86800,841.4,103.6
"29221","88521","2019",2,2,0,262500,1522.5,170
"29222","88523","2019",2,2,0,118935,820.5,143
"29223","88524","2019",2,2,0,59911,486.5,121.5
"29224","88525","2019",2,2,0,113330,987,107
"29225","88526","2019",5,5,0,100920,1033.6,99.8
"29226","88530","2019",11,11,0,98984.5454545455,1045.36363636364,97.8181818181818
"29227","88531","2019",54,25,29,155231,2125.7962962963,81.1481481481482
"29228","89002","2019",1,1,0,160000,696,230
"29229","89003","2019",37,37,0,128047.594594595,1372.81081081081,96.6486486486486
"29230","89004","2019",4,4,0,78500,929.25,85
"29231","89005","2019",9,9,0,54584,688.333333333333,75
"29232","89006","2019",4,4,0,79500,911,88.25
"29233","89007","2019",9,9,0,67345.5555555556,789.444444444444,82.5555555555556
"29234","89010","2019",2,2,0,80000,946.5,83
"29235","89012","2019",1,1,0,170000,1181,144
"29236","89013","2019",44,44,0,126066.363636364,1470.77272727273,84.0227272727273
"29237","89014","2019",15,15,0,101803.2,1043.53333333333,96.4
"29238","89015","2019",10,10,0,80344,866.3,95.5
"29239","89017","2019",3,3,0,83833.3333333333,801.666666666667,109.666666666667
"29240","89018","2019",6,6,0,94710.8333333333,1256.83333333333,73.1666666666667
"29241","89019","2019",1,1,0,112000,1723,65
"29242","89020","2019",3,3,0,43333.3333333333,403,105.333333333333
"29243","89021","2019",5,5,0,62760,989.4,61.8
"29244","89023","2019",13,13,0,132188,1602.92307692308,83.4615384615385
"29245","89024","2019",502,218,284,109020.446215139,1530.77091633466,71.8027888446215
"29246","89025","2019",79,46,33,103741.316455696,1261.21518987342,85.2784810126582
"29247","89027","2019",1,1,0,149000,1242,120
"29248","89028","2019",1,1,0,150000,882,170
"29249","89029","2019",13,13,0,100478.461538462,1206.46153846154,94.7692307692308
"29250","89030","2019",8,8,0,78000,926.875,78.5
"29251","89031","2019",5,5,0,160800,1740,96.4
"29252","89032","2019",2,2,0,105016,1191.5,83
"29253","89033","2019",3,3,0,110000,1122.33333333333,96.6666666666667
"29254","89034","2019",5,5,0,124698,1392.8,90
"29255","89035","2019",5,5,0,123800,1580.8,82.2
"29256","89036","2019",5,5,0,182527,1304.2,144.2
"29257","89037","2019",8,8,0,126362.5,1166.875,110.875
"29258","89040","2019",1,1,0,79000,699,113
"29259","89041","2019",4,4,0,91000,967,94.75
"29260","89042","2019",5,5,0,153200,1528.8,107.8
"29261","89043","2019",3,3,0,130000,1077.33333333333,113.333333333333
"29262","89044","2019",2,2,0,72500,600,119.5
"29263","89045","2019",7,7,0,128263.142857143,1600.85714285714,78.5714285714286
"29264","89046","2019",17,17,0,92882.3529411765,891.058823529412,106.882352941176
"29265","89048","2019",8,8,0,123625,1152.5,114.125
"29266","89049","2019",1,1,0,30000,577,52
"29267","89050","2019",13,12,1,135892.307692308,1383.53846153846,99.6923076923077
"29268","89051","2019",6,6,0,148666.666666667,1219.66666666667,133.166666666667
"29269","89053","2019",4,4,0,131662.5,1812,85.75
"29270","89054","2019",18,18,0,123797.388888889,1395.22222222222,89.8333333333333
"29271","89055","2019",30,28,2,81179,1103.26666666667,78.2333333333333
"29272","89056","2019",9,9,0,94222.2222222222,1236.55555555556,80.2222222222222
"29273","89057","2019",6,6,0,87083.3333333333,735.166666666667,117.5
"29274","89058","2019",2,2,0,128250,1257.5,100
"29275","89059","2019",7,7,0,107742.857142857,1053.57142857143,104.571428571429
"29276","89060","2019",1,1,0,139860,1413,99
"29277","89061","2019",2,2,0,71500,698,103
"29278","89062","2019",1,1,0,1e+05,833,120
"29279","89063","2019",17,17,0,118376.470588235,1091.76470588235,108.705882352941
"29280","89065","2019",1,1,0,119810,1198,100
"29281","89066","2019",15,15,0,95713.3333333333,1108.26666666667,81.6
"29282","89067","2019",14,14,0,69250,1027.07142857143,69.2857142857143
"29283","89068","2019",26,25,1,132378.538461538,1667.46153846154,89.4615384615385
"29284","89069","2019",3,3,0,84333.3333333333,784.666666666667,114
"29285","89072","2019",7,7,0,76424.2857142857,1076.42857142857,72
"29286","89073","2019",23,22,1,92250,1047,88.0434782608696
"29287","89074","2019",41,41,0,133539.609756098,1502.80487804878,93.0975609756098
"29288","89075","2019",10,10,0,108300,1086.2,98.6
"29289","89076","2019",11,11,0,100954.545454545,1005.36363636364,108.090909090909
"29290","89077","2019",25,25,0,149188.6,1585.4,94.72
"29291","89079","2019",12,11,1,119605,1395.75,84.8333333333333
"29292","89080","2019",8,8,0,116062.5,1414.75,82.5
"29293","89081","2019",2,2,0,64000,664.5,85.5
"29294","89083","2019",22,22,0,158897.954545455,1434.22727272727,121.272727272727
"29295","89084","2019",4,4,0,129000,1411.25,93.5
"29296","89085","2019",8,8,0,103937.5,1393.5,79.625
"29297","89086","2019",100,99,1,108199,1103.04,99.18
"29298","89087","2019",3,3,0,81666.6666666667,842,100.333333333333
"29299","89088","2019",7,7,0,104542.857142857,1249.85714285714,85.8571428571429
"29300","89089","2019",5,5,0,120009.4,1263.2,102.8
"29301","89091","2019",14,14,0,73964.2857142857,782.214285714286,93.2142857142857
"29302","89092","2019",5,5,0,140340,702.2,151.6
"29303","89093","2019",14,14,0,149035.714285714,1715.71428571429,91.7857142857143
"29304","89094","2019",12,12,0,142033,1516.66666666667,97.4166666666667
"29305","89095","2019",2,2,0,61500,735.5,87.5
"29306","89096","2019",16,15,1,134455.5,1847.5,85.8125
"29307","89098","2019",3,3,0,99900,604,171.333333333333
"29308","89099","2019",31,31,0,113891.193548387,1123.74193548387,103.451612903226
"29309","89100","2019",32,30,2,130038.1875,1485.1875,88.125
"29310","89101","2019",6,6,0,76000,912.833333333333,85
"29311","89102","2019",26,26,0,146408.846153846,1408.84615384615,104.230769230769
"29312","89104","2019",3,3,0,141766.666666667,1477,90.6666666666667
"29313","89105","2019",5,5,0,132120,1876.2,79.8
"29314","89108","2019",7,7,0,107070.142857143,1233,84.4285714285714
"29315","89111","2019",6,6,0,119125,750.166666666667,167.333333333333
"29316","89112","2019",1,1,0,76550,773,99
"29317","89113","2019",3,3,0,121666.666666667,1428,89
"29318","89115","2019",1,1,0,48750,393,124
"29319","89116","2019",5,5,0,177800,1281.8,134.8
"29320","89117","2019",1,1,0,144000,1398,103
"29321","89118","2019",7,7,0,136185.714285714,1257.71428571429,111.714285714286
"29322","89119","2019",6,6,0,72500,946.166666666667,75.3333333333333
"29323","89120","2019",1,1,0,50000,538,93
"29324","89122","2019",9,9,0,114406.666666667,1174.55555555556,97.7777777777778
"29325","89123","2019",3,3,0,109666.666666667,1170.33333333333,128
"29326","89124","2019",22,22,0,166463.636363636,1556.13636363636,112.454545454545
"29327","89125","2019",14,14,0,80085.7142857143,879.714285714286,88.7142857142857
"29328","89126","2019",3,3,0,145333.333333333,1295.66666666667,116
"29329","89127","2019",9,9,0,159188.888888889,1541,105.888888888889
"29330","89128","2019",1,1,0,171000,1213,141
"29331","89129","2019",9,9,0,77111.1111111111,943.222222222222,80.1111111111111
"29332","89130","2019",24,22,2,99412.5,988.333333333333,103.333333333333
"29333","89131","2019",3,3,0,191666.666666667,1010,168.666666666667
"29334","89132","2019",1,1,0,90000,682,132
"29335","89133","2019",4,4,0,112156.25,896.5,122
"29336","89134","2019",1,1,0,83000,1000,83
"29337","89136","2019",9,9,0,120777.777777778,1315.55555555556,91.5555555555556
"29338","89137","2019",5,5,0,91000,1231.2,81.8
"29339","89139","2019",21,21,0,124476.19047619,1251,104.380952380952
"29340","89141","2019",1,1,0,40000,755,53
"29341","89142","2019",21,21,0,106487.619047619,1313.09523809524,91.4761904761905
"29342","89143","2019",8,8,0,151812.5,1656.125,91.375
"29343","89144","2019",11,11,0,153905.454545455,1391.63636363636,116.545454545455
"29344","89145","2019",5,5,0,113400,1245.8,88.8
"29345","89146","2019",3,3,0,67950,885,79
"29346","89147","2019",2,2,0,106000,792.5,140
"29347","89148","2019",5,5,0,64800,725.2,98
"29348","89149","2019",1,1,0,127000,907,140
"29349","89150","2019",11,11,0,109727.272727273,1001,111.636363636364
"29350","89151","2019",28,28,0,94369.6428571429,1305.75,68.5357142857143
"29351","89152","2019",12,12,0,79791.6666666667,1074.75,80.0833333333333
"29352","89153","2019",5,5,0,96800,1121.2,82.6
"29353","89154","2019",12,12,0,131612.5,1388.91666666667,97.25
"29354","89155","2019",9,9,0,138203.333333333,1506,91.2222222222222
"29355","89156","2019",6,6,0,113663.333333333,1046.83333333333,109.333333333333
"29356","89158","2019",9,9,0,80444.4444444444,666.666666666667,123.444444444444
"29357","89159","2019",7,7,0,116594.285714286,1266,92.4285714285714
"29358","89160","2019",9,9,0,185262.222222222,1481.33333333333,127.333333333333
"29359","89161","2019",9,9,0,104422.222222222,778,136.555555555556
"29360","89162","2019",10,10,0,137035,1473.6,92.6
"29361","89163","2019",5,5,0,84600,1200,75
"29362","89164","2019",1,1,0,50000,877,57
"29363","89165","2019",1,1,0,85000,895,95
"29364","89167","2019",16,16,0,148906.25,1207.125,126.625
"29365","89168","2019",3,3,0,87666.6666666667,731,135
"29366","89169","2019",7,7,0,94878.5714285714,1049.57142857143,91
"29367","89171","2019",4,4,0,95625,769,128.25
"29368","89172","2019",8,8,0,182687.5,1603.5,116.625
"29369","89173","2019",7,7,0,72315.4285714286,965,89.7142857142857
"29370","89175","2019",3,3,0,222100,1549.33333333333,147
"29371","89176","2019",1,1,0,50000,556,90
"29372","89177","2019",1,1,0,29894,712,42
"29373","89179","2019",9,9,0,93111.1111111111,1085.22222222222,77.7777777777778
"29374","89180","2019",2,2,0,121250,1570,77
"29375","89181","2019",3,3,0,102250,765,140.333333333333
"29376","89182","2019",1,1,0,60000,577,104
"29377","89184","2019",2,2,0,67500,741,85.5
"29378","89186","2019",5,5,0,135800,1289,113
"29379","89187","2019",1,1,0,67150,781,86
"29380","89188","2019",3,3,0,87650,1195.33333333333,78.6666666666667
"29381","89189","2019",8,8,0,136162.5,1304.75,110.75
"29382","89190","2019",1,1,0,73000,1304,56
"29383","89191","2019",1,1,0,59800,893,67
"29384","89194","2019",5,5,0,133200,978.2,109.4
"29385","89195","2019",10,10,0,129748,1562.1,84.6
"29386","89196","2019",15,15,0,111386.666666667,1161.46666666667,97.4666666666667
"29387","89197","2019",13,13,0,120518.769230769,1223.92307692308,103.461538461538
"29388","89198","2019",19,19,0,142810.526315789,1670.63157894737,85.5263157894737
"29389","89199","2019",5,5,0,109924,1181.4,96.8
"29390","89200","2019",3,3,0,117803.333333333,982.666666666667,123
"29391","89201","2019",20,20,0,149385.25,1432.85,107.25
"29392","89202","2019",8,8,0,128976.875,1428.875,95.125
"29393","89203","2019",2,2,0,128500,927.5,145
"29394","89204","2019",9,9,0,117011.111111111,954.111111111111,128.444444444444
"29395","89205","2019",3,3,0,99463.3333333333,1194.66666666667,81.6666666666667
"29396","89206","2019",87,70,17,101297.643678161,1185.49425287356,87.2413793103448
"29397","89208","2019",9,9,0,77476.6666666667,974.111111111111,86.6666666666667
"29398","89209","2019",3,3,0,113666.666666667,1318.66666666667,86.3333333333333
"29399","89212","2019",5,5,0,135400,1003,140.4
"29400","89214","2019",5,5,0,88200,833.8,108
"29401","89215","2019",2,2,0,35000,654,50
"29402","89216","2019",6,6,0,95166.6666666667,1175.16666666667,95.3333333333333
"29403","89217","2019",5,5,0,127010,1422,101.8
"29404","89218","2019",16,15,1,102468.75,1513.0625,77.9375
"29405","89219","2019",1,1,0,61227,862,71
"29406","89220","2019",7,7,0,72142.8571428571,835.857142857143,81.1428571428571
"29407","89221","2019",5,5,0,101400,969.6,103.8
"29408","89222","2019",2,2,0,124000,1185,104.5
"29409","89223","2019",9,9,0,96405.5555555556,1047,93.3333333333333
"29410","89224","2019",3,3,0,86766.6666666667,1068.66666666667,81.3333333333333
"29411","89225","2019",3,3,0,101000,646.333333333333,131
"29412","89226","2019",1,1,0,133000,1415,94
"29413","89227","2019",32,32,0,109815.625,1119.40625,104.96875
"29414","89228","2019",15,14,1,172196.133333333,1427.53333333333,133.733333333333
"29415","89229","2019",5,5,0,130340,1090.8,119.8
"29416","89230","2019",8,8,0,135581.25,1332.5,101.875
"29417","89232","2019",7,7,0,100928.571428571,1115.57142857143,92.5714285714286
"29418","89233","2019",3,3,0,96000,982.333333333333,90.6666666666667
"29419","89234","2019",1,1,0,105000,840,125
"29420","89235","2019",8,8,0,115206.5,1138.375,99.25
"29421","89236","2019",12,12,0,135700,1299.91666666667,106.166666666667
"29422","89237","2019",10,10,0,73070,788.6,99.6
"29423","89238","2019",2,2,0,63250,681,89
"29424","89239","2019",8,8,0,119625,1331,90.5
"29425","89240","2019",5,5,0,92650,934,104.8
"29426","89242","2019",9,9,0,178661.111111111,1423.55555555556,102.777777777778
"29427","89245","2019",17,17,0,151812.058823529,1253.29411764706,123
"29428","89246","2019",9,9,0,168587.666666667,1533.22222222222,115.222222222222
"29429","89247","2019",4,4,0,93477.5,875.25,101.75
"29430","89249","2019",1,1,0,110000,1264,87
"29431","89250","2019",1,1,0,50100,477,105
"29432","89251","2019",3,3,0,91000,1628,65.3333333333333
"29433","89252","2019",3,3,0,53666.6666666667,511.333333333333,108
"29434","89253","2019",7,7,0,53071.4285714286,718.142857142857,75.7142857142857
"29435","89254","2019",8,8,0,101075,1040.75,91
"29436","89255","2019",21,21,0,151332.857142857,1605.47619047619,102.380952380952
"29437","89256","2019",4,4,0,70625,756.25,100.25
"29438","89257","2019",90,72,18,84321.8888888889,1129.56666666667,77.5555555555556
"29439","89259","2019",2,2,0,160000,949,166
"29440","89261","2019",1,0,1,60000,750,80
"29441","89262","2019",4,4,0,33500,511.5,64.5
"29442","89263","2019",54,53,1,147618.259259259,1613.64814814815,92.9444444444444
"29443","89264","2019",11,11,0,146354.545454545,1553.72727272727,93.5454545454545
"29444","89265","2019",10,10,0,139016.7,1148.4,138.1
"29445","89266","2019",3,3,0,131663.333333333,970,136.666666666667
"29446","89267","2019",5,5,0,188100,1597.8,115.6
"29447","89268","2019",6,6,0,118666.666666667,1282.16666666667,107.5
"29448","89270","2019",2,2,0,109750,1143.5,97
"29449","89271","2019",2,2,0,89153,1126.5,78
"29450","89272","2019",4,4,0,111680,984.5,110.25
"29451","89273","2019",10,10,0,89350,1018.3,84.4
"29452","89274","2019",9,9,0,133055.555555556,1300.55555555556,101.111111111111
"29453","89276","2019",12,12,0,119683.75,912.25,129.833333333333
"29454","89277","2019",6,6,0,77951.6666666667,928.333333333333,88.6666666666667
"29455","89278","2019",7,7,0,132585.714285714,1300.71428571429,107.285714285714
"29456","89279","2019",18,18,0,95438.8333333333,1036.66666666667,96.9444444444444
"29457","89280","2019",4,3,1,68250,842.25,88
"29458","89281","2019",6,6,0,107500,865.166666666667,129.833333333333
"29459","89282","2019",10,10,0,140549.1,1253.1,115.8
"29460","89283","2019",10,10,0,140877.9,1403.9,101.4
"29461","89285","2019",6,6,0,130333.333333333,1254.16666666667,104.666666666667
"29462","89286","2019",10,10,0,108333.2,1137.2,100.9
"29463","89287","2019",60,52,8,141370.316666667,1539.2,93.8166666666667
"29464","89288","2019",2,2,0,131000,981.5,138.5
"29465","89291","2019",2,2,0,146150,1347,104
"29466","89292","2019",3,3,0,78533.3333333333,732,101
"29467","89295","2019",10,9,1,190050,1543.8,127.1
"29468","89296","2019",1,1,0,97500,1083,90
"29469","89297","2019",1,1,0,182000,1456,125
"29470","89298","2019",10,10,0,131733.5,1350,118.5
"29471","89300","2019",2,2,0,54000,949,51.5
"29472","89302","2019",3,3,0,128166.666666667,884.666666666667,146
"29473","89303","2019",3,3,0,109666.666666667,1393.33333333333,70.3333333333333
"29474","89304","2019",7,7,0,119428.571428571,1460.28571428571,82.4285714285714
"29475","89306","2019",2,2,0,123335,1083,111
"29476","89307","2019",13,13,0,102858.461538462,1222.15384615385,85.3076923076923
"29477","89308","2019",3,3,0,83666.6666666667,823.666666666667,95
"29478","89309","2019",53,49,4,104978.660377358,1309.01886792453,82.622641509434
"29479","89310","2019",2,2,0,98500,987.5,95.5
"29480","89311","2019",13,13,0,132851.538461538,1247.76923076923,107.846153846154
"29481","89312","2019",3,3,0,54000,663.666666666667,84.6666666666667
"29482","89313","2019",1,1,0,58000,563,103
"29483","89314","2019",1,1,0,150500,1052,143
"29484","89315","2019",1,1,0,93000,2022,46
"29485","89316","2019",3,3,0,80945,801,112.333333333333
"29486","89318","2019",11,11,0,109639.090909091,1192.63636363636,97.8181818181818
"29487","89319","2019",4,4,0,115750,1147.75,105.5
"29488","89321","2019",10,7,3,67956,974.4,68
"29489","89324","2019",17,17,0,87694.1176470588,1216.82352941176,74.0588235294118
"29490","89325","2019",1,1,0,20000,714,28
"29491","89326","2019",9,9,0,113600,1365.44444444444,84.4444444444444
"29492","89327","2019",5,5,0,91400,1105.2,83
"29493","89328","2019",6,6,0,166416.666666667,1458,118.166666666667
"29494","89331","2019",4,4,0,77825,925.25,103.25
"29495","89332","2019",20,20,0,155696.7,1464.45,107.5
"29496","89333","2019",2,2,0,87500,1398.5,56
"29497","89334","2019",5,5,0,138000,1403.8,97
"29498","89335","2019",8,8,0,140722.625,1151.75,118.625
"29499","89336","2019",3,3,0,140666.666666667,1552.33333333333,93.3333333333333
"29500","89337","2019",11,11,0,134618.181818182,1263.36363636364,111.909090909091
"29501","89338","2019",33,29,4,125593.939393939,1591.36363636364,80.2424242424242
"29502","89339","2019",1,1,0,69000,896,77
"29503","89341","2019",4,4,0,74057.5,889.25,95
"29504","89342","2019",8,7,1,157430,1628.875,99.125
"29505","89344","2019",24,23,1,72100.3333333333,873.75,79.6666666666667
"29506","89345","2019",38,33,5,84589.4736842105,963.5,90.3421052631579
"29507","89346","2019",54,42,12,159555.87037037,1649.12962962963,98
"29508","89347","2019",4,4,0,171000,1723.5,100.25
"29509","89348","2019",48,47,1,101066.104166667,1189.33333333333,85.6041666666667
"29510","89349","2019",6,6,0,94041.6666666667,887.333333333333,108.833333333333
"29511","89350","2019",3,3,0,102333.333333333,921.666666666667,105.333333333333
"29512","89351","2019",7,7,0,90070,941.428571428571,96.1428571428571
"29513","89352","2019",4,4,0,184975,1380,114.75
"29514","89353","2019",5,5,0,116000,1207.8,91.4
"29515","89354","2019",17,17,0,131976.470588235,1431.76470588235,90.9411764705882
"29516","89355","2019",3,3,0,91666.6666666667,854.333333333333,115
"29517","89359","2019",10,8,2,102250,1339.4,86
"29518","89360","2019",7,7,0,199571.428571429,1502.14285714286,140.571428571429
"29519","89361","2019",5,5,0,116600,1509,84.8
"29520","89362","2019",3,3,0,157000,2366,85.3333333333333
"29521","89364","2019",6,6,0,73583.3333333333,1120.5,67.8333333333333
"29522","89365","2019",9,9,0,133999.555555556,1215.33333333333,99.1111111111111
"29523","89367","2019",4,4,0,119250,1099.75,97.75
"29524","89368","2019",16,15,1,87084.875,948.25,98.4375
"29525","89369","2019",7,7,0,185611.428571429,1399.85714285714,125
"29526","89370","2019",16,15,1,144995,1345.75,107.8125
"29527","89371","2019",1,1,0,168843,1456,116
"29528","89373","2019",3,3,0,185000,1764.66666666667,104.333333333333
"29529","89376","2019",2,2,0,79500,909.5,91
"29530","89377","2019",1,1,0,118000,1494,79
"29531","89378","2019",7,7,0,104453.571428571,986.714285714286,107.285714285714
"29532","89379","2019",2,2,0,111250,1027,107.5
"29533","89380","2019",21,17,4,270500.952380952,3462.7619047619,77.3333333333333
"29534","89382","2019",18,17,1,115318.888888889,1278.44444444444,86.7222222222222
"29535","89383","2019",1,1,0,185000,1542,120
"29536","89384","2019",5,5,0,104700,942.6,106
"29537","89385","2019",2,2,0,86000,1133,84.5
"29538","89386","2019",1,1,0,50750,634,80
"29539","89387","2019",387,159,228,112241.720930233,1506.12919896641,74.1782945736434
"29540","89388","2019",7,7,0,97808.8571428571,927.714285714286,115
"29541","89390","2019",11,11,0,154063.636363636,1573.18181818182,103.363636363636
"29542","89391","2019",10,10,0,138250,1611.9,86.6
"29543","89392","2019",4,4,0,123500,1266.75,95.25
"29544","89393","2019",1,1,0,140000,824,170
"29545","89394","2019",4,4,0,53650,605.75,89.75
"29546","89395","2019",6,6,0,73200,824.833333333333,90.5
"29547","89397","2019",8,8,0,102675.625,1016.5,109.5
"29548","89398","2019",6,6,0,66833.3333333333,644,104.333333333333
"29549","89399","2019",16,16,0,126518.75,1382.625,97.75
"29550","89400","2019",6,6,0,64241.6666666667,555.666666666667,98.5
"29551","89402","2019",1,1,0,90000,1200,75
"29552","89403","2019",2,2,0,78500,774,92.5
"29553","89404","2019",6,6,0,165275,1980.66666666667,91.3333333333333
"29554","89405","2019",8,8,0,79687.5,1071.625,95.5
"29555","89407","2019",8,8,0,100875,729,133.5
"29556","89408","2019",6,6,0,122216.666666667,1522,90.6666666666667
"29557","89409","2019",1,1,0,189000,1575,120
"29558","89410","2019",1,1,0,145000,863,168
"29559","89411","2019",16,16,0,125818.75,1241.0625,105.9375
"29560","89412","2019",1,1,0,117500,979,120
"29561","89414","2019",38,27,11,91835.1315789474,1143.36842105263,80.1842105263158
"29562","89416","2019",6,6,0,47583.3333333333,665,74
"29563","89417","2019",2,2,0,82039.5,863.5,96
"29564","89418","2019",38,28,10,77884.4736842105,972.236842105263,85.9210526315789
"29565","89419","2019",34,32,2,104003.529411765,1254.47058823529,85.9411764705882
"29566","89420","2019",27,27,0,91437.9259259259,970.37037037037,95.7777777777778
"29567","89422","2019",1,1,0,75000,750,100
"29568","89423","2019",1,1,0,217000,1219,178
"29569","89424","2019",3,3,0,76433.3333333333,717.666666666667,90.6666666666667
"29570","89425","2019",7,7,0,131428.571428571,1290,108.142857142857
"29571","89426","2019",7,7,0,112535.714285714,1212.71428571429,89.5714285714286
"29572","89427","2019",11,11,0,120364.090909091,1347.18181818182,92.6363636363636
"29573","89428","2019",6,6,0,125816.666666667,1181.16666666667,105.833333333333
"29574","89430","2019",2,2,0,60000,837,65
"29575","89432","2019",7,6,1,112871.428571429,1039.28571428571,104.714285714286
"29576","89433","2019",5,5,0,115611.2,1451,82.4
"29577","89434","2019",5,5,0,89700,982,92.4
"29578","89436","2019",13,13,0,92115.3846153846,1104.84615384615,89.3076923076923
"29579","89437","2019",4,4,0,143250,1385.5,104.75
"29580","89438","2019",19,19,0,125678.526315789,1387.63157894737,91.2631578947368
"29581","89439","2019",14,13,1,87741.5,927.571428571429,97.7857142857143
"29582","89440","2019",5,5,0,106600,1151.6,102.2
"29583","89441","2019",19,19,0,81962.1052631579,886.315789473684,96.3157894736842
"29584","89442","2019",2,2,0,132450,1405.5,104
"29585","89443","2019",26,26,0,129853.923076923,1531.42307692308,87.2692307692308
"29586","89446","2019",6,6,0,166306.666666667,2249,79.6666666666667
"29587","89447","2019",1,1,0,35000,467,75
"29588","89449","2019",32,32,0,163757.15625,1542.875,107.09375
"29589","89450","2019",9,9,0,100262.888888889,1100.55555555556,106.111111111111
"29590","89451","2019",2,2,0,52250,723.5,70.5
"29591","89452","2019",5,5,0,138800,1227.4,105.8
"29592","89453","2019",9,9,0,211272.666666667,1669,125.888888888889
"29593","89456","2019",11,11,0,111411.363636364,1596.27272727273,75.2727272727273
"29594","89458","2019",1,1,0,180460,1719,105
"29595","89459","2019",6,6,0,158363.333333333,1121.66666666667,142.5
"29596","89460","2019",43,39,4,142678.837209302,1734.79069767442,90.6046511627907
"29597","89461","2019",14,12,2,77428.5714285714,957.5,89.0714285714286
"29598","89462","2019",7,7,0,109342.857142857,1130.57142857143,99.1428571428571
"29599","89463","2019",4,4,0,125850,1426.5,88.5
"29600","89464","2019",89,78,11,105444.337078652,1258.88764044944,86.2359550561798
"29601","89465","2019",7,7,0,122571.428571429,1161.42857142857,110.142857142857
"29602","89466","2019",4,4,0,183780,1674.75,109.75
"29603","89467","2019",11,11,0,159136.363636364,1574.09090909091,103.545454545455
"29604","89468","2019",7,7,0,97128.5714285714,1133.28571428571,89.7142857142857
"29605","89469","2019",13,13,0,133615.384615385,1248.61538461538,112.923076923077
"29606","89471","2019",2,2,0,135500,923.5,136.5
"29607","89472","2019",9,9,0,130472.777777778,1005.66666666667,124.333333333333
"29608","89474","2019",2,2,0,76250,816,98.5
"29609","89475","2019",3,3,0,51735,719,73
"29610","89477","2019",1,1,0,2e+05,699,286
"29611","89478","2019",15,15,0,112206.666666667,1307.66666666667,87.8666666666667
"29612","89479","2019",7,7,0,103778.571428571,1027.85714285714,109
"29613","89480","2019",21,21,0,154192.380952381,1998.19047619048,86.0952380952381
"29614","89482","2019",1,1,0,59500,567,105
"29615","89483","2019",12,12,0,119419.166666667,1162.25,113.666666666667
"29616","89485","2019",4,4,0,84137.5,1119,72
"29617","89486","2019",2,2,0,103250,1411.5,70
"29618","90001","2019",8,8,0,190300.125,1728.375,109.625
"29619","90002","2019",4,4,0,223200,1825.25,122.75
"29620","90003","2019",12,8,4,200670.833333333,1441.25,130.25
"29621","90004","2019",4,3,1,141625,1408,106.5
"29622","90005","2019",2,1,1,77775,1229.5,75
"29623","90006","2019",5,5,0,108180,1083.4,96
"29624","90007","2019",4,4,0,193386.25,1282.5,139
"29625","90008","2019",60,41,19,158985.916666667,1609.51666666667,100.783333333333
"29626","90009","2019",43,27,16,110119.604651163,1253.23255813953,91.0930232558139
"29627","90010","2019",643,101,542,95058.7776049767,1277.83981337481,73.5085536547434
"29628","90011","2019",2,2,0,157034,1323,112.5
"29629","90012","2019",13,10,3,240413.615384615,2034.69230769231,120.076923076923
"29630","90013","2019",1,1,0,248000,1722,144
"29631","90014","2019",5,5,0,233480,2213.6,122.2
"29632","90015","2019",2,2,0,156500,1505.5,102.5
"29633","90017","2019",11,6,5,146968.181818182,1511.90909090909,93.2727272727273
"29634","90018","2019",1,1,0,245700,1890,130
"29635","90020","2019",1,1,0,228550,1970,116
"29636","90021","2019",6,6,0,208082.5,1931,103.833333333333
"29637","90022","2019",35,24,11,127402.8,1369.14285714286,93.6
"29638","90023","2019",15,14,1,157508.333333333,1459,110.866666666667
"29639","90024","2019",2,2,0,193000,1953.5,98
"29640","90025","2019",3,2,1,126875,1268.33333333333,124.333333333333
"29641","90026","2019",10,9,1,243858,1854.2,132.2
"29642","90028","2019",6,5,1,148733.333333333,1449.66666666667,101.5
"29643","90029","2019",19,15,4,171435.263157895,1562.52631578947,115.631578947368
"29644","90030","2019",2,2,0,302125,1572.5,191
"29645","90031","2019",6,6,0,198525,2130.5,96.6666666666667
"29646","90032","2019",40,19,21,126933.45,1447.125,89.475
"29647","90033","2019",60,33,27,138681.333333333,1515.85,92.2666666666667
"29648","90034","2019",5,3,2,156900,1483.6,105
"29649","90035","2019",7,5,2,108771.428571429,1151.28571428571,99
"29650","90036","2019",2,2,0,240125,1935,126.5
"29651","90037","2019",7,6,1,157628.571428571,1506,106.428571428571
"29652","90039","2019",26,20,6,188313.461538462,1640.73076923077,114.769230769231
"29653","90041","2019",12,9,3,143595.833333333,1503.83333333333,99.5
"29654","90042","2019",18,15,3,202740,1702.5,121.333333333333
"29655","90043","2019",10,8,2,206241,1957.9,107.8
"29656","90044","2019",1,1,0,175000,1199,146
"29657","90045","2019",5,5,0,126400,1417.4,103
"29658","90046","2019",3,3,0,198333.333333333,1940.33333333333,103
"29659","90047","2019",7,6,1,199571.428571429,1683.14285714286,121.285714285714
"29660","90048","2019",3,3,0,205650,2004.33333333333,104
"29661","90049","2019",19,15,4,150115.789473684,1612.47368421053,101.473684210526
"29662","90050","2019",3,3,0,168416.666666667,1868.33333333333,90.3333333333333
"29663","90051","2019",2,1,1,131080,1203,109.5
"29664","90052","2019",34,22,12,116797.058823529,1234.44117647059,93.4117647058823
"29665","90053","2019",22,11,11,146009,1813.77272727273,86.5
"29666","90054","2019",5,4,1,164400,1933.4,89.2
"29667","90055","2019",6,6,0,198836.666666667,1661,126.5
"29668","90056","2019",17,16,1,164259.588235294,1601.05882352941,107.941176470588
"29669","90057","2019",7,7,0,200571.428571429,1922.42857142857,112.142857142857
"29670","90058","2019",6,3,3,132496.666666667,1061.5,125
"29671","90060","2019",2,2,0,293200,2321,127
"29672","90062","2019",1,1,0,171500,1949,88
"29673","90063","2019",3,2,1,132500,1301.33333333333,102.333333333333
"29674","90065","2019",11,11,0,114656.363636364,1273.45454545455,113.272727272727
"29675","90066","2019",2,2,0,153500,1518.5,97
"29676","90067","2019",5,4,1,235568,2388.2,95
"29677","90068","2019",10,7,3,228081,2052.4,113.5
"29678","90069","2019",18,17,1,168289.055555556,1533.61111111111,112.444444444444
"29679","90070","2019",6,4,2,175916.666666667,1326.83333333333,136.5
"29680","90071","2019",19,10,9,140907.736842105,1581.05263157895,92.3684210526316
"29681","90072","2019",6,4,2,117916.666666667,1378,86.6666666666667
"29682","90074","2019",1,1,0,269950,1800,150
"29683","90075","2019",35,18,17,159405.885714286,1604.28571428571,101.057142857143
"29684","90076","2019",12,8,4,194203.666666667,1815.16666666667,114.583333333333
"29685","90077","2019",1,1,0,192250,1657,116
"29686","90078","2019",1,1,0,320000,2192,146
"29687","90079","2019",5,5,0,150380,1682,90.4
"29688","90080","2019",6,6,0,154344.333333333,1493.33333333333,111.5
"29689","90081","2019",6,4,2,154550,1446.16666666667,108.333333333333
"29690","90082","2019",2,2,0,224000,2410.5,102.5
"29691","90084","2019",3,3,0,209040,1806.33333333333,123
"29692","90085","2019",3,3,0,138566.666666667,1388.33333333333,92.3333333333333
"29693","90086","2019",1,1,0,110000,1100,100
"29694","90087","2019",14,12,2,180909.785714286,1532.35714285714,126.785714285714
"29695","90088","2019",10,9,1,163670,1557.2,118.4
"29696","90089","2019",20,16,4,148644.5,1390.65,108.4
"29697","90090","2019",2,2,0,261500,1884,137
"29698","90093","2019",10,9,1,131981.3,1384.3,93
"29699","90094","2019",2,1,1,171125,1349,128.5
"29700","90095","2019",4,4,0,161475,1400.75,122
"29701","90096","2019",4,4,0,191412.5,1581.25,123.5
"29702","90097","2019",13,11,2,186776.923076923,1752.69230769231,103.769230769231
"29703","90099","2019",65,28,37,118266.292307692,1429.49230769231,84.4923076923077
"29704","90100","2019",2,2,0,235100,2285.5,103
"29705","90101","2019",3,3,0,165333.333333333,1501.66666666667,108.333333333333
"29706","90102","2019",16,16,0,180800,1529.875,118.4375
"29707","90103","2019",4,3,1,151437.5,1629.25,98.75
"29708","90104","2019",11,3,8,160700.454545455,1844.27272727273,87.4545454545455
"29709","90105","2019",2,2,0,150490,1320.5,115
"29710","91001","2019",3,3,0,201666.666666667,1914,110
"29711","91016","2019",54,42,12,167582.296296296,1956.98148148148,87.2407407407407
"29712","91017","2019",25,25,0,279561.4,2837.16,101.88
"29713","91021","2019",166,40,126,173545.801204819,3042.24698795181,59.1385542168675
"29714","91022","2019",2,2,0,248000,1666,148.5
"29715","91027","2019",421,151,270,223244.726840855,3307.53919239905,69.0641330166271
"29716","91035","2019",4,4,0,209000,1906.75,119.25
"29717","91037","2019",3,3,0,349333.333333333,2559.33333333333,147.666666666667
"29718","91038","2019",17,14,3,282777.647058824,2799.94117647059,106.764705882353
"29719","91041","2019",8,8,0,363097.5,3493.75,108
"29720","91044","2019",63,43,20,309237.619047619,3536.73015873016,92.6190476190476
"29721","91045","2019",103,79,24,250725.844660194,2916.98058252427,91.5436893203884
"29722","91047","2019",21,16,5,272423.80952381,3381.33333333333,85.4761904761905
"29723","91064","2019",67,32,35,424223.626865672,4622.98507462687,91
"29724","91069","2019",7,6,1,226642.857142857,1858,127.285714285714
"29725","91075","2019",3,2,1,159753.333333333,2180.66666666667,73.3333333333333
"29726","91079","2019",22,22,0,227247.272727273,2093.54545454545,118.909090909091
"29727","91080","2019",13,12,1,254257.692307692,2370.15384615385,114.153846153846
"29728","91081","2019",14,14,0,219946.428571429,2432.21428571429,91.5714285714286
"29729","91085","2019",54,44,10,240425.981481481,3069.90740740741,82.2592592592593
"29730","91086","2019",140,103,37,257346.9,2795.24285714286,93.8285714285714
"29731","91093","2019",5,5,0,382160,2383.6,161.6
"29732","91095","2019",23,22,1,272992,3194.69565217391,93.0434782608696
"29733","91097","2019",162,65,97,208263.975308642,2627.66666666667,81.1728395061728
"29734","91098","2019",2,2,0,232545,2220,107.5
"29735","91099","2019",57,49,8,233364.842105263,2649.71929824561,94.4561403508772
"29736","91100","2019",17,17,0,237680.588235294,2495,100.117647058824
"29737","91103","2019",358,146,212,203804.17877095,3057.91620111732,69.8631284916201
"29738","91105","2019",84,74,10,245564.821428571,2941.29761904762,86.1309523809524
"29739","91106","2019",19,18,1,266210.526315789,2735.89473684211,103.947368421053
"29740","91109","2019",17,15,2,232650.882352941,2562.17647058824,94.4705882352941
"29741","91111","2019",44,34,10,281788.931818182,2865.77272727273,101.568181818182
"29742","91112","2019",5,5,0,160800,2173.2,89.4
"29743","91114","2019",394,193,201,257117.517766497,3289.81979695431,80.989847715736
"29744","91115","2019",54,40,14,226572.314814815,3058.57407407407,78.6481481481482
"29745","91121","2019",10,10,0,212390,2990.2,75.4
"29746","91122","2019",118,78,40,334757.79661017,4182.77118644068,86.2033898305085
"29747","91129","2019",55,47,8,215190.181818182,2764.32727272727,81.6909090909091
"29748","91130","2019",21,19,2,236645.952380952,2163.42857142857,114.761904761905
"29749","91131","2019",7,7,0,184642.857142857,1841.85714285714,98.2857142857143
"29750","91132","2019",19,12,7,202834.210526316,3008.89473684211,71.4736842105263
"29751","91135","2019",34,34,0,272701.470588235,2666.91176470588,110.470588235294
"29752","91136","2019",31,27,4,297250.483870968,3577.83870967742,96.9032258064516
"29753","91137","2019",12,12,0,205658.333333333,1993,106.833333333333
"29754","91145","2019",2,2,0,157500,2258,77
"29755","91156","2019",33,26,7,258515.878787879,2898.84848484848,93.0606060606061
"29756","91159","2019",16,15,1,279028.5,2787.25,105.8125
"29757","91161","2019",363,73,290,192060.355371901,2810.02754820937,71.3140495867769
"29758","91174","2019",754,187,567,149322.453580902,2519.91114058355,60.9442970822281
"29759","91175","2019",31,23,8,225138.258064516,3172.74193548387,88.9677419354839
"29760","91179","2019",68,31,37,244120.970588235,2816.54411764706,88.6617647058823
"29761","91180","2019",3,3,0,313233.333333333,2834.33333333333,106.333333333333
"29762","91184","2019",4,4,0,272250,2550,108
"29763","91186","2019",5,3,2,289760,3338.2,94.6
"29764","91191","2019",149,69,80,231144.288590604,3030.57046979866,79.9060402684564
"29765","91195","2019",17,16,1,258908.470588235,2951.82352941176,102
"29766","91198","2019",23,17,6,240151.086956522,2603.78260869565,94.0869565217391
"29767","91200","2019",171,86,85,217503.122807018,2883.33918128655,79.9824561403509
"29768","91201","2019",373,237,136,266412.490616622,3368.24932975871,82.911528150134
"29769","91204","2019",9,9,0,293466.666666667,2717.77777777778,109
"29770","91207","2019",55,34,21,232052.254545455,2936.16363636364,82.6181818181818
"29771","91215","2019",127,37,90,151936.826771654,2028.1811023622,74.8503937007874
"29772","91216","2019",145,85,60,258539.386206897,3526.73103448276,75.4551724137931
"29773","91223","2019",391,162,229,156146.242966752,2331.72378516624,68.4526854219949
"29774","91225","2019",33,29,4,390266.363636364,2994.66666666667,136.121212121212
"29775","91226","2019",107,69,38,220204.38317757,3497.68224299065,74.0280373831776
"29776","91228","2019",792,147,645,150467.185606061,2194.08964646465,70.0820707070707
"29777","91232","2019",79,51,28,207168.987341772,2721.10126582278,80.2911392405063
"29778","91235","2019",53,11,42,167852.490566038,2746.69811320755,62.3584905660377
"29779","91240","2019",7,6,1,367285.714285714,3856.71428571429,111.428571428571
"29780","91243","2019",33,24,9,289274.515151515,3170.69696969697,97.7878787878788
"29781","91244","2019",13,11,2,273155,2930.61538461538,94.6153846153846
"29782","91247","2019",4,4,0,247750,2196.5,117
"29783","91248","2019",5,3,2,184423,1825.6,102.6
"29784","91249","2019",42,30,12,273794.928571429,2850.54761904762,95.7142857142857
"29785","91272","2019",290,162,128,372055.993103448,3920.24827586207,100.693103448276
"29786","91273","2019",16,15,1,220352.5,2613.1875,95.625
"29787","91274","2019",15,7,8,289319.333333333,4153.86666666667,75.6666666666667
"29788","91275","2019",32,29,3,352403.71875,3586.3125,107.78125
"29789","91284","2019",21,20,1,235186.619047619,2519.7619047619,95.9523809523809
"29790","91286","2019",51,34,17,203943.137254902,2361.6862745098,88.6470588235294
"29791","91292","2019",7,6,1,346571.428571429,3989.42857142857,89.4285714285714
"29792","91293","2019",19,15,4,229700,2366.31578947368,102.421052631579
"29793","91294","2019",11,10,1,223615.454545455,2170,118.090909090909
"29794","91312","2019",127,85,42,396896.606299213,4439.84251968504,93.6850393700787
"29795","91315","2019",101,92,9,247112.613861386,2994.40594059406,87.950495049505
"29796","91318","2019",37,32,5,255552.702702703,3010.94594594595,95.9189189189189
"29797","91319","2019",4,4,0,373487.5,2738,137
"29798","91326","2019",277,92,185,241343.566787004,3637.90613718412,66.9205776173285
"29799","91330","2019",76,63,13,262892.486842105,2901.06578947368,94.5
"29800","91332","2019",18,13,5,228911.666666667,2956.5,82
"29801","91333","2019",62,49,13,266736.193548387,3231.09677419355,85.1290322580645
"29802","91338","2019",75,62,13,313391.733333333,3401.08,96.92
"29803","91339","2019",88,53,35,256012.295454545,3113.57954545455,85.3522727272727
"29804","91340","2019",99,73,26,253987.242424242,2920.14141414141,90.969696969697
"29805","91345","2019",310,107,203,231357.029032258,3023.84838709677,73.8064516129032
"29806","91347","2019",79,57,22,279301.620253165,3210.15189873418,91.0632911392405
"29807","91359","2019",52,43,9,196756.730769231,2516.42307692308,80.5
"29808","91363","2019",95,76,19,315179.231578947,3415.02105263158,97.5473684210526
"29809","91374","2019",3,3,0,191188.333333333,1639.33333333333,120
"29810","91376","2019",77,53,24,263998.142857143,3219.61038961039,86.0649350649351
"29811","91377","2019",569,79,490,242761.356766257,3657.2460456942,69.0509666080844
"29812","91378","2019",6,4,2,202191.666666667,2260.83333333333,111
"29813","91386","2019",246,161,85,248651.447154472,2915.66666666667,91.4918699186992
"29814","91390","2019",64,57,7,190856.40625,2082.78125,100.1875
"29815","91393","2019",14,14,0,202002.142857143,1870.14285714286,110.357142857143
"29816","91399","2019",2,2,0,307420,2121.5,160
"29817","91405","2019",82,63,19,250070.817073171,2938.0487804878,89.4756097560976
"29818","91408","2019",18,17,1,344123.333333333,3009.83333333333,125.5
"29819","91411","2019",28,24,4,377782.107142857,3632.85714285714,106.142857142857
"29820","91412","2019",5,5,0,256600,2475.2,113.4
"29821","91414","2019",8,8,0,192373.75,2147.5,89.5
"29822","91421","2019",300,164,136,271607.44,3616.11666666667,77.9066666666667
"29823","91425","2019",131,74,57,284697.618320611,3212.81679389313,89.6030534351145
"29824","91432","2019",191,116,75,269981.64921466,3659.86387434555,77.5026178010471
"29825","91433","2019",70,47,23,236072.657142857,2485.45714285714,98.5285714285714
"29826","91434","2019",327,184,143,240407.470948012,3197.74923547401,76.8134556574924
"29827","91435","2019",4,4,0,588076.25,4223.25,178.25
"29828","91441","2019",2,2,0,216300.5,2013,103.5
"29829","91457","2019",41,37,4,276499.707317073,2781.26829268293,106.024390243902
"29830","91458","2019",58,38,20,321294.620689655,3512.27586206897,92.7068965517241
"29831","91461","2019",60,46,14,228650.083333333,2920.86666666667,81.1666666666667
"29832","91463","2019",14,14,0,244557.142857143,2623.28571428571,99.7857142857143
"29833","91468","2019",26,23,3,268161.692307692,2845.5,98
"29834","91469","2019",19,11,8,203764.210526316,2344.57894736842,89.3157894736842
"29835","91471","2019",235,135,100,343691.255319149,4310.28936170213,83.0723404255319
"29836","91473","2019",2,2,0,213327.5,2839.5,74
"29837","91477","2019",438,151,287,295278.413242009,3899.74657534247,77.8721461187215
"29838","91479","2019",88,70,18,301603.170454545,4110.71590909091,76.8181818181818
"29839","91482","2019",16,9,7,262741.75,2683.0625,100.0625
"29840","91494","2019",53,42,11,310082.509433962,3328.77358490566,98.2641509433962
"29841","91495","2019",5,5,0,191200,1973.6,98.8
"29842","91507","2019",4,4,0,283232.5,2041,135.75
"29843","91508","2019",7,7,0,237957.142857143,2095.42857142857,127.142857142857
"29844","91511","2019",47,30,17,154983.829787234,1783.59574468085,87.4042553191489
"29845","91514","2019",112,74,38,240394.580357143,3064.80357142857,83.9196428571429
"29846","91519","2019",8,8,0,284437.5,2213.625,129.375
"29847","91521","2019",342,127,215,178809.228070175,2482.98245614035,73.4415204678363
"29848","91525","2019",20,16,4,245388.8,3188.1,96.7
"29849","91533","2019",36,31,5,186112.916666667,2271.27777777778,85.4166666666667
"29850","91534","2019",29,23,6,444641.275862069,4345.8275862069,107.275862068966
"29851","91538","2019",5,5,0,601938,3239.2,187.4
"29852","91540","2019",84,65,19,233984.392857143,2703.71428571429,90.5833333333333
"29853","91544","2019",6,5,1,321908.333333333,2337,135.666666666667
"29854","91546","2019",17,16,1,272385.294117647,2764.05882352941,102.176470588235
"29855","91547","2019",10,10,0,212550,1912.1,116
"29856","91549","2019",462,253,209,250160.017316017,3310.87662337662,76.7012987012987
"29857","91552","2019",126,89,37,232722.936507937,2882.8253968254,83.0634920634921
"29858","91553","2019",126,86,40,289126.865079365,3120.06349206349,96.1904761904762
"29859","91556","2019",6,6,0,347666.666666667,2609.66666666667,134.666666666667
"29860","91560","2019",2,2,0,347200,3702.5,97
"29861","91568","2019",15,15,0,350209.733333333,2939.6,120.4
"29862","91570","2019",260,101,159,199254.834615385,2657.79230769231,75.3961538461539
"29863","91573","2019",155,104,51,253948.270967742,3012.35483870968,86.0064516129032
"29864","91577","2019",99,76,23,243534.555555556,2944.61616161616,86.2020202020202
"29865","91578","2019",5,5,0,301321,3211.8,94.2
"29866","91579","2019",44,26,18,209312.5,2796.90909090909,77.9545454545455
"29867","91581","2019",14,14,0,221693.285714286,2273.64285714286,98.5
"29868","91587","2019",105,49,56,270540.885714286,3369.72380952381,81.8380952380952
"29869","91589","2019",574,328,246,244292.388501742,3337.24912891986,75.1933797909408
"29870","91593","2019",22,22,0,243740.909090909,2657.36363636364,99.7727272727273
"29871","91599","2019",20,20,0,296704.5,3173.2,96.35
"29872","91600","2019",84,58,26,302360,3118.27380952381,103.785714285714
"29873","91602","2019",9,9,0,310955.555555556,2267.55555555556,139.777777777778
"29874","91613","2019",3,3,0,225000,2102.66666666667,108
"29875","91617","2019",50,37,13,274038,3330.88,85.38
"29876","91619","2019",3,3,0,196000,3223.33333333333,71.3333333333333
"29877","91629","2019",14,14,0,204112.142857143,2273.28571428571,100.357142857143
"29878","91630","2019",26,25,1,314620.769230769,2682.5,120.307692307692
"29879","91631","2019",30,26,4,354693.1,3046.16666666667,124.166666666667
"29880","91634","2019",16,16,0,286323.125,2815.0625,104.8125
"29881","91635","2019",24,23,1,499517.5,4952.41666666667,103.041666666667
"29882","91639","2019",11,10,1,227470,2375.27272727273,98.4545454545455
"29883","91645","2019",214,121,93,501632.696261682,4806.01401869159,106.182242990654
"29884","91648","2019",48,32,16,270443.479166667,3201.54166666667,92.3125
"29885","91649","2019",46,37,9,245334.391304348,2776.67391304348,91.2826086956522
"29886","91654","2019",4,4,0,257937.5,2876.25,121
"29887","91657","2019",351,215,136,227286.737891738,3292.59259259259,71.4472934472934
"29888","91659","2019",54,42,12,233716.111111111,2874.03703703704,82.4444444444444
"29889","91661","2019",127,62,65,281208.141732283,3753.8031496063,78.1811023622047
"29890","91662","2019",11,11,0,292220.909090909,2267.36363636364,130.545454545455
"29891","91665","2019",80,64,16,280419.5375,3208.4125,91.225
"29892","91666","2019",39,34,5,302528.461538462,3282.15384615385,99.6410256410256
"29893","91667","2019",86,69,17,327915.511627907,3664.67441860465,93.2558139534884
"29894","91671","2019",6,6,0,319553.333333333,3187.83333333333,130
"29895","91679","2019",12,6,6,307845.416666667,3844.25,82.8333333333333
"29896","91685","2019",59,42,17,283416.949152542,3250.05084745763,87.8305084745763
"29897","91687","2019",381,157,224,206846.485564304,3058.61154855643,69.8923884514436
"29898","91689","2019",125,54,71,327120.448,4062.824,83.56
"29899","91691","2019",460,223,237,255612.343478261,3277.36086956522,80.4065217391304
"29900","91692","2019",233,20,213,167167.56223176,2291.3991416309,73.6051502145923
"29901","92002","2019",740,257,483,402723.606756757,5246.90135135135,76.6432432432432
"29902","92004","2019",1552,135,1417,384685.036082474,6310.45940721649,60.0515463917526
"29903","92007","2019",245,48,197,305159.6,4989.58775510204,63.6326530612245
"29904","92009","2019",532,122,410,455086.879699248,6459.01503759398,68.3665413533835
"29905","92012","2019",2004,37,1967,523968.644211577,8641.07185628742,60.064371257485
"29906","92014","2019",276,39,237,370628.746376812,5524.80072463768,66.3514492753623
"29907","92019","2019",365,55,310,356571.726027397,4645.02465753425,75.8794520547945
"29908","92020","2019",477,75,402,371584.932914046,5860.73375262054,63.7085953878407
"29909","92022","2019",307,76,231,399910.214983713,5856.62214983713,67.5830618892508
"29910","92023","2019",701,208,493,416324.493580599,5943.84165477889,69.6590584878745
"29911","92024","2019",686,12,674,306031.174927114,6417.0583090379,47.9577259475219
"29912","92025","2019",1167,363,804,372596.586118252,5485.04541559554,66.5055698371894
"29913","92026","2019",1268,46,1222,407002.200315457,6755.42271293375,60.1711356466877
"29914","92032","2019",272,47,225,321544.301470588,4835.09191176471,66.5698529411765
"29915","92033","2019",298,67,231,576308.22147651,5923.73825503356,91.9832214765101
"29916","92035","2019",559,53,506,425085.010733453,6591.2915921288,62.6726296958855
"29917","92036","2019",183,39,144,246601.945355191,4144.74316939891,59.5245901639344
"29918","92040","2019",906,58,848,456827.811258278,7751.9701986755,58.4415011037528
"29919","92044","2019",1109,8,1101,505371.781785392,9098.92786293958,55.1956717763751
"29920","92046","2019",303,63,240,367392.98019802,6762.67326732673,54.4191419141914
"29921","92047","2019",22,11,11,899443.181818182,6543.13636363636,131.818181818182
"29922","92048","2019",621,93,528,444974.173913043,5621.58937198068,74.5507246376812
"29923","92049","2019",685,22,663,382653.764963504,7137.67153284672,53.356204379562
"29924","92050","2019",611,175,436,378051.081833061,5554.66612111293,68.8510638297872
"29925","92051","2019",960,11,949,830487.494791667,10366.4604166667,78.76875
"29926","92060","2019",415,42,373,360192.469879518,5250.18554216868,68.4987951807229
"29927","92062","2019",630,15,615,400128.706349206,6914.26507936508,58.3714285714286
"29928","92063","2019",1078,245,833,458133.926716141,6041.11502782931,72.808905380334
"29929","92064","2019",440,58,382,596296.725,7039.09772727273,81.4159090909091
"29930","92071","2019",223,42,181,534998.372197309,6443.17937219731,81.7354260089686
"29931","92072","2019",306,70,236,493163.882352941,6216.87908496732,75.1895424836601
"29932","92073","2019",686,103,583,471204.774052478,6866.27551020408,68.1093294460641
"29933","92075","2019",404,39,365,400780.205445545,6805.5,57.8910891089109
"29934","92076","2019",139,30,109,558479.697841727,5150.76978417266,103.359712230216
"29935","92077","2019",126,21,105,563411.428571429,5683.57142857143,96.4523809523809
"29936","92078","2019",153,26,127,217511.843137255,3394.41830065359,65.3333333333333
"29937","93001","2019",629,55,574,179369.615262321,3752.37678855326,49.933227344992
"29938","93005","2019",745,436,309,230968.848322148,3343.48993288591,73.3006711409396
"29939","93006","2019",351,85,266,314934.222222222,5293.1566951567,60.7435897435897
"29940","93007","2019",347,208,139,244053.30259366,3540.81268011527,72.0691642651297
"29941","93008","2019",248,106,142,198760.012096774,3183.77016129032,64.2822580645161
"29942","93010","2019",401,191,210,204847.064837905,3190.5536159601,67.0922693266833
"29943","93013","2019",194,29,165,181652.74742268,3203.25773195876,57.2164948453608
"29944","93014","2019",207,76,131,153450.903381643,2203.55072463768,69.3236714975845
"29945","93015","2019",62,37,25,243400.548387097,2871.66129032258,88.2258064516129
"29946","93027","2019",221,47,174,172430.900452489,2952.8778280543,60.4615384615385
"29947","93029","2019",599,292,307,205932.2721202,3410.632721202,63.8664440734558
"29948","93030","2019",48,8,40,161205.75,2386.08333333333,71.0833333333333
"29949","93031","2019",460,91,369,177374.452173913,2776.08043478261,66.0021739130435
"29950","93032","2019",607,300,307,248844.352553542,3351.42833607908,75.5337726523888
"29951","93033","2019",130,84,46,338324.807692308,4270.92307692308,81.6076923076923
"29952","93039","2019",64,8,56,221999.078125,3361.921875,66.8125
"29953","93045","2019",267,21,246,341845.31835206,6512.19850187266,53.4307116104869
"29954","93046","2019",678,277,401,218726.010324484,3218.38790560472,69.9926253687316
"29955","93047","2019",257,199,58,245621.73540856,3183.12840466926,81.568093385214
"29956","93048","2019",1319,272,1047,352698.296436694,5877.6186504928,60.9461713419257
"29957","93049","2019",311,135,176,284297.8585209,4207.29903536978,68.6077170418006
"29958","93050","2019",365,96,269,217587.684931507,3268.01369863014,68.6383561643836
"29959","93051","2019",869,236,633,250541.186421174,3858.12197928654,67.3924050632911
"29960","93053","2019",356,120,236,245898.033707865,3762.24438202247,66.7050561797753
"29961","93055","2019",597,32,565,273297.820770519,5519.86264656616,49.5829145728643
"29962","93057","2019",360,163,197,226829.905555556,3473.17222222222,66.5972222222222
"29963","93059","2019",192,107,85,196581.78125,2897.06770833333,70.2083333333333
"29964","93061","2019",194,26,168,335935.237113402,6252.56701030928,54.6958762886598
"29965","93062","2019",297,96,201,325060.548821549,4043.9494949495,80.7474747474748
"29966","93063","2019",236,67,169,318046.101694915,5167.72881355932,63.1610169491525
"29967","93064","2019",551,123,428,233081.715063521,3708.58802177858,64.3883847549909
"29968","93066","2019",871,90,781,203717.129735936,3769.06429391504,55.6291618828932
"29969","93070","2019",599,33,566,298947.095158598,5827.60767946578,51.085141903172
"29970","93071","2019",382,205,177,190728.659685864,2683.01308900524,73.9607329842932
"29971","93072","2019",185,89,96,181314.459459459,2874.23783783784,65.1945945945946
"29972","93073","2019",369,253,116,230630.300813008,3077.13550135501,78.7642276422764
"29973","93074","2019",121,44,77,213345.20661157,3294.78512396694,68.1570247933884
"29974","93077","2019",426,183,243,268921.73943662,3780.15962441315,72.443661971831
"29975","93078","2019",327,198,129,216899.95412844,2888.37308868502,77.4648318042813
"29976","93079","2019",55,32,23,213990.2,2883.2,76.0181818181818
"29977","94001","2019",115,27,88,194501.113043478,2863.44347826087,69.4869565217391
"29978","94002","2019",537,66,471,269485.918063315,4902.40037243948,55.6238361266294
"29979","94003","2019",202,52,150,341208.534653465,5591.51485148515,62.0247524752475
"29980","94004","2019",197,58,139,224017.868020305,3150.71065989848,75.3096446700508
"29981","94011","2019",117,38,79,243541.512820513,3625.59829059829,68.8376068376068
"29982","94015","2019",253,78,175,377152.011857708,5084.33596837945,75.5691699604743
"29983","94016","2019",296,63,233,318732.347972973,5114.25675675676,63.2364864864865
"29984","94017","2019",845,360,485,280160.21183432,3844.44852071006,75.1502958579882
"29985","94018","2019",404,7,397,444529.995049505,7392.08168316832,59.7846534653465
"29986","94019","2019",328,115,213,272692.923780488,3539.75609756098,78.2530487804878
"29987","94021","2019",182,26,156,228183.098901099,3519.47802197802,67.7967032967033
"29988","94022","2019",565,100,465,213877.23539823,3676.40530973451,60.6176991150442
"29989","94028","2019",873,104,769,246402.287514318,3758.35509736541,67.282932416953
"29990","94033","2019",692,214,478,389205.00867052,5859.03179190751,67.3829479768786
"29991","94034","2019",408,64,344,227032.968137255,3362.9387254902,68.2156862745098
"29992","94037","2019",133,30,103,351307.218045113,6135.0977443609,58.9548872180451
"29993","94038","2019",308,106,202,313020.366883117,4270.98376623377,74.3214285714286
"29994","94041","2019",524,43,481,260638.788167939,4925.40076335878,53.8339694656489
"29995","94042","2019",295,67,228,367459.118644068,5821.9593220339,62.4406779661017
"29996","94043","2019",267,11,256,278025.966292135,5744.55805243446,50.4943820224719
"29997","94044","2019",380,98,282,209298.660526316,3161.00789473684,67.6
"29998","94046","2019",743,107,636,322155.106325707,5358.76312247645,60.5114401076716
"29999","94047","2019",68,55,13,295883.926470588,3264.27941176471,93.8235294117647
"30000","94048","2019",60,52,8,363755.083333333,3278.91666666667,116.066666666667
"30001","94052","2019",638,72,566,419116.021943574,6205.87147335423,66.3416927899686
"30002","94053","2019",63,40,23,334740.634920635,3935.55555555556,89.6349206349206
"30003","94054","2019",180,65,115,225201.283333333,3307.06111111111,68.7611111111111
"30004","94055","2019",120,114,6,362991.841666667,4017.11666666667,95.0333333333333
"30005","94056","2019",49,33,16,288994.897959184,3207.26530612245,94.265306122449
"30006","94058","2019",627,169,458,366967.290271132,5350.81977671451,68.8325358851675
"30007","94059","2019",335,105,230,289313.558208955,3681.68955223881,78.5044776119403
"30008","94060","2019",177,143,34,280781.971751412,3191.00564971751,91.8022598870056
"30009","94065","2019",81,20,61,292921.777777778,4080.45679012346,70.8765432098765
"30010","94067","2019",372,10,362,572113.663978495,8475.95161290323,66.8844086021505
"30011","94068","2019",1427,434,993,412434.337771549,5692.18850735809,72.6965662228451
"30012","94069","2019",217,7,210,321159.852534562,5861.03225806452,55.4884792626728
"30013","94070","2019",45,37,8,361295.555555556,3169.2,126.044444444444
"30014","94071","2019",320,172,148,317850.409375,3883.509375,85.790625
"30015","94073","2019",418,86,332,243907.210526316,3622.14593301435,68.7942583732057
"30016","94074","2019",63,28,35,205903.079365079,3145.2380952381,68.6031746031746
"30017","94075","2019",176,122,54,300290.965909091,3364.94318181818,95.5
"30018","94076","2019",559,119,440,290286.148479428,4935.17889087657,60.7942754919499
"30019","94077","2019",242,150,92,230191.830578512,3615.07024793388,67.1570247933884
"30020","94078","2019",287,110,177,177388.972125436,3027.98257839721,61.5505226480836
"30021","94079","2019",408,155,253,277265.681372549,3868.70833333333,74.4142156862745
"30022","94080","2019",883,31,852,465218.17214043,8449.35787089468,54.5537938844847
"30023","94081","2019",751,201,550,256272.588548602,4162.76697736352,63.1304926764314
"30024","95002","2019",17,16,1,314161.764705882,3121.29411764706,103.176470588235
"30025","95008","2019",8,6,2,219181.25,2320.25,99.125
"30026","95011","2019",6,5,1,178666.666666667,1774,116
"30027","95012","2019",4,4,0,149750,2713.5,55.25
"30028","95014","2019",29,23,6,414951.034482759,3427.8275862069,122.310344827586
"30029","95018","2019",1249,545,704,218185.642113691,3343.22658126501,67.6549239391513
"30030","95019","2019",139,97,42,239489.208633094,3121.01438848921,81.3237410071942
"30031","95023","2019",11,11,0,266329.545454545,2614.36363636364,108.727272727273
"30032","95024","2019",4,4,0,2e+05,1841.75,111.25
"30033","95026","2019",52,46,6,281584.903846154,2694.86538461538,111.5
"30034","95028","2019",32,25,7,266180.5625,3161.4375,88.5
"30035","95039","2019",115,102,13,306980.930434783,3594.02608695652,90.1304347826087
"30036","95040","2019",17,17,0,291260,2918.76470588235,101.705882352941
"30037","95042","2019",29,23,6,290452.275862069,3087.20689655172,97.9655172413793
"30038","95046","2019",1,1,0,405000,2793,145
"30039","95051","2019",148,103,45,319122.243243243,3871.0472972973,85.6891891891892
"30040","95052","2019",182,84,98,191168.478021978,2949.3021978022,68.0549450549451
"30041","95054","2019",2,2,0,2e+05,2007,97
"30042","95055","2019",12,10,2,259040.416666667,2881.83333333333,97.0833333333333
"30043","95056","2019",41,32,9,249383.43902439,3123.17073170732,85.6341463414634
"30044","95058","2019",26,26,0,258118.576923077,2769.30769230769,94.9230769230769
"30045","95059","2019",14,14,0,285950.714285714,2186.92857142857,137.928571428571
"30046","95060","2019",118,66,52,257392.194915254,3491.97457627119,76.5084745762712
"30047","95061","2019",6,6,0,404342.666666667,3274.5,126.833333333333
"30048","95063","2019",361,155,206,279665.091412742,4260.8891966759,67.6426592797784
"30049","95074","2019",10,9,1,366871.5,2801.5,142.5
"30050","95078","2019",24,17,7,252366.666666667,2366.83333333333,110.541666666667
"30051","95088","2019",10,5,5,198269.9,2969.4,71.5
"30052","95091","2019",70,61,9,287684.4,3276.61428571429,92.1142857142857
"30053","95094","2019",4,4,0,213100,2134.25,93.5
"30054","95101","2019",13,13,0,199523.153846154,2175.61538461538,96.6923076923077
"30055","95102","2019",4,4,0,425750,3501.5,124.5
"30056","95110","2019",2,2,0,328000,4472,75
"30057","95116","2019",46,44,2,237574.97826087,2693.5652173913,90.9565217391304
"30058","95119","2019",6,6,0,232825,2752.66666666667,94.8333333333333
"30059","95120","2019",27,24,3,293074.814814815,3132.51851851852,99.2592592592593
"30060","95127","2019",799,211,588,193454.730913642,2927.87734668335,70.0337922403004
"30061","95134","2019",86,72,14,289031.197674419,3141.86046511628,94.7906976744186
"30062","95139","2019",10,10,0,239400,2553.2,98.2
"30063","95142","2019",31,23,8,191586.451612903,2467.45161290323,86.2903225806452
"30064","95149","2019",47,45,2,317929.063829787,3012.10638297872,111.170212765957
"30065","95150","2019",4,4,0,199250,2223.25,93.5
"30066","95151","2019",2,2,0,407500,2787,149.5
"30067","95157","2019",5,5,0,270240,2350.8,123.8
"30068","95166","2019",4,4,0,245406.25,2192.75,115.25
"30069","95169","2019",7,7,0,261785.714285714,3306.42857142857,92.1428571428571
"30070","95170","2019",9,5,4,271722.222222222,3098.33333333333,87.1111111111111
"30071","95176","2019",344,180,164,307498.351744186,4007.41860465116,78.125
"30072","95177","2019",18,17,1,380446.444444444,3445.44444444444,115.722222222222
"30073","95181","2019",2,1,1,149400,2717.5,60
"30074","95183","2019",93,57,36,255655.505376344,3012.11827956989,88.2365591397849
"30075","95197","2019",376,144,232,269883.045212766,3596.48138297872,76.2739361702128
"30076","95199","2019",232,100,132,237207.452586207,3284.34051724138,75.4137931034483
"30077","95203","2019",315,138,177,293500.358730159,3834.28888888889,78.5079365079365
"30078","95205","2019",93,52,41,244333.215053763,3026.47311827957,83.1075268817204
"30079","95210","2019",223,61,162,417992.426008969,5193.79372197309,80.2645739910314
"30080","95211","2019",21,15,6,299856.666666667,3414.04761904762,87.9047619047619
"30081","95213","2019",3,3,0,305333.333333333,3506.33333333333,87.6666666666667
"30082","95214","2019",1,1,0,350000,2917,120
"30083","95218","2019",250,115,135,239883.944,3023.664,81.416
"30084","95219","2019",378,124,254,279321.658730159,3680.71693121693,76.8492063492064
"30085","95229","2019",139,56,83,232583.942446043,3188.39568345324,74.3597122302158
"30086","95241","2019",27,24,3,271152.222222222,2905.92592592593,99.8518518518518
"30087","95250","2019",123,114,9,229635.512195122,2717.56097560976,89.2845528455285
"30088","95252","2019",587,144,443,216516.93867121,3031.64565587734,72.045996592845
"30089","95253","2019",5,5,0,405186.6,2398.6,177.6
"30090","95254","2019",7,6,1,325857.142857143,2669.14285714286,126.857142857143
"30091","95256","2019",45,44,1,355095.577777778,3545.6,106.933333333333
"30092","95257","2019",86,62,24,352417.627906977,4131.29069767442,86.5348837209302
"30093","95258","2019",4,4,0,356887.5,2955.5,123.25
"30094","95268","2019",202,69,133,160148.737623762,2465.34653465347,65.3415841584158
"30095","95270","2019",13,12,1,203306.461538462,2118.53846153846,104.615384615385
"30096","95271","2019",7,7,0,306950,3436.57142857143,92.7142857142857
"30097","95277","2019",195,97,98,209287.58974359,2846.30256410256,76.2410256410256
"30098","95280","2019",253,204,49,220749.644268775,3211.88932806324,74.2687747035573
"30099","95282","2019",1,1,0,110000,1310,84
"30100","95287","2019",14,12,2,285671.428571429,2697.42857142857,109.5
"30101","95288","2019",140,79,61,275932.9,3256.74285714286,88.3
"30102","95295","2019",3,3,0,395500,2763.66666666667,178.333333333333
"30103","95298","2019",13,13,0,353988.461538462,2692.07692307692,145.538461538462
"30104","95301","2019",12,12,0,214047.333333333,2675.75,88.5
"30105","95303","2019",4,3,1,254750,2917.5,94.75
"30106","95304","2019",7,7,0,253281.428571429,3590.42857142857,80
"30107","95306","2019",437,225,212,272196.205949657,3674.87871853547,76.6315789473684
"30108","95308","2019",11,9,2,277454.545454545,3156.36363636364,88.4545454545455
"30109","95309","2019",2,2,0,128000,1196.5,110
"30110","95313","2019",220,106,114,321396.918181818,3799.13181818182,86.8318181818182
"30111","95316","2019",5,5,0,244400,2697,95
"30112","95323","2019",190,156,34,251671.1,2842.9,91.5473684210526
"30113","95328","2019",13,11,2,323242.307692308,3317.84615384615,100.846153846154
"30114","95341","2019",7,4,3,216200,2334,93.5714285714286
"30115","95348","2019",7,6,1,210985.714285714,3180.28571428571,76
"30116","95351","2019",118,77,41,203666.101694915,2888.01694915254,74.0677966101695
"30117","95352","2019",63,46,17,319240.507936508,3192.42857142857,101.698412698413
"30118","95353","2019",40,28,12,273767.525,3304.7,88.5
"30119","95355","2019",70,53,17,221678.342857143,2720.91428571429,87.1571428571429
"30120","95365","2019",9,9,0,305444.444444444,3313.77777777778,99.8888888888889
"30121","95369","2019",50,30,20,333644.92,3565.76,93.84
"30122","95370","2019",51,41,10,258868,2971.07843137255,89.1764705882353
"30123","95371","2019",85,68,17,243843.176470588,2937.87058823529,86.8823529411765
"30124","95379","2019",2,2,0,160425,1779.5,92.5
"30125","95387","2019",2,2,0,337000,3052.5,110
"30126","95388","2019",71,56,15,236555.507042254,2955.87323943662,80.887323943662
"30127","95392","2019",66,57,9,284522.46969697,3471.83333333333,90.5
"30128","95394","2019",169,106,63,261329.142011834,3184.11834319527,83.5562130177515
"30129","95395","2019",15,14,1,260123.333333333,2949,92.3333333333333
"30130","95409","2019",24,17,7,250312.5,3034.58333333333,85.7083333333333
"30131","95422","2019",6,6,0,280941.666666667,2726.16666666667,110.666666666667
"30132","95424","2019",228,123,105,238930.162280702,3119.92543859649,78.3464912280702
"30133","95426","2019",41,34,7,402863.658536585,3599.82926829268,116.09756097561
"30134","95427","2019",188,75,113,238080.85106383,3031.98936170213,75.3244680851064
"30135","95428","2019",380,130,250,318715.852631579,3865.85,84.5736842105263
"30136","95429","2019",5,5,0,185374,2321.8,79
"30137","95430","2019",59,48,11,260460.033898305,3072.03389830508,87.6101694915254
"30138","95436","2019",13,10,3,242698,3085.23076923077,83.5384615384615
"30139","95438","2019",1,1,0,470000,3481,135
"30140","95445","2019",10,10,0,306355,2895.4,107.9
"30141","95446","2019",35,33,2,333064,3564.02857142857,100.228571428571
"30142","95447","2019",1,1,0,259000,2846,91
"30143","95450","2019",27,22,5,353225.296296296,3311.48148148148,110.555555555556
"30144","95452","2019",20,17,3,285307.5,2966.95,99.9
"30145","95456","2019",8,8,0,249212.5,3164.375,89.875
"30146","95459","2019",9,8,1,266616.666666667,2679.66666666667,100.222222222222
"30147","95462","2019",3,3,0,243833.333333333,1803,136.666666666667
"30148","95476","2019",181,131,50,263432.61878453,3116.37569060773,87.9005524861878
"30149","95480","2019",98,86,12,297409.12244898,3191.65306122449,97.3265306122449
"30150","95483","2019",4,4,0,303725,2657.5,115
"30151","95487","2019",134,63,71,178921.358208955,2704.02985074627,69.0074626865672
"30152","95488","2019",94,60,34,257393.244680851,3560.02127659574,75.9468085106383
"30153","95489","2019",9,8,1,397166.666666667,3783.66666666667,110.333333333333
"30154","95491","2019",153,67,86,258680.098039216,3346.50326797386,80.0915032679739
"30155","95492","2019",2,1,1,275500,2686.5,106
"30156","95493","2019",1,1,0,175000,3646,48
"30157","95500","2019",442,120,322,204366.828054299,3004.56334841629,70.7941176470588
"30158","95504","2019",67,53,14,307396.611940299,3602.97014925373,88.089552238806
"30159","95509","2019",52,43,9,241482.115384615,3054.26923076923,82.9038461538462
"30160","95510","2019",4,1,3,248447.5,3941.75,68.5
"30161","95523","2019",12,10,2,148808.333333333,1814.58333333333,88.75
"30162","95527","2019",34,18,16,272619.117647059,3631.44117647059,73.9411764705882
"30163","95529","2019",9,7,2,246539.444444444,2346.22222222222,117.333333333333
"30164","95535","2019",10,9,1,267180.5,2433.9,111.6
"30165","95539","2019",193,93,100,251983.896373057,3193.41450777202,80.8082901554404
"30166","95541","2019",8,7,1,229125,2520.25,96.875
"30167","95543","2019",6,5,1,366110.5,3296,112.166666666667
"30168","95554","2019",15,15,0,263502.333333333,2003,134.2
"30169","95555","2019",288,85,203,282945.75,3670.68402777778,75.7361111111111
"30170","95563","2019",258,157,101,303420.76744186,3626.67441860465,86.4418604651163
"30171","95566","2019",27,23,4,218244.444444444,2697.44444444444,83.3703703703704
"30172","95572","2019",314,126,188,200366.429936306,2928.68789808917,70.9171974522293
"30173","95574","2019",119,100,19,388606.428571429,3941.15966386555,104.100840336134
"30174","95580","2019",49,47,2,447852.040816327,3185.79591836735,147.285714285714
"30175","95582","2019",434,137,297,254024.165898618,3538.96774193548,72.684331797235
"30176","95584","2019",7,7,0,302714.285714286,2727.14285714286,118
"30177","95585","2019",307,109,198,187834.501628664,2437.98697068404,78.9250814332248
"30178","95592","2019",13,13,0,255016.153846154,2999.23076923077,88.0769230769231
"30179","95594","2019",17,13,4,281823.529411765,3095.70588235294,98.3529411764706
"30180","95598","2019",246,116,130,302571.154471545,3710.86991869919,83.1666666666667
"30181","95604","2019",90,40,50,178939.055555556,2427.18888888889,77.5
"30182","95607","2019",447,200,247,246273.536912752,3283.46979865772,76.420581655481
"30183","95610","2019",6,6,0,367583.333333333,2869.83333333333,130.833333333333
"30184","95612","2019",47,35,12,239334.042553191,2957.34042553192,84.7872340425532
"30185","95625","2019",20,16,4,242864,3024.8,83.8
"30186","95627","2019",14,10,4,241103.571428571,2812.21428571429,89.2142857142857
"30187","95628","2019",30,27,3,294647.333333333,3146.33333333333,99.7666666666667
"30188","95633","2019",1,1,0,210000,2079,101
"30189","95637","2019",237,167,70,267374.329113924,3245.37552742616,85.7004219409283
"30190","95641","2019",31,23,8,250761.806451613,2905.48387096774,88.2903225806452
"30191","95651","2019",28,27,1,223401.785714286,2426.14285714286,95.1428571428571
"30192","95652","2019",88,77,11,265867.045454545,2991.31818181818,93.5113636363636
"30193","95656","2019",5,5,0,377680,2493.2,172.6
"30194","95658","2019",12,11,1,297223.916666667,2665.25,112
"30195","95660","2019",9,8,1,321416.666666667,3258,104.333333333333
"30196","95675","2019",13,5,8,254244.769230769,3290.53846153846,82.5384615384615
"30197","95676","2019",9,9,0,291456.666666667,2226.11111111111,124.222222222222
"30198","95678","2019",17,14,3,294009.529411765,3342.64705882353,90.7058823529412
"30199","95680","2019",208,88,120,168848.139423077,2444.52403846154,70.9519230769231
"30200","95682","2019",3,3,0,261166.666666667,2740.33333333333,97.6666666666667
"30201","95690","2019",8,8,0,337362.5,2673.75,141.375
"30202",NA,"2019",9186,NA,NA,193470.602438493,2585.65011974744,76.3231003701285
