"","INSEE_COM","Annee","Nb_mutations","NbMaisons","NbApparts","PrixMoyen","Prixm2Moyen","SurfaceMoy"
"1","01001","2020",6,6,0,215083.333333333,1693.16666666667,124.333333333333
"2","01002","2020",2,2,0,80125,2023,47
"3","01004","2020",223,122,101,162119.659192825,2018.9730941704,83.2017937219731
"4","01005","2020",25,19,6,282148.6,2680.76,101.96
"5","01006","2020",2,2,0,254237.5,2327,110
"6","01007","2020",20,18,2,180191.3,1835.15,98.45
"7","01008","2020",5,5,0,188810,2059.4,91.2
"8","01009","2020",7,6,1,138078.571428571,1371.14285714286,107.142857142857
"9","01010","2020",11,10,1,177236.363636364,1857.54545454545,101.636363636364
"10","01011","2020",2,2,0,181371.5,1417.5,127.5
"11","01012","2020",4,4,0,91250,1042.5,98.25
"12","01013","2020",7,7,0,88721.4285714286,865,91.2857142857143
"13","01014","2020",22,12,10,137295.454545455,1464.59090909091,86.3181818181818
"14","01015","2020",12,12,0,162208.333333333,1424.41666666667,119.583333333333
"15","01016","2020",5,5,0,156218,1341.4,115
"16","01017","2020",8,6,2,88683.75,1107,83.625
"17","01021","2020",22,16,6,262488.454545455,2583.45454545455,99.7272727272727
"18","01022","2020",14,13,1,146500.714285714,1293.5,113.428571428571
"19","01024","2020",29,23,6,189708.275862069,1901.20689655172,100.793103448276
"20","01025","2020",47,47,0,210817.659574468,1896.70212765957,115.744680851064
"21","01026","2020",9,9,0,192530,1738,105.777777777778
"22","01027","2020",19,18,1,306033.421052632,3134.89473684211,101.473684210526
"23","01028","2020",12,12,0,218210.833333333,1968.41666666667,121.5
"24","01029","2020",8,8,0,151997.5,1280.875,120.25
"25","01030","2020",23,8,15,177917.608695652,2130.5652173913,85.0434782608696
"26","01031","2020",21,9,12,128960.857142857,1694.7619047619,73.2380952380952
"27","01032","2020",25,19,6,281070.08,2791.32,105.04
"28","01033","2020",251,98,153,187814.988047809,2257.72111553785,83.7290836653386
"29","01034","2020",138,74,64,158647.630434783,1749.52898550725,91.8115942028985
"30","01035","2020",3,3,0,143333.333333333,1654.33333333333,84
"31","01036","2020",24,24,0,145963.333333333,1461.75,100.5
"32","01037","2020",5,4,1,123760,1618.2,81.4
"33","01038","2020",6,6,0,227693.333333333,1913.83333333333,111.333333333333
"34","01039","2020",8,8,0,135868.75,1958.125,82.375
"35","01040","2020",5,5,0,173896,1450.8,116.4
"36","01041","2020",11,11,0,151179.545454545,1701.81818181818,90
"37","01042","2020",4,4,0,251965,2128,122.5
"38","01043","2020",66,50,16,370676.287878788,3490.65151515152,107.409090909091
"39","01044","2020",1,1,0,238100,2506,95
"40","01045","2020",1,1,0,332805,2465,135
"41","01046","2020",11,11,0,271872.727272727,2294.09090909091,122.454545454545
"42","01047","2020",15,15,0,271223.4,2478.13333333333,116.533333333333
"43","01049","2020",39,33,6,311240,2974.4358974359,107.666666666667
"44","01050","2020",4,4,0,110500,1199.25,85.75
"45","01051","2020",2,2,0,151000,1658,94
"46","01052","2020",1,1,0,395000,2194,180
"47","01053","2020",572,148,424,139164.923076923,1741.24125874126,81.2115384615385
"48","01054","2020",20,20,0,228492.5,2664.5,90.85
"49","01056","2020",4,4,0,81218,919,85.75
"50","01057","2020",5,5,0,195170,2104.6,99
"51","01058","2020",11,11,0,160513.636363636,1729.45454545455,99.2727272727273
"52","01060","2020",9,8,1,147791.111111111,1075.66666666667,158.888888888889
"53","01061","2020",17,17,0,222239.411764706,2083.70588235294,116.941176470588
"54","01062","2020",13,11,2,312079.461538462,2652.53846153846,117.384615384615
"55","01063","2020",6,3,3,208901.833333333,2430.33333333333,87.1666666666667
"56","01064","2020",19,19,0,163180,1882.47368421053,90.8947368421053
"57","01065","2020",9,8,1,244200,1872.22222222222,132.888888888889
"58","01066","2020",5,5,0,109000,1030.8,94.6
"59","01067","2020",2,2,0,89250,799,113.5
"60","01068","2020",16,16,0,132781.25,1441.875,104.25
"61","01069","2020",13,9,4,179630.769230769,1886.76923076923,102.692307692308
"62","01071","2020",94,47,47,460691.808510638,4402.40425531915,105.223404255319
"63","01072","2020",32,25,7,202110.125,1970.5625,108.46875
"64","01073","2020",12,12,0,179805.833333333,1610.08333333333,115.833333333333
"65","01074","2020",31,20,11,199295.064516129,2087.1935483871,93.5483870967742
"66","01075","2020",16,15,1,248404.125,2344.75,107.625
"67","01076","2020",3,3,0,104666.666666667,1137.66666666667,92.6666666666667
"68","01077","2020",4,4,0,148000,2059.5,75.5
"69","01078","2020",17,11,6,378708.764705882,3870.58823529412,98.7647058823529
"70","01079","2020",10,9,1,180675,1492.9,128.9
"71","01080","2020",9,9,0,162738.888888889,1652,98.2222222222222
"72","01081","2020",10,7,3,203165,2028.1,97.7
"73","01082","2020",10,8,2,169010.2,2107.1,88.1
"74","01083","2020",11,8,3,230924.545454545,2629.18181818182,95.1818181818182
"75","01084","2020",14,12,2,180678.714285714,1793.57142857143,107.857142857143
"76","01085","2020",10,10,0,245805,2128.6,121.2
"77","01087","2020",3,2,1,140833.333333333,1600.33333333333,89.6666666666667
"78","01088","2020",4,4,0,275125,3081.5,93.25
"79","01089","2020",19,19,0,232946.842105263,2226.21052631579,106.421052631579
"80","01090","2020",4,4,0,340093,2648.5,126.75
"81","01092","2020",30,26,4,217036.5,1978.93333333333,114.1
"82","01093","2020",62,31,31,187874.177419355,2167.95161290323,89.5
"83","01094","2020",12,12,0,168866.333333333,1650,103.166666666667
"84","01095","2020",6,5,1,147666.666666667,995,155
"85","01096","2020",8,8,0,185251.875,1731.875,108.75
"86","01098","2020",12,12,0,210995.833333333,1689.91666666667,122.5
"87","01099","2020",13,12,1,214305.384615385,2372.23076923077,94
"88","01100","2020",4,4,0,115375,1213.75,91.5
"89","01101","2020",2,2,0,93675,688.5,131
"90","01102","2020",13,13,0,204568.461538462,1800.61538461538,118.230769230769
"91","01103","2020",30,13,17,383887.533333333,4404.3,88.0666666666667
"92","01104","2020",6,6,0,185283.333333333,2264.33333333333,89
"93","01105","2020",24,22,2,355607.083333333,3468.29166666667,102.291666666667
"94","01106","2020",4,4,0,151625,1186.5,124
"95","01107","2020",2,2,0,116145,1032,110
"96","01108","2020",21,17,4,128091.666666667,1132.80952380952,120.714285714286
"97","01109","2020",39,32,7,337498.794871795,3433.05128205128,104.769230769231
"98","01110","2020",3,3,0,165466.666666667,1260.33333333333,135.666666666667
"99","01111","2020",8,8,0,141306.25,1333.375,115.125
"100","01112","2020",6,6,0,146500,1440.5,104
"101","01113","2020",11,11,0,210022.727272727,1800.90909090909,121.818181818182
"102","01114","2020",4,4,0,299081.25,2297,136.5
"103","01115","2020",6,6,0,195581.666666667,1713.16666666667,133.833333333333
"104","01116","2020",5,4,1,166580,1627.8,107.6
"105","01118","2020",15,11,4,199326.666666667,2385.53333333333,83.3333333333333
"106","01121","2020",1,1,0,160000,1702,94
"107","01123","2020",20,20,0,193846.05,1909.6,109.45
"108","01124","2020",13,13,0,126255.076923077,1138,109.153846153846
"109","01125","2020",18,18,0,135762,1376.83333333333,94.5555555555556
"110","01127","2020",6,6,0,169783.333333333,1598,106.166666666667
"111","01128","2020",3,3,0,174695,1343,147
"112","01129","2020",5,5,0,252940,2157.4,119.8
"113","01130","2020",24,24,0,187908.541666667,1677.95833333333,116.25
"114","01133","2020",7,7,0,226757.142857143,2057,98.5714285714286
"115","01134","2020",20,17,3,213703,1855.7,116.95
"116","01135","2020",30,22,8,495925,4360.83333333333,118.733333333333
"117","01136","2020",13,13,0,220691.538461538,1930.69230769231,118.538461538462
"118","01138","2020",52,37,15,140103.615384615,1638.05769230769,89.9423076923077
"119","01139","2020",3,3,0,97000,800.333333333333,115.666666666667
"120","01140","2020",15,15,0,198194,1711.2,127.8
"121","01141","2020",7,7,0,218322.857142857,2054.14285714286,115.857142857143
"122","01142","2020",59,41,18,314210.440677966,3046.79661016949,97.2372881355932
"123","01143","2020",180,58,122,621698.988888889,5370.03333333333,115.227777777778
"124","01145","2020",16,16,0,191872.5,1774.0625,109.4375
"125","01146","2020",3,3,0,224419.333333333,1810.66666666667,132.333333333333
"126","01147","2020",10,9,1,117511,1377.6,91.2
"127","01148","2020",13,12,1,173086.923076923,1706.92307692308,98.3076923076923
"128","01149","2020",15,15,0,207825.333333333,1999.73333333333,104.533333333333
"129","01150","2020",2,2,0,123500,1366.5,85
"130","01151","2020",7,7,0,162471.428571429,1635.85714285714,104.714285714286
"131","01152","2020",10,9,1,262950,1973.8,128.4
"132","01153","2020",30,23,7,477673.566666667,4438.76666666667,110.666666666667
"133","01155","2020",2,2,0,122500,1236.5,100.5
"134","01156","2020",5,5,0,248514,2678,101
"135","01157","2020",27,26,1,301509.814814815,2674.96296296296,112.185185185185
"136","01158","2020",14,9,5,377338.928571429,3783.5,99.7142857142857
"137","01159","2020",23,20,3,171124.826086957,1658.26086956522,103.565217391304
"138","01160","2020",152,13,139,303077.111842105,4094.20394736842,75.8157894736842
"139","01163","2020",27,27,0,145282.592592593,1597.55555555556,95.2962962962963
"140","01165","2020",30,30,0,258723.033333333,2199.4,119.766666666667
"141","01166","2020",32,29,3,286483.78125,2778.96875,105.09375
"142","01167","2020",7,7,0,243942.857142857,1946.28571428571,124.285714285714
"143","01169","2020",22,12,10,191299,1878.45454545455,99.0454545454545
"144","01170","2020",6,6,0,152733.333333333,1586,98.1666666666667
"145","01171","2020",7,7,0,193278.571428571,1621.14285714286,127.571428571429
"146","01173","2020",216,65,151,332807.023148148,4071.80555555556,80.587962962963
"147","01174","2020",1,0,1,105000,4773,22
"148","01175","2020",7,7,0,171630.142857143,1723.14285714286,100.857142857143
"149","01177","2020",4,4,0,141806.25,1058.5,129
"150","01179","2020",25,21,4,206788.08,1863.04,116.52
"151","01180","2020",9,5,4,523243.333333333,5124,106.333333333333
"152","01181","2020",11,11,0,169425.454545455,1709.54545454545,97
"153","01183","2020",15,12,3,225221.666666667,2142.33333333333,107.866666666667
"154","01184","2020",13,13,0,134727.692307692,1201.46153846154,109.538461538462
"155","01185","2020",50,41,9,123962.9,1300,99.36
"156","01187","2020",12,9,3,124247.083333333,1997.25,63.6666666666667
"157","01188","2020",5,5,0,233780,1600.2,149.4
"158","01189","2020",7,7,0,282714.285714286,2630,108.428571428571
"159","01190","2020",1,1,0,230000,1494,154
"160","01191","2020",2,2,0,154650,1211,118.5
"161","01192","2020",8,8,0,158822.5,1502.5,103.25
"162","01194","2020",82,47,35,236221.597560976,2565.98780487805,93.5121951219512
"163","01195","2020",12,10,2,220025,2076.58333333333,104.333333333333
"164","01196","2020",21,21,0,154940.476190476,1448.47619047619,106.952380952381
"165","01197","2020",7,7,0,219400,1762.14285714286,125.142857142857
"166","01198","2020",3,3,0,309666.666666667,2003.33333333333,136
"167","01199","2020",44,37,7,152565.5,1766.40909090909,89.1590909090909
"168","01200","2020",4,3,1,122306.25,1227.5,99.75
"169","01202","2020",89,53,36,181651.617977528,1951.79775280899,94.4494382022472
"170","01203","2020",11,11,0,267886.363636364,2044,131.909090909091
"171","01204","2020",10,7,3,139600,1660,98
"172","01206","2020",1,1,0,140000,1474,95
"173","01207","2020",6,6,0,238621.666666667,2033.33333333333,119
"174","01208","2020",4,4,0,160000,1324.25,120.75
"175","01209","2020",4,4,0,314016.25,2913.25,111.5
"176","01210","2020",28,3,25,67340.6071428571,1890.67857142857,36.6428571428571
"177","01211","2020",13,12,1,222552.307692308,1948.61538461538,115.076923076923
"178","01212","2020",10,10,0,155363.6,1499.9,105.6
"179","01213","2020",14,13,1,200804.642857143,2060.57142857143,95.2857142857143
"180","01214","2020",4,4,0,81750,1440.75,66.75
"181","01216","2020",17,17,0,181785.941176471,1567.76470588235,124.823529411765
"182","01219","2020",1,1,0,89640,815,110
"183","01224","2020",52,41,11,236511.057692308,2421.73076923077,96.5576923076923
"184","01225","2020",8,7,1,299293.75,2472,134.75
"185","01227","2020",4,4,0,203500,1895,102.25
"186","01228","2020",4,4,0,174138.25,1216.25,157.25
"187","01229","2020",22,17,5,207401.5,1977.04545454545,112
"188","01230","2020",6,6,0,120177.833333333,1291.66666666667,91.1666666666667
"189","01231","2020",14,14,0,197361.5,1618.71428571429,120.357142857143
"190","01232","2020",29,27,2,179203,1707.72413793103,105.689655172414
"191","01233","2020",2,2,0,272500,3286.5,77.5
"192","01234","2020",2,2,0,264500,1611.5,207
"193","01235","2020",15,12,3,224053.266666667,2355.73333333333,95.1333333333333
"194","01236","2020",17,17,0,185080.588235294,1461.47058823529,131.588235294118
"195","01237","2020",16,12,4,165375,1579.9375,103.125
"196","01238","2020",23,23,0,369690,3391,108.826086956522
"197","01239","2020",4,4,0,177375,1483.75,104.25
"198","01240","2020",17,16,1,138760,1653.47058823529,83.8235294117647
"199","01241","2020",12,10,2,168042.5,1907,87.1666666666667
"200","01242","2020",1,1,0,120000,1034,116
"201","01243","2020",19,17,2,242775.894736842,2612.84210526316,96.2105263157895
"202","01244","2020",90,52,38,225751.311111111,2549.07777777778,90.9222222222222
"203","01245","2020",10,10,0,156734.6,1554.3,96.5
"204","01246","2020",31,29,2,207438.064516129,1808.16129032258,116.387096774194
"205","01247","2020",25,3,22,74255.68,2141.52,34.28
"206","01248","2020",23,15,8,345307.217391304,3212.04347826087,108
"207","01249","2020",131,65,66,279350.213740458,3056.01526717557,91.5496183206107
"208","01250","2020",18,18,0,321722.777777778,2904.55555555556,112.722222222222
"209","01252","2020",12,12,0,290654.166666667,2249.83333333333,130.5
"210","01254","2020",11,11,0,296868.181818182,2396.72727272727,129.727272727273
"211","01255","2020",6,6,0,132866.666666667,1581.5,83
"212","01257","2020",5,5,0,196800,1777.6,118
"213","01258","2020",15,14,1,288275.666666667,2863.66666666667,101.4
"214","01259","2020",7,7,0,243677.142857143,2209.85714285714,113.142857142857
"215","01260","2020",6,6,0,306907,2625.5,112.5
"216","01261","2020",7,7,0,369814.285714286,3094.57142857143,124.285714285714
"217","01262","2020",123,53,70,201871.62601626,2575.28455284553,81.0650406504065
"218","01263","2020",59,47,12,253997.372881356,2452.52542372881,104.71186440678
"219","01264","2020",11,10,1,217725.454545455,1889.90909090909,113.272727272727
"220","01265","2020",19,11,8,168330.736842105,1848.73684210526,91.9473684210526
"221","01266","2020",63,35,28,176703.920634921,1977.88888888889,90.2539682539683
"222","01267","2020",10,10,0,161575,1297.8,129.1
"223","01269","2020",25,8,17,90135.2,1104.96,84.32
"224","01272","2020",24,19,5,177718.958333333,1848.54166666667,97.25
"225","01273","2020",24,23,1,217627.25,1906.5,109.291666666667
"226","01274","2020",5,5,0,171948,1504.6,127
"227","01275","2020",30,23,7,391895.333333333,3714.96666666667,113.5
"228","01276","2020",14,14,0,336178.571428571,3174.35714285714,113.071428571429
"229","01279","2020",1,1,0,40000,816,49
"230","01280","2020",2,2,0,141750,1385,104.5
"231","01281","2020",67,30,37,438171.76119403,4352.26865671642,99.2089552238806
"232","01282","2020",1,1,0,90000,783,115
"233","01283","2020",185,81,104,131276.854054054,1504.75135135135,85.7675675675676
"234","01284","2020",8,8,0,202630,1914.5,120.5
"235","01285","2020",16,15,1,338070.125,3176.9375,108.0625
"236","01286","2020",9,9,0,237111.111111111,2119.55555555556,118.222222222222
"237","01288","2020",50,24,26,350483.18,3612.92,96.6
"238","01289","2020",72,48,24,193275.805555556,2020.26388888889,95.8055555555556
"239","01290","2020",21,10,11,223617.666666667,2821.61904761905,92.3809523809524
"240","01291","2020",9,9,0,237205.555555556,1861.22222222222,144.888888888889
"241","01294","2020",9,9,0,191655.555555556,1637.33333333333,132.666666666667
"242","01295","2020",6,5,1,230066.666666667,2409,96
"243","01296","2020",1,1,0,81500,1567,52
"244","01297","2020",11,10,1,329218.181818182,2650.72727272727,140.454545454545
"245","01298","2020",2,2,0,332028,2696.5,127
"246","01299","2020",7,6,1,281388.571428571,2425.85714285714,121.142857142857
"247","01301","2020",30,27,3,194278.233333333,1950.36666666667,104.5
"248","01302","2020",2,2,0,175500,1650,103.5
"249","01303","2020",22,22,0,161417.818181818,1517.31818181818,101.590909090909
"250","01304","2020",32,25,7,167173.15625,1642.28125,106
"251","01305","2020",23,14,9,118081.565217391,1359.13043478261,86.4782608695652
"252","01306","2020",20,10,10,125772.5,1522.2,83.9
"253","01307","2020",3,2,1,87716.6666666667,1060.66666666667,78
"254","01308","2020",3,2,1,701833.333333333,6473.33333333333,123
"255","01309","2020",2,2,0,74775,729,99.5
"256","01310","2020",4,4,0,175925,1581.25,124.25
"257","01313","2020",127,55,72,477414.125984252,4930.99212598425,99.6456692913386
"258","01314","2020",23,21,2,203352.391304348,1997.39130434783,101.521739130435
"259","01317","2020",3,3,0,206908.333333333,1585.33333333333,141.333333333333
"260","01318","2020",8,8,0,331936.25,2315.375,146.625
"261","01319","2020",10,10,0,241313,2065.9,117.5
"262","01320","2020",39,39,0,208134.564102564,2025.51282051282,108.923076923077
"263","01321","2020",14,14,0,204136.428571429,1939.14285714286,115.928571428571
"264","01322","2020",64,58,6,353765.59375,2989.53125,121
"265","01323","2020",11,11,0,163436.363636364,1619.81818181818,103.454545454545
"266","01325","2020",10,10,0,264000,2363.7,114.7
"267","01328","2020",12,9,3,214503.75,2442.58333333333,91.8333333333333
"268","01329","2020",1,1,0,55000,545,101
"269","01330","2020",2,2,0,226600,1197.5,189
"270","01331","2020",3,3,0,118000,1305.66666666667,90
"271","01332","2020",9,9,0,250518.888888889,1952.44444444444,129.111111111111
"272","01333","2020",23,16,7,246459.130434783,2743.13043478261,91.2173913043478
"273","01334","2020",7,7,0,191575,2084.14285714286,102.428571428571
"274","01335","2020",6,6,0,263001.666666667,2443.5,114
"275","01336","2020",15,15,0,209034.466666667,1676.13333333333,121.866666666667
"276","01337","2020",9,9,0,196560.444444444,1905.11111111111,109.777777777778
"277","01338","2020",14,14,0,150971.428571429,1517.35714285714,102.928571428571
"278","01339","2020",10,9,1,501021,4157.8,114.3
"279","01342","2020",3,3,0,292566.666666667,3636,79.6666666666667
"280","01343","2020",25,25,0,189881.52,1829.44,106
"281","01344","2020",59,47,12,229858.525423729,2248.33898305085,106.508474576271
"282","01345","2020",32,24,8,163404.84375,1698.03125,96.65625
"283","01346","2020",13,11,2,185652.307692308,1800.38461538462,102.307692307692
"284","01347","2020",27,27,0,351273.333333333,3039.25925925926,115.703703703704
"285","01348","2020",39,32,7,245153.974358974,2136.20512820513,112.923076923077
"286","01349","2020",8,8,0,274267.125,2930,106.5
"287","01350","2020",30,26,4,189383.233333333,1723.9,109.6
"288","01351","2020",21,20,1,225648.666666667,2178.42857142857,107.809523809524
"289","01352","2020",8,8,0,151260,2249.125,85.5
"290","01353","2020",24,19,5,276654.041666667,2824.04166666667,95.875
"291","01354","2020",184,59,125,397032.641304348,4080.8152173913,98.1304347826087
"292","01355","2020",5,5,0,175200,1451.4,125.2
"293","01356","2020",4,4,0,198970,1928.75,97.75
"294","01357","2020",7,7,0,176128.571428571,1679.28571428571,102
"295","01358","2020",1,1,0,194500,1768,110
"296","01359","2020",4,4,0,148875,2084,72.5
"297","01360","2020",23,17,6,467443.086956522,4322.4347826087,109.478260869565
"298","01361","2020",46,20,26,192742.304347826,2438.10869565217,79.9130434782609
"299","01362","2020",7,4,3,221671.142857143,2471.57142857143,86.8571428571429
"300","01363","2020",23,20,3,199255.304347826,1789.82608695652,117.739130434783
"301","01364","2020",3,3,0,259875,2182,122
"302","01365","2020",15,15,0,203475.333333333,1746.73333333333,123.133333333333
"303","01366","2020",14,13,1,232632.142857143,2144.71428571429,115.071428571429
"304","01367","2020",8,8,0,154125,1566.5,98.375
"305","01368","2020",6,6,0,215533.333333333,2081.5,108.333333333333
"306","01369","2020",7,7,0,220135,2248,100.142857142857
"307","01370","2020",29,4,25,110503.137931034,1624.8275862069,66.0689655172414
"308","01371","2020",20,13,7,276151.6,2899.5,100
"309","01372","2020",5,5,0,142800,1432,98.6
"310","01373","2020",4,4,0,215872.25,2063.25,105.25
"311","01374","2020",22,21,1,215905,2066.77272727273,110.681818181818
"312","01375","2020",6,6,0,200415,1718.83333333333,114.833333333333
"313","01376","2020",48,12,36,197732.916666667,2442.79166666667,80.8125
"314","01378","2020",24,23,1,293452.083333333,3083.08333333333,99.5833333333333
"315","01379","2020",11,11,0,172127.636363636,1980.81818181818,87.6363636363636
"316","01380","2020",9,9,0,204172.222222222,1672.11111111111,140.555555555556
"317","01381","2020",14,14,0,234060.714285714,2263.5,107.714285714286
"318","01382","2020",2,2,0,323305,2639.5,122.5
"319","01383","2020",13,11,2,163287.692307692,1805.84615384615,105.615384615385
"320","01384","2020",27,18,9,94085.9259259259,1204.92592592593,78
"321","01385","2020",5,5,0,344490,2174.4,170.4
"322","01386","2020",17,15,2,138225.882352941,1614.58823529412,87.7058823529412
"323","01387","2020",4,4,0,193537.5,1599.75,120.5
"324","01388","2020",15,15,0,134883.733333333,1428.93333333333,93.8666666666667
"325","01389","2020",23,20,3,209342.782608696,1939.08695652174,113.869565217391
"326","01390","2020",9,8,1,242525,2490.33333333333,97.1111111111111
"327","01391","2020",2,2,0,123400,1985,76.5
"328","01392","2020",6,6,0,137766.666666667,1631.83333333333,75.3333333333333
"329","01393","2020",6,5,1,231516.666666667,2097.16666666667,120.666666666667
"330","01396","2020",15,13,2,163353.333333333,1554.86666666667,110.333333333333
"331","01397","2020",7,7,0,774071.428571429,4917.57142857143,158.428571428571
"332","01398","2020",18,13,5,285798.611111111,2476.27777777778,113
"333","01399","2020",45,33,12,467227.044444444,4625.37777777778,99.8
"334","01400","2020",1,1,0,30000,492,61
"335","01401","2020",28,19,9,526940.535714286,4359.64285714286,123.392857142857
"336","01402","2020",12,12,0,155452.916666667,1399.33333333333,115.75
"337","01403","2020",13,13,0,132730.769230769,1521.84615384615,90.6153846153846
"338","01404","2020",6,6,0,82581.6666666667,2443.66666666667,40.1666666666667
"339","01405","2020",14,11,3,145469.285714286,1438.35714285714,97.9285714285714
"340","01406","2020",2,2,0,165000,1239.5,129
"341","01407","2020",21,13,8,180577.761904762,2164.61904761905,88.4761904761905
"342","01408","2020",7,7,0,106878.571428571,1096.42857142857,101.142857142857
"343","01410","2020",4,4,0,92250,1513.75,70
"344","01411","2020",3,3,0,97100,958,91.6666666666667
"345","01412","2020",8,7,1,231317.875,1887.25,122.625
"346","01415","2020",5,5,0,165316,1986.6,88.6
"347","01416","2020",27,21,6,73615.1851851852,994.074074074074,78.5555555555556
"348","01418","2020",13,12,1,338828.461538462,3106.15384615385,114.153846153846
"349","01419","2020",90,48,42,424738.255555556,4195.67777777778,102.3
"350","01420","2020",39,16,23,126030.512820513,1496.46153846154,86.0769230769231
"351","01421","2020",15,15,0,161822.666666667,1759.93333333333,95.0666666666667
"352","01422","2020",14,14,0,219440,1883.07142857143,117
"353","01423","2020",14,14,0,297123.571428571,2703,111.857142857143
"354","01424","2020",13,10,3,366884,3423.61538461538,107.615384615385
"355","01425","2020",4,4,0,235746.25,1684,149.75
"356","01426","2020",34,34,0,193330.823529412,1612.88235294118,124.441176470588
"357","01427","2020",98,52,46,230890.653061224,2511.15306122449,93.6734693877551
"358","01428","2020",1,1,0,396700,4312,92
"359","01429","2020",6,6,0,278048.833333333,1631,176.166666666667
"360","01430","2020",11,11,0,237141,1892.09090909091,123.636363636364
"361","01431","2020",16,16,0,142762.8125,1624.125,89.4375
"362","01432","2020",3,3,0,258350,1754,169.333333333333
"363","01433","2020",2,2,0,85736.5,866,103.5
"364","01434","2020",8,8,0,268907.75,2267.625,122.125
"365","01435","2020",20,17,3,452312.1,3842.3,116
"366","01436","2020",10,2,8,336871.2,3507.1,99.3
"367","01437","2020",4,4,0,124212.5,1302.5,104
"368","01441","2020",5,5,0,133770,1234,105.4
"369","01443","2020",76,49,27,234479.473684211,2494.68421052632,94.3815789473684
"370","01444","2020",19,18,1,151007.368421053,1602.84210526316,90.8421052631579
"371","01445","2020",10,6,4,116194,1494.5,82.5
"372","01446","2020",19,15,4,235651.105263158,2265.52631578947,101.947368421053
"373","01447","2020",9,9,0,174302.222222222,1321.44444444444,126.777777777778
"374","01448","2020",6,3,3,244766.666666667,2758.16666666667,86.8333333333333
"375","01449","2020",13,13,0,237026.923076923,2422.23076923077,107.076923076923
"376","01450","2020",60,53,7,288956.016666667,2950.86666666667,104.816666666667
"377","01451","2020",72,68,4,226596.847222222,2129.65277777778,106.486111111111
"378","01452","2020",25,20,5,110154.4,1262.48,93.88
"379","01453","2020",5,5,0,135264,1486.6,90.4
"380","01454","2020",16,13,3,190484.6875,1838.5,108.875
"381","01457","2020",29,26,3,190728.310344828,1880.89655172414,106.689655172414
"382","02001","2020",7,7,0,119571.428571429,1263.71428571429,101.857142857143
"383","02002","2020",7,7,0,93185.7142857143,999.714285714286,92.5714285714286
"384","02003","2020",10,10,0,160220,1504.3,116.3
"385","02004","2020",1,1,0,45000,1250,36
"386","02005","2020",4,4,0,190787.5,1814.25,110.75
"387","02006","2020",4,4,0,114250,1343,114.75
"388","02007","2020",1,1,0,130000,823,158
"389","02008","2020",2,2,0,101250,882,117
"390","02009","2020",5,5,0,132500,1559.6,85
"391","02010","2020",2,2,0,157500,1155,138
"392","02011","2020",13,13,0,164037.076923077,1431.61538461538,120.076923076923
"393","02013","2020",3,3,0,138066.666666667,1111.66666666667,118.333333333333
"394","02014","2020",3,3,0,159333.333333333,1583.66666666667,103.666666666667
"395","02015","2020",4,4,0,171500,1554,121.5
"396","02016","2020",3,3,0,79166.6666666667,975,80.6666666666667
"397","02017","2020",1,1,0,2e+05,980,204
"398","02018","2020",19,19,0,110578.947368421,1306.21052631579,88.2631578947368
"399","02019","2020",5,5,0,143000,1233,115.4
"400","02020","2020",4,4,0,95002.5,815.25,121.75
"401","02021","2020",1,1,0,65000,348,187
"402","02022","2020",11,11,0,236263.636363636,1792.27272727273,106.636363636364
"403","02023","2020",1,1,0,136000,1071,127
"404","02025","2020",3,3,0,154100,1548.33333333333,99.6666666666667
"405","02027","2020",7,7,0,100417.142857143,849.714285714286,119.428571428571
"406","02028","2020",25,25,0,132217.2,1463.6,92.16
"407","02029","2020",6,6,0,127372.666666667,1558.66666666667,84.8333333333333
"408","02030","2020",1,1,0,130000,1383,94
"409","02031","2020",7,7,0,61954.4285714286,582.142857142857,108.714285714286
"410","02032","2020",3,3,0,81000,971.333333333333,87
"411","02033","2020",2,2,0,109950,1350.5,86
"412","02034","2020",3,3,0,148333.333333333,1213.33333333333,125
"413","02035","2020",1,1,0,140000,432,324
"414","02036","2020",2,2,0,154140,1179.5,137.5
"415","02037","2020",9,9,0,161800,1202,140.555555555556
"416","02038","2020",1,1,0,135000,1364,99
"417","02039","2020",5,5,0,69980,859,75.8
"418","02040","2020",2,2,0,72500,853,84.5
"419","02041","2020",8,8,0,113937.5,1472.875,80.375
"420","02042","2020",4,4,0,180250,1617.75,101
"421","02043","2020",1,1,0,180000,1385,130
"422","02044","2020",1,1,0,81500,566,144
"423","02046","2020",8,8,0,106416.25,1169.375,88.75
"424","02047","2020",2,2,0,143475,1455.5,93.5
"425","02048","2020",2,2,0,115000,1204.5,94.5
"426","02049","2020",8,8,0,180328.125,1770.125,98
"427","02050","2020",6,6,0,98000,962,104.5
"428","02051","2020",8,8,0,114350,1418.75,79.375
"429","02053","2020",11,11,0,147327.272727273,1099.18181818182,125
"430","02054","2020",6,6,0,183420,1261.66666666667,148.666666666667
"431","02055","2020",1,1,0,109000,1147,95
"432","02056","2020",1,1,0,108000,1227,88
"433","02057","2020",16,16,0,87531.25,781.5,112.25
"434","02058","2020",10,10,0,126520,1530.3,84.3
"435","02059","2020",17,16,1,80032.3529411765,927,87.7058823529412
"436","02060","2020",6,6,0,125591.333333333,924.666666666667,136.166666666667
"437","02061","2020",4,4,0,94000,707.25,124
"438","02062","2020",3,3,0,171066.666666667,1398.66666666667,138
"439","02063","2020",3,3,0,101433.333333333,1213,87
"440","02064","2020",36,32,4,122858.75,1413.75,87.4722222222222
"441","02065","2020",4,4,0,60000,495,123
"442","02066","2020",3,3,0,216666.666666667,1069,197.333333333333
"443","02067","2020",1,1,0,260000,1688,154
"444","02069","2020",2,2,0,68000,737.5,90
"445","02070","2020",4,4,0,85500,783,115.75
"446","02071","2020",10,10,0,125867.5,1357.8,91.9
"447","02072","2020",2,2,0,125000,1044.5,124.5
"448","02073","2020",8,8,0,184021.125,1595.125,120.125
"449","02074","2020",9,9,0,113961.111111111,1052.55555555556,105.222222222222
"450","02075","2020",4,4,0,154850,1691.5,94.75
"451","02077","2020",3,3,0,76666.6666666667,973.666666666667,78
"452","02078","2020",3,3,0,116666.666666667,1173,104.666666666667
"453","02079","2020",2,2,0,157500,1298,125.5
"454","02080","2020",2,2,0,169000,1498,110
"455","02081","2020",6,6,0,112166.666666667,1239.33333333333,93.3333333333333
"456","02083","2020",11,11,0,145127.272727273,1390.18181818182,106.272727272727
"457","02084","2020",9,9,0,177757.777777778,1957.55555555556,87.3333333333333
"458","02085","2020",15,15,0,158318.333333333,1544.06666666667,105.133333333333
"459","02086","2020",11,11,0,141977.272727273,1229,121.636363636364
"460","02087","2020",2,2,0,150500,1160.5,126.5
"461","02088","2020",2,2,0,207500,1097.5,177
"462","02089","2020",18,18,0,139527.777777778,1481.16666666667,94.1666666666667
"463","02090","2020",7,7,0,130942.857142857,1300.14285714286,113.571428571429
"464","02091","2020",2,2,0,123500,1137.5,110
"465","02093","2020",15,14,1,116950,1291.06666666667,91.7333333333333
"466","02094","2020",6,6,0,139893.333333333,1421.5,101.166666666667
"467","02095","2020",43,43,0,66732.7906976744,757.279069767442,85.6279069767442
"468","02096","2020",5,5,0,91400,872.8,105.6
"469","02097","2020",3,3,0,106023.333333333,1097.33333333333,97.6666666666667
"470","02098","2020",5,5,0,191800,2050.6,98.8
"471","02099","2020",2,2,0,184000,1317,157.5
"472","02100","2020",1,1,0,30000,370,81
"473","02101","2020",6,6,0,80000,719.833333333333,107.833333333333
"474","02102","2020",1,1,0,164000,2523,65
"475","02103","2020",14,14,0,88785.7142857143,1003.92857142857,89
"476","02105","2020",3,3,0,103000,1323.33333333333,84.3333333333333
"477","02106","2020",7,7,0,154857.142857143,1871.14285714286,108.571428571429
"478","02109","2020",4,4,0,90500,1025,86.75
"479","02110","2020",21,21,0,134215.238095238,1224.90476190476,106
"480","02111","2020",7,7,0,104271.428571429,1304.57142857143,82.2857142857143
"481","02112","2020",1,1,0,53600,454,118
"482","02114","2020",26,26,0,170634.615384615,1659.26923076923,104.307692307692
"483","02115","2020",3,3,0,142830,1436.66666666667,100.666666666667
"484","02116","2020",3,3,0,113500,708.666666666667,170
"485","02117","2020",1,1,0,160000,964,166
"486","02119","2020",3,3,0,166500,1105.66666666667,156.666666666667
"487","02120","2020",3,3,0,108333.333333333,1709.66666666667,63.6666666666667
"488","02121","2020",2,2,0,146950,1167,125.5
"489","02123","2020",4,4,0,70000,667,106.25
"490","02124","2020",9,9,0,114811.111111111,1000.44444444444,116.222222222222
"491","02125","2020",3,3,0,185000,1392.33333333333,132
"492","02126","2020",6,6,0,72816.6666666667,685.166666666667,118.166666666667
"493","02127","2020",5,5,0,115900,1279.4,94.6
"494","02128","2020",17,17,0,136755.882352941,1440,93.5882352941177
"495","02129","2020",1,1,0,80000,1111,72
"496","02131","2020",13,12,1,128079.230769231,1492.38461538462,89.8461538461538
"497","02132","2020",1,1,0,125000,1116,112
"498","02133","2020",7,7,0,67692.8571428571,861.571428571429,75.4285714285714
"499","02134","2020",9,9,0,95821.6666666667,1005.77777777778,95.1111111111111
"500","02135","2020",12,12,0,94963.8333333333,1003.33333333333,99.1666666666667
"501","02136","2020",3,3,0,56333.3333333333,922,59
"502","02137","2020",1,1,0,240000,3810,63
"503","02139","2020",5,5,0,94100,990.8,108
"504","02140","2020",9,9,0,121411.111111111,1199.22222222222,105.666666666667
"505","02141","2020",15,14,1,88995.1333333333,859.266666666667,102.133333333333
"506","02142","2020",3,3,0,86166.6666666667,837.333333333333,102
"507","02143","2020",2,2,0,108500,1246,91.5
"508","02144","2020",2,2,0,324671,1738,184
"509","02145","2020",7,7,0,88542.8571428571,943.714285714286,95.2857142857143
"510","02146","2020",2,2,0,143000,1116,126
"511","02148","2020",5,5,0,157679,1292,133.6
"512","02150","2020",3,3,0,104266.666666667,1199.66666666667,88.6666666666667
"513","02153","2020",7,7,0,126871.428571429,1269.85714285714,106.571428571429
"514","02154","2020",3,3,0,133333.333333333,1173.33333333333,100.666666666667
"515","02155","2020",5,5,0,135400,1290.8,107.4
"516","02156","2020",7,7,0,123842.857142857,1181.14285714286,118.428571428571
"517","02157","2020",6,6,0,142466.666666667,1508.33333333333,95.5
"518","02158","2020",5,5,0,187440,1721.2,112.2
"519","02159","2020",1,1,0,133000,1873,71
"520","02160","2020",6,6,0,81833.3333333333,694.833333333333,101.833333333333
"521","02162","2020",1,1,0,75000,882,85
"522","02163","2020",26,24,2,147667.307692308,1360.34615384615,106.730769230769
"523","02164","2020",3,3,0,173000,1916,102
"524","02165","2020",29,29,0,98048.0344827586,985.51724137931,105.137931034483
"525","02166","2020",7,7,0,160214.285714286,1333.14285714286,125.571428571429
"526","02167","2020",8,8,0,139056.25,1216.75,111.5
"527","02168","2020",141,93,48,146137.19858156,1718.30496453901,89.822695035461
"528","02169","2020",1,1,0,31750,349,91
"529","02170","2020",2,2,0,92500,1284,72.5
"530","02172","2020",4,4,0,148000,1555,98.25
"531","02173","2020",138,123,15,113721.97826087,1276.20289855072,94.6449275362319
"532","02174","2020",12,12,0,137225,1563.75,101.5
"533","02175","2020",4,4,0,164375,1197.75,148.25
"534","02176","2020",3,3,0,54833.3333333333,1120,49.6666666666667
"535","02177","2020",5,5,0,103200,955.6,114
"536","02179","2020",2,2,0,154500,1505.5,110
"537","02180","2020",9,9,0,95544.4444444444,1234.33333333333,78.5555555555556
"538","02181","2020",1,1,0,77000,1540,50
"539","02182","2020",4,4,0,68450,784.5,94.25
"540","02183","2020",1,1,0,93000,802,116
"541","02184","2020",1,1,0,69750,742,94
"542","02185","2020",4,4,0,149062.5,1361,111
"543","02186","2020",17,16,1,135729.411764706,1542.94117647059,89.2941176470588
"544","02187","2020",18,16,2,171405.888888889,1869.5,93.8333333333333
"545","02188","2020",2,2,0,72500,709.5,110.5
"546","02189","2020",3,3,0,113000,1256.66666666667,89.6666666666667
"547","02190","2020",7,7,0,160112.142857143,1628.85714285714,103.428571428571
"548","02191","2020",4,4,0,118750,1528.5,75.25
"549","02192","2020",5,5,0,104200,1354.4,72.2
"550","02194","2020",1,1,0,40000,533,75
"551","02195","2020",11,10,1,166636.363636364,1683.63636363636,105.363636363636
"552","02196","2020",2,2,0,124662.5,865.5,146.5
"553","02197","2020",6,6,0,96616.6666666667,855.833333333333,114.5
"554","02198","2020",1,1,0,171500,1665,103
"555","02199","2020",6,6,0,136066.666666667,1323,99
"556","02200","2020",2,2,0,87500,719,114.5
"557","02201","2020",9,9,0,125388.888888889,1402.88888888889,96.4444444444444
"558","02203","2020",17,17,0,126971.176470588,1369.17647058824,95.1176470588235
"559","02204","2020",1,1,0,68220,1034,66
"560","02205","2020",1,1,0,170000,1393,122
"561","02207","2020",6,6,0,114808.333333333,1265.83333333333,92
"562","02208","2020",5,5,0,138000,1697.2,80.6
"563","02209","2020",12,12,0,113500,1476.33333333333,79.1666666666667
"564","02210","2020",9,9,0,149222.222222222,1374.44444444444,101.555555555556
"565","02211","2020",5,5,0,156396,1799.2,89
"566","02212","2020",10,10,0,107015,1187.3,103.3
"567","02213","2020",4,4,0,109925,1697.25,71.25
"568","02214","2020",1,1,0,130000,1494,87
"569","02215","2020",13,13,0,163457.692307692,1673,101.153846153846
"570","02216","2020",9,9,0,152777.777777778,1792.11111111111,83.3333333333333
"571","02217","2020",12,12,0,87285.8333333333,925.583333333333,97.3333333333333
"572","02218","2020",6,6,0,157825,1504.16666666667,104.666666666667
"573","02219","2020",3,3,0,79666.6666666667,1016,75.3333333333333
"574","02220","2020",12,12,0,142866.666666667,1144,115.5
"575","02221","2020",1,1,0,40000,702,57
"576","02223","2020",4,4,0,125000,1414,88.5
"577","02224","2020",1,1,0,180000,1324,136
"578","02226","2020",21,19,2,141275.428571429,1472.71428571429,97.8571428571429
"579","02227","2020",3,3,0,172266.666666667,954,188.333333333333
"580","02228","2020",2,2,0,76500,1018.5,77.5
"581","02230","2020",3,3,0,91233.3333333333,981.666666666667,94.3333333333333
"582","02231","2020",6,6,0,153645,1588,100.166666666667
"583","02232","2020",4,4,0,147370.25,1609.25,100
"584","02233","2020",1,1,0,75000,750,100
"585","02234","2020",3,3,0,159166.666666667,1310.66666666667,111
"586","02235","2020",2,2,0,140817.5,1743,78.5
"587","02236","2020",6,6,0,100333.333333333,1255.16666666667,81.5
"588","02237","2020",13,13,0,83406,832.692307692308,95.3076923076923
"589","02238","2020",18,17,1,107697.222222222,1241.77777777778,90.9444444444444
"590","02239","2020",7,7,0,127857.142857143,1193.14285714286,105
"591","02241","2020",1,1,0,145000,1189,122
"592","02242","2020",12,11,1,129387.5,1506.33333333333,89
"593","02243","2020",30,27,3,129905,1458.06666666667,93.5666666666667
"594","02245","2020",21,17,4,138828.571428571,1474.52380952381,94.3333333333333
"595","02246","2020",10,10,0,113000,1077.4,99.8
"596","02249","2020",2,2,0,75000,954,76
"597","02250","2020",1,1,0,105000,1193,88
"598","02251","2020",1,1,0,55600,520,107
"599","02253","2020",5,5,0,143800,1183,118.8
"600","02254","2020",3,3,0,80500,1054,108.333333333333
"601","02256","2020",2,2,0,74000,600,125
"602","02257","2020",3,3,0,171989.333333333,1420,126.666666666667
"603","02258","2020",4,4,0,198702.5,1418.75,151.25
"604","02259","2020",2,2,0,159700,2248,77
"605","02260","2020",8,8,0,143812.5,1068.875,134.875
"606","02261","2020",3,3,0,135166.666666667,1162,108.333333333333
"607","02262","2020",1,1,0,220000,2857,77
"608","02263","2020",2,2,0,161815,1343.5,120
"609","02264","2020",4,4,0,62250,1168.5,71.25
"610","02265","2020",2,2,0,62750,758.5,83
"611","02267","2020",4,4,0,101250,1319.75,73.75
"612","02268","2020",5,5,0,161800,1553.6,105.6
"613","02269","2020",1,1,0,172000,2072,83
"614","02270","2020",1,1,0,65000,560,116
"615","02271","2020",4,4,0,115125,1319,94.25
"616","02272","2020",1,1,0,160000,1074,149
"617","02273","2020",2,2,0,121855,1362.5,102
"618","02275","2020",1,1,0,92000,575,160
"619","02276","2020",3,3,0,99333.3333333333,1128.66666666667,86.3333333333333
"620","02277","2020",9,9,0,155555.555555556,1334.44444444444,119.222222222222
"621","02278","2020",1,1,0,72000,545,132
"622","02279","2020",7,7,0,179571.428571429,1580.42857142857,115.571428571429
"623","02280","2020",6,6,0,193616.5,2092.5,101.5
"624","02281","2020",6,6,0,178550,1707.33333333333,116.333333333333
"625","02282","2020",7,7,0,123844.285714286,1576.85714285714,82
"626","02283","2020",3,3,0,73333.3333333333,887.666666666667,79.3333333333333
"627","02284","2020",2,2,0,98500,996,109
"628","02286","2020",6,6,0,73333.3333333333,874.166666666667,88
"629","02287","2020",12,12,0,141900.25,1462.91666666667,98.75
"630","02288","2020",5,5,0,111936,1212.8,98.2
"631","02289","2020",2,2,0,179500,1258.5,198
"632","02290","2020",39,37,2,169124.358974359,1683.87179487179,107.666666666667
"633","02291","2020",4,4,0,116000,913,127
"634","02292","2020",10,10,0,142950,1737,80.4
"635","02293","2020",5,5,0,63400,1007.6,62.2
"636","02294","2020",1,0,1,95100,1057,90
"637","02295","2020",11,11,0,97045.4545454545,820.181818181818,110.909090909091
"638","02296","2020",9,9,0,158394.111111111,1463,110.666666666667
"639","02297","2020",1,1,0,170000,3542,48
"640","02298","2020",19,19,0,64115.2631578947,727.631578947368,92.6842105263158
"641","02299","2020",13,13,0,150555.384615385,1743.46153846154,92.9230769230769
"642","02302","2020",5,5,0,147736,1701.2,94.6
"643","02303","2020",13,13,0,259277.692307692,1845.61538461538,149.923076923077
"644","02304","2020",28,21,7,68695,738.714285714286,100.964285714286
"645","02305","2020",33,30,3,116252.424242424,1120.84848484848,110.30303030303
"646","02306","2020",6,6,0,81333.3333333333,1115.33333333333,83.3333333333333
"647","02307","2020",39,35,4,142458.923076923,1736.53846153846,83.9230769230769
"648","02308","2020",5,5,0,130600,1355.4,108.6
"649","02309","2020",6,6,0,147500,1271.66666666667,114.666666666667
"650","02310","2020",1,1,0,21000,362,58
"651","02311","2020",3,3,0,125333.333333333,1678.66666666667,84.3333333333333
"652","02312","2020",3,3,0,133333.333333333,1064,128.333333333333
"653","02313","2020",4,4,0,148675,1068,138.5
"654","02315","2020",19,19,0,116747.368421053,1166.78947368421,103.789473684211
"655","02316","2020",1,1,0,156000,1560,100
"656","02317","2020",3,3,0,118466.666666667,800,186
"657","02318","2020",27,26,1,107028.518518519,1050.33333333333,100.37037037037
"658","02319","2020",1,1,0,115000,777,148
"659","02320","2020",4,4,0,151250,1262,121.75
"660","02321","2020",13,13,0,143400,1376.07692307692,112.461538461538
"661","02322","2020",5,5,0,90500,759.2,113.8
"662","02323","2020",7,7,0,112147.142857143,749.285714285714,146.142857142857
"663","02324","2020",5,5,0,69100,733,102.8
"664","02326","2020",5,5,0,225510,1895.2,134.4
"665","02327","2020",1,1,0,50000,510,98
"666","02328","2020",6,6,0,171745.666666667,1632.5,104
"667","02329","2020",2,2,0,108950,1049.5,101
"668","02330","2020",5,5,0,193488.4,1549,130.8
"669","02332","2020",4,4,0,135750,1103.25,123
"670","02333","2020",3,3,0,94450,918,103.333333333333
"671","02334","2020",24,24,0,91647.4583333333,974.333333333333,93.9166666666667
"672","02335","2020",2,2,0,60500,915.5,66.5
"673","02336","2020",9,9,0,143636.666666667,1371,104.111111111111
"674","02337","2020",2,2,0,195000,975,200
"675","02338","2020",2,2,0,62750,764,88
"676","02339","2020",11,11,0,146543.181818182,1410.18181818182,122.727272727273
"677","02340","2020",67,67,0,119189.194029851,1337.83582089552,89.865671641791
"678","02341","2020",1,1,0,1e+05,1333,75
"679","02342","2020",2,2,0,62500,371,169
"680","02343","2020",2,2,0,144800,1060.5,138.5
"681","02346","2020",7,7,0,90614.2857142857,1063.71428571429,97.5714285714286
"682","02347","2020",9,9,0,128522.222222222,1330.66666666667,94
"683","02350","2020",2,2,0,101475,1296.5,79
"684","02351","2020",2,2,0,145000,1474,101.5
"685","02352","2020",10,10,0,87440.2,1026.7,90.9
"686","02353","2020",2,2,0,181700,1029,188.5
"687","02354","2020",1,1,0,75000,862,87
"688","02355","2020",8,8,0,161000,1529.5,104
"689","02356","2020",4,4,0,125000,1209.75,102
"690","02357","2020",1,1,0,142000,1775,80
"691","02358","2020",2,2,0,106000,906,115
"692","02359","2020",18,17,1,101361.666666667,1335.61111111111,72.3888888888889
"693","02360","2020",35,32,3,171071.571428571,1751.25714285714,100.714285714286
"694","02361","2020",36,35,1,87781.9444444444,851.527777777778,101.833333333333
"695","02362","2020",4,4,0,105500,993,107.5
"696","02363","2020",4,4,0,99100,2074.25,56
"697","02364","2020",4,4,0,177800,2005,89.75
"698","02366","2020",5,5,0,93000,761.8,137.2
"699","02367","2020",1,1,0,22900,654,35
"700","02368","2020",6,6,0,204488.333333333,1923.5,110.166666666667
"701","02370","2020",3,3,0,147666.666666667,972,152.666666666667
"702","02371","2020",17,17,0,108755.294117647,1243.76470588235,87.1176470588235
"703","02372","2020",5,5,0,125800,1198,105.8
"704","02373","2020",4,4,0,126625,991.25,123.75
"705","02374","2020",10,6,4,83060,1114.8,74.3
"706","02375","2020",1,1,0,120000,1212,99
"707","02376","2020",2,2,0,115000,1118,103.5
"708","02377","2020",2,2,0,156750,1453.5,112
"709","02378","2020",1,1,0,160000,1000,160
"710","02379","2020",2,2,0,111750,778.5,140
"711","02381","2020",93,87,6,69278.5161290323,861.096774193548,81.1290322580645
"712","02382","2020",7,7,0,137421.428571429,1327.57142857143,112.571428571429
"713","02383","2020",11,11,0,155759.090909091,1469.54545454545,111.090909090909
"714","02385","2020",1,1,0,335000,1081,310
"715","02387","2020",10,10,0,171300,1600.3,104.3
"716","02388","2020",2,2,0,97710,1395,85
"717","02389","2020",11,10,1,181306.363636364,1890.54545454545,105.090909090909
"718","02390","2020",3,3,0,108000,1002.66666666667,116
"719","02391","2020",5,5,0,109480,1354.4,84.4
"720","02392","2020",7,7,0,111778.571428571,954.428571428571,126.857142857143
"721","02393","2020",3,3,0,194141.666666667,1390.33333333333,135
"722","02395","2020",3,3,0,167666.666666667,1218,138
"723","02396","2020",1,1,0,98000,817,120
"724","02397","2020",16,16,0,84925,972.5625,89.1875
"725","02398","2020",2,2,0,156481,1472,102
"726","02399","2020",8,8,0,167212.5,1382.875,142.625
"727","02400","2020",4,3,1,187750,1520,121.75
"728","02401","2020",1,1,0,73000,716,102
"729","02402","2020",1,1,0,54000,651,83
"730","02403","2020",1,1,0,101340,1024,99
"731","02405","2020",7,7,0,91271.4285714286,1031.71428571429,102.714285714286
"732","02406","2020",2,2,0,140450,1377,102.5
"733","02407","2020",3,3,0,89733.3333333333,938.666666666667,103.666666666667
"734","02408","2020",292,182,110,91213.4554794521,1129.31849315068,81.5856164383562
"735","02410","2020",4,4,0,215750,1829.75,114
"736","02411","2020",5,5,0,145980,1203.6,115.4
"737","02413","2020",1,1,0,95000,1301,73
"738","02414","2020",2,2,0,102500,800,119.5
"739","02415","2020",2,2,0,148750,1748.5,84.5
"740","02416","2020",5,5,0,82400,925,89.4
"741","02420","2020",10,10,0,149765,1528.3,97
"742","02422","2020",8,8,0,91250,917,102.25
"743","02423","2020",6,6,0,132666.666666667,1229.16666666667,114.166666666667
"744","02426","2020",9,9,0,146728.888888889,1182.44444444444,122
"745","02428","2020",3,3,0,195000,1559,126.333333333333
"746","02430","2020",11,11,0,79136.3636363636,876.727272727273,86.6363636363636
"747","02431","2020",6,6,0,92621.3333333333,1118.33333333333,84
"748","02432","2020",5,5,0,201200,1688,107.4
"749","02433","2020",3,3,0,150666.666666667,971.666666666667,159.333333333333
"750","02438","2020",5,4,1,109990,1301.4,91.4
"751","02439","2020",17,17,0,137937.235294118,1090.76470588235,126.764705882353
"752","02440","2020",3,3,0,111000,768,146.333333333333
"753","02441","2020",5,5,0,160000,1543,104.6
"754","02443","2020",2,2,0,199650,1455.5,143
"755","02444","2020",1,1,0,55000,786,70
"756","02445","2020",4,4,0,81500,1141.5,82
"757","02447","2020",2,2,0,145000,1000.5,137
"758","02448","2020",1,1,0,78000,650,120
"759","02450","2020",5,5,0,117120,886.8,131.2
"760","02452","2020",3,3,0,163473.333333333,1472.33333333333,116.666666666667
"761","02453","2020",6,6,0,192499.833333333,1463,134.833333333333
"762","02454","2020",3,3,0,119000,1295,85.6666666666667
"763","02455","2020",2,2,0,82500,918,100
"764","02456","2020",7,7,0,132964.285714286,1563.71428571429,93.5714285714286
"765","02457","2020",5,5,0,102950,1388,75.4
"766","02458","2020",9,9,0,155622.222222222,1623,97.7777777777778
"767","02460","2020",2,2,0,104750,1179.5,87
"768","02461","2020",7,7,0,113628.571428571,1172.71428571429,108.142857142857
"769","02462","2020",2,2,0,209525,1438.5,155.5
"770","02463","2020",3,3,0,75833.3333333333,953,80
"771","02464","2020",4,4,0,173500,1441,118.25
"772","02465","2020",7,7,0,164285.714285714,1658.42857142857,100
"773","02468","2020",20,20,0,93745,860.2,117.45
"774","02469","2020",6,6,0,75226.6666666667,703.166666666667,114.333333333333
"775","02470","2020",3,3,0,60333.3333333333,864.333333333333,70.3333333333333
"776","02471","2020",3,3,0,199416.666666667,3414.33333333333,72
"777","02472","2020",5,5,0,111190,1068.8,99.8
"778","02473","2020",5,5,0,106200,1089.4,99.2
"779","02474","2020",6,6,0,93750,1005.5,97.5
"780","02476","2020",8,8,0,73625,856.125,90.375
"781","02477","2020",6,6,0,207150,1952,104.666666666667
"782","02478","2020",2,2,0,175000,1259.5,176.5
"783","02480","2020",3,3,0,89333.3333333333,897,94
"784","02481","2020",2,2,0,155790,1498,104
"785","02482","2020",1,1,0,155500,864,180
"786","02483","2020",5,5,0,145500,1229,129.2
"787","02484","2020",1,1,0,140000,1129,124
"788","02485","2020",1,1,0,220000,2056,107
"789","02487","2020",5,5,0,142240,1543,101.6
"790","02488","2020",1,1,0,54600,607,90
"791","02489","2020",1,1,0,112800,1226,92
"792","02490","2020",1,1,0,56000,767,73
"793","02491","2020",3,3,0,68666.6666666667,620.333333333333,108.666666666667
"794","02492","2020",7,7,0,76121.4285714286,918.285714285714,84
"795","02494","2020",3,3,0,82000,771.666666666667,101.333333333333
"796","02495","2020",7,7,0,104980,1005.85714285714,103
"797","02497","2020",14,14,0,160650,1347.92857142857,117.785714285714
"798","02498","2020",8,8,0,107825,1149,102
"799","02500","2020",13,13,0,87544.3076923077,998.461538461538,90
"800","02501","2020",1,1,0,1e+05,1031,97
"801","02502","2020",13,13,0,81096.0769230769,715.615384615385,130.384615384615
"802","02503","2020",5,5,0,141149,1094.4,122.6
"803","02504","2020",24,24,0,108495.833333333,1127.20833333333,98.0416666666667
"804","02505","2020",3,3,0,144333.333333333,1731.66666666667,87.3333333333333
"805","02506","2020",3,3,0,196666.666666667,1707.66666666667,123.333333333333
"806","02508","2020",2,2,0,133450,1224,109
"807","02510","2020",1,1,0,350000,1750,200
"808","02511","2020",6,6,0,74111.3333333333,782.833333333333,91.6666666666667
"809","02512","2020",5,5,0,115400,1671.4,70
"810","02513","2020",1,1,0,80000,976,82
"811","02514","2020",12,12,0,184208.333333333,1860.16666666667,106.25
"812","02515","2020",2,2,0,88000,865.5,107.5
"813","02516","2020",1,1,0,65000,844,77
"814","02517","2020",5,5,0,113020,1054.8,114
"815","02518","2020",2,2,0,172000,1262,136
"816","02519","2020",7,7,0,78000,899.714285714286,90.7142857142857
"817","02520","2020",9,9,0,142875.888888889,1236.44444444444,115.222222222222
"818","02521","2020",16,16,0,179962.5,1880.375,94.9375
"819","02523","2020",1,1,0,169000,1779,95
"820","02524","2020",6,6,0,193923.333333333,1700,119
"821","02525","2020",7,7,0,106900,1232.42857142857,85.1428571428571
"822","02527","2020",8,8,0,132738.25,1534.75,86.5
"823","02528","2020",3,3,0,194000,1737.33333333333,115
"824","02531","2020",3,3,0,220000,1576,143
"825","02532","2020",21,21,0,116073.80952381,1158.52380952381,100.714285714286
"826","02533","2020",3,3,0,164500,1237,131.666666666667
"827","02535","2020",3,3,0,137000,1112.33333333333,136
"828","02536","2020",1,1,0,150000,1500,100
"829","02537","2020",5,5,0,112376,1252,96.6
"830","02538","2020",1,1,0,90000,1047,86
"831","02539","2020",6,6,0,137500,1318.33333333333,107
"832","02540","2020",13,13,0,195269.230769231,1951.15384615385,110.384615384615
"833","02541","2020",7,7,0,161478.571428571,1426.42857142857,121.714285714286
"834","02543","2020",38,38,0,139552.631578947,1310.73684210526,107.842105263158
"835","02544","2020",2,2,0,105000,1230.5,85
"836","02545","2020",2,2,0,44250,556.5,80.5
"837","02548","2020",7,7,0,93428.5714285714,831.142857142857,110.142857142857
"838","02549","2020",12,12,0,136991.666666667,1408.41666666667,93
"839","02550","2020",3,3,0,148500,1749,84
"840","02551","2020",3,3,0,100666.666666667,704,143
"841","02552","2020",3,3,0,51733.3333333333,724,76
"842","02553","2020",2,2,0,86250,986.5,99
"843","02554","2020",7,7,0,157714.285714286,1926.57142857143,87.8571428571429
"844","02555","2020",34,31,3,129800,1595,83.3823529411765
"845","02556","2020",2,2,0,114500,902.5,127
"846","02557","2020",4,4,0,111500,1337,84
"847","02558","2020",19,19,0,73663.1578947368,831.684210526316,90.3684210526316
"848","02559","2020",7,7,0,101428.571428571,1007.71428571429,99.1428571428571
"849","02560","2020",4,4,0,71625,1420.5,58.5
"850","02561","2020",2,2,0,178275,1290.5,139
"851","02562","2020",3,3,0,145166.666666667,1526,106
"852","02564","2020",5,5,0,78820,1234,61.8
"853","02565","2020",3,3,0,122366.666666667,1074.33333333333,108.333333333333
"854","02566","2020",26,26,0,113326.923076923,1431.07692307692,87.7692307692308
"855","02567","2020",2,2,0,97750,1684.5,72
"856","02568","2020",5,5,0,145600,1886.8,82.4
"857","02569","2020",5,5,0,71900,787.4,88.4
"858","02570","2020",2,2,0,49500,634.5,78.5
"859","02571","2020",8,8,0,89558.375,1292.75,71.25
"860","02572","2020",5,5,0,231600,1751.4,148.2
"861","02573","2020",1,1,0,89000,937,95
"862","02574","2020",14,14,0,92401.7857142857,802.285714285714,121
"863","02575","2020",16,16,0,89243.75,903.6875,102.5
"864","02576","2020",4,4,0,124000,1280.5,94.75
"865","02577","2020",1,1,0,140000,1045,134
"866","02578","2020",1,1,0,110000,1803,61
"867","02579","2020",1,1,0,70000,1167,60
"868","02580","2020",7,7,0,175557.142857143,1321.57142857143,128.857142857143
"869","02581","2020",4,4,0,192297.5,1467.75,128.5
"870","02583","2020",2,2,0,269800,2474.5,119.5
"871","02584","2020",2,2,0,149250,1325,112.5
"872","02585","2020",2,2,0,221500,1393,173
"873","02586","2020",5,5,0,81119,1255.6,72
"874","02587","2020",6,6,0,137167.333333333,1287.33333333333,109.5
"875","02589","2020",2,2,0,116150,1339,88
"876","02590","2020",5,5,0,126766.6,1132.4,163
"877","02591","2020",2,2,0,58400,532,109.5
"878","02592","2020",2,2,0,87500,884.5,99
"879","02593","2020",22,22,0,148234.545454545,1483.95454545455,102.954545454545
"880","02594","2020",1,1,0,189000,1312,144
"881","02595","2020",1,1,0,175000,1966,89
"882","02596","2020",12,12,0,112458.333333333,1385.33333333333,82.0833333333333
"883","02598","2020",11,11,0,181177.272727273,2417.27272727273,101.818181818182
"884","02599","2020",5,5,0,127320,1371.8,95.2
"885","02600","2020",4,4,0,73125,996.75,73.5
"886","02601","2020",5,5,0,177480,1563.2,114.6
"887","02602","2020",21,21,0,129694.047619048,1397.33333333333,99
"888","02604","2020",5,5,0,174802,1296.2,135.6
"889","02606","2020",1,1,0,80000,889,90
"890","02608","2020",6,6,0,57166.6666666667,628.666666666667,90.1666666666667
"891","02610","2020",11,11,0,142387.363636364,1641,85.6363636363636
"892","02612","2020",2,2,0,82500,802.5,85
"893","02613","2020",8,8,0,173875.625,2016,92.875
"894","02614","2020",5,5,0,160100,1479,101.8
"895","02615","2020",4,4,0,148742.5,1184.75,114.25
"896","02616","2020",1,1,0,170000,1214,140
"897","02617","2020",5,5,0,98710,797.2,120.4
"898","02618","2020",6,6,0,88465.6666666667,873.5,104.166666666667
"899","02619","2020",3,2,1,86925.3333333333,720,120.333333333333
"900","02620","2020",1,1,0,122000,1452,84
"901","02621","2020",4,4,0,155450,1506,107.75
"902","02623","2020",1,1,0,35000,438,80
"903","02624","2020",8,8,0,77500,796.25,96.375
"904","02625","2020",3,3,0,85000,911,97.3333333333333
"905","02626","2020",4,4,0,145950,1578,89.75
"906","02627","2020",3,3,0,190853.333333333,1807.33333333333,105.666666666667
"907","02628","2020",3,3,0,267886.666666667,2338.66666666667,130
"908","02629","2020",2,2,0,71000,746.5,95
"909","02631","2020",6,6,0,118666.666666667,1285,107.833333333333
"910","02633","2020",1,1,0,320000,3721,86
"911","02634","2020",4,4,0,85250,793.25,106
"912","02635","2020",2,2,0,122642.5,824.5,141.5
"913","02636","2020",2,2,0,147450,2196.5,67.5
"914","02637","2020",4,4,0,145400,1545,94.75
"915","02638","2020",4,4,0,85687.5,844,102.25
"916","02639","2020",5,5,0,150000,1649.4,95.4
"917","02641","2020",1,1,0,73332,733,100
"918","02642","2020",2,2,0,113675,1005,122.5
"919","02643","2020",4,4,0,147997.5,1717.75,92.5
"920","02644","2020",10,10,0,169660,1951,107.9
"921","02645","2020",5,5,0,115260,1557,79.6
"922","02647","2020",1,1,0,250000,1543,162
"923","02648","2020",23,23,0,98371.7391304348,1131,91.7391304347826
"924","02649","2020",3,3,0,148333.333333333,1534.33333333333,101
"925","02650","2020",5,5,0,149400,1043.4,149.6
"926","02653","2020",7,7,0,109428.571428571,1805.71428571429,66.5714285714286
"927","02654","2020",1,1,0,345000,10147,34
"928","02655","2020",2,2,0,157000,1004,161
"929","02656","2020",6,6,0,222076.666666667,1932.33333333333,114.166666666667
"930","02657","2020",1,1,0,40500,393,103
"931","02658","2020",3,3,0,98383.3333333333,1108.33333333333,106.666666666667
"932","02659","2020",5,5,0,224010,1658,130.2
"933","02661","2020",2,2,0,88500,831.5,106
"934","02662","2020",11,11,0,135727.272727273,1098.45454545455,127.181818181818
"935","02663","2020",3,3,0,121233.333333333,1404.33333333333,87.3333333333333
"936","02664","2020",1,1,0,130000,1444,90
"937","02665","2020",2,2,0,102500,1299.5,84
"938","02666","2020",6,6,0,66166.6666666667,674.166666666667,102.666666666667
"939","02667","2020",3,3,0,174000,1324.66666666667,143
"940","02668","2020",9,9,0,104565.555555556,833.555555555556,124.666666666667
"941","02670","2020",2,2,0,55742.5,1589.5,42
"942","02671","2020",4,4,0,99500,948,109
"943","02672","2020",5,5,0,149260,1278.8,113.2
"944","02674","2020",1,1,0,140000,1077,130
"945","02676","2020",25,25,0,108688,1039.88,104.6
"946","02677","2020",3,3,0,97666.6666666667,1194.33333333333,79
"947","02679","2020",4,4,0,175000,1755.75,107.5
"948","02680","2020",41,39,2,92352.6829268293,1038,90.0243902439024
"949","02681","2020",2,2,0,119550,820.5,162
"950","02682","2020",1,1,0,40000,800,50
"951","02683","2020",3,3,0,80333.3333333333,866,96.6666666666667
"952","02684","2020",15,15,0,95066.6666666667,978.266666666667,97.8666666666667
"953","02685","2020",2,2,0,165450,1860.5,90
"954","02686","2020",3,3,0,84166.6666666667,1055.33333333333,91.6666666666667
"955","02687","2020",6,6,0,204083.333333333,1852.16666666667,113.333333333333
"956","02690","2020",2,2,0,116670,673,168
"957","02691","2020",634,531,103,98480.7018927445,1119.36119873817,86.7981072555205
"958","02693","2020",1,1,0,215000,4778,45
"959","02694","2020",6,6,0,102123.333333333,1128.33333333333,93.3333333333333
"960","02696","2020",3,3,0,78666.6666666667,952.666666666667,87.3333333333333
"961","02697","2020",5,5,0,89600,1024.4,86.4
"962","02698","2020",1,1,0,1e+05,901,111
"963","02699","2020",3,3,0,107566.666666667,1314.66666666667,83.3333333333333
"964","02701","2020",14,11,3,128035.714285714,1350.07142857143,103.285714285714
"965","02702","2020",4,4,0,125500,1303.75,96.75
"966","02703","2020",12,12,0,74959.3333333333,906.833333333333,84.25
"967","02704","2020",2,2,0,50000,683,78
"968","02705","2020",1,1,0,129990,1057,123
"969","02706","2020",5,5,0,230900,1665.8,137.8
"970","02707","2020",2,2,0,125500,801,156.5
"971","02708","2020",2,2,0,91500,909.5,89.5
"972","02709","2020",1,1,0,95050,897,106
"973","02710","2020",9,9,0,101755.555555556,1094.55555555556,92.6666666666667
"974","02711","2020",2,2,0,118750,1131.5,104.5
"975","02712","2020",2,2,0,380250,2226,150.5
"976","02713","2020",6,6,0,135500,1199.66666666667,121.833333333333
"977","02714","2020",2,1,1,66000,868.5,76
"978","02715","2020",1,1,0,175000,2500,70
"979","02716","2020",3,3,0,74500,984.666666666667,74.6666666666667
"980","02717","2020",6,6,0,115000,1058.5,106.666666666667
"981","02719","2020",20,20,0,106345,1147.55,89.9
"982","02720","2020",19,19,0,98568.6842105263,999.947368421053,100.684210526316
"983","02721","2020",7,7,0,148798.428571429,1498.85714285714,107.714285714286
"984","02722","2020",330,163,167,140309.245454545,1651.16363636364,84.2090909090909
"985","02726","2020",3,3,0,65666.6666666667,776,72.6666666666667
"986","02727","2020",4,4,0,72617.5,765.5,98.5
"987","02728","2020",6,6,0,93583.3333333333,729.833333333333,131
"988","02729","2020",3,3,0,214333.333333333,1812.33333333333,126.333333333333
"989","02730","2020",2,2,0,126000,915.5,141
"990","02731","2020",1,1,0,30000,517,58
"991","02732","2020",1,1,0,85000,739,115
"992","02734","2020",4,4,0,122875,1160.75,99
"993","02735","2020",1,1,0,125000,1736,72
"994","02736","2020",2,2,0,143325,1188,142.5
"995","02737","2020",7,7,0,76000,673.571428571429,107.142857142857
"996","02738","2020",147,144,3,95345.5102040816,1111.38095238095,88.421768707483
"997","02739","2020",1,1,0,107000,1244,86
"998","02740","2020",5,5,0,93660,1160.6,77.4
"999","02741","2020",9,9,0,48155.5555555556,586.111111111111,82.5555555555556
"1000","02742","2020",3,3,0,55333.3333333333,767,70.3333333333333
"1001","02745","2020",1,1,0,67800,595,114
"1002","02746","2020",7,7,0,99414.2857142857,885.428571428571,110
"1003","02747","2020",2,2,0,198000,1519.5,135.5
"1004","02748","2020",24,24,0,144204.916666667,1315.16666666667,112
"1005","02749","2020",6,6,0,192333.333333333,1556.33333333333,126.666666666667
"1006","02750","2020",7,7,0,141972.142857143,1466.85714285714,97.4285714285714
"1007","02751","2020",6,6,0,126166.666666667,1096.33333333333,115.666666666667
"1008","02752","2020",3,3,0,129519,1274,108.666666666667
"1009","02753","2020",7,7,0,67000,746.142857142857,92.7142857142857
"1010","02754","2020",3,3,0,159466.666666667,1249,119
"1011","02755","2020",9,9,0,144211.111111111,1267.44444444444,131.555555555556
"1012","02756","2020",5,5,0,123200,1473.4,87
"1013","02757","2020",5,5,0,189670,1226,150.6
"1014","02758","2020",27,24,3,102159.259259259,1230.66666666667,83.2222222222222
"1015","02759","2020",3,3,0,125370,1233.66666666667,105.333333333333
"1016","02760","2020",1,1,0,60000,606,99
"1017","02761","2020",3,3,0,145666.666666667,1379,102.666666666667
"1018","02762","2020",3,3,0,88383.3333333333,617.666666666667,141.333333333333
"1019","02763","2020",3,3,0,196500,1445,131
"1020","02765","2020",1,1,0,116000,1841,63
"1021","02766","2020",6,6,0,114031.666666667,1329.83333333333,86
"1022","02767","2020",4,4,0,181375,2073,105
"1023","02768","2020",4,4,0,135725,1611,100.75
"1024","02769","2020",10,10,0,92850,830.2,112.1
"1025","02770","2020",10,9,1,177640,1675,107
"1026","02772","2020",1,1,0,23000,451,51
"1027","02774","2020",2,2,0,79500,811,98
"1028","02775","2020",9,9,0,134144.444444444,1198.55555555556,115.444444444444
"1029","02776","2020",5,5,0,149000,1176,142
"1030","02777","2020",5,5,0,148700,1484.2,101.8
"1031","02778","2020",3,3,0,156666.666666667,1324.66666666667,115.666666666667
"1032","02779","2020",3,3,0,71333.3333333333,809.666666666667,90
"1033","02780","2020",9,8,1,131407.222222222,1348.55555555556,102.111111111111
"1034","02781","2020",4,4,0,160750,1648,95
"1035","02782","2020",1,1,0,135000,1570,86
"1036","02783","2020",1,1,0,126500,1488,85
"1037","02784","2020",3,3,0,87000,985.333333333333,85.3333333333333
"1038","02785","2020",11,11,0,99727.2727272727,880.636363636364,108.909090909091
"1039","02786","2020",3,3,0,105000,1447.66666666667,84
"1040","02787","2020",5,5,0,101864,971,108.6
"1041","02788","2020",4,4,0,109250,1125.5,94.25
"1042","02789","2020",10,10,0,77000,851.5,96.1
"1043","02791","2020",2,2,0,70937,944.5,73.5
"1044","02792","2020",2,2,0,182000,2003.5,101
"1045","02794","2020",7,7,0,182728.571428571,1433.28571428571,139.857142857143
"1046","02795","2020",19,18,1,148143.157894737,1535.21052631579,96
"1047","02797","2020",1,1,0,95000,1319,72
"1048","02798","2020",12,12,0,151708.333333333,1550.83333333333,99.8333333333333
"1049","02799","2020",8,6,2,118250,1507.125,79.875
"1050","02800","2020",4,4,0,159250,1608.75,103
"1051","02801","2020",2,2,0,140000,1077,103
"1052","02802","2020",2,2,0,76500,631,128.5
"1053","02803","2020",3,3,0,137033.333333333,1118,113.333333333333
"1054","02804","2020",3,3,0,133100,1560,83.6666666666667
"1055","02805","2020",19,13,6,119368.473684211,1387.89473684211,85.4736842105263
"1056","02806","2020",3,3,0,91666.6666666667,1220.66666666667,73.3333333333333
"1057","02807","2020",7,7,0,151685.714285714,1158.28571428571,131
"1058","02808","2020",4,4,0,84500,1001.5,94.25
"1059","02809","2020",1,1,0,183400,1112,165
"1060","02810","2020",123,80,43,151924.341463415,1845.73170731707,87.3008130081301
"1061","02812","2020",4,4,0,209250,2223.5,107
"1062","02813","2020",3,3,0,85000,842.666666666667,104
"1063","02814","2020",4,4,0,93325,1129.5,98
"1064","02815","2020",4,4,0,147125,1048.75,144
"1065","02816","2020",4,4,0,145500,1583.25,93.25
"1066","02817","2020",2,2,0,291150,1450,209
"1067","02818","2020",12,12,0,151000,1760.08333333333,90.3333333333333
"1068","02819","2020",1,1,0,125000,1025,122
"1069","02820","2020",22,22,0,119219.636363636,1374.18181818182,85.1818181818182
"1070","02821","2020",6,6,0,137591.666666667,1375.83333333333,105.833333333333
"1071","02822","2020",8,8,0,179500,1543.75,119.875
"1072","02824","2020",2,2,0,183000,1817.5,100.5
"1073","02826","2020",2,2,0,93750,982.5,96
"1074","02827","2020",5,5,0,108800,829.8,132.6
"1075","02829","2020",1,1,0,2e+05,1667,120
"1076","02830","2020",8,8,0,65562.5,747,92.625
"1077","02831","2020",3,3,0,159706.666666667,1092.33333333333,154.666666666667
"1078","02832","2020",1,1,0,68000,607,112
"1079","02833","2020",6,6,0,79061.6666666667,845.5,99.1666666666667
"1080","02834","2020",1,1,0,220000,1089,202
"1081","03001","2020",46,44,2,145857.456521739,1352.41304347826,103.630434782609
"1082","03002","2020",2,2,0,122698,876.5,144.5
"1083","03003","2020",10,10,0,72295,738.7,92.4
"1084","03004","2020",2,2,0,164250,1664.5,117.5
"1085","03005","2020",6,6,0,51608.3333333333,930.833333333333,56.3333333333333
"1086","03006","2020",11,11,0,73354.5454545455,829.454545454545,88.7272727272727
"1087","03007","2020",6,6,0,52658.3333333333,589,90.6666666666667
"1088","03008","2020",9,9,0,97376.6666666667,902.555555555556,113.333333333333
"1089","03009","2020",1,1,0,1e+05,1136,88
"1090","03010","2020",4,4,0,90785,873,101
"1091","03011","2020",1,1,0,65000,915,71
"1092","03012","2020",4,4,0,129487.5,1146,144.5
"1093","03013","2020",40,39,1,123529.625,1485.2,86.85
"1094","03014","2020",5,5,0,86520,888.8,89.6
"1095","03015","2020",3,3,0,97000,1151,84.6666666666667
"1096","03017","2020",3,3,0,152133.333333333,1470,107
"1097","03018","2020",8,8,0,101446.25,1050,92.75
"1098","03019","2020",15,15,0,79979.3333333333,793.8,97
"1099","03020","2020",3,3,0,71833.3333333333,1206,60.3333333333333
"1100","03021","2020",2,2,0,137465,1194.5,116.5
"1101","03022","2020",21,21,0,114862.380952381,1044.80952380952,103.333333333333
"1102","03023","2020",138,105,33,158054.876811594,1607.26811594203,97.1159420289855
"1103","03024","2020",5,5,0,83530,989.8,84.4
"1104","03025","2020",17,17,0,101176.470588235,1040.52941176471,97.0588235294118
"1105","03026","2020",11,11,0,172294.545454545,1544.27272727273,117.636363636364
"1106","03027","2020",16,16,0,61651.875,703,89.3125
"1107","03028","2020",2,2,0,139500,1279,107.5
"1108","03029","2020",17,17,0,88690.8823529412,915.588235294118,98.7058823529412
"1109","03030","2020",6,6,0,100088.333333333,908.833333333333,106
"1110","03031","2020",1,0,1,44500,445,100
"1111","03032","2020",3,3,0,142000,1255.66666666667,122
"1112","03033","2020",4,4,0,163262.5,1445.75,121.5
"1113","03034","2020",8,8,0,94787.5,1065.75,87.375
"1114","03035","2020",1,1,0,58000,1074,54
"1115","03036","2020",34,33,1,124341.764705882,1297.52941176471,96.4117647058823
"1116","03037","2020",9,9,0,94221.6666666667,884.444444444444,97.2222222222222
"1117","03038","2020",6,6,0,87850,1022.66666666667,78.5
"1118","03039","2020",7,7,0,95400,1080.57142857143,85.4285714285714
"1119","03040","2020",9,9,0,145922.222222222,1287,114.111111111111
"1120","03041","2020",7,7,0,84740,1081.57142857143,81.4285714285714
"1121","03042","2020",9,9,0,68814.4444444444,862.444444444444,86
"1122","03043","2020",14,14,0,141517.857142857,1371.92857142857,104.142857142857
"1123","03044","2020",13,13,0,177536.153846154,1402.23076923077,120.307692307692
"1124","03045","2020",10,10,0,128216,1228.1,108.1
"1125","03046","2020",14,14,0,75039.2857142857,958.857142857143,77.2142857142857
"1126","03047","2020",6,5,1,99777.5,1023.66666666667,99
"1127","03048","2020",20,20,0,97300,989.3,107.95
"1128","03049","2020",8,8,0,171287.5,1334.875,114.25
"1129","03050","2020",2,2,0,38779,771,62.5
"1130","03051","2020",4,4,0,55750,745.75,77.5
"1131","03052","2020",12,12,0,104329.166666667,1100.75,93.3333333333333
"1132","03053","2020",18,17,1,118772.222222222,1057.5,102.833333333333
"1133","03054","2020",4,4,0,93755.75,1121.75,85
"1134","03055","2020",11,11,0,72227.2727272727,719.090909090909,101
"1135","03056","2020",9,9,0,117163.888888889,1530.55555555556,85.8888888888889
"1136","03058","2020",4,4,0,104875,963,106.25
"1137","03059","2020",5,5,0,92100,1111.4,79.8
"1138","03060","2020",15,15,0,157816.666666667,1468.73333333333,109.333333333333
"1139","03061","2020",6,6,0,189720,1756.33333333333,106.5
"1140","03062","2020",6,6,0,111241.666666667,1367.16666666667,84.8333333333333
"1141","03063","2020",6,6,0,116351.666666667,1085.5,117.333333333333
"1142","03064","2020",1,1,0,150000,1364,110
"1143","03065","2020",6,6,0,128883.333333333,922.5,131.5
"1144","03066","2020",10,10,0,86646,754.6,114
"1145","03068","2020",3,3,0,149740,1451,101.333333333333
"1146","03069","2020",2,2,0,76500,694,111
"1147","03070","2020",2,2,0,226980,1186.5,230
"1148","03071","2020",5,5,0,116464,1365.2,121.8
"1149","03072","2020",6,6,0,128933.333333333,1138.66666666667,107.666666666667
"1150","03073","2020",5,5,0,144100,1476.4,98.8
"1151","03074","2020",7,7,0,170142.857142857,1464.42857142857,109.142857142857
"1152","03077","2020",2,2,0,111000,1201,102.5
"1153","03078","2020",8,8,0,107756.25,968.5,111.75
"1154","03079","2020",8,8,0,115157.875,1171.125,123.5
"1155","03080","2020",5,5,0,175200,1295.2,138.8
"1156","03081","2020",6,6,0,116891.666666667,1141.83333333333,123.5
"1157","03082","2020",51,48,3,82953.0392156863,909.745098039216,91.9411764705882
"1158","03083","2020",7,7,0,92050,987.142857142857,98.7142857142857
"1159","03084","2020",18,18,0,99055.5555555556,1041.33333333333,94.1111111111111
"1160","03085","2020",10,10,0,160509.9,1335.1,136.3
"1161","03086","2020",5,5,0,61400,692.6,87.4
"1162","03087","2020",15,15,0,86706.6666666667,985.133333333333,94.5333333333333
"1163","03088","2020",2,2,0,70000,763.5,98
"1164","03089","2020",3,3,0,83333.3333333333,907.333333333333,101
"1165","03090","2020",5,5,0,107960,902,118
"1166","03091","2020",5,5,0,107700,1108,92.4
"1167","03092","2020",6,6,0,96223.3333333333,1096.83333333333,98.1666666666667
"1168","03093","2020",22,22,0,168591.227272727,1401.86363636364,120.681818181818
"1169","03094","2020",46,40,6,169238,1530.78260869565,109.152173913043
"1170","03095","2020",217,141,76,106146.225806452,1258.94470046083,85.3548387096774
"1171","03097","2020",5,5,0,91296,844.4,106.2
"1172","03098","2020",47,45,2,90980.8510638298,1140.97872340426,79.3829787234042
"1173","03099","2020",8,8,0,67131.25,719.125,91.125
"1174","03100","2020",13,13,0,71738.4615384615,872.384615384615,77.9230769230769
"1175","03101","2020",93,88,5,108249.47311828,1232.09677419355,87.1075268817204
"1176","03102","2020",32,32,0,121289.53125,1149.5,103.75
"1177","03103","2020",15,14,1,73646.6666666667,853.2,84.9333333333333
"1178","03104","2020",10,10,0,85148,813.9,107
"1179","03105","2020",4,4,0,64750,1023.25,70
"1180","03106","2020",15,15,0,71966.6666666667,742.333333333333,99.4666666666667
"1181","03107","2020",20,20,0,146268,1148.05,122.4
"1182","03108","2020",5,5,0,83250,912,90.2
"1183","03109","2020",11,11,0,148342.272727273,1178.63636363636,124.272727272727
"1184","03110","2020",10,10,0,149290,1422.1,104.7
"1185","03111","2020",15,15,0,143774,1187.6,117.4
"1186","03112","2020",10,10,0,70520,833.4,83.6
"1187","03113","2020",7,7,0,57857.1428571429,656,98.5714285714286
"1188","03114","2020",4,4,0,136087.5,1315,103.75
"1189","03115","2020",2,2,0,110000,1010.5,114
"1190","03116","2020",5,5,0,102246,1011,115.2
"1191","03117","2020",3,3,0,67400,723.333333333333,94.6666666666667
"1192","03118","2020",68,63,5,124457.867647059,1238.97058823529,95.6323529411765
"1193","03119","2020",5,5,0,84940,1029.2,86
"1194","03120","2020",3,3,0,88666.6666666667,794.666666666667,85.6666666666667
"1195","03121","2020",4,4,0,161312.5,1495,106
"1196","03122","2020",3,3,0,109500,1011,92.3333333333333
"1197","03124","2020",3,3,0,185443.333333333,1707.66666666667,115.333333333333
"1198","03125","2020",5,5,0,100700,1049,103.2
"1199","03126","2020",24,19,5,125539.791666667,1291.83333333333,100.583333333333
"1200","03127","2020",13,13,0,68153.0769230769,751.846153846154,91.2307692307692
"1201","03128","2020",32,31,1,97981.34375,982.53125,97.4375
"1202","03129","2020",5,5,0,83684.6,1102.2,86.4
"1203","03130","2020",5,5,0,63500,820.6,85.4
"1204","03131","2020",5,5,0,94836,1100.8,85.4
"1205","03132","2020",7,7,0,104928.571428571,911.142857142857,115.571428571429
"1206","03133","2020",7,7,0,92647.4285714286,1005.71428571429,95.7142857142857
"1207","03134","2020",4,4,0,118000,1207.5,97.25
"1208","03135","2020",9,9,0,57465.6666666667,777.555555555556,80.3333333333333
"1209","03136","2020",2,2,0,89000,703.5,112.5
"1210","03137","2020",3,3,0,108833.333333333,830.666666666667,138.333333333333
"1211","03138","2020",35,34,1,87211,883.571428571429,104.6
"1212","03139","2020",6,6,0,88333.3333333333,959,89.6666666666667
"1213","03140","2020",7,7,0,111571.428571429,1170.14285714286,97.4285714285714
"1214","03141","2020",2,2,0,147550,1532,82
"1215","03142","2020",1,1,0,55870,1242,45
"1216","03143","2020",1,1,0,118650,1582,75
"1217","03144","2020",4,4,0,62500,763.25,88.25
"1218","03145","2020",1,1,0,38000,567,67
"1219","03146","2020",1,1,0,120000,882,136
"1220","03147","2020",2,2,0,172900,1797,96.5
"1221","03148","2020",7,7,0,107448.571428571,1165,93.8571428571429
"1222","03149","2020",4,4,0,113112.5,1029.75,107.5
"1223","03150","2020",4,4,0,121487.5,844.75,131
"1224","03151","2020",5,5,0,84090,1026.4,84.6
"1225","03152","2020",5,5,0,80980,757.8,102.4
"1226","03154","2020",4,4,0,123525,1239,93.25
"1227","03155","2020",27,27,0,83165.8888888889,829.222222222222,97.2962962962963
"1228","03156","2020",21,21,0,130938.095238095,1390.85714285714,92.5714285714286
"1229","03157","2020",11,11,0,121764.545454545,1270.54545454545,95.2727272727273
"1230","03158","2020",6,6,0,63666.6666666667,831.833333333333,76.5
"1231","03159","2020",7,7,0,133765.714285714,937.142857142857,141.428571428571
"1232","03160","2020",6,6,0,97766.6666666667,1086.66666666667,99
"1233","03161","2020",11,11,0,71590.9090909091,732.818181818182,94
"1234","03162","2020",4,4,0,56065,821.25,61.5
"1235","03163","2020",9,8,1,152103.333333333,1327.77777777778,123
"1236","03164","2020",5,5,0,81820,1040,78
"1237","03165","2020",15,15,0,66453.3333333333,751.8,90.8
"1238","03166","2020",2,2,0,56500,809,67
"1239","03167","2020",6,6,0,90000,924.666666666667,96.6666666666667
"1240","03168","2020",8,8,0,94100,890.25,95.75
"1241","03169","2020",3,3,0,144666.666666667,1663.33333333333,81.6666666666667
"1242","03170","2020",1,1,0,2e+05,935,214
"1243","03171","2020",4,4,0,138810,1031.25,127.5
"1244","03173","2020",9,9,0,100977.777777778,1038.77777777778,97.7777777777778
"1245","03174","2020",8,8,0,115453.75,1220,96.375
"1246","03175","2020",5,5,0,120160,1050.4,108.4
"1247","03176","2020",6,6,0,113266.666666667,1139.5,99.3333333333333
"1248","03177","2020",7,7,0,76785.7142857143,889.714285714286,94.5714285714286
"1249","03179","2020",5,5,0,107910,1018.6,106.2
"1250","03180","2020",4,4,0,90192.5,1243.75,65.5
"1251","03181","2020",3,3,0,66333.3333333333,605.333333333333,114.333333333333
"1252","03182","2020",3,3,0,165333.333333333,1297.66666666667,131
"1253","03183","2020",3,3,0,91000,1028,105
"1254","03184","2020",4,4,0,126250,1163.75,111.25
"1255","03185","2020",507,277,230,77886.0098619329,957.205128205128,79.6055226824458
"1256","03186","2020",11,11,0,86618.1818181818,782.636363636364,109.727272727273
"1257","03187","2020",5,5,0,93700,920.4,93.4
"1258","03188","2020",2,2,0,106750,1200,96.5
"1259","03189","2020",11,11,0,85863.6363636364,1101.81818181818,89.4545454545455
"1260","03190","2020",220,85,135,100736.263636364,1366.17272727273,77.0818181818182
"1261","03191","2020",6,6,0,79137.5,943.666666666667,82.8333333333333
"1262","03192","2020",1,1,0,34000,708,48
"1263","03193","2020",3,3,0,146166.666666667,1231,127.666666666667
"1264","03194","2020",2,2,0,115500,909,129.5
"1265","03195","2020",55,43,12,118221.527272727,1197.61818181818,102.272727272727
"1266","03196","2020",1,1,0,70000,897,78
"1267","03197","2020",18,18,0,124922.222222222,1132.88888888889,110.333333333333
"1268","03198","2020",6,6,0,88000,974.333333333333,94.1666666666667
"1269","03200","2020",16,16,0,162968.625,1568.375,105.6875
"1270","03202","2020",9,9,0,81166.6666666667,1023.88888888889,82.6666666666667
"1271","03203","2020",3,3,0,89533.3333333333,830.333333333333,109.666666666667
"1272","03204","2020",15,15,0,94952,1093.4,90.2
"1273","03205","2020",5,5,0,85570,872.6,93.4
"1274","03206","2020",2,2,0,68500,909.5,68
"1275","03207","2020",4,4,0,82187.5,721.25,112.25
"1276","03208","2020",4,4,0,94787.5,1035.5,100
"1277","03209","2020",3,3,0,153603.333333333,1505.66666666667,102
"1278","03210","2020",10,10,0,64560,766.8,85.7
"1279","03211","2020",16,15,1,134468.75,1637.625,82.8125
"1280","03212","2020",13,12,1,151730.769230769,1493.76923076923,93.3846153846154
"1281","03213","2020",3,3,0,112600,1186,91
"1282","03215","2020",8,8,0,96175,840,115.375
"1283","03216","2020",1,1,0,130000,722,180
"1284","03217","2020",3,3,0,103250,1219.33333333333,82
"1285","03218","2020",2,2,0,54200,896,56.5
"1286","03219","2020",2,2,0,105400,1047.5,97.5
"1287","03220","2020",10,10,0,126205,1051.4,121.8
"1288","03221","2020",8,8,0,98500,1043,90.125
"1289","03223","2020",3,3,0,52900,650.333333333333,77
"1290","03224","2020",3,3,0,112666.666666667,765.333333333333,168.333333333333
"1291","03225","2020",5,5,0,79950,600.6,133
"1292","03226","2020",4,4,0,99175,670.5,137.75
"1293","03227","2020",8,8,0,132875,1507.375,93.25
"1294","03229","2020",7,7,0,107799.142857143,1122.14285714286,103.571428571429
"1295","03230","2020",5,5,0,114700,1251.2,90
"1296","03231","2020",4,4,0,64250,784.5,81.25
"1297","03232","2020",3,3,0,127130,1265,97.6666666666667
"1298","03233","2020",6,6,0,107916.666666667,1103.83333333333,89.8333333333333
"1299","03234","2020",4,3,1,123075,1089.75,103.75
"1300","03235","2020",15,15,0,87372.6666666667,806.4,105.333333333333
"1301","03236","2020",43,42,1,101010.906976744,1191.16279069767,85.2093023255814
"1302","03237","2020",8,8,0,90549.875,911.375,92.25
"1303","03238","2020",5,5,0,76140,794,96
"1304","03239","2020",4,4,0,191455,1343.75,141.5
"1305","03240","2020",4,4,0,43125,793.25,56.25
"1306","03241","2020",7,7,0,226179.285714286,1431.42857142857,143.714285714286
"1307","03242","2020",9,9,0,119535.555555556,1071.22222222222,114.222222222222
"1308","03243","2020",1,1,0,45500,361,126
"1309","03244","2020",1,1,0,16500,375,44
"1310","03245","2020",1,1,0,885600,8355,106
"1311","03246","2020",3,3,0,73333.3333333333,583,105.333333333333
"1312","03247","2020",15,15,0,86524.6666666667,919.6,98.7333333333333
"1313","03248","2020",10,10,0,116585,1419.3,96.8
"1314","03249","2020",10,10,0,43723.5,643.2,71.1
"1315","03250","2020",6,5,1,105633.333333333,1045.66666666667,91.1666666666667
"1316","03251","2020",11,11,0,100818.181818182,1648,97.8181818181818
"1317","03252","2020",5,5,0,216490,1269,172.6
"1318","03253","2020",6,6,0,138243.333333333,1561.33333333333,89.5
"1319","03254","2020",59,53,6,109322.711864407,1166.98305084746,99.1694915254237
"1320","03255","2020",4,4,0,169667.5,1220.25,150.5
"1321","03256","2020",2,2,0,98875,894.5,105
"1322","03257","2020",9,7,2,103548,1112,89.8888888888889
"1323","03258","2020",34,34,0,174033.411764706,1792.23529411765,104.676470588235
"1324","03259","2020",10,10,0,83810.5,1113.7,87.1
"1325","03260","2020",3,3,0,68750,934,74
"1326","03261","2020",3,3,0,79416.6666666667,682.333333333333,116.333333333333
"1327","03262","2020",17,15,2,161625.529411765,1787.29411764706,94.7058823529412
"1328","03264","2020",52,49,3,107998.019230769,1257.69230769231,88.2884615384615
"1329","03265","2020",13,13,0,108173.076923077,1107.69230769231,104.538461538462
"1330","03266","2020",2,2,0,300752.5,2251.5,154
"1331","03267","2020",12,12,0,121741.666666667,1170.75,99.5833333333333
"1332","03268","2020",1,1,0,219455,1322,166
"1333","03270","2020",1,1,0,53500,357,150
"1334","03271","2020",9,9,0,129177.777777778,1158,108.222222222222
"1335","03272","2020",5,5,0,103275,1070.8,100
"1336","03273","2020",6,6,0,127325,1311.33333333333,100.166666666667
"1337","03274","2020",3,3,0,130000,1272.66666666667,79.3333333333333
"1338","03275","2020",19,17,2,87697.3684210526,852.631578947368,100.105263157895
"1339","03277","2020",5,5,0,92100,1044.6,89.8
"1340","03278","2020",1,1,0,169000,1374,123
"1341","03279","2020",5,5,0,70624,823.8,82.6
"1342","03280","2020",3,3,0,106666.666666667,1154.66666666667,98.3333333333333
"1343","03281","2020",5,5,0,69400,731,88
"1344","03282","2020",8,8,0,92850,1117.125,72.75
"1345","03283","2020",12,12,0,107333.333333333,1134.66666666667,91.0833333333333
"1346","03284","2020",5,5,0,110860,1093.4,106.8
"1347","03285","2020",3,3,0,238800,2403.66666666667,100
"1348","03286","2020",10,10,0,154580,1584.5,95.8
"1349","03287","2020",9,9,0,107700,913.111111111111,112.111111111111
"1350","03288","2020",5,5,0,91600,1055.2,90.8
"1351","03289","2020",12,12,0,83886.5,1013.66666666667,79.5833333333333
"1352","03290","2020",17,17,0,144140.294117647,1383.17647058824,102.764705882353
"1353","03291","2020",3,3,0,133333.333333333,767.333333333333,182.333333333333
"1354","03292","2020",6,6,0,92133.3333333333,764.666666666667,114
"1355","03293","2020",7,7,0,72582.8571428571,783.285714285714,90.2857142857143
"1356","03294","2020",8,8,0,93970.625,1001.625,93.375
"1357","03295","2020",1,1,0,35000,389,90
"1358","03296","2020",10,10,0,65940,724.8,95.4
"1359","03297","2020",23,22,1,99734.1304347826,1147.21739130435,89.1304347826087
"1360","03298","2020",49,34,15,83413.7755102041,1020.75510204082,82.1224489795918
"1361","03299","2020",4,4,0,60000,611,98.25
"1362","03300","2020",3,3,0,67333.3333333333,696.666666666667,98
"1363","03301","2020",11,10,1,106443.636363636,1104.90909090909,95.8181818181818
"1364","03302","2020",2,2,0,46250,492.5,89
"1365","03303","2020",3,3,0,370333.333333333,2907,108
"1366","03304","2020",37,37,0,168129.189189189,1482.67567567568,115.189189189189
"1367","03305","2020",9,9,0,146556.666666667,1414.11111111111,106.444444444444
"1368","03306","2020",18,18,0,174707.777777778,1617.77777777778,111.666666666667
"1369","03307","2020",2,2,0,138000,1500.5,94
"1370","03309","2020",7,7,0,83214.2857142857,849.857142857143,95.7142857142857
"1371","03310","2020",812,185,627,111999.464285714,1465.6736453202,72.9913793103448
"1372","03311","2020",2,2,0,86375,861.5,103
"1373","03312","2020",6,6,0,72027.1666666667,1097.66666666667,87.8333333333333
"1374","03313","2020",3,3,0,71133.3333333333,844.333333333333,76.3333333333333
"1375","03314","2020",16,16,0,145268.125,1356.5,104.0625
"1376","03315","2020",13,13,0,68924.7692307692,775.692307692308,93.6923076923077
"1377","03316","2020",16,16,0,114635.4375,1291.75,90.1875
"1378","03317","2020",6,6,0,65407.1666666667,633.166666666667,105.166666666667
"1379","03319","2020",5,5,0,84538,892.2,96.6
"1380","03320","2020",17,17,0,89635.2941176471,800.235294117647,113.058823529412
"1381","03321","2020",164,131,33,115554.268292683,1396.70731707317,82.6158536585366
"1382","04001","2020",7,5,2,198500,1628.85714285714,128.142857142857
"1383","04004","2020",10,10,0,138225,1729.9,81
"1384","04005","2020",5,5,0,75570,1048,71
"1385","04006","2020",197,17,180,72996.9340101523,2169.06091370558,31.6446700507614
"1386","04007","2020",1,1,0,45000,900,50
"1387","04008","2020",16,13,3,142943.75,2248.875,68
"1388","04009","2020",1,1,0,364200,3035,120
"1389","04012","2020",2,2,0,256000,3708,76
"1390","04013","2020",5,5,0,155426,1731.2,96
"1391","04016","2020",1,1,0,47000,712,66
"1392","04017","2020",3,1,2,46166.6666666667,1009,50.6666666666667
"1393","04018","2020",14,11,3,189791.428571429,2339.85714285714,94.2857142857143
"1394","04019","2020",89,18,71,112066.831460674,2128.04494382022,51.9887640449438
"1395","04021","2020",1,1,0,255000,2833,90
"1396","04022","2020",4,2,2,61125,878.5,67.25
"1397","04023","2020",3,3,0,76153.3333333333,1140,69.3333333333333
"1398","04024","2020",1,1,0,75000,1471,51
"1399","04025","2020",19,15,4,157241.052631579,2013.15789473684,75.2631578947368
"1400","04026","2020",2,2,0,186865,1660.5,112
"1401","04027","2020",4,4,0,286962.5,2431.75,123
"1402","04028","2020",1,1,0,375000,2206,170
"1403","04030","2020",1,1,0,197000,2432,81
"1404","04031","2020",9,9,0,185521.111111111,2263.55555555556,90.5555555555556
"1405","04032","2020",1,1,0,220000,3333,66
"1406","04033","2020",4,4,0,271972.5,2950.25,88
"1407","04034","2020",11,11,0,236594.636363636,2202.18181818182,109.818181818182
"1408","04035","2020",4,2,2,132625,1593.5,89.75
"1409","04036","2020",7,6,1,178892.857142857,1713.85714285714,102.428571428571
"1410","04039","2020",24,19,5,170516.666666667,2353.75,78.875
"1411","04040","2020",1,1,0,199000,2488,80
"1412","04041","2020",5,5,0,116080,1514.6,84.6
"1413","04042","2020",3,3,0,175689.666666667,1951,106
"1414","04043","2020",6,5,1,245516.666666667,2435.16666666667,99.5
"1415","04045","2020",32,30,2,197736.3125,2458.15625,81.21875
"1416","04046","2020",1,1,0,105000,1842,57
"1417","04047","2020",8,8,0,201250,1759.375,112.25
"1418","04049","2020",56,27,29,145516.714285714,1850.64285714286,79.1964285714286
"1419","04051","2020",2,2,0,157275,1216,148.5
"1420","04053","2020",4,4,0,232920,2298,102
"1421","04055","2020",5,4,1,149400,1468,101.2
"1422","04057","2020",4,4,0,156036.25,1748.5,87.25
"1423","04058","2020",2,2,0,274400,2820,105
"1424","04059","2020",4,4,0,145610.5,1956.25,72.75
"1425","04061","2020",23,15,8,115118,1609.69565217391,69.8695652173913
"1426","04062","2020",7,3,4,82721.4285714286,1122.71428571429,70.4285714285714
"1427","04063","2020",14,13,1,206727.285714286,2253.57142857143,90.8571428571429
"1428","04065","2020",9,9,0,140172.222222222,1720.88888888889,81.3333333333333
"1429","04066","2020",4,4,0,217875,2353.75,84.5
"1430","04067","2020",2,2,0,167500,1654,101.5
"1431","04068","2020",8,8,0,253131.25,2692.875,92.625
"1432","04069","2020",1,0,1,35000,875,40
"1433","04070","2020",208,76,132,125402.4375,1737.42307692308,71.4567307692308
"1434","04073","2020",69,9,60,86933,2083.13043478261,39.5507246376812
"1435","04074","2020",2,1,1,122500,1701,69.5
"1436","04075","2020",4,4,0,254962.5,2263.75,115
"1437","04076","2020",11,7,4,116415.909090909,1870.45454545455,59.4545454545455
"1438","04077","2020",1,1,0,220350,2476,89
"1439","04079","2020",16,14,2,154125,1817.625,84.625
"1440","04081","2020",13,13,0,273343.076923077,2727.46153846154,95.3846153846154
"1441","04084","2020",8,8,0,147140.125,1786.375,87.75
"1442","04086","2020",7,2,5,162885.714285714,1992.42857142857,77.8571428571429
"1443","04087","2020",3,3,0,117666.666666667,2341.33333333333,50.3333333333333
"1444","04088","2020",66,43,23,214087.939393939,2510.89393939394,84.3787878787879
"1445","04090","2020",1,1,0,51000,1500,34
"1446","04091","2020",1,1,0,72500,1036,70
"1447","04092","2020",2,2,0,67000,822.5,86.5
"1448","04093","2020",1,1,0,241270,1508,160
"1449","04094","2020",138,41,97,151720.949275362,2901.00724637681,53.9202898550725
"1450","04095","2020",2,2,0,212050,2021.5,110
"1451","04096","2020",36,13,23,97487.3611111111,1768.77777777778,56.4722222222222
"1452","04097","2020",2,2,0,158500,1396,114
"1453","04099","2020",1,0,1,47300,2365,20
"1454","04101","2020",1,1,0,107000,1115,96
"1455","04102","2020",3,2,1,74083.3333333333,1946.33333333333,35
"1456","04104","2020",3,3,0,305626.666666667,2787,104.666666666667
"1457","04106","2020",8,4,4,196450,1897.75,106.875
"1458","04108","2020",21,16,5,177788.095238095,2158.85714285714,83.1904761904762
"1459","04109","2020",4,4,0,169032.5,2313,73.5
"1460","04110","2020",14,14,0,215171.428571429,2177.85714285714,100.071428571429
"1461","04111","2020",6,6,0,216641.666666667,2118,99.1666666666667
"1462","04112","2020",296,121,175,161024.422297297,2046.89864864865,77.7871621621622
"1463","04113","2020",2,2,0,165250,2040.5,77.5
"1464","04115","2020",3,3,0,121333.333333333,1547.33333333333,73
"1465","04116","2020",40,31,9,167719.625,1752.675,94.525
"1466","04118","2020",1,1,0,418970,5739,73
"1467","04120","2020",2,2,0,59875,656,87
"1468","04121","2020",10,8,2,169140,1868.3,94
"1469","04122","2020",8,8,0,210936.25,2071,98.5
"1470","04123","2020",6,6,0,225891.666666667,2166.66666666667,105.333333333333
"1471","04124","2020",10,10,0,127204,1993.2,68.4
"1472","04126","2020",35,10,25,102457.914285714,2065.85714285714,49.7142857142857
"1473","04127","2020",1,1,0,499000,1883,265
"1474","04128","2020",2,2,0,205000,2919,84
"1475","04129","2020",1,1,0,471000,3463,136
"1476","04130","2020",1,1,0,150000,1786,84
"1477","04132","2020",1,1,0,48000,511,94
"1478","04133","2020",1,1,0,115200,1097,105
"1479","04134","2020",4,4,0,145720,1772.25,109.75
"1480","04135","2020",6,6,0,143000,2537,59.1666666666667
"1481","04136","2020",4,4,0,72875,1362.75,58
"1482","04137","2020",1,1,0,150000,1500,100
"1483","04138","2020",10,10,0,235850,2074,110
"1484","04139","2020",4,3,1,135375,1475.75,88.5
"1485","04140","2020",1,1,0,250000,2809,89
"1486","04141","2020",6,6,0,210306.666666667,2380.83333333333,86.5
"1487","04142","2020",2,2,0,274000,1995.5,132.5
"1488","04143","2020",79,56,23,180195.17721519,2240.18987341772,79.6962025316456
"1489","04144","2020",1,1,0,430000,4300,100
"1490","04145","2020",18,16,2,177247.222222222,1954.61111111111,92.8888888888889
"1491","04148","2020",7,7,0,181285.714285714,2076.71428571429,89.2857142857143
"1492","04149","2020",31,29,2,172348.064516129,2010.83870967742,82.8709677419355
"1493","04151","2020",7,7,0,242454.285714286,2842,82
"1494","04152","2020",54,48,6,304303.907407407,2677.40740740741,113.259259259259
"1495","04154","2020",1,1,0,2e+05,5556,36
"1496","04155","2020",6,6,0,72156.6666666667,880.833333333333,77
"1497","04156","2020",5,4,1,147292,1631.8,77
"1498","04157","2020",8,7,1,159066.5,2221.125,90.5
"1499","04158","2020",11,10,1,241031.363636364,3702.81818181818,72
"1500","04159","2020",2,2,0,332500,3380,87.5
"1501","04160","2020",25,22,3,268228.4,2572.96,96.96
"1502","04161","2020",9,8,1,154956.666666667,2472.44444444444,83.8888888888889
"1503","04162","2020",6,5,1,181166.666666667,1965.66666666667,102.5
"1504","04163","2020",12,11,1,126091.666666667,1613.33333333333,93.5
"1505","04164","2020",1,0,1,100400,1894,53
"1506","04166","2020",29,24,5,247951.379310345,1995.13793103448,111.793103448276
"1507","04167","2020",1,1,0,135000,1500,90
"1508","04169","2020",2,2,0,175230,1460.5,130.5
"1509","04170","2020",1,0,1,25000,379,66
"1510","04171","2020",1,1,0,150000,2830,53
"1511","04172","2020",9,9,0,203473.333333333,1905.88888888889,108.666666666667
"1512","04173","2020",15,9,6,142432.066666667,1594.06666666667,88.8
"1513","04174","2020",5,5,0,83700,1070.8,74.8
"1514","04175","2020",1,1,0,411495,2212,186
"1515","04176","2020",6,5,1,250406.666666667,2949.83333333333,85.8333333333333
"1516","04178","2020",15,12,3,171626.666666667,2236.26666666667,79.0666666666667
"1517","04179","2020",3,3,0,146666.666666667,2251.66666666667,65
"1518","04182","2020",5,4,1,198436,2243.2,83.4
"1519","04183","2020",2,2,0,252500,2411,116.5
"1520","04184","2020",5,4,1,176922.6,2476.2,77.6
"1521","04186","2020",1,0,1,145000,2589,56
"1522","04187","2020",7,7,0,116850.714285714,1505.14285714286,76.4285714285714
"1523","04188","2020",7,7,0,184424.285714286,2193,95
"1524","04189","2020",20,19,1,124647,2336.9,58.95
"1525","04190","2020",1,1,0,211301,2032,104
"1526","04192","2020",14,12,2,262786.428571429,3089.71428571429,102.785714285714
"1527","04193","2020",4,4,0,92537.5,1203.25,77.75
"1528","04194","2020",2,2,0,110000,1733.5,64
"1529","04195","2020",12,8,4,204825,2086.5,106.666666666667
"1530","04197","2020",44,32,12,180422.5,2221.86363636364,80.3863636363636
"1531","04199","2020",2,2,0,97500,1210,77.5
"1532","04200","2020",4,3,1,174750,1939.5,86
"1533","04201","2020",3,3,0,133333.333333333,2501.66666666667,53.3333333333333
"1534","04202","2020",3,1,2,148666.666666667,1850.66666666667,72.6666666666667
"1535","04203","2020",28,12,16,103760.535714286,1988.03571428571,51.2857142857143
"1536","04204","2020",3,3,0,116333.333333333,1459,84.6666666666667
"1537","04205","2020",42,22,20,101947.785714286,1535.71428571429,66.9523809523809
"1538","04206","2020",10,10,0,234185,2342,92.8
"1539","04207","2020",2,2,0,427500,2756.5,138.5
"1540","04208","2020",14,14,0,199257.928571429,2509.14285714286,85
"1541","04209","2020",94,48,46,141784.35106383,1868.26595744681,74.5
"1542","04210","2020",4,4,0,108467.5,1334.5,75.75
"1543","04211","2020",1,1,0,65000,1625,40
"1544","04214","2020",1,1,0,1e+05,1282,78
"1545","04216","2020",3,3,0,94166.6666666667,978.333333333333,97.3333333333333
"1546","04217","2020",6,4,2,64036.6666666667,1273.66666666667,47.3333333333333
"1547","04218","2020",9,7,2,109318.888888889,1516,65
"1548","04219","2020",6,5,1,65350,1410.83333333333,50.3333333333333
"1549","04220","2020",4,3,1,139650,1561.25,99.5
"1550","04222","2020",3,3,0,98500,1938.66666666667,49.6666666666667
"1551","04224","2020",2,2,0,52000,1091,55
"1552","04226","2020",120,9,111,91706.4666666667,2336.64166666667,36.7583333333333
"1553","04227","2020",8,8,0,187733.75,2051.5,95.125
"1554","04228","2020",1,1,0,40000,816,49
"1555","04229","2020",5,5,0,149170,1547,93.6
"1556","04230","2020",38,34,4,158981.315789474,1915.5,86.0789473684211
"1557","04233","2020",1,1,0,182601,1602,114
"1558","04234","2020",5,5,0,183706,2204.4,82.8
"1559","04236","2020",3,2,1,94833.3333333333,1561.66666666667,50.3333333333333
"1560","04237","2020",4,1,3,78300,1397.25,55.75
"1561","04240","2020",12,10,2,95456.9166666667,1461.91666666667,65.5
"1562","04241","2020",4,4,0,317801.25,2271,124
"1563","04242","2020",42,39,3,231394.976190476,2314.30952380952,102.928571428571
"1564","04244","2020",18,15,3,141129.055555556,1816.5,81.5
"1565","04245","2020",48,34,14,194591.208333333,2428.875,83.5208333333333
"1566","05001","2020",10,4,6,159633.1,2750,62.2
"1567","05003","2020",10,1,9,58371,1354.1,37.2
"1568","05004","2020",54,11,43,114020.833333333,2314.5,48.4074074074074
"1569","05006","2020",25,14,11,190200.08,2087.64,95.16
"1570","05007","2020",11,6,5,147820.909090909,2037.54545454545,79.2727272727273
"1571","05008","2020",5,5,0,159836.2,1732,92.2
"1572","05009","2020",1,1,0,155000,2385,65
"1573","05010","2020",12,12,0,110615.833333333,1178.58333333333,94.1666666666667
"1574","05011","2020",2,2,0,239000,2423,101.5
"1575","05012","2020",10,4,6,208917,2977,70
"1576","05013","2020",2,2,0,227560,1851,130.5
"1577","05014","2020",2,2,0,244070,1777.5,130.5
"1578","05016","2020",2,2,0,176975,2150,87
"1579","05017","2020",21,16,5,244844.285714286,2457,101
"1580","05018","2020",5,5,0,351427.8,2617.6,135.8
"1581","05019","2020",2,2,0,139050,1160,127
"1582","05021","2020",3,3,0,255000,1654.66666666667,182
"1583","05022","2020",1,1,0,170000,895,190
"1584","05023","2020",279,37,242,156060.577060932,2289.53046594982,65.8064516129032
"1585","05024","2020",4,4,0,136075,1498.75,90.5
"1586","05025","2020",2,2,0,208520,2244.5,93
"1587","05026","2020",7,2,5,180544.285714286,2975.71428571429,58.5714285714286
"1588","05027","2020",5,3,2,116996.6,1698.8,59.4
"1589","05029","2020",15,13,2,191995.333333333,2200.6,84
"1590","05031","2020",7,5,2,205289.285714286,2490.14285714286,84
"1591","05032","2020",2,2,0,172500,3896,88
"1592","05035","2020",1,1,0,155000,2039,76
"1593","05036","2020",13,10,3,265723.076923077,3009.46153846154,95.3076923076923
"1594","05037","2020",8,8,0,364417.5,2694.625,134.75
"1595","05038","2020",8,5,3,128562.5,1641.5,87.5
"1596","05039","2020",6,6,0,184566.666666667,1852.5,104
"1597","05040","2020",47,29,18,215119.978723404,2388.8085106383,91.0425531914894
"1598","05044","2020",6,4,2,165387.5,2175.33333333333,74
"1599","05045","2020",22,20,2,251940,2651.95454545455,100.409090909091
"1600","05046","2020",157,33,124,159914.229299363,2769.75796178344,59.9235668789809
"1601","05047","2020",5,5,0,91480,1418.2,68
"1602","05048","2020",1,1,0,82000,1262,65
"1603","05050","2020",4,4,0,125097.5,1208.75,102.25
"1604","05052","2020",6,6,0,232060,2976.83333333333,84
"1605","05053","2020",5,5,0,146200,1905.4,76
"1606","05054","2020",6,3,3,159220.833333333,1752.66666666667,101.833333333333
"1607","05055","2020",4,4,0,138562.5,1842.75,73.25
"1608","05056","2020",1,1,0,47500,490,97
"1609","05057","2020",3,3,0,274950,2713,102.333333333333
"1610","05058","2020",2,2,0,187382.5,1725.5,113.5
"1611","05059","2020",9,9,0,251007.777777778,2849.44444444444,91.1111111111111
"1612","05060","2020",2,2,0,235635,1903,137.5
"1613","05061","2020",607,147,460,169887.060955519,2194.55189456343,77.7479406919275
"1614","05062","2020",4,3,1,108850,1442.5,72.5
"1615","05063","2020",19,6,13,141279.842105263,2402.73684210526,64.4210526315789
"1616","05064","2020",2,1,1,149154.5,2036.5,72.5
"1617","05065","2020",47,13,34,152849.042553191,2356.93617021277,66.4255319148936
"1618","05068","2020",2,2,0,202500,2285.5,90
"1619","05070","2020",38,25,13,152004.684210526,1717.36842105263,91.6052631578947
"1620","05071","2020",2,2,0,268820,2360,117.5
"1621","05072","2020",13,5,8,111388.076923077,2419.30769230769,53.6923076923077
"1622","05073","2020",3,3,0,234666.666666667,2102,111.666666666667
"1623","05074","2020",1,1,0,285850,2343,122
"1624","05075","2020",9,9,0,177628.333333333,2998,59
"1625","05077","2020",12,0,12,80302.5833333333,2151.58333333333,40
"1626","05078","2020",3,3,0,193333.333333333,2212.33333333333,89.3333333333333
"1627","05079","2020",58,15,43,235500.586206897,3499.34482758621,63.4137931034483
"1628","05080","2020",1,1,0,76000,661,115
"1629","05082","2020",1,0,1,75000,1250,60
"1630","05084","2020",3,1,2,113693.333333333,2015.66666666667,55
"1631","05085","2020",38,4,34,217005,4039.39473684211,49
"1632","05086","2020",1,1,0,270350,1931,140
"1633","05087","2020",4,4,0,116650,1576,74.25
"1634","05089","2020",1,1,0,178600,1384,129
"1635","05090","2020",1,1,0,101000,1443,70
"1636","05092","2020",8,6,2,292612.625,2588.125,117.375
"1637","05093","2020",14,6,8,169458.214285714,2973.57142857143,55.3571428571429
"1638","05095","2020",7,3,4,117716.285714286,1223,99.2857142857143
"1639","05096","2020",137,13,124,83856.8905109489,1842.24087591241,45.6861313868613
"1640","05097","2020",6,6,0,155130,1436.5,99.8333333333333
"1641","05098","2020",95,4,91,83884.1052631579,2450.25263157895,35.2736842105263
"1642","05099","2020",3,3,0,162000,1470.33333333333,101.333333333333
"1643","05100","2020",9,7,2,206178.888888889,2013.66666666667,92.7777777777778
"1644","05101","2020",33,13,20,182906.818181818,2579.24242424242,69.8181818181818
"1645","05102","2020",4,4,0,132540,1438.75,92.75
"1646","05103","2020",12,10,2,175832.916666667,2057.58333333333,87.1666666666667
"1647","05104","2020",7,7,0,198042.857142857,2396.42857142857,86.5714285714286
"1648","05106","2020",6,4,2,174398.333333333,2469.33333333333,60.5
"1649","05107","2020",2,1,1,228195,1648.5,125
"1650","05109","2020",8,2,6,300973.75,2563.625,102.25
"1651","05110","2020",103,5,98,71546.7669902913,2071.94174757282,32.1844660194175
"1652","05111","2020",5,3,2,342820,3360.6,107.4
"1653","05112","2020",1,1,0,305700,2168,141
"1654","05113","2020",3,3,0,303533.333333333,2143.66666666667,149.333333333333
"1655","05114","2020",13,3,10,103238.461538462,2380.46153846154,41.8461538461538
"1656","05115","2020",9,7,2,139733.333333333,1734.88888888889,82.3333333333333
"1657","05116","2020",2,2,0,174070,2598.5,61.5
"1658","05117","2020",2,2,0,231500,2325,99
"1659","05118","2020",13,11,2,152441.538461538,1603.46153846154,89.3076923076923
"1660","05119","2020",125,13,112,108674.296,3137.144,34.264
"1661","05121","2020",3,2,1,146033.333333333,1431,90.3333333333333
"1662","05122","2020",8,6,2,176250,1796.5,101.375
"1663","05123","2020",18,16,2,221272.222222222,2167.16666666667,107.444444444444
"1664","05124","2020",3,2,1,282266.666666667,2502.33333333333,116.666666666667
"1665","05126","2020",5,4,1,202181,2940.4,65
"1666","05127","2020",4,3,1,222000,1733.75,111.5
"1667","05128","2020",8,8,0,289056.5,3013.375,96
"1668","05129","2020",1,1,0,56000,683,82
"1669","05130","2020",1,1,0,344750,3788,91
"1670","05131","2020",1,1,0,210000,2100,100
"1671","05132","2020",38,24,14,160705.789473684,2072.65789473684,83.3684210526316
"1672","05133","2020",78,9,69,196815.807692308,3448.53846153846,54.7948717948718
"1673","05134","2020",2,2,0,192966.5,1812.5,116
"1674","05135","2020",2,2,0,156250,1882,74
"1675","05136","2020",7,5,2,196599.285714286,2431.57142857143,101.714285714286
"1676","05139","2020",190,17,173,88365.3789473684,2282.28947368421,36.0894736842105
"1677","05140","2020",6,6,0,177783.333333333,2006.66666666667,91.3333333333333
"1678","05142","2020",14,10,4,127913.857142857,2272.35714285714,68.6428571428571
"1679","05145","2020",18,12,6,145166,1881.16666666667,73.7777777777778
"1680","05146","2020",5,5,0,118766,1592,76
"1681","05147","2020",2,2,0,262350,2181,122.5
"1682","05148","2020",9,9,0,130241.666666667,1327.77777777778,95.1111111111111
"1683","05149","2020",37,7,30,59367.8378378378,1608.81081081081,38.4054054054054
"1684","05151","2020",13,9,4,159901.538461538,2254.92307692308,76.9230769230769
"1685","05153","2020",33,6,27,73454.696969697,1882.84848484848,40.3030303030303
"1686","05154","2020",1,1,0,20000,370,54
"1687","05156","2020",6,5,1,274300,2195.5,132.166666666667
"1688","05157","2020",11,6,5,279713.818181818,3409.54545454545,75.6363636363636
"1689","05158","2020",1,1,0,69000,1438,48
"1690","05160","2020",1,1,0,51500,769,67
"1691","05161","2020",74,5,69,165170.743243243,3871.67567567568,41.7027027027027
"1692","05162","2020",15,8,7,161367.333333333,2140.73333333333,78
"1693","05163","2020",2,2,0,284975,1939,150.5
"1694","05164","2020",44,19,25,196824.25,3018.77272727273,68.0454545454545
"1695","05165","2020",1,1,0,86500,1573,55
"1696","05166","2020",18,13,5,102170,1429.16666666667,74.1666666666667
"1697","05168","2020",6,4,2,215503.666666667,2743.5,82
"1698","05169","2020",1,1,0,320000,1333,240
"1699","05170","2020",24,18,6,176513.75,2167.5,82.5833333333333
"1700","05171","2020",2,2,0,185566,2650,72.5
"1701","05172","2020",3,3,0,165000,1443,113
"1702","05173","2020",5,5,0,177596,1890,104.8
"1703","05174","2020",12,9,3,194186.666666667,2077.08333333333,106.833333333333
"1704","05176","2020",3,1,2,87333.3333333333,1563,50.3333333333333
"1705","05177","2020",109,7,102,148202.201834862,3336.32110091743,41.1100917431193
"1706","05178","2020",4,4,0,148360,1771.25,80
"1707","05179","2020",54,36,18,118082.222222222,1616.01851851852,82.6296296296296
"1708","05180","2020",7,4,3,254102.857142857,2670.42857142857,94.5714285714286
"1709","05181","2020",4,2,2,132975,1655.75,83
"1710","05182","2020",1,0,1,40000,678,59
"1711","05183","2020",14,10,4,254411.142857143,2751.57142857143,93.1428571428571
"1712","05184","2020",1,1,0,130000,1806,72
"1713","06001","2020",5,4,1,104800,1545,73
"1714","06002","2020",1,1,0,20000,606,33
"1715","06003","2020",24,13,11,129660.833333333,2414.29166666667,61.7916666666667
"1716","06004","2020",2048,212,1836,295019.176269531,4710.74560546875,60.80224609375
"1717","06005","2020",1,1,0,2e+05,2564,78
"1718","06006","2020",18,15,3,384516.777777778,3766.66666666667,110.555555555556
"1719","06007","2020",57,41,16,404174.192982456,4323.49122807018,93.0175438596491
"1720","06008","2020",2,2,0,165500,2387,73.5
"1721","06009","2020",4,4,0,120250,1534.5,69.25
"1722","06010","2020",55,33,22,313781.127272727,3643.98181818182,86.2727272727273
"1723","06011","2020",94,4,90,460626.563829787,6772.58510638298,65.6808510638298
"1724","06012","2020",216,10,206,342639.208333333,6306.29166666667,53.9907407407407
"1725","06013","2020",20,13,7,123505,2160.6,54
"1726","06014","2020",13,6,7,185561.846153846,2270.15384615385,79.7692307692308
"1727","06015","2020",19,12,7,246984.210526316,3200,77.7368421052632
"1728","06016","2020",31,11,20,119138.483870968,2719.70967741935,43.3870967741936
"1729","06017","2020",7,6,1,206677.142857143,2386.42857142857,88.1428571428571
"1730","06018","2020",131,88,43,550883.183206107,5158.86259541985,105.053435114504
"1731","06019","2020",16,10,6,264625,3187.8125,83.75
"1732","06020","2020",14,9,5,170603.571428571,2246.64285714286,75
"1733","06021","2020",9,7,2,241450,2625.66666666667,85.4444444444444
"1734","06022","2020",15,11,4,190846.666666667,2661.33333333333,73.5333333333333
"1735","06023","2020",38,18,20,109418.973684211,1958.73684210526,55.4210526315789
"1736","06024","2020",3,2,1,101250,1441.33333333333,66.6666666666667
"1737","06025","2020",25,17,8,264174.32,3208.96,82.4
"1738","06026","2020",23,18,5,435972.391304348,3768.91304347826,115.130434782609
"1739","06027","2020",1006,152,854,268753.01888668,4321.97216699801,62.5854870775348
"1740","06028","2020",15,15,0,150693.133333333,2563.06666666667,63.7333333333333
"1741","06029","2020",2344,119,2225,321541.348122867,5154.47994880546,60.8758532423208
"1742","06030","2020",1009,83,926,241418.792864222,3672.39841427156,63.1248761149653
"1743","06031","2020",10,7,3,369130,4219.3,99.6
"1744","06032","2020",60,4,56,461382.466666667,7532.48333333333,59.55
"1745","06033","2020",106,35,71,234069.528301887,2865.52830188679,81.3396226415094
"1746","06034","2020",22,20,2,366270.454545455,3849.31818181818,102.727272727273
"1747","06035","2020",16,9,7,290918.75,4484.625,66.5
"1748","06036","2020",3,1,2,386500,2800.66666666667,139.666666666667
"1749","06037","2020",6,6,0,337500,4079.16666666667,90.8333333333333
"1750","06038","2020",40,32,8,809820.95,5273.1,143.225
"1751","06039","2020",4,2,2,213000,3098.75,67.25
"1752","06041","2020",8,7,1,169000,2249.75,79.75
"1753","06042","2020",7,3,4,103407.428571429,2020.28571428571,49.1428571428571
"1754","06043","2020",9,8,1,258484.444444444,3015.55555555556,87.8888888888889
"1755","06044","2020",117,82,35,523170.418803419,4750.68376068376,104.282051282051
"1756","06046","2020",30,21,9,400257.666666667,4437.86666666667,94.4333333333333
"1757","06048","2020",83,53,30,317062.56626506,3572.25301204819,91.3975903614458
"1758","06049","2020",2,2,0,226250,3574,60
"1759","06050","2020",10,8,2,215143.6,3090.7,70.4
"1760","06051","2020",1,1,0,26587,2216,12
"1761","06052","2020",1,1,0,54000,600,90
"1762","06053","2020",1,1,0,120000,1200,100
"1763","06054","2020",30,10,20,205123.966666667,2951.66666666667,78.2333333333333
"1764","06055","2020",3,2,1,129000,1277.33333333333,77.3333333333333
"1765","06056","2020",1,0,1,20000,571,35
"1766","06057","2020",34,12,22,182368.382352941,2686.47058823529,70.5882352941177
"1767","06058","2020",10,10,0,214850,3082.5,73.3
"1768","06059","2020",52,24,28,627311.865384615,7318.65384615385,85.5384615384615
"1769","06060","2020",23,18,5,603751,5216.21739130435,109.391304347826
"1770","06062","2020",8,4,4,53875,925.5,69
"1771","06064","2020",41,31,10,350942.073170732,3776.60975609756,96.6829268292683
"1772","06065","2020",69,49,20,421665.594202899,4323,100.724637681159
"1773","06066","2020",12,8,4,252412.5,3143.66666666667,73.0833333333333
"1774","06067","2020",25,7,18,238740,4177.04,58.92
"1775","06068","2020",3,3,0,297000,3085,91.3333333333333
"1776","06069","2020",934,242,692,239796.406852248,3049.89507494647,74.8222698072805
"1777","06070","2020",23,1,22,54968.2608695652,1459.04347826087,37.695652173913
"1778","06071","2020",38,4,34,124303.263157895,3136.60526315789,44.7368421052632
"1779","06072","2020",3,3,0,108200,1834.66666666667,64
"1780","06073","2020",136,7,129,119950.058823529,3559.55882352941,32.5735294117647
"1781","06074","2020",20,11,9,150950,2885.9,60.65
"1782","06075","2020",61,39,22,276521.409836066,3468.80327868852,81.7704918032787
"1783","06076","2020",2,2,0,136000,1667,74
"1784","06077","2020",12,7,5,150345.833333333,2549.83333333333,66.8333333333333
"1785","06078","2020",3,1,2,85333.3333333333,1753,50.6666666666667
"1786","06079","2020",717,83,634,276402.305439331,4340.44630404463,62.1087866108787
"1787","06081","2020",5,5,0,64700,2070.8,41.6
"1788","06082","2020",1,1,0,221000,1842,120
"1789","06083","2020",943,53,890,245889.951219512,4544.23647932131,54.8886532343584
"1790","06084","2020",123,85,38,597519.869918699,4803.34959349593,117.756097560976
"1791","06085","2020",347,158,189,541061.536023055,4949.61959654179,101.063400576369
"1792","06086","2020",10,2,8,83500,1334.6,63.5
"1793","06088","2020",7798,302,7496,251906.218774045,4285.34726853039,58.8988202103103
"1794","06089","2020",27,27,0,987672.777777778,6125.07407407407,162.296296296296
"1795","06090","2020",94,43,51,265928.404255319,4229.40425531915,65.2021276595745
"1796","06091","2020",30,22,8,385497.866666667,4607.96666666667,80.3
"1797","06092","2020",13,7,6,216646.153846154,2931.46153846154,71.3076923076923
"1798","06093","2020",4,4,0,167575,2273,77
"1799","06094","2020",66,11,55,168635.833333333,3330.45454545455,51.3787878787879
"1800","06095","2020",150,83,67,293083.22,3386.16666666667,86.3733333333333
"1801","06097","2020",4,4,0,274537.5,2483.25,113.5
"1802","06098","2020",2,2,0,271500,2673,105
"1803","06099","2020",22,11,11,137045.454545455,2304.45454545455,60.5454545454545
"1804","06100","2020",4,4,0,335567.5,2442,149
"1805","06101","2020",4,2,2,100750,1332,63
"1806","06102","2020",5,3,2,86840,1233.2,71.8
"1807","06103","2020",27,13,14,164044.444444444,2383.81481481481,67.7037037037037
"1808","06104","2020",385,29,356,347768.815584416,5660.87012987013,57.0545454545455
"1809","06105","2020",100,83,17,664744.84,4972.95,136.05
"1810","06106","2020",7,6,1,131285.714285714,2041.14285714286,61.4285714285714
"1811","06107","2020",2,1,1,86250,1947.5,45.5
"1812","06108","2020",66,52,14,500272.545454545,4494.04545454545,108.136363636364
"1813","06109","2020",6,2,4,272941.666666667,2586.33333333333,89
"1814","06110","2020",8,7,1,141250,3097.125,52.875
"1815","06111","2020",1,1,0,80000,1270,63
"1816","06112","2020",59,51,8,621451.915254237,4976.83050847458,129.440677966102
"1817","06113","2020",16,13,3,374937.5,4443.75,88
"1818","06114","2020",48,14,34,242646.354166667,3594.45833333333,69.4166666666667
"1819","06115","2020",1,1,0,36000,735,49
"1820","06116","2020",8,7,1,132187.5,1778.375,80.125
"1821","06117","2020",8,8,0,386729.375,3627.25,113.75
"1822","06118","2020",86,78,8,347473.488372093,3524.38372093023,101.604651162791
"1823","06119","2020",2,0,2,64000,1600,40
"1824","06120","2020",130,9,121,157696.661538462,4059.89230769231,37.3384615384615
"1825","06121","2020",30,6,24,630116.666666667,8665.4,72.8
"1826","06122","2020",41,32,9,399723.487804878,4002.09756097561,101.268292682927
"1827","06123","2020",641,66,575,268267.223088924,4330.32449297972,63.3510140405616
"1828","06124","2020",1,1,0,168500,1685,100
"1829","06125","2020",8,6,2,113625,1395.875,82.875
"1830","06126","2020",26,14,12,341716.538461538,3949.73076923077,85.0384615384615
"1831","06127","2020",43,14,29,145123.488372093,2544.6976744186,58.1395348837209
"1832","06128","2020",47,34,13,635126.468085106,5547.93617021277,123.276595744681
"1833","06129","2020",2,0,2,46000,757.5,57.5
"1834","06130","2020",70,56,14,233026.657142857,3400.55714285714,74.8428571428571
"1835","06131","2020",1,1,0,104000,1143,91
"1836","06132","2020",11,2,9,79219.0909090909,1474.09090909091,45.1818181818182
"1837","06133","2020",2,2,0,140000,1236.5,105
"1838","06134","2020",9,8,1,153908.888888889,1941.55555555556,78.4444444444444
"1839","06135","2020",2,2,0,276510,3205.5,90.5
"1840","06136","2020",64,27,37,221574.0625,3028.125,72.609375
"1841","06137","2020",24,22,2,506933.291666667,4456.375,112
"1842","06138","2020",103,21,82,419330.087378641,6165.2427184466,65.6407766990291
"1843","06139","2020",1,0,1,20000,606,33
"1844","06140","2020",38,35,3,397561.973684211,3866.97368421053,104.184210526316
"1845","06141","2020",5,2,3,58294,1326.4,50
"1846","06142","2020",5,1,4,94900,2086.6,51.4
"1847","06143","2020",6,4,2,135500,1982.33333333333,62.6666666666667
"1848","06144","2020",4,2,2,80062.5,1496.75,53.5
"1849","06145","2020",4,3,1,78250,1539.5,49.25
"1850","06146","2020",1,1,0,188679,2948,64
"1851","06147","2020",47,41,6,362220.595744681,3738.72340425532,97.6808510638298
"1852","06148","2020",67,59,8,608891.059701493,4562.86567164179,131.940298507463
"1853","06149","2020",105,30,75,239543.39047619,3330.10476190476,71.9333333333333
"1854","06150","2020",40,19,21,454238,6003.15,73.5
"1855","06151","2020",14,12,2,177496.428571429,2206.71428571429,75.1428571428571
"1856","06152","2020",150,84,66,512091.82,4916.18,99.5666666666667
"1857","06153","2020",59,25,34,151596.101694915,2397.71186440678,63.4237288135593
"1858","06154","2020",13,7,6,119270.769230769,1734.30769230769,67.3846153846154
"1859","06155","2020",724,123,601,287690.026243094,4213.98204419889,63.232044198895
"1860","06156","2020",3,0,3,50833.3333333333,1615.33333333333,52
"1861","06157","2020",360,129,231,328398.702777778,4088.95,79.2055555555555
"1862","06158","2020",12,6,6,145875,2415.58333333333,61.5833333333333
"1863","06159","2020",133,23,110,665004.917293233,7235.6992481203,83.4360902255639
"1864","06161","2020",499,109,390,316164.76753507,5149.91983967936,60.062124248497
"1865","06162","2020",13,4,9,89558.4615384615,1397.53846153846,59.2307692307692
"1866","06163","2020",18,6,12,84334.4444444444,1473.94444444444,56.8888888888889
"1867","07001","2020",5,5,0,142476,1049.8,126
"1868","07002","2020",8,8,0,212487.5,2040.125,103.75
"1869","07004","2020",1,1,0,52300,1162,45
"1870","07005","2020",10,9,1,221372,2854.3,80.7
"1871","07006","2020",4,4,0,94750,1638.5,59.25
"1872","07007","2020",15,15,0,142354.333333333,1445.6,110.333333333333
"1873","07008","2020",14,14,0,222762.857142857,2139.28571428571,103.428571428571
"1874","07009","2020",19,18,1,134264.368421053,1517.42105263158,89.9473684210526
"1875","07010","2020",234,82,152,101442.585470085,1239.52991452991,77.5641025641026
"1876","07011","2020",16,14,2,130101.5625,1699.4375,82.1875
"1877","07012","2020",8,8,0,91506.25,1368.25,76.375
"1878","07013","2020",10,10,0,131980,1516.9,85
"1879","07014","2020",5,5,0,145200,2345.6,62.8
"1880","07015","2020",1,1,0,230000,2396,96
"1881","07017","2020",8,8,0,157676.25,1558.25,95.125
"1882","07018","2020",2,2,0,190750,2206,88
"1883","07019","2020",169,55,114,125717.390532544,1739.52662721893,75.508875739645
"1884","07020","2020",5,5,0,174096,1823,91.4
"1885","07022","2020",21,20,1,183998.571428571,2117.19047619048,95.3809523809524
"1886","07023","2020",8,8,0,205337.5,2868.75,74.125
"1887","07024","2020",7,7,0,402160,2797.71428571429,160.857142857143
"1888","07025","2020",4,4,0,106625,1317,72.5
"1889","07026","2020",3,3,0,89900,2499.66666666667,39
"1890","07027","2020",17,15,2,180117.647058824,2170.88235294118,83.3529411764706
"1891","07028","2020",8,8,0,151687.5,1748.875,82.625
"1892","07029","2020",7,7,0,115651.428571429,1431.28571428571,75.4285714285714
"1893","07030","2020",6,6,0,128961.666666667,2185.66666666667,67.6666666666667
"1894","07031","2020",7,7,0,233004.285714286,2541.42857142857,98
"1895","07032","2020",2,1,1,78500,858,91
"1896","07034","2020",5,5,0,187338,1675.6,116.2
"1897","07035","2020",8,8,0,198167.5,2337.5,91.75
"1898","07036","2020",6,6,0,226966.666666667,2355.66666666667,105
"1899","07037","2020",7,7,0,99071.4285714286,1779.85714285714,61.5714285714286
"1900","07038","2020",1,1,0,38000,494,77
"1901","07039","2020",9,9,0,202664.444444444,1770,119.666666666667
"1902","07040","2020",3,3,0,181744.666666667,1678.33333333333,108.333333333333
"1903","07041","2020",21,19,2,171254,1836.52380952381,91.7619047619048
"1904","07042","2020",88,48,40,109545.954545455,1448.44318181818,76.5568181818182
"1905","07044","2020",4,4,0,215625,1875.25,116
"1906","07045","2020",9,8,1,171537.666666667,1840.44444444444,93.1111111111111
"1907","07047","2020",3,3,0,50000,375,133.333333333333
"1908","07048","2020",5,5,0,89863,1376,67.2
"1909","07049","2020",2,2,0,43410,788,55.5
"1910","07050","2020",13,12,1,219043.846153846,2352.84615384615,98.7692307692308
"1911","07051","2020",2,2,0,188750,1822.5,93.5
"1912","07052","2020",7,7,0,181869.142857143,1939.42857142857,123
"1913","07053","2020",3,3,0,192673.333333333,1991.66666666667,90.6666666666667
"1914","07054","2020",7,6,1,90907.1428571429,1454.14285714286,70.8571428571429
"1915","07055","2020",29,28,1,261474.965517241,2493.1724137931,107.862068965517
"1916","07056","2020",9,9,0,227610,2067.11111111111,110.666666666667
"1917","07058","2020",8,8,0,123937.5,1464,86
"1918","07059","2020",3,3,0,189733.333333333,1243.33333333333,141.666666666667
"1919","07060","2020",3,3,0,114000,1254.66666666667,94.3333333333333
"1920","07061","2020",4,4,0,139835,1929.75,79.25
"1921","07062","2020",3,3,0,228266.666666667,2853,83
"1922","07063","2020",4,4,0,159000,1889.75,84.5
"1923","07064","2020",15,8,7,128715,1278.46666666667,96.8
"1924","07065","2020",9,9,0,170155.555555556,1598.44444444444,105
"1925","07066","2020",25,19,6,174760,1893.36,89.8
"1926","07068","2020",4,4,0,87562.5,1073,83
"1927","07069","2020",9,9,0,195160,1998.55555555556,100.888888888889
"1928","07070","2020",18,17,1,221483.055555556,2338,97.6666666666667
"1929","07071","2020",17,17,0,107712.647058824,1281.41176470588,85
"1930","07072","2020",10,8,2,205700,1971.4,107.4
"1931","07073","2020",6,6,0,119333.333333333,1129.83333333333,100
"1932","07074","2020",3,3,0,73500,831.666666666667,83
"1933","07075","2020",6,6,0,115883.333333333,1500.16666666667,89.1666666666667
"1934","07076","2020",26,26,0,174556.269230769,1850.61538461538,96.4615384615385
"1935","07077","2020",4,4,0,180625,1684,119.75
"1936","07078","2020",28,18,10,171341.428571429,1870.10714285714,91.6071428571429
"1937","07079","2020",25,23,2,118695.8,1358.2,88.96
"1938","07080","2020",9,9,0,125166.666666667,1601.44444444444,97.5555555555556
"1939","07081","2020",2,2,0,161000,1796.5,93
"1940","07082","2020",3,3,0,257290,2670.33333333333,107
"1941","07083","2020",6,6,0,96833.3333333333,1559.66666666667,62
"1942","07084","2020",9,9,0,156688.888888889,1430.55555555556,107.555555555556
"1943","07085","2020",8,8,0,142411.25,1834.5,85.5
"1944","07086","2020",8,8,0,177992.5,1804.625,93.625
"1945","07087","2020",2,2,0,198540,1996.5,102.5
"1946","07088","2020",2,2,0,95950,1952.5,49.5
"1947","07089","2020",15,14,1,204938,2341.6,91.9333333333333
"1948","07090","2020",11,6,5,118218.181818182,1674.45454545455,70.6363636363636
"1949","07091","2020",3,3,0,169433.333333333,1597,115.666666666667
"1950","07093","2020",7,7,0,150528.571428571,1748.42857142857,83.1428571428571
"1951","07094","2020",2,2,0,333000,3739.5,84.5
"1952","07095","2020",9,9,0,158053.333333333,1728.22222222222,95.7777777777778
"1953","07096","2020",3,3,0,251233.333333333,2105,115.333333333333
"1954","07097","2020",10,10,0,197554.3,2000.3,102.4
"1955","07098","2020",5,5,0,140410,1799.6,79
"1956","07099","2020",5,5,0,381774,2519.6,147
"1957","07100","2020",8,8,0,167562.5,2286.25,72.75
"1958","07101","2020",9,8,1,144200,2040,74.4444444444444
"1959","07102","2020",183,57,126,175040.098360656,2241.67213114754,77.0218579234973
"1960","07103","2020",2,2,0,181646,2133,94
"1961","07105","2020",2,2,0,39500,438.5,93.5
"1962","07106","2020",6,5,1,100950,1529.66666666667,72
"1963","07107","2020",21,17,4,172281.714285714,1671.52380952381,103.619047619048
"1964","07109","2020",5,5,0,250200,3167.2,85
"1965","07110","2020",27,17,10,152664.222222222,1725.33333333333,87.962962962963
"1966","07111","2020",3,2,1,110833.333333333,1313.33333333333,82.6666666666667
"1967","07112","2020",4,4,0,117500,1494.5,73.75
"1968","07113","2020",5,5,0,180040,1862.4,101
"1969","07114","2020",4,4,0,96750,1400.5,72.75
"1970","07115","2020",12,12,0,241818.166666667,2613.33333333333,97.25
"1971","07116","2020",26,12,14,86186.5384615385,1315.26923076923,70.1538461538462
"1972","07117","2020",26,24,2,225048.461538462,2461.23076923077,93.6153846153846
"1973","07118","2020",5,5,0,119198.6,1665.8,82
"1974","07119","2020",6,6,0,131075,1874.66666666667,78
"1975","07120","2020",2,2,0,220965,1723.5,124
"1976","07121","2020",9,9,0,127633.333333333,1306,93.2222222222222
"1977","07122","2020",16,16,0,210900.375,2334.4375,91.125
"1978","07126","2020",12,11,1,277450,2427.08333333333,102.916666666667
"1979","07127","2020",14,12,2,145832.642857143,1690.92857142857,85.8571428571429
"1980","07128","2020",12,8,4,126455.833333333,1781.41666666667,101.083333333333
"1981","07129","2020",28,24,4,115348.571428571,1531.96428571429,84.1785714285714
"1982","07130","2020",7,7,0,59614.2857142857,1218.14285714286,52.8571428571429
"1983","07131","2020",8,8,0,126193.75,1990.875,73.625
"1984","07132","2020",23,21,2,136153.043478261,1466.04347826087,97.1739130434783
"1985","07133","2020",1,1,0,222000,2094,106
"1986","07134","2020",7,7,0,196071.428571429,2194.28571428571,97.2857142857143
"1987","07137","2020",1,1,0,110000,1719,64
"1988","07138","2020",20,19,1,209010,1903.45,114.05
"1989","07139","2020",1,1,0,1e+05,714,140
"1990","07140","2020",9,9,0,264311.111111111,2478.77777777778,106.777777777778
"1991","07141","2020",4,4,0,257575,2375.5,118.5
"1992","07142","2020",4,4,0,121250,878,109.25
"1993","07143","2020",12,12,0,157676.666666667,1721.83333333333,92.0833333333333
"1994","07144","2020",1,1,0,145460,817,178
"1995","07145","2020",13,13,0,190403.846153846,1932.30769230769,108.153846153846
"1996","07146","2020",5,5,0,111887.2,1095.8,81
"1997","07147","2020",5,5,0,166476,1746,100.2
"1998","07148","2020",3,3,0,130500,2104,62.3333333333333
"1999","07149","2020",3,3,0,137855,810.666666666667,168.666666666667
"2000","07150","2020",12,12,0,124318.333333333,1373.66666666667,95.75
"2001","07151","2020",7,7,0,116164.285714286,1654,75.7142857142857
"2002","07152","2020",10,8,2,186978.5,2239.6,90.6
"2003","07153","2020",10,10,0,79082.4,1224.2,66.5
"2004","07155","2020",7,7,0,187962.857142857,1751.57142857143,109.285714285714
"2005","07156","2020",17,17,0,163886.294117647,1818.52941176471,99.4117647058823
"2006","07157","2020",15,14,1,199016.2,2026.6,95.8666666666667
"2007","07158","2020",3,3,0,81166.6666666667,895,93.3333333333333
"2008","07159","2020",8,8,0,218781.25,2361.375,93.125
"2009","07160","2020",3,3,0,191666.666666667,2075,92.6666666666667
"2010","07161","2020",14,13,1,123566.071428571,1514.71428571429,81.6428571428571
"2011","07162","2020",5,5,0,128940,1484.2,99.6
"2012","07163","2020",1,1,0,135000,1364,99
"2013","07165","2020",6,6,0,119550,1596.83333333333,84
"2014","07166","2020",5,5,0,112108,1422.4,81
"2015","07167","2020",13,13,0,171586.153846154,1910.30769230769,95.8461538461538
"2016","07168","2020",7,7,0,236250.142857143,2112.85714285714,112.571428571429
"2017","07169","2020",5,5,0,238800,2270,104.8
"2018","07170","2020",4,4,0,153347.5,1853.5,87.5
"2019","07171","2020",9,8,1,247236.666666667,2180.66666666667,110.555555555556
"2020","07172","2020",22,22,0,204167.272727273,1993.04545454545,105.363636363636
"2021","07173","2020",2,2,0,265000,3030,71
"2022","07174","2020",11,11,0,124863.636363636,1285.54545454545,100.909090909091
"2023","07175","2020",1,1,0,70000,833,84
"2024","07176","2020",1,1,0,230000,2421,95
"2025","07177","2020",12,11,1,154275,1738.08333333333,95.3333333333333
"2026","07178","2020",11,10,1,128600.909090909,2137.81818181818,72.1818181818182
"2027","07179","2020",1,1,0,150000,1316,114
"2028","07181","2020",30,27,3,143415.8,1784.9,83.1333333333333
"2029","07182","2020",14,13,1,133871.428571429,1629.64285714286,78.4285714285714
"2030","07183","2020",14,11,3,184878.571428571,1925.5,96.7857142857143
"2031","07184","2020",5,4,1,154140,1497.6,98.2
"2032","07185","2020",5,5,0,214400,1603.8,129.8
"2033","07186","2020",111,48,63,122259.198198198,1442.21621621622,85.0900900900901
"2034","07187","2020",3,2,1,125333.333333333,1939.33333333333,78.6666666666667
"2035","07188","2020",13,13,0,151852.769230769,1801.46153846154,88.9230769230769
"2036","07189","2020",2,2,0,230000,2185.5,106
"2037","07190","2020",1,1,0,644308,4104,157
"2038","07191","2020",24,20,4,172040.541666667,1726.29166666667,98.4583333333333
"2039","07192","2020",8,8,0,153667.5,1295.375,113.125
"2040","07193","2020",3,3,0,164333.333333333,1972.33333333333,83.3333333333333
"2041","07194","2020",3,3,0,205000,2144.66666666667,101.333333333333
"2042","07196","2020",3,3,0,260571.666666667,2503.33333333333,110.333333333333
"2043","07197","2020",34,32,2,201766.852941176,1821.26470588235,111.970588235294
"2044","07198","2020",15,14,1,138373.333333333,1465.06666666667,91.8666666666667
"2045","07199","2020",12,12,0,223972.5,2607.91666666667,92.0833333333333
"2046","07200","2020",1,1,0,40000,851,47
"2047","07201","2020",40,27,13,167716.125,2179.475,80.2
"2048","07202","2020",3,3,0,122000,2755.33333333333,48.6666666666667
"2049","07203","2020",2,2,0,172550,4136.5,53
"2050","07204","2020",27,22,5,95059.2592592593,1062.62962962963,95.2222222222222
"2051","07205","2020",13,13,0,158809.692307692,1716.46153846154,90.0769230769231
"2052","07206","2020",2,2,0,117295,1514,78
"2053","07207","2020",19,18,1,227045.526315789,2234.78947368421,107.947368421053
"2054","07208","2020",1,1,0,417370,2470,169
"2055","07209","2020",2,2,0,79500,1002.5,76.5
"2056","07210","2020",7,7,0,146230,1894.42857142857,77.1428571428571
"2057","07211","2020",9,9,0,169422.222222222,1687.55555555556,117.333333333333
"2058","07212","2020",5,5,0,148600,1588,104.8
"2059","07213","2020",2,2,0,84250,2110,36.5
"2060","07214","2020",6,6,0,202641.666666667,2288.16666666667,88.3333333333333
"2061","07215","2020",7,7,0,114142.857142857,1126,104.571428571429
"2062","07216","2020",14,14,0,152939.285714286,1794.5,95.5714285714286
"2063","07217","2020",3,3,0,136333.333333333,1556,85.3333333333333
"2064","07218","2020",3,3,0,214000,1658.33333333333,128.666666666667
"2065","07219","2020",4,4,0,276550,1960.75,147
"2066","07220","2020",3,3,0,64000,962.666666666667,93
"2067","07221","2020",2,2,0,87500,1231.5,74
"2068","07222","2020",1,1,0,108000,1403,77
"2069","07224","2020",2,2,0,46500,412.5,120.5
"2070","07225","2020",17,17,0,238230,1916,124.235294117647
"2071","07226","2020",3,3,0,66260,921,86.6666666666667
"2072","07227","2020",8,8,0,235731.25,2257.375,102.75
"2073","07228","2020",5,5,0,154300,1687.8,95
"2074","07229","2020",7,7,0,175921.428571429,1856.57142857143,98.7142857142857
"2075","07230","2020",3,3,0,149333.333333333,1480.66666666667,118.666666666667
"2076","07231","2020",20,19,1,203697.4,2244.55,101.55
"2077","07232","2020",3,3,0,51566.6666666667,998.333333333333,57.3333333333333
"2078","07233","2020",1,1,0,228000,1425,160
"2079","07234","2020",2,2,0,50250,867.5,59.5
"2080","07235","2020",5,5,0,119500,1148.2,94.6
"2081","07236","2020",14,12,2,145939.285714286,1768.78571428571,88.8571428571429
"2082","07237","2020",6,5,1,139583.333333333,1757.83333333333,73.6666666666667
"2083","07238","2020",4,4,0,235216,2134.5,119.5
"2084","07239","2020",2,2,0,92000,1668.5,54
"2085","07240","2020",21,16,5,264173.095238095,2567.61904761905,107.190476190476
"2086","07241","2020",9,8,1,179103.888888889,1733.66666666667,103.111111111111
"2087","07242","2020",2,2,0,126500,1907,64
"2088","07243","2020",5,5,0,174875.6,1887.4,95
"2089","07244","2020",6,6,0,148650,1508.83333333333,91.6666666666667
"2090","07245","2020",24,23,1,170652.083333333,1728.20833333333,99.4583333333333
"2091","07247","2020",8,7,1,173975,1804.625,93.25
"2092","07248","2020",3,3,0,74000,1309.33333333333,58
"2093","07249","2020",3,3,0,118666.666666667,1752.66666666667,93
"2094","07250","2020",3,3,0,105500,1653.66666666667,63.3333333333333
"2095","07251","2020",4,4,0,125645.75,1023.25,106.25
"2096","07253","2020",4,4,0,121500,1438.75,86
"2097","07254","2020",10,10,0,238185.7,2437.4,102.9
"2098","07255","2020",16,13,3,165231.25,1971.125,86
"2099","07258","2020",5,5,0,144782,1872.6,82.8
"2100","07259","2020",11,8,3,173868.181818182,2010.09090909091,92.8181818181818
"2101","07260","2020",6,6,0,188721.666666667,2062,91
"2102","07261","2020",18,16,2,148294.444444444,1824.11111111111,84.7222222222222
"2103","07262","2020",5,5,0,52198,1132.6,48.6
"2104","07263","2020",1,1,0,122900,853,144
"2105","07264","2020",26,25,1,233797.692307692,2042.38461538462,113.807692307692
"2106","07265","2020",9,9,0,130022.222222222,1322,96.5555555555556
"2107","07266","2020",5,5,0,59220,1010.6,57.2
"2108","07267","2020",9,8,1,79277.7777777778,1540.88888888889,55.1111111111111
"2109","07268","2020",11,8,3,183981.818181818,2726.81818181818,69.1818181818182
"2110","07269","2020",15,14,1,92164,1223.73333333333,92.9333333333333
"2111","07270","2020",6,6,0,172833.333333333,1770.5,97.1666666666667
"2112","07272","2020",2,2,0,207500,3906,60
"2113","07273","2020",3,3,0,124586.666666667,1526.33333333333,81.6666666666667
"2114","07274","2020",3,3,0,112000,1441,95.6666666666667
"2115","07275","2020",2,2,0,137450,2257.5,71
"2116","07276","2020",3,3,0,139333.333333333,1904.33333333333,97
"2117","07277","2020",1,1,0,55000,1279,43
"2118","07278","2020",12,12,0,173654.166666667,1860.5,95.5
"2119","07279","2020",18,18,0,199816.666666667,1987.55555555556,101.333333333333
"2120","07280","2020",15,15,0,170470.666666667,2664,72.2
"2121","07281","2020",77,60,17,262766.753246753,2638.2987012987,99.8311688311688
"2122","07282","2020",5,5,0,132200,1828,87.2
"2123","07284","2020",4,4,0,95250,1156.5,85.5
"2124","07285","2020",3,3,0,119333.333333333,1853,66
"2125","07286","2020",9,8,1,67277.7777777778,874.111111111111,73.8888888888889
"2126","07287","2020",4,4,0,185000,2141.5,82
"2127","07288","2020",15,13,2,188904.8,2041.53333333333,101.4
"2128","07289","2020",13,13,0,199296.153846154,1740.61538461538,113.153846153846
"2129","07290","2020",2,2,0,135000,1349.5,93
"2130","07291","2020",19,18,1,173591.263157895,1848.47368421053,96.3157894736842
"2131","07292","2020",5,5,0,177314.2,1424.2,118
"2132","07293","2020",10,10,0,208675,1991,103.1
"2133","07294","2020",7,7,0,127060,1654,78.4285714285714
"2134","07295","2020",11,11,0,131309.090909091,1862.90909090909,79.4545454545455
"2135","07296","2020",15,14,1,216156.4,1952,111.533333333333
"2136","07297","2020",8,8,0,135306.25,1523.5,96.875
"2137","07298","2020",1,1,0,240000,3000,80
"2138","07299","2020",3,3,0,52166.6666666667,788.666666666667,73.3333333333333
"2139","07300","2020",4,4,0,272775,2313.5,113
"2140","07301","2020",13,12,1,129346.153846154,1455.23076923077,88.9230769230769
"2141","07302","2020",12,12,0,261499.583333333,2335.58333333333,117.916666666667
"2142","07303","2020",2,2,0,154000,1720.5,97.5
"2143","07304","2020",21,15,6,149609.523809524,2042.19047619048,72.9047619047619
"2144","07305","2020",7,5,2,275240,3000.28571428571,92.4285714285714
"2145","07306","2020",9,9,0,209257.888888889,2320.33333333333,91
"2146","07307","2020",9,8,1,191555.555555556,2551.88888888889,81
"2147","07308","2020",37,32,5,137229.756756757,1653.86486486486,85.0810810810811
"2148","07309","2020",25,23,2,131368,1672.4,87.48
"2149","07310","2020",9,9,0,212346.666666667,1683.88888888889,129.777777777778
"2150","07311","2020",2,2,0,195000,2491,72
"2151","07312","2020",11,11,0,155637.090909091,1742.09090909091,94.3636363636364
"2152","07313","2020",14,13,1,146203.571428571,1841.78571428571,84.3571428571429
"2153","07314","2020",13,13,0,153304.230769231,1864,82
"2154","07315","2020",4,4,0,51250,879.25,70.25
"2155","07316","2020",22,22,0,266031.818181818,2760.5,96.6363636363636
"2156","07317","2020",5,5,0,114680,1445.8,87
"2157","07318","2020",3,2,1,75500,873.666666666667,76.6666666666667
"2158","07319","2020",74,48,26,134394.675675676,1554.71621621622,85.2432432432432
"2159","07321","2020",3,3,0,172250,1746.33333333333,102
"2160","07322","2020",19,17,2,142640.526315789,2349.63157894737,74.0526315789474
"2161","07323","2020",17,17,0,213361.764705882,2252.70588235294,96.8823529411765
"2162","07324","2020",190,82,108,166212.068421053,2019.44210526316,83.3578947368421
"2163","07325","2020",29,26,3,219162.586206897,2179.65517241379,100.724137931034
"2164","07326","2020",1,1,0,35600,468,76
"2165","07327","2020",5,4,1,172416.4,1749.4,99
"2166","07328","2020",4,4,0,213912.5,1986.25,103
"2167","07329","2020",11,11,0,131536.181818182,1564.45454545455,83.1818181818182
"2168","07330","2020",50,46,4,206711.18,2477.14,92.14
"2169","07331","2020",68,26,42,107189.926470588,1554.85294117647,71.75
"2170","07332","2020",3,3,0,114800,929.333333333333,130.666666666667
"2171","07333","2020",16,15,1,183207.8125,1971.5625,97.125
"2172","07334","2020",52,39,13,235566.557692308,2279.61538461538,97.8461538461538
"2173","07336","2020",2,2,0,177405,2251.5,82
"2174","07337","2020",20,20,0,204644.25,1859.35,115.5
"2175","07338","2020",25,24,1,127122,1332.04,91.68
"2176","07339","2020",16,15,1,246177.75,1972.5,119
"2177","07340","2020",14,14,0,188794.285714286,2303.5,91.7857142857143
"2178","07341","2020",26,24,2,157848.461538462,1732.65384615385,95.8461538461538
"2179","07342","2020",12,12,0,142779.166666667,1433.25,107.25
"2180","07343","2020",12,12,0,182503.333333333,1793.41666666667,101.916666666667
"2181","07344","2020",7,7,0,220256.857142857,2027.14285714286,106.428571428571
"2182","07345","2020",7,7,0,211071.428571429,1871.57142857143,108.285714285714
"2183","07346","2020",34,27,7,120816.617647059,1368.05882352941,86.9117647058823
"2184","07347","2020",7,7,0,154978.571428571,1867.71428571429,79.1428571428571
"2185","07348","2020",11,11,0,170190.272727273,2416.81818181818,75.4545454545455
"2186","07349","2020",49,24,25,128071.836734694,1620.16326530612,77.2244897959184
"2187","08001","2020",3,3,0,131666.666666667,1260.66666666667,112.333333333333
"2188","08003","2020",19,19,0,146205.526315789,1450.31578947368,102.736842105263
"2189","08004","2020",3,3,0,136166.666666667,963.333333333333,143.666666666667
"2190","08005","2020",1,1,0,55000,379,145
"2191","08006","2020",3,3,0,40666.6666666667,627.666666666667,67
"2192","08008","2020",11,11,0,110922.727272727,1276.27272727273,96.8181818181818
"2193","08010","2020",5,5,0,99800,1112.6,90
"2194","08011","2020",5,5,0,106700,1203.4,80
"2195","08013","2020",4,4,0,65937.5,807.25,80.25
"2196","08014","2020",2,2,0,197000,1426.5,140
"2197","08015","2020",1,1,0,138000,1516,91
"2198","08016","2020",1,1,0,50000,625,80
"2199","08017","2020",2,2,0,91000,584.5,146
"2200","08019","2020",1,1,0,77500,510,152
"2201","08022","2020",4,4,0,208625,1530.75,133
"2202","08023","2020",2,2,0,167784.5,1035,162
"2203","08024","2020",9,9,0,153269.444444444,1385.44444444444,112.666666666667
"2204","08025","2020",14,14,0,87686.1428571429,1044.21428571429,95.9285714285714
"2205","08026","2020",4,4,0,125000,1194,107.75
"2206","08028","2020",6,6,0,128000,1383.33333333333,92.5
"2207","08029","2020",1,1,0,2e+05,667,300
"2208","08032","2020",3,3,0,138166.666666667,1893,97
"2209","08033","2020",4,4,0,80162.5,828.75,120.75
"2210","08034","2020",2,2,0,92500,1053,88.5
"2211","08035","2020",1,1,0,50000,526,95
"2212","08036","2020",1,1,0,30000,361,83
"2213","08037","2020",8,8,0,90828.5,966.125,91.75
"2214","08038","2020",1,1,0,185000,1729,107
"2215","08039","2020",9,9,0,164705.555555556,1588,102.666666666667
"2216","08040","2020",7,7,0,328957.142857143,3414.28571428571,111.714285714286
"2217","08041","2020",2,2,0,167000,1055.5,146.5
"2218","08043","2020",16,9,7,98168.75,1072.3125,90.375
"2219","08044","2020",6,6,0,114533.333333333,1166.5,96.3333333333333
"2220","08046","2020",3,3,0,122400,974.333333333333,128.333333333333
"2221","08047","2020",1,1,0,190000,1407,135
"2222","08048","2020",4,4,0,150600,1690.5,95.25
"2223","08053","2020",33,32,1,129459.545454545,1333.51515151515,99.1515151515152
"2224","08055","2020",2,2,0,47000,573.5,71
"2225","08057","2020",2,2,0,64900,718.5,92
"2226","08058","2020",6,6,0,190250,1726.83333333333,109.166666666667
"2227","08060","2020",2,2,0,246850,2022.5,126.5
"2228","08064","2020",8,8,0,196767.5,1665.75,121.625
"2229","08067","2020",13,13,0,86107.6923076923,1019.23076923077,83.9230769230769
"2230","08069","2020",2,2,0,174000,1175,149
"2231","08070","2020",4,4,0,114125,1331.5,79
"2232","08071","2020",1,1,0,130050,1084,120
"2233","08074","2020",1,1,0,41700,684,61
"2234","08075","2020",2,2,0,150940,1107.5,139
"2235","08076","2020",14,14,0,132792.857142857,1210.07142857143,112.571428571429
"2236","08078","2020",7,7,0,101000,959.714285714286,105.142857142857
"2237","08081","2020",50,50,0,74125.34,921.24,79.54
"2238","08082","2020",3,3,0,80666.6666666667,800.666666666667,95.6666666666667
"2239","08083","2020",4,3,1,57500,712.5,81.75
"2240","08084","2020",5,5,0,194830,1624.6,130.2
"2241","08085","2020",1,1,0,63000,467,135
"2242","08086","2020",1,1,0,72000,2880,25
"2243","08087","2020",4,4,0,179850,1358.75,135
"2244","08088","2020",1,1,0,40000,667,60
"2245","08089","2020",2,2,0,69000,652,109
"2246","08090","2020",31,27,4,99658.064516129,1010.54838709677,100.032258064516
"2247","08092","2020",3,3,0,161330,1799.33333333333,90.6666666666667
"2248","08094","2020",1,1,0,45000,600,75
"2249","08095","2020",2,2,0,128250,978,141
"2250","08096","2020",6,6,0,173000,1665.16666666667,104
"2251","08097","2020",3,3,0,88400,1035,84.3333333333333
"2252","08098","2020",2,2,0,91600,802.5,115
"2253","08099","2020",3,3,0,158000,1143.33333333333,136
"2254","08100","2020",1,1,0,132500,967,137
"2255","08101","2020",1,1,0,216000,1174,184
"2256","08103","2020",2,2,0,40495,954,59
"2257","08105","2020",518,228,290,109295.66988417,1271.16602316602,85.7181467181467
"2258","08107","2020",14,14,0,119803.571428571,1226.92857142857,96.7142857142857
"2259","08110","2020",1,1,0,130000,2167,60
"2260","08111","2020",6,6,0,216233.333333333,1712.16666666667,130.333333333333
"2261","08115","2020",1,1,0,232000,1856,125
"2262","08119","2020",2,2,0,207150,1803.5,121.5
"2263","08121","2020",2,2,0,128150,1345.5,99
"2264","08122","2020",11,11,0,136136.363636364,1095.90909090909,120.181818181818
"2265","08124","2020",1,1,0,192500,1346,143
"2266","08125","2020",4,4,0,198000,1702.5,121
"2267","08126","2020",3,3,0,128333.333333333,1392,94
"2268","08131","2020",3,3,0,42166.6666666667,495.333333333333,85.3333333333333
"2269","08132","2020",5,5,0,129000,1389.4,96.4
"2270","08133","2020",6,6,0,108100,1005.83333333333,104.5
"2271","08134","2020",1,1,0,195000,956,204
"2272","08135","2020",3,3,0,31000,513,59
"2273","08136","2020",4,4,0,146550,1448.25,103.5
"2274","08137","2020",6,6,0,186108.333333333,1565.66666666667,133.333333333333
"2275","08138","2020",2,2,0,124625,1070,117
"2276","08139","2020",10,10,0,76681.9,821,88.4
"2277","08140","2020",11,11,0,139785,1415.45454545455,103.272727272727
"2278","08141","2020",1,1,0,182500,849,215
"2279","08142","2020",15,14,1,151900,1540.33333333333,98.7333333333333
"2280","08145","2020",16,16,0,152831.25,1522.125,103.3125
"2281","08148","2020",2,2,0,211125,1468.5,146.5
"2282","08149","2020",3,3,0,70833.3333333333,732.666666666667,97.3333333333333
"2283","08150","2020",3,3,0,120666.666666667,784.666666666667,145.333333333333
"2284","08151","2020",2,2,0,116025,888,146
"2285","08153","2020",1,1,0,89000,742,120
"2286","08154","2020",2,2,0,174467.5,1067,159.5
"2287","08155","2020",1,1,0,102600,968,106
"2288","08156","2020",4,4,0,72500,562,126
"2289","08158","2020",3,3,0,122000,890.666666666667,144.666666666667
"2290","08159","2020",2,2,0,96000,821.5,107.5
"2291","08161","2020",1,1,0,75000,577,130
"2292","08162","2020",4,4,0,161825,1224.5,129
"2293","08164","2020",3,3,0,117333.333333333,1060.66666666667,118
"2294","08166","2020",1,1,0,83000,1509,55
"2295","08167","2020",1,1,0,58500,488,120
"2296","08168","2020",3,3,0,48666.6666666667,607.333333333333,77.6666666666667
"2297","08170","2020",1,1,0,227000,1465,155
"2298","08173","2020",22,22,0,142240.590909091,1499.36363636364,110.909090909091
"2299","08174","2020",22,22,0,117568.181818182,1240.09090909091,99.9090909090909
"2300","08175","2020",1,1,0,160000,1194,134
"2301","08179","2020",6,6,0,163433.333333333,1719.66666666667,106.333333333333
"2302","08180","2020",13,12,1,149834.615384615,1588.61538461538,92.9230769230769
"2303","08182","2020",1,1,0,114000,1027,111
"2304","08183","2020",12,12,0,125033.333333333,1283.16666666667,95.8333333333333
"2305","08185","2020",28,27,1,71765.5,933.071428571429,78.7142857142857
"2306","08186","2020",2,2,0,126000,1394.5,89.5
"2307","08187","2020",8,8,0,149900,1213.125,140.25
"2308","08188","2020",10,10,0,110850,923.7,124.7
"2309","08189","2020",2,2,0,96500,739,132
"2310","08190","2020",47,41,6,108021.276595745,1195.48936170213,94.3191489361702
"2311","08191","2020",9,9,0,164466.666666667,1533,115.222222222222
"2312","08193","2020",2,2,0,93500,1397.5,70
"2313","08194","2020",9,9,0,150500,1668,103.666666666667
"2314","08195","2020",8,8,0,119881.25,1088.125,115
"2315","08199","2020",3,3,0,80398.6666666667,694.666666666667,124
"2316","08200","2020",2,2,0,90000,925,97.5
"2317","08201","2020",1,1,0,170000,1405,121
"2318","08202","2020",2,2,0,85000,1003.5,88
"2319","08203","2020",2,2,0,144000,1340.5,105.5
"2320","08204","2020",3,3,0,63333.3333333333,769.666666666667,80
"2321","08206","2020",5,5,0,129300,1081.6,124.4
"2322","08207","2020",4,4,0,106250,1400,82.5
"2323","08208","2020",5,5,0,83600,746.2,105
"2324","08209","2020",3,3,0,154606.666666667,1030,162.666666666667
"2325","08210","2020",3,3,0,77400,806.333333333333,91
"2326","08211","2020",2,2,0,89500,1021,93
"2327","08212","2020",3,3,0,221983.333333333,1763.66666666667,129
"2328","08214","2020",3,3,0,130166.666666667,1078,140
"2329","08215","2020",1,1,0,60000,779,77
"2330","08216","2020",2,2,0,57500,913.5,74.5
"2331","08217","2020",4,4,0,61882,632.5,98.25
"2332","08218","2020",9,9,0,77594.4444444444,895.333333333333,92.5555555555556
"2333","08219","2020",2,2,0,82450,1229,71.5
"2334","08220","2020",6,6,0,144500,1251.33333333333,118
"2335","08222","2020",17,17,0,78350,883.470588235294,91
"2336","08223","2020",1,1,0,150000,1230,122
"2337","08225","2020",2,2,0,139725,1259.5,113
"2338","08226","2020",1,1,0,165000,1650,100
"2339","08228","2020",1,1,0,169000,1724,98
"2340","08229","2020",4,4,0,127825,1386.25,95
"2341","08230","2020",8,8,0,132947.375,1195.75,110.5
"2342","08232","2020",1,1,0,87500,941,93
"2343","08234","2020",4,4,0,108750,1187.25,91.75
"2344","08235","2020",4,4,0,134325,1128.25,120.5
"2345","08236","2020",4,4,0,174612.5,977,181.75
"2346","08237","2020",13,13,0,99506.9230769231,994.153846153846,98.3076923076923
"2347","08238","2020",2,2,0,90000,683,112.5
"2348","08239","2020",17,17,0,174152.941176471,1727.52941176471,105
"2349","08242","2020",5,5,0,53400,932.6,57
"2350","08243","2020",3,3,0,76666.6666666667,751.666666666667,114.666666666667
"2351","08244","2020",1,1,0,60000,750,80
"2352","08247","2020",1,1,0,131020,936,140
"2353","08248","2020",8,8,0,155075,1167.625,139.375
"2354","08249","2020",3,3,0,137966.666666667,1489,91.3333333333333
"2355","08250","2020",2,2,0,107000,633.5,162.5
"2356","08251","2020",1,1,0,35000,389,90
"2357","08252","2020",2,2,0,57500,1062,52
"2358","08254","2020",5,5,0,110400,1371.8,78.6
"2359","08255","2020",2,2,0,97500,1047.5,92.5
"2360","08259","2020",1,1,0,60000,789,76
"2361","08260","2020",2,2,0,78500,975.5,84.5
"2362","08262","2020",8,8,0,118486.25,1314.625,92.375
"2363","08263","2020",8,7,1,142875,1449.25,101.5
"2364","08264","2020",6,6,0,119025,1220.5,95.6666666666667
"2365","08269","2020",1,1,0,115000,871,132
"2366","08272","2020",2,2,0,98368,968.5,106
"2367","08273","2020",3,3,0,159966.666666667,1016.66666666667,156.666666666667
"2368","08275","2020",3,3,0,66666.6666666667,1023.33333333333,67.3333333333333
"2369","08276","2020",9,8,1,114427.777777778,997.222222222222,121.111111111111
"2370","08281","2020",5,5,0,129100,1280.6,98.6
"2371","08282","2020",17,17,0,105482.352941176,992.470588235294,111.588235294118
"2372","08284","2020",13,13,0,109307.692307692,980.692307692308,108
"2373","08286","2020",1,1,0,158000,1339,118
"2374","08287","2020",3,3,0,146716.666666667,1127.33333333333,122.333333333333
"2375","08289","2020",9,9,0,121596.666666667,1137.33333333333,118.333333333333
"2376","08291","2020",5,5,0,102800,1171.6,86.6
"2377","08293","2020",1,1,0,103000,736,140
"2378","08294","2020",1,1,0,192000,1714,112
"2379","08295","2020",2,2,0,172500,1656.5,100.5
"2380","08296","2020",2,2,0,67500,957,78.5
"2381","08297","2020",4,4,0,104500,1244.5,84.25
"2382","08298","2020",23,18,5,121773.913043478,1237.04347826087,97.6086956521739
"2383","08302","2020",22,22,0,118226.818181818,1134.22727272727,103.136363636364
"2384","08303","2020",6,6,0,89016.6666666667,951.333333333333,98.5
"2385","08304","2020",2,2,0,91605,596,154.5
"2386","08306","2020",2,2,0,128325,1156,105.5
"2387","08307","2020",1,1,0,40000,444,90
"2388","08311","2020",28,26,2,95343.6071428571,1044.64285714286,98.8214285714286
"2389","08312","2020",1,1,0,170000,1545,110
"2390","08313","2020",2,2,0,137000,1382,110
"2391","08314","2020",7,7,0,158714.285714286,1695.85714285714,93.8571428571429
"2392","08315","2020",1,1,0,150000,1250,120
"2393","08316","2020",18,18,0,91130.5555555556,1052.61111111111,87.4444444444444
"2394","08317","2020",2,1,1,1e+05,1298,72
"2395","08318","2020",4,4,0,111250,959.75,117.75
"2396","08319","2020",6,6,0,85223.3333333333,827.5,106.666666666667
"2397","08320","2020",6,6,0,163550,1217.66666666667,138.166666666667
"2398","08322","2020",4,4,0,153794,1219.75,131
"2399","08327","2020",12,11,1,128500,1490.91666666667,86.25
"2400","08328","2020",60,54,6,85891.4833333333,1036.98333333333,82.0166666666667
"2401","08330","2020",6,6,0,117276.666666667,1067,115.166666666667
"2402","08331","2020",10,10,0,108475,1240.2,90.3
"2403","08336","2020",2,2,0,127000,855.5,146.5
"2404","08338","2020",1,1,0,55000,821,67
"2405","08339","2020",4,4,0,145250,1170.5,134.25
"2406","08340","2020",3,3,0,68831.6666666667,730.333333333333,98.3333333333333
"2407","08341","2020",9,9,0,135777.777777778,981.222222222222,131
"2408","08342","2020",6,6,0,136479.166666667,1204.66666666667,110.166666666667
"2409","08343","2020",8,8,0,103956.75,1286.5,93.75
"2410","08344","2020",1,1,0,65000,867,75
"2411","08346","2020",9,9,0,176338.888888889,1692.66666666667,104.888888888889
"2412","08347","2020",2,2,0,100750,1710.5,60
"2413","08349","2020",7,7,0,96857.1428571429,903.714285714286,106.428571428571
"2414","08350","2020",2,2,0,35000,772.5,45.5
"2415","08351","2020",1,1,0,40000,519,77
"2416","08352","2020",1,1,0,60000,556,108
"2417","08353","2020",7,7,0,143627,1140,128.285714285714
"2418","08354","2020",12,12,0,128319.916666667,1108.16666666667,97.4166666666667
"2419","08355","2020",4,4,0,169075,1234,147.5
"2420","08356","2020",2,2,0,57500,505,105.5
"2421","08357","2020",9,9,0,123472.222222222,1509.66666666667,85.2222222222222
"2422","08358","2020",2,2,0,104085,677.5,145
"2423","08361","2020",16,14,2,99037.375,1013.1875,96.625
"2424","08362","2020",76,56,20,121275.434210526,1529.51315789474,85.6710526315789
"2425","08363","2020",60,57,3,65215,764.7,82.6833333333333
"2426","08364","2020",1,1,0,125000,781,160
"2427","08365","2020",12,12,0,144808.333333333,1234.41666666667,125.916666666667
"2428","08366","2020",11,11,0,92815,1020.54545454545,100.636363636364
"2429","08367","2020",21,20,1,125724.904761905,1278,98.3333333333333
"2430","08368","2020",2,2,0,123000,1198.5,107.5
"2431","08370","2020",4,4,0,138250,1374.25,100.75
"2432","08373","2020",5,5,0,99300,796,150.6
"2433","08374","2020",1,1,0,75585,1035,73
"2434","08376","2020",4,4,0,134225,1061,133
"2435","08379","2020",2,2,0,144000,1208,123
"2436","08380","2020",1,1,0,209000,1393,150
"2437","08381","2020",11,11,0,137554.545454545,1282.45454545455,118.727272727273
"2438","08383","2020",1,1,0,85000,944,90
"2439","08384","2020",2,2,0,99500,1266,81.5
"2440","08385","2020",8,7,1,138137.5,1441.125,98.25
"2441","08388","2020",8,8,0,184840,1448.875,134.625
"2442","08389","2020",4,4,0,189325,1913.5,115.75
"2443","08391","2020",13,13,0,88100,947,96.1538461538462
"2444","08392","2020",1,1,0,95000,477,199
"2445","08393","2020",1,1,0,170000,1382,123
"2446","08395","2020",4,4,0,133997.75,1182.5,113.5
"2447","08396","2020",1,1,0,222000,1067,208
"2448","08398","2020",1,1,0,105000,929,113
"2449","08399","2020",5,5,0,67753,900.4,88.8
"2450","08400","2020",5,5,0,116200,1376.6,96.6
"2451","08402","2020",5,5,0,90036,1088.4,98.4
"2452","08403","2020",17,17,0,128982.352941176,1444.88235294118,89
"2453","08405","2020",4,4,0,129125,1315.75,103
"2454","08406","2020",6,6,0,134400,1088.16666666667,129.333333333333
"2455","08408","2020",2,2,0,134500,1452.5,92.5
"2456","08409","2020",183,90,93,92948.9617486339,1068.98907103825,87.0765027322404
"2457","08410","2020",2,2,0,264820,1105.5,238
"2458","08413","2020",2,2,0,97125,862,115
"2459","08415","2020",7,7,0,93928.5714285714,790.285714285714,120.285714285714
"2460","08417","2020",1,1,0,50000,667,75
"2461","08418","2020",5,5,0,117770,1026,118
"2462","08419","2020",14,14,0,89052.8571428571,977.428571428571,90.8571428571429
"2463","08420","2020",8,8,0,97125,1019.375,94.5
"2464","08422","2020",3,3,0,104578.666666667,1033.66666666667,120
"2465","08425","2020",1,1,0,108000,422,256
"2466","08426","2020",1,1,0,1e+05,781,128
"2467","08428","2020",1,1,0,89962,1022,88
"2468","08429","2020",3,3,0,154250,1272,115.333333333333
"2469","08433","2020",2,2,0,142500,732,197
"2470","08434","2020",1,1,0,110000,710,155
"2471","08435","2020",9,9,0,151400,1477.55555555556,98.8888888888889
"2472","08436","2020",3,3,0,195000,1298.66666666667,147.333333333333
"2473","08437","2020",1,1,0,88570,1107,80
"2474","08438","2020",4,4,0,137475,1394.5,101
"2475","08439","2020",1,1,0,150000,1103,136
"2476","08444","2020",2,2,0,61500,702.5,90
"2477","08445","2020",5,5,0,100200,1169.8,92.2
"2478","08446","2020",1,1,0,93200,630,148
"2479","08448","2020",11,11,0,61045.4545454545,714.272727272727,84.6363636363636
"2480","08449","2020",10,10,0,128141.7,1066.1,136.4
"2481","08450","2020",2,2,0,123150,1254.5,110.5
"2482","08451","2020",2,1,1,56000,742,75
"2483","08452","2020",2,2,0,85000,1431,60
"2484","08453","2020",2,2,0,55000,598,92
"2485","08454","2020",2,2,0,84850,1085.5,78
"2486","08456","2020",3,3,0,160333.333333333,1534.33333333333,110
"2487","08457","2020",4,4,0,224850,1647.5,136.25
"2488","08458","2020",6,6,0,95000,1204,80.6666666666667
"2489","08459","2020",2,2,0,85000,1085,75
"2490","08460","2020",1,1,0,120000,750,160
"2491","08461","2020",1,1,0,1e+05,926,108
"2492","08463","2020",1,1,0,1e+05,1000,100
"2493","08465","2020",3,3,0,136333.333333333,1161.66666666667,121
"2494","08468","2020",2,2,0,106250,1463.5,77
"2495","08469","2020",4,4,0,175725,1525.25,130.75
"2496","08473","2020",6,6,0,126500,1327.83333333333,95.8333333333333
"2497","08476","2020",5,5,0,141820,1530.8,93.8
"2498","08477","2020",3,3,0,116800,1275,89
"2499","08478","2020",1,1,0,137000,1007,136
"2500","08480","2020",31,31,0,129902.419354839,1476.22580645161,91.0967741935484
"2501","08481","2020",1,1,0,45000,500,90
"2502","08482","2020",1,1,0,130000,850,153
"2503","08483","2020",5,3,2,118000,1023.8,121.2
"2504","08484","2020",1,1,0,167500,1675,100
"2505","08485","2020",1,1,0,184000,1804,102
"2506","08486","2020",20,20,0,77350.25,899.4,87.55
"2507","08487","2020",22,22,0,142001.318181818,1600.27272727273,99.8636363636364
"2508","08488","2020",21,19,2,121604.761904762,1207.71428571429,99.3809523809524
"2509","08490","2020",30,26,4,98682.1666666667,1091.6,94.0333333333333
"2510","08491","2020",25,25,0,120741.8,1224.8,100.6
"2511","08494","2020",6,6,0,118166.666666667,1399.83333333333,88
"2512","08497","2020",18,18,0,148270.833333333,1632.55555555556,91.3333333333333
"2513","08498","2020",4,4,0,152400,1349,116.25
"2514","08503","2020",2,2,0,112500,1126,98.5
"2515","09002","2020",10,10,0,196745.9,1624.9,124.3
"2516","09003","2020",7,7,0,97714.2857142857,851.857142857143,117.714285714286
"2517","09004","2020",3,3,0,130333.333333333,1110,115.666666666667
"2518","09005","2020",3,3,0,68698.6666666667,967,72.6666666666667
"2519","09006","2020",1,1,0,119000,2644,45
"2520","09008","2020",3,3,0,43050,931,54
"2521","09009","2020",2,2,0,156960.5,1334.5,116
"2522","09011","2020",2,2,0,93725,1115.5,72
"2523","09012","2020",1,1,0,90000,849,106
"2524","09013","2020",1,1,0,249000,2128,117
"2525","09014","2020",4,4,0,130716.25,1361.25,92.5
"2526","09015","2020",3,3,0,94500,1397,80.6666666666667
"2527","09016","2020",1,1,0,106500,1299,82
"2528","09017","2020",6,6,0,109262.166666667,1259.16666666667,95.1666666666667
"2529","09018","2020",2,2,0,210000,3829,58
"2530","09019","2020",9,9,0,125777.777777778,870.444444444444,136.888888888889
"2531","09020","2020",1,1,0,135000,1534,88
"2532","09021","2020",1,1,0,155000,1314,118
"2533","09022","2020",6,6,0,172166.666666667,1630.16666666667,106
"2534","09023","2020",4,4,0,81225,1052.75,81.5
"2535","09024","2020",3,3,0,146000,1737,84
"2536","09025","2020",1,1,0,389114,2027,192
"2537","09027","2020",4,4,0,63500,917.25,75.5
"2538","09029","2020",12,2,10,45776.8333333333,993.166666666667,52.6666666666667
"2539","09030","2020",9,9,0,108192.222222222,1256.55555555556,88.6666666666667
"2540","09032","2020",104,24,80,102636.903846154,2078.79807692308,58.0096153846154
"2541","09033","2020",2,2,0,162500,1487,108
"2542","09034","2020",3,3,0,116666.666666667,2162.66666666667,56.3333333333333
"2543","09035","2020",2,2,0,135500,1433.5,105
"2544","09038","2020",8,8,0,102464.5,969.25,104.75
"2545","09039","2020",1,1,0,59250,823,72
"2546","09040","2020",2,2,0,86500,783,114
"2547","09041","2020",4,4,0,170775,1253.75,133.75
"2548","09042","2020",13,13,0,120923.076923077,1233.38461538462,112.384615384615
"2549","09043","2020",11,10,1,92790.9090909091,1038.09090909091,89.2727272727273
"2550","09044","2020",4,4,0,184225,1598.25,114.5
"2551","09045","2020",3,3,0,100275,984.333333333333,101.666666666667
"2552","09046","2020",3,3,0,141000,1294.33333333333,110.333333333333
"2553","09047","2020",21,21,0,88729.0476190476,903.142857142857,92.1904761904762
"2554","09049","2020",2,2,0,107200,1815,59.5
"2555","09050","2020",4,3,1,180675,1306.25,143.75
"2556","09051","2020",1,1,0,190000,1357,140
"2557","09052","2020",3,3,0,240696.666666667,1368.33333333333,192.333333333333
"2558","09054","2020",8,8,0,103762.5,1223.375,106.625
"2559","09055","2020",7,7,0,61585.7142857143,1352.57142857143,45
"2560","09056","2020",5,5,0,166911,1140.4,153
"2561","09057","2020",12,12,0,115663.416666667,1496.08333333333,81.9166666666667
"2562","09058","2020",2,2,0,188875,1505,125.5
"2563","09059","2020",6,6,0,67508.3333333333,975.333333333333,77.6666666666667
"2564","09060","2020",7,7,0,144714.857142857,1323.85714285714,112
"2565","09061","2020",17,17,0,66576.4705882353,910.764705882353,77.2352941176471
"2566","09062","2020",5,5,0,56600,816.2,77.8
"2567","09063","2020",2,2,0,120000,988.5,107.5
"2568","09065","2020",14,14,0,86892.1428571429,1517.14285714286,65.2142857142857
"2569","09066","2020",10,10,0,98750,1042.3,95.1
"2570","09067","2020",3,3,0,203300,1282.33333333333,153
"2571","09070","2020",7,7,0,150664.285714286,1719.42857142857,99
"2572","09071","2020",2,2,0,126100,1055,115
"2573","09072","2020",1,1,0,50000,833,60
"2574","09073","2020",2,2,0,66000,464,144.5
"2575","09074","2020",3,3,0,104003.333333333,1574,63.6666666666667
"2576","09075","2020",9,9,0,105603.333333333,1618.22222222222,77
"2577","09076","2020",3,3,0,118333.333333333,1263,84
"2578","09077","2020",3,3,0,103000,1566.66666666667,67.6666666666667
"2579","09078","2020",3,3,0,71000,990,69.6666666666667
"2580","09079","2020",12,12,0,213474.166666667,1730.25,123.916666666667
"2581","09080","2020",3,3,0,106766.666666667,996,98
"2582","09081","2020",3,3,0,134964.666666667,847.666666666667,157
"2583","09082","2020",8,7,1,107187.5,1130.125,92.25
"2584","09084","2020",1,1,0,157000,1670,94
"2585","09085","2020",11,9,2,90818.1818181818,1031.81818181818,83.6363636363636
"2586","09091","2020",3,3,0,134956.666666667,1737,81.6666666666667
"2587","09092","2020",2,2,0,50000,760,66
"2588","09093","2020",3,3,0,52333.3333333333,765,69.6666666666667
"2589","09094","2020",6,6,0,124016.666666667,1115.5,110.5
"2590","09095","2020",3,3,0,89000,1085,82
"2591","09096","2020",2,2,0,64770.5,816,100
"2592","09097","2020",2,2,0,132500,1771,76
"2593","09099","2020",6,6,0,174515,1532.33333333333,113
"2594","09100","2020",6,4,2,47883.8333333333,788.166666666667,59.1666666666667
"2595","09101","2020",4,4,0,140500,1565.25,98.5
"2596","09102","2020",1,1,0,420000,1469,286
"2597","09103","2020",11,11,0,180809.454545455,1713,107.181818181818
"2598","09104","2020",11,11,0,149517.272727273,1680.18181818182,92.1818181818182
"2599","09105","2020",13,13,0,82476.9230769231,1076.07692307692,74.9230769230769
"2600","09106","2020",2,2,0,146000,1286.5,113.5
"2601","09107","2020",7,7,0,84102.8571428571,1164,77.2857142857143
"2602","09108","2020",4,4,0,80500,1072,82.5
"2603","09109","2020",2,2,0,112500,977.5,114
"2604","09110","2020",1,1,0,102600,1127,91
"2605","09111","2020",7,7,0,77361.4285714286,982.714285714286,87.8571428571429
"2606","09113","2020",7,7,0,105392.857142857,2176.71428571429,54.8571428571429
"2607","09114","2020",5,5,0,137790,1670.4,73
"2608","09116","2020",4,4,0,144355.75,1101.75,128.5
"2609","09117","2020",1,1,0,210000,1400,150
"2610","09118","2020",4,4,0,80500,1115.75,69.5
"2611","09119","2020",3,3,0,63666.6666666667,974.333333333333,68.3333333333333
"2612","09120","2020",4,4,0,183530.5,1582.75,157.25
"2613","09121","2020",13,13,0,136978.461538462,1782.84615384615,83.5384615384615
"2614","09122","2020",184,106,78,114549.434782609,1401.36413043478,83.6576086956522
"2615","09124","2020",12,11,1,98943.75,1308.75,73.75
"2616","09125","2020",4,4,0,116125,788.75,127.25
"2617","09126","2020",3,3,0,45000,723,62
"2618","09128","2020",3,3,0,151500,1268.33333333333,118
"2619","09129","2020",1,1,0,125000,2155,58
"2620","09130","2020",13,13,0,176136.384615385,1443.38461538462,115.153846153846
"2621","09131","2020",2,2,0,57720,784,85
"2622","09132","2020",2,2,0,217801.5,1920,106.5
"2623","09133","2020",1,1,0,70000,1750,40
"2624","09134","2020",1,1,0,65000,812,80
"2625","09136","2020",2,2,0,96500,1217,76.5
"2626","09137","2020",1,1,0,158000,1646,96
"2627","09138","2020",1,1,0,160000,2667,60
"2628","09139","2020",4,0,4,71375,1073.25,76.5
"2629","09140","2020",4,4,0,316110.75,2998.75,101.5
"2630","09141","2020",2,2,0,80000,992.5,78
"2631","09142","2020",1,1,0,81000,976,83
"2632","09145","2020",2,2,0,154200,1051,125
"2633","09146","2020",1,1,0,75000,2500,30
"2634","09147","2020",3,3,0,169423.333333333,1407,114.666666666667
"2635","09149","2020",2,2,0,73700,1938.5,55.5
"2636","09150","2020",3,3,0,146666.666666667,1139,124.666666666667
"2637","09151","2020",1,1,0,601000,2946,204
"2638","09152","2020",1,1,0,87420,857,102
"2639","09153","2020",3,3,0,129333.333333333,1661,96.3333333333333
"2640","09154","2020",2,2,0,122500,1047.5,117
"2641","09155","2020",3,3,0,80563.3333333333,1409.33333333333,54.6666666666667
"2642","09157","2020",34,32,2,97918.0882352941,1030.35294117647,95.8823529411765
"2643","09158","2020",5,5,0,122000,1235,99
"2644","09159","2020",4,3,1,126750,1302,97.25
"2645","09160","2020",72,66,6,89212.6388888889,959.055555555556,96.7638888888889
"2646","09161","2020",7,7,0,136142.857142857,1244.14285714286,100.857142857143
"2647","09162","2020",3,3,0,74150,1077.66666666667,74.6666666666667
"2648","09164","2020",6,6,0,218491.666666667,1534.83333333333,131.166666666667
"2649","09165","2020",6,5,1,83750,1062.5,88.3333333333333
"2650","09166","2020",1,1,0,106000,1395,76
"2651","09167","2020",31,30,1,153683.225806452,1526.87096774194,108.193548387097
"2652","09168","2020",5,5,0,96308,1017.2,89.8
"2653","09170","2020",3,3,0,156433.333333333,1278.33333333333,109
"2654","09171","2020",1,1,0,290000,1706,170
"2655","09172","2020",1,1,0,347665,2575,135
"2656","09173","2020",3,3,0,238333.333333333,1034.33333333333,204
"2657","09174","2020",5,5,0,198280,1927,100.2
"2658","09175","2020",1,1,0,311000,1757,177
"2659","09176","2020",7,6,1,68185.7142857143,922.428571428571,72.5714285714286
"2660","09177","2020",2,2,0,121900,1424,82
"2661","09178","2020",3,3,0,156100,1724.33333333333,100
"2662","09179","2020",1,1,0,124000,1240,100
"2663","09180","2020",6,6,0,190750,1621.16666666667,117.5
"2664","09181","2020",19,18,1,92447.8947368421,1184.31578947368,78.4210526315789
"2665","09182","2020",19,17,2,58820,805.052631578947,72.6842105263158
"2666","09185","2020",70,60,10,132910.628571429,1465.08571428571,89.7
"2667","09187","2020",6,6,0,184384.333333333,1400.33333333333,128.666666666667
"2668","09188","2020",12,12,0,91356.6666666667,1083.5,85.25
"2669","09189","2020",3,2,1,93366.6666666667,843.333333333333,92
"2670","09190","2020",2,2,0,40000,694.5,67.5
"2671","09192","2020",1,1,0,136000,1308,104
"2672","09193","2020",4,4,0,57925,964.5,58.75
"2673","09194","2020",53,46,7,156001.358490566,1535.54716981132,98.6981132075472
"2674","09195","2020",2,2,0,238000,3016,75
"2675","09196","2020",1,1,0,65000,691,94
"2676","09197","2020",1,1,0,190000,1056,180
"2677","09198","2020",5,5,0,119367,1378,90
"2678","09199","2020",13,13,0,127315.384615385,1176.30769230769,107.769230769231
"2679","09200","2020",3,3,0,256000,1982.33333333333,142
"2680","09202","2020",3,3,0,134570,967.666666666667,134
"2681","09203","2020",5,5,0,301298,3787,89
"2682","09205","2020",1,1,0,80000,650,123
"2683","09206","2020",17,14,3,81345.1764705882,1510.17647058824,68.8235294117647
"2684","09207","2020",23,21,2,160650.913043478,1664.82608695652,96.1304347826087
"2685","09209","2020",7,7,0,152610,1332.71428571429,116.714285714286
"2686","09210","2020",7,7,0,147642.857142857,1557,94
"2687","09211","2020",2,2,0,62000,1058.5,64.5
"2688","09212","2020",3,3,0,98900,857.666666666667,108.666666666667
"2689","09213","2020",3,3,0,131116.666666667,1089,157.333333333333
"2690","09214","2020",16,16,0,130256.25,1398.1875,88.9375
"2691","09215","2020",3,3,0,90333.3333333333,1173.66666666667,78.6666666666667
"2692","09216","2020",1,1,0,302500,2542,119
"2693","09217","2020",4,4,0,109675,1517.75,75.25
"2694","09218","2020",1,1,0,131600,1755,75
"2695","09219","2020",3,3,0,75166.6666666667,1149.33333333333,65
"2696","09220","2020",3,3,0,113333.333333333,1385.66666666667,85.6666666666667
"2697","09221","2020",2,2,0,61500,618.5,100.5
"2698","09223","2020",9,9,0,111388.333333333,1313.11111111111,88.6666666666667
"2699","09224","2020",12,12,0,126306.083333333,1710.33333333333,79.5833333333333
"2700","09225","2020",281,177,104,112660.501779359,1370.20640569395,81.4056939501779
"2701","09226","2020",1,1,0,111400,1311,85
"2702","09227","2020",1,1,0,81600,692,118
"2703","09228","2020",2,2,0,125000,1088.5,124
"2704","09229","2020",4,4,0,116250,1260.25,102.25
"2705","09230","2020",6,6,0,87748.3333333333,972.666666666667,106.833333333333
"2706","09231","2020",13,13,0,65286.9230769231,1218.53846153846,55.9230769230769
"2707","09232","2020",1,1,0,71250,432,165
"2708","09233","2020",1,1,0,351295,3585,98
"2709","09234","2020",1,1,0,38000,1056,36
"2710","09235","2020",7,7,0,115428.571428571,1284.28571428571,92.4285714285714
"2711","09236","2020",5,5,0,139120,1318.2,103
"2712","09237","2020",1,1,0,163500,2151,76
"2713","09238","2020",8,8,0,243793.125,1627.5,159.75
"2714","09239","2020",12,12,0,106145.833333333,1352.75,77.1666666666667
"2715","09240","2020",3,3,0,130160,1477.66666666667,86.6666666666667
"2716","09241","2020",5,5,0,147064,1357.8,113.2
"2717","09242","2020",1,1,0,125000,984,127
"2718","09243","2020",1,1,0,75700,1097,69
"2719","09244","2020",12,12,0,137066.666666667,1511.5,101.5
"2720","09245","2020",11,11,0,188845.454545455,1508.27272727273,122.636363636364
"2721","09246","2020",13,13,0,107048.846153846,1096.38461538462,108.076923076923
"2722","09247","2020",6,6,0,79331.6666666667,1043.5,85
"2723","09249","2020",4,4,0,152137.5,2261.75,113.25
"2724","09251","2020",2,2,0,429325,3217,127.5
"2725","09252","2020",1,1,0,35000,625,56
"2726","09253","2020",5,5,0,65650,968.6,77.2
"2727","09254","2020",2,2,0,95000,1170,78
"2728","09255","2020",1,1,0,133000,739,180
"2729","09256","2020",1,1,0,120000,1579,76
"2730","09257","2020",9,9,0,114788.888888889,1470.33333333333,80.8888888888889
"2731","09258","2020",7,7,0,164436.285714286,1713.85714285714,107.571428571429
"2732","09261","2020",101,84,17,125103.96039604,1405.11881188119,92.970297029703
"2733","09262","2020",4,4,0,63025,754.5,82.5
"2734","09263","2020",1,1,0,35000,515,68
"2735","09264","2020",18,18,0,146748.666666667,1549.22222222222,97.1111111111111
"2736","09265","2020",31,22,9,125253.677419355,1420.29032258065,91.5806451612903
"2737","09267","2020",6,6,0,83617.5,1550.83333333333,56.5
"2738","09268","2020",18,18,0,150141.666666667,1504.66666666667,99.5555555555556
"2739","09269","2020",4,4,0,175550,1893.25,104.25
"2740","09270","2020",3,3,0,219500,1758,133.333333333333
"2741","09271","2020",1,1,0,43000,524,82
"2742","09272","2020",23,23,0,121342.173913043,1409.47826086957,91.0434782608696
"2743","09273","2020",5,5,0,188470,1637,121.2
"2744","09274","2020",10,10,0,139040,1270.7,107.2
"2745","09275","2020",5,5,0,145400,1441.6,103.4
"2746","09276","2020",3,3,0,206666.666666667,1607.66666666667,127
"2747","09277","2020",8,8,0,139920,1665.875,94.375
"2748","09280","2020",20,20,0,95190.5,1254.5,87.9
"2749","09281","2020",1,1,0,175000,1182,148
"2750","09282","2020",68,58,10,153613.897058824,1522.60294117647,102.544117647059
"2751","09283","2020",6,4,2,164806.333333333,1735.83333333333,97
"2752","09284","2020",1,1,0,60000,545,110
"2753","09285","2020",20,20,0,101003,1328.65,78.35
"2754","09287","2020",2,2,0,92750,1160.5,79
"2755","09289","2020",6,6,0,113060.833333333,1208,105.833333333333
"2756","09290","2020",8,8,0,86895.625,1469.875,54.125
"2757","09291","2020",5,5,0,94344,1880,56.2
"2758","09292","2020",2,2,0,47000,694,69.5
"2759","09293","2020",10,10,0,135272,1213.6,107.5
"2760","09294","2020",1,1,0,96296,1204,80
"2761","09295","2020",6,6,0,55029.3333333333,1338.5,55.8333333333333
"2762","09296","2020",3,3,0,60333.3333333333,1192.33333333333,75.3333333333333
"2763","09298","2020",2,1,1,37500,856.5,44
"2764","09299","2020",9,9,0,80436.3333333333,1166.66666666667,66.1111111111111
"2765","09300","2020",2,2,0,167550,2378,75
"2766","09301","2020",7,7,0,68071.4285714286,1013,66.1428571428571
"2767","09303","2020",4,4,0,180450,3238.25,81
"2768","09305","2020",3,3,0,91833.3333333333,1129,80.3333333333333
"2769","09306","2020",33,27,6,110860.909090909,1187.78787878788,100
"2770","09307","2020",1,1,0,220000,2857,77
"2771","09308","2020",2,2,0,252550,1397.5,162.5
"2772","09309","2020",2,2,0,108000,1132.5,97.5
"2773","09311","2020",1,1,0,1e+05,1250,80
"2774","09312","2020",35,34,1,178966.857142857,1840.05714285714,99.3142857142857
"2775","09313","2020",1,1,0,74000,987,75
"2776","09315","2020",1,1,0,70000,1400,50
"2777","09316","2020",1,1,0,189000,950,199
"2778","09318","2020",1,1,0,45000,643,70
"2779","09319","2020",2,2,0,256000,2211,105
"2780","09321","2020",5,2,3,52043,1009,49.2
"2781","09322","2020",49,40,9,91936.5714285714,1676.38775510204,56.6734693877551
"2782","09324","2020",48,48,0,163367.229166667,1614.89583333333,101.5
"2783","09325","2020",2,2,0,64740,830,76
"2784","09327","2020",2,2,0,118900,769.5,125
"2785","09328","2020",7,7,0,146928.571428571,1438.71428571429,103.714285714286
"2786","09329","2020",15,15,0,148657.666666667,1606,91.6666666666667
"2787","09331","2020",8,8,0,139625,1845,77.125
"2788","09332","2020",38,37,1,159577.631578947,1512.36842105263,113.368421052632
"2789","09334","2020",16,16,0,72357.625,1024.9375,75.625
"2790","09336","2020",12,12,0,112900.833333333,1083.33333333333,107.416666666667
"2791","09338","2020",2,2,0,192500,1781,109.5
"2792","09339","2020",8,8,0,135881.25,1174.75,106.25
"2793","09340","2020",2,2,0,168300,1767.5,95
"2794","09341","2020",2,2,0,113650,1399,86
"2795","09342","2020",5,5,0,164760,1471.2,104.8
"2796","10003","2020",62,62,0,115322.822580645,1248.70967741935,95.2741935483871
"2797","10004","2020",1,1,0,25400,397,64
"2798","10005","2020",6,6,0,122500,1274.5,117.166666666667
"2799","10006","2020",36,28,8,111188.916666667,1216.25,88.8888888888889
"2800","10007","2020",2,2,0,45000,469,90
"2801","10008","2020",1,1,0,1e+05,1031,97
"2802","10011","2020",3,3,0,110000,925.333333333333,104.666666666667
"2803","10012","2020",3,3,0,161666.666666667,1496.66666666667,105
"2804","10013","2020",3,3,0,146750,1108.66666666667,130.333333333333
"2805","10014","2020",2,2,0,183250,1382,133
"2806","10015","2020",8,8,0,192625,1780.375,109.875
"2807","10017","2020",1,1,0,71000,1224,58
"2808","10018","2020",13,13,0,140000,1040.30769230769,135.615384615385
"2809","10019","2020",2,2,0,88000,1123.5,81
"2810","10020","2020",4,4,0,131250,1325.5,100.5
"2811","10021","2020",2,2,0,78000,745,111.5
"2812","10022","2020",1,1,0,57500,737,78
"2813","10023","2020",6,6,0,91500,1072.16666666667,85.8333333333333
"2814","10024","2020",1,1,0,129000,992,130
"2815","10025","2020",1,1,0,105500,1055,100
"2816","10026","2020",1,1,0,65000,663,98
"2817","10027","2020",1,1,0,55000,743,74
"2818","10028","2020",3,3,0,135166.666666667,1113.66666666667,129
"2819","10029","2020",2,2,0,103550,916,109
"2820","10030","2020",13,11,2,175380,1903.84615384615,93.2307692307692
"2821","10031","2020",13,13,0,120123.076923077,1386,89.3846153846154
"2822","10032","2020",2,2,0,144500,870,163
"2823","10033","2020",45,30,15,85985.5555555556,1025.22222222222,87.4888888888889
"2824","10034","2020",24,18,6,108125,1066.16666666667,100.916666666667
"2825","10035","2020",13,13,0,81388.4615384615,836,97
"2826","10037","2020",9,9,0,151566.666666667,1410.66666666667,108
"2827","10038","2020",6,6,0,111100.333333333,1007.5,108.333333333333
"2828","10040","2020",2,2,0,70000,849.5,80
"2829","10042","2020",8,8,0,96437.5,900.125,113.5
"2830","10043","2020",1,1,0,98800,1176,84
"2831","10045","2020",2,2,0,78000,1072.5,68.5
"2832","10046","2020",1,1,0,130000,1444,90
"2833","10048","2020",2,2,0,85000,596.5,153.5
"2834","10049","2020",4,4,0,183387.5,1522.25,128.5
"2835","10050","2020",2,2,0,118000,1045,110
"2836","10051","2020",14,14,0,163810.714285714,1735.07142857143,93.3571428571429
"2837","10052","2020",5,5,0,112520,1221.4,97.4
"2838","10053","2020",5,5,0,180000,2014.6,90
"2839","10054","2020",7,7,0,141571.428571429,1043.71428571429,133.571428571429
"2840","10055","2020",6,6,0,127650,1182.66666666667,109.5
"2841","10056","2020",2,2,0,185000,1432.5,131.5
"2842","10058","2020",3,3,0,79700,890.333333333333,84.6666666666667
"2843","10059","2020",2,2,0,80000,789.5,100.5
"2844","10060","2020",27,26,1,198190.740740741,1829.44444444444,110.296296296296
"2845","10061","2020",1,1,0,88966,649,137
"2846","10062","2020",5,5,0,118000,1172.6,97.6
"2847","10063","2020",5,5,0,126000,1057.4,117.2
"2848","10065","2020",1,1,0,27000,386,70
"2849","10066","2020",4,4,0,201825,1922.75,114
"2850","10067","2020",21,15,6,199716.476190476,1978.04761904762,116.380952380952
"2851","10068","2020",1,1,0,135000,1957,69
"2852","10069","2020",1,1,0,125000,893,140
"2853","10070","2020",3,3,0,265833.333333333,2484.33333333333,98.6666666666667
"2854","10071","2020",1,1,0,120000,755,159
"2855","10073","2020",2,2,0,129000,878,146.5
"2856","10074","2020",6,6,0,103916.666666667,1351.16666666667,81.8333333333333
"2857","10076","2020",3,3,0,96333.3333333333,802,136.666666666667
"2858","10077","2020",2,2,0,107500,1051,100
"2859","10080","2020",5,5,0,92000,1221,81.4
"2860","10081","2020",107,36,71,98678.3644859813,1361.31775700935,69.5607476635514
"2861","10083","2020",4,4,0,256000,1507.5,161.25
"2862","10084","2020",19,19,0,167693,1390.78947368421,117.842105263158
"2863","10085","2020",1,1,0,207000,1344,154
"2864","10086","2020",6,6,0,141000,1306.5,116.666666666667
"2865","10089","2020",10,10,0,148082.8,1305.4,119.4
"2866","10090","2020",4,4,0,242687.75,1766.5,145
"2867","10091","2020",2,2,0,163500,1122,150
"2868","10092","2020",1,1,0,135500,1652,82
"2869","10093","2020",1,1,0,40000,471,85
"2870","10094","2020",7,7,0,87992.8571428571,741.571428571429,119
"2871","10095","2020",3,3,0,138100,1203.66666666667,114.666666666667
"2872","10096","2020",9,9,0,129788.888888889,1275.44444444444,105.111111111111
"2873","10097","2020",2,2,0,44625,682.5,68.5
"2874","10098","2020",6,6,0,85333.3333333333,902.333333333333,94.5
"2875","10099","2020",7,7,0,152142.857142857,1289.85714285714,120.142857142857
"2876","10100","2020",20,20,0,162823.3,1847.25,93.5
"2877","10101","2020",2,2,0,87650,907,104
"2878","10102","2020",2,2,0,169325,1093,147.5
"2879","10103","2020",1,1,0,150000,1429,105
"2880","10104","2020",7,7,0,152428.571428571,1573.42857142857,97.4285714285714
"2881","10105","2020",1,1,0,122300,679,180
"2882","10106","2020",1,1,0,77000,1100,70
"2883","10109","2020",2,2,0,202300,1215.5,166.5
"2884","10110","2020",6,6,0,200119,2178.5,107.166666666667
"2885","10112","2020",4,4,0,100700,949.75,100.75
"2886","10113","2020",1,1,0,225000,1991,113
"2887","10114","2020",14,14,0,94678.5714285714,932.785714285714,98.8571428571429
"2888","10115","2020",17,17,0,216720,1872.88235294118,117.882352941176
"2889","10116","2020",4,4,0,130962.5,1027.75,127
"2890","10118","2020",2,2,0,67500,741,92.5
"2891","10119","2020",8,7,1,83062.5,742,113.75
"2892","10120","2020",1,1,0,66000,695,95
"2893","10122","2020",3,3,0,107000,1154.66666666667,90
"2894","10123","2020",9,7,2,104422.222222222,1147.66666666667,97.7777777777778
"2895","10124","2020",4,4,0,144875,1379,109.75
"2896","10125","2020",4,4,0,161250,1341.75,130
"2897","10129","2020",3,3,0,235166.666666667,1952.33333333333,123
"2898","10130","2020",2,2,0,197500,1217.5,175
"2899","10131","2020",2,2,0,231000,1430.5,159.5
"2900","10132","2020",2,2,0,142500,1503,112
"2901","10133","2020",4,4,0,141625,1347.5,109.5
"2902","10135","2020",1,1,0,235000,1224,192
"2903","10136","2020",1,1,0,65000,1413,46
"2904","10138","2020",2,2,0,92250,786,93
"2905","10139","2020",4,4,0,134500,1186,110.25
"2906","10140","2020",17,17,0,130491.352941176,1219.52941176471,108.705882352941
"2907","10141","2020",6,5,1,141608.333333333,1280.33333333333,118.166666666667
"2908","10142","2020",23,22,1,134404.695652174,1220.04347826087,110.217391304348
"2909","10143","2020",3,3,0,61666.6666666667,664,90
"2910","10144","2020",2,2,0,77500,1124,78.5
"2911","10145","2020",4,4,0,93250,1179.75,78
"2912","10146","2020",4,4,0,140612.5,1341.25,100.75
"2913","10147","2020",5,5,0,165240,1418,126.6
"2914","10148","2020",2,2,0,84000,510,155
"2915","10149","2020",3,3,0,194023.333333333,1643.33333333333,118.333333333333
"2916","10150","2020",1,1,0,55000,598,92
"2917","10151","2020",4,4,0,123000,1541.75,81.5
"2918","10153","2020",8,8,0,184840.625,1909.75,111
"2919","10155","2020",3,3,0,128333.333333333,941.333333333333,134.333333333333
"2920","10156","2020",9,9,0,160322.222222222,1598.88888888889,101
"2921","10157","2020",2,2,0,117000,1008,116.5
"2922","10158","2020",9,9,0,171555.555555556,1399.88888888889,118.222222222222
"2923","10159","2020",2,2,0,170500,1353.5,125
"2924","10162","2020",4,4,0,152627.5,1330.75,113.75
"2925","10164","2020",4,4,0,108250,833.5,127.75
"2926","10165","2020",2,2,0,180000,1315,143.5
"2927","10166","2020",6,6,0,127300,1045.83333333333,134.166666666667
"2928","10167","2020",1,1,0,70000,422,166
"2929","10168","2020",2,2,0,244500,991.5,233
"2930","10169","2020",2,2,0,145125,1652,88
"2931","10170","2020",7,7,0,113000,1058.42857142857,108
"2932","10171","2020",4,4,0,78500,874,97.25
"2933","10172","2020",4,4,0,136250,1570,88.25
"2934","10173","2020",5,4,1,163994,1265.2,119.4
"2935","10174","2020",3,2,1,69833.3333333333,944.666666666667,76.3333333333333
"2936","10175","2020",2,2,0,91500,621.5,139
"2937","10176","2020",1,1,0,128000,985,130
"2938","10177","2020",1,1,0,204550,1650,124
"2939","10178","2020",4,4,0,109500,1068.5,101.5
"2940","10179","2020",3,3,0,92666.6666666667,867,101.666666666667
"2941","10180","2020",2,2,0,59748.5,574.5,97.5
"2942","10181","2020",5,5,0,91888.4,967.2,95.8
"2943","10182","2020",1,1,0,30000,417,72
"2944","10184","2020",1,1,0,112000,1067,105
"2945","10185","2020",5,5,0,83500,1161.6,80
"2946","10186","2020",7,7,0,174457.142857143,1894.85714285714,93.1428571428571
"2947","10187","2020",8,7,1,78625,764.75,103.625
"2948","10188","2020",4,4,0,104100,1089.75,97
"2949","10190","2020",5,5,0,180400,1694,107.2
"2950","10191","2020",11,10,1,230772.727272727,1871.72727272727,124.272727272727
"2951","10192","2020",3,3,0,92766.6666666667,607.333333333333,151
"2952","10193","2020",10,10,0,94400,721,134.8
"2953","10194","2020",2,2,0,132500,993,134
"2954","10195","2020",2,2,0,107100,702.5,138.5
"2955","10196","2020",2,2,0,28000,366,77.5
"2956","10197","2020",1,1,0,15000,333,45
"2957","10199","2020",5,5,0,61152,744.4,83.2
"2958","10200","2020",1,1,0,56000,778,72
"2959","10201","2020",1,1,0,60000,1250,48
"2960","10202","2020",2,2,0,45410,609,77.5
"2961","10203","2020",5,5,0,71600,846.6,79.4
"2962","10205","2020",2,2,0,112850,987.5,92
"2963","10206","2020",1,1,0,215000,1243,173
"2964","10207","2020",2,2,0,186500,1259,148
"2965","10208","2020",10,10,0,123050,1091,118.8
"2966","10209","2020",29,28,1,195432.75862069,1674.89655172414,122.137931034483
"2967","10210","2020",7,7,0,203342.857142857,1599,127.857142857143
"2968","10211","2020",7,6,1,212642.857142857,1782.57142857143,119.857142857143
"2969","10212","2020",2,2,0,152500,1328,117
"2970","10213","2020",3,3,0,88333.3333333333,764,113.333333333333
"2971","10214","2020",1,1,0,43000,478,90
"2972","10215","2020",2,2,0,122500,1504.5,81.5
"2973","10216","2020",15,14,1,121166.666666667,1268.6,96.7333333333333
"2974","10218","2020",1,1,0,105000,1000,105
"2975","10220","2020",15,15,0,154850.066666667,1428.53333333333,109.666666666667
"2976","10221","2020",2,2,0,69750,829,75.5
"2977","10222","2020",12,12,0,131966.666666667,984.916666666667,139.083333333333
"2978","10223","2020",7,7,0,125000,1123.57142857143,111.285714285714
"2979","10224","2020",12,12,0,128740.083333333,1092.41666666667,121.25
"2980","10225","2020",1,1,0,80000,1333,60
"2981","10226","2020",1,1,0,190000,1583,120
"2982","10227","2020",5,5,0,96741,771.2,127.2
"2983","10228","2020",2,2,0,94128,1073,103.5
"2984","10230","2020",3,3,0,147333.333333333,1958.66666666667,74.3333333333333
"2985","10231","2020",13,13,0,150242.307692308,1389.38461538462,112.307692307692
"2986","10232","2020",3,3,0,102000,869.666666666667,101.333333333333
"2987","10233","2020",14,14,0,122513.214285714,1243.64285714286,94.4285714285714
"2988","10234","2020",3,3,0,175333.333333333,1547.33333333333,114.666666666667
"2989","10237","2020",6,6,0,154250,1486.5,107.166666666667
"2990","10238","2020",9,9,0,114733.333333333,1195.44444444444,100.666666666667
"2991","10239","2020",3,3,0,176999.666666667,1730.33333333333,102.333333333333
"2992","10240","2020",3,3,0,173333.333333333,1734.66666666667,106.333333333333
"2993","10241","2020",1,1,0,161109,2039,79
"2994","10243","2020",1,1,0,85000,1090,78
"2995","10245","2020",7,6,1,147814.285714286,1353.57142857143,117.285714285714
"2996","10246","2020",4,4,0,148250,1462.25,100.5
"2997","10247","2020",4,4,0,118500,1055.5,122.5
"2998","10248","2020",2,2,0,259500,1837.5,136.5
"2999","10249","2020",2,2,0,119000,1164,101
"3000","10251","2020",3,3,0,154833.333333333,1552.66666666667,100
"3001","10253","2020",1,1,0,81000,349,232
"3002","10254","2020",3,3,0,148333.333333333,1427.66666666667,108.333333333333
"3003","10255","2020",5,5,0,140400,1943.8,60
"3004","10256","2020",4,4,0,160500,1455.75,119
"3005","10258","2020",5,5,0,95200,1086.2,86.6
"3006","10259","2020",9,9,0,142866.666666667,1416.88888888889,105.888888888889
"3007","10260","2020",7,7,0,221514.285714286,1825,118.857142857143
"3008","10261","2020",8,8,0,67000,819.625,81.625
"3009","10262","2020",2,2,0,186000,989.5,169.5
"3010","10263","2020",7,7,0,152814.285714286,1224.42857142857,118.714285714286
"3011","10265","2020",23,20,3,172119.565217391,1705.65217391304,106.826086956522
"3012","10266","2020",3,3,0,81666.6666666667,984.333333333333,104.333333333333
"3013","10267","2020",2,2,0,119500,965.5,124
"3014","10268","2020",59,51,8,129682.508474576,1577.84745762712,87.1016949152542
"3015","10269","2020",2,2,0,40000,588.5,69
"3016","10270","2020",2,2,0,89250,1261,71
"3017","10271","2020",8,8,0,102062.5,1000.75,106.25
"3018","10272","2020",4,4,0,90850,1040.75,90.5
"3019","10274","2020",1,1,0,60000,1000,60
"3020","10275","2020",11,10,1,120772.727272727,1083.72727272727,103.363636363636
"3021","10276","2020",6,6,0,178467.5,1165.66666666667,158.166666666667
"3022","10278","2020",3,3,0,81333.3333333333,954,87.3333333333333
"3023","10280","2020",7,7,0,130571.428571429,1384.28571428571,95
"3024","10281","2020",4,4,0,109750,1530,71.5
"3025","10282","2020",7,7,0,181928.571428571,1914.42857142857,103.571428571429
"3026","10283","2020",1,1,0,65000,833,78
"3027","10284","2020",1,1,0,138041,1569,88
"3028","10286","2020",1,1,0,129000,1372,94
"3029","10287","2020",14,14,0,96000,1190.85714285714,83.2857142857143
"3030","10288","2020",3,3,0,51666.6666666667,804.333333333333,75.3333333333333
"3031","10289","2020",11,11,0,107727.272727273,1058.27272727273,103.818181818182
"3032","10290","2020",5,5,0,114460,1295.8,102
"3033","10291","2020",4,4,0,167375,1400.75,126
"3034","10293","2020",1,1,0,38000,352,108
"3035","10295","2020",2,2,0,141000,924,142.5
"3036","10296","2020",1,1,0,35000,380,92
"3037","10297","2020",56,46,10,163478.928571429,1811.16071428571,91.5714285714286
"3038","10299","2020",6,6,0,95616.6666666667,913,97.1666666666667
"3039","10300","2020",4,4,0,121500,913,140.25
"3040","10301","2020",2,2,0,65500,725.5,94
"3041","10302","2020",3,3,0,47666.6666666667,638.666666666667,71.6666666666667
"3042","10303","2020",2,2,0,73500,844.5,95
"3043","10304","2020",1,1,0,75577,1021,74
"3044","10305","2020",3,3,0,134333.333333333,1193,112.333333333333
"3045","10306","2020",2,2,0,120100,1297,92.5
"3046","10307","2020",3,3,0,224000,1428.66666666667,158
"3047","10308","2020",2,2,0,134045,689,206.5
"3048","10312","2020",6,6,0,104083.333333333,882,140.833333333333
"3049","10313","2020",4,4,0,137750,1577.25,90.25
"3050","10314","2020",3,3,0,158000,1125,141
"3051","10317","2020",12,12,0,103075,960.5,106.583333333333
"3052","10318","2020",1,1,0,174000,1438,121
"3053","10319","2020",19,19,0,68426.3157894737,822.947368421053,92.6315789473684
"3054","10320","2020",3,3,0,219666.666666667,1583,130.666666666667
"3055","10321","2020",44,39,5,199549.931818182,2045.29545454545,101.886363636364
"3056","10323","2020",227,197,30,88417.9515418502,1109.3127753304,81.3171806167401
"3057","10324","2020",2,2,0,141000,2002,80
"3058","10325","2020",40,35,5,201926.85,2155.1,103.55
"3059","10326","2020",3,3,0,79666.6666666667,757.333333333333,141
"3060","10327","2020",1,1,0,31000,413,75
"3061","10328","2020",5,5,0,103016,870.8,131.4
"3062","10329","2020",2,2,0,180945,2300,82.5
"3063","10331","2020",4,4,0,185500,1692,97.25
"3064","10332","2020",8,8,0,238181.25,1951.25,121
"3065","10333","2020",223,110,113,139831.560538117,1714.25112107623,79.9192825112108
"3066","10334","2020",9,9,0,129133.333333333,1602.66666666667,82.4444444444444
"3067","10335","2020",5,5,0,88600,1009.4,90.4
"3068","10336","2020",4,4,0,204000,1635.5,127
"3069","10338","2020",3,3,0,140973.333333333,1282,111
"3070","10340","2020",22,21,1,175312.272727273,1766.63636363636,100.772727272727
"3071","10341","2020",2,2,0,79000,1066.5,72.5
"3072","10342","2020",8,8,0,189500,1395.625,134.75
"3073","10343","2020",93,55,38,133543.225806452,1659.18279569892,82.8602150537634
"3074","10344","2020",5,5,0,204400,1937,107
"3075","10345","2020",5,5,0,173040,1381.6,127.4
"3076","10346","2020",1,1,0,69360,1261,55
"3077","10347","2020",3,3,0,162466.666666667,1267.33333333333,120.333333333333
"3078","10348","2020",2,2,0,72500,722,101
"3079","10349","2020",34,33,1,191701.911764706,1756.67647058824,112.205882352941
"3080","10350","2020",13,13,0,123038.461538462,975.230769230769,126.230769230769
"3081","10351","2020",5,5,0,103400,1155.6,89.4
"3082","10352","2020",17,16,1,207426.470588235,1814.23529411765,117.470588235294
"3083","10353","2020",12,12,0,150625,1567.25,95.5
"3084","10354","2020",1,1,0,37500,375,100
"3085","10355","2020",1,1,0,288350,1584,182
"3086","10356","2020",3,3,0,98573.3333333333,1351.66666666667,72.6666666666667
"3087","10357","2020",43,38,5,174948.860465116,1839.51162790698,94.6511627906977
"3088","10358","2020",12,12,0,137366.666666667,1405.5,101.166666666667
"3089","10359","2020",6,6,0,125325,1212.5,107
"3090","10360","2020",10,10,0,181950,1754.8,109.6
"3091","10361","2020",3,3,0,188166.666666667,1589.33333333333,117.666666666667
"3092","10362","2020",210,97,113,134988.861904762,1862.84761904762,73.5333333333333
"3093","10363","2020",3,3,0,153000,1425.33333333333,120
"3094","10364","2020",1,1,0,125000,1582,79
"3095","10365","2020",1,1,0,117000,900,130
"3096","10367","2020",12,12,0,134350,1603.5,92.8333333333333
"3097","10368","2020",9,9,0,154277.777777778,1555.88888888889,95.5555555555556
"3098","10369","2020",1,1,0,78000,839,93
"3099","10370","2020",6,6,0,110333.333333333,1240.5,94.1666666666667
"3100","10371","2020",3,3,0,151933.333333333,1668,93
"3101","10372","2020",1,1,0,75000,750,100
"3102","10373","2020",5,5,0,212560,1488,143.6
"3103","10374","2020",1,1,0,120000,960,125
"3104","10377","2020",3,3,0,64666.6666666667,457.333333333333,136
"3105","10379","2020",3,3,0,104666.666666667,1408.33333333333,79.3333333333333
"3106","10380","2020",1,1,0,115000,1337,86
"3107","10381","2020",9,7,2,227116.666666667,1937.66666666667,121.333333333333
"3108","10382","2020",21,21,0,105669.523809524,1252.90476190476,85.3333333333333
"3109","10383","2020",3,3,0,119000,1048.33333333333,129.666666666667
"3110","10384","2020",2,2,0,125000,1161,108
"3111","10386","2020",4,4,0,132487.5,1230.5,106
"3112","10387","2020",1170,244,926,110512.094871795,1595.47606837607,69.0564102564103
"3113","10388","2020",2,2,0,104950,710,135
"3114","10390","2020",1,1,0,161000,1175,137
"3115","10391","2020",6,6,0,140650,1510.16666666667,92.5
"3116","10392","2020",3,3,0,174333.333333333,1470,115.666666666667
"3117","10394","2020",4,4,0,94875,945.5,101.5
"3118","10395","2020",6,6,0,109753.166666667,1076.83333333333,116.333333333333
"3119","10396","2020",9,9,0,160563.888888889,1425.55555555556,119.777777777778
"3120","10399","2020",5,5,0,149632.2,1542,96.2
"3121","10400","2020",2,2,0,167000,1117.5,148
"3122","10401","2020",12,11,1,90382.5,985.583333333333,96
"3123","10402","2020",4,4,0,256912.5,1655.25,156.75
"3124","10404","2020",3,3,0,54600,640.333333333333,91.3333333333333
"3125","10406","2020",17,16,1,185879.411764706,1734.29411764706,109.529411764706
"3126","10408","2020",4,4,0,105000,1038.25,103.25
"3127","10409","2020",3,3,0,186000,1338.66666666667,140
"3128","10410","2020",2,2,0,119500,1326.5,86
"3129","10412","2020",13,12,1,298422.307692308,2788,126.230769230769
"3130","10414","2020",1,1,0,190000,1111,171
"3131","10416","2020",1,1,0,324100,1350,240
"3132","10417","2020",7,7,0,97414.2857142857,954.142857142857,111
"3133","10419","2020",11,11,0,193793.454545455,1502.27272727273,134.909090909091
"3134","10420","2020",29,29,0,105206.896551724,1277.1724137931,83.3448275862069
"3135","10421","2020",2,2,0,93500,1091,85
"3136","10422","2020",3,3,0,130666.666666667,997.666666666667,133.333333333333
"3137","10423","2020",1,1,0,150000,1095,137
"3138","10425","2020",7,7,0,176836,1902.85714285714,99.1428571428571
"3139","10426","2020",8,8,0,99562.5,943.75,109.875
"3140","10427","2020",5,5,0,147230.2,972.6,140.8
"3141","10428","2020",1,1,0,64000,427,150
"3142","10429","2020",3,3,0,119666.666666667,1113.66666666667,110
"3143","10430","2020",3,3,0,152833.333333333,943.333333333333,146
"3144","10431","2020",4,4,0,94375,1163.5,88.5
"3145","10432","2020",1,1,0,167300,1317,127
"3146","10433","2020",1,1,0,116000,1055,110
"3147","10434","2020",1,1,0,130000,1383,94
"3148","10435","2020",2,2,0,163135,1308.5,145
"3149","10436","2020",1,1,0,228000,1390,164
"3150","10437","2020",9,9,0,117188.888888889,1351.88888888889,82.7777777777778
"3151","10439","2020",2,2,0,57500,523,110
"3152","10440","2020",2,2,0,95000,785,121
"3153","10441","2020",5,5,0,158800,1220.8,124.4
"3154","10442","2020",11,11,0,153716.818181818,1416.27272727273,110.090909090909
"3155","10444","2020",6,6,0,93166.6666666667,800.5,119.166666666667
"3156","11001","2020",6,6,0,102476.666666667,1026.5,99.6666666666667
"3157","11002","2020",4,4,0,141625,1612.75,87.5
"3158","11003","2020",6,6,0,103303.333333333,972.166666666667,101.166666666667
"3159","11004","2020",3,3,0,155000,1499,98
"3160","11005","2020",11,11,0,162774.818181818,2041.72727272727,88.9090909090909
"3161","11006","2020",5,5,0,63640,1188.2,50.4
"3162","11007","2020",1,1,0,1e+05,1538,65
"3163","11008","2020",7,7,0,116387.142857143,1287.28571428571,97.7142857142857
"3164","11009","2020",19,18,1,121945.263157895,1232.73684210526,95.7368421052632
"3165","11010","2020",4,4,0,137000,1233.25,103.25
"3166","11011","2020",6,6,0,140250,1257.5,107
"3167","11012","2020",43,43,0,172454.651162791,1710.60465116279,101
"3168","11013","2020",6,6,0,176693.333333333,1541.5,111.5
"3169","11014","2020",13,13,0,203061.538461538,2104.53846153846,99.1538461538462
"3170","11015","2020",3,3,0,65500,531.666666666667,127.666666666667
"3171","11016","2020",4,4,0,176225,1385,114.75
"3172","11017","2020",1,1,0,170000,1604,106
"3173","11018","2020",17,17,0,134338.529411765,1607.29411764706,89.7647058823529
"3174","11021","2020",8,8,0,76555.625,948.625,88.375
"3175","11022","2020",28,24,4,140966,1362.28571428571,100.107142857143
"3176","11023","2020",16,16,0,114125.625,1104.9375,103.6875
"3177","11024","2020",16,14,2,210256.25,2197.0625,104
"3178","11025","2020",2,2,0,127500,1432,90
"3179","11026","2020",5,5,0,178149.4,1948.8,104.2
"3180","11027","2020",11,11,0,102743.636363636,975.545454545455,110.181818181818
"3181","11028","2020",8,8,0,123917.125,1060.875,116.125
"3182","11029","2020",1,1,0,120000,923,130
"3183","11030","2020",1,1,0,69000,1725,40
"3184","11032","2020",7,7,0,210781.428571429,1581.57142857143,130.428571428571
"3185","11033","2020",30,29,1,113136,1173.1,95.3
"3186","11034","2020",19,19,0,120925.526315789,1256,97.7894736842105
"3187","11035","2020",12,12,0,107195.416666667,1249.91666666667,84.25
"3188","11036","2020",5,5,0,136577.2,1220.6,113.6
"3189","11037","2020",29,9,20,66334.4827586207,982.965517241379,61.7241379310345
"3190","11038","2020",3,3,0,68000,821.333333333333,89
"3191","11040","2020",25,24,1,178056.8,1965.52,93.52
"3192","11041","2020",29,29,0,151285.172413793,1656.86206896552,95.1034482758621
"3193","11042","2020",3,3,0,79966.6666666667,1089,71.3333333333333
"3194","11044","2020",2,2,0,86922.5,1280.5,65
"3195","11045","2020",3,3,0,103533.333333333,1081.33333333333,103.666666666667
"3196","11047","2020",1,1,0,70000,1429,49
"3197","11048","2020",15,14,1,198295.333333333,1443.4,105.733333333333
"3198","11049","2020",39,39,0,136257.846153846,1317.33333333333,101.692307692308
"3199","11051","2020",3,3,0,222861.666666667,1899.33333333333,126
"3200","11052","2020",4,4,0,131200,1672,76
"3201","11053","2020",7,7,0,141929.285714286,1648.14285714286,92.4285714285714
"3202","11054","2020",4,4,0,181923.75,1307.75,145.5
"3203","11055","2020",7,7,0,62643.5714285714,964,71
"3204","11056","2020",4,4,0,62000,1008.5,75.25
"3205","11058","2020",6,6,0,257452,1593.16666666667,164
"3206","11059","2020",2,2,0,41245,852,49
"3207","11060","2020",1,1,0,30000,500,60
"3208","11061","2020",9,9,0,116105.666666667,1268.11111111111,91.4444444444444
"3209","11063","2020",7,7,0,153264.285714286,1193.42857142857,121
"3210","11064","2020",4,4,0,189700,2135,91
"3211","11065","2020",1,1,0,80000,667,120
"3212","11066","2020",6,6,0,112021,1494.33333333333,82.6666666666667
"3213","11067","2020",34,34,0,180059,1856.70588235294,95.1176470588235
"3214","11068","2020",26,26,0,113157.692307692,1160.53846153846,95.2692307692308
"3215","11069","2020",800,451,349,113971.4275,1303.2075,84.2825
"3216","11070","2020",2,2,0,81190,709,96.5
"3217","11071","2020",3,3,0,46756.6666666667,733.333333333333,63.6666666666667
"3218","11072","2020",4,4,0,109050,1209.5,91.75
"3219","11074","2020",7,7,0,207417.142857143,1925.28571428571,108.857142857143
"3220","11075","2020",5,5,0,53418,916.4,63
"3221","11076","2020",160,121,39,124432.5625,1339.4125,90.94375
"3222","11077","2020",7,7,0,163297.142857143,1415.57142857143,120.285714285714
"3223","11078","2020",1,1,0,162000,2160,75
"3224","11079","2020",3,3,0,76000,864.666666666667,79
"3225","11080","2020",1,1,0,95300,866,110
"3226","11081","2020",27,26,1,181450.777777778,1488.03703703704,115.148148148148
"3227","11084","2020",12,12,0,156264.166666667,1496.5,100.083333333333
"3228","11085","2020",11,11,0,124116.636363636,1143,105.545454545455
"3229","11086","2020",13,13,0,221825.384615385,2456.23076923077,90.4615384615385
"3230","11088","2020",29,29,0,142620.931034483,1337.8275862069,109.724137931034
"3231","11089","2020",6,6,0,154360,1317.66666666667,114.333333333333
"3232","11090","2020",2,2,0,380800,1704,214
"3233","11091","2020",10,9,1,85700,1169.9,81.7
"3234","11092","2020",3,3,0,106233.333333333,1161,107.666666666667
"3235","11094","2020",1,1,0,2e+05,2000,100
"3236","11095","2020",7,7,0,137595.142857143,1267.71428571429,102.285714285714
"3237","11096","2020",2,2,0,81000,888,101
"3238","11098","2020",16,15,1,151693.75,1324.875,115.4375
"3239","11099","2020",43,43,0,129682.790697674,1323.27906976744,98.1860465116279
"3240","11100","2020",1,1,0,67000,893,75
"3241","11102","2020",5,5,0,109900,1004.6,103
"3242","11103","2020",12,10,2,105508.75,1159.33333333333,90.5
"3243","11104","2020",2,2,0,71500,983.5,90
"3244","11105","2020",10,10,0,121033.6,1254.4,93.8
"3245","11106","2020",95,87,8,135467.494736842,1556.21052631579,91.4736842105263
"3246","11108","2020",1,1,0,45000,750,60
"3247","11109","2020",2,2,0,57750,1159,50.5
"3248","11110","2020",3,3,0,119166.666666667,1369.33333333333,85.6666666666667
"3249","11111","2020",18,18,0,180906.388888889,1898.16666666667,94.8333333333333
"3250","11113","2020",2,2,0,145000,1475,103.5
"3251","11114","2020",1,1,0,287400,2456,117
"3252","11115","2020",14,13,1,102216.428571429,1289.85714285714,88.9285714285714
"3253","11116","2020",58,52,6,156452.155172414,1600.81034482759,97.6206896551724
"3254","11117","2020",8,8,0,73037.5,902.625,83.5
"3255","11119","2020",6,6,0,172000,1790,98.5
"3256","11120","2020",3,3,0,201000,1558.33333333333,122.333333333333
"3257","11122","2020",11,11,0,132368.181818182,1281.45454545455,102.636363636364
"3258","11123","2020",1,1,0,134620,1346,100
"3259","11124","2020",6,6,0,153279.166666667,1673,92
"3260","11125","2020",3,3,0,181500,2028,100.666666666667
"3261","11126","2020",10,10,0,144980.5,1535.8,114.2
"3262","11127","2020",1,1,0,25000,781,32
"3263","11128","2020",3,3,0,150800,1393.66666666667,108.666666666667
"3264","11129","2020",29,29,0,90741.6551724138,983.655172413793,93.6551724137931
"3265","11130","2020",5,5,0,77370,843.6,90.6
"3266","11131","2020",10,9,1,102407,1178.8,91
"3267","11132","2020",23,23,0,122500.608695652,1289,98.4347826086957
"3268","11133","2020",3,3,0,156515.333333333,1169.66666666667,120.333333333333
"3269","11135","2020",2,2,0,33480,626.5,56.5
"3270","11136","2020",5,5,0,138020,1447.8,91.6
"3271","11137","2020",3,3,0,164093.333333333,1144.66666666667,143.666666666667
"3272","11138","2020",10,10,0,191409.3,1715.8,118.6
"3273","11140","2020",29,29,0,134035.172413793,1447.03448275862,97
"3274","11141","2020",2,2,0,126000,1393.5,72.5
"3275","11142","2020",2,2,0,133400,803,144
"3276","11143","2020",3,3,0,105000,2203.33333333333,60.3333333333333
"3277","11144","2020",48,39,9,180539.666666667,2262.9375,83.625
"3278","11145","2020",285,167,118,122262.329824561,2767.39649122807,48.3368421052632
"3279","11146","2020",1,1,0,95000,1044,91
"3280","11147","2020",1,1,0,32000,471,68
"3281","11148","2020",7,7,0,163160,1649.85714285714,100.714285714286
"3282","11149","2020",1,1,0,135000,1239,109
"3283","11150","2020",17,17,0,90964.7058823529,1085.58823529412,90
"3284","11151","2020",6,6,0,156076.5,1525.83333333333,108.5
"3285","11152","2020",5,5,0,134440,1354.6,99.4
"3286","11153","2020",4,4,0,111431.25,1169.25,99.5
"3287","11154","2020",1,1,0,82400,1177,70
"3288","11156","2020",5,5,0,133620,1174.2,105.6
"3289","11157","2020",8,8,0,157245,2012,85.5
"3290","11158","2020",4,4,0,133720,1340.5,92.75
"3291","11160","2020",1,1,0,73000,664,110
"3292","11161","2020",3,3,0,144066.666666667,1147.66666666667,112.666666666667
"3293","11162","2020",1,1,0,150000,1190,126
"3294","11163","2020",2,2,0,138500,1867,85
"3295","11164","2020",24,24,0,201570,1793.79166666667,115.583333333333
"3296","11165","2020",4,4,0,158210,1125.25,140
"3297","11166","2020",1,1,0,150000,1786,84
"3298","11167","2020",2,2,0,147500,1420,95
"3299","11168","2020",2,2,0,43500,655,58.5
"3300","11169","2020",1,1,0,50000,943,53
"3301","11170","2020",451,164,287,124010.044345898,3162.19290465632,39.0487804878049
"3302","11172","2020",9,8,1,128861.111111111,1683.11111111111,82.1111111111111
"3303","11173","2020",2,2,0,87475,679,132
"3304","11174","2020",2,2,0,104500,1345,71
"3305","11175","2020",3,3,0,119833.333333333,1277,93.3333333333333
"3306","11177","2020",2,2,0,55677.5,526.5,105
"3307","11178","2020",21,21,0,165067.619047619,1730.95238095238,97.2857142857143
"3308","11179","2020",1,1,0,85000,1417,60
"3309","11180","2020",8,8,0,60500,1429.625,46.375
"3310","11181","2020",5,5,0,125770,1504.6,82.2
"3311","11182","2020",8,8,0,116823.75,1368.375,93.25
"3312","11183","2020",3,3,0,95666.6666666667,816,113.333333333333
"3313","11184","2020",1,1,0,180000,6000,30
"3314","11185","2020",8,8,0,231875,2200,120.75
"3315","11187","2020",3,3,0,153866.666666667,1069.66666666667,129
"3316","11188","2020",34,32,2,153101.323529412,1637.23529411765,95.1470588235294
"3317","11189","2020",8,8,0,110406.25,1181.625,99.25
"3318","11190","2020",16,16,0,98206.25,1066.375,92.6875
"3319","11191","2020",3,3,0,48903.3333333333,739,67.6666666666667
"3320","11192","2020",10,10,0,143250,1156.2,119.4
"3321","11193","2020",3,3,0,99666.6666666667,1144,78
"3322","11195","2020",9,9,0,118730,1089.44444444444,103.444444444444
"3323","11196","2020",10,10,0,73975,1161.3,63.5
"3324","11197","2020",4,4,0,158500,1568.25,101
"3325","11198","2020",20,20,0,115927.4,1114,97.7
"3326","11199","2020",18,18,0,137589.166666667,1545.5,86.8888888888889
"3327","11200","2020",3,3,0,93733.3333333333,3509.33333333333,89.6666666666667
"3328","11201","2020",9,9,0,106278.666666667,1077.44444444444,99.8888888888889
"3329","11202","2020",481,191,290,103527.869022869,2783.41372141372,38.035343035343
"3330","11203","2020",158,137,21,142723.936708861,1517.65189873418,94.9430379746835
"3331","11205","2020",2,2,0,74500,1325.5,69.5
"3332","11206","2020",118,95,23,121605.415254237,1358.1186440678,92.7966101694915
"3333","11207","2020",3,3,0,141433.333333333,1229.33333333333,100.333333333333
"3334","11208","2020",1,1,0,180000,1475,122
"3335","11209","2020",3,3,0,142856.666666667,1262.66666666667,120
"3336","11210","2020",18,18,0,152354.888888889,1700.22222222222,91.8888888888889
"3337","11211","2020",4,4,0,133750,1602.25,79
"3338","11212","2020",8,8,0,128062.5,1626.125,77.75
"3339","11214","2020",5,5,0,161410,1710.2,104.2
"3340","11215","2020",11,11,0,195744.545454545,1654.90909090909,119.727272727273
"3341","11216","2020",6,6,0,148500,1599.33333333333,95.8333333333333
"3342","11217","2020",18,18,0,157425.888888889,1587.33333333333,100.277777777778
"3343","11218","2020",2,2,0,163580,1217.5,135
"3344","11220","2020",11,10,1,92725,1294.54545454545,80.3636363636364
"3345","11221","2020",9,9,0,151503.333333333,1562.55555555556,93.6666666666667
"3346","11222","2020",4,4,0,52168,1045.5,58
"3347","11225","2020",13,12,1,140061.538461538,1302.92307692308,105.461538461538
"3348","11226","2020",1,1,0,360000,1412,255
"3349","11229","2020",2,2,0,52500,492.5,108.5
"3350","11232","2020",2,2,0,142500,1868,76
"3351","11233","2020",7,7,0,129291.428571429,1500.71428571429,85.7142857142857
"3352","11234","2020",2,1,1,32500,791.5,39.5
"3353","11235","2020",1,1,0,62235,692,90
"3354","11236","2020",3,3,0,98333.3333333333,803.666666666667,119.333333333333
"3355","11238","2020",5,5,0,222540,2097,103.2
"3356","11240","2020",13,13,0,144255.384615385,1471.30769230769,96.0769230769231
"3357","11241","2020",6,6,0,139916.666666667,1555.66666666667,101
"3358","11242","2020",3,3,0,118536.666666667,1829,64.6666666666667
"3359","11243","2020",7,7,0,281686.428571429,1966.57142857143,151
"3360","11244","2020",6,5,1,47250,763.666666666667,68.1666666666667
"3361","11245","2020",2,2,0,170060,2120.5,80.5
"3362","11249","2020",3,3,0,257500,1979.33333333333,126
"3363","11250","2020",1,1,0,27000,458,59
"3364","11251","2020",5,5,0,98560,1006.2,98.2
"3365","11252","2020",7,7,0,152618.142857143,1060.42857142857,143.571428571429
"3366","11253","2020",11,11,0,144673.636363636,1406.90909090909,102.636363636364
"3367","11254","2020",21,19,2,135542.857142857,1344.38095238095,95.5238095238095
"3368","11255","2020",24,23,1,189232.25,1751.33333333333,113.416666666667
"3369","11256","2020",12,12,0,220915.416666667,1931.41666666667,116.166666666667
"3370","11257","2020",6,6,0,110547.5,1086.16666666667,93.8333333333333
"3371","11258","2020",32,32,0,188560.9375,2019.625,100.03125
"3372","11259","2020",12,12,0,140752.25,1530.41666666667,94.8333333333333
"3373","11260","2020",2,2,0,93850,1204.5,78
"3374","11261","2020",26,26,0,142078.461538462,1455.15384615385,98.2307692307692
"3375","11262","2020",1066,434,632,148453.714821764,2133.67354596623,69.9437148217636
"3376","11263","2020",5,5,0,95325,821.8,118
"3377","11264","2020",12,12,0,172604.166666667,1671.25,104.333333333333
"3378","11265","2020",1,1,0,45000,592,76
"3379","11266","2020",221,98,123,107349.515837104,2214.09049773756,51.8235294117647
"3380","11267","2020",12,11,1,166454.25,1452.16666666667,112.75
"3381","11269","2020",44,44,0,148164.772727273,1560.52272727273,99.0454545454545
"3382","11270","2020",9,9,0,98279.1111111111,837.777777777778,107.777777777778
"3383","11271","2020",2,2,0,85940,1146,75
"3384","11272","2020",24,24,0,215375.875,1990.04166666667,106.791666666667
"3385","11273","2020",12,12,0,196392.916666667,2036,94.0833333333333
"3386","11274","2020",6,6,0,123250,1267.33333333333,101.5
"3387","11275","2020",3,3,0,211000,2770.66666666667,146.333333333333
"3388","11276","2020",18,18,0,87081.1111111111,874.055555555556,95.4444444444444
"3389","11278","2020",2,2,0,146080,1221,170
"3390","11279","2020",30,29,1,162616.4,1569.93333333333,102.766666666667
"3391","11280","2020",13,13,0,158228.307692308,1496.76923076923,124.230769230769
"3392","11281","2020",15,15,0,119209.333333333,1228.06666666667,93.8666666666667
"3393","11283","2020",1,1,0,155000,1360,114
"3394","11284","2020",3,3,0,81666.6666666667,1162,81
"3395","11285","2020",24,19,5,224540.291666667,2390.29166666667,98.125
"3396","11286","2020",20,20,0,159038.65,1469.1,107.45
"3397","11287","2020",1,1,0,80000,825,97
"3398","11288","2020",32,32,0,136019.59375,1360.375,100.28125
"3399","11289","2020",14,14,0,145160,1510.92857142857,99.1428571428571
"3400","11290","2020",4,4,0,108875,1485.25,73.5
"3401","11291","2020",4,4,0,232000,1609.25,149.75
"3402","11292","2020",3,3,0,74000,1335.33333333333,54.3333333333333
"3403","11293","2020",17,16,1,156438.235294118,1577.76470588235,100.176470588235
"3404","11295","2020",27,26,1,139095.444444444,1327.7037037037,105.481481481481
"3405","11296","2020",10,10,0,197847,1655.9,113.8
"3406","11297","2020",8,8,0,77725,984.75,87.25
"3407","11299","2020",8,8,0,114336.875,1347.875,83
"3408","11301","2020",16,16,0,105853.5625,1349.5,84.25
"3409","11302","2020",7,7,0,83671.4285714286,820,100.428571428571
"3410","11303","2020",14,14,0,110864.642857143,1143.35714285714,95.7857142857143
"3411","11304","2020",54,50,4,116543.722222222,1186.61111111111,97.1296296296296
"3412","11305","2020",1,1,0,69000,802,86
"3413","11306","2020",1,1,0,140000,1014,138
"3414","11307","2020",3,3,0,171783.333333333,1862.33333333333,96.6666666666667
"3415","11308","2020",5,5,0,124800,1078.8,118.2
"3416","11309","2020",4,4,0,98943.75,1671.75,61
"3417","11310","2020",8,3,5,64932.25,1357.25,41.75
"3418","11311","2020",1,1,0,72000,1333,54
"3419","11312","2020",1,1,0,45000,900,50
"3420","11313","2020",3,3,0,146121.666666667,1231.33333333333,126.666666666667
"3421","11314","2020",2,2,0,96150,1460.5,80.5
"3422","11315","2020",38,35,3,106960.263157895,1092.92105263158,98.2105263157895
"3423","11316","2020",4,4,0,169231.25,1271.5,108.25
"3424","11317","2020",1,1,0,50000,568,88
"3425","11318","2020",1,1,0,94600,1154,82
"3426","11320","2020",10,10,0,104569,1170.4,91.9
"3427","11321","2020",3,3,0,40000,608.333333333333,66.6666666666667
"3428","11322","2020",13,12,1,188270.769230769,1720,105.769230769231
"3429","11323","2020",4,4,0,144750,1134.75,123.75
"3430","11324","2020",7,7,0,175180,1694.85714285714,107.142857142857
"3431","11325","2020",4,4,0,169562.5,1181.5,139.5
"3432","11326","2020",1,1,0,50000,500,100
"3433","11327","2020",5,5,0,189800,1626,119.8
"3434","11328","2020",4,4,0,92936.25,963.25,99
"3435","11330","2020",5,5,0,318180,2456.6,119.2
"3436","11332","2020",27,27,0,168951.851851852,1720.59259259259,97.0740740740741
"3437","11333","2020",1,1,0,320000,2462,130
"3438","11334","2020",1,1,0,170000,1932,88
"3439","11335","2020",4,4,0,68865,764,95.25
"3440","11336","2020",8,8,0,103975,1111.75,93
"3441","11337","2020",3,3,0,183048.666666667,1685,118.333333333333
"3442","11339","2020",6,6,0,167006.666666667,1645,98
"3443","11340","2020",3,3,0,171000,1514,114.666666666667
"3444","11342","2020",4,4,0,59152.5,814.25,81.25
"3445","11343","2020",1,1,0,3e+05,1818,165
"3446","11344","2020",13,13,0,161457.307692308,1562.76923076923,98.8461538461538
"3447","11345","2020",6,6,0,138691.666666667,1148.66666666667,104.166666666667
"3448","11346","2020",3,3,0,158880.333333333,1476.33333333333,108.666666666667
"3449","11347","2020",3,3,0,133003.333333333,1438.33333333333,96.3333333333333
"3450","11348","2020",1,1,0,219300,2437,90
"3451","11351","2020",18,18,0,108694.444444444,1407.11111111111,84.8888888888889
"3452","11352","2020",2,2,0,1e+05,1708.5,64.5
"3453","11353","2020",42,41,1,192831.166666667,1837.21428571429,105.809523809524
"3454","11354","2020",3,3,0,130666.666666667,1611.33333333333,84.6666666666667
"3455","11355","2020",8,8,0,199267.5,1701.75,115.875
"3456","11356","2020",14,13,1,173587.214285714,1655,111.357142857143
"3457","11357","2020",5,5,0,90178,1123.6,87.4
"3458","11358","2020",2,2,0,58750,1037,60
"3459","11359","2020",12,12,0,202813.333333333,2045.5,99.9166666666667
"3460","11360","2020",33,33,0,193282.090909091,1855.57575757576,103.272727272727
"3461","11361","2020",4,4,0,147000,1686.75,92.25
"3462","11362","2020",2,2,0,276250,2889.5,107
"3463","11363","2020",3,3,0,96560,1044.66666666667,82.3333333333333
"3464","11364","2020",3,3,0,170166.666666667,1407.33333333333,120.333333333333
"3465","11366","2020",14,14,0,142417.785714286,1478.71428571429,99
"3466","11367","2020",21,21,0,121268.571428571,1086.71428571429,109.095238095238
"3467","11368","2020",1,1,0,80000,784,102
"3468","11369","2020",57,55,2,173267.631578947,1719.29824561404,101.736842105263
"3469","11370","2020",54,52,2,209323.759259259,2008.64814814815,109.740740740741
"3470","11371","2020",11,10,1,132235,1343.63636363636,101.181818181818
"3471","11372","2020",3,3,0,43000,673.666666666667,60.3333333333333
"3472","11373","2020",3,3,0,57483.3333333333,610,88.6666666666667
"3473","11376","2020",4,4,0,106963.75,940,109.5
"3474","11377","2020",1,1,0,33000,805,41
"3475","11378","2020",5,5,0,96130,874,117.2
"3476","11379","2020",106,99,7,175959.122641509,1903.38679245283,97.2641509433962
"3477","11380","2020",1,1,0,420000,7000,60
"3478","11381","2020",3,3,0,50333.3333333333,814.333333333333,73.6666666666667
"3479","11382","2020",1,1,0,180000,2118,85
"3480","11383","2020",2,2,0,185000,1746.5,106.5
"3481","11384","2020",2,2,0,76500,907.5,84
"3482","11385","2020",4,4,0,147337.5,1573.5,95.75
"3483","11386","2020",5,5,0,154195.6,1545.6,96
"3484","11387","2020",3,3,0,67073.6666666667,596.666666666667,110.333333333333
"3485","11388","2020",3,3,0,39036.6666666667,681,63.3333333333333
"3486","11389","2020",1,1,0,140000,1443,97
"3487","11390","2020",9,9,0,84151.1111111111,1151.33333333333,69.1111111111111
"3488","11391","2020",1,1,0,52000,743,70
"3489","11392","2020",4,4,0,126375,1795,69.5
"3490","11393","2020",10,10,0,108770,1017.8,105.7
"3491","11394","2020",3,3,0,92333.3333333333,913,100
"3492","11396","2020",8,8,0,119125,1242.75,95.625
"3493","11397","2020",77,68,9,100384.38961039,1153.22077922078,84.5844155844156
"3494","11398","2020",2,2,0,262500,2460.5,106
"3495","11400","2020",5,5,0,141030,1156.4,128.6
"3496","11401","2020",15,14,1,88786.1333333333,1345,79.3333333333333
"3497","11404","2020",7,7,0,183871.428571429,1507,116.857142857143
"3498","11405","2020",8,8,0,197975,2199.5,103.5
"3499","11406","2020",2,2,0,141500,1427.5,99
"3500","11408","2020",4,4,0,85750,875.75,97.25
"3501","11409","2020",1,1,0,43000,538,80
"3502","11410","2020",9,9,0,148788.888888889,1522.77777777778,97.8888888888889
"3503","11411","2020",4,4,0,62925,591.75,104.75
"3504","11413","2020",6,6,0,148610,1459.66666666667,96.6666666666667
"3505","11415","2020",2,2,0,69942.5,784,92.5
"3506","11416","2020",2,2,0,153300,1655,102
"3507","11417","2020",2,2,0,292850,2318.5,130.5
"3508","11418","2020",14,14,0,146099.357142857,1192.92857142857,124.142857142857
"3509","11420","2020",3,3,0,158833.333333333,1512,112.333333333333
"3510","11421","2020",9,9,0,179110.555555556,1629.22222222222,109.666666666667
"3511","11422","2020",2,2,0,159750,1999.5,78
"3512","11423","2020",3,3,0,161300,1914.66666666667,84.3333333333333
"3513","11424","2020",1,1,0,40000,690,58
"3514","11425","2020",30,30,0,139805.4,1468.56666666667,94.7
"3515","11426","2020",11,9,2,140314.636363636,1441.36363636364,104.090909090909
"3516","11427","2020",9,9,0,164628.888888889,1722.77777777778,97.3333333333333
"3517","11428","2020",4,4,0,108125,695,140
"3518","11429","2020",54,46,8,175008.518518519,1726.90740740741,101.388888888889
"3519","11430","2020",11,11,0,138827.272727273,1750,90.0909090909091
"3520","11431","2020",4,4,0,136575,1232.75,101.5
"3521","11432","2020",3,3,0,344461.666666667,1948.66666666667,177.666666666667
"3522","11433","2020",12,12,0,106370.416666667,1058.16666666667,105.916666666667
"3523","11434","2020",10,10,0,134856.7,1181.5,116
"3524","11435","2020",2,2,0,23950,489.5,49
"3525","11436","2020",3,3,0,108000,1037.66666666667,114
"3526","11437","2020",12,12,0,141261.666666667,1414.75,98.75
"3527","11438","2020",4,4,0,143375,1300.25,115
"3528","11439","2020",4,4,0,96475,1197.5,77.25
"3529","11440","2020",1,1,0,95000,1131,84
"3530","11441","2020",46,38,8,179109.608695652,1981.84782608696,89.6521739130435
"3531","12001","2020",12,12,0,211673.833333333,1809.66666666667,115.5
"3532","12002","2020",11,10,1,134234.272727273,1510.90909090909,98.0909090909091
"3533","12003","2020",2,2,0,119000,1252.5,95
"3534","12004","2020",1,1,0,1e+05,667,150
"3535","12006","2020",3,3,0,73500,804.333333333333,84
"3536","12007","2020",1,1,0,85000,1809,47
"3537","12008","2020",4,4,0,215225,2140.75,105.25
"3538","12009","2020",2,2,0,65500,1084,65
"3539","12010","2020",1,1,0,135500,1178,115
"3540","12011","2020",17,17,0,115339.882352941,1507.94117647059,78.4117647058823
"3541","12012","2020",11,11,0,120431.818181818,1261.72727272727,91.7272727272727
"3542","12013","2020",37,35,2,75955.4054054054,842.027027027027,94.7027027027027
"3543","12015","2020",4,4,0,77250,848.25,96.25
"3544","12016","2020",14,14,0,119667.142857143,1373,87.3571428571429
"3545","12017","2020",5,5,0,77809,983,76
"3546","12018","2020",5,5,0,99800,1381.4,77
"3547","12021","2020",21,21,0,121278.095238095,1098.19047619048,126.142857142857
"3548","12022","2020",3,3,0,70833.3333333333,883.333333333333,95
"3549","12023","2020",4,4,0,87381.5,1288.75,63.75
"3550","12024","2020",1,1,0,121650,1560,78
"3551","12025","2020",6,5,1,56000,697.833333333333,95.3333333333333
"3552","12026","2020",14,14,0,149367.857142857,1561.42857142857,96
"3553","12027","2020",3,3,0,324933.333333333,2070.33333333333,159
"3554","12028","2020",3,2,1,85500,1067.66666666667,82
"3555","12029","2020",1,1,0,183000,1271,144
"3556","12030","2020",6,6,0,67597.1666666667,768.666666666667,87.3333333333333
"3557","12031","2020",3,3,0,88333.3333333333,843.333333333333,101
"3558","12032","2020",5,5,0,173400,1658.4,108
"3559","12033","2020",20,16,4,151908.5,1575.2,96.35
"3560","12034","2020",4,4,0,95282,1004.75,92.5
"3561","12035","2020",5,5,0,86200,791.4,112
"3562","12036","2020",8,7,1,240870.625,1723.125,101.5
"3563","12037","2020",11,11,0,92055.6363636364,1193.54545454545,97.1818181818182
"3564","12038","2020",3,3,0,96333.3333333333,1260.66666666667,79.3333333333333
"3565","12039","2020",7,6,1,60992.8571428571,697.857142857143,88.7142857142857
"3566","12041","2020",4,4,0,68000,656,102.5
"3567","12043","2020",11,11,0,186605,1849.90909090909,116
"3568","12044","2020",13,9,4,85966.1538461538,1021.15384615385,83.5384615384615
"3569","12045","2020",5,5,0,178600,1524.8,123.2
"3570","12046","2020",4,4,0,84512.5,1300.25,72.25
"3571","12047","2020",3,3,0,116666.666666667,1594,75
"3572","12048","2020",6,6,0,87016.6666666667,1060.66666666667,81.6666666666667
"3573","12049","2020",2,2,0,96930,1392,60
"3574","12050","2020",8,8,0,162216.25,1654.25,94.75
"3575","12051","2020",2,2,0,53750,577,85
"3576","12052","2020",51,46,5,122000.529411765,1286.3137254902,98.5098039215686
"3577","12053","2020",2,2,0,145075,1346.5,110
"3578","12054","2020",9,9,0,141335.555555556,1136.66666666667,111.222222222222
"3579","12056","2020",33,26,7,135444.666666667,1500.27272727273,92.4848484848485
"3580","12057","2020",14,13,1,89778.5714285714,1047.42857142857,95.8571428571429
"3581","12058","2020",1,1,0,50000,397,126
"3582","12059","2020",5,5,0,108149.2,1236.2,112.4
"3583","12060","2020",1,1,0,140000,1458,96
"3584","12061","2020",5,5,0,114400,1338.6,88
"3585","12062","2020",4,4,0,65375,1273,58.5
"3586","12063","2020",11,10,1,149731.818181818,1635,93
"3587","12064","2020",1,1,0,50000,556,90
"3588","12065","2020",4,4,0,89750,906.5,108.25
"3589","12066","2020",8,7,1,176025,1900.25,92.375
"3590","12067","2020",2,2,0,141355,1330.5,102
"3591","12068","2020",13,13,0,114969.230769231,1317.46153846154,106.615384615385
"3592","12069","2020",3,3,0,91666.6666666667,1050.33333333333,93.6666666666667
"3593","12070","2020",8,7,1,205523.75,1952.125,105.5
"3594","12071","2020",3,3,0,159000,1532,103
"3595","12072","2020",2,2,0,120000,1696.5,66
"3596","12073","2020",3,3,0,162516.666666667,1547.33333333333,107.333333333333
"3597","12074","2020",3,3,0,148333.333333333,1264,117
"3598","12075","2020",3,3,0,64397,803.666666666667,81.6666666666667
"3599","12076","2020",22,22,0,128625,1508.22727272727,80.1363636363636
"3600","12077","2020",6,4,2,92133.3333333333,946.5,97.5
"3601","12078","2020",1,1,0,110000,1310,84
"3602","12079","2020",6,6,0,155033.333333333,1856.5,83.1666666666667
"3603","12080","2020",6,6,0,142566.666666667,1159,113.5
"3604","12082","2020",3,3,0,81666.6666666667,807.333333333333,100.333333333333
"3605","12083","2020",18,17,1,94486.1111111111,1135.88888888889,88
"3606","12084","2020",20,19,1,169375.05,1987.8,87.5
"3607","12085","2020",4,4,0,105300,1295.5,119.5
"3608","12086","2020",1,1,0,202200,2063,98
"3609","12088","2020",2,2,0,129000,1691,70
"3610","12089","2020",61,42,19,76152.6885245902,912.606557377049,84.5409836065574
"3611","12090","2020",21,21,0,171459.523809524,1810,94.3809523809524
"3612","12091","2020",3,3,0,129000,1013,135
"3613","12092","2020",1,1,0,40000,1600,25
"3614","12093","2020",4,4,0,102225,1382,82.25
"3615","12094","2020",15,14,1,117164.6,1294.13333333333,90.2666666666667
"3616","12095","2020",3,3,0,121606.666666667,740,130
"3617","12096","2020",69,36,33,123190.695652174,1381.85507246377,88.9130434782609
"3618","12097","2020",1,1,0,44000,1571,28
"3619","12098","2020",5,3,2,170465.6,1865.2,115.6
"3620","12099","2020",4,4,0,55250,1352.75,54.25
"3621","12100","2020",21,18,3,114333.904761905,1259.95238095238,87.6666666666667
"3622","12101","2020",6,6,0,144166.666666667,1484.33333333333,93.3333333333333
"3623","12102","2020",20,17,3,175174.5,1744.8,101.1
"3624","12103","2020",5,5,0,108430,997.4,126.2
"3625","12104","2020",4,4,0,113750,1163.75,94
"3626","12105","2020",11,11,0,125690.909090909,1136.63636363636,106.363636363636
"3627","12106","2020",6,6,0,119866.666666667,1197.33333333333,101.666666666667
"3628","12107","2020",7,7,0,102090,1523.28571428571,66.8571428571429
"3629","12108","2020",1,1,0,122000,1017,120
"3630","12110","2020",3,3,0,103666.666666667,1482.66666666667,67.3333333333333
"3631","12111","2020",3,3,0,193040,1351.33333333333,141.333333333333
"3632","12113","2020",6,6,0,156166.666666667,1287.66666666667,122
"3633","12115","2020",1,1,0,85000,1118,76
"3634","12118","2020",6,6,0,82211.6666666667,962.833333333333,85.1666666666667
"3635","12119","2020",20,10,10,107686.6,1613.85,63.4
"3636","12120","2020",27,22,5,119561.481481481,1272.59259259259,91.1481481481482
"3637","12121","2020",9,8,1,109372.222222222,1218.55555555556,93.1111111111111
"3638","12122","2020",2,2,0,31500,366.5,86
"3639","12124","2020",2,2,0,67000,832,88
"3640","12125","2020",9,8,1,62185,790.777777777778,81.2222222222222
"3641","12127","2020",11,11,0,88731.8181818182,912,94
"3642","12128","2020",3,3,0,157700,1224.66666666667,153.666666666667
"3643","12129","2020",3,3,0,105033.333333333,1266,82.3333333333333
"3644","12130","2020",6,6,0,95750,1166.16666666667,81.8333333333333
"3645","12131","2020",19,19,0,227126.842105263,2014.42105263158,114.315789473684
"3646","12133","2020",61,41,20,180452.081967213,1982.31147540984,93.5737704918033
"3647","12134","2020",1,1,0,240000,1702,141
"3648","12135","2020",6,6,0,90156.8333333333,1143.16666666667,94.6666666666667
"3649","12136","2020",9,9,0,192138.444444444,2267.55555555556,99.6666666666667
"3650","12137","2020",5,5,0,168870,1987,91.8
"3651","12138","2020",12,11,1,119459.166666667,1392,83.0833333333333
"3652","12139","2020",4,4,0,160675,1331.25,111.75
"3653","12140","2020",7,7,0,139049.571428571,1232.85714285714,105.142857142857
"3654","12141","2020",3,3,0,73493.3333333333,827.666666666667,100
"3655","12142","2020",4,4,0,142375,1467.5,94
"3656","12145","2020",311,111,200,121731.649517685,1600.98713826367,76.5627009646302
"3657","12146","2020",54,38,16,163489.62962963,1870.2037037037,86.0555555555556
"3658","12147","2020",4,4,0,56250,887.5,63.5
"3659","12148","2020",13,11,2,89889.2307692308,1130.92307692308,75.2307692307692
"3660","12149","2020",2,2,0,62500,1223.5,48.5
"3661","12150","2020",4,4,0,126847.5,1100.25,113.25
"3662","12153","2020",9,9,0,181356.888888889,1775.22222222222,104.888888888889
"3663","12154","2020",7,7,0,101190.714285714,945.571428571429,110.285714285714
"3664","12155","2020",4,4,0,147045.25,1450.75,105
"3665","12156","2020",6,6,0,78353.3333333333,1101.16666666667,69.3333333333333
"3666","12157","2020",17,17,0,146213.058823529,1719.23529411765,82.8235294117647
"3667","12158","2020",3,3,0,133370,1405.66666666667,89.6666666666667
"3668","12159","2020",6,6,0,126916.666666667,1583.5,86
"3669","12160","2020",4,4,0,118150,1447.5,85.25
"3670","12161","2020",5,5,0,87460,1314.2,70.6
"3671","12162","2020",11,11,0,125986.363636364,1174.63636363636,113.909090909091
"3672","12164","2020",9,6,3,73922.2222222222,909.444444444444,80.1111111111111
"3673","12165","2020",9,9,0,100164.444444444,1018.44444444444,102
"3674","12167","2020",17,17,0,143433.411764706,1457.17647058824,100.647058823529
"3675","12168","2020",14,13,1,139680.642857143,1782.92857142857,78.8571428571429
"3676","12169","2020",25,24,1,109245.08,1313.04,90.6
"3677","12170","2020",7,7,0,127371.428571429,1544.57142857143,86
"3678","12171","2020",7,7,0,136142.857142857,1552.14285714286,85
"3679","12172","2020",12,12,0,112266.666666667,1345.75,85.5833333333333
"3680","12174","2020",52,31,21,152499.365384615,1865.07692307692,85.6538461538462
"3681","12175","2020",2,2,0,131100,1374,96.5
"3682","12176","2020",181,76,105,148451.524861878,1931.33701657459,79.121546961326
"3683","12177","2020",10,10,0,133381,1264.8,105.6
"3684","12179","2020",1,1,0,1e+05,505,198
"3685","12181","2020",1,1,0,85000,1417,60
"3686","12182","2020",3,3,0,132666.666666667,1239.33333333333,99
"3687","12183","2020",4,4,0,120750,1908,72.75
"3688","12185","2020",13,13,0,124811.538461538,1319.61538461538,104.307692307692
"3689","12186","2020",1,1,0,90000,900,100
"3690","12187","2020",10,8,2,79375.2,1400.4,60.1
"3691","12188","2020",3,3,0,82933.3333333333,1346.33333333333,59.3333333333333
"3692","12189","2020",9,9,0,167462.777777778,1632.11111111111,109.444444444444
"3693","12190","2020",2,2,0,149275,1216,118.5
"3694","12191","2020",8,8,0,123600,1267.875,99.25
"3695","12192","2020",2,2,0,99085,1501.5,62.5
"3696","12193","2020",3,3,0,138333.333333333,1575,104
"3697","12194","2020",14,14,0,169983.857142857,1407.5,121.642857142857
"3698","12195","2020",5,5,0,126776.6,1118.6,105.6
"3699","12197","2020",32,30,2,109380.875,1570.40625,80.96875
"3700","12198","2020",19,16,3,100878.947368421,1036.52631578947,95.9473684210526
"3701","12199","2020",31,18,13,91345.0322580645,1417.51612903226,64.8387096774194
"3702","12200","2020",8,7,1,139087.5,1402.125,107.125
"3703","12201","2020",7,7,0,169985.714285714,1983.28571428571,81.8571428571429
"3704","12202","2020",589,84,505,123780.222410866,1901.52122241087,66.3938879456706
"3705","12203","2020",4,4,0,172175,1868,94.25
"3706","12204","2020",4,4,0,105475,1323,80.25
"3707","12205","2020",8,8,0,210575,1794.125,114
"3708","12206","2020",8,8,0,168888.75,1588.375,103.25
"3709","12207","2020",4,4,0,95250,1088.75,100.75
"3710","12208","2020",99,64,35,124849.494949495,1532.19191919192,82.5050505050505
"3711","12209","2020",6,6,0,126274.333333333,1310,94.8333333333333
"3712","12210","2020",6,6,0,109713,1147.16666666667,89.1666666666667
"3713","12211","2020",2,2,0,137500,2682,51.5
"3714","12212","2020",2,2,0,92500,1564,58
"3715","12213","2020",8,8,0,156362.5,1199.375,118.875
"3716","12214","2020",13,12,1,84309.2307692308,1229.53846153846,76.9230769230769
"3717","12215","2020",16,16,0,150890.625,1535.625,100.5625
"3718","12216","2020",10,9,1,117797,1461.9,82.4
"3719","12217","2020",13,13,0,165178.076923077,1343.46153846154,124
"3720","12219","2020",4,4,0,127250,1660.75,70
"3721","12220","2020",3,3,0,66000,846,74.6666666666667
"3722","12221","2020",6,6,0,61916.6666666667,941,78.6666666666667
"3723","12222","2020",6,6,0,108106.666666667,1758.16666666667,64.8333333333333
"3724","12223","2020",21,21,0,114805.19047619,1030.38095238095,104
"3725","12224","2020",58,28,30,76125.9482758621,1146.77586206897,63.6034482758621
"3726","12225","2020",18,15,3,135037.777777778,1370.05555555556,97.4444444444444
"3727","12226","2020",9,8,1,82744.4444444444,961.444444444444,87.2222222222222
"3728","12227","2020",2,2,0,120000,1539,78
"3729","12228","2020",5,5,0,90953,1126.4,90.2
"3730","12229","2020",1,1,0,240000,1905,126
"3731","12230","2020",4,4,0,97750,817.5,106.75
"3732","12231","2020",15,13,2,89633.2666666667,1189.73333333333,87.6666666666667
"3733","12232","2020",3,3,0,148500,1692.66666666667,91.3333333333333
"3734","12233","2020",2,2,0,112500,1463.5,92.5
"3735","12234","2020",6,6,0,161645.833333333,1178.83333333333,147.5
"3736","12235","2020",6,6,0,105830.166666667,1116,104.666666666667
"3737","12236","2020",6,6,0,167550,1631.83333333333,88.3333333333333
"3738","12237","2020",4,3,1,51450,741.75,71.25
"3739","12238","2020",8,8,0,161325,1458,109.375
"3740","12239","2020",4,4,0,80960,1059.25,81
"3741","12240","2020",6,6,0,96719.1666666667,1072.33333333333,86.3333333333333
"3742","12241","2020",10,10,0,218790,2057.7,107.5
"3743","12242","2020",3,3,0,102466.666666667,925.666666666667,116.666666666667
"3744","12243","2020",7,7,0,141241.428571429,1284.71428571429,111
"3745","12244","2020",10,7,3,90320,1173.1,75.1
"3746","12246","2020",5,5,0,86500,915.6,92
"3747","12247","2020",6,6,0,68758.3333333333,1038.66666666667,71.5
"3748","12248","2020",6,5,1,180716.666666667,1731.16666666667,98.3333333333333
"3749","12249","2020",3,3,0,104408.333333333,966.666666666667,99
"3750","12250","2020",2,2,0,216450,1715,109
"3751","12251","2020",2,2,0,125000,1142.5,126.5
"3752","12252","2020",7,7,0,124335.714285714,1185.28571428571,105
"3753","12253","2020",17,13,4,130908.823529412,1733.05882352941,71.1176470588235
"3754","12254","2020",26,25,1,200619.230769231,1756.57692307692,124.961538461538
"3755","12255","2020",11,11,0,95363.6363636364,1378.27272727273,71.3636363636364
"3756","12256","2020",7,7,0,143361.428571429,1850,86.2857142857143
"3757","12257","2020",9,9,0,128333.333333333,1240.11111111111,95.2222222222222
"3758","12258","2020",15,15,0,117751.333333333,1670.46666666667,90.3333333333333
"3759","12259","2020",8,8,0,118787.5,971.625,112.75
"3760","12260","2020",7,7,0,79028.5714285714,1006.85714285714,66.1428571428571
"3761","12261","2020",3,3,0,132766.666666667,879.666666666667,146.666666666667
"3762","12262","2020",9,9,0,130521.111111111,1203.66666666667,104.111111111111
"3763","12263","2020",9,9,0,215757.777777778,1563.22222222222,133.111111111111
"3764","12264","2020",35,31,4,197716,2022.2,99.6285714285714
"3765","12265","2020",2,2,0,92000,1138.5,80.5
"3766","12266","2020",6,6,0,94751.6666666667,1270.83333333333,77.5
"3767","12267","2020",4,4,0,50417.5,812.75,59.25
"3768","12268","2020",5,5,0,71800,1134.6,72.2
"3769","12269","2020",3,3,0,121666.666666667,1145.66666666667,100.333333333333
"3770","12270","2020",64,56,8,139345.890625,1342.265625,101.359375
"3771","12272","2020",6,6,0,124166.666666667,1231.66666666667,105.833333333333
"3772","12274","2020",3,3,0,170833.333333333,1135,113.333333333333
"3773","12275","2020",1,1,0,45000,500,90
"3774","12276","2020",7,7,0,114142.857142857,1087.28571428571,116.428571428571
"3775","12277","2020",5,5,0,105000,1366.2,72.8
"3776","12278","2020",3,3,0,120000,1003.33333333333,122.666666666667
"3777","12280","2020",2,2,0,180000,1823,93
"3778","12281","2020",4,4,0,89750,920.75,105
"3779","12282","2020",7,7,0,102371.428571429,1101,93.4285714285714
"3780","12283","2020",5,5,0,133000,944.2,140
"3781","12284","2020",4,4,0,125810,1826.5,73.25
"3782","12286","2020",11,10,1,85070,937.818181818182,92.7272727272727
"3783","12287","2020",6,6,0,120161.666666667,1352,85.5
"3784","12288","2020",15,15,0,137063.466666667,1348.6,105.6
"3785","12289","2020",3,3,0,128333.333333333,955.333333333333,127.666666666667
"3786","12290","2020",3,3,0,85523.3333333333,981.666666666667,99
"3787","12291","2020",5,3,2,164520,2010.8,81
"3788","12292","2020",5,5,0,64800,1249,60.8
"3789","12293","2020",1,1,0,120000,1558,77
"3790","12294","2020",8,8,0,59641.25,871.75,72.25
"3791","12295","2020",3,3,0,121666.666666667,1097.33333333333,120.333333333333
"3792","12296","2020",10,10,0,63440.5,962.8,65.4
"3793","12297","2020",7,7,0,98791.4285714286,1913.42857142857,66.7142857142857
"3794","12298","2020",3,3,0,136333.333333333,917.666666666667,120.333333333333
"3795","12299","2020",11,11,0,115099.090909091,1375.27272727273,95.7272727272727
"3796","12300","2020",167,116,51,125830.065868263,1362.80838323353,96.3173652694611
"3797","12301","2020",17,17,0,148950.882352941,1366.41176470588,107.176470588235
"3798","12303","2020",5,5,0,189190,1387.2,134.4
"3799","12305","2020",14,14,0,69753.5714285714,826.928571428571,83.6428571428571
"3800","12307","2020",3,3,0,259100,2423.66666666667,103.333333333333
"3801","13001","2020",2190,351,1839,317471.823287671,4609.69315068493,67.6374429223744
"3802","13002","2020",239,156,83,340357.213389121,4204.78242677824,83.3640167364017
"3803","13003","2020",27,25,2,304079.444444444,2906.77777777778,105.962962962963
"3804","13004","2020",628,383,245,203816.511146497,2639.35191082803,78.0987261146497
"3805","13005","2020",475,174,301,264965.581052632,3284.41894736842,79.2336842105263
"3806","13006","2020",9,9,0,272011.111111111,3314.55555555556,88.2222222222222
"3807","13007","2020",117,77,40,334996.666666667,3706.84615384615,89.9401709401709
"3808","13008","2020",4,4,0,476280,2789.25,175.75
"3809","13009","2020",5,4,1,280516,2763.4,112.6
"3810","13010","2020",49,37,12,278867.959183673,3051.40816326531,92.3673469387755
"3811","13011","2020",10,9,1,837753.5,6388.3,140.9
"3812","13012","2020",4,4,0,818422.5,5467.5,148.75
"3813","13013","2020",13,13,0,417678.538461538,4066.38461538462,108.615384615385
"3814","13014","2020",88,54,34,210362.409090909,2604.01136363636,80.625
"3815","13015","2020",130,92,38,426136.038461538,4613.83846153846,96.7076923076923
"3816","13016","2020",73,51,22,314698.602739726,3653.54794520548,88.5479452054795
"3817","13017","2020",18,16,2,272740.111111111,2577.16666666667,107.722222222222
"3818","13018","2020",56,47,9,240261.25,2631.66071428571,92.8571428571429
"3819","13019","2020",100,70,30,463718.95,4700.29,98.05
"3820","13020","2020",30,26,4,334667.8,3621.43333333333,92.6666666666667
"3821","13021","2020",105,61,44,537366.580952381,5304.80952380952,100.819047619048
"3822","13022","2020",134,30,104,478052.552238806,6833.09701492537,72.410447761194
"3823","13023","2020",61,50,11,499091.049180328,4793.96721311475,100.606557377049
"3824","13024","2020",25,19,6,231541.48,2758.56,85.36
"3825","13025","2020",36,19,17,415196.083333333,4308.58333333333,97.7222222222222
"3826","13026","2020",199,136,63,272366.08040201,3433.34673366834,80.1356783919598
"3827","13027","2020",201,127,74,209688.666666667,2526.84577114428,83.6318407960199
"3828","13028","2020",727,163,564,286144.121045392,4541.65061898212,62.2957359009629
"3829","13029","2020",17,17,0,392884.705882353,3439.76470588235,127.882352941176
"3830","13030","2020",45,37,8,324297.533333333,3693.97777777778,89.0888888888889
"3831","13031","2020",48,26,22,309755.416666667,3603.64583333333,86.1041666666667
"3832","13032","2020",111,80,31,476142.189189189,4737.88288288288,100.072072072072
"3833","13033","2020",73,55,18,443306.315068493,4968.47945205479,92.3561643835616
"3834","13034","2020",37,36,1,1090228.10810811,6447.05405405405,162.027027027027
"3835","13035","2020",104,87,17,274045.355769231,3481.19230769231,82.6730769230769
"3836","13036","2020",56,49,7,382320,3383.14285714286,111.892857142857
"3837","13037","2020",98,79,19,297744.010204082,3479.80612244898,87.2448979591837
"3838","13038","2020",43,39,4,391241.302325581,3412.32558139535,105.488372093023
"3839","13039","2020",189,135,54,231928.671957672,2814.08994708995,85.6984126984127
"3840","13040","2020",114,81,33,364754.859649123,4160.41228070175,89.8947368421053
"3841","13041","2020",202,88,114,240267.95049505,3402.70792079208,72.0247524752475
"3842","13042","2020",49,39,10,452814.224489796,4297.71428571429,102.714285714286
"3843","13043","2020",100,74,26,279396.24,3451.2,82.42
"3844","13044","2020",54,39,15,324496.537037037,3350.7962962963,94.3518518518518
"3845","13045","2020",68,59,9,267734.897058824,2841.60294117647,97.1323529411765
"3846","13046","2020",39,32,7,381611.769230769,3974.61538461538,99.1794871794872
"3847","13047","2020",469,259,210,215161.57782516,2781.74413646055,78.1940298507463
"3848","13048","2020",50,41,9,332511.06,3350.04,104
"3849","13049","2020",27,25,2,293951.666666667,2906.48148148148,106.962962962963
"3850","13050","2020",125,83,42,336321.368,3503.848,94.96
"3851","13051","2020",102,84,18,282260.303921569,3535.76470588235,83.9901960784314
"3852","13052","2020",22,21,1,382127.727272727,3401.63636363636,106.090909090909
"3853","13053","2020",138,88,50,300200.463768116,3424.59420289855,86.4710144927536
"3854","13054","2020",424,154,270,214993.870283019,2779.6391509434,76.3160377358491
"3855","13055","2020",12850,1634,11216,202692.700389105,3037.59315175097,64.9050583657587
"3856","13056","2020",443,153,290,213066.943566591,2890.79683972912,75.3950338600451
"3857","13057","2020",5,5,0,361928,3123.8,112.4
"3858","13058","2020",55,48,7,667039.781818182,4851.50909090909,127.8
"3859","13059","2020",38,25,13,280942.236842105,3237.84210526316,84.6842105263158
"3860","13060","2020",43,25,18,389477.674418605,4435.18604651163,88.7441860465116
"3861","13061","2020",1,1,0,280000,3182,88
"3862","13062","2020",43,42,1,394463.651162791,4371.55813953488,92.5348837209302
"3863","13063","2020",308,161,147,197783.564935065,2532.29545454545,77.8993506493507
"3864","13064","2020",20,19,1,326344.2,3169.65,103.3
"3865","13065","2020",59,57,2,286232.423728814,3173.69491525424,88.4237288135593
"3866","13066","2020",67,57,10,263422.776119403,2800.74626865672,92.7313432835821
"3867","13067","2020",40,36,4,251125.075,2712.6,90.175
"3868","13068","2020",40,38,2,551872.675,3983.775,122.425
"3869","13069","2020",124,102,22,319340.620967742,3535.60483870968,90.5322580645161
"3870","13070","2020",65,39,26,294881.830769231,3649.33846153846,83.2
"3871","13071","2020",213,147,66,299599.187793427,3604.3896713615,85.3990610328639
"3872","13072","2020",48,40,8,356296.770833333,3704.6875,94.7291666666667
"3873","13073","2020",69,56,13,347256.434782609,3922.72463768116,90.6376811594203
"3874","13074","2020",70,47,23,285759.214285714,2999.62857142857,92.9714285714286
"3875","13075","2020",144,60,84,296834.805555556,4076.01388888889,74.3055555555556
"3876","13076","2020",43,40,3,281725.744186047,2602.76744186047,108.488372093023
"3877","13077","2020",144,81,63,196566.145833333,2461.70138888889,79.2569444444444
"3878","13078","2020",68,48,20,176641.852941176,2383.32352941176,73.8235294117647
"3879","13079","2020",12,12,0,398445.833333333,4246.66666666667,102.333333333333
"3880","13080","2020",54,44,10,363953.185185185,3753.14814814815,98.5925925925926
"3881","13081","2020",170,117,53,272003.488235294,3188.8,87.2882352941176
"3882","13082","2020",52,41,11,484226.096153846,4151.09615384615,116.865384615385
"3883","13083","2020",45,36,9,289051.755555556,2910.15555555556,99.7111111111111
"3884","13084","2020",59,51,8,283476.118644068,2881.37288135593,98.0169491525424
"3885","13085","2020",67,36,31,336116.179104478,3986.67164179104,84.3134328358209
"3886","13086","2020",108,68,40,335136.759259259,3755.89814814815,88.4351851851852
"3887","13087","2020",53,28,25,303624.301886792,3934.67924528302,79.1320754716981
"3888","13088","2020",52,37,15,332514.903846154,4325.11538461538,78.9230769230769
"3889","13089","2020",35,26,9,194457,2125.48571428571,88.5714285714286
"3890","13090","2020",1,1,0,855000,5588,153
"3891","13091","2020",92,76,16,407666.75,3868.58695652174,108.75
"3892","13092","2020",135,75,60,229005.511111111,2940.28148148148,78.4148148148148
"3893","13093","2020",4,4,0,376550,4765.75,114
"3894","13094","2020",31,20,11,299226.129032258,4490.48387096774,87.0322580645161
"3895","13095","2020",5,4,1,1042270,6109.2,166.2
"3896","13096","2020",96,36,60,206495.104166667,4005.40625,54.9375
"3897","13097","2020",163,133,30,258297.128834356,2910.99386503067,89.9263803680982
"3898","13098","2020",71,58,13,261412.732394366,3119.43661971831,83.8732394366197
"3899","13099","2020",13,10,3,229553.846153846,2299.61538461538,98.3846153846154
"3900","13100","2020",167,129,38,514902.874251497,4635.47305389222,106.425149700599
"3901","13101","2020",35,24,11,324372.114285714,3995,80.7142857142857
"3902","13102","2020",45,38,7,275123.622222222,3447.62222222222,82.4888888888889
"3903","13103","2020",667,235,432,204845.191904048,2754.26236881559,74.4197901049475
"3904","13104","2020",139,57,82,316220.057553957,5667.82014388489,60.9784172661871
"3905","13105","2020",56,49,7,265206.285714286,3389.51785714286,83.3214285714286
"3906","13106","2020",119,55,64,251602.025210084,3289.17647058824,78.7563025210084
"3907","13107","2020",62,51,11,413080.032258065,4077.24193548387,100.983870967742
"3908","13108","2020",162,89,73,146822.530864198,1665.61728395062,84.179012345679
"3909","13109","2020",23,19,4,814303.913043478,6370.26086956522,123.521739130435
"3910","13110","2020",158,109,49,296679.898734177,3398.60759493671,88.2911392405063
"3911","13111","2020",10,5,5,430166.5,4099.4,99.5
"3912","13112","2020",86,71,15,368813.244186047,3757.11627906977,98.6511627906977
"3913","13113","2020",93,68,25,424587.838709677,4222.05376344086,97.7096774193548
"3914","13114","2020",66,59,7,588577.939393939,4487.28787878788,128.681818181818
"3915","13115","2020",25,23,2,304495,3635.56,85.68
"3916","13116","2020",6,6,0,425616.666666667,3003,155.666666666667
"3917","13117","2020",394,200,194,242406.631979695,3130.64974619289,77.6979695431472
"3918","13118","2020",34,31,3,373193.970588235,4032.64705882353,93.5882352941177
"3919","13119","2020",83,41,42,326647.096385542,3729.89156626506,86.8915662650602
"3920","14001","2020",17,17,0,227992.352941176,1974.29411764706,121.588235294118
"3921","14003","2020",3,3,0,191936.666666667,2199.66666666667,87
"3922","14005","2020",25,25,0,190763.6,1857.84,111.12
"3923","14006","2020",16,16,0,258007.875,1807.6875,148.8125
"3924","14007","2020",2,2,0,257500,2375.5,109
"3925","14009","2020",19,18,1,236026.842105263,2312.26315789474,103.105263157895
"3926","14011","2020",21,21,0,182834.047619048,1572.52380952381,113.761904761905
"3927","14012","2020",6,4,2,149458.333333333,1662.83333333333,98.5
"3928","14014","2020",10,10,0,232968.5,2418.8,97.2
"3929","14015","2020",10,7,3,335106,2112.1,152.7
"3930","14016","2020",9,9,0,199027.777777778,2092.33333333333,102
"3931","14020","2020",35,33,2,208378.057142857,2179.05714285714,99.7714285714286
"3932","14021","2020",8,6,2,177687.5,2018.125,93.75
"3933","14022","2020",28,25,3,138929.642857143,2086.35714285714,68.5714285714286
"3934","14023","2020",1,1,0,137000,2283,60
"3935","14024","2020",11,10,1,337994.545454545,2732.72727272727,119.181818181818
"3936","14025","2020",4,4,0,158250,1338.25,111.25
"3937","14026","2020",15,15,0,200052.666666667,1621.06666666667,118.466666666667
"3938","14027","2020",45,38,7,131130.888888889,1332.46666666667,99.0888888888889
"3939","14030","2020",17,17,0,284182.352941176,2355.35294117647,122.705882352941
"3940","14032","2020",5,5,0,326400,3402,109.4
"3941","14033","2020",1,1,0,237000,2324,102
"3942","14034","2020",9,9,0,204883.333333333,2077.77777777778,103.555555555556
"3943","14035","2020",29,29,0,150671.482758621,1362.37931034483,110.689655172414
"3944","14036","2020",4,4,0,216475,2211.25,97.5
"3945","14037","2020",8,8,0,127128.125,1197.125,111.25
"3946","14038","2020",13,13,0,239196.153846154,1877.69230769231,132.923076923077
"3947","14039","2020",9,9,0,192511.111111111,1905.22222222222,104.444444444444
"3948","14040","2020",2,2,0,102800,792.5,119
"3949","14041","2020",1,1,0,6e+05,4027,149
"3950","14042","2020",15,15,0,280426.133333333,2197.73333333333,132.066666666667
"3951","14044","2020",12,12,0,249052.416666667,2109.41666666667,119.75
"3952","14045","2020",4,4,0,212500,2659,85.25
"3953","14046","2020",29,29,0,219346.517241379,2315.79310344828,100.310344827586
"3954","14047","2020",190,106,84,200011.947368421,2144.95263157895,90.5578947368421
"3955","14049","2020",3,3,0,181540,2349.33333333333,79.6666666666667
"3956","14050","2020",4,4,0,133035,1047,134.5
"3957","14053","2020",4,4,0,112303.75,799.75,139.5
"3958","14054","2020",2,2,0,184100,1389.5,133
"3959","14055","2020",13,12,1,322997.692307692,2359.53846153846,123.384615384615
"3960","14057","2020",19,19,0,180432.105263158,1890.31578947368,99.5263157894737
"3961","14059","2020",55,18,37,285344.418181818,3916.07272727273,66.4363636363636
"3962","14060","2020",20,18,2,191074.2,1957.6,97.95
"3963","14061","2020",110,109,1,114059.190909091,1110.31818181818,103.636363636364
"3964","14062","2020",6,6,0,170216.666666667,1646,105.666666666667
"3965","14063","2020",5,5,0,141700,1273.4,108.4
"3966","14064","2020",4,4,0,145912.5,1147.5,134.5
"3967","14066","2020",57,40,17,189893.859649123,2807.24561403509,69.6315789473684
"3968","14068","2020",44,43,1,309365.090909091,2500.38636363636,126.659090909091
"3969","14069","2020",7,6,1,123600,1452.14285714286,83
"3970","14070","2020",4,4,0,532305.5,3001,161.5
"3971","14076","2020",63,35,28,188822.222222222,2291.06349206349,82.4126984126984
"3972","14077","2020",15,15,0,269883.666666667,3104.6,97.7333333333333
"3973","14078","2020",7,7,0,218706.714285714,1804.42857142857,125.142857142857
"3974","14079","2020",120,34,86,183520.558333333,3309.3,54.1583333333333
"3975","14080","2020",3,3,0,177666.666666667,1571.33333333333,114.333333333333
"3976","14082","2020",2,2,0,176250,1497,120
"3977","14083","2020",22,22,0,163272.5,1879.77272727273,97.3181818181818
"3978","14084","2020",10,10,0,145628,1296,121
"3979","14085","2020",16,16,0,230453.8125,2058.8125,122.3125
"3980","14086","2020",11,11,0,404248.727272727,2805.09090909091,150.454545454545
"3981","14087","2020",2,2,0,145129,1224.5,120
"3982","14088","2020",8,8,0,178675,1772.75,102.25
"3983","14089","2020",6,6,0,197246.666666667,1845.5,107.833333333333
"3984","14090","2020",15,15,0,173302.333333333,1776.53333333333,99.2
"3985","14091","2020",7,7,0,436514.285714286,4122.42857142857,107.285714285714
"3986","14092","2020",47,39,8,239658.787234043,2389.31914893617,105.617021276596
"3987","14093","2020",1,1,0,415000,2767,150
"3988","14096","2020",5,5,0,112450,1123.2,100.2
"3989","14097","2020",8,8,0,195584.125,1795.875,112
"3990","14098","2020",84,82,2,216752.154761905,2121.04761904762,105.214285714286
"3991","14100","2020",14,12,2,162642.857142857,1589.21428571429,106.642857142857
"3992","14101","2020",45,41,4,274191.111111111,2806.15555555556,101.288888888889
"3993","14102","2020",19,19,0,204374.736842105,1855.21052631579,113.052631578947
"3994","14103","2020",8,8,0,183168.75,1340.75,141.25
"3995","14104","2020",4,4,0,439671,4137.5,135.25
"3996","14106","2020",13,13,0,236307.692307692,2519.23076923077,97.7692307692308
"3997","14107","2020",1,1,0,1e+05,1449,69
"3998","14110","2020",1,1,0,272000,2925,93
"3999","14111","2020",8,8,0,166262.5,1502.625,111.125
"4000","14116","2020",4,4,0,118525,1766,68.5
"4001","14117","2020",443,82,361,167434.291196388,3731.19187358916,44.5959367945824
"4002","14118","2020",2217,343,1874,166767.622011728,2627.55660802887,64.5493910690122
"4003","14119","2020",13,13,0,179123.076923077,2106.76923076923,88.7692307692308
"4004","14120","2020",19,19,0,178849.473684211,1756.52631578947,109
"4005","14121","2020",3,3,0,181000,1383,126.666666666667
"4006","14122","2020",3,3,0,160333.333333333,1585.33333333333,105.333333333333
"4007","14123","2020",23,23,0,294746.086956522,2365,127.565217391304
"4008","14124","2020",11,11,0,115636.272727273,1476,88.0909090909091
"4009","14125","2020",26,23,3,247564.846153846,2370.30769230769,109.615384615385
"4010","14126","2020",19,18,1,281486.789473684,2356.63157894737,120.421052631579
"4011","14127","2020",9,9,0,95200,1009.88888888889,95.5555555555556
"4012","14130","2020",4,4,0,159125,1211.25,127.75
"4013","14131","2020",8,8,0,418650,3075.75,142.875
"4014","14132","2020",5,5,0,152995,1428.8,114.6
"4015","14134","2020",4,4,0,212075,1658,132
"4016","14135","2020",5,5,0,225900,1681.6,137.4
"4017","14136","2020",2,2,0,163995,1348.5,123.5
"4018","14137","2020",21,21,0,218230.952380952,2356.71428571429,93.2857142857143
"4019","14138","2020",3,3,0,103666.666666667,637.666666666667,161.333333333333
"4020","14140","2020",6,6,0,132016.666666667,1272.5,98.3333333333333
"4021","14141","2020",2,2,0,73500,677,108
"4022","14143","2020",38,38,0,123185,1322.86842105263,96.4210526315789
"4023","14145","2020",5,5,0,185000,1865.6,100.4
"4024","14146","2020",5,5,0,112200,1056.4,105.8
"4025","14147","2020",1,1,0,69850,852,82
"4026","14149","2020",8,8,0,199931.25,2021.875,104
"4027","14150","2020",19,19,0,152306.894736842,1370.42105263158,115.947368421053
"4028","14159","2020",1,1,0,239000,1494,160
"4029","14160","2020",1,1,0,390000,3482,112
"4030","14161","2020",6,6,0,290146.666666667,1955,145.333333333333
"4031","14162","2020",24,24,0,149108.958333333,1562.70833333333,96.8333333333333
"4032","14163","2020",5,5,0,203600,2168.6,92.4
"4033","14165","2020",5,5,0,209840,2141.6,101
"4034","14166","2020",45,43,2,230746.555555556,2513.31111111111,94.1777777777778
"4035","14167","2020",51,35,16,179312.745098039,2291.09803921569,81.0588235294118
"4036","14168","2020",3,3,0,116250,1351.33333333333,79.3333333333333
"4037","14171","2020",2,2,0,171550,1431.5,120.5
"4038","14172","2020",11,11,0,183170.909090909,2018.63636363636,93.1818181818182
"4039","14173","2020",4,4,0,179475,1726,105.25
"4040","14174","2020",61,53,8,95900.3442622951,1007.45901639344,100.459016393443
"4041","14175","2020",4,4,0,247125,2016.25,128.5
"4042","14177","2020",17,17,0,193041.176470588,1749.76470588235,114.941176470588
"4043","14179","2020",2,2,0,222500,2585.5,98.5
"4044","14180","2020",2,2,0,132000,1521.5,89
"4045","14181","2020",68,46,22,207199.823529412,2306.44117647059,86.3676470588235
"4046","14182","2020",13,13,0,125719.230769231,1114.76923076923,110.307692307692
"4047","14183","2020",1,1,0,191000,1364,140
"4048","14184","2020",5,5,0,220660,1624.6,137.4
"4049","14190","2020",3,3,0,67666.6666666667,994.333333333333,69.3333333333333
"4050","14191","2020",242,60,182,134540.404958678,2707.5826446281,49.8884297520661
"4051","14193","2020",14,14,0,163228.571428571,1554.71428571429,106.571428571429
"4052","14194","2020",16,16,0,118449.375,1429.875,91.625
"4053","14195","2020",2,2,0,217000,1496.5,145
"4054","14196","2020",4,4,0,183825,1747.5,118.5
"4055","14197","2020",12,12,0,254867.5,2112.66666666667,123.166666666667
"4056","14198","2020",5,5,0,228874,2119,108.4
"4057","14200","2020",33,31,2,186136.696969697,2004.21212121212,94.2727272727273
"4058","14202","2020",6,6,0,316560,2945.16666666667,109.833333333333
"4059","14203","2020",4,4,0,365677.5,2249.25,171.5
"4060","14205","2020",3,3,0,170785.666666667,2357.33333333333,65
"4061","14206","2020",6,6,0,207425,1585.83333333333,126.666666666667
"4062","14207","2020",11,11,0,146324.090909091,1266.36363636364,120.545454545455
"4063","14209","2020",7,7,0,133485.714285714,1173.42857142857,123.571428571429
"4064","14211","2020",5,5,0,125200,1122,99
"4065","14214","2020",2,2,0,230500,1906.5,151.5
"4066","14215","2020",21,20,1,228746.904761905,2343.14285714286,100.904761904762
"4067","14216","2020",4,4,0,209095,1177.5,183
"4068","14218","2020",5,5,0,171846.2,1824,93.6
"4069","14220","2020",342,84,258,369862.230994152,5201.37426900585,68.7748538011696
"4070","14221","2020",32,25,7,207525.125,2416.59375,88.5625
"4071","14223","2020",1,1,0,106000,946,112
"4072","14225","2020",118,72,46,172950.728813559,3072.96610169492,59.9491525423729
"4073","14226","2020",8,8,0,165633.125,1079.375,139.125
"4074","14227","2020",2,2,0,226720,3097.5,82.5
"4075","14228","2020",81,60,21,241917.098765432,2464.9012345679,99.9876543209877
"4076","14229","2020",29,27,2,162862.068965517,1877.89655172414,87.3448275862069
"4077","14230","2020",2,2,0,265275,2586.5,106
"4078","14231","2020",12,12,0,238208.333333333,2180.66666666667,109.833333333333
"4079","14232","2020",2,2,0,277750,1391.5,203.5
"4080","14236","2020",6,6,0,153950,1461,104.833333333333
"4081","14237","2020",6,6,0,194363.333333333,1843.16666666667,107.666666666667
"4082","14238","2020",5,5,0,738490,4773.4,178
"4083","14239","2020",1,1,0,227500,1591,143
"4084","14240","2020",3,3,0,198333.333333333,1707,119.333333333333
"4085","14241","2020",3,3,0,173500,1775.66666666667,106
"4086","14242","2020",18,18,0,314022.222222222,2506.88888888889,127.555555555556
"4087","14243","2020",29,18,11,340998.275862069,2897.20689655172,106.48275862069
"4088","14244","2020",5,5,0,168660,1536,114.2
"4089","14245","2020",9,9,0,137388.888888889,1263.77777777778,114.555555555556
"4090","14246","2020",8,8,0,238512.5,2580.5,102.5
"4091","14248","2020",2,2,0,186740,1939,97.5
"4092","14249","2020",18,18,0,215204.444444444,2136.33333333333,105.777777777778
"4093","14250","2020",5,5,0,164160,1557,99.8
"4094","14251","2020",6,6,0,161918.333333333,1435.83333333333,111
"4095","14252","2020",7,7,0,184400,1566.42857142857,130.571428571429
"4096","14254","2020",21,21,0,254897.619047619,2055.61904761905,128.142857142857
"4097","14256","2020",5,5,0,208500,2245.6,98.2
"4098","14257","2020",25,25,0,209605.2,2004.96,105.52
"4099","14258","2020",124,73,51,133716.419354839,1624.70967741935,84.4032258064516
"4100","14260","2020",5,5,0,367049,2287.6,163.8
"4101","14261","2020",6,6,0,475835.833333333,3059.16666666667,165
"4102","14266","2020",14,14,0,168076.785714286,1874.64285714286,91.1428571428571
"4103","14269","2020",2,2,0,868830,2560,312
"4104","14270","2020",3,3,0,213333.333333333,1521,146.666666666667
"4105","14271","2020",72,52,20,210288.958333333,2507.65277777778,85.6805555555556
"4106","14272","2020",3,3,0,81240,1156.33333333333,94
"4107","14273","2020",2,2,0,109400,1874,59.5
"4108","14274","2020",40,36,4,268136.25,2299.475,118.55
"4109","14275","2020",9,9,0,191033.333333333,1568.66666666667,119.444444444444
"4110","14276","2020",1,1,0,34000,654,52
"4111","14277","2020",23,22,1,193416.52173913,1767.30434782609,114.695652173913
"4112","14278","2020",13,13,0,192728.230769231,1911.76923076923,103.692307692308
"4113","14280","2020",1,1,0,350000,5385,65
"4114","14281","2020",14,14,0,164428.571428571,1415.78571428571,114.142857142857
"4115","14282","2020",4,4,0,194075,1520.5,123.5
"4116","14283","2020",2,2,0,271500,2932.5,125
"4117","14284","2020",1,1,0,80000,748,107
"4118","14286","2020",10,10,0,292280,1972.4,138.1
"4119","14287","2020",22,22,0,180347.727272727,2039.68181818182,87.9545454545455
"4120","14288","2020",15,14,1,257673,2050.33333333333,135.733333333333
"4121","14289","2020",3,3,0,157733.333333333,1301,124.333333333333
"4122","14290","2020",16,16,0,170471.25,1894.1875,93.0625
"4123","14291","2020",3,3,0,226500,1328.33333333333,198.666666666667
"4124","14293","2020",5,5,0,314110,2757.2,112.6
"4125","14297","2020",7,7,0,198232.142857143,2030.71428571429,99.1428571428571
"4126","14298","2020",6,6,0,137788.333333333,1558.33333333333,88.3333333333333
"4127","14299","2020",12,12,0,264973.083333333,2351.25,113.666666666667
"4128","14300","2020",2,2,0,2e+05,1496.5,131.5
"4129","14301","2020",44,43,1,191509.772727273,2529.47727272727,78.4772727272727
"4130","14302","2020",3,3,0,335000,3271.33333333333,99.3333333333333
"4131","14303","2020",7,7,0,158714.285714286,1692.14285714286,92
"4132","14304","2020",12,12,0,322075,2614,126.583333333333
"4133","14305","2020",17,17,0,503772.352941176,3786.23529411765,144
"4134","14306","2020",5,5,0,328725,2707.4,139.4
"4135","14308","2020",5,5,0,189558,2099.2,92
"4136","14309","2020",15,14,1,159706.666666667,1775.2,91.6666666666667
"4137","14310","2020",13,13,0,184705.384615385,2141.15384615385,88.5384615384615
"4138","14311","2020",15,15,0,171487.333333333,1874.8,95.0666666666667
"4139","14312","2020",76,46,30,108955.986842105,1662.92105263158,64.3684210526316
"4140","14316","2020",6,6,0,521310.666666667,3098.33333333333,177.166666666667
"4141","14318","2020",13,13,0,235300,2102.46153846154,114.461538461538
"4142","14319","2020",16,14,2,187606.5625,2245.3125,88.375
"4143","14320","2020",5,5,0,198378,1715.6,119.2
"4144","14322","2020",2,2,0,185450,1951.5,94.5
"4145","14325","2020",57,50,7,218563.368421053,2517.89473684211,84.859649122807
"4146","14326","2020",10,10,0,233220,1909.8,126.2
"4147","14327","2020",268,61,207,120014.041044776,1769.71641791045,67.339552238806
"4148","14328","2020",12,12,0,250889.166666667,2471.41666666667,109.583333333333
"4149","14329","2020",4,4,0,288500,2580.75,112.5
"4150","14332","2020",10,10,0,183560,1582,125.3
"4151","14333","2020",54,32,22,259377.944444444,3017.31481481481,88.6111111111111
"4152","14334","2020",5,5,0,157200,1412.2,108.6
"4153","14335","2020",3,3,0,191666.666666667,1843.33333333333,101.333333333333
"4154","14336","2020",2,2,0,217000,1347.5,168.5
"4155","14337","2020",4,4,0,149749.25,1564,92.75
"4156","14338","2020",205,62,143,187473.234146341,3189.07317073171,57.9317073170732
"4157","14341","2020",167,89,78,175894.28742515,2207.44910179641,79.8682634730539
"4158","14342","2020",51,44,7,116991.823529412,1232.72549019608,95.078431372549
"4159","14343","2020",2,2,0,145950,1054,126.5
"4160","14344","2020",4,4,0,186500,1717.5,113
"4161","14345","2020",4,4,0,105425,720.75,144.5
"4162","14346","2020",11,11,0,136534.090909091,1349.09090909091,101.909090909091
"4163","14347","2020",18,18,0,130314.944444444,1455.16666666667,97.6666666666667
"4164","14348","2020",1,1,0,1e+05,1282,78
"4165","14349","2020",25,25,0,211428.04,2134.08,103.24
"4166","14352","2020",16,16,0,112486.5625,1092.3125,108.3125
"4167","14353","2020",9,9,0,145911.111111111,1336.77777777778,115.111111111111
"4168","14354","2020",39,31,8,206573.076923077,2656.20512820513,82.2051282051282
"4169","14355","2020",14,14,0,241631.785714286,2015.42857142857,122.357142857143
"4170","14357","2020",17,17,0,103624.705882353,1057.17647058824,103.058823529412
"4171","14358","2020",1,1,0,177500,3413,52
"4172","14360","2020",2,2,0,158255,1317,121
"4173","14362","2020",1,1,0,327500,2729,120
"4174","14364","2020",8,8,0,180087.5,1632.5,126.75
"4175","14365","2020",61,46,15,227388.409836066,2933.55737704918,79.1147540983606
"4176","14366","2020",353,128,225,108230.790368272,1440.00283286119,74.1444759206799
"4177","14367","2020",6,6,0,156916.666666667,1443.33333333333,116.666666666667
"4178","14368","2020",7,7,0,153575,1461.71428571429,100.142857142857
"4179","14369","2020",3,3,0,127500,849,147.333333333333
"4180","14370","2020",36,36,0,134341.527777778,1485.94444444444,92.6944444444444
"4181","14371","2020",99,98,1,158375.676767677,1463.71717171717,106.020202020202
"4182","14375","2020",1,1,0,133000,1462,91
"4183","14377","2020",6,6,0,124116.666666667,1305.33333333333,94.6666666666667
"4184","14378","2020",5,5,0,108380,1285.6,89
"4185","14379","2020",5,5,0,271134.4,1610,144.2
"4186","14380","2020",2,2,0,237750,1920.5,134.5
"4187","14381","2020",1,1,0,120000,1176,102
"4188","14383","2020",30,24,6,262676.833333333,2396.53333333333,111.166666666667
"4189","14384","2020",86,52,34,221669.418604651,2913.67441860465,77.8255813953488
"4190","14389","2020",5,5,0,134500,1599.4,93
"4191","14390","2020",5,5,0,132300,1436.4,89.2
"4192","14391","2020",3,3,0,199333.333333333,2149.66666666667,92
"4193","14393","2020",1,1,0,231035,2139,108
"4194","14394","2020",7,7,0,176142.857142857,1521.71428571429,117.285714285714
"4195","14396","2020",14,14,0,210465.714285714,2147.5,104
"4196","14397","2020",4,4,0,262250,1531,185.75
"4197","14398","2020",11,11,0,233418.181818182,2115.27272727273,112.454545454545
"4198","14399","2020",9,9,0,367940,2966.33333333333,137.222222222222
"4199","14400","2020",3,3,0,225333.333333333,1431.33333333333,158.666666666667
"4200","14403","2020",13,13,0,170306.846153846,1548.61538461538,101.615384615385
"4201","14404","2020",3,3,0,181663.333333333,1582,115.333333333333
"4202","14405","2020",3,3,0,126833.333333333,1324.33333333333,102.333333333333
"4203","14406","2020",16,16,0,250075,1705.1875,147.125
"4204","14407","2020",38,33,5,349974.026315789,2774.89473684211,127.736842105263
"4205","14408","2020",19,17,2,205496.052631579,2181.05263157895,96.8947368421053
"4206","14409","2020",102,46,56,203207.107843137,3172.13725490196,65.5196078431373
"4207","14410","2020",18,18,0,177175,1687.72222222222,104.777777777778
"4208","14411","2020",7,7,0,192708,1552.14285714286,125.857142857143
"4209","14412","2020",3,3,0,202100,1382,151.333333333333
"4210","14419","2020",1,1,0,305000,3177,96
"4211","14421","2020",12,12,0,163259.166666667,1687.5,98.9166666666667
"4212","14424","2020",3,3,0,108583.333333333,1015.33333333333,106.666666666667
"4213","14425","2020",1,1,0,167000,1704,98
"4214","14426","2020",4,4,0,513067.5,2648.25,217.25
"4215","14427","2020",4,4,0,77537.5,1011.25,79
"4216","14430","2020",2,2,0,177000,1899.5,92
"4217","14431","2020",127,121,6,147504.598425197,1543.84251968504,98.1417322834646
"4218","14435","2020",4,4,0,348887.5,2497,136.25
"4219","14436","2020",11,11,0,223178.363636364,1803,126.909090909091
"4220","14437","2020",126,65,61,148687.920634921,2196.19047619048,69.4603174603175
"4221","14438","2020",6,6,0,242430,2215.33333333333,115.666666666667
"4222","14445","2020",1,1,0,120000,1000,120
"4223","14446","2020",1,1,0,110000,1571,70
"4224","14448","2020",1,1,0,285750,1504,190
"4225","14449","2020",4,4,0,230112.5,1545.75,155
"4226","14452","2020",10,10,0,145100,1237.8,137.3
"4227","14453","2020",5,5,0,206470,1499,143
"4228","14454","2020",25,22,3,202851.2,2085.72,100.72
"4229","14455","2020",4,4,0,126375,1834.75,68.25
"4230","14456","2020",36,36,0,197504.777777778,1925.66666666667,107.111111111111
"4231","14458","2020",9,9,0,220554.444444444,1873.33333333333,120.555555555556
"4232","14460","2020",27,27,0,173498.148148148,1761.48148148148,112.518518518519
"4233","14461","2020",3,3,0,160996.666666667,1551,98
"4234","14465","2020",5,5,0,205380,1612.6,126
"4235","14466","2020",6,6,0,246883.333333333,2242.66666666667,109.166666666667
"4236","14467","2020",3,3,0,157433.333333333,1626.66666666667,93.6666666666667
"4237","14468","2020",5,5,0,215220,2326.4,119.8
"4238","14473","2020",1,1,0,117000,1147,102
"4239","14474","2020",1,1,0,157500,2218,71
"4240","14475","2020",41,41,0,208500.829268293,1853.21951219512,116.658536585366
"4241","14476","2020",5,5,0,158110,1695.2,112.6
"4242","14478","2020",38,35,3,97203.9210526316,1270.76315789474,84.7368421052632
"4243","14480","2020",6,6,0,98458.3333333333,1400.66666666667,69.6666666666667
"4244","14482","2020",1,1,0,309000,2191,141
"4245","14483","2020",3,3,0,145000,1401.33333333333,104
"4246","14484","2020",3,3,0,452333.333333333,2396.66666666667,174.333333333333
"4247","14486","2020",6,6,0,169333.333333333,1545.5,112.833333333333
"4248","14487","2020",13,13,0,192229.615384615,1832.69230769231,106.538461538462
"4249","14488","2020",259,155,104,199856.316602317,2765.04247104247,73.3011583011583
"4250","14491","2020",1,1,0,460000,2323,198
"4251","14492","2020",6,6,0,810033.333333333,3467.33333333333,165.5
"4252","14494","2020",1,1,0,433300,3009,144
"4253","14495","2020",7,7,0,406871.428571429,2448.85714285714,167.285714285714
"4254","14496","2020",2,2,0,73523.5,1269,60
"4255","14497","2020",5,5,0,133200,1760,91.2
"4256","14498","2020",2,2,0,107101.5,893,122.5
"4257","14499","2020",6,6,0,253570,2449,106.666666666667
"4258","14500","2020",3,3,0,266000,2663,111.333333333333
"4259","14501","2020",7,7,0,136142.857142857,1062.14285714286,131
"4260","14502","2020",1,1,0,95000,731,130
"4261","14504","2020",9,9,0,185657.333333333,1711.22222222222,108.777777777778
"4262","14506","2020",2,2,0,117500,1114.5,103.5
"4263","14509","2020",2,2,0,263400,1966,140
"4264","14511","2020",3,3,0,97094.3333333333,1150,99
"4265","14512","2020",1,1,0,46000,793,58
"4266","14514","2020",69,54,15,212215.710144928,2262.63768115942,97.8695652173913
"4267","14515","2020",46,31,15,147668.217391304,2091.30434782609,72.9347826086957
"4268","14516","2020",34,34,0,119811.176470588,1830.41176470588,69.1470588235294
"4269","14519","2020",1,1,0,687856,3439,200
"4270","14520","2020",12,12,0,185860.416666667,1907.91666666667,96.4166666666667
"4271","14522","2020",6,6,0,165783.333333333,2037.33333333333,90.1666666666667
"4272","14524","2020",1,1,0,120000,1818,66
"4273","14527","2020",11,11,0,221363.636363636,1784.09090909091,112.181818181818
"4274","14528","2020",15,15,0,285468.333333333,2207.26666666667,129.6
"4275","14529","2020",2,2,0,190000,2305,85.5
"4276","14530","2020",24,24,0,211007.5,2393.41666666667,88.4166666666667
"4277","14531","2020",1,1,0,105800,1176,90
"4278","14533","2020",3,3,0,260000,2224.33333333333,111.666666666667
"4279","14534","2020",5,5,0,274710,2742.4,109.8
"4280","14535","2020",8,8,0,319056.25,2166.375,147.375
"4281","14536","2020",39,34,5,204050.923076923,2086.4358974359,98.1794871794872
"4282","14538","2020",13,12,1,237189.538461538,2261.30769230769,104.461538461538
"4283","14540","2020",5,5,0,439998,3257.2,133.6
"4284","14541","2020",1,1,0,330000,2157,153
"4285","14542","2020",6,6,0,315250,2653.33333333333,118.666666666667
"4286","14543","2020",24,22,2,224202.291666667,2088.70833333333,109.458333333333
"4287","14546","2020",4,4,0,120250,1644,72.25
"4288","14550","2020",2,2,0,222000,2372.5,124
"4289","14552","2020",5,5,0,217004,2031,122.8
"4290","14554","2020",30,30,0,201109.133333333,2029.93333333333,101.6
"4291","14555","2020",10,10,0,217340,2353.8,97.1
"4292","14556","2020",13,13,0,205378.461538462,2347.53846153846,92.7692307692308
"4293","14557","2020",56,31,25,295967.571428571,3277.83928571429,90.4464285714286
"4294","14558","2020",19,19,0,256917.052631579,2407.84210526316,110.631578947368
"4295","14559","2020",4,4,0,120750,851.25,126.5
"4296","14562","2020",58,34,24,211403.310344828,2982.63793103448,73.1551724137931
"4297","14563","2020",5,5,0,368380,2767.2,142.8
"4298","14565","2020",10,10,0,248540.3,2612.7,94
"4299","14566","2020",24,24,0,393575.916666667,2520.79166666667,152.791666666667
"4300","14569","2020",2,2,0,251025,1787,142
"4301","14570","2020",40,40,0,152969.75,1539.75,106.825
"4302","14571","2020",4,4,0,205700,1588.5,127.75
"4303","14572","2020",14,14,0,94371.4285714286,968,100.5
"4304","14574","2020",26,25,1,197573.115384615,1636.23076923077,121.769230769231
"4305","14575","2020",6,6,0,350166.666666667,2313,145.166666666667
"4306","14576","2020",8,8,0,225352.5,1765.5,124.625
"4307","14578","2020",23,23,0,283375.913043478,2746.86956521739,105.173913043478
"4308","14579","2020",18,18,0,140583.888888889,1343.83333333333,105
"4309","14582","2020",5,5,0,140980,1551.6,107.4
"4310","14586","2020",1,1,0,93000,1162,80
"4311","14587","2020",21,17,4,210545.238095238,2395.33333333333,90.3809523809524
"4312","14588","2020",3,3,0,198166.666666667,1392,160
"4313","14589","2020",12,12,0,139565.833333333,1827.5,89.25
"4314","14591","2020",12,12,0,217113.333333333,1921.91666666667,114.166666666667
"4315","14592","2020",13,13,0,204207.692307692,1840,113.230769230769
"4316","14593","2020",8,8,0,245900,2466.75,100.625
"4317","14595","2020",4,4,0,188000,2031,106
"4318","14598","2020",6,6,0,207716.666666667,2479,84
"4319","14601","2020",3,3,0,282500,2220.33333333333,126
"4320","14602","2020",4,4,0,96000,904.5,111
"4321","14603","2020",12,12,0,190828.333333333,1694.75,111.5
"4322","14605","2020",4,4,0,219312.5,2600,88.5
"4323","14606","2020",6,6,0,243887.5,2129.83333333333,124.166666666667
"4324","14607","2020",4,4,0,246000,1887.5,117.5
"4325","14609","2020",5,5,0,336290,2603.2,127.2
"4326","14610","2020",29,29,0,260011.379310345,2399.44827586207,111.51724137931
"4327","14613","2020",1,1,0,292500,1773,165
"4328","14614","2020",12,12,0,151122.833333333,1222.08333333333,118.916666666667
"4329","14619","2020",2,2,0,54000,674,83
"4330","14620","2020",14,14,0,377446.428571429,2521.28571428571,140.571428571429
"4331","14621","2020",9,9,0,124144.444444444,1125.66666666667,97.4444444444444
"4332","14622","2020",2,2,0,103105,1656,65.5
"4333","14623","2020",30,28,2,200304.6,2204.66666666667,92.8333333333333
"4334","14625","2020",9,9,0,191322.222222222,1887.77777777778,98.3333333333333
"4335","14626","2020",15,15,0,169126.666666667,1611.06666666667,109.6
"4336","14627","2020",4,4,0,115750,1051.25,106
"4337","14630","2020",9,9,0,213810,1784.77777777778,127.555555555556
"4338","14635","2020",1,1,0,168990,2036,83
"4339","14639","2020",5,5,0,223740,2619.2,87.8
"4340","14643","2020",12,12,0,179096.666666667,1430.91666666667,124.333333333333
"4341","14644","2020",16,16,0,277035.4375,2049.5625,140.6875
"4342","14645","2020",6,6,0,976158.333333333,4516.33333333333,207.166666666667
"4343","14646","2020",3,3,0,204566.666666667,1728.33333333333,125
"4344","14648","2020",4,4,0,346500,2150,158.75
"4345","14649","2020",6,6,0,183966.666666667,1652.83333333333,112.833333333333
"4346","14650","2020",7,7,0,141628.571428571,1524,98.8571428571429
"4347","14651","2020",2,2,0,311400,1749,181
"4348","14652","2020",1,1,0,125000,1302,96
"4349","14654","2020",121,120,1,172133.008264463,1600.17355371901,109.752066115702
"4350","14656","2020",17,16,1,99506.1176470588,956.470588235294,99.5882352941177
"4351","14657","2020",4,4,0,214625,1872,115.25
"4352","14658","2020",63,63,0,92373.0158730159,949.952380952381,96.9047619047619
"4353","14659","2020",15,15,0,167026.666666667,1911.26666666667,89.6666666666667
"4354","14660","2020",2,2,0,305000,2472.5,115
"4355","14661","2020",4,4,0,180000,2232.75,79.25
"4356","14663","2020",24,22,2,184683.333333333,2142.79166666667,86.0833333333333
"4357","14664","2020",2,2,0,149250,1329,120
"4358","14665","2020",12,12,0,206301.666666667,2266.75,84.4166666666667
"4359","14666","2020",20,18,2,225859,2461.25,100.7
"4360","14667","2020",7,7,0,128714.285714286,1316.57142857143,100.857142857143
"4361","14668","2020",1,1,0,120000,1121,107
"4362","14669","2020",6,6,0,116583.333333333,1063.66666666667,115.833333333333
"4363","14672","2020",13,13,0,161200,1477.38461538462,116.692307692308
"4364","14674","2020",3,3,0,231266.666666667,2149,106
"4365","14675","2020",24,24,0,231453.833333333,2270.08333333333,103.333333333333
"4366","14676","2020",12,12,0,235683.333333333,2195.58333333333,111.916666666667
"4367","14677","2020",1,1,0,256910,1586,162
"4368","14678","2020",7,7,0,150571.428571429,1749,90.5714285714286
"4369","14679","2020",11,11,0,263691.818181818,1902.63636363636,136.090909090909
"4370","14680","2020",1,1,0,128000,1488,86
"4371","14682","2020",3,3,0,516666.666666667,2822.66666666667,195
"4372","14684","2020",1,1,0,385000,1604,240
"4373","14685","2020",27,27,0,272616.518518519,2049.7037037037,133.407407407407
"4374","14687","2020",4,4,0,178750,1689.5,106.75
"4375","14689","2020",52,48,4,154217.519230769,1574.03846153846,104.961538461538
"4376","14692","2020",19,19,0,217790.473684211,1869.31578947368,123.842105263158
"4377","14694","2020",9,9,0,248366.666666667,2149,107.666666666667
"4378","14698","2020",7,7,0,186942.857142857,1797.85714285714,106
"4379","14699","2020",135,61,74,218958.459259259,2954.21481481481,69.1925925925926
"4380","14700","2020",8,8,0,440427.75,2312,141.5
"4381","14701","2020",106,22,84,352565.037735849,4494.04716981132,72.4811320754717
"4382","14705","2020",2,2,0,80000,895,91.5
"4383","14706","2020",4,4,0,230500,2377,92.5
"4384","14707","2020",13,13,0,214392.307692308,2324.53846153846,93.7692307692308
"4385","14708","2020",2,2,0,235900,1866,130
"4386","14709","2020",6,6,0,239178.333333333,1985,123.666666666667
"4387","14710","2020",2,2,0,53000,896,57.5
"4388","14711","2020",15,14,1,139019.933333333,1606.93333333333,89.3333333333333
"4389","14712","2020",48,46,2,203089.479166667,2083.0625,103.270833333333
"4390","14713","2020",5,5,0,195480,2020.6,96.2
"4391","14714","2020",10,10,0,121125,1241.3,93.3
"4392","14715","2020",405,117,288,229747.501234568,4209.32839506173,55.4296296296296
"4393","14716","2020",2,2,0,213500,1518.5,142
"4394","14719","2020",10,9,1,159713,1741,94.8
"4395","14720","2020",21,21,0,135042.333333333,1236.85714285714,110.714285714286
"4396","14721","2020",3,3,0,222500,1652.33333333333,155.666666666667
"4397","14723","2020",8,8,0,162250,2212.625,75.875
"4398","14724","2020",33,18,15,189761.939393939,3003.9696969697,63.6969696969697
"4399","14726","2020",96,96,0,111594.177083333,1162.47916666667,102.552083333333
"4400","14728","2020",5,5,0,223980,2318.2,97.6
"4401","14731","2020",11,11,0,707695,3345.18181818182,201.454545454545
"4402","14732","2020",6,6,0,183500,1494.83333333333,132.833333333333
"4403","14733","2020",6,6,0,294675,1901.5,148.333333333333
"4404","14734","2020",2,2,0,249500,1904.5,128
"4405","14735","2020",13,13,0,134230.769230769,1441.23076923077,94.7692307692308
"4406","14737","2020",5,5,0,158000,1696.6,97
"4407","14738","2020",44,42,2,253861.363636364,2387,108.977272727273
"4408","14739","2020",30,30,0,217146,2433.73333333333,96.8666666666667
"4409","14740","2020",16,16,0,142531.25,1358.6875,110.4375
"4410","14741","2020",4,4,0,114437.5,1254.25,84.75
"4411","14743","2020",5,5,0,176700,1593.2,112.4
"4412","14744","2020",2,2,0,136500,1133.5,123
"4413","14745","2020",4,4,0,273762.5,2334.75,118.5
"4414","14747","2020",8,7,1,249568.75,2337.375,108.875
"4415","14748","2020",2,2,0,190000,2349,81
"4416","14751","2020",3,3,0,120400,871.666666666667,139
"4417","14752","2020",28,25,3,177092.857142857,1826.57142857143,102.285714285714
"4418","14753","2020",12,12,0,203004.166666667,1667.5,131.25
"4419","14754","2020",469,66,403,140060.351812367,3280.65884861407,41.4797441364606
"4420","14755","2020",24,18,6,366630.625,3204.45833333333,102.75
"4421","14756","2020",1,1,0,120000,1000,120
"4422","14758","2020",6,6,0,304333.333333333,2517.33333333333,124.166666666667
"4423","14759","2020",2,2,0,125495,1941.5,61
"4424","14760","2020",12,12,0,188195.083333333,1618.91666666667,115.916666666667
"4425","14761","2020",9,9,0,217438.888888889,2029.33333333333,110.111111111111
"4426","14762","2020",226,167,59,118709.544247788,1299.42477876106,93.0575221238938
"4427","14764","2020",10,10,0,99027.8,1062.3,99.8
"4428","15001","2020",5,4,1,83006,810.6,113.8
"4429","15002","2020",2,2,0,166825,1960.5,85
"4430","15003","2020",3,3,0,55666,647.666666666667,86
"4431","15004","2020",2,2,0,165075,2107.5,77
"4432","15005","2020",2,2,0,187875,1492.5,126.5
"4433","15006","2020",10,9,1,60350,931.9,67.4
"4434","15007","2020",1,1,0,178000,1508,118
"4435","15008","2020",4,4,0,73250,711.75,102.5
"4436","15009","2020",6,6,0,66601.1666666667,804.166666666667,84.1666666666667
"4437","15010","2020",1,1,0,75000,1190,63
"4438","15012","2020",71,51,20,152053.971830986,1651.3661971831,92.0140845070423
"4439","15014","2020",424,104,320,101224.867924528,1374.35613207547,73.1037735849057
"4440","15016","2020",7,7,0,161444.857142857,1183.57142857143,142.857142857143
"4441","15017","2020",4,4,0,127025,1715.75,83.75
"4442","15018","2020",2,2,0,71925,844.5,84.5
"4443","15019","2020",1,1,0,32500,365,89
"4444","15020","2020",1,1,0,126500,1543,82
"4445","15021","2020",8,8,0,107431.25,1247.125,84.625
"4446","15022","2020",1,1,0,237000,3038,78
"4447","15024","2020",1,1,0,70000,833,84
"4448","15025","2020",2,2,0,84665.5,941,90
"4449","15026","2020",4,4,0,52100,697,83.25
"4450","15027","2020",5,5,0,90400,1179.8,90.2
"4451","15028","2020",1,1,0,107200,1061,101
"4452","15029","2020",5,5,0,113939.4,975.8,103.6
"4453","15030","2020",2,2,0,143000,1194,126.5
"4454","15033","2020",1,1,0,55000,545,101
"4455","15036","2020",7,6,1,85535.7142857143,1265.42857142857,71.2857142857143
"4456","15037","2020",7,7,0,60280,986.142857142857,63.1428571428571
"4457","15038","2020",9,9,0,76790.4444444444,1051.77777777778,81.5555555555556
"4458","15040","2020",2,2,0,75000,739.5,95
"4459","15043","2020",3,3,0,73666.6666666667,977.333333333333,76
"4460","15045","2020",8,7,1,72639.875,1342.625,61.875
"4461","15048","2020",1,1,0,87250,980,89
"4462","15049","2020",6,6,0,77950,1063.16666666667,89.8333333333333
"4463","15050","2020",8,8,0,104331.25,1230.875,86.125
"4464","15051","2020",4,4,0,198750,1748.5,97
"4465","15052","2020",4,4,0,71075,761.25,87.75
"4466","15053","2020",3,3,0,110375,1294.66666666667,86.6666666666667
"4467","15054","2020",13,11,2,57981.7692307692,873,73.6153846153846
"4468","15055","2020",3,3,0,145000,1598.33333333333,94.6666666666667
"4469","15056","2020",6,6,0,151750,1555.16666666667,95.5
"4470","15057","2020",2,2,0,77500,839.5,85
"4471","15058","2020",1,1,0,50000,1250,40
"4472","15059","2020",1,1,0,175000,2188,80
"4473","15060","2020",1,1,0,77000,856,90
"4474","15063","2020",3,3,0,38733.3333333333,548.333333333333,70
"4475","15064","2020",2,2,0,94850,1079,86.5
"4476","15065","2020",1,1,0,250000,1073,233
"4477","15066","2020",2,2,0,81500,994.5,84.5
"4478","15067","2020",1,1,0,45000,450,100
"4479","15069","2020",4,4,0,59245,883,69
"4480","15070","2020",4,4,0,52750,554.5,96
"4481","15072","2020",2,2,0,66500,972,71.5
"4482","15074","2020",3,3,0,122416.666666667,1401,87.6666666666667
"4483","15076","2020",2,2,0,139700,1916,76
"4484","15077","2020",1,1,0,124200,1479,84
"4485","15079","2020",2,2,0,129750,1735.5,78.5
"4486","15080","2020",4,4,0,116425,1044.5,106.25
"4487","15081","2020",1,1,0,31000,365,85
"4488","15082","2020",2,2,0,92000,1125,77
"4489","15083","2020",24,23,1,142933.291666667,1483.875,96.8333333333333
"4490","15084","2020",3,3,0,127512.333333333,1307,96.6666666666667
"4491","15085","2020",9,9,0,115272.222222222,1297.55555555556,92.2222222222222
"4492","15086","2020",2,2,0,62500,765,77.5
"4493","15087","2020",2,2,0,121250,1116.5,156
"4494","15088","2020",9,9,0,149737.222222222,1308.55555555556,113
"4495","15089","2020",4,4,0,92087.5,1192.75,78.75
"4496","15090","2020",9,9,0,105631.666666667,1134,95.2222222222222
"4497","15091","2020",1,1,0,51400,428,120
"4498","15092","2020",23,22,1,94328.6956521739,1219.91304347826,86.304347826087
"4499","15093","2020",2,2,0,163750,1628.5,110.5
"4500","15094","2020",7,6,1,92107.1428571429,1149.71428571429,78.1428571428571
"4501","15095","2020",5,5,0,61000,1100,58.4
"4502","15096","2020",5,5,0,155894.8,1514,96.2
"4503","15097","2020",1,1,0,145000,1295,112
"4504","15098","2020",2,2,0,50000,635,80
"4505","15100","2020",3,3,0,116067,1086.66666666667,95
"4506","15101","2020",34,7,27,90085.2941176471,2309.79411764706,40.9705882352941
"4507","15102","2020",1,0,1,734500,8161,90
"4508","15103","2020",2,2,0,57000,996,71
"4509","15104","2020",2,2,0,130470,983,117.5
"4510","15106","2020",3,3,0,136038.333333333,1148.66666666667,118
"4511","15107","2020",1,1,0,125000,1330,94
"4512","15108","2020",10,10,0,75587.2,1002.6,82.1
"4513","15110","2020",1,1,0,32500,542,60
"4514","15111","2020",3,3,0,56166.6666666667,641.666666666667,86.6666666666667
"4515","15112","2020",2,2,0,85082.5,742.5,113
"4516","15113","2020",7,7,0,88150,1100,84
"4517","15114","2020",6,5,1,82498.6666666667,721.333333333333,111.833333333333
"4518","15116","2020",2,2,0,73500,1045,75
"4519","15117","2020",5,5,0,87090,914,100.4
"4520","15118","2020",10,10,0,166267,1484.4,106.8
"4521","15119","2020",19,17,2,106163.157894737,1821.21052631579,80.6315789473684
"4522","15120","2020",33,26,7,94790.7575757576,1018.42424242424,91.7575757575758
"4523","15121","2020",1,1,0,30500,635,48
"4524","15122","2020",19,18,1,119100,1329.84210526316,92.0526315789474
"4525","15123","2020",2,2,0,86600,884,97
"4526","15124","2020",7,7,0,117657.142857143,1396.28571428571,82.2857142857143
"4527","15127","2020",8,8,0,67376.25,925,73.75
"4528","15128","2020",3,3,0,122133.333333333,1748.66666666667,80.6666666666667
"4529","15129","2020",1,1,0,87900,1059,83
"4530","15131","2020",5,5,0,66760,961,70.4
"4531","15133","2020",3,3,0,137066.666666667,1640.33333333333,79.3333333333333
"4532","15134","2020",7,7,0,72714.2857142857,858.714285714286,84.5714285714286
"4533","15135","2020",1,1,0,42000,500,84
"4534","15137","2020",7,7,0,76428.5714285714,889.142857142857,92.7142857142857
"4535","15138","2020",18,15,3,97073.8888888889,1070.44444444444,90.1666666666667
"4536","15139","2020",3,3,0,88566.6666666667,853,106.333333333333
"4537","15140","2020",23,23,0,163471.304347826,1624.08695652174,102.95652173913
"4538","15141","2020",22,21,1,90073,952.454545454545,97.4090909090909
"4539","15142","2020",20,20,0,117536.25,1260.7,98.3
"4540","15144","2020",1,1,0,110000,1158,95
"4541","15147","2020",3,2,1,118500,1486.33333333333,77.6666666666667
"4542","15148","2020",7,6,1,69141.4285714286,970.857142857143,63.5714285714286
"4543","15149","2020",2,2,0,163150,1697.5,85.5
"4544","15151","2020",1,1,0,90000,662,136
"4545","15152","2020",9,9,0,115660,1124.77777777778,103.111111111111
"4546","15153","2020",22,22,0,86092.4545454545,957.045454545455,93.6818181818182
"4547","15154","2020",9,9,0,110318,1261.77777777778,84.1111111111111
"4548","15155","2020",2,2,0,84475,829.5,100
"4549","15156","2020",3,3,0,92480,1303.33333333333,90.6666666666667
"4550","15157","2020",5,5,0,97940,1229.6,78.4
"4551","15159","2020",3,3,0,570127,3580.66666666667,123.666666666667
"4552","15160","2020",7,7,0,187037.142857143,1886.14285714286,96.4285714285714
"4553","15162","2020",27,24,3,106678.666666667,1192.66666666667,99.037037037037
"4554","15163","2020",11,10,1,148652.090909091,1526.09090909091,94.8181818181818
"4555","15164","2020",2,2,0,149600,1743,85.5
"4556","15165","2020",1,1,0,58000,983,59
"4557","15166","2020",7,7,0,150385.714285714,1380.28571428571,107.571428571429
"4558","15167","2020",1,1,0,140000,800,175
"4559","15168","2020",9,6,3,119088.888888889,1611.66666666667,88.1111111111111
"4560","15169","2020",15,15,0,98796.2,904.866666666667,111.866666666667
"4561","15170","2020",5,5,0,61800,694.8,92.8
"4562","15173","2020",2,2,0,39000,564.5,69.5
"4563","15174","2020",3,3,0,75833.3333333333,859.666666666667,81.6666666666667
"4564","15175","2020",13,13,0,95893.8461538462,865.923076923077,108.692307692308
"4565","15176","2020",4,4,0,173637.5,1536,98.75
"4566","15178","2020",1,1,0,43000,717,60
"4567","15179","2020",2,2,0,1e+05,946,96.5
"4568","15181","2020",6,6,0,136916.666666667,1574.16666666667,87.1666666666667
"4569","15182","2020",2,2,0,204487.5,1726.5,119.5
"4570","15184","2020",5,5,0,147800,1481.8,100.4
"4571","15185","2020",8,8,0,74100,983.875,76.75
"4572","15186","2020",5,5,0,76580,1014.8,80.8
"4573","15187","2020",61,34,27,121209.93442623,1374.90163934426,92.0655737704918
"4574","15188","2020",6,6,0,178291.666666667,1510.83333333333,111.166666666667
"4575","15189","2020",9,9,0,174481.111111111,2655.22222222222,65.3333333333333
"4576","15190","2020",4,4,0,49537.5,837.5,71.75
"4577","15191","2020",5,5,0,99228,1078.4,88.4
"4578","15192","2020",10,7,3,112038,1478.2,81.3
"4579","15196","2020",13,13,0,132784.692307692,1443.23076923077,89
"4580","15199","2020",1,1,0,90000,1111,81
"4581","15200","2020",2,2,0,75000,978,65.5
"4582","15201","2020",4,3,1,113250,1195.75,78
"4583","15202","2020",8,8,0,55561.25,813.5,68.25
"4584","15204","2020",9,9,0,169627.111111111,1679.55555555556,100.444444444444
"4585","15205","2020",1,1,0,80000,2286,35
"4586","15206","2020",1,1,0,40000,571,70
"4587","15207","2020",6,6,0,78191.6666666667,972.666666666667,81
"4588","15208","2020",2,2,0,70000,676.5,114.5
"4589","15211","2020",2,2,0,42000,548,71
"4590","15212","2020",1,1,0,45000,1000,45
"4591","15213","2020",3,3,0,106633.333333333,1589,104.333333333333
"4592","15214","2020",2,2,0,140500,1167,120.5
"4593","15215","2020",8,8,0,136350,1375.625,101.5
"4594","15216","2020",4,4,0,121250,1375.75,77.25
"4595","15217","2020",1,1,0,125000,1866,67
"4596","15218","2020",7,7,0,108928.571428571,1079.57142857143,82.5714285714286
"4597","15219","2020",8,8,0,95687.5,1061.5,93.875
"4598","15220","2020",1,1,0,102000,850,120
"4599","15221","2020",15,14,1,187030,1574.06666666667,119.933333333333
"4600","15222","2020",1,1,0,117000,1462,80
"4601","15223","2020",4,4,0,114750,1188.5,110.75
"4602","15224","2020",1,1,0,70000,886,79
"4603","15225","2020",3,3,0,56166.6666666667,489,114.333333333333
"4604","15226","2020",2,2,0,129750,1226,143.5
"4605","15228","2020",6,6,0,82495,765,109.666666666667
"4606","15229","2020",2,2,0,110750,1402,77
"4607","15230","2020",1,1,0,53000,757,70
"4608","15231","2020",3,3,0,99531.6666666667,761,127.333333333333
"4609","15232","2020",2,2,0,170000,2551.5,73
"4610","15233","2020",5,5,0,150030,1408.8,107.6
"4611","15234","2020",5,5,0,156272,1824.4,92
"4612","15235","2020",9,9,0,151244.444444444,1503.88888888889,98.2222222222222
"4613","15236","2020",7,7,0,99500,982.571428571429,105.857142857143
"4614","15237","2020",1,1,0,370000,2056,180
"4615","15238","2020",3,3,0,110795.666666667,1053.33333333333,116.666666666667
"4616","15240","2020",6,6,0,69033.3333333333,1007.5,66.6666666666667
"4617","15241","2020",2,2,0,69245,1140.5,61
"4618","15242","2020",2,2,0,144096,1296,114.5
"4619","15243","2020",1,1,0,35000,636,55
"4620","15244","2020",3,3,0,95000,1681.33333333333,68
"4621","15246","2020",1,1,0,130000,1494,87
"4622","15248","2020",7,7,0,108452.857142857,1237.42857142857,87
"4623","15250","2020",6,6,0,103333.333333333,986.166666666667,101.666666666667
"4624","15252","2020",2,2,0,138650,1327,104.5
"4625","15254","2020",3,3,0,43333.3333333333,580,74
"4626","15255","2020",18,18,0,173789.444444444,1701.55555555556,105.333333333333
"4627","15257","2020",1,1,0,67000,479,140
"4628","15258","2020",19,13,6,97171.0526315789,1181.73684210526,79.1578947368421
"4629","15259","2020",5,5,0,83950,829,105.4
"4630","15260","2020",3,3,0,140320,1055.33333333333,121.666666666667
"4631","15261","2020",8,8,0,106693.75,1050.875,96.625
"4632","15262","2020",3,3,0,97890,1272.33333333333,79
"4633","15263","2020",3,3,0,86629,773,109.333333333333
"4634","15264","2020",2,2,0,177250,1027.5,162.5
"4635","15265","2020",15,15,0,81066.6666666667,999.466666666667,81.8666666666667
"4636","15266","2020",10,10,0,129366.3,1387.2,93.7
"4637","15267","2020",36,36,0,160290.222222222,1568.5,103.638888888889
"4638","15268","2020",14,13,1,117521.428571429,1286.07142857143,91.2857142857143
"4639","15269","2020",2,2,0,120000,1292,89.5
"4640","16001","2020",10,10,0,99348.7,925.6,128
"4641","16002","2020",6,6,0,96766.6666666667,898.5,104.666666666667
"4642","16003","2020",26,26,0,125844,1304.69230769231,105.115384615385
"4643","16005","2020",27,27,0,95340.6296296296,901.148148148148,102.259259259259
"4644","16007","2020",11,11,0,108229.090909091,1205.09090909091,90
"4645","16008","2020",3,3,0,112000,978.666666666667,114.333333333333
"4646","16009","2020",3,3,0,79976.6666666667,755.666666666667,102
"4647","16011","2020",6,6,0,152916.666666667,1463.33333333333,103.833333333333
"4648","16012","2020",5,5,0,169846,1339.2,119.2
"4649","16013","2020",4,4,0,134000,1255.5,103.75
"4650","16014","2020",1,1,0,130000,1048,124
"4651","16015","2020",785,475,310,123729.045859873,1533.51592356688,82.224203821656
"4652","16016","2020",11,11,0,104323.909090909,864.363636363636,118.727272727273
"4653","16018","2020",11,11,0,214874.545454545,1570.54545454545,135.727272727273
"4654","16019","2020",19,19,0,145375.315789474,1365.78947368421,106.842105263158
"4655","16020","2020",11,11,0,188492.363636364,1625.18181818182,116.363636363636
"4656","16023","2020",7,7,0,111285.714285714,1057.14285714286,102.714285714286
"4657","16024","2020",9,9,0,152692.222222222,1510.11111111111,105.333333333333
"4658","16025","2020",12,12,0,141471.666666667,1071.08333333333,122.083333333333
"4659","16026","2020",14,14,0,181384,1530.42857142857,118.642857142857
"4660","16027","2020",2,2,0,117850,1050.5,115.5
"4661","16028","2020",61,59,2,143324.295081967,1289.88524590164,112.918032786885
"4662","16030","2020",11,11,0,153816.363636364,1434.72727272727,107.181818181818
"4663","16031","2020",4,4,0,116125,1241,87.25
"4664","16032","2020",11,11,0,103849.636363636,927.909090909091,103.727272727273
"4665","16034","2020",1,1,0,370000,1644,225
"4666","16035","2020",3,3,0,136666.666666667,702.333333333333,202
"4667","16036","2020",6,6,0,145740,1299.33333333333,111
"4668","16037","2020",3,3,0,74575,821.666666666667,89.3333333333333
"4669","16038","2020",4,4,0,88060,1067.75,85
"4670","16039","2020",3,3,0,126666.666666667,1234.66666666667,103
"4671","16040","2020",1,1,0,82000,788,104
"4672","16041","2020",3,3,0,64626.6666666667,774.666666666667,91.3333333333333
"4673","16042","2020",3,3,0,148333.333333333,735.333333333333,188
"4674","16044","2020",4,4,0,114375,668.25,151.5
"4675","16045","2020",1,1,0,231600,1412,164
"4676","16046","2020",8,7,1,151143.75,1038.625,143.125
"4677","16047","2020",3,3,0,163911.666666667,1212.66666666667,135.333333333333
"4678","16048","2020",1,1,0,329500,1810,182
"4679","16049","2020",5,5,0,175621,1516.6,113.4
"4680","16050","2020",3,3,0,253950,3089.33333333333,81
"4681","16052","2020",4,4,0,87500,1131,83
"4682","16053","2020",1,1,0,160000,1860,86
"4683","16054","2020",3,3,0,106713.333333333,1075,106
"4684","16055","2020",14,14,0,134091.071428571,1339.85714285714,102.714285714286
"4685","16056","2020",9,9,0,225611.111111111,1774.88888888889,127.111111111111
"4686","16057","2020",6,6,0,115951.666666667,959.333333333333,112.666666666667
"4687","16058","2020",20,20,0,180291,1464.25,125.45
"4688","16060","2020",9,9,0,143688.888888889,999.111111111111,142.666666666667
"4689","16061","2020",41,41,0,156488.756097561,1545.51219512195,102.317073170732
"4690","16062","2020",1,1,0,50000,667,75
"4691","16063","2020",2,2,0,164500,1339.5,124
"4692","16064","2020",22,22,0,107363.136363636,1236.54545454545,97.8636363636364
"4693","16065","2020",8,8,0,67246.875,757.375,94.125
"4694","16066","2020",16,16,0,112516.6875,1167.75,99.9375
"4695","16067","2020",7,7,0,168650,1553.85714285714,111
"4696","16068","2020",13,13,0,107410.384615385,777.769230769231,134.769230769231
"4697","16069","2020",9,9,0,108632.111111111,1074,102.555555555556
"4698","16070","2020",27,27,0,86287.962962963,795.851851851852,112.555555555556
"4699","16071","2020",3,3,0,124166.666666667,1503.66666666667,86.3333333333333
"4700","16072","2020",3,3,0,154000,1251.33333333333,112.666666666667
"4701","16073","2020",33,32,1,91031.2121212121,1014.60606060606,92.7878787878788
"4702","16074","2020",6,6,0,130583.333333333,1055.16666666667,110.333333333333
"4703","16075","2020",2,2,0,213500,1261.5,171
"4704","16076","2020",9,9,0,86750,755.888888888889,109
"4705","16077","2020",4,4,0,136750,1399.5,98.75
"4706","16078","2020",50,50,0,156725.84,1395.24,116.82
"4707","16079","2020",5,5,0,108492,1156.6,102.2
"4708","16081","2020",4,4,0,193125,1075,157.5
"4709","16082","2020",7,7,0,139735.714285714,1283.28571428571,120.285714285714
"4710","16083","2020",11,11,0,139139.545454545,1037.09090909091,151.727272727273
"4711","16084","2020",15,14,1,214135.666666667,1823.06666666667,112.133333333333
"4712","16085","2020",45,44,1,101475.644444444,1224.86666666667,91.2444444444444
"4713","16086","2020",16,16,0,82896.75,956.8125,91.3125
"4714","16087","2020",1,1,0,63000,1033,61
"4715","16088","2020",10,10,0,159080,1084,145.6
"4716","16089","2020",52,50,2,155154.769230769,1561.21153846154,102.538461538462
"4717","16090","2020",42,42,0,147270.714285714,1192.95238095238,126.97619047619
"4718","16091","2020",5,5,0,108216,859,120
"4719","16093","2020",14,14,0,146010.714285714,1260.35714285714,117.214285714286
"4720","16095","2020",2,2,0,90000,644,141
"4721","16096","2020",7,7,0,125155.714285714,964.857142857143,120.857142857143
"4722","16097","2020",25,25,0,173489,1364.28,122.28
"4723","16098","2020",2,2,0,217325,1037,213.5
"4724","16099","2020",1,1,0,97500,580,168
"4725","16100","2020",9,9,0,88233.3333333333,781.444444444444,108.777777777778
"4726","16101","2020",7,7,0,183728.714285714,1826.28571428571,107.714285714286
"4727","16102","2020",350,254,96,132923.897142857,1536.32285714286,88.78
"4728","16103","2020",4,4,0,120400,1185.25,98
"4729","16104","2020",6,6,0,154666.666666667,1508.5,103.333333333333
"4730","16105","2020",8,8,0,159906.25,1502.25,103.5
"4731","16106","2020",36,33,3,98596.9722222222,1019.02777777778,104.055555555556
"4732","16107","2020",7,7,0,142440,1416.85714285714,101.142857142857
"4733","16108","2020",3,3,0,55666.6666666667,528.666666666667,101.333333333333
"4734","16109","2020",8,8,0,142862.5,1367.625,107.25
"4735","16110","2020",16,16,0,122323.875,921.75,141.1875
"4736","16111","2020",5,5,0,78340,950.6,97.6
"4737","16112","2020",2,2,0,170350,923.5,182.5
"4738","16113","2020",61,59,2,143161.704918033,1479.70491803279,96.0327868852459
"4739","16114","2020",4,4,0,122875,875.75,130
"4740","16116","2020",2,2,0,287000,1596.5,183.5
"4741","16117","2020",2,2,0,85500,1119.5,75.5
"4742","16118","2020",1,1,0,105500,909,116
"4743","16119","2020",11,11,0,125966.363636364,1176.72727272727,112.090909090909
"4744","16120","2020",13,13,0,183265.769230769,1451.92307692308,127.384615384615
"4745","16121","2020",5,5,0,123230,1088,110.4
"4746","16122","2020",2,2,0,57500,810.5,71
"4747","16123","2020",5,5,0,126470,1251.4,101.8
"4748","16124","2020",29,29,0,87950.275862069,1053.79310344828,82.2413793103448
"4749","16125","2020",6,6,0,195082,1344,144.833333333333
"4750","16127","2020",5,5,0,144624,1196.4,116.2
"4751","16128","2020",3,3,0,97416.6666666667,1079,89
"4752","16130","2020",3,3,0,118666.666666667,1623.66666666667,67
"4753","16131","2020",4,4,0,57750,770.25,69.5
"4754","16132","2020",5,5,0,118700,1068.4,106.4
"4755","16133","2020",2,2,0,180000,1129.5,159.5
"4756","16134","2020",13,13,0,103287.538461538,1095.84615384615,95.5384615384615
"4757","16135","2020",1,1,0,159000,1282,124
"4758","16136","2020",7,7,0,97785.7142857143,1373.71428571429,95.2857142857143
"4759","16137","2020",3,3,0,134500,1161.66666666667,110.333333333333
"4760","16138","2020",47,46,1,167606.425531915,1598.93617021277,104.36170212766
"4761","16139","2020",4,4,0,128386.25,1462.25,101.5
"4762","16140","2020",3,3,0,178000,963.333333333333,155
"4763","16141","2020",4,4,0,106525,1298,83.75
"4764","16142","2020",4,4,0,93591.25,745.25,126.75
"4765","16143","2020",10,10,0,165566,1425.3,123.6
"4766","16144","2020",9,9,0,121305.666666667,921.222222222222,123.777777777778
"4767","16145","2020",8,8,0,208246.875,1462.625,153.625
"4768","16146","2020",15,15,0,188638.666666667,1732.26666666667,112.4
"4769","16147","2020",2,2,0,145350,1432.5,101.5
"4770","16148","2020",10,10,0,97447.5,868.4,116.3
"4771","16150","2020",18,18,0,182090,1417.66666666667,131
"4772","16151","2020",11,11,0,219348.181818182,1243.54545454545,168.727272727273
"4773","16152","2020",5,5,0,128126,1359.4,106.2
"4774","16153","2020",12,12,0,145640,1245.75,116.416666666667
"4775","16154","2020",131,113,18,122795.625954198,1447.13740458015,85.4045801526718
"4776","16157","2020",4,4,0,134500,1349.75,102.5
"4777","16158","2020",4,4,0,72000,612.25,110.75
"4778","16160","2020",3,3,0,205666.666666667,1484.33333333333,141.666666666667
"4779","16162","2020",3,3,0,189083.333333333,1002.33333333333,168.333333333333
"4780","16163","2020",8,8,0,122875,984.75,126.375
"4781","16164","2020",4,4,0,191212.5,1257.5,153.5
"4782","16165","2020",5,5,0,129380,932.4,130.4
"4783","16166","2020",57,52,5,140074.526315789,1503.0701754386,92.6842105263158
"4784","16167","2020",78,75,3,128669.166666667,1195.74358974359,106.884615384615
"4785","16168","2020",16,16,0,152269.75,1494.9375,110.0625
"4786","16169","2020",16,16,0,170221.875,1459.6875,122.3125
"4787","16170","2020",5,5,0,168479.4,1283.8,135.2
"4788","16171","2020",10,10,0,154863.2,1384.3,115.6
"4789","16173","2020",5,5,0,124429.2,823.6,143.6
"4790","16174","2020",7,7,0,194314.285714286,1608.42857142857,122.714285714286
"4791","16175","2020",12,12,0,99328.3333333333,979,100.75
"4792","16176","2020",2,2,0,226350,1495.5,155
"4793","16177","2020",1,1,0,180000,1241,145
"4794","16178","2020",5,5,0,126580,1130.6,112.2
"4795","16180","2020",8,8,0,155820.625,1223.5,126.125
"4796","16181","2020",9,9,0,68700,742,97.8888888888889
"4797","16182","2020",5,5,0,67500,804.8,78.4
"4798","16183","2020",7,7,0,108775.714285714,825.857142857143,125.142857142857
"4799","16184","2020",2,2,0,155750,1293.5,125.5
"4800","16185","2020",3,3,0,105606,717.333333333333,139.333333333333
"4801","16186","2020",2,2,0,62250,830.5,81.5
"4802","16187","2020",22,22,0,141149.545454545,1283.77272727273,107.454545454545
"4803","16188","2020",4,4,0,75250,1017.5,74.25
"4804","16189","2020",6,6,0,142062.666666667,948.5,146.833333333333
"4805","16190","2020",2,2,0,145000,871,167
"4806","16191","2020",5,5,0,104838.6,985.8,104.8
"4807","16192","2020",45,45,0,91791.9777777778,1002.86666666667,92.0222222222222
"4808","16193","2020",8,8,0,141587.5,1165,119.875
"4809","16194","2020",1,1,0,80000,889,90
"4810","16195","2020",3,3,0,57666.6666666667,819.333333333333,74.6666666666667
"4811","16196","2020",11,11,0,124555.909090909,1036.09090909091,120.727272727273
"4812","16197","2020",1,1,0,120000,1319,91
"4813","16198","2020",5,5,0,123500,1014.2,123.6
"4814","16199","2020",46,46,0,153469.413043478,1672.5,91.695652173913
"4815","16200","2020",9,9,0,101683.333333333,950.444444444444,104
"4816","16203","2020",2,2,0,83750,949.5,88.5
"4817","16204","2020",19,19,0,129731.315789474,1307.68421052632,106.736842105263
"4818","16205","2020",12,12,0,90191.6666666667,1066.33333333333,85.75
"4819","16206","2020",24,23,1,92402.5,1190.45833333333,85.4166666666667
"4820","16207","2020",11,11,0,77142.0909090909,1018.54545454545,81.4545454545455
"4821","16208","2020",8,8,0,122355.25,918.75,125.625
"4822","16209","2020",10,10,0,146435,1356.4,109.8
"4823","16210","2020",5,5,0,139540,1323.2,102.2
"4824","16211","2020",10,10,0,155985,1227.2,130
"4825","16212","2020",4,4,0,91750,878.5,100.75
"4826","16213","2020",4,4,0,126000,1056.5,121.75
"4827","16215","2020",3,3,0,94000,884,115.666666666667
"4828","16216","2020",5,5,0,285184.2,1348.8,205.2
"4829","16217","2020",16,16,0,172531.75,1521.875,110.5
"4830","16218","2020",2,2,0,125000,911.5,133.5
"4831","16220","2020",12,12,0,171291.25,1560.58333333333,116.75
"4832","16221","2020",3,3,0,100266.666666667,991,102
"4833","16222","2020",3,3,0,160000,687,226
"4834","16223","2020",35,34,1,126417.142857143,1265.65714285714,105.028571428571
"4835","16224","2020",7,7,0,202036.285714286,1269.28571428571,149.285714285714
"4836","16225","2020",8,8,0,87893.625,832.375,93.5
"4837","16226","2020",9,8,1,126988.888888889,1241.33333333333,107.444444444444
"4838","16227","2020",4,4,0,219714.5,1692.5,123.75
"4839","16230","2020",33,33,0,108505.151515152,1054.0303030303,104.666666666667
"4840","16231","2020",9,9,0,75188.8888888889,915.666666666667,92.4444444444444
"4841","16232","2020",20,20,0,163448.5,1498.1,110.2
"4842","16233","2020",5,5,0,127200,1087.6,119.4
"4843","16234","2020",8,8,0,136000,1221.875,102.875
"4844","16236","2020",27,27,0,145885.740740741,1421.66666666667,106.481481481481
"4845","16237","2020",4,4,0,85250,742.25,111.25
"4846","16238","2020",2,2,0,48500,549,85.5
"4847","16239","2020",2,2,0,169750,1202,135
"4848","16240","2020",2,2,0,273165,1493,183.5
"4849","16241","2020",7,7,0,120113.571428571,1196.14285714286,102.571428571429
"4850","16242","2020",35,35,0,114590.142857143,1076.37142857143,108.8
"4851","16243","2020",8,8,0,133275,1339.5,106.375
"4852","16244","2020",30,26,4,109986.333333333,1393.56666666667,78.9333333333333
"4853","16245","2020",8,8,0,91450,832.25,108.75
"4854","16246","2020",6,6,0,155841.666666667,1307.83333333333,116.666666666667
"4855","16248","2020",7,7,0,116707.142857143,852.142857142857,132.285714285714
"4856","16249","2020",8,8,0,79324,875.375,91.875
"4857","16250","2020",1,1,0,71850,599,120
"4858","16251","2020",2,2,0,99905,1217.5,87.5
"4859","16252","2020",2,2,0,182500,1526,122
"4860","16253","2020",15,15,0,97170.2,1059.4,94.7333333333333
"4861","16254","2020",4,4,0,68000,908.75,77.75
"4862","16255","2020",3,3,0,76666.6666666667,675.333333333333,116.333333333333
"4863","16256","2020",1,1,0,75000,469,160
"4864","16258","2020",7,7,0,113185.714285714,1226.57142857143,90.8571428571429
"4865","16260","2020",3,3,0,224166.666666667,1677,129
"4866","16261","2020",7,7,0,99121.4285714286,1006.71428571429,94.5714285714286
"4867","16263","2020",5,5,0,140226.4,1655.6,88
"4868","16264","2020",5,5,0,63800,686.2,87.6
"4869","16268","2020",4,4,0,120467.5,1025.25,112
"4870","16269","2020",9,9,0,121348.888888889,1110.77777777778,112.777777777778
"4871","16270","2020",5,5,0,56722,961.2,56
"4872","16271","2020",28,28,0,201616.75,1771.35714285714,115.392857142857
"4873","16272","2020",11,11,0,124109.090909091,1258.72727272727,97
"4874","16273","2020",3,3,0,70000,548,126.333333333333
"4875","16275","2020",3,3,0,91378.6666666667,780,123.666666666667
"4876","16276","2020",6,6,0,113630,1062,109.833333333333
"4877","16277","2020",7,7,0,140767.142857143,1355,103.428571428571
"4878","16279","2020",3,3,0,125550,1243,89
"4879","16280","2020",25,25,0,124859.72,1246.96,100.76
"4880","16281","2020",61,56,5,118688.918032787,1246.85245901639,94.8852459016394
"4881","16282","2020",5,5,0,132232,1242.4,105.8
"4882","16283","2020",10,10,0,160348.4,1232.6,130
"4883","16285","2020",7,7,0,95519.7142857143,1081.42857142857,95.8571428571429
"4884","16286","2020",31,30,1,105311.290322581,1041.61290322581,111.129032258065
"4885","16287","2020",50,50,0,151627.5,1375.38,112.62
"4886","16289","2020",5,5,0,79259,721.2,96.2
"4887","16290","2020",11,11,0,166850,1246.90909090909,135.181818181818
"4888","16291","2020",114,102,12,130109.105263158,1428.17543859649,91.2631578947368
"4889","16292","2020",51,48,3,91035.8823529412,1003.54901960784,89.9607843137255
"4890","16293","2020",7,7,0,192857.142857143,1304.28571428571,145.142857142857
"4891","16295","2020",17,17,0,96986.4705882353,943.882352941176,104.647058823529
"4892","16297","2020",5,5,0,102820,973.4,103.8
"4893","16298","2020",4,4,0,131750,1226.5,107
"4894","16300","2020",15,15,0,116370,1031.26666666667,108.6
"4895","16301","2020",3,3,0,143423.333333333,1183.66666666667,127.333333333333
"4896","16302","2020",4,4,0,130300,1033.25,123.25
"4897","16303","2020",3,3,0,210000,1335.33333333333,155.333333333333
"4898","16304","2020",19,19,0,208517.894736842,1766.89473684211,125.684210526316
"4899","16306","2020",4,4,0,65500,1116.5,78.5
"4900","16307","2020",4,4,0,135000,747,186.5
"4901","16308","2020",7,7,0,93857.1428571429,813.571428571429,126.714285714286
"4902","16310","2020",1,1,0,90000,732,123
"4903","16312","2020",11,11,0,147295.454545455,1239.72727272727,115.545454545455
"4904","16315","2020",1,1,0,1e+05,1087,92
"4905","16316","2020",4,4,0,91625,882.25,104.25
"4906","16317","2020",7,7,0,134470.857142857,961,129
"4907","16318","2020",9,9,0,168405,1386.11111111111,128.555555555556
"4908","16320","2020",15,15,0,132418,1269,103.933333333333
"4909","16323","2020",7,7,0,104015.714285714,1050,106.428571428571
"4910","16325","2020",6,6,0,81583.3333333333,830.833333333333,97.1666666666667
"4911","16326","2020",4,4,0,101287.5,1177.5,93.75
"4912","16329","2020",9,9,0,87333.3333333333,898.444444444444,98.8888888888889
"4913","16330","2020",20,20,0,160265.75,1271.6,125.15
"4914","16331","2020",1,1,0,175000,1268,138
"4915","16334","2020",1,1,0,238300,1537,155
"4916","16335","2020",1,1,0,105000,1000,105
"4917","16336","2020",4,4,0,102500,791.5,127.5
"4918","16337","2020",10,10,0,93465.9,949.7,92
"4919","16338","2020",2,2,0,154000,1079.5,141
"4920","16339","2020",11,11,0,118395.454545455,996.090909090909,108
"4921","16340","2020",17,17,0,112532.352941176,900.823529411765,122.470588235294
"4922","16341","2020",42,30,12,102341.928571429,1413,72.1904761904762
"4923","16342","2020",2,2,0,183500,1326.5,143
"4924","16343","2020",3,3,0,164820,824,192.333333333333
"4925","16345","2020",3,3,0,127000,1229.33333333333,103
"4926","16346","2020",4,4,0,117500,883,132.5
"4927","16347","2020",6,6,0,116928.333333333,1129.66666666667,118.333333333333
"4928","16348","2020",11,11,0,177469.545454545,1532.18181818182,113.272727272727
"4929","16349","2020",3,3,0,228466.666666667,1154.33333333333,182
"4930","16350","2020",16,16,0,127437.5,1146.375,118.6875
"4931","16352","2020",8,8,0,149731.25,969.75,130.5
"4932","16353","2020",9,9,0,127611.111111111,1297.66666666667,101.111111111111
"4933","16354","2020",5,5,0,107650,695.8,161.8
"4934","16355","2020",14,14,0,158857.142857143,1302.28571428571,120
"4935","16356","2020",2,2,0,109400,772,125
"4936","16357","2020",1,1,0,57000,760,75
"4937","16358","2020",98,93,5,174181.43877551,1688.5,108.5
"4938","16359","2020",14,14,0,137395.357142857,1135.57142857143,126.285714285714
"4939","16360","2020",4,4,0,119845,1232.75,98.25
"4940","16361","2020",8,8,0,152437.5,1084.375,129.75
"4941","16362","2020",6,6,0,105900,1083.83333333333,84.1666666666667
"4942","16363","2020",8,8,0,105069.75,958.75,111
"4943","16364","2020",3,3,0,146183.333333333,1163.66666666667,121.666666666667
"4944","16365","2020",2,2,0,73250,523.5,145
"4945","16366","2020",13,13,0,171376.923076923,1359.15384615385,133
"4946","16368","2020",11,11,0,154660.272727273,1282.09090909091,118.454545454545
"4947","16369","2020",16,16,0,151509.6875,1259,121.75
"4948","16370","2020",12,12,0,126234.166666667,1332,113.083333333333
"4949","16372","2020",4,4,0,202325,1130,167.75
"4950","16373","2020",3,3,0,116000,837,142.666666666667
"4951","16374","2020",102,86,16,123221.176470588,1434.72549019608,86.1862745098039
"4952","16375","2020",4,4,0,99687.5,1016,105.5
"4953","16378","2020",8,8,0,128187.5,1118.875,114.875
"4954","16379","2020",15,15,0,128119.6,1333.4,99.2
"4955","16380","2020",2,2,0,204189.5,1075,222
"4956","16381","2020",1,1,0,239600,1136,211
"4957","16382","2020",6,6,0,152833.333333333,1218.66666666667,123.833333333333
"4958","16383","2020",7,7,0,137742.857142857,1185.57142857143,124.714285714286
"4959","16384","2020",6,5,1,160006.166666667,1200.5,136
"4960","16385","2020",14,14,0,120944.285714286,1258.85714285714,93.3571428571429
"4961","16387","2020",7,7,0,152515.714285714,1575.57142857143,95.1428571428571
"4962","16388","2020",15,15,0,142721.333333333,1402.86666666667,106.6
"4963","16389","2020",1,1,0,128000,1067,120
"4964","16390","2020",5,5,0,111350,951.6,119.2
"4965","16392","2020",3,3,0,61333.3333333333,642.666666666667,93
"4966","16393","2020",33,33,0,149893.03030303,1365.39393939394,115.030303030303
"4967","16394","2020",1,1,0,45000,634,71
"4968","16395","2020",1,1,0,30500,367,83
"4969","16396","2020",4,4,0,108350,1124,106.75
"4970","16397","2020",4,4,0,115875,892,124.25
"4971","16398","2020",5,5,0,131650,1711,96.4
"4972","16399","2020",2,2,0,161500,1274.5,125
"4973","16400","2020",15,15,0,130436.666666667,1031.86666666667,117.666666666667
"4974","16402","2020",4,4,0,187046.25,1648,109
"4975","16403","2020",3,3,0,96000,880,111
"4976","16405","2020",3,3,0,143841.666666667,2674,73.3333333333333
"4977","16406","2020",6,6,0,153666.666666667,1351.83333333333,110.5
"4978","16408","2020",14,14,0,123128.571428571,1126.64285714286,113.071428571429
"4979","16409","2020",7,7,0,89928.5714285714,983,87.4285714285714
"4980","16412","2020",6,6,0,116010,1011.16666666667,118.166666666667
"4981","16413","2020",4,4,0,117750,1062.5,126
"4982","16414","2020",7,7,0,92714.2857142857,941.714285714286,103.142857142857
"4983","16415","2020",11,11,0,157654.545454545,1416.81818181818,110.727272727273
"4984","16416","2020",7,7,0,140374.285714286,1066.85714285714,133.571428571429
"4985","16418","2020",5,5,0,183600,1521.2,116.2
"4986","16419","2020",5,5,0,68800,873.4,84.6
"4987","16420","2020",3,3,0,131183.333333333,1107,124
"4988","16421","2020",3,3,0,107811.666666667,1136.66666666667,93.3333333333333
"4989","16422","2020",11,11,0,141490.909090909,1314.36363636364,111.272727272727
"4990","16423","2020",7,7,0,95822.8571428571,862.857142857143,114.428571428571
"4991","16424","2020",6,6,0,144781.833333333,1102.83333333333,127.666666666667
"4992","16425","2020",16,16,0,97187.5,950.25,105.625
"4993","17003","2020",79,79,0,227836.759493671,2311.24050632911,99.7721518987342
"4994","17004","2020",5,5,0,332550,7046.4,49.6
"4995","17005","2020",1,1,0,135000,1350,100
"4996","17006","2020",4,4,0,141015,1333.25,102
"4997","17007","2020",5,5,0,155600,1372.6,108.8
"4998","17008","2020",31,31,0,212961.290322581,2101.1935483871,102.677419354839
"4999","17009","2020",18,18,0,240790.833333333,2215.83333333333,110.777777777778
"5000","17010","2020",67,63,4,353778.955223881,3488.40298507463,100.074626865672
"5001","17011","2020",2,2,0,228250,2154.5,106.5
"5002","17012","2020",3,3,0,111000,1399,85.6666666666667
"5003","17013","2020",2,2,0,158750,1397,116
"5004","17015","2020",12,12,0,191396.25,1646,112.166666666667
"5005","17016","2020",9,8,1,127777.777777778,1626.66666666667,95
"5006","17017","2020",25,25,0,150274.04,1316.6,120.8
"5007","17018","2020",13,13,0,194592.307692308,1827.38461538462,107.307692307692
"5008","17019","2020",38,36,2,565581.684210526,5970.28947368421,98.3157894736842
"5009","17020","2020",6,6,0,139833.333333333,1191.33333333333,109
"5010","17021","2020",79,75,4,207954.898734177,2005.83544303797,102.582278481013
"5011","17022","2020",17,17,0,129657.647058824,1220.11764705882,113.764705882353
"5012","17023","2020",4,4,0,81838.25,1087.5,83
"5013","17024","2020",26,25,1,117583.384615385,1246.34615384615,106.269230769231
"5014","17025","2020",17,17,0,143105.882352941,1185.23529411765,123.294117647059
"5015","17026","2020",5,5,0,185400,1424.8,137.2
"5016","17027","2020",4,4,0,149395,1202,129
"5017","17028","2020",184,109,75,234759.195652174,3326.83152173913,72.9673913043478
"5018","17029","2020",6,6,0,117750,843.666666666667,118
"5019","17030","2020",7,7,0,150428.571428571,1551,97.7142857142857
"5020","17031","2020",4,4,0,99205,742.25,133.25
"5021","17032","2020",15,15,0,185072,1712.06666666667,112.4
"5022","17033","2020",8,8,0,146288.75,1343,109.25
"5023","17034","2020",19,19,0,148786.842105263,1585.31578947368,95.5789473684211
"5024","17035","2020",1,1,0,60000,441,136
"5025","17036","2020",15,15,0,219118,1860.86666666667,113.733333333333
"5026","17037","2020",5,5,0,91090,1077.4,83
"5027","17038","2020",3,3,0,92313.3333333333,1024.66666666667,101.666666666667
"5028","17039","2020",2,2,0,154200,1230.5,123.5
"5029","17041","2020",33,33,0,197361.96969697,1912,108.090909090909
"5030","17042","2020",5,5,0,98800,925.2,107.2
"5031","17043","2020",16,16,0,134837.5,1363.125,94.1875
"5032","17044","2020",16,16,0,125062.5,1252.8125,96.9375
"5033","17045","2020",14,14,0,167630.714285714,1379.07142857143,122.714285714286
"5034","17046","2020",8,8,0,162028,1579.25,117.625
"5035","17047","2020",5,5,0,117712,967.8,120.8
"5036","17048","2020",5,5,0,173288,1460.4,114.4
"5037","17049","2020",1,1,0,110000,1111,99
"5038","17050","2020",13,13,0,170726.153846154,1390,133.461538461538
"5039","17051","2020",73,73,0,804536.780821918,6812.27397260274,124.315068493151
"5040","17052","2020",9,9,0,122736.111111111,1059.88888888889,124.666666666667
"5041","17053","2020",30,30,0,150242.2,1445.83333333333,107.5
"5042","17054","2020",5,5,0,149593,1603.4,103.2
"5043","17055","2020",4,4,0,122500,1303,94
"5044","17056","2020",9,9,0,173455.555555556,1411.66666666667,121.888888888889
"5045","17057","2020",12,12,0,204055.833333333,1777.08333333333,115.416666666667
"5046","17058","2020",72,71,1,190967.208333333,2237.66666666667,88.8611111111111
"5047","17059","2020",10,10,0,312241.5,2352,134.8
"5048","17060","2020",5,5,0,163545,1397.2,112.8
"5049","17062","2020",4,4,0,81812.5,610,136.5
"5050","17063","2020",7,7,0,117928.571428571,1089.28571428571,106.571428571429
"5051","17064","2020",62,62,0,331758.548387097,2781.41935483871,121.322580645161
"5052","17065","2020",37,37,0,224485.162162162,2073.27027027027,108.486486486486
"5053","17066","2020",3,3,0,196333.333333333,1866,113.666666666667
"5054","17067","2020",1,1,0,69000,690,100
"5055","17068","2020",4,4,0,112160,1715,70.75
"5056","17069","2020",3,3,0,120983.333333333,1236.66666666667,105
"5057","17070","2020",15,15,0,159959.466666667,1477.26666666667,114.6
"5058","17071","2020",6,6,0,116725.833333333,1139.33333333333,105.166666666667
"5059","17072","2020",24,24,0,153350.416666667,1433.45833333333,115.291666666667
"5060","17073","2020",20,20,0,193526.85,1482.25,133.55
"5061","17074","2020",8,7,1,145693.625,1280.75,110.75
"5062","17075","2020",19,19,0,183071.210526316,1714.47368421053,103.315789473684
"5063","17076","2020",3,3,0,147200,1168.33333333333,140.666666666667
"5064","17077","2020",16,16,0,123087.5,1302.8125,96.3125
"5065","17078","2020",2,2,0,157500,1354.5,122.5
"5066","17079","2020",31,31,0,210515.451612903,1938.06451612903,112.58064516129
"5067","17080","2020",22,22,0,181331.136363636,1664.09090909091,108.909090909091
"5068","17081","2020",7,7,0,129368.571428571,1234.14285714286,105.714285714286
"5069","17083","2020",14,14,0,140978.571428571,1189.92857142857,121.5
"5070","17084","2020",10,10,0,100024,1144.3,94.2
"5071","17085","2020",7,7,0,201328.571428571,1454.57142857143,144
"5072","17086","2020",55,54,1,165877.290909091,1639.21818181818,101.636363636364
"5073","17087","2020",1,1,0,182000,1625,112
"5074","17089","2020",9,9,0,136666.666666667,1414.44444444444,100.444444444444
"5075","17091","2020",32,32,0,198539.15625,2028.75,96.15625
"5076","17092","2020",1,1,0,149500,1759,85
"5077","17093","2020",93,85,8,194681.182795699,2527.22580645161,78.8172043010753
"5078","17094","2020",181,131,50,309372.049723757,4124.29281767956,79.5303867403315
"5079","17096","2020",2,2,0,86500,1528.5,68
"5080","17097","2020",14,14,0,183208.571428571,1954.78571428571,92.1428571428571
"5081","17098","2020",12,12,0,148095.833333333,1495.08333333333,106.083333333333
"5082","17099","2020",9,9,0,158855.444444444,1273.88888888889,129.111111111111
"5083","17100","2020",21,21,0,147838.857142857,1230.38095238095,119.761904761905
"5084","17101","2020",6,6,0,74715.8333333333,626.833333333333,116
"5085","17102","2020",18,18,0,206227.777777778,1761.33333333333,119.444444444444
"5086","17104","2020",15,15,0,94773.3333333333,976.333333333333,100.466666666667
"5087","17105","2020",9,9,0,104503.333333333,1183.11111111111,94.7777777777778
"5088","17106","2020",5,5,0,128386.4,986,141.6
"5089","17107","2020",28,28,0,192443.214285714,1852.64285714286,110.928571428571
"5090","17108","2020",4,4,0,170000,1418.75,116.25
"5091","17109","2020",25,23,2,272238.52,2682.76,105.16
"5092","17110","2020",11,11,0,131574.727272727,1164.54545454545,115.727272727273
"5093","17111","2020",14,14,0,125541.071428571,1313.14285714286,99.9285714285714
"5094","17112","2020",12,12,0,211553.75,1896.75,115.5
"5095","17113","2020",9,9,0,160661.111111111,1500.88888888889,108.111111111111
"5096","17114","2020",6,6,0,90666.6666666667,842.5,109.666666666667
"5097","17115","2020",6,6,0,130788.333333333,1377.16666666667,93.5
"5098","17116","2020",2,2,0,97500,1122,75.5
"5099","17118","2020",6,6,0,162279.833333333,1333.66666666667,118.833333333333
"5100","17119","2020",16,16,0,173825,1669.25,106.125
"5101","17120","2020",21,21,0,148612.142857143,1578.04761904762,99.9523809523809
"5102","17121","2020",41,37,4,546560.243902439,5902.17073170732,96.8536585365854
"5103","17122","2020",4,4,0,129750,1086,110
"5104","17124","2020",2,2,0,120500,1295,98.5
"5105","17125","2020",8,8,0,134830,1151.625,122
"5106","17126","2020",3,3,0,145666.666666667,947.666666666667,128.666666666667
"5107","17127","2020",31,29,2,158801.451612903,1539.64516129032,108.354838709677
"5108","17128","2020",7,7,0,178035.714285714,1188.85714285714,144.285714285714
"5109","17129","2020",5,5,0,169400,1277.2,135
"5110","17130","2020",8,8,0,82171.375,871.25,95.875
"5111","17131","2020",42,42,0,143877.523809524,1564.40476190476,98.1666666666667
"5112","17132","2020",12,12,0,137585.416666667,1285.41666666667,106.166666666667
"5113","17133","2020",14,14,0,198705.928571429,1591,127.642857142857
"5114","17134","2020",9,9,0,176649,1502.77777777778,116.666666666667
"5115","17135","2020",7,7,0,87049,1010.42857142857,98.1428571428571
"5116","17136","2020",25,24,1,256002.12,1973.64,129.84
"5117","17137","2020",3,3,0,62333.3333333333,661.666666666667,103.333333333333
"5118","17138","2020",10,10,0,119615,1034.1,114.2
"5119","17139","2020",8,8,0,112241.75,881.875,129.25
"5120","17140","2020",137,115,22,205610.102189781,3099.82481751825,70.8540145985401
"5121","17141","2020",8,8,0,141179.125,1364,116.125
"5122","17142","2020",96,91,5,331413.541666667,3115.42708333333,107.302083333333
"5123","17143","2020",13,10,3,136658.692307692,1242.53846153846,115.692307692308
"5124","17145","2020",3,3,0,138333.333333333,872.666666666667,165.666666666667
"5125","17146","2020",64,59,5,173911.796875,1853.3125,96.65625
"5126","17147","2020",18,18,0,151449.5,1273.88888888889,122.166666666667
"5127","17148","2020",6,6,0,294575,1790,164.833333333333
"5128","17149","2020",1,1,0,159722,1011,158
"5129","17150","2020",10,10,0,96518.3,903.1,109.2
"5130","17151","2020",16,15,1,172234.6875,1865.625,93.6875
"5131","17152","2020",14,13,1,138650,1433.21428571429,96.1428571428571
"5132","17153","2020",31,31,0,295088.935483871,2493.64516129032,121.612903225806
"5133","17154","2020",6,6,0,188000,1887.83333333333,105.666666666667
"5134","17155","2020",67,63,4,216464.611940299,2159,101.44776119403
"5135","17156","2020",2,2,0,138500,1583,86.5
"5136","17157","2020",3,3,0,140835,1428,100.666666666667
"5137","17158","2020",13,13,0,226980.153846154,2149.46153846154,106
"5138","17159","2020",3,3,0,150481.333333333,1202.33333333333,123.333333333333
"5139","17160","2020",6,6,0,201650,1542.5,127.666666666667
"5140","17161","2020",105,93,12,520415.6,5967.82857142857,90.9047619047619
"5141","17162","2020",6,6,0,105434.333333333,1021.16666666667,100.333333333333
"5142","17163","2020",6,6,0,144562.5,1206.83333333333,132.666666666667
"5143","17164","2020",42,42,0,214860.5,1902.02380952381,113.595238095238
"5144","17165","2020",14,14,0,99687.0714285714,1084,101.071428571429
"5145","17166","2020",26,26,0,201888.076923077,1758.5,121.230769230769
"5146","17167","2020",13,13,0,147116.923076923,1406.30769230769,105.153846153846
"5147","17168","2020",171,154,17,298451.456140351,3524.47953216374,87.766081871345
"5148","17171","2020",10,10,0,212433,1578,144.1
"5149","17172","2020",36,36,0,185111.888888889,1489.19444444444,123.833333333333
"5150","17174","2020",14,14,0,187042.857142857,1623.92857142857,118.785714285714
"5151","17175","2020",7,7,0,120378.571428571,1357.14285714286,89.1428571428571
"5152","17176","2020",4,4,0,240500,1605,156
"5153","17177","2020",4,4,0,61250,539.75,113
"5154","17179","2020",12,11,1,160890.666666667,1563.83333333333,103.166666666667
"5155","17180","2020",3,3,0,82666.6666666667,569.666666666667,141
"5156","17181","2020",6,6,0,122500,1643.33333333333,80.6666666666667
"5157","17182","2020",16,16,0,149731.25,1325.1875,117.5
"5158","17183","2020",10,10,0,158220,1738.7,99.1
"5159","17184","2020",11,11,0,179850,1607.90909090909,112
"5160","17185","2020",32,32,0,189084.53125,1722.09375,109.25
"5161","17186","2020",16,16,0,168912.1875,1625.625,111.0625
"5162","17187","2020",5,5,0,163114,1656.4,99.4
"5163","17188","2020",8,8,0,126625,1066,131.625
"5164","17190","2020",51,45,6,351229.098039216,3570.43137254902,98.6274509803922
"5165","17191","2020",14,14,0,139821.428571429,1299.57142857143,108.071428571429
"5166","17192","2020",6,6,0,174250,1511.16666666667,114
"5167","17193","2020",46,46,0,252714.369565217,2704.73913043478,94.9130434782609
"5168","17194","2020",48,48,0,282478.020833333,2493.125,109.979166666667
"5169","17195","2020",4,4,0,101250,884.25,113.25
"5170","17196","2020",6,6,0,132901.666666667,1151.66666666667,124.666666666667
"5171","17197","2020",54,42,12,120455.407407407,1634.53703703704,84.1296296296296
"5172","17198","2020",2,2,0,66850,770.5,91.5
"5173","17200","2020",120,109,11,309436.816666667,3104.75,99.4833333333333
"5174","17201","2020",5,5,0,181400,1671.8,111.4
"5175","17202","2020",9,9,0,116333.333333333,1169.66666666667,100.666666666667
"5176","17203","2020",16,16,0,187187.5,1746.25,104
"5177","17204","2020",2,2,0,80490,839.5,108
"5178","17205","2020",3,3,0,177400,1827.66666666667,97.6666666666667
"5179","17206","2020",2,2,0,107500,659.5,150
"5180","17207","2020",26,23,3,583128.846153846,5780.5,107
"5181","17208","2020",18,18,0,286657.777777778,2438.22222222222,116.388888888889
"5182","17209","2020",4,4,0,152956.25,1148.75,135.5
"5183","17210","2020",7,7,0,148457.142857143,1153,121.571428571429
"5184","17211","2020",6,6,0,79750,882.5,91.6666666666667
"5185","17212","2020",5,5,0,101700,1136.6,86.8
"5186","17213","2020",5,5,0,85200,1216,80.8
"5187","17214","2020",11,11,0,171984.090909091,1510.09090909091,113.545454545455
"5188","17215","2020",1,1,0,355081,2731,130
"5189","17216","2020",13,13,0,163231,1148.38461538462,151.307692307692
"5190","17217","2020",4,4,0,103387.5,978,109
"5191","17218","2020",93,79,14,148501.989247312,1665.78494623656,93.258064516129
"5192","17219","2020",122,115,7,175602.918032787,2029.22950819672,90.2131147540984
"5193","17220","2020",7,7,0,110224.142857143,1032.57142857143,106.285714285714
"5194","17221","2020",15,15,0,104486.666666667,940.733333333333,110.733333333333
"5195","17222","2020",37,36,1,417654.702702703,3327.48648648649,123.864864864865
"5196","17223","2020",1,1,0,105500,1122,94
"5197","17224","2020",42,40,2,111949.404761905,1105.7380952381,107.738095238095
"5198","17225","2020",193,172,21,206204.694300518,3409.00518134715,65.9378238341969
"5199","17226","2020",9,9,0,124765,1147.77777777778,107.888888888889
"5200","17227","2020",3,3,0,104000,989.666666666667,118.333333333333
"5201","17228","2020",58,54,4,227839.465517241,2298.58620689655,99.1551724137931
"5202","17229","2020",2,2,0,239725,1648.5,149
"5203","17230","2020",110,90,20,209435.627272727,2929.72727272727,75.6636363636364
"5204","17231","2020",1,1,0,82000,781,105
"5205","17232","2020",36,35,1,200376.861111111,1576.19444444444,128.527777777778
"5206","17233","2020",2,2,0,149425,1327.5,111
"5207","17234","2020",3,3,0,122366.666666667,1278.66666666667,99
"5208","17235","2020",13,13,0,149401.153846154,1165.46153846154,126.307692307692
"5209","17236","2020",30,25,5,107336.933333333,1194.83333333333,98.1
"5210","17237","2020",9,9,0,162333.333333333,1580,103
"5211","17239","2020",5,5,0,148760,1066.4,155
"5212","17240","2020",54,53,1,138180.574074074,1316.61111111111,108.407407407407
"5213","17241","2020",23,23,0,134968.739130435,1219.21739130435,117.260869565217
"5214","17242","2020",11,11,0,164970.454545455,1544.72727272727,124.181818181818
"5215","17243","2020",8,8,0,137818.75,1281,113
"5216","17244","2020",20,20,0,134655.75,1243.85,114.55
"5217","17245","2020",19,19,0,245351.263157895,2627.52631578947,96
"5218","17246","2020",4,4,0,145792.5,1566.25,104.75
"5219","17247","2020",27,25,2,208467.037037037,2188.44444444444,96.6666666666667
"5220","17248","2020",21,21,0,182433.333333333,1639.57142857143,108.428571428571
"5221","17249","2020",4,4,0,240272.5,1174.25,204.5
"5222","17250","2020",7,7,0,130785.714285714,1099.57142857143,125.714285714286
"5223","17252","2020",4,4,0,195812.5,1300.5,160.75
"5224","17253","2020",30,29,1,163985,1792.03333333333,94.5
"5225","17254","2020",3,3,0,63666.6666666667,1058,89.6666666666667
"5226","17255","2020",12,12,0,135066.25,1569.41666666667,88.6666666666667
"5227","17256","2020",4,4,0,167875,1314.25,124.5
"5228","17257","2020",11,11,0,113454.545454545,868.818181818182,129.636363636364
"5229","17258","2020",2,2,0,79500,842,95
"5230","17260","2020",5,5,0,122170,1120.4,104.6
"5231","17261","2020",5,5,0,130400,1010,122.2
"5232","17262","2020",9,9,0,171593.333333333,1786.55555555556,95.7777777777778
"5233","17263","2020",4,4,0,131750,987.5,128.25
"5234","17264","2020",89,86,3,318363.617977528,3061.15730337079,106.460674157303
"5235","17265","2020",18,18,0,202317.5,1722.33333333333,121.111111111111
"5236","17266","2020",12,12,0,140662.5,1288.75,112.833333333333
"5237","17267","2020",19,19,0,214185.947368421,2039,104.210526315789
"5238","17268","2020",2,2,0,205500,743,248
"5239","17269","2020",10,10,0,101736.7,1047.7,94.7
"5240","17270","2020",6,6,0,90131.6666666667,1506.66666666667,73.3333333333333
"5241","17271","2020",4,4,0,94500,716.75,135.25
"5242","17273","2020",11,11,0,164222.727272727,1226.81818181818,138.909090909091
"5243","17274","2020",128,85,43,307515.5,3392.890625,90.09375
"5244","17275","2020",9,9,0,213850,1673.66666666667,126.444444444444
"5245","17277","2020",13,13,0,156667.538461538,1432.23076923077,111.923076923077
"5246","17278","2020",11,11,0,163568.181818182,1632.18181818182,104.909090909091
"5247","17279","2020",9,9,0,119222.222222222,1304.33333333333,98.3333333333333
"5248","17280","2020",9,9,0,161418.222222222,1508.33333333333,104.333333333333
"5249","17281","2020",3,3,0,169000,1372.66666666667,117.333333333333
"5250","17282","2020",3,3,0,128993.333333333,1267,106.666666666667
"5251","17283","2020",63,63,0,123111,1210.26984126984,107.968253968254
"5252","17284","2020",40,40,0,156047.5,1487.95,112.425
"5253","17285","2020",22,22,0,180980.454545455,1531.63636363636,117.727272727273
"5254","17286","2020",42,42,0,820677.952380952,7615.02380952381,104.333333333333
"5255","17287","2020",4,4,0,115953.75,1151.5,100.25
"5256","17288","2020",3,3,0,131966.666666667,1463,92
"5257","17289","2020",7,7,0,326385.714285714,2121.57142857143,152.428571428571
"5258","17290","2020",3,3,0,228333.333333333,1370,143
"5259","17291","2020",112,87,25,254429.553571429,2962.73214285714,85.3928571428571
"5260","17292","2020",8,8,0,138807.5,1192.875,121.625
"5261","17293","2020",10,10,0,137400,1178.2,125.7
"5262","17294","2020",4,4,0,46750,694.5,71.75
"5263","17295","2020",6,6,0,133927,1473.16666666667,95.3333333333333
"5264","17296","2020",11,11,0,152420.909090909,1516,102.181818181818
"5265","17297","2020",47,44,3,614226.574468085,5971.87234042553,106.063829787234
"5266","17298","2020",9,9,0,162666.666666667,1341.22222222222,121.666666666667
"5267","17299","2020",542,260,282,139129.335793358,2025.036900369,72.3191881918819
"5268","17300","2020",1568,581,987,264285.647959184,4123.03507653061,66.2219387755102
"5269","17301","2020",5,5,0,71435.8,685.2,110
"5270","17302","2020",16,16,0,128519.6875,1172.625,113.8125
"5271","17303","2020",23,23,0,141625.217391304,1444.39130434783,101.652173913043
"5272","17304","2020",10,10,0,105713,1142.9,94
"5273","17305","2020",5,5,0,124000,1165.8,112.2
"5274","17306","2020",825,349,476,232624.111515152,3268.48,73.4654545454545
"5275","17307","2020",15,14,1,193421.333333333,1791.8,108.8
"5276","17308","2020",35,35,0,186243.571428571,1730.82857142857,111.885714285714
"5277","17309","2020",27,27,0,103518.518518519,1085.11111111111,97.2222222222222
"5278","17310","2020",22,22,0,210597.727272727,1651.13636363636,123.227272727273
"5279","17311","2020",38,36,2,230906.789473684,2443.89473684211,95.6315789473684
"5280","17312","2020",8,8,0,124262.875,1185.125,123
"5281","17313","2020",7,7,0,155771.428571429,1355.14285714286,116.857142857143
"5282","17314","2020",11,10,1,120920.909090909,1350.36363636364,89.0909090909091
"5283","17315","2020",31,31,0,206539.064516129,2115.67741935484,100.612903225806
"5284","17316","2020",5,5,0,123180,1227,99.2
"5285","17317","2020",4,4,0,145900,1312.75,117
"5286","17318","2020",28,28,0,433774.107142857,5379.71428571429,84.0357142857143
"5287","17320","2020",4,4,0,103750,1349.5,77.75
"5288","17321","2020",10,10,0,138250,1287.6,110.5
"5289","17322","2020",7,7,0,215926.571428571,1591.85714285714,141.428571428571
"5290","17323","2020",79,78,1,211063.936708861,3248.79746835443,70.5189873417721
"5291","17324","2020",1,1,0,40000,615,65
"5292","17325","2020",14,14,0,182375,1542.14285714286,138.428571428571
"5293","17326","2020",2,2,0,134000,1183.5,113.5
"5294","17327","2020",4,4,0,72875,956.75,76.75
"5295","17328","2020",16,16,0,168360.3125,1483.4375,109.875
"5296","17329","2020",6,6,0,132666.666666667,2077.66666666667,79.3333333333333
"5297","17330","2020",21,21,0,147333.80952381,1401.7619047619,109.761904761905
"5298","17331","2020",16,16,0,165040.6875,1409.75,125.1875
"5299","17332","2020",7,7,0,124764.285714286,1184.57142857143,105.571428571429
"5300","17333","2020",282,160,122,223713.617021277,3441.85106382979,67.8049645390071
"5301","17334","2020",3,3,0,115166.666666667,817,155.333333333333
"5302","17335","2020",6,6,0,157106.166666667,1177.16666666667,122.333333333333
"5303","17336","2020",36,36,0,188500.555555556,1806.47222222222,107.027777777778
"5304","17337","2020",189,180,9,208966.46031746,3025.10582010582,73.3439153439153
"5305","17338","2020",26,26,0,170173.115384615,1462.15384615385,110.923076923077
"5306","17339","2020",14,14,0,164237,1361.64285714286,119.357142857143
"5307","17340","2020",27,27,0,172024.518518519,1529.22222222222,119.333333333333
"5308","17341","2020",3,3,0,161526.666666667,1456.33333333333,105.333333333333
"5309","17342","2020",7,7,0,239177.142857143,1880.42857142857,137.428571428571
"5310","17344","2020",15,15,0,142767.666666667,1470.66666666667,100.933333333333
"5311","17345","2020",5,5,0,163503,1552.6,111.4
"5312","17346","2020",18,18,0,226176.111111111,1999.11111111111,110.444444444444
"5313","17347","2020",171,144,27,118436.187134503,1188.38011695906,103.157894736842
"5314","17348","2020",5,5,0,168800,1580.6,107.6
"5315","17349","2020",43,43,0,198892.186046512,1796.83720930233,114.604651162791
"5316","17350","2020",11,11,0,160866.363636364,1185.27272727273,139.272727272727
"5317","17351","2020",37,36,1,178390.27027027,1609.86486486486,109.459459459459
"5318","17353","2020",53,53,0,235746.79245283,2421.88679245283,99.7924528301887
"5319","17354","2020",3,3,0,178666.666666667,1639,108.333333333333
"5320","17355","2020",6,6,0,149658.333333333,1535.16666666667,91.3333333333333
"5321","17356","2020",8,8,0,136882.5,1233.125,116.625
"5322","17357","2020",7,7,0,154967.857142857,1330.85714285714,113.285714285714
"5323","17358","2020",1,1,0,58000,1055,55
"5324","17359","2020",21,21,0,176340.380952381,1542.09523809524,116.809523809524
"5325","17360","2020",70,70,0,661376.985714286,5371.51428571429,125.457142857143
"5326","17361","2020",3,3,0,102666.666666667,742.666666666667,125.666666666667
"5327","17362","2020",5,5,0,162163.4,1604.6,109
"5328","17363","2020",7,7,0,141277.142857143,1456.71428571429,93.4285714285714
"5329","17364","2020",3,3,0,125183.333333333,982,134.666666666667
"5330","17365","2020",5,5,0,119934,1417.2,87
"5331","17366","2020",4,4,0,124037.5,1326.5,92
"5332","17367","2020",3,3,0,33000,848,43.6666666666667
"5333","17369","2020",60,30,30,463020.25,6384.86666666667,67.75
"5334","17373","2020",45,45,0,255647.444444444,2487.24444444444,111.866666666667
"5335","17374","2020",6,6,0,149366.666666667,1394.83333333333,108.666666666667
"5336","17375","2020",24,23,1,149716.666666667,1747.41666666667,89.125
"5337","17376","2020",34,34,0,271119.294117647,2531.70588235294,109.558823529412
"5338","17377","2020",5,5,0,121660,952,143.8
"5339","17378","2020",7,7,0,107585.714285714,915.857142857143,117.714285714286
"5340","17379","2020",5,5,0,123605,1090.8,110
"5341","17380","2020",217,167,50,309805.626728111,3826.59907834101,85.9769585253456
"5342","17381","2020",2,2,0,81000,1078.5,82
"5343","17382","2020",4,4,0,180250,1420.75,126
"5344","17383","2020",5,5,0,129078,809.4,158.2
"5345","17384","2020",5,5,0,211460,1807.2,129.4
"5346","17385","2020",214,204,10,231885.014018692,3022.1261682243,80.9719626168224
"5347","17386","2020",5,5,0,130208.4,1543,86.4
"5348","17387","2020",23,23,0,165367.434782609,1591.26086956522,107.217391304348
"5349","17388","2020",8,8,0,125445.25,955.75,127.25
"5350","17389","2020",10,10,0,142601,1532.1,92
"5351","17390","2020",1,1,0,79000,1215,65
"5352","17391","2020",25,25,0,345624.48,3084.28,110
"5353","17393","2020",26,23,3,139469.307692308,1629.38461538462,98.1923076923077
"5354","17394","2020",11,11,0,171111.363636364,1280.09090909091,135.181818181818
"5355","17395","2020",4,4,0,157770.75,1472,108.5
"5356","17396","2020",24,24,0,196622.875,2024.41666666667,105.916666666667
"5357","17397","2020",46,46,0,144945.826086957,1447.08695652174,102.695652173913
"5358","17398","2020",2,2,0,169841,1215,154.5
"5359","17400","2020",7,7,0,152331.428571429,1315.28571428571,126.571428571429
"5360","17401","2020",3,3,0,139020.666666667,1023.33333333333,144.666666666667
"5361","17402","2020",3,3,0,112666.666666667,763.333333333333,144.333333333333
"5362","17403","2020",6,6,0,130637.5,1365.66666666667,97.1666666666667
"5363","17404","2020",13,13,0,175731.307692308,1611.30769230769,116.769230769231
"5364","17405","2020",3,3,0,120900,1506.66666666667,74.3333333333333
"5365","17406","2020",7,7,0,171907.142857143,1895,93.5714285714286
"5366","17407","2020",67,63,4,256291.731343284,2449.80597014925,104.417910447761
"5367","17408","2020",14,14,0,177191.428571429,1626.28571428571,112.928571428571
"5368","17409","2020",73,68,5,249333.547945205,2459.17808219178,104.013698630137
"5369","17410","2020",7,7,0,193171.428571429,1492.42857142857,134.285714285714
"5370","17411","2020",45,43,2,288719.133333333,3720.04444444444,85.6
"5371","17412","2020",8,8,0,280850,1846,160
"5372","17413","2020",20,20,0,295642.1,2815.35,101.3
"5373","17414","2020",78,78,0,301710.525641026,2856.5,109.948717948718
"5374","17415","2020",488,357,131,156280.534836066,1783.07991803279,87.5512295081967
"5375","17416","2020",2,2,0,94500,753,124.5
"5376","17417","2020",4,4,0,120750,962.75,131.75
"5377","17418","2020",10,10,0,206610,1376.2,151.8
"5378","17420","2020",35,33,2,283260.285714286,2793,105.342857142857
"5379","17421","2020",139,117,22,185003.971223022,2117.87769784173,89.9640287769784
"5380","17422","2020",1,1,0,55000,671,82
"5381","17423","2020",1,1,0,85100,564,151
"5382","17424","2020",5,5,0,147660,1139.8,112.2
"5383","17425","2020",50,50,0,214366.3,2188.42,98.96
"5384","17426","2020",5,5,0,86800,997.6,107.8
"5385","17427","2020",4,4,0,80250,777.25,99.25
"5386","17428","2020",7,7,0,130214.285714286,1047.14285714286,123.571428571429
"5387","17429","2020",35,34,1,196247.457142857,1944.02857142857,101.4
"5388","17430","2020",2,2,0,80000,656.5,122
"5389","17431","2020",12,12,0,137746.666666667,1196.33333333333,112
"5390","17432","2020",9,9,0,150177.777777778,1313.66666666667,116.111111111111
"5391","17433","2020",2,2,0,130000,1427,92.5
"5392","17434","2020",126,113,13,158945.722222222,1582.07936507937,100.722222222222
"5393","17435","2020",3,3,0,144666.666666667,1223.33333333333,129.333333333333
"5394","17436","2020",6,6,0,227516.666666667,1618.33333333333,145.666666666667
"5395","17437","2020",3,3,0,230833.333333333,2503.33333333333,91.6666666666667
"5396","17438","2020",3,3,0,216750,1101.66666666667,202
"5397","17439","2020",18,18,0,118549.722222222,1285.16666666667,94.6111111111111
"5398","17440","2020",12,8,4,96541.6666666667,1301.33333333333,78.1666666666667
"5399","17441","2020",12,12,0,127177.083333333,1281.08333333333,101.25
"5400","17442","2020",3,2,1,260441.666666667,1681.33333333333,157
"5401","17443","2020",33,33,0,273110.121212121,2198.09090909091,124
"5402","17444","2020",24,24,0,177168.375,1777.79166666667,104.083333333333
"5403","17445","2020",1,1,0,460000,1549,297
"5404","17446","2020",5,5,0,109900,1004,116
"5405","17447","2020",26,26,0,205848.846153846,1998,108.346153846154
"5406","17448","2020",24,24,0,128582.625,1251.875,106.875
"5407","17449","2020",149,108,41,159082.483221477,1759.6711409396,91.4563758389262
"5408","17450","2020",6,6,0,114651.666666667,1029,113.333333333333
"5409","17451","2020",6,6,0,94000,924.666666666667,97.6666666666667
"5410","17452","2020",145,133,12,225321.248275862,2823.61379310345,83.5724137931035
"5411","17453","2020",16,16,0,187937.5,1648.5,116.6875
"5412","17454","2020",4,4,0,92000,980.75,88.75
"5413","17455","2020",9,9,0,151900,1280.22222222222,113.222222222222
"5414","17457","2020",22,22,0,142200.272727273,1566.59090909091,96.2727272727273
"5415","17458","2020",4,4,0,117541,1332.25,92.75
"5416","17459","2020",13,13,0,142039.769230769,1215.23076923077,120
"5417","17460","2020",14,14,0,189026.071428571,1571.14285714286,125.071428571429
"5418","17461","2020",215,120,95,266519.548837209,3858.76279069767,72.0651162790698
"5419","17462","2020",15,15,0,203446.066666667,1626.4,126.733333333333
"5420","17463","2020",35,35,0,250129.114285714,2292.17142857143,113.371428571429
"5421","17464","2020",1,1,0,171400,1731,99
"5422","17465","2020",13,13,0,146292.307692308,1231.30769230769,108.846153846154
"5423","17466","2020",34,32,2,240574.852941176,2199.85294117647,115.441176470588
"5424","17467","2020",7,7,0,130566.857142857,1196.14285714286,108.571428571429
"5425","17468","2020",2,2,0,93676.5,832.5,116
"5426","17469","2020",8,8,0,174575,1347.875,124.5
"5427","17470","2020",2,2,0,77250,1457.5,58
"5428","17471","2020",5,5,0,66742,568.8,113.6
"5429","17472","2020",45,45,0,256638.622222222,2535.6,102
"5430","17473","2020",2,2,0,138975,1345,98.5
"5431","17474","2020",19,19,0,97595.6842105263,951,101.052631578947
"5432","17477","2020",2,2,0,42500,517.5,73
"5433","17478","2020",2,2,0,71500,739,103
"5434","17479","2020",3,3,0,153000,1329,119
"5435","17480","2020",20,20,0,208973.25,1650.9,132.2
"5436","17481","2020",1,1,0,82500,927,89
"5437","17482","2020",11,11,0,199486.363636364,1611.18181818182,119.909090909091
"5438","17483","2020",27,27,0,257442.777777778,2519.81481481481,102.333333333333
"5439","17484","2020",57,54,3,173301.315789474,1938.45614035088,89.6666666666667
"5440","17485","2020",33,32,1,280120.545454545,3685.0303030303,79.4848484848485
"5441","17486","2020",56,55,1,228603.089285714,3780.76785714286,66.1071428571429
"5442","18001","2020",9,9,0,107611.111111111,993.666666666667,104.666666666667
"5443","18002","2020",2,2,0,48500,749,70
"5444","18003","2020",27,27,0,111875.185185185,1238.51851851852,93.3333333333333
"5445","18004","2020",13,13,0,155811.538461538,1334,113.384615384615
"5446","18005","2020",4,3,1,102322.5,988.25,109.75
"5447","18006","2020",2,2,0,87500,948,96.5
"5448","18008","2020",7,7,0,131571.428571429,1235.71428571429,118.142857142857
"5449","18009","2020",6,6,0,95166.6666666667,631.666666666667,144.166666666667
"5450","18010","2020",3,3,0,51000,676,70.6666666666667
"5451","18011","2020",26,25,1,116885.961538462,1174.65384615385,90.1153846153846
"5452","18012","2020",8,8,0,60152.5,749.125,83.375
"5453","18013","2020",4,4,0,103125,935.25,101.5
"5454","18014","2020",2,2,0,36125,952,36
"5455","18015","2020",62,53,9,103043.387096774,1242.96774193548,80.4838709677419
"5456","18016","2020",1,1,0,133500,4450,30
"5457","18017","2020",4,4,0,60875,643.25,93.75
"5458","18018","2020",24,24,0,117064.583333333,1223.54166666667,96.25
"5459","18019","2020",5,5,0,70000,820.4,86.4
"5460","18020","2020",12,12,0,111441.666666667,1113.41666666667,99.3333333333333
"5461","18021","2020",7,7,0,88214.2857142857,873.285714285714,94.4285714285714
"5462","18022","2020",3,3,0,59833.3333333333,768.666666666667,82.3333333333333
"5463","18023","2020",16,15,1,118671.875,1121.25,103.6875
"5464","18024","2020",1,1,0,45870,459,100
"5465","18025","2020",5,5,0,122759.4,1208,95
"5466","18026","2020",14,14,0,109325,1166.28571428571,92.0714285714286
"5467","18027","2020",11,11,0,143472.727272727,1221.45454545455,101.636363636364
"5468","18028","2020",11,11,0,167950.909090909,1372.90909090909,121.272727272727
"5469","18029","2020",7,7,0,130614.285714286,935.714285714286,128.142857142857
"5470","18030","2020",14,14,0,90771.4285714286,1016,85.6428571428571
"5471","18031","2020",7,7,0,55120,804,78.8571428571429
"5472","18032","2020",17,17,0,114000,1285.76470588235,91.3529411764706
"5473","18033","2020",1067,513,554,119855.812558575,1536.03936269916,78.0402999062793
"5474","18034","2020",4,4,0,138978.5,1278.25,112
"5475","18035","2020",11,11,0,130272.727272727,1357.81818181818,102.454545454545
"5476","18036","2020",3,3,0,85366.6666666667,1035.33333333333,85.3333333333333
"5477","18037","2020",12,12,0,108575,1123.75,93.1666666666667
"5478","18038","2020",7,7,0,78071.4285714286,1133.14285714286,80.4285714285714
"5479","18039","2020",5,5,0,168849,1641.4,116.2
"5480","18040","2020",1,1,0,64000,516,124
"5481","18041","2020",3,3,0,96000,1122.33333333333,85.6666666666667
"5482","18043","2020",3,3,0,83333.3333333333,889,88.6666666666667
"5483","18044","2020",6,6,0,126116.666666667,1082.66666666667,122.666666666667
"5484","18045","2020",5,5,0,86800,836.4,103.4
"5485","18046","2020",2,2,0,67500,771,94
"5486","18047","2020",8,8,0,65562.5,790.375,79.875
"5487","18048","2020",3,3,0,59750,954.333333333333,68.3333333333333
"5488","18049","2020",10,10,0,112800,999.1,113.4
"5489","18050","2020",51,51,0,145312.745098039,1612.11764705882,90.3137254901961
"5490","18051","2020",2,2,0,121250,1138,100.5
"5491","18052","2020",11,11,0,82072.7272727273,700.272727272727,121.363636363636
"5492","18053","2020",10,10,0,66300,816.9,81.9
"5493","18054","2020",4,4,0,117027.5,1116.75,112.5
"5494","18055","2020",24,24,0,81859.75,886.458333333333,91.5
"5495","18056","2020",1,1,0,69062,691,100
"5496","18057","2020",21,21,0,69790,1013.47619047619,82.6666666666667
"5497","18058","2020",22,22,0,82235.4545454545,849.5,96.4545454545455
"5498","18059","2020",9,9,0,55286.1111111111,630.444444444444,90.2222222222222
"5499","18060","2020",1,1,0,70000,700,100
"5500","18061","2020",1,1,0,23000,354,65
"5501","18062","2020",2,2,0,83000,934,94
"5502","18063","2020",5,5,0,109580,1081.4,102.6
"5503","18064","2020",4,4,0,94250,1075.5,89.25
"5504","18065","2020",10,10,0,139764.6,1252.5,84.9
"5505","18066","2020",11,10,1,123081.818181818,1260.63636363636,100.909090909091
"5506","18067","2020",9,8,1,93000,1382.33333333333,75.1111111111111
"5507","18069","2020",4,4,0,91000,1076.5,82.5
"5508","18070","2020",7,7,0,69357.1428571429,764.857142857143,99
"5509","18072","2020",4,4,0,73750,702.25,93
"5510","18073","2020",1,1,0,90000,1000,90
"5511","18074","2020",2,2,0,65000,642,97
"5512","18075","2020",6,6,0,91166.6666666667,1167.33333333333,79.6666666666667
"5513","18076","2020",2,2,0,67250,724,77.5
"5514","18077","2020",6,6,0,103000,910.333333333333,107.666666666667
"5515","18078","2020",2,2,0,57500,821,103
"5516","18079","2020",5,5,0,148000,1748,93
"5517","18080","2020",3,3,0,100593.333333333,1408.33333333333,80.6666666666667
"5518","18081","2020",4,4,0,129000,1327.75,104.25
"5519","18082","2020",11,11,0,155815.454545455,1448.63636363636,110.272727272727
"5520","18083","2020",13,13,0,75532.9230769231,844.384615384615,92.9230769230769
"5521","18084","2020",1,1,0,45000,375,120
"5522","18085","2020",4,4,0,91750,911.75,98.5
"5523","18086","2020",5,5,0,95100,928,88
"5524","18087","2020",49,49,0,100351.020408163,992.795918367347,101.897959183673
"5525","18088","2020",4,4,0,164635,1608.5,96.25
"5526","18089","2020",4,4,0,56750,730,79.75
"5527","18090","2020",7,7,0,108742.857142857,1046.42857142857,109.714285714286
"5528","18091","2020",1,1,0,153920,1019,151
"5529","18092","2020",13,13,0,146261.538461538,1329.15384615385,114.923076923077
"5530","18093","2020",1,1,0,150000,1210,124
"5531","18094","2020",7,7,0,73357.1428571429,712,97.7142857142857
"5532","18095","2020",4,4,0,106250,786.5,135.25
"5533","18096","2020",30,30,0,104920.9,1140.33333333333,89.9666666666667
"5534","18097","2020",38,38,0,165939.210526316,1544.57894736842,109.763157894737
"5535","18098","2020",1,1,0,63000,1050,60
"5536","18099","2020",1,1,0,52000,385,135
"5537","18100","2020",7,7,0,114000,918.285714285714,123.285714285714
"5538","18101","2020",7,7,0,56928.5714285714,731.571428571429,79.1428571428571
"5539","18102","2020",3,3,0,85000,890.666666666667,100.666666666667
"5540","18103","2020",14,14,0,86715,984.571428571429,84.7142857142857
"5541","18104","2020",1,1,0,149000,1380,108
"5542","18105","2020",7,7,0,94628.5714285714,972,96.2857142857143
"5543","18106","2020",4,3,1,55300,588.75,100.75
"5544","18107","2020",2,2,0,112300,963.5,120
"5545","18108","2020",41,41,0,88090.243902439,1058.58536585366,87.6585365853659
"5546","18109","2020",25,25,0,97811.2,1018.16,88.32
"5547","18110","2020",14,14,0,92714.2857142857,964.5,97.5714285714286
"5548","18112","2020",7,7,0,90551.5714285714,890.142857142857,100.571428571429
"5549","18113","2020",1,1,0,76000,1583,48
"5550","18114","2020",1,1,0,105313,1726,61
"5551","18115","2020",6,6,0,84933.3333333333,906.833333333333,95.3333333333333
"5552","18116","2020",8,8,0,79919.25,848.75,92
"5553","18117","2020",5,5,0,144008.2,1428.8,115
"5554","18118","2020",27,27,0,95946.2962962963,1344.55555555556,84.1851851851852
"5555","18119","2020",4,4,0,55062.5,754.5,73.5
"5556","18120","2020",12,12,0,82750,1002.16666666667,82.5833333333333
"5557","18121","2020",2,2,0,90000,950,87.5
"5558","18122","2020",3,3,0,88333.3333333333,952.333333333333,87.6666666666667
"5559","18124","2020",7,7,0,104561,1093.28571428571,105.571428571429
"5560","18125","2020",13,13,0,77126.9230769231,986.923076923077,78.8461538461538
"5561","18126","2020",13,12,1,106338.461538462,1139.69230769231,91.9230769230769
"5562","18127","2020",19,19,0,117410.526315789,1241.21052631579,88.1578947368421
"5563","18128","2020",1,1,0,58000,744,78
"5564","18129","2020",3,3,0,141166.666666667,1556,88
"5565","18130","2020",3,3,0,82933.3333333333,724,93.6666666666667
"5566","18132","2020",3,3,0,47000,511,94.3333333333333
"5567","18133","2020",14,14,0,70142.8571428571,838.214285714286,84.5714285714286
"5568","18134","2020",3,3,0,115000,1113.66666666667,106.333333333333
"5569","18135","2020",6,6,0,101875,1272.16666666667,75.8333333333333
"5570","18136","2020",7,7,0,87015,871.571428571429,104.714285714286
"5571","18137","2020",9,9,0,75777.7777777778,818.111111111111,93.8888888888889
"5572","18138","2020",27,27,0,163152.111111111,1533.2962962963,104.666666666667
"5573","18139","2020",6,6,0,113300,1080.5,127.166666666667
"5574","18140","2020",21,21,0,79673.8095238095,932,97.0952380952381
"5575","18141","2020",91,85,6,117122.252747253,1278.37362637363,91.5384615384615
"5576","18142","2020",6,6,0,59821.6666666667,976.333333333333,70
"5577","18143","2020",1,1,0,110000,764,144
"5578","18144","2020",4,4,0,80675,1039.25,76.5
"5579","18145","2020",14,14,0,116821.428571429,1271.42857142857,98.1428571428571
"5580","18146","2020",9,9,0,45133.3333333333,793,54.3333333333333
"5581","18147","2020",6,6,0,114750,1195.16666666667,101
"5582","18148","2020",25,25,0,154876,1346.24,118.68
"5583","18149","2020",12,12,0,77116.6666666667,802.333333333333,95.0833333333333
"5584","18150","2020",10,10,0,121013,1114.8,111.1
"5585","18151","2020",3,3,0,90000,1111,82
"5586","18152","2020",4,4,0,88384.5,911.25,94.5
"5587","18153","2020",5,5,0,81200,907,87.8
"5588","18154","2020",1,1,0,92000,902,102
"5589","18155","2020",10,10,0,55950,773.6,71.7
"5590","18156","2020",10,10,0,164900,1310.5,115.4
"5591","18157","2020",14,14,0,119677.142857143,1365.07142857143,86.4285714285714
"5592","18158","2020",6,6,0,188500,1620.16666666667,120.166666666667
"5593","18159","2020",25,25,0,140729.44,1369.92,100.4
"5594","18160","2020",17,17,0,109455.882352941,979.705882352941,98.8235294117647
"5595","18161","2020",5,5,0,109000,1235.4,111.6
"5596","18162","2020",4,4,0,146102.5,1417.5,94.5
"5597","18163","2020",3,3,0,122000,1002.66666666667,107.333333333333
"5598","18164","2020",3,3,0,148333.333333333,1105.33333333333,140.666666666667
"5599","18165","2020",16,16,0,126053.1875,1119.125,92.4375
"5600","18166","2020",4,4,0,171000,1710.5,121.25
"5601","18167","2020",3,3,0,93666.6666666667,833.666666666667,104
"5602","18168","2020",3,3,0,141666.666666667,1906.33333333333,77
"5603","18169","2020",3,3,0,128000,1069,117.333333333333
"5604","18170","2020",16,16,0,120414.375,1177.4375,110.6875
"5605","18172","2020",25,24,1,65782.76,866.4,77.88
"5606","18173","2020",1,1,0,138000,1408,98
"5607","18174","2020",2,2,0,180000,1830.5,99
"5608","18175","2020",6,6,0,85483.3333333333,822.166666666667,105.333333333333
"5609","18176","2020",7,7,0,160142.857142857,1302.57142857143,125.428571428571
"5610","18178","2020",6,6,0,70666.6666666667,815,83.5
"5611","18179","2020",15,15,0,147066.666666667,1418.53333333333,100.8
"5612","18180","2020",25,25,0,205247.6,1800.6,120.52
"5613","18181","2020",4,4,0,105625,1187,87.25
"5614","18182","2020",3,3,0,40666.6666666667,570.666666666667,72.3333333333333
"5615","18183","2020",4,4,0,92290.75,1188.75,66
"5616","18184","2020",3,3,0,122833.333333333,1180,103.666666666667
"5617","18185","2020",4,4,0,86250,938,101.25
"5618","18186","2020",10,10,0,146600,1136.3,120.1
"5619","18187","2020",16,15,1,65721.8125,763.5625,91.25
"5620","18188","2020",4,4,0,102631.25,1219.25,86
"5621","18189","2020",8,7,1,118731.25,1232.125,96
"5622","18190","2020",7,7,0,102992.857142857,1057,104.428571428571
"5623","18191","2020",2,2,0,122500,1207.5,102
"5624","18192","2020",4,4,0,123725,1425.75,88
"5625","18193","2020",7,7,0,62557,740.571428571429,83.7142857142857
"5626","18194","2020",9,9,0,130000,1280.55555555556,98.5555555555556
"5627","18195","2020",8,8,0,58687.5,641.25,86.75
"5628","18196","2020",2,2,0,87500,883.5,103
"5629","18197","2020",146,120,26,81901.5684931507,978.739726027397,83.0821917808219
"5630","18198","2020",5,5,0,106200,977,108
"5631","18199","2020",10,10,0,48400,617.8,77
"5632","18200","2020",7,7,0,50714.2857142857,808.428571428571,62.5714285714286
"5633","18201","2020",3,3,0,194666.666666667,1402.33333333333,140
"5634","18203","2020",1,1,0,39000,765,51
"5635","18204","2020",2,2,0,148650,1295,122.5
"5636","18205","2020",95,92,3,184360.357894737,1798.21052631579,106.284210526316
"5637","18206","2020",21,21,0,146285.714285714,1374.85714285714,102.285714285714
"5638","18207","2020",82,74,8,109251.426829268,1312.0243902439,84.5853658536585
"5639","18208","2020",5,5,0,142360,1200,114.6
"5640","18209","2020",9,9,0,89650.5555555556,1134.77777777778,82.1111111111111
"5641","18210","2020",6,6,0,103558.333333333,1065.5,98.5
"5642","18211","2020",5,5,0,130666,1287,103.8
"5643","18212","2020",3,3,0,86833.3333333333,932,87.3333333333333
"5644","18213","2020",46,46,0,141568.934782609,1357.69565217391,103.652173913043
"5645","18214","2020",10,10,0,103400,1361.5,80.5
"5646","18215","2020",5,5,0,93320,986,97.4
"5647","18216","2020",6,6,0,170836.666666667,1565,103
"5648","18218","2020",7,7,0,99303.5714285714,1053,95.8571428571429
"5649","18219","2020",9,9,0,195988.888888889,1364,134.555555555556
"5650","18220","2020",7,7,0,50810.4285714286,709.428571428571,74.1428571428571
"5651","18221","2020",5,5,0,285732,2095.2,134.8
"5652","18223","2020",25,25,0,124346,1398.56,89.92
"5653","18224","2020",4,4,0,96000,1169.25,78.5
"5654","18225","2020",6,6,0,59833.3333333333,890,68.1666666666667
"5655","18226","2020",5,5,0,207330,1539.8,137.6
"5656","18227","2020",2,2,0,160000,1266,122.5
"5657","18228","2020",4,4,0,117330,864.5,123.75
"5658","18229","2020",7,7,0,146947.142857143,1248.14285714286,113
"5659","18230","2020",2,2,0,163000,1050,137
"5660","18231","2020",11,11,0,89880,1069.63636363636,85.7272727272727
"5661","18232","2020",5,5,0,60100,974.4,62
"5662","18233","2020",23,23,0,103604.347826087,1378.08695652174,93.8260869565217
"5663","18234","2020",15,15,0,78066.6666666667,831.2,93.8
"5664","18235","2020",12,12,0,117125.833333333,1239.25,93.25
"5665","18236","2020",1,1,0,50000,714,70
"5666","18237","2020",4,4,0,100250,1291.5,80.25
"5667","18238","2020",6,6,0,63866.6666666667,726.833333333333,90
"5668","18240","2020",12,12,0,91478.3333333333,996.5,93.3333333333333
"5669","18241","2020",13,13,0,121667.307692308,1340.92307692308,94.5384615384615
"5670","18242","2020",36,35,1,76377.0833333333,902.25,81.0833333333333
"5671","18243","2020",8,8,0,112625,2207.375,60.625
"5672","18244","2020",2,2,0,108882.5,1010,113.5
"5673","18245","2020",6,6,0,232580,2193.16666666667,100.5
"5674","18246","2020",15,15,0,86233.3333333333,1048.2,84.7333333333333
"5675","18247","2020",7,7,0,111857.142857143,1201,93
"5676","18248","2020",3,3,0,125666.666666667,1135.33333333333,111
"5677","18249","2020",4,4,0,110000,1343.5,84.75
"5678","18250","2020",1,1,0,64000,711,90
"5679","18252","2020",4,4,0,66250,907.75,73.5
"5680","18253","2020",1,1,0,160000,1000,160
"5681","18254","2020",6,6,0,125026.666666667,1203.33333333333,103.833333333333
"5682","18255","2020",6,6,0,226805,1838.16666666667,132.5
"5683","18256","2020",3,3,0,85833.3333333333,855.666666666667,93.3333333333333
"5684","18257","2020",5,5,0,98600,1223.4,78
"5685","18258","2020",9,9,0,85266.6666666667,1235.77777777778,71.7777777777778
"5686","18259","2020",2,2,0,66250,732,90.5
"5687","18260","2020",2,2,0,74000,590.5,126.5
"5688","18261","2020",5,5,0,111800,1708.6,85.4
"5689","18262","2020",7,7,0,86209.7142857143,976.714285714286,90.1428571428571
"5690","18263","2020",6,6,0,139646.666666667,1005.16666666667,149
"5691","18264","2020",3,3,0,54500,604.333333333333,83.6666666666667
"5692","18265","2020",11,11,0,90764.0909090909,1068,84.4545454545455
"5693","18266","2020",4,4,0,61064.5,606.5,110
"5694","18267","2020",39,39,0,168653.512820513,1592.58974358974,106.179487179487
"5695","18268","2020",8,8,0,88937.5,1088.375,88.375
"5696","18269","2020",13,13,0,96338.4615384615,945.076923076923,104.692307692308
"5697","18270","2020",5,5,0,56700,628.6,90.4
"5698","18271","2020",16,16,0,192969.8125,1621.875,119.6875
"5699","18272","2020",6,6,0,62890.8333333333,902.166666666667,71
"5700","18273","2020",13,13,0,84692.3076923077,972.692307692308,85.2307692307692
"5701","18274","2020",1,1,0,152000,1476,103
"5702","18275","2020",5,5,0,116400,957.2,135.8
"5703","18276","2020",2,2,0,53000,533,99.5
"5704","18278","2020",12,12,0,61266.6666666667,845.666666666667,76.4166666666667
"5705","18279","2020",326,249,77,71922.0705521472,957.294478527607,75.5306748466258
"5706","18280","2020",5,5,0,119000,1078.8,99.2
"5707","18281","2020",34,34,0,129207.794117647,1272.23529411765,104.029411764706
"5708","18282","2020",5,5,0,106446,1060.2,104.4
"5709","18283","2020",1,1,0,21500,391,55
"5710","18284","2020",2,2,0,202645,1711.5,115.5
"5711","18285","2020",13,13,0,82412.3076923077,1105.46153846154,76.4615384615385
"5712","18286","2020",3,3,0,82336.6666666667,1037,77.6666666666667
"5713","18287","2020",4,4,0,103500,849.5,119.25
"5714","18289","2020",6,6,0,112500,1282.33333333333,95
"5715","18290","2020",10,10,0,145056.5,1277.2,105.7
"5716","19001","2020",6,6,0,92376.6666666667,1014,92.3333333333333
"5717","19003","2020",2,2,0,187500,1425.5,122
"5718","19004","2020",9,9,0,109333.333333333,1068.11111111111,102.666666666667
"5719","19005","2020",44,44,0,152469.318181818,1365.31818181818,115.795454545455
"5720","19007","2020",6,6,0,145791.666666667,1758.66666666667,88.6666666666667
"5721","19008","2020",2,2,0,96250,1719,65
"5722","19010","2020",35,33,2,120031.971428571,1242.97142857143,106.457142857143
"5723","19011","2020",21,20,1,121451.761904762,1062.38095238095,119.904761904762
"5724","19012","2020",8,8,0,98687.5,1150.875,82.75
"5725","19013","2020",8,8,0,122437.5,1485.625,87.625
"5726","19014","2020",6,6,0,121000,1314.16666666667,99.5
"5727","19015","2020",13,13,0,130097.692307692,1339.53846153846,102.384615384615
"5728","19016","2020",4,4,0,146909.5,1108.75,127.5
"5729","19017","2020",4,4,0,84550,1331.5,57
"5730","19018","2020",4,4,0,118250,1013.25,125.5
"5731","19019","2020",26,25,1,110074.423076923,1305.92307692308,84.6923076923077
"5732","19020","2020",1,1,0,90000,1286,70
"5733","19021","2020",2,2,0,91250,675.5,134.5
"5734","19022","2020",2,2,0,117875,1708.5,98
"5735","19023","2020",17,16,1,104470.176470588,1236.29411764706,90.4117647058823
"5736","19024","2020",6,6,0,121500.666666667,1617.16666666667,87.3333333333333
"5737","19025","2020",8,8,0,124500,1338.75,91.875
"5738","19026","2020",3,3,0,151368.333333333,1612,88.6666666666667
"5739","19027","2020",4,4,0,108500,1438.5,78.25
"5740","19028","2020",23,22,1,83413.0434782609,982.173913043478,82.8260869565217
"5741","19029","2020",6,6,0,203866.666666667,1591.5,129
"5742","19030","2020",11,11,0,124086.363636364,1285.36363636364,92.2727272727273
"5743","19031","2020",819,420,399,130927.111111111,1679.96214896215,78.8449328449328
"5744","19033","2020",12,11,1,96851.6666666667,1133.33333333333,87.5833333333333
"5745","19034","2020",5,5,0,95530,1164.4,98.8
"5746","19035","2020",7,7,0,139782.857142857,1584.71428571429,82.5714285714286
"5747","19036","2020",24,24,0,80708.3333333333,858.166666666667,92.5
"5748","19037","2020",23,23,0,99175.6086956522,1099.34782608696,92.9130434782609
"5749","19038","2020",9,9,0,143430.222222222,1505.44444444444,101.333333333333
"5750","19039","2020",4,4,0,94000,1390.25,65.5
"5751","19040","2020",2,2,0,63000,678,92
"5752","19041","2020",5,5,0,125378.4,1103,114.4
"5753","19042","2020",2,2,0,122500,1080.5,112.5
"5754","19043","2020",2,2,0,246750,1867,127.5
"5755","19044","2020",5,5,0,220200,1562.6,141
"5756","19045","2020",2,2,0,114250,1614,71
"5757","19047","2020",9,9,0,132855.555555556,1463.88888888889,90.6666666666667
"5758","19048","2020",3,3,0,168268,1117.33333333333,160.666666666667
"5759","19049","2020",3,3,0,70633.3333333333,1014.33333333333,79
"5760","19050","2020",5,5,0,110200,1549.2,80
"5761","19051","2020",2,2,0,88750,1207,73
"5762","19052","2020",2,2,0,87500,1164.5,71.5
"5763","19054","2020",6,6,0,182383.333333333,1675.33333333333,107.5
"5764","19055","2020",3,3,0,116866.666666667,985,113.333333333333
"5765","19056","2020",11,11,0,151731.818181818,1420,107.818181818182
"5766","19057","2020",6,6,0,190983.333333333,2072.66666666667,125
"5767","19058","2020",7,7,0,100842,1227.14285714286,85
"5768","19059","2020",5,5,0,135288,1397.6,111.6
"5769","19060","2020",6,5,1,124092.5,1293.16666666667,99.1666666666667
"5770","19061","2020",6,6,0,139500,1407,95.6666666666667
"5771","19062","2020",15,15,0,122430,1213.26666666667,102.933333333333
"5772","19063","2020",22,22,0,216507.727272727,1750.04545454545,124.772727272727
"5773","19064","2020",3,3,0,50000,538.666666666667,91
"5774","19065","2020",2,2,0,46612,967.5,56.5
"5775","19066","2020",24,24,0,182680.416666667,1619.29166666667,111.625
"5776","19067","2020",7,7,0,125571.428571429,1842,78.7142857142857
"5777","19068","2020",4,4,0,172150,1290.25,124.5
"5778","19069","2020",2,2,0,95828.5,1253,76
"5779","19070","2020",5,5,0,82720,1104.2,83.6
"5780","19071","2020",5,5,0,126780,1373.6,102.8
"5781","19072","2020",30,29,1,133691.166666667,1400.03333333333,100
"5782","19073","2020",50,45,5,96554.62,946.02,101.42
"5783","19074","2020",3,3,0,82833.3333333333,827,106.666666666667
"5784","19075","2020",9,9,0,78265.5555555556,970.777777777778,86.7777777777778
"5785","19076","2020",5,5,0,132835,1000.6,121.4
"5786","19078","2020",4,4,0,107625,1399.25,78.25
"5787","19079","2020",5,5,0,169860,1327.2,120.4
"5788","19080","2020",3,3,0,86666.6666666667,599.333333333333,128.666666666667
"5789","19081","2020",7,7,0,68357.1428571429,684.428571428571,110.571428571429
"5790","19082","2020",5,5,0,134210,1746.4,79.8
"5791","19084","2020",8,8,0,121750,1222.375,107
"5792","19085","2020",5,5,0,83700,930.2,93.8
"5793","19086","2020",5,5,0,75820,1115.2,76.2
"5794","19087","2020",2,2,0,42790,488.5,91
"5795","19088","2020",2,2,0,86500,785,111
"5796","19089","2020",1,1,0,145000,1142,127
"5797","19090","2020",3,3,0,100666.666666667,936,93
"5798","19091","2020",4,4,0,120600,1107.5,111.75
"5799","19093","2020",10,10,0,217655.5,1639.7,129.2
"5800","19094","2020",17,17,0,125779.941176471,1244.29411764706,98.2941176470588
"5801","19095","2020",4,4,0,100680,1315.25,88
"5802","19096","2020",3,3,0,170160,1429,117
"5803","19098","2020",6,6,0,104108.333333333,1146.83333333333,93
"5804","19099","2020",3,3,0,103666.666666667,1000,110.666666666667
"5805","19100","2020",11,11,0,131336.909090909,1215.54545454545,106.454545454545
"5806","19101","2020",14,13,1,90475,1072.28571428571,87.7857142857143
"5807","19102","2020",2,2,0,52250,1030,52
"5808","19103","2020",2,2,0,122500,1291.5,105
"5809","19104","2020",1,1,0,90000,1875,48
"5810","19105","2020",6,6,0,128541.666666667,1527.66666666667,80.8333333333333
"5811","19106","2020",12,11,1,55590.1666666667,866.666666666667,73.1666666666667
"5812","19107","2020",23,17,6,112055.913043478,1522.69565217391,73.9565217391304
"5813","19108","2020",2,2,0,101000,864,111.5
"5814","19109","2020",5,5,0,141780,1859,79
"5815","19110","2020",2,2,0,147000,1186,124.5
"5816","19112","2020",2,2,0,95000,1369,75.5
"5817","19113","2020",17,17,0,98612.0588235294,1101.76470588235,87.4705882352941
"5818","19114","2020",1,1,0,94000,1133,83
"5819","19115","2020",5,5,0,175324,1976.6,89.4
"5820","19116","2020",2,2,0,206555,1427,142.5
"5821","19117","2020",12,12,0,143854.166666667,1384.25,99.3333333333333
"5822","19118","2020",17,17,0,81005.8823529412,973.647058823529,85
"5823","19119","2020",5,5,0,153980,1846,91.2
"5824","19120","2020",5,5,0,117590,1523.2,75.2
"5825","19121","2020",21,21,0,115120.19047619,1131.2380952381,106.095238095238
"5826","19122","2020",4,4,0,57187.5,568,109.5
"5827","19123","2020",120,81,39,138716.65,1544.24166666667,87.15
"5828","19124","2020",15,15,0,129182,1519.46666666667,92.1333333333333
"5829","19125","2020",17,16,1,85108.8235294118,1150.64705882353,76.7647058823529
"5830","19126","2020",2,2,0,192875,1452,139
"5831","19128","2020",5,5,0,96200,1058.4,109
"5832","19129","2020",5,5,0,50950,684.2,69.8
"5833","19130","2020",6,6,0,105688.166666667,1223.33333333333,86
"5834","19131","2020",11,11,0,119363.636363636,1184.63636363636,110.545454545455
"5835","19132","2020",2,2,0,93500,1253,72.5
"5836","19133","2020",1,1,0,105000,1167,90
"5837","19134","2020",15,15,0,76600,832.333333333333,93
"5838","19135","2020",1,1,0,218000,1557,140
"5839","19136","2020",40,37,3,102411.125,1126.975,93.7
"5840","19138","2020",21,20,1,150094.761904762,1726.42857142857,88.5714285714286
"5841","19139","2020",1,1,0,90000,562,160
"5842","19140","2020",9,9,0,82270.2222222222,958.222222222222,97.5555555555556
"5843","19141","2020",2,2,0,68250,956,72.5
"5844","19142","2020",2,2,0,108500,1000.5,110.5
"5845","19143","2020",10,10,0,103133,983.9,104.4
"5846","19144","2020",7,7,0,103728.571428571,1070.28571428571,111.857142857143
"5847","19145","2020",9,9,0,84577.7777777778,967.333333333333,90.1111111111111
"5848","19146","2020",17,17,0,134508.529411765,1316.47058823529,103.411764705882
"5849","19147","2020",16,16,0,130528.125,1518.0625,91.6875
"5850","19148","2020",21,20,1,120680.952380952,991.52380952381,109
"5851","19149","2020",4,4,0,157500,1234,141.5
"5852","19150","2020",5,5,0,134696,1708.2,85.6
"5853","19151","2020",8,8,0,126425,1623.5,80.75
"5854","19152","2020",4,4,0,120200,1180.25,90.75
"5855","19153","2020",43,34,9,124279.348837209,1453.81395348837,84.7209302325581
"5856","19154","2020",3,3,0,158000,1787,92.3333333333333
"5857","19155","2020",2,2,0,72250,775.5,92.5
"5858","19156","2020",2,2,0,102925,1161.5,85.5
"5859","19157","2020",5,5,0,106093,1243.4,84.8
"5860","19158","2020",1,1,0,159535,1464,109
"5861","19159","2020",2,2,0,46250,1463,31.5
"5862","19160","2020",3,3,0,92833.3333333333,811.333333333333,113.666666666667
"5863","19161","2020",5,5,0,365635,2562,152.4
"5864","19162","2020",10,10,0,130568,1483.2,86.7
"5865","19163","2020",4,4,0,105965,1094.75,106.5
"5866","19164","2020",10,10,0,92990,955.9,99.9
"5867","19167","2020",2,2,0,65875,1355,49
"5868","19169","2020",5,5,0,116000,1069.2,106.4
"5869","19170","2020",5,5,0,175520,1883.6,93
"5870","19171","2020",5,5,0,141000,1225.4,87
"5871","19172","2020",2,2,0,86000,900,95.5
"5872","19173","2020",2,2,0,122210,1473.5,74.5
"5873","19174","2020",1,1,0,87600,834,105
"5874","19175","2020",1,1,0,58500,760,77
"5875","19176","2020",11,11,0,86227.2727272727,917.727272727273,91.9090909090909
"5876","19177","2020",1,1,0,95000,1397,68
"5877","19178","2020",9,9,0,221055.555555556,1979.66666666667,115.888888888889
"5878","19180","2020",6,5,1,67783.3333333333,876.166666666667,78.3333333333333
"5879","19181","2020",7,7,0,80491.4285714286,981.142857142857,85.1428571428571
"5880","19182","2020",10,10,0,92850,1025.4,96.1
"5881","19184","2020",3,3,0,210666.666666667,1403,185
"5882","19186","2020",7,7,0,123885.714285714,1270.71428571429,100.142857142857
"5883","19187","2020",12,12,0,160899.166666667,1670.08333333333,102.166666666667
"5884","19188","2020",7,7,0,136700.714285714,1323.57142857143,104.142857142857
"5885","19189","2020",2,2,0,77750,1259.5,66
"5886","19190","2020",1,1,0,95000,1105,86
"5887","19191","2020",9,9,0,191631.666666667,1800.11111111111,103.777777777778
"5888","19192","2020",8,7,1,84934.875,1037.375,79.75
"5889","19193","2020",6,6,0,72166.6666666667,667,102.5
"5890","19194","2020",11,11,0,125974.909090909,1455.63636363636,91.6363636363636
"5891","19195","2020",4,4,0,187573,1701.75,112.75
"5892","19196","2020",8,8,0,150712.625,1247.75,121.875
"5893","19198","2020",2,2,0,55000,553.5,99.5
"5894","19199","2020",2,2,0,65000,711.5,97.5
"5895","19201","2020",3,3,0,116150,1116.33333333333,103.333333333333
"5896","19202","2020",30,29,1,176649.733333333,1613.6,107.9
"5897","19203","2020",9,9,0,156993.888888889,1222.44444444444,142.777777777778
"5898","19204","2020",4,4,0,175375,1605.5,96.75
"5899","19205","2020",3,3,0,90000,933.333333333333,100.666666666667
"5900","19206","2020",4,4,0,64430,870,77.5
"5901","19207","2020",13,12,1,141776.461538462,1319.15384615385,106.538461538462
"5902","19208","2020",3,3,0,63000,774.333333333333,82.6666666666667
"5903","19209","2020",3,3,0,78000,1129,68.3333333333333
"5904","19211","2020",19,19,0,125392.894736842,1117.57894736842,112.789473684211
"5905","19212","2020",1,1,0,261750,1531,171
"5906","19213","2020",4,4,0,138375,957,127
"5907","19214","2020",2,2,0,87500,1036.5,77.5
"5908","19215","2020",3,3,0,70244.6666666667,767.666666666667,96.6666666666667
"5909","19216","2020",4,4,0,111750,1122.75,102.5
"5910","19217","2020",3,3,0,129000,1631.66666666667,87.6666666666667
"5911","19219","2020",1,1,0,135000,1467,92
"5912","19220","2020",5,5,0,101000,1168.4,96.6
"5913","19221","2020",2,2,0,74500,1064,70
"5914","19222","2020",9,9,0,77333.3333333333,1152.66666666667,65.6666666666667
"5915","19223","2020",2,2,0,138000,1747.5,62
"5916","19225","2020",8,7,1,92375,1280.875,76.625
"5917","19226","2020",1,1,0,106000,746,142
"5918","19227","2020",9,9,0,141872.222222222,1547.88888888889,95.5555555555556
"5919","19228","2020",1,1,0,25000,500,50
"5920","19229","2020",53,47,6,170695.754716981,1694.81132075472,101.792452830189
"5921","19230","2020",5,5,0,100310.8,1304.6,81.2
"5922","19231","2020",7,6,1,85969.8571428571,1438,68.4285714285714
"5923","19232","2020",1,1,0,55000,1375,40
"5924","19234","2020",3,3,0,143333.333333333,1557,91.6666666666667
"5925","19235","2020",4,4,0,161300,1571.75,99.5
"5926","19236","2020",6,5,1,101200,1218.16666666667,84.5
"5927","19237","2020",11,11,0,101380.454545455,1164.63636363636,89.3636363636364
"5928","19238","2020",2,2,0,59675,1064.5,57.5
"5929","19239","2020",5,5,0,178658,1556.6,117.6
"5930","19240","2020",2,2,0,82500,1150,69
"5931","19241","2020",4,4,0,66562.5,803,83.25
"5932","19242","2020",5,5,0,103300,844.4,116.6
"5933","19243","2020",16,14,2,94436.5625,1356,77.8125
"5934","19244","2020",1,1,0,338100,2113,160
"5935","19245","2020",3,3,0,87580.6666666667,793.666666666667,125
"5936","19246","2020",16,16,0,179928.125,1584.5,117.1875
"5937","19247","2020",1,1,0,82000,1038,79
"5938","19248","2020",10,10,0,120789.9,1227.2,101.2
"5939","19249","2020",8,8,0,71012.5,1048.375,68.125
"5940","19250","2020",6,6,0,101766.666666667,968,98.5
"5941","19251","2020",2,2,0,180025,909.5,194
"5942","19252","2020",15,14,1,97490,1043.73333333333,100.666666666667
"5943","19253","2020",2,2,0,162885,1088,125
"5944","19254","2020",4,4,0,303675,3572.75,80
"5945","19255","2020",15,15,0,141782.866666667,1237,127.733333333333
"5946","19256","2020",8,8,0,59767.5,880.75,75
"5947","19257","2020",2,2,0,96500,1193,81.5
"5948","19258","2020",4,4,0,60875,1114,55.5
"5949","19259","2020",2,2,0,126960,1038,141.5
"5950","19260","2020",3,3,0,145000,1641,85.6666666666667
"5951","19261","2020",7,7,0,64900,838.571428571429,83.7142857142857
"5952","19262","2020",2,2,0,116500,1163.5,95.5
"5953","19263","2020",3,3,0,102666.666666667,953.333333333333,101
"5954","19264","2020",9,9,0,110278,1323.66666666667,87.1111111111111
"5955","19265","2020",8,8,0,65250,663.5,99
"5956","19266","2020",3,3,0,151966.666666667,946.666666666667,140
"5957","19268","2020",1,1,0,40000,370,108
"5958","19269","2020",17,16,1,92652.9411764706,1224.94117647059,77.1176470588235
"5959","19270","2020",6,6,0,121092.5,1250.5,99
"5960","19271","2020",2,2,0,89250,1606,56
"5961","19272","2020",167,82,85,76308.1796407186,921.652694610778,83.4251497005988
"5962","19273","2020",10,10,0,153365,1407,114.9
"5963","19274","2020",54,49,5,236660.37037037,1959.44444444444,122.407407407407
"5964","19275","2020",78,61,17,100115.641025641,1122.37179487179,92.4358974358974
"5965","19276","2020",27,22,5,86025.7037037037,1080.22222222222,81.2962962962963
"5966","19277","2020",2,2,0,90000,955.5,91.5
"5967","19278","2020",28,27,1,135449.142857143,1628.21428571429,86.8928571428571
"5968","19279","2020",3,3,0,125633.333333333,1136,121.666666666667
"5969","19280","2020",1,1,0,90900,1855,49
"5970","19281","2020",1,1,0,73000,811,90
"5971","19284","2020",2,2,0,82500,808,91
"5972","19285","2020",17,17,0,70676.4705882353,975.823529411765,74.5882352941177
"5973","19286","2020",7,7,0,117817.857142857,1256.14285714286,85.1428571428571
"5974","19287","2020",1,1,0,58000,460,126
"5975","19288","2020",18,18,0,128776.666666667,1480.27777777778,91
"5976","19289","2020",5,5,0,156116,1352.8,109.2
"5977","21001","2020",2,2,0,327775,1486,214
"5978","21002","2020",6,6,0,148738.333333333,1741.16666666667,85
"5979","21003","2020",20,14,6,289373,3032.2,91.3
"5980","21004","2020",4,3,1,116125,1229.75,102
"5981","21005","2020",25,24,1,207200.6,2019.24,104.36
"5982","21006","2020",7,7,0,93292.8571428571,889.428571428571,106
"5983","21007","2020",1,1,0,107000,1289,83
"5984","21008","2020",4,4,0,131645,1246,111.25
"5985","21009","2020",2,2,0,94000,2589,44.5
"5986","21010","2020",1,1,0,105000,1312,80
"5987","21012","2020",3,3,0,54913.3333333333,725,81.3333333333333
"5988","21013","2020",8,8,0,151543.75,1531.5,95
"5989","21014","2020",1,1,0,75000,1000,75
"5990","21015","2020",1,1,0,213000,869,245
"5991","21016","2020",13,13,0,341750.769230769,2354.92307692308,145.538461538462
"5992","21017","2020",8,8,0,204450,1650.5,131.5
"5993","21020","2020",2,2,0,1e+05,663,151.5
"5994","21021","2020",31,30,1,256125.516129032,2290.12903225806,113.645161290323
"5995","21022","2020",6,6,0,159716.666666667,1589.66666666667,101.333333333333
"5996","21023","2020",21,17,4,92269.0476190476,1002.38095238095,98.2380952380952
"5997","21024","2020",1,1,0,177000,1229,144
"5998","21026","2020",3,3,0,56666.6666666667,893,57.3333333333333
"5999","21027","2020",18,17,1,336619.166666667,2535.27777777778,133.944444444444
"6000","21028","2020",9,9,0,185756.777777778,1747.44444444444,107
"6001","21029","2020",2,2,0,49000,791,60.5
"6002","21030","2020",3,3,0,152333.333333333,1714.33333333333,84.6666666666667
"6003","21031","2020",5,5,0,221510,1737,144.8
"6004","21032","2020",2,2,0,145800,1386.5,97.5
"6005","21033","2020",1,1,0,280000,1677,167
"6006","21034","2020",3,3,0,72666.6666666667,774.666666666667,89.3333333333333
"6007","21035","2020",4,4,0,164500,1350.25,111.5
"6008","21037","2020",3,3,0,190928.333333333,2093.66666666667,98
"6009","21038","2020",95,57,38,119568.747368421,1438.83157894737,83.1578947368421
"6010","21039","2020",1,1,0,70000,603,116
"6011","21040","2020",4,4,0,133000,1337.75,96
"6012","21041","2020",5,5,0,97060,1587,84.2
"6013","21042","2020",1,1,0,312500,2671,117
"6014","21043","2020",8,8,0,71175,843.625,77.875
"6015","21044","2020",4,4,0,173250,939.75,144.25
"6016","21045","2020",3,3,0,103333.333333333,1327.66666666667,75
"6017","21046","2020",3,3,0,119216.666666667,958,117.666666666667
"6018","21047","2020",1,1,0,320000,1322,242
"6019","21048","2020",3,3,0,231900,2170.33333333333,106
"6020","21050","2020",5,5,0,242360,1910.8,127
"6021","21051","2020",2,2,0,168750,2266,74.5
"6022","21053","2020",1,1,0,165000,1833,90
"6023","21054","2020",374,156,218,179678.510695187,2348.1871657754,78.6363636363636
"6024","21056","2020",10,8,2,229715,2076.9,111.8
"6025","21057","2020",2,2,0,3e+05,2000,150
"6026","21058","2020",3,3,0,76333.3333333333,699,128.666666666667
"6027","21059","2020",8,8,0,339900,2706.125,120.5
"6028","21060","2020",20,20,0,214762.5,2082.7,106.95
"6029","21063","2020",4,4,0,89500,939.25,102.25
"6030","21064","2020",2,2,0,103000,1114,80
"6031","21066","2020",3,3,0,87000,893.333333333333,93.3333333333333
"6032","21067","2020",10,10,0,195340,1793.2,107.8
"6033","21069","2020",2,2,0,194100,1710,115
"6034","21070","2020",4,4,0,160335,1835.25,116.5
"6035","21071","2020",8,8,0,186750,1709,113.25
"6036","21072","2020",2,2,0,181400,2321,87
"6037","21074","2020",1,1,0,79950,898,89
"6038","21075","2020",1,1,0,120000,800,150
"6039","21076","2020",14,12,2,275555.357142857,2485.21428571429,116.285714285714
"6040","21077","2020",1,1,0,139100,848,164
"6041","21078","2020",1,1,0,73000,646,113
"6042","21079","2020",2,2,0,185250,2120.5,89.5
"6043","21080","2020",11,11,0,195128.727272727,1698.63636363636,120.909090909091
"6044","21081","2020",1,1,0,60000,1000,60
"6045","21082","2020",1,1,0,85000,1062,80
"6046","21083","2020",3,3,0,84000,885,95.3333333333333
"6047","21084","2020",1,1,0,95000,633,150
"6048","21085","2020",1,1,0,146218,1643,89
"6049","21086","2020",11,11,0,225050,2036,119.727272727273
"6050","21087","2020",15,15,0,100826.666666667,1132.26666666667,86
"6051","21088","2020",3,3,0,268890,2274.33333333333,119.666666666667
"6052","21089","2020",3,3,0,75666.6666666667,1313,60
"6053","21091","2020",1,1,0,43500,659,66
"6054","21092","2020",2,2,0,266500,2171.5,123.5
"6055","21093","2020",1,1,0,19000,1267,15
"6056","21094","2020",8,8,0,125060.75,1272.375,107
"6057","21096","2020",1,1,0,105000,1235,85
"6058","21097","2020",2,2,0,90000,800,120
"6059","21099","2020",4,4,0,152162.5,1535.75,96.25
"6060","21101","2020",2,2,0,90000,1094,85
"6061","21102","2020",3,3,0,203333.333333333,1319,164
"6062","21103","2020",34,33,1,158750.705882353,1690.41176470588,93.3529411764706
"6063","21105","2020",16,16,0,234134.375,2352,101.5
"6064","21106","2020",10,10,0,255928.5,2441.3,106.4
"6065","21107","2020",8,7,1,337599.5,2707.875,124
"6066","21108","2020",1,1,0,138000,1586,87
"6067","21109","2020",5,5,0,90280,877,101.4
"6068","21110","2020",6,6,0,187800,2196.33333333333,83.1666666666667
"6069","21111","2020",5,5,0,335710,2536,134.4
"6070","21112","2020",7,7,0,181797.857142857,1606.57142857143,120.428571428571
"6071","21114","2020",3,3,0,76333.3333333333,1190.66666666667,71.6666666666667
"6072","21116","2020",1,1,0,116352,751,155
"6073","21117","2020",1,1,0,150000,588,255
"6074","21120","2020",4,4,0,103032.75,917.25,120
"6075","21121","2020",1,1,0,245000,1678,146
"6076","21122","2020",2,2,0,131250,1358,92
"6077","21124","2020",1,1,0,119000,700,170
"6078","21125","2020",1,1,0,125000,1420,88
"6079","21126","2020",11,11,0,174386.363636364,1724.45454545455,102.363636363636
"6080","21127","2020",6,6,0,273375,1865.16666666667,145.333333333333
"6081","21128","2020",3,3,0,145780,905,178.666666666667
"6082","21129","2020",1,1,0,110000,710,155
"6083","21130","2020",6,6,0,163523,1282,141.333333333333
"6084","21131","2020",5,5,0,148852,1624.6,93.8
"6085","21132","2020",5,5,0,335028,2731.8,126.6
"6086","21133","2020",3,2,1,164000,1829.66666666667,91.3333333333333
"6087","21134","2020",6,5,1,72416.6666666667,706.333333333333,98.6666666666667
"6088","21135","2020",4,4,0,138062.5,1845.25,87.5
"6089","21137","2020",1,1,0,86000,1049,82
"6090","21138","2020",10,10,0,164666.5,1541.3,112.6
"6091","21139","2020",5,5,0,121600,2249.2,70.4
"6092","21141","2020",1,1,0,176400,1044,169
"6093","21144","2020",2,1,1,28000,523,51.5
"6094","21145","2020",1,1,0,65000,556,117
"6095","21146","2020",1,1,0,190600,2242,85
"6096","21147","2020",3,3,0,243466.666666667,2024.66666666667,123
"6097","21148","2020",10,10,0,126913,1215.9,104.7
"6098","21150","2020",2,2,0,84750,1511,54
"6099","21151","2020",2,2,0,111500,952.5,117
"6100","21152","2020",2,2,0,119500,1613.5,74.5
"6101","21153","2020",1,1,0,55000,786,70
"6102","21154","2020",62,34,28,74602.4193548387,958.806451612903,74.6290322580645
"6103","21155","2020",1,1,0,138195,768,180
"6104","21157","2020",1,1,0,138000,767,180
"6105","21158","2020",4,4,0,133400,1186.5,113.5
"6106","21159","2020",3,3,0,30166.6666666667,389.666666666667,75.6666666666667
"6107","21160","2020",2,2,0,208400,1229,181
"6108","21161","2020",1,1,0,60000,500,120
"6109","21162","2020",4,4,0,247937.5,1933.5,121.5
"6110","21163","2020",4,4,0,126625,1195,103.5
"6111","21164","2020",1,1,0,132000,1833,72
"6112","21165","2020",2,2,0,171550,1518,114
"6113","21166","2020",174,68,106,134008.270114943,1696.86206896552,78.7873563218391
"6114","21167","2020",1,1,0,176000,1833,96
"6115","21168","2020",1,1,0,110000,909,121
"6116","21169","2020",4,4,0,185395,1803.5,105
"6117","21170","2020",6,6,0,274000,2179.83333333333,128.5
"6118","21171","2020",176,32,144,149858.159090909,2128.34090909091,71.9431818181818
"6119","21172","2020",3,3,0,130333.333333333,1436,86
"6120","21173","2020",6,6,0,193146.666666667,2035.5,97.8333333333333
"6121","21175","2020",3,3,0,220176.666666667,2272.33333333333,97
"6122","21176","2020",4,4,0,164741.25,1745.25,95.25
"6123","21177","2020",3,3,0,182166.666666667,3302.66666666667,78
"6124","21178","2020",6,6,0,147250,1626.83333333333,103.833333333333
"6125","21179","2020",13,13,0,311826.692307692,2587.53846153846,120.230769230769
"6126","21180","2020",5,5,0,142476,1324.4,112
"6127","21181","2020",1,1,0,168600,1653,102
"6128","21183","2020",8,8,0,187003.75,1858.5,103.75
"6129","21185","2020",4,4,0,214825,2027.75,106.5
"6130","21186","2020",15,15,0,154970,1867.4,82.2
"6131","21187","2020",1,1,0,106000,2585,41
"6132","21189","2020",4,4,0,190723,1756,118.75
"6133","21190","2020",3,3,0,281983.333333333,2111,133.333333333333
"6134","21191","2020",11,11,0,168399.272727273,1813.81818181818,91.5454545454545
"6135","21192","2020",10,10,0,270380,2011.2,149
"6136","21193","2020",4,4,0,245463.75,1996.5,122.25
"6137","21194","2020",17,15,2,193605,1873.82352941176,103.470588235294
"6138","21195","2020",4,4,0,132125,1037.75,123.25
"6139","21196","2020",6,6,0,187052.333333333,2261.16666666667,85.6666666666667
"6140","21198","2020",6,6,0,104433.333333333,951.333333333333,101
"6141","21199","2020",3,3,0,117233.333333333,878,108.333333333333
"6142","21200","2020",16,15,1,265549.625,2390.5625,107.8125
"6143","21201","2020",2,2,0,90000,1158,78
"6144","21202","2020",1,1,0,18000,900,20
"6145","21203","2020",1,1,0,138000,1423,97
"6146","21205","2020",1,1,0,105000,854,123
"6147","21207","2020",3,3,0,107033.333333333,1043.66666666667,103.333333333333
"6148","21208","2020",6,6,0,154485,1569.33333333333,103.5
"6149","21209","2020",19,17,2,276594.736842105,2782.15789473684,99.9473684210526
"6150","21210","2020",2,2,0,260700,1517,165.5
"6151","21211","2020",2,2,0,104000,851,125
"6152","21212","2020",4,4,0,130325,1252.25,103.75
"6153","21214","2020",7,7,0,75542.8571428571,1082.42857142857,72.2857142857143
"6154","21215","2020",3,3,0,182543.333333333,1471,117.333333333333
"6155","21217","2020",1,1,0,184500,2599,71
"6156","21218","2020",3,3,0,176933.333333333,990.333333333333,155.333333333333
"6157","21219","2020",4,4,0,210588.75,1736,128.75
"6158","21220","2020",1,1,0,225865,1158,195
"6159","21222","2020",2,2,0,97000,1097,88.5
"6160","21223","2020",18,13,5,341501.666666667,3189,107.444444444444
"6161","21225","2020",4,4,0,100855,1195.5,96
"6162","21226","2020",2,2,0,146350,908.5,126
"6163","21227","2020",4,4,0,329050,2434.25,139
"6164","21228","2020",3,3,0,142666.666666667,1505,90
"6165","21229","2020",1,1,0,81000,779,104
"6166","21230","2020",6,6,0,284733.333333333,1822.83333333333,162.666666666667
"6167","21231","2020",3428,435,2993,151830.504084014,2465.63768961494,61.7112018669778
"6168","21232","2020",5,5,0,117546,1178.8,96.4
"6169","21233","2020",3,3,0,155500,1234.66666666667,126.666666666667
"6170","21234","2020",1,1,0,98000,1307,75
"6171","21236","2020",4,4,0,180500,1817.25,99.5
"6172","21237","2020",2,2,0,107000,1106,132.5
"6173","21238","2020",1,1,0,205200,3310,62
"6174","21239","2020",12,12,0,134284.5,1419.75,92.75
"6175","21240","2020",2,2,0,117500,1261.5,86
"6176","21241","2020",2,2,0,202500,1653,122.5
"6177","21242","2020",6,6,0,258000,2313.66666666667,116.666666666667
"6178","21245","2020",5,5,0,203400,1707.6,118
"6179","21246","2020",1,1,0,155000,1867,83
"6180","21247","2020",9,9,0,93300,1128,94.2222222222222
"6181","21249","2020",9,9,0,105797.777777778,1543.55555555556,82.1111111111111
"6182","21250","2020",1,1,0,361000,1081,334
"6183","21251","2020",5,4,1,116500,1295.2,89.6
"6184","21252","2020",1,1,0,140900,915,154
"6185","21253","2020",1,1,0,260000,1368,190
"6186","21254","2020",3,3,0,295450,1980.66666666667,146.333333333333
"6187","21255","2020",2,2,0,254000,2556.5,101.5
"6188","21256","2020",4,4,0,184900,1682.25,115.75
"6189","21257","2020",2,2,0,157600,1429.5,110
"6190","21258","2020",1,1,0,59000,492,120
"6191","21259","2020",1,1,0,90450,620,146
"6192","21261","2020",5,5,0,247800,2248.4,114.8
"6193","21263","2020",23,23,0,276893,2497.30434782609,114.652173913043
"6194","21264","2020",1,1,0,25000,625,40
"6195","21265","2020",13,12,1,239616.153846154,2553.61538461538,95.6153846153846
"6196","21266","2020",1,1,0,3e+05,1875,160
"6197","21267","2020",3,3,0,131910,1988.66666666667,59
"6198","21268","2020",1,1,0,215000,1991,108
"6199","21269","2020",8,8,0,161687.5,1487.75,107.625
"6200","21271","2020",10,9,1,149570,1424.1,109
"6201","21272","2020",4,4,0,139500,1627.5,90.25
"6202","21273","2020",16,14,2,211871.875,2296.9375,94
"6203","21274","2020",1,1,0,135000,1038,130
"6204","21275","2020",3,3,0,137000,1226,114.333333333333
"6205","21277","2020",13,13,0,131999.692307692,1426,93.8461538461538
"6206","21278","2020",146,67,79,249600.739726027,2789.21232876712,88.6575342465753
"6207","21280","2020",1,1,0,130000,1831,71
"6208","21281","2020",1,1,0,83396,1367,61
"6209","21283","2020",1,1,0,79000,1215,65
"6210","21284","2020",2,2,0,195850,1356.5,137.5
"6211","21285","2020",6,6,0,151133.333333333,1259.66666666667,122.5
"6212","21286","2020",2,2,0,155000,1088.5,156
"6213","21287","2020",3,3,0,133666.666666667,1459,95.3333333333333
"6214","21288","2020",5,5,0,134060,1358,99.2
"6215","21290","2020",15,15,0,204188.333333333,1617.53333333333,131
"6216","21291","2020",1,1,0,78000,545,143
"6217","21292","2020",60,40,20,157013.75,1867.28333333333,86.6666666666667
"6218","21293","2020",5,5,0,116500,1441,78.4
"6219","21294","2020",1,1,0,183000,2288,80
"6220","21295","2020",38,17,21,183487.684210526,2307.65789473684,77.1578947368421
"6221","21297","2020",5,5,0,271441.2,2220.8,128.8
"6222","21298","2020",1,1,0,55000,1375,40
"6223","21299","2020",2,2,0,116000,789,152
"6224","21300","2020",4,4,0,158125,1480.5,99.5
"6225","21301","2020",5,5,0,98263.8,1168.2,78.8
"6226","21302","2020",2,2,0,90500,973,111.5
"6227","21304","2020",4,4,0,66250,794.75,88.5
"6228","21305","2020",2,2,0,94300,878,115.5
"6229","21306","2020",3,3,0,170125,1325.33333333333,130.333333333333
"6230","21307","2020",1,1,0,68500,867,79
"6231","21308","2020",3,3,0,54333.3333333333,577.666666666667,94.3333333333333
"6232","21310","2020",1,1,0,27000,409,66
"6233","21311","2020",1,1,0,157000,1688,93
"6234","21314","2020",2,2,0,94675,845,112
"6235","21315","2020",13,13,0,442942.307692308,3180.38461538462,141.076923076923
"6236","21316","2020",9,9,0,117007.777777778,1302.88888888889,91
"6237","21317","2020",51,40,11,181159.392156863,1838.27450980392,100.43137254902
"6238","21319","2020",6,6,0,287638.333333333,2253.33333333333,136
"6239","21320","2020",7,7,0,228912.857142857,1943.57142857143,119
"6240","21321","2020",2,2,0,78450,1457.5,58
"6241","21322","2020",8,8,0,104430.875,1243.875,97.25
"6242","21324","2020",2,2,0,242500,1788.5,149.5
"6243","21325","2020",1,1,0,55000,743,74
"6244","21327","2020",3,3,0,128000,1218.66666666667,104
"6245","21328","2020",2,2,0,71000,797,106
"6246","21330","2020",3,3,0,194333.333333333,3121.66666666667,93.3333333333333
"6247","21331","2020",6,6,0,134833.333333333,1483.83333333333,98.3333333333333
"6248","21332","2020",18,18,0,139627.222222222,1326.66666666667,105.666666666667
"6249","21333","2020",6,6,0,134966.666666667,1445,93.8333333333333
"6250","21334","2020",11,11,0,90767.2727272727,920.909090909091,101
"6251","21336","2020",3,3,0,72333.3333333333,613,116
"6252","21337","2020",21,21,0,125050.333333333,1564.04761904762,82.1428571428571
"6253","21338","2020",4,4,0,397306.25,2892.75,117.25
"6254","21339","2020",6,6,0,217283.333333333,2460.66666666667,87.8333333333333
"6255","21340","2020",3,3,0,113666.666666667,1149.66666666667,92
"6256","21341","2020",2,2,0,122300,1459,83
"6257","21342","2020",4,4,0,104500,1026.75,96.25
"6258","21343","2020",1,1,0,72650,765,95
"6259","21344","2020",3,3,0,118000,1545.66666666667,82
"6260","21345","2020",8,8,0,84901.25,891.375,100.375
"6261","21346","2020",1,1,0,55000,663,83
"6262","21347","2020",4,3,1,310800,2132.5,163.5
"6263","21348","2020",3,3,0,140666.666666667,996,134
"6264","21349","2020",6,6,0,64016.6666666667,718.666666666667,86.6666666666667
"6265","21350","2020",1,1,0,90000,957,94
"6266","21351","2020",18,17,1,194008.333333333,1886.5,103.222222222222
"6267","21352","2020",14,14,0,179881.857142857,1954.21428571429,99.2857142857143
"6268","21353","2020",21,19,2,214065.238095238,2308.09523809524,95.5714285714286
"6269","21355","2020",109,42,67,179335.880733945,2117.75229357798,83.7706422018349
"6270","21356","2020",24,23,1,138742.5,1502.25,92.8333333333333
"6271","21357","2020",1,1,0,123890,486,255
"6272","21358","2020",2,2,0,250500,1640,157.5
"6273","21359","2020",1,1,0,123000,542,227
"6274","21360","2020",3,3,0,317166.666666667,2421,115.666666666667
"6275","21361","2020",7,7,0,129957.142857143,1224.71428571429,110.142857142857
"6276","21363","2020",4,4,0,72375,889,83.5
"6277","21364","2020",2,2,0,66800,1135,58.5
"6278","21365","2020",1,1,0,92500,1381,67
"6279","21366","2020",2,2,0,128000,1125,108
"6280","21367","2020",3,3,0,157000,1767.66666666667,89
"6281","21368","2020",2,2,0,244625,1966.5,123
"6282","21369","2020",3,3,0,234066.666666667,1716,131.333333333333
"6283","21370","2020",12,12,0,282184.166666667,2540.25,115.25
"6284","21371","2020",7,7,0,143178.571428571,1531.28571428571,101
"6285","21372","2020",2,2,0,99027.5,1032.5,109.5
"6286","21373","2020",6,6,0,159350,1510.5,103.666666666667
"6287","21374","2020",1,1,0,110000,1310,84
"6288","21375","2020",5,5,0,66960,911.4,75.4
"6289","21376","2020",1,1,0,65750,822,80
"6290","21377","2020",1,1,0,123150,1466,84
"6291","21378","2020",1,1,0,39000,1147,34
"6292","21379","2020",5,5,0,113708,1221.4,101.8
"6293","21380","2020",1,1,0,1e+05,1316,76
"6294","21381","2020",1,1,0,66000,717,92
"6295","21382","2020",3,3,0,122916.666666667,1211,144
"6296","21383","2020",18,18,0,159872.777777778,1716.16666666667,101.388888888889
"6297","21384","2020",1,1,0,199000,2314,86
"6298","21385","2020",6,6,0,124833.333333333,969.333333333333,119.333333333333
"6299","21386","2020",3,3,0,114416.666666667,866,135
"6300","21387","2020",1,1,0,229000,2632,87
"6301","21388","2020",5,5,0,194230,1926.8,99.6
"6302","21389","2020",1,1,0,125000,1374,91
"6303","21390","2020",69,63,6,212123.536231884,2318.33333333333,92.6231884057971
"6304","21391","2020",6,6,0,255000,2288.33333333333,125.5
"6305","21393","2020",3,3,0,73776.6666666667,1060.33333333333,83.3333333333333
"6306","21394","2020",2,2,0,163500,1767,93.5
"6307","21395","2020",1,1,0,43000,478,90
"6308","21396","2020",1,1,0,65000,903,72
"6309","21397","2020",1,1,0,153800,1831,84
"6310","21398","2020",7,7,0,137857.142857143,1150.14285714286,122.857142857143
"6311","21399","2020",4,4,0,75000,898.75,87
"6312","21401","2020",8,8,0,101687.5,1619.375,77.75
"6313","21402","2020",2,2,0,84330,1023.5,85.5
"6314","21403","2020",4,4,0,79062.5,951.5,98.25
"6315","21404","2020",4,4,0,106125,1347.5,82.5
"6316","21406","2020",3,3,0,201166.666666667,1479.33333333333,143.333333333333
"6317","21407","2020",3,3,0,205783.333333333,1745.33333333333,118.666666666667
"6318","21408","2020",18,13,5,271766.888888889,2169.5,120.722222222222
"6319","21409","2020",11,11,0,171068.545454545,1765,96.4545454545455
"6320","21411","2020",6,5,1,347538.333333333,2228.5,125.5
"6321","21412","2020",16,15,1,263418,2532.0625,105.375
"6322","21413","2020",2,2,0,58500,1530.5,40
"6323","21414","2020",8,8,0,126362.5,1321.75,97.875
"6324","21415","2020",3,3,0,126666.666666667,1207,111.666666666667
"6325","21416","2020",38,32,6,181867.105263158,1697.07894736842,107.473684210526
"6326","21419","2020",7,7,0,55328.5714285714,671.285714285714,83.5714285714286
"6327","21420","2020",4,4,0,48000,561,84.5
"6328","21421","2020",2,2,0,217500,1862,117
"6329","21422","2020",1,1,0,155000,1938,80
"6330","21423","2020",10,10,0,231525,1947.7,122.4
"6331","21425","2020",56,45,11,101281.339285714,1071.42857142857,92.2857142857143
"6332","21426","2020",3,3,0,82666.6666666667,820.333333333333,110
"6333","21427","2020",3,3,0,122333.333333333,1076.33333333333,113.666666666667
"6334","21428","2020",3,3,0,293333.333333333,2139,121.333333333333
"6335","21429","2020",7,7,0,103628.571428571,966.571428571429,104.571428571429
"6336","21430","2020",2,2,0,62500,1049.5,61
"6337","21431","2020",2,2,0,177500,1553.5,113
"6338","21432","2020",2,2,0,77750,792.5,96.5
"6339","21433","2020",5,5,0,166860,1492.6,108.4
"6340","21434","2020",3,3,0,55333.3333333333,579,95
"6341","21435","2020",6,6,0,147516.666666667,1263.83333333333,115
"6342","21437","2020",5,5,0,171520,1695.2,105.6
"6343","21439","2020",3,3,0,158083.333333333,1183.33333333333,148
"6344","21440","2020",1,1,0,205600,2056,100
"6345","21441","2020",6,5,1,121250,1100.83333333333,110.666666666667
"6346","21442","2020",14,14,0,233942.857142857,2381.21428571429,104.428571428571
"6347","21445","2020",3,3,0,48500,970.666666666667,58.6666666666667
"6348","21446","2020",2,2,0,92500,742.5,116.5
"6349","21448","2020",1,1,0,1e+05,1163,86
"6350","21449","2020",1,1,0,25000,500,50
"6351","21450","2020",3,3,0,211500,1907.33333333333,86.3333333333333
"6352","21451","2020",1,1,0,95000,1250,76
"6353","21452","2020",49,45,4,249180.632653061,2363.89795918367,106.673469387755
"6354","21454","2020",1,1,0,54500,568,96
"6355","21455","2020",5,5,0,75160,823.4,94.2
"6356","21456","2020",7,7,0,75928.5714285714,738.857142857143,111.714285714286
"6357","21457","2020",2,2,0,72850,649.5,110.5
"6358","21458","2020",14,14,0,239796.428571429,2420.85714285714,104.142857142857
"6359","21459","2020",5,5,0,108000,1216.4,82.8
"6360","21460","2020",2,2,0,69500,918.5,79
"6361","21461","2020",26,26,0,103596.153846154,1165.53846153846,90.2692307692308
"6362","21462","2020",19,12,7,269646.315789474,2549.84210526316,103.684210526316
"6363","21464","2020",79,47,32,174310.17721519,2042.82278481013,86.1645569620253
"6364","21467","2020",1,1,0,189000,1629,116
"6365","21469","2020",2,2,0,287790.5,1602,168.5
"6366","21472","2020",2,2,0,128000,1289.5,99
"6367","21473","2020",12,11,1,237310,2388.91666666667,97.6666666666667
"6368","21474","2020",16,16,0,144931.25,1480.875,103.3125
"6369","21475","2020",6,6,0,184116.666666667,1455.5,126.333333333333
"6370","21476","2020",4,4,0,92000,980.25,108.75
"6371","21477","2020",1,1,0,230000,1278,180
"6372","21478","2020",4,4,0,238250,1760.5,143.25
"6373","21479","2020",4,4,0,68000,778.25,97.5
"6374","21480","2020",5,5,0,150649,1759,78.2
"6375","21481","2020",21,16,5,231875.047619048,2518.52380952381,95.7142857142857
"6376","21482","2020",12,12,0,122191.666666667,1758.41666666667,81.3333333333333
"6377","21483","2020",2,2,0,139000,1382.5,104
"6378","21484","2020",1,1,0,1e+05,847,118
"6379","21485","2020",52,32,20,172223.846153846,2104.69230769231,84.8076923076923
"6380","21487","2020",4,4,0,191087.5,1723.5,111.25
"6381","21488","2020",2,2,0,50500,673.5,71.5
"6382","21489","2020",1,1,0,162000,1800,90
"6383","21490","2020",1,1,0,50000,649,77
"6384","21491","2020",1,1,0,198250,1680,118
"6385","21492","2020",9,9,0,180794.444444444,2049.77777777778,90.4444444444444
"6386","21493","2020",6,6,0,136021.666666667,1583.5,90.5
"6387","21495","2020",3,3,0,225333.333333333,1688.33333333333,137.333333333333
"6388","21496","2020",30,27,3,117347.5,1336.36666666667,85.3
"6389","21497","2020",5,5,0,117175.4,1489.4,89
"6390","21498","2020",1,1,0,130000,1130,115
"6391","21500","2020",5,5,0,92269.6,1294,73.4
"6392","21501","2020",15,13,2,127278.066666667,1182.26666666667,105.933333333333
"6393","21502","2020",13,12,1,99076.9230769231,1011.46153846154,97.7692307692308
"6394","21503","2020",1,1,0,163500,1258,130
"6395","21504","2020",5,5,0,185800,1416.4,133
"6396","21505","2020",9,9,0,129622.222222222,1228,109.777777777778
"6397","21506","2020",9,8,1,128722.222222222,1646.88888888889,82.3333333333333
"6398","21508","2020",6,6,0,273816.666666667,2454.66666666667,113.166666666667
"6399","21510","2020",3,3,0,38000,374.333333333333,102.333333333333
"6400","21511","2020",1,1,0,80400,1787,45
"6401","21512","2020",4,3,1,128500,2201.75,64.75
"6402","21515","2020",105,51,54,173042.171428571,2123.8,81.0285714285714
"6403","21517","2020",7,6,1,256428.571428571,1851.42857142857,136.142857142857
"6404","21518","2020",1,1,0,122000,1341,91
"6405","21519","2020",2,2,0,135500,941.5,144.5
"6406","21520","2020",1,1,0,142000,1127,126
"6407","21521","2020",7,7,0,240328.571428571,2020.71428571429,118
"6408","21522","2020",7,7,0,174392.857142857,1598,117.285714285714
"6409","21523","2020",1,1,0,239000,1593,150
"6410","21524","2020",1,1,0,146400,1609,91
"6411","21525","2020",15,15,0,114010,1027.8,113.866666666667
"6412","21527","2020",4,4,0,66750,1197,60
"6413","21528","2020",1,1,0,180001,1118,161
"6414","21529","2020",2,2,0,75000,661,116
"6415","21530","2020",2,2,0,177500,1394.5,121.5
"6416","21531","2020",12,11,1,121298.333333333,1194,104.583333333333
"6417","21532","2020",13,13,0,244284.615384615,2129.46153846154,113.384615384615
"6418","21533","2020",2,2,0,51000,1004,50
"6419","21534","2020",5,5,0,301490,1928.4,171.4
"6420","21535","2020",12,12,0,309834.833333333,2446.83333333333,136.333333333333
"6421","21536","2020",3,3,0,48000,932.666666666667,51
"6422","21537","2020",4,4,0,114150,1053.5,108.5
"6423","21538","2020",3,3,0,92666.6666666667,1033.33333333333,90.3333333333333
"6424","21539","2020",2,2,0,162650,1112.5,146
"6425","21540","2020",112,69,43,222304.375,2651.25,84.8214285714286
"6426","21541","2020",6,6,0,200233.333333333,2074.5,102.333333333333
"6427","21542","2020",6,6,0,224950,2239.33333333333,107.333333333333
"6428","21543","2020",2,2,0,127500,1061,124.5
"6429","21544","2020",1,1,0,287500,1808,159
"6430","21545","2020",7,7,0,104030,1051.14285714286,101
"6431","21546","2020",8,8,0,120012.5,1814,83.25
"6432","21547","2020",1,1,0,117000,992,118
"6433","21548","2020",4,4,0,54025,814.5,73.75
"6434","21549","2020",3,3,0,102583.333333333,824.333333333333,130.333333333333
"6435","21552","2020",1,1,0,181000,1293,140
"6436","21554","2020",21,5,16,69197.6190476191,874.952380952381,77.2857142857143
"6437","21555","2020",33,33,0,276680.454545455,2494.54545454545,115.454545454545
"6438","21556","2020",3,3,0,195153.333333333,1830.66666666667,108
"6439","21557","2020",3,3,0,116546.666666667,2239,107.333333333333
"6440","21558","2020",9,5,4,142922.222222222,1841.11111111111,76.4444444444444
"6441","21559","2020",6,6,0,200982.5,1781.66666666667,116.166666666667
"6442","21560","2020",9,9,0,92922.1111111111,952,89.1111111111111
"6443","21561","2020",4,4,0,164802.5,1414,116.5
"6444","21562","2020",4,4,0,195772.5,1152,162
"6445","21563","2020",3,3,0,158333.333333333,1343,112.333333333333
"6446","21564","2020",4,4,0,183500,1714.25,106
"6447","21565","2020",9,9,0,225029.444444444,2309,101.222222222222
"6448","21566","2020",1,1,0,90000,1084,83
"6449","21567","2020",5,5,0,121550,1187.8,95.4
"6450","21568","2020",12,12,0,108700,1035,104.166666666667
"6451","21569","2020",5,5,0,169660,1697,98.2
"6452","21570","2020",4,4,0,77761.5,940.75,84
"6453","21571","2020",5,5,0,161040,1262,128.8
"6454","21572","2020",7,7,0,167642.857142857,1807.28571428571,94.4285714285714
"6455","21573","2020",10,10,0,91314,1152.2,76.8
"6456","21574","2020",4,4,0,78800,976.5,78
"6457","21575","2020",4,4,0,144250,1341.5,110
"6458","21576","2020",1,1,0,85000,574,148
"6459","21577","2020",19,19,0,154905.263157895,1569.52631578947,101.210526315789
"6460","21578","2020",7,7,0,235957.142857143,1932.71428571429,124.428571428571
"6461","21579","2020",1,1,0,180800,1424,127
"6462","21580","2020",3,3,0,57000,757,81.3333333333333
"6463","21581","2020",1,1,0,1e+05,1149,87
"6464","21582","2020",14,14,0,96580,1495.57142857143,63
"6465","21583","2020",1,1,0,185250,726,255
"6466","21584","2020",28,27,1,113015.214285714,1050.03571428571,109
"6467","21585","2020",11,11,0,229088.090909091,2403,96.4545454545455
"6468","21586","2020",8,7,1,186306.25,2193.875,89.25
"6469","21587","2020",2,2,0,129000,1183.5,100.5
"6470","21589","2020",2,2,0,236825,3090,77
"6471","21590","2020",14,11,3,335450,2914.28571428571,125.142857142857
"6472","21591","2020",6,6,0,284873.833333333,2757.5,101.833333333333
"6473","21592","2020",2,2,0,107500,1520.5,76
"6474","21593","2020",1,1,0,45000,849,53
"6475","21594","2020",2,2,0,63083.5,595.5,104.5
"6476","21595","2020",4,4,0,272055,1962,145.25
"6477","21596","2020",2,2,0,197750,1901.5,104
"6478","21598","2020",2,2,0,75000,496,149
"6479","21599","2020",30,29,1,154666.666666667,1492.73333333333,103.633333333333
"6480","21600","2020",1,1,0,115000,885,130
"6481","21601","2020",1,1,0,217000,1466,148
"6482","21602","2020",1,1,0,76000,691,110
"6483","21603","2020",34,24,10,137663.382352941,1503.76470588235,94.2352941176471
"6484","21605","2020",24,22,2,230145.625,2439.375,95.75
"6485","21606","2020",29,24,5,184318.517241379,2090.58620689655,91.3448275862069
"6486","21607","2020",45,41,4,119124.222222222,1348.24444444444,90.4444444444444
"6487","21608","2020",4,4,0,67477.5,994.25,67
"6488","21609","2020",2,2,0,178000,1476.5,108
"6489","21610","2020",7,7,0,167671.428571429,1255.57142857143,135.857142857143
"6490","21611","2020",12,12,0,182191.666666667,1483,133
"6491","21613","2020",2,2,0,155000,1403.5,124
"6492","21614","2020",8,8,0,234136.25,1749.25,137.375
"6493","21615","2020",5,5,0,74230,689.4,108
"6494","21616","2020",3,3,0,230000,1879,126.666666666667
"6495","21617","2020",172,68,104,222761.901162791,2433.65697674419,88.6686046511628
"6496","21618","2020",12,12,0,104833.333333333,907.75,122.25
"6497","21619","2020",1,1,0,143000,1192,120
"6498","21620","2020",1,1,0,195000,1300,150
"6499","21622","2020",2,2,0,155000,1575,98.5
"6500","21623","2020",30,30,0,210868.333333333,2097.83333333333,105.133333333333
"6501","21625","2020",2,2,0,189325,2146,87.5
"6502","21627","2020",1,1,0,22000,423,52
"6503","21629","2020",2,2,0,61000,742,84
"6504","21630","2020",5,5,0,119600,1233,108.6
"6505","21632","2020",14,13,1,233209.428571429,2455.07142857143,96.7142857142857
"6506","21633","2020",2,2,0,69100,940,74
"6507","21634","2020",4,4,0,212000,1560.25,136.5
"6508","21635","2020",1,1,0,80000,625,128
"6509","21636","2020",4,4,0,91925,878.75,105.75
"6510","21637","2020",4,4,0,109500,1284.75,88
"6511","21638","2020",15,13,2,175719.666666667,1597.46666666667,111.4
"6512","21639","2020",8,8,0,155775,2061.75,95.875
"6513","21640","2020",1,1,0,50000,833,60
"6514","21641","2020",7,7,0,139714.285714286,1405.28571428571,96.1428571428571
"6515","21642","2020",5,5,0,75480,879.2,87.6
"6516","21643","2020",6,6,0,118883.333333333,1340.66666666667,85.3333333333333
"6517","21644","2020",1,1,0,323200,2565,126
"6518","21645","2020",11,11,0,143509.090909091,1463.27272727273,97.8181818181818
"6519","21647","2020",5,5,0,139500,1679.6,86.6
"6520","21648","2020",3,3,0,89766.6666666667,910.666666666667,98.3333333333333
"6521","21650","2020",2,2,0,252350,1852.5,135.5
"6522","21651","2020",4,4,0,187675,1548,129
"6523","21652","2020",3,3,0,184000,2092.33333333333,87.3333333333333
"6524","21655","2020",2,2,0,50250,733.5,74
"6525","21656","2020",5,5,0,273503.4,1815.4,147.4
"6526","21657","2020",18,18,0,312359.166666667,2612.83333333333,121.833333333333
"6527","21659","2020",2,2,0,175275,1072.5,160.5
"6528","21661","2020",23,16,7,246562.608695652,2297,112.173913043478
"6529","21663","2020",20,18,2,109725,1261.35,94.1
"6530","21665","2020",2,2,0,73125,831,88
"6531","21666","2020",2,2,0,105500,733.5,145
"6532","21667","2020",4,4,0,135000,1353.25,97
"6533","21670","2020",7,7,0,81985.7142857143,805.428571428571,101.428571428571
"6534","21671","2020",1,1,0,39500,343,115
"6535","21673","2020",4,4,0,125625,1091.75,122
"6536","21674","2020",4,4,0,86225,759.75,114.5
"6537","21676","2020",1,1,0,282000,1762,160
"6538","21677","2020",3,3,0,116400,1140.66666666667,105.666666666667
"6539","21678","2020",3,3,0,281343.333333333,1203,225.333333333333
"6540","21680","2020",7,7,0,104557.142857143,1285.57142857143,84
"6541","21682","2020",9,9,0,182174.444444444,1596.88888888889,118.111111111111
"6542","21683","2020",8,8,0,83565,846.75,97.375
"6543","21684","2020",4,4,0,230437.5,1938.5,124.25
"6544","21685","2020",1,1,0,34000,523,65
"6545","21686","2020",2,2,0,113500,1187,93
"6546","21687","2020",2,2,0,106500,837.5,127
"6547","21688","2020",1,1,0,108000,1714,63
"6548","21690","2020",1,1,0,295000,3933,75
"6549","21691","2020",3,3,0,210033.333333333,2522.33333333333,79.6666666666667
"6550","21692","2020",2,2,0,149000,1273,118
"6551","21693","2020",2,2,0,36500,972.5,37
"6552","21694","2020",1,1,0,402000,1748,230
"6553","21696","2020",1,1,0,128000,1164,110
"6554","21698","2020",2,2,0,202500,2315.5,87.5
"6555","21699","2020",20,20,0,184807.5,1635.25,113.1
"6556","21701","2020",4,4,0,137737.5,1467.75,90.75
"6557","21702","2020",4,4,0,190212.5,1501.25,133.5
"6558","21703","2020",1,1,0,1e+05,971,103
"6559","21704","2020",1,1,0,54000,675,80
"6560","21705","2020",1,1,0,86800,575,151
"6561","21706","2020",1,1,0,217200,1255,173
"6562","21707","2020",3,3,0,123950,1122.66666666667,103.333333333333
"6563","21708","2020",3,3,0,199208.333333333,1571.66666666667,154
"6564","21709","2020",2,2,0,192500,1452.5,123
"6565","21710","2020",6,6,0,91400,1145.33333333333,85.1666666666667
"6566","21712","2020",3,3,0,235033.333333333,2263.66666666667,104.333333333333
"6567","21713","2020",9,9,0,143800,1391.22222222222,111.666666666667
"6568","21714","2020",4,4,0,383750,1983.5,167
"6569","21715","2020",2,2,0,93575,1151,81
"6570","21716","2020",1,1,0,124500,1029,121
"6571","21717","2020",1,1,0,45165,452,100
"6572","22001","2020",7,7,0,148857.142857143,1378.14285714286,113.428571428571
"6573","22002","2020",11,11,0,156954.090909091,1623,105.454545454545
"6574","22003","2020",8,8,0,156535.75,1449,110.75
"6575","22004","2020",84,81,3,122745.833333333,1301.13095238095,93.5952380952381
"6576","22005","2020",20,19,1,91775,1081.2,93.3
"6577","22006","2020",4,4,0,119500,1305.25,92.25
"6578","22008","2020",14,14,0,187848.928571429,1956.14285714286,98.8571428571429
"6579","22009","2020",4,4,0,106887.5,1185,87
"6580","22011","2020",9,9,0,129722.222222222,1219.66666666667,100.666666666667
"6581","22012","2020",13,13,0,135653.846153846,1420.46153846154,104.384615384615
"6582","22013","2020",33,32,1,90528.1818181818,1137.48484848485,84.4545454545455
"6583","22014","2020",15,15,0,144700,1411.53333333333,111.2
"6584","22015","2020",23,23,0,145080.695652174,1451.17391304348,102.347826086957
"6585","22016","2020",12,11,1,398468.666666667,3411.66666666667,119.25
"6586","22018","2020",4,4,0,116873.75,1183.25,97.75
"6587","22019","2020",7,7,0,151042.857142857,1436.57142857143,106.857142857143
"6588","22020","2020",40,39,1,124742.75,1152.9,112.075
"6589","22021","2020",27,27,0,153242.592592593,1586.14814814815,98.2592592592593
"6590","22023","2020",11,11,0,58054.5454545455,843.181818181818,71.8181818181818
"6591","22024","2020",3,3,0,66666.6666666667,904,75.3333333333333
"6592","22025","2020",52,52,0,79235.9615384615,858.942307692308,95.4038461538462
"6593","22026","2020",8,8,0,173898.875,1570.75,114
"6594","22027","2020",9,9,0,64589.4444444444,750,93.7777777777778
"6595","22028","2020",7,7,0,172157.142857143,1351.57142857143,123.285714285714
"6596","22029","2020",7,7,0,96928.5714285714,1091.14285714286,87.1428571428571
"6597","22030","2020",6,6,0,105583.333333333,1328.5,87.8333333333333
"6598","22031","2020",7,7,0,103304.285714286,940.714285714286,104
"6599","22032","2020",38,37,1,137384.473684211,1281.78947368421,112.631578947368
"6600","22033","2020",14,14,0,88346.6428571429,1224.57142857143,78.2857142857143
"6601","22034","2020",21,21,0,146812.857142857,1222.14285714286,118.714285714286
"6602","22035","2020",11,11,0,145732.545454545,1604.45454545455,95.7272727272727
"6603","22036","2020",2,2,0,102750,858,115
"6604","22037","2020",11,11,0,88581.8181818182,967.363636363636,94.1818181818182
"6605","22039","2020",7,7,0,80000,951.714285714286,86.2857142857143
"6606","22040","2020",7,7,0,130900,1323.42857142857,88.5714285714286
"6607","22041","2020",4,4,0,111500,1098,93
"6608","22042","2020",4,4,0,116000,1145,104.5
"6609","22043","2020",6,6,0,58250,771.666666666667,72.6666666666667
"6610","22044","2020",21,21,0,184926.19047619,1681.14285714286,108.095238095238
"6611","22045","2020",2,2,0,1e+05,1423.5,84
"6612","22046","2020",115,113,2,85855.2434782609,899.217391304348,97.5739130434783
"6613","22047","2020",30,30,0,73703.3333333333,819.766666666667,87.8666666666667
"6614","22048","2020",41,41,0,169747.317073171,1649,107.634146341463
"6615","22049","2020",21,21,0,195323.80952381,1932.57142857143,105.619047619048
"6616","22050","2020",348,150,198,184052.181034483,2149.42816091954,86.0862068965517
"6617","22052","2020",7,7,0,118705,1130.57142857143,98.2857142857143
"6618","22053","2020",11,11,0,95272.7272727273,920.818181818182,109.272727272727
"6619","22054","2020",123,80,43,254307.25203252,2848.82926829268,93.9024390243902
"6620","22055","2020",160,133,27,230500.74375,2497.1875,98.30625
"6621","22056","2020",25,25,0,160220,1522.96,108.08
"6622","22057","2020",8,8,0,126527.5,1430.75,91.5
"6623","22059","2020",10,10,0,165550,1409.7,115.1
"6624","22060","2020",10,10,0,85915,1092.9,83.9
"6625","22061","2020",25,25,0,81029.6,1097.12,82.52
"6626","22062","2020",10,10,0,90700,914.2,99.6
"6627","22063","2020",8,8,0,103177.875,1380.625,77.5
"6628","22064","2020",14,14,0,77263.4285714286,918.642857142857,84.3571428571429
"6629","22065","2020",34,34,0,142965.735294118,1462.08823529412,102.5
"6630","22067","2020",39,39,0,133598.384615385,1375.10256410256,98.3333333333333
"6631","22068","2020",6,6,0,108166.666666667,1000.16666666667,98.8333333333333
"6632","22069","2020",5,5,0,176116.8,1249,133.2
"6633","22070","2020",122,60,62,84948.3360655738,1157.44262295082,77.5081967213115
"6634","22071","2020",11,11,0,110054.545454545,1215.27272727273,92.0909090909091
"6635","22072","2020",8,8,0,63241.5,881.75,67.5
"6636","22073","2020",4,4,0,151875,1316.75,121
"6637","22074","2020",16,16,0,80181.25,808.6875,101.375
"6638","22075","2020",7,7,0,115285.714285714,1051.71428571429,108.857142857143
"6639","22076","2020",23,23,0,138865.217391304,1712.91304347826,84.8260869565217
"6640","22077","2020",15,15,0,176182.266666667,1578.2,108.533333333333
"6641","22079","2020",11,11,0,159131.818181818,1550.63636363636,103.909090909091
"6642","22081","2020",51,47,4,191414.117647059,1846.6862745098,104.803921568627
"6643","22082","2020",13,13,0,177089.615384615,1601.69230769231,111.692307692308
"6644","22083","2020",12,12,0,90666.6666666667,866,99.0833333333333
"6645","22084","2020",41,40,1,124296.341463415,1288.65853658537,95.4146341463415
"6646","22085","2020",3,3,0,298066.666666667,2158,157.666666666667
"6647","22086","2020",11,11,0,193687.272727273,1583,116.090909090909
"6648","22087","2020",11,11,0,90589.1818181818,854.636363636364,99
"6649","22088","2020",6,6,0,98366.6666666667,1113.66666666667,91.3333333333333
"6650","22090","2020",15,15,0,169440.266666667,1457.33333333333,116.6
"6651","22091","2020",5,5,0,106400,1112.8,97.6
"6652","22092","2020",8,8,0,101113.125,898,117.625
"6653","22093","2020",237,183,54,180385.919831224,1853.24894514768,98.0759493670886
"6654","22094","2020",37,32,5,417907.486486487,4161,95.7567567567568
"6655","22095","2020",5,5,0,93800,1265.4,83.8
"6656","22096","2020",8,8,0,114000,1332.125,86.375
"6657","22097","2020",9,9,0,150403,1522.22222222222,94
"6658","22098","2020",17,17,0,191522.588235294,1533.52941176471,124
"6659","22099","2020",15,15,0,135513.666666667,1315.86666666667,109.133333333333
"6660","22101","2020",20,20,0,142932.5,1423,101.7
"6661","22103","2020",23,23,0,235099.695652174,2335.30434782609,109.260869565217
"6662","22104","2020",8,8,0,118262.5,1884.875,63.375
"6663","22105","2020",8,8,0,166875,1704.125,99.125
"6664","22106","2020",95,68,27,153108.126315789,1893.28421052632,82.2105263157895
"6665","22107","2020",40,39,1,99013.75,1063.4,95.675
"6666","22108","2020",1,1,0,142000,2219,64
"6667","22109","2020",14,14,0,154128.142857143,1548.28571428571,106.5
"6668","22110","2020",8,8,0,164785,1656.75,99.125
"6669","22111","2020",11,11,0,220390,2221.72727272727,102.545454545455
"6670","22112","2020",6,6,0,206373.333333333,1447.16666666667,137.666666666667
"6671","22113","2020",318,217,101,140061.886792453,1628.02830188679,86.748427672956
"6672","22114","2020",19,19,0,85248.4210526316,862.105263157895,101.368421052632
"6673","22115","2020",8,8,0,55462.5,708.75,81.25
"6674","22116","2020",12,12,0,130279,1242.5,114.75
"6675","22117","2020",16,16,0,177043.9375,1586.6875,116.9375
"6676","22118","2020",73,64,9,188429.054794521,1909.86301369863,99.8767123287671
"6677","22119","2020",25,25,0,110270.8,1444.52,80.96
"6678","22121","2020",28,25,3,123690.892857143,1317.03571428571,98.6428571428571
"6679","22122","2020",10,10,0,84300,924,91.3
"6680","22124","2020",8,8,0,92948.75,880.375,104.25
"6681","22126","2020",2,2,0,117550,949,124
"6682","22127","2020",35,34,1,184752.571428571,1797.17142857143,103.885714285714
"6683","22128","2020",6,6,0,92993.1666666667,810.833333333333,107.5
"6684","22129","2020",4,4,0,82000,986.5,89
"6685","22131","2020",18,18,0,79569.4444444444,895.555555555556,102.444444444444
"6686","22132","2020",3,3,0,101253.333333333,1598.66666666667,77.6666666666667
"6687","22133","2020",8,8,0,111250,1054.25,113.75
"6688","22134","2020",60,60,0,220040.316666667,2005.11666666667,109.816666666667
"6689","22135","2020",43,43,0,112759.046511628,1182.27906976744,99.2790697674419
"6690","22136","2020",120,94,26,108400.083333333,1192.15,94.05
"6691","22137","2020",36,36,0,71867.75,837.527777777778,89.8888888888889
"6692","22138","2020",7,7,0,147021.428571429,1219.85714285714,104.714285714286
"6693","22139","2020",2,2,0,99000,906.5,103.5
"6694","22140","2020",1,1,0,175000,1902,92
"6695","22143","2020",34,27,7,182758.235294118,1930.5,94.4411764705882
"6696","22144","2020",10,10,0,166915,1494,109.6
"6697","22145","2020",22,22,0,123772.363636364,1237.27272727273,106.318181818182
"6698","22146","2020",4,4,0,98750,1066,88.75
"6699","22147","2020",46,43,3,97074.4565217391,989.54347826087,101.04347826087
"6700","22148","2020",3,3,0,53333.3333333333,628.333333333333,85.3333333333333
"6701","22149","2020",10,10,0,102670,976.4,107
"6702","22150","2020",21,21,0,122773.80952381,1224.61904761905,100
"6703","22152","2020",16,16,0,194900,1551.625,126.5
"6704","22153","2020",10,10,0,96355.3,1091.8,88.6
"6705","22155","2020",17,16,1,98000,1094.11764705882,93.7647058823529
"6706","22156","2020",7,7,0,78900,1051.57142857143,76.5714285714286
"6707","22157","2020",8,8,0,91212.5,1022.25,92.625
"6708","22158","2020",43,43,0,106770.162790698,1132.48837209302,100.116279069767
"6709","22160","2020",5,5,0,92500,1127.6,77.2
"6710","22161","2020",31,31,0,116296.129032258,1307.45161290323,88.9677419354839
"6711","22162","2020",152,109,43,206465.157894737,2363.17105263158,91.9934210526316
"6712","22163","2020",11,11,0,65218.9090909091,866.909090909091,75.8181818181818
"6713","22164","2020",19,19,0,118247.368421053,1276.10526315789,91.6842105263158
"6714","22165","2020",3,3,0,121666.666666667,1106,107.333333333333
"6715","22166","2020",52,52,0,231396.538461538,2206.44230769231,110.807692307692
"6716","22168","2020",258,142,116,227310.895348837,2606.65503875969,87.2558139534884
"6717","22169","2020",4,4,0,65730,635.25,105.5
"6718","22170","2020",23,23,0,156014.347826087,1522.5652173913,105.304347826087
"6719","22171","2020",45,45,0,154810.844444444,1500.53333333333,106.222222222222
"6720","22172","2020",65,41,24,127821.692307692,1542.73846153846,80.8769230769231
"6721","22174","2020",13,13,0,162344.230769231,1682.07692307692,103.230769230769
"6722","22175","2020",14,14,0,177157.142857143,1570.57142857143,118.785714285714
"6723","22176","2020",74,69,5,151593.189189189,1497.63513513514,101.608108108108
"6724","22177","2020",21,21,0,157917.666666667,1655.85714285714,97.6666666666667
"6725","22178","2020",16,16,0,141667.1875,1557.9375,96.125
"6726","22179","2020",74,46,28,193896.675675676,2471.13513513513,82.3513513513514
"6727","22180","2020",20,19,1,126495,1267.25,101.45
"6728","22181","2020",14,14,0,100045.5,1124,99.7857142857143
"6729","22182","2020",23,23,0,153333.391304348,1277.47826086957,126.260869565217
"6730","22183","2020",57,54,3,110251,1125.22807017544,105.245614035088
"6731","22184","2020",24,24,0,112129.583333333,1188.66666666667,99.4583333333333
"6732","22185","2020",29,29,0,121573.965517241,1291.55172413793,95.4137931034483
"6733","22186","2020",135,87,48,273765.140740741,3329.46666666667,84.562962962963
"6734","22187","2020",202,172,30,211145.336633663,2094.35643564356,99.9554455445545
"6735","22188","2020",10,10,0,161540,1615.5,101.2
"6736","22189","2020",15,15,0,113006.666666667,1287.73333333333,91.3333333333333
"6737","22190","2020",66,65,1,176372.545454545,1792.5303030303,98.469696969697
"6738","22193","2020",22,17,5,112783.045454545,1218.72727272727,89.8636363636364
"6739","22194","2020",80,76,4,167327.7625,1645.125,103.45
"6740","22195","2020",75,73,2,170567.413333333,1816.85333333333,98.1333333333333
"6741","22196","2020",19,19,0,133676,1324.78947368421,99.3157894736842
"6742","22197","2020",43,42,1,230954.76744186,2084.11627906977,119.023255813953
"6743","22198","2020",81,79,2,252139.469135802,2469.40740740741,106.185185185185
"6744","22199","2020",25,25,0,109092,1237.68,89.92
"6745","22200","2020",10,10,0,119870,1255.4,98.3
"6746","22201","2020",16,16,0,203375,2370.25,92.625
"6747","22202","2020",12,12,0,71076.3333333333,969.833333333333,83.6666666666667
"6748","22203","2020",42,42,0,113153,1183.07142857143,96.6666666666667
"6749","22204","2020",19,19,0,115249.210526316,1145.05263157895,99.3684210526316
"6750","22205","2020",9,9,0,102252.777777778,1130.11111111111,92.6666666666667
"6751","22206","2020",65,59,6,124381.276923077,1310.41538461538,99.6461538461539
"6752","22207","2020",66,66,0,109063,1192.65151515152,94.030303030303
"6753","22208","2020",25,25,0,141418,1460.88,98.48
"6754","22209","2020",69,49,20,190491.391304348,2170.92753623188,89.9420289855072
"6755","22210","2020",51,51,0,232780.333333333,2176.82352941176,107.980392156863
"6756","22211","2020",65,63,2,148470.153846154,1484.75384615385,102.2
"6757","22212","2020",30,30,0,102037.133333333,1061.3,95.4
"6758","22213","2020",40,39,1,294692.9,2427.825,118.875
"6759","22214","2020",77,75,2,182006.896103896,1933.5974025974,98.1038961038961
"6760","22215","2020",116,104,12,142553.793103448,1572.68965517241,92.1896551724138
"6761","22216","2020",14,14,0,65714.2857142857,905.714285714286,71.7857142857143
"6762","22217","2020",11,11,0,87418.1818181818,1120.81818181818,84.2727272727273
"6763","22218","2020",25,25,0,220368,2280.12,97.76
"6764","22219","2020",29,29,0,97029.3103448276,913.172413793103,104.034482758621
"6765","22220","2020",26,26,0,89707.2692307692,885.307692307692,102.576923076923
"6766","22221","2020",40,40,0,144343,1499.425,98.35
"6767","22222","2020",120,105,15,162336.3,1896.75833333333,88.025
"6768","22223","2020",26,26,0,120924.384615385,1339.03846153846,92.0769230769231
"6769","22224","2020",23,23,0,174767.391304348,1649.30434782609,108.130434782609
"6770","22225","2020",82,74,8,128265.012195122,1394.69512195122,91.0853658536585
"6771","22226","2020",57,57,0,145091.157894737,1593,97.1578947368421
"6772","22227","2020",11,11,0,115020.181818182,1351.18181818182,87
"6773","22228","2020",32,32,0,92910.46875,990.59375,97.28125
"6774","22229","2020",24,24,0,83737.9166666667,818.875,101.333333333333
"6775","22231","2020",6,6,0,114423.333333333,1381.16666666667,103.666666666667
"6776","22232","2020",46,46,0,178026.565217391,1707.47826086957,106.54347826087
"6777","22233","2020",32,31,1,147812.53125,1555.25,96.15625
"6778","22234","2020",14,14,0,147421.428571429,1156.42857142857,129.142857142857
"6779","22235","2020",6,6,0,155883.333333333,1652.16666666667,89.6666666666667
"6780","22236","2020",13,13,0,185684.615384615,1567.76923076923,121.307692307692
"6781","22237","2020",22,22,0,156431.818181818,1451.59090909091,108.181818181818
"6782","22238","2020",10,10,0,148260,1238.3,117.9
"6783","22239","2020",18,18,0,140823.055555556,1399.77777777778,99.2777777777778
"6784","22240","2020",22,22,0,124337.818181818,1085.13636363636,114.272727272727
"6785","22241","2020",17,17,0,112272.882352941,1430.41176470588,84.5294117647059
"6786","22242","2020",30,30,0,194256.9,2028.46666666667,97.5
"6787","22243","2020",13,13,0,87592.0769230769,947,97.2307692307692
"6788","22244","2020",10,10,0,81370,1200.6,89.4
"6789","22245","2020",17,17,0,150585.294117647,1263,114.941176470588
"6790","22246","2020",11,11,0,182195.454545455,1687.45454545455,111
"6791","22248","2020",37,37,0,122988.702702703,1238,105.540540540541
"6792","22249","2020",13,13,0,82691.5384615385,837.692307692308,99.8461538461538
"6793","22250","2020",16,11,5,78418.125,988,86.75
"6794","22251","2020",92,84,8,208482.22826087,2209.34782608696,95.5760869565217
"6795","22254","2020",12,12,0,116800,1359.91666666667,94.4166666666667
"6796","22255","2020",15,15,0,90573.3333333333,944.4,98.9333333333333
"6797","22256","2020",29,29,0,131705.310344828,1238.58620689655,106.310344827586
"6798","22257","2020",4,4,0,117375,1092.25,121
"6799","22258","2020",51,51,0,163160.431372549,1594.72549019608,101.039215686275
"6800","22259","2020",63,59,4,177896.174603175,1741.8253968254,101.047619047619
"6801","22260","2020",12,12,0,102319,888.25,126.583333333333
"6802","22261","2020",4,4,0,248562.5,1858.75,154.25
"6803","22262","2020",49,48,1,151764.285714286,1386.55102040816,113.122448979592
"6804","22263","2020",1,1,0,139000,1598,87
"6805","22264","2020",52,52,0,116848.076923077,1168.57692307692,102.5
"6806","22265","2020",17,17,0,143117.647058824,1405.82352941176,102.352941176471
"6807","22266","2020",68,66,2,87793.0882352941,939.794117647059,94.6470588235294
"6808","22267","2020",8,8,0,78912.5,840.125,96.25
"6809","22268","2020",17,17,0,176894.117647059,1692,110.705882352941
"6810","22269","2020",3,3,0,108216.666666667,886.333333333333,111.333333333333
"6811","22271","2020",1,1,0,120000,1176,102
"6812","22272","2020",34,32,2,162725,1701.67647058824,99.8823529411765
"6813","22273","2020",34,34,0,215364.5,2076.47058823529,105.235294117647
"6814","22274","2020",3,3,0,240300,1589,150
"6815","22275","2020",11,11,0,108795.454545455,1234.27272727273,91.6363636363636
"6816","22277","2020",29,29,0,161596.551724138,1495.51724137931,106.931034482759
"6817","22278","2020",1044,391,653,107054.035440613,1418.96360153257,74.6072796934866
"6818","22279","2020",17,16,1,98355.8823529412,1032.35294117647,94.2352941176471
"6819","22280","2020",13,13,0,156184.615384615,1450.53846153846,111.538461538462
"6820","22281","2020",11,11,0,133923.181818182,1289.09090909091,105.454545454545
"6821","22282","2020",190,105,85,217536.852631579,2879.98947368421,77.5368421052632
"6822","22283","2020",16,16,0,128293.1875,1433.875,88.875
"6823","22284","2020",8,8,0,58625,752.75,74.5
"6824","22285","2020",6,6,0,128483.333333333,939.166666666667,138.833333333333
"6825","22286","2020",5,5,0,172800,1944.4,93.8
"6826","22287","2020",16,16,0,134125.5,1395.3125,99.3125
"6827","22288","2020",2,2,0,106405,1325,80.5
"6828","22289","2020",1,1,0,183200,1078,170
"6829","22291","2020",4,4,0,115747.5,1082.5,105.75
"6830","22293","2020",7,7,0,110428.571428571,1098.85714285714,114.285714285714
"6831","22294","2020",4,4,0,118813.75,1048.5,95.5
"6832","22295","2020",10,10,0,81710,768.1,102.2
"6833","22296","2020",10,9,1,135431,1480.4,102.2
"6834","22299","2020",24,24,0,169534.25,1662.95833333333,105.541666666667
"6835","22300","2020",5,5,0,99400,1281.2,87.2
"6836","22302","2020",27,25,2,372580,3663.81481481481,100.222222222222
"6837","22304","2020",7,7,0,202514.285714286,2044.14285714286,93.7142857142857
"6838","22305","2020",3,3,0,197666.666666667,1550.66666666667,134.666666666667
"6839","22306","2020",8,8,0,158812.5,1309.625,118.5
"6840","22307","2020",17,17,0,141964.470588235,1456.47058823529,100
"6841","22308","2020",10,9,1,168420,1664.1,96.8
"6842","22309","2020",2,2,0,197500,784.5,197.5
"6843","22310","2020",4,4,0,120250,1333.75,87.75
"6844","22311","2020",13,13,0,226492.307692308,1855.46153846154,123.692307692308
"6845","22312","2020",7,7,0,136814.285714286,1233.85714285714,94.5714285714286
"6846","22313","2020",9,9,0,62304.4444444444,826.222222222222,69.3333333333333
"6847","22314","2020",4,4,0,97125,1117.25,90
"6848","22315","2020",4,4,0,192597,1920.75,96.75
"6849","22316","2020",8,8,0,70401.25,779.875,96.75
"6850","22317","2020",8,7,1,96643.75,1034.5,88.625
"6851","22318","2020",7,7,0,79814.2857142857,1277.71428571429,75
"6852","22319","2020",10,9,1,158158.9,1954.8,96.4
"6853","22320","2020",5,5,0,110400,2351.8,70.6
"6854","22321","2020",41,41,0,71274.3902439024,851.585365853659,88.9756097560976
"6855","22322","2020",8,8,0,112375,1365.125,83.5
"6856","22323","2020",11,11,0,130136.363636364,1504.36363636364,86.6363636363636
"6857","22324","2020",26,26,0,261472.807692308,2104.88461538462,121.115384615385
"6858","22325","2020",132,76,56,204938.295454545,2650.55303030303,83.0833333333333
"6859","22326","2020",4,4,0,128000,1434.25,93.25
"6860","22327","2020",27,27,0,178337.037037037,1931.03703703704,92.5185185185185
"6861","22328","2020",5,5,0,93100,965.8,89.6
"6862","22330","2020",10,10,0,91755.5,1306.3,81.2
"6863","22331","2020",2,2,0,105477.5,714.5,142
"6864","22332","2020",9,9,0,133287.777777778,1292.22222222222,102
"6865","22333","2020",11,11,0,83045.4545454545,910.272727272727,89.5454545454545
"6866","22334","2020",3,3,0,100333.333333333,941.333333333333,104.333333333333
"6867","22335","2020",6,6,0,111320.833333333,1607.5,70.3333333333333
"6868","22337","2020",16,16,0,97688.6875,1129.5625,87
"6869","22338","2020",10,10,0,119719,1275.9,97.8
"6870","22339","2020",66,52,14,158994.696969697,1728.0303030303,92.4242424242424
"6871","22340","2020",11,11,0,150722.727272727,1456.09090909091,105.363636363636
"6872","22341","2020",11,11,0,117207.090909091,1064.45454545455,109.363636363636
"6873","22342","2020",3,3,0,87333.3333333333,908.666666666667,88.3333333333333
"6874","22343","2020",111,76,35,206547.945945946,2587.24324324324,91.972972972973
"6875","22344","2020",13,13,0,105865.384615385,918.538461538462,115.153846153846
"6876","22345","2020",16,16,0,100100.875,1041.9375,100.75
"6877","22346","2020",12,12,0,133970.833333333,1324,103.5
"6878","22347","2020",21,21,0,175127.142857143,1851.04761904762,103.47619047619
"6879","22348","2020",8,8,0,76939,1036.5,82.5
"6880","22349","2020",25,25,0,175066,1997.76,94.56
"6881","22350","2020",2,2,0,86250,1055,65.5
"6882","22351","2020",5,5,0,104800,799.6,122.8
"6883","22352","2020",3,3,0,134200,1487,91.6666666666667
"6884","22353","2020",65,57,8,275179.230769231,2979.41538461538,98.7538461538462
"6885","22354","2020",9,9,0,164888.888888889,1293.88888888889,126.333333333333
"6886","22356","2020",10,10,0,176794,1480.9,121.7
"6887","22358","2020",7,7,0,102814.285714286,1246,84.5714285714286
"6888","22359","2020",12,12,0,183433.333333333,1338.08333333333,131.166666666667
"6889","22360","2020",87,78,9,167508.172413793,1620.12643678161,105.563218390805
"6890","22361","2020",10,10,0,144663,1404.9,99.4
"6891","22362","2020",41,36,5,150643.902439024,1630.41463414634,96.0975609756098
"6892","22363","2020",28,27,1,259937.321428571,2557.57142857143,108.142857142857
"6893","22364","2020",40,34,6,154876.2,1812,85.725
"6894","22365","2020",3,3,0,91000,851,107.333333333333
"6895","22366","2020",8,8,0,89500,1192.125,77.5
"6896","22368","2020",9,9,0,200170,2030.77777777778,98.8888888888889
"6897","22369","2020",15,15,0,105633.333333333,1097.93333333333,92.4
"6898","22370","2020",7,7,0,140897.142857143,1162.71428571429,120.714285714286
"6899","22371","2020",11,11,0,82000,995.363636363636,82.7272727272727
"6900","22372","2020",20,20,0,171655,1671.6,103.9
"6901","22373","2020",2,2,0,62500,744.5,82.5
"6902","22375","2020",8,8,0,135088.75,1500.625,88.75
"6903","22376","2020",16,15,1,118247.5,1072.125,105.875
"6904","22377","2020",16,16,0,191410.8125,1815.75,109.5
"6905","22378","2020",6,6,0,142426.666666667,1640.83333333333,95.8333333333333
"6906","22379","2020",35,28,7,181822.485714286,2663.71428571429,74.9428571428571
"6907","22380","2020",13,12,1,110115.384615385,1360.69230769231,85.7692307692308
"6908","22381","2020",3,3,0,134000,1197.66666666667,111.333333333333
"6909","22383","2020",5,5,0,163300,1024.4,144
"6910","22384","2020",21,21,0,115401.428571429,950.333333333333,123.714285714286
"6911","22385","2020",16,16,0,187803.125,1829.875,106.875
"6912","22386","2020",7,7,0,101000,1222.85714285714,93.1428571428571
"6913","22387","2020",29,29,0,127611.379310345,1260.1724137931,102.896551724138
"6914","22388","2020",14,14,0,169103.571428571,1822.92857142857,96.8571428571429
"6915","22389","2020",68,60,8,150139.823529412,1602.29411764706,95.6323529411765
"6916","22390","2020",14,14,0,160592.857142857,1417.21428571429,113.214285714286
"6917","22391","2020",25,24,1,125965.28,1179.96,109.2
"6918","23001","2020",9,9,0,63038.8888888889,738.777777777778,83.4444444444444
"6919","23002","2020",15,15,0,102217,967.4,106.266666666667
"6920","23003","2020",1,1,0,16000,889,18
"6921","23004","2020",6,6,0,86416.6666666667,893.166666666667,92.3333333333333
"6922","23005","2020",4,4,0,76750,999.75,77.75
"6923","23006","2020",8,8,0,77900,1071.75,83.5
"6924","23007","2020",2,2,0,70500,518,136.5
"6925","23008","2020",38,28,10,65928.9473684211,830.789473684211,84.8157894736842
"6926","23010","2020",1,1,0,55000,519,106
"6927","23011","2020",3,3,0,47113.3333333333,670.666666666667,70.3333333333333
"6928","23012","2020",3,3,0,113200,1041.66666666667,100
"6929","23013","2020",11,10,1,95595.4545454545,1098.18181818182,86.6363636363636
"6930","23014","2020",2,2,0,56000,666,81
"6931","23015","2020",12,12,0,62466.6666666667,888.5,77
"6932","23016","2020",4,4,0,37250,613.75,61
"6933","23017","2020",2,2,0,118325,773.5,149
"6934","23018","2020",2,2,0,83500,777.5,116.5
"6935","23020","2020",6,6,0,75166.6666666667,808.5,92.1666666666667
"6936","23021","2020",7,7,0,86688.5714285714,618.285714285714,144.285714285714
"6937","23022","2020",4,4,0,55500,950.25,67.5
"6938","23023","2020",3,3,0,46833.3333333333,828,55.3333333333333
"6939","23024","2020",7,7,0,100257.142857143,1087.57142857143,90.2857142857143
"6940","23025","2020",8,8,0,74666.25,904.375,75.25
"6941","23026","2020",6,6,0,88230.5,1264.5,75.6666666666667
"6942","23027","2020",4,4,0,76000,1051.75,75
"6943","23028","2020",2,2,0,86000,915.5,95
"6944","23029","2020",5,5,0,54700,751,76.8
"6945","23030","2020",27,24,3,73392.5925925926,872.37037037037,88.5555555555556
"6946","23031","2020",15,15,0,68430,817.866666666667,82.5333333333333
"6947","23032","2020",4,4,0,75000,827.25,97.5
"6948","23033","2020",5,5,0,142645,1120.2,129
"6949","23035","2020",5,5,0,108287,870.4,101
"6950","23036","2020",14,14,0,69115.3571428571,986.214285714286,90.2142857142857
"6951","23038","2020",6,6,0,51833.3333333333,697.666666666667,70.5
"6952","23039","2020",6,6,0,122475,925.333333333333,116.833333333333
"6953","23040","2020",3,3,0,73333.3333333333,1010,81
"6954","23041","2020",6,6,0,51666.6666666667,486.166666666667,104
"6955","23042","2020",5,5,0,49600,597.2,93
"6956","23043","2020",1,1,0,95000,1056,90
"6957","23044","2020",3,3,0,70000,679,98.3333333333333
"6958","23045","2020",10,10,0,106100,817.4,123.6
"6959","23046","2020",2,2,0,76500,729.5,117.5
"6960","23048","2020",5,5,0,62160,729.8,85.4
"6961","23049","2020",4,4,0,91475,898.25,107.5
"6962","23050","2020",1,1,0,70000,636,110
"6963","23051","2020",1,1,0,61300,578,106
"6964","23052","2020",1,1,0,71500,406,176
"6965","23053","2020",3,3,0,88771.3333333333,952.333333333333,116
"6966","23054","2020",1,1,0,49000,445,110
"6967","23055","2020",1,1,0,80000,1000,80
"6968","23056","2020",11,11,0,66690.9090909091,921.545454545455,80.0909090909091
"6969","23057","2020",5,5,0,75560,712,114.6
"6970","23058","2020",1,1,0,85000,885,96
"6971","23060","2020",3,3,0,97991.6666666667,686.333333333333,117.333333333333
"6972","23061","2020",5,5,0,73400,858.8,84
"6973","23062","2020",15,15,0,56266.6666666667,830.333333333333,68.6666666666667
"6974","23063","2020",3,3,0,110233.333333333,697,185.666666666667
"6975","23064","2020",16,16,0,56437.5,801,78.625
"6976","23065","2020",5,5,0,65606.6,543.4,111.6
"6977","23066","2020",3,3,0,151420,1027.66666666667,170.666666666667
"6978","23067","2020",6,6,0,82775,784.666666666667,100.833333333333
"6979","23068","2020",12,12,0,62458.3333333333,791.75,79.8333333333333
"6980","23069","2020",3,3,0,64243.3333333333,761,86.3333333333333
"6981","23070","2020",13,13,0,94846.1538461538,1312.07692307692,71.7692307692308
"6982","23071","2020",4,4,0,64625,596.5,111
"6983","23072","2020",6,6,0,51211.6666666667,546.333333333333,87.5
"6984","23073","2020",4,4,0,84334.25,989.25,88.25
"6985","23074","2020",4,4,0,69876.25,773.75,94
"6986","23075","2020",17,17,0,95890.8823529412,962.058823529412,103.176470588235
"6987","23076","2020",13,11,2,80980,782.076923076923,113.615384615385
"6988","23077","2020",15,15,0,72610,1117.4,74.4
"6989","23078","2020",3,3,0,93300,984,104.333333333333
"6990","23079","2020",25,23,2,74318.4,794.48,95
"6991","23080","2020",3,3,0,106000,914.333333333333,109.666666666667
"6992","23081","2020",3,3,0,135824.333333333,733,184.333333333333
"6993","23082","2020",6,6,0,82223.3333333333,895,88.6666666666667
"6994","23083","2020",1,1,0,120000,902,133
"6995","23084","2020",4,4,0,72625,692.75,109
"6996","23086","2020",6,6,0,77371.6666666667,769.666666666667,96.8333333333333
"6997","23087","2020",12,12,0,51558.3333333333,691.416666666667,73.3333333333333
"6998","23088","2020",1,1,0,55000,585,94
"6999","23089","2020",10,10,0,62940,801.9,82.3
"7000","23090","2020",11,10,1,44992.7272727273,601.545454545455,77.1818181818182
"7001","23091","2020",2,2,0,63750,579,119.5
"7002","23092","2020",8,8,0,101875,1121,86.25
"7003","23093","2020",13,13,0,90436.1538461538,1036.69230769231,87.7692307692308
"7004","23095","2020",18,18,0,107389.444444444,1097,93.1666666666667
"7005","23096","2020",163,114,49,89541.5582822086,1120.98773006135,83.2822085889571
"7006","23097","2020",6,6,0,76916.6666666667,1028.83333333333,75.6666666666667
"7007","23098","2020",2,2,0,70500,696,87.5
"7008","23099","2020",6,6,0,60035,619.5,100.666666666667
"7009","23100","2020",3,3,0,59666.6666666667,698,82
"7010","23101","2020",5,5,0,41400,589.6,73
"7011","23102","2020",2,2,0,130875,1009,122
"7012","23103","2020",10,10,0,85116,713.1,110
"7013","23105","2020",9,9,0,49522.2222222222,741.888888888889,66.8888888888889
"7014","23106","2020",3,3,0,108833.333333333,896.666666666667,125.333333333333
"7015","23107","2020",5,5,0,71120,688.6,108
"7016","23108","2020",1,1,0,69000,986,70
"7017","23109","2020",5,5,0,70745,667.6,96.2
"7018","23110","2020",1,1,0,190000,633,300
"7019","23111","2020",2,2,0,106114.5,710,133
"7020","23112","2020",16,16,0,70035.625,1013.0625,71.5625
"7021","23113","2020",5,5,0,121784,1285.8,90.6
"7022","23114","2020",2,2,0,50650,633.5,84.5
"7023","23115","2020",8,8,0,99626.375,890.25,111.5
"7024","23116","2020",9,9,0,101508.333333333,1070.33333333333,98.2222222222222
"7025","23117","2020",2,2,0,46000,434.5,95.5
"7026","23118","2020",1,1,0,79628,995,80
"7027","23120","2020",4,4,0,135250,2723.25,63.5
"7028","23123","2020",4,4,0,53217.5,1018.5,53
"7029","23124","2020",11,11,0,72445,743.454545454545,92.3636363636364
"7030","23125","2020",1,1,0,50500,935,54
"7031","23127","2020",2,2,0,32710,395.5,85
"7032","23128","2020",2,2,0,50000,588.5,86
"7033","23130","2020",3,3,0,59000,733,79
"7034","23131","2020",8,8,0,72337.5,840.125,87.375
"7035","23132","2020",6,6,0,112609.5,829.833333333333,115.833333333333
"7036","23133","2020",3,3,0,62700,506.666666666667,111.333333333333
"7037","23134","2020",3,3,0,59166.6666666667,732,79.6666666666667
"7038","23137","2020",6,5,1,43583.3333333333,621.5,68.6666666666667
"7039","23138","2020",4,3,1,99882.5,1300.25,71
"7040","23139","2020",4,4,0,77846,773,102.5
"7041","23140","2020",4,4,0,81000,908.25,92
"7042","23141","2020",7,7,0,68142.8571428571,879.714285714286,74.2857142857143
"7043","23142","2020",2,2,0,60814.5,625,98.5
"7044","23143","2020",7,7,0,115538.142857143,1170.42857142857,96.8571428571429
"7045","23144","2020",7,7,0,66562.8571428571,773.571428571429,87.5714285714286
"7046","23145","2020",3,3,0,39123.3333333333,550.333333333333,76.6666666666667
"7047","23146","2020",11,10,1,92035.8181818182,1198.81818181818,80.9090909090909
"7048","23147","2020",1,1,0,32000,381,84
"7049","23148","2020",3,3,0,46333.3333333333,662.333333333333,68
"7050","23149","2020",9,9,0,100241.111111111,816.444444444444,124.555555555556
"7051","23150","2020",2,2,0,98030,1006.5,107.5
"7052","23151","2020",6,6,0,57833.3333333333,677.833333333333,76.5
"7053","23152","2020",1,1,0,58750,539,109
"7054","23154","2020",4,4,0,73012.5,900,91.75
"7055","23155","2020",3,3,0,66450,737.333333333333,88.6666666666667
"7056","23156","2020",2,2,0,73000,934,76.5
"7057","23157","2020",3,3,0,127333.333333333,1332.33333333333,96.3333333333333
"7058","23158","2020",3,3,0,58733.3333333333,694.666666666667,88.3333333333333
"7059","23159","2020",2,2,0,72750,428.5,166
"7060","23160","2020",3,3,0,78666.6666666667,635,123
"7061","23162","2020",3,3,0,54020,771.666666666667,69
"7062","23164","2020",4,4,0,68050,873.5,72
"7063","23165","2020",15,15,0,81069.4,1528.33333333333,63.7333333333333
"7064","23167","2020",9,9,0,73718.8888888889,817.222222222222,86.7777777777778
"7065","23168","2020",3,3,0,30185,406.333333333333,73
"7066","23169","2020",5,5,0,60150,1096.2,63.8
"7067","23170","2020",5,5,0,115700,970.4,127.8
"7068","23172","2020",4,4,0,85212.25,879.25,103
"7069","23173","2020",1,1,0,34000,354,96
"7070","23174","2020",8,8,0,56062.5,862.125,67.375
"7071","23175","2020",7,7,0,66392.8571428571,678.285714285714,90.4285714285714
"7072","23176","2020",42,37,5,106485.476190476,1128.35714285714,97.1904761904762
"7073","23177","2020",11,11,0,95527.2727272727,956.090909090909,94.0909090909091
"7074","23178","2020",1,1,0,30000,429,70
"7075","23179","2020",3,3,0,56666.6666666667,901.666666666667,63.6666666666667
"7076","23180","2020",2,2,0,75750,880,75
"7077","23181","2020",2,2,0,227637.5,1347,170.5
"7078","23182","2020",2,2,0,61450,761,83.5
"7079","23185","2020",8,8,0,60512.5,693.875,81.875
"7080","23187","2020",2,2,0,62500,546,114
"7081","23188","2020",5,5,0,57400,653.6,89.8
"7082","23189","2020",17,17,0,65329.2941176471,719.235294117647,90.8823529411765
"7083","23190","2020",3,3,0,81030.6666666667,873,95.3333333333333
"7084","23191","2020",3,3,0,66266.6666666667,804.666666666667,82.3333333333333
"7085","23192","2020",30,30,0,91566.3333333333,968.433333333333,105.8
"7086","23193","2020",28,28,0,100787.5,982.392857142857,101.821428571429
"7087","23194","2020",3,3,0,43666.6666666667,757.333333333333,60
"7088","23195","2020",11,11,0,136504.545454545,1217.36363636364,111.545454545455
"7089","23196","2020",3,3,0,86992,720,116.666666666667
"7090","23197","2020",4,4,0,82500,741.75,102.5
"7091","23198","2020",2,2,0,28000,575.5,53
"7092","23199","2020",6,6,0,89833.3333333333,683.333333333333,134.833333333333
"7093","23200","2020",8,8,0,78423.125,738.625,111.25
"7094","23201","2020",5,5,0,107400,925.8,107.8
"7095","23202","2020",4,4,0,77000,656.5,143.5
"7096","23203","2020",2,2,0,47250,435.5,106.5
"7097","23204","2020",1,1,0,131550,756,174
"7098","23205","2020",2,2,0,50800,884,57
"7099","23206","2020",4,4,0,100250,782.75,120.75
"7100","23207","2020",2,2,0,48500,572.5,85
"7101","23208","2020",6,6,0,68283.3333333333,776.666666666667,83
"7102","23209","2020",3,3,0,55833.3333333333,642.666666666667,88
"7103","23210","2020",2,2,0,50000,451,110
"7104","23211","2020",3,3,0,107183.333333333,1017,101
"7105","23212","2020",1,1,0,88000,1128,78
"7106","23213","2020",4,4,0,73375,939.25,78
"7107","23214","2020",1,1,0,132100,1190,111
"7108","23215","2020",2,2,0,125000,1133,114.5
"7109","23216","2020",5,5,0,54900,567.2,95.4
"7110","23217","2020",8,8,0,80062.5,845.5,96.625
"7111","23218","2020",2,2,0,72500,743.5,101
"7112","23219","2020",17,17,0,108412.941176471,1059.58823529412,104.882352941176
"7113","23220","2020",9,9,0,66000,681.888888888889,94.2222222222222
"7114","23221","2020",1,1,0,199000,1318,151
"7115","23222","2020",1,1,0,75000,1087,69
"7116","23223","2020",8,8,0,65602.5,809.875,94.875
"7117","23224","2020",1,1,0,55000,688,80
"7118","23225","2020",1,1,0,32500,855,38
"7119","23227","2020",5,5,0,137540,1099.8,119.6
"7120","23228","2020",1,1,0,150000,1562,96
"7121","23229","2020",5,5,0,64060,955.2,71
"7122","23230","2020",4,4,0,120875,1349.75,85.75
"7123","23232","2020",4,4,0,93650,702.75,136.5
"7124","23233","2020",2,2,0,110229.5,928.5,116
"7125","23234","2020",2,2,0,50500,772,65
"7126","23235","2020",4,4,0,108873.75,835.25,134.75
"7127","23236","2020",2,2,0,61000,734,86.5
"7128","23238","2020",4,4,0,64145,997.75,85.25
"7129","23239","2020",5,5,0,58896.4,942,72.4
"7130","23240","2020",7,7,0,88214.2857142857,1290.42857142857,69.1428571428571
"7131","23241","2020",2,2,0,47612,500,95.5
"7132","23242","2020",1,1,0,150000,1064,141
"7133","23243","2020",2,2,0,94000,902,103
"7134","23244","2020",12,12,0,61966.6666666667,773.333333333333,85.1666666666667
"7135","23245","2020",16,16,0,108009.375,985.5,103.0625
"7136","23246","2020",3,3,0,97400,1093.66666666667,86.6666666666667
"7137","23247","2020",26,26,0,77105.6153846154,898.692307692308,88.3846153846154
"7138","23248","2020",9,9,0,62736.6666666667,746,85.6666666666667
"7139","23249","2020",2,2,0,62750,757.5,82
"7140","23250","2020",5,5,0,52120,704.8,82.2
"7141","23251","2020",3,3,0,134036.666666667,944.333333333333,151.666666666667
"7142","23252","2020",5,5,0,73963.6,914,81.8
"7143","23253","2020",5,5,0,47700,674,69
"7144","23254","2020",12,12,0,69433.3333333333,959.583333333333,72.9166666666667
"7145","23255","2020",5,5,0,63094,615.2,109.8
"7146","23257","2020",12,12,0,83833.3333333333,863.333333333333,98.8333333333333
"7147","23258","2020",6,6,0,89375,897.5,96.5
"7148","23259","2020",2,2,0,78000,1245,53.5
"7149","23260","2020",2,2,0,106500,1103,95
"7150","23261","2020",3,2,1,127833.333333333,1151.66666666667,92.3333333333333
"7151","23262","2020",2,2,0,34000,435,77.5
"7152","23263","2020",2,2,0,67500,1429,48
"7153","23264","2020",3,3,0,61576.6666666667,686,94.6666666666667
"7154","23266","2020",2,2,0,69500,1494.5,64
"7155","24001","2020",13,13,0,102076.923076923,1333.07692307692,85.3076923076923
"7156","24002","2020",21,19,2,132820.952380952,1241.2380952381,104.857142857143
"7157","24004","2020",4,4,0,185211.25,1402.5,143.75
"7158","24005","2020",5,5,0,242656,1566.8,161
"7159","24006","2020",6,6,0,151666.666666667,1609.16666666667,105.333333333333
"7160","24007","2020",8,8,0,170554.625,1692.875,108
"7161","24008","2020",9,9,0,83305.5555555556,1247.11111111111,83.2222222222222
"7162","24009","2020",4,4,0,92875,1385,61.5
"7163","24010","2020",19,19,0,148767.368421053,1430,104.842105263158
"7164","24011","2020",15,15,0,149336.333333333,1886.26666666667,95.8
"7165","24012","2020",5,5,0,220146,3306.2,97.2
"7166","24014","2020",8,8,0,130131.25,1507.875,94.625
"7167","24015","2020",3,3,0,201400,1617,126.666666666667
"7168","24016","2020",17,17,0,121834.117647059,1424.29411764706,97
"7169","24018","2020",7,7,0,114057.142857143,1474.28571428571,69.5714285714286
"7170","24019","2020",5,5,0,135850,1494,106.6
"7171","24020","2020",14,14,0,132493.571428571,1252.28571428571,107.785714285714
"7172","24021","2020",7,7,0,109342.857142857,1281,82.2857142857143
"7173","24022","2020",3,3,0,82417.3333333333,907.666666666667,103.333333333333
"7174","24023","2020",6,6,0,134985,1302.5,102.666666666667
"7175","24025","2020",2,2,0,146500,1333.5,112.5
"7176","24026","2020",41,41,0,158217.43902439,1413.9512195122,116.292682926829
"7177","24027","2020",6,6,0,191500,1277.66666666667,143
"7178","24028","2020",40,40,0,171383.7,1395.9,117.875
"7179","24029","2020",2,2,0,99250,965,102
"7180","24030","2020",11,11,0,135259.090909091,1436,95.7272727272727
"7181","24031","2020",3,3,0,175000,1035,168.666666666667
"7182","24032","2020",8,8,0,125768.75,1041,128
"7183","24034","2020",8,8,0,158775,2401.75,84.625
"7184","24035","2020",16,16,0,120093.75,1222.375,97.0625
"7185","24037","2020",549,407,142,128266.058287796,1493.81785063752,87.2914389799636
"7186","24038","2020",4,4,0,136685,1201.75,125.5
"7187","24039","2020",2,2,0,102020,1511,67.5
"7188","24040","2020",6,6,0,192250,1955.5,98
"7189","24042","2020",6,6,0,196501.666666667,1755.33333333333,118.666666666667
"7190","24043","2020",1,1,0,119000,1190,100
"7191","24045","2020",3,3,0,121666.666666667,1182.33333333333,105.333333333333
"7192","24046","2020",1,1,0,49000,408,120
"7193","24050","2020",4,4,0,137250,1235.5,118.5
"7194","24051","2020",3,3,0,183416.666666667,1503,123.666666666667
"7195","24052","2020",3,3,0,131716.333333333,1473,111.666666666667
"7196","24053","2020",87,65,22,152500.689655172,1724.79310344828,89.4022988505747
"7197","24054","2020",10,10,0,167578,1510.7,111.1
"7198","24055","2020",12,12,0,118685,1183.66666666667,103.083333333333
"7199","24056","2020",2,2,0,119400,1215,79
"7200","24058","2020",3,3,0,160716.666666667,1126.66666666667,151.666666666667
"7201","24059","2020",3,3,0,93666.6666666667,1385.33333333333,66.6666666666667
"7202","24061","2020",1,1,0,86738,818,106
"7203","24062","2020",6,6,0,130528.333333333,1117,109
"7204","24063","2020",4,4,0,266300,1809.25,151
"7205","24064","2020",47,47,0,144622.680851064,1520.14893617021,103.723404255319
"7206","24066","2020",4,4,0,126772.5,1322.75,105.25
"7207","24067","2020",47,44,3,148848.531914894,1639.91489361702,96.6382978723404
"7208","24068","2020",36,36,0,183537.055555556,1705.36111111111,113.083333333333
"7209","24069","2020",4,4,0,186608.75,1329,150.5
"7210","24070","2020",10,10,0,91345.5,989.5,88.7
"7211","24071","2020",9,9,0,77705.5555555556,1025.88888888889,77
"7212","24073","2020",6,6,0,137500,1280.33333333333,107.166666666667
"7213","24074","2020",6,6,0,204775,1955.66666666667,104.666666666667
"7214","24075","2020",3,3,0,155000,1767.33333333333,86
"7215","24076","2020",7,7,0,231041.428571429,1839.85714285714,119.142857142857
"7216","24077","2020",4,4,0,97362.5,831.25,104
"7217","24080","2020",6,6,0,180916.666666667,1600.16666666667,118.5
"7218","24081","2020",14,14,0,187442.857142857,1663.28571428571,111.571428571429
"7219","24082","2020",18,18,0,280431.388888889,2337.61111111111,114.444444444444
"7220","24083","2020",3,3,0,171000,1219,140
"7221","24084","2020",1,1,0,232550,1472,158
"7222","24085","2020",3,3,0,63111.3333333333,989.333333333333,56.6666666666667
"7223","24086","2020",8,7,1,171071.625,1534,116.875
"7224","24087","2020",11,10,1,241069.363636364,2419.54545454545,116.181818181818
"7225","24088","2020",3,3,0,72000,957,85.6666666666667
"7226","24090","2020",6,6,0,152000,1269,141.666666666667
"7227","24091","2020",11,11,0,163950,2019.81818181818,85.9090909090909
"7228","24094","2020",3,3,0,192833.333333333,1237.33333333333,165.333333333333
"7229","24095","2020",8,8,0,137631.25,1683,87.875
"7230","24096","2020",5,5,0,172756.6,1155.6,149.2
"7231","24097","2020",4,4,0,179099.75,1446.5,141
"7232","24098","2020",51,38,13,157448.078431373,1692.56862745098,89.6862745098039
"7233","24100","2020",9,9,0,126670.444444444,1084.55555555556,123.444444444444
"7234","24101","2020",6,6,0,135083.333333333,1096.33333333333,127.833333333333
"7235","24102","2020",74,68,6,161103.351351351,1640.67567567568,98.2972972972973
"7236","24104","2020",6,6,0,159100,1637.66666666667,99.3333333333333
"7237","24105","2020",5,5,0,157881.6,978.8,138.8
"7238","24106","2020",7,7,0,256222.857142857,1764.71428571429,137.857142857143
"7239","24107","2020",8,8,0,92000,923.875,107.25
"7240","24108","2020",10,10,0,210285,1862.9,115.2
"7241","24109","2020",1,1,0,50000,568,88
"7242","24110","2020",1,1,0,176000,1692,104
"7243","24111","2020",1,1,0,45333,567,80
"7244","24114","2020",5,5,0,106440,1253.4,93.8
"7245","24115","2020",22,22,0,153920.454545455,1566.04545454545,99.7272727272727
"7246","24116","2020",5,5,0,91020,1317,69.6
"7247","24117","2020",3,3,0,277550,2043.33333333333,128
"7248","24119","2020",4,4,0,96058.75,1059,100
"7249","24120","2020",10,10,0,124254.8,1102.8,106.8
"7250","24121","2020",1,1,0,119500,2656,45
"7251","24122","2020",2,2,0,117500,2165,58
"7252","24123","2020",2,2,0,350169.5,2124,123
"7253","24124","2020",2,2,0,180690,1093,171.5
"7254","24126","2020",4,4,0,166750,1307.25,129.5
"7255","24128","2020",1,1,0,82000,1065,77
"7256","24129","2020",7,7,0,143912.857142857,1147.28571428571,129.857142857143
"7257","24130","2020",14,14,0,136271.428571429,1249.92857142857,111.285714285714
"7258","24131","2020",1,1,0,45000,409,110
"7259","24132","2020",2,2,0,186346,1415.5,130.5
"7260","24133","2020",22,22,0,103611.363636364,1143,104.545454545455
"7261","24134","2020",13,13,0,114961.538461538,1339,93.9230769230769
"7262","24135","2020",4,4,0,158875,1514.25,108
"7263","24137","2020",7,7,0,109571.428571429,1070.28571428571,110.571428571429
"7264","24138","2020",108,93,15,120856.648148148,1495.21296296296,81.5648148148148
"7265","24139","2020",22,22,0,197850.227272727,1731.27272727273,115.727272727273
"7266","24140","2020",17,17,0,170912.941176471,1784.52941176471,94.2352941176471
"7267","24141","2020",2,2,0,85500,836,102.5
"7268","24142","2020",21,21,0,170990.333333333,1588.38095238095,106.666666666667
"7269","24143","2020",17,17,0,160015.588235294,1685.88235294118,107.176470588235
"7270","24144","2020",3,3,0,103833.333333333,1230.33333333333,95.3333333333333
"7271","24145","2020",28,27,1,144910.035714286,1499.71428571429,101.678571428571
"7272","24146","2020",7,7,0,195495.714285714,1626.42857142857,118
"7273","24147","2020",17,16,1,104129.411764706,1187.76470588235,88.1764705882353
"7274","24148","2020",1,1,0,329200,1849,178
"7275","24150","2020",12,12,0,178790,1589.25,118.916666666667
"7276","24151","2020",2,2,0,170000,1988,92
"7277","24152","2020",14,13,1,296839.285714286,3020,119.071428571429
"7278","24153","2020",3,3,0,136883.333333333,1637,81
"7279","24154","2020",5,5,0,149200,1540.2,96.8
"7280","24155","2020",9,9,0,145565.555555556,1555.77777777778,98.2222222222222
"7281","24156","2020",18,18,0,176696,1790.5,109.222222222222
"7282","24157","2020",9,9,0,146337.777777778,1218.33333333333,113.222222222222
"7283","24158","2020",7,7,0,182950.142857143,1910.85714285714,92.4285714285714
"7284","24159","2020",9,9,0,85039.5555555556,998.111111111111,87
"7285","24160","2020",1,1,0,98000,1021,96
"7286","24161","2020",1,1,0,55150,919,60
"7287","24162","2020",7,7,0,166110,1617,106.285714285714
"7288","24163","2020",5,5,0,96400,917,103
"7289","24164","2020",10,8,2,117950,1448.1,87.5
"7290","24165","2020",6,6,0,149428.333333333,1621.16666666667,98.6666666666667
"7291","24167","2020",66,66,0,155452.742424242,1408.24242424242,112.909090909091
"7292","24168","2020",8,8,0,279103.375,2089.25,133.375
"7293","24171","2020",9,9,0,203202.777777778,1758.55555555556,118.888888888889
"7294","24172","2020",22,22,0,187514.181818182,1428.13636363636,119.5
"7295","24174","2020",2,2,0,178350,1981,112.5
"7296","24175","2020",3,3,0,208333.333333333,1912.66666666667,97
"7297","24176","2020",1,1,0,85000,850,100
"7298","24177","2020",16,16,0,206636.1875,1854.75,114.6875
"7299","24179","2020",7,7,0,216950,1743,115.571428571429
"7300","24180","2020",8,8,0,163825,1158.5,133.875
"7301","24182","2020",21,21,0,166522.714285714,1444.7619047619,126.095238095238
"7302","24183","2020",4,4,0,200625,1951.25,138.75
"7303","24184","2020",1,1,0,3e+05,2308,130
"7304","24186","2020",2,2,0,167250,1017.5,177.5
"7305","24188","2020",11,11,0,135000,1265.63636363636,110.363636363636
"7306","24189","2020",6,6,0,140057.5,1170.33333333333,118
"7307","24190","2020",4,4,0,178625,1686.25,106
"7308","24191","2020",1,1,0,65000,650,100
"7309","24192","2020",3,3,0,124416.666666667,1482,88
"7310","24193","2020",6,6,0,245250,1702.5,157.666666666667
"7311","24194","2020",30,29,1,137891.9,1232.2,115.666666666667
"7312","24196","2020",16,16,0,124081.875,1347.375,89.75
"7313","24197","2020",10,10,0,195690.6,1558,132.4
"7314","24199","2020",5,5,0,115880,963.8,124.4
"7315","24200","2020",5,5,0,150446,1305.6,114
"7316","24202","2020",2,2,0,208003,1580.5,116
"7317","24205","2020",6,6,0,200325,1490.16666666667,121.666666666667
"7318","24207","2020",16,16,0,191818.125,1782.5625,109.125
"7319","24208","2020",1,1,0,234000,936,250
"7320","24209","2020",2,2,0,66500,789,83
"7321","24210","2020",13,12,1,98008.6153846154,1369.07692307692,84.2307692307692
"7322","24211","2020",8,8,0,224578.75,1579.875,151
"7323","24212","2020",13,13,0,201088.615384615,1627.69230769231,115.923076923077
"7324","24213","2020",8,8,0,120162.5,1353.25,87.875
"7325","24214","2020",4,4,0,77517.5,1265,80.5
"7326","24215","2020",3,3,0,196133.333333333,1628,111
"7327","24216","2020",7,7,0,115104.857142857,1016.42857142857,126.285714285714
"7328","24217","2020",4,4,0,229875,2406,96.75
"7329","24218","2020",33,32,1,116820.848484848,1365.36363636364,93.4242424242424
"7330","24220","2020",5,5,0,157900,1690.4,97
"7331","24222","2020",45,44,1,157238.777777778,1440.42222222222,111.088888888889
"7332","24223","2020",54,51,3,143844.537037037,1450.96296296296,96.7222222222222
"7333","24224","2020",6,6,0,245108.333333333,1905,116.333333333333
"7334","24225","2020",31,31,0,180908.387096774,1459.22580645161,126.709677419355
"7335","24226","2020",25,25,0,152866.84,1480.68,98.92
"7336","24227","2020",9,9,0,84055.5555555556,1012.55555555556,82.5555555555556
"7337","24228","2020",6,6,0,186880,1727.83333333333,112.5
"7338","24229","2020",18,18,0,117589.111111111,1472.61111111111,79.7222222222222
"7339","24230","2020",3,3,0,106333.333333333,1039,93.6666666666667
"7340","24231","2020",2,2,0,165000,1813,91
"7341","24232","2020",1,1,0,150000,1429,105
"7342","24234","2020",7,7,0,169257.142857143,1205.28571428571,132.142857142857
"7343","24236","2020",8,8,0,139412.5,1520.5,92.375
"7344","24237","2020",21,21,0,209017.047619048,1533.38095238095,133.666666666667
"7345","24238","2020",1,1,0,50000,439,114
"7346","24240","2020",9,9,0,159783.333333333,1526.33333333333,116.555555555556
"7347","24241","2020",7,7,0,116171,1421.42857142857,103.285714285714
"7348","24242","2020",5,5,0,388900,2106.2,171
"7349","24243","2020",14,14,0,134117.142857143,1201.42857142857,116.714285714286
"7350","24244","2020",2,2,0,99275,899,114.5
"7351","24245","2020",3,3,0,264411.666666667,2193,123.333333333333
"7352","24246","2020",7,7,0,174428.571428571,1472.71428571429,119
"7353","24247","2020",6,6,0,105596.666666667,1506.83333333333,80.5
"7354","24248","2020",4,4,0,64500,846.25,71.5
"7355","24251","2020",7,7,0,197185.714285714,2198,108.428571428571
"7356","24252","2020",12,12,0,221814.166666667,1744.58333333333,122.333333333333
"7357","24253","2020",48,48,0,115114.645833333,1065.72916666667,106.770833333333
"7358","24254","2020",1,1,0,135000,1800,75
"7359","24255","2020",5,5,0,334662.8,2400.8,133.8
"7360","24256","2020",43,37,6,165321.23255814,1536.3488372093,106.116279069767
"7361","24257","2020",4,4,0,301309.5,1838.75,137.75
"7362","24259","2020",16,16,0,176522.8125,1468.5625,123.3125
"7363","24260","2020",12,12,0,184891.333333333,1697.33333333333,104.666666666667
"7364","24261","2020",8,8,0,250221.25,2307.375,111.75
"7365","24262","2020",3,3,0,159623.333333333,1199.33333333333,150
"7366","24264","2020",33,33,0,153919.878787879,1341.30303030303,118.545454545455
"7367","24266","2020",19,19,0,136715.052631579,1354.78947368421,104.368421052632
"7368","24267","2020",1,1,0,65000,793,82
"7369","24268","2020",12,12,0,233566.5,1873.33333333333,126.833333333333
"7370","24269","2020",17,17,0,74870.5882352941,930.764705882353,79.6470588235294
"7371","24271","2020",7,7,0,122984.428571429,1204.71428571429,98.8571428571429
"7372","24272","2020",9,9,0,182343.666666667,1465.66666666667,127.444444444444
"7373","24273","2020",12,12,0,172573.333333333,1645.33333333333,107.583333333333
"7374","24274","2020",14,14,0,196078.142857143,1484.42857142857,133.928571428571
"7375","24276","2020",10,10,0,203603.5,1437.2,133.5
"7376","24277","2020",8,8,0,154471.25,1563.375,97.875
"7377","24278","2020",1,1,0,155200,1338,116
"7378","24280","2020",10,10,0,165441.8,1949.5,87.2
"7379","24281","2020",2,2,0,316450,1714.5,213
"7380","24282","2020",4,4,0,164775,1297.25,128.5
"7381","24284","2020",2,2,0,103254.5,1121.5,93.5
"7382","24285","2020",6,6,0,293250,2521.16666666667,105
"7383","24286","2020",11,11,0,157011.727272727,1329.63636363636,131.454545454545
"7384","24287","2020",3,3,0,131793,1760.33333333333,65.6666666666667
"7385","24288","2020",9,9,0,142222.222222222,1327.66666666667,119.555555555556
"7386","24289","2020",21,21,0,196337.619047619,1503.14285714286,124.809523809524
"7387","24291","2020",54,50,4,126215.648148148,1453.25925925926,90.1851851851852
"7388","24292","2020",5,5,0,139797.2,1018.6,121.6
"7389","24293","2020",5,5,0,148600,1243.4,117.2
"7390","24294","2020",106,105,1,126793.820754717,1273.24528301887,101.330188679245
"7391","24295","2020",14,14,0,139321.428571429,1151.71428571429,117.285714285714
"7392","24296","2020",21,21,0,99780.9523809524,1059.90476190476,97.5714285714286
"7393","24297","2020",21,21,0,163930.714285714,1384.95238095238,123.571428571429
"7394","24299","2020",46,45,1,101073.413043478,1060.34782608696,99.2391304347826
"7395","24300","2020",2,2,0,172500,1485.5,118
"7396","24301","2020",9,9,0,143344.444444444,1562.66666666667,93.6666666666667
"7397","24302","2020",2,2,0,189018.5,1591,126.5
"7398","24303","2020",5,5,0,137326,916.8,164
"7399","24304","2020",15,15,0,162766.666666667,1331.06666666667,120.666666666667
"7400","24305","2020",2,2,0,188500,839.5,231.5
"7401","24306","2020",4,4,0,176250,1254.25,140.25
"7402","24307","2020",4,4,0,192748.75,1358.5,130.25
"7403","24308","2020",6,6,0,117581.833333333,1209.5,112
"7404","24309","2020",43,42,1,119886.534883721,1347.41860465116,91.4418604651163
"7405","24311","2020",37,36,1,95812.6756756757,1003.45945945946,102.621621621622
"7406","24312","2020",44,36,8,168295.227272727,1670.79545454545,103.181818181818
"7407","24316","2020",14,14,0,96842.1428571429,1132.71428571429,85.2142857142857
"7408","24317","2020",4,4,0,261399.75,1934.5,144.75
"7409","24318","2020",5,5,0,157940,1701.2,96.6
"7410","24319","2020",8,8,0,147255.625,1199.25,124.25
"7411","24320","2020",22,22,0,122850.954545455,1709.31818181818,80.3181818181818
"7412","24321","2020",11,9,2,140855.454545455,1253.54545454545,113.818181818182
"7413","24322","2020",545,204,341,131963.148623853,1714.26605504587,77.6642201834862
"7414","24323","2020",4,4,0,133748.75,1129,126.5
"7415","24324","2020",5,5,0,124599.6,1234.4,100.6
"7416","24325","2020",5,5,0,138220,1345.6,111.6
"7417","24327","2020",6,6,0,187729,1353.83333333333,131.833333333333
"7418","24328","2020",18,17,1,110041.666666667,1157.83333333333,96.8888888888889
"7419","24329","2020",25,25,0,111779.2,1274.88,95.28
"7420","24330","2020",7,7,0,162783,1774.28571428571,101
"7421","24331","2020",8,8,0,239220,1823.625,128.125
"7422","24334","2020",5,5,0,177400,1436,127.6
"7423","24335","2020",46,40,6,137440.782608696,1296.0652173913,109.239130434783
"7424","24336","2020",3,3,0,214666.666666667,1993,117
"7425","24337","2020",2,2,0,69750,1228,59.5
"7426","24338","2020",10,10,0,141950,1198.9,126.2
"7427","24339","2020",1,1,0,115000,1211,95
"7428","24340","2020",45,45,0,161160.555555556,1542.53333333333,104.333333333333
"7429","24341","2020",9,9,0,261560,2101,130.333333333333
"7430","24345","2020",5,5,0,194420,1545,123.2
"7431","24346","2020",4,4,0,111250,903,124.75
"7432","24348","2020",2,2,0,186753,1617,114.5
"7433","24349","2020",5,5,0,153958,1160.2,127
"7434","24350","2020",28,28,0,154422.857142857,1597.07142857143,103.535714285714
"7435","24351","2020",3,3,0,188333.333333333,1378,137
"7436","24352","2020",59,56,3,108494.813559322,1165.06779661017,94.3898305084746
"7437","24353","2020",8,8,0,95007,1363.75,86.875
"7438","24354","2020",35,35,0,120289.485714286,1212.71428571429,98.1428571428571
"7439","24355","2020",7,7,0,174926.428571429,1956.85714285714,86.5714285714286
"7440","24356","2020",33,33,0,188097.727272727,1695.93939393939,113.060606060606
"7441","24357","2020",3,3,0,202666.666666667,1237.33333333333,150
"7442","24359","2020",2,2,0,153652,1180.5,121
"7443","24360","2020",5,5,0,120600,1219.4,95.8
"7444","24361","2020",4,4,0,114850,964.5,122.5
"7445","24362","2020",30,26,4,226533.533333333,2051.63333333333,124.733333333333
"7446","24364","2020",10,10,0,192732.5,1260,168.5
"7447","24365","2020",4,4,0,262212.5,1804,153.25
"7448","24366","2020",6,6,0,168531.833333333,1756.66666666667,97.3333333333333
"7449","24367","2020",4,4,0,211762.5,1423.25,155
"7450","24370","2020",19,19,0,158048.684210526,1479.73684210526,101.578947368421
"7451","24371","2020",13,13,0,152003.384615385,1430.76923076923,104
"7452","24372","2020",70,59,11,132102.142857143,1338.48571428571,94.6142857142857
"7453","24373","2020",3,3,0,123333.333333333,1161.33333333333,109.333333333333
"7454","24374","2020",6,6,0,137358.333333333,1414.16666666667,98.1666666666667
"7455","24375","2020",1,1,0,165000,1634,101
"7456","24376","2020",22,21,1,123813.363636364,1208.27272727273,105.772727272727
"7457","24377","2020",1,1,0,414000,1800,230
"7458","24378","2020",1,1,0,140000,3182,44
"7459","24379","2020",8,8,0,130000,1314.25,97.125
"7460","24380","2020",8,8,0,103500,1347.125,77.625
"7461","24381","2020",2,2,0,48484,1081,52.5
"7462","24382","2020",8,8,0,147706.25,1201.125,122.875
"7463","24383","2020",5,5,0,182305,1446.6,122.8
"7464","24384","2020",1,1,0,421000,2631,160
"7465","24385","2020",2,2,0,277500,1913.5,135.5
"7466","24386","2020",5,5,0,184008,1776,112.4
"7467","24388","2020",12,12,0,192799.333333333,1506.58333333333,123.75
"7468","24390","2020",1,1,0,202950,1664,122
"7469","24392","2020",6,6,0,246049.666666667,1920.66666666667,131.333333333333
"7470","24393","2020",3,3,0,232000,1409.33333333333,150
"7471","24394","2020",1,1,0,208000,2059,101
"7472","24395","2020",13,13,0,170027.692307692,1902.30769230769,96.0769230769231
"7473","24396","2020",31,31,0,161076.161290323,1665.38709677419,101.709677419355
"7474","24397","2020",1,1,0,45000,346,130
"7475","24398","2020",13,13,0,122024.461538462,1117.38461538462,110.923076923077
"7476","24401","2020",1,1,0,131570,1115,118
"7477","24403","2020",1,1,0,525430,2421,217
"7478","24404","2020",1,1,0,184500,1538,120
"7479","24405","2020",3,3,0,117333.333333333,1065.33333333333,108
"7480","24406","2020",1,1,0,168000,1680,100
"7481","24407","2020",5,5,0,165080,1647.8,105.6
"7482","24408","2020",1,1,0,61000,504,121
"7483","24409","2020",15,15,0,102711.333333333,1319.26666666667,78.4
"7484","24410","2020",2,2,0,157015,1022.5,172
"7485","24411","2020",2,2,0,125000,1234.5,101
"7486","24412","2020",13,12,1,220107.692307692,2220.07692307692,99.7692307692308
"7487","24413","2020",1,1,0,162590,1232,132
"7488","24414","2020",8,8,0,213357.5,1986,109.875
"7489","24415","2020",4,4,0,221842.5,1901.5,109.75
"7490","24416","2020",1,1,0,115000,1438,80
"7491","24417","2020",9,9,0,143535,1118.11111111111,124.666666666667
"7492","24418","2020",23,23,0,106791.47826087,1055.17391304348,98.695652173913
"7493","24419","2020",9,9,0,155264.444444444,1348.55555555556,117
"7494","24420","2020",3,3,0,89666.6666666667,730.666666666667,131.666666666667
"7495","24423","2020",2,2,0,125470,984.5,127.5
"7496","24425","2020",10,10,0,100318,1121.2,92.4
"7497","24428","2020",10,10,0,149628.8,1568.9,98.7
"7498","24429","2020",3,3,0,184466.666666667,1267.66666666667,132
"7499","24432","2020",11,11,0,166371.363636364,1841.09090909091,94.1818181818182
"7500","24436","2020",13,12,1,113030.769230769,1195.53846153846,93
"7501","24437","2020",9,9,0,220224.777777778,1647.88888888889,135.444444444444
"7502","24438","2020",5,5,0,226954.2,1959.2,118.2
"7503","24441","2020",1,1,0,205580,1581,130
"7504","24442","2020",24,24,0,146209.791666667,1415.625,98.2916666666667
"7505","24443","2020",3,3,0,168333.333333333,2050.33333333333,83.6666666666667
"7506","24444","2020",1,1,0,105000,1721,61
"7507","24445","2020",3,3,0,175666.666666667,1631,101
"7508","24448","2020",2,2,0,103200,819.5,130
"7509","24449","2020",25,25,0,122160.96,1200.36,102.76
"7510","24450","2020",8,8,0,170096.25,1823.875,95.5
"7511","24451","2020",12,12,0,98475,1006.25,97.25
"7512","24452","2020",3,3,0,457500,2528.66666666667,175.333333333333
"7513","24453","2020",6,6,0,151833.333333333,1198.33333333333,135.5
"7514","24454","2020",7,7,0,101500,1348.42857142857,76.7142857142857
"7515","24455","2020",5,5,0,86588,836.6,102.2
"7516","24456","2020",2,2,0,296800,1422,236.5
"7517","24457","2020",2,2,0,155000,1121.5,141.5
"7518","24458","2020",2,2,0,159500,1050.5,161
"7519","24459","2020",2,2,0,280000,1750,138
"7520","24460","2020",8,8,0,111157.75,1277.75,106.75
"7521","24461","2020",13,13,0,145823.076923077,1494,94.6923076923077
"7522","24462","2020",17,17,0,123569.411764706,1098.82352941176,105.235294117647
"7523","24463","2020",7,7,0,79000,1059.28571428571,75.8571428571429
"7524","24464","2020",6,6,0,102333.333333333,1470,89.8333333333333
"7525","24465","2020",3,3,0,95300,689.333333333333,135.333333333333
"7526","24466","2020",5,5,0,106200,1104.2,93.2
"7527","24470","2020",5,5,0,344625.4,3410,135.4
"7528","24471","2020",5,5,0,233910,1762.6,141.4
"7529","24472","2020",11,11,0,167557.272727273,1523.45454545455,107.909090909091
"7530","24473","2020",8,8,0,110013.125,1061.125,108.75
"7531","24474","2020",1,1,0,147850,770,192
"7532","24476","2020",1,1,0,148950,828,180
"7533","24477","2020",1,1,0,140000,1077,130
"7534","24479","2020",20,20,0,109436.75,1157.95,96.25
"7535","24480","2020",1,1,0,170000,1717,99
"7536","24481","2020",8,8,0,145562.5,1321.25,104.25
"7537","24482","2020",8,8,0,166468.875,1707.625,110.625
"7538","24483","2020",2,2,0,111825,1497.5,76.5
"7539","24484","2020",10,10,0,120470,1367.7,85.9
"7540","24485","2020",8,7,1,105649.75,1250,92.875
"7541","24486","2020",5,5,0,161200,1466.6,103.4
"7542","24487","2020",20,20,0,132407.25,1411.8,94.3
"7543","24488","2020",4,4,0,90750,1208.75,75.75
"7544","24489","2020",5,5,0,117980,1224.6,99
"7545","24490","2020",11,11,0,102256.818181818,1114.90909090909,92.4545454545455
"7546","24491","2020",6,6,0,105666.666666667,1292,85.6666666666667
"7547","24493","2020",3,3,0,224000,1621.66666666667,117
"7548","24494","2020",6,6,0,158876.666666667,1377,112
"7549","24495","2020",2,2,0,119980,1365.5,90.5
"7550","24496","2020",4,4,0,134750,1309.25,108.25
"7551","24498","2020",23,23,0,114325.217391304,1038.17391304348,118.478260869565
"7552","24499","2020",9,9,0,143312.666666667,1621.44444444444,90.6666666666667
"7553","24501","2020",5,5,0,216802,1288.8,142
"7554","24502","2020",1,1,0,225000,1324,170
"7555","24504","2020",2,2,0,128200,1089.5,125
"7556","24505","2020",5,5,0,87044,1016.4,91.6
"7557","24507","2020",1,1,0,75000,882,85
"7558","24508","2020",1,1,0,30000,400,75
"7559","24509","2020",7,7,0,93238.5714285714,974.571428571429,88.5714285714286
"7560","24510","2020",9,9,0,300673.777777778,2743,118.111111111111
"7561","24511","2020",2,2,0,120000,1290.5,93.5
"7562","24512","2020",3,3,0,172245,1835.33333333333,93.6666666666667
"7563","24513","2020",6,6,0,132250,1321.33333333333,91.6666666666667
"7564","24514","2020",4,4,0,181209.25,1310.25,152
"7565","24516","2020",9,9,0,229089.888888889,4170.88888888889,77.7777777777778
"7566","24517","2020",1,1,0,90000,900,100
"7567","24518","2020",3,3,0,60333.3333333333,946.333333333333,65.6666666666667
"7568","24519","2020",7,7,0,128785.714285714,1448.57142857143,90.2857142857143
"7569","24520","2020",179,111,68,148849.56424581,1786.50837988827,86.1675977653631
"7570","24521","2020",14,14,0,137167.285714286,1300.21428571429,115.071428571429
"7571","24522","2020",8,8,0,117187.5,1191.25,95
"7572","24523","2020",2,2,0,135000,1449.5,94
"7573","24524","2020",2,2,0,151296.5,1176.5,129
"7574","24526","2020",9,9,0,93411.2222222222,1138.77777777778,81.4444444444444
"7575","24527","2020",11,11,0,168895.454545455,1414.90909090909,128.818181818182
"7576","24531","2020",3,3,0,157666.666666667,1441.33333333333,115.333333333333
"7577","24532","2020",1,1,0,330000,3173,104
"7578","24533","2020",1,1,0,125000,658,190
"7579","24534","2020",17,17,0,165845.294117647,1289.11764705882,134.294117647059
"7580","24535","2020",5,5,0,213938.8,1571.4,132.2
"7581","24536","2020",5,5,0,130970,1312.2,100.2
"7582","24537","2020",2,2,0,131084.5,983.5,129.5
"7583","24538","2020",18,18,0,122348.166666667,1274.5,97.9444444444444
"7584","24540","2020",18,18,0,139155.555555556,1214,119.555555555556
"7585","24543","2020",19,19,0,138628.947368421,1380.47368421053,99.7894736842105
"7586","24544","2020",4,4,0,267875,1975.25,121.25
"7587","24545","2020",2,2,0,110817.5,741,150.5
"7588","24547","2020",124,100,24,108786.008064516,1410.81451612903,79.2258064516129
"7589","24548","2020",6,6,0,146913.333333333,1164,121.5
"7590","24549","2020",12,12,0,289324.916666667,1615.25,153.416666666667
"7591","24550","2020",15,14,1,181386.666666667,1439.93333333333,116.4
"7592","24551","2020",40,33,7,112351.9,1043.35,103.775
"7593","24552","2020",4,4,0,136500,1686.5,80.5
"7594","24553","2020",20,20,0,125312.2,1285.6,100.75
"7595","24554","2020",7,7,0,88396.4285714286,767,115.857142857143
"7596","24555","2020",10,10,0,129900,1256.2,108.7
"7597","24557","2020",115,80,35,137446.052173913,1575.6,86.0782608695652
"7598","24558","2020",11,11,0,153268.181818182,1792.27272727273,104.454545454545
"7599","24559","2020",5,5,0,195536,2007.6,104.8
"7600","24560","2020",2,2,0,334412.5,1452,202
"7601","24562","2020",1,1,0,120000,1600,75
"7602","24563","2020",7,7,0,262577.428571429,2479.71428571429,128
"7603","24564","2020",10,10,0,114984,1309.8,91
"7604","24565","2020",7,7,0,109857.142857143,1040.85714285714,112.857142857143
"7605","24566","2020",7,7,0,100754.714285714,1138.14285714286,86.8571428571429
"7606","24567","2020",3,3,0,179466.666666667,2040.33333333333,81.3333333333333
"7607","24568","2020",20,20,0,132414.9,1285.15,108.7
"7608","24569","2020",2,2,0,220250,2675.5,104.5
"7609","24571","2020",23,21,2,165261.47826087,1457.08695652174,112.347826086957
"7610","24572","2020",3,3,0,160000,1447.66666666667,117
"7611","24573","2020",10,10,0,97522.3,1123.8,90.2
"7612","24574","2020",7,7,0,164414.285714286,1842.14285714286,97.4285714285714
"7613","24575","2020",6,6,0,210916.666666667,1962.33333333333,100.166666666667
"7614","24576","2020",4,4,0,191750,1475.25,140
"7615","24577","2020",11,11,0,234334.363636364,2030.72727272727,135.545454545455
"7616","24580","2020",3,3,0,156166.666666667,1826.66666666667,80.6666666666667
"7617","24581","2020",11,11,0,128363.636363636,1458.27272727273,107.272727272727
"7618","24582","2020",4,4,0,97625,870.25,114.75
"7619","24584","2020",21,21,0,147420,1245.90476190476,115
"7620","24585","2020",6,5,1,77583.3333333333,784.5,97.3333333333333
"7621","24586","2020",7,7,0,154449,1383.14285714286,129.857142857143
"7622","24587","2020",8,8,0,247368.125,1910.875,120
"7623","25001","2020",2,2,0,313000,884.5,354
"7624","25002","2020",2,2,0,192000,1869,124
"7625","25003","2020",6,5,1,120300,1026.5,116.166666666667
"7626","25004","2020",11,8,3,173320.454545455,1727.18181818182,104.181818181818
"7627","25005","2020",3,3,0,151133.333333333,1640.33333333333,92.6666666666667
"7628","25007","2020",1,1,0,275000,2723,101
"7629","25008","2020",7,7,0,175428.571428571,1741.28571428571,104.714285714286
"7630","25011","2020",4,4,0,155850,1126.75,144
"7631","25012","2020",5,5,0,234718,1937.2,118.4
"7632","25014","2020",8,8,0,166217.5,1555.125,113.5
"7633","25015","2020",6,5,1,150498.333333333,1303,131
"7634","25016","2020",2,2,0,81012.5,889,97
"7635","25017","2020",1,1,0,210976,1803,117
"7636","25018","2020",9,9,0,148077.777777778,1410.11111111111,104.111111111111
"7637","25019","2020",4,4,0,156875,1324.5,133.25
"7638","25020","2020",8,5,3,101273,1351.25,74.75
"7639","25021","2020",16,16,0,171775,2101.625,106.5625
"7640","25022","2020",17,17,0,178949.647058824,1531.94117647059,117.176470588235
"7641","25024","2020",6,3,3,248873.666666667,2424.66666666667,99.6666666666667
"7642","25025","2020",6,5,1,213363.333333333,2028.5,108.166666666667
"7643","25026","2020",5,4,1,180900,1392.8,130.2
"7644","25029","2020",4,4,0,146926.25,1658.75,97
"7645","25030","2020",4,4,0,181050,2163.25,85.25
"7646","25031","2020",142,82,60,108460.838028169,1336.19014084507,83.9295774647887
"7647","25032","2020",2,2,0,213000,2111.5,102
"7648","25033","2020",6,6,0,133291.666666667,1224.33333333333,122.333333333333
"7649","25035","2020",27,22,5,227325.962962963,2375.48148148148,99.2222222222222
"7650","25036","2020",22,19,3,218889.545454545,1992.77272727273,112.045454545455
"7651","25038","2020",4,4,0,183725,1617.75,116
"7652","25039","2020",6,6,0,194827.333333333,1567.83333333333,118.333333333333
"7653","25040","2020",4,3,1,156000,1746,93
"7654","25041","2020",4,3,1,248257.5,2366.75,109.25
"7655","25042","2020",2,2,0,182500,1644.5,121.5
"7656","25043","2020",20,17,3,181365,1519.05,114.5
"7657","25047","2020",68,31,37,117888.970588235,1371.98529411765,83.4264705882353
"7658","25048","2020",36,27,9,133752.444444444,1476.25,92.3055555555556
"7659","25049","2020",1,1,0,105174,965,109
"7660","25050","2020",4,4,0,257830,1494.25,191.75
"7661","25051","2020",8,6,2,151717,1224.875,123
"7662","25052","2020",1,1,0,25000,962,26
"7663","25053","2020",1,1,0,102500,645,159
"7664","25054","2020",6,6,0,232508.333333333,1846.5,123.166666666667
"7665","25055","2020",3,3,0,188100,2403.66666666667,81
"7666","25056","2020",1860,231,1629,134120.547849462,1957.23010752688,69.0650537634409
"7667","25057","2020",42,32,10,115192.404761905,1256.95238095238,92.4047619047619
"7668","25058","2020",14,8,6,144882.142857143,1888.64285714286,76.3571428571429
"7669","25059","2020",7,6,1,208028.142857143,1712.42857142857,136.428571428571
"7670","25060","2020",11,8,3,219654.545454545,2107.36363636364,116.181818181818
"7671","25062","2020",3,3,0,232000,1597,145.666666666667
"7672","25063","2020",13,10,3,182084.615384615,1717.69230769231,111.384615384615
"7673","25066","2020",1,1,0,115000,1237,93
"7674","25067","2020",2,2,0,233000,2035,114
"7675","25070","2020",2,2,0,162030,1058.5,156.5
"7676","25071","2020",7,5,2,191148.571428571,1690.42857142857,110.285714285714
"7677","25073","2020",11,9,2,180097.909090909,1688.27272727273,112.363636363636
"7678","25074","2020",8,7,1,221987.5,2133.875,109.5
"7679","25075","2020",6,6,0,263593.666666667,2299.66666666667,114.833333333333
"7680","25078","2020",8,8,0,178750,1821,101.25
"7681","25079","2020",5,3,2,163633.2,1691,98.8
"7682","25082","2020",7,7,0,137214.285714286,1443.28571428571,88.1428571428571
"7683","25083","2020",2,2,0,63500,1061,58.5
"7684","25084","2020",14,13,1,234671.285714286,2180.85714285714,109.5
"7685","25085","2020",3,3,0,253000,2151,134.666666666667
"7686","25087","2020",3,3,0,86066.6666666667,984.333333333333,90.6666666666667
"7687","25088","2020",1,1,0,140000,1556,90
"7688","25090","2020",1,1,0,80000,615,130
"7689","25091","2020",7,5,2,216942.857142857,2103.71428571429,105.142857142857
"7690","25093","2020",1,1,0,169500,1630,104
"7691","25095","2020",3,3,0,111000,1544.33333333333,69.6666666666667
"7692","25097","2020",3,3,0,163333.333333333,1361.66666666667,115.666666666667
"7693","25098","2020",4,4,0,154450,1747,112
"7694","25099","2020",1,1,0,277500,1461,190
"7695","25100","2020",5,2,3,174800,1744.6,100.6
"7696","25101","2020",4,4,0,218937.5,2075.5,107.25
"7697","25103","2020",4,4,0,205413.5,1687.25,125.25
"7698","25105","2020",7,6,1,113707.142857143,1390.14285714286,86.2857142857143
"7699","25107","2020",3,3,0,136343.333333333,951,147
"7700","25108","2020",3,2,1,162116.666666667,2211,72.3333333333333
"7701","25109","2020",5,5,0,173780,1762,100.4
"7702","25110","2020",9,7,2,247044.444444444,2219.55555555556,118
"7703","25111","2020",4,4,0,160225,1642.75,92
"7704","25112","2020",21,7,14,119837.19047619,1828.61904761905,65.6666666666667
"7705","25114","2020",4,4,0,89000,862.5,106.75
"7706","25115","2020",2,1,1,158950,1818,89
"7707","25116","2020",3,3,0,127000,1438.33333333333,94.3333333333333
"7708","25117","2020",1,1,0,124000,954,130
"7709","25119","2020",3,3,0,221950,1926.66666666667,111.333333333333
"7710","25120","2020",5,5,0,146820,1284.2,113
"7711","25121","2020",11,4,7,219811.545454545,3965.72727272727,65.8181818181818
"7712","25122","2020",5,3,2,206400,2280.2,89.8
"7713","25124","2020",4,4,0,185862.5,1652.75,129.5
"7714","25125","2020",4,4,0,129175,1174,137.25
"7715","25126","2020",6,6,0,195266.666666667,1855.66666666667,105.666666666667
"7716","25127","2020",42,16,26,180989.428571429,1994.16666666667,91.8571428571429
"7717","25129","2020",2,2,0,170500,1416.5,116.5
"7718","25131","2020",2,1,1,208300,2782.5,114.5
"7719","25132","2020",2,2,0,109750,1500.5,65.5
"7720","25133","2020",21,20,1,267709.619047619,2154.57142857143,125.333333333333
"7721","25136","2020",4,4,0,198380,1902.5,106.5
"7722","25138","2020",1,1,0,74500,876,85
"7723","25139","2020",6,5,1,276372.5,2152.83333333333,130.166666666667
"7724","25141","2020",1,1,0,95000,1357,70
"7725","25142","2020",12,9,3,231725.5,2459.08333333333,87.6666666666667
"7726","25143","2020",3,3,0,135833.333333333,886.666666666667,148.333333333333
"7727","25145","2020",1,1,0,136400,822,166
"7728","25147","2020",16,14,2,223507,2375.5625,97.375
"7729","25148","2020",6,6,0,285565,2601.5,109.333333333333
"7730","25149","2020",4,4,0,193450,1636,129.5
"7731","25150","2020",4,4,0,188551.25,1659.25,113.25
"7732","25151","2020",5,5,0,184700,1834,103
"7733","25152","2020",1,1,0,265000,1978,134
"7734","25154","2020",2,2,0,158300,1734,98.5
"7735","25155","2020",3,3,0,154105,1447.33333333333,104.666666666667
"7736","25156","2020",12,12,0,111366.666666667,878.166666666667,124.5
"7737","25157","2020",19,7,12,200243.157894737,2518.68421052632,84.8421052631579
"7738","25159","2020",14,11,3,136378.571428571,1393,104.857142857143
"7739","25160","2020",10,9,1,244664.7,2689.3,95.7
"7740","25161","2020",1,1,0,80000,630,127
"7741","25162","2020",3,3,0,154885.666666667,1535,105.333333333333
"7742","25164","2020",1,1,0,188820,1642,115
"7743","25170","2020",23,16,7,160354.130434783,1602.4347826087,97.9130434782609
"7744","25171","2020",2,2,0,205600,1794.5,116
"7745","25172","2020",3,3,0,126900,2829.33333333333,44.3333333333333
"7746","25173","2020",7,6,1,120083.571428571,1537.71428571429,90.7142857142857
"7747","25174","2020",2,2,0,161000,840.5,182.5
"7748","25175","2020",1,1,0,236000,1573,150
"7749","25176","2020",8,7,1,240833.75,2192.625,120.5
"7750","25177","2020",3,3,0,94333.3333333333,1061,89.6666666666667
"7751","25178","2020",2,2,0,95000,905,104
"7752","25179","2020",1,1,0,280500,2004,140
"7753","25181","2020",4,4,0,90348.75,943,92.25
"7754","25182","2020",1,1,0,150500,752,200
"7755","25184","2020",1,1,0,140000,1186,118
"7756","25185","2020",1,1,0,1e+05,690,145
"7757","25186","2020",13,12,1,238831.538461538,2067.61538461538,113.846153846154
"7758","25187","2020",9,7,2,157740,1328.88888888889,123.888888888889
"7759","25188","2020",8,7,1,198396.25,1851.375,108.25
"7760","25189","2020",1,1,0,195000,1560,125
"7761","25190","2020",29,22,7,137090.103448276,1432.58620689655,95.9310344827586
"7762","25191","2020",2,2,0,127500,1357.5,95
"7763","25192","2020",2,2,0,63750,1416,48
"7764","25193","2020",20,14,6,157227.5,1749.6,87.85
"7765","25194","2020",1,1,0,129000,1518,85
"7766","25195","2020",17,14,3,205245.352941176,2086.23529411765,100.941176470588
"7767","25196","2020",18,9,9,101915.277777778,1209.61111111111,82.5
"7768","25197","2020",11,3,8,100858.181818182,1378,74.0909090909091
"7769","25198","2020",4,4,0,226525,1584.25,132
"7770","25199","2020",2,2,0,180000,2478.5,72.5
"7771","25200","2020",12,12,0,258479.166666667,2386.66666666667,104.666666666667
"7772","25201","2020",10,5,5,210816,2342.6,93.3
"7773","25202","2020",4,1,3,164700,1851,99
"7774","25203","2020",1,1,0,125000,781,160
"7775","25204","2020",47,16,31,227073.765957447,2628.04255319149,89.1276595744681
"7776","25207","2020",8,8,0,239443.75,1819.125,146.75
"7777","25208","2020",3,3,0,201850,1764.66666666667,122.666666666667
"7778","25209","2020",1,1,0,229500,1530,150
"7779","25210","2020",4,4,0,195143,1611.75,129
"7780","25211","2020",1,1,0,165000,1320,125
"7781","25212","2020",24,19,5,257191.041666667,2216.79166666667,119.125
"7782","25213","2020",7,7,0,268373.714285714,2242.28571428571,127.142857142857
"7783","25214","2020",3,3,0,208666.666666667,1601.66666666667,124.666666666667
"7784","25215","2020",1,1,0,160000,1333,120
"7785","25216","2020",2,2,0,153101,1806.5,86
"7786","25217","2020",8,8,0,157131.25,1864.125,90.625
"7787","25218","2020",5,5,0,241281.2,2030.4,122.4
"7788","25219","2020",2,2,0,169400,1901.5,110
"7789","25220","2020",6,6,0,181508.333333333,1499.5,123.5
"7790","25221","2020",2,1,1,100500,1125,108
"7791","25222","2020",17,13,4,200302.941176471,1945.64705882353,105.352941176471
"7792","25223","2020",4,4,0,158750,1259.5,133.5
"7793","25224","2020",7,6,1,151921.428571429,1282.14285714286,113.142857142857
"7794","25225","2020",1,1,0,305500,1946,157
"7795","25226","2020",2,2,0,166640,911.5,181.5
"7796","25228","2020",40,31,9,156729.25,1772.25,86.475
"7797","25229","2020",2,0,2,111000,1472,76
"7798","25230","2020",45,37,8,133433.333333333,1465.62222222222,92.5111111111111
"7799","25231","2020",1,1,0,218500,1466,149
"7800","25232","2020",1,0,1,65000,1016,64
"7801","25233","2020",3,3,0,225223.333333333,1765.66666666667,129
"7802","25235","2020",1,1,0,247000,1843,134
"7803","25236","2020",2,2,0,196135,2343,84
"7804","25237","2020",29,18,11,121731.034482759,1436.27586206897,84.551724137931
"7805","25238","2020",2,2,0,108355,2796,73
"7806","25239","2020",2,2,0,164000,1110,142.5
"7807","25240","2020",29,21,8,279154.827586207,2662.58620689655,107.172413793103
"7808","25241","2020",2,2,0,182500,1629,112
"7809","25243","2020",8,7,1,261289.375,2229.5,113.875
"7810","25244","2020",6,6,0,135000,1019.33333333333,123.166666666667
"7811","25245","2020",7,5,2,213708.571428571,1796,121
"7812","25246","2020",4,4,0,122206.25,1027,129.25
"7813","25247","2020",2,2,0,96750,1071,92.5
"7814","25248","2020",7,7,0,257689.285714286,1851.57142857143,154.285714285714
"7815","25249","2020",1,1,0,119500,1406,85
"7816","25253","2020",4,4,0,95822.5,1105,101.25
"7817","25254","2020",19,4,15,197866.315789474,2481.21052631579,84
"7818","25255","2020",4,2,2,171125,2150,93.5
"7819","25256","2020",16,10,6,174625,1851.25,95.25
"7820","25257","2020",3,3,0,198950,1713.66666666667,105
"7821","25258","2020",23,21,2,195285.304347826,1975.34782608696,102.652173913043
"7822","25259","2020",29,18,11,187598.965517241,1807.65517241379,106.310344827586
"7823","25263","2020",1,1,0,150000,1145,131
"7824","25264","2020",1,1,0,40000,556,72
"7825","25265","2020",18,13,5,217172.222222222,2189,97
"7826","25266","2020",1,1,0,45000,643,70
"7827","25268","2020",1,1,0,180000,2143,84
"7828","25270","2020",1,1,0,233300,1248,187
"7829","25271","2020",17,9,8,206167.411764706,2129.47058823529,101.588235294118
"7830","25274","2020",5,5,0,170870,1433,103.6
"7831","25278","2020",3,3,0,149866.666666667,1446.33333333333,104.666666666667
"7832","25279","2020",1,1,0,50000,446,112
"7833","25280","2020",6,5,1,204683.333333333,1776.66666666667,114.666666666667
"7834","25281","2020",5,4,1,149870,1475.6,104.8
"7835","25282","2020",8,6,2,211000,1787.75,121.125
"7836","25284","2020",45,28,17,117471.355555556,1321.68888888889,87.0222222222222
"7837","25285","2020",19,14,5,240578.684210526,2556.47368421053,98.6315789473684
"7838","25287","2020",17,17,0,231020.647058824,2332.23529411765,100.352941176471
"7839","25288","2020",9,9,0,248555.555555556,2349.11111111111,118
"7840","25290","2020",1,1,0,233500,1557,150
"7841","25293","2020",20,10,10,272168.75,2995.2,92.8
"7842","25295","2020",8,3,5,249437.5,3028.125,84.875
"7843","25296","2020",7,6,1,286385.714285714,2714.14285714286,109.142857142857
"7844","25297","2020",1,1,0,443270,2297,193
"7845","25298","2020",3,3,0,167600,1524.33333333333,112.333333333333
"7846","25299","2020",1,1,0,79000,898,88
"7847","25300","2020",2,2,0,146000,1692,92.5
"7848","25301","2020",5,4,1,249690,1884.4,135.4
"7849","25303","2020",2,2,0,260000,1472,169.5
"7850","25304","2020",43,22,21,103015.348837209,1180.83720930233,86.6279069767442
"7851","25305","2020",3,3,0,213233.333333333,1823.66666666667,115.666666666667
"7852","25307","2020",23,11,12,250221,3062.69565217391,82.4782608695652
"7853","25308","2020",1,0,1,90000,3103,29
"7854","25309","2020",11,10,1,248981.818181818,2400.36363636364,102.363636363636
"7855","25310","2020",2,2,0,107575,608.5,170
"7856","25311","2020",1,1,0,124000,2033,61
"7857","25313","2020",2,2,0,78500,1287.5,61.5
"7858","25314","2020",5,5,0,166600,1564.8,111.8
"7859","25315","2020",44,40,4,124422.727272727,1321.54545454545,97.4318181818182
"7860","25316","2020",2,2,0,195250,1786,107.5
"7861","25317","2020",3,3,0,202900,1699,125
"7862","25318","2020",25,9,16,202914.16,2885.76,70.8
"7863","25320","2020",16,4,12,219112.6875,2726.9375,80.125
"7864","25321","2020",86,39,47,224680.988372093,2677.75581395349,84.8488372093023
"7865","25322","2020",6,6,0,202050,1843.83333333333,111.333333333333
"7866","25323","2020",4,3,1,126875,1444.75,87
"7867","25324","2020",1,1,0,184100,1227,150
"7868","25325","2020",1,1,0,262000,1344,195
"7869","25326","2020",1,1,0,80000,1143,70
"7870","25328","2020",1,1,0,130500,1305,100
"7871","25329","2020",1,1,0,115000,898,128
"7872","25331","2020",2,2,0,125000,892.5,138
"7873","25332","2020",4,3,1,183070,1980.5,93
"7874","25333","2020",3,3,0,184400,1488,126.666666666667
"7875","25334","2020",25,19,6,200296.84,2222.92,102.24
"7876","25335","2020",1,1,0,117740,1840,64
"7877","25336","2020",5,5,0,97320,1083.2,84.2
"7878","25338","2020",2,1,1,183875,1875.5,98.5
"7879","25339","2020",6,4,2,119447,1072.33333333333,104.333333333333
"7880","25340","2020",2,2,0,115550,1581.5,71.5
"7881","25341","2020",1,1,0,209000,1215,172
"7882","25342","2020",2,2,0,215000,1783.5,120
"7883","25343","2020",2,2,0,140575,1803.5,79
"7884","25344","2020",1,1,0,50000,610,82
"7885","25345","2020",5,5,0,171240,1880.4,97
"7886","25346","2020",1,1,0,167000,1637,102
"7887","25347","2020",3,3,0,235046.666666667,1577.33333333333,159.333333333333
"7888","25348","2020",15,9,6,235318.133333333,2682.6,93.1333333333333
"7889","25349","2020",6,6,0,170666.666666667,1849.5,98.3333333333333
"7890","25350","2020",10,10,0,120769.2,1160.4,102.7
"7891","25351","2020",1,1,0,287640,2339,123
"7892","25354","2020",3,3,0,176245.333333333,1023,173.666666666667
"7893","25356","2020",59,28,31,162470.169491525,1979.67796610169,82.864406779661
"7894","25357","2020",6,6,0,211916.666666667,2384.83333333333,92.1666666666667
"7895","25359","2020",2,2,0,138400,1100.5,118
"7896","25360","2020",1,1,0,222700,1626,137
"7897","25361","2020",18,5,13,209781.055555556,2847.16666666667,73.7777777777778
"7898","25362","2020",8,2,6,232575.125,2201,109.75
"7899","25364","2020",14,14,0,174187.857142857,1873.42857142857,94.5714285714286
"7900","25365","2020",6,6,0,132925,1390.66666666667,104.5
"7901","25366","2020",2,2,0,285200,2339,122.5
"7902","25367","2020",48,35,13,106855.645833333,1305.08333333333,84.4166666666667
"7903","25368","2020",9,8,1,188352.222222222,1857,107.777777777778
"7904","25369","2020",3,3,0,108760,965,110.666666666667
"7905","25370","2020",16,13,3,124568.75,1263,99.1875
"7906","25371","2020",1,1,0,563200,3634,155
"7907","25372","2020",3,3,0,86666.6666666667,819.666666666667,104
"7908","25373","2020",5,5,0,241440,1887.6,151.2
"7909","25374","2020",3,3,0,177000,1959.33333333333,90
"7910","25375","2020",4,4,0,231267.5,2129.75,109.5
"7911","25376","2020",2,2,0,266500,2299.5,115.5
"7912","25377","2020",2,2,0,123150,1070.5,104.5
"7913","25378","2020",5,3,2,110880,1635,67.6
"7914","25379","2020",1,1,0,85600,2038,42
"7915","25380","2020",105,41,64,138921.723809524,3347.33333333333,41.8380952380952
"7916","25381","2020",28,23,5,254598.892857143,2312.5,113.821428571429
"7917","25382","2020",11,10,1,190086.363636364,1749.63636363636,113.363636363636
"7918","25383","2020",1,1,0,192000,2233,86
"7919","25384","2020",1,1,0,117500,1088,108
"7920","25386","2020",2,2,0,59280,1326.5,44.5
"7921","25387","2020",7,7,0,191454.285714286,1525,122.428571428571
"7922","25388","2020",296,84,212,91328.4189189189,1173.16891891892,77.0236486486486
"7923","25389","2020",2,2,0,231935,1911.5,119.5
"7924","25390","2020",4,1,3,176977.5,2156.5,80.75
"7925","25391","2020",3,3,0,298466.666666667,2210.33333333333,130.666666666667
"7926","25392","2020",2,2,0,170600,1753.5,92
"7927","25393","2020",5,5,0,119880,1418,98.2
"7928","25394","2020",10,10,0,141601,1329.4,105.5
"7929","25395","2020",20,15,5,266033,2194,119.7
"7930","25397","2020",24,13,11,180063.333333333,1860.16666666667,94.625
"7931","25398","2020",1,1,0,320000,3951,81
"7932","25400","2020",5,3,2,115079.8,1208.4,88.6
"7933","25403","2020",31,12,19,229796.290322581,2671.1935483871,88.6774193548387
"7934","25404","2020",2,2,0,2e+05,1939,104
"7935","25405","2020",9,8,1,293632.444444444,3520.77777777778,93.4444444444444
"7936","25406","2020",6,6,0,152134.166666667,1453.33333333333,109.666666666667
"7937","25408","2020",1,1,0,30000,353,85
"7938","25410","2020",17,16,1,192694.705882353,1912.05882352941,102.823529411765
"7939","25411","2020",116,33,83,195915.801724138,2496,79.8448275862069
"7940","25413","2020",34,9,25,154048.088235294,1930.52941176471,79.0294117647059
"7941","25414","2020",3,3,0,166500,1559,114.333333333333
"7942","25415","2020",8,7,1,168812.5,1125.75,147.375
"7943","25416","2020",4,4,0,183574.75,1316,128.25
"7944","25417","2020",5,5,0,202800,2166,97
"7945","25418","2020",18,14,4,193542.777777778,1892.77777777778,103.611111111111
"7946","25420","2020",3,2,1,118743.333333333,682.666666666667,177.666666666667
"7947","25422","2020",1,1,0,120000,2222,54
"7948","25424","2020",14,14,0,161946.928571429,1602.07142857143,102.857142857143
"7949","25425","2020",3,3,0,321200,2802,117.333333333333
"7950","25426","2020",5,3,2,125520,1171.2,108
"7951","25427","2020",2,2,0,180500,1617.5,109
"7952","25428","2020",20,18,2,170813.65,1736.4,97.25
"7953","25429","2020",9,8,1,185652.222222222,2049.55555555556,87.7777777777778
"7954","25431","2020",6,6,0,177233.333333333,1351.33333333333,133
"7955","25432","2020",25,15,10,172285.2,1935.64,94
"7956","25434","2020",68,48,20,148148.735294118,1597.07352941176,93.2794117647059
"7957","25435","2020",2,2,0,65800,925,80.5
"7958","25437","2020",2,2,0,219375,1379.5,165
"7959","25438","2020",7,7,0,224439.285714286,1883.42857142857,128.857142857143
"7960","25439","2020",1,1,0,63162,710,89
"7961","25440","2020",4,3,1,154980,1479.75,117
"7962","25442","2020",14,5,9,233529.5,2591.21428571429,87.9285714285714
"7963","25444","2020",1,1,0,239000,2320,103
"7964","25446","2020",3,3,0,182533.333333333,1202,135
"7965","25447","2020",6,4,2,161495,1439.5,116.166666666667
"7966","25448","2020",16,15,1,210268.75,1998.5,105.9375
"7967","25449","2020",3,3,0,84666.6666666667,925,95
"7968","25451","2020",4,4,0,268750,2135.25,132.5
"7969","25452","2020",7,6,1,135314.285714286,1354.71428571429,97.7142857142857
"7970","25453","2020",20,15,5,161039.45,1652,101.5
"7971","25454","2020",23,15,8,235112.173913043,2297.34782608696,103.913043478261
"7972","25455","2020",2,2,0,250327.5,2079,124
"7973","25456","2020",2,2,0,203530,2446,87.5
"7974","25457","2020",1,1,0,153000,1663,92
"7975","25459","2020",3,2,1,304013.333333333,2782.33333333333,108.666666666667
"7976","25461","2020",2,2,0,49000,509.5,105
"7977","25462","2020",373,65,308,169439.512064343,2318.95710455764,73.9061662198391
"7978","25463","2020",40,24,16,129335.975,1434.025,90.75
"7979","25464","2020",1,1,0,379563,1898,200
"7980","25466","2020",3,3,0,231066.666666667,1895.66666666667,134.666666666667
"7981","25467","2020",17,12,5,211209.411764706,1953.82352941176,100.823529411765
"7982","25468","2020",3,3,0,232976.666666667,1579.33333333333,160.333333333333
"7983","25469","2020",1,1,0,187000,1326,141
"7984","25470","2020",1,1,0,96000,1524,63
"7985","25471","2020",1,1,0,130000,1625,80
"7986","25473","2020",7,6,1,160271.428571429,1859.42857142857,94.4285714285714
"7987","25475","2020",5,5,0,175528,1716.4,95.6
"7988","25476","2020",2,2,0,155250,1595,98.5
"7989","25477","2020",4,3,1,213012.5,2166.5,100.75
"7990","25478","2020",1,1,0,150000,1200,125
"7991","25479","2020",6,6,0,131883.333333333,1118,113.333333333333
"7992","25481","2020",4,4,0,189275,1691,110.5
"7993","25482","2020",7,6,1,148983.571428571,1220.14285714286,113.285714285714
"7994","25485","2020",4,4,0,242887.5,2625.25,92.75
"7995","25486","2020",1,1,0,429200,3066,140
"7996","25487","2020",1,1,0,148000,1947,76
"7997","25489","2020",3,3,0,155666.666666667,1299.33333333333,109.666666666667
"7998","25490","2020",4,2,2,114037.5,1171.75,128.5
"7999","25491","2020",3,3,0,92000,999,91.3333333333333
"8000","25493","2020",13,11,2,244119.230769231,2332.23076923077,113.230769230769
"8001","25494","2020",13,6,7,187532.307692308,2696.69230769231,73.1538461538462
"8002","25495","2020",28,17,11,180011.678571429,1786,98.4642857142857
"8003","25496","2020",4,4,0,33112.5,1028.75,35
"8004","25497","2020",3,3,0,111000,1314,80
"8005","25498","2020",1,1,0,79000,898,88
"8006","25499","2020",3,3,0,119338.333333333,1664.33333333333,72
"8007","25500","2020",1,1,0,45000,409,110
"8008","25502","2020",4,4,0,180975,1533,127
"8009","25503","2020",2,2,0,178925,1473,124
"8010","25504","2020",1,1,0,113080,2513,45
"8011","25505","2020",12,12,0,126825,1275.25,101
"8012","25508","2020",8,7,1,183592.25,1615,111.375
"8013","25510","2020",3,3,0,188890,2105,90.6666666666667
"8014","25511","2020",4,4,0,227012.5,1572.25,143.5
"8015","25512","2020",36,16,20,171876.722222222,2036.11111111111,85.6111111111111
"8016","25514","2020",4,2,2,287227.25,3390.75,77.5
"8017","25515","2020",11,3,8,248931.727272727,2827.90909090909,107.090909090909
"8018","25517","2020",1,1,0,98000,784,125
"8019","25518","2020",1,1,0,309000,1569,197
"8020","25519","2020",12,5,7,125558.333333333,1863.16666666667,73
"8021","25520","2020",1,1,0,77000,906,85
"8022","25521","2020",4,4,0,226450,2449,101.75
"8023","25522","2020",2,2,0,211425,1413.5,152.5
"8024","25523","2020",9,9,0,201383.333333333,2062.22222222222,95
"8025","25524","2020",8,7,1,128737.5,1289.25,107.75
"8026","25525","2020",3,1,2,332784,2785.66666666667,110
"8027","25526","2020",29,17,12,121109.655172414,1343.48275862069,91.4827586206897
"8028","25527","2020",52,36,16,187885,1959.80769230769,98.2307692307692
"8029","25528","2020",1,1,0,150000,1119,134
"8030","25529","2020",15,13,2,120673.333333333,1071.06666666667,109.533333333333
"8031","25532","2020",46,24,22,174429.086956522,1998.36956521739,86.2173913043478
"8032","25533","2020",1,1,0,25000,333,75
"8033","25534","2020",3,3,0,333666.666666667,2285.33333333333,146.333333333333
"8034","25535","2020",4,3,1,233625,1712.5,145.5
"8035","25536","2020",1,1,0,90000,682,132
"8036","25537","2020",3,3,0,141700,1716,96.3333333333333
"8037","25539","2020",87,47,40,125688.75862069,1518.81609195402,83.3218390804598
"8038","25540","2020",2,2,0,208750,1422,148.5
"8039","25541","2020",1,1,0,195000,1875,104
"8040","25542","2020",28,19,9,205666.428571429,2122.92857142857,95.1428571428571
"8041","25544","2020",3,3,0,178500,1141,156.666666666667
"8042","25545","2020",1,1,0,216000,2541,85
"8043","25547","2020",26,10,16,88722.6923076923,973.346153846154,88.2692307692308
"8044","25548","2020",1,1,0,185650,1547,120
"8045","25549","2020",5,4,1,198552,1851.8,108.6
"8046","25551","2020",2,2,0,192322.5,1298,163
"8047","25552","2020",3,1,2,107690,1163.66666666667,96
"8048","25553","2020",4,4,0,132700,1632.25,79.75
"8049","25554","2020",2,2,0,277500,2170.5,126
"8050","25555","2020",15,9,6,146724.333333333,1448.6,101.266666666667
"8051","25556","2020",1,1,0,95000,1357,70
"8052","25557","2020",4,4,0,432700,2616.5,168.75
"8053","25558","2020",5,3,2,180400,1763.6,103
"8054","25559","2020",1,1,0,184300,878,210
"8055","25560","2020",33,29,4,226703.333333333,2060.69696969697,111.727272727273
"8056","25561","2020",3,1,2,85685,1226,79
"8057","25562","2020",2,2,0,285400,2223.5,131.5
"8058","25563","2020",1,1,0,275000,2292,120
"8059","25564","2020",10,8,2,216937.2,2061.1,105.1
"8060","25565","2020",4,4,0,427223.25,3983.5,112
"8061","25566","2020",4,4,0,203765.5,1366.5,148.25
"8062","25567","2020",1,1,0,80550,732,110
"8063","25569","2020",5,5,0,250764,1953,133.4
"8064","25571","2020",7,4,3,159950,1543,98.2857142857143
"8065","25574","2020",6,6,0,75936.6666666667,796.333333333333,101.5
"8066","25575","2020",6,6,0,123666.666666667,1894.66666666667,66.8333333333333
"8067","25578","2020",59,26,33,174963,2150.67796610169,84.593220338983
"8068","25580","2020",105,67,38,105264,1250.66666666667,83.9428571428571
"8069","25582","2020",2,2,0,127770.5,1489.5,85
"8070","25583","2020",1,1,0,168200,1294,130
"8071","25586","2020",4,4,0,161663.25,1304.75,129
"8072","25588","2020",2,2,0,110000,1411.5,103.5
"8073","25589","2020",1,1,0,130000,963,135
"8074","25590","2020",1,1,0,161720,1484,109
"8075","25592","2020",14,9,5,171437.285714286,2094.14285714286,83.2857142857143
"8076","25594","2020",1,1,0,194900,2293,85
"8077","25595","2020",1,1,0,173800,2803,62
"8078","25597","2020",4,4,0,143357.5,1338.25,109
"8079","25598","2020",4,4,0,168450,1789.5,94.25
"8080","25599","2020",2,2,0,185600,1985,94
"8081","25600","2020",4,4,0,199610,1572.25,142
"8082","25601","2020",25,16,9,174820.2,2203.8,91
"8083","25605","2020",5,5,0,199686,1821,111.6
"8084","25608","2020",1,1,0,72500,684,106
"8085","25609","2020",6,5,1,341116.666666667,3096.83333333333,116.666666666667
"8086","25611","2020",3,3,0,177883.333333333,1998,88.6666666666667
"8087","25612","2020",5,3,2,192640,1711.2,111.6
"8088","25614","2020",36,28,8,141654.166666667,1617.94444444444,91.2222222222222
"8089","25615","2020",8,8,0,125287.5,1313.625,90.375
"8090","25616","2020",2,2,0,210000,1692,124.5
"8091","25617","2020",3,2,1,142466.666666667,2298,69.3333333333333
"8092","25618","2020",1,1,0,118000,2360,50
"8093","25619","2020",8,5,3,228231.25,2869.625,77
"8094","25622","2020",1,1,0,195700,1288,152
"8095","25623","2020",3,3,0,193600,1681.66666666667,117.333333333333
"8096","25627","2020",7,7,0,149410.714285714,1248.28571428571,120.428571428571
"8097","25629","2020",2,2,0,109000,1842.5,74
"8098","25631","2020",6,6,0,178850,2183.83333333333,84.1666666666667
"8099","25632","2020",49,41,8,144863.673469388,1516.40816326531,97.1224489795918
"8100","25633","2020",11,10,1,152583.363636364,1772.81818181818,90.4545454545455
"8101","25634","2020",12,4,8,256441.666666667,2701,92.8333333333333
"8102","25635","2020",2,2,0,166500,1290,126.5
"8103","26001","2020",5,5,0,188840,1778.4,107
"8104","26002","2020",27,27,0,191282.037037037,1893.44444444444,104.740740740741
"8105","26004","2020",31,28,3,279266.967741935,2383.58064516129,116.225806451613
"8106","26005","2020",27,26,1,315146.851851852,2496.92592592593,127.703703703704
"8107","26006","2020",28,25,3,233284.678571429,2135.21428571429,115.035714285714
"8108","26008","2020",14,12,2,177260.142857143,1922.64285714286,95.4285714285714
"8109","26009","2020",18,17,1,156732.777777778,1680.94444444444,92.9444444444444
"8110","26010","2020",57,45,12,178100.052631579,1691.85964912281,108.140350877193
"8111","26011","2020",34,31,3,227712.676470588,2442.85294117647,95.9411764705882
"8112","26013","2020",1,1,0,143000,2383,60
"8113","26014","2020",1,1,0,285500,1586,180
"8114","26016","2020",5,4,1,183576.6,2025.6,86.6
"8115","26019","2020",3,2,1,144666.666666667,1871.33333333333,77.6666666666667
"8116","26020","2020",4,4,0,352700,1642.75,224.25
"8117","26021","2020",1,1,0,784020,2658,295
"8118","26022","2020",4,4,0,123625,1708.75,74.5
"8119","26023","2020",15,15,0,219123.933333333,2306.66666666667,96.6
"8120","26024","2020",1,1,0,130000,3421,38
"8121","26025","2020",3,3,0,211600,2838.33333333333,74
"8122","26026","2020",3,3,0,173333.333333333,2297.33333333333,76
"8123","26028","2020",2,2,0,236350,2679.5,87.5
"8124","26031","2020",23,14,9,173513.608695652,1698.52173913043,102.086956521739
"8125","26032","2020",3,3,0,570926.666666667,3927,145.666666666667
"8126","26033","2020",19,18,1,235643.263157895,2109.57894736842,105.736842105263
"8127","26034","2020",9,9,0,178646.666666667,1733,105.444444444444
"8128","26035","2020",9,7,2,235116.666666667,1818,123.777777777778
"8129","26037","2020",46,39,7,252026.239130435,2300.78260869565,111.760869565217
"8130","26038","2020",12,12,0,240965.333333333,1873.83333333333,124.75
"8131","26039","2020",10,10,0,280835,2535,117.8
"8132","26040","2020",3,3,0,147866.666666667,831.666666666667,160.333333333333
"8133","26041","2020",12,11,1,195802.916666667,2280.16666666667,91.4166666666667
"8134","26042","2020",14,12,2,239282.857142857,2370.78571428571,97.2142857142857
"8135","26043","2020",2,2,0,117500,1469,80
"8136","26045","2020",23,22,1,278891.086956522,2366.34782608696,116.347826086957
"8137","26046","2020",2,2,0,233525,2059.5,113.5
"8138","26049","2020",17,16,1,170373.529411765,1391.35294117647,117.058823529412
"8139","26052","2020",6,6,0,187005,2109,87.6666666666667
"8140","26054","2020",14,14,0,265100.714285714,2502.35714285714,107.214285714286
"8141","26055","2020",1,1,0,156000,907,172
"8142","26056","2020",10,10,0,158595.2,1290.7,136.1
"8143","26057","2020",139,75,64,148464.086330935,1856.64748201439,80.6690647482014
"8144","26058","2020",297,112,185,148653.841750842,1846.04713804714,79.7542087542087
"8145","26059","2020",5,5,0,134250,1498.6,85.6
"8146","26060","2020",3,2,1,88500,2038.33333333333,54
"8147","26061","2020",4,4,0,292850,2482,119.75
"8148","26063","2020",47,45,2,228594.468085106,2442.57446808511,93.5744680851064
"8149","26064","2020",90,77,13,259255.166666667,2530.83333333333,107.011111111111
"8150","26065","2020",4,4,0,249500,2214,113.25
"8151","26069","2020",3,3,0,189466.666666667,2523.33333333333,72.6666666666667
"8152","26070","2020",10,9,1,276860,2052.2,127.4
"8153","26071","2020",11,11,0,227692.727272727,1841.27272727273,133.636363636364
"8154","26072","2020",10,10,0,195895.2,2103.3,95.3
"8155","26073","2020",5,4,1,305050,3605.8,77.2
"8156","26074","2020",20,16,4,159924.5,1901.95,93.65
"8157","26075","2020",1,1,0,157000,2415,65
"8158","26077","2020",10,10,0,222366.5,2023.6,111
"8159","26078","2020",9,9,0,202880.666666667,1697.11111111111,112.333333333333
"8160","26079","2020",12,12,0,254409.083333333,2240.33333333333,113.5
"8161","26080","2020",1,1,0,157500,4375,36
"8162","26081","2020",5,5,0,256978.2,2916.6,89.2
"8163","26083","2020",24,21,3,207094.166666667,1603.79166666667,133
"8164","26084","2020",39,38,1,215415.564102564,1903.66666666667,112.205128205128
"8165","26085","2020",29,25,4,199890.172413793,1916.34482758621,104.655172413793
"8166","26086","2020",17,15,2,159597.411764706,2108.47058823529,78.1764705882353
"8167","26087","2020",17,16,1,232428.235294118,2047.64705882353,118.470588235294
"8168","26088","2020",59,53,6,219878.13559322,2041.96610169492,105.440677966102
"8169","26090","2020",1,1,0,115636,1032,112
"8170","26091","2020",1,1,0,125550,2092,60
"8171","26092","2020",8,7,1,200940,1709.625,116.625
"8172","26093","2020",6,4,2,407682.5,3150.33333333333,130.833333333333
"8173","26094","2020",6,6,0,188633.333333333,1883.16666666667,96.5
"8174","26095","2020",15,14,1,174874,1586,114.466666666667
"8175","26096","2020",25,22,3,196113.72,1954.48,100.96
"8176","26097","2020",9,8,1,265851.111111111,2300.11111111111,128.666666666667
"8177","26098","2020",1,1,0,122000,1452,84
"8178","26099","2020",4,4,0,250483.25,2620.75,93.25
"8179","26100","2020",1,1,0,202000,1603,126
"8180","26101","2020",2,2,0,257500,1869,140
"8181","26102","2020",1,1,0,3e+05,2459,122
"8182","26103","2020",5,5,0,291980,2462.4,124.2
"8183","26104","2020",1,1,0,123500,1103,112
"8184","26105","2020",3,3,0,174836.666666667,2358,75.3333333333333
"8185","26106","2020",12,11,1,205920.833333333,1740.58333333333,114.916666666667
"8186","26107","2020",6,6,0,209178.333333333,1694.66666666667,143.166666666667
"8187","26108","2020",105,57,48,171601.142857143,1957.82857142857,87.647619047619
"8188","26110","2020",4,4,0,232524.75,2661,94.5
"8189","26111","2020",1,1,0,423600,2353,180
"8190","26112","2020",2,2,0,187000,1722.5,109
"8191","26113","2020",71,48,23,169705.436619718,2007.66197183099,89.2535211267606
"8192","26114","2020",67,51,16,190369.47761194,2095.35820895522,95.2985074626866
"8193","26115","2020",7,7,0,294384.285714286,2645.28571428571,104.285714285714
"8194","26116","2020",73,58,15,184917.178082192,1876.46575342466,99.9315068493151
"8195","26117","2020",1,1,0,128000,1422,90
"8196","26118","2020",28,27,1,196789.464285714,1867.21428571429,106.285714285714
"8197","26119","2020",13,12,1,143797.692307692,1621.15384615385,93.5384615384615
"8198","26121","2020",14,13,1,290217.071428571,2573.92857142857,115.857142857143
"8199","26122","2020",1,1,0,139000,2623,53
"8200","26124","2020",55,51,4,260714.363636364,2517.21818181818,109.563636363636
"8201","26125","2020",12,12,0,264843.333333333,2248.5,120.333333333333
"8202","26127","2020",4,4,0,173975,2024.75,97
"8203","26128","2020",2,2,0,214430,2373.5,86
"8204","26129","2020",13,13,0,235359.538461538,1913.46153846154,130.153846153846
"8205","26131","2020",1,1,0,196750,3452,57
"8206","26133","2020",2,2,0,193650,2464.5,72.5
"8207","26136","2020",1,1,0,398558,4195,95
"8208","26138","2020",19,19,0,240995.789473684,2504.36842105263,99.7368421052632
"8209","26139","2020",26,23,3,260677.153846154,2249.65384615385,120.076923076923
"8210","26140","2020",4,4,0,256937.5,1925,127.75
"8211","26141","2020",3,3,0,305090,1975.33333333333,155
"8212","26142","2020",2,2,0,230000,2206,123
"8213","26143","2020",22,20,2,138719,1416.31818181818,98.1818181818182
"8214","26144","2020",18,14,4,246469.944444444,2226.11111111111,116.055555555556
"8215","26145","2020",5,5,0,178982,1970,90
"8216","26146","2020",27,24,3,348506.111111111,3038.48148148148,116.592592592593
"8217","26148","2020",22,20,2,192591.818181818,1912.31818181818,103.045454545455
"8218","26149","2020",15,9,6,173168.533333333,2027.73333333333,84.6666666666667
"8219","26153","2020",3,3,0,172966.666666667,1720.33333333333,96
"8220","26154","2020",7,7,0,106895.714285714,1500.28571428571,68.5714285714286
"8221","26155","2020",20,20,0,210005.25,1724.95,130.45
"8222","26156","2020",8,8,0,175391.25,2072.875,88.75
"8223","26157","2020",8,8,0,259165,2017.625,126.125
"8224","26159","2020",2,2,0,337500,2520.5,134.5
"8225","26160","2020",15,11,4,143680,1616.66666666667,88.8666666666667
"8226","26162","2020",23,22,1,146982.826086957,1519.08695652174,102.04347826087
"8227","26164","2020",1,1,0,55000,1100,50
"8228","26165","2020",120,94,26,180062.516666667,2040.825,89.8833333333333
"8229","26166","2020",79,68,11,185026.898734177,1942,95.2278481012658
"8230","26167","2020",8,8,0,173875,1797,103.125
"8231","26168","2020",7,3,4,78475,1400.71428571429,65.5714285714286
"8232","26169","2020",23,21,2,240649.826086957,2191.34782608696,108.565217391304
"8233","26170","2020",25,25,0,265108,2332.92,116.44
"8234","26171","2020",2,2,0,297645,2540,130
"8235","26172","2020",7,7,0,165585.714285714,1795.14285714286,97.1428571428571
"8236","26173","2020",9,9,0,229003.333333333,2156.33333333333,108.777777777778
"8237","26174","2020",12,11,1,250540.833333333,2222,116.666666666667
"8238","26175","2020",3,3,0,257833.333333333,1881.66666666667,147.333333333333
"8239","26176","2020",17,15,2,273660,2425.41176470588,110.941176470588
"8240","26177","2020",9,9,0,216262.222222222,1902.55555555556,111.111111111111
"8241","26178","2020",3,3,0,191666.666666667,1569.33333333333,125.333333333333
"8242","26179","2020",21,21,0,260830.952380952,2318.47619047619,114.761904761905
"8243","26181","2020",2,2,0,84500,982,89
"8244","26182","2020",20,18,2,281828.25,2848.15,114.2
"8245","26183","2020",14,14,0,279510.5,2630.92857142857,110.357142857143
"8246","26185","2020",7,7,0,312850,3350.14285714286,91.8571428571429
"8247","26188","2020",27,21,6,219919.777777778,2342.96296296296,93.9259259259259
"8248","26189","2020",1,1,0,77950,2165,36
"8249","26191","2020",33,25,8,228997.575757576,2436.0303030303,94.7272727272727
"8250","26192","2020",4,4,0,415075,2805.75,156.75
"8251","26193","2020",8,3,5,154021.25,2204.875,63.125
"8252","26194","2020",4,4,0,185037.5,2234,85
"8253","26195","2020",2,2,0,285000,2774.5,107.5
"8254","26196","2020",13,13,0,374184.615384615,3562.07692307692,106
"8255","26197","2020",39,32,7,288998.333333333,2916.4358974359,107.025641025641
"8256","26198","2020",609,277,332,164934.761904762,1904.25779967159,83.4302134646962
"8257","26199","2020",1,1,0,160000,1301,123
"8258","26200","2020",4,4,0,106852.5,1819.5,62.5
"8259","26201","2020",1,1,0,205000,2135,96
"8260","26202","2020",6,5,1,156816.666666667,1682.16666666667,106
"8261","26203","2020",7,7,0,252015.571428571,2195.28571428571,116.857142857143
"8262","26204","2020",1,1,0,253000,2008,126
"8263","26205","2020",3,3,0,203333.333333333,1968,104
"8264","26206","2020",30,27,3,254457.133333333,2259.16666666667,114.433333333333
"8265","26207","2020",4,4,0,198534,1993.75,104.25
"8266","26208","2020",24,24,0,280912.458333333,2584.25,118.041666666667
"8267","26209","2020",1,1,0,213000,1936,110
"8268","26210","2020",16,15,1,170192.1875,1623.5,112.8125
"8269","26211","2020",13,10,3,173863.153846154,2004.61538461538,86
"8270","26212","2020",11,9,2,203300,2208.36363636364,90.8181818181818
"8271","26213","2020",9,7,2,180572.222222222,1581.77777777778,133
"8272","26215","2020",9,9,0,129177.777777778,1551.22222222222,81.2222222222222
"8273","26216","2020",8,8,0,179995,1372,131.875
"8274","26217","2020",2,2,0,211600,2223.5,95
"8275","26218","2020",38,34,4,229188.078947368,2234.07894736842,105.684210526316
"8276","26220","2020",118,50,68,179926.381355932,2333.88983050847,76.9661016949153
"8277","26223","2020",10,10,0,140500,1443.5,96.7
"8278","26224","2020",3,3,0,190000,3657.33333333333,81.6666666666667
"8279","26225","2020",5,5,0,244894,1890.8,129.8
"8280","26226","2020",3,3,0,226798.333333333,2530,102
"8281","26231","2020",24,24,0,265487.083333333,2085.125,136.166666666667
"8282","26232","2020",6,6,0,164041.666666667,1993.83333333333,84.1666666666667
"8283","26233","2020",2,2,0,345100,2949,122
"8284","26234","2020",13,11,2,262901.153846154,2313.92307692308,110.076923076923
"8285","26235","2020",151,120,31,174086.38410596,1843.30463576159,95.4503311258278
"8286","26236","2020",1,1,0,250000,2907,86
"8287","26238","2020",3,3,0,87053.3333333333,1560.33333333333,69.3333333333333
"8288","26239","2020",5,5,0,230000,1907.4,110.4
"8289","26240","2020",3,3,0,224500,2540.33333333333,83.3333333333333
"8290","26242","2020",1,1,0,504000,4582,110
"8291","26243","2020",18,13,5,252958.333333333,2573.11111111111,103.388888888889
"8292","26244","2020",2,2,0,242500,1564,164
"8293","26247","2020",9,9,0,174988.888888889,1546,121.111111111111
"8294","26248","2020",4,4,0,132500,1242,119.5
"8295","26249","2020",14,13,1,197043.571428571,2055.57142857143,100.785714285714
"8296","26250","2020",32,28,4,209407.1875,2109.09375,100.34375
"8297","26251","2020",5,5,0,260166,2843.2,92
"8298","26252","2020",147,96,51,188897.68707483,2207.79591836735,85.5510204081633
"8299","26256","2020",1,1,0,209000,2944,71
"8300","26257","2020",4,4,0,284745,2411.75,126.75
"8301","26258","2020",17,16,1,226655.529411765,1967.70588235294,111.235294117647
"8302","26261","2020",9,7,2,165822.777777778,1870.88888888889,92.3333333333333
"8303","26262","2020",2,2,0,121750,3808.5,37.5
"8304","26263","2020",2,2,0,285000,4608,69
"8305","26264","2020",12,12,0,212168.333333333,1757.08333333333,105.25
"8306","26266","2020",1,1,0,235000,2938,80
"8307","26267","2020",1,1,0,4e+05,2759,145
"8308","26268","2020",1,1,0,794500,4966,160
"8309","26271","2020",37,36,1,199942.432432432,2016.40540540541,102.108108108108
"8310","26272","2020",4,4,0,253667.5,2331.25,112.75
"8311","26273","2020",6,6,0,272800,1891.33333333333,142.333333333333
"8312","26275","2020",23,23,0,263354.565217391,2333.47826086957,110.130434782609
"8313","26276","2020",8,8,0,441781.25,3015.25,143.625
"8314","26277","2020",3,3,0,574333.333333333,4140,177.333333333333
"8315","26278","2020",5,5,0,442246,3764.8,116.4
"8316","26279","2020",1,1,0,36200,1508,24
"8317","26281","2020",576,232,344,140832.963541667,1723.328125,81.1302083333333
"8318","26282","2020",1,1,0,35000,686,51
"8319","26284","2020",5,5,0,384574,3074.6,121.8
"8320","26285","2020",10,10,0,453928.9,3554.6,128.1
"8321","26287","2020",6,6,0,252895,1919.5,135.333333333333
"8322","26288","2020",2,2,0,360740,3082,117.5
"8323","26289","2020",24,22,2,196320.25,2190.625,86.7916666666667
"8324","26290","2020",18,9,9,95230.2777777778,1610.38888888889,60
"8325","26291","2020",1,1,0,220000,2200,100
"8326","26292","2020",1,1,0,105000,2561,41
"8327","26293","2020",4,4,0,270162.5,1801.25,147
"8328","26294","2020",12,12,0,227955.833333333,1887.25,120.75
"8329","26295","2020",18,18,0,179608.611111111,1817.22222222222,101.777777777778
"8330","26298","2020",3,3,0,86666.6666666667,910,106.666666666667
"8331","26299","2020",3,3,0,67333.3333333333,835,70
"8332","26301","2020",53,41,12,167783.679245283,1717.37735849057,96.1320754716981
"8333","26302","2020",9,8,1,155461.111111111,1736.66666666667,95.2222222222222
"8334","26303","2020",3,3,0,92166.6666666667,1178,89
"8335","26305","2020",10,9,1,230930.7,2051.2,108.4
"8336","26306","2020",7,7,0,198945,2049,96
"8337","26307","2020",37,30,7,149933.945945946,1636.43243243243,88.1621621621622
"8338","26308","2020",1,1,0,40000,667,60
"8339","26309","2020",3,3,0,221396.666666667,1717,147.333333333333
"8340","26310","2020",3,3,0,213666.666666667,1226,161.666666666667
"8341","26311","2020",7,7,0,111941.428571429,1267.42857142857,85.4285714285714
"8342","26312","2020",17,15,2,243140,2467.41176470588,107.941176470588
"8343","26313","2020",57,54,3,279763.210526316,2467.10526315789,113.842105263158
"8344","26314","2020",1,1,0,1e+05,980,102
"8345","26315","2020",3,3,0,145423.333333333,1437,100
"8346","26317","2020",8,8,0,154806.25,1710.25,88.875
"8347","26319","2020",1,1,0,193000,1771,109
"8348","26320","2020",11,7,4,137085.545454545,1397.18181818182,93.7272727272727
"8349","26321","2020",2,2,0,57500,990,53
"8350","26322","2020",6,2,4,253708.333333333,2258.5,116
"8351","26323","2020",12,9,3,196665.166666667,2076.33333333333,94
"8352","26324","2020",111,78,33,210872.378378378,2195.52252252252,94.3153153153153
"8353","26325","2020",83,65,18,161405.903614458,1672.53012048193,97.0240963855422
"8354","26326","2020",17,16,1,312215.294117647,2818.64705882353,110.705882352941
"8355","26327","2020",5,5,0,198716,2681.2,76.4
"8356","26329","2020",2,2,0,108750,1453,68
"8357","26330","2020",19,18,1,186842.473684211,1741.21052631579,110.157894736842
"8358","26331","2020",4,4,0,164900,1567.5,115.75
"8359","26332","2020",18,17,1,185312.777777778,1621.5,115.611111111111
"8360","26333","2020",49,21,28,97770.4081632653,1231.75510204082,79.734693877551
"8361","26334","2020",1,1,0,185000,1259,147
"8362","26335","2020",1,1,0,67000,1675,40
"8363","26336","2020",3,3,0,370436.666666667,2529.66666666667,159.666666666667
"8364","26337","2020",26,22,4,166905.384615385,1897.15384615385,87.1923076923077
"8365","26338","2020",19,17,2,287462.421052632,2189.15789473684,132.578947368421
"8366","26339","2020",17,15,2,228127.352941176,2144.17647058824,104.352941176471
"8367","26340","2020",11,10,1,185295,1822.63636363636,96.2727272727273
"8368","26341","2020",14,14,0,163241.428571429,1694.28571428571,98.3571428571429
"8369","26342","2020",4,4,0,415231.25,2508.25,162.5
"8370","26343","2020",1,1,0,311500,2685,116
"8371","26344","2020",3,3,0,355000,3162,106
"8372","26345","2020",23,22,1,228128.739130435,2348.52173913043,97.3478260869565
"8373","26346","2020",2,2,0,327875,3056.5,107.5
"8374","26347","2020",75,35,40,167747.466666667,2035.41333333333,81.92
"8375","26348","2020",16,14,2,255831.875,2574.4375,104.75
"8376","26349","2020",3,3,0,169476.666666667,1795.66666666667,94
"8377","26350","2020",3,3,0,147500,1644,85.3333333333333
"8378","26352","2020",4,4,0,253897.5,2082,120.75
"8379","26353","2020",13,9,4,160993.846153846,1707.38461538462,92
"8380","26355","2020",6,6,0,192976.166666667,1839.16666666667,104.833333333333
"8381","26356","2020",2,2,0,674900,3590,188.5
"8382","26357","2020",19,17,2,203708.947368421,1972.68421052632,95.4736842105263
"8383","26358","2020",13,13,0,255734.615384615,2308.30769230769,111.846153846154
"8384","26360","2020",10,10,0,353671.7,2907.1,122
"8385","26361","2020",2,2,0,51500,1943.5,39
"8386","26362","2020",1115,216,899,146233.873542601,1953.34529147982,75.2869955156951
"8387","26364","2020",6,6,0,260475.333333333,2464.5,109.666666666667
"8388","26365","2020",6,6,0,393341.666666667,3021.33333333333,131.833333333333
"8389","26367","2020",1,1,0,176600,2030,87
"8390","26368","2020",4,4,0,199147.5,3189.75,69
"8391","26370","2020",3,2,1,345483.333333333,2714,124
"8392","26373","2020",1,1,0,75000,833,90
"8393","26376","2020",2,2,0,123765,1126,106.5
"8394","26377","2020",15,15,0,242212.666666667,2327.26666666667,105.6
"8395","26379","2020",5,5,0,240464,2502.4,95
"8396","26380","2020",3,3,0,176666.666666667,1610,106.666666666667
"8397","26381","2020",6,6,0,184380,1631.5,110.5
"8398","26382","2020",5,5,0,167210,1821.8,91.8
"8399","27001","2020",2,2,0,192050,2444.5,77.5
"8400","27002","2020",14,14,0,140000,2004.78571428571,83.1428571428571
"8401","27003","2020",26,23,3,192497.5,1858.34615384615,102.384615384615
"8402","27004","2020",2,2,0,176000,2253,79
"8403","27005","2020",24,24,0,211304.166666667,1870.54166666667,116.333333333333
"8404","27006","2020",3,3,0,144366.666666667,1522.33333333333,102
"8405","27008","2020",12,12,0,180041.666666667,1903.25,100.25
"8406","27009","2020",10,10,0,125240,1410.5,99.5
"8407","27011","2020",21,20,1,183564.523809524,1783.04761904762,107.285714285714
"8408","27012","2020",7,7,0,219987.142857143,1788.28571428571,120.857142857143
"8409","27013","2020",9,9,0,164177.777777778,1627.33333333333,109.777777777778
"8410","27014","2020",15,15,0,203756.666666667,1904.13333333333,114.866666666667
"8411","27015","2020",25,24,1,246804,2164.12,115.2
"8412","27016","2020",87,74,13,147430.965517241,1800.1724137931,84.2068965517241
"8413","27017","2020",16,16,0,159684.375,1659.5625,97.9375
"8414","27018","2020",14,14,0,177590.714285714,1494.35714285714,121
"8415","27019","2020",4,4,0,164925,1203.25,135.75
"8416","27020","2020",20,20,0,169739.95,1753.8,99.05
"8417","27021","2020",3,3,0,330000,2596,151.333333333333
"8418","27022","2020",61,59,2,175929.262295082,1932.16393442623,96.0819672131148
"8419","27023","2020",10,10,0,174918,1876.4,95.6
"8420","27025","2020",17,17,0,159442.411764706,1938.94117647059,88.5294117647059
"8421","27026","2020",8,7,1,238030,2601.625,89.625
"8422","27027","2020",5,5,0,152300,1629,93.2
"8423","27028","2020",5,5,0,127800,1329.6,96.6
"8424","27031","2020",11,11,0,202472.727272727,1814.18181818182,117.181818181818
"8425","27032","2020",19,19,0,178713.157894737,1691.52631578947,107.368421052632
"8426","27033","2020",5,5,0,158600,1684,91
"8427","27034","2020",16,16,0,159550,1708.125,103.125
"8428","27035","2020",4,4,0,279500,1908.5,132
"8429","27036","2020",7,7,0,150067.857142857,1468.14285714286,104
"8430","27037","2020",17,17,0,137748.058823529,1386,99.4705882352941
"8431","27039","2020",7,7,0,202857.142857143,2272.71428571429,83.7142857142857
"8432","27040","2020",9,9,0,183388.888888889,1600.77777777778,123.222222222222
"8433","27043","2020",17,17,0,133997.058823529,1288.29411764706,106.764705882353
"8434","27044","2020",11,11,0,170847.727272727,2106,87
"8435","27045","2020",13,13,0,204576.923076923,2352.30769230769,89.2307692307692
"8436","27046","2020",4,4,0,109500,1464.5,79.5
"8437","27047","2020",3,3,0,209883.333333333,1406.66666666667,160.333333333333
"8438","27048","2020",4,4,0,224850,2139.25,120.75
"8439","27049","2020",109,109,0,135989.174311927,1420.48623853211,96.4403669724771
"8440","27050","2020",8,8,0,121437.5,1427.375,93.25
"8441","27051","2020",41,39,2,130830.780487805,1495.56097560976,92.609756097561
"8442","27052","2020",10,10,0,181200,1774.1,116.7
"8443","27053","2020",5,5,0,196200,1807.2,110.4
"8444","27054","2020",4,4,0,121216.5,1177.75,102.25
"8445","27055","2020",3,3,0,144333.333333333,1483.33333333333,100.666666666667
"8446","27056","2020",149,111,38,140952.342281879,1734.1610738255,84.6644295302013
"8447","27057","2020",5,5,0,173380,1596.2,116.2
"8448","27058","2020",24,22,2,198508.333333333,2123.45833333333,96.5
"8449","27059","2020",6,6,0,165583.333333333,1932.5,91.8333333333333
"8450","27061","2020",3,3,0,155666.666666667,1403,121
"8451","27062","2020",13,13,0,212098.461538462,1942.61538461538,108.384615384615
"8452","27063","2020",2,2,0,167000,1910.5,88
"8453","27064","2020",18,18,0,162693.333333333,1801.44444444444,89.5
"8454","27065","2020",92,70,22,162340.793478261,1922.27173913043,85.3586956521739
"8455","27066","2020",7,7,0,174564.285714286,2029.28571428571,85
"8456","27067","2020",20,20,0,172750,1827.05,98.8
"8457","27068","2020",5,5,0,97260,961.4,105.6
"8458","27069","2020",14,14,0,108392.857142857,1326.57142857143,85.9285714285714
"8459","27070","2020",20,20,0,166712.45,1693.8,107.55
"8460","27071","2020",7,7,0,245835.714285714,2050.42857142857,135.857142857143
"8461","27072","2020",8,8,0,246125,1910.5,134.875
"8462","27073","2020",24,24,0,175236.916666667,1981.45833333333,93.7916666666667
"8463","27074","2020",5,5,0,164200,1516.8,113
"8464","27075","2020",9,9,0,126333.333333333,1199,100.444444444444
"8465","27076","2020",7,7,0,170857.142857143,1724.28571428571,100.571428571429
"8466","27077","2020",17,17,0,168802.941176471,1679.17647058824,104.705882352941
"8467","27078","2020",7,7,0,239971.428571429,1622.28571428571,154.714285714286
"8468","27079","2020",4,4,0,145625,1922.5,77.5
"8469","27081","2020",5,5,0,173000,1877,95
"8470","27082","2020",30,29,1,160251.5,1836.4,91.3333333333333
"8471","27083","2020",5,5,0,148890,1857,79.4
"8472","27085","2020",25,25,0,179978,1639.24,111.68
"8473","27089","2020",17,17,0,221940.176470588,1896.11764705882,122.941176470588
"8474","27090","2020",40,40,0,175145.625,1814.425,98.9
"8475","27091","2020",10,10,0,183540.5,1613.4,125.3
"8476","27094","2020",3,3,0,158222.333333333,2110,79.6666666666667
"8477","27095","2020",6,6,0,157586.666666667,1589.16666666667,100.666666666667
"8478","27096","2020",10,10,0,129300,1724,79.5
"8479","27097","2020",6,6,0,187407.833333333,2057,89.5
"8480","27099","2020",10,10,0,203562.9,1572.7,119.7
"8481","27100","2020",23,20,3,200941.47826087,2103.52173913043,101.521739130435
"8482","27101","2020",6,6,0,133583.333333333,1156.16666666667,109.666666666667
"8483","27102","2020",8,7,1,191208.125,2029.875,98.125
"8484","27103","2020",34,34,0,193327.617647059,1916.02941176471,102.176470588235
"8485","27104","2020",12,12,0,156825,1518.83333333333,106.666666666667
"8486","27105","2020",43,40,3,166081.744186047,2002.72093023256,86.1162790697674
"8487","27106","2020",9,9,0,190322.222222222,1864.44444444444,115.111111111111
"8488","27107","2020",20,20,0,178110,2021.8,95.5
"8489","27108","2020",18,18,0,149820.222222222,1586.61111111111,96.7777777777778
"8490","27109","2020",4,4,0,158175,1638.75,96.75
"8491","27110","2020",10,10,0,162565.2,1521.8,113.6
"8492","27111","2020",5,5,0,220040,1950.8,112
"8493","27112","2020",58,58,0,126931.24137931,1377.8275862069,94.1551724137931
"8494","27113","2020",4,4,0,149500,1307.5,112.5
"8495","27114","2020",20,20,0,258578.1,1921.8,139.55
"8496","27115","2020",6,6,0,120277.666666667,1444.16666666667,88.8333333333333
"8497","27116","2020",72,67,5,123120.972222222,1426.98611111111,90.7916666666667
"8498","27117","2020",20,20,0,107825,1267.95,86.45
"8499","27118","2020",14,14,0,153028.571428571,1606.64285714286,90.2142857142857
"8500","27119","2020",22,22,0,217374.545454545,2356.09090909091,93.5
"8501","27120","2020",6,6,0,191000,1780.5,110.833333333333
"8502","27123","2020",6,6,0,255804.166666667,2104.66666666667,119.833333333333
"8503","27124","2020",4,4,0,238225,1416,169.75
"8504","27125","2020",10,10,0,170775,2047.3,85.9
"8505","27126","2020",14,14,0,176047.857142857,1911.07142857143,95.6428571428571
"8506","27127","2020",7,7,0,157524.142857143,1301.57142857143,117.142857142857
"8507","27129","2020",10,10,0,197720,1768.3,120.1
"8508","27130","2020",12,12,0,140200,1456.5,91.4166666666667
"8509","27132","2020",15,15,0,161114,1738.73333333333,100.533333333333
"8510","27133","2020",21,20,1,247665.333333333,1944.52380952381,135.52380952381
"8511","27134","2020",4,4,0,128011.75,1737.5,74.5
"8512","27135","2020",8,8,0,149712.5,1383.875,115.5
"8513","27136","2020",1,1,0,240000,2449,98
"8514","27137","2020",6,6,0,167083.333333333,1551.33333333333,119.833333333333
"8515","27138","2020",3,3,0,212083.333333333,1928.33333333333,114.666666666667
"8516","27139","2020",5,5,0,79400,975.2,82.4
"8517","27140","2020",8,8,0,257931.25,2027.5,130.375
"8518","27141","2020",1,1,0,1e+05,909,110
"8519","27142","2020",3,3,0,258862.333333333,2037,125
"8520","27144","2020",2,2,0,196000,1744.5,115
"8521","27146","2020",5,5,0,200790,2504.6,81.6
"8522","27147","2020",12,12,0,183406.166666667,1910.75,96.5833333333333
"8523","27148","2020",8,8,0,147925,1333.5,125
"8524","27149","2020",3,3,0,114166.666666667,1723.66666666667,65.3333333333333
"8525","27151","2020",17,17,0,155291.176470588,1554.35294117647,103.235294117647
"8526","27152","2020",14,12,2,194285.714285714,2185.92857142857,96.4285714285714
"8527","27153","2020",6,6,0,164278.333333333,2016,85.3333333333333
"8528","27154","2020",10,10,0,166170,1785.3,95.4
"8529","27155","2020",1,1,0,178000,1290,138
"8530","27156","2020",4,4,0,143825,1990.25,92.25
"8531","27157","2020",21,21,0,166019.047619048,1488.61904761905,112.952380952381
"8532","27158","2020",7,7,0,155357.142857143,1690.57142857143,97.2857142857143
"8533","27161","2020",13,13,0,158584.615384615,1607.76923076923,108.076923076923
"8534","27162","2020",5,5,0,120200,1549,77.8
"8535","27163","2020",2,2,0,144500,1439,102.5
"8536","27164","2020",12,12,0,173708.333333333,1681.25,102.5
"8537","27165","2020",69,67,2,150586.956521739,1781.71014492754,81.8695652173913
"8538","27167","2020",8,8,0,138737.5,1427,96.125
"8539","27169","2020",20,20,0,183375,1734.2,110.1
"8540","27170","2020",18,15,3,131583.611111111,1562.72222222222,83.4444444444444
"8541","27171","2020",8,8,0,207892.125,1890.625,103.5
"8542","27174","2020",27,27,0,181956.111111111,1840.96296296296,108.407407407407
"8543","27176","2020",6,6,0,148688.333333333,1980.66666666667,76.5
"8544","27177","2020",9,9,0,189655.555555556,1825.66666666667,106
"8545","27179","2020",10,10,0,126061,1455.6,86.7
"8546","27180","2020",19,19,0,187028.947368421,2009.94736842105,96.4210526315789
"8547","27181","2020",6,6,0,155818.333333333,1965.16666666667,88.6666666666667
"8548","27182","2020",2,2,0,158150,1364.5,123.5
"8549","27183","2020",34,33,1,183541.117647059,2051.02941176471,91.2058823529412
"8550","27184","2020",3,3,0,130166.666666667,1372.66666666667,92.6666666666667
"8551","27185","2020",6,6,0,130250,2197,83
"8552","27187","2020",4,4,0,199250,2045.5,101
"8553","27188","2020",15,15,0,177862.4,1789.2,109.8
"8554","27189","2020",3,3,0,284000,2790.33333333333,95.6666666666667
"8555","27190","2020",6,6,0,253083.5,2066.83333333333,116.833333333333
"8556","27191","2020",30,30,0,211316.666666667,2007.66666666667,105.833333333333
"8557","27192","2020",9,9,0,203011.111111111,2016.33333333333,103.888888888889
"8558","27193","2020",16,16,0,205275,1947.0625,114.5625
"8559","27194","2020",3,3,0,143666.666666667,1992,77.3333333333333
"8560","27196","2020",20,20,0,180073.5,1956.35,92.2
"8561","27198","2020",92,91,1,148363.586956522,1603.10869565217,98.3586956521739
"8562","27199","2020",16,16,0,200674.375,2097.5625,101.625
"8563","27200","2020",1,1,0,140000,1138,123
"8564","27201","2020",2,2,0,128000,1138,108.5
"8565","27202","2020",12,12,0,161466.666666667,1378.58333333333,122.5
"8566","27203","2020",6,6,0,196000,1848.66666666667,113.666666666667
"8567","27204","2020",5,5,0,141030,2027.2,69.8
"8568","27205","2020",9,9,0,163422.222222222,1372.33333333333,135.777777777778
"8569","27206","2020",5,5,0,145600,1474.4,98.2
"8570","27207","2020",12,12,0,173332.083333333,1752.58333333333,100.5
"8571","27208","2020",7,7,0,143428.571428571,1859.71428571429,75
"8572","27209","2020",12,12,0,209009.166666667,1990.66666666667,113.833333333333
"8573","27210","2020",6,6,0,97833.3333333333,1229.66666666667,82.3333333333333
"8574","27213","2020",102,101,1,213637.931372549,2031.14705882353,112.352941176471
"8575","27214","2020",11,11,0,127454.545454545,1488.09090909091,87.7272727272727
"8576","27215","2020",5,5,0,148700,1151.6,129.8
"8577","27216","2020",6,6,0,207420,2240.83333333333,93.5
"8578","27217","2020",5,5,0,132000,1532,100
"8579","27218","2020",19,19,0,244064.526315789,2169.42105263158,120.842105263158
"8580","27219","2020",4,4,0,182250,1634,111
"8581","27220","2020",8,8,0,165000,2158.625,77.25
"8582","27222","2020",8,8,0,178300,1437.5,123.375
"8583","27224","2020",4,4,0,214360,1983.25,122.5
"8584","27226","2020",50,49,1,149655.98,1779.72,89.64
"8585","27227","2020",5,5,0,177350,1429.6,123.4
"8586","27228","2020",8,8,0,135037.5,1386.125,98.25
"8587","27229","2020",662,252,410,118239.15407855,1704.0996978852,70.6223564954683
"8588","27230","2020",59,50,9,172170.762711864,1944.89830508475,92.1186440677966
"8589","27231","2020",3,3,0,245666.666666667,2337,107
"8590","27232","2020",5,5,0,151752,1771.8,85.4
"8591","27233","2020",15,15,0,225086.666666667,1992.2,120.133333333333
"8592","27234","2020",3,3,0,202200,1710,122.666666666667
"8593","27235","2020",2,2,0,211000,1643,134.5
"8594","27237","2020",4,4,0,138125,1442.5,103
"8595","27238","2020",16,16,0,202484.75,1699.25,120.4375
"8596","27239","2020",12,12,0,161875,1739.41666666667,94.1666666666667
"8597","27240","2020",3,3,0,82166.6666666667,1424,56.6666666666667
"8598","27241","2020",2,2,0,259750,1509,175
"8599","27242","2020",19,19,0,129026.315789474,1539.42105263158,92.7368421052632
"8600","27243","2020",12,12,0,249208.333333333,2044.5,124.083333333333
"8601","27245","2020",14,14,0,158607.142857143,1623.57142857143,106.428571428571
"8602","27246","2020",20,19,1,124506,1379.9,93.5
"8603","27247","2020",6,6,0,166750,1629.83333333333,114
"8604","27248","2020",5,5,0,135760,1497,110
"8605","27249","2020",20,20,0,223630,1869.8,127.65
"8606","27251","2020",8,8,0,104437.5,1134.375,90.5
"8607","27252","2020",13,13,0,235948.461538462,1807.46153846154,132.230769230769
"8608","27254","2020",19,19,0,274544.736842105,2265.10526315789,125.947368421053
"8609","27256","2020",7,7,0,202428.571428571,1900.14285714286,117.428571428571
"8610","27258","2020",14,14,0,174128.571428571,1748.35714285714,109.5
"8611","27260","2020",19,19,0,184812,1825,109.736842105263
"8612","27261","2020",5,5,0,184975,1527,122
"8613","27263","2020",25,25,0,183496,1702.72,114.44
"8614","27266","2020",5,5,0,134800,1339.6,103.2
"8615","27267","2020",8,8,0,119137.5,1286,92.5
"8616","27269","2020",4,4,0,193762.5,1979.25,99.25
"8617","27271","2020",5,5,0,1e+05,1754.2,58.4
"8618","27273","2020",7,7,0,253280.857142857,2254.71428571429,111.142857142857
"8619","27275","2020",100,48,52,113148.49,1607.77,70.27
"8620","27276","2020",5,5,0,140100,1689.4,84.6
"8621","27277","2020",11,11,0,170772.727272727,2009.09090909091,84.7272727272727
"8622","27278","2020",31,31,0,170403.548387097,1931.77419354839,98.5806451612903
"8623","27279","2020",38,31,7,169130.789473684,2050.76315789474,84.9736842105263
"8624","27280","2020",7,7,0,183200,2401,77.8571428571429
"8625","27281","2020",2,2,0,122665,1440.5,102.5
"8626","27282","2020",5,5,0,199200,1688.2,126.4
"8627","27284","2020",145,112,33,184091.510344828,2266.43448275862,86.6413793103448
"8628","27285","2020",5,5,0,331440,2724.6,129.2
"8629","27286","2020",5,5,0,188957.8,1558.2,112
"8630","27287","2020",12,12,0,208812.5,1634.5,127.583333333333
"8631","27288","2020",12,12,0,137836.333333333,1462.58333333333,94.0833333333333
"8632","27289","2020",6,6,0,118091.666666667,1087.83333333333,113.166666666667
"8633","27290","2020",22,22,0,146195.454545455,1373.59090909091,112.545454545455
"8634","27291","2020",3,3,0,156666.666666667,1598,103.666666666667
"8635","27294","2020",18,18,0,176606.666666667,1600.38888888889,115.222222222222
"8636","27295","2020",8,8,0,174500,1534.625,116.5
"8637","27298","2020",3,3,0,186000,2082.66666666667,95.6666666666667
"8638","27299","2020",44,26,18,129068.204545455,1681.79545454545,75.7727272727273
"8639","27300","2020",9,9,0,135722.222222222,1428.11111111111,97.6666666666667
"8640","27301","2020",13,13,0,165453.846153846,1749.76923076923,100.076923076923
"8641","27302","2020",22,22,0,164505.590909091,1727.63636363636,96.6818181818182
"8642","27304","2020",2,2,0,246225,2074.5,116.5
"8643","27306","2020",41,41,0,190633.87804878,2011.0243902439,97.1707317073171
"8644","27307","2020",7,7,0,220714.285714286,1981.57142857143,122.285714285714
"8645","27309","2020",9,9,0,191994.444444444,2043.55555555556,106.111111111111
"8646","27310","2020",8,8,0,126292.5,1293.625,99.875
"8647","27311","2020",10,10,0,162550,1658.8,99.9
"8648","27312","2020",5,5,0,246620.8,1929.2,127.8
"8649","27313","2020",14,14,0,190464.285714286,1850.5,111.857142857143
"8650","27315","2020",2,2,0,250150,1812,141
"8651","27316","2020",17,17,0,172655.882352941,2017.76470588235,86.2941176470588
"8652","27317","2020",8,8,0,165837.5,1400.375,116.5
"8653","27318","2020",4,4,0,154000,1571,101.75
"8654","27319","2020",5,5,0,138580,1417,93
"8655","27320","2020",4,4,0,170675,1595.75,115
"8656","27322","2020",16,16,0,178273.5,1597,117.4375
"8657","27323","2020",10,10,0,109000,1097.5,96.8
"8658","27324","2020",13,13,0,185615.384615385,1960.46153846154,94.1538461538462
"8659","27325","2020",1,1,0,49000,831,59
"8660","27326","2020",6,6,0,286716.666666667,1977.16666666667,139
"8661","27327","2020",1,1,0,80000,1212,66
"8662","27329","2020",7,7,0,175000,1887.28571428571,95.8571428571429
"8663","27331","2020",5,5,0,187000,1883,98.8
"8664","27332","2020",11,11,0,198009.090909091,2129.90909090909,103.363636363636
"8665","27333","2020",10,10,0,176411.3,2022.3,89.5
"8666","27334","2020",3,3,0,101333.333333333,1155,89.3333333333333
"8667","27335","2020",17,17,0,204151.764705882,1842.35294117647,115.117647058824
"8668","27336","2020",4,4,0,208875,1853,114.25
"8669","27337","2020",9,9,0,186000,1882,99.7777777777778
"8670","27338","2020",12,12,0,161466.666666667,1850.58333333333,91.5
"8671","27339","2020",15,14,1,192566.666666667,1633.73333333333,136.066666666667
"8672","27340","2020",8,8,0,245805,1798,133
"8673","27341","2020",1,1,0,130000,1000,130
"8674","27342","2020",2,2,0,154000,1650,92.5
"8675","27343","2020",17,17,0,296847.058823529,2425.41176470588,144.117647058824
"8676","27345","2020",10,10,0,200250,1722.8,121.3
"8677","27346","2020",1,1,0,157000,1586,99
"8678","27347","2020",12,12,0,200645.833333333,2068.41666666667,99.3333333333333
"8679","27348","2020",17,17,0,169317.647058824,1866.23529411765,90.5294117647059
"8680","27349","2020",16,16,0,212987.625,1724,121.875
"8681","27350","2020",11,11,0,167055.454545455,1763,103.909090909091
"8682","27351","2020",14,14,0,191785.714285714,1886.35714285714,107.5
"8683","27353","2020",5,5,0,209562,1757.4,128.8
"8684","27354","2020",6,6,0,166233.333333333,1524.83333333333,109.5
"8685","27355","2020",50,44,6,166352.16,2075.82,86.58
"8686","27358","2020",6,6,0,223223.333333333,2230.83333333333,107
"8687","27359","2020",4,4,0,90125,941,97.75
"8688","27360","2020",7,7,0,136285.714285714,1663,86.1428571428571
"8689","27361","2020",6,6,0,211550,2269.83333333333,105.5
"8690","27363","2020",3,3,0,163635,1307.33333333333,109.333333333333
"8691","27364","2020",2,2,0,104404.5,1255.5,79.5
"8692","27365","2020",19,19,0,165394.736842105,1617.47368421053,104.947368421053
"8693","27367","2020",15,15,0,176171.333333333,1866,99.3333333333333
"8694","27368","2020",4,4,0,134921.25,1163.5,121.25
"8695","27370","2020",9,9,0,143965.555555556,1306,116
"8696","27371","2020",3,3,0,184716.666666667,2917.33333333333,65.6666666666667
"8697","27372","2020",12,12,0,176624.5,1695.41666666667,111.166666666667
"8698","27373","2020",7,7,0,205357.142857143,2205.14285714286,105.714285714286
"8699","27374","2020",11,11,0,141600,1650.45454545455,94.9090909090909
"8700","27375","2020",208,145,63,144849.798076923,1757.68269230769,82.4423076923077
"8701","27376","2020",1,1,0,160000,1584,101
"8702","27377","2020",10,10,0,169500,1396.1,126.2
"8703","27378","2020",23,23,0,147077.826086957,1424.86956521739,110.130434782609
"8704","27379","2020",14,14,0,176069.285714286,1908.85714285714,94
"8705","27380","2020",5,5,0,126600,1461.4,101
"8706","27381","2020",1,1,0,140000,1556,90
"8707","27382","2020",8,8,0,195356.25,1773.25,113.625
"8708","27383","2020",5,5,0,178560,2006.4,92.2
"8709","27384","2020",12,12,0,214092.833333333,2225.16666666667,102.083333333333
"8710","27385","2020",27,23,4,138009.62962963,1563.48148148148,87.8888888888889
"8711","27386","2020",18,17,1,151552.777777778,1831.16666666667,83.7222222222222
"8712","27388","2020",16,16,0,153671.4375,1742.375,87.75
"8713","27389","2020",6,6,0,303516.666666667,2361.66666666667,133.5
"8714","27390","2020",22,22,0,153756.045454545,1522.04545454545,105.090909090909
"8715","27391","2020",30,30,0,195654.733333333,2137.63333333333,99.2666666666667
"8716","27392","2020",6,6,0,133331.666666667,1375,113.833333333333
"8717","27393","2020",13,13,0,159620,1741.46153846154,93.9230769230769
"8718","27394","2020",6,6,0,171333.333333333,1868,93.8333333333333
"8719","27396","2020",5,5,0,141200,1500,99.4
"8720","27397","2020",23,22,1,206576.695652174,2303.47826086957,94.7391304347826
"8721","27398","2020",21,21,0,181892.857142857,1772.71428571429,104.095238095238
"8722","27400","2020",8,8,0,210244.5,2072.75,101.875
"8723","27401","2020",1,1,0,244000,1627,150
"8724","27403","2020",1,1,0,236000,2165,109
"8725","27405","2020",1,1,0,136500,2438,56
"8726","27406","2020",12,10,2,141039.5,1426.33333333333,104.333333333333
"8727","27407","2020",2,2,0,156000,2691,63
"8728","27408","2020",10,10,0,219231.9,2086.3,108.4
"8729","27410","2020",12,12,0,181670.833333333,2071.25,97.6666666666667
"8730","27411","2020",2,2,0,185500,1302.5,142.5
"8731","27412","2020",10,10,0,125850,1233.3,114.2
"8732","27413","2020",7,6,1,170378.571428571,1321.57142857143,118.142857142857
"8733","27414","2020",16,16,0,114462.5,1037.75,108.25
"8734","27415","2020",7,7,0,213538.571428571,1882.57142857143,116.857142857143
"8735","27417","2020",19,19,0,161300.736842105,1611.52631578947,107.421052631579
"8736","27418","2020",2,2,0,188500,2094.5,90
"8737","27419","2020",14,14,0,208091.785714286,2204.92857142857,105.142857142857
"8738","27420","2020",6,6,0,141541.333333333,1839.83333333333,77.6666666666667
"8739","27421","2020",12,12,0,166900,1544.5,113.083333333333
"8740","27422","2020",9,9,0,206444.444444444,1940.55555555556,106.111111111111
"8741","27423","2020",18,18,0,203229.833333333,1781.77777777778,125.833333333333
"8742","27424","2020",4,4,0,136237.5,1239.25,108.5
"8743","27425","2020",36,36,0,145605.555555556,1526.77777777778,97.7777777777778
"8744","27426","2020",27,27,0,217041.888888889,2148.14814814815,103.333333333333
"8745","27427","2020",9,9,0,124155.555555556,1311.77777777778,93.4444444444444
"8746","27428","2020",61,49,12,146899.672131148,1864.31147540984,82.7377049180328
"8747","27429","2020",2,2,0,165500,2127,95
"8748","27430","2020",6,6,0,165356.333333333,1647.83333333333,105.833333333333
"8749","27431","2020",14,14,0,122078.571428571,1299.14285714286,97.4285714285714
"8750","27432","2020",10,10,0,171050,1375.3,121.5
"8751","27433","2020",4,4,0,120000,1277.25,95.75
"8752","27435","2020",4,4,0,162250,1762.75,90.75
"8753","27436","2020",6,6,0,142866.666666667,1430.16666666667,102.666666666667
"8754","27437","2020",5,5,0,203600,1777.8,128
"8755","27438","2020",15,12,3,155470,1362.8,117.666666666667
"8756","27439","2020",16,16,0,218304.375,1937.125,112.0625
"8757","27440","2020",7,7,0,275071.428571429,2107.57142857143,124.142857142857
"8758","27441","2020",3,3,0,111785,1395,76.6666666666667
"8759","27442","2020",5,5,0,51300,752,68.8
"8760","27444","2020",6,6,0,197500,1436,125.5
"8761","27445","2020",3,3,0,201666.666666667,1515.66666666667,137.333333333333
"8762","27446","2020",6,6,0,149283.333333333,1609.16666666667,95.3333333333333
"8763","27447","2020",13,13,0,150876.923076923,1660.23076923077,99
"8764","27448","2020",66,61,5,220998.560606061,2302.60606060606,98.7878787878788
"8765","27451","2020",5,5,0,199640,2340,91
"8766","27453","2020",21,21,0,160985.714285714,1669.85714285714,97.6190476190476
"8767","27454","2020",8,8,0,197550,1571.25,131.375
"8768","27455","2020",3,3,0,134300,1642,78
"8769","27456","2020",12,12,0,169505.666666667,1761,98.9166666666667
"8770","27457","2020",15,15,0,126318.466666667,1389.33333333333,96.6
"8771","27458","2020",24,24,0,155051.75,1623.375,99.0416666666667
"8772","27459","2020",1,1,0,192000,1882,102
"8773","27460","2020",4,4,0,177475,1833,98.5
"8774","27462","2020",5,5,0,132900,1647.2,74.6
"8775","27463","2020",9,9,0,178211.111111111,1950.44444444444,100
"8776","27464","2020",9,9,0,190444.444444444,1817,116.555555555556
"8777","27465","2020",7,7,0,225947.285714286,1820.85714285714,117.428571428571
"8778","27466","2020",3,3,0,109000,1274.33333333333,91.3333333333333
"8779","27467","2020",134,97,37,137755.634328358,1787.65671641791,80.6865671641791
"8780","27468","2020",4,4,0,149875,1164.75,135
"8781","27469","2020",47,44,3,171625.829787234,2064.82978723404,91.2340425531915
"8782","27470","2020",12,12,0,111225,1491.5,79.4166666666667
"8783","27471","2020",3,3,0,294666.666666667,2317,129
"8784","27472","2020",6,6,0,114150,1533.5,77.1666666666667
"8785","27473","2020",11,11,0,211427.272727273,1699.81818181818,127.818181818182
"8786","27474","2020",15,15,0,189020,1881.2,107.933333333333
"8787","27475","2020",2,2,0,135000,1360,106.5
"8788","27476","2020",11,11,0,163504.545454545,1868,91.7272727272727
"8789","27477","2020",12,12,0,258993.333333333,2152.33333333333,116.666666666667
"8790","27478","2020",8,8,0,209736.5,1730.875,123
"8791","27480","2020",9,9,0,149852.222222222,1668.55555555556,96.4444444444444
"8792","27481","2020",6,6,0,231616.666666667,1602.83333333333,150.333333333333
"8793","27482","2020",3,3,0,284133.333333333,2195.66666666667,126
"8794","27483","2020",8,8,0,173562.5,1757,101.25
"8795","27485","2020",20,20,0,85087.5,1194.25,70.65
"8796","27486","2020",9,8,1,130740,1404,94.7777777777778
"8797","27487","2020",8,8,0,175937.5,1405.375,131.5
"8798","27488","2020",1,1,0,204400,2086,98
"8799","27489","2020",8,8,0,186769.375,1955.25,102.25
"8800","27490","2020",1,1,0,175440,1772,99
"8801","27492","2020",7,7,0,101071.428571429,1234.71428571429,84.7142857142857
"8802","27493","2020",45,44,1,170630.355555556,1773.08888888889,96.3777777777778
"8803","27495","2020",7,7,0,187571.428571429,2669.57142857143,99.5714285714286
"8804","27496","2020",16,16,0,174221.0625,1593.875,111.25
"8805","27497","2020",13,13,0,187907.153846154,1588.15384615385,119.923076923077
"8806","27498","2020",5,5,0,145450,1458.4,107.6
"8807","27500","2020",36,30,6,148548.611111111,1712.80555555556,87.9722222222222
"8808","27501","2020",4,4,0,249750,1689.75,151.5
"8809","27502","2020",39,39,0,108354.512820513,1206.35897435897,91.3846153846154
"8810","27504","2020",17,17,0,184327.058823529,1736.23529411765,108.470588235294
"8811","27505","2020",4,4,0,213393.75,1754.75,125.25
"8812","27507","2020",35,32,3,150115.714285714,1974.88571428571,79.6
"8813","27508","2020",3,3,0,192000,1589.33333333333,125
"8814","27511","2020",10,10,0,171400,2029.8,89.3
"8815","27512","2020",12,12,0,153375,1976.83333333333,86.9166666666667
"8816","27514","2020",8,8,0,186087.5,2055,104.375
"8817","27516","2020",22,22,0,165814.090909091,1460.54545454545,117.681818181818
"8818","27517","2020",25,25,0,190786.88,2111.04,97.36
"8819","27518","2020",11,11,0,147251.818181818,1444.09090909091,102.636363636364
"8820","27520","2020",5,5,0,166420,2561.4,71.8
"8821","27521","2020",3,3,0,206000,1532.66666666667,133.333333333333
"8822","27522","2020",7,7,0,181822.857142857,2183.57142857143,95.1428571428571
"8823","27524","2020",10,10,0,150830,1580.9,98.4
"8824","27525","2020",6,6,0,243916.666666667,1932.5,127
"8825","27527","2020",5,5,0,178400,1783.6,118.2
"8826","27528","2020",50,38,12,191933,2133.22,89.1
"8827","27529","2020",13,13,0,208907.692307692,1830.76923076923,114.538461538462
"8828","27530","2020",2,2,0,91650,2231,47
"8829","27531","2020",4,4,0,185000,1654.25,106.25
"8830","27533","2020",6,5,1,175183.333333333,2003.66666666667,97.1666666666667
"8831","27534","2020",16,16,0,164860.6875,1560.625,112.4375
"8832","27535","2020",1,1,0,62000,2214,28
"8833","27536","2020",14,14,0,170462.857142857,1638.42857142857,106.357142857143
"8834","27537","2020",15,14,1,157733.333333333,1619.86666666667,98.2666666666667
"8835","27538","2020",10,9,1,242233,1587.5,153.8
"8836","27539","2020",1,1,0,63450,453,140
"8837","27540","2020",9,9,0,162116.666666667,1636.77777777778,100.333333333333
"8838","27541","2020",6,6,0,274500,2376.16666666667,105.833333333333
"8839","27542","2020",7,7,0,154928.571428571,1635.28571428571,98.2857142857143
"8840","27543","2020",15,15,0,190650.2,1931.6,102.4
"8841","27544","2020",4,4,0,164767.5,1964.75,86
"8842","27545","2020",4,4,0,542500,2980.75,192.5
"8843","27546","2020",3,3,0,174433.333333333,1492.33333333333,125
"8844","27547","2020",18,18,0,120174.055555556,1401.66666666667,88.8888888888889
"8845","27548","2020",15,15,0,175971.333333333,1685.06666666667,109.6
"8846","27550","2020",9,9,0,195010,1766.88888888889,107.666666666667
"8847","27552","2020",4,4,0,143650,1141.75,127.75
"8848","27553","2020",4,4,0,141250,1394.25,72.25
"8849","27554","2020",42,42,0,227029.761904762,2310.45238095238,103.547619047619
"8850","27555","2020",3,3,0,228340,1694,136
"8851","27556","2020",2,2,0,109500,1902,58
"8852","27557","2020",5,5,0,178180,1735.2,96.2
"8853","27560","2020",1,1,0,205000,2470,83
"8854","27561","2020",10,10,0,291800,1939.5,147.8
"8855","27562","2020",56,37,19,185079.464285714,2181.05357142857,87
"8856","27563","2020",15,15,0,193806.666666667,1965.33333333333,104.866666666667
"8857","27564","2020",4,4,0,95750,1282.5,76.25
"8858","27565","2020",6,6,0,166083.333333333,1596.33333333333,105.333333333333
"8859","27567","2020",7,7,0,182407.142857143,1665.85714285714,114.428571428571
"8860","27568","2020",9,9,0,149838.888888889,1568.22222222222,102.555555555556
"8861","27569","2020",4,4,0,169575,1545,104
"8862","27571","2020",6,6,0,168487.666666667,1408,115.666666666667
"8863","27572","2020",4,4,0,162000,1899,86.5
"8864","27576","2020",7,7,0,232380,1479.57142857143,149.428571428571
"8865","27577","2020",12,11,1,106916.666666667,1474.25,76.5
"8866","27578","2020",9,9,0,152583.333333333,1317.66666666667,113.555555555556
"8867","27580","2020",35,35,0,228313.685714286,2019.28571428571,114.428571428571
"8868","27582","2020",19,19,0,206647.368421053,1981.57894736842,102.842105263158
"8869","27584","2020",5,5,0,121290,1357.8,95.2
"8870","27586","2020",4,4,0,145750,1912.25,83
"8871","27587","2020",13,13,0,138392.307692308,1348.69230769231,94.6153846153846
"8872","27589","2020",10,10,0,219800,1737.3,131.1
"8873","27590","2020",4,4,0,126665,1257,96
"8874","27591","2020",18,18,0,219981.666666667,2246.38888888889,108.722222222222
"8875","27592","2020",6,6,0,138283.333333333,1672,86.1666666666667
"8876","27593","2020",15,15,0,174671.8,1978.93333333333,88.4
"8877","27594","2020",5,5,0,178540,1681.8,112.4
"8878","27595","2020",13,13,0,196823.846153846,1800.15384615385,117.076923076923
"8879","27597","2020",14,14,0,218464.285714286,1924.78571428571,105.714285714286
"8880","27598","2020",16,16,0,140693.75,1482.625,95.1875
"8881","27599","2020",12,12,0,281047.5,2349.5,118.333333333333
"8882","27601","2020",4,4,0,195571.25,1997,112.5
"8883","27602","2020",75,75,0,156401.133333333,1626.82666666667,100.04
"8884","27603","2020",10,10,0,186150,1819.1,110.3
"8885","27604","2020",3,3,0,223750.666666667,1809.66666666667,119.666666666667
"8886","27605","2020",6,6,0,344769,2727.66666666667,133.333333333333
"8887","27606","2020",14,14,0,159848.571428571,1702.42857142857,101.642857142857
"8888","27608","2020",9,9,0,134555.555555556,1590.55555555556,91.7777777777778
"8889","27609","2020",5,5,0,135300,1276.4,107.6
"8890","27610","2020",1,1,0,40000,714,56
"8891","27611","2020",7,7,0,193142.857142857,1849.42857142857,103.142857142857
"8892","27612","2020",5,5,0,212600,2127.2,106.2
"8893","27613","2020",8,8,0,147375,1322.75,109.875
"8894","27614","2020",3,3,0,167833.333333333,1463.33333333333,114.666666666667
"8895","27615","2020",4,4,0,221175,1979,116.75
"8896","27616","2020",24,24,0,208134.75,1765.5,124.875
"8897","27617","2020",5,5,0,137330,1661.2,81.6
"8898","27618","2020",4,4,0,122225,1607.75,74.75
"8899","27620","2020",9,9,0,273570,2762.44444444444,96.5555555555556
"8900","27621","2020",1,1,0,219500,2386,92
"8901","27622","2020",25,25,0,138248,1463,97.04
"8902","27623","2020",9,9,0,164797.777777778,1787.11111111111,97.2222222222222
"8903","27624","2020",4,4,0,176375,2399.25,89.25
"8904","27625","2020",4,4,0,203020,1852.5,129.5
"8905","27627","2020",4,4,0,108250,1206.5,85
"8906","27629","2020",20,19,1,157385,1643.7,104.75
"8907","27630","2020",3,3,0,141000,1348.33333333333,105.333333333333
"8908","27631","2020",3,3,0,131666.666666667,1816.33333333333,75.6666666666667
"8909","27632","2020",9,9,0,229320.222222222,1982.77777777778,111.333333333333
"8910","27633","2020",2,2,0,278750,1565,179
"8911","27635","2020",3,3,0,151333.333333333,3153.33333333333,64
"8912","27638","2020",36,36,0,192783.333333333,1783.58333333333,111.138888888889
"8913","27640","2020",5,5,0,158520,1517.8,106.8
"8914","27641","2020",7,7,0,205078.571428571,2030.57142857143,108.142857142857
"8915","27643","2020",22,22,0,134735.909090909,1347.86363636364,108.818181818182
"8916","27644","2020",7,7,0,216888.428571429,2036.14285714286,114.571428571429
"8917","27645","2020",2,2,0,155000,1934,83.5
"8918","27646","2020",10,10,0,221757.4,1875.6,125.9
"8919","27649","2020",6,6,0,164458.333333333,1754.66666666667,90.1666666666667
"8920","27650","2020",6,6,0,163945.333333333,2125.83333333333,94.8333333333333
"8921","27652","2020",7,7,0,196385.714285714,2309.28571428571,86.8571428571429
"8922","27654","2020",14,14,0,172857.142857143,1785.07142857143,97.1428571428571
"8923","27655","2020",8,8,0,131812.5,1627.625,84.75
"8924","27656","2020",25,25,0,156372.4,1664.8,97.16
"8925","27658","2020",6,6,0,170750,1725.66666666667,102.5
"8926","27659","2020",2,2,0,372950,1906,200.5
"8927","27660","2020",9,9,0,134555.555555556,1243.55555555556,106.777777777778
"8928","27661","2020",3,3,0,215000,2006.33333333333,111.666666666667
"8929","27662","2020",7,7,0,186652.857142857,1725.57142857143,119.428571428571
"8930","27663","2020",1,1,0,175000,2059,85
"8931","27664","2020",15,15,0,162306.666666667,1730.93333333333,102.4
"8932","27665","2020",15,15,0,165103.333333333,1853.8,93.3333333333333
"8933","27666","2020",4,4,0,143750,1398,97.5
"8934","27667","2020",5,5,0,175200,1275,139.4
"8935","27668","2020",12,12,0,177688.166666667,1871.33333333333,98.5833333333333
"8936","27669","2020",1,1,0,166600,1772,94
"8937","27670","2020",11,11,0,179098.272727273,1883.81818181818,105.454545454545
"8938","27671","2020",7,7,0,190585.714285714,1886.57142857143,108.285714285714
"8939","27672","2020",4,3,1,185910,2403.75,91
"8940","27673","2020",5,5,0,136860,1468.2,89
"8941","27674","2020",9,9,0,318723.222222222,2319.33333333333,140.222222222222
"8942","27677","2020",4,4,0,186500,1838.25,106.5
"8943","27678","2020",17,17,0,174226.470588235,1667.52941176471,107.294117647059
"8944","27679","2020",119,100,19,141804.226890756,1535.0756302521,95.8487394957983
"8945","27680","2020",6,6,0,118017,970.666666666667,109.333333333333
"8946","27681","2020",314,158,156,182773.203821656,2270.32802547771,81.0891719745223
"8947","27682","2020",18,18,0,212968.055555556,1813,122.944444444444
"8948","27683","2020",5,5,0,156198,2077,79.2
"8949","27684","2020",13,13,0,194836.153846154,1898.23076923077,107.076923076923
"8950","27685","2020",18,18,0,140694.444444444,1407,101.944444444444
"8951","27686","2020",2,2,0,422090,3069,138
"8952","27689","2020",6,6,0,251983.333333333,2320.33333333333,112
"8953","27690","2020",2,2,0,121450,805,140.5
"8954","27691","2020",10,10,0,219000.6,2041.7,112.7
"8955","27693","2020",16,16,0,176656.1875,1739.875,114
"8956","27694","2020",3,3,0,257133.333333333,2527,105.333333333333
"8957","27695","2020",2,2,0,248500,1838.5,133
"8958","27696","2020",17,17,0,173852.941176471,2032.47058823529,93.5294117647059
"8959","27698","2020",8,8,0,175500,1860.625,103.125
"8960","27700","2020",8,8,0,178334.375,1953.625,90.25
"8961","27701","2020",84,77,7,128598.80952381,1441.47619047619,88.75
"8962","28001","2020",43,41,2,222066.976744186,2271.39534883721,103.767441860465
"8963","28003","2020",1,1,0,173500,1928,90
"8964","28004","2020",6,6,0,163933.333333333,1320.66666666667,133.333333333333
"8965","28005","2020",7,7,0,140456.428571429,1269.14285714286,108.428571428571
"8966","28006","2020",21,21,0,209470.476190476,1870,115.571428571429
"8967","28007","2020",45,40,5,208172.444444444,2142.6,103.266666666667
"8968","28008","2020",6,6,0,167666.666666667,1480.33333333333,119
"8969","28009","2020",2,2,0,138995,1292.5,107.5
"8970","28010","2020",8,8,0,158150,1156.25,126.375
"8971","28012","2020",76,76,0,95134,1114.94736842105,89.6710526315789
"8972","28013","2020",22,22,0,164985.909090909,1877.36363636364,89.6363636363636
"8973","28014","2020",5,5,0,157640,1851.2,84.8
"8974","28015","2020",75,62,13,196729.2,2195.52,93.6266666666667
"8975","28016","2020",2,2,0,131000,999,117
"8976","28018","2020",36,36,0,91241.0277777778,1077.02777777778,86.3611111111111
"8977","28019","2020",3,3,0,128000,1397,87
"8978","28021","2020",15,15,0,134145.333333333,1571.66666666667,86.4
"8979","28022","2020",11,11,0,183577.272727273,1778.90909090909,105.363636363636
"8980","28023","2020",22,22,0,214135,2161.5,104.181818181818
"8981","28024","2020",18,18,0,227368.944444444,2283.77777777778,101
"8982","28025","2020",1,1,0,165000,1650,100
"8983","28026","2020",3,3,0,179000,1314,133.666666666667
"8984","28027","2020",28,28,0,88675,1219.03571428571,75.4285714285714
"8985","28028","2020",5,5,0,114100,1382,80.2
"8986","28029","2020",5,5,0,100700,968.4,105.6
"8987","28030","2020",6,6,0,151600,1307.83333333333,110.666666666667
"8988","28031","2020",5,5,0,131000,1510.6,88.2
"8989","28032","2020",5,5,0,139200,1254.2,118
"8990","28033","2020",15,15,0,142820.333333333,1405.86666666667,108.533333333333
"8991","28034","2020",14,14,0,217566.428571429,2078.5,106.928571428571
"8992","28035","2020",12,12,0,201066.666666667,2019.5,117.416666666667
"8993","28036","2020",16,16,0,280135.875,2784.5,103.5
"8994","28037","2020",6,6,0,121605,1412.5,84.6666666666667
"8995","28038","2020",3,3,0,100500,1042.33333333333,108.333333333333
"8996","28039","2020",35,32,3,196246,2014.94285714286,100.942857142857
"8997","28040","2020",3,3,0,130666.666666667,1442,94.6666666666667
"8998","28041","2020",4,4,0,192000,1450,143.5
"8999","28045","2020",1,1,0,279000,1885,148
"9000","28046","2020",6,6,0,150083.333333333,1408.5,112.5
"9001","28047","2020",10,10,0,182477.6,1470.3,132
"9002","28048","2020",8,8,0,143906.25,1462.125,99.875
"9003","28050","2020",2,2,0,237000,1893.5,126.5
"9004","28051","2020",68,67,1,112695.308823529,1403.58823529412,84.4558823529412
"9005","28052","2020",14,14,0,216578.571428571,2204.21428571429,101.571428571429
"9006","28053","2020",5,5,0,349120,2184.2,149
"9007","28054","2020",8,8,0,169662.5,1753.5,100.5
"9008","28055","2020",14,14,0,197196.428571429,2330.78571428571,106.928571428571
"9009","28056","2020",33,33,0,294013.363636364,2323.63636363636,130.181818181818
"9010","28057","2020",8,8,0,110875,1379.125,82.875
"9011","28058","2020",4,4,0,264812.5,2053,125.75
"9012","28059","2020",16,16,0,132329.375,1369.6875,102.5625
"9013","28060","2020",2,2,0,123000,816.5,142
"9014","28061","2020",52,49,3,115103.615384615,1182.40384615385,100.846153846154
"9015","28062","2020",11,11,0,249401.818181818,2443.09090909091,104.909090909091
"9016","28064","2020",33,33,0,204137.151515152,2256.9696969697,96.7575757575758
"9017","28067","2020",3,3,0,100666.666666667,940.333333333333,101.333333333333
"9018","28068","2020",5,5,0,180829.4,1724.6,103.8
"9019","28070","2020",48,48,0,252348.395833333,2359.33333333333,110.0625
"9020","28071","2020",7,7,0,121857.142857143,1294.14285714286,88.1428571428571
"9021","28072","2020",7,7,0,135957.142857143,1452.85714285714,96.8571428571429
"9022","28073","2020",5,5,0,261824,1795.2,147.2
"9023","28074","2020",6,6,0,177400,1390.83333333333,131.666666666667
"9024","28075","2020",16,16,0,104697.25,1093.8125,95.75
"9025","28076","2020",1,1,0,405000,2288,177
"9026","28077","2020",5,5,0,110580,1235.2,90.2
"9027","28078","2020",3,3,0,111333.333333333,1286,85.6666666666667
"9028","28079","2020",11,11,0,68281.8181818182,877,88.4545454545455
"9029","28080","2020",11,11,0,104363.636363636,1049.72727272727,94
"9030","28081","2020",5,5,0,126400,1282,99
"9031","28082","2020",10,10,0,224940,1942.8,126.9
"9032","28084","2020",11,10,1,220151.818181818,1973.90909090909,112.727272727273
"9033","28085","2020",682,215,467,169497.171554252,2398.37829912023,70.0395894428153
"9034","28086","2020",7,7,0,106556.571428571,1100.28571428571,99.1428571428571
"9035","28087","2020",4,4,0,136500,1264.5,104
"9036","28088","2020",141,117,24,107036.120567376,1252.10638297872,87.6028368794326
"9037","28089","2020",32,29,3,133734.375,1438.34375,100.28125
"9038","28090","2020",1,1,0,126000,1326,95
"9039","28091","2020",4,4,0,112125,1246.25,84.5
"9040","28092","2020",6,6,0,127500,1536.66666666667,88.3333333333333
"9041","28094","2020",34,31,3,200039.852941176,1845.08823529412,110.5
"9042","28095","2020",3,3,0,228666.666666667,2063.66666666667,109
"9043","28096","2020",16,16,0,198522.5,2093.5,95
"9044","28098","2020",34,34,0,227714.676470588,2121.29411764706,111.852941176471
"9045","28099","2020",16,16,0,149855.4375,1510.875,103.6875
"9046","28100","2020",2,2,0,223500,1800.5,124
"9047","28102","2020",8,8,0,161673,1493,116.25
"9048","28103","2020",107,105,2,100807.009345794,1101.77570093458,92.6542056074766
"9049","28104","2020",8,8,0,172625,1890.25,98.875
"9050","28105","2020",7,7,0,141421.428571429,1549.28571428571,106.142857142857
"9051","28106","2020",7,7,0,70250,1040,71
"9052","28107","2020",3,3,0,198333.333333333,1739.66666666667,115.666666666667
"9053","28108","2020",1,1,0,110500,2125,52
"9054","28109","2020",5,5,0,119200,1263,101.4
"9055","28110","2020",66,32,34,202194.166666667,2444.4696969697,85.6060606060606
"9056","28111","2020",9,9,0,115722.222222222,1204.66666666667,97.2222222222222
"9057","28113","2020",28,26,2,221246.428571429,1866.21428571429,120.928571428571
"9058","28114","2020",1,1,0,66000,1015,65
"9059","28116","2020",28,27,1,222597.857142857,1951,106.964285714286
"9060","28117","2020",6,6,0,165791.666666667,2170.16666666667,82.3333333333333
"9061","28118","2020",5,5,0,229998,1934.4,114.6
"9062","28119","2020",1,1,0,45450,1033,44
"9063","28120","2020",7,7,0,149164.857142857,1556.14285714286,101.571428571429
"9064","28121","2020",1,1,0,35000,593,59
"9065","28122","2020",15,15,0,211779.933333333,1929.06666666667,113.533333333333
"9066","28123","2020",5,5,0,116600,1378,86
"9067","28124","2020",14,14,0,148090.714285714,1538.64285714286,101.142857142857
"9068","28126","2020",5,5,0,76400,820,88.8
"9069","28127","2020",18,18,0,87521.1111111111,1221.11111111111,78.1111111111111
"9070","28128","2020",4,4,0,155918.75,1998.5,77.75
"9071","28129","2020",24,24,0,186940,1841.04166666667,119.583333333333
"9072","28130","2020",19,19,0,131521.631578947,1380.94736842105,96.6842105263158
"9073","28132","2020",11,11,0,119010.636363636,1357.18181818182,89.7272727272727
"9074","28134","2020",349,191,158,136219.716332378,1703.57306590258,80.9054441260745
"9075","28135","2020",16,16,0,328453.125,2597.5625,131.875
"9076","28136","2020",8,8,0,203817.625,1715.125,116.125
"9077","28137","2020",14,14,0,247338.214285714,2221.42857142857,111.714285714286
"9078","28140","2020",95,38,57,163617.368421053,2432.89473684211,70.3052631578947
"9079","28141","2020",7,7,0,170484.285714286,1531.28571428571,121
"9080","28142","2020",6,6,0,122833.333333333,1011.66666666667,125.5
"9081","28143","2020",1,1,0,380000,1226,310
"9082","28144","2020",3,3,0,80166.6666666667,958.333333333333,84.6666666666667
"9083","28146","2020",15,14,1,224733.333333333,2153.13333333333,108.333333333333
"9084","28147","2020",8,8,0,176493.75,1758.75,113.25
"9085","28148","2020",4,4,0,116100,1409.75,103.5
"9086","28149","2020",12,12,0,101875,1306.91666666667,79.0833333333333
"9087","28151","2020",2,2,0,175000,1794.5,98.5
"9088","28153","2020",1,1,0,88262,1193,74
"9089","28154","2020",13,13,0,229765.384615385,2016.23076923077,108.538461538462
"9090","28155","2020",4,4,0,165500,1431,112.75
"9091","28156","2020",12,12,0,138485,1554.66666666667,103.333333333333
"9092","28157","2020",2,2,0,62250,885.5,77.5
"9093","28158","2020",15,15,0,328146.4,2922.06666666667,116.066666666667
"9094","28159","2020",7,7,0,166785.714285714,1394.42857142857,109.285714285714
"9095","28160","2020",19,19,0,166534.473684211,1800.42105263158,96.4736842105263
"9096","28161","2020",10,10,0,81645,909.4,91.7
"9097","28162","2020",4,4,0,181330,1386.25,130.75
"9098","28163","2020",6,6,0,184370,1653.5,126
"9099","28164","2020",9,9,0,148100,1681.66666666667,87
"9100","28166","2020",2,2,0,116500,1188,102.5
"9101","28167","2020",7,7,0,136000,1359.42857142857,103.428571428571
"9102","28168","2020",60,53,7,195890.666666667,2037.88333333333,95.8333333333333
"9103","28169","2020",2,2,0,239000,2807.5,85
"9104","28170","2020",1,1,0,190000,2568,74
"9105","28171","2020",11,11,0,172545.454545455,1408.54545454545,119.272727272727
"9106","28172","2020",15,14,1,220096.666666667,2304.46666666667,99
"9107","28173","2020",15,14,1,205875.333333333,2080.06666666667,108.866666666667
"9108","28175","2020",1,1,0,95000,905,105
"9109","28176","2020",14,14,0,125362,1260.21428571429,101.928571428571
"9110","28177","2020",10,10,0,285520,1980.7,150.9
"9111","28178","2020",6,6,0,259166.666666667,2535.66666666667,109.833333333333
"9112","28180","2020",5,5,0,238655.8,2386.8,107.4
"9113","28182","2020",5,5,0,85434,994,91.6
"9114","28183","2020",12,12,0,157225,1595.58333333333,101.25
"9115","28184","2020",6,6,0,170026.666666667,1557.5,116.166666666667
"9116","28185","2020",17,17,0,317185.882352941,2735.17647058824,120
"9117","28187","2020",9,9,0,172333.333333333,1539.22222222222,110.666666666667
"9118","28188","2020",14,14,0,208244.285714286,2060.71428571429,102.357142857143
"9119","28189","2020",8,8,0,121777.5,1258.875,101.75
"9120","28190","2020",11,11,0,135909.090909091,1159.81818181818,116.363636363636
"9121","28191","2020",36,27,9,204771.944444444,2370.13888888889,90.4166666666667
"9122","28192","2020",3,3,0,106116.666666667,1172.66666666667,90
"9123","28193","2020",3,3,0,220522,2082.33333333333,107
"9124","28194","2020",9,9,0,170323,1481.33333333333,117.444444444444
"9125","28195","2020",10,10,0,234263,2232.7,107.4
"9126","28196","2020",51,51,0,116182.352941176,1209.49019607843,96.7254901960784
"9127","28197","2020",1,1,0,215000,1433,150
"9128","28198","2020",13,13,0,127814.615384615,1240.07692307692,101.846153846154
"9129","28199","2020",35,33,2,129328.285714286,1476.54285714286,93.3428571428571
"9130","28200","2020",6,6,0,271063.333333333,1748.66666666667,159.166666666667
"9131","28201","2020",36,35,1,212165.277777778,2083.94444444444,104.25
"9132","28202","2020",5,5,0,157300,1481.6,111.4
"9133","28203","2020",10,10,0,191450,1766.8,111.6
"9134","28206","2020",11,11,0,98636.3636363636,1080.90909090909,90.3636363636364
"9135","28207","2020",4,4,0,255375,1677,160.25
"9136","28208","2020",4,4,0,348330,2356.75,164.5
"9137","28209","2020",81,58,23,198832.172839506,2266.97530864198,88.8641975308642
"9138","28210","2020",3,3,0,121466.666666667,1126,120.333333333333
"9139","28211","2020",3,3,0,156166.666666667,1097.66666666667,144
"9140","28212","2020",2,2,0,176500,1024.5,188
"9141","28213","2020",11,10,1,202672.727272727,2125.18181818182,96.8181818181818
"9142","28214","2020",52,51,1,107208.653846154,1238.59615384615,86.5769230769231
"9143","28215","2020",4,4,0,126625,1284,93.5
"9144","28216","2020",7,7,0,194654.285714286,1554.85714285714,128.142857142857
"9145","28217","2020",1,1,0,175000,1167,150
"9146","28218","2020",144,61,83,143115.770833333,2044.65972222222,71.8819444444444
"9147","28219","2020",8,8,0,106725,1278.75,87.625
"9148","28220","2020",86,69,17,224211.523255814,2405.75581395349,94.046511627907
"9149","28221","2020",3,3,0,110160,840.333333333333,130
"9150","28222","2020",5,5,0,168124.4,1568,111.2
"9151","28223","2020",18,18,0,166042.833333333,1769.33333333333,99.9444444444444
"9152","28225","2020",13,13,0,146288.461538462,1621.61538461538,96.8461538461538
"9153","28226","2020",23,23,0,161636.782608696,1587.5652173913,104.521739130435
"9154","28227","2020",73,54,19,190415.205479452,2493.98630136986,81.1232876712329
"9155","28229","2020",132,74,58,159956.363636364,2075.63636363636,78.6136363636364
"9156","28230","2020",9,9,0,197743.333333333,1917.22222222222,103.111111111111
"9157","28231","2020",2,2,0,82500,798,108.5
"9158","28232","2020",15,15,0,137634,1739.4,102.266666666667
"9159","28233","2020",16,16,0,91859.375,1061.875,88.1875
"9160","28234","2020",4,4,0,104050,1225.75,79.25
"9161","28235","2020",6,6,0,249833.333333333,2346.5,108.333333333333
"9162","28236","2020",41,40,1,146389.634146341,1458.9756097561,107.073170731707
"9163","28237","2020",4,4,0,146000,2213.25,64.25
"9164","28239","2020",17,17,0,189724.705882353,1650.58823529412,121.882352941176
"9165","28240","2020",9,9,0,141355.555555556,1682.55555555556,89.7777777777778
"9166","28242","2020",1,1,0,120010,1348,89
"9167","28243","2020",4,4,0,205311,1936.75,122
"9168","28245","2020",4,4,0,187675,2160.75,87.5
"9169","28246","2020",12,12,0,154638.333333333,1282.08333333333,117.333333333333
"9170","28247","2020",8,8,0,299181.25,2115.375,139.125
"9171","28248","2020",8,8,0,140381.25,1179.75,116.875
"9172","28249","2020",9,9,0,215255.555555556,2173.44444444444,98.4444444444444
"9173","28251","2020",17,17,0,212206.352941176,1945.94117647059,116.235294117647
"9174","28252","2020",1,1,0,51000,543,94
"9175","28253","2020",9,9,0,179222.333333333,1342.44444444444,143.777777777778
"9176","28254","2020",11,11,0,136668.181818182,1491.36363636364,93.4545454545455
"9177","28255","2020",3,3,0,123993.666666667,1319.33333333333,87.3333333333333
"9178","28256","2020",3,3,0,119583.333333333,1615.66666666667,79
"9179","28257","2020",2,2,0,158270,1877,85.5
"9180","28259","2020",6,6,0,138408.333333333,1195.5,119.5
"9181","28260","2020",2,2,0,174750,1596,109.5
"9182","28261","2020",11,11,0,115363.636363636,1353.90909090909,87.2727272727273
"9183","28263","2020",9,9,0,112000,1229.77777777778,92.5555555555556
"9184","28264","2020",3,3,0,170000,1168.33333333333,164.666666666667
"9185","28265","2020",12,12,0,103258.333333333,1015,96.6666666666667
"9186","28267","2020",9,9,0,201222.222222222,1967.88888888889,107.555555555556
"9187","28269","2020",17,16,1,234530,2184.82352941176,107.588235294118
"9188","28270","2020",6,6,0,124143.333333333,1572.83333333333,76.5
"9189","28271","2020",1,1,0,60000,600,100
"9190","28272","2020",2,2,0,125820,1178.5,101
"9191","28273","2020",2,2,0,148000,1265,114.5
"9192","28274","2020",4,4,0,116875,1497.5,81.5
"9193","28275","2020",11,11,0,235081.818181818,2054.45454545455,116.909090909091
"9194","28276","2020",3,3,0,123730,1366.33333333333,96
"9195","28277","2020",7,7,0,143610.714285714,1266.57142857143,104.428571428571
"9196","28278","2020",9,8,1,253933.333333333,2451.11111111111,124.777777777778
"9197","28279","2020",64,51,13,163738.09375,1825.484375,94.625
"9198","28280","2020",155,110,45,101470.535483871,1184.30967741935,82.7354838709677
"9199","28281","2020",7,7,0,164371.428571429,1793.71428571429,94.2857142857143
"9200","28282","2020",10,10,0,112900,1152.3,98.8
"9201","28283","2020",4,4,0,155250,1290.25,123.5
"9202","28284","2020",4,4,0,131875,1690,74.5
"9203","28285","2020",8,8,0,192150,2112.5,95.25
"9204","28286","2020",6,6,0,151308.333333333,1744,92.1666666666667
"9205","28287","2020",10,10,0,131250,1417.8,92.5
"9206","28289","2020",5,5,0,209880,1873.8,116.6
"9207","28290","2020",2,2,0,205500,1874.5,111
"9208","28291","2020",10,10,0,163930,2007.2,86.4
"9209","28292","2020",9,9,0,187585.222222222,1910.33333333333,101.555555555556
"9210","28293","2020",20,20,0,176107.8,1788.05,101.95
"9211","28294","2020",16,16,0,187937.5,1897,102.5625
"9212","28296","2020",11,11,0,136213.636363636,1160.72727272727,110.090909090909
"9213","28298","2020",30,24,6,191406.033333333,2127.56666666667,94.7333333333333
"9214","28299","2020",3,3,0,214013.333333333,1812,129.333333333333
"9215","28300","2020",2,2,0,205050,1887,108.5
"9216","28301","2020",4,4,0,165412.5,1983.5,84.75
"9217","28302","2020",21,21,0,134290,1395.66666666667,100.142857142857
"9218","28303","2020",1,1,0,88375,803,110
"9219","28304","2020",8,8,0,140475.75,1469.25,102.375
"9220","28305","2020",10,10,0,116550,1243.2,101.5
"9221","28306","2020",3,3,0,95166.6666666667,1395.66666666667,70.6666666666667
"9222","28308","2020",4,4,0,134252.5,907,157.5
"9223","28309","2020",14,14,0,213329.714285714,2744.07142857143,88.5
"9224","28310","2020",7,7,0,156474.285714286,1362,116
"9225","28312","2020",2,2,0,198000,1349.5,147
"9226","28313","2020",3,3,0,139333.333333333,1413.33333333333,97
"9227","28314","2020",2,2,0,116750,1058,108
"9228","28315","2020",1,1,0,147000,865,170
"9229","28316","2020",1,1,0,234400,2254,104
"9230","28317","2020",7,7,0,208842.857142857,2406.57142857143,90.4285714285714
"9231","28319","2020",7,7,0,168142.857142857,1672.14285714286,96.1428571428571
"9232","28321","2020",18,18,0,281883.333333333,2310.05555555556,125.722222222222
"9233","28322","2020",4,4,0,141875,1162.75,137.25
"9234","28323","2020",2,2,0,301045,2423,132
"9235","28324","2020",13,13,0,174080.769230769,1700,114.615384615385
"9236","28325","2020",17,17,0,182003.823529412,1963.11764705882,95.2352941176471
"9237","28326","2020",9,9,0,110344.444444444,1179.22222222222,110.444444444444
"9238","28327","2020",1,1,0,30500,871,35
"9239","28329","2020",4,4,0,108034.75,972.25,111
"9240","28330","2020",32,31,1,120264.03125,1194.375,105.75
"9241","28331","2020",17,17,0,145682.352941176,1400,104.705882352941
"9242","28332","2020",14,14,0,220600.071428571,1959.57142857143,125.5
"9243","28333","2020",3,3,0,130903.333333333,1145.33333333333,120.666666666667
"9244","28334","2020",25,25,0,109859.2,1160.96,94.6
"9245","28335","2020",12,12,0,100542.25,1074.75,96.75
"9246","28336","2020",2,2,0,121135,1303,101.5
"9247","28337","2020",21,21,0,209890,2206.90476190476,98.8095238095238
"9248","28339","2020",3,3,0,177000,1791.66666666667,98.6666666666667
"9249","28341","2020",4,4,0,135647.5,1483.5,93
"9250","28342","2020",3,3,0,188733.333333333,2208,93.3333333333333
"9251","28343","2020",10,10,0,259107,1947.4,141.4
"9252","28344","2020",1,1,0,120000,1008,119
"9253","28346","2020",1,1,0,140000,2188,64
"9254","28347","2020",24,23,1,304886.25,2760.83333333333,115.166666666667
"9255","28348","2020",42,42,0,139975.357142857,1511.85714285714,92.7619047619048
"9256","28349","2020",2,2,0,148500,1273,117.5
"9257","28350","2020",14,14,0,150093.571428571,1971.14285714286,82.1428571428571
"9258","28351","2020",4,4,0,138912.5,1695.5,86.75
"9259","28352","2020",41,41,0,250036.097560976,2140.48780487805,120.268292682927
"9260","28353","2020",4,4,0,131750,1187.75,124.75
"9261","28354","2020",6,6,0,131650,1088.5,123.333333333333
"9262","28355","2020",4,4,0,568425,2868.75,179.5
"9263","28357","2020",25,25,0,178673.72,1982.44,91.44
"9264","28358","2020",39,37,2,245296.256410256,2214.28205128205,115.487179487179
"9265","28359","2020",56,54,2,145907.142857143,1612.89285714286,94.7321428571429
"9266","28360","2020",6,6,0,199830,1471.83333333333,136.166666666667
"9267","28362","2020",8,8,0,135387.5,1179,122.25
"9268","28363","2020",19,19,0,197526.315789474,1881.21052631579,107.684210526316
"9269","28364","2020",8,8,0,95785,1215,79.5
"9270","28365","2020",8,8,0,164600,1544.75,111
"9271","28366","2020",3,3,0,149450,1936.33333333333,84.6666666666667
"9272","28367","2020",3,3,0,111670,1096.33333333333,99.6666666666667
"9273","28368","2020",1,1,0,221000,1700,130
"9274","28369","2020",9,9,0,142277.777777778,1744.44444444444,83.2222222222222
"9275","28370","2020",6,6,0,161450,1671.66666666667,91.5
"9276","28371","2020",13,13,0,258561.538461538,2243,122.615384615385
"9277","28372","2020",12,12,0,224499.166666667,2063.5,119.166666666667
"9278","28373","2020",60,59,1,116618.166666667,1179.9,99.7
"9279","28374","2020",10,10,0,149215,1614.2,94.8
"9280","28375","2020",7,7,0,232214.285714286,2347,104.857142857143
"9281","28377","2020",26,25,1,178370.923076923,1780.42307692308,110.076923076923
"9282","28378","2020",6,6,0,172210,940,152.166666666667
"9283","28379","2020",6,6,0,188200,2045.33333333333,95
"9284","28380","2020",24,23,1,206109.333333333,1931.875,113.25
"9285","28382","2020",20,20,0,141481,1438.55,101.8
"9286","28383","2020",11,11,0,141527.272727273,1446.90909090909,99.3636363636364
"9287","28385","2020",4,4,0,94267,1088,87.5
"9288","28386","2020",18,18,0,149157.777777778,1671.33333333333,98.0555555555556
"9289","28387","2020",13,13,0,102484.615384615,1032,99.2307692307692
"9290","28388","2020",12,12,0,199352.083333333,2267.75,88.25
"9291","28389","2020",5,5,0,84292.8,1003.6,84.6
"9292","28390","2020",11,11,0,129280.909090909,1092.18181818182,129.272727272727
"9293","28391","2020",40,36,4,129589.25,1488.9,88.15
"9294","28392","2020",3,3,0,82733.3333333333,964,91
"9295","28393","2020",43,43,0,172028.88372093,1599.06976744186,112.186046511628
"9296","28394","2020",18,18,0,162020,1735.11111111111,93.6666666666667
"9297","28395","2020",8,8,0,148421.875,1427,95.5
"9298","28396","2020",2,2,0,84250,943,89
"9299","28397","2020",6,6,0,178300,1667,110
"9300","28398","2020",24,24,0,150796.416666667,1476.875,97.375
"9301","28400","2020",3,3,0,108716.666666667,1131.66666666667,95.3333333333333
"9302","28401","2020",15,15,0,108296.666666667,1248.53333333333,88.4
"9303","28403","2020",6,6,0,265075,2415.83333333333,108.666666666667
"9304","28404","2020",116,90,26,152935.206896552,1735.31034482759,91.301724137931
"9305","28405","2020",15,15,0,175900,2096.93333333333,91.4666666666667
"9306","28406","2020",29,29,0,102093.793103448,1262.10344827586,86.3448275862069
"9307","28407","2020",7,7,0,101957.142857143,1368.28571428571,74.5714285714286
"9308","28409","2020",6,6,0,102433.333333333,1711,66.8333333333333
"9309","28410","2020",2,2,0,68500,634,105
"9310","28411","2020",2,2,0,163500,1032.5,158.5
"9311","28415","2020",29,28,1,196193.103448276,1762.62068965517,116.48275862069
"9312","28417","2020",33,33,0,229943.03030303,2171.84848484848,109.393939393939
"9313","28418","2020",5,5,0,132488,1970.6,81.2
"9314","28419","2020",6,6,0,129708.333333333,1409.16666666667,90.6666666666667
"9315","28421","2020",5,5,0,148800,2331.4,75.6
"9316","28422","2020",40,37,3,133474.5,1595.5,90.925
"9317","28423","2020",11,11,0,180215.545454545,2066.54545454545,94.7272727272727
"9318","28424","2020",21,20,1,113523.80952381,1326.80952380952,85
"9319","28425","2020",10,10,0,207317.3,2022.6,104.4
"9320","28426","2020",4,4,0,126243.75,1171.75,106.25
"9321","29001","2020",16,16,0,156866.9375,1643.1875,99.375
"9322","29002","2020",22,21,1,161695.772727273,1465.81818181818,110.090909090909
"9323","29003","2020",141,96,45,133600.893617021,1842.08510638298,78.4255319148936
"9324","29004","2020",115,106,9,142224.643478261,1486.73043478261,97.3217391304348
"9325","29005","2020",10,10,0,179370,1787,103.5
"9326","29006","2020",174,70,104,195500.528735632,2820.14942528736,69.1609195402299
"9327","29007","2020",24,24,0,72602.7083333333,902.708333333333,86.125
"9328","29008","2020",14,14,0,164178.571428571,1346.07142857143,115.071428571429
"9329","29010","2020",18,18,0,164926.388888889,1417.88888888889,125.277777777778
"9330","29011","2020",29,27,2,263511.275862069,2020.34482758621,130.862068965517
"9331","29012","2020",3,2,1,50000,1148.66666666667,51.6666666666667
"9332","29013","2020",5,5,0,63300,757.2,85.6
"9333","29014","2020",7,7,0,116428.571428571,999.571428571429,119.285714285714
"9334","29015","2020",28,28,0,199558.928571429,1841.96428571429,108.892857142857
"9335","29016","2020",21,21,0,63713.5714285714,776.761904761905,82
"9336","29017","2020",12,12,0,173983.75,1876,96.5
"9337","29018","2020",9,9,0,75416.6666666667,790.777777777778,90.2222222222222
"9338","29019","2020",3089,750,2339,124668.856587893,1767.89316931046,71.1709291032697
"9339","29020","2020",78,73,5,138674.756410256,1373.32051282051,102.371794871795
"9340","29021","2020",36,34,2,190322,1996.52777777778,93.2222222222222
"9341","29022","2020",74,61,13,154339.148648649,1840.85135135135,91.3648648648649
"9342","29023","2020",84,57,27,238835.44047619,2467.70238095238,93.5952380952381
"9343","29024","2020",99,83,16,93924.9595959596,1149.88888888889,83.0707070707071
"9344","29025","2020",21,21,0,139330.238095238,1381.38095238095,105.428571428571
"9345","29026","2020",74,64,10,109828.689189189,1218.93243243243,90.1216216216216
"9346","29027","2020",68,67,1,91945.2794117647,967.955882352941,97.8088235294118
"9347","29028","2020",25,25,0,138448,1514.44,96.76
"9348","29029","2020",14,14,0,82928.6428571429,945.642857142857,85.6428571428571
"9349","29030","2020",71,69,2,131784.014084507,1545.98591549296,95.1971830985916
"9350","29031","2020",110,89,21,219456.527272727,2433.6,97.2818181818182
"9351","29032","2020",20,20,0,190434.75,1836.5,103.25
"9352","29033","2020",3,3,0,96443.3333333333,996.666666666667,100.333333333333
"9353","29034","2020",12,12,0,104500,1177.66666666667,89.8333333333333
"9354","29035","2020",14,14,0,194951.642857143,1787.71428571429,112.071428571429
"9355","29036","2020",14,14,0,84848.5714285714,888,96.7857142857143
"9356","29037","2020",69,62,7,230047.130434783,2353.20289855072,103.898550724638
"9357","29038","2020",21,21,0,97316.6666666667,851.380952380952,115.857142857143
"9358","29039","2020",394,228,166,193376.949238579,2304.13959390863,85.3071065989848
"9359","29040","2020",41,28,13,199431.975609756,2218.36585365854,92.780487804878
"9360","29041","2020",36,36,0,117777.777777778,1160.41666666667,102.861111111111
"9361","29042","2020",199,157,42,190397.618090452,2258.09547738693,86.537688442211
"9362","29043","2020",26,26,0,188003.846153846,1765.5,107.461538461538
"9363","29044","2020",28,28,0,120720.5,1225.03571428571,104.035714285714
"9364","29045","2020",27,27,0,213850,1723.81481481481,121.814814814815
"9365","29046","2020",330,193,137,123897.960606061,1588.89696969697,82.0545454545454
"9366","29047","2020",18,18,0,153208.888888889,1449.16666666667,113.944444444444
"9367","29048","2020",24,23,1,145148.583333333,1358.95833333333,110.375
"9368","29049","2020",53,53,0,127513.20754717,1311.01886792453,97.5471698113208
"9369","29051","2020",82,76,6,166076.93902439,1732.69512195122,99.3658536585366
"9370","29053","2020",29,27,2,135737.931034483,1480.34482758621,96.7586206896552
"9371","29054","2020",22,22,0,73586.1363636364,844.727272727273,87.3636363636364
"9372","29055","2020",36,34,2,142636.027777778,1472.75,96.5555555555556
"9373","29056","2020",20,19,1,191306,1889.85,102.35
"9374","29057","2020",74,60,14,242040.202702703,2568.2972972973,98.3648648648649
"9375","29058","2020",241,186,55,243843.012448133,2586.28215767635,98.0871369294606
"9376","29059","2020",14,14,0,145496.428571429,1375.21428571429,106.5
"9377","29060","2020",35,34,1,253019.428571429,2255.57142857143,115.114285714286
"9378","29061","2020",76,68,8,203609.171052632,2112.25,98.5921052631579
"9379","29062","2020",15,15,0,131220,1164.86666666667,109.466666666667
"9380","29063","2020",6,6,0,175750,1730,103
"9381","29064","2020",7,7,0,121214.285714286,1426.28571428571,84.8571428571429
"9382","29065","2020",8,8,0,164010.375,1463,121.875
"9383","29066","2020",21,21,0,145496.19047619,1498.95238095238,101.238095238095
"9384","29067","2020",25,25,0,97372.16,1094.28,98.64
"9385","29068","2020",26,25,1,130626.923076923,1353.46153846154,95.2692307692308
"9386","29069","2020",90,85,5,203478.211111111,1950.47777777778,104.377777777778
"9387","29070","2020",7,6,1,117676.428571429,1303.28571428571,87.4285714285714
"9388","29071","2020",11,11,0,141338.636363636,1315,104.363636363636
"9389","29072","2020",84,69,15,147498.333333333,1819.66666666667,85.6666666666667
"9390","29073","2020",17,17,0,134872.941176471,1480.64705882353,92.1176470588235
"9391","29074","2020",14,14,0,123183.714285714,1122.28571428571,114.071428571429
"9392","29075","2020",182,163,19,218653.461538462,2091.06043956044,104.153846153846
"9393","29076","2020",56,56,0,198314.910714286,1875.14285714286,107.839285714286
"9394","29077","2020",30,30,0,165198.133333333,1652.93333333333,98.5333333333333
"9395","29078","2020",28,28,0,185430,1678.78571428571,108.178571428571
"9396","29079","2020",21,20,1,150066.666666667,1444.85714285714,102.142857142857
"9397","29080","2020",32,30,2,169765.9375,1941.9375,94.84375
"9398","29081","2020",42,42,0,86170.2380952381,1047.7380952381,83.8095238095238
"9399","29082","2020",9,8,1,172519.333333333,2391.11111111111,78.4444444444444
"9400","29085","2020",28,23,5,222506.071428571,2917.10714285714,84.25
"9401","29086","2020",19,18,1,140555.263157895,1531.21052631579,94.2105263157895
"9402","29087","2020",9,9,0,138105.555555556,1454.77777777778,104.444444444444
"9403","29089","2020",13,13,0,98866.9230769231,945.923076923077,100.230769230769
"9404","29090","2020",15,15,0,196180,1652.73333333333,117.266666666667
"9405","29091","2020",37,37,0,161240.675675676,1518.91891891892,107.594594594595
"9406","29093","2020",18,18,0,152271.388888889,1359.94444444444,115.055555555556
"9407","29094","2020",6,6,0,145350,1309.16666666667,114.333333333333
"9408","29095","2020",12,12,0,184179.166666667,1619.16666666667,116.333333333333
"9409","29097","2020",27,27,0,135633.962962963,1383.92592592593,108.074074074074
"9410","29098","2020",45,41,4,169364.311111111,2027.17777777778,87.6666666666667
"9411","29099","2020",13,13,0,168280.769230769,1643.53846153846,107.307692307692
"9412","29100","2020",3,3,0,205000,1656.66666666667,125
"9413","29101","2020",51,48,3,213139.607843137,2064.17647058824,103.803921568627
"9414","29102","2020",15,15,0,115543.133333333,1163.33333333333,90.3333333333333
"9415","29103","2020",257,161,96,156941.070038911,1783.28015564202,88.7782101167315
"9416","29104","2020",12,12,0,175265,2009.33333333333,90.5833333333333
"9417","29105","2020",143,104,39,116254.636363636,1413.64335664336,87
"9418","29106","2020",14,14,0,162044.285714286,1517.5,107.071428571429
"9419","29107","2020",15,15,0,143090,1571.4,95.2666666666667
"9420","29108","2020",13,13,0,122592.307692308,1547.69230769231,98.2307692307692
"9421","29109","2020",28,28,0,231296.571428571,2356.75,98.5714285714286
"9422","29110","2020",15,15,0,137288.666666667,1211.86666666667,112.066666666667
"9423","29111","2020",17,17,0,131031.764705882,1366.29411764706,98.8823529411765
"9424","29112","2020",16,16,0,211167.1875,1822,116.5
"9425","29113","2020",40,39,1,133030.75,1489.675,96.225
"9426","29114","2020",8,8,0,110793.875,972,125.625
"9427","29115","2020",7,7,0,82881.4285714286,761.714285714286,112.285714285714
"9428","29116","2020",1,1,0,205000,1694,121
"9429","29117","2020",72,69,3,164237.027777778,1690.59722222222,97.9861111111111
"9430","29119","2020",14,14,0,184172.5,1792.92857142857,103.642857142857
"9431","29120","2020",35,32,3,151365.628571429,1660.08571428571,94.2571428571429
"9432","29122","2020",16,16,0,101228.125,1046,93.5
"9433","29123","2020",5,5,0,95600,824.4,120
"9434","29124","2020",128,97,31,137430.7265625,1562.4609375,88.9140625
"9435","29125","2020",22,22,0,91465.5909090909,1067.81818181818,90.2272727272727
"9436","29128","2020",1,1,0,65000,783,83
"9437","29130","2020",64,61,3,285563.484375,2426.6875,115.21875
"9438","29131","2020",8,8,0,101712.5,1077.75,95.75
"9439","29132","2020",10,10,0,247060,1902.2,128.9
"9440","29133","2020",44,39,5,257225.136363636,2494.18181818182,103.113636363636
"9441","29134","2020",16,16,0,203253.125,1734,119.9375
"9442","29135","2020",85,76,9,193920.564705882,2096.18823529412,99
"9443","29136","2020",19,19,0,154009.210526316,1273.47368421053,128.789473684211
"9444","29137","2020",24,24,0,180875.5,1751.45833333333,102.833333333333
"9445","29139","2020",8,8,0,113193.75,1116.75,106
"9446","29140","2020",37,37,0,232208.513513514,2019.97297297297,116.432432432432
"9447","29141","2020",7,7,0,64928.5714285714,858.714285714286,80.4285714285714
"9448","29142","2020",6,6,0,136708.333333333,1349.5,102.666666666667
"9449","29143","2020",9,9,0,193088.222222222,1614.77777777778,119
"9450","29144","2020",16,16,0,136543.375,1350.5625,102.625
"9451","29145","2020",10,10,0,120373.7,1190.9,103.4
"9452","29146","2020",35,35,0,188792,1807.6,106.085714285714
"9453","29147","2020",31,31,0,175524.870967742,1592.45161290323,113.064516129032
"9454","29148","2020",13,13,0,114930.769230769,1019.61538461538,116.692307692308
"9455","29150","2020",157,144,13,208723.96178344,2185.36942675159,97.5477707006369
"9456","29151","2020",294,141,153,96919.8197278912,1276.98299319728,77.6122448979592
"9457","29152","2020",10,10,0,112610,1047.3,109.4
"9458","29153","2020",58,53,5,248195.862068966,2481.13793103448,100.603448275862
"9459","29155","2020",13,13,0,200130.769230769,3140,66.9230769230769
"9460","29156","2020",19,19,0,212420.263157895,1941.89473684211,111.947368421053
"9461","29158","2020",117,107,10,201793.982905983,2056.98290598291,99.042735042735
"9462","29159","2020",8,8,0,162400,1733.125,101.875
"9463","29160","2020",110,103,7,195886.209090909,1895.5,105.981818181818
"9464","29161","2020",43,42,1,216019,2035.74418604651,109.162790697674
"9465","29162","2020",57,56,1,100535.087719298,1079.31578947368,97.7719298245614
"9466","29163","2020",52,52,0,130628.653846154,1244.19230769231,106.423076923077
"9467","29165","2020",71,70,1,185317.323943662,2040.43661971831,95.6338028169014
"9468","29166","2020",8,8,0,107450,1151,95.125
"9469","29167","2020",25,25,0,161105.8,1429.56,113
"9470","29168","2020",37,37,0,142409.567567568,1616.45945945946,94.2162162162162
"9471","29169","2020",38,37,1,109941.342105263,1134.23684210526,98.7368421052632
"9472","29170","2020",42,39,3,169101.80952381,1631.21428571429,103.785714285714
"9473","29171","2020",67,64,3,221701.492537313,2135.49253731343,105.761194029851
"9474","29172","2020",35,35,0,165633,1530.45714285714,112.257142857143
"9475","29173","2020",27,27,0,175845.037037037,1521.55555555556,118.777777777778
"9476","29174","2020",96,95,1,177907.208333333,1629.70833333333,111.239583333333
"9477","29175","2020",42,41,1,79323.7380952381,897.928571428571,88.1190476190476
"9478","29176","2020",27,27,0,202955.925925926,1920.2962962963,104.222222222222
"9479","29177","2020",63,63,0,200117.603174603,2092.07936507937,97.8730158730159
"9480","29178","2020",84,78,6,194858.452380952,1875.46428571429,104.142857142857
"9481","29179","2020",40,39,1,182238,1702.3,108.7
"9482","29180","2020",15,15,0,118902.8,1120.73333333333,104.933333333333
"9483","29181","2020",29,27,2,176464.137931034,1741.27586206897,102.137931034483
"9484","29182","2020",17,17,0,155617.647058824,1356.29411764706,114.470588235294
"9485","29183","2020",12,12,0,131472.666666667,1400.33333333333,104.583333333333
"9486","29184","2020",34,34,0,105495.088235294,1177.58823529412,90.8529411764706
"9487","29185","2020",68,65,3,150923.264705882,1551.22058823529,99.7058823529412
"9488","29186","2020",28,28,0,181085.857142857,1744.35714285714,107.321428571429
"9489","29187","2020",8,8,0,100062.75,921.25,106.125
"9490","29188","2020",90,81,9,179675.422222222,1888.35555555556,97.8444444444444
"9491","29189","2020",159,141,18,217220.446540881,2150.23899371069,100.51572327044
"9492","29190","2020",77,50,27,224330.324675325,2532.16883116883,89.9090909090909
"9493","29191","2020",54,54,0,168835.555555556,1481.42592592593,109.796296296296
"9494","29192","2020",28,28,0,114503.214285714,1181.82142857143,103
"9495","29193","2020",14,14,0,100516.5,900.5,110.5
"9496","29195","2020",140,137,3,181232.357142857,1875.54285714286,101
"9497","29196","2020",26,24,2,149757.307692308,1376.61538461538,111.5
"9498","29197","2020",108,100,8,164089.009259259,1677.06481481481,98.8981481481482
"9499","29198","2020",27,26,1,137249.259259259,1355.88888888889,103.62962962963
"9500","29199","2020",51,50,1,150380.509803922,1513.88235294118,102.196078431373
"9501","29201","2020",26,26,0,200138.038461538,1991.53846153846,104.269230769231
"9502","29202","2020",20,20,0,79375,899.8,89.8
"9503","29204","2020",24,24,0,159425.833333333,1363.20833333333,115.625
"9504","29205","2020",8,8,0,106137.5,1061,98.625
"9505","29206","2020",36,36,0,131650.666666667,1446.33333333333,98.9166666666667
"9506","29207","2020",61,61,0,136740.229508197,1373.49180327869,102.524590163934
"9507","29208","2020",11,11,0,193710.909090909,1645.18181818182,116.090909090909
"9508","29209","2020",52,50,2,161972.576923077,1579.11538461538,100.076923076923
"9509","29210","2020",35,35,0,127154.857142857,1220.71428571429,110.2
"9510","29211","2020",15,15,0,82333.3333333333,914.333333333333,94.7333333333333
"9511","29212","2020",143,130,13,192349.853146853,1913.38461538462,101.251748251748
"9512","29213","2020",26,26,0,123644.230769231,1193.84615384615,112.730769230769
"9513","29214","2020",16,16,0,207477.5,2181.0625,100.1875
"9514","29215","2020",75,74,1,168361.826666667,1632.37333333333,103.506666666667
"9515","29216","2020",37,37,0,175151.513513514,1700.81081081081,104.972972972973
"9516","29217","2020",46,39,7,157822.826086957,1919.17391304348,89.0652173913043
"9517","29218","2020",35,33,2,133329.428571429,1494.08571428571,90.6571428571429
"9518","29220","2020",188,129,59,159783.595744681,1818.35106382979,90.4095744680851
"9519","29221","2020",28,28,0,215777.857142857,1932.39285714286,114.964285714286
"9520","29222","2020",5,5,0,92000,1117.8,86
"9521","29224","2020",14,14,0,145821.428571429,1564.71428571429,103.5
"9522","29225","2020",22,22,0,127250,1199.81818181818,105.181818181818
"9523","29226","2020",16,16,0,161856.625,1557.1875,108.0625
"9524","29227","2020",29,29,0,78094.4827586207,881.793103448276,84.4137931034483
"9525","29228","2020",12,12,0,183208.333333333,1551.41666666667,117.666666666667
"9526","29229","2020",20,20,0,111362.3,1053.05,91.8
"9527","29230","2020",34,34,0,132450.735294118,1483.91176470588,92
"9528","29232","2020",1507,623,884,129462.02986065,1696.28268082283,75.8885202388852
"9529","29233","2020",206,143,63,140489.349514563,1606.63106796116,87.7233009708738
"9530","29234","2020",24,24,0,186057.958333333,1584.83333333333,124
"9531","29235","2020",129,99,30,201898.279069767,2257.34108527132,90.5813953488372
"9532","29236","2020",82,82,0,181040.158536585,1812.84146341463,104.390243902439
"9533","29237","2020",29,29,0,136934.827586207,1423.62068965517,96.0344827586207
"9534","29238","2020",30,30,0,186033.666666667,2091.73333333333,95.8333333333333
"9535","29239","2020",86,44,42,194733.744186047,2323.12790697674,85.2558139534884
"9536","29240","2020",11,11,0,211631.818181818,1807.72727272727,117.272727272727
"9537","29241","2020",123,115,8,131760.178861789,1497.93495934959,89.4552845528455
"9538","29243","2020",6,6,0,79666.6666666667,1185.83333333333,72
"9539","29244","2020",11,11,0,131132.727272727,1273.36363636364,101.727272727273
"9540","29245","2020",12,11,1,199194.916666667,1868.91666666667,107.5
"9541","29246","2020",2,2,0,93000,1033,88
"9542","29247","2020",55,55,0,235062.727272727,2061.14545454545,117.909090909091
"9543","29248","2020",18,18,0,145541.388888889,1523.5,101.166666666667
"9544","29249","2020",7,7,0,102212.857142857,980.428571428571,105.571428571429
"9545","29250","2020",13,13,0,68403.0769230769,866.461538461538,80.5384615384615
"9546","29251","2020",11,11,0,199318.181818182,2070.45454545455,96.2727272727273
"9547","29252","2020",7,6,1,365128.571428571,3247.28571428571,114.571428571429
"9548","29254","2020",69,63,6,130433.594202899,1463.60869565217,90.5072463768116
"9549","29255","2020",10,10,0,122115,1179.3,101.6
"9550","29256","2020",48,19,29,107854.020833333,2255.58333333333,51.8333333333333
"9551","29257","2020",44,44,0,189858.136363636,1945.70454545455,98.0909090909091
"9552","29259","2020",117,95,22,149626.495726496,1695.61538461538,94.6923076923077
"9553","29260","2020",115,93,22,213610.913043478,2078.12173913043,105.017391304348
"9554","29261","2020",4,4,0,90604.75,1258.25,77.75
"9555","29262","2020",17,17,0,117212.352941176,1095.88235294118,112.117647058824
"9556","29263","2020",13,13,0,135198.538461538,1176.84615384615,111.307692307692
"9557","29264","2020",10,10,0,142280,1575.8,92.7
"9558","29265","2020",9,9,0,196344.444444444,1250.33333333333,142.666666666667
"9559","29266","2020",41,41,0,115234.780487805,1199.46341463415,95.4390243902439
"9560","29267","2020",14,14,0,72005.7142857143,1253.28571428571,69.5714285714286
"9561","29268","2020",22,22,0,196844.772727273,1840.77272727273,111.909090909091
"9562","29269","2020",15,15,0,129016.666666667,1170.86666666667,115.2
"9563","29270","2020",19,19,0,197688.421052632,1740.31578947368,114.631578947368
"9564","29271","2020",17,17,0,95488.2352941177,972.411764705882,99.8235294117647
"9565","29272","2020",28,28,0,177592.857142857,1542.71428571429,122.821428571429
"9566","29273","2020",40,37,3,223663.85,1916.625,115.225
"9567","29274","2020",98,98,0,114369.744897959,1098.89795918367,106.428571428571
"9568","29275","2020",28,28,0,72576.7857142857,932.321428571429,80.25
"9569","29276","2020",17,17,0,164570.176470588,1616.82352941176,107.941176470588
"9570","29277","2020",36,35,1,130035.583333333,1217.61111111111,103.694444444444
"9571","29278","2020",37,37,0,90010.2702702703,1004.02702702703,90.6486486486486
"9572","29279","2020",38,38,0,127943.684210526,1454.13157894737,90.2894736842105
"9573","29280","2020",51,50,1,176403.62745098,1910.43137254902,94.6274509803922
"9574","29281","2020",8,8,0,122843.75,1429.25,96.875
"9575","29282","2020",3,3,0,171000,1723.66666666667,99.3333333333333
"9576","29284","2020",44,44,0,172347.954545455,1924.25,92.6818181818182
"9577","29285","2020",8,8,0,163276.5,1265.5,113.5
"9578","29286","2020",6,6,0,166485.5,1573.83333333333,109.833333333333
"9579","29287","2020",14,14,0,141467.071428571,1166.35714285714,126.142857142857
"9580","29288","2020",6,6,0,181525,1774,104.5
"9581","29289","2020",2,2,0,175000,1700.5,101.5
"9582","29290","2020",13,13,0,147385.769230769,1474.46153846154,97.9230769230769
"9583","29291","2020",19,19,0,110842.105263158,1168.63157894737,93.7368421052632
"9584","29292","2020",10,9,1,268705,3020.9,115.8
"9585","29293","2020",123,105,18,248858.365853659,2379.07317073171,104.878048780488
"9586","29294","2020",5,5,0,138486,1426,98.6
"9587","29295","2020",5,5,0,151280,1552.8,100.6
"9588","29296","2020",12,12,0,220423.333333333,1829.91666666667,122.916666666667
"9589","29297","2020",28,26,2,165014.285714286,1628.92857142857,105.107142857143
"9590","29298","2020",7,7,0,184971.428571429,2228.71428571429,87.7142857142857
"9591","29299","2020",2,2,0,168000,1367.5,121
"9592","29300","2020",25,25,0,166976.8,1520.28,116.4
"9593","29301","2020",5,5,0,137828.4,1462,94
"9594","29302","2020",75,74,1,106022.6,1211.45333333333,91.92
"9595","2A001","2020",21,17,4,425203.333333333,4078.52380952381,105.047619047619
"9596","2A004","2020",806,44,762,236631.275434243,3375.33622828784,70.9441687344913
"9597","2A006","2020",22,19,3,386313.181818182,3623,110.454545454545
"9598","2A008","2020",40,14,26,398975.3,4871.4,79.6
"9599","2A017","2020",13,11,2,262100,3917.53846153846,74.6923076923077
"9600","2A018","2020",2,0,2,81950,1612.5,50.5
"9601","2A019","2020",1,1,0,40000,714,56
"9602","2A021","2020",2,0,2,49750,1627.5,30.5
"9603","2A022","2020",1,0,1,70000,972,72
"9604","2A024","2020",1,1,0,50000,694,72
"9605","2A028","2020",1,0,1,87000,1740,50
"9606","2A031","2020",3,3,0,219666.666666667,3350,70.6666666666667
"9607","2A032","2020",25,20,5,432831.64,4015.2,114.76
"9608","2A035","2020",1,0,1,220000,4889,45
"9609","2A040","2020",6,4,2,137333.333333333,2209.5,59.1666666666667
"9610","2A041","2020",29,14,15,541405.862068966,5075.72413793103,83.5172413793103
"9611","2A048","2020",15,7,8,342052.466666667,4439.33333333333,68.8
"9612","2A056","2020",1,1,0,255000,2833,90
"9613","2A060","2020",1,1,0,1e+05,1613,62
"9614","2A062","2020",6,5,1,190333.333333333,2120.16666666667,81.6666666666667
"9615","2A065","2020",13,9,4,267412.307692308,4402.76923076923,65.4615384615385
"9616","2A070","2020",11,3,8,250700,5157.72727272727,51.8181818181818
"9617","2A071","2020",4,2,2,276258.75,3162.75,82.75
"9618","2A085","2020",14,8,6,304420.214285714,3953.64285714286,78.5
"9619","2A089","2020",1,0,1,60000,2400,25
"9620","2A090","2020",10,4,6,469129.1,4740.6,76.8
"9621","2A091","2020",3,1,2,84666.6666666667,2008.33333333333,41.3333333333333
"9622","2A092","2020",16,11,5,262183.1875,3706.6875,77.9375
"9623","2A098","2020",23,22,1,608978.47826087,4974.08695652174,119.086956521739
"9624","2A099","2020",1,1,0,158400,1800,88
"9625","2A103","2020",14,12,2,277360.714285714,4489,83.7142857142857
"9626","2A104","2020",2,2,0,364500,3599,106.5
"9627","2A108","2020",6,4,2,86175,1599.16666666667,48.8333333333333
"9628","2A114","2020",6,6,0,225800.166666667,3951.66666666667,61
"9629","2A115","2020",2,2,0,205000,1990.5,106
"9630","2A117","2020",2,0,2,60000,1252,48
"9631","2A118","2020",4,3,1,287000,4806.5,72.75
"9632","2A119","2020",1,0,1,20000,714,28
"9633","2A130","2020",54,22,32,306991.814814815,4528.42592592593,67.3518518518518
"9634","2A132","2020",1,0,1,20000,556,36
"9635","2A133","2020",1,1,0,110000,1549,71
"9636","2A139","2020",50,30,20,468521.4,5372.88,86.88
"9637","2A141","2020",1,0,1,175000,2083,84
"9638","2A142","2020",9,6,3,160224.888888889,1796.55555555556,96.4444444444444
"9639","2A146","2020",1,1,0,15000,833,18
"9640","2A154","2020",1,0,1,142070,1776,80
"9641","2A160","2020",2,1,1,45000,1148,39.5
"9642","2A163","2020",1,1,0,315700,3095,102
"9643","2A181","2020",3,3,0,315466.666666667,3573,86.6666666666667
"9644","2A186","2020",4,2,2,115647.5,1555.25,70.5
"9645","2A189","2020",14,9,5,417811.214285714,3710.42857142857,115.142857142857
"9646","2A191","2020",1,1,0,370000,3854,96
"9647","2A196","2020",2,2,0,66500,847,75.5
"9648","2A197","2020",1,0,1,20000,833,24
"9649","2A198","2020",9,3,6,105166.666666667,1581.66666666667,64
"9650","2A200","2020",1,0,1,75000,1339,56
"9651","2A203","2020",5,3,2,116092.8,1160.8,83
"9652","2A209","2020",11,10,1,251685,2753.18181818182,97.3636363636364
"9653","2A211","2020",8,7,1,216215.875,2309.125,93.625
"9654","2A212","2020",5,2,3,239190,2353.4,87
"9655","2A215","2020",7,4,3,383538,4079.42857142857,80.8571428571429
"9656","2A228","2020",26,19,7,725775.538461538,5832.73076923077,112.5
"9657","2A232","2020",2,2,0,233250,1918,121
"9658","2A240","2020",2,1,1,45250,649.5,65
"9659","2A247","2020",137,77,60,488323.890510949,4777.53284671533,94.0948905109489
"9660","2A249","2020",58,7,51,228011.534482759,3710.89655172414,62.1896551724138
"9661","2A253","2020",1,1,0,180000,1500,120
"9662","2A254","2020",4,4,0,186000,2939.25,68.75
"9663","2A258","2020",1,1,0,30000,667,45
"9664","2A259","2020",2,2,0,125600,1651,75
"9665","2A262","2020",1,1,0,60000,1224,49
"9666","2A266","2020",1,1,0,88400,1579,56
"9667","2A269","2020",25,7,18,376196.56,4328.64,79.96
"9668","2A271","2020",42,14,28,231066.333333333,3141.38095238095,75.4285714285714
"9669","2A272","2020",34,16,18,277590.882352941,3230.38235294118,90.9411764705882
"9670","2A276","2020",12,5,7,354546.916666667,4892.25,76.25
"9671","2A278","2020",1,1,0,60000,1000,60
"9672","2A284","2020",1,1,0,270000,2250,120
"9673","2A288","2020",11,8,3,310591.818181818,3699.45454545455,83
"9674","2A295","2020",2,2,0,108250,891.5,125
"9675","2A300","2020",8,7,1,329176.125,4646.5,79.25
"9676","2A308","2020",5,2,3,118293.2,1959.2,58
"9677","2A312","2020",1,0,1,140000,1556,90
"9678","2A322","2020",1,1,0,25000,694,36
"9679","2A323","2020",4,4,0,366115,3128.5,126.5
"9680","2A324","2020",2,1,1,137322.5,1776.5,77
"9681","2A326","2020",3,3,0,93333.3333333333,3941.66666666667,21.6666666666667
"9682","2A330","2020",4,3,1,89500,1979.5,48
"9683","2A336","2020",4,4,0,350000,2942.5,114
"9684","2A345","2020",2,2,0,172750,2564.5,59
"9685","2A348","2020",17,8,9,330192.117647059,3737.41176470588,74.1176470588235
"9686","2A349","2020",11,10,1,423477.272727273,3804.54545454545,119.545454545455
"9687","2A357","2020",2,1,1,75000,2719,29.5
"9688","2A359","2020",3,3,0,59666.6666666667,1004.66666666667,60.3333333333333
"9689","2A360","2020",2,2,0,82500,2160.5,37.5
"9690","2A362","2020",53,39,14,459359.830188679,4879.47169811321,86.2641509433962
"9691","2B002","2020",3,3,0,215500,2149.33333333333,116.333333333333
"9692","2B007","2020",1,1,0,135000,1607,84
"9693","2B009","2020",17,8,9,253875.588235294,2295.70588235294,104.176470588235
"9694","2B010","2020",10,2,8,272551,4731.6,57
"9695","2B012","2020",2,1,1,40000,795.5,51
"9696","2B016","2020",1,1,0,215090,2088,103
"9697","2B020","2020",6,1,5,157923.166666667,3359.5,45.3333333333333
"9698","2B025","2020",2,0,2,172500,2585.5,65
"9699","2B029","2020",3,2,1,704333.333333333,4015,112.666666666667
"9700","2B030","2020",2,2,0,343750,4022.5,73.5
"9701","2B033","2020",416,22,394,183907.649038462,2679.09855769231,68.2043269230769
"9702","2B034","2020",24,13,11,174978.666666667,3217.33333333333,52.4583333333333
"9703","2B037","2020",62,24,38,259646.548387097,2708.66129032258,93.9032258064516
"9704","2B039","2020",1,1,0,70000,1129,62
"9705","2B042","2020",116,53,63,197186.017241379,2954.44827586207,70.3793103448276
"9706","2B043","2020",25,7,18,250384.8,2982.8,83.4
"9707","2B046","2020",2,1,1,137500,1725,65
"9708","2B047","2020",1,1,0,128000,2560,50
"9709","2B049","2020",35,24,11,263845.714285714,3260.34285714286,81.3142857142857
"9710","2B050","2020",128,16,112,210681.859375,4088.7890625,51.34375
"9711","2B051","2020",1,1,0,39700,441,90
"9712","2B052","2020",1,0,1,440677,8012,55
"9713","2B054","2020",3,2,1,60833.3333333333,945.333333333333,65.3333333333333
"9714","2B057","2020",2,1,1,110000,1405,71.5
"9715","2B058","2020",2,2,0,159000,2369,67.5
"9716","2B074","2020",1,1,0,253720,2537,100
"9717","2B077","2020",6,5,1,293945,2434.66666666667,114
"9718","2B079","2020",2,2,0,243950,2123.5,118
"9719","2B080","2020",2,0,2,67500,1812,45
"9720","2B081","2020",1,0,1,35000,1591,22
"9721","2B083","2020",1,0,1,4e+05,3008,133
"9722","2B084","2020",4,1,3,150500,1999.75,77.5
"9723","2B086","2020",3,3,0,338000,4030.66666666667,81.6666666666667
"9724","2B087","2020",21,13,8,208487.666666667,2423.95238095238,86.7142857142857
"9725","2B088","2020",3,2,1,407666.666666667,5187.66666666667,85
"9726","2B093","2020",6,4,2,403333.333333333,4847.66666666667,72.1666666666667
"9727","2B095","2020",5,3,2,52200,1032.4,45.2
"9728","2B096","2020",66,1,65,134593.5,2763.45454545455,52.7727272727273
"9729","2B102","2020",2,2,0,100500,1114.5,82.5
"9730","2B105","2020",1,1,0,1e+05,1031,97
"9731","2B107","2020",5,3,2,230309,3470.6,59.2
"9732","2B111","2020",1,0,1,111140,1048,106
"9733","2B112","2020",1,1,0,110000,1833,60
"9734","2B113","2020",1,1,0,35000,530,66
"9735","2B116","2020",1,1,0,66500,1330,50
"9736","2B120","2020",46,21,25,264040.804347826,3098.41304347826,85.304347826087
"9737","2B121","2020",3,2,1,405166.666666667,3896.33333333333,88.3333333333333
"9738","2B123","2020",23,16,7,217497.869565217,2525.65217391304,92
"9739","2B124","2020",5,1,4,64690,1614.4,45.8
"9740","2B125","2020",1,1,0,305872,2154,142
"9741","2B126","2020",2,2,0,139250,1405.5,94
"9742","2B134","2020",76,1,75,214676.407894737,3766.82894736842,58.9210526315789
"9743","2B135","2020",1,0,1,23500,470,50
"9744","2B136","2020",1,1,0,180000,3000,60
"9745","2B140","2020",2,0,2,50000,1188,43.5
"9746","2B143","2020",18,8,10,115957.222222222,2298.38888888889,47.8888888888889
"9747","2B148","2020",70,38,32,171712.928571429,2483.5,72.8
"9748","2B150","2020",51,13,38,284595.862745098,5102.64705882353,57.156862745098
"9749","2B152","2020",5,3,2,223820,2627.6,88
"9750","2B155","2020",2,2,0,85000,1325,64.5
"9751","2B157","2020",1,1,0,53000,898,59
"9752","2B159","2020",2,2,0,4e+05,2200.5,183
"9753","2B161","2020",1,1,0,40000,465,86
"9754","2B162","2020",6,2,4,156000,1641.83333333333,81.3333333333333
"9755","2B165","2020",3,2,1,275500,4052,64.3333333333333
"9756","2B166","2020",3,3,0,200666.666666667,1950.66666666667,91.6666666666667
"9757","2B167","2020",3,2,1,172916.666666667,3530.66666666667,49.6666666666667
"9758","2B168","2020",25,14,11,542399.6,5274.88,90.92
"9759","2B169","2020",4,3,1,185050,1904.75,86.25
"9760","2B170","2020",2,2,0,270000,4363,84.5
"9761","2B172","2020",11,6,5,169636.363636364,2579.18181818182,75.0909090909091
"9762","2B173","2020",5,2,3,156900,2500.2,60
"9763","2B175","2020",2,2,0,234500,4041,64
"9764","2B176","2020",1,1,0,15000,366,41
"9765","2B178","2020",3,2,1,150000,2159.33333333333,61.6666666666667
"9766","2B179","2020",1,1,0,50000,1389,36
"9767","2B182","2020",2,2,0,115300,3034.5,45
"9768","2B185","2020",23,13,10,270148.913043478,3002.65217391304,87.0434782608696
"9769","2B187","2020",3,3,0,105833.333333333,1985,61
"9770","2B188","2020",5,3,2,273800,2915,90.2
"9771","2B190","2020",1,1,0,32500,542,60
"9772","2B195","2020",1,1,0,193000,1350,143
"9773","2B199","2020",2,2,0,295500,2778,105
"9774","2B201","2020",2,0,2,20500,662.5,32
"9775","2B205","2020",8,4,4,236446.25,3415,65.125
"9776","2B207","2020",22,16,6,220086.363636364,2471.77272727273,96.0454545454545
"9777","2B214","2020",1,1,0,222800,2621,85
"9778","2B223","2020",1,0,1,40000,714,56
"9779","2B224","2020",11,10,1,297670,3550.36363636364,79.4545454545455
"9780","2B225","2020",1,0,1,115000,2091,55
"9781","2B226","2020",2,1,1,35000,669.5,53
"9782","2B229","2020",2,1,1,113000,1363.5,97
"9783","2B231","2020",1,1,0,3e+05,3947,76
"9784","2B233","2020",1,1,0,90000,9000,10
"9785","2B235","2020",4,2,2,173931.25,2915.5,69.5
"9786","2B239","2020",2,2,0,181850,2191,79
"9787","2B242","2020",20,18,2,115862.45,2547.3,47.25
"9788","2B244","2020",2,2,0,133000,1138,110
"9789","2B245","2020",1,1,0,146525,2254,65
"9790","2B251","2020",21,18,3,216053.571428571,2507.09523809524,94.5714285714286
"9791","2B252","2020",3,2,1,66275,883.333333333333,74.3333333333333
"9792","2B256","2020",1,1,0,33000,750,44
"9793","2B257","2020",2,1,1,141000,1920.5,58
"9794","2B261","2020",8,7,1,210028.75,2792.625,84.25
"9795","2B263","2020",2,2,0,17307.5,576.5,31
"9796","2B264","2020",1,1,0,1e+05,909,110
"9797","2B265","2020",1,1,0,195000,2635,74
"9798","2B267","2020",1,1,0,40000,444,90
"9799","2B274","2020",2,2,0,106500,1582,72.5
"9800","2B280","2020",1,0,1,70000,2000,35
"9801","2B281","2020",11,9,2,257236.363636364,3444.09090909091,85.2727272727273
"9802","2B283","2020",8,7,1,310524.375,3013.5,109.5
"9803","2B286","2020",6,5,1,223055,1802.33333333333,142.833333333333
"9804","2B287","2020",4,4,0,141875,2274.5,66
"9805","2B290","2020",2,1,1,65000,1726,41
"9806","2B292","2020",1,1,0,26000,433,60
"9807","2B293","2020",2,2,0,310000,1863,113
"9808","2B298","2020",19,2,17,312755.736842105,4169.73684210526,74.4736842105263
"9809","2B299","2020",2,2,0,172500,1528.5,101
"9810","2B302","2020",2,2,0,174552.5,2974.5,59
"9811","2B303","2020",5,4,1,247380,2269.6,108.2
"9812","2B305","2020",25,9,16,276475.56,3321,79
"9813","2B306","2020",1,1,0,80000,1250,64
"9814","2B307","2020",34,17,17,192672.235294118,2397.67647058824,83.3823529411765
"9815","2B309","2020",10,6,4,356235,3340.9,107.1
"9816","2B311","2020",8,7,1,188670.625,3060.125,71.375
"9817","2B313","2020",48,12,36,136667.708333333,2508.35416666667,55.8958333333333
"9818","2B314","2020",4,4,0,156255,2440,61.5
"9819","2B316","2020",10,6,4,404785,4000.8,96.5
"9820","2B318","2020",1,0,1,107525,2560,42
"9821","2B319","2020",1,1,0,287470,1742,165
"9822","2B320","2020",4,3,1,183780.5,1794,96.5
"9823","2B327","2020",1,1,0,65180,1448,45
"9824","2B328","2020",2,1,1,50000,1671,28
"9825","2B333","2020",3,3,0,187333.333333333,2993.33333333333,65.3333333333333
"9826","2B334","2020",1,0,1,190000,3167,60
"9827","2B339","2020",1,1,0,175000,1750,100
"9828","2B341","2020",10,4,6,77350,1352,72.2
"9829","2B342","2020",10,7,3,221899.4,3889.5,70.6
"9830","2B343","2020",17,13,4,182000,2411.23529411765,80.2941176470588
"9831","2B346","2020",19,9,10,184488.789473684,2376.05263157895,75.8421052631579
"9832","2B347","2020",2,1,1,93100,1299.5,55.5
"9833","2B352","2020",3,2,1,345000,3181.33333333333,105
"9834","2B353","2020",39,5,34,236783.333333333,2810.92307692308,83.1282051282051
"9835","2B355","2020",2,2,0,237500,3592,77
"9836","2B361","2020",4,4,0,249250,2428.5,91.25
"9837","2B364","2020",1,0,1,80000,1176,68
"9838","2B365","2020",1,1,0,150000,1579,95
"9839","30001","2020",4,4,0,242873.75,2814.75,87.75
"9840","30002","2020",12,12,0,242463.333333333,2148.91666666667,116.083333333333
"9841","30003","2020",175,133,42,271496.828571429,3400.57142857143,81.8628571428571
"9842","30004","2020",15,14,1,279592,2295.86666666667,120.133333333333
"9843","30005","2020",3,3,0,188000,1884,136
"9844","30006","2020",66,57,9,259769.939393939,2717.56060606061,89.8333333333333
"9845","30007","2020",536,239,297,127872.656716418,1607.7276119403,77.1026119402985
"9846","30008","2020",12,12,0,233538.333333333,2195,101.583333333333
"9847","30009","2020",6,4,2,90344,2256.83333333333,59.1666666666667
"9848","30010","2020",54,41,13,181994.277777778,1948.51851851852,90.1666666666667
"9849","30011","2020",127,75,52,233725.496062992,2845.5905511811,84.1811023622047
"9850","30012","2020",41,37,4,242345.43902439,2476.43902439024,97.9268292682927
"9851","30013","2020",9,9,0,366509.666666667,3026.22222222222,119.777777777778
"9852","30014","2020",17,16,1,322817.941176471,2907.35294117647,110.176470588235
"9853","30015","2020",3,3,0,84326.6666666667,1278.33333333333,61.3333333333333
"9854","30016","2020",9,6,3,43700,770.666666666667,64.1111111111111
"9855","30017","2020",6,6,0,83837.5,1402.16666666667,69.1666666666667
"9856","30018","2020",4,3,1,313831.25,2886.5,109.5
"9857","30019","2020",48,47,1,297817.395833333,2734.58333333333,109.020833333333
"9858","30020","2020",30,27,3,230561,2183.46666666667,104.8
"9859","30021","2020",5,5,0,597316,4198,139
"9860","30022","2020",3,3,0,131666.666666667,1906,70
"9861","30023","2020",6,6,0,233245,2018.66666666667,108.666666666667
"9862","30024","2020",8,7,1,139167.625,1468.875,92.5
"9863","30025","2020",6,4,2,74305,950,76.5
"9864","30026","2020",16,13,3,124658,1425.1875,81.6875
"9865","30027","2020",19,19,0,232183.157894737,2053.84210526316,113.578947368421
"9866","30028","2020",231,120,111,136209.086580087,1711.54978354978,78.8484848484848
"9867","30029","2020",15,15,0,263416,2730.06666666667,103.266666666667
"9868","30030","2020",3,3,0,256985.666666667,2172.33333333333,121.666666666667
"9869","30031","2020",1,1,0,5e+05,3185,157
"9870","30032","2020",175,119,56,151478.074285714,1753.50857142857,85.7542857142857
"9871","30033","2020",59,54,5,215701.152542373,2228.15254237288,98.4745762711864
"9872","30034","2020",83,75,8,213015.674698795,2362.67469879518,90.3373493975904
"9873","30035","2020",6,6,0,304741.666666667,2322.16666666667,131.333333333333
"9874","30036","2020",37,33,4,230803.783783784,2474.16216216216,94.4324324324324
"9875","30037","2020",27,19,8,98720,1245.14814814815,81.2962962962963
"9876","30038","2020",5,2,3,63406,1115,53.6
"9877","30039","2020",27,21,6,173141.555555556,1839.81481481481,94.7407407407407
"9878","30040","2020",10,10,0,128678.3,1955.5,76.8
"9879","30041","2020",19,19,0,272563.947368421,2647.47368421053,106
"9880","30042","2020",35,34,1,255659.942857143,2144.94285714286,118.742857142857
"9881","30043","2020",6,6,0,366458.333333333,2732,131.833333333333
"9882","30045","2020",3,3,0,140333.333333333,1643,83.3333333333333
"9883","30046","2020",13,13,0,147880,1847.53846153846,81.3846153846154
"9884","30047","2020",59,54,5,235092.372881356,2419.23728813559,96.0169491525424
"9885","30048","2020",8,8,0,318340,2292.25,136.875
"9886","30049","2020",3,3,0,161833.333333333,2159,76.6666666666667
"9887","30051","2020",19,15,4,122683.157894737,1409,84.6315789473684
"9888","30052","2020",13,13,0,164239.230769231,1732.92307692308,92.2307692307692
"9889","30053","2020",6,6,0,292266.666666667,2243.16666666667,130.5
"9890","30054","2020",4,4,0,261967.5,2222.75,120
"9891","30055","2020",11,9,2,188469.090909091,1702.27272727273,108.818181818182
"9892","30056","2020",9,9,0,279804.444444444,1808.33333333333,150
"9893","30057","2020",15,15,0,287651.733333333,2516,114.6
"9894","30058","2020",2,2,0,142500,809,170
"9895","30059","2020",39,38,1,238853.871794872,2600.35897435897,90.1282051282051
"9896","30060","2020",40,35,5,214749.625,2369.675,91.475
"9897","30061","2020",32,27,5,164636.5625,1923.625,83.9375
"9898","30062","2020",106,64,42,192250.603773585,2524.71698113208,78.2358490566038
"9899","30064","2020",4,4,0,99855,1150.75,78.75
"9900","30065","2020",7,7,0,193235.714285714,1990.57142857143,95.5714285714286
"9901","30066","2020",9,9,0,186158.888888889,1828.11111111111,103.888888888889
"9902","30067","2020",10,10,0,453317,2951.1,151.1
"9903","30068","2020",9,9,0,141196.666666667,1604.66666666667,81.2222222222222
"9904","30069","2020",8,8,0,201181.875,2066.75,97
"9905","30070","2020",6,6,0,246318.333333333,2067.16666666667,115.666666666667
"9906","30071","2020",9,9,0,181016.666666667,1666.77777777778,105.555555555556
"9907","30072","2020",3,3,0,141836.666666667,1650,82
"9908","30073","2020",27,25,2,278894.074074074,2909.48148148148,97.4444444444444
"9909","30075","2020",43,41,2,268960.255813953,2673.67441860465,103.302325581395
"9910","30076","2020",16,16,0,192583.75,2072.875,97
"9911","30077","2020",7,7,0,203978.571428571,2638.71428571429,74.2857142857143
"9912","30079","2020",3,3,0,119133.333333333,1924,61
"9913","30080","2020",20,16,4,117114.5,1527.8,77.45
"9914","30081","2020",12,12,0,186986.666666667,1814.83333333333,106.25
"9915","30082","2020",48,42,6,240008.625,2435.72916666667,99
"9916","30083","2020",28,26,2,245158.214285714,2579.71428571429,98.0714285714286
"9917","30084","2020",3,3,0,176666.666666667,1278.33333333333,126
"9918","30085","2020",23,23,0,282775,2491.4347826087,117.565217391304
"9919","30086","2020",18,18,0,307590,2533.05555555556,123.777777777778
"9920","30087","2020",6,4,2,233833.333333333,2245.33333333333,106.5
"9921","30088","2020",7,7,0,203212.857142857,2385.71428571429,80.5714285714286
"9922","30089","2020",17,17,0,214458.823529412,2429.82352941176,90.3529411764706
"9923","30090","2020",9,9,0,104944.444444444,1566.88888888889,66.1111111111111
"9924","30091","2020",25,25,0,253442.88,2561.64,97.96
"9925","30092","2020",20,19,1,198831.75,2281.05,87.2
"9926","30093","2020",1,1,0,52000,3059,17
"9927","30094","2020",2,0,2,62000,1036,60.5
"9928","30095","2020",7,7,0,125031.142857143,1860.42857142857,72.8571428571429
"9929","30096","2020",13,13,0,214676.923076923,2492.38461538462,92.1538461538462
"9930","30097","2020",9,9,0,179474.444444444,2013,99.3333333333333
"9931","30098","2020",9,9,0,254983.333333333,2302.11111111111,115.111111111111
"9932","30099","2020",8,7,1,251208.375,1580.25,161.5
"9933","30100","2020",11,11,0,260118.181818182,2145.72727272727,117.181818181818
"9934","30101","2020",3,3,0,383300,2754.66666666667,129.666666666667
"9935","30102","2020",5,5,0,129584,2014.6,66.2
"9936","30103","2020",9,9,0,323525.555555556,3253.11111111111,108
"9937","30104","2020",5,5,0,195000,1926.6,107.8
"9938","30105","2020",14,14,0,114486.428571429,1567.71428571429,77.9285714285714
"9939","30106","2020",11,11,0,162827.727272727,1617.45454545455,99.6363636363636
"9940","30107","2020",1,1,0,147000,2194,67
"9941","30108","2020",2,2,0,104725,1324,84
"9942","30109","2020",7,7,0,331500,2736.71428571429,122.285714285714
"9943","30110","2020",9,9,0,359473.888888889,2935.55555555556,112.111111111111
"9944","30111","2020",6,6,0,215746.666666667,2451.83333333333,90.5
"9945","30112","2020",17,17,0,215529.411764706,1964,110.176470588235
"9946","30113","2020",5,5,0,187903,1547.2,127
"9947","30114","2020",5,5,0,229000,2395.6,103
"9948","30115","2020",8,8,0,217616.25,2301.875,95.625
"9949","30116","2020",14,12,2,180561.071428571,2098,86.6428571428571
"9950","30117","2020",32,26,6,196086.25,2360.78125,82.96875
"9951","30119","2020",1,1,0,176680,1510,117
"9952","30120","2020",14,11,3,137096.571428571,1491.57142857143,91.8571428571429
"9953","30121","2020",6,6,0,339391.666666667,3300.5,105.5
"9954","30122","2020",7,7,0,218930,2183.14285714286,102.428571428571
"9955","30123","2020",56,49,7,224466.25,2495.94642857143,89.1607142857143
"9956","30124","2020",5,5,0,211640,1975.6,110.8
"9957","30125","2020",50,46,4,215143.92,2320.28,95.62
"9958","30126","2020",11,11,0,248207.727272727,2694.18181818182,96.4545454545455
"9959","30127","2020",21,21,0,247532.857142857,2659.38095238095,95.5714285714286
"9960","30128","2020",57,40,17,177901.929824561,2072.21052631579,86.6491228070175
"9961","30129","2020",9,9,0,328761.888888889,2523.44444444444,132.888888888889
"9962","30130","2020",11,11,0,175186.363636364,1931.54545454545,93.0909090909091
"9963","30131","2020",20,17,3,203586.75,2474.45,86.25
"9964","30132","2020",37,26,11,77485,943.972972972973,81.1351351351351
"9965","30133","2020",879,52,827,164807.789533561,4303.01706484642,38.0534698521047
"9966","30134","2020",6,6,0,265405,1780.16666666667,149.166666666667
"9967","30135","2020",42,36,6,185684.30952381,2161.85714285714,89.0476190476191
"9968","30136","2020",14,13,1,214552.142857143,2932.28571428571,82.2142857142857
"9969","30137","2020",2,2,0,182505,1692.5,91
"9970","30138","2020",17,17,0,321656.470588235,2785.47058823529,117.294117647059
"9971","30139","2020",9,7,2,101168.888888889,1250.33333333333,80.5555555555556
"9972","30140","2020",19,16,3,162755.315789474,2005.10526315789,100.789473684211
"9973","30141","2020",75,62,13,205148.533333333,2221.34666666667,94.0933333333333
"9974","30142","2020",7,7,0,162135.714285714,1747.57142857143,90.1428571428571
"9975","30143","2020",5,5,0,194946,2198.2,90.2
"9976","30144","2020",9,8,1,221962.222222222,2622.88888888889,107.888888888889
"9977","30145","2020",11,11,0,219776.636363636,2662.72727272727,85.0909090909091
"9978","30146","2020",16,14,2,155250,1981.625,80.8125
"9979","30147","2020",12,11,1,158791.833333333,1642.91666666667,93.1666666666667
"9980","30148","2020",3,3,0,368426.666666667,2870.66666666667,130.666666666667
"9981","30149","2020",10,10,0,219557,2243.8,98.9
"9982","30150","2020",3,3,0,184445,1966.33333333333,94.6666666666667
"9983","30151","2020",12,12,0,193143.916666667,2221.83333333333,90.1666666666667
"9984","30152","2020",25,24,1,176947.6,1890.84,92.12
"9985","30154","2020",5,5,0,141828,1632.4,86
"9986","30155","2020",66,63,3,236267.727272727,2482.39393939394,99.8484848484848
"9987","30156","2020",102,78,24,209254,2408.50980392157,86.0980392156863
"9988","30158","2020",3,3,0,191833.333333333,2153.66666666667,97
"9989","30159","2020",12,10,2,123566.666666667,1341.25,92.5833333333333
"9990","30160","2020",4,4,0,161596.25,1385.75,112.5
"9991","30161","2020",1,1,0,170000,2429,70
"9992","30162","2020",7,7,0,208642.857142857,2022.85714285714,100.857142857143
"9993","30164","2020",31,30,1,140907.419354839,1895.90322580645,72.1612903225806
"9994","30165","2020",12,12,0,224084.166666667,2048.91666666667,109.5
"9995","30166","2020",25,23,2,181597.28,2039.68,91.32
"9996","30167","2020",16,14,2,170779.25,1881.375,92
"9997","30168","2020",11,11,0,164490.909090909,2405.54545454545,72.6363636363636
"9998","30169","2020",84,68,16,184284.880952381,2168.60714285714,86.2857142857143
"9999","30170","2020",19,17,2,174954.736842105,1724.73684210526,102.578947368421
"10000","30171","2020",17,13,4,106048.235294118,1265.76470588235,88.8235294117647
"10001","30172","2020",11,11,0,271270.181818182,2428.45454545455,106.363636363636
"10002","30173","2020",23,23,0,196333.47826087,1735.91304347826,113.95652173913
"10003","30174","2020",17,17,0,300133.235294118,2683.23529411765,120.647058823529
"10004","30175","2020",2,2,0,169250,2461.5,66.5
"10005","30176","2020",7,7,0,212497.142857143,2106,98.1428571428571
"10006","30177","2020",8,7,1,184725,2385,84.5
"10007","30178","2020",11,11,0,218063.636363636,2410.81818181818,90.4545454545455
"10008","30179","2020",47,44,3,180277.425531915,2083.10638297872,89.3191489361702
"10009","30180","2020",4,4,0,245110,1904.25,127.25
"10010","30181","2020",5,5,0,223201,2043.2,110.2
"10011","30182","2020",13,12,1,198422.384615385,1968.07692307692,100.230769230769
"10012","30183","2020",7,7,0,263368.857142857,2230.14285714286,103.571428571429
"10013","30184","2020",27,27,0,203252.962962963,1945.33333333333,108.518518518519
"10014","30185","2020",12,12,0,260834.75,3037.33333333333,100.416666666667
"10015","30186","2020",17,17,0,374461.176470588,2978.17647058824,124
"10016","30187","2020",1,1,0,120000,1091,110
"10017","30188","2020",5,5,0,147795,1593.4,89.8
"10018","30189","2020",2338,634,1704,154033.192472198,2140.81693755346,70.5923866552609
"10019","30191","2020",14,13,1,182071.857142857,1969.71428571429,103.714285714286
"10020","30192","2020",5,5,0,313160,2638.8,124.6
"10021","30193","2020",5,5,0,230870,1950,114.6
"10022","30194","2020",5,5,0,138400,1524.6,100.2
"10023","30195","2020",1,1,0,3e+05,3000,100
"10024","30196","2020",5,5,0,216200,2138,97.2
"10025","30197","2020",1,1,0,439610,2512,175
"10026","30198","2020",4,4,0,69725,1036.5,66
"10027","30199","2020",2,2,0,47000,890.5,56
"10028","30200","2020",7,7,0,191066.571428571,2246.42857142857,90.8571428571429
"10029","30201","2020",3,3,0,87000,1513.66666666667,57.6666666666667
"10030","30202","2020",149,103,46,151858.248322148,1695.12080536913,89.5167785234899
"10031","30203","2020",5,4,1,104200,1442.6,72.6
"10032","30204","2020",3,3,0,171666.666666667,1436.33333333333,120.333333333333
"10033","30205","2020",4,4,0,371662.5,2814.25,140.5
"10034","30206","2020",50,46,4,293989.84,2720.64,108.08
"10035","30207","2020",14,14,0,240386.428571429,2100.5,119.642857142857
"10036","30209","2020",54,50,4,311922.425925926,2822.7037037037,112.055555555556
"10037","30210","2020",37,32,5,209879.459459459,2189.35135135135,98.054054054054
"10038","30211","2020",42,42,0,226769.285714286,2258.38095238095,102.309523809524
"10039","30212","2020",28,23,5,171780.357142857,1997.64285714286,87.25
"10040","30214","2020",25,24,1,196191.6,2033.44,101.72
"10041","30215","2020",14,14,0,163485.714285714,1636.5,108.571428571429
"10042","30216","2020",10,9,1,124105,1093.1,124.7
"10043","30217","2020",99,92,7,278537.95959596,2773.68686868687,102.707070707071
"10044","30218","2020",2,2,0,204000,2351,104
"10045","30220","2020",3,3,0,176383.333333333,1663.33333333333,116
"10046","30221","2020",76,61,15,200294.013157895,2169.67105263158,97.4736842105263
"10047","30222","2020",4,4,0,299251,2337,129
"10048","30223","2020",54,54,0,188170.722222222,1844.38888888889,99.2592592592593
"10049","30224","2020",3,3,0,217000,2192.33333333333,94.6666666666667
"10050","30225","2020",21,20,1,240302.142857143,2161.47619047619,114.238095238095
"10051","30226","2020",9,8,1,252211.111111111,2822.88888888889,109.333333333333
"10052","30227","2020",54,44,10,137437.962962963,1493.64814814815,88.7222222222222
"10053","30228","2020",25,25,0,372575.8,2857.84,119.4
"10054","30229","2020",10,9,1,114571,1570.7,80.5
"10055","30230","2020",7,7,0,215888.571428571,2343.71428571429,82.4285714285714
"10056","30231","2020",17,14,3,115454.411764706,1618.58823529412,75.8235294117647
"10057","30232","2020",7,7,0,247658.571428571,2483.42857142857,99.4285714285714
"10058","30233","2020",8,8,0,208767.25,2153.875,99.5
"10059","30234","2020",3,3,0,206700,1796,115
"10060","30235","2020",12,12,0,211045.833333333,2116.41666666667,99.5
"10061","30237","2020",6,6,0,180535,1896,89
"10062","30239","2020",4,2,2,116000,2222.5,57.75
"10063","30240","2020",8,8,0,240025,1998.5,119.75
"10064","30241","2020",26,25,1,196219.730769231,2140.92307692308,91.5384615384615
"10065","30242","2020",4,4,0,257250,2449,105.25
"10066","30243","2020",75,61,14,168120.36,2038.13333333333,86.2133333333333
"10067","30244","2020",7,7,0,248152.857142857,2208,115.142857142857
"10068","30245","2020",5,5,0,189790.8,4730.2,67.6
"10069","30246","2020",1,1,0,177450,2431,73
"10070","30247","2020",5,5,0,144900,1626.8,87.4
"10071","30248","2020",8,8,0,166975,1608.625,101
"10072","30249","2020",11,9,2,266310.909090909,2569.27272727273,101.454545454545
"10073","30250","2020",11,9,2,194921.636363636,2074.09090909091,96.0909090909091
"10074","30251","2020",10,9,1,92690,1388.7,67.9
"10075","30252","2020",10,10,0,172960,2178.9,87.4
"10076","30253","2020",15,14,1,151896.666666667,1513,99.7333333333333
"10077","30254","2020",20,20,0,220549.6,2052.6,107.8
"10078","30255","2020",43,34,9,163352.558139535,1903.20930232558,81.3953488372093
"10079","30256","2020",7,7,0,214557.142857143,1833.71428571429,110.714285714286
"10080","30257","2020",25,25,0,192036,2052.76,94.64
"10081","30258","2020",190,138,52,150761.663157895,1823.08947368421,81.0473684210526
"10082","30259","2020",47,43,4,181401.617021277,2052.65957446808,97.2765957446808
"10083","30260","2020",15,12,3,200434.4,2398.06666666667,88.8
"10084","30261","2020",2,2,0,328250,3455.5,103.5
"10085","30262","2020",7,7,0,298877.142857143,2460.42857142857,122.857142857143
"10086","30263","2020",42,36,6,172075.547619048,1802.07142857143,98.5
"10087","30264","2020",1,1,0,85000,2429,35
"10088","30265","2020",6,6,0,230283.333333333,2103.16666666667,106.666666666667
"10089","30266","2020",8,8,0,151750,1854.375,89.5
"10090","30267","2020",8,8,0,163633.25,1902.75,89.625
"10091","30268","2020",13,11,2,122428.846153846,1288.61538461538,96.6153846153846
"10092","30269","2020",30,22,8,160843.7,1856.86666666667,94.6
"10093","30270","2020",11,11,0,191094.545454545,2001.63636363636,104.545454545455
"10094","30271","2020",5,4,1,178366,1628,107.8
"10095","30273","2020",13,13,0,204564.615384615,1965.38461538462,101.538461538462
"10096","30274","2020",31,31,0,190726.935483871,1944.32258064516,99.258064516129
"10097","30275","2020",7,7,0,353854.285714286,2351.42857142857,143.857142857143
"10098","30276","2020",64,55,9,207048.328125,2547.859375,84.65625
"10099","30277","2020",9,9,0,180594.444444444,1873.88888888889,107.444444444444
"10100","30278","2020",47,47,0,291336.489361702,2685.70212765957,110.595744680851
"10101","30279","2020",11,10,1,241430.909090909,2477.81818181818,100.636363636364
"10102","30280","2020",5,4,1,127450,1186.6,108.2
"10103","30281","2020",16,15,1,228267.0625,2157.4375,115.1875
"10104","30282","2020",8,8,0,147687.5,1989.625,79
"10105","30283","2020",5,5,0,123300,2152.8,69.2
"10106","30284","2020",40,35,5,164442.775,1753.875,93.325
"10107","30285","2020",8,7,1,204605.375,1971,105.25
"10108","30286","2020",8,8,0,346933.75,2537.25,133.5
"10109","30287","2020",8,7,1,222536.25,2227.875,102.25
"10110","30288","2020",18,13,5,152657.222222222,1526.55555555556,93.1111111111111
"10111","30290","2020",17,17,0,286947.941176471,2528.76470588235,107.176470588235
"10112","30291","2020",3,3,0,265900,2484.33333333333,111.333333333333
"10113","30292","2020",6,6,0,234191.666666667,2107.16666666667,113.333333333333
"10114","30293","2020",4,4,0,351250,3148,118
"10115","30294","2020",56,47,9,204633.678571429,2032.71428571429,100.410714285714
"10116","30295","2020",49,43,6,273204.693877551,2908.0612244898,93.2448979591837
"10117","30296","2020",7,7,0,249492.857142857,2929.42857142857,100
"10118","30297","2020",13,13,0,204597.307692308,2895.07692307692,71.0769230769231
"10119","30298","2020",4,4,0,261812.5,1709.75,142.5
"10120","30299","2020",24,23,1,385573.791666667,2860.75,134.291666666667
"10121","30300","2020",5,5,0,219090,2498.4,88.2
"10122","30301","2020",9,9,0,314150.777777778,2576.11111111111,116.666666666667
"10123","30302","2020",24,24,0,257297,2382.08333333333,106
"10124","30303","2020",13,12,1,183092.307692308,1820.30769230769,104.153846153846
"10125","30304","2020",6,6,0,184232.5,1970,98.1666666666667
"10126","30305","2020",33,29,4,153477.303030303,1725.0303030303,89.6363636363636
"10127","30306","2020",6,6,0,289595.166666667,2702.66666666667,111.333333333333
"10128","30307","2020",30,26,4,117408.333333333,1255.96666666667,93.6666666666667
"10129","30308","2020",9,9,0,233621.111111111,2463.55555555556,96.8888888888889
"10130","30309","2020",6,6,0,184650,1848.16666666667,97.3333333333333
"10131","30310","2020",3,3,0,143273.333333333,2147,77.3333333333333
"10132","30311","2020",27,19,8,143842.740740741,1478.03703703704,92.5925925925926
"10133","30312","2020",23,22,1,319975.695652174,2733.30434782609,119.565217391304
"10134","30313","2020",12,11,1,239817.083333333,2011.25,122.916666666667
"10135","30314","2020",1,1,0,359800,3331,108
"10136","30315","2020",18,17,1,256516.666666667,2401.77777777778,105.555555555556
"10137","30316","2020",12,11,1,127729.166666667,1557.08333333333,80.6666666666667
"10138","30317","2020",25,21,4,187467.52,2038.12,87.48
"10139","30318","2020",1,1,0,121600,1621,75
"10140","30319","2020",8,8,0,429643.75,3127.75,132.375
"10141","30320","2020",2,2,0,160325,2285.5,65
"10142","30321","2020",64,49,15,250304.546875,2716.671875,94.34375
"10143","30322","2020",4,2,2,157712.5,1546.25,95.5
"10144","30324","2020",7,7,0,221160,2294.57142857143,102.714285714286
"10145","30325","2020",18,13,5,133297.777777778,1728.5,87.7777777777778
"10146","30326","2020",15,14,1,250423.333333333,2292.26666666667,114.4
"10147","30328","2020",12,11,1,171345,1936.75,91
"10148","30329","2020",7,6,1,132358.571428571,1557.42857142857,90.2857142857143
"10149","30330","2020",9,8,1,288707.777777778,2222.77777777778,164.666666666667
"10150","30331","2020",17,16,1,200329.058823529,2025.64705882353,100.588235294118
"10151","30332","2020",5,5,0,60000,1134.6,60.6
"10152","30333","2020",77,60,17,193287.012987013,2191.28571428571,91.0779220779221
"10153","30334","2020",203,85,118,258062.842364532,2963.7684729064,84.3251231527094
"10154","30336","2020",28,27,1,189848.25,1843.25,102.892857142857
"10155","30337","2020",3,3,0,344833.333333333,2662.66666666667,120.333333333333
"10156","30339","2020",45,31,14,109068.955555556,1712.64444444444,67.1111111111111
"10157","30340","2020",5,5,0,255320,2863.8,80.6
"10158","30341","2020",158,121,37,197602.253164557,2186.6835443038,92.0189873417721
"10159","30342","2020",14,11,3,193142.857142857,1869.71428571429,98.9285714285714
"10160","30343","2020",5,5,0,255940,2177.2,125.4
"10161","30344","2020",72,64,8,255455.611111111,2600.25,100.833333333333
"10162","30345","2020",7,6,1,74857.1428571429,1128.28571428571,66.8571428571429
"10163","30346","2020",24,22,2,271054.708333333,2770.29166666667,97
"10164","30347","2020",11,10,1,210958.181818182,2452.27272727273,87.0909090909091
"10165","30348","2020",26,23,3,205076.346153846,2098.11538461538,99.3076923076923
"10166","30349","2020",11,11,0,208243.636363636,1945.72727272727,108.181818181818
"10167","30350","2020",47,27,20,117463.170212766,1445.57446808511,80.4042553191489
"10168","30351","2020",194,125,69,328136.984536082,3266.92783505155,100.541237113402
"10169","30352","2020",24,23,1,321357.5,2857.125,111.416666666667
"10170","30354","2020",5,4,1,226096,2000.2,118
"10171","30355","2020",14,14,0,223715.214285714,1971.07142857143,114.785714285714
"10172","30356","2020",27,25,2,197431.851851852,2224.14814814815,91.2592592592593
"10173","31001","2020",4,4,0,161250,1331.75,128.75
"10174","31003","2020",12,12,0,385445,2719.41666666667,148.916666666667
"10175","31004","2020",31,31,0,291601.258064516,2667.25806451613,111.41935483871
"10176","31005","2020",6,6,0,123270,1031.83333333333,126.5
"10177","31007","2020",2,2,0,217500,1536.5,140.5
"10178","31008","2020",3,3,0,198000,1725.66666666667,115.333333333333
"10179","31009","2020",2,2,0,111000,1335.5,99
"10180","31010","2020",2,2,0,147500,1667,90
"10181","31011","2020",13,13,0,102150.769230769,976.461538461538,110.384615384615
"10182","31012","2020",4,4,0,132625,1339.75,100.5
"10183","31013","2020",7,7,0,131557.142857143,1220.57142857143,104.571428571429
"10184","31014","2020",4,4,0,104175,1193.25,88.75
"10185","31015","2020",4,4,0,94550,1019.75,94.75
"10186","31017","2020",2,2,0,131375,1182.5,111
"10187","31018","2020",6,6,0,183367.5,1523.33333333333,118.333333333333
"10188","31020","2020",10,9,1,109090,1442.9,77
"10189","31021","2020",3,3,0,140100,1442.66666666667,100.333333333333
"10190","31022","2020",205,67,138,175009.546341463,2652.0243902439,66.6048780487805
"10191","31023","2020",4,4,0,123250,689.25,181.75
"10192","31024","2020",5,5,0,227420,1701.4,133.8
"10193","31025","2020",6,6,0,580268.333333333,3042.66666666667,173.666666666667
"10194","31026","2020",15,15,0,235053.333333333,1668,139.333333333333
"10195","31028","2020",19,17,2,132894.736842105,1451.42105263158,98.3157894736842
"10196","31029","2020",3,3,0,264206.666666667,2020,162.666666666667
"10197","31030","2020",1,1,0,80000,1067,75
"10198","31031","2020",7,7,0,128857.142857143,1345.71428571429,95.5714285714286
"10199","31032","2020",94,59,35,251574.744680851,2650.81914893617,92.8085106382979
"10200","31033","2020",173,126,47,169108.670520231,1880.56069364162,88.9537572254335
"10201","31034","2020",5,5,0,170670,1140.2,149.6
"10202","31035","2020",55,23,32,290666.018181818,3311.6,90.4727272727273
"10203","31036","2020",18,17,1,333237.333333333,3081.33333333333,109.277777777778
"10204","31037","2020",12,12,0,236012.75,1774.33333333333,147.083333333333
"10205","31038","2020",7,7,0,222444,2146,106.285714285714
"10206","31039","2020",3,3,0,210951.666666667,2024,106
"10207","31040","2020",2,2,0,148275,1941.5,78.5
"10208","31041","2020",4,4,0,78500,728.25,99.25
"10209","31042","2020",157,28,129,93990.3503184713,1902.69426751592,51.7898089171975
"10210","31043","2020",2,2,0,64500,784,90.5
"10211","31044","2020",192,95,97,345372.6875,3555.58854166667,95.734375
"10212","31045","2020",7,7,0,139607.142857143,1397,107.285714285714
"10213","31047","2020",1,1,0,90000,1452,62
"10214","31048","2020",78,73,5,207165.564102564,2391.88461538462,86.8333333333333
"10215","31049","2020",5,5,0,269330,1791.6,157.6
"10216","31050","2020",9,9,0,136245.555555556,1141.11111111111,129.777777777778
"10217","31051","2020",2,2,0,265500,2134.5,124
"10218","31052","2020",13,13,0,240960.769230769,2165.46153846154,119.307692307692
"10219","31053","2020",15,15,0,373676,3409.73333333333,114.466666666667
"10220","31054","2020",2,2,0,317552.5,2626.5,121
"10221","31055","2020",1,1,0,538130,3817,141
"10222","31056","2020",80,39,41,245493.425,2979.8125,82.0125
"10223","31057","2020",17,14,3,333292.882352941,2873.17647058824,120.941176470588
"10224","31060","2020",1,1,0,75000,773,97
"10225","31061","2020",1,1,0,456540,3682,124
"10226","31063","2020",2,2,0,117500,829,141
"10227","31064","2020",3,3,0,176479,2450.33333333333,76.6666666666667
"10228","31065","2020",43,39,4,212998.697674419,2095.81395348837,105.860465116279
"10229","31066","2020",71,52,19,194761.183098592,2173.02816901408,87.1971830985916
"10230","31067","2020",2,2,0,176915,2032,86.5
"10231","31069","2020",343,98,245,218001.145772595,3017.10204081633,70.9008746355685
"10232","31070","2020",2,2,0,80000,805,139
"10233","31071","2020",1,1,0,67000,838,80
"10234","31072","2020",3,3,0,144833.333333333,1186.66666666667,120.666666666667
"10235","31073","2020",4,4,0,242287.5,1976,127.75
"10236","31075","2020",10,10,0,279088.6,2543.4,111.1
"10237","31076","2020",6,6,0,125750,1432.83333333333,88.8333333333333
"10238","31077","2020",6,6,0,217495.833333333,1866.5,129.333333333333
"10239","31078","2020",5,5,0,140300,1634.2,87.4
"10240","31079","2020",5,5,0,360510,2872.4,123.2
"10241","31080","2020",16,15,1,126034.4375,1098.3125,118
"10242","31081","2020",1,1,0,71040,846,84
"10243","31082","2020",8,8,0,266937.875,2269.75,121.5
"10244","31083","2020",4,4,0,122012.5,999.5,143.5
"10245","31084","2020",14,13,1,137730.142857143,1661.57142857143,82
"10246","31085","2020",17,11,6,63447.6470588235,1263.05882352941,51.9411764705882
"10247","31086","2020",1,1,0,310000,2214,140
"10248","31087","2020",4,4,0,194731.5,1768.75,110
"10249","31088","2020",21,20,1,353043.380952381,2926.85714285714,125.380952380952
"10250","31089","2020",5,5,0,337914,2542.2,129.6
"10251","31090","2020",6,6,0,109450,1389.33333333333,96.8333333333333
"10252","31091","2020",83,58,25,251845.843373494,2670.25301204819,92.3012048192771
"10253","31093","2020",9,9,0,212676.666666667,2020.22222222222,115.666666666667
"10254","31094","2020",49,42,7,204425.224489796,2040.04081632653,99.8163265306122
"10255","31095","2020",3,3,0,165266.666666667,1445.33333333333,122.333333333333
"10256","31096","2020",2,2,0,255400,2038.5,125
"10257","31097","2020",2,2,0,216441,1741,123
"10258","31098","2020",23,22,1,195063.869565217,1744.86956521739,108.739130434783
"10259","31099","2020",8,8,0,184197.5,2421.625,83.75
"10260","31100","2020",34,34,0,177249.117647059,1883.58823529412,97.2647058823529
"10261","31101","2020",3,3,0,238250,2396,99.3333333333333
"10262","31102","2020",3,3,0,295293.333333333,2303.66666666667,133.333333333333
"10263","31103","2020",2,2,0,46250,510,87.5
"10264","31104","2020",6,6,0,191065,1891.66666666667,101.166666666667
"10265","31106","2020",19,17,2,208136.736842105,2001.94736842105,105.368421052632
"10266","31107","2020",69,58,11,189139.260869565,2198.42028985507,92.0724637681159
"10267","31108","2020",6,6,0,132500,1364.66666666667,103.833333333333
"10268","31109","2020",5,5,0,90460,1208,84
"10269","31110","2020",6,6,0,134691.666666667,1330,112
"10270","31111","2020",5,5,0,202010,2047.2,94.8
"10271","31112","2020",3,3,0,110333.333333333,930.333333333333,134.666666666667
"10272","31113","2020",196,67,129,234520.964285714,2953.65816326531,80.3877551020408
"10273","31114","2020",1,1,0,243000,1774,137
"10274","31116","2020",181,88,93,196442.994475138,2506.22651933702,76.9668508287293
"10275","31117","2020",44,43,1,366284,3070.04545454545,119.068181818182
"10276","31118","2020",179,79,100,166682.005586592,2219.7094972067,72.5530726256983
"10277","31119","2020",1,1,0,188000,1333,141
"10278","31120","2020",8,8,0,249402.625,1951.375,129.25
"10279","31124","2020",4,4,0,135387.5,1115.25,121.25
"10280","31125","2020",1,1,0,85000,607,140
"10281","31126","2020",1,1,0,507500,2207,230
"10282","31128","2020",15,15,0,226415.266666667,1928.53333333333,117.6
"10283","31129","2020",2,2,0,69552.5,1526,68
"10284","31131","2020",3,3,0,77500,766.333333333333,99.6666666666667
"10285","31133","2020",2,2,0,130431,2614,52
"10286","31135","2020",88,70,18,145448.522727273,1636.23863636364,92.7840909090909
"10287","31136","2020",35,21,14,207489.314285714,2496.97142857143,81.4571428571429
"10288","31137","2020",2,2,0,125000,1255,109
"10289","31138","2020",2,2,0,159695,1056,152.5
"10290","31139","2020",2,2,0,95000,1049.5,90
"10291","31140","2020",1,1,0,62000,488,127
"10292","31141","2020",1,1,0,91000,910,100
"10293","31142","2020",3,3,0,223333.333333333,1712.66666666667,129.666666666667
"10294","31143","2020",4,4,0,141000,1097.25,135
"10295","31144","2020",16,16,0,94531.25,1137.375,86.625
"10296","31145","2020",46,42,4,178913.782608696,1566.30434782609,110.847826086957
"10297","31147","2020",4,4,0,159760,1834.5,86.75
"10298","31148","2020",4,4,0,362875,2318,161.5
"10299","31149","2020",496,206,290,214383.038306452,2580.32661290323,81.4415322580645
"10300","31150","2020",103,71,32,231541.009708738,2629.66019417476,86.252427184466
"10301","31151","2020",9,9,0,341801.111111111,2930.44444444444,113.555555555556
"10302","31152","2020",1,1,0,127000,1245,102
"10303","31153","2020",6,6,0,125900,1508,88
"10304","31155","2020",3,3,0,157483.333333333,1704.66666666667,94.3333333333333
"10305","31156","2020",4,4,0,236627.5,1735.5,138.75
"10306","31157","2020",261,129,132,206508.984674329,2571.63601532567,80.1800766283525
"10307","31158","2020",2,2,0,160440,1447,110.5
"10308","31159","2020",5,5,0,176300,1417.2,134.8
"10309","31160","2020",28,27,1,272110.607142857,2646.32142857143,105.75
"10310","31161","2020",13,11,2,286713.076923077,2922.69230769231,95.4615384615385
"10311","31162","2020",11,11,0,287908.181818182,2036.09090909091,130.818181818182
"10312","31163","2020",31,26,5,341719.225806452,2937.45161290323,117.354838709677
"10313","31164","2020",2,2,0,242600,2747.5,89
"10314","31165","2020",109,70,39,216687.027522936,2424.45871559633,86.5963302752294
"10315","31166","2020",2,2,0,199500,2306,93.5
"10316","31167","2020",11,11,0,113510,1248.63636363636,88.2727272727273
"10317","31168","2020",2,2,0,211950,1780.5,118.5
"10318","31169","2020",84,56,28,294980.55952381,3043.21428571429,95.2619047619048
"10319","31170","2020",3,3,0,233666.666666667,1835,135
"10320","31173","2020",10,10,0,209424,1742.7,123.4
"10321","31174","2020",11,11,0,146818.181818182,1304.90909090909,120
"10322","31175","2020",4,4,0,181525,1612.5,110.25
"10323","31176","2020",4,4,0,58840,789.25,76.5
"10324","31177","2020",3,3,0,131333.333333333,1603.33333333333,84.6666666666667
"10325","31178","2020",2,2,0,89950,945.5,90
"10326","31179","2020",4,4,0,186475,1511.5,124
"10327","31181","2020",27,19,8,211430.074074074,2065.37037037037,100
"10328","31182","2020",97,44,53,179157.494845361,2393.86597938144,72.7525773195876
"10329","31183","2020",4,4,0,138062.75,1330,103
"10330","31184","2020",25,20,5,308340.36,3149.24,110.52
"10331","31186","2020",56,25,31,207552.839285714,2646.23214285714,74.7678571428571
"10332","31187","2020",208,122,86,211664.1875,2384.87980769231,86
"10333","31188","2020",1,1,0,263900,2693,98
"10334","31190","2020",9,9,0,79594.4444444444,1052.66666666667,80.3333333333333
"10335","31191","2020",4,4,0,93017.5,978.75,121.25
"10336","31192","2020",5,5,0,225524,2101.6,118
"10337","31193","2020",21,19,2,213225,2191.95238095238,101.190476190476
"10338","31196","2020",1,1,0,130000,1000,130
"10339","31197","2020",6,6,0,155808.333333333,1327.5,113.166666666667
"10340","31198","2020",1,1,0,162000,1543,105
"10341","31199","2020",3,3,0,120900,1122,109
"10342","31200","2020",3,3,0,145500,1188,119
"10343","31201","2020",3,3,0,198016.666666667,1771.66666666667,114.333333333333
"10344","31202","2020",86,66,20,236100.26744186,2432.09302325581,98.7558139534884
"10345","31203","2020",132,87,45,217982.045454545,2589.37121212121,86.0833333333333
"10346","31204","2020",1,1,0,264000,2047,129
"10347","31205","2020",66,24,42,177872.848484848,2391.92424242424,73.0606060606061
"10348","31206","2020",15,12,3,136880.666666667,1275.8,107.8
"10349","31207","2020",1,1,0,95000,1188,80
"10350","31208","2020",1,1,0,408818,2044,200
"10351","31209","2020",2,2,0,310321,2672,116.5
"10352","31210","2020",17,15,2,205880.235294118,1857.52941176471,117.705882352941
"10353","31211","2020",7,7,0,314504.285714286,2378.71428571429,130.285714285714
"10354","31212","2020",21,18,3,270566.523809524,2586.95238095238,104.333333333333
"10355","31213","2020",1,1,0,190000,3220,59
"10356","31215","2020",5,5,0,367117.6,1922.2,207.6
"10357","31216","2020",4,4,0,175500,1947.5,90.75
"10358","31217","2020",1,1,0,95000,1439,66
"10359","31218","2020",1,1,0,40000,769,52
"10360","31219","2020",5,5,0,175650,1382,124.4
"10361","31220","2020",9,9,0,157857.222222222,1451.11111111111,110.555555555556
"10362","31221","2020",6,1,5,79023.3333333333,1535.16666666667,52.8333333333333
"10363","31222","2020",1,1,0,90000,1125,80
"10364","31224","2020",17,16,1,104418.470588235,1095.05882352941,100.882352941176
"10365","31227","2020",8,6,2,454760,3173.875,157
"10366","31228","2020",30,18,12,264480.266666667,2741.3,97.6333333333333
"10367","31229","2020",8,8,0,222290,1890.5,122
"10368","31230","2020",56,49,7,268010.625,2645.60714285714,103.732142857143
"10369","31231","2020",7,7,0,220735.428571429,2416.42857142857,99
"10370","31232","2020",145,89,56,187262.827586207,2208.32413793103,83.7310344827586
"10371","31233","2020",13,13,0,245228.461538462,2480.76923076923,102.307692307692
"10372","31234","2020",2,2,0,245500,2089.5,117
"10373","31236","2020",1,1,0,54000,574,94
"10374","31237","2020",4,4,0,87828,1151.75,92.75
"10375","31238","2020",3,3,0,48500,587.333333333333,86.3333333333333
"10376","31239","2020",36,36,0,116887.472222222,1291.63888888889,106.638888888889
"10377","31240","2020",5,5,0,280230,2403,118.2
"10378","31241","2020",5,5,0,94700,1036.6,88.2
"10379","31243","2020",1,1,0,242000,1952,124
"10380","31244","2020",6,6,0,171075,1635.66666666667,110.5
"10381","31245","2020",2,2,0,139000,1046,145
"10382","31246","2020",9,9,0,168896.222222222,1601.11111111111,105.555555555556
"10383","31247","2020",14,14,0,156150.785714286,1422.5,119
"10384","31248","2020",41,34,7,228235.43902439,2459.9756097561,93.9268292682927
"10385","31249","2020",12,12,0,304956.25,2497.08333333333,120.583333333333
"10386","31250","2020",9,9,0,180164.444444444,2166.22222222222,93.8888888888889
"10387","31251","2020",2,2,0,151000,1474.5,113
"10388","31252","2020",26,25,1,289228.269230769,2617.15384615385,111.192307692308
"10389","31253","2020",37,28,9,230650.459459459,2457.94594594595,94.972972972973
"10390","31254","2020",15,8,7,278754.066666667,3185.46666666667,87.8666666666667
"10391","31255","2020",2,2,0,112201.5,1229,82.5
"10392","31256","2020",2,2,0,334225,2335,141.5
"10393","31258","2020",4,4,0,194125,1308.25,150.5
"10394","31259","2020",26,19,7,375111.576923077,3102.80769230769,116.423076923077
"10395","31260","2020",1,1,0,149000,1620,92
"10396","31261","2020",15,15,0,200452.666666667,1714.66666666667,115.666666666667
"10397","31262","2020",10,10,0,306468.5,2253.5,141.8
"10398","31263","2020",42,41,1,212972.952380952,2200.38095238095,102.095238095238
"10399","31264","2020",3,3,0,250535,2696.66666666667,93.6666666666667
"10400","31265","2020",5,5,0,185040,1912.6,104.6
"10401","31266","2020",1,1,0,185000,2256,82
"10402","31268","2020",2,2,0,89000,830,115
"10403","31269","2020",16,16,0,228131.25,2200.4375,107.625
"10404","31270","2020",11,11,0,187020,1431.54545454545,132.636363636364
"10405","31271","2020",23,18,5,310508.043478261,2709.04347826087,121.086956521739
"10406","31273","2020",28,28,0,346470.714285714,2823.60714285714,119.857142857143
"10407","31274","2020",2,2,0,238500,1895,128.5
"10408","31275","2020",2,2,0,199507.5,1626,126
"10409","31277","2020",11,11,0,275404.545454545,2519.45454545455,112.454545454545
"10410","31278","2020",4,4,0,183250,1149.5,167.25
"10411","31279","2020",1,1,0,261800,1745,150
"10412","31280","2020",3,3,0,179266.666666667,1210.66666666667,149.333333333333
"10413","31281","2020",18,17,1,191959.944444444,1952.33333333333,101.555555555556
"10414","31282","2020",108,60,48,218663.768518519,2658.92592592593,81.6481481481482
"10415","31283","2020",5,5,0,226800,1978,118.2
"10416","31284","2020",6,6,0,438148.333333333,3226.16666666667,136.833333333333
"10417","31285","2020",4,4,0,436987.5,2846,154.5
"10418","31286","2020",4,4,0,188250,1592.5,116.75
"10419","31287","2020",61,52,9,222489.786885246,2300.5737704918,98
"10420","31288","2020",4,4,0,318612.5,2526,132
"10421","31289","2020",2,2,0,36500,730,50
"10422","31290","2020",2,2,0,92925,1390.5,67.5
"10423","31291","2020",173,80,93,188283.98265896,2418.13294797688,74.514450867052
"10424","31292","2020",1,1,0,60000,845,71
"10425","31293","2020",21,15,6,229746.428571429,2459.95238095238,95.7142857142857
"10426","31294","2020",3,3,0,185983.333333333,1232.33333333333,149.666666666667
"10427","31295","2020",2,2,0,98500,733.5,131.5
"10428","31296","2020",4,4,0,118325,1176.5,99.25
"10429","31297","2020",40,34,6,220586.075,2294.975,96.525
"10430","31299","2020",49,41,8,234676.285714286,2168.97959183673,109.020408163265
"10431","31301","2020",2,2,0,119550,1311,93.5
"10432","31302","2020",6,6,0,128916.666666667,1256.33333333333,96.1666666666667
"10433","31303","2020",40,32,8,213575.275,2150.225,101.425
"10434","31304","2020",7,7,0,249622.571428571,1809.14285714286,136.571428571429
"10435","31306","2020",5,5,0,139000,1560.4,95.8
"10436","31308","2020",1,1,0,142500,1096,130
"10437","31309","2020",3,3,0,254426.666666667,1828.33333333333,149
"10438","31310","2020",4,4,0,290000,1829.75,155.5
"10439","31311","2020",14,14,0,278745.714285714,2490,117.642857142857
"10440","31313","2020",3,3,0,59000,1235,49.3333333333333
"10441","31314","2020",7,7,0,218814.285714286,1602.28571428571,142.285714285714
"10442","31315","2020",14,13,1,129419.642857143,1219.21428571429,100.428571428571
"10443","31316","2020",6,6,0,134250,1277.33333333333,105.166666666667
"10444","31317","2020",10,10,0,200576,1727.1,123
"10445","31318","2020",2,2,0,257655,2573,107.5
"10446","31319","2020",2,2,0,97000,555,171.5
"10447","31320","2020",13,13,0,263567.692307692,2058.76923076923,131.692307692308
"10448","31321","2020",1,1,0,82500,917,90
"10449","31322","2020",1,1,0,354500,1866,190
"10450","31323","2020",4,4,0,141500,1234.75,115.75
"10451","31324","2020",26,23,3,131576.923076923,1410.80769230769,93.2692307692308
"10452","31325","2020",4,4,0,152153.5,1784,91.25
"10453","31327","2020",4,4,0,125937.5,1087.5,116.5
"10454","31328","2020",7,7,0,308985.428571429,2124.42857142857,150.428571428571
"10455","31329","2020",3,3,0,219615,2144.33333333333,96
"10456","31330","2020",7,7,0,189291.428571429,1548.14285714286,119.142857142857
"10457","31331","2020",2,2,0,371622.5,2601.5,142.5
"10458","31332","2020",4,4,0,122312.5,1248.75,99.75
"10459","31333","2020",1,1,0,120000,800,150
"10460","31334","2020",16,16,0,293256.375,2206.5625,132.6875
"10461","31336","2020",3,3,0,102166.666666667,773,127.666666666667
"10462","31337","2020",3,3,0,80026.6666666667,1363.66666666667,74.6666666666667
"10463","31338","2020",10,10,0,313488.5,2600.3,132.3
"10464","31339","2020",6,6,0,287375,2003,145.5
"10465","31340","2020",2,2,0,377950,2434.5,162.5
"10466","31341","2020",60,36,24,216963.85,2366.4,90.05
"10467","31342","2020",1,1,0,74750,1116,67
"10468","31343","2020",1,1,0,342200,1922,178
"10469","31344","2020",12,10,2,92522.75,1019.91666666667,94.9166666666667
"10470","31345","2020",48,43,5,214200.270833333,2185.8125,99.2083333333333
"10471","31346","2020",7,7,0,252050,2010.14285714286,136.142857142857
"10472","31347","2020",2,2,0,151000,1496,100
"10473","31348","2020",3,3,0,122766.666666667,922,134.666666666667
"10474","31349","2020",6,6,0,174001.333333333,1614.83333333333,117
"10475","31350","2020",1,1,0,172000,1117,154
"10476","31351","2020",119,59,60,196141.294117647,2663.61344537815,72.7899159663866
"10477","31352","2020",1,1,0,340000,2267,150
"10478","31353","2020",2,2,0,120000,1771.5,68.5
"10479","31354","2020",1,1,0,230000,1447,159
"10480","31355","2020",11,11,0,514454.909090909,3673,148
"10481","31356","2020",27,25,2,273121.074074074,2291.77777777778,118.111111111111
"10482","31357","2020",6,6,0,97333.3333333333,915.666666666667,104.5
"10483","31358","2020",50,44,6,289395.02,2525.64,117.44
"10484","31360","2020",12,8,4,183430,1850,100.083333333333
"10485","31361","2020",9,9,0,233094.333333333,2330.33333333333,112.111111111111
"10486","31363","2020",4,4,0,342275,1618.25,206
"10487","31364","2020",37,34,3,299187.081081081,2795.02702702703,109.324324324324
"10488","31365","2020",5,5,0,164990,1528.2,112.8
"10489","31366","2020",4,4,0,335745,2861.75,121
"10490","31369","2020",2,2,0,95345,1138,78.5
"10491","31370","2020",1,1,0,125500,2057,61
"10492","31371","2020",5,5,0,235156,1883.4,128.8
"10493","31372","2020",9,9,0,98888.8888888889,1204.66666666667,82.8888888888889
"10494","31374","2020",11,11,0,276955.454545455,2256.45454545455,145.272727272727
"10495","31375","2020",41,41,0,144594,1252.19512195122,117.292682926829
"10496","31376","2020",5,5,0,126400,1242.2,100.8
"10497","31377","2020",5,5,0,254162.4,2286.4,112.6
"10498","31379","2020",4,4,0,202237.5,1980,111.75
"10499","31380","2020",9,9,0,224747.222222222,1885,114.555555555556
"10500","31381","2020",28,28,0,257205.892857143,2396.42857142857,112.678571428571
"10501","31382","2020",2,2,0,234765.5,2013,116
"10502","31383","2020",6,6,0,329853.333333333,2403,136.833333333333
"10503","31384","2020",10,10,0,316227.1,3447.5,95
"10504","31385","2020",2,2,0,136254,722.5,181
"10505","31386","2020",1,1,0,115000,697,165
"10506","31387","2020",1,1,0,174500,2029,86
"10507","31388","2020",4,4,0,308401.25,2119.25,147
"10508","31389","2020",65,44,21,305150.261538462,2932.72307692308,104.215384615385
"10509","31390","2020",49,30,19,79817.0408163265,986.061224489796,79.1020408163265
"10510","31391","2020",4,4,0,176000,1067.75,184.75
"10511","31392","2020",1,1,0,316650,2533,125
"10512","31393","2020",1,1,0,111500,1593,70
"10513","31394","2020",3,3,0,221383.333333333,1754.33333333333,126
"10514","31395","2020",407,218,189,184004.493857494,2194.88697788698,84.2186732186732
"10515","31396","2020",90,44,46,151206.266666667,1814.13333333333,79.1888888888889
"10516","31398","2020",1,1,0,140000,1029,136
"10517","31399","2020",38,33,5,218755.710526316,2193.55263157895,103.631578947368
"10518","31400","2020",1,1,0,96500,1097,88
"10519","31401","2020",9,9,0,258905,2593.44444444444,106.333333333333
"10520","31402","2020",9,9,0,422065.555555556,3048.22222222222,143
"10521","31403","2020",11,11,0,235974.545454545,2264.90909090909,107.636363636364
"10522","31406","2020",13,13,0,162502.307692308,1523.61538461538,110.307692307692
"10523","31407","2020",11,11,0,172184.090909091,1517.81818181818,121
"10524","31408","2020",2,2,0,191805,942,197
"10525","31409","2020",38,23,15,258273.631578947,2846.55263157895,90.8421052631579
"10526","31410","2020",70,62,8,282566.828571429,2714.92857142857,106.557142857143
"10527","31411","2020",5,5,0,416364,3216.6,136.6
"10528","31412","2020",5,5,0,123200,877.2,133.2
"10529","31413","2020",8,8,0,204555,1715.75,121.125
"10530","31414","2020",1,1,0,119000,1400,85
"10531","31415","2020",1,1,0,121000,1391,87
"10532","31416","2020",6,6,0,230283.333333333,2247,104
"10533","31417","2020",96,74,22,312734.708333333,2875.11458333333,106.447916666667
"10534","31418","2020",5,2,3,445800.8,5655.8,86
"10535","31420","2020",29,21,8,205042.413793103,2371.58620689655,86.3103448275862
"10536","31421","2020",50,29,21,210063.06,2380.16,86.36
"10537","31422","2020",3,3,0,182100,1627.33333333333,132.666666666667
"10538","31423","2020",3,3,0,214780,1505.66666666667,151
"10539","31424","2020",216,154,62,254495.773148148,2852.47685185185,89.7546296296296
"10540","31425","2020",7,7,0,156142.857142857,1367.14285714286,122.142857142857
"10541","31426","2020",7,7,0,139225.571428571,1398.42857142857,101.142857142857
"10542","31427","2020",8,8,0,138081.25,1300.625,106.625
"10543","31428","2020",1,1,0,243000,2963,82
"10544","31429","2020",28,15,13,269232.964285714,2993.71428571429,90.7142857142857
"10545","31430","2020",9,9,0,125426.111111111,1326.22222222222,102.777777777778
"10546","31431","2020",4,4,0,107540,1287,96.75
"10547","31432","2020",1,1,0,150000,1071,140
"10548","31433","2020",120,83,37,210338.916666667,2405.46666666667,86.9333333333333
"10549","31434","2020",4,4,0,208750,2808.25,78.25
"10550","31435","2020",8,8,0,222081.75,2130.5,112.875
"10551","31436","2020",6,6,0,192350,1826.33333333333,107
"10552","31437","2020",1,1,0,175240,1735,101
"10553","31439","2020",4,4,0,395925,2656,158.75
"10554","31441","2020",1,1,0,310000,2460,126
"10555","31442","2020",4,4,0,250370,1957.25,125.75
"10556","31443","2020",4,4,0,86752.5,655.5,120.5
"10557","31444","2020",1,1,0,202800,1811,112
"10558","31445","2020",54,36,18,354305.574074074,3504.18518518519,102.62962962963
"10559","31446","2020",203,59,144,216924.004926108,2897.88177339901,75.7635467980296
"10560","31447","2020",2,2,0,104000,1723,69.5
"10561","31448","2020",6,6,0,370738.333333333,2412.83333333333,169.833333333333
"10562","31449","2020",1,1,0,25000,417,60
"10563","31450","2020",6,6,0,284391.666666667,2396,118.333333333333
"10564","31451","2020",111,92,19,173223.333333333,1859.59459459459,98.1171171171171
"10565","31453","2020",2,2,0,293600,2658,117
"10566","31454","2020",47,35,12,163174.042553191,1672.82978723404,97.936170212766
"10567","31455","2020",42,41,1,179100.238095238,1699.52380952381,109.833333333333
"10568","31456","2020",2,2,0,120000,1033.5,115
"10569","31457","2020",8,8,0,173343.125,1561.5,108.875
"10570","31458","2020",57,45,12,241059.456140351,2684.80701754386,94.4210526315789
"10571","31459","2020",11,11,0,342001,2597,147.909090909091
"10572","31460","2020",46,30,16,235201.5,2542.97826086957,91.7173913043478
"10573","31462","2020",42,19,23,239462.738095238,2700.47619047619,83.5714285714286
"10574","31463","2020",2,2,0,260650,2780.5,99.5
"10575","31465","2020",1,1,0,45000,511,88
"10576","31466","2020",14,14,0,300627.285714286,2612.28571428571,120.357142857143
"10577","31467","2020",68,47,21,255668.308823529,2726.51470588235,92.9852941176471
"10578","31468","2020",6,6,0,141358.333333333,1267.16666666667,118.833333333333
"10579","31469","2020",2,2,0,202718.5,1605.5,134.5
"10580","31470","2020",13,3,10,80299.9230769231,1742.76923076923,42.8461538461538
"10581","31471","2020",12,12,0,94654.0833333333,1033.66666666667,86.8333333333333
"10582","31472","2020",4,4,0,179475,1403.25,134.25
"10583","31473","2020",8,6,2,200760.5,2175.5,96.125
"10584","31474","2020",4,4,0,166182.5,1486,111
"10585","31475","2020",16,15,1,215555.9375,2230.3125,99.25
"10586","31476","2020",16,15,1,203480,2035.25,113.3125
"10587","31478","2020",16,16,0,194007.25,1627.9375,125.375
"10588","31479","2020",1,1,0,150000,1154,130
"10589","31480","2020",32,27,5,284152.65625,2883.40625,101.71875
"10590","31481","2020",31,23,8,208849.741935484,2261.70967741935,95.6774193548387
"10591","31482","2020",3,3,0,74358.6666666667,1036.33333333333,73.6666666666667
"10592","31483","2020",193,96,97,84947.103626943,1128.58549222798,75.3989637305699
"10593","31484","2020",22,22,0,348792.5,2789.63636363636,129.272727272727
"10594","31485","2020",2,2,0,190000,1686.5,107.5
"10595","31486","2020",21,17,4,231831,2189.95238095238,103.285714285714
"10596","31487","2020",2,2,0,77500,640.5,125.5
"10597","31488","2020",196,112,84,247423.678571429,2990.72959183673,82.2244897959184
"10598","31489","2020",1,1,0,398350,2710,147
"10599","31490","2020",70,55,15,227265.528571429,2496.28571428571,90.7285714285714
"10600","31491","2020",4,4,0,152377.5,1184,160
"10601","31492","2020",5,5,0,150708.2,1705.2,86.4
"10602","31493","2020",2,2,0,155000,855.5,181.5
"10603","31494","2020",4,4,0,127382.5,868,134.75
"10604","31495","2020",10,10,0,208588,1991.2,106.1
"10605","31496","2020",1,1,0,195000,1931,101
"10606","31497","2020",27,27,0,310910.666666667,2804.88888888889,111.888888888889
"10607","31498","2020",1,1,0,73000,487,150
"10608","31499","2020",135,86,49,190680.096296296,2235.84444444444,83.8814814814815
"10609","31500","2020",23,15,8,153970.869565217,2271.47826086957,72.9130434782609
"10610","31501","2020",2,2,0,393100,3055,129.5
"10611","31502","2020",6,6,0,125666.666666667,1122.66666666667,110.5
"10612","31503","2020",16,16,0,151243.4375,1564.5625,99.3125
"10613","31504","2020",1,1,0,155000,1107,140
"10614","31505","2020",4,3,1,180575,1740.75,164.25
"10615","31506","2020",178,91,87,240338.061797753,3011.05617977528,79.314606741573
"10616","31507","2020",31,17,14,170706.129032258,2065.64516129032,82.741935483871
"10617","31509","2020",5,5,0,143710,1196.8,118
"10618","31510","2020",2,2,0,143000,851,180
"10619","31511","2020",1,1,0,273000,1820,150
"10620","31512","2020",10,10,0,332773,3076.7,115.5
"10621","31513","2020",3,3,0,124585,942.666666666667,135
"10622","31514","2020",1,1,0,149450,1177,127
"10623","31515","2020",7,7,0,219785.142857143,1992.85714285714,113.142857142857
"10624","31516","2020",22,19,3,239245,2396.90909090909,97.5
"10625","31517","2020",24,23,1,147785.083333333,1470.91666666667,103.875
"10626","31518","2020",8,8,0,284111.125,2764.875,107
"10627","31520","2020",1,1,0,187900,1708,110
"10628","31521","2020",4,4,0,110373.75,1531.75,83.75
"10629","31522","2020",1,1,0,180000,612,294
"10630","31523","2020",22,17,5,154293.181818182,1565.77272727273,99.4090909090909
"10631","31524","2020",4,3,1,159337.5,1720.5,90.5
"10632","31525","2020",8,8,0,211919.25,1951.375,116.75
"10633","31526","2020",110,66,44,225835.154545455,2672.09090909091,82.2
"10634","31528","2020",1,1,0,120000,1101,109
"10635","31529","2020",1,1,0,164500,1828,90
"10636","31530","2020",2,2,0,235295,1882.5,125
"10637","31531","2020",1,1,0,120500,1095,110
"10638","31532","2020",1,1,0,212000,1413,150
"10639","31533","2020",31,29,2,288709.419354839,2689.8064516129,107.225806451613
"10640","31534","2020",2,2,0,180550,2295.5,80
"10641","31535","2020",9,8,1,96805.5555555556,1112.44444444444,86.1111111111111
"10642","31538","2020",5,5,0,311660,2464.8,132.6
"10643","31539","2020",1,1,0,230000,3239,71
"10644","31540","2020",3,3,0,249150,2522.33333333333,101
"10645","31541","2020",67,23,44,225518.492537313,2984.07462686567,72.7611940298507
"10646","31542","2020",3,3,0,114333.666666667,1186,98.3333333333333
"10647","31543","2020",2,2,0,160000,1649,97
"10648","31544","2020",3,3,0,54000,801,72
"10649","31547","2020",105,79,26,215650.857142857,2329.30476190476,96.2285714285714
"10650","31550","2020",7,7,0,84428.5714285714,815,99.5714285714286
"10651","31551","2020",1,1,0,291700,2805,104
"10652","31553","2020",18,12,6,196880.555555556,1994.44444444444,94.5
"10653","31555","2020",8553,1230,7323,212464.180755291,3411.5352507892,63.139950894423
"10654","31556","2020",3,3,0,97766.6666666667,1033.33333333333,90.3333333333333
"10655","31557","2020",338,165,173,277285.99112426,3075.49112426035,87.5059171597633
"10656","31558","2020",9,9,0,215495.555555556,1798.33333333333,130.777777777778
"10657","31560","2020",5,5,0,217009.6,1830.8,113
"10658","31561","2020",139,118,21,332983.316546763,3417.15107913669,100.856115107914
"10659","31562","2020",2,2,0,116000,500,223
"10660","31563","2020",14,14,0,339212.857142857,2576.14285714286,131.714285714286
"10661","31564","2020",2,2,0,120000,4266.5,50
"10662","31565","2020",5,5,0,82400,755.2,111.6
"10663","31566","2020",5,5,0,188851,1619.6,120.6
"10664","31567","2020",1,1,0,362000,3148,115
"10665","31568","2020",3,3,0,202159,1766,109.333333333333
"10666","31569","2020",1,1,0,198100,2021,98
"10667","31570","2020",6,6,0,316566.666666667,1889.83333333333,203.5
"10668","31571","2020",2,2,0,127250,1376.5,87.5
"10669","31572","2020",34,33,1,268312.294117647,2542,105.764705882353
"10670","31573","2020",52,45,7,243982.173076923,2331.86538461538,103.653846153846
"10671","31574","2020",39,38,1,237943.102564103,2320.17948717949,104.666666666667
"10672","31575","2020",15,15,0,568787.866666667,3268.4,190.266666666667
"10673","31576","2020",3,3,0,162166.666666667,2040,79.3333333333333
"10674","31577","2020",2,2,0,229600,2217,104.5
"10675","31578","2020",12,12,0,476172.5,3189.41666666667,152.5
"10676","31579","2020",16,15,1,249274.6875,2581.4375,96.5
"10677","31580","2020",14,10,4,214840.714285714,2382.21428571429,88.2142857142857
"10678","31581","2020",18,18,0,190278.333333333,1923.27777777778,99.6111111111111
"10679","31582","2020",66,59,7,211378.303030303,2283.10606060606,93.3333333333333
"10680","31583","2020",13,13,0,249068.461538462,2283,116
"10681","31584","2020",110,87,23,160314.063636364,1730.08181818182,92.6636363636364
"10682","31585","2020",11,11,0,165037.272727273,1294.09090909091,130.727272727273
"10683","31586","2020",8,8,0,156485,1493.875,117
"10684","31587","2020",15,14,1,250872.133333333,2401.46666666667,103.466666666667
"10685","31588","2020",96,64,32,212764.53125,2623.91666666667,81.5833333333333
"10686","31589","2020",22,20,2,227871.181818182,2216.27272727273,106.954545454545
"10687","31591","2020",2,2,0,68250,1215,76.5
"10688","31592","2020",18,18,0,252000,2369.44444444444,108.555555555556
"10689","31593","2020",2,2,0,215000,1713,126
"10690","32001","2020",11,11,0,137826.363636364,1489.18181818182,94.7272727272727
"10691","32002","2020",1,1,0,75000,625,120
"10692","32003","2020",1,1,0,235000,1536,153
"10693","32004","2020",1,1,0,162550,1270,128
"10694","32005","2020",3,3,0,115666.666666667,1102.33333333333,121
"10695","32008","2020",2,2,0,108500,1388,72
"10696","32010","2020",3,3,0,138333.333333333,1432.33333333333,90
"10697","32012","2020",14,14,0,181050,1702.21428571429,110.357142857143
"10698","32013","2020",360,176,184,131322.630555556,1601.66388888889,82.3861111111111
"10699","32014","2020",1,1,0,130000,1215,107
"10700","32015","2020",1,1,0,130000,1444,90
"10701","32016","2020",10,10,0,330310,2141,143.9
"10702","32017","2020",1,1,0,50000,610,82
"10703","32018","2020",2,1,1,120000,1056.5,102
"10704","32019","2020",10,9,1,168908,2141.5,82.9
"10705","32020","2020",4,4,0,88250,708.5,127
"10706","32022","2020",2,2,0,57500,977,59
"10707","32024","2020",3,3,0,145366.666666667,921,160
"10708","32027","2020",23,21,2,116039.782608696,1273.69565217391,102.217391304348
"10709","32029","2020",9,9,0,122070.555555556,1103.11111111111,113.444444444444
"10710","32031","2020",3,3,0,144250,1295.33333333333,115.333333333333
"10711","32032","2020",5,5,0,277708,1702.2,150.2
"10712","32034","2020",2,2,0,303700,1110,246
"10713","32035","2020",6,6,0,129155,1213.66666666667,113.5
"10714","32036","2020",7,7,0,131317.142857143,1950.28571428571,87.7142857142857
"10715","32037","2020",1,1,0,130000,1383,94
"10716","32039","2020",2,2,0,119500,1129,121.5
"10717","32040","2020",1,1,0,164330,1494,110
"10718","32041","2020",1,1,0,150000,833,180
"10719","32042","2020",1,1,0,140000,1250,112
"10720","32043","2020",1,1,0,242000,1613,150
"10721","32044","2020",5,5,0,211672.6,1727,117
"10722","32045","2020",7,7,0,190564.857142857,1248,160.142857142857
"10723","32046","2020",1,1,0,116000,773,150
"10724","32048","2020",1,1,0,99500,1746,57
"10725","32050","2020",1,1,0,55000,458,120
"10726","32051","2020",1,1,0,270450,2003,135
"10727","32053","2020",3,3,0,139833.333333333,1115.33333333333,112.666666666667
"10728","32054","2020",3,3,0,198333.333333333,1440,143.666666666667
"10729","32055","2020",2,2,0,209900,1353,156.5
"10730","32057","2020",3,3,0,227666.666666667,1548.66666666667,143.333333333333
"10731","32059","2020",4,4,0,171750,1238.5,155.25
"10732","32060","2020",1,1,0,244450,1734,141
"10733","32061","2020",3,3,0,172000,1224,131.333333333333
"10734","32062","2020",1,1,0,270000,1588,170
"10735","32063","2020",3,3,0,133616.666666667,1000.66666666667,134
"10736","32064","2020",4,4,0,106000,1268,81.25
"10737","32065","2020",2,2,0,48500,510,90.5
"10738","32066","2020",3,3,0,174300,1607.33333333333,105
"10739","32067","2020",1,1,0,290000,795,365
"10740","32068","2020",2,2,0,224500,2282,98.5
"10741","32069","2020",3,3,0,193233.333333333,1516.33333333333,123.666666666667
"10742","32070","2020",3,3,0,132666.666666667,940.666666666667,151
"10743","32071","2020",2,2,0,191125,2544,76
"10744","32072","2020",1,1,0,170000,515,330
"10745","32073","2020",1,1,0,241500,1059,228
"10746","32075","2020",4,4,0,171375,1051.75,153.25
"10747","32076","2020",4,4,0,108475,936.75,115.5
"10748","32077","2020",1,1,0,42500,409,104
"10749","32078","2020",3,3,0,193000,2117.33333333333,92.3333333333333
"10750","32079","2020",23,22,1,138348.47826087,1335.08695652174,112.913043478261
"10751","32080","2020",2,2,0,227500,1927.5,116.5
"10752","32082","2020",4,3,1,172250,1780.25,143.75
"10753","32083","2020",15,11,4,115634.6,1312.53333333333,102
"10754","32085","2020",2,2,0,55000,601,92
"10755","32087","2020",1,1,0,1e+05,595,168
"10756","32088","2020",2,2,0,140750,865.5,189
"10757","32089","2020",1,1,0,180688,2030,89
"10758","32090","2020",6,6,0,283083.333333333,2295.5,136.166666666667
"10759","32091","2020",4,4,0,176215.25,1082,146.75
"10760","32093","2020",2,2,0,145350,1304,107
"10761","32095","2020",3,3,0,266661.666666667,1347.66666666667,164.666666666667
"10762","32096","2020",78,23,55,60139.6794871795,1182.28205128205,58.0769230769231
"10763","32097","2020",1,1,0,215000,1667,129
"10764","32098","2020",6,6,0,207815,2394.83333333333,85.8333333333333
"10765","32099","2020",1,1,0,132000,846,156
"10766","32100","2020",1,1,0,262700,1763,149
"10767","32101","2020",2,2,0,222000,1758.5,125.5
"10768","32102","2020",3,3,0,177433.333333333,1615,103.333333333333
"10769","32103","2020",4,4,0,161800,1772.5,99.75
"10770","32105","2020",3,3,0,324906.666666667,2928.33333333333,112.333333333333
"10771","32106","2020",13,13,0,172548,1679.84615384615,105
"10772","32107","2020",96,88,8,146019.645833333,1229.05208333333,118.895833333333
"10773","32108","2020",2,2,0,120000,1186,116.5
"10774","32110","2020",8,8,0,133023.625,1214.125,119.375
"10775","32111","2020",1,1,0,90000,882,102
"10776","32112","2020",1,1,0,110000,846,130
"10777","32113","2020",1,1,0,119000,763,156
"10778","32115","2020",5,5,0,70600,705.8,101
"10779","32117","2020",6,6,0,213340.333333333,2179.83333333333,96.5
"10780","32118","2020",1,1,0,142000,1753,81
"10781","32119","2020",57,51,6,146946.140350877,1332.49122807018,113.175438596491
"10782","32120","2020",1,1,0,190000,1275,149
"10783","32121","2020",8,8,0,238087.5,2034.125,123.25
"10784","32122","2020",5,5,0,136400,1851,79.4
"10785","32123","2020",6,6,0,252325.333333333,1584.33333333333,156.833333333333
"10786","32126","2020",1,1,0,80500,619,130
"10787","32127","2020",15,15,0,92397.0666666667,1164.46666666667,81.0666666666667
"10788","32128","2020",3,3,0,162333.333333333,1047.33333333333,152.333333333333
"10789","32129","2020",1,0,1,221000,1483,149
"10790","32130","2020",4,4,0,164250,1193.25,141.75
"10791","32131","2020",2,2,0,50685,654,73
"10792","32132","2020",103,82,21,115208.660194175,1215.58252427184,97.2135922330097
"10793","32133","2020",3,3,0,224139.666666667,1436,156
"10794","32134","2020",3,3,0,260333.333333333,1978,129.666666666667
"10795","32135","2020",2,2,0,105750,931.5,107.5
"10796","32136","2020",1,1,0,119400,1076,111
"10797","32138","2020",2,2,0,151403.5,1235,125.5
"10798","32139","2020",1,1,0,195000,1147,170
"10799","32141","2020",1,1,0,250000,2083,120
"10800","32142","2020",2,2,0,179080,1411,140
"10801","32143","2020",4,4,0,115400,834.5,128.5
"10802","32144","2020",1,1,0,339200,1785,190
"10803","32145","2020",1,1,0,235000,2500,94
"10804","32146","2020",1,1,0,256453,1509,170
"10805","32147","2020",46,40,6,159291.934782609,1561.36956521739,102.630434782609
"10806","32148","2020",3,3,0,248166.666666667,1570,168
"10807","32149","2020",22,21,1,94094.4545454545,875.636363636364,107.636363636364
"10808","32150","2020",2,2,0,164000,767,220
"10809","32151","2020",2,2,0,150000,1107,136.5
"10810","32152","2020",4,4,0,149707.5,1073.25,131.25
"10811","32154","2020",1,1,0,163000,1087,150
"10812","32155","2020",17,17,0,109741.176470588,1091.17647058824,111.294117647059
"10813","32156","2020",3,3,0,173353.333333333,1413.66666666667,119
"10814","32157","2020",2,2,0,222450,1602.5,143.5
"10815","32158","2020",1,1,0,82000,854,96
"10816","32159","2020",5,5,0,140000,888.4,171.6
"10817","32160","2020",131,75,56,198535.473282443,2233.32061068702,86.7328244274809
"10818","32161","2020",3,3,0,180333.333333333,989,174.666666666667
"10819","32162","2020",20,20,0,151386,1140.25,134.5
"10820","32163","2020",4,4,0,136387.5,1279.25,107.75
"10821","32164","2020",1,1,0,289100,1763,164
"10822","32166","2020",1,1,0,137400,763,180
"10823","32167","2020",9,9,0,133566.666666667,1427.55555555556,106.111111111111
"10824","32169","2020",1,1,0,204000,1325,154
"10825","32170","2020",2,2,0,198425,1256,156.5
"10826","32171","2020",2,2,0,176500,1298.5,136
"10827","32172","2020",1,1,0,40000,440,91
"10828","32173","2020",3,3,0,185000,1646,110
"10829","32174","2020",4,4,0,140625,1367,125.5
"10830","32175","2020",1,1,0,125485,896,140
"10831","32176","2020",2,2,0,197250,1159.5,186
"10832","32177","2020",1,1,0,118000,1326,89
"10833","32178","2020",1,1,0,357000,2856,125
"10834","32180","2020",9,9,0,175000,1857,94.8888888888889
"10835","32181","2020",5,5,0,111839.8,1100.4,98.4
"10836","32182","2020",1,1,0,167700,1863,90
"10837","32183","2020",1,1,0,75000,1172,64
"10838","32184","2020",3,3,0,107199.666666667,604.666666666667,178.666666666667
"10839","32186","2020",2,2,0,158825,1520,102.5
"10840","32187","2020",1,1,0,190000,1080,176
"10841","32188","2020",2,2,0,189500,1370.5,138
"10842","32189","2020",1,1,0,144025,1252,115
"10843","32190","2020",4,4,0,167975,1308.5,119.75
"10844","32191","2020",1,1,0,188000,1469,128
"10845","32192","2020",7,7,0,99428.5714285714,1167.57142857143,88.7142857142857
"10846","32193","2020",4,4,0,228407.5,1426,183.75
"10847","32194","2020",2,2,0,145000,1624.5,89
"10848","32195","2020",2,2,0,234500,1113.5,203.5
"10849","32196","2020",2,1,1,154000,1444,116.5
"10850","32197","2020",2,2,0,90500,730.5,128
"10851","32198","2020",1,1,0,95000,731,130
"10852","32199","2020",2,2,0,126500,984.5,129
"10853","32200","2020",1,1,0,241700,1859,130
"10854","32201","2020",4,4,0,177500,1621,116.5
"10855","32202","2020",10,10,0,171269,1475.7,121.2
"10856","32203","2020",2,2,0,129200,730,177.5
"10857","32204","2020",4,4,0,188500,1494.75,125.75
"10858","32205","2020",3,3,0,166333.333333333,956.666666666667,162.333333333333
"10859","32206","2020",2,2,0,123000,2173.5,69
"10860","32207","2020",6,5,1,188800,1615.33333333333,117.5
"10861","32208","2020",61,50,11,148983.868852459,1684.09836065574,95.8360655737705
"10862","32209","2020",3,3,0,122216.666666667,1045.66666666667,114
"10863","32210","2020",1,1,0,260000,3291,79
"10864","32211","2020",4,4,0,139250,864.25,166.5
"10865","32212","2020",4,4,0,149850,1328.75,119
"10866","32213","2020",62,61,1,141450.14516129,1497.41935483871,97.1129032258064
"10867","32214","2020",2,2,0,82500,742,113.5
"10868","32216","2020",1,1,0,268000,1314,204
"10869","32217","2020",1,1,0,330000,2426,136
"10870","32218","2020",1,1,0,95000,679,140
"10871","32219","2020",5,5,0,140800,1116.2,123.8
"10872","32220","2020",3,3,0,151724.666666667,852.666666666667,196.666666666667
"10873","32221","2020",2,2,0,196875,1920,101.5
"10874","32222","2020",6,6,0,131008.333333333,1260.66666666667,108.666666666667
"10875","32223","2020",1,1,0,110000,957,115
"10876","32224","2020",3,3,0,244500,1973,124.333333333333
"10877","32225","2020",1,1,0,271375,1952,139
"10878","32227","2020",7,7,0,118935.714285714,1163.42857142857,115.857142857143
"10879","32228","2020",2,2,0,280445,2525.5,129
"10880","32231","2020",5,5,0,141347.2,1224.2,122.4
"10881","32233","2020",26,22,4,123928.692307692,1169.88461538462,106.923076923077
"10882","32234","2020",4,4,0,258475,2191.25,116.5
"10883","32235","2020",4,4,0,143125,1005.75,138.25
"10884","32237","2020",7,7,0,153142.857142857,1903.14285714286,89
"10885","32238","2020",1,1,0,168000,1366,123
"10886","32239","2020",6,6,0,284041.666666667,1448.5,166.666666666667
"10887","32240","2020",1,1,0,517600,5566,93
"10888","32242","2020",27,24,3,114475.925925926,1112.51851851852,102.111111111111
"10889","32243","2020",5,5,0,185570,1465.4,119.4
"10890","32244","2020",1,1,0,146000,1081,135
"10891","32245","2020",2,2,0,67000,1123.5,53
"10892","32246","2020",1,1,0,79048,659,120
"10893","32247","2020",3,3,0,256930,1821,145.666666666667
"10894","32248","2020",2,2,0,279500,1607,208.5
"10895","32249","2020",34,27,7,140692.941176471,1530.5,93.0882352941177
"10896","32252","2020",18,18,0,118675.111111111,1176.11111111111,99.3888888888889
"10897","32253","2020",9,9,0,148531.666666667,1071.88888888889,138.444444444444
"10898","32254","2020",1,1,0,150900,1524,99
"10899","32255","2020",2,2,0,207500,1421.5,147.5
"10900","32256","2020",45,41,4,109789.022222222,1177.26666666667,95.9333333333333
"10901","32257","2020",1,1,0,120000,822,146
"10902","32260","2020",1,1,0,130000,1429,91
"10903","32261","2020",1,1,0,135750,1597,85
"10904","32262","2020",10,10,0,259630,1873.1,143.7
"10905","32263","2020",1,1,0,150000,1579,95
"10906","32264","2020",3,3,0,123666.666666667,1346,89
"10907","32265","2020",2,2,0,93500,1184.5,80
"10908","32266","2020",2,2,0,292750,1598.5,177.5
"10909","32267","2020",1,1,0,180000,1475,122
"10910","32268","2020",6,6,0,229575,2045.16666666667,117.833333333333
"10911","32269","2020",10,10,0,157143,1031.9,156.6
"10912","32271","2020",3,3,0,83266.6666666667,1310,66.3333333333333
"10913","32272","2020",3,3,0,210233.333333333,1499.33333333333,145.333333333333
"10914","32274","2020",4,4,0,118975,1222.5,164.75
"10915","32275","2020",1,1,0,120000,1500,80
"10916","32276","2020",1,1,0,116000,829,140
"10917","32277","2020",1,1,0,185450,1973,94
"10918","32279","2020",5,5,0,250370,1504.2,184.8
"10919","32280","2020",2,2,0,191690,1685,105.5
"10920","32281","2020",1,1,0,229000,1431,160
"10921","32282","2020",4,4,0,187065,1832.75,103
"10922","32283","2020",8,8,0,144532.25,1332,107.5
"10923","32285","2020",11,11,0,117127.272727273,1159.18181818182,95.2727272727273
"10924","32286","2020",7,7,0,118122.142857143,1237.28571428571,98.7142857142857
"10925","32287","2020",2,2,0,216995,1070.5,188
"10926","32288","2020",3,3,0,121050,1041.66666666667,121.333333333333
"10927","32289","2020",1,1,0,245500,2758,89
"10928","32290","2020",17,17,0,172651.529411765,1370.94117647059,130.235294117647
"10929","32292","2020",7,7,0,238343.285714286,1836,128.285714285714
"10930","32295","2020",5,5,0,304558,2364.2,144.4
"10931","32296","2020",33,27,6,107850.909090909,1235.57575757576,90.3030303030303
"10932","32297","2020",2,2,0,325005,2063,160.5
"10933","32298","2020",7,7,0,176404.571428571,1364.42857142857,136.285714285714
"10934","32299","2020",1,1,0,210000,2333,90
"10935","32300","2020",2,2,0,275200,1658.5,171
"10936","32301","2020",13,13,0,264203.846153846,1898.46153846154,137.923076923077
"10937","32302","2020",3,3,0,168500,1384.66666666667,119.333333333333
"10938","32304","2020",2,2,0,151000,1613,95.5
"10939","32305","2020",4,4,0,84750,1317.5,68.75
"10940","32306","2020",6,6,0,111081.666666667,1115.5,103
"10941","32307","2020",32,32,0,185455.03125,1624.21875,115.875
"10942","32308","2020",3,3,0,249533.333333333,1747,154.666666666667
"10943","32309","2020",1,1,0,223490,2353,95
"10944","32311","2020",3,3,0,267119,2559.33333333333,110.666666666667
"10945","32312","2020",6,6,0,174233.333333333,1834.66666666667,99.8333333333333
"10946","32313","2020",3,3,0,225366.666666667,1431.33333333333,191.666666666667
"10947","32315","2020",3,3,0,171750,1403.66666666667,109.666666666667
"10948","32316","2020",1,1,0,2e+05,1942,103
"10949","32317","2020",1,1,0,304500,1162,262
"10950","32318","2020",2,2,0,83625,746,125
"10951","32319","2020",22,21,1,142844.545454545,1395.63636363636,104.227272727273
"10952","32320","2020",2,2,0,115785,895,131.5
"10953","32321","2020",4,4,0,206975,1990.75,105
"10954","32324","2020",1,1,0,155000,987,157
"10955","32325","2020",3,3,0,181600,1160.33333333333,158.666666666667
"10956","32328","2020",2,2,0,259825,1647.5,139
"10957","32329","2020",2,2,0,157250,1035.5,146
"10958","32330","2020",3,3,0,77739,863.333333333333,93
"10959","32331","2020",9,4,5,114277.777777778,1528.44444444444,73.4444444444444
"10960","32332","2020",2,2,0,219500,1769,122
"10961","32334","2020",14,14,0,304144.214285714,2367,137.928571428571
"10962","32335","2020",2,2,0,125195,1051,122
"10963","32336","2020",1,1,0,192000,1548,124
"10964","32338","2020",4,4,0,136155,1179.5,122.75
"10965","32339","2020",1,1,0,288450,2289,126
"10966","32340","2020",4,4,0,134350,1146,120
"10967","32341","2020",5,5,0,184100,1196.4,173
"10968","32343","2020",1,1,0,85000,1328,64
"10969","32344","2020",25,25,0,96269.8,1019.76,97.8
"10970","32345","2020",12,12,0,257591.666666667,1863.5,138.5
"10971","32347","2020",1,1,0,140000,1818,77
"10972","32348","2020",2,2,0,101750,1336.5,60.5
"10973","32349","2020",1,1,0,175000,1651,106
"10974","32351","2020",1,1,0,181500,1745,104
"10975","32352","2020",1,1,0,168000,1680,100
"10976","32353","2020",1,1,0,128000,1707,75
"10977","32354","2020",2,2,0,83000,1064,109.5
"10978","32356","2020",4,4,0,172875,1597,111.75
"10979","32357","2020",2,2,0,226500,1802.5,126
"10980","32358","2020",4,4,0,128050,1034,124.75
"10981","32359","2020",1,1,0,678500,2300,295
"10982","32360","2020",4,4,0,173075,1982.25,114
"10983","32361","2020",1,1,0,90000,804,112
"10984","32362","2020",3,3,0,125000,1185.66666666667,122
"10985","32363","2020",2,2,0,270000,1350,200
"10986","32364","2020",1,1,0,60000,368,163
"10987","32365","2020",5,5,0,123930,1315.4,138
"10988","32367","2020",2,2,0,243991.5,1735.5,139
"10989","32368","2020",8,8,0,142500,1278.875,112
"10990","32369","2020",4,4,0,224115,1490.75,140.75
"10991","32370","2020",4,4,0,118096,1016.75,105
"10992","32371","2020",2,2,0,270000,1495,182
"10993","32372","2020",3,3,0,190233.333333333,2383.66666666667,79.3333333333333
"10994","32374","2020",4,4,0,178625,1527.75,121.75
"10995","32375","2020",1,1,0,66000,943,70
"10996","32376","2020",1,1,0,7e+05,3825,183
"10997","32377","2020",2,2,0,236360,1684.5,133.5
"10998","32378","2020",3,3,0,120333.333333333,1159,100.666666666667
"10999","32379","2020",2,2,0,140375,1446.5,96
"11000","32380","2020",2,2,0,188550,1608,117.5
"11001","32381","2020",3,3,0,150766.7,1281,122.6667
"11002","32382","2020",4,4,0,191082.5,1719.75,113
"11003","32383","2020",1,1,0,120000,1200,100
"11004","32384","2020",1,1,0,130000,2167,60
"11005","32385","2020",3,3,0,166643.3,661,241.6667
"11006","32386","2020",1,1,0,154200,1455,106
"11007","32387","2020",3,3,0,252950,1843.333,138
"11008","32388","2020",4,4,0,227382.8,1591,154.75
"11009","32389","2020",3,3,0,114400,918.3333,127
"11010","32390","2020",3,3,0,141333.3,1004.333,163.3333
"11011","32391","2020",1,1,0,130000,1368,95
"11012","32394","2020",2,2,0,120000,1267,100.5
"11013","32395","2020",3,3,0,372500,1774,164
"11014","32396","2020",4,4,0,246862.5,1610.75,142
"11015","32397","2020",7,7,0,210194.3,1501.714,149.4286
"11016","32398","2020",2,2,0,113500,776.5,158.5
"11017","32399","2020",1,1,0,211300,1761,120
"11018","32400","2020",2,2,0,72500,616,114.5
"11019","32401","2020",1,1,0,80000,552,145
"11020","32402","2020",2,2,0,203500,1201,162
"11021","32403","2020",1,1,0,140000,1273,110
"11022","32404","2020",11,11,0,159700,1147.727,127.1818
"11023","32406","2020",3,3,0,134983.3,1788.333,90.66667
"11024","32407","2020",1,1,0,130000,1300,100
"11025","32410","2020",32,30,2,183625.2,1963.438,100.3438
"11026","32412","2020",16,14,2,109055.8,1249.938,90
"11027","32414","2020",1,1,0,80000,1039,77
"11028","32416","2020",3,3,0,129628,2313,76.66667
"11029","32417","2020",8,8,0,323875,1786.625,124.875
"11030","32418","2020",10,10,0,172068.8,1587.1,107.7
"11031","32419","2020",1,1,0,261300,1306,200
"11032","32421","2020",2,2,0,158750,1453,100
"11033","32422","2020",1,1,0,265000,1893,140
"11034","32423","2020",1,1,0,98000,467,210
"11035","32424","2020",2,2,0,66500,928.5,74
"11036","32425","2020",11,11,0,253624.8,2270.455,115.4545
"11037","32426","2020",9,9,0,112122.2,1142.778,106.7778
"11038","32428","2020",1,1,0,591500,6429,92
"11039","32429","2020",1,1,0,190000,1462,130
"11040","32430","2020",2,2,0,161750,2476,68.5
"11041","32432","2020",3,3,0,266665,2487.333,105.3333
"11042","32433","2020",6,6,0,155903.3,1413,124.1667
"11043","32434","2020",1,1,0,374175,1445,259
"11044","32435","2020",2,2,0,264400,2144,125.5
"11045","32436","2020",6,6,0,169626.7,1582.667,113
"11046","32437","2020",7,7,0,155975,1185.571,132.8571
"11047","32438","2020",1,1,0,240000,1481,162
"11048","32439","2020",1,1,0,88000,652,135
"11049","32440","2020",3,3,0,139616.7,1523,103.3333
"11050","32441","2020",3,3,0,89333.33,857,110.3333
"11051","32442","2020",4,4,0,189950,1494.75,126
"11052","32443","2020",1,1,0,39000,488,80
"11053","32444","2020",1,1,0,236250,2054,115
"11054","32445","2020",2,2,0,167625,1681.5,99.5
"11055","32446","2020",6,6,0,160165,1360,133.3333
"11056","32447","2020",2,2,0,213180,1830,117
"11057","32448","2020",7,6,1,195055.7,1552.857,137.1429
"11058","32450","2020",2,2,0,161675,1674.5,96.5
"11059","32451","2020",3,3,0,222333.3,1728.667,121.6667
"11060","32452","2020",5,5,0,195690,1510.8,135.4
"11061","32455","2020",6,6,0,201500,1354.667,148.5
"11062","32457","2020",1,1,0,296000,1244,238
"11063","32458","2020",7,7,0,94500,868.7143,108.2857
"11064","32459","2020",16,16,0,89350,1019.25,89.5625
"11065","32460","2020",7,7,0,114792.9,1095.429,100.4286
"11066","32461","2020",1,1,0,80000,593,135
"11067","32462","2020",50,47,3,126891.6,1249.94,105.92
"11068","32463","2020",7,7,0,96085.71,822.5714,136.4286
"11069","32464","2020",12,12,0,141020.8,1135.75,112.4167
"11070","32465","2020",2,2,0,67250,945,71.5
"11071","32466","2020",1,1,0,155750,1309,119
"11072","32467","2020",3,3,0,149500,1045.333,142.6667
"11073","33001","2020",16,16,0,153125,1722.875,93.4375
"11074","33002","2020",17,17,0,211864.7,1701.765,134.3529
"11075","33003","2020",163,141,22,230324,2502.939,95.69325
"11076","33004","2020",24,23,1,187608.3,2271.292,86.875
"11077","33005","2020",257,200,57,398682.5,4822.058,88.33463
"11078","33006","2020",14,14,0,133771.4,1398.286,103.6429
"11079","33007","2020",17,17,0,290190.5,2495.353,117.2941
"11080","33008","2020",3,3,0,134000,1214,109
"11081","33009","2020",559,167,392,466422.4,6896.374,68.40072
"11082","33010","2020",9,9,0,203728.3,2163.333,93.22222
"11083","33011","2020",159,121,38,333357.4,4224.314,81.61006
"11084","33012","2020",44,43,1,329084.9,2929,115.5
"11085","33013","2020",85,67,18,315974.1,3410.671,96.34118
"11086","33014","2020",15,15,0,239682.3,1794.467,132.5333
"11087","33015","2020",17,16,1,264733.5,2690.529,105
"11088","33016","2020",6,6,0,299141.7,2069.333,154
"11089","33017","2020",5,5,0,162760,1898.8,91.6
"11090","33018","2020",38,35,3,201965.5,2137.816,101.5
"11091","33019","2020",152,111,41,283066,3208.691,89.20395
"11092","33021","2020",12,12,0,159080.8,1672.417,95.25
"11093","33022","2020",41,41,0,254928.7,2588,102.7073
"11094","33023","2020",6,6,0,236100,2195.833,112.5
"11095","33024","2020",7,7,0,183657.1,1379.714,137
"11096","33025","2020",3,3,0,200966.7,1802.667,118.3333
"11097","33026","2020",10,10,0,218331.9,1775.6,124
"11098","33027","2020",3,3,0,222666.7,1441.667,155
"11099","33028","2020",13,13,0,285606.2,2481.308,120.8462
"11100","33029","2020",67,55,12,265193.9,2835.91,96.80597
"11101","33030","2020",29,24,5,254014.6,2395.034,104.6207
"11102","33031","2020",4,4,0,181875,1856,103.5
"11103","33032","2020",61,51,10,228173.3,2955.016,81.34426
"11104","33033","2020",11,11,0,354935.8,3163.091,114.8182
"11105","33034","2020",7,7,0,138049.3,1010.571,127
"11106","33035","2020",10,10,0,192080,1497.7,135.1
"11107","33036","2020",59,53,6,175657.7,1793.712,103.1525
"11108","33037","2020",20,18,2,280322.5,3022.95,92.9
"11109","33038","2020",15,15,0,164112.8,1557.467,103.3333
"11110","33039","2020",408,199,209,280194.3,3854.228,73.5049
"11111","33040","2020",15,15,0,179190.5,2059.733,93.66667
"11112","33042","2020",93,88,5,270402.8,2543.054,109.2258
"11113","33043","2020",1,1,0,237500,1979,120
"11114","33044","2020",5,5,0,253250.2,1850.4,144.4
"11115","33045","2020",5,5,0,186020,1690.6,121.6
"11116","33046","2020",12,11,1,157333.3,1697.833,98.33333
"11117","33047","2020",22,22,0,181695.5,1636.364,116.4091
"11118","33048","2020",2,2,0,168500,2370.5,74
"11119","33049","2020",24,24,0,283328.8,2709.833,105.9167
"11120","33050","2020",8,8,0,219290,1758.75,130.5
"11121","33051","2020",156,122,34,265053.1,3079.583,89
"11122","33052","2020",30,13,17,152424.3,2035.567,72.3
"11123","33053","2020",4,4,0,190962.5,1599.25,122
"11124","33054","2020",6,6,0,171998.3,1457.667,126
"11125","33055","2020",2,2,0,218525,1744.5,123
"11126","33056","2020",161,112,49,295919.8,3218.82,95.22981
"11127","33057","2020",17,17,0,218374.4,1593.765,135.5882
"11128","33058","2020",109,89,20,122197.3,1390.532,87.14679
"11129","33059","2020",6,5,1,160750,1729,88.16667
"11130","33060","2020",1,1,0,177500,2399,74
"11131","33061","2020",8,8,0,296370,2609,117.25
"11132","33062","2020",9,9,0,197789.4,1436.444,133.4444
"11133","33063","2020",4691,1280,3411,330792.8,4731.696,71.29823
"11134","33064","2020",1,1,0,107000,1783,60
"11135","33065","2020",41,39,2,494412,3892.024,128.4634
"11136","33066","2020",4,4,0,223000,1624,140.75
"11137","33067","2020",35,35,0,142327.1,1686.314,85.28571
"11138","33068","2020",3,3,0,227333.3,2137.667,112
"11139","33069","2020",433,228,205,392963.6,4334.18,87.5612
"11140","33070","2020",8,8,0,283318.8,2898.875,99.75
"11141","33071","2020",9,9,0,150311.1,1457.111,105.1111
"11142","33072","2020",1,1,0,270000,2727,99
"11143","33073","2020",10,9,1,119550,1296,91.7
"11144","33074","2020",1,1,0,40000,667,60
"11145","33075","2020",323,127,196,291480.4,3619.43,80.26006
"11146","33076","2020",9,9,0,160483.3,1859.889,87.33333
"11147","33077","2020",31,30,1,309249.4,2883.323,115.3548
"11148","33078","2020",3,3,0,140333.3,1209,113
"11149","33079","2020",1,1,0,230500,2022,114
"11150","33080","2020",85,52,33,267452.1,3203.024,84.04706
"11151","33081","2020",38,30,8,151720.1,1918.105,83.5
"11152","33082","2020",15,15,0,220420,2076.933,109
"11153","33083","2020",8,8,0,296203,2980.125,99.625
"11154","33084","2020",27,20,7,250086.5,2705.741,92.18519
"11155","33085","2020",35,32,3,374539.7,3040.314,127.4
"11156","33086","2020",3,3,0,83000,1265,66.66667
"11157","33087","2020",4,4,0,109000,1271.25,91.75
"11158","33088","2020",8,8,0,133025,1367.25,99.875
"11159","33089","2020",7,7,0,143200,1113.286,128.2857
"11160","33090","2020",47,39,8,323179.5,3516.362,94.6383
"11161","33093","2020",7,7,0,208885.7,2044,97
"11162","33094","2020",3,3,0,65308,755,96
"11163","33095","2020",17,15,2,144733.5,1945.118,95.52941
"11164","33096","2020",80,52,28,237717.6,3197.275,86.2625
"11165","33097","2020",100,62,38,209085.3,3314.76,68.41
"11166","33098","2020",2,2,0,147500,2091.5,66
"11167","33099","2020",31,30,1,393626,3500.097,116.2581
"11168","33100","2020",17,17,0,153873.2,1438.235,108.8235
"11169","33101","2020",11,10,1,143717.3,1620,91.18182
"11170","33102","2020",4,4,0,185500,2327.25,88.25
"11171","33103","2020",1,1,0,1e+05,1111,90
"11172","33104","2020",93,70,23,222745.5,2779.634,84.95699
"11173","33105","2020",2,2,0,195975,1530,129.5
"11174","33106","2020",15,15,0,176413.2,1823.133,101.2
"11175","33108","2020",59,55,4,106622.1,1205.492,97.54237
"11176","33109","2020",33,33,0,243821.4,2389.576,104
"11177","33111","2020",15,15,0,225456.7,1612.533,137.5333
"11178","33112","2020",2,2,0,180000,1641.5,108.5
"11179","33113","2020",3,3,0,207133.3,1451.333,143.6667
"11180","33114","2020",32,19,13,154237.9,1866.812,92.125
"11181","33115","2020",8,8,0,169500,1701.125,115.75
"11182","33116","2020",7,7,0,185868.9,1751.857,126.1429
"11183","33117","2020",3,3,0,125000,2033.333,75.66667
"11184","33118","2020",14,14,0,405994.3,3010.571,132.2143
"11185","33119","2020",316,126,190,205960.4,3226.206,66.01266
"11186","33120","2020",19,19,0,158325.8,2111.316,83.21053
"11187","33121","2020",1,1,0,270436,1486,182
"11188","33122","2020",174,164,10,391734.8,3649.851,112.4655
"11189","33123","2020",41,41,0,209364.6,1931,114.3902
"11190","33124","2020",7,7,0,144571.4,1608.143,92.14286
"11191","33125","2020",26,26,0,177968.8,1782.962,97.84615
"11192","33126","2020",8,8,0,175184.9,1436.25,116.375
"11193","33128","2020",7,7,0,201442.9,1411.143,148.8571
"11194","33129","2020",1,1,0,164000,1726,95
"11195","33130","2020",11,11,0,232350,2148.091,108
"11196","33131","2020",4,4,0,145000,1458.25,98.5
"11197","33132","2020",7,7,0,201492.9,1533.571,124.1429
"11198","33133","2020",1,1,0,237000,1959,121
"11199","33134","2020",4,4,0,168145,1389.5,122.75
"11200","33135","2020",4,4,0,235720,1750.5,138.75
"11201","33136","2020",8,8,0,158609,1273.75,127.375
"11202","33137","2020",3,3,0,221333.3,1272.333,173
"11203","33138","2020",120,88,32,137528,1652.95,84.75833
"11204","33139","2020",1,1,0,164000,2103,78
"11205","33140","2020",77,57,20,214528.9,2627.922,80.55844
"11206","33141","2020",9,9,0,246050,2528.333,100.1111
"11207","33142","2020",23,22,1,190861,1810.783,109.7826
"11208","33143","2020",25,24,1,228901.4,2384,102
"11209","33144","2020",9,9,0,176863.9,1636.222,111.3333
"11210","33145","2020",4,4,0,314500,2626.25,115.75
"11211","33146","2020",27,26,1,193217,2209.704,96.18519
"11212","33147","2020",7,7,0,194849.9,1592.571,125.2857
"11213","33149","2020",2,2,0,172500,1317.5,133
"11214","33150","2020",9,9,0,255909.4,2031.222,119
"11215","33151","2020",3,3,0,154833.3,1782.667,102.3333
"11216","33152","2020",3,3,0,135366.7,1437.667,101.6667
"11217","33153","2020",3,3,0,154033.3,1613,97.66667
"11218","33154","2020",30,30,0,114591,1116.767,110.5667
"11219","33155","2020",3,3,0,104673.3,1428.333,72.66667
"11220","33156","2020",7,7,0,167993.9,1050,164.4286
"11221","33157","2020",8,7,1,337938.9,2135.5,151.875
"11222","33158","2020",5,5,0,194180,1540.6,128.6
"11223","33159","2020",33,31,2,112250.9,1203.121,96.81818
"11224","33160","2020",10,10,0,179744.4,1409.4,125
"11225","33161","2020",9,9,0,130293.3,1381.333,99.66667
"11226","33162","2020",314,173,141,273200.6,3511.818,79.50318
"11227","33163","2020",2,2,0,179500,1791,101.5
"11228","33164","2020",9,9,0,221316.7,2056,109.7778
"11229","33165","2020",51,42,9,296818.5,3028.255,96.09804
"11230","33166","2020",2,2,0,91750,954,91.5
"11231","33167","2020",203,115,88,248680.8,3158.64,79.99015
"11232","33168","2020",10,10,0,148713,1716.1,84.8
"11233","33169","2020",1,1,0,129000,1290,100
"11234","33170","2020",13,13,0,142652.5,1316.231,114.3077
"11235","33171","2020",1,1,0,260000,1688,154
"11236","33172","2020",5,5,0,153095.8,1433.2,100.8
"11237","33173","2020",4,4,0,133750,1856.5,76.5
"11238","33174","2020",15,15,0,303946.7,2206.933,137.9333
"11239","33175","2020",11,11,0,236454.5,1855,125.5455
"11240","33176","2020",2,2,0,161205,1987.5,80.5
"11241","33177","2020",43,41,2,202313,2155.256,116.3256
"11242","33178","2020",9,9,0,144977.8,1483.111,101
"11243","33179","2020",40,35,5,165846.2,1864.35,91.3
"11244","33180","2020",2,2,0,705000,2889,233.5
"11245","33181","2020",1,1,0,148000,1510,98
"11246","33182","2020",14,14,0,255400.7,1698.643,134.5714
"11247","33183","2020",13,12,1,194082.2,2143.231,92.07692
"11248","33184","2020",4,4,0,161375,1243.5,128.25
"11249","33185","2020",35,25,10,163419.7,2073.4,88.54286
"11250","33186","2020",15,15,0,165660.1,1458.933,110.3333
"11251","33187","2020",17,14,3,135755.9,1427.941,101.2941
"11252","33188","2020",5,5,0,200180,1670.8,120.4
"11253","33189","2020",11,11,0,173991.5,1531.909,115.6364
"11254","33190","2020",1,1,0,186100,1379,135
"11255","33191","2020",12,12,0,102425.3,1284.5,85.41667
"11256","33192","2020",283,128,155,275362.4,3503.505,78.56184
"11257","33193","2020",24,24,0,189268.1,2156.125,93.25
"11258","33194","2020",8,8,0,214317.5,1822.875,116.375
"11259","33195","2020",21,19,2,143600,1314,125.5714
"11260","33196","2020",5,5,0,164772,1926.6,114.8
"11261","33197","2020",5,5,0,219280,1883,119
"11262","33198","2020",28,27,1,147025,1288,114.7143
"11263","33199","2020",417,313,104,348142.4,4128.242,84.63309
"11264","33200","2020",151,95,56,304238.3,3607.265,86.49669
"11265","33201","2020",12,9,3,290892.9,2880.667,119.5833
"11266","33202","2020",32,31,1,220692,2277.594,104.4375
"11267","33203","2020",144,99,45,201489.7,2781.556,73.20833
"11268","33204","2020",10,10,0,201250,1804.8,102.6
"11269","33205","2020",8,8,0,229750,2244.25,110.875
"11270","33206","2020",7,6,1,191800,2974.571,71.42857
"11271","33207","2020",68,68,0,258195.5,2549.485,108.2647
"11272","33208","2020",20,20,0,136267,1455.6,92.5
"11273","33209","2020",2,2,0,330000,2325,150
"11274","33210","2020",2,2,0,162249.5,1832.5,88.5
"11275","33211","2020",10,10,0,191003,1907.6,109.4
"11276","33212","2020",5,5,0,160600,1736.2,96
"11277","33213","2020",38,32,6,327086.3,3452.211,99.63158
"11278","33214","2020",295,191,104,252603.4,4052.393,63.78983
"11279","33215","2020",1,1,0,165000,2012,82
"11280","33216","2020",3,3,0,363333.3,1814,184.3333
"11281","33218","2020",24,24,0,171972.9,1646.333,108.5
"11282","33219","2020",32,29,3,240853,2130.938,113.625
"11283","33220","2020",21,21,0,183977.4,1957.714,96.14286
"11284","33221","2020",14,14,0,162743.2,1239,121.5714
"11285","33222","2020",8,8,0,226193.8,1808.25,117.875
"11286","33223","2020",4,4,0,117600,808.5,155
"11287","33225","2020",39,39,0,204730.9,2017.769,106.641
"11288","33226","2020",40,37,3,208936.6,2318.725,93.725
"11289","33227","2020",135,82,53,132969,1800.578,75.59259
"11290","33228","2020",8,8,0,141893.8,941.375,147.125
"11291","33229","2020",134,112,22,341925.7,4068.978,86.85821
"11292","33230","2020",5,4,1,158354,1563.8,99.4
"11293","33231","2020",5,5,0,260094.6,2008.4,127.2
"11294","33232","2020",1,1,0,268760,2688,100
"11295","33233","2020",27,27,0,197679.8,1779.37,120.963
"11296","33234","2020",46,41,5,429242.8,3607.891,123.3696
"11297","33235","2020",4,4,0,197312.5,1565,149.5
"11298","33236","2020",200,159,41,760721.5,7561.325,103.12
"11299","33237","2020",13,13,0,211169.2,1875,114.6923
"11300","33238","2020",97,94,3,356162,3477,105.6289
"11301","33239","2020",7,7,0,205642.9,1686.571,130
"11302","33240","2020",106,83,23,149167.6,1581.472,95.14151
"11303","33241","2020",11,9,2,149036.4,1990.545,80.54545
"11304","33242","2020",5,5,0,208600,1430.4,142.2
"11305","33243","2020",404,227,177,173044.4,2265.76,77.51485
"11306","33244","2020",3,3,0,170666.7,1396.333,150.6667
"11307","33245","2020",13,13,0,325651.5,2629.692,124.6923
"11308","33246","2020",1,1,0,85000,773,110
"11309","33247","2020",2,2,0,1e+05,839,120
"11310","33248","2020",43,43,0,218945.6,2232.372,100.5116
"11311","33249","2020",232,88,144,189798.7,2644.638,73.30603
"11312","33250","2020",3,3,0,226606.7,1618.333,137
"11313","33251","2020",8,8,0,244000,1838.625,142.25
"11314","33252","2020",8,8,0,420846.2,3130.125,133.375
"11315","33253","2020",7,7,0,165357.1,1762.429,94
"11316","33254","2020",5,5,0,231676.4,1298.4,182
"11317","33255","2020",6,6,0,140833.3,1242,111.5
"11318","33256","2020",71,63,8,272735.3,2870.944,97.46479
"11319","33257","2020",3,3,0,252616.7,1509,169
"11320","33258","2020",4,4,0,235062.5,1439.5,161
"11321","33259","2020",7,7,0,278857.1,2457.714,121.4286
"11322","33260","2020",18,18,0,291509.2,2194.667,139
"11323","33261","2020",10,10,0,186223.8,1827.8,108.7
"11324","33262","2020",51,47,4,239452,2774.725,92.84314
"11325","33263","2020",3,3,0,223116.7,2584.667,91.33333
"11326","33264","2020",8,8,0,172375,1744,115.375
"11327","33266","2020",10,10,0,184458.7,1576.4,125.6
"11328","33268","2020",38,35,3,228121.9,2295.5,103.5789
"11329","33269","2020",4,4,0,106551.2,1038.25,104.5
"11330","33270","2020",4,4,0,226337.5,2030.5,110.75
"11331","33272","2020",10,10,0,185146.9,1932,92.3
"11332","33273","2020",108,73,35,313383.1,3401.306,94.14815
"11333","33274","2020",42,37,5,302981.5,3168.5,98.04762
"11334","33275","2020",3,3,0,160000,2073.333,81
"11335","33277","2020",2,2,0,173000,1462.5,117
"11336","33279","2020",3,3,0,246766.7,1932.333,137
"11337","33280","2020",4,4,0,181250,1750,105.75
"11338","33281","2020",1060,403,657,278955.2,3680.261,76.24717
"11339","33282","2020",3,3,0,198666.7,1740.333,102.6667
"11340","33283","2020",5,5,0,140100,1233.6,126.8
"11341","33284","2020",147,138,9,323255.8,3276.748,103.0476
"11342","33285","2020",9,9,0,150950,1721.444,88.44444
"11343","33287","2020",13,13,0,163413.1,1432.538,123.3846
"11344","33288","2020",2,2,0,222500,2090,111
"11345","33289","2020",24,24,0,161995.8,1208.833,128.9167
"11346","33290","2020",21,21,0,183998.6,1664.048,119.0476
"11347","33291","2020",2,2,0,149750,1816.5,82.5
"11348","33293","2020",38,30,8,277792.3,2726.053,103.4737
"11349","33294","2020",11,11,0,171127.3,1532.273,113
"11350","33295","2020",1,1,0,140000,1474,95
"11351","33296","2020",14,14,0,174216.1,1604.357,103.3571
"11352","33297","2020",32,32,0,222991.9,2088,107.8438
"11353","33298","2020",9,9,0,329550.6,2466.333,139.1111
"11354","33299","2020",7,7,0,185957.1,1672,112.5714
"11355","33300","2020",17,17,0,213692.9,2131.118,105.2941
"11356","33301","2020",3,3,0,253866.7,1742,177.3333
"11357","33302","2020",3,3,0,179093.3,1709.667,101.6667
"11358","33303","2020",15,15,0,247566.8,2341.2,99.66667
"11359","33304","2020",2,2,0,130250,2085.5,80.5
"11360","33305","2020",12,12,0,187563.6,2013.75,94.91667
"11361","33306","2020",6,6,0,223881.7,1771,134.1667
"11362","33307","2020",23,23,0,199187,1861.783,108.2174
"11363","33308","2020",3,3,0,200666.7,1787.667,115
"11364","33309","2020",9,9,0,164322.2,1450.333,117.2222
"11365","33310","2020",3,3,0,206333.3,1639.667,135
"11366","33311","2020",31,22,9,158048.4,1877.484,89
"11367","33312","2020",135,90,45,264090.8,3171.252,82.77778
"11368","33314","2020",50,50,0,157068.4,1737.52,94.14
"11369","33315","2020",26,26,0,148865.8,1620.654,101.1154
"11370","33316","2020",17,17,0,151641.8,1207.529,125.5882
"11371","33317","2020",10,10,0,232716.1,2205.2,106.4
"11372","33318","2020",727,430,297,304955.8,3687.691,83.63274
"11373","33320","2020",7,7,0,179285.7,1729.571,106.4286
"11374","33321","2020",18,18,0,224043.4,2143.056,102.5556
"11375","33322","2020",86,81,5,325034.1,3209.64,103.7326
"11376","33323","2020",15,15,0,210474.1,1969.533,106
"11377","33324","2020",83,58,25,108802.7,1262.41,87.36145
"11378","33325","2020",17,17,0,188847.9,1535.176,125.7059
"11379","33326","2020",1,1,0,60000,1000,60
"11380","33327","2020",34,32,2,191535.3,2042.353,98.85294
"11381","33328","2020",6,6,0,144333.3,1467,106.1667
"11382","33329","2020",3,3,0,269800,2347.667,111.3333
"11383","33330","2020",48,45,3,354294.3,3096.583,119.5625
"11384","33331","2020",5,5,0,311826,1915.6,163.2
"11385","33332","2020",15,15,0,151855.4,1471.6,106.2667
"11386","33333","2020",39,39,0,299740.5,3098.667,100.641
"11387","33334","2020",24,21,3,207236.8,2461.542,86.41667
"11388","33335","2020",3,3,0,210907.3,2898,73.33333
"11389","33336","2020",17,17,0,106382.4,1052,103.7059
"11390","33337","2020",29,28,1,179431.8,1743.966,107.4138
"11391","33339","2020",17,17,0,268544.7,1928.941,144.2941
"11392","33341","2020",21,20,1,256412.2,2352.095,115.6667
"11393","33342","2020",7,7,0,199464.3,2493.571,83.14286
"11394","33343","2020",12,12,0,169942.5,1950.333,90.75
"11395","33344","2020",5,5,0,145694,1371.8,131.6
"11396","33345","2020",6,6,0,150134.7,1324.667,115.8333
"11397","33346","2020",6,6,0,175633.3,1605.667,125
"11398","33347","2020",5,5,0,205300,1428.6,140
"11399","33348","2020",19,19,0,164627.3,1700.947,102.5263
"11400","33349","2020",19,19,0,459928.9,3174.579,150.2632
"11401","33350","2020",28,28,0,170551.6,1631.679,102.8571
"11402","33351","2020",13,13,0,119126.5,1101.385,113.3077
"11403","33352","2020",59,56,3,122412,1258.61,99.28814
"11404","33353","2020",1,1,0,148200,1059,140
"11405","33354","2020",2,2,0,292628,1180,241
"11406","33355","2020",19,19,0,198551.9,1992.947,98.63158
"11407","33356","2020",7,7,0,258971.4,2223.571,111.2857
"11408","33357","2020",25,25,0,219876.4,2120.16,104.32
"11409","33358","2020",8,8,0,165787.5,1566.625,107.25
"11410","33359","2020",5,5,0,164875,1290.6,130.4
"11411","33360","2020",2,2,0,73175,859,98
"11412","33361","2020",7,7,0,115428.6,1291,91.28571
"11413","33362","2020",13,13,0,178022.4,1899.385,100.8462
"11414","33363","2020",49,48,1,310732.3,2862.592,110.6122
"11415","33364","2020",3,3,0,161333.3,1852.333,84
"11416","33365","2020",1,1,0,173350,2709,64
"11417","33366","2020",185,131,54,204483.3,2348.124,88.65405
"11418","33367","2020",5,5,0,194600,1324.4,146.6
"11419","33369","2020",2,2,0,147775,1731.5,85.5
"11420","33370","2020",4,4,0,172022.5,1521,122.75
"11421","33373","2020",8,8,0,140071.8,1449,100.375
"11422","33374","2020",10,10,0,110900,1264.9,96.6
"11423","33375","2020",5,5,0,240669,1743,144
"11424","33376","2020",85,73,12,419441.3,3559.365,118.0941
"11425","33377","2020",2,2,0,266082.5,2170,119.5
"11426","33378","2020",15,15,0,122460,1164.867,105.4
"11427","33379","2020",4,4,0,142611,1683.25,86
"11428","33380","2020",13,13,0,111202.8,923.9231,122
"11429","33381","2020",50,36,14,247245.2,2600.24,95.68
"11430","33382","2020",24,24,0,167726.7,1572.417,112.5
"11431","33383","2020",9,9,0,126518.3,1226.556,109.8889
"11432","33384","2020",3,3,0,188900,2526.333,75
"11433","33385","2020",9,9,0,138866.7,1126.778,137
"11434","33387","2020",22,22,0,185112.7,1767.318,105.6364
"11435","33388","2020",9,9,0,173954.7,2115.667,93.11111
"11436","33389","2020",45,45,0,121330.4,1261.356,100.8444
"11437","33390","2020",5,5,0,232200,1509.2,137.4
"11438","33391","2020",7,7,0,193535.7,1784,118.5714
"11439","33392","2020",8,8,0,133875,1175.5,117.875
"11440","33393","2020",56,53,3,173033.3,1715.589,108.125
"11441","33394","2020",15,15,0,271152.8,3377.4,97.86667
"11442","33395","2020",32,31,1,98132.81,1212.5,84.125
"11443","33397","2020",41,37,4,274617.4,2878.78,96.73171
"11444","33398","2020",2,2,0,175500,1480,126
"11445","33399","2020",2,2,0,154000,1476.5,105
"11446","33400","2020",3,3,0,238666.7,3297.667,102.3333
"11447","33401","2020",4,4,0,656318.8,3158.25,166.25
"11448","33402","2020",47,34,13,79622.77,921.383,91.34043
"11449","33403","2020",1,1,0,282000,2136,132
"11450","33404","2020",3,3,0,208000,2068,106.3333
"11451","33405","2020",3,3,0,188166.7,1312.333,147.6667
"11452","33406","2020",6,6,0,284766.7,3356.5,97.83333
"11453","33407","2020",11,11,0,282748.6,2817.909,107.5455
"11454","33408","2020",5,5,0,296400,2738.8,112.4
"11455","33411","2020",3,3,0,2e+05,1799.333,101.6667
"11456","33412","2020",13,13,0,141807.7,1548.308,92.69231
"11457","33413","2020",25,24,1,270354.3,2441.08,119.08
"11458","33414","2020",3,3,0,323333.3,3093.667,114.3333
"11459","33415","2020",34,31,3,192930.2,2059.765,95.97059
"11460","33416","2020",18,18,0,178470.8,1496.389,122.2778
"11461","33417","2020",36,35,1,325156.8,3124.25,109.5556
"11462","33418","2020",7,7,0,168334.3,1753.286,99.57143
"11463","33419","2020",1,1,0,146300,2709,54
"11464","33420","2020",1,1,0,310000,2081,149
"11465","33421","2020",6,6,0,240033.3,1883,121
"11466","33422","2020",100,76,24,346768.4,3609.77,98.31
"11467","33423","2020",5,5,0,113720,1092.4,107.4
"11468","33424","2020",69,51,18,169176.3,1882.029,91.5942
"11469","33425","2020",15,15,0,200145.5,2208.467,97.73333
"11470","33426","2020",3,3,0,218666.7,2264.667,96.66667
"11471","33427","2020",6,6,0,184578.3,1261.5,139.5
"11472","33429","2020",7,7,0,184732.9,1520.714,124
"11473","33431","2020",4,4,0,203500,2385.25,85
"11474","33432","2020",1,1,0,217000,1669,130
"11475","33433","2020",92,83,9,301092.7,2930.065,99.70652
"11476","33434","2020",31,24,7,177991.5,2304.903,78.67742
"11477","33435","2020",47,27,20,151496.2,1672.17,91.95745
"11478","33436","2020",15,14,1,249613.1,2207.867,115.5333
"11479","33437","2020",33,33,0,222995.5,1635.939,132.9697
"11480","33438","2020",23,23,0,183323.9,1863.304,98.95652
"11481","33439","2020",16,15,1,195002.5,1817.25,111.6875
"11482","33441","2020",24,17,7,126830.2,1539.917,80.625
"11483","33442","2020",9,9,0,179211.1,1568.556,120.2222
"11484","33443","2020",1,1,0,149000,1419,105
"11485","33444","2020",5,5,0,225390,2272.2,97.8
"11486","33445","2020",7,7,0,203380,1865.429,109.5714
"11487","33446","2020",2,2,0,232000,1314.5,176
"11488","33447","2020",51,50,1,137898.1,1563.98,92.54902
"11489","33448","2020",33,32,1,291275.2,2744.788,112.2727
"11490","33449","2020",341,267,74,329909,3466.472,97.21114
"11491","33450","2020",8,8,0,141538,1434.875,99.625
"11492","33451","2020",3,3,0,157500,1171.667,149
"11493","33452","2020",7,7,0,194162.9,1777.857,108.2857
"11494","33453","2020",4,4,0,267595,1989,134.5
"11495","33454","2020",22,22,0,327253.3,2873.955,118.8636
"11496","33456","2020",3,3,0,178333.3,1188.667,150.3333
"11497","33457","2020",9,9,0,240435.6,2107.444,116.7778
"11498","33458","2020",13,13,0,147639.7,1431.769,108.8462
"11499","33460","2020",9,9,0,172768.3,1940.333,86
"11500","33461","2020",4,4,0,297100,1782,157.5
"11501","33462","2020",2,2,0,92750,1032.5,92
"11502","33463","2020",21,21,0,176941.1,1922.095,94.95238
"11503","33464","2020",6,6,0,155633.3,2039.167,83.5
"11504","33465","2020",12,12,0,187722.5,1685.833,115.6667
"11505","33466","2020",80,30,50,140542.2,2026.412,66.35
"11506","33467","2020",6,6,0,202238.3,1640.833,135.6667
"11507","33468","2020",10,10,0,194513.6,1870.2,102.2
"11508","33470","2020",5,5,0,353100,3004,123.4
"11509","33471","2020",14,14,0,212042.1,1780.357,116.3571
"11510","33472","2020",6,6,0,210391.7,1730.333,121.6667
"11511","33473","2020",31,29,2,157293.7,1469.032,116.9355
"11512","33474","2020",41,41,0,336525.8,2727.488,127.9024
"11513","33475","2020",6,6,0,133916.7,1536.833,84.66667
"11514","33476","2020",7,7,0,171720,1211.286,117.7143
"11515","33477","2020",16,16,0,118918.8,1318.938,89.0625
"11516","33478","2020",55,46,9,111728.1,1510.364,74.4
"11517","33479","2020",2,2,0,172875,1765,97
"11518","33480","2020",11,11,0,173363.6,1855,96.09091
"11519","33481","2020",1,1,0,115000,1045,110
"11520","33482","2020",6,6,0,263516.7,1593.333,157.6667
"11521","33483","2020",65,58,7,348395.9,2825.415,121.1077
"11522","33484","2020",25,21,4,159410,1681.48,100.28
"11523","33485","2020",27,26,1,183664.8,1840,103.4074
"11524","33486","2020",5,5,0,207446,1955.2,107.4
"11525","33487","2020",9,9,0,273550.3,2363.222,111.5556
"11526","33488","2020",5,5,0,265128,2046.4,128.2
"11527","33489","2020",6,6,0,220550,1604.167,145
"11528","33490","2020",45,40,5,144973.3,1719.889,87.73333
"11529","33491","2020",7,7,0,206240,1958,120.5714
"11530","33492","2020",34,25,9,145388.4,1730.588,81.73529
"11531","33493","2020",9,9,0,158638.9,1429.222,132.1111
"11532","33494","2020",13,13,0,384121.5,3388.231,113.6154
"11533","33496","2020",28,28,0,301818.1,2847.143,111.0357
"11534","33498","2020",95,86,9,265856,2732.211,100.0842
"11535","33499","2020",6,6,0,142367.5,1287.833,111.6667
"11536","33500","2020",5,5,0,162680,1732.6,108.6
"11537","33501","2020",33,32,1,322714.4,2984.758,109.8485
"11538","33502","2020",9,9,0,168213.9,1830.667,99.33333
"11539","33503","2020",5,5,0,326120,2595.4,126.2
"11540","33504","2020",8,8,0,235032.9,2234.125,112.75
"11541","33505","2020",17,17,0,212540,2062.353,106.9412
"11542","33506","2020",27,22,5,158042,1566.519,101.4444
"11543","33507","2020",5,5,0,210300,1338.2,165
"11544","33508","2020",7,7,0,194235.7,1673.571,120.2857
"11545","33509","2020",5,5,0,220400,1889.8,132
"11546","33510","2020",3,3,0,177766.7,1680.667,102
"11547","33511","2020",5,5,0,158655.8,1772.8,91.2
"11548","33512","2020",5,5,0,199720,1653.6,126.4
"11549","33513","2020",1,1,0,258000,1665,155
"11550","33514","2020",169,109,60,184294.5,2931.314,66.31361
"11551","33515","2020",3,3,0,166166.7,1579,107
"11552","33516","2020",3,3,0,186266.7,1734.667,105.6667
"11553","33517","2020",28,28,0,243349.4,2370.679,99.75
"11554","33518","2020",14,14,0,220413.4,2277.286,98.5
"11555","33519","2020",114,101,13,337090,3550.079,98.47368
"11556","33520","2020",4,4,0,208512.8,1350,151.5
"11557","33521","2020",10,10,0,198791,2176,92.1
"11558","33522","2020",669,251,418,262586.6,4145.39,65.07773
"11559","33523","2020",20,19,1,210502,2019.3,106.85
"11560","33525","2020",11,10,1,165040.9,1921.545,87.72727
"11561","33526","2020",1,1,0,345000,2464,140
"11562","33527","2020",117,89,28,316802.5,3497.291,91.46154
"11563","33528","2020",4,4,0,347625,2560.75,135.5
"11564","33529","2020",492,394,98,499722.4,4950.014,96.36382
"11565","33530","2020",14,14,0,204002.7,1795.571,113.5
"11566","33531","2020",3,3,0,149000,1390.667,108.3333
"11567","33533","2020",27,24,3,180730.1,2035.593,92.66667
"11568","33534","2020",10,7,3,230739.1,2678.3,90.7
"11569","33535","2020",44,38,6,335125.2,3302.659,102.2955
"11570","33536","2020",8,8,0,427812.5,3435.125,129.125
"11571","33537","2020",6,6,0,195116.7,1821.5,121.1667
"11572","33538","2020",12,12,0,107458.3,1254.917,84.41667
"11573","33539","2020",58,53,5,265017.2,2257.448,121.0862
"11574","33540","2020",75,73,2,208368,2700.933,82.01333
"11575","33541","2020",25,25,0,201023.1,2106.08,96.64
"11576","33542","2020",9,9,0,226432.8,2335.667,97.44444
"11577","33543","2020",12,12,0,214424.6,1817.167,118.4167
"11578","33544","2020",70,33,37,131041,2089.714,62.27143
"11579","33545","2020",15,14,1,148729.3,1365.267,118.5333
"11580","33546","2020",4,4,0,194613.5,1889.5,109.25
"11581","33547","2020",15,15,0,185444.1,1513.867,126.8667
"11582","33548","2020",17,17,0,198544.4,1841.176,111.4706
"11583","33549","2020",3,3,0,207000,2318,102.3333
"11584","33550","2020",435,297,138,285504.5,3559.88,81.09425
"11585","33551","2020",4,4,0,176150,1627.5,106.25
"11586","33552","2020",10,10,0,206730,1964,106.8
"11587","33553","2020",10,9,1,206766.5,2419.8,84.7
"11588","33554","2020",28,28,0,334022,3027.679,116.5714
"11589","33555","2020",73,62,11,294003.1,3202.233,92.94521
"11590","34001","2020",27,25,2,150593.4,1756.259,89.2963
"11591","34002","2020",16,15,1,191200,1962,89.75
"11592","34003","2020",1784,421,1363,137803.5,3312.461,44.79428
"11593","34004","2020",3,3,0,197100,1270,136.3333
"11594","34005","2020",4,4,0,304006.8,2941.25,124
"11595","34006","2020",7,7,0,240978.6,2594.857,112.7143
"11596","34007","2020",8,8,0,84805.38,1027.25,82.625
"11597","34008","2020",10,10,0,110454.5,1333.9,75.7
"11598","34009","2020",21,20,1,162161.4,1767.095,90.80952
"11599","34010","2020",27,24,3,166447.6,2259.259,76.48148
"11600","34011","2020",3,3,0,118350,1433.333,70
"11601","34012","2020",18,18,0,275944.1,2710.889,104.8889
"11602","34013","2020",24,23,1,152281.6,1689.958,89.25
"11603","34014","2020",11,9,2,432382.4,3097.818,135.4545
"11604","34015","2020",4,4,0,121625,1204.25,107
"11605","34016","2020",6,6,0,346441.7,2718.833,122.5
"11606","34017","2020",12,12,0,216330.4,2154.5,95.33333
"11607","34018","2020",30,29,1,140434,1392.3,104.2
"11608","34019","2020",6,6,0,71701.67,829.5,81.5
"11609","34020","2020",8,8,0,120890.6,1271.125,90.5
"11610","34021","2020",6,6,0,113975,888.8333,128.6667
"11611","34022","2020",102,73,29,324853.4,3461.824,94.48039
"11612","34023","2020",256,56,200,172200.4,3926.438,49.14062
"11613","34024","2020",41,37,4,286370.9,3136.171,93.14634
"11614","34025","2020",35,35,0,165796.5,1693.943,101.0571
"11615","34026","2020",4,4,0,81500,1250,67
"11616","34027","2020",27,25,2,416267.1,3222.63,127.7407
"11617","34028","2020",103,63,40,107311.3,1293.243,84.74757
"11618","34029","2020",9,8,1,238004.3,2452.556,100.2222
"11619","34030","2020",5,5,0,183778.6,1611.6,119
"11620","34031","2020",90,83,7,194001.6,2228.822,85.31111
"11621","34032","2020",1302,514,788,130060.7,1677.251,77.2765
"11622","34033","2020",30,24,6,259776.4,2743.633,93.1
"11623","34035","2020",13,13,0,330191.5,2922,112.6923
"11624","34036","2020",13,13,0,230573.1,1955.538,115.9231
"11625","34037","2020",35,28,7,197880.7,2120.2,94.8
"11626","34038","2020",23,22,1,117471.7,1316.043,89.21739
"11627","34039","2020",28,20,8,298121.4,3530.821,84.71429
"11628","34040","2020",1,1,0,76000,1310,58
"11629","34041","2020",7,7,0,231150,2409.571,97.85714
"11630","34042","2020",8,8,0,326592.5,2497.625,137
"11631","34043","2020",4,4,0,332225,3022.75,110.25
"11632","34044","2020",9,8,1,111017.1,1580.778,77.77778
"11633","34045","2020",13,13,0,195480,2180.846,90.84615
"11634","34046","2020",3,3,0,83438.33,1177.667,80.66667
"11635","34047","2020",10,9,1,179798,2034.2,93
"11636","34049","2020",5,5,0,57600,998.8,69
"11637","34050","2020",26,16,10,319520.7,3439.308,92.88462
"11638","34051","2020",54,52,2,226819.1,2221.907,106
"11639","34052","2020",55,51,4,147903.6,1646.509,85.90909
"11640","34053","2020",2,2,0,115000,1065,108.5
"11641","34055","2020",3,3,0,59016.67,639,92.33333
"11642","34056","2020",21,21,0,142456.2,1762.143,78.09524
"11643","34057","2020",362,138,224,296386.7,3722.948,77.40608
"11644","34058","2020",1,1,0,210000,1750,120
"11645","34059","2020",3,3,0,73333.33,1005,71
"11646","34060","2020",6,6,0,173351,1975.667,88
"11647","34061","2020",14,14,0,123439.3,1317.214,91.35714
"11648","34062","2020",3,3,0,127044.7,1161.333,108.6667
"11649","34063","2020",49,45,4,210342.9,1890.163,102.6735
"11650","34064","2020",8,7,1,123318.8,1343,90.75
"11651","34065","2020",9,9,0,190591.4,1603.889,106.3333
"11652","34066","2020",3,3,0,577590.3,3044,198
"11653","34067","2020",21,19,2,190166.2,2106.286,99.52381
"11654","34068","2020",3,3,0,58000,922,62.66667
"11655","34069","2020",76,71,5,168632.8,1725.934,96.65789
"11656","34070","2020",15,15,0,172511.3,1560.067,101.8667
"11657","34071","2020",3,2,1,67723.33,990.6667,67.66667
"11658","34073","2020",33,30,3,174560,2334.636,81.09091
"11659","34074","2020",34,34,0,121551.5,1524.882,83.61765
"11660","34075","2020",9,9,0,184771.7,1538.889,124.6667
"11661","34076","2020",19,17,2,229655.3,2202.842,102.2105
"11662","34077","2020",46,35,11,327253.3,3408.935,96.69565
"11663","34078","2020",22,22,0,271066.4,2853.909,98.68182
"11664","34079","2020",142,76,66,164014.4,1999.852,80.84507
"11665","34080","2020",6,6,0,154500,1389.5,110.6667
"11666","34081","2020",37,35,2,207503.9,2090.622,102.0811
"11667","34082","2020",8,8,0,303261.2,2582.375,111.625
"11668","34083","2020",5,5,0,120994,1346.2,94.2
"11669","34084","2020",14,13,1,174815,1640.214,101.5714
"11670","34085","2020",5,5,0,299316,1957.2,147.2
"11671","34086","2020",19,19,0,81478.84,906.8421,90.89474
"11672","34087","2020",61,46,15,266853.6,2864.033,93.19672
"11673","34088","2020",87,68,19,244788.6,2574.667,97.09195
"11674","34089","2020",28,28,0,173509.8,1669.786,102.3571
"11675","34090","2020",89,59,30,310924.7,3558.461,89.41573
"11676","34091","2020",1,1,0,62000,653,95
"11677","34092","2020",19,17,2,129955.8,1233.895,105.7895
"11678","34093","2020",3,3,0,137519.7,1377.333,92.33333
"11679","34094","2020",22,22,0,191316.7,1826.955,102.1818
"11680","34095","2020",89,73,16,309548,3074.506,100.3708
"11681","34096","2020",14,13,1,162925,1814,87.71429
"11682","34097","2020",8,8,0,152562.5,1652.125,88.25
"11683","34098","2020",7,7,0,60724.29,911.5714,76.28571
"11684","34101","2020",67,65,2,185870.4,2214.672,83.26866
"11685","34102","2020",5,5,0,417655.6,2660,157.4
"11686","34103","2020",5,5,0,143300,1687.8,79.6
"11687","34104","2020",3,3,0,193016.7,2344.667,67
"11688","34105","2020",5,5,0,179770,1673.2,110.6
"11689","34106","2020",2,2,0,223000,3070.5,71
"11690","34107","2020",3,3,0,108000,1733.667,70.33333
"11691","34108","2020",480,231,249,195241,3023.196,68.39167
"11692","34109","2020",20,20,0,179289.6,1764.15,98.45
"11693","34110","2020",11,10,1,432222.7,3069.727,128.7273
"11694","34111","2020",52,29,23,131339.3,1714.231,78.96154
"11695","34112","2020",1,1,0,494000,3431,144
"11696","34113","2020",101,85,16,255179.4,2609.109,99.34653
"11697","34114","2020",87,77,10,214945.6,2464.184,88.56322
"11698","34115","2020",2,2,0,110144.5,1470.5,78.5
"11699","34116","2020",151,55,96,207324.3,2852.086,68.55629
"11700","34117","2020",7,5,2,62550,793.8571,83.14286
"11701","34118","2020",4,3,1,364125,2741.75,119.25
"11702","34119","2020",30,24,6,96744.33,1230.1,78.96667
"11703","34120","2020",61,40,21,320809.4,3729.459,87.08197
"11704","34121","2020",3,3,0,194553.3,1582,113.6667
"11705","34122","2020",4,4,0,247632.5,1911,127.5
"11706","34123","2020",193,127,66,269745.8,3020.549,88.81347
"11707","34124","2020",9,8,1,186056.7,2378.556,84.77778
"11708","34125","2020",2,2,0,262650,2723.5,95.5
"11709","34126","2020",60,22,38,115912.7,1964.267,64.2
"11710","34127","2020",48,43,5,291425.2,3101.979,95.52083
"11711","34128","2020",28,24,4,185078.6,1893.25,94.32143
"11712","34129","2020",254,111,143,329315.8,4091.366,81.20472
"11713","34130","2020",28,28,0,212916.2,1985.893,107.8571
"11714","34131","2020",6,6,0,343435.2,2665.833,136.1667
"11715","34132","2020",3,3,0,185333.3,1723,108.6667
"11716","34134","2020",35,28,7,291718.9,3324.886,88.4
"11717","34135","2020",58,56,2,186895.6,1902.776,101.2414
"11718","34136","2020",11,10,1,115885,1568.455,69.63636
"11719","34138","2020",4,4,0,149598.2,1884.25,78
"11720","34139","2020",20,20,0,248949.8,1989.6,121.5
"11721","34140","2020",34,33,1,208683.3,2071.765,101.2941
"11722","34141","2020",19,19,0,132818.4,1543.842,90.68421
"11723","34142","2020",84,47,37,129082.9,1563.524,78.85714
"11724","34143","2020",58,53,5,183267.2,2767.914,74.84483
"11725","34144","2020",22,20,2,96215.91,909.8182,96.22727
"11726","34145","2020",424,259,165,177669.9,2252.38,79.28538
"11727","34146","2020",51,45,6,253057.5,2496.118,102.2549
"11728","34147","2020",58,56,2,190172.3,1870.138,99.7931
"11729","34148","2020",46,41,5,186458,1932.348,92.91304
"11730","34149","2020",15,15,0,211843.3,2050.333,103.9333
"11731","34150","2020",300,150,150,175411.1,3281.86,58.3
"11732","34151","2020",133,103,30,197189,2452.767,83.25564
"11733","34152","2020",7,7,0,416646.9,3272.714,129.1429
"11734","34153","2020",18,16,2,423073,3563.056,118.9444
"11735","34154","2020",434,136,298,234726.2,4006.751,59.95622
"11736","34155","2020",36,36,0,201374.8,1990.333,95.72222
"11737","34157","2020",204,140,64,252849.5,3052.578,84.25
"11738","34158","2020",3,3,0,275483.3,2522.333,97.66667
"11739","34159","2020",41,34,7,268457.4,3230.927,89.56098
"11740","34160","2020",6,6,0,121293.3,1247.833,86.83333
"11741","34161","2020",48,47,1,194780.2,2135.604,93.83333
"11742","34162","2020",54,51,3,171531.6,1918.722,85.85185
"11743","34163","2020",67,61,6,307139.1,2942.791,105.9552
"11744","34164","2020",10,7,3,361976.8,3113.2,114.7
"11745","34165","2020",40,32,8,255937.1,2484.4,104.225
"11746","34166","2020",56,53,3,179815.2,2055.304,87.73214
"11747","34167","2020",4,4,0,169027.2,1712.75,93.5
"11748","34168","2020",1,1,0,104500,1900,55
"11749","34169","2020",44,39,5,571789.1,4082.205,140.6591
"11750","34170","2020",4,4,0,199025,1833.5,100.25
"11751","34172","2020",5129,598,4531,188051.5,3149.051,60.86781
"11752","34173","2020",18,18,0,206085.2,2532.667,83.83333
"11753","34174","2020",7,7,0,242464.3,2485.286,107.4286
"11754","34175","2020",1,1,0,225000,1442,156
"11755","34176","2020",37,36,1,310109.3,3182.27,97.83784
"11756","34178","2020",52,49,3,161786.7,1779,90.19231
"11757","34179","2020",17,14,3,271670.4,2869.529,91.82353
"11758","34180","2020",26,23,3,163104.5,1804.769,88.5
"11759","34181","2020",21,21,0,187363.9,2041.048,89.66667
"11760","34182","2020",27,25,2,238080.8,2205.259,112.1481
"11761","34183","2020",65,63,2,188966.1,1863.492,100.3538
"11762","34184","2020",13,13,0,172119.3,1881.538,90.76923
"11763","34185","2020",1,1,0,248050,3221,77
"11764","34186","2020",7,7,0,198181.4,1587.143,133
"11765","34187","2020",12,12,0,142802.8,1423.333,97
"11766","34188","2020",1,1,0,178000,1548,115
"11767","34189","2020",22,21,1,105582.9,1084.591,98.31818
"11768","34190","2020",3,3,0,139248.3,1542.667,87.66667
"11769","34191","2020",11,11,0,212081.1,1848.455,114.2727
"11770","34192","2020",256,33,223,210610.8,4558.168,46.27734
"11771","34193","2020",4,4,0,238125,1707.75,137.25
"11772","34194","2020",59,57,2,185987.4,2065.254,88.83051
"11773","34195","2020",1,1,0,50000,1282,39
"11774","34196","2020",3,3,0,69333.33,1090.333,64.33333
"11775","34197","2020",18,16,2,193923.9,1938.667,94.27778
"11776","34198","2020",142,102,40,350785.4,3896.915,90.69718
"11777","34199","2020",145,80,65,181205.1,2065.297,89.64828
"11778","34200","2020",4,4,0,197475,1668.25,107.25
"11779","34201","2020",7,7,0,167926.9,1775.857,94
"11780","34202","2020",127,93,34,246775.2,2938.685,85.35433
"11781","34203","2020",38,36,2,176770.9,2449.342,80.71053
"11782","34204","2020",26,24,2,211043.9,2144.269,96.42308
"11783","34205","2020",4,4,0,147737.5,1694.5,90
"11784","34206","2020",11,11,0,262177.1,2242.364,118.4545
"11785","34207","2020",50,49,1,178237.3,2290.38,77.9
"11786","34208","2020",5,5,0,286102,2267.4,133.8
"11787","34209","2020",115,103,12,182298.5,3130.33,61.53913
"11788","34210","2020",27,26,1,193016.4,2088.815,93.62963
"11789","34211","2020",9,8,1,99883.33,1233.444,77.44444
"11790","34212","2020",4,4,0,165725,1510,109.5
"11791","34213","2020",83,64,19,264318.3,2843.434,92.57831
"11792","34214","2020",30,29,1,152725.3,1530.5,99.43333
"11793","34215","2020",16,13,3,192462.5,1718.188,105.75
"11794","34216","2020",4,4,0,300100,1863.25,151.5
"11795","34217","2020",74,52,22,311092.7,3476.743,88.40541
"11796","34218","2020",6,6,0,284108.3,1889.333,158.8333
"11797","34219","2020",6,6,0,119500,1232.5,93.5
"11798","34220","2020",1,1,0,95000,864,110
"11799","34221","2020",6,5,1,349395.7,3571.833,121.1667
"11800","34222","2020",4,4,0,181712.5,2421.25,74.75
"11801","34223","2020",20,20,0,214504.4,1948.85,98
"11802","34224","2020",20,18,2,249125.6,2142.1,107.65
"11803","34225","2020",52,44,8,117206.5,1306.077,91.84615
"11804","34226","2020",25,24,1,133996,1555.48,94.04
"11805","34227","2020",25,22,3,286853.7,3087.6,94.92
"11806","34228","2020",1,1,0,54000,771,70
"11807","34229","2020",17,16,1,86425.59,934.4118,94.82353
"11808","34230","2020",3,3,0,112890,1049,95.33333
"11809","34231","2020",1,1,0,248900,2263,110
"11810","34232","2020",15,15,0,171780.3,2290.6,74.2
"11811","34234","2020",2,2,0,179000,1967,106.5
"11812","34235","2020",8,8,0,155326.5,1550.125,93.625
"11813","34237","2020",62,59,3,171174.4,1815.194,91.33871
"11814","34239","2020",91,76,15,205187.8,2269.901,91.02198
"11815","34240","2020",45,36,9,378132.3,3728.022,105.8222
"11816","34241","2020",13,12,1,197121.9,2250.231,85.92308
"11817","34242","2020",14,13,1,386522.9,3226.786,126.1429
"11818","34243","2020",24,23,1,211969.5,2401.458,90.625
"11819","34244","2020",73,30,43,210331.3,2776.315,75.84932
"11820","34245","2020",44,39,5,154038.5,1629.386,88.22727
"11821","34246","2020",32,23,9,260492.8,2573.969,104.2188
"11822","34247","2020",44,39,5,514890.5,3641.364,136.7955
"11823","34248","2020",15,15,0,400452.3,3128.8,129.9333
"11824","34249","2020",34,31,3,308685,2906.647,105.5588
"11825","34250","2020",6,6,0,97293.33,1440.333,63.33333
"11826","34251","2020",9,9,0,213944.4,1823.111,113.8889
"11827","34252","2020",7,6,1,79585.71,1124.857,61.14286
"11828","34254","2020",16,15,1,177813.8,1913.188,92.25
"11829","34255","2020",108,77,31,426171.1,3516.176,113.287
"11830","34256","2020",21,18,3,370703.8,3288.619,117.7143
"11831","34257","2020",3,3,0,117666.7,1418,84.66667
"11832","34258","2020",38,38,0,224487.6,2114.474,110.3684
"11833","34259","2020",46,33,13,317309.7,2983.087,107.1739
"11834","34260","2020",12,10,2,88395,985.9167,88.58333
"11835","34261","2020",3,3,0,211666.7,3066.667,66.33333
"11836","34262","2020",4,4,0,263782.5,2886,89.25
"11837","34263","2020",1,1,0,127650,2901,44
"11838","34264","2020",3,3,0,58333.33,1082,54.33333
"11839","34265","2020",10,10,0,377031,3084.6,124.6
"11840","34266","2020",2,2,0,432000,3718.5,115.5
"11841","34267","2020",26,25,1,203048.7,2061.962,91
"11842","34268","2020",13,12,1,217664.6,1914.692,112.9231
"11843","34269","2020",2,2,0,141815.5,1569,97.5
"11844","34270","2020",148,96,52,338331.2,3730.514,92.77027
"11845","34271","2020",2,2,0,218000,2206,105
"11846","34272","2020",37,32,5,260237.2,2969.784,88.05405
"11847","34273","2020",1,1,0,155000,3100,50
"11848","34274","2020",23,23,0,297480.7,3031.13,107.913
"11849","34276","2020",52,47,5,336880,3156.788,108.0962
"11850","34277","2020",3,3,0,103450,906.3333,104.6667
"11851","34278","2020",1,1,0,187000,1438,130
"11852","34279","2020",2,2,0,85000,776,121
"11853","34280","2020",5,5,0,295781.2,3070.4,100
"11854","34281","2020",41,39,2,180907.6,2079.39,93.92683
"11855","34282","2020",22,20,2,272823.2,2368.909,124.3182
"11856","34283","2020",2,2,0,40000,610.5,67.5
"11857","34284","2020",20,17,3,76621.5,991,73.75
"11858","34285","2020",5,5,0,154206,1876.8,86.4
"11859","34286","2020",6,6,0,156400,1750.5,89.83333
"11860","34287","2020",7,6,1,146949.9,1779.714,81.28571
"11861","34288","2020",11,10,1,334287.5,3245.273,109
"11862","34289","2020",64,61,3,174996,1994.125,89.25
"11863","34290","2020",7,6,1,339114.3,3143.857,109.1429
"11864","34291","2020",8,8,0,122422.5,1507.125,83.75
"11865","34292","2020",9,9,0,237566.7,2137.222,117.8889
"11866","34293","2020",55,55,0,118565.2,1494,74.56364
"11867","34294","2020",13,13,0,257069.2,2875.077,89.23077
"11868","34295","2020",19,18,1,376762.4,3301.158,117.6316
"11869","34296","2020",4,4,0,203537.5,3213.25,88.5
"11870","34297","2020",2,2,0,253225,2110.5,120
"11871","34298","2020",80,76,4,250036,2505.075,101.35
"11872","34299","2020",129,101,28,217882.4,2630.566,82.12403
"11873","34300","2020",83,80,3,206062.5,2004.253,100.0482
"11874","34301","2020",1175,144,1031,178750.2,2980.036,60.03404
"11875","34302","2020",20,20,0,134246.8,1401.85,91.6
"11876","34304","2020",14,13,1,152396.4,1578.643,92.07143
"11877","34305","2020",5,5,0,109700,1612.2,69.4
"11878","34306","2020",3,3,0,304766.7,1761.333,174
"11879","34307","2020",32,26,6,318109.3,3061.344,103.0312
"11880","34308","2020",10,9,1,153563,1749.3,87
"11881","34309","2020",35,29,6,398475.1,3622.2,109.8286
"11882","34310","2020",49,48,1,211682.6,1986.776,106.7959
"11883","34311","2020",28,26,2,194175.4,2009.964,95.82143
"11884","34312","2020",21,20,1,129630.5,1473.095,88.95238
"11885","34313","2020",8,8,0,219253.8,2035.125,100.875
"11886","34314","2020",7,7,0,565627.6,4388.857,128.4286
"11887","34315","2020",6,6,0,258433.3,1887.833,154
"11888","34316","2020",5,5,0,244160,2043.6,110.8
"11889","34317","2020",3,2,1,54000,778.3333,69.66667
"11890","34318","2020",10,10,0,298268.3,2561.9,125.8
"11891","34319","2020",1,1,0,358100,2197,163
"11892","34320","2020",21,21,0,386181.4,3259.714,120.0952
"11893","34321","2020",26,25,1,303760.2,2733.385,111.6923
"11894","34322","2020",8,8,0,444697.1,3556.125,127.875
"11895","34324","2020",306,121,185,138301,3058.15,46.65359
"11896","34325","2020",19,16,3,189244.9,2119.053,87.57895
"11897","34327","2020",86,58,28,290520.7,3461.233,84.75581
"11898","34328","2020",15,15,0,157373.3,1647.267,89.46667
"11899","34329","2020",60,52,8,167659.5,3057.183,62.03333
"11900","34331","2020",3,3,0,75190,864.3333,82.66667
"11901","34332","2020",161,136,25,147070.1,2654.453,60.71429
"11902","34333","2020",93,92,1,189070.3,4833.495,45.89247
"11903","34334","2020",6,6,0,70891.67,1059.333,61.16667
"11904","34335","2020",3,3,0,40000,606.6667,63.66667
"11905","34336","2020",75,59,16,141824.4,1753.96,82.93333
"11906","34337","2020",109,91,18,283120.3,3424.688,85.09174
"11907","34338","2020",1,1,0,250000,2778,90
"11908","34339","2020",5,5,0,119064,1229.6,97.8
"11909","34340","2020",15,15,0,325012.8,3018.2,110
"11910","34341","2020",47,44,3,219495.9,2166.043,99.74468
"11911","34342","2020",2,1,1,383175,2264,152
"11912","34343","2020",6,6,0,237173.5,3267.5,70.83333
"11913","34344","2020",862,70,792,175732.7,4461.617,38.55104
"11914","35001","2020",76,44,32,233753.5,2582.105,91.17105
"11915","35002","2020",17,17,0,234726.9,1841.706,129.2353
"11916","35003","2020",11,11,0,221007.3,1984,115.0909
"11917","35004","2020",57,56,1,104910.8,1088.93,99.82456
"11918","35005","2020",4,4,0,100500,756.5,109.5
"11919","35006","2020",53,48,5,180419.5,1714.453,110.3774
"11920","35007","2020",5,5,0,190360,1994.6,96.2
"11921","35008","2020",9,9,0,127482.2,1503.778,84.11111
"11922","35009","2020",26,25,1,168287.6,1686.5,105.6538
"11923","35010","2020",20,20,0,153786,1677.8,101.8
"11924","35012","2020",98,71,27,159771.8,1830.265,89.63265
"11925","35013","2020",44,44,0,141982.3,1331,103.8182
"11926","35014","2020",32,30,2,156950.3,1554.594,102.75
"11927","35015","2020",20,20,0,173146.8,1401.85,126.1
"11928","35016","2020",26,26,0,150629.2,1591.846,103.9615
"11929","35017","2020",10,10,0,195771.3,1889.5,102
"11930","35018","2020",13,12,1,119634.6,1156.538,107.6154
"11931","35019","2020",26,26,0,104937.5,1117.577,91.42308
"11932","35021","2020",17,17,0,200502.6,2097.882,100.9412
"11933","35022","2020",16,13,3,163440.2,1648.25,97.3125
"11934","35023","2020",61,50,11,199266.7,1986.279,103.4262
"11935","35024","2020",133,89,44,286783,2903.895,100.1278
"11936","35025","2020",13,13,0,136300,1343.308,105
"11937","35027","2020",31,31,0,163074.8,1527.258,109.7097
"11938","35028","2020",14,14,0,144401.4,1572.714,94.42857
"11939","35029","2020",20,20,0,139473,1472.55,97.75
"11940","35030","2020",6,6,0,184300,1652.5,104.5
"11941","35031","2020",63,60,3,211048,2101.476,101.6349
"11942","35032","2020",81,60,21,220235,2249.333,102.0741
"11943","35033","2020",42,35,7,177775.8,1845.905,94.88095
"11944","35034","2020",27,26,1,113901.9,1373,83.85185
"11945","35035","2020",8,8,0,182500,1558.125,120.875
"11946","35037","2020",80,62,18,205650.4,2153.762,96.25
"11947","35038","2020",4,4,0,145815.8,1422.5,102
"11948","35039","2020",24,19,5,198623.1,2205.417,95.41667
"11949","35040","2020",45,37,8,190869.3,2142.578,92.26667
"11950","35041","2020",8,8,0,167741,1596.375,103.875
"11951","35042","2020",12,12,0,126873.3,1186.917,109.25
"11952","35044","2020",5,5,0,102600,1552.2,83
"11953","35045","2020",6,6,0,100665,1484.167,83
"11954","35046","2020",9,9,0,106600,1302.222,84.77778
"11955","35047","2020",260,147,113,237046.3,2750.185,88.41923
"11956","35049","2020",158,97,61,259079.5,3201.728,85.75949
"11957","35050","2020",7,7,0,170298,1615.571,117.2857
"11958","35051","2020",198,102,96,332108.7,3632.475,91.78788
"11959","35052","2020",4,4,0,193875,1541.75,127.25
"11960","35054","2020",18,18,0,204794.4,1861,108.7222
"11961","35055","2020",168,57,111,222584.4,2813.554,79.09524
"11962","35056","2020",12,12,0,145005.2,1551,93.33333
"11963","35057","2020",28,23,5,118060.4,1402.107,83.5
"11964","35058","2020",19,19,0,200955.7,1983.526,104.6316
"11965","35059","2020",55,38,17,242348,2514.855,96.87273
"11966","35060","2020",12,12,0,178151.7,1751.917,102.3333
"11967","35061","2020",3,3,0,129000,1388.333,96.66667
"11968","35062","2020",15,15,0,120619.7,1247.4,93.06667
"11969","35063","2020",3,3,0,117000,1048.333,105.3333
"11970","35064","2020",18,18,0,106005.2,1076.222,97
"11971","35065","2020",23,18,5,176647,2514.87,79.34783
"11972","35066","2020",147,66,81,199832.5,2455.272,82.42857
"11973","35067","2020",24,24,0,242799.9,2143.125,115.4167
"11974","35068","2020",98,77,21,190397.7,2182.592,88.42857
"11975","35069","2020",159,123,36,238071.5,2317.22,104.4151
"11976","35070","2020",27,24,3,200816.3,1917.407,108
"11977","35071","2020",4,4,0,170000,1688.5,106
"11978","35072","2020",13,13,0,110500,1239.308,100.0769
"11979","35075","2020",11,11,0,144635.7,1310.636,126.2727
"11980","35076","2020",65,41,24,197883.6,2291.215,89.53846
"11981","35077","2020",8,8,0,98304.38,839.375,118.5
"11982","35078","2020",26,26,0,182217.7,1867.038,99.65385
"11983","35079","2020",21,18,3,246053.1,2579.333,95.80952
"11984","35080","2020",34,32,2,196642.6,1910.794,104.8529
"11985","35081","2020",14,14,0,201408.1,2167.571,92.85714
"11986","35082","2020",23,23,0,145560.2,1357.174,109.7826
"11987","35084","2020",16,16,0,98972.81,1331.375,76.75
"11988","35085","2020",71,57,14,160310.9,1718.972,98.39437
"11989","35086","2020",11,11,0,105372.7,1170.273,93.81818
"11990","35087","2020",12,12,0,175233.3,1667.167,103.25
"11991","35088","2020",53,47,6,204857.9,2090.849,101.3585
"11992","35089","2020",9,9,0,92186.11,1518.556,68.66667
"11993","35090","2020",32,22,10,185044.4,1873.562,100.1875
"11994","35091","2020",13,13,0,172306.2,1616,115.9231
"11995","35092","2020",9,9,0,157668.2,1392.778,117.4444
"11996","35093","2020",319,138,181,341263.9,4593.038,74.5047
"11997","35094","2020",26,26,0,175992.3,1605.423,113.5
"11998","35095","2020",106,66,40,149394.8,1838.679,82.48113
"11999","35096","2020",33,18,15,162019.6,1991.455,87.81818
"12000","35097","2020",25,25,0,154385.6,1475.96,105.92
"12001","35098","2020",9,9,0,148211.1,1349.556,108.3333
"12002","35099","2020",42,34,8,228188.5,2348.143,97.83333
"12003","35101","2020",12,12,0,178620.8,1651.167,112
"12004","35102","2020",6,6,0,93833.33,1224.667,85.5
"12005","35103","2020",7,7,0,134457.1,1153.571,116.5714
"12006","35104","2020",17,17,0,162114.1,1532.588,100.7647
"12007","35105","2020",16,16,0,188209.8,1721.875,115.0625
"12008","35106","2020",34,34,0,141173.8,1334.941,102.4118
"12009","35107","2020",17,17,0,189808.6,2065.412,91.70588
"12010","35108","2020",13,13,0,173930.8,1907.846,95
"12011","35109","2020",27,23,4,184207.4,1795.37,107.037
"12012","35110","2020",14,14,0,152073.6,1325.714,119.2857
"12013","35111","2020",10,10,0,115650,1126,101.4
"12014","35112","2020",11,11,0,136954.5,1350.727,105.2727
"12015","35114","2020",3,3,0,123526.7,1138.333,107
"12016","35115","2020",291,156,135,134874.8,1576.962,85.28179
"12017","35116","2020",31,31,0,167670.8,1714.71,99.93548
"12018","35117","2020",28,27,1,85532.86,854.1786,100.5357
"12019","35118","2020",19,19,0,174612.6,1521.526,116.6316
"12020","35119","2020",6,6,0,181683.3,1304.833,118
"12021","35120","2020",89,53,36,193357.1,2285.798,87.73034
"12022","35121","2020",21,20,1,211436.9,1897.571,112.619
"12023","35122","2020",35,30,5,200227.2,2254.886,89.94286
"12024","35123","2020",58,49,9,197759.7,1942.155,102.1897
"12025","35124","2020",40,40,0,131156.8,1189.3,106.075
"12026","35125","2020",77,63,14,105178.4,1224.896,88.25974
"12027","35126","2020",127,110,17,216382.8,2197.386,100.6535
"12028","35127","2020",65,59,6,194383.8,1720.862,115.6923
"12029","35128","2020",18,18,0,225408.9,2137.444,110.3333
"12030","35130","2020",25,21,4,180220,1754.04,105.56
"12031","35131","2020",55,38,17,200399.9,2292.709,92.14545
"12032","35132","2020",15,15,0,212853.3,1820.733,115.7333
"12033","35133","2020",62,59,3,159424.1,1570.484,104.8065
"12034","35134","2020",3,3,0,231000,1833.667,124
"12035","35135","2020",22,19,3,184633,1594.455,117.7273
"12036","35136","2020",131,81,50,167730.6,2044.221,85.27481
"12037","35137","2020",28,28,0,187152.1,1639.429,111.6071
"12038","35138","2020",13,13,0,169686.7,1521.615,113.4615
"12039","35139","2020",62,53,9,249042,2378.032,107.2419
"12040","35140","2020",5,5,0,97600,995.6,88.4
"12041","35141","2020",10,10,0,174080,1554.3,116.4
"12042","35142","2020",16,16,0,101211.3,1242.25,88.625
"12043","35143","2020",9,9,0,207491.8,2349.556,93.22222
"12044","35144","2020",11,11,0,204031.1,2116,97.27273
"12045","35145","2020",27,27,0,127488.1,1176.852,102.5556
"12046","35146","2020",7,7,0,166104.3,1653.429,106.1429
"12047","35148","2020",3,3,0,140620,1616.333,84.66667
"12048","35149","2020",21,21,0,199721.9,1755.429,118.1905
"12049","35150","2020",31,31,0,179628.2,1652.258,113.4194
"12050","35151","2020",10,10,0,135903.7,1354.5,95.8
"12051","35152","2020",117,86,31,226498.4,2398.359,98.93162
"12052","35153","2020",8,8,0,220376.4,1462.875,145.5
"12053","35154","2020",21,21,0,153451.4,1477.619,104.2857
"12054","35155","2020",6,6,0,123051.7,1380.833,88.66667
"12055","35156","2020",10,10,0,174515,1373.3,111
"12056","35157","2020",13,13,0,98456.92,1129.846,85.61538
"12057","35159","2020",6,6,0,180583.3,1523.667,115.8333
"12058","35160","2020",4,3,1,146250,1399.75,93.5
"12059","35161","2020",34,34,0,173930.5,1695.588,104.4706
"12060","35162","2020",40,35,5,101870.6,1000.95,97.275
"12061","35163","2020",21,21,0,118795.2,1153.952,102.2857
"12062","35164","2020",10,10,0,107342.3,1062.1,104
"12063","35165","2020",16,16,0,131865.6,1246.312,106.25
"12064","35166","2020",7,7,0,134721.4,1475,102
"12065","35167","2020",55,53,2,107911,1230.891,91.69091
"12066","35168","2020",62,61,1,129306.2,1386.081,99.20968
"12067","35169","2020",19,19,0,126610.6,1356.158,103.3684
"12068","35170","2020",13,13,0,111605,1171.308,95.84615
"12069","35171","2020",24,24,0,144861,1375.25,106.3333
"12070","35172","2020",34,34,0,129399.9,1526.529,90.91176
"12071","35173","2020",107,81,26,270794.1,2615.477,102.785
"12072","35174","2020",5,5,0,119199,1069.8,104.4
"12073","35175","2020",8,8,0,127153.1,1351.625,94
"12074","35176","2020",81,80,1,128252.3,1413.222,89.03704
"12075","35177","2020",58,42,16,258528.1,2504.534,101.7241
"12076","35178","2020",26,26,0,205999.3,1673.423,122.8077
"12077","35179","2020",59,50,9,178654.1,1856.322,100.7288
"12078","35180","2020",10,10,0,145063.3,1507.4,104.1
"12079","35181","2020",28,28,0,357563.9,3028.929,119.4643
"12080","35183","2020",8,8,0,160811.2,1546.125,110.5
"12081","35184","2020",76,66,10,165974.8,1675.934,99.43421
"12082","35185","2020",4,4,0,79696.25,858,93.25
"12083","35186","2020",22,21,1,164389.4,1818.727,101.1364
"12084","35187","2020",19,19,0,186869.3,1810.684,105.5789
"12085","35188","2020",81,54,27,218889,2311.704,93.55556
"12086","35189","2020",35,15,20,231673.1,2693,86.94286
"12087","35190","2020",4,4,0,108725,798,134
"12088","35191","2020",39,38,1,126117.9,1261.128,103
"12089","35192","2020",3,3,0,127251.3,1177,97
"12090","35193","2020",21,21,0,214269.5,2207.095,102.9048
"12091","35194","2020",16,16,0,175835.6,1384.75,125.8125
"12092","35195","2020",34,28,6,166434.3,1693.853,102.7353
"12093","35196","2020",128,67,61,202201.6,2449.875,85.01562
"12094","35197","2020",15,15,0,236481.4,1855.867,128
"12095","35198","2020",13,13,0,197146.2,1698.846,107.5385
"12096","35199","2020",2,2,0,118500,1407,83
"12097","35200","2020",10,10,0,128350,1312.9,95.1
"12098","35201","2020",13,13,0,131307.7,1281.154,104.9231
"12099","35202","2020",12,12,0,142673.8,1304.833,104.5833
"12100","35204","2020",37,33,4,225135.4,2212.216,103.6757
"12101","35205","2020",9,9,0,176388.9,1237.667,134.4444
"12102","35206","2020",97,63,34,249077,2551.278,99.02062
"12103","35207","2020",59,40,19,247457.9,2453.339,101.6102
"12104","35208","2020",73,56,17,226728.8,2276.479,101.726
"12105","35210","2020",164,88,76,276195.2,2856.951,98.43902
"12106","35211","2020",28,28,0,164421,1727.679,102.0714
"12107","35212","2020",13,13,0,151274.3,1620.615,98.84615
"12108","35214","2020",8,8,0,141986.9,1396.125,102.625
"12109","35215","2020",14,14,0,144810,1418.571,103.6429
"12110","35216","2020",29,12,17,159680.1,2101.034,76.44828
"12111","35217","2020",14,14,0,102769.3,1207.786,84.64286
"12112","35218","2020",11,11,0,206376,1809.364,116.1818
"12113","35219","2020",61,51,10,105721.6,1289.689,86.90164
"12114","35220","2020",53,51,2,213931.3,1968.472,117.6981
"12115","35221","2020",30,30,0,149921.2,1556.967,93.56667
"12116","35222","2020",31,31,0,108381.4,1246.613,85.64516
"12117","35223","2020",49,47,2,148435.5,1617.714,91.32653
"12118","35224","2020",50,50,0,169611.3,1730.24,99.22
"12119","35225","2020",18,13,5,125189.4,1409.167,93.44444
"12120","35226","2020",29,25,4,154525.9,1743.793,95.27586
"12121","35227","2020",65,50,15,220059.4,2124.892,106.2769
"12122","35228","2020",149,104,45,218418.8,2573.094,87.14765
"12123","35229","2020",11,11,0,192092.9,1716.818,112.1818
"12124","35230","2020",9,8,1,109596.9,1324.667,78.77778
"12125","35231","2020",15,11,4,199447.8,1794.067,110.3333
"12126","35232","2020",7,7,0,88898.57,949.7143,88.42857
"12127","35233","2020",23,23,0,158778,1683.304,91.34783
"12128","35234","2020",15,15,0,113066.7,1355.467,84.26667
"12129","35235","2020",18,18,0,146864.6,1342.833,103.7222
"12130","35236","2020",167,95,72,130444.7,1523.946,89.53293
"12131","35237","2020",12,12,0,131815.3,1396.417,100.8333
"12132","35238","2020",3504,509,2995,235472.5,3556.479,66.69606
"12133","35239","2020",75,70,5,154913.2,1618.347,99.29333
"12134","35240","2020",156,86,70,236765.4,2670.66,90.76282
"12135","35241","2020",47,40,7,286547.2,2912.617,101.766
"12136","35242","2020",7,7,0,130971.4,898.8571,143.2857
"12137","35243","2020",20,20,0,190835,1527.1,127.5
"12138","35244","2020",4,4,0,115500,1083,106.25
"12139","35245","2020",40,32,8,179722.5,2079.825,88.325
"12140","35246","2020",19,19,0,198344.7,1903,105.6316
"12141","35247","2020",19,18,1,115257.7,1399.842,85.15789
"12142","35248","2020",6,6,0,93916.67,981.3333,92.16667
"12143","35249","2020",16,16,0,96375.56,1093.688,93.75
"12144","35250","2020",37,18,19,175497.9,2165.919,81.72973
"12145","35251","2020",57,35,22,188127.8,2067.86,90.21053
"12146","35252","2020",10,9,1,155728.9,1682.4,94.9
"12147","35253","2020",15,15,0,177303.3,2082.6,89.06667
"12148","35255","2020",20,20,0,226572,2184.1,109.2
"12149","35256","2020",68,53,15,344419.5,3872.279,98.54412
"12150","35257","2020",55,53,2,148333.3,1413.582,104.5636
"12151","35258","2020",3,3,0,82966.67,1121.333,75
"12152","35259","2020",17,15,2,121195.9,1315.235,88.47059
"12153","35260","2020",9,9,0,106341,1600.778,75.88889
"12154","35261","2020",2,2,0,152500,1110.5,159.5
"12155","35262","2020",7,7,0,102350,1535.857,63
"12156","35263","2020",51,49,2,369099.1,3151.863,119.902
"12157","35264","2020",17,16,1,216205.9,2110.294,106.8235
"12158","35265","2020",31,30,1,156335,1861.097,90.77419
"12159","35266","2020",62,41,21,205070.2,2294.516,90.14516
"12160","35268","2020",7,7,0,89141.43,888.1429,95.42857
"12161","35270","2020",4,4,0,146649.2,2902.5,76.5
"12162","35271","2020",21,21,0,116462.1,1121.714,103.6667
"12163","35272","2020",13,13,0,165054.8,1546.077,102.4615
"12164","35273","2020",34,34,0,137317.6,1294.765,109.8824
"12165","35274","2020",11,11,0,250454.5,2194,118.8182
"12166","35275","2020",61,43,18,254895.3,2435.689,103.2295
"12167","35276","2020",8,8,0,204415,1868.75,118
"12168","35277","2020",2,2,0,126500,1333.5,93.5
"12169","35278","2020",127,77,50,378792.8,3419.047,112.4488
"12170","35279","2020",18,18,0,219928.7,1972.167,116.3889
"12171","35280","2020",13,13,0,157960.6,1482.231,105.7692
"12172","35281","2020",206,59,147,194146.1,2744.345,71.41748
"12173","35282","2020",28,28,0,149581.1,1521.357,100.5714
"12174","35283","2020",21,21,0,209297.1,1963.714,107.7619
"12175","35284","2020",32,31,1,269079.6,2610.125,109.9062
"12176","35285","2020",11,11,0,94128,1439,75
"12177","35286","2020",2,2,0,135000,1163.5,112.5
"12178","35287","2020",53,38,15,413084.6,4110.226,99.66038
"12179","35288","2020",980,384,596,292242.6,3870.723,76.27551
"12180","35289","2020",13,13,0,122206,1282.462,97.46154
"12181","35290","2020",15,14,1,137980.1,1349.133,104.1333
"12182","35291","2020",11,11,0,128645.1,1451.182,103.5455
"12183","35292","2020",15,15,0,94213.33,1038.8,92.13333
"12184","35294","2020",25,25,0,107502.3,1159.32,94.56
"12185","35295","2020",4,4,0,114000,1276.25,84
"12186","35296","2020",21,21,0,221319,2013,112.7619
"12187","35297","2020",78,51,27,120091.2,1428.231,87.71795
"12188","35299","2020",70,58,12,226966.2,2524.457,93.75714
"12189","35300","2020",15,15,0,123197.8,1427.8,87.86667
"12190","35302","2020",15,15,0,170660,1539.667,116.2
"12191","35304","2020",13,12,1,149868,1369.154,109.2308
"12192","35305","2020",4,4,0,140000,1678.75,87.75
"12193","35306","2020",35,35,0,241817.2,2424.143,99.88571
"12194","35307","2020",13,13,0,164389.5,1495,115.8462
"12195","35308","2020",65,64,1,142778.9,1514.969,97.95385
"12196","35309","2020",9,9,0,165784.4,1571.667,107.4444
"12197","35310","2020",10,10,0,201550,1526.7,129.7
"12198","35311","2020",11,11,0,101876.8,1186.091,83
"12199","35312","2020",40,40,0,169765.4,1741.525,95.15
"12200","35314","2020",15,14,1,281278.7,3156.133,92.46667
"12201","35315","2020",18,17,1,203098.3,2106.556,97.16667
"12202","35316","2020",19,19,0,112063.7,1137.211,104.1579
"12203","35317","2020",8,8,0,185070.2,1597.375,118.625
"12204","35318","2020",14,14,0,193029.3,1898.5,102.0714
"12205","35319","2020",31,24,7,171825.5,1894.387,92.80645
"12206","35320","2020",8,7,1,170058.1,1231.375,129.125
"12207","35321","2020",3,3,0,163333.3,1188.667,129.3333
"12208","35322","2020",13,13,0,175322.3,1698.692,105.5385
"12209","35324","2020",4,4,0,115750,1359.75,83.25
"12210","35325","2020",2,2,0,204000,1342.5,153
"12211","35326","2020",35,32,3,156970.6,1636.057,97.45714
"12212","35327","2020",44,32,12,204001.7,2211.182,96.11364
"12213","35328","2020",23,23,0,125832.4,1295.87,99.6087
"12214","35329","2020",16,16,0,105537.5,976.6875,110.8125
"12215","35330","2020",17,17,0,138545.3,1355.412,103.4706
"12216","35331","2020",26,23,3,192281.7,1931.846,99.57692
"12217","35332","2020",22,22,0,113681.4,1134.045,100.2727
"12218","35333","2020",20,20,0,151400,1487.85,100.9
"12219","35334","2020",86,49,37,249686.1,2756.57,91
"12220","35335","2020",9,9,0,183200,1345.889,107.4444
"12221","35336","2020",5,5,0,63600,835,70.4
"12222","35337","2020",45,34,11,184791.6,1919.022,98.04444
"12223","35338","2020",12,12,0,155806.8,1595.5,99.25
"12224","35339","2020",10,10,0,98294.5,1964.3,78.5
"12225","35340","2020",10,10,0,167910,1500.2,109.3
"12226","35342","2020",4,4,0,113750,1625,69.25
"12227","35343","2020",15,15,0,148480,1402.133,110
"12228","35345","2020",13,13,0,143359.2,1299.308,109.7692
"12229","35346","2020",2,2,0,177900,1236.5,143
"12230","35347","2020",37,36,1,152519.8,1500.108,99.51351
"12231","35350","2020",4,4,0,76000,1276.5,62
"12232","35351","2020",21,21,0,189378.6,1904.81,100.4286
"12233","35352","2020",79,56,23,246590.9,2473.759,100.2025
"12234","35353","2020",73,36,37,225472,2654.425,86.16438
"12235","35354","2020",3,3,0,158908.3,2201,75
"12236","35355","2020",15,15,0,184501.4,1526.733,117.2667
"12237","35356","2020",29,28,1,249030.8,2014.414,122.6552
"12238","35357","2020",3,3,0,118333.3,1008.333,119.6667
"12239","35358","2020",17,17,0,214856.5,2129.294,104
"12240","35359","2020",13,13,0,115221.4,1145.692,96.46154
"12241","35360","2020",261,158,103,198870.7,2201.67,93.76628
"12242","35361","2020",18,18,0,172707.9,1676.389,103.6111
"12243","35362","2020",26,22,4,147881.9,1697.538,88.88462
"12244","35363","2020",62,43,19,205823.6,2249.597,91.16129
"12245","36001","2020",17,17,0,74221.53,904.0588,83.11765
"12246","36003","2020",5,5,0,99000,975.2,99
"12247","36004","2020",5,5,0,94600,846.2,107.8
"12248","36005","2020",39,39,0,119159.3,1118.436,105.7179
"12249","36006","2020",71,64,7,106222.5,1109.958,93.14085
"12250","36007","2020",10,10,0,68601.9,947,68.8
"12251","36008","2020",1,1,0,58000,1289,45
"12252","36009","2020",12,12,0,103408.3,1205.5,86.25
"12253","36010","2020",11,11,0,71260,807.7273,91
"12254","36011","2020",3,3,0,146333.3,1168,127
"12255","36012","2020",2,2,0,79975,934.5,86
"12256","36013","2020",7,7,0,73142.86,716.7143,109.1429
"12257","36014","2020",2,2,0,60000,728,83
"12258","36016","2020",9,9,0,108611.1,1006.889,94
"12259","36017","2020",7,7,0,71674.29,1158.429,71.57143
"12260","36018","2020",66,61,5,88722.73,907.4091,96.34848
"12261","36019","2020",4,4,0,65100,846.25,83
"12262","36020","2020",4,4,0,155000,1149,142.75
"12263","36021","2020",7,7,0,107771.4,1129.286,94.71429
"12264","36022","2020",3,3,0,53777.67,699,77.33333
"12265","36023","2020",5,5,0,89704,870.6,103
"12266","36024","2020",2,2,0,69000,990.5,73.5
"12267","36025","2020",9,9,0,119333.3,1063.667,114.1111
"12268","36026","2020",6,6,0,113017,1108.167,98.83333
"12269","36027","2020",5,5,0,105600,1035.4,122.2
"12270","36028","2020",1,1,0,35000,603,58
"12271","36029","2020",2,2,0,73500,987.5,75
"12272","36030","2020",4,4,0,112425,1561.5,70.25
"12273","36031","2020",50,48,2,87878.46,967.2,90.58
"12274","36032","2020",9,9,0,107433.3,918.6667,105.2222
"12275","36033","2020",6,6,0,142583.3,1477,85.16667
"12276","36034","2020",52,52,0,74049.48,888.0769,82.71154
"12277","36035","2020",15,15,0,103484.5,907.1333,116.7333
"12278","36036","2020",3,3,0,77666.67,979.6667,75.33333
"12279","36038","2020",3,3,0,38166.67,534.6667,68.66667
"12280","36040","2020",2,2,0,51500,583.5,95.5
"12281","36041","2020",1,1,0,75000,806,93
"12282","36042","2020",5,5,0,45549,711.2,57.6
"12283","36043","2020",10,10,0,108300,1285.9,90.3
"12284","36044","2020",596,373,223,107975.4,1293.673,83.83054
"12285","36045","2020",37,37,0,83237.57,913.8108,93.32432
"12286","36046","2020",59,51,8,89571.1,929.661,100.0169
"12287","36047","2020",9,9,0,105341.1,1056.111,94.77778
"12288","36048","2020",3,3,0,34148,650.3333,52.66667
"12289","36050","2020",5,5,0,103100,1073.6,92.6
"12290","36051","2020",4,4,0,109250,998.25,114
"12291","36053","2020",6,6,0,79900,948.1667,81
"12292","36054","2020",4,4,0,207363.8,1175,148
"12293","36055","2020",7,7,0,65531.43,1140.143,61
"12294","36056","2020",18,18,0,100354.5,1011.278,102.7778
"12295","36057","2020",17,17,0,142216.9,1320.118,120.7059
"12296","36058","2020",17,17,0,112182.4,1096.176,104.4706
"12297","36059","2020",1,1,0,135000,2015,67
"12298","36060","2020",12,12,0,62775,739.9167,83.66667
"12299","36061","2020",3,3,0,113430,1057,103.3333
"12300","36062","2020",12,12,0,74457.08,1034.25,79
"12301","36063","2020",87,84,3,119702.8,1394.46,86
"12302","36064","2020",6,6,0,110836.7,1068.667,97
"12303","36065","2020",3,3,0,48666.67,704,70.66667
"12304","36066","2020",1,1,0,70000,496,141
"12305","36067","2020",4,4,0,83712.5,849.75,115.5
"12306","36068","2020",5,5,0,77403.8,849.4,86.4
"12307","36069","2020",16,16,0,86995.94,1084.875,81.5
"12308","36070","2020",19,19,0,78910.26,946.6316,80.05263
"12309","36071","2020",5,5,0,127900,1547.6,92.4
"12310","36073","2020",8,8,0,42698,886,65.25
"12311","36074","2020",8,8,0,99592.75,1147.5,88.875
"12312","36076","2020",1,1,0,75000,765,98
"12313","36077","2020",4,4,0,80750,992.75,77.25
"12314","36078","2020",5,5,0,70800,1116.4,61.6
"12315","36081","2020",8,8,0,59237.5,927.25,64.375
"12316","36082","2020",8,8,0,85250,810.125,105.25
"12317","36084","2020",3,3,0,114779.3,915.3333,126.3333
"12318","36085","2020",7,7,0,106114.3,865,116.4286
"12319","36086","2020",5,5,0,102031,1122.8,97.4
"12320","36087","2020",5,5,0,93500,973.8,97.4
"12321","36088","2020",138,124,14,80750.25,932.7029,88.57246
"12322","36089","2020",4,4,0,109000,936.75,111.5
"12323","36090","2020",2,2,0,62000,737.5,83
"12324","36091","2020",5,5,0,128400,1343.8,93.6
"12325","36092","2020",6,6,0,51272.5,670.8333,78
"12326","36093","2020",21,21,0,87055.71,897.9048,96.61905
"12327","36094","2020",9,9,0,110450.6,830.8889,119.6667
"12328","36095","2020",1,1,0,175000,1667,105
"12329","36096","2020",2,2,0,116395,823.5,134
"12330","36097","2020",4,4,0,82875,1128,77.5
"12331","36098","2020",2,2,0,65350,725.5,90.5
"12332","36099","2020",6,6,0,54641.67,569.6667,88.66667
"12333","36100","2020",3,3,0,195266.7,1348.333,140.3333
"12334","36101","2020",15,15,0,136997.3,1304.867,101.9333
"12335","36102","2020",2,2,0,63500,996,63.5
"12336","36103","2020",20,19,1,73583.9,853.7,83.05
"12337","36104","2020",3,3,0,101056.7,850.6667,140.6667
"12338","36105","2020",1,1,0,88000,677,130
"12339","36106","2020",1,1,0,70000,909,77
"12340","36107","2020",12,12,0,94016.67,800.5833,116.0833
"12341","36108","2020",4,4,0,84200,929,85.75
"12342","36109","2020",9,9,0,117911.1,1165.222,98.88889
"12343","36110","2020",7,7,0,82714.29,951.8571,89
"12344","36111","2020",2,2,0,87200,790,100.5
"12345","36112","2020",8,8,0,140962.5,1213.375,114.5
"12346","36113","2020",6,6,0,71333.33,849.1667,80.16667
"12347","36114","2020",4,4,0,49537.5,589,83.5
"12348","36115","2020",4,4,0,67400,745.5,92
"12349","36116","2020",1,1,0,84500,650,130
"12350","36117","2020",4,4,0,76000,791,89.25
"12351","36118","2020",4,4,0,98825,1275.5,92
"12352","36119","2020",7,7,0,98682.86,1129.286,88.57143
"12353","36120","2020",10,10,0,71670,807.5,87.3
"12354","36121","2020",3,3,0,121079.3,683.6667,185
"12355","36122","2020",3,3,0,113000,1395,85
"12356","36123","2020",22,22,0,98624.73,892.1818,105.4545
"12357","36124","2020",2,2,0,1e+05,3333.5,30
"12358","36125","2020",2,2,0,141225,1161,143
"12359","36126","2020",4,4,0,60144.25,671,93
"12360","36127","2020",27,27,0,103272.2,885.3333,118.7037
"12361","36128","2020",24,24,0,136691.7,1248.042,115
"12362","36129","2020",10,10,0,68377,753.6,84.9
"12363","36130","2020",1,1,0,190000,1152,165
"12364","36131","2020",7,7,0,110104.7,1079.143,98.71429
"12365","36132","2020",1,1,0,250000,1923,130
"12366","36133","2020",1,1,0,37000,902,41
"12367","36134","2020",4,4,0,69125,690.75,99.75
"12368","36135","2020",5,5,0,46400,626.4,76.6
"12369","36136","2020",2,2,0,68500,688,87
"12370","36137","2020",5,5,0,87420,875.8,99.6
"12371","36138","2020",1,1,0,50000,617,81
"12372","36139","2020",5,5,0,156300,1971.6,86.4
"12373","36140","2020",14,14,0,91647.64,1082.929,83
"12374","36141","2020",20,20,0,80985,1018.25,79.45
"12375","36142","2020",9,9,0,180688.9,2354.556,78.55556
"12376","36143","2020",4,4,0,57625,591.25,91.5
"12377","36144","2020",2,2,0,40000,528.5,73
"12378","36145","2020",6,6,0,61500,846.6667,72.83333
"12379","36146","2020",7,7,0,81328.57,829.5714,100.8571
"12380","36148","2020",7,7,0,82882.86,862.7143,100.4286
"12381","36149","2020",12,12,0,59433.33,730.75,82.25
"12382","36150","2020",8,8,0,109362.5,1131.125,116.25
"12383","36152","2020",14,14,0,147964.6,1179.5,123.1429
"12384","36153","2020",4,4,0,61765,707.5,87
"12385","36154","2020",21,20,1,84535.71,891.619,94.14286
"12386","36155","2020",8,8,0,75896.12,827.5,94.25
"12387","36156","2020",6,6,0,75833.33,758.3333,102.8333
"12388","36157","2020",4,4,0,144000,1348.25,108.75
"12389","36158","2020",11,11,0,90120.45,1054.273,82.18182
"12390","36159","2020",64,64,0,173786.7,1662.125,108.5625
"12391","36160","2020",4,4,0,52500,592.25,89.25
"12392","36161","2020",9,9,0,76618.44,1062,71.22222
"12393","36162","2020",15,15,0,76976.67,730.7333,105.5333
"12394","36163","2020",7,7,0,60942.86,803.1429,67.42857
"12395","36164","2020",1,1,0,2e+05,1053,190
"12396","36165","2020",13,13,0,92384.62,977.3846,99.76923
"12397","36166","2020",7,7,0,377882.9,2718.143,133.1429
"12398","36167","2020",2,2,0,161250,1260.5,132.5
"12399","36168","2020",12,12,0,58701.67,715.4167,85.41667
"12400","36169","2020",6,6,0,71166.67,786.3333,85.83333
"12401","36170","2020",2,2,0,144630,1377.5,105
"12402","36171","2020",24,24,0,95395.83,913.5417,98.91667
"12403","36172","2020",6,6,0,80500,1012,81.83333
"12404","36173","2020",11,11,0,160954.5,1302.818,106.8182
"12405","36174","2020",1,1,0,45000,446,101
"12406","36175","2020",2,2,0,79500,733,104.5
"12407","36176","2020",5,5,0,66390,623.2,107.2
"12408","36177","2020",3,3,0,44396.67,661.6667,65
"12409","36178","2020",4,4,0,54250,555,100.25
"12410","36179","2020",2,2,0,142500,2211,70
"12411","36180","2020",11,11,0,67754.55,917.1818,75.81818
"12412","36181","2020",1,1,0,28000,389,72
"12413","36182","2020",12,12,0,119645.4,912.5,131.3333
"12414","36184","2020",5,5,0,82310,856.4,92.8
"12415","36185","2020",6,6,0,83809.5,870,95.33333
"12416","36186","2020",4,4,0,87018.75,935.5,93.25
"12417","36187","2020",3,3,0,55000,617.3333,98.66667
"12418","36188","2020",4,4,0,114937.5,838.25,136
"12419","36189","2020",11,11,0,108000,898.4545,123.8182
"12420","36190","2020",2,2,0,173721,1773,98
"12421","36191","2020",4,4,0,85250,1005.25,84
"12422","36192","2020",20,20,0,76345.35,914.8,90
"12423","36193","2020",5,5,0,100800,930.2,104.2
"12424","36194","2020",8,8,0,66768.75,860.625,78.125
"12425","36195","2020",9,9,0,111233.3,1227.333,93
"12426","36196","2020",3,3,0,91666.67,853.3333,108.3333
"12427","36197","2020",7,7,0,85171.43,1048,81.28571
"12428","36198","2020",1,1,0,170000,950,179
"12429","36199","2020",11,11,0,130727.3,1205.273,111
"12430","36200","2020",23,23,0,92902.26,979.913,94.34783
"12431","36202","2020",20,20,0,145475,1448.6,103.75
"12432","36203","2020",2,2,0,124500,880,153
"12433","36204","2020",4,4,0,195325,1400.25,104
"12434","36205","2020",3,3,0,85333.33,875.3333,96.33333
"12435","36207","2020",10,10,0,101335.5,1096.4,106.5
"12436","36208","2020",6,6,0,61716.67,752.1667,78.33333
"12437","36209","2020",4,4,0,93250,852.25,106.5
"12438","36210","2020",4,4,0,63375,1119,53.5
"12439","36211","2020",8,8,0,86050,1243.25,70.375
"12440","36212","2020",5,5,0,75940,998.2,76.8
"12441","36213","2020",3,3,0,112985,835,120
"12442","36214","2020",8,8,0,71500,935.875,89.125
"12443","36215","2020",6,6,0,178983.3,1745.5,94.16667
"12444","36216","2020",1,1,0,78420,572,137
"12445","36217","2020",1,1,0,187000,2493,75
"12446","36218","2020",3,3,0,85833.33,907,97.66667
"12447","36219","2020",7,7,0,107785.7,1016.143,110.8571
"12448","36220","2020",14,14,0,81178.57,748.5714,108.5
"12449","36221","2020",3,3,0,145000,1274.667,112.6667
"12450","36222","2020",1,1,0,61000,871,70
"12451","36223","2020",1,0,1,33000,917,36
"12452","36224","2020",15,15,0,87946.8,953.0667,89.93333
"12453","36225","2020",2,2,0,124500,1255.5,107.5
"12454","36226","2020",2,2,0,106920,1022.5,98.5
"12455","36227","2020",6,6,0,62305,1007.167,73.5
"12456","36228","2020",33,32,1,87662.88,901.0606,97.69697
"12457","36229","2020",19,19,0,70652.63,921.4211,81.68421
"12458","36230","2020",25,24,1,81565.08,865.44,93.4
"12459","36231","2020",7,7,0,112928.6,1162.429,100.2857
"12460","36232","2020",3,2,1,71500,725,90
"12461","36233","2020",15,15,0,89056.67,945.9333,93.66667
"12462","36234","2020",6,6,0,64180,688.3333,95.66667
"12463","36235","2020",3,3,0,73333.33,793.3333,90.33333
"12464","36236","2020",4,4,0,130000,1481.25,101.25
"12465","36237","2020",6,6,0,77083.33,905.1667,83.33333
"12466","36238","2020",2,2,0,52158,657.5,78.5
"12467","36239","2020",7,7,0,92357.14,704.8571,130.8571
"12468","36240","2020",7,7,0,84004.14,967.4286,82.28571
"12469","36241","2020",26,24,2,105758.7,1256.5,85.65385
"12470","36242","2020",3,3,0,671098.3,5203.667,107
"12471","36243","2020",1,1,0,250000,1613,155
"12472","36244","2020",12,12,0,45125,774.1667,62.75
"12473","36246","2020",3,3,0,100300,1393,69.66667
"12474","36247","2020",12,12,0,147938.3,1308.167,116.1667
"12475","36248","2020",5,5,0,86000,866,107
"12476","37001","2020",11,11,0,115181.8,1207.182,94.09091
"12477","37002","2020",28,28,0,170471.8,1642.321,105.75
"12478","37003","2020",230,164,66,184530.3,2208.904,86.12174
"12479","37004","2020",4,4,0,1e+05,920.5,135.25
"12480","37005","2020",7,7,0,115447.6,1303.714,83.71429
"12481","37006","2020",27,25,2,222256.2,1984.593,116.037
"12482","37007","2020",2,2,0,85000,707.5,118.5
"12483","37008","2020",26,26,0,201800.2,1930.346,105.2692
"12484","37009","2020",8,8,0,184150,1673.25,107
"12485","37010","2020",27,27,0,162677.3,1553.481,111.2963
"12486","37011","2020",17,12,5,150968.2,1564.647,94.17647
"12487","37012","2020",7,7,0,168928.6,1873.571,94.42857
"12488","37013","2020",18,18,0,145339.2,1368.167,113.8333
"12489","37014","2020",49,44,5,187455.4,1997.551,98.28571
"12490","37015","2020",42,42,0,238542.4,2240.548,113.5952
"12491","37016","2020",7,7,0,158050,1821.571,93.57143
"12492","37018","2020",112,81,31,244409,2525.652,99.85714
"12493","37019","2020",7,7,0,66665.71,1045.571,70.28571
"12494","37020","2020",21,21,0,147121.4,1474.714,102.0476
"12495","37021","2020",15,15,0,192925.3,1766.333,110
"12496","37022","2020",37,36,1,157179.7,1523.027,102.4054
"12497","37023","2020",7,7,0,134298.7,1250,105.7143
"12498","37024","2020",10,10,0,197610,1649.5,116.4
"12499","37025","2020",7,7,0,164264.9,1876.571,90.42857
"12500","37026","2020",14,14,0,92150,802.2143,105.5714
"12501","37027","2020",59,57,2,171106.9,1925.949,90.59322
"12502","37028","2020",7,7,0,121738.1,1034.143,110.8571
"12503","37029","2020",6,5,1,134141.7,1522.833,91.66667
"12504","37030","2020",4,4,0,125075,1439.75,89.5
"12505","37031","2020",64,54,10,123877.2,1422.828,88.48438
"12506","37032","2020",5,5,0,186320,1398.4,128.4
"12507","37033","2020",5,5,0,94650,877.6,108.2
"12508","37034","2020",4,4,0,68150,606.5,105
"12509","37035","2020",4,4,0,66370.5,787,82.5
"12510","37036","2020",6,6,0,126488.3,1299.833,105.3333
"12511","37037","2020",4,4,0,135250,1257,124
"12512","37038","2020",9,9,0,181294.4,1657.778,116.8889
"12513","37039","2020",5,5,0,82100,839.2,96
"12514","37040","2020",2,2,0,158500,1730.5,96.5
"12515","37041","2020",6,6,0,131666.7,1380.333,87.5
"12516","37042","2020",7,7,0,144302.9,1714.857,99.57143
"12517","37043","2020",16,16,0,177523.8,1663.875,116.75
"12518","37044","2020",1,1,0,50000,463,108
"12519","37045","2020",7,6,1,117785.7,1201.714,100.4286
"12520","37046","2020",8,8,0,127556.2,1332.625,111.75
"12521","37047","2020",13,13,0,222032.8,1986.462,116.9231
"12522","37048","2020",4,4,0,54550,588,91.75
"12523","37049","2020",16,16,0,134340.6,1374.688,99.625
"12524","37050","2020",187,103,84,194994.6,2470.866,78.45989
"12525","37051","2020",15,15,0,111293.3,1210.4,96.33333
"12526","37052","2020",20,20,0,174115,1705.05,100.15
"12527","37053","2020",1,1,0,440000,2085,211
"12528","37054","2020",34,34,0,241937.9,2339.529,106.6471
"12529","37055","2020",15,15,0,125961.3,1137.533,114.4
"12530","37056","2020",6,6,0,208266.7,1646,125.5
"12531","37057","2020",12,12,0,153503.6,1618.417,93.08333
"12532","37058","2020",26,26,0,117070,1230.154,92.65385
"12533","37059","2020",15,15,0,248649.7,2017.333,126.6
"12534","37060","2020",18,18,0,218379.6,2081.167,116.7778
"12535","37061","2020",10,10,0,154465.7,1015.1,122.9
"12536","37062","2020",29,28,1,111948.2,1193.069,94.2069
"12537","37063","2020",54,50,4,120063.2,1278.259,93.27778
"12538","37064","2020",4,4,0,101670,899.75,120.75
"12539","37065","2020",10,10,0,91986,926.5,104.7
"12540","37066","2020",11,11,0,152393.6,1508.545,94.18182
"12541","37067","2020",19,19,0,189479.6,1790.632,104.8947
"12542","37068","2020",14,14,0,114474.1,1274.5,91.85714
"12543","37069","2020",2,2,0,110500,1359.5,81
"12544","37070","2020",6,6,0,141985,1897.833,80.5
"12545","37072","2020",138,103,35,136038.4,1574.101,88.34783
"12546","37073","2020",4,4,0,183750,1476.75,121.5
"12547","37074","2020",33,32,1,137031.8,1510.273,99.78788
"12548","37075","2020",6,6,0,208731.7,1771.5,111.5
"12549","37076","2020",5,5,0,120460,1052.2,106.2
"12550","37077","2020",48,46,2,179937.6,1905.854,95.27083
"12551","37078","2020",5,5,0,161616,1441.2,114.6
"12552","37079","2020",25,24,1,184698,1959.24,97.68
"12553","37080","2020",5,5,0,116100,1185,92
"12554","37081","2020",21,21,0,155874.9,1376.238,116.7143
"12555","37082","2020",11,11,0,162509.1,2052.455,89.36364
"12556","37083","2020",26,24,2,135261.2,1517.885,86.03846
"12557","37084","2020",7,7,0,105878.6,1622,75.57143
"12558","37085","2020",9,9,0,222222.2,1841.889,114.2222
"12559","37086","2020",9,9,0,166777.8,1726.778,100
"12560","37087","2020",4,4,0,229250,1390,170
"12561","37089","2020",6,6,0,174783.2,1916.167,89.66667
"12562","37090","2020",2,2,0,195797,2800.5,55.5
"12563","37091","2020",33,32,1,153279.1,1806.182,95.57576
"12564","37092","2020",18,18,0,158521.3,1770.722,97
"12565","37093","2020",5,5,0,102480,1250.8,80.8
"12566","37094","2020",15,15,0,111491.7,1375.467,83.4
"12567","37095","2020",6,6,0,130666.7,1224.333,105.1667
"12568","37096","2020",12,12,0,167187.5,1765.833,110.4167
"12569","37097","2020",9,9,0,202493.3,2251,113.6667
"12570","37098","2020",8,8,0,154799.4,1503.375,104.375
"12571","37099","2020",13,13,0,182011.9,1758.462,106.8462
"12572","37100","2020",8,8,0,150393.8,1439.75,105.25
"12573","37101","2020",2,2,0,179650,1509,97.5
"12574","37103","2020",2,2,0,170250,1402,124.5
"12575","37104","2020",89,88,1,225219.9,2218.787,105.1461
"12576","37105","2020",3,3,0,125833.3,1368,100.3333
"12577","37107","2020",6,6,0,65691.67,859.3333,76
"12578","37108","2020",7,7,0,145007.1,1528.571,96.85714
"12579","37109","2020",123,112,11,327072.5,2778.106,117.8211
"12580","37110","2020",19,19,0,189201.3,2016.526,96.47368
"12581","37111","2020",17,17,0,131855.4,1439,101.7059
"12582","37112","2020",1,1,0,30000,462,65
"12583","37113","2020",18,18,0,82161.11,1183.667,83.05556
"12584","37114","2020",3,3,0,75416.67,1211,73.33333
"12585","37115","2020",66,57,9,88447.5,984.5455,86.98485
"12586","37116","2020",8,8,0,92822.5,1137.625,80.75
"12587","37117","2020",14,14,0,103244.3,1042.286,100.5714
"12588","37118","2020",24,24,0,126938,1382.75,94.95833
"12589","37119","2020",22,22,0,110513.7,1156.591,94.13636
"12590","37121","2020",3,3,0,107333.3,920,118.6667
"12591","37122","2020",582,259,323,153647.8,2009.227,75.58763
"12592","37123","2020",48,48,0,175384.8,2019.771,91.08333
"12593","37124","2020",21,20,1,246375.7,2584.857,99.61905
"12594","37125","2020",11,11,0,112541.8,1109.273,98.81818
"12595","37126","2020",3,3,0,92333.33,1044,94.33333
"12596","37127","2020",4,4,0,129875,1092.75,120
"12597","37128","2020",12,12,0,151681,1587.583,97.25
"12598","37129","2020",14,14,0,197796.6,1816.357,109.0714
"12599","37130","2020",33,32,1,103292.4,1083.455,93
"12600","37131","2020",20,20,0,199833.5,1848.3,109.8
"12601","37132","2020",89,78,11,144065.3,1457.472,98
"12602","37133","2020",13,13,0,147061.5,1088.308,129.0769
"12603","37134","2020",9,9,0,146677.8,1727.111,93.88889
"12604","37136","2020",8,8,0,172218.8,1378.375,131.875
"12605","37137","2020",1,1,0,110000,917,120
"12606","37138","2020",17,17,0,192427.6,1853.706,101.2353
"12607","37139","2020",63,55,8,210620.7,2054.429,105.8413
"12608","37140","2020",3,3,0,137222,1167.667,106
"12609","37141","2020",13,13,0,179381.3,1669.769,105.6154
"12610","37142","2020",9,9,0,113400,1247.222,103.4444
"12611","37143","2020",19,19,0,163831.1,1368.789,125.8947
"12612","37144","2020",4,4,0,165675,1920.75,91.25
"12613","37145","2020",1,1,0,60000,857,70
"12614","37146","2020",1,1,0,20000,541,37
"12615","37147","2020",9,9,0,92725.56,998.3333,91.55556
"12616","37148","2020",7,7,0,100870.6,1092.286,97
"12617","37149","2020",4,4,0,257925,2366,114
"12618","37150","2020",10,9,1,167920,1501.6,115
"12619","37151","2020",37,31,6,274340,2603.649,111.7838
"12620","37152","2020",21,21,0,288597.9,2692.762,108.381
"12621","37153","2020",54,54,0,205256.8,1970.333,110.2222
"12622","37154","2020",54,53,1,238158.9,2208.778,107.963
"12623","37155","2020",13,13,0,120965.4,1394.077,88.15385
"12624","37156","2020",153,143,10,226289.5,2329.928,100.8235
"12625","37157","2020",6,6,0,79416.67,989.5,83.5
"12626","37158","2020",9,9,0,175551.1,1303.444,141.1111
"12627","37159","2020",109,96,13,215457.3,2159.321,100.1835
"12628","37160","2020",4,4,0,133750,1379.25,99.25
"12629","37161","2020",9,9,0,147076.3,1696.333,92.22222
"12630","37162","2020",3,3,0,1e+05,1083.667,92.33333
"12631","37163","2020",59,58,1,170585.1,2118.814,90.59322
"12632","37165","2020",7,7,0,130571.4,1784.429,80
"12633","37166","2020",21,21,0,191561.5,1621.095,124.4762
"12634","37167","2020",19,19,0,156347.8,1617.947,100.6842
"12635","37168","2020",7,7,0,67570,969.2857,66.85714
"12636","37169","2020",8,8,0,144500,1483.75,95.125
"12637","37170","2020",13,13,0,161904.6,1693.769,93.07692
"12638","37171","2020",13,13,0,234738.5,1832.154,132.7692
"12639","37172","2020",49,40,9,239330.9,2570.878,93.69388
"12640","37173","2020",13,13,0,69261,953.3077,83.46154
"12641","37174","2020",13,13,0,97153.85,1205.077,86.61538
"12642","37175","2020",18,18,0,223822.2,1968.889,115.7222
"12643","37176","2020",12,12,0,136206.7,1576.5,88
"12644","37177","2020",12,12,0,88193,1004.833,88.83333
"12645","37178","2020",8,8,0,186600,1915.125,89.75
"12646","37179","2020",20,20,0,286800,2820.2,104.65
"12647","37180","2020",8,8,0,122687.5,1114.5,115
"12648","37181","2020",2,2,0,48500,930,58.5
"12649","37182","2020",16,16,0,255772.7,2350.625,108.125
"12650","37183","2020",13,13,0,161561.2,1675.846,96.92308
"12651","37184","2020",5,5,0,82320,1095.4,93.2
"12652","37185","2020",19,17,2,189253.4,1749.105,108.7368
"12653","37186","2020",12,12,0,208150,2317.5,90.33333
"12654","37187","2020",8,8,0,103550,1278.5,80.75
"12655","37188","2020",19,19,0,101311.2,991.8947,102.1579
"12656","37189","2020",23,23,0,74252.17,798.4783,91.08696
"12657","37190","2020",1,1,0,63000,630,100
"12658","37191","2020",6,6,0,122535.2,1297.333,101.8333
"12659","37192","2020",21,21,0,149821.4,1730.381,87.80952
"12660","37193","2020",13,13,0,163903.8,1664.154,102.2308
"12661","37194","2020",25,25,0,174986,1865.76,96.64
"12662","37195","2020",182,44,138,155930.9,2412.22,65.92308
"12663","37196","2020",32,23,9,77908.44,901.8438,82.625
"12664","37197","2020",7,7,0,133308.9,1352.429,98.71429
"12665","37198","2020",8,8,0,108290,1165.875,113.5
"12666","37199","2020",7,7,0,138125.9,1283.571,109.1429
"12667","37200","2020",10,10,0,143980,1374.4,106.1
"12668","37201","2020",4,4,0,181557.5,2078.5,84.75
"12669","37202","2020",11,11,0,169409.1,1568.545,106.1818
"12670","37203","2020",37,34,3,310305.5,2823.405,121.1622
"12671","37204","2020",17,17,0,258301.7,2243.706,122.3529
"12672","37205","2020",18,18,0,221227.8,1787,126.6667
"12673","37206","2020",27,24,3,246685.9,2042.037,123.037
"12674","37207","2020",4,4,0,49247.5,739.5,71
"12675","37208","2020",188,136,52,278681.2,2681.505,105.4947
"12676","37210","2020",5,5,0,156313.2,1885,87.2
"12677","37211","2020",31,31,0,186491.3,1973.903,99.90323
"12678","37212","2020",8,8,0,144868.8,1923.875,77.75
"12679","37213","2020",15,15,0,147656.7,1469.667,103.4667
"12680","37214","2020",285,138,147,258837.5,2766.526,90.71579
"12681","37216","2020",17,17,0,169573.5,1494.471,117.3529
"12682","37217","2020",33,33,0,150646.7,1762.091,91.54545
"12683","37218","2020",5,5,0,139700,1079,116.4
"12684","37219","2020",14,14,0,176095.7,2100.286,88.71429
"12685","37220","2020",7,7,0,103571.4,1035.143,101.4286
"12686","37221","2020",7,7,0,127928.6,1209.714,115.8571
"12687","37222","2020",8,8,0,178903.4,1499.5,131.625
"12688","37223","2020",3,3,0,115333.3,1205.333,96.66667
"12689","37224","2020",9,9,0,152333.3,1636.667,99.33333
"12690","37225","2020",54,53,1,186990.9,1954.111,99.57407
"12691","37226","2020",53,50,3,141864.3,1659.302,95.64151
"12692","37228","2020",15,15,0,129688,1434.533,94.13333
"12693","37229","2020",3,3,0,122000,1088.667,112
"12694","37230","2020",17,17,0,175515.6,1762.647,100.7059
"12695","37231","2020",32,30,2,137959,1349.062,100.0312
"12696","37232","2020",22,22,0,123953.2,1378.909,95.22727
"12697","37233","2020",190,111,79,145542.4,1983.311,74.86316
"12698","37234","2020",6,6,0,171833.3,1295.333,136
"12699","37236","2020",5,5,0,151900,1314.4,107.6
"12700","37237","2020",15,15,0,240066.7,2346.467,104.7333
"12701","37238","2020",7,7,0,162814.3,989.7143,167.1429
"12702","37240","2020",14,14,0,141239.3,1424.429,103.0714
"12703","37241","2020",18,18,0,133772.2,1250.056,116.9444
"12704","37242","2020",10,10,0,85000,984,92
"12705","37243","2020",47,45,2,249073.8,2393.766,110.0426
"12706","37244","2020",5,5,0,118163.4,1046.8,116
"12707","37245","2020",19,19,0,217597.9,2131.053,104.8947
"12708","37246","2020",1,1,0,98000,2130,46
"12709","37247","2020",6,6,0,142179.8,1510.667,94.5
"12710","37248","2020",5,5,0,132000,1319.2,98.6
"12711","37249","2020",18,18,0,162419.4,1546.333,108.8333
"12712","37250","2020",32,30,2,201096.1,2034.625,108.875
"12713","37251","2020",18,18,0,186621.2,1647.778,122.1111
"12714","37252","2020",4,4,0,86875,1011.75,78
"12715","37253","2020",3,3,0,159333.3,1404,116.3333
"12716","37254","2020",20,20,0,201412,1971.8,110.95
"12717","37255","2020",4,4,0,81125,1509.25,62.5
"12718","37256","2020",2,2,0,157601,1791.5,99
"12719","37257","2020",12,12,0,198658.3,1728,118.75
"12720","37258","2020",3,3,0,131000,1113,122.6667
"12721","37259","2020",3,3,0,80933.33,697,111.6667
"12722","37260","2020",6,6,0,115250,952.3333,126.8333
"12723","37261","2020",2375,576,1799,183873.1,2747.341,67.31411
"12724","37262","2020",1,1,0,165000,1044,158
"12725","37263","2020",31,30,1,195113,1877.839,105.8387
"12726","37264","2020",12,12,0,186150,2098.25,88.08333
"12727","37265","2020",1,1,0,108000,1662,65
"12728","37266","2020",75,74,1,246403.9,2376.187,104.36
"12729","37267","2020",58,58,0,241294.2,2272.603,107.1379
"12730","37268","2020",2,2,0,68500,944.5,71.5
"12731","37269","2020",9,9,0,74940,1303.778,60.22222
"12732","37270","2020",45,44,1,262162.5,2273.2,113.6444
"12733","37271","2020",11,11,0,158472.7,1489.455,117.5455
"12734","37272","2020",13,13,0,221380.8,2249.846,98.15385
"12735","37273","2020",61,56,5,208036.4,2314.23,93.59016
"12736","37274","2020",6,6,0,107983.3,1351.5,85.16667
"12737","37275","2020",1,1,0,35000,530,66
"12738","37276","2020",18,18,0,197615.7,1737.889,115.2222
"12739","37277","2020",10,10,0,126400,1187.7,107.3
"12740","37278","2020",13,12,1,162726.5,1933.615,84.15385
"12741","37279","2020",13,13,0,132769.2,1564.846,84.15385
"12742","37280","2020",6,6,0,138306.7,1325.333,127
"12743","37281","2020",46,40,6,258078.2,2546.913,109.8043
"12744","37282","2020",27,27,0,87317.33,866.6296,97.55556
"12745","38001","2020",133,94,39,157467.8,1717.654,93.87218
"12746","38002","2020",66,7,59,93219.18,2501.591,34.5
"12747","38003","2020",14,14,0,234925,2121.357,112.5714
"12748","38004","2020",12,12,0,226250,2135.25,103.9167
"12749","38005","2020",15,10,5,181733.3,2091,83.93333
"12750","38006","2020",99,38,61,128874.3,1868.596,69.34343
"12751","38009","2020",10,10,0,200980,1839.9,116.2
"12752","38010","2020",7,7,0,234638.9,2450.857,95.42857
"12753","38011","2020",21,18,3,323295.9,3300.476,100.619
"12754","38012","2020",54,41,13,156480.4,1762.556,93.85185
"12755","38013","2020",55,39,16,191447.5,2103.927,95.63636
"12756","38015","2020",19,17,2,198583.7,2045.158,99.89474
"12757","38017","2020",23,23,0,242943.5,2405.522,102.2174
"12758","38018","2020",2,2,0,51000,591,90
"12759","38019","2020",33,27,6,206246.4,1980.727,106.303
"12760","38020","2020",43,3,40,88877.09,2767.302,31.90698
"12761","38022","2020",121,104,17,181477.6,1910.215,96.38843
"12762","38023","2020",2,2,0,311000,3493.5,92.5
"12763","38026","2020",10,7,3,176581,2107.2,85.8
"12764","38027","2020",20,19,1,242023.9,2592.3,91.65
"12765","38029","2020",21,19,2,185230.9,1780.048,105.4286
"12766","38030","2020",15,10,5,195506.3,1955.533,104.2
"12767","38031","2020",1,1,0,81135,1014,80
"12768","38032","2020",7,7,0,253107.1,2080.714,119.5714
"12769","38033","2020",4,4,0,196512.5,1580,115.25
"12770","38034","2020",80,72,8,147662.7,1527.638,96.8
"12771","38035","2020",5,5,0,235940,2217.2,107.2
"12772","38036","2020",1,1,0,237150,2665,89
"12773","38037","2020",13,11,2,207240,1679,118.2308
"12774","38038","2020",5,5,0,191044,2031,101.8
"12775","38039","2020",31,25,6,397944.9,4120.194,97.93548
"12776","38040","2020",2,0,2,83000,1689.5,61
"12777","38041","2020",2,2,0,194152.5,2632.5,73.5
"12778","38042","2020",10,10,0,219573.3,2143.1,102.1
"12779","38043","2020",11,10,1,252727.3,2535.091,104.9091
"12780","38044","2020",11,8,3,191042.7,2055.182,96.72727
"12781","38045","2020",36,33,3,452466.1,3939.111,117.2222
"12782","38046","2020",9,9,0,207561.1,1919.778,117.3333
"12783","38047","2020",1,1,0,168000,1697,99
"12784","38048","2020",10,8,2,226276.8,2389.1,93.1
"12785","38049","2020",3,3,0,169766.7,1415.333,120.3333
"12786","38050","2020",11,10,1,197900,1943.182,107.9091
"12787","38051","2020",14,14,0,205895,1891.929,110.3571
"12788","38052","2020",60,33,27,183401.1,2366.917,76.96667
"12789","38053","2020",459,123,336,174968.7,2350.512,76.12418
"12790","38054","2020",16,16,0,158858.1,1685.812,95.875
"12791","38055","2020",9,9,0,182640.6,1623.444,114.1111
"12792","38056","2020",1,1,0,120000,1000,120
"12793","38057","2020",5,4,1,414803,3927,105.2
"12794","38058","2020",20,19,1,203677.5,1979.05,108.85
"12795","38059","2020",33,17,16,267244.5,2903.909,92.15152
"12796","38060","2020",2,2,0,210250,2458.5,93.5
"12797","38061","2020",46,24,22,260992.2,2891.609,91.71739
"12798","38062","2020",10,10,0,298751.5,2311,138.3
"12799","38063","2020",4,3,1,135500,1595.5,86.25
"12800","38064","2020",27,26,1,232782.1,2377.333,104.2222
"12801","38065","2020",27,26,1,188735.4,1797.815,109.8889
"12802","38066","2020",3,3,0,50380,477.6667,109
"12803","38067","2020",17,15,2,322250.6,3014,112.6471
"12804","38068","2020",19,19,0,383986.8,3657.421,106.2632
"12805","38069","2020",15,12,3,182220,2663.733,83.33333
"12806","38070","2020",27,15,12,216164.9,2758.333,79.33333
"12807","38071","2020",40,29,11,258202.1,2907.55,90.65
"12808","38072","2020",26,23,3,205963.7,2000.962,104.5385
"12809","38073","2020",4,4,0,142188.8,2039.75,96
"12810","38074","2020",1,1,0,284500,2874,99
"12811","38075","2020",42,31,11,201945.1,2446.714,88.57143
"12812","38076","2020",37,31,6,195666.8,1926.486,102.2432
"12813","38077","2020",6,6,0,212208.3,2078.167,102.8333
"12814","38078","2020",9,9,0,239908.3,2573.778,99.33333
"12815","38080","2020",4,4,0,238637.5,1938.25,122.75
"12816","38081","2020",24,21,3,269990.8,2578.542,108.75
"12817","38082","2020",31,26,5,211920.5,2243.839,100.3226
"12818","38083","2020",5,5,0,177740,1833.6,102.8
"12819","38084","2020",16,16,0,295580,2533,117.0625
"12820","38085","2020",117,104,13,255629.7,2726.128,95.11111
"12821","38086","2020",3,3,0,142116.7,1042,133
"12822","38087","2020",79,58,21,244909.4,2728.405,89.49367
"12823","38089","2020",2,2,0,185500,1912,97.5
"12824","38090","2020",11,11,0,191556.8,1980.909,107.6364
"12825","38091","2020",11,11,0,260774.9,2257.545,116.8182
"12826","38092","2020",1,1,0,173550,1972,88
"12827","38093","2020",3,3,0,137433.3,1739.333,77.66667
"12828","38094","2020",23,22,1,189774.8,2071.304,96.43478
"12829","38095","2020",30,29,1,196847.5,1794.067,107.0667
"12830","38097","2020",49,39,10,252193.5,2711.612,94.65306
"12831","38098","2020",6,6,0,265108.3,2440,110.1667
"12832","38099","2020",9,9,0,258206.1,2380.333,133.1111
"12833","38100","2020",34,26,8,222482.8,2332.029,93
"12834","38101","2020",15,14,1,247180,2347.8,107.8667
"12835","38102","2020",7,7,0,357522.9,2701.857,135.1429
"12836","38103","2020",5,4,1,111250,1766.4,77.2
"12837","38104","2020",21,21,0,224410.3,2104.143,108.619
"12838","38105","2020",24,24,0,252344.6,2620.625,101.375
"12839","38106","2020",1,0,1,25000,893,28
"12840","38107","2020",21,16,5,338978.6,3050.952,117.7619
"12841","38108","2020",1,1,0,3e+05,1765,170
"12842","38109","2020",11,11,0,373047.3,2922.273,128
"12843","38110","2020",31,29,2,367033.9,3430.387,107.1613
"12844","38111","2020",85,55,30,333021.5,3339.424,100.4941
"12845","38112","2020",2,2,0,161475,1984.5,81
"12846","38113","2020",8,8,0,173188.8,2016.5,96.25
"12847","38114","2020",17,16,1,212341.2,2067.176,107.2353
"12848","38115","2020",3,3,0,305550,2473.667,124
"12849","38116","2020",2,2,0,120150,1106,110
"12850","38117","2020",5,5,0,136621.4,1977.2,70
"12851","38118","2020",12,12,0,243096.6,2252.5,108.8333
"12852","38120","2020",6,6,0,434583.3,3295,128.5
"12853","38124","2020",38,32,6,189546.5,1745.421,109
"12854","38126","2020",48,36,12,569705.6,4095.604,137.6042
"12855","38127","2020",2,1,1,152500,1562.5,99
"12856","38128","2020",8,5,3,116031.2,1397.125,81.375
"12857","38129","2020",27,3,24,137872.2,3155.778,37.81481
"12858","38130","2020",94,62,32,160508.5,1854.372,88.06383
"12859","38131","2020",9,8,1,247455.6,2444.222,106.4444
"12860","38132","2020",2,2,0,185000,2222.5,84.5
"12861","38133","2020",53,43,10,305097,3048.792,101.7547
"12862","38134","2020",13,10,3,233208.1,2072.154,114.7692
"12863","38135","2020",15,15,0,203026.7,2119.333,100.4
"12864","38136","2020",5,5,0,231000,2394.4,96.2
"12865","38137","2020",1,1,0,385000,3667,105
"12866","38138","2020",44,18,26,232640.5,2671,96.79545
"12867","38139","2020",26,22,4,172721,1788,104.9615
"12868","38140","2020",62,46,16,358881.2,3411.839,107.629
"12869","38141","2020",10,10,0,312465,2519.9,119.1
"12870","38144","2020",29,23,6,267413,2892.828,101.8966
"12871","38146","2020",17,16,1,227506.2,2491.588,91.35294
"12872","38147","2020",8,7,1,191320,2225.875,86.125
"12873","38148","2020",33,31,2,202671.9,1970.424,106.6667
"12874","38149","2020",24,20,4,261585.7,2478.25,108.2083
"12875","38150","2020",94,31,63,198200.7,2688.702,72.92553
"12876","38151","2020",426,55,371,145719.2,2036.362,71.90141
"12877","38152","2020",15,14,1,247938.9,2409.267,102.6667
"12878","38153","2020",5,4,1,306198.4,2625.2,122.2
"12879","38154","2020",5,3,2,95350,1712,61
"12880","38155","2020",22,22,0,200105.5,1983.409,100
"12881","38156","2020",7,7,0,195857.1,2280.714,85.14286
"12882","38157","2020",41,36,5,249713.1,2398.854,108.7317
"12883","38158","2020",130,20,110,223420.6,2876.231,76.96154
"12884","38159","2020",4,4,0,178750,1864,103.75
"12885","38160","2020",28,27,1,241592,2464.393,101.1429
"12886","38161","2020",9,9,0,257252.8,2059.444,130.6667
"12887","38162","2020",20,19,1,215284.5,1937.4,111.45
"12888","38163","2020",28,10,18,84237.86,1671.714,50.03571
"12889","38166","2020",3,3,0,260000,2418,117.3333
"12890","38167","2020",6,6,0,203885,2152.667,96.33333
"12891","38169","2020",311,34,277,138532.1,1966.122,68.65595
"12892","38170","2020",52,21,31,225803.2,2897.135,78.80769
"12893","38171","2020",5,5,0,198682,1598.8,135
"12894","38172","2020",19,11,8,251609.5,2751.105,93.63158
"12895","38173","2020",4,4,0,166754.5,1923,92.75
"12896","38174","2020",12,12,0,174237.5,1696.5,100.4167
"12897","38175","2020",36,19,17,251212.2,3097,80.97222
"12898","38176","2020",19,19,0,309048.4,2939.158,106.4737
"12899","38177","2020",4,2,2,72090,1770,43.75
"12900","38179","2020",101,13,88,200562.6,3033.05,67.22772
"12901","38180","2020",12,12,0,240566.7,2471,100.25
"12902","38181","2020",27,18,9,212272.4,2458.704,93.66667
"12903","38182","2020",35,26,9,164032,1856.286,88.48571
"12904","38183","2020",2,2,0,102750,1571.5,70
"12905","38184","2020",30,25,5,303625.4,3152.767,98.63333
"12906","38185","2020",2985,97,2888,156970.2,2508.019,64.08107
"12907","38186","2020",44,11,33,87352.5,1892.091,42.81818
"12908","38187","2020",32,28,4,235415.6,2480.531,92.875
"12909","38188","2020",14,10,4,394870.7,3368.714,125.6429
"12910","38189","2020",50,34,16,239955.8,2771.86,89.54
"12911","38190","2020",13,13,0,193542.6,2076.385,98.84615
"12912","38191","2020",194,6,188,199070.2,5130.155,37.50515
"12913","38193","2020",221,138,83,194690.8,2420.457,81.61086
"12914","38194","2020",19,15,4,201036.8,2077.842,100.2105
"12915","38195","2020",7,6,1,165399.9,1748.286,95.71429
"12916","38197","2020",22,19,3,284299.5,2901.409,99.59091
"12917","38198","2020",10,9,1,171100,1780.9,97.4
"12918","38199","2020",36,30,6,314072.7,3034.25,107.4167
"12919","38200","2020",34,17,17,260102.2,2694.235,96.58824
"12920","38203","2020",8,7,1,177458.1,2100.25,82.5
"12921","38204","2020",3,3,0,138958.7,1107,152.6667
"12922","38205","2020",47,21,26,158816.8,3103.723,50.17021
"12923","38206","2020",10,10,0,251031,2809.8,92.8
"12924","38207","2020",3,3,0,90050,1426.333,61.33333
"12925","38208","2020",6,6,0,147925,2038.167,86.83333
"12926","38209","2020",1,1,0,89325,1004,89
"12927","38210","2020",7,7,0,252657.1,2112.714,125
"12928","38211","2020",5,5,0,229320,1831.4,133.6
"12929","38212","2020",11,10,1,113762.7,1509.636,79.63636
"12930","38213","2020",4,4,0,149250,1234.25,121.5
"12931","38214","2020",9,7,2,332322.8,3592.333,94.77778
"12932","38215","2020",34,28,6,340039.3,3363.059,105.2647
"12933","38216","2020",2,2,0,186000,1982,96
"12934","38217","2020",1,1,0,115000,898,128
"12935","38218","2020",8,7,1,204651.2,1771.625,118.125
"12936","38219","2020",6,6,0,184666.7,1892.667,106.1667
"12937","38221","2020",1,1,0,249000,1132,220
"12938","38222","2020",9,9,0,199944.4,1785.778,118.3333
"12939","38223","2020",21,21,0,370762.4,2774.381,139.5714
"12940","38224","2020",1,1,0,88000,978,90
"12941","38225","2020",52,21,31,196792.5,2870.75,70.40385
"12942","38226","2020",16,16,0,180293.1,1694.5,122.5
"12943","38228","2020",8,8,0,210437.5,2013.875,114.75
"12944","38229","2020",216,43,173,294481.2,3482.782,83.10648
"12945","38230","2020",15,13,2,344185.2,2900.067,120.2667
"12946","38231","2020",10,10,0,240457.5,2122.8,115.9
"12947","38232","2020",10,10,0,191579.3,1601.8,119.8
"12948","38235","2020",4,4,0,334262.5,2465.75,138.25
"12949","38236","2020",26,24,2,208727.9,2044.154,106.8846
"12950","38237","2020",3,2,1,144666.7,1732,97.33333
"12951","38238","2020",28,23,5,260039.1,2513.429,108.1071
"12952","38239","2020",72,50,22,221044.9,2359.319,95.73611
"12953","38240","2020",12,12,0,197327.1,2049.583,95.66667
"12954","38242","2020",19,15,4,185121.1,1851.684,101.5263
"12955","38243","2020",8,7,1,153366.6,1613.875,105.25
"12956","38244","2020",8,8,0,249776.2,2198.125,119.375
"12957","38245","2020",3,3,0,234566.7,2641.667,102.6667
"12958","38246","2020",13,13,0,228194.9,2361.308,98.07692
"12959","38247","2020",61,44,17,150101.9,1816.344,83.03279
"12960","38248","2020",3,3,0,329033.3,2763.333,131.6667
"12961","38249","2020",52,18,34,331323.8,3712.135,88.51923
"12962","38250","2020",1,1,0,225000,2394,94
"12963","38252","2020",1,1,0,92500,752,123
"12964","38253","2020",339,18,321,141513.9,3760.357,36.71976
"12965","38254","2020",7,7,0,150121.4,1761.143,85.14286
"12966","38255","2020",2,2,0,109000,1244,91
"12967","38256","2020",21,19,2,189709.5,2128.524,88.52381
"12968","38257","2020",4,4,0,174200,1588.75,108
"12969","38258","2020",1,1,0,205989,1648,125
"12970","38259","2020",12,12,0,225157.1,1975,116.4167
"12971","38260","2020",5,5,0,248378.6,2547.8,108
"12972","38261","2020",97,69,28,189679.6,2080.814,93.78351
"12973","38263","2020",1,1,0,395000,2862,138
"12974","38264","2020",15,4,11,74713.67,1853.867,40.26667
"12975","38265","2020",25,19,6,154789.2,1760.8,89.28
"12976","38266","2020",12,12,0,106333.3,1718.333,61.83333
"12977","38267","2020",12,12,0,196583.3,1906.75,105.1667
"12978","38268","2020",3,3,0,212503.3,1927,111.6667
"12979","38269","2020",69,32,37,113468.5,1490.638,76.71014
"12980","38270","2020",23,20,3,216458.6,2365.957,95.86957
"12981","38271","2020",6,5,1,358282.3,3066.667,119.3333
"12982","38272","2020",6,4,2,211021.7,1737,124
"12983","38273","2020",5,5,0,197319,2010.8,102.4
"12984","38275","2020",2,1,1,131800,1554,87.5
"12985","38276","2020",37,30,7,225326.6,2287.351,98.21622
"12986","38277","2020",6,4,2,268141.7,2481.333,111.6667
"12987","38278","2020",4,4,0,235950,2163.25,111
"12988","38279","2020",15,15,0,259345.3,2589.4,101.0667
"12989","38280","2020",8,8,0,168737.6,1917.75,89.125
"12990","38281","2020",11,9,2,321041.8,2688.727,121.6364
"12991","38282","2020",5,5,0,259406.2,2716.4,95.6
"12992","38283","2020",2,2,0,131825,872,145
"12993","38284","2020",8,7,1,170288.8,1755.125,97
"12994","38285","2020",6,6,0,162640,1602.167,99.33333
"12995","38286","2020",1,1,0,140000,2258,62
"12996","38287","2020",16,15,1,215132.5,2007.062,109
"12997","38288","2020",20,18,2,269050,2928,96.55
"12998","38289","2020",31,2,29,256270.8,4449,59.77419
"12999","38290","2020",9,9,0,176444.4,1779.778,101.5556
"13000","38291","2020",13,13,0,165738.5,1897.462,100.1538
"13001","38292","2020",38,35,3,221734.2,2050.526,110.6053
"13002","38294","2020",6,6,0,229715,2850.833,92
"13003","38295","2020",12,12,0,208187.5,2013.5,105.8333
"13004","38296","2020",12,11,1,206520,2166.25,103.1667
"13005","38297","2020",23,20,3,177292.4,1887.957,94.86957
"13006","38298","2020",106,80,26,153053.7,1850.632,88.17925
"13007","38299","2020",3,3,0,90506.67,1044,87
"13008","38300","2020",1,1,0,212950,2009,106
"13009","38301","2020",1,1,0,85000,1889,45
"13010","38303","2020",8,8,0,285931.2,2757.5,103.125
"13011","38304","2020",10,10,0,206412.2,2292.3,88.5
"13012","38307","2020",2,2,0,169675,2354.5,69.5
"13013","38308","2020",3,3,0,167186.7,1660.333,107.6667
"13014","38309","2020",24,16,8,247938,2757.25,92.25
"13015","38310","2020",7,5,2,218371.4,2238.857,92.14286
"13016","38311","2020",9,9,0,172521.1,1646.889,108.6667
"13017","38313","2020",1,1,0,151500,2405,63
"13018","38314","2020",96,55,41,205903.1,2477.594,88.10417
"13019","38315","2020",71,35,36,150335,1819.972,82.16901
"13020","38316","2020",99,31,68,161848.7,2204.263,76.13131
"13021","38317","2020",134,13,121,114444.9,1742.366,66.03731
"13022","38318","2020",57,28,29,164152.1,1986.368,83.85965
"13023","38319","2020",9,6,3,113510.6,1270.778,82.33333
"13024","38320","2020",31,30,1,190940.3,2094.226,93.19355
"13025","38321","2020",3,2,1,72666.67,936,95.33333
"13026","38322","2020",2,2,0,202500,1634,130.5
"13027","38323","2020",8,8,0,224084.4,1884.375,121
"13028","38324","2020",8,8,0,256240,1765.125,142.25
"13029","38325","2020",2,2,0,191750,2397.5,80
"13030","38326","2020",2,2,0,174000,1284.5,128.5
"13031","38328","2020",5,5,0,436660,3266.4,134.8
"13032","38329","2020",2,2,0,109675,1566,76
"13033","38330","2020",1,1,0,238000,793,300
"13034","38331","2020",15,13,2,267245.3,2538.733,107.6667
"13035","38332","2020",47,29,18,189016.1,2024.596,90.2766
"13036","38333","2020",7,5,2,149556.3,2132.571,76.28571
"13037","38334","2020",12,12,0,372231.8,3085.917,126.75
"13038","38335","2020",18,18,0,164304.4,1710.5,99.05556
"13039","38336","2020",24,20,4,288635,2314.375,127.4167
"13040","38337","2020",111,40,71,162956.5,2004.919,79.96396
"13041","38338","2020",5,4,1,190898,2698.4,78.6
"13042","38339","2020",13,11,2,254945,2352.538,112.6923
"13043","38340","2020",32,17,15,174500.5,2150.344,85.4375
"13044","38341","2020",9,8,1,217068.2,3018.778,87.55556
"13045","38342","2020",3,3,0,199333.3,2173,94.33333
"13046","38343","2020",16,15,1,211660,2065.812,105.4375
"13047","38344","2020",118,71,47,160080.5,1711.203,90.0678
"13048","38345","2020",5,5,0,191270,1938,102.2
"13049","38346","2020",7,7,0,208560,1877.286,120.4286
"13050","38347","2020",11,9,2,163535.1,1896.545,84.54545
"13051","38348","2020",47,44,3,310517.2,2819.936,110.4043
"13052","38349","2020",26,25,1,198709.6,1959.577,103.3077
"13053","38350","2020",4,4,0,239405,3246.5,73
"13054","38351","2020",13,12,1,232463.8,2055.692,117.7692
"13055","38352","2020",28,23,5,257025.2,2823.821,94.32143
"13056","38353","2020",4,4,0,191725,2423.5,82.75
"13057","38354","2020",4,4,0,213175,2082,113.75
"13058","38355","2020",4,4,0,197370,2416.5,87.25
"13059","38356","2020",4,4,0,142080,1736,90.25
"13060","38357","2020",36,34,2,222025.5,2008.278,114.0556
"13061","38358","2020",5,5,0,296491.4,2465.2,117.8
"13062","38359","2020",9,9,0,153064.4,1724,90.66667
"13063","38360","2020",6,6,0,253578.3,1763.167,141.1667
"13064","38361","2020",2,2,0,141325,1255.5,115.5
"13065","38362","2020",9,5,4,189964.7,2188.444,94.11111
"13066","38363","2020",9,9,0,180348.9,1639.778,121.2222
"13067","38364","2020",4,4,0,251282.5,2686.5,94
"13068","38365","2020",10,10,0,210360.8,2299.7,93.1
"13069","38366","2020",5,4,1,143200,1861.6,77.6
"13070","38368","2020",10,10,0,312609,2447.6,130.4
"13071","38369","2020",8,8,0,170062.5,1720.125,97
"13072","38370","2020",9,9,0,238830.6,1825.444,131
"13073","38372","2020",10,9,1,182600,2218.1,87.1
"13074","38373","2020",13,12,1,329271.9,2140.308,147.6154
"13075","38374","2020",50,42,8,234091.9,2268.08,104.26
"13076","38375","2020",3,3,0,111833.3,1563.667,76
"13077","38376","2020",9,9,0,162402.8,2036.889,81.66667
"13078","38377","2020",63,49,14,186120.6,2004.746,92.2381
"13079","38378","2020",45,39,6,227002.2,2359.622,99.04444
"13080","38379","2020",4,4,0,123875,1747.75,79.75
"13081","38380","2020",1,1,0,55000,679,81
"13082","38381","2020",19,19,0,232647.4,2161.368,110.4211
"13083","38382","2020",244,78,166,223875.4,2738.914,81.27459
"13084","38383","2020",28,23,5,266073.4,2638.964,104
"13085","38384","2020",45,30,15,169316,1839.533,91.33333
"13086","38386","2020",20,14,6,145338,1572.55,88.3
"13087","38387","2020",8,5,3,160031.2,2092,74.375
"13088","38388","2020",29,21,8,271359,3043.69,96.75862
"13089","38389","2020",28,23,5,253109.6,2396.643,108.6071
"13090","38390","2020",8,8,0,156362.5,1805.125,95.625
"13091","38391","2020",4,4,0,216750,1559.5,148.75
"13092","38392","2020",10,10,0,334994,2726.8,121.8
"13093","38393","2020",21,19,2,189810,1788.286,107.3333
"13094","38394","2020",15,13,2,193589,1927.6,99.66667
"13095","38395","2020",16,13,3,226612.8,2493.625,89.0625
"13096","38396","2020",8,3,5,115515.4,1465.125,70.625
"13097","38397","2020",71,47,24,437351.5,3972.648,114.3521
"13098","38398","2020",11,10,1,182695.5,1808.636,103.1818
"13099","38399","2020",61,43,18,185088.1,2090.803,94.57377
"13100","38400","2020",42,32,10,282815.9,2786.286,103.119
"13101","38401","2020",16,15,1,200741.4,1915.438,106.6875
"13102","38402","2020",2,2,0,171600,1889.5,87
"13103","38403","2020",2,2,0,165337.5,1592.5,107.5
"13104","38404","2020",2,2,0,399295,4235,96
"13105","38405","2020",17,15,2,208416.8,1963.059,109.4706
"13106","38407","2020",10,9,1,227103,1954.3,114.4
"13107","38408","2020",28,28,0,333424.1,3327.5,101.2857
"13108","38409","2020",21,19,2,198221.6,1866.381,108.8095
"13109","38410","2020",11,10,1,205054.5,1713.273,124.7273
"13110","38412","2020",52,38,14,165521.9,1917.269,86.03846
"13111","38413","2020",4,4,0,150825,1504.25,141
"13112","38415","2020",11,11,0,306770.9,2679.545,111.8182
"13113","38416","2020",142,49,93,140348.1,1839.444,77.35211
"13114","38417","2020",2,2,0,332550,3476.5,95.5
"13115","38418","2020",6,6,0,212208.3,2262.667,99.33333
"13116","38419","2020",4,4,0,148427.5,1347.25,112
"13117","38420","2020",2,2,0,245000,2728.5,102
"13118","38421","2020",475,47,428,148295,2263.219,65.61895
"13119","38422","2020",68,34,34,313240.6,3405.265,93.27941
"13120","38423","2020",84,19,65,183454.9,2352.357,74.32143
"13121","38424","2020",4,4,0,87356.25,986,94
"13122","38425","2020",76,66,10,186723.6,2007.671,95.05263
"13123","38426","2020",5,5,0,156400,1822.4,88.8
"13124","38427","2020",6,6,0,201115,1948.833,115
"13125","38429","2020",4,4,0,263305,2342.5,123.75
"13126","38430","2020",3,3,0,174850,2567.667,67.66667
"13127","38431","2020",32,24,8,407869.1,3757.625,109.4375
"13128","38432","2020",8,6,2,273350,2262,127.125
"13129","38433","2020",12,6,6,270220.8,3074.583,89.16667
"13130","38434","2020",4,3,1,168155.5,1671,102.25
"13131","38436","2020",20,19,1,376975.5,3451.15,111.85
"13132","38438","2020",3,3,0,198583.3,2084.333,105.6667
"13133","38439","2020",51,44,7,208930.8,2314.098,92.88235
"13134","38440","2020",5,5,0,210822,1903.2,111.8
"13135","38442","2020",29,15,14,127967.5,2259.586,59.86207
"13136","38443","2020",4,4,0,148851.2,2253.75,78.5
"13137","38444","2020",1,1,0,130000,977,133
"13138","38445","2020",8,8,0,264818.8,2547.125,108.125
"13139","38446","2020",6,4,2,143675,2554.5,61.16667
"13140","38448","2020",14,11,3,279965,2332.571,125.2143
"13141","38449","2020",65,56,9,227417.6,2441.846,96.30769
"13142","38450","2020",5,4,1,220354,2500.2,86.4
"13143","38451","2020",30,30,0,287539.1,2962.133,98.9
"13144","38452","2020",5,5,0,246130,2261.2,111.4
"13145","38453","2020",22,20,2,204126.9,1966.909,102.0455
"13146","38454","2020",20,18,2,234137,2071.15,114.4
"13147","38455","2020",50,50,0,304661.2,2691.46,114.12
"13148","38456","2020",2,2,0,229070,2054,132.5
"13149","38457","2020",32,25,7,165817.3,1713.938,96.0625
"13150","38458","2020",7,7,0,144301.4,1560.286,96.71429
"13151","38459","2020",6,6,0,285933.3,2394.667,128.5
"13152","38460","2020",5,5,0,187045,1812.4,102.4
"13153","38462","2020",5,5,0,136600,1867.6,72.6
"13154","38463","2020",25,24,1,216113.2,2105.6,104.56
"13155","38464","2020",18,18,0,208113.3,1978.944,109.8333
"13156","38465","2020",12,12,0,269529.5,2413.25,112.0833
"13157","38466","2020",13,13,0,355192.5,3023.154,126.3846
"13158","38467","2020",18,18,0,279403.3,2393.889,116.9444
"13159","38468","2020",47,37,10,177801.1,1915.532,95.04255
"13160","38469","2020",1,1,0,65000,812,80
"13161","38470","2020",2,2,0,141000,2560,55
"13162","38471","2020",11,5,6,275450.5,2795.545,100.6364
"13163","38472","2020",4,2,2,355475,2616.25,125
"13164","38473","2020",20,20,0,192954.4,1753.35,112.7
"13165","38474","2020",177,55,122,214285.5,2746.192,76.97175
"13166","38475","2020",29,24,5,271841.6,2836.655,97.72414
"13167","38476","2020",10,10,0,270999.7,2743.2,99.6
"13168","38478","2020",15,14,1,158261.3,2119,78.2
"13169","38479","2020",21,21,0,177242.9,1762.19,101.0952
"13170","38480","2020",33,22,11,240864.9,2594.667,98.24242
"13171","38481","2020",13,13,0,245810.2,2232.231,114
"13172","38483","2020",26,24,2,214236.5,1992.077,110.8462
"13173","38484","2020",29,24,5,269394.8,2887.724,91.93103
"13174","38485","2020",184,26,158,183107.9,2474.457,69.61957
"13175","38486","2020",79,27,52,287271.1,3211.278,90.78481
"13176","38487","2020",16,11,5,270069.4,3061.625,99
"13177","38488","2020",12,12,0,224671.7,2208.917,106.1667
"13178","38489","2020",1,1,0,126000,2377,53
"13179","38490","2020",21,17,4,203340.7,2107.524,102.8571
"13180","38492","2020",10,9,1,227568.2,2463.5,91.6
"13181","38494","2020",9,9,0,241847.7,2020.556,122.4444
"13182","38495","2020",7,6,1,121160,1132.429,103
"13183","38496","2020",16,15,1,192348.2,1653.438,124.0625
"13184","38497","2020",1,1,0,306100,2449,125
"13185","38498","2020",7,7,0,209356.6,2083.714,110.4286
"13186","38499","2020",9,8,1,147044.4,1614.778,94.44444
"13187","38500","2020",4,4,0,172000,2161.75,86.75
"13188","38501","2020",44,24,20,229190,2733.205,85.40909
"13189","38503","2020",18,11,7,242412.1,2756.333,86.66667
"13190","38504","2020",12,12,0,229086.8,3112.25,85.66667
"13191","38505","2020",12,12,0,213610,2013.833,116.0833
"13192","38507","2020",101,89,12,279665.1,2961.604,97.68317
"13193","38508","2020",9,9,0,237826.7,2360.333,102.6667
"13194","38509","2020",116,41,75,138090.8,1817.172,77.91379
"13195","38511","2020",39,19,20,228790.3,2742.487,82.94872
"13196","38512","2020",14,14,0,295644.3,2556.714,120.3571
"13197","38513","2020",2,2,0,284000,2776.5,104.5
"13198","38514","2020",1,0,1,430000,5375,80
"13199","38515","2020",32,29,3,193263.8,2279.938,89.125
"13200","38516","2020",87,20,67,276743.7,3407.011,77.87356
"13201","38517","2020",99,55,44,169858.6,1917.788,90.0202
"13202","38518","2020",3,3,0,58213.67,817,81.66667
"13203","38519","2020",36,26,10,292948.9,3156.083,95.11111
"13204","38520","2020",8,7,1,168779.6,1905.75,102.625
"13205","38522","2020",6,6,0,110533.3,1307.167,89.5
"13206","38523","2020",9,9,0,176767.3,1471.222,124.7778
"13207","38524","2020",61,34,27,305917.7,3449.934,87.62295
"13208","38525","2020",5,5,0,210930,1741.4,121.2
"13209","38526","2020",4,4,0,226092.5,2199.5,99.5
"13210","38527","2020",17,3,14,277517,4672.706,57.41176
"13211","38528","2020",14,12,2,354993.6,3347.143,114.5
"13212","38529","2020",55,26,29,282227.4,3100.091,90.07273
"13213","38530","2020",38,17,21,240774.9,2749.132,87.73684
"13214","38531","2020",5,5,0,171180,2022,100.8
"13215","38532","2020",11,11,0,265242.5,2430.545,108.8182
"13216","38533","2020",11,11,0,513520.5,3642.182,146.4545
"13217","38535","2020",3,3,0,228433.3,2812.333,81
"13218","38536","2020",15,13,2,257068.7,2367.133,111.6
"13219","38537","2020",108,62,46,203244.8,2607.731,78.88889
"13220","38538","2020",63,33,30,260717,2977.206,89.04762
"13221","38539","2020",12,12,0,162820.8,1877.833,85.41667
"13222","38540","2020",15,15,0,375652.9,3095.6,124
"13223","38542","2020",2,2,0,353630,2242.5,166.5
"13224","38543","2020",36,36,0,201310,1925.361,105.5833
"13225","38544","2020",445,107,338,168635.2,2206.175,77.79101
"13226","38545","2020",88,38,50,258109.6,2941.943,89.56818
"13227","38546","2020",17,17,0,193046.6,2078.176,96.23529
"13228","38547","2020",90,38,52,199290.5,2609.389,78.18889
"13229","38548","2020",268,30,238,135522.5,2912.877,45.48134
"13230","38551","2020",1,1,0,176700,3927,45
"13231","38553","2020",173,108,65,180569.5,2119.572,85.11561
"13232","38554","2020",19,17,2,262094.7,2717,105.0526
"13233","38555","2020",11,11,0,227963.6,1920.091,133.6364
"13234","38556","2020",11,10,1,251230.3,2288.636,118.5455
"13235","38557","2020",62,50,12,323165.9,3251.339,103.5645
"13236","38558","2020",25,14,11,326742.4,3150.4,112.16
"13237","38559","2020",59,29,30,157677.7,2029.966,75.9322
"13238","38560","2020",16,15,1,183110.9,1683.375,116.8125
"13239","38561","2020",20,17,3,168117.5,1677.6,103.1
"13240","38562","2020",102,33,69,151256.5,2111.598,71.17647
"13241","38563","2020",386,80,306,163355.1,2213.158,72.36528
"13242","38564","2020",3,3,0,198283.3,1654.667,132
"13243","38565","2020",123,55,68,219969.9,2623.577,82.65854
"13244","38566","2020",18,17,1,283489.9,2539.389,112.1111
"13245","38567","2020",121,4,117,74218.7,2089.074,34.80992
"13246","39001","2020",12,12,0,128869.2,1290.833,103.0833
"13247","39002","2020",1,1,0,90000,968,93
"13248","39006","2020",2,2,0,122050,846,144
"13249","39008","2020",6,6,0,207975,1313.5,154.1667
"13250","39009","2020",5,5,0,121560,1075.6,110
"13251","39010","2020",3,3,0,129000,1389.667,89.66667
"13252","39011","2020",7,7,0,121728.6,1053.857,129.8571
"13253","39013","2020",45,35,10,109781.8,1240.489,87.4
"13254","39014","2020",2,2,0,235000,1605.5,144
"13255","39015","2020",1,1,0,204550,1311,156
"13256","39016","2020",15,13,2,73766.67,867,86.86667
"13257","39017","2020",13,13,0,142059.6,1241.692,114
"13258","39018","2020",7,7,0,226142.9,1821.429,126.5714
"13259","39019","2020",1,1,0,251000,1793,140
"13260","39020","2020",1,1,0,134500,830,162
"13261","39021","2020",3,3,0,124633.3,1343.667,110.3333
"13262","39022","2020",3,3,0,117833.3,1265,110.3333
"13263","39024","2020",6,6,0,118081.7,1727.333,72.33333
"13264","39026","2020",3,1,2,86500,1322.667,63
"13265","39027","2020",3,3,0,83333.33,1131.333,78.66667
"13266","39028","2020",3,3,0,195983.3,1470.667,136
"13267","39029","2020",4,4,0,138825,1328.25,110
"13268","39030","2020",10,9,1,122760,1427.2,86
"13269","39032","2020",4,4,0,170625,1918.25,90.25
"13270","39034","2020",3,3,0,146173.3,1556.667,94.66667
"13271","39035","2020",5,5,0,108000,1166,89.4
"13272","39037","2020",2,2,0,149750,1327.5,109.5
"13273","39038","2020",2,2,0,108750,1170,87.5
"13274","39039","2020",2,2,0,142500,2096.5,71.5
"13275","39040","2020",2,2,0,229000,1924.5,124.5
"13276","39041","2020",2,2,0,119500,1435,84
"13277","39042","2020",7,6,1,252051.4,2278.714,110.1429
"13278","39043","2020",21,19,2,146921.4,1201.048,121.619
"13279","39045","2020",1,1,0,275000,1455,189
"13280","39047","2020",7,1,6,105442.9,2065.286,47.57143
"13281","39048","2020",1,1,0,143000,1416,101
"13282","39049","2020",4,4,0,144637.5,1418.25,108
"13283","39050","2020",6,5,1,100166.7,884.1667,122.1667
"13284","39051","2020",1,1,0,196000,1661,118
"13285","39052","2020",1,1,0,63000,875,72
"13286","39053","2020",5,5,0,219500,1914,127
"13287","39054","2020",3,3,0,193433.3,1421.667,137.3333
"13288","39055","2020",1,1,0,71000,645,110
"13289","39056","2020",16,15,1,144494.2,1457.75,106.125
"13290","39058","2020",2,2,0,60000,853.5,79
"13291","39059","2020",24,9,15,187514.6,2359.25,80.70833
"13292","39061","2020",1,0,1,178500,1275,140
"13293","39062","2020",1,1,0,212000,1134,187
"13294","39063","2020",2,2,0,142000,957.5,166.5
"13295","39066","2020",3,3,0,103666.7,1141,95.33333
"13296","39068","2020",9,9,0,161119.4,2029.444,96.88889
"13297","39070","2020",1,1,0,60000,1000,60
"13298","39072","2020",6,4,2,101706.7,1221.833,89.33333
"13299","39073","2020",3,3,0,234500,1717.667,141
"13300","39074","2020",3,3,0,140000,1462,86
"13301","39076","2020",1,1,0,199500,1662,120
"13302","39077","2020",1,1,0,80000,537,149
"13303","39078","2020",10,10,0,183835.6,1678,108.7
"13304","39079","2020",2,2,0,232000,1960.5,128
"13305","39081","2020",2,2,0,169350,1308,125.5
"13306","39083","2020",3,3,0,206637.7,1766.333,119
"13307","39085","2020",1,1,0,349000,1939,180
"13308","39086","2020",4,4,0,119534,996.25,115.75
"13309","39088","2020",5,5,0,112100,943.2,116.6
"13310","39090","2020",5,5,0,173720,1466,120.2
"13311","39092","2020",6,6,0,105166.7,805.1667,137
"13312","39093","2020",7,7,0,176795.9,1413.429,124.1429
"13313","39095","2020",2,2,0,167500,1517.5,114.5
"13314","39096","2020",5,5,0,136250,1581.4,90.4
"13315","39097","2020",99,36,63,112800.8,1402.848,80.21212
"13316","39099","2020",3,3,0,91666.67,961.3333,96.66667
"13317","39100","2020",2,2,0,158750,1278,159
"13318","39101","2020",15,14,1,160913.3,1730.933,96.13333
"13319","39102","2020",7,7,0,169285.7,1762.857,97.57143
"13320","39103","2020",2,2,0,163000,1841.5,88.5
"13321","39104","2020",8,8,0,124240,1271.75,97.375
"13322","39105","2020",3,2,1,43333.33,423.3333,102.3333
"13323","39106","2020",5,5,0,154000,1302.2,101.4
"13324","39107","2020",1,1,0,101400,984,103
"13325","39109","2020",3,3,0,141666.7,1467,96.66667
"13326","39110","2020",1,1,0,106000,1178,90
"13327","39112","2020",2,2,0,201500,1751,131.5
"13328","39114","2020",3,3,0,333666.7,2884.333,115
"13329","39118","2020",2,2,0,74309.5,684,117.5
"13330","39119","2020",1,1,0,133000,1064,125
"13331","39121","2020",6,6,0,139341.7,1207.667,109
"13332","39122","2020",3,3,0,174816.7,1118.667,154.6667
"13333","39124","2020",12,12,0,136041.7,1294.167,117.5
"13334","39126","2020",4,4,0,184087.5,2060.25,91.25
"13335","39128","2020",13,13,0,138930.8,1392.385,97.38462
"13336","39129","2020",5,4,1,102690,1078.4,106.8
"13337","39130","2020",9,8,1,179645.6,1745.444,120.3333
"13338","39131","2020",6,5,1,130213.3,1534.167,82.83333
"13339","39133","2020",2,1,1,134875,1026.5,143
"13340","39134","2020",4,4,0,143825,1291,110.25
"13341","39137","2020",5,5,0,120200,1098.4,112.8
"13342","39138","2020",2,2,0,106570,1250,85
"13343","39141","2020",4,4,0,118625,1085.25,114.75
"13344","39142","2020",1,1,0,52000,693,75
"13345","39145","2020",1,1,0,196500,1665,118
"13346","39146","2020",11,10,1,198008.2,1701.545,114.1818
"13347","39149","2020",4,4,0,164475,1515.5,109
"13348","39150","2020",11,10,1,178000,1840.909,93.18182
"13349","39151","2020",2,2,0,124000,1496.5,80
"13350","39153","2020",8,8,0,211412.5,2030.25,103.75
"13351","39154","2020",8,6,2,118481.2,1137.75,106.375
"13352","39155","2020",3,3,0,156000,1140.667,136.6667
"13353","39156","2020",2,2,0,113550,1178.5,99.5
"13354","39159","2020",2,2,0,134500,1168.5,117
"13355","39160","2020",14,14,0,144527.4,1316.286,111.7857
"13356","39162","2020",1,1,0,182500,1547,118
"13357","39163","2020",1,1,0,61000,693,88
"13358","39164","2020",11,10,1,125716.4,1038.364,117.7273
"13359","39166","2020",5,5,0,82948,997,81
"13360","39167","2020",6,6,0,141990,1420.5,106.3333
"13361","39169","2020",8,6,2,146112.5,1178,146.125
"13362","39170","2020",5,5,0,261284,1989,127.4
"13363","39171","2020",16,16,0,168546.2,1502,112.375
"13364","39172","2020",2,1,1,238900,1692.5,145
"13365","39173","2020",30,27,3,91843,1045.967,91.6
"13366","39174","2020",1,1,0,153100,1701,90
"13367","39175","2020",2,2,0,133300,1290.5,106.5
"13368","39176","2020",4,4,0,149250,1335.5,112.5
"13369","39177","2020",9,9,0,154827.8,1395.667,109.3333
"13370","39178","2020",1,1,0,228000,1754,130
"13371","39179","2020",1,1,0,130000,1711,76
"13372","39180","2020",4,4,0,103375,1035.5,99.5
"13373","39182","2020",9,7,2,166422.2,1544.333,112.3333
"13374","39183","2020",7,6,1,137191.4,1356.571,105
"13375","39184","2020",2,2,0,77500,795.5,99
"13376","39185","2020",2,2,0,109500,968.5,112.5
"13377","39187","2020",1,1,0,280500,1576,178
"13378","39188","2020",3,3,0,168500,1160,158.3333
"13379","39189","2020",43,42,1,136204.2,1507.442,93.2093
"13380","39190","2020",13,11,2,142926.9,1359.692,106.7692
"13381","39192","2020",1,1,0,83000,755,110
"13382","39193","2020",19,19,0,131181.5,1378.842,100.0526
"13383","39194","2020",3,3,0,156453.3,1420,110.6667
"13384","39196","2020",1,1,0,48000,600,80
"13385","39197","2020",2,2,0,77000,857.5,86
"13386","39198","2020",330,157,173,131059.8,1549.482,85.22424
"13387","39199","2020",10,10,0,155725,1676.3,94.2
"13388","39200","2020",3,3,0,41666.67,612,62.66667
"13389","39201","2020",6,6,0,106828.3,1466.167,79.33333
"13390","39205","2020",4,4,0,147415,3091.5,95
"13391","39206","2020",1,1,0,121000,1440,84
"13392","39207","2020",2,2,0,182900,2011.5,134.5
"13393","39208","2020",2,2,0,236950,1911,122.5
"13394","39209","2020",10,10,0,105992,1049.3,103.8
"13395","39210","2020",6,6,0,173383.3,1514,124.5
"13396","39211","2020",2,2,0,128500,1177,114
"13397","39214","2020",2,2,0,172500,820,195.5
"13398","39216","2020",1,1,0,79000,859,92
"13399","39217","2020",4,3,1,161375,1246.25,126.75
"13400","39218","2020",4,4,0,129500,1219.25,107.75
"13401","39219","2020",6,4,2,191900,1715.5,119.6667
"13402","39220","2020",5,5,0,158655,1111.6,150
"13403","39221","2020",1,1,0,144000,1694,85
"13404","39222","2020",2,2,0,93500,551.5,138.5
"13405","39223","2020",1,0,1,49000,1089,45
"13406","39225","2020",2,2,0,143800,1397.5,102
"13407","39227","2020",7,3,4,66271.43,1009.857,64.71429
"13408","39228","2020",19,12,7,143036.8,1712.842,89.42105
"13409","39229","2020",1,1,0,67500,776,87
"13410","39230","2020",1,1,0,150000,1293,116
"13411","39232","2020",4,4,0,219490,2374.75,94.75
"13412","39233","2020",35,27,8,158454,1657.4,94.34286
"13413","39235","2020",15,11,4,144855.4,1554.267,97.13333
"13414","39236","2020",2,2,0,193600,1364.5,143.5
"13415","39237","2020",1,1,0,175000,1591,110
"13416","39239","2020",1,1,0,50000,385,130
"13417","39241","2020",2,2,0,97350,1246,82
"13418","39244","2020",4,4,0,115250,1009.75,107.5
"13419","39245","2020",3,3,0,167666.7,1370,126
"13420","39246","2020",3,3,0,158500,1484,115
"13421","39249","2020",1,1,0,149250,2073,72
"13422","39250","2020",2,2,0,219802.5,1831.5,120
"13423","39251","2020",4,4,0,147450,1595,90
"13424","39252","2020",6,5,1,147783.3,1810.667,84.83333
"13425","39253","2020",3,3,0,102333.3,1216.333,76.66667
"13426","39254","2020",1,1,0,45000,562,80
"13427","39255","2020",2,2,0,40500,1178.5,34
"13428","39258","2020",7,7,0,202478.6,1984.143,111
"13429","39259","2020",1,1,0,30000,698,43
"13430","39261","2020",3,3,0,135166.7,1070,125.3333
"13431","39262","2020",2,2,0,65000,1158,53
"13432","39263","2020",4,4,0,138000,1468.75,90.5
"13433","39266","2020",3,3,0,114666.7,1399.667,85.33333
"13434","39269","2020",2,2,0,137250,1317,94.5
"13435","39270","2020",6,5,1,164175,1784.167,91
"13436","39271","2020",5,5,0,210690,1883.8,130.6
"13437","39273","2020",5,5,0,113300,1125,97.8
"13438","39274","2020",3,3,0,309653,2245,157
"13439","39275","2020",15,8,7,178954,2554.667,71.93333
"13440","39277","2020",1,1,0,170000,1491,114
"13441","39278","2020",1,1,0,325000,1555,209
"13442","39279","2020",2,2,0,151000,1533.5,98.5
"13443","39280","2020",3,2,1,112333.3,908,127
"13444","39282","2020",1,1,0,241300,1557,155
"13445","39283","2020",8,8,0,194830,1974.125,101.5
"13446","39285","2020",4,4,0,177887.5,1370.75,127.25
"13447","39286","2020",17,12,5,129426.5,1180.176,112.7647
"13448","39288","2020",4,4,0,130375,1391,91.25
"13449","39289","2020",3,3,0,103316.7,1125.333,96
"13450","39290","2020",2,2,0,88000,964,101
"13451","39291","2020",2,2,0,142100,1880,77
"13452","39293","2020",8,8,0,158440,1500,107.75
"13453","39295","2020",2,2,0,80175,709.5,115.5
"13454","39297","2020",13,12,1,184224.6,1796.692,100.0769
"13455","39298","2020",1,1,0,234000,1560,150
"13456","39299","2020",7,7,0,101321.4,1235.714,85.42857
"13457","39300","2020",249,69,180,126063,1546.386,82.28916
"13458","39301","2020",2,2,0,165300,1665.5,103
"13459","39302","2020",1,1,0,230000,2000,115
"13460","39304","2020",2,2,0,212000,1544,137
"13461","39305","2020",7,7,0,179871.4,1425.286,124.7143
"13462","39306","2020",9,9,0,148723,1701.556,90.33333
"13463","39307","2020",5,5,0,194647,1829.6,113.4
"13464","39308","2020",4,4,0,187750,1560,122.25
"13465","39310","2020",7,7,0,85642.86,1030.143,98.42857
"13466","39312","2020",4,4,0,98275,1117.5,94.25
"13467","39313","2020",1,1,0,175000,2273,77
"13468","39314","2020",1,1,0,210000,1556,135
"13469","39315","2020",3,3,0,145666.7,1327.667,115
"13470","39317","2020",11,11,0,131927.3,1036.727,124.4545
"13471","39318","2020",1,1,0,53000,716,74
"13472","39319","2020",1,1,0,142000,1060,134
"13473","39320","2020",2,2,0,76250,573.5,121
"13474","39321","2020",1,1,0,202000,1836,110
"13475","39323","2020",6,6,0,72200,827.5,89.83333
"13476","39325","2020",5,5,0,137235,1249.2,113.2
"13477","39327","2020",5,5,0,194196,1761,111.8
"13478","39328","2020",2,2,0,191900,2014,96
"13479","39329","2020",1,1,0,40000,417,96
"13480","39331","2020",8,7,1,220397.6,1583,141.125
"13481","39333","2020",10,5,5,96547,1094.8,90.6
"13482","39334","2020",2,2,0,278431,1950.5,139.5
"13483","39335","2020",5,5,0,73560,974.2,77.6
"13484","39336","2020",3,3,0,136583.3,963.6667,134
"13485","39338","2020",4,4,0,147250,1353,111.25
"13486","39339","2020",6,5,1,173175,1410.333,113.8333
"13487","39342","2020",3,3,0,56833.33,591.6667,81.66667
"13488","39344","2020",3,2,1,120383.3,1111.667,126.3333
"13489","39345","2020",5,5,0,194590,1575.8,141.4
"13490","39346","2020",3,3,0,193553.3,1370.333,152
"13491","39348","2020",7,7,0,149157.1,1571.429,95
"13492","39350","2020",2,1,1,70000,679.5,102.5
"13493","39351","2020",1,1,0,155300,1635,95
"13494","39352","2020",1,1,0,182000,1957,93
"13495","39353","2020",5,5,0,123552,984.4,130
"13496","39354","2020",4,4,0,150487.5,1285,124.25
"13497","39356","2020",2,2,0,115920,1096.5,150.5
"13498","39360","2020",1,1,0,45000,833,54
"13499","39361","2020",3,3,0,163183.3,1120,147
"13500","39362","2020",39,25,14,127230.1,1511.59,85.17949
"13501","39363","2020",4,4,0,37250,538.25,77
"13502","39364","2020",11,7,4,151030.3,1351,114.6364
"13503","39365","2020",13,10,3,148843.1,1408.077,105.8462
"13504","39366","2020",2,2,0,197625,1872,105
"13505","39367","2020",25,15,10,180481,1772.2,103.28
"13506","39368","2020",69,16,53,103563.7,1264.188,79.46377
"13507","39370","2020",11,11,0,114610,1087.455,115.5455
"13508","39373","2020",3,3,0,230333.3,1627.667,138.3333
"13509","39375","2020",2,2,0,85050,625.5,120
"13510","39377","2020",3,3,0,172666.7,1221.333,141.6667
"13511","39378","2020",8,8,0,85987.5,913.75,93.375
"13512","39379","2020",5,5,0,156264,1473.4,112
"13513","39381","2020",4,4,0,175072.5,1836,99.25
"13514","39385","2020",12,12,0,80916.67,1073.583,80.08333
"13515","39386","2020",1,1,0,224000,1736,129
"13516","39387","2020",2,2,0,175228.5,1437.5,121.5
"13517","39388","2020",6,6,0,175316.7,1488.333,124.5
"13518","39389","2020",4,3,1,184625,1426,120.25
"13519","39390","2020",1,1,0,110000,743,148
"13520","39391","2020",2,1,1,103880,1245,74.5
"13521","39392","2020",5,2,3,110900,1125.2,90.8
"13522","39393","2020",2,2,0,138565,1271.5,114.5
"13523","39394","2020",1,1,0,42000,447,94
"13524","39396","2020",13,13,0,152401.5,1432.615,119.4615
"13525","39397","2020",16,15,1,109606.2,1217.75,88.3125
"13526","39398","2020",11,10,1,163079.3,1359,124.1818
"13527","39399","2020",1,1,0,239500,1842,130
"13528","39400","2020",4,4,0,183775,1649.25,111
"13529","39401","2020",2,2,0,93000,1078,87.5
"13530","39402","2020",3,2,1,146600,1896,75.33333
"13531","39403","2020",1,1,0,130000,1512,86
"13532","39404","2020",7,6,1,124828.6,1306.571,107.1429
"13533","39405","2020",8,8,0,134000,1347.25,98
"13534","39406","2020",2,1,1,106650,889.5,122
"13535","39407","2020",4,4,0,175432.5,1577.25,108.5
"13536","39408","2020",2,1,1,98200,1580,59
"13537","39409","2020",2,2,0,76000,693,104
"13538","39411","2020",23,15,8,134596.1,1355.087,101.8696
"13539","39412","2020",2,2,0,68495,846.5,83
"13540","39413","2020",4,4,0,290742.5,2258.75,133.25
"13541","39415","2020",16,16,0,120917.8,1255.062,99.0625
"13542","39420","2020",5,5,0,114600,1156.8,111
"13543","39421","2020",2,2,0,166412,1626.5,109
"13544","39422","2020",3,3,0,230966.7,1912.667,121
"13545","39424","2020",2,2,0,92229,628.5,154
"13546","39426","2020",1,1,0,143110,906,158
"13547","39429","2020",5,5,0,129835,1367.6,91.8
"13548","39431","2020",2,2,0,209750,2004.5,113
"13549","39432","2020",2,2,0,100550,956,108
"13550","39434","2020",37,28,9,119291.6,1312.351,90.48649
"13551","39435","2020",10,7,3,102200,1469.8,68
"13552","39436","2020",2,2,0,174000,1491.5,119.5
"13553","39437","2020",5,5,0,117706,1623.2,82.8
"13554","39439","2020",8,6,2,176250,1828,93.875
"13555","39441","2020",54,18,36,157361.7,2888.648,52.85185
"13556","39443","2020",1,1,0,91500,1204,76
"13557","39446","2020",4,4,0,240963.2,1932.5,123.5
"13558","39447","2020",1,1,0,219800,2134,103
"13559","39448","2020",4,4,0,101082.8,1061.75,105
"13560","39449","2020",4,4,0,231812.5,1587.5,146.75
"13561","39451","2020",5,5,0,130040,1261.2,105.4
"13562","39452","2020",8,8,0,123900,1351.875,89.75
"13563","39453","2020",4,3,1,137900,1046.25,126.75
"13564","39454","2020",1,1,0,158000,1264,125
"13565","39456","2020",5,5,0,105530,1306,80.4
"13566","39457","2020",1,1,0,202500,1985,102
"13567","39458","2020",4,4,0,162500,1041.75,133.25
"13568","39460","2020",2,2,0,226495,2300,97.5
"13569","39462","2020",6,6,0,154416.7,1275.333,134
"13570","39463","2020",2,2,0,96000,940.5,101.5
"13571","39464","2020",3,3,0,190083.3,1895.333,104.6667
"13572","39465","2020",3,3,0,101666.7,964.6667,121
"13573","39466","2020",3,3,0,73333.33,981.6667,76
"13574","39467","2020",6,6,0,131133.3,1191.833,114.8333
"13575","39468","2020",4,4,0,93360,1214.5,78
"13576","39469","2020",2,2,0,173250,1371.5,123.5
"13577","39470","2020",15,5,10,300646,2467.667,113.2667
"13578","39471","2020",6,6,0,181000,1361,125.1667
"13579","39472","2020",6,6,0,148225,1110.5,133.6667
"13580","39474","2020",1,1,0,130560,1788,73
"13581","39475","2020",39,33,6,143887.4,1211.231,121.7179
"13582","39476","2020",15,14,1,152981.7,1506.733,104.0667
"13583","39477","2020",1,1,0,123500,1300,95
"13584","39478","2020",83,25,58,89419.34,996.6867,84.6747
"13585","39479","2020",1,1,0,120000,816,147
"13586","39480","2020",4,4,0,188850,1860.75,113.5
"13587","39481","2020",4,4,0,185300,1115.75,166.75
"13588","39485","2020",14,14,0,113958.6,1100.5,102.7143
"13589","39487","2020",23,13,10,179503.9,2241.565,84.21739
"13590","39489","2020",6,6,0,103883.3,1006.167,119.6667
"13591","39490","2020",2,2,0,121500,1321,92.5
"13592","39491","2020",14,10,4,134642.9,1233.929,111.8571
"13593","39492","2020",3,3,0,167583.3,1645.667,107.6667
"13594","39493","2020",7,7,0,118085.7,955,119
"13595","39494","2020",2,2,0,186500,1199,155.5
"13596","39497","2020",1,1,0,125000,962,130
"13597","39498","2020",6,6,0,197583.3,2018,100.5
"13598","39499","2020",1,1,0,226100,788,287
"13599","39500","2020",33,14,19,100465.2,1109.97,94.0303
"13600","39501","2020",18,16,2,165263.9,1559.222,110.0556
"13601","39502","2020",2,1,1,57500,614,99
"13602","39503","2020",2,2,0,206000,1823,114
"13603","39504","2020",4,4,0,92000,1115.75,88.25
"13604","39507","2020",1,1,0,67500,696,97
"13605","39508","2020",6,6,0,120116.7,1227,96.16667
"13606","39510","2020",10,6,4,204300,1765.9,109.6
"13607","39511","2020",1,1,0,152000,1152,132
"13608","39512","2020",2,2,0,194350,1610,163
"13609","39513","2020",3,3,0,240426.7,1740.667,147.6667
"13610","39514","2020",1,1,0,90000,500,180
"13611","39517","2020",6,6,0,106161.2,957.3333,119.3333
"13612","39519","2020",1,1,0,178000,1728,103
"13613","39520","2020",5,4,1,113800,926,126
"13614","39522","2020",2,2,0,291500,1882.5,156
"13615","39525","2020",7,7,0,131678.6,1081.571,135.7143
"13616","39526","2020",45,40,5,137128.7,1382.044,100.5333
"13617","39527","2020",2,2,0,144900,2026,79
"13618","39528","2020",3,3,0,146366.7,834.3333,178.3333
"13619","39529","2020",1,1,0,67980,544,125
"13620","39530","2020",5,5,0,138500,1336.6,106.4
"13621","39531","2020",2,2,0,127000,752.5,144.5
"13622","39532","2020",1,1,0,187700,1935,97
"13623","39534","2020",4,4,0,199767.5,2193.75,92.25
"13624","39535","2020",3,3,0,152000,1637,94.66667
"13625","39537","2020",4,4,0,161393.8,1178.75,135.75
"13626","39538","2020",2,2,0,237550,1440.5,162.5
"13627","39539","2020",4,4,0,131500,1222,109.5
"13628","39540","2020",1,1,0,67000,931,72
"13629","39543","2020",1,1,0,115000,858,134
"13630","39545","2020",2,2,0,59500,630,94
"13631","39546","2020",3,3,0,277400,1971.667,161.3333
"13632","39547","2020",5,5,0,134402,1306.4,105.8
"13633","39550","2020",3,3,0,133366.7,876,167.6667
"13634","39551","2020",3,3,0,26166.67,517,51.33333
"13635","39552","2020",3,3,0,291966.7,2116.333,135.6667
"13636","39553","2020",1,1,0,63000,863,73
"13637","39554","2020",2,2,0,216000,2399.5,88
"13638","39555","2020",4,4,0,162795,1277.5,135.25
"13639","39557","2020",3,3,0,77000,953,80.66667
"13640","39558","2020",3,3,0,235733.3,1243,194.3333
"13641","39559","2020",2,2,0,131850,1579.5,89
"13642","39560","2020",4,4,0,153750,1256,122.5
"13643","39561","2020",6,5,1,111666.7,1203,95
"13644","39567","2020",3,2,1,138933.3,1664.333,82.66667
"13645","39569","2020",5,5,0,162090,1249.4,133.2
"13646","39570","2020",3,3,0,162016.7,1059,151
"13647","39571","2020",2,2,0,138625,929,153
"13648","39572","2020",2,2,0,158650,2086,79
"13649","39573","2020",10,8,2,167000,1511.8,108.8
"13650","39574","2020",12,11,1,123603.3,1129.333,118.1667
"13651","39576","2020",12,12,0,147695.8,1349.583,114.6667
"13652","39577","2020",6,6,0,183083.3,1462,122.8333
"13653","39579","2020",9,9,0,171788.9,1681.444,108.4444
"13654","39581","2020",5,4,1,113760,1182.4,97
"13655","39582","2020",7,7,0,186714.3,1792.286,105.5714
"13656","39583","2020",1,1,0,80200,1337,60
"13657","39584","2020",2,2,0,226850,1568,144
"13658","39586","2020",1,1,0,25000,373,67
"13659","40001","2020",113,84,29,129095.3,1442.717,94.17699
"13660","40002","2020",25,25,0,178854.4,1548.24,119.12
"13661","40004","2020",37,25,12,340467.8,3656.919,93.56757
"13662","40005","2020",5,5,0,92480,836,127.4
"13663","40006","2020",4,4,0,179252.5,1607.5,112
"13664","40007","2020",5,5,0,157932,1213,137.6
"13665","40011","2020",2,2,0,99500,1108,90.5
"13666","40012","2020",2,2,0,280000,2723,98
"13667","40013","2020",2,2,0,248550.5,956,248.5
"13668","40014","2020",6,6,0,128500.8,1317,96.83333
"13669","40015","2020",2,2,0,97266,1122,100
"13670","40016","2020",6,6,0,112550,1228.833,93.5
"13671","40017","2020",3,3,0,209890,1443,151
"13672","40018","2020",3,3,0,197483.3,2238,90.33333
"13673","40019","2020",23,18,5,170530,2374.87,70.95652
"13674","40020","2020",8,8,0,192125,1970.25,105
"13675","40021","2020",27,27,0,227230.8,2845.852,81.96296
"13676","40022","2020",3,3,0,121416.7,1276.667,96.66667
"13677","40023","2020",3,3,0,107670,1429.333,75
"13678","40024","2020",2,2,0,204505,1564,143
"13679","40025","2020",12,12,0,216884.8,1857.167,122
"13680","40026","2020",7,7,0,185026.9,1424.714,133
"13681","40027","2020",1,1,0,129000,1554,83
"13682","40028","2020",3,3,0,158033.3,1309.333,121.6667
"13683","40029","2020",4,4,0,127450,1078.75,120
"13684","40031","2020",13,13,0,171556.2,1914.231,92.23077
"13685","40032","2020",6,6,0,158480,1573.833,105.3333
"13686","40033","2020",3,3,0,207666.7,2011.333,107
"13687","40034","2020",6,6,0,174200,1606,125.6667
"13688","40035","2020",5,5,0,158018,1813.8,107.2
"13689","40036","2020",50,35,15,263575.2,3179.96,86.86
"13690","40037","2020",20,20,0,223169.5,2032.5,114.5
"13691","40038","2020",1,1,0,120110,953,126
"13692","40039","2020",1,1,0,99000,943,105
"13693","40040","2020",3,3,0,218666.7,1467.667,146.6667
"13694","40041","2020",2,2,0,184500,1464,124.5
"13695","40042","2020",3,3,0,235886.7,3095.333,76
"13696","40043","2020",29,25,4,151390.9,1984.621,75.24138
"13697","40044","2020",12,10,2,296445,2415.75,122.8333
"13698","40046","2020",433,251,182,258908.3,3330.873,80.26328
"13699","40047","2020",2,2,0,91500,1117.5,90
"13700","40049","2020",6,6,0,146283.3,1589.667,94
"13701","40050","2020",4,4,0,152850,1304.5,122.5
"13702","40051","2020",11,11,0,205395.5,1928.091,108.1818
"13703","40052","2020",4,4,0,189500,1363,139.75
"13704","40053","2020",4,4,0,125950,1479.75,86.25
"13705","40054","2020",6,6,0,138066.7,1174.333,111
"13706","40055","2020",14,14,0,211283.4,2437.071,99.5
"13707","40056","2020",7,7,0,191243.3,1742.286,110.8571
"13708","40058","2020",4,4,0,190367.2,1179.25,169.5
"13709","40059","2020",12,12,0,242772.9,2055.583,126.0833
"13710","40060","2020",3,3,0,178333.3,2199.667,81.66667
"13711","40061","2020",8,7,1,207066.5,1651.5,136.875
"13712","40062","2020",10,10,0,175333.2,1876.8,96.4
"13713","40063","2020",8,7,1,175250,1824.125,100.125
"13714","40064","2020",4,3,1,124262.5,1337.25,92.25
"13715","40065","2020",331,141,190,338902.7,5405.094,65.03625
"13716","40066","2020",6,6,0,176675,1607.5,115.1667
"13717","40067","2020",5,5,0,205230,1635.6,123
"13718","40068","2020",7,7,0,170871.1,1781.857,93.71429
"13719","40069","2020",5,5,0,160054,1405.6,116
"13720","40070","2020",8,8,0,142937.5,1128.125,143
"13721","40071","2020",10,10,0,130623.7,1277.7,107.8
"13722","40072","2020",1,1,0,65000,392,166
"13723","40073","2020",2,2,0,147250,990.5,141.5
"13724","40074","2020",6,6,0,146066.3,1512.5,96.16667
"13725","40075","2020",33,32,1,217297,2266.97,98.84848
"13726","40076","2020",1,1,0,252000,1969,128
"13727","40077","2020",11,11,0,283590.9,2380.545,124.9091
"13728","40078","2020",5,5,0,168253,1608.2,121.2
"13729","40080","2020",21,21,0,142372.9,1358.667,108.5714
"13730","40081","2020",6,6,0,193085,1552.833,137.6667
"13731","40082","2020",3,3,0,182333.3,1640.333,112
"13732","40083","2020",1,1,0,130000,828,157
"13733","40084","2020",4,4,0,166148.8,1353.75,127.25
"13734","40085","2020",7,7,0,160932.1,1471.429,139
"13735","40086","2020",3,3,0,191633.3,1667.333,116
"13736","40087","2020",4,4,0,177775,1341.5,140.75
"13737","40088","2020",552,167,385,138453.3,2161.817,65.66123
"13738","40089","2020",8,8,0,139768.8,1126.5,139.875
"13739","40090","2020",12,12,0,137762.5,1144.417,122.25
"13740","40091","2020",5,5,0,151800,1521.8,102.4
"13741","40092","2020",3,3,0,163000,1545,109.6667
"13742","40093","2020",2,2,0,107500,1458,71.5
"13743","40094","2020",10,10,0,221655.2,1947.9,115.8
"13744","40095","2020",3,3,0,213610,1955,109
"13745","40096","2020",1,1,0,131300,1751,75
"13746","40097","2020",8,3,5,132487.5,1747.75,82.125
"13747","40098","2020",3,3,0,129666.7,1236,102.6667
"13748","40099","2020",3,3,0,97166.67,845.6667,123.3333
"13749","40100","2020",4,4,0,126250,1347.5,90.75
"13750","40101","2020",5,5,0,220230,1802.6,121.4
"13751","40102","2020",16,15,1,119875,1154.125,95.1875
"13752","40103","2020",7,7,0,131071.4,1550.143,85.71429
"13753","40104","2020",23,23,0,212182,1949.043,112.1739
"13754","40105","2020",6,6,0,164733.3,1329.833,141.6667
"13755","40106","2020",1,1,0,260800,1144,228
"13756","40108","2020",14,14,0,214405.3,2551,84
"13757","40109","2020",2,2,0,141250,1535.5,93.5
"13758","40110","2020",11,11,0,147036.5,1116.091,127
"13759","40111","2020",9,9,0,193766.7,1717.333,113.1111
"13760","40113","2020",9,9,0,178233.3,1596.778,121.2222
"13761","40114","2020",5,5,0,313840,2206.2,141.2
"13762","40115","2020",3,3,0,214865.3,1791.667,120
"13763","40116","2020",4,4,0,144225,1583.25,91.5
"13764","40117","2020",28,25,3,137720.8,1417.179,103.2857
"13765","40118","2020",21,21,0,212852,1688.952,133.2381
"13766","40119","2020",71,62,9,149655.9,1529.085,101.7042
"13767","40120","2020",12,12,0,226779.9,1715.167,123.75
"13768","40121","2020",3,3,0,135583.3,1075,128
"13769","40122","2020",9,9,0,179957.8,1754,101.7778
"13770","40123","2020",15,15,0,246023.1,2320.733,106.2
"13771","40124","2020",3,3,0,166466.7,1419,109
"13772","40125","2020",12,12,0,171519.1,1727.667,100.75
"13773","40126","2020",31,30,1,215502.5,2044.903,112.2581
"13774","40127","2020",10,10,0,138619.2,1308.9,113.2
"13775","40128","2020",11,11,0,182965.7,1421.636,128.6364
"13776","40129","2020",12,12,0,220428,2533.583,96.91667
"13777","40131","2020",7,7,0,130414.3,1346.143,99
"13778","40132","2020",19,18,1,166510,1505.947,111.7368
"13779","40133","2020",102,73,29,330879.8,3914.118,84.68627
"13780","40134","2020",31,31,0,168525.9,1686.839,105.5161
"13781","40135","2020",12,12,0,130266.7,1344.75,98.83333
"13782","40137","2020",12,12,0,197316.8,1719.917,118.4167
"13783","40138","2020",5,5,0,126894,1377.4,92.2
"13784","40139","2020",5,5,0,208417.6,1497,145.6
"13785","40140","2020",1,1,0,148000,1057,140
"13786","40141","2020",2,2,0,170000,1835,96
"13787","40142","2020",13,13,0,168653.8,1588.538,118.3077
"13788","40143","2020",4,4,0,134762.5,1320.25,107.5
"13789","40145","2020",9,9,0,178366.7,1507.222,120.5556
"13790","40146","2020",2,2,0,175525,1115.5,175
"13791","40147","2020",6,6,0,145000,1530.5,95.16667
"13792","40149","2020",9,9,0,125226.7,1116.778,128.1111
"13793","40150","2020",67,37,30,181785.2,2653.224,67.65672
"13794","40151","2020",7,7,0,171714.3,1553.857,112.7143
"13795","40152","2020",21,20,1,173035.1,1585.19,113
"13796","40153","2020",2,2,0,146750,1583.5,92.5
"13797","40154","2020",3,3,0,251000,2261,125.3333
"13798","40155","2020",26,24,2,232903,2460.654,99.96154
"13799","40156","2020",2,2,0,137500,1231,112
"13800","40157","2020",42,24,18,208622.5,2469,81.21429
"13801","40158","2020",2,2,0,232500,1506,146
"13802","40159","2020",8,7,1,169781.2,2067.875,82.375
"13803","40160","2020",3,3,0,198775.7,2480,87
"13804","40161","2020",2,2,0,103250,1030,113.5
"13805","40162","2020",9,9,0,184653.3,1701.667,107.5556
"13806","40163","2020",7,7,0,190514.3,1987.143,96
"13807","40164","2020",7,7,0,148337.1,1443,107.7143
"13808","40165","2020",8,8,0,156306.8,1682.125,102.5
"13809","40167","2020",9,9,0,156822.2,1682.444,96.77778
"13810","40168","2020",32,30,2,261269.8,2340.625,113.5
"13811","40170","2020",6,6,0,236516.7,1594.167,141
"13812","40171","2020",2,2,0,197499.5,1908.5,106.5
"13813","40172","2020",4,4,0,112850,1275.25,100.25
"13814","40173","2020",1,1,0,55046,519,106
"13815","40174","2020",1,1,0,64000,711,90
"13816","40175","2020",4,4,0,136820,1259.25,112.5
"13817","40176","2020",1,1,0,168000,1500,112
"13818","40177","2020",7,7,0,185901.4,1323,157.2857
"13819","40178","2020",4,4,0,230825,1236.75,171.75
"13820","40179","2020",31,31,0,233137.7,2076.516,114
"13821","40180","2020",16,16,0,189047.5,1844.625,104.5625
"13822","40181","2020",26,25,1,343250.2,3507.423,101.5
"13823","40182","2020",16,16,0,231038.1,2330.625,103.3125
"13824","40183","2020",15,15,0,189372.8,1662.467,112.6
"13825","40184","2020",206,126,80,202621.3,3061.33,72.48544
"13826","40185","2020",4,4,0,159750,1068.5,165.25
"13827","40186","2020",9,9,0,228947.8,1627.778,145.3333
"13828","40187","2020",144,65,79,192069.9,3561.833,54.5
"13829","40188","2020",8,8,0,153250,1292,122.75
"13830","40189","2020",2,2,0,130000,1358,101
"13831","40190","2020",4,4,0,220285.2,1971.25,109.5
"13832","40191","2020",8,8,0,149992.5,1595.125,94.75
"13833","40192","2020",495,260,235,138132.8,1861.931,74.72727
"13834","40194","2020",15,11,4,121812,1242.4,105.8667
"13835","40195","2020",5,3,2,153800,1385.4,112
"13836","40196","2020",4,4,0,262685.2,2264.75,115.5
"13837","40197","2020",70,69,1,161785.1,1689.486,98.44286
"13838","40198","2020",3,3,0,199666.7,1186,174.3333
"13839","40199","2020",3,3,0,174133.3,1581.333,108
"13840","40200","2020",7,7,0,255188.6,2708.429,111.2857
"13841","40201","2020",19,17,2,137696.3,1553.474,107.2632
"13842","40202","2020",41,38,3,211550.2,2092.976,104.1707
"13843","40203","2020",4,4,0,124242.5,997,128.5
"13844","40204","2020",5,5,0,175240,1370.4,130.2
"13845","40205","2020",2,2,0,140189.5,1302.5,106.5
"13846","40206","2020",4,4,0,192300,1351.75,158.75
"13847","40207","2020",10,10,0,260818,2021.1,130.2
"13848","40208","2020",3,3,0,189933.3,1400,130.6667
"13849","40209","2020",103,57,46,253783.3,3374.913,75.72816
"13850","40210","2020",10,10,0,215111,2005.6,106.8
"13851","40211","2020",11,9,2,209300,1762.182,119.9091
"13852","40212","2020",10,8,2,187859.9,1927.2,98
"13853","40213","2020",4,4,0,369687.5,3324,105.25
"13854","40214","2020",7,7,0,283050.3,1961.857,146.5714
"13855","40215","2020",6,6,0,170078.7,1447,124.6667
"13856","40216","2020",3,3,0,207081.7,1767,114.6667
"13857","40217","2020",154,128,26,225874,2427.539,94.87013
"13858","40218","2020",9,9,0,166420,1421.667,123.1111
"13859","40221","2020",4,4,0,163189.5,1385.75,115
"13860","40222","2020",11,11,0,306936.2,2459.364,125.8182
"13861","40223","2020",2,2,0,130900,1226.5,115
"13862","40224","2020",66,56,10,191093.1,1888.985,103.1667
"13863","40225","2020",2,2,0,2e+05,1987.5,122
"13864","40227","2020",16,15,1,187578.3,1904.938,114.125
"13865","40228","2020",15,15,0,168218.7,1334,141.8667
"13866","40229","2020",27,27,0,227276.8,2203.519,114.7037
"13867","40230","2020",36,29,7,172023.5,1892.583,91.77778
"13868","40231","2020",14,14,0,256228.6,2244.857,121
"13869","40232","2020",8,8,0,145975,1259.25,115.375
"13870","40233","2020",45,43,2,234365.4,1906.822,126.7778
"13871","40234","2020",16,16,0,156062.5,1481.125,105.625
"13872","40235","2020",12,11,1,119553.8,1406.167,84.75
"13873","40236","2020",6,6,0,184871.7,1637.833,115
"13874","40237","2020",12,12,0,187091.9,1613.833,122.3333
"13875","40238","2020",8,8,0,151031.2,1580.75,101.5
"13876","40239","2020",3,3,0,124912.3,801,166
"13877","40240","2020",4,3,1,173750,1324.25,136.75
"13878","40243","2020",47,46,1,178788.3,1698.043,107.5532
"13879","40244","2020",10,10,0,275161,2405.6,121
"13880","40245","2020",34,34,0,101158.8,1017.559,102.4706
"13881","40246","2020",18,18,0,129327.8,1453.833,95.22222
"13882","40247","2020",2,2,0,70000,842.5,83.5
"13883","40248","2020",24,23,1,357392.5,3073.25,119.3333
"13884","40249","2020",5,5,0,176771.2,1179.4,151
"13885","40250","2020",4,4,0,229625,1871.25,123.5
"13886","40251","2020",3,3,0,426583.3,2081,219.6667
"13887","40252","2020",9,9,0,179730,1556.889,124.3333
"13888","40253","2020",4,4,0,145500,1559.5,96
"13889","40254","2020",8,8,0,162556.2,1537.875,113.125
"13890","40255","2020",2,2,0,251000,1643.5,159.5
"13891","40256","2020",7,7,0,250290.3,2606.571,99.28571
"13892","40257","2020",16,16,0,207091.6,2670.688,78.875
"13893","40258","2020",1,1,0,163950,1763,93
"13894","40259","2020",3,3,0,82333.33,924.6667,87.33333
"13895","40260","2020",3,3,0,142333.3,1500.667,100
"13896","40261","2020",46,42,4,259501.8,2470.783,108
"13897","40262","2020",1,1,0,125000,1562,80
"13898","40263","2020",2,2,0,231000,1595,147.5
"13899","40264","2020",29,23,6,264740.8,2542.69,103.931
"13900","40266","2020",58,33,25,187637.9,2585.138,77.46552
"13901","40267","2020",19,17,2,169107.1,1419.105,129.0526
"13902","40268","2020",3,3,0,386666.7,2327,197.3333
"13903","40269","2020",12,11,1,226319.1,2102.25,107.5
"13904","40270","2020",5,5,0,151056,1315.2,124.8
"13905","40271","2020",9,9,0,287526.9,2480.444,117.5556
"13906","40272","2020",27,22,5,279956.8,2654.704,109.3333
"13907","40273","2020",69,44,25,299440.4,3060.464,98
"13908","40274","2020",16,16,0,185267.2,1754.875,108.4375
"13909","40275","2020",9,9,0,153376.3,1681.556,90.77778
"13910","40276","2020",9,9,0,271197.4,4141.444,95.77778
"13911","40277","2020",4,4,0,268750,2867,94.5
"13912","40278","2020",15,15,0,212142.2,2219.333,103.4
"13913","40279","2020",289,157,132,169140.6,2234.135,75.47405
"13914","40280","2020",45,20,25,124841.6,1694.556,72.68889
"13915","40281","2020",206,118,88,147335.1,1915.845,77.57767
"13916","40282","2020",59,49,10,155670.2,1587.831,104.2203
"13917","40283","2020",42,29,13,193525.8,1996.405,93.64286
"13918","40284","2020",145,76,69,205133.6,2677.11,79.61379
"13919","40285","2020",16,16,0,152051.6,1402.5,116.625
"13920","40286","2020",20,20,0,148209,1363,119.25
"13921","40287","2020",67,56,11,317356,3340.97,99.0597
"13922","40288","2020",11,11,0,151590.9,1555.909,97.45455
"13923","40290","2020",1,1,0,112000,2333,48
"13924","40291","2020",38,36,2,342628.2,3413.974,100.5263
"13925","40292","2020",17,16,1,360363.5,2919.353,131.8235
"13926","40293","2020",16,16,0,241456.2,2178.562,113.125
"13927","40294","2020",21,21,0,245023.8,2135.905,122.7143
"13928","40295","2020",11,11,0,168340,1788.273,94.72727
"13929","40296","2020",213,92,121,315498.5,4671.155,65.74178
"13930","40297","2020",2,2,0,265500,1532.5,179
"13931","40298","2020",5,5,0,173500,1350,123.6
"13932","40299","2020",1,1,0,123200,1283,96
"13933","40300","2020",7,7,0,230121.4,2402.143,96.85714
"13934","40301","2020",3,3,0,253750,2005.333,124
"13935","40303","2020",11,11,0,184395.9,1724.364,107.0909
"13936","40304","2020",140,84,56,632212.6,6657.186,94.30714
"13937","40305","2020",3,3,0,156666.7,1170.333,135.3333
"13938","40306","2020",6,6,0,216950,1551.333,137
"13939","40307","2020",18,18,0,174401.8,1645.167,113.2778
"13940","40308","2020",11,11,0,222862.9,2011.273,113
"13941","40309","2020",17,17,0,142004.3,1422,103.2353
"13942","40310","2020",194,131,63,231699.5,3163.943,76.49485
"13943","40311","2020",11,11,0,230397.3,2211.182,108.0909
"13944","40312","2020",169,98,71,275831.1,3211.651,88.39645
"13945","40313","2020",64,53,11,131098.7,1551.422,88.21875
"13946","40314","2020",17,16,1,226557.1,2123.765,109.6471
"13947","40315","2020",8,8,0,268601.2,1994.375,131.625
"13948","40316","2020",5,5,0,100051.6,959.8,112
"13949","40317","2020",51,45,6,353572.8,3445.863,103.7647
"13950","40318","2020",2,2,0,179337.5,1418,128
"13951","40319","2020",6,6,0,193400,1747,107.1667
"13952","40320","2020",15,15,0,232087.3,1846,128.6
"13953","40321","2020",5,5,0,110300,894.4,119.2
"13954","40322","2020",4,4,0,257715,2887.25,92.5
"13955","40323","2020",3,3,0,208333.3,1907.333,110
"13956","40324","2020",2,2,0,245110,2042,120
"13957","40325","2020",4,4,0,163147,1420.75,115.75
"13958","40326","2020",31,22,9,221958.3,2749.032,85.54839
"13959","40327","2020",4,4,0,139255,1146.25,125.75
"13960","40328","2020",122,39,83,217793.1,4090.926,55.88525
"13961","40329","2020",8,8,0,108425,1130.875,102.75
"13962","40330","2020",6,6,0,129666.7,1468,88.83333
"13963","40331","2020",44,43,1,141630.6,1397.591,103.2273
"13964","40332","2020",26,26,0,236920.8,2398.423,100.0385
"13965","40333","2020",17,17,0,145215.3,1396.118,106.2353
"13966","40334","2020",8,8,0,226070,1978.25,114.875
"13967","41001","2020",2,2,0,167940,1599,113
"13968","41002","2020",10,10,0,120320,1111.4,113.8
"13969","41003","2020",3,3,0,130000,1547.667,86.66667
"13970","41004","2020",3,3,0,164208.3,1511.333,98
"13971","41006","2020",7,7,0,137395.3,1173,112.8571
"13972","41007","2020",17,17,0,121689.1,1269.882,100.1765
"13973","41008","2020",13,13,0,136861.5,1315.538,107.0769
"13974","41009","2020",12,12,0,162991.7,1431.833,116.75
"13975","41010","2020",16,16,0,128745,1479.25,91.9375
"13976","41012","2020",1,1,0,20000,357,56
"13977","41013","2020",4,4,0,197875,2465.25,110.75
"13978","41014","2020",3,3,0,88233.33,940,86.33333
"13979","41016","2020",12,12,0,102717.5,1442,70.41667
"13980","41017","2020",20,20,0,123577.4,1300.75,105.15
"13981","41018","2020",730,263,467,118341.9,1659.559,73.15753
"13982","41020","2020",5,5,0,80000,1073.8,76.8
"13983","41022","2020",3,3,0,111666.7,1183.333,102.6667
"13984","41024","2020",4,4,0,101250,850.75,116.25
"13985","41025","2020",24,24,0,140825,1369.375,102
"13986","41026","2020",10,10,0,92800,770.6,119.7
"13987","41027","2020",2,2,0,166500,2196,77
"13988","41028","2020",6,6,0,97833.33,908.5,108
"13989","41029","2020",13,13,0,152251.5,1458.769,94.84615
"13990","41030","2020",2,2,0,59999.5,759,77
"13991","41031","2020",37,36,1,191176.7,1806.892,107.7568
"13992","41032","2020",25,24,1,209290.1,1761.48,115.12
"13993","41035","2020",8,8,0,120489.4,1268.125,104.125
"13994","41036","2020",4,4,0,225875,1875.25,122.75
"13995","41037","2020",2,2,0,165500,1118,147.5
"13996","41038","2020",11,11,0,152181.1,1197,124.1818
"13997","41039","2020",11,11,0,111272.7,1278.364,88.18182
"13998","41040","2020",8,8,0,204187.5,1774.25,124.375
"13999","41041","2020",4,4,0,88750,875,96
"14000","41042","2020",3,3,0,63333.33,803.3333,86
"14001","41043","2020",25,25,0,90743,1019.72,90.8
"14002","41044","2020",14,14,0,74657.71,775,94.14286
"14003","41045","2020",12,12,0,156434.9,1505.5,107.9167
"14004","41046","2020",17,17,0,245420.6,1800.412,127.0588
"14005","41047","2020",65,37,28,151809,1780.831,86.36923
"14006","41048","2020",3,3,0,64333.33,1273.333,58.33333
"14007","41049","2020",10,10,0,137115,1386.1,97.3
"14008","41050","2020",20,20,0,238691.5,1992.2,119.75
"14009","41051","2020",20,20,0,158747.5,1547.25,105.5
"14010","41052","2020",12,12,0,222834.8,1924.333,119.0833
"14011","41053","2020",10,10,0,101460,1209.8,85.7
"14012","41054","2020",8,8,0,107225,1160.5,86.75
"14013","41055","2020",40,40,0,182751.4,1655.675,112
"14014","41057","2020",1,1,0,60855,472,129
"14015","41058","2020",4,4,0,68750,977,65.5
"14016","41059","2020",87,87,0,147975.9,1553.759,101.4023
"14017","41060","2020",6,6,0,75568.33,980.1667,76.33333
"14018","41061","2020",22,22,0,177831.5,1579.545,114.5455
"14019","41062","2020",5,5,0,92360,1164.2,83.8
"14020","41063","2020",5,5,0,133588.2,1199.8,105.6
"14021","41065","2020",4,4,0,122750,1110.75,112.5
"14022","41066","2020",3,2,1,176333.3,1998.667,95
"14023","41067","2020",41,41,0,200238,1811.341,115.9268
"14024","41068","2020",5,5,0,103200,1012.6,98.6
"14025","41069","2020",3,3,0,274500,1965,127.3333
"14026","41070","2020",10,10,0,98628.2,849.5,121.1
"14027","41071","2020",8,8,0,192673,2209.625,89.625
"14028","41072","2020",5,5,0,100600,1250.8,87.8
"14029","41073","2020",10,10,0,102440,966.1,102.5
"14030","41074","2020",18,17,1,139041.1,1225.222,110.0556
"14031","41075","2020",19,19,0,61765.79,819.2105,81.36842
"14032","41077","2020",4,4,0,134000,1089.25,124.75
"14033","41078","2020",11,11,0,126489.1,1207.909,104.8182
"14034","41079","2020",2,2,0,107000,1574.5,68.5
"14035","41080","2020",20,20,0,152432.5,1471.65,107.15
"14036","41083","2020",6,6,0,187666.7,1494.333,119.6667
"14037","41084","2020",5,5,0,85300,930.8,89.6
"14038","41085","2020",20,20,0,197758.5,1517.85,148.9
"14039","41086","2020",7,7,0,105357.1,1404.143,72.71429
"14040","41087","2020",4,4,0,131500,1259.25,147
"14041","41088","2020",9,9,0,78150,886.8889,96.66667
"14042","41089","2020",5,5,0,60660,875.6,71.6
"14043","41090","2020",7,7,0,102123.7,1161,92
"14044","41091","2020",14,14,0,176300,1605.571,116.7857
"14045","41093","2020",7,7,0,130592.9,1438.286,93.28571
"14046","41094","2020",15,15,0,146843.3,1462.067,101.4667
"14047","41095","2020",16,16,0,101374.9,1355.375,77.25
"14048","41096","2020",3,3,0,55333.33,1371.333,43.66667
"14049","41097","2020",28,28,0,146170.1,1568.929,96.46429
"14050","41099","2020",2,2,0,226875,1951,117.5
"14051","41100","2020",9,9,0,122555.6,1179.667,100.6667
"14052","41101","2020",13,13,0,136703.8,1439.692,99.76923
"14053","41102","2020",11,11,0,150417.7,1059.818,132.0909
"14054","41103","2020",7,7,0,139569.1,1296.857,100.4286
"14055","41104","2020",17,17,0,145888.2,1475,101.4706
"14056","41105","2020",21,21,0,160401.6,1556.762,104.1429
"14057","41106","2020",70,64,6,160929.4,1743.443,97.31429
"14058","41107","2020",4,4,0,147000,1788,85.5
"14059","41108","2020",1,1,0,73000,702,104
"14060","41109","2020",8,8,0,216037.5,1648.125,141.875
"14061","41110","2020",11,11,0,125972.7,1065.091,119.0909
"14062","41112","2020",1,1,0,276000,1577,175
"14063","41113","2020",5,5,0,134028,1893.2,75.6
"14064","41114","2020",4,4,0,190062.5,1545.5,147
"14065","41115","2020",5,5,0,66200,1087.2,60.2
"14066","41116","2020",2,2,0,54250,1040,52
"14067","41118","2020",2,2,0,122271.5,1458,84
"14068","41119","2020",7,7,0,142357.1,1472.429,102.8571
"14069","41120","2020",26,26,0,121961.5,1197.462,94.76923
"14070","41121","2020",1,1,0,161000,988,163
"14071","41122","2020",3,3,0,134500,1182,124
"14072","41123","2020",12,12,0,99016.67,1243.833,84.58333
"14073","41124","2020",2,2,0,208645,2352,88.5
"14074","41125","2020",21,20,1,116077.5,1133.095,107.3333
"14075","41126","2020",18,18,0,91535.56,974.3333,95.94444
"14076","41127","2020",10,10,0,201745,1745.5,124.3
"14077","41128","2020",6,6,0,158098.3,1723,89.66667
"14078","41129","2020",7,7,0,131222.9,1443,90
"14079","41130","2020",7,7,0,165510,1166.857,144.4286
"14080","41131","2020",9,9,0,125794.4,1318.889,96.77778
"14081","41132","2020",4,4,0,92000,1020.5,92.25
"14082","41134","2020",8,6,2,178612.5,1460,109.25
"14083","41135","2020",11,11,0,58455.45,795.4545,81.72727
"14084","41136","2020",89,80,9,126750.6,1328.124,96.1573
"14085","41137","2020",5,5,0,192276,1334.6,143
"14086","41138","2020",4,4,0,139406.2,1318.75,98
"14087","41139","2020",22,22,0,112130.9,1169.591,94.90909
"14088","41140","2020",14,14,0,104792.9,1040.071,99.14286
"14089","41141","2020",5,5,0,93362,865.6,107.8
"14090","41142","2020",35,35,0,161988.8,1537.657,105.5714
"14091","41143","2020",20,20,0,77180,816.15,94.4
"14092","41144","2020",13,13,0,156086.2,1311.077,115.5385
"14093","41145","2020",11,11,0,192426.4,1798.727,109.3636
"14094","41146","2020",17,17,0,206185.3,1675.588,126.4706
"14095","41147","2020",28,28,0,140864.6,1618.821,92
"14096","41148","2020",14,14,0,170647.6,1585.5,108.3571
"14097","41149","2020",63,59,4,102947.2,1224.222,91.06349
"14098","41150","2020",33,31,2,184416.6,1762.182,112.4848
"14099","41151","2020",82,69,13,124128.4,1295.122,94.02439
"14100","41152","2020",5,5,0,197600,1575,131.2
"14101","41153","2020",1,1,0,204000,2040,100
"14102","41154","2020",14,14,0,104007.1,1146,91.14286
"14103","41155","2020",15,15,0,131980,1376.267,99.93333
"14104","41156","2020",5,5,0,197000,1702.8,116.2
"14105","41157","2020",16,16,0,143225,1491.875,95.75
"14106","41158","2020",34,34,0,147268.8,1526.324,97.76471
"14107","41159","2020",14,14,0,89683.21,1119.929,78.28571
"14108","41160","2020",1,1,0,62500,781,80
"14109","41161","2020",28,28,0,158267.9,1538.286,106.3214
"14110","41163","2020",1,1,0,154000,1540,100
"14111","41164","2020",37,37,0,105596.3,1134.784,92.43243
"14112","41166","2020",1,1,0,190000,1439,132
"14113","41167","2020",58,55,3,131933.5,1452.724,97.13793
"14114","41171","2020",21,21,0,91833.33,999.2381,92.04762
"14115","41172","2020",6,6,0,71583.33,860,82.16667
"14116","41173","2020",58,58,0,128002.6,1179.69,110.8448
"14117","41174","2020",7,7,0,119642.9,1351,93.28571
"14118","41175","2020",25,25,0,103912.8,1179.68,97.8
"14119","41176","2020",12,12,0,151466.7,1528,95.75
"14120","41177","2020",1,1,0,64000,762,84
"14121","41178","2020",1,1,0,115000,871,132
"14122","41179","2020",6,6,0,124150,923.6667,131.3333
"14123","41180","2020",3,3,0,129366.7,960.3333,156.3333
"14124","41181","2020",10,10,0,132458,1290.9,106.1
"14125","41182","2020",4,4,0,185655.8,1193.75,163.5
"14126","41184","2020",14,14,0,102234.3,1243,82.42857
"14127","41185","2020",37,37,0,166872.7,1759.162,109.4865
"14128","41186","2020",5,5,0,147200,1251.8,125.8
"14129","41187","2020",2,2,0,136500,1080.5,129.5
"14130","41188","2020",3,3,0,87215,766.6667,108.3333
"14131","41189","2020",6,6,0,119883.3,1331.167,93
"14132","41190","2020",5,5,0,115000,1097.4,106.8
"14133","41192","2020",9,9,0,60055.56,728.5556,82.55556
"14134","41193","2020",2,2,0,82500,857,100.5
"14135","41194","2020",247,226,21,121159.9,1359.555,92.17409
"14136","41196","2020",3,3,0,88716.67,826.6667,104
"14137","41198","2020",33,32,1,87194.58,974.5152,88.57576
"14138","41199","2020",20,20,0,114254.8,1262.35,91.85
"14139","41200","2020",1,1,0,95000,1188,80
"14140","41201","2020",6,6,0,72833.33,943.5,74.66667
"14141","41203","2020",4,4,0,112350,1376.75,82.25
"14142","41204","2020",19,18,1,151146.1,1689,92.42105
"14143","41205","2020",5,5,0,128200,1174.6,112.4
"14144","41206","2020",6,6,0,213333.3,1602.833,131.1667
"14145","41207","2020",14,14,0,164328.9,1645.5,105.8571
"14146","41208","2020",1,1,0,148575,2476,60
"14147","41209","2020",11,11,0,171390.9,1545.091,108
"14148","41211","2020",44,44,0,138511.5,1464.568,96.40909
"14149","41212","2020",38,37,1,185573.9,1855.237,103.8421
"14150","41213","2020",1,1,0,256985,1725,149
"14151","41214","2020",12,12,0,74808.33,993.75,80.25
"14152","41215","2020",2,2,0,43250,872.5,81.5
"14153","41216","2020",7,7,0,107885.7,978.5714,118.4286
"14154","41217","2020",11,11,0,114096.4,1256.636,91.54545
"14155","41218","2020",13,13,0,117121.2,1140.154,96.30769
"14156","41219","2020",6,6,0,99125,1107.333,91.5
"14157","41220","2020",58,58,0,130353.9,1347.121,98.81034
"14158","41221","2020",16,16,0,97784.38,1141.188,91.75
"14159","41222","2020",4,4,0,117796.5,1754.75,80
"14160","41223","2020",9,9,0,137149.4,1390,108.5556
"14161","41224","2020",3,3,0,81000,787.6667,129
"14162","41225","2020",10,10,0,137630,1058.6,135.1
"14163","41226","2020",41,41,0,134357.3,1436.634,97.78049
"14164","41228","2020",5,5,0,131600,1069.8,132.2
"14165","41229","2020",16,16,0,106156.2,1223.812,93.125
"14166","41230","2020",20,20,0,176318,1750.8,102.25
"14167","41231","2020",19,19,0,233634.1,2222.842,116.7368
"14168","41232","2020",63,59,4,131426.5,1400.222,84.34921
"14169","41233","2020",5,5,0,133800,1610.8,90
"14170","41234","2020",7,7,0,178257.1,1532.714,107.8571
"14171","41235","2020",11,11,0,105427.3,1123.909,89.18182
"14172","41236","2020",2,2,0,222100,1385,140
"14173","41237","2020",14,14,0,138800,1272,105.4286
"14174","41238","2020",22,22,0,88918.18,981.2727,91.27273
"14175","41239","2020",12,12,0,124583.3,1301.25,98.66667
"14176","41241","2020",22,22,0,100666.4,1170.182,86.95455
"14177","41242","2020",64,59,5,99590.78,1047.078,93.32812
"14178","41243","2020",10,10,0,124500,1138.1,103.8
"14179","41245","2020",5,5,0,110336,1179.8,95.2
"14180","41246","2020",5,5,0,216820,1728.8,124.8
"14181","41247","2020",16,16,0,179671.1,1621.812,114.3125
"14182","41248","2020",24,24,0,100025,1131.75,96.91667
"14183","41249","2020",27,26,1,99758.15,1279.63,81.37037
"14184","41250","2020",9,9,0,74055.56,874.6667,85.22222
"14185","41251","2020",11,11,0,171240.9,1292.182,129.5455
"14186","41252","2020",19,18,1,191179.3,1441.105,142.0526
"14187","41253","2020",5,5,0,157840,1307.4,122.2
"14188","41254","2020",4,4,0,123500,948.25,129.75
"14189","41255","2020",9,9,0,77488.89,795.7778,93.77778
"14190","41256","2020",12,11,1,94383.33,930.0833,109.5
"14191","41258","2020",11,11,0,74600,896,82.90909
"14192","41259","2020",11,11,0,114672.7,1081.909,100
"14193","41260","2020",2,2,0,36000,1121.5,32
"14194","41262","2020",5,5,0,184866,1558.4,119.6
"14195","41265","2020",7,7,0,111142.9,1161.571,98.14286
"14196","41266","2020",1,1,0,95000,1067,89
"14197","41267","2020",8,8,0,204296.5,1599.75,135.875
"14198","41268","2020",2,2,0,93000,1199,78.5
"14199","41269","2020",250,150,100,131050,1633.932,83.152
"14200","41271","2020",9,9,0,302158.9,2621.444,138
"14201","41273","2020",9,9,0,128006.1,1359.333,85.11111
"14202","41274","2020",3,3,0,120166.7,1145,104.6667
"14203","41275","2020",11,11,0,88000,1084.636,81.54545
"14204","41276","2020",28,23,5,143621.1,1700,85.39286
"14205","41277","2020",4,4,0,105125,981,108.25
"14206","41278","2020",4,4,0,161156.2,1508.5,130.75
"14207","41279","2020",16,16,0,121900,1182.625,113.3125
"14208","41280","2020",46,45,1,101762.8,1121.87,93.54348
"14209","41281","2020",6,6,0,115966.7,1246.5,95
"14210","41282","2020",3,3,0,155500,1281.667,116.6667
"14211","41283","2020",4,4,0,75750,963.75,86.75
"14212","41285","2020",8,8,0,152812.5,1477.625,106.5
"14213","41286","2020",1,1,0,105500,1199,88
"14214","41287","2020",13,13,0,170184.6,1373.769,116.6154
"14215","41288","2020",5,5,0,144600,1763.6,82.2
"14216","41289","2020",4,4,0,80295.75,968,91.75
"14217","41290","2020",4,4,0,87500,876.5,99.5
"14218","41291","2020",4,4,0,100750,928.5,104.25
"14219","41292","2020",2,2,0,179500,1271.5,143
"14220","41293","2020",2,2,0,155000,1316,111
"14221","41294","2020",16,16,0,197612.6,1477.625,133.6875
"14222","41295","2020",94,85,9,185560.8,1828.309,104.5213
"14223","41296","2020",18,18,0,148550,1436.889,104.1111
"14224","41297","2020",11,11,0,255780,2001.364,133.5455
"14225","42001","2020",8,8,0,160125,1599.875,99.625
"14226","42002","2020",2,2,0,117500,1457.5,84
"14227","42003","2020",22,22,0,144622.7,1300.773,114.7727
"14228","42005","2020",123,68,55,192697.1,2174.691,88.01626
"14229","42006","2020",7,7,0,147157.1,1487.714,97.71429
"14230","42007","2020",3,3,0,96000,1339.333,70.66667
"14231","42008","2020",3,3,0,118266.7,1817.333,57
"14232","42009","2020",12,12,0,128525,1302.417,107.5833
"14233","42010","2020",27,26,1,199855.7,1798.148,109.7778
"14234","42011","2020",35,23,12,155559.7,2008.971,88.88571
"14235","42012","2020",8,8,0,219231.9,1465.125,153.5
"14236","42013","2020",27,26,1,155506.9,1713.926,91.48148
"14237","42014","2020",9,9,0,110205.6,1233.333,101.1111
"14238","42015","2020",19,18,1,119296.3,1029.789,105.1053
"14239","42017","2020",13,12,1,191838.5,2615.462,90.23077
"14240","42018","2020",7,7,0,184433.6,2064,93.28571
"14241","42019","2020",54,46,8,109057.2,1131.852,96.94444
"14242","42020","2020",18,17,1,188168.3,1942.333,103.6667
"14243","42021","2020",15,15,0,169676,2038.2,83.26667
"14244","42022","2020",52,50,2,188141.8,2124.692,90.19231
"14245","42023","2020",24,16,8,127614,1413.333,86.25
"14246","42025","2020",2,2,0,182000,1359,136.5
"14247","42026","2020",20,19,1,159056,1626.9,98.1
"14248","42027","2020",11,11,0,124181.8,1135.091,112.1818
"14249","42028","2020",8,8,0,125592.5,1376.75,99.375
"14250","42029","2020",21,20,1,150250.7,1334.333,110.9048
"14251","42030","2020",5,5,0,149945,1177.8,121.6
"14252","42031","2020",5,5,0,293630,2410.2,125.6
"14253","42032","2020",15,15,0,277217.1,2730.8,102.7333
"14254","42033","2020",12,12,0,125654.2,1159.667,110.6667
"14255","42034","2020",1,1,0,48500,404,120
"14256","42035","2020",3,3,0,111333.3,1020.667,109.3333
"14257","42036","2020",1,1,0,130500,2900,45
"14258","42037","2020",4,4,0,253237.5,2060,123
"14259","42038","2020",13,13,0,206945.4,2030.077,100.6923
"14260","42039","2020",10,9,1,93870,891.3,117.1
"14261","42040","2020",1,1,0,1e+05,833,120
"14262","42041","2020",8,8,0,217246.2,1913.125,122.875
"14263","42042","2020",12,12,0,280170.8,2402.917,115.3333
"14264","42043","2020",19,18,1,268970.2,2469.263,109.9474
"14265","42044","2020",125,65,60,122634.6,1422,84.768
"14266","42045","2020",1,1,0,60000,723,83
"14267","42046","2020",17,15,2,195705.6,1816.529,112.1176
"14268","42047","2020",4,4,0,85187.5,898,90.75
"14269","42048","2020",23,22,1,148643.9,1448.565,109.3478
"14270","42049","2020",8,8,0,123750,1195,105.75
"14271","42050","2020",4,4,0,102000,1012.25,97.5
"14272","42051","2020",5,5,0,326414,2475.4,129.8
"14273","42052","2020",41,24,17,134582.9,1383.805,99.31707
"14274","42053","2020",20,19,1,299679.5,2833.8,108.05
"14275","42054","2020",3,3,0,138666.7,1033.667,128.6667
"14276","42056","2020",32,31,1,199291.9,2157.812,97.28125
"14277","42058","2020",5,5,0,167136,1399.4,121.4
"14278","42059","2020",69,41,28,153219.9,1744.116,88.98551
"14279","42060","2020",8,8,0,136150,1592,91.25
"14280","42061","2020",5,5,0,92180,896.6,108.4
"14281","42062","2020",9,9,0,232353.3,1968.889,114.6667
"14282","42063","2020",5,5,0,71200,1062,64.6
"14283","42064","2020",9,9,0,210425.6,2156,107
"14284","42065","2020",8,8,0,226000,1859.875,119.125
"14285","42066","2020",7,7,0,135142.9,1293.143,103.1429
"14286","42068","2020",3,3,0,117850,1407.667,81.33333
"14287","42069","2020",34,33,1,191336.9,1745.706,110.4118
"14288","42070","2020",14,14,0,149621.4,1385.214,113.1429
"14289","42071","2020",130,47,83,105697,1335.123,77.18462
"14290","42072","2020",1,1,0,153550,1163,132
"14291","42073","2020",12,12,0,131591.2,1268.25,112.1667
"14292","42074","2020",12,11,1,105662.5,1152.167,90.75
"14293","42075","2020",16,15,1,187551.2,2185.812,89.25
"14294","42076","2020",11,11,0,105857.3,1099.364,98.27273
"14295","42077","2020",2,2,0,168000,1545,109
"14296","42078","2020",3,3,0,91833.33,1065,100.6667
"14297","42079","2020",8,7,1,69775,772,89.875
"14298","42081","2020",26,24,2,191902.7,2137.346,93
"14299","42083","2020",8,7,1,327625.4,3216.875,101.75
"14300","42084","2020",2,2,0,89300,1004.5,86
"14301","42085","2020",3,3,0,167966.7,2012.333,74.33333
"14302","42086","2020",5,5,0,103260,798.8,138.4
"14303","42087","2020",15,15,0,237730.6,2075.133,113.8667
"14304","42088","2020",8,8,0,169293.8,1866.625,93.375
"14305","42089","2020",3,3,0,172633.3,2505,78
"14306","42090","2020",8,8,0,111575,1109.75,98.875
"14307","42091","2020",7,7,0,162638.6,1529.571,124.2857
"14308","42092","2020",45,30,15,280587.5,2706.644,104.2667
"14309","42093","2020",11,9,2,241448.2,2576.636,94.54545
"14310","42094","2020",113,64,49,139551,1591.558,87.09735
"14311","42095","2020",188,70,118,111026.3,1296.761,84.07447
"14312","42096","2020",3,3,0,223033.3,2190.333,101.6667
"14313","42097","2020",71,57,14,250371.3,2310.648,111.9859
"14314","42098","2020",10,10,0,149608.8,1239.4,123.4
"14315","42099","2020",44,28,16,161623.3,1750.545,91.02273
"14316","42100","2020",2,2,0,233450,1532,147.5
"14317","42101","2020",2,2,0,125000,1680.5,75
"14318","42102","2020",7,7,0,192317.1,1768.429,105.5714
"14319","42103","2020",43,36,7,193995.7,2088.209,94.32558
"14320","42104","2020",9,9,0,117313.9,1000.222,112.4444
"14321","42105","2020",1,1,0,270000,1985,136
"14322","42106","2020",5,5,0,101100,859.2,115
"14323","42107","2020",4,3,1,97687.5,1122.75,86.75
"14324","42108","2020",8,8,0,304119.4,2428.25,129.375
"14325","42109","2020",2,2,0,110850,888,125
"14326","42110","2020",46,28,18,167059.5,1709.87,97.21739
"14327","42112","2020",2,2,0,141125,867,140
"14328","42113","2020",5,5,0,185820,1883.6,108.2
"14329","42115","2020",10,6,4,128334,1395.1,95.3
"14330","42116","2020",4,4,0,89762.5,1233,98.25
"14331","42117","2020",4,4,0,130737.5,1979.5,69.5
"14332","42118","2020",7,7,0,119185.7,912.2857,137
"14333","42119","2020",4,4,0,190400,1419,137.5
"14334","42120","2020",22,22,0,185068.2,1757.773,106.8182
"14335","42121","2020",1,1,0,304000,2432,125
"14336","42122","2020",16,16,0,186119.1,1824.062,102.25
"14337","42123","2020",47,28,19,168170.7,1901.936,89.29787
"14338","42124","2020",7,6,1,154394.3,1649,93.57143
"14339","42125","2020",2,2,0,98650,899,111.5
"14340","42126","2020",18,18,0,209922.2,1882.111,113.3333
"14341","42127","2020",96,92,4,144025.7,1640.604,89.9375
"14342","42128","2020",6,6,0,116516.7,913.6667,128.8333
"14343","42129","2020",15,15,0,180683,1680.733,101.1333
"14344","42130","2020",5,5,0,203700,1847.6,108.8
"14345","42131","2020",1,1,0,50250,1795,28
"14346","42132","2020",8,8,0,211367.5,2024.875,103.125
"14347","42133","2020",8,8,0,166197.9,2040.5,84.125
"14348","42134","2020",15,14,1,139494.7,1276.533,109.2
"14349","42135","2020",5,5,0,199760,1923.6,103.6
"14350","42136","2020",10,10,0,186360,1694.2,108.8
"14351","42137","2020",8,7,1,202706.2,1919.5,111.875
"14352","42138","2020",8,8,0,170606.2,1978.375,89.875
"14353","42139","2020",14,13,1,154185.7,1253.643,128.1429
"14354","42140","2020",9,9,0,135804.4,1541,94.11111
"14355","42141","2020",6,6,0,124043.3,1019.333,117.3333
"14356","42142","2020",9,9,0,164218.9,1530.556,110.7778
"14357","42143","2020",3,3,0,87333.33,805.3333,107.3333
"14358","42145","2020",9,7,2,111400,1103.111,107.4444
"14359","42146","2020",1,1,0,125745,2028,62
"14360","42147","2020",238,130,108,159971,1837.155,88.05882
"14361","42148","2020",10,10,0,166265,1563.4,112
"14362","42149","2020",86,52,34,177025.9,2040.907,92.02326
"14363","42150","2020",16,16,0,166184.4,1641.312,106.25
"14364","42151","2020",4,4,0,170000,1691,104.25
"14365","42152","2020",4,4,0,176012.5,1450,121.5
"14366","42153","2020",5,5,0,186050,1554.4,144
"14367","42154","2020",6,6,0,115058.3,1245.333,93
"14368","42155","2020",16,16,0,129812.5,1362.188,108
"14369","42156","2020",14,13,1,129071.4,1153.429,118.2143
"14370","42157","2020",9,9,0,150066.7,1412.333,111.7778
"14371","42158","2020",3,3,0,80900,769.3333,108.3333
"14372","42159","2020",15,14,1,85066.67,895.3333,103.8667
"14373","42161","2020",4,4,0,236000,2180.5,108.25
"14374","42162","2020",14,14,0,147370.1,1453.071,103.7857
"14375","42163","2020",10,9,1,90450,1001.2,93.3
"14376","42165","2020",43,40,3,117857.2,1070.14,106.6977
"14377","42166","2020",9,9,0,158188.9,1568.111,102.8889
"14378","42167","2020",2,2,0,113680,1929,57.5
"14379","42168","2020",47,38,9,191317.6,1900.043,101.6809
"14380","42169","2020",27,27,0,167134.3,1772.185,96.81481
"14381","42170","2020",26,23,3,162885,1475.5,115.6154
"14382","42171","2020",3,3,0,136766.7,1354.333,101
"14383","42172","2020",13,12,1,195578.5,1813.923,111.6923
"14384","42173","2020",3,3,0,212082,1348.667,162
"14385","42174","2020",19,19,0,197398.4,1845.263,106.2632
"14386","42175","2020",17,17,0,176880.6,1537.765,113.7647
"14387","42176","2020",24,24,0,162116.7,1522.375,108.5417
"14388","42177","2020",34,32,2,129418.2,1382.176,98.67647
"14389","42178","2020",9,9,0,182183.3,1824.556,101
"14390","42179","2020",8,8,0,228778.8,1986.75,120.5
"14391","42180","2020",8,7,1,180037.5,1994.375,89.875
"14392","42181","2020",22,19,3,130811.4,1278.636,103.3182
"14393","42182","2020",39,37,2,179179.9,1761.513,104.1026
"14394","42183","2020",65,34,31,108999.4,1209.754,83.29231
"14395","42184","2020",174,115,59,150098.4,1580.149,93.52299
"14396","42185","2020",9,9,0,328458.3,2332,139.7778
"14397","42186","2020",137,82,55,166969.5,1798.328,90.10219
"14398","42187","2020",700,177,523,95795.72,1226.6,76.75286
"14399","42188","2020",4,4,0,126125,1473.25,96.5
"14400","42189","2020",143,69,74,144392.7,1707.245,83.40559
"14401","42191","2020",10,10,0,255492,2140.1,129.2
"14402","42192","2020",12,12,0,148166.7,1191.667,109.3333
"14403","42193","2020",26,25,1,127170.8,1270.885,100.8846
"14404","42194","2020",6,6,0,57333.33,774.3333,82
"14405","42195","2020",18,15,3,90165.56,1124.222,87.33333
"14406","42196","2020",1,1,0,35000,350,100
"14407","42197","2020",16,16,0,140975.3,1431.312,102.3125
"14408","42198","2020",8,8,0,185013.8,1527.375,121.125
"14409","42199","2020",19,19,0,170236.8,1399.895,127.8947
"14410","42200","2020",23,23,0,203707.4,2008.348,107.1304
"14411","42201","2020",12,12,0,193681.2,1932.917,101
"14412","42202","2020",12,11,1,152633.8,1997.333,79.41667
"14413","42203","2020",7,7,0,104321.4,1149.286,98.42857
"14414","42204","2020",18,12,6,98047.72,1207.944,87.22222
"14415","42205","2020",6,6,0,131916.7,1293.333,89.66667
"14416","42206","2020",18,17,1,364543.6,2777.056,133.3333
"14417","42207","2020",355,130,225,134974.6,1513.676,88.14085
"14418","42208","2020",10,9,1,247919,2251.1,107.7
"14419","42209","2020",7,7,0,105757.1,1173.714,85
"14420","42210","2020",5,5,0,174374,2046,91.6
"14421","42211","2020",29,22,7,221184.1,2167.276,103.4483
"14422","42212","2020",16,16,0,162803.1,1483.625,111.1875
"14423","42213","2020",2,2,0,55000,1037,52
"14424","42214","2020",15,15,0,197953.3,1728.533,107
"14425","42215","2020",10,10,0,143021.9,1111,125
"14426","42216","2020",3,3,0,262940,2312,112.6667
"14427","42217","2020",5,5,0,79800,912.8,87.6
"14428","42218","2020",2994,291,2703,92517.12,1246.107,73.29793
"14429","42219","2020",9,9,0,236722.2,2251.667,115.4444
"14430","42220","2020",5,5,0,152580,1354,133.2
"14431","42221","2020",6,6,0,226945,1857.333,133.1667
"14432","42222","2020",67,52,15,248837.9,2463.925,103.3284
"14433","42223","2020",92,49,43,188396.5,2006.098,93.45652
"14434","42224","2020",23,19,4,272660.9,2320.043,120.9565
"14435","42225","2020",48,42,6,218108.5,2252.646,102.8958
"14436","42226","2020",6,6,0,156221.7,1496.333,112.8333
"14437","42227","2020",3,3,0,77333.33,698,111.3333
"14438","42228","2020",10,10,0,196230,1827.3,109.4
"14439","42229","2020",4,4,0,140300,1367.5,99.25
"14440","42230","2020",19,19,0,85968.42,968.1579,84.73684
"14441","42231","2020",14,14,0,119323.3,1214.071,105.8571
"14442","42232","2020",13,13,0,140745.4,1264.308,117.8462
"14443","42233","2020",11,11,0,161740.9,1478,108.0909
"14444","42234","2020",41,33,8,184131.2,2010.561,89.80488
"14445","42235","2020",6,6,0,78341.67,883.5,89.16667
"14446","42236","2020",3,3,0,108500,974.3333,111.6667
"14447","42237","2020",60,40,20,194956,2114.167,92.91667
"14448","42238","2020",5,5,0,67200,788.8,88.6
"14449","42239","2020",15,15,0,157656.7,1463.733,108.9333
"14450","42240","2020",6,6,0,97623.33,1049.5,86.16667
"14451","42241","2020",11,11,0,146965.5,1391.909,117.8182
"14452","42242","2020",17,16,1,250950,2311.941,110.1176
"14453","42243","2020",2,1,1,91500,875.5,114
"14454","42245","2020",4,4,0,137150,954.75,140.25
"14455","42246","2020",20,20,0,128452,1357.05,93.55
"14456","42247","2020",4,3,1,76375,833.25,93.5
"14457","42248","2020",11,11,0,121843.6,1241.545,96.90909
"14458","42249","2020",22,22,0,94232.27,1173.455,83.68182
"14459","42251","2020",6,5,1,197731.7,1758,110.3333
"14460","42252","2020",4,4,0,77900,800.25,97.5
"14461","42253","2020",16,16,0,164809.4,1629.25,104.75
"14462","42254","2020",11,11,0,102181.8,1032,99.45455
"14463","42255","2020",3,3,0,175500,1134.667,145.6667
"14464","42256","2020",49,41,8,185299,2095.755,88.85714
"14465","42257","2020",16,14,2,80019.19,855,94.75
"14466","42259","2020",38,33,5,254708.3,2637.184,96.60526
"14467","42260","2020",3,3,0,78666.67,968,80
"14468","42261","2020",9,9,0,117033.3,1332.556,86.77778
"14469","42262","2020",16,16,0,170751.6,1496.062,111
"14470","42264","2020",13,13,0,216553.8,2082.769,110.8462
"14471","42265","2020",5,5,0,277830.4,2208,131.8
"14472","42266","2020",9,9,0,118022.2,1416.667,87.44444
"14473","42267","2020",16,16,0,137140.6,1252.312,111
"14474","42268","2020",13,13,0,130049.2,1059.077,123.6923
"14475","42269","2020",1,1,0,240800,1627,148
"14476","42270","2020",21,18,3,239962.9,2118.381,112.619
"14477","42271","2020",44,33,11,209226.6,2151.682,98.88636
"14478","42272","2020",24,24,0,197495.4,1776.167,113.9167
"14479","42273","2020",3,3,0,123666.7,1517.333,80.66667
"14480","42274","2020",2,2,0,75500,1034,73
"14481","42275","2020",90,30,60,165157.3,2145.844,80.62222
"14482","42276","2020",2,2,0,134250,931,148
"14483","42277","2020",6,6,0,150750,1659.667,91.83333
"14484","42279","2020",203,135,68,209739.7,2287.369,92.24631
"14485","42280","2020",3,3,0,298233.3,2325,128
"14486","42282","2020",2,2,0,103500,1055.5,100
"14487","42283","2020",12,12,0,164513,1982.417,84.66667
"14488","42284","2020",12,11,1,186541.7,1678,109.0833
"14489","42285","2020",49,39,10,162163,1782.612,92.89796
"14490","42286","2020",13,13,0,212796.3,2021.615,107.3077
"14491","42287","2020",6,6,0,67366.67,834.8333,79.66667
"14492","42288","2020",5,5,0,108300,1232.4,87.8
"14493","42289","2020",15,15,0,131940,1283.933,116.4667
"14494","42290","2020",5,5,0,196800,1525.8,130.8
"14495","42293","2020",15,14,1,128413.3,1358.2,108.6
"14496","42294","2020",6,6,0,209900,1774.5,120.1667
"14497","42295","2020",2,2,0,160750,2211,56
"14498","42296","2020",5,4,1,169950,1673.4,102.2
"14499","42297","2020",5,5,0,143900,1204.4,127.8
"14500","42298","2020",1,1,0,180000,3000,60
"14501","42299","2020",39,29,10,178230,1976.308,91.15385
"14502","42300","2020",10,9,1,112848.9,1129.6,95.5
"14503","42301","2020",9,7,2,123868.9,1316.667,87.22222
"14504","42302","2020",73,55,18,239340.9,2514.973,94.42466
"14505","42303","2020",5,5,0,110600,935.8,117.8
"14506","42304","2020",88,75,13,169270.5,1787.648,94.42045
"14507","42305","2020",70,41,29,189483.4,2229.914,83.91429
"14508","42306","2020",5,4,1,197000,1566.2,117.8
"14509","42307","2020",20,4,16,115568.1,1412.8,81.85
"14510","42308","2020",6,4,2,158881.5,1575.167,106.1667
"14511","42310","2020",2,2,0,111299,1071,102.5
"14512","42311","2020",12,12,0,313679.2,2227.667,144.1667
"14513","42312","2020",7,7,0,159528.6,1633.143,97.85714
"14514","42313","2020",4,4,0,145750,1240.25,124.75
"14515","42314","2020",6,6,0,93658.33,739.3333,126.5
"14516","42315","2020",2,2,0,312500,2892.5,107.5
"14517","42316","2020",92,69,23,160916.2,1698.728,92.72826
"14518","42317","2020",2,2,0,115500,773,142.5
"14519","42318","2020",16,16,0,125404.2,1146.25,103.6875
"14520","42319","2020",4,4,0,140375,1291,106
"14521","42320","2020",3,3,0,204216.7,2421.667,88.33333
"14522","42321","2020",1,1,0,58000,707,82
"14523","42322","2020",13,11,2,140288.8,1666,84.69231
"14524","42323","2020",94,73,21,206087.5,2370.936,86.7766
"14525","42324","2020",10,10,0,214442.4,2283.1,93.7
"14526","42325","2020",2,2,0,152250,1380.5,109.5
"14527","42326","2020",11,11,0,220456.4,2131.455,110.5455
"14528","42327","2020",8,6,2,210659.4,1793.875,116.75
"14529","42328","2020",6,6,0,198520,2171.5,102.1667
"14530","42329","2020",7,7,0,140585.7,1749.714,82.85714
"14531","42330","2020",115,45,70,149821.7,1593.843,91.08696
"14532","42331","2020",7,7,0,138607.1,1482.571,93
"14533","42332","2020",59,53,6,191043.6,1693.085,114.8475
"14534","42333","2020",3,3,0,143616.7,1189.667,119.6667
"14535","42334","2020",12,12,0,191037.1,1950.167,106.4167
"14536","42335","2020",3,3,0,131333.3,1464,88
"14537","42336","2020",8,8,0,188803.8,1441,136.75
"14538","42337","2020",5,5,0,166746,1221,133.2
"14539","42338","2020",13,13,0,177562.2,1490.154,126.5385
"14540","42339","2020",2,2,0,58500,831,70
"14541","43001","2020",2,1,1,77500,757,106
"14542","43002","2020",14,9,5,132250.7,1424.071,85.57143
"14543","43003","2020",9,9,0,89188.89,829,113.1111
"14544","43004","2020",5,5,0,64700,901.8,67
"14545","43005","2020",4,4,0,82250,945,91
"14546","43007","2020",13,12,1,104133.5,1114.077,93.38462
"14547","43008","2020",2,2,0,81680,766,106.5
"14548","43010","2020",9,9,0,127055.6,1368.889,91.88889
"14549","43011","2020",4,4,0,98750,814,120.5
"14550","43012","2020",83,66,17,164046.1,1751.181,92.62651
"14551","43013","2020",5,5,0,146850,1580,97.4
"14552","43014","2020",3,3,0,170600,1097,150.6667
"14553","43016","2020",16,16,0,80191.88,968.75,80.5
"14554","43017","2020",1,1,0,19000,559,34
"14555","43018","2020",9,9,0,172061.1,1489.444,118.1111
"14556","43020","2020",55,52,3,181984.2,1845.255,99.52727
"14557","43021","2020",10,10,0,125888,1283.6,89.9
"14558","43022","2020",1,1,0,185000,2176,85
"14559","43023","2020",4,4,0,188900,1486.75,125
"14560","43024","2020",19,19,0,117230.5,1358.316,88.47368
"14561","43025","2020",47,45,2,129321.3,1442.745,88.06383
"14562","43026","2020",4,4,0,94851.25,1215.5,98.25
"14563","43027","2020",5,5,0,101956,796,105
"14564","43028","2020",3,3,0,138833.3,1345.667,110
"14565","43029","2020",2,2,0,35400,485.5,84
"14566","43030","2020",4,4,0,129512.5,1256.5,86.25
"14567","43031","2020",3,3,0,71000,1041,69.66667
"14568","43032","2020",9,7,2,143600,1571.556,98
"14569","43033","2020",4,4,0,65405,841.5,73.5
"14570","43034","2020",3,3,0,120833.3,1176.667,103
"14571","43036","2020",3,3,0,197766.7,1825.667,118.6667
"14572","43037","2020",4,4,0,102312.5,1026.75,105.5
"14573","43038","2020",6,5,1,92833.33,1271.167,71.5
"14574","43039","2020",8,8,0,116112.5,861.875,128.375
"14575","43040","2020",67,52,15,117943.4,1196.522,98.23881
"14576","43041","2020",46,19,27,132457.3,1473.326,88.56522
"14577","43042","2020",9,9,0,81622.78,1064.111,76
"14578","43043","2020",4,4,0,79225,1243,67
"14579","43044","2020",1,1,0,71000,1420,50
"14580","43045","2020",3,3,0,177466.7,1527.667,114.6667
"14581","43046","2020",30,20,10,184599,1792.967,103.7667
"14582","43047","2020",3,3,0,160950,1768.333,87.66667
"14583","43048","2020",15,15,0,71533.33,765.8,90.13333
"14584","43049","2020",9,8,1,109872.7,1420,77.11111
"14585","43050","2020",4,4,0,76362.5,769,95.5
"14586","43051","2020",54,36,18,145651,1342.481,106.7407
"14587","43052","2020",9,9,0,138106.7,1856.778,97.11111
"14588","43053","2020",8,8,0,101512.5,1405.5,71.75
"14589","43054","2020",2,2,0,62500,713,79
"14590","43055","2020",2,2,0,51910,1689,30.5
"14591","43056","2020",9,9,0,56666.67,629.6667,89.77778
"14592","43058","2020",4,4,0,259300,2344.25,109.5
"14593","43059","2020",1,1,0,46500,684,68
"14594","43060","2020",3,3,0,46666.67,695,79.33333
"14595","43061","2020",11,11,0,165600,1312.455,123.6364
"14596","43062","2020",8,8,0,165225.9,1558.75,105.125
"14597","43063","2020",1,1,0,86000,935,92
"14598","43064","2020",1,1,0,44000,1000,44
"14599","43065","2020",4,3,1,52975,420,130
"14600","43066","2020",4,4,0,43875,673.75,66.25
"14601","43067","2020",4,4,0,112600,1363.5,89.5
"14602","43068","2020",2,2,0,48000,574,83.5
"14603","43069","2020",3,3,0,93193.33,1162.667,76.66667
"14604","43070","2020",2,2,0,37750,645,60
"14605","43071","2020",12,12,0,104250,965.5,97.25
"14606","43072","2020",1,1,0,136100,1403,97
"14607","43073","2020",4,4,0,96500,769.5,115
"14608","43074","2020",5,5,0,153056,1371.2,114
"14609","43076","2020",1,1,0,110000,688,160
"14610","43077","2020",5,5,0,89213.8,831.6,109
"14611","43078","2020",30,28,2,193938.3,1702.667,114.2333
"14612","43079","2020",2,2,0,110550,1139,91
"14613","43080","2020",23,21,2,102322.1,901.8696,119.087
"14614","43082","2020",5,5,0,70500,678,107.8
"14615","43083","2020",1,1,0,100950,841,120
"14616","43084","2020",7,7,0,172335.7,1548.714,114
"14617","43085","2020",1,1,0,95000,736,129
"14618","43086","2020",2,2,0,153835,2482.5,63
"14619","43087","2020",23,22,1,140795.8,1508.043,101.7826
"14620","43089","2020",38,26,12,143536.3,1432.368,96.78947
"14621","43090","2020",3,3,0,76513.33,1045,75.66667
"14622","43091","2020",4,3,1,150625,1890.75,116.25
"14623","43092","2020",6,6,0,174345,1464,122
"14624","43093","2020",9,9,0,93644.44,888.4444,120.2222
"14625","43094","2020",1,1,0,24500,377,65
"14626","43095","2020",3,3,0,67300,967.3333,80.66667
"14627","43096","2020",4,4,0,136900,1263,116
"14628","43097","2020",5,5,0,57050,853.2,69.2
"14629","43098","2020",4,4,0,55587.5,1026.5,54.25
"14630","43099","2020",7,7,0,93008.57,1102.714,91.28571
"14631","43100","2020",2,2,0,62500,844.5,72.5
"14632","43101","2020",3,3,0,103750,729.6667,144.6667
"14633","43102","2020",16,16,0,145950,1461.688,106.8125
"14634","43104","2020",3,3,0,40666.67,697.6667,56.66667
"14635","43105","2020",1,1,0,69500,993,70
"14636","43106","2020",4,4,0,76987.5,680,112.5
"14637","43107","2020",5,5,0,102780,716.2,137.6
"14638","43108","2020",8,7,1,87821.25,906.875,98.875
"14639","43109","2020",5,5,0,72560,1040.8,72.6
"14640","43110","2020",5,5,0,86900,1253.6,70.4
"14641","43111","2020",15,15,0,91888.67,1166.533,80.53333
"14642","43112","2020",56,47,9,100221.2,1172.179,85.75
"14643","43113","2020",11,11,0,151246.5,1526.727,99
"14644","43114","2020",27,27,0,135220.4,1382.259,99.92593
"14645","43115","2020",15,15,0,129706.7,1381.467,89.66667
"14646","43116","2020",3,3,0,134626.7,1362,87.33333
"14647","43117","2020",3,3,0,96000,882.6667,115.6667
"14648","43118","2020",3,2,1,164373.3,1424.667,119.6667
"14649","43119","2020",5,3,2,111720,1246.6,84.8
"14650","43120","2020",10,10,0,83090,1079.2,78.2
"14651","43121","2020",2,2,0,92500,965,102.5
"14652","43122","2020",2,2,0,95305,1302,76
"14653","43123","2020",4,4,0,205125,1608.5,123.5
"14654","43124","2020",13,13,0,125557.9,1422.154,96.38462
"14655","43125","2020",1,1,0,60000,857,70
"14656","43126","2020",11,11,0,130009.1,1167.091,112.9091
"14657","43127","2020",19,19,0,144262.1,1543.684,93.10526
"14658","43128","2020",1,1,0,1e+05,1333,75
"14659","43129","2020",3,3,0,72333.33,889.6667,102.6667
"14660","43130","2020",20,20,0,130863,1679.65,94.6
"14661","43131","2020",1,1,0,1e+05,926,108
"14662","43132","2020",13,13,0,73714.62,877.3077,84.46154
"14663","43134","2020",4,4,0,104500,1812.5,57.25
"14664","43135","2020",20,20,0,108725,1128.5,112.5
"14665","43136","2020",8,8,0,121437.5,1081.375,110.875
"14666","43137","2020",104,88,16,191730.3,1902.24,101.9615
"14667","43138","2020",4,4,0,64873.75,980.75,68.75
"14668","43141","2020",13,10,3,114024.6,1159.231,100.7692
"14669","43142","2020",5,5,0,175620,3274.4,72.8
"14670","43143","2020",4,4,0,79750,1445,56.75
"14671","43145","2020",1,1,0,118000,472,250
"14672","43147","2020",11,11,0,130129.1,1174,115.0909
"14673","43148","2020",8,8,0,79075,826.25,88.375
"14674","43149","2020",1,0,1,38000,950,40
"14675","43150","2020",9,9,0,132022.2,1515.111,84
"14676","43151","2020",3,3,0,97333.33,1235.333,80.66667
"14677","43152","2020",13,13,0,184456.2,1658.462,104.2308
"14678","43153","2020",13,13,0,166080.8,1612.615,102.6154
"14679","43154","2020",6,5,1,77231.67,1274.667,61.33333
"14680","43155","2020",4,4,0,210932.5,2260.25,113.75
"14681","43156","2020",5,5,0,129703.8,1374,111
"14682","43157","2020",327,69,258,108700.2,1428.3,76.72783
"14683","43158","2020",5,5,0,142900,1709,93.6
"14684","43159","2020",7,7,0,176335.7,1784.286,101.5714
"14685","43160","2020",6,6,0,125304.2,1035.833,105
"14686","43162","2020",52,49,3,109899.2,1402.712,82.5
"14687","43163","2020",15,15,0,104549.3,999.9333,107.7333
"14688","43164","2020",14,14,0,79045.36,794.0714,94.57143
"14689","43165","2020",10,10,0,157690,1662.7,94
"14690","43166","2020",3,3,0,88666.67,937.6667,98.33333
"14691","43167","2020",2,2,0,81000,747.5,107.5
"14692","43168","2020",5,5,0,74300,1141,65
"14693","43169","2020",3,3,0,133333.3,1078,120
"14694","43170","2020",2,2,0,197800,1154.5,172
"14695","43171","2020",3,3,0,46250,564,84
"14696","43172","2020",5,4,1,120400,1403.4,85.4
"14697","43173","2020",3,3,0,93333.33,1017.667,110
"14698","43174","2020",7,7,0,158921.4,1498.286,107
"14699","43175","2020",2,2,0,119500,857.5,130
"14700","43177","2020",42,33,9,144434.5,1470.024,103.2857
"14701","43178","2020",5,4,1,80800,934.4,86
"14702","43181","2020",8,8,0,169865,1552,124
"14703","43182","2020",2,2,0,124300,1091.5,115.5
"14704","43183","2020",1,1,0,45000,662,68
"14705","43184","2020",22,17,5,178596.6,2089.091,93
"14706","43185","2020",47,47,0,96327.45,1107.83,87.80851
"14707","43186","2020",13,12,1,99157.69,1200.769,76.30769
"14708","43187","2020",4,4,0,95362.5,978.75,96.5
"14709","43188","2020",5,5,0,136598,1021.6,122.6
"14710","43189","2020",9,9,0,67444.44,813.1111,93.44444
"14711","43190","2020",31,31,0,167526.4,1646,101.6129
"14712","43191","2020",3,3,0,203050,2001.667,101.3333
"14713","43192","2020",3,3,0,119000,1240.333,109
"14714","43193","2020",3,3,0,36000,567.3333,66
"14715","43194","2020",8,8,0,134925,1438,92.25
"14716","43195","2020",4,4,0,120612.5,1725,81
"14717","43196","2020",4,3,1,58724,953.25,65
"14718","43197","2020",3,3,0,83233.33,1107.667,79
"14719","43198","2020",9,9,0,82277.78,1056.333,91.88889
"14720","43199","2020",12,12,0,119086.7,1514.917,82.33333
"14721","43200","2020",27,23,4,143127.4,1554.111,91.85185
"14722","43201","2020",5,5,0,153600,924.6,153
"14723","43203","2020",5,5,0,168210,1422,102
"14724","43204","2020",5,4,1,149712,1177.8,123.4
"14725","43205","2020",37,32,5,184590.5,2035.027,94.45946
"14726","43206","2020",6,4,2,91533.33,997.8333,103.6667
"14727","43207","2020",1,1,0,179000,1967,91
"14728","43208","2020",2,2,0,45375,509.5,88.5
"14729","43210","2020",7,7,0,68450,936.7143,71.71429
"14730","43211","2020",24,24,0,135003.1,1499.292,89.95833
"14731","43212","2020",14,13,1,113877.1,1069.143,101.7857
"14732","43213","2020",26,24,2,140205.5,1345.731,104.0385
"14733","43214","2020",2,2,0,80650,674,117
"14734","43215","2020",5,4,1,66588,1211,54.2
"14735","43216","2020",23,21,2,156762.6,1434.522,110.1739
"14736","43217","2020",6,6,0,142275,1094.667,126
"14737","43218","2020",7,7,0,212957.1,1694.429,129.5714
"14738","43220","2020",2,2,0,66850,787.5,80
"14739","43221","2020",6,6,0,70416.67,894.6667,80.33333
"14740","43222","2020",2,2,0,39000,507.5,73.5
"14741","43223","2020",3,3,0,183166.7,1499,107.3333
"14742","43224","2020",50,45,5,171037.5,1707.66,100.46
"14743","43225","2020",1,1,0,49000,612,80
"14744","43226","2020",1,1,0,28000,700,40
"14745","43227","2020",4,4,0,186887.5,2149,87.25
"14746","43228","2020",1,1,0,125000,833,150
"14747","43229","2020",4,4,0,185000,1536,119
"14748","43230","2020",15,15,0,125532,1484.667,90.86667
"14749","43231","2020",1,1,0,72000,2000,36
"14750","43232","2020",3,3,0,109490,1380,79.33333
"14751","43233","2020",7,6,1,147495.7,1416.143,112
"14752","43234","2020",14,13,1,130714.3,1174.571,116.9286
"14753","43236","2020",17,6,11,87852.94,1086.824,77.29412
"14754","43237","2020",1,1,0,45000,529,85
"14755","43238","2020",2,2,0,138750,1203,117.5
"14756","43239","2020",7,7,0,60400,725.5714,81.57143
"14757","43240","2020",3,3,0,89986.67,824,96.33333
"14758","43241","2020",10,9,1,132405,1306.8,101.1
"14759","43244","2020",40,31,9,114203.9,1315.925,91.5
"14760","43245","2020",8,8,0,93675,1064.625,89.75
"14761","43246","2020",10,10,0,113820,1326.4,84.6
"14762","43249","2020",9,9,0,125943.4,1134.444,114.1111
"14763","43251","2020",52,22,30,131535.2,1450.038,90.61538
"14764","43252","2020",1,1,0,142000,4581,31
"14765","43253","2020",6,6,0,94604.83,1430,76
"14766","43254","2020",1,1,0,24200,637,38
"14767","43256","2020",5,5,0,105066,1403.6,82.4
"14768","43257","2020",5,4,1,80890,980.2,81
"14769","43258","2020",19,19,0,116948.4,1138.579,99.63158
"14770","43259","2020",6,6,0,71525,876.3333,77.5
"14771","43262","2020",23,15,8,83266.96,1038.304,75.91304
"14772","43263","2020",1,1,0,188640,925,204
"14773","43264","2020",8,8,0,105421.2,915,112.375
"14774","43265","2020",17,17,0,200158.5,1759.588,113.1765
"14775","43267","2020",20,19,1,102987.5,1170.75,94.8
"14776","43268","2020",76,61,15,159192.7,1539.184,102.5132
"14777","44001","2020",32,32,0,138911.8,1569.375,92.96875
"14778","44002","2020",44,36,8,221263,2374.273,96.5
"14779","44003","2020",64,52,12,209131.4,2067.625,101.7812
"14780","44005","2020",85,83,2,214193.2,2155.235,101.7176
"14781","44006","2020",42,41,1,214479.1,2575,89.11905
"14782","44007","2020",38,38,0,120693.1,1264.342,95.65789
"14783","44009","2020",102,91,11,341093.4,3231.118,109.098
"14784","44010","2020",121,97,24,265305.2,3700.661,76.21488
"14785","44012","2020",100,84,16,267361,3544.92,79.27
"14786","44013","2020",38,37,1,194486.1,1968.789,102.6579
"14787","44014","2020",41,39,2,245784.1,2507.488,98
"14788","44015","2020",120,106,14,173735.4,1903.675,94.26667
"14789","44016","2020",17,17,0,171548.6,1775.176,100.1176
"14790","44018","2020",109,93,16,291651.5,2919.945,101.9541
"14791","44019","2020",12,12,0,156333.2,1337.25,116.4167
"14792","44020","2020",277,228,49,257281.7,2948.978,90.66787
"14793","44021","2020",79,78,1,185336.3,2014.747,92.93671
"14794","44022","2020",39,37,2,151439.3,1685.974,96.4359
"14795","44023","2020",35,35,0,171131.5,1917.314,93.22857
"14796","44024","2020",30,28,2,240109.5,2599.933,93.86667
"14797","44025","2020",56,55,1,187336.3,1946.107,99.17857
"14798","44026","2020",239,155,84,302040.9,3153.556,97.43096
"14799","44027","2020",25,25,0,250933,2175.4,116.28
"14800","44028","2020",55,54,1,242054.7,2319.109,105.2909
"14801","44029","2020",81,81,0,218830.7,2328.111,97.16049
"14802","44030","2020",46,45,1,165026.7,1761.217,96.3913
"14803","44031","2020",19,19,0,111703.2,1110.316,105.8947
"14804","44032","2020",43,41,2,220491.9,2184.698,102.186
"14805","44033","2020",26,26,0,240471.1,2201.654,109.8077
"14806","44035","2020",229,167,62,320629,3312.288,99.27948
"14807","44036","2020",187,155,32,137233.8,1483.358,91.50267
"14808","44037","2020",21,20,1,236563.3,2520.238,95.47619
"14809","44038","2020",43,42,1,209702.3,2241.349,94.74419
"14810","44039","2020",14,13,1,236250,2482,95.42857
"14811","44041","2020",71,71,0,236124.9,2392.775,103.3239
"14812","44043","2020",91,78,13,280832.7,2832.626,99.53846
"14813","44044","2020",20,20,0,131322.9,1476.95,92.9
"14814","44045","2020",40,40,0,253658.3,2277.4,114.925
"14815","44046","2020",24,24,0,243946.3,2403.75,101.625
"14816","44047","2020",313,264,49,267818,3048.505,92.30671
"14817","44048","2020",29,29,0,201495.7,1868.172,109.6207
"14818","44049","2020",205,88,117,225582.7,3507.551,65.76585
"14819","44050","2020",34,34,0,201200.4,1772.559,113.2647
"14820","44051","2020",50,48,2,143612.6,1526.12,100.94
"14821","44052","2020",107,105,2,154191.9,1663.234,94.59813
"14822","44053","2020",28,28,0,177200,1717.75,101.7143
"14823","44054","2020",41,41,0,127938.1,1235.756,102.4634
"14824","44055","2020",902,298,604,361181.2,5074.667,72.9745
"14825","44056","2020",55,52,3,197336.4,1959.382,106.7455
"14826","44057","2020",34,33,1,120579.1,1260.147,99.20588
"14827","44058","2020",11,11,0,107000,962.6364,116
"14828","44061","2020",50,48,2,192820,2028.62,101.24
"14829","44062","2020",26,25,1,134251.3,1618.923,88
"14830","44063","2020",35,34,1,192763.7,2054.457,96.08571
"14831","44064","2020",50,49,1,254282.1,2359.24,108.98
"14832","44065","2020",16,16,0,116156.2,1174.562,98.5
"14833","44066","2020",84,83,1,306171.5,2712.298,114.4762
"14834","44067","2020",105,103,2,117268.8,1284.505,96.27619
"14835","44068","2020",63,63,0,135016,1506.286,92.38095
"14836","44069","2020",293,237,56,311553.8,3032.881,105.9898
"14837","44070","2020",61,59,2,282506.3,2658.721,108.9836
"14838","44071","2020",50,50,0,323176.2,3073.48,113.56
"14839","44072","2020",114,114,0,204761.4,1987.228,106.0877
"14840","44073","2020",59,59,0,245063.1,2238.864,115.5593
"14841","44074","2020",66,51,15,230234.1,2956.788,79.57576
"14842","44075","2020",28,28,0,116214.3,1241.107,92.82143
"14843","44076","2020",21,21,0,93357.14,1120.333,81.33333
"14844","44077","2020",23,23,0,170921.7,1769.609,101.1739
"14845","44078","2020",5,5,0,60400,857.6,76.4
"14846","44079","2020",37,36,1,222268.7,2140.622,105.5135
"14847","44080","2020",10,10,0,160700,1834.8,91.7
"14848","44081","2020",75,75,0,169087,1779.08,100.8267
"14849","44082","2020",58,56,2,220096.9,2139.569,103.8103
"14850","44083","2020",32,32,0,209243.8,2072.031,102.3125
"14851","44084","2020",92,81,11,229454,2555.25,91.33696
"14852","44085","2020",7,7,0,154500,1364.286,116.5714
"14853","44086","2020",8,8,0,94450,1036.5,93.25
"14854","44087","2020",112,96,16,182644,1949.241,95.38393
"14855","44088","2020",37,35,2,211317.6,2120.514,99.54054
"14856","44089","2020",43,43,0,212631.2,2202.791,100.907
"14857","44090","2020",18,18,0,176102.8,1845.722,98.5
"14858","44091","2020",35,35,0,138658.9,1336.229,104.3429
"14859","44092","2020",21,21,0,93715.19,986.4286,91.52381
"14860","44094","2020",37,34,3,280048.8,2906.486,102.1081
"14861","44095","2020",25,25,0,118220,1280.68,96.76
"14862","44096","2020",46,45,1,213986,2207.696,101.0652
"14863","44097","2020",62,53,9,272900.4,3303.516,85.67742
"14864","44098","2020",91,88,3,168841.8,1779.099,97.36264
"14865","44099","2020",19,19,0,149463.2,1356.947,103.2632
"14866","44100","2020",27,27,0,214579.4,2292.556,95.44444
"14867","44101","2020",64,59,5,230434.5,2818.75,84.53125
"14868","44102","2020",35,35,0,222168.6,2140.857,104.9429
"14869","44103","2020",79,55,24,148249.8,1929.684,79.13924
"14870","44104","2020",17,17,0,153470.6,1525.353,99
"14871","44105","2020",7,7,0,105855.7,1258.286,81.42857
"14872","44106","2020",52,50,2,239877.1,3239.135,81.51923
"14873","44107","2020",31,31,0,177838.5,1897.29,94.67742
"14874","44108","2020",25,25,0,206162,2071.24,102.6
"14875","44109","2020",5415,1172,4243,261929.6,3805.358,68.20369
"14876","44110","2020",86,79,7,219362.6,2366.256,95.34884
"14877","44111","2020",26,25,1,235985.8,2612.115,107.2308
"14878","44112","2020",3,3,0,183589.3,1522.333,109.6667
"14879","44113","2020",67,57,10,148071.8,1648.642,95.59701
"14880","44114","2020",371,222,149,299258.8,3277.178,93.47978
"14881","44115","2020",48,47,1,256863.3,2325.625,111.7292
"14882","44116","2020",5,4,1,140400,1383,110.6
"14883","44117","2020",44,40,4,218165,2255.205,96.79545
"14884","44118","2020",21,21,0,149119,1449.571,103.7619
"14885","44119","2020",26,26,0,169407.7,1790.654,102.3077
"14886","44120","2020",67,60,7,216016.9,2506.045,89.73134
"14887","44121","2020",6,6,0,136000,1604.833,84.66667
"14888","44122","2020",36,36,0,234432.3,2326.917,101.4722
"14889","44123","2020",12,12,0,131708.3,1063.833,124.5
"14890","44124","2020",9,9,0,97722.22,948.3333,94.88889
"14891","44125","2020",82,76,6,362532,3692.488,100.9512
"14892","44126","2020",129,124,5,227957.6,3237.69,75.90698
"14893","44127","2020",24,24,0,183633.3,1772.417,106.9167
"14894","44128","2020",80,80,0,167861.8,1691.175,103.725
"14895","44129","2020",142,114,28,185571,1965.514,96.3662
"14896","44130","2020",88,88,0,259508.1,2892.943,93.72727
"14897","44131","2020",358,288,70,338069,4000.327,86.08939
"14898","44132","2020",393,161,232,318822,4629.117,72.56743
"14899","44133","2020",31,30,1,207946.8,2302.774,87.35484
"14900","44134","2020",13,13,0,191153.8,1967.615,106.6923
"14901","44135","2020",211,102,109,317631.7,4457.839,72.81517
"14902","44136","2020",49,41,8,296234.7,3657.184,82.04082
"14903","44137","2020",39,39,0,183661.2,1906.256,97.41026
"14904","44138","2020",12,10,2,148544.6,1669.167,92.5
"14905","44139","2020",19,19,0,162405.3,1862.263,90.63158
"14906","44140","2020",10,10,0,193413,1979.9,99
"14907","44141","2020",17,17,0,187944.1,1794.529,104.1176
"14908","44142","2020",25,25,0,192462.4,2021,99.52
"14909","44143","2020",732,364,368,239654.3,3107.679,77.0724
"14910","44144","2020",31,30,1,123777.3,1317.613,97.58065
"14911","44145","2020",32,32,0,237562.5,2506.062,101.25
"14912","44146","2020",42,41,1,120471.7,1196.762,100
"14913","44148","2020",10,10,0,109100,1090.1,99.1
"14914","44149","2020",51,49,2,170004.9,1746.765,98.90196
"14915","44150","2020",56,56,0,269333,2528.482,110.7679
"14916","44151","2020",116,106,10,307260.5,2763.586,109.0086
"14917","44152","2020",37,37,0,198310.8,2052.081,99.86486
"14918","44153","2020",17,17,0,143842.1,1529.235,100.8824
"14919","44154","2020",398,274,124,244101.4,3345.276,75.63065
"14920","44155","2020",54,54,0,193777,2008.037,102.6481
"14921","44156","2020",49,47,2,166917.9,1739.857,95.97959
"14922","44157","2020",24,24,0,153560.6,1589.917,97.5
"14923","44158","2020",105,101,4,291532,2820.905,106.5048
"14924","44159","2020",16,15,1,285968.8,2516.375,112.6875
"14925","44161","2020",38,38,0,152111.8,1573.579,97.47368
"14926","44162","2020",798,296,502,214366.6,2725.461,78.47744
"14927","44163","2020",53,52,1,168526.4,1680.019,102.3019
"14928","44164","2020",26,26,0,197925,2032.154,97.42308
"14929","44165","2020",30,30,0,223388.6,2145.067,106.3
"14930","44166","2020",79,79,0,245638.8,2728.608,93.59494
"14931","44168","2020",55,55,0,159324.7,1753.691,94.50909
"14932","44169","2020",103,93,10,236282.1,2482.728,96.38835
"14933","44170","2020",11,11,0,90636.36,954.6364,102.3636
"14934","44171","2020",18,18,0,282694.4,2324.833,120.6667
"14935","44172","2020",180,129,51,267857.4,3315.883,82.73333
"14936","44173","2020",23,23,0,215482.6,2313.826,97.52174
"14937","44174","2020",27,27,0,186225.6,1858.852,101.4444
"14938","44175","2020",67,67,0,244059.5,2363.09,112.7612
"14939","44176","2020",43,42,1,162016.7,1727.674,95.06977
"14940","44178","2020",26,26,0,239326.8,2112.962,113.8462
"14941","44179","2020",56,56,0,249334.4,2506.839,100.4643
"14942","44180","2020",31,30,1,130886.3,1312.871,100.7097
"14943","44182","2020",145,117,28,224245.1,3492.703,70.55862
"14944","44183","2020",44,44,0,281104.3,2341.523,117.1364
"14945","44184","2020",1215,559,656,190649.2,2591.291,74.97778
"14946","44185","2020",46,39,7,137841.4,1525.109,95.13043
"14947","44186","2020",80,76,4,224765.1,2382.387,97.7
"14948","44187","2020",59,55,4,202024.6,2203.017,93.25424
"14949","44188","2020",106,104,2,222731.9,2296.377,100.1132
"14950","44189","2020",20,19,1,162998,1847,88.55
"14951","44190","2020",460,253,207,264179.7,3267.002,82.11087
"14952","44192","2020",41,41,0,195842,2238.098,88.56098
"14953","44193","2020",28,28,0,118035.4,1019.571,116.7857
"14954","44194","2020",97,75,22,379066.9,3592.031,107.3608
"14955","44195","2020",75,67,8,222265.8,2357.013,94.48
"14956","44196","2020",29,29,0,142610.3,1656.103,91.06897
"14957","44197","2020",22,22,0,103344.9,1107.818,97.31818
"14958","44198","2020",152,109,43,252334,2879.289,88.65132
"14959","44199","2020",31,31,0,116411.6,1104,103.4839
"14960","44200","2020",13,13,0,87153.85,994.6154,93
"14961","44201","2020",36,36,0,399451.4,3384.083,125.7222
"14962","44202","2020",22,22,0,156886.4,1468.045,107.6818
"14963","44203","2020",23,22,1,237360.9,2245.13,110.0435
"14964","44204","2020",97,77,20,290443.1,3162.722,94.46392
"14965","44205","2020",32,32,0,205530,2002.688,108
"14966","44206","2020",32,32,0,138270.5,1531.938,92
"14967","44207","2020",11,11,0,140290.9,1725.273,81.45455
"14968","44208","2020",12,12,0,108193.7,1145.333,98.75
"14969","44209","2020",112,103,9,321100.9,3002.875,111.4196
"14970","44210","2020",122,103,19,168235.3,2133.893,83.98361
"14971","44211","2020",152,103,49,235591.2,3347.053,77.31579
"14972","44212","2020",113,102,11,217806.6,2213.027,100.3628
"14973","44213","2020",99,97,2,154390.8,1585.455,101.1313
"14974","44214","2020",33,33,0,117615.2,1359.182,85.39394
"14975","44215","2020",335,280,55,328076.5,3407.543,97.78806
"14976","44216","2020",56,56,0,173757,1689.446,103.3214
"14977","44217","2020",99,96,3,324609.7,2691.313,123.4141
"14978","44218","2020",17,17,0,106264.7,1391.706,88
"14979","44220","2020",27,27,0,226351.9,2298.741,97.11111
"14980","44221","2020",22,22,0,197395.1,1885.682,104.9545
"14981","44222","2020",15,15,0,154530,1694.067,91.66667
"14982","44223","2020",58,54,4,235828.1,2388.603,98.74138
"14983","44224","2020",28,28,0,161657.1,1735.964,98.07143
"14984","45001","2020",4,4,0,145075,1194.75,115.25
"14985","45002","2020",8,8,0,132562.5,1259.375,112.5
"14986","45004","2020",169,163,6,143126.4,1501.456,95.79882
"14987","45005","2020",3,3,0,197266.7,1929,105
"14988","45006","2020",23,12,11,211884.8,2442,88.6087
"14989","45008","2020",12,11,1,164733.3,1817.417,91.75
"14990","45009","2020",14,14,0,121917.1,1415.714,87.57143
"14991","45010","2020",10,10,0,167025,1702.2,103.6
"14992","45011","2020",2,2,0,150000,1865,95
"14993","45012","2020",3,3,0,137900,2333,75
"14994","45013","2020",3,3,0,154833.3,1953.667,81.66667
"14995","45014","2020",13,13,0,184988.4,1477.077,131.6154
"14996","45015","2020",15,15,0,176480,1780.4,103
"14997","45016","2020",10,10,0,140045,1297.7,103
"14998","45017","2020",3,3,0,130000,1685,89.66667
"14999","45018","2020",15,15,0,111393.3,1230.133,106.5333
"15000","45019","2020",13,13,0,183492.3,1357.615,139.4615
"15001","45020","2020",11,11,0,185900,1766.182,104.7273
"15002","45021","2020",7,7,0,157714.3,1193,134.1429
"15003","45022","2020",12,12,0,138808.3,1230.083,115.9167
"15004","45024","2020",24,24,0,169315,1923.542,94.83333
"15005","45025","2020",17,17,0,176974.7,1836.706,99
"15006","45026","2020",12,12,0,117670.8,1584.75,79.83333
"15007","45027","2020",5,5,0,168000,1491.4,117
"15008","45028","2020",114,77,37,141187.6,1640.096,87.78947
"15009","45029","2020",28,28,0,84217.86,986.7143,86.53571
"15010","45030","2020",25,24,1,112246,1231.68,92.4
"15011","45031","2020",19,19,0,110593,1250.737,89.26316
"15012","45032","2020",6,6,0,240541.7,1574.5,151
"15013","45033","2020",13,13,0,137665.8,1338.769,103.9231
"15014","45034","2020",18,15,3,222600.8,2196.389,106.1111
"15015","45035","2020",26,24,2,110602.3,1127.269,111.5
"15016","45036","2020",12,12,0,139458.3,1364.833,104.25
"15017","45037","2020",6,6,0,159785,1952.333,87.5
"15018","45038","2020",5,5,0,190950,1870.2,104
"15019","45039","2020",8,8,0,164000,1594.375,105.75
"15020","45040","2020",19,19,0,95331.58,1124.053,87.89474
"15021","45041","2020",1,1,0,68000,596,114
"15022","45042","2020",25,25,0,142644.6,1364.24,105.64
"15023","45043","2020",11,11,0,219390.9,2045.455,116.0909
"15024","45044","2020",3,3,0,217566.7,1639,132.3333
"15025","45045","2020",2,2,0,160000,1365,117.5
"15026","45046","2020",6,5,1,148364.2,1440.667,103.5
"15027","45047","2020",7,7,0,137923.1,1241.429,127.2857
"15028","45049","2020",23,23,0,190207,1752.13,112.1739
"15029","45050","2020",18,18,0,132392.8,1316.111,98.61111
"15030","45051","2020",19,19,0,160948.4,1416,117.5789
"15031","45052","2020",4,4,0,64750,610,102
"15032","45053","2020",58,55,3,124966.5,1453.483,87.27586
"15033","45054","2020",14,14,0,156107.1,1727.286,94.5
"15034","45055","2020",6,5,1,176083.3,1784.5,97.66667
"15035","45056","2020",3,3,0,170666.7,1501,117.3333
"15036","45058","2020",3,3,0,136333.3,1384,99
"15037","45059","2020",1,1,0,140000,1022,137
"15038","45060","2020",13,13,0,120715.4,1647.077,84.84615
"15039","45061","2020",41,39,2,117856,1345.024,87.70732
"15040","45062","2020",18,17,1,204222.8,1735.167,121.8889
"15041","45063","2020",22,21,1,114977.3,1204.727,91.40909
"15042","45064","2020",7,7,0,79214.29,782.1429,95
"15043","45065","2020",4,3,1,152000,1660.5,93
"15044","45066","2020",24,24,0,123294.5,1416.042,93.83333
"15045","45067","2020",51,51,0,193225.1,1872.412,104.3529
"15046","45068","2020",123,106,17,101567.4,1344.602,79.22764
"15047","45069","2020",12,12,0,142275.1,1391.083,109.9167
"15048","45072","2020",17,16,1,254205.9,2202.118,120
"15049","45073","2020",14,14,0,124250,1164.5,113.5714
"15050","45074","2020",1,1,0,21000,389,54
"15051","45075","2020",133,96,37,182193.7,1995.571,91.71429
"15052","45076","2020",7,7,0,125814.3,1117.143,120
"15053","45077","2020",10,10,0,108790,1139.8,99.4
"15054","45078","2020",4,4,0,147312.5,1258.25,120
"15055","45079","2020",6,6,0,81928.33,1368.5,64.83333
"15056","45080","2020",6,6,0,72500,1172.333,78.5
"15057","45081","2020",8,8,0,140118.1,1258.75,111.375
"15058","45082","2020",114,87,27,153234.2,1871.553,84.01754
"15059","45083","2020",27,26,1,85381.48,1033.593,87.14815
"15060","45084","2020",8,8,0,129063.8,1226.625,103.125
"15061","45085","2020",36,36,0,102478.3,1160.861,85
"15062","45086","2020",1,1,0,198000,1523,130
"15063","45087","2020",45,45,0,89280.89,1005.444,89.88889
"15064","45088","2020",3,3,0,178932.7,2337.333,81.33333
"15065","45089","2020",113,97,16,194230.5,2052.912,97.18584
"15066","45091","2020",4,4,0,171750,1720.75,117
"15067","45092","2020",18,18,0,166063.9,1543.278,114.1667
"15068","45093","2020",36,34,2,194476.9,1807.5,114.5556
"15069","45094","2020",7,7,0,214770,2120.857,114.2857
"15070","45095","2020",20,20,0,161513,1508.8,119.15
"15071","45096","2020",16,16,0,135959.4,1545.062,107.4375
"15072","45097","2020",26,26,0,104044.6,1170.885,91.38462
"15073","45098","2020",50,50,0,178859.8,1847.38,101.26
"15074","45099","2020",3,3,0,266383.3,2457.667,110
"15075","45100","2020",5,5,0,306610,2029.4,155
"15076","45101","2020",4,4,0,164627.5,1580,101.75
"15077","45102","2020",3,3,0,212583.3,1578.667,136
"15078","45103","2020",13,13,0,123664.7,1373.077,91.92308
"15079","45104","2020",30,30,0,123895.5,1406.233,87.86667
"15080","45107","2020",7,7,0,148642.9,1443.286,93.42857
"15081","45108","2020",32,32,0,114101.2,1137.812,97.40625
"15082","45109","2020",7,7,0,166107.1,2302.143,86.28571
"15083","45110","2020",11,11,0,156479.5,1635.273,105.5455
"15084","45111","2020",8,8,0,139762.8,1413.625,102.375
"15085","45112","2020",4,4,0,166750,1168.25,144.75
"15086","45113","2020",9,9,0,151316.7,1474.889,110.7778
"15087","45114","2020",3,3,0,160666.7,1042.667,167.6667
"15088","45115","2020",81,81,0,120796.8,1373.753,91.49383
"15089","45116","2020",14,14,0,145760.4,1265.429,123.9286
"15090","45118","2020",4,4,0,148775,1671.25,91
"15091","45119","2020",37,37,0,161816,1649.784,98.78378
"15092","45120","2020",5,5,0,78300,811.4,92.8
"15093","45121","2020",19,19,0,83973.16,1039.842,89.47368
"15094","45122","2020",15,15,0,147204.3,1382.8,105.9333
"15095","45123","2020",28,28,0,190788.4,1779.143,117.1071
"15096","45124","2020",2,2,0,194500,1406,138.5
"15097","45125","2020",3,3,0,133836.7,2322,59.33333
"15098","45126","2020",36,33,3,207277.8,1870.139,113.5833
"15099","45127","2020",53,53,0,152562,1768.208,88.56604
"15100","45129","2020",34,34,0,120657.1,1139.441,108.3235
"15101","45130","2020",10,10,0,194480,1688.7,124.2
"15102","45131","2020",12,12,0,159628.8,1513.5,113.0833
"15103","45132","2020",7,7,0,102961.7,1150.286,88.85714
"15104","45133","2020",6,6,0,169850,1660.833,118.6667
"15105","45134","2020",9,9,0,158189,1320.333,127
"15106","45135","2020",4,4,0,110550,1711.75,78.25
"15107","45136","2020",14,14,0,114903.6,1422.857,83.07143
"15108","45137","2020",11,11,0,117090.9,1368.909,89.45455
"15109","45139","2020",7,7,0,183350,1781.143,113.5714
"15110","45141","2020",1,1,0,87000,1088,80
"15111","45142","2020",53,50,3,203495.1,1951.585,108.1132
"15112","45144","2020",10,10,0,177236,1937.2,90.6
"15113","45145","2020",68,67,1,174428.9,1642.485,109.2941
"15114","45146","2020",83,75,8,163991.7,1959.265,89.18072
"15115","45147","2020",267,148,119,149381.7,1920.637,80.02996
"15116","45148","2020",24,24,0,123014,1480.958,89.125
"15117","45149","2020",8,8,0,99500,1412.25,71.5
"15118","45150","2020",3,3,0,167700,1286.333,131
"15119","45151","2020",7,7,0,157314.3,1410.714,119.4286
"15120","45152","2020",3,3,0,171766.7,1405,138
"15121","45153","2020",12,12,0,206568.3,1751.583,120.3333
"15122","45154","2020",15,15,0,188477.3,1923.467,97.26667
"15123","45155","2020",176,127,49,106171.8,1239.142,86.40341
"15124","45156","2020",16,16,0,124375,1428,94.8125
"15125","45157","2020",5,5,0,106700,1184.2,85.6
"15126","45158","2020",7,7,0,116742.9,1167,103.1429
"15127","45159","2020",1,1,0,195666,2198,89
"15128","45160","2020",8,8,0,163650,1491.375,114.625
"15129","45161","2020",9,9,0,157961.8,1509.556,103
"15130","45162","2020",9,9,0,119988.9,1329.889,100.1111
"15131","45164","2020",7,7,0,167400,1560.714,118.1429
"15132","45165","2020",9,9,0,108833.3,1327.667,82.33333
"15133","45166","2020",3,3,0,104003.3,1019.333,97
"15134","45167","2020",23,21,2,199050,1688.826,127.7391
"15135","45168","2020",10,10,0,157770,1827.4,90.5
"15136","45169","2020",93,82,11,218554,2285.495,100.0753
"15137","45170","2020",3,3,0,151000,2142.333,76.33333
"15138","45171","2020",11,11,0,134172.7,1883.364,83.90909
"15139","45173","2020",51,45,6,190603,1842.902,107.6275
"15140","45174","2020",2,2,0,125500,1110,114.5
"15141","45175","2020",17,17,0,245247.9,1925,136.0588
"15142","45176","2020",8,8,0,125625,1122.5,128.75
"15143","45177","2020",6,6,0,126426.2,1462.833,84.66667
"15144","45178","2020",22,21,1,96545.45,1117.091,88.72727
"15145","45179","2020",46,44,2,173805.1,1680.37,106.6739
"15146","45180","2020",1,1,0,60000,2400,25
"15147","45181","2020",1,1,0,69527,790,88
"15148","45182","2020",25,25,0,199364.6,1796.48,113.92
"15149","45183","2020",2,2,0,145320.5,1249,116.5
"15150","45184","2020",5,5,0,174110,1372,117.6
"15151","45185","2020",11,11,0,206272.7,1630.455,128
"15152","45186","2020",11,11,0,115481.8,1366,89.45455
"15153","45187","2020",46,42,4,136931.2,1595,95.69565
"15154","45188","2020",24,24,0,211730,1737.25,125.125
"15155","45189","2020",5,5,0,141920,1195.4,131
"15156","45191","2020",102,72,30,152891.4,1748.922,87.38235
"15157","45193","2020",21,21,0,213028.4,2313.286,103
"15158","45194","2020",28,28,0,234588.2,1948.036,124.3214
"15159","45195","2020",6,6,0,171946.2,1314.333,133.3333
"15160","45196","2020",11,11,0,188727.3,1839.364,103.4545
"15161","45197","2020",23,23,0,217810,1988,111.5217
"15162","45198","2020",3,3,0,176666.7,1313,134
"15163","45199","2020",10,10,0,102645.3,1130.4,90.1
"15164","45200","2020",25,25,0,209596.6,1923.08,107.72
"15165","45201","2020",6,6,0,135166.7,1176.667,111.3333
"15166","45202","2020",12,12,0,161087.5,1727.083,95.25
"15167","45203","2020",83,75,8,193532.1,2038.819,100.0602
"15168","45204","2020",10,10,0,212626.8,2215.5,97.8
"15169","45205","2020",5,5,0,112800,1089.4,109.6
"15170","45206","2020",7,7,0,80309.14,1288.429,67
"15171","45207","2020",9,9,0,116005.6,1164.778,108.1111
"15172","45208","2020",228,101,127,97059.06,1452.873,72.93421
"15173","45209","2020",3,3,0,248250,2195,109.3333
"15174","45210","2020",11,11,0,87566.36,1174.273,73.63636
"15175","45212","2020",17,17,0,149211.8,1332.471,107.4118
"15176","45213","2020",7,6,1,138191.4,1466.571,93.85714
"15177","45214","2020",2,2,0,175000,1130.5,154
"15178","45216","2020",1,1,0,80000,909,88
"15179","45217","2020",1,1,0,150000,2083,72
"15180","45218","2020",2,2,0,362500,1681,215.5
"15181","45219","2020",3,3,0,144333.3,1206,117.3333
"15182","45220","2020",7,7,0,97950,1023.857,100.2857
"15183","45222","2020",27,27,0,154885.2,1555.815,104.5185
"15184","45223","2020",5,5,0,107000,1194.8,88.2
"15185","45224","2020",44,39,5,164847.4,1849.5,92.77273
"15186","45225","2020",5,5,0,204400,1388.2,129.6
"15187","45226","2020",22,22,0,152200,1601.273,102.1818
"15188","45227","2020",14,14,0,175110.9,1553.929,117.3571
"15189","45228","2020",23,23,0,126674.6,1469.826,90.13043
"15190","45229","2020",32,32,0,121190.9,1326.281,95.1875
"15191","45230","2020",15,15,0,126233.6,1233.333,102.6
"15192","45231","2020",4,4,0,117250,1355.75,112.75
"15193","45232","2020",376,217,159,206639,2345.463,89.84043
"15194","45233","2020",7,7,0,128098.3,1680.429,80
"15195","45234","2020",1909,471,1438,157248.4,2316.261,69.58041
"15196","45235","2020",28,24,4,216170.9,2153.071,105.0714
"15197","45237","2020",1,1,0,230000,2212,104
"15198","45238","2020",19,19,0,168207.4,1449.158,114.3158
"15199","45239","2020",7,7,0,148642.9,1657.714,92.14286
"15200","45240","2020",23,22,1,162617.4,1691.13,98.73913
"15201","45241","2020",9,9,0,198278.9,1618,133.2222
"15202","45242","2020",1,1,0,98500,1048,94
"15203","45243","2020",3,3,0,111000,1261,92.66667
"15204","45244","2020",42,42,0,148773.9,1479,99.09524
"15205","45245","2020",14,14,0,89810,996.5,93.35714
"15206","45247","2020",47,47,0,143821.9,1390.149,106.3191
"15207","45248","2020",22,21,1,131134.1,1284.182,107.6364
"15208","45249","2020",9,9,0,199977.8,1565.889,130.5556
"15209","45250","2020",7,7,0,143700,1774,91.71429
"15210","45251","2020",10,10,0,103770.3,1188.3,93.5
"15211","45252","2020",92,57,35,106441.5,1355.804,80.3587
"15212","45253","2020",19,19,0,145830.7,1690.158,88.63158
"15213","45254","2020",30,30,0,131336.7,1349.967,96.63333
"15214","45255","2020",4,4,0,123250,1317.75,93.75
"15215","45256","2020",4,4,0,108125,973,103.5
"15216","45257","2020",9,9,0,149083.3,1338.111,105.6667
"15217","45258","2020",57,54,3,141391.1,1580.912,89.19298
"15218","45259","2020",15,15,0,139783.3,1486,97.13333
"15219","45260","2020",2,2,0,148000,1676,92.5
"15220","45261","2020",18,18,0,192323.1,1918.278,101.2778
"15221","45262","2020",4,4,0,108300,1148.75,90.25
"15222","45263","2020",4,4,0,134107.5,1476.75,92.25
"15223","45264","2020",3,3,0,149333.3,2483.333,59
"15224","45265","2020",15,15,0,124033.3,1806.467,78.66667
"15225","45268","2020",16,16,0,113522.5,1237.812,97.1875
"15226","45269","2020",51,51,0,189516.6,1761.412,108.4118
"15227","45270","2020",17,17,0,138317.1,1402.647,103.3529
"15228","45271","2020",16,15,1,99334.38,1430.438,77.0625
"15229","45272","2020",30,30,0,255134.9,2315.1,112.6
"15230","45273","2020",44,40,4,171872.7,1767.977,100.9545
"15231","45274","2020",76,70,6,277212.6,2595.697,109.8684
"15232","45275","2020",10,10,0,95229.9,1165.8,82.6
"15233","45276","2020",8,8,0,117750,1222.25,96.875
"15234","45277","2020",14,14,0,106747.9,1349.357,79.64286
"15235","45278","2020",11,11,0,92863.64,1159.818,77.36364
"15236","45279","2020",22,22,0,135580.9,1468.636,103.8636
"15237","45280","2020",12,12,0,129354.8,1227.667,106.8333
"15238","45281","2020",21,21,0,121112.1,1276.762,103.6667
"15239","45282","2020",26,19,7,237365.4,2495.192,99.73077
"15240","45283","2020",3,3,0,141031.3,1284,108
"15241","45284","2020",337,126,211,150008.1,1945.472,77.50742
"15242","45285","2020",241,136,105,139756.4,1835.946,75.97925
"15243","45286","2020",145,70,75,206051.9,2313.262,87.10345
"15244","45288","2020",4,4,0,124750,1299,99.75
"15245","45289","2020",11,11,0,174784.5,1628.273,105.0909
"15246","45290","2020",24,23,1,190956.8,1654.375,117.3333
"15247","45291","2020",12,12,0,158787.3,1639.833,101.5833
"15248","45292","2020",13,13,0,125269.2,1152.846,110
"15249","45293","2020",13,13,0,123230.8,1187.769,108.3077
"15250","45294","2020",1,1,0,88000,2095,42
"15251","45296","2020",6,6,0,165225,1557.5,107.3333
"15252","45297","2020",20,20,0,139149.5,1536.1,88.45
"15253","45298","2020",80,62,18,214870.5,2255.738,93.7875
"15254","45299","2020",3,3,0,148333.3,1214.667,122.6667
"15255","45300","2020",37,37,0,233678.4,2192.486,111.2162
"15256","45301","2020",5,5,0,180700,2016.8,100.4
"15257","45302","2020",176,135,41,180101.1,2118.716,86.64773
"15258","45303","2020",14,14,0,143527.1,1223.786,118.2143
"15259","45305","2020",2,2,0,170175,1546.5,112
"15260","45306","2020",15,15,0,142760,1423.533,100.6
"15261","45307","2020",25,25,0,127938,1290.76,99.96
"15262","45308","2020",27,26,1,265863,2305.444,118.2963
"15263","45309","2020",13,13,0,136076.9,1494.538,96.15385
"15264","45310","2020",18,17,1,179222.2,1520.778,123.1111
"15265","45311","2020",13,13,0,161653.8,1661.154,105.1538
"15266","45312","2020",8,8,0,107812.5,1257.75,96.5
"15267","45313","2020",18,18,0,168613.9,1675.611,107.4444
"15268","45314","2020",10,10,0,152074,1944,87.9
"15269","45315","2020",56,45,11,122578.6,1413.232,87.91071
"15270","45316","2020",11,11,0,172510,1291.091,129.8182
"15271","45317","2020",19,19,0,169826.3,1913.211,93
"15272","45320","2020",8,8,0,147483.6,1524.75,98.5
"15273","45321","2020",10,10,0,152490,1304.7,117.8
"15274","45322","2020",4,4,0,105475,968,102.5
"15275","45323","2020",5,5,0,94560,1152.8,76
"15276","45324","2020",32,31,1,170492.2,1738.812,103.0625
"15277","45325","2020",5,5,0,112800,1277.6,86.6
"15278","45326","2020",4,4,0,110750,1215,89.5
"15279","45327","2020",30,30,0,191018.9,1826.4,113.8
"15280","45328","2020",6,6,0,144533.3,1463.667,108.5
"15281","45329","2020",31,30,1,110098.8,1257.839,102.8387
"15282","45331","2020",11,11,0,211581.8,1699.727,124.0909
"15283","45332","2020",26,26,0,123886.5,1400.923,89.96154
"15284","45333","2020",25,25,0,190901,1901.36,102.88
"15285","45334","2020",5,5,0,185858,1978.2,96
"15286","45335","2020",22,22,0,181607.6,1784.545,105.5909
"15287","45336","2020",13,13,0,162270,1517.846,110.3846
"15288","45337","2020",1,1,0,135000,1709,79
"15289","45338","2020",5,5,0,178600,1899.4,94.8
"15290","45339","2020",8,8,0,124352.5,1523.25,90.5
"15291","45340","2020",11,11,0,231700,2234.545,98.27273
"15292","45341","2020",7,7,0,123633.4,1201.429,101.2857
"15293","45342","2020",5,5,0,193103.6,1401,160.6
"15294","45343","2020",2,2,0,1e+05,919.5,106
"15295","45344","2020",13,12,1,134692.3,1389.846,101.4615
"15296","45345","2020",11,11,0,144987.9,1589.636,91.18182
"15297","45346","2020",29,29,0,166244.3,1848.379,92.37931
"15298","45347","2020",12,12,0,168619.6,1517.25,117.5833
"15299","45348","2020",9,9,0,146466.7,1932.222,81.77778
"15300","46001","2020",7,7,0,224872.9,1745.714,122.5714
"15301","46002","2020",1,1,0,106000,1767,60
"15302","46003","2020",7,7,0,165677.1,1396.714,116.1429
"15303","46004","2020",2,2,0,64500,785.5,88.5
"15304","46005","2020",6,6,0,132583.3,1017.667,120.3333
"15305","46006","2020",8,8,0,148062.5,1499.625,100.625
"15306","46007","2020",11,11,0,143803.1,1568.909,93.90909
"15307","46008","2020",1,1,0,273700,1165,235
"15308","46009","2020",9,8,1,117450,1422.444,86.44444
"15309","46010","2020",1,1,0,254800,1334,191
"15310","46011","2020",3,3,0,173900,1461,115
"15311","46012","2020",5,5,0,134600,1346.4,97.6
"15312","46013","2020",2,2,0,187900,1194.5,149.5
"15313","46015","2020",12,12,0,98616.67,989,102.9167
"15314","46016","2020",3,3,0,161783.3,1688,97.66667
"15315","46017","2020",1,1,0,108000,1662,65
"15316","46018","2020",1,1,0,60000,882,68
"15317","46021","2020",5,5,0,168240,2135.8,82.6
"15318","46022","2020",3,3,0,272500,2557,91
"15319","46023","2020",5,5,0,198050,1812.2,113
"15320","46024","2020",3,3,0,168260,1336.333,133
"15321","46026","2020",1,1,0,82000,911,90
"15322","46027","2020",1,1,0,225000,1442,156
"15323","46028","2020",16,16,0,115587.2,1226.438,90
"15324","46029","2020",22,20,2,124443.2,1445.864,88.54545
"15325","46030","2020",4,4,0,200250,1634,142.5
"15326","46031","2020",4,4,0,129620,1703.75,75.5
"15327","46032","2020",2,2,0,112450,1820.5,59.5
"15328","46033","2020",10,10,0,207311.7,1886.7,115.5
"15329","46034","2020",5,5,0,126600,918.2,156.4
"15330","46035","2020",2,2,0,136750,1772.5,77
"15331","46036","2020",1,1,0,130000,2167,60
"15332","46037","2020",2,2,0,61000,984.5,68.5
"15333","46038","2020",14,13,1,133814.3,1429.357,94.42857
"15334","46039","2020",1,1,0,172500,2654,65
"15335","46040","2020",1,1,0,144960,1705,85
"15336","46041","2020",1,1,0,112000,1534,73
"15337","46042","2020",335,158,177,119933,1497.958,80.61493
"15338","46043","2020",1,1,0,73000,961,76
"15339","46044","2020",4,4,0,93750,1340.75,66
"15340","46045","2020",15,15,0,187706.7,1694.867,119.5333
"15341","46046","2020",3,3,0,135933.3,1444,98.33333
"15342","46047","2020",3,3,0,92966.67,1200.333,81
"15343","46049","2020",4,4,0,257000,1451.25,154.75
"15344","46050","2020",3,3,0,68176,854.3333,73
"15345","46051","2020",2,2,0,148150,1559.5,95.5
"15346","46052","2020",4,4,0,147725,1432.75,101.25
"15347","46053","2020",2,2,0,152500,1367.5,116.5
"15348","46054","2020",3,3,0,137400,1242.667,105
"15349","46055","2020",11,11,0,114604.5,1101.091,105.1818
"15350","46056","2020",1,1,0,80000,1333,60
"15351","46057","2020",10,10,0,174530,1481,122
"15352","46058","2020",3,3,0,143783.3,1474,102.3333
"15353","46059","2020",4,4,0,118500,1325.75,90.25
"15354","46060","2020",3,3,0,156490,1660.667,94.66667
"15355","46061","2020",2,2,0,159000,1239.5,128.5
"15356","46062","2020",12,11,1,124008.3,1137,118
"15357","46063","2020",21,21,0,147885,1429.667,100.9524
"15358","46064","2020",17,16,1,129910.8,1185.412,106.5294
"15359","46065","2020",5,5,0,138770,1342.8,111.8
"15360","46066","2020",12,12,0,190454.2,1847,108
"15361","46068","2020",4,4,0,90250,922.75,93
"15362","46069","2020",5,5,0,117500,1288.2,86.4
"15363","46070","2020",5,5,0,166239.6,1751,98
"15364","46072","2020",5,5,0,166350.4,1405.4,111.6
"15365","46073","2020",9,9,0,146580,1663.778,92.22222
"15366","46074","2020",5,5,0,120200,1497,81
"15367","46075","2020",3,3,0,132000,1937.333,69
"15368","46076","2020",2,2,0,173500,1948.5,90.5
"15369","46078","2020",4,4,0,106506.2,1174.75,93.5
"15370","46079","2020",2,2,0,186187.5,1220.5,145
"15371","46080","2020",9,9,0,146916.7,1575.333,93.22222
"15372","46081","2020",4,4,0,108500,1185,95.75
"15373","46082","2020",2,2,0,272500,2200,115
"15374","46083","2020",26,26,0,152958.8,1633.538,97.80769
"15375","46084","2020",2,2,0,75000,2115.5,34.5
"15376","46085","2020",4,4,0,132750,992,113.5
"15377","46086","2020",8,8,0,240662.5,1803.625,133.125
"15378","46087","2020",12,12,0,108865.2,1253.833,87.25
"15379","46088","2020",9,9,0,129077.8,1389.556,87.22222
"15380","46089","2020",20,20,0,167153.1,1449.65,111.65
"15381","46090","2020",3,3,0,125516.7,1588,86.33333
"15382","46091","2020",6,6,0,127966.7,1558.5,90.33333
"15383","46092","2020",3,3,0,161540,1382.667,106.3333
"15384","46093","2020",5,5,0,135700,1714.6,89
"15385","46094","2020",9,9,0,170300,1485.333,125.2222
"15386","46095","2020",9,9,0,146974.9,1565.667,100.3333
"15387","46096","2020",1,1,0,135000,1350,100
"15388","46097","2020",2,2,0,100150,1351.5,76
"15389","46098","2020",1,1,0,175000,1804,97
"15390","46100","2020",6,6,0,221761.7,1677.667,134.1667
"15391","46101","2020",5,5,0,116797.2,1111.2,105.8
"15392","46102","2020",126,83,43,120893.5,1523.46,81.50794
"15393","46103","2020",10,10,0,157989,1627.6,100.1
"15394","46105","2020",6,6,0,188048.5,1239.833,146.3333
"15395","46106","2020",2,2,0,109190,848.5,128
"15396","46107","2020",5,5,0,172000,1562.8,109.4
"15397","46108","2020",2,2,0,208750,1026,205
"15398","46109","2020",3,3,0,123144,1534,81.33333
"15399","46111","2020",2,2,0,217500,1718.5,129
"15400","46112","2020",1,1,0,65000,1048,62
"15401","46113","2020",6,6,0,200833.3,1714,126.8333
"15402","46114","2020",7,7,0,152357.1,1087.857,133.1429
"15403","46115","2020",2,2,0,136194,1104.5,128
"15404","46117","2020",10,10,0,109600,1497.8,78.7
"15405","46118","2020",17,17,0,177482.9,1590.118,109.3529
"15406","46119","2020",5,5,0,172460,1304.4,132
"15407","46120","2020",7,7,0,244176.7,1895.429,134
"15408","46121","2020",4,4,0,161125,2262,76.25
"15409","46122","2020",1,1,0,57000,1096,52
"15410","46123","2020",2,2,0,61500,865,71.5
"15411","46124","2020",2,2,0,106000,739,133.5
"15412","46125","2020",2,2,0,1e+05,1137.5,82
"15413","46126","2020",2,2,0,244956.5,2329.5,126.5
"15414","46127","2020",71,56,15,127193.8,1396.197,91.8169
"15415","46128","2020",49,44,5,141681.9,1374.082,102.6735
"15416","46129","2020",2,2,0,71500,927.5,77.5
"15417","46130","2020",9,9,0,174333.3,1694.667,98.22222
"15418","46131","2020",6,6,0,100816.7,1486.333,81.83333
"15419","46132","2020",6,6,0,149001.7,1482.333,106.8333
"15420","46134","2020",3,3,0,177833.3,1839,114.3333
"15421","46136","2020",5,5,0,108380,1131,98.6
"15422","46137","2020",17,17,0,220952.9,1866.647,119.5294
"15423","46138","2020",16,16,0,136143.8,1528.75,90.5625
"15424","46139","2020",3,3,0,82666.67,792.3333,104.3333
"15425","46140","2020",3,3,0,198500,2405.667,84
"15426","46142","2020",1,1,0,190000,979,194
"15427","46143","2020",13,13,0,121729.9,1102.385,115.4615
"15428","46144","2020",4,4,0,277675,2149.25,132.75
"15429","46145","2020",13,13,0,124147.7,1409.462,88
"15430","46147","2020",1,1,0,290000,1706,170
"15431","46148","2020",13,13,0,153000,1655.308,94.84615
"15432","46149","2020",9,9,0,134198.9,1484.444,99
"15433","46151","2020",3,3,0,98800,1401.667,70.66667
"15434","46152","2020",6,6,0,194336.7,1557.833,142.8333
"15435","46153","2020",4,4,0,87000,1112.25,90.75
"15436","46154","2020",2,2,0,44250,414.5,108
"15437","46155","2020",4,4,0,53205,1357.5,43
"15438","46156","2020",18,18,0,182554.7,1460.778,124.8333
"15439","46159","2020",5,5,0,59600,915.8,62
"15440","46160","2020",7,6,1,79278.29,723.8571,108.2857
"15441","46161","2020",2,2,0,69000,942.5,72.5
"15442","46162","2020",4,4,0,82500,711.75,115
"15443","46163","2020",7,7,0,74781.43,1011.714,71.85714
"15444","46164","2020",1,1,0,70000,538,130
"15445","46165","2020",1,1,0,172500,1725,100
"15446","46167","2020",1,1,0,65000,1182,55
"15447","46169","2020",2,2,0,254000,1512.5,167
"15448","46170","2020",11,11,0,109351.2,1281.545,87.09091
"15449","46171","2020",3,3,0,105333.3,1354.333,77.33333
"15450","46172","2020",5,5,0,127279.6,1364.8,94.4
"15451","46173","2020",12,12,0,134730.8,1481,93.83333
"15452","46174","2020",3,3,0,73423.67,1447,62
"15453","46175","2020",15,15,0,138566.7,1580.867,89.33333
"15454","46176","2020",7,7,0,296114.3,2376.286,114.2857
"15455","46177","2020",5,5,0,152000,1245.8,129.6
"15456","46178","2020",2,2,0,128300,1328.5,95
"15457","46179","2020",1,1,0,95000,1173,81
"15458","46180","2020",6,6,0,184309.2,1622.5,114.1667
"15459","46182","2020",22,21,1,197739.9,1699.273,115.3636
"15460","46183","2020",5,5,0,142324,1432.4,107.2
"15461","46184","2020",8,8,0,164823.8,1460,118.375
"15462","46185","2020",28,25,3,172628.6,1850.964,104.8571
"15463","46186","2020",6,6,0,131583.3,1406.667,98.66667
"15464","46187","2020",14,14,0,148597.2,1428.286,93.5
"15465","46188","2020",3,3,0,166303.3,1886,99.66667
"15466","46189","2020",5,5,0,109821.8,916,122.8
"15467","46190","2020",1,1,0,103000,665,155
"15468","46191","2020",12,12,0,113130.8,1201.167,92.58333
"15469","46192","2020",3,3,0,117353.3,1200,104.3333
"15470","46193","2020",5,5,0,149442,1474,105.2
"15471","46194","2020",4,4,0,281837.5,2055.25,110.5
"15472","46195","2020",6,6,0,98833.33,1136.833,90.5
"15473","46197","2020",14,13,1,199917.5,1780.786,114.4286
"15474","46199","2020",7,7,0,235426.9,1937.429,117.4286
"15475","46200","2020",5,5,0,208733.6,1935,101.8
"15476","46201","2020",29,27,2,197967.8,1587.966,126.069
"15477","46202","2020",10,10,0,158763,1374.6,118.1
"15478","46203","2020",4,4,0,92500,801,110
"15479","46204","2020",6,6,0,130775,1440.167,94.16667
"15480","46205","2020",7,7,0,135854.3,1286.286,107.5714
"15481","46206","2020",1,1,0,155200,1584,98
"15482","46207","2020",3,3,0,136666.7,1514.333,114.6667
"15483","46208","2020",1,1,0,210000,1579,133
"15484","46209","2020",3,3,0,231173.3,2847.667,80.33333
"15485","46210","2020",3,3,0,240066.7,1481.667,162.6667
"15486","46211","2020",2,2,0,128500,1110.5,124.5
"15487","46212","2020",3,3,0,143510,1593.333,91.33333
"15488","46213","2020",4,4,0,251250,1584.75,157.25
"15489","46214","2020",6,6,0,154435,1280.5,114.6667
"15490","46215","2020",10,10,0,134555,1455,91.1
"15491","46216","2020",10,10,0,131861,1361.8,103.6
"15492","46217","2020",5,5,0,181760,1607.2,115.4
"15493","46218","2020",3,3,0,192533.3,1693,111.6667
"15494","46219","2020",5,5,0,67212.4,902.8,82.2
"15495","46220","2020",5,5,0,173630,1464.2,119.6
"15496","46221","2020",2,2,0,212500,1543.5,136.5
"15497","46222","2020",4,4,0,179250,1535.5,127
"15498","46223","2020",2,2,0,164000,1875,87.5
"15499","46224","2020",47,42,5,140461.1,1444.851,98.21277
"15500","46225","2020",54,53,1,144163.5,1557.296,95.01852
"15501","46226","2020",5,5,0,115250,2038,60
"15502","46227","2020",1,1,0,29500,1967,15
"15503","46228","2020",8,8,0,189330.5,1829.25,103.875
"15504","46229","2020",17,17,0,107528.6,1217.882,89.29412
"15505","46230","2020",1,1,0,94000,2350,40
"15506","46231","2020",31,30,1,140654.6,1317.968,104.5484
"15507","46232","2020",14,14,0,149387.1,1481.071,98.35714
"15508","46233","2020",3,3,0,185754.7,1866.333,100.3333
"15509","46235","2020",4,4,0,83596.75,1115.75,71.25
"15510","46236","2020",2,2,0,132500,1088.5,123
"15511","46237","2020",6,6,0,139634.7,1390.833,98.33333
"15512","46238","2020",2,2,0,137375,1700,77.5
"15513","46239","2020",1,1,0,52500,972,54
"15514","46240","2020",7,7,0,268485.7,2452.857,122.7143
"15515","46241","2020",4,4,0,135375,1085.25,122.75
"15516","46242","2020",4,4,0,183500,1732.5,99
"15517","46243","2020",2,2,0,192500,2560,82.5
"15518","46245","2020",1,1,0,190000,2714,70
"15519","46247","2020",1,1,0,180000,1800,100
"15520","46251","2020",45,39,6,123929,1290.178,98.62222
"15521","46252","2020",10,10,0,185200,1517.9,111.8
"15522","46253","2020",3,3,0,190166.7,2053.667,95
"15523","46254","2020",2,2,0,115000,1664.5,74
"15524","46255","2020",4,4,0,150500,1234.25,123.25
"15525","46256","2020",6,6,0,264282.5,2407.5,127.8333
"15526","46257","2020",3,3,0,178333.3,1547.333,114
"15527","46258","2020",2,2,0,86500,932.5,94
"15528","46260","2020",4,4,0,77852.5,933.5,84.5
"15529","46262","2020",10,10,0,164681,1555.6,110.2
"15530","46263","2020",12,12,0,201212.5,1721.833,113.3333
"15531","46264","2020",4,4,0,149775,2044.25,72.25
"15532","46265","2020",4,4,0,142500,1220.75,103.75
"15533","46266","2020",4,4,0,161325,1624.5,101.5
"15534","46267","2020",5,5,0,173091.4,1292,129.4
"15535","46268","2020",24,24,0,116074.8,1178.292,96.25
"15536","46269","2020",1,1,0,48375,820,59
"15537","46270","2020",1,1,0,205500,1631,126
"15538","46271","2020",3,3,0,204500,2102.667,103
"15539","46273","2020",12,11,1,162175.4,1319,125.9167
"15540","46276","2020",6,6,0,145825.7,1238.667,112.1667
"15541","46277","2020",2,2,0,141250,1069.5,136
"15542","46279","2020",2,2,0,89250,2121.5,42
"15543","46280","2020",1,1,0,1e+05,1235,81
"15544","46281","2020",1,1,0,260000,1486,175
"15545","46282","2020",1,1,0,35400,354,100
"15546","46283","2020",1,1,0,50000,694,72
"15547","46284","2020",3,3,0,193333.3,1766,108
"15548","46288","2020",2,2,0,155005,1538.5,102
"15549","46289","2020",6,6,0,158333.3,1668,96
"15550","46290","2020",3,3,0,101533.3,1512.667,84.33333
"15551","46292","2020",6,6,0,102083.3,1352.833,74.33333
"15552","46293","2020",6,6,0,167333.3,1378,118.8333
"15553","46294","2020",2,2,0,138000,2275.5,78.5
"15554","46295","2020",4,4,0,175955.2,1431.25,127.75
"15555","46296","2020",9,9,0,128729.8,1198.889,101.5556
"15556","46297","2020",19,19,0,136385.5,1338.737,106.5263
"15557","46299","2020",1,1,0,75000,1000,75
"15558","46301","2020",4,4,0,110747.5,1174.75,93.5
"15559","46303","2020",4,4,0,149500,1321.25,115.25
"15560","46304","2020",2,2,0,71000,973.5,71.5
"15561","46305","2020",10,10,0,149599.4,1299.6,113.6
"15562","46307","2020",8,8,0,171080.4,1414.625,118
"15563","46308","2020",4,4,0,137950,1179.25,119.75
"15564","46309","2020",63,41,22,107040.2,1306.556,84.79365
"15565","46310","2020",4,4,0,147000,1371.25,134
"15566","46311","2020",22,21,1,133865.3,1066.727,120
"15567","46312","2020",2,2,0,165500,1504,106.5
"15568","46313","2020",8,8,0,136865.9,1272.875,103.625
"15569","46316","2020",7,7,0,133181.1,1530.286,81
"15570","46317","2020",10,10,0,138486,1473.9,99.3
"15571","46318","2020",4,4,0,185500,1795,90.5
"15572","46319","2020",7,7,0,136742.4,1247.429,102.2857
"15573","46320","2020",6,6,0,113377.5,1086.333,109.8333
"15574","46321","2020",3,3,0,135251.7,1594.667,89.33333
"15575","46322","2020",5,5,0,169640,1538.4,118.8
"15576","46323","2020",3,3,0,163333.3,1824,110.3333
"15577","46324","2020",2,2,0,167500,1260.5,134
"15578","46328","2020",4,4,0,97927.5,1325,73.5
"15579","46329","2020",3,3,0,230390,1891.667,104.3333
"15580","46330","2020",15,15,0,137353.3,1389.933,118.7333
"15581","46332","2020",4,4,0,182375,2414.25,86
"15582","46333","2020",3,3,0,110666.7,1216.667,90.66667
"15583","46334","2020",21,21,0,159334.9,1528.524,103.9048
"15584","46335","2020",1,1,0,165000,1528,108
"15585","46336","2020",6,6,0,143505,1630.5,100.8333
"15586","46337","2020",2,2,0,50500,514,93
"15587","46338","2020",1,1,0,7e+05,2632,266
"15588","46339","2020",6,6,0,168403.3,1568.667,107.1667
"15589","46340","2020",2,2,0,200500,1189.5,157.5
"15590","47001","2020",724,256,468,114447.6,1533.434,74.90608
"15591","47002","2020",2,2,0,112500,982,113.5
"15592","47003","2020",9,9,0,154735.3,1308.111,117.3333
"15593","47004","2020",53,47,6,112404.7,1200.358,102.2075
"15594","47005","2020",9,9,0,167375.7,1395.556,123
"15595","47006","2020",8,8,0,140875,1293.375,109.5
"15596","47007","2020",2,2,0,88700,1006.5,89
"15597","47009","2020",4,4,0,133900,1207.25,122
"15598","47011","2020",4,4,0,282712.5,2614.75,122
"15599","47012","2020",3,3,0,400782.3,3439.667,129.3333
"15600","47013","2020",3,3,0,245266.7,1536,155
"15601","47014","2020",2,2,0,146250,1097.5,133.5
"15602","47015","2020",11,11,0,160833.7,1568.545,99.90909
"15603","47016","2020",11,11,0,211786.4,1857.636,113.0909
"15604","47017","2020",2,2,0,106500,1646.5,68.5
"15605","47018","2020",3,3,0,160116.7,1673.667,106
"15606","47019","2020",3,3,0,194333.3,1646.333,118
"15607","47020","2020",5,5,0,263018,1826,149.4
"15608","47021","2020",18,18,0,151432.8,1558.944,95.11111
"15609","47022","2020",2,2,0,137500,1226,111
"15610","47023","2020",3,3,0,281100,1994,152
"15611","47024","2020",32,31,1,209384.4,1792.656,120.1875
"15612","47025","2020",9,9,0,122550,1287.222,99.22222
"15613","47026","2020",4,4,0,185500,1487.5,126.75
"15614","47027","2020",36,36,0,144546.7,1297.083,115.8889
"15615","47028","2020",10,10,0,234034.7,1827.9,128.4
"15616","47029","2020",6,6,0,138305,1997,92.5
"15617","47030","2020",4,4,0,166500,1301.25,148.25
"15618","47031","2020",69,60,9,190453.1,1800.638,105.5797
"15619","47032","2020",84,74,10,177191,1840.107,94.84524
"15620","47033","2020",3,3,0,117666.7,947.3333,134
"15621","47034","2020",5,5,0,172292,1993.2,92.2
"15622","47035","2020",1,1,0,190000,2317,82
"15623","47036","2020",1,1,0,60000,492,122
"15624","47037","2020",2,2,0,284026.5,2087.5,131.5
"15625","47038","2020",6,6,0,142100,1649.333,88.5
"15626","47040","2020",37,37,0,182963.6,1801.405,106.973
"15627","47041","2020",9,9,0,120227.8,1061.556,117.4444
"15628","47042","2020",1,1,0,120000,1043,115
"15629","47043","2020",14,13,1,118142.9,1343.643,96.42857
"15630","47044","2020",4,4,0,168425,1309.75,131
"15631","47045","2020",4,4,0,180250,1500,121.75
"15632","47046","2020",7,6,1,102142.9,1372.571,83.14286
"15633","47047","2020",3,3,0,237516.7,1287.667,184.3333
"15634","47048","2020",15,15,0,120330.8,1238.4,102
"15635","47049","2020",30,29,1,131340,1371.167,97.53333
"15636","47050","2020",1,1,0,246160,1520,162
"15637","47051","2020",26,16,10,185494.6,2042.615,88.73077
"15638","47052","2020",81,65,16,126987.2,1512.852,85.7284
"15639","47053","2020",2,2,0,220325,2099.5,111
"15640","47054","2020",18,18,0,115075,1149.667,97.55556
"15641","47055","2020",9,4,5,140807.8,1309.556,99.33333
"15642","47056","2020",17,17,0,209617.6,1680.294,121.2353
"15643","47057","2020",19,19,0,102878.9,943,108.6842
"15644","47058","2020",4,4,0,101750,1291.5,77.5
"15645","47059","2020",3,3,0,211398.3,1899.333,110.6667
"15646","47060","2020",11,11,0,132677.3,1495.545,98.27273
"15647","47061","2020",6,6,0,116631.7,1356.333,85.83333
"15648","47062","2020",3,3,0,138133.3,1680,87.33333
"15649","47063","2020",4,4,0,149692.5,1221.5,125.75
"15650","47064","2020",3,3,0,98143.33,1217,78.33333
"15651","47065","2020",44,41,3,115419.3,1301.477,100.0227
"15652","47066","2020",9,9,0,138542.2,1392.333,103.7778
"15653","47067","2020",4,4,0,164375,1357.75,121.25
"15654","47068","2020",22,22,0,135564.3,1103.409,128.8182
"15655","47069","2020",47,43,4,138056.6,1485.489,94.82979
"15656","47070","2020",6,6,0,127112.3,1120.5,121.6667
"15657","47071","2020",7,7,0,218174.3,1456.571,144.5714
"15658","47072","2020",3,3,0,280500,1908.667,147
"15659","47073","2020",2,2,0,88250,995.5,72.5
"15660","47074","2020",10,10,0,90775,1014.9,89.9
"15661","47075","2020",14,14,0,166603.6,1572.214,114.1429
"15662","47076","2020",1,1,0,247300,1178,210
"15663","47077","2020",10,10,0,150085,1190.2,115.5
"15664","47078","2020",17,17,0,130361.8,1208.529,106.3529
"15665","47079","2020",8,8,0,153163.5,1345,118.75
"15666","47080","2020",4,4,0,164862.5,1495.5,110.25
"15667","47081","2020",6,6,0,175733.3,1710.5,117.3333
"15668","47082","2020",2,2,0,214500,1486,144.5
"15669","47084","2020",5,5,0,115400,1001,113.4
"15670","47085","2020",3,3,0,122066.7,1172.667,102.6667
"15671","47086","2020",26,24,2,137676.7,1475.615,96.42308
"15672","47087","2020",2,2,0,159175,1846,73
"15673","47088","2020",14,11,3,115934.1,1188.143,103.4286
"15674","47089","2020",1,1,0,306800,2223,138
"15675","47090","2020",6,6,0,334080,2338.5,168.5
"15676","47091","2020",25,21,4,173117.3,1928.6,89.56
"15677","47092","2020",2,2,0,222500,2077.5,107.5
"15678","47093","2020",5,5,0,146598,1596.8,96.2
"15679","47094","2020",8,8,0,135941.2,1338.25,103.125
"15680","47095","2020",8,8,0,152762.5,1555.5,98.75
"15681","47096","2020",3,3,0,153833.3,1280.333,109
"15682","47097","2020",11,11,0,124372.7,1168.818,118
"15683","47098","2020",3,3,0,304883.3,2207.333,139
"15684","47099","2020",5,5,0,115200,1284.8,91.4
"15685","47100","2020",47,46,1,201182.1,1799.894,115.5745
"15686","47101","2020",11,11,0,169181.8,1623.818,104
"15687","47102","2020",5,5,0,158800,1195.2,132.6
"15688","47104","2020",3,3,0,175000,1572.333,117.3333
"15689","47105","2020",6,6,0,187658.3,1417.5,132.6667
"15690","47106","2020",73,71,2,107510,1110.123,96.06849
"15691","47107","2020",4,4,0,76000,941.25,86.75
"15692","47108","2020",2,2,0,130375,1388.5,91
"15693","47109","2020",6,6,0,220666.7,1791.5,132.8333
"15694","47110","2020",25,25,0,120871.2,1141.64,121
"15695","47111","2020",9,9,0,136905.6,1572.556,94.77778
"15696","47112","2020",1,1,0,40000,421,95
"15697","47113","2020",2,2,0,68500,541.5,121
"15698","47114","2020",4,4,0,104000,1192,83.5
"15699","47115","2020",2,2,0,181500,1268.5,145
"15700","47117","2020",17,17,0,148209.4,1489.529,96.64706
"15701","47119","2020",11,11,0,83618.18,982.3636,88.36364
"15702","47120","2020",2,2,0,118950,1170,101.5
"15703","47121","2020",5,5,0,150200,1431.8,103.6
"15704","47122","2020",3,3,0,169000,1262,139
"15705","47123","2020",6,6,0,132833.3,1151.5,111
"15706","47124","2020",3,3,0,220283.3,1454,160
"15707","47125","2020",6,6,0,132043.3,1059.167,126.6667
"15708","47126","2020",1,1,0,55000,611,90
"15709","47127","2020",9,9,0,113524.4,1151.444,99.77778
"15710","47128","2020",12,7,5,125883.3,1461.5,83.41667
"15711","47129","2020",3,3,0,191666.7,1298.667,145.6667
"15712","47130","2020",3,3,0,168000,1754.667,92.66667
"15713","47131","2020",8,8,0,201381.2,1409.5,160.125
"15714","47132","2020",2,2,0,197790.5,2466,77.5
"15715","47133","2020",8,8,0,188171.2,1702,110.5
"15716","47134","2020",3,3,0,130333.3,1138,108
"15717","47135","2020",10,10,0,169090,1287.6,124.4
"15718","47137","2020",22,22,0,195461.8,1623.455,122.6364
"15719","47138","2020",21,20,1,200288.8,1762.476,115
"15720","47139","2020",1,1,0,1e+05,1020,98
"15721","47140","2020",9,8,1,181844.4,1386.444,135.7778
"15722","47141","2020",5,5,0,218945,1629.6,131.2
"15723","47142","2020",15,14,1,158916,1210,143.6667
"15724","47143","2020",24,22,2,140661.6,1217.917,112.2083
"15725","47144","2020",14,14,0,162604,1366.714,119.5
"15726","47145","2020",60,46,14,149250.3,1621.167,92.31667
"15727","47146","2020",12,12,0,162435.3,1555.25,103.1667
"15728","47147","2020",4,4,0,136250,1355.5,100
"15729","47148","2020",1,1,0,285265,1279,223
"15730","47150","2020",4,4,0,105500,1305.75,80.25
"15731","47151","2020",4,4,0,196450,1371.5,134
"15732","47152","2020",10,10,0,154448.4,1251,121
"15733","47154","2020",7,7,0,184071.4,1850,112.1429
"15734","47155","2020",8,8,0,321250,1980.625,158.625
"15735","47156","2020",15,15,0,156053.4,1450.267,117.0667
"15736","47157","2020",325,229,96,115235,1377.025,84.21231
"15737","47158","2020",2,2,0,171000,906,170.5
"15738","47159","2020",16,16,0,134268.8,1131.812,117.375
"15739","47160","2020",3,3,0,127226.7,1295.667,94.33333
"15740","47163","2020",3,3,0,248733.3,2137.667,138.3333
"15741","47164","2020",2,2,0,264250,2117,127.5
"15742","47165","2020",19,19,0,137457.9,1062.053,128.2105
"15743","47167","2020",24,24,0,98930.79,1043.083,98
"15744","47168","2020",42,41,1,103870.3,1061.167,95.52381
"15745","47169","2020",15,15,0,226620,2205.667,111.4
"15746","47170","2020",12,12,0,130416.7,1188,108
"15747","47171","2020",5,5,0,225850,2334.6,125
"15748","47172","2020",10,10,0,211363.2,1802.6,118.1
"15749","47173","2020",11,11,0,132562.7,1279.091,105.5455
"15750","47174","2020",14,13,1,187125,1489,111.1429
"15751","47175","2020",41,36,5,134581.1,1362,91.19512
"15752","47176","2020",2,2,0,335000,1514.5,207.5
"15753","47177","2020",2,2,0,86500,631.5,125
"15754","47178","2020",4,4,0,255623.8,1952,141.25
"15755","47179","2020",22,20,2,125338.6,1103.545,112.5455
"15756","47180","2020",7,7,0,186742.9,1395.429,140.1429
"15757","47181","2020",3,3,0,210936.7,1948,97
"15758","47182","2020",3,3,0,107385,892.3333,128.6667
"15759","47183","2020",1,1,0,50000,714,70
"15760","47184","2020",5,5,0,201470,2929,104.4
"15761","47185","2020",46,46,0,127082.9,1249.022,102.8913
"15762","47186","2020",9,9,0,191438.9,1261.333,166.3333
"15763","47187","2020",1,1,0,219100,1905,115
"15764","47188","2020",3,3,0,51666.67,568.3333,89
"15765","47189","2020",1,1,0,170500,1624,105
"15766","47190","2020",5,5,0,301400,1940.8,140.6
"15767","47191","2020",5,5,0,186520,1538.6,128.2
"15768","47193","2020",4,4,0,168080,979,164.75
"15769","47194","2020",3,3,0,165000,1482.333,97.66667
"15770","47195","2020",89,74,15,142335.6,1504.404,97.68539
"15771","47196","2020",1,1,0,28000,483,58
"15772","47197","2020",3,3,0,119333.3,787.6667,165
"15773","47198","2020",4,4,0,237746.8,1663.25,155.5
"15774","47199","2020",6,6,0,103166.7,1203,75.66667
"15775","47201","2020",166,146,20,145516.9,1645.09,89.87349
"15776","47202","2020",4,4,0,132500,1234.75,99.5
"15777","47203","2020",28,25,3,132503.9,1390.536,101.25
"15778","47204","2020",6,6,0,191002,1388.833,129.3333
"15779","47205","2020",4,4,0,177035,1943,94
"15780","47206","2020",7,7,0,251735.7,1764,153.1429
"15781","47207","2020",6,6,0,181333.3,2069.833,105.6667
"15782","47208","2020",1,1,0,95000,1092,87
"15783","47209","2020",57,54,3,144357.8,1628.439,87.77193
"15784","47210","2020",21,20,1,127463.1,1250.286,102.1429
"15785","47211","2020",4,4,0,76875,630.75,126
"15786","47212","2020",5,5,0,223800,1874,124
"15787","47213","2020",9,9,0,119444.4,1023,110.2222
"15788","47214","2020",5,5,0,157200,1323,112.2
"15789","47215","2020",48,48,0,154677.2,1377.771,110.7708
"15790","47216","2020",7,7,0,124010,1264.286,98.14286
"15791","47217","2020",17,17,0,137575.9,1295.824,99.23529
"15792","47218","2020",3,3,0,161653,1611.667,101.6667
"15793","47219","2020",1,1,0,160000,1839,87
"15794","47220","2020",5,5,0,131800,1138.2,112.2
"15795","47221","2020",4,4,0,120550,846.25,158.75
"15796","47222","2020",4,4,0,157555,1732.25,92.25
"15797","47223","2020",1,1,0,145000,1115,130
"15798","47224","2020",2,2,0,129500,1274,115
"15799","47225","2020",26,25,1,210194.3,2011.385,108
"15800","47226","2020",6,6,0,120417.3,1385.833,90
"15801","47227","2020",3,3,0,117770,1032,96
"15802","47228","2020",6,6,0,115466.8,1406.833,79.5
"15803","47229","2020",3,3,0,271333.3,1868.333,144.6667
"15804","47232","2020",13,13,0,112329.6,1091.462,102.6154
"15805","47233","2020",28,26,2,118177,1195.143,104.5714
"15806","47234","2020",9,9,0,181246.4,1735.889,107.5556
"15807","47235","2020",10,10,0,123335.5,1357.9,97.6
"15808","47236","2020",1,1,0,206782,2068,100
"15809","47237","2020",2,2,0,94450,1369.5,88.5
"15810","47238","2020",16,16,0,208928.1,1700.125,139.3125
"15811","47239","2020",3,3,0,145316.7,1154,146.3333
"15812","47240","2020",4,4,0,165632,1325.5,136.5
"15813","47241","2020",8,8,0,259656.2,1481.625,169.125
"15814","47242","2020",10,10,0,123030,1174.7,100.4
"15815","47244","2020",4,4,0,88049,715.5,135.25
"15816","47245","2020",3,3,0,231428.3,2301.667,135.6667
"15817","47246","2020",17,17,0,160168.2,1504.176,102.7647
"15818","47247","2020",1,1,0,170755,1742,98
"15819","47248","2020",10,10,0,179620.9,1550.9,113.2
"15820","47249","2020",3,3,0,197000,1832.333,102
"15821","47250","2020",2,2,0,325288,2020.5,136.5
"15822","47251","2020",2,2,0,137500,1881,72.5
"15823","47252","2020",86,85,1,125771.5,1283.849,97.80233
"15824","47253","2020",9,9,0,274680,1697.667,161.1111
"15825","47254","2020",4,4,0,141200,1554.5,93.5
"15826","47255","2020",2,2,0,207500,2500,81
"15827","47256","2020",1,1,0,151000,521,290
"15828","47257","2020",8,8,0,169331.2,1754,96.625
"15829","47258","2020",7,7,0,98751.43,1122.714,100.7143
"15830","47259","2020",2,2,0,245000,1930.5,128
"15831","47260","2020",9,9,0,138061.1,1288.333,120.8889
"15832","47262","2020",9,9,0,157819.4,1321.889,121.5556
"15833","47263","2020",6,6,0,124294.5,1196.5,104.8333
"15834","47264","2020",26,26,0,120417.3,1368,87.69231
"15835","47265","2020",5,5,0,98875.2,1138.2,98.8
"15836","47266","2020",2,2,0,131950,1464,97
"15837","47267","2020",6,6,0,111200,1183.167,88
"15838","47269","2020",13,13,0,179463.8,2345.462,102.5385
"15839","47271","2020",10,10,0,188300,1455.2,132.1
"15840","47272","2020",6,6,0,192091.7,1683.833,111.1667
"15841","47273","2020",1,1,0,53400,822,65
"15842","47274","2020",6,6,0,172475,1321.167,130.5
"15843","47275","2020",3,3,0,103960,949.3333,113
"15844","47276","2020",5,5,0,177200,1222,144.4
"15845","47277","2020",2,2,0,145000,1315,111
"15846","47278","2020",9,9,0,191376.7,1482.222,127.6667
"15847","47279","2020",2,2,0,157000,1872.5,81
"15848","47280","2020",34,34,0,164162.1,1428.088,119.3529
"15849","47281","2020",3,3,0,157363.3,2280,86.33333
"15850","47282","2020",3,3,0,153566.7,1189.333,130
"15851","47283","2020",12,12,0,88891.67,977.25,94.66667
"15852","47284","2020",2,2,0,80250,946.5,80
"15853","47285","2020",9,9,0,184233.2,1407.222,125
"15854","47286","2020",1,1,0,193088,1463,132
"15855","47287","2020",5,5,0,159460,1241.4,127
"15856","47288","2020",3,3,0,253500,2022.333,133.6667
"15857","47289","2020",9,8,1,174582.2,1452.778,117.6667
"15858","47290","2020",5,5,0,142800,1154.6,108.4
"15859","47291","2020",13,13,0,146653.8,1248.615,109.2308
"15860","47292","2020",7,7,0,151251.4,1346.286,99.28571
"15861","47293","2020",6,6,0,160733.3,1306,136.5
"15862","47294","2020",1,1,0,53000,716,74
"15863","47295","2020",4,4,0,159237.5,1440.5,108.5
"15864","47296","2020",3,3,0,211300,1850.667,118.6667
"15865","47297","2020",1,1,0,209400,1636,128
"15866","47298","2020",4,4,0,88254.5,1205.25,73.25
"15867","47299","2020",4,4,0,229500,1690.25,131.75
"15868","47300","2020",20,20,0,167998.5,1349.45,125.85
"15869","47301","2020",10,10,0,92725.2,1089.8,89
"15870","47302","2020",15,15,0,110300,970.3333,119.0667
"15871","47303","2020",2,2,0,156930,1325,118
"15872","47304","2020",2,2,0,148750,1775,83
"15873","47305","2020",9,9,0,156253.3,1787.111,88.66667
"15874","47306","2020",6,4,2,144861.3,1000.667,157.1667
"15875","47307","2020",4,4,0,344275,4636,115.75
"15876","47308","2020",4,4,0,98250,1078.5,85.75
"15877","47309","2020",10,8,2,80520.8,939.6,89.4
"15878","47310","2020",145,127,18,108388.7,1205.29,95.15862
"15879","47311","2020",1,1,0,265000,1417,187
"15880","47312","2020",13,13,0,160558.5,1557.692,117.3077
"15881","47313","2020",4,4,0,232276.2,1244.75,177.75
"15882","47314","2020",7,7,0,227457,1910.143,108.7143
"15883","47315","2020",10,9,1,98390,1074.8,96
"15884","47316","2020",8,8,0,171181.2,1371.625,122.5
"15885","47317","2020",6,6,0,138283.3,1474.833,91.16667
"15886","47318","2020",11,11,0,115018.2,1329.364,86.09091
"15887","47319","2020",1,1,0,264821,2244,118
"15888","47320","2020",5,5,0,176734,1662.8,145.6
"15889","47321","2020",1,1,0,92500,925,100
"15890","47323","2020",440,349,91,110257.8,1240,91.15
"15891","47324","2020",34,34,0,154692.8,1542.735,105.4412
"15892","47325","2020",6,6,0,124416.7,1351.5,93.16667
"15893","47326","2020",21,21,0,206519,1629.524,129.381
"15894","47327","2020",3,3,0,110224.3,810.6667,121
"15895","47328","2020",4,4,0,210046.5,1838.25,121.75
"15896","48001","2020",3,3,0,110433.3,1093,103
"15897","48002","2020",4,4,0,247500,1517.5,159.25
"15898","48003","2020",3,3,0,180940,1352.333,135
"15899","48004","2020",2,2,0,115000,1647.5,69
"15900","48005","2020",1,1,0,160000,2000,80
"15901","48008","2020",4,4,0,91125,1127,110.25
"15902","48009","2020",24,24,0,134291.1,1489.042,96.70833
"15903","48010","2020",6,6,0,79000,854.1667,84.66667
"15904","48012","2020",2,2,0,72800,959,73.5
"15905","48013","2020",7,6,1,165565.7,1775.286,94.42857
"15906","48015","2020",3,3,0,84533.33,1096.333,78.33333
"15907","48016","2020",7,7,0,136714.3,1538.143,94.85714
"15908","48017","2020",6,6,0,96500,1244.5,70.66667
"15909","48018","2020",6,6,0,147461.2,1506,96.83333
"15910","48019","2020",4,3,1,113125,1062.25,107.5
"15911","48021","2020",4,4,0,91337.5,1002,100.25
"15912","48025","2020",5,4,1,138760,1029.6,124.8
"15913","48026","2020",4,4,0,78385,1036.75,78.25
"15914","48027","2020",20,19,1,75727.5,1127.5,70.4
"15915","48028","2020",2,2,0,214000,2464,90
"15916","48029","2020",1,1,0,280000,1795,156
"15917","48030","2020",2,2,0,170750,2423.5,75
"15918","48031","2020",1,0,1,28000,467,60
"15919","48034","2020",21,21,0,137786.2,1649.381,92.2381
"15920","48036","2020",4,4,0,96225,1298,88.5
"15921","48038","2020",7,7,0,60357.14,673.5714,94.14286
"15922","48039","2020",16,16,0,153861.2,1543.188,98.25
"15923","48041","2020",2,2,0,73060,872.5,92
"15924","48042","2020",4,4,0,142900,1390.25,93
"15925","48043","2020",6,4,2,73416.67,961,76.83333
"15926","48044","2020",3,3,0,95000,1377,86
"15927","48045","2020",4,4,0,115000,1764.5,66.75
"15928","48046","2020",1,1,0,150000,1190,126
"15929","48048","2020",1,1,0,63000,955,66
"15930","48050","2020",8,8,0,178669.4,2018,86.625
"15931","48051","2020",14,13,1,156438.2,1996.071,77.85714
"15932","48053","2020",2,2,0,37500,682,63.5
"15933","48054","2020",2,2,0,95848,989.5,119
"15934","48055","2020",1,1,0,110000,1038,106
"15935","48056","2020",3,3,0,170933.3,1570.667,106
"15936","48058","2020",1,1,0,223000,1689,132
"15937","48059","2020",2,2,0,99000,877.5,115
"15938","48061","2020",32,26,6,108446.2,1343.5,79.5
"15939","48063","2020",5,5,0,85020,854.6,96.4
"15940","48064","2020",3,3,0,101500,1550.333,72.66667
"15941","48065","2020",1,1,0,44000,344,128
"15942","48067","2020",1,1,0,1e+05,2083,48
"15943","48068","2020",2,2,0,141950,895.5,133.5
"15944","48070","2020",11,11,0,95307.27,935.5455,96.81818
"15945","48071","2020",1,1,0,60000,1333,45
"15946","48072","2020",2,2,0,48300,524.5,93.5
"15947","48073","2020",1,1,0,62000,534,116
"15948","48074","2020",2,2,0,91000,1013,87
"15949","48075","2020",8,8,0,147875,1752.375,82.25
"15950","48079","2020",1,1,0,2e+05,1905,105
"15951","48080","2020",35,24,11,92610.29,1123.286,86.82857
"15952","48081","2020",5,4,1,154000,1228.2,123.4
"15953","48082","2020",2,2,0,42500,512.5,79
"15954","48083","2020",2,2,0,73500,1257,57
"15955","48085","2020",1,1,0,189820,1483,128
"15956","48086","2020",10,9,1,77001.7,992.2,81.3
"15957","48087","2020",1,1,0,355000,3227,110
"15958","48088","2020",5,5,0,95140,1194.8,74.8
"15959","48089","2020",8,8,0,153068.8,1168.125,135.5
"15960","48090","2020",11,9,2,122545.5,1272.182,98.72727
"15961","48092","2020",69,37,32,99975.72,1319.826,75.86957
"15962","48094","2020",9,8,1,126775.6,1399.889,94.77778
"15963","48095","2020",112,49,63,131300.8,1676.545,79.09821
"15964","48096","2020",9,9,0,117000,1249.556,94.66667
"15965","48097","2020",2,2,0,107000,1202.5,98
"15966","48099","2020",17,15,2,134195.3,1349.412,105.6471
"15967","48103","2020",11,10,1,181107.3,1632.545,119
"15968","48104","2020",3,3,0,157733.3,1148.333,126.6667
"15969","48105","2020",4,4,0,118625,1140.25,118.75
"15970","48106","2020",2,2,0,40000,697.5,63
"15971","48108","2020",2,2,0,110500,1640.5,75
"15972","48110","2020",2,2,0,105500,998,105
"15973","48111","2020",1,1,0,65000,1083,60
"15974","48115","2020",2,2,0,101860,1094,88
"15975","48116","2020",14,13,1,121291.8,1689.643,79.5
"15976","48117","2020",5,5,0,94053,1465,70.4
"15977","48119","2020",7,7,0,243985.7,2975.714,79.71429
"15978","48121","2020",1,1,0,116000,1289,90
"15979","48123","2020",2,2,0,317500,3523,132.5
"15980","48124","2020",3,3,0,69416.67,812.6667,81.66667
"15981","48126","2020",1,1,0,90000,1034,87
"15982","48127","2020",19,19,0,118159.5,1365.737,85.31579
"15983","48128","2020",12,12,0,122054.2,1172.417,102.8333
"15984","48129","2020",4,4,0,143672,1494.25,95.25
"15985","48130","2020",1,1,0,55000,1719,32
"15986","48132","2020",19,18,1,105157.9,1166.842,92.05263
"15987","48135","2020",3,3,0,71666.67,911.3333,72.66667
"15988","48136","2020",5,5,0,119986,1547.4,78.8
"15989","48137","2020",8,8,0,162781.2,1559.25,110.875
"15990","48139","2020",3,3,0,122633.3,1645.333,85.33333
"15991","48140","2020",28,20,8,112356.2,1287.964,88.35714
"15992","48141","2020",5,5,0,170084.4,2142.4,77.2
"15993","48144","2020",5,4,1,116400,1561.8,64
"15994","48145","2020",1,1,0,75000,915,82
"15995","48146","2020",23,20,3,118525.8,1632.522,76.86957
"15996","48147","2020",6,4,2,156425,1150.5,127
"15997","48148","2020",9,9,0,239638.6,2054,110.1111
"15998","48151","2020",2,2,0,72950,1236.5,57.5
"15999","48152","2020",4,4,0,240700,1722,142.25
"16000","48153","2020",3,3,0,143885,1327,127.6667
"16001","48155","2020",7,7,0,138000,1622.714,79.71429
"16002","48156","2020",5,5,0,116853.4,1204.4,103
"16003","48158","2020",1,1,0,220000,2444,90
"16004","48160","2020",4,4,0,67376,665.5,96.25
"16005","48161","2020",1,1,0,85000,1118,76
"16006","48165","2020",2,2,0,183900,2499,66.5
"16007","48166","2020",1,1,0,91700,1951,47
"16008","48168","2020",6,5,1,65635,803.5,87.33333
"16009","48169","2020",2,2,0,165000,1041,157
"16010","48170","2020",4,4,0,133375,1459.75,87
"16011","48171","2020",4,4,0,190900,2061.75,88.5
"16012","48173","2020",3,3,0,131133.3,1875.333,85
"16013","48174","2020",3,3,0,44216.67,532,90
"16014","48176","2020",3,3,0,81000,1445,60
"16015","48177","2020",6,6,0,84966.5,950,93.16667
"16016","48178","2020",2,2,0,154110,1729.5,89
"16017","48179","2020",1,1,0,74000,718,103
"16018","48181","2020",1,1,0,130660,2042,64
"16019","48185","2020",3,3,0,179666.7,1674,112.6667
"16020","48187","2020",3,3,0,109833.3,1951.667,61.33333
"16021","48188","2020",3,3,0,79100,981.6667,87
"16022","48190","2020",4,4,0,62312,982.5,64
"16023","48191","2020",3,3,0,69576.67,1039.667,72.66667
"16024","48192","2020",4,4,0,74621.25,1063.5,82.75
"16025","48193","2020",7,6,1,109680,1648.429,69.57143
"16026","48194","2020",11,8,3,91829.55,1143.182,82.18182
"16027","48198","2020",13,11,2,69413.08,1570.462,50.38462
"16028","49002","2020",39,39,0,176433.3,1648.308,114.0513
"16029","49003","2020",16,16,0,136096.9,1527.812,92.375
"16030","49007","2020",2522,653,1869,191966.3,2746.575,71.39255
"16031","49008","2020",17,17,0,119345.3,1113.706,105.1765
"16032","49009","2020",4,4,0,85625,987.5,89.5
"16033","49010","2020",3,3,0,132000,1435,94.66667
"16034","49011","2020",4,4,0,123875,1140.5,108.75
"16035","49012","2020",5,5,0,100030,1252.4,93.2
"16036","49015","2020",205,122,83,230584.5,2542.673,92.61951
"16037","49017","2020",8,8,0,114501.2,1201.5,90.625
"16038","49018","2020",169,166,3,127049.9,1259.503,100.9112
"16039","49020","2020",53,51,2,257965.5,2489.962,103.4717
"16040","49021","2020",80,78,2,155848.2,1565.112,104.0125
"16041","49022","2020",16,15,1,156431.2,1458.438,112.4375
"16042","49023","2020",286,261,25,141914,1452.881,98.71678
"16043","49026","2020",26,25,1,165980.8,1704.692,103.9231
"16044","49027","2020",20,20,0,154744,1623.15,98.95
"16045","49028","2020",2,2,0,157500,3107,46
"16046","49029","2020",10,10,0,235268,1649.6,136.5
"16047","49030","2020",12,12,0,154375,1573,100.8333
"16048","49035","2020",73,66,7,317051.9,2849.425,112.6301
"16049","49036","2020",10,10,0,106772,865.8,122.9
"16050","49038","2020",3,3,0,106633.3,1273,80.33333
"16051","49041","2020",27,27,0,144578.9,1413.778,104.3333
"16052","49045","2020",7,7,0,180755.7,1578,117.7143
"16053","49048","2020",51,48,3,217473.5,2211.725,103.5098
"16054","49050","2020",120,114,6,220352.9,1948.083,117.025
"16055","49053","2020",3,3,0,121892.3,1245.333,102.6667
"16056","49054","2020",30,29,1,143926.7,1301.067,112.3333
"16057","49055","2020",18,18,0,233221.7,2298.667,103.7222
"16058","49056","2020",8,8,0,133918,1331,105.375
"16059","49057","2020",4,4,0,137125,1393.25,99.75
"16060","49058","2020",12,12,0,100568.3,1201.083,84.91667
"16061","49060","2020",42,40,2,120262.4,1258.19,97.57143
"16062","49061","2020",15,15,0,170448.7,1225.867,128.4
"16063","49063","2020",88,74,14,185998.5,1993.739,96.11364
"16064","49064","2020",4,4,0,149000,1315,107.5
"16065","49067","2020",8,8,0,120502.6,1555.5,90.5
"16066","49068","2020",18,18,0,135811.4,1398.944,102.6111
"16067","49069","2020",210,208,2,172985.1,1827.824,97.14762
"16068","49070","2020",12,12,0,156908.3,1464.75,99.66667
"16069","49076","2020",10,10,0,167217.5,1566.2,112.3
"16070","49080","2020",129,123,6,151826.1,1439.946,107.8682
"16071","49082","2020",14,13,1,172457.1,1776.357,99.07143
"16072","49086","2020",51,50,1,170125.5,1634.412,106.7059
"16073","49089","2020",18,18,0,146923.1,1345.389,111.5556
"16074","49090","2020",14,14,0,185153.6,1732.786,110.6429
"16075","49092","2020",221,212,9,138428.8,1381.937,102.1357
"16076","49099","2020",879,586,293,155598.9,1793.736,87.2992
"16077","49100","2020",3,3,0,144000,1233.333,109
"16078","49102","2020",6,6,0,89083.33,896.1667,111.5
"16079","49107","2020",9,9,0,229944.4,1759.111,134.5556
"16080","49109","2020",15,15,0,115396.7,1219.067,96.13333
"16081","49110","2020",16,16,0,216843.8,2024.875,116.75
"16082","49112","2020",10,10,0,193300.1,1800.1,105.5
"16083","49113","2020",4,4,0,160920,1566.75,101
"16084","49114","2020",3,3,0,117933.3,2176.667,53.66667
"16085","49120","2020",18,18,0,168580.7,1950.667,90.22222
"16086","49121","2020",6,6,0,108541.7,1085.167,98.33333
"16087","49123","2020",18,18,0,172912.2,1431.167,118.0556
"16088","49125","2020",129,126,3,159884.4,1463.752,112.6047
"16089","49127","2020",43,42,1,125374.4,1279.488,106.3488
"16090","49129","2020",43,38,5,239751.7,2197.651,111.1628
"16091","49130","2020",6,6,0,198583.3,1516.167,133
"16092","49131","2020",8,8,0,126787.5,1202.25,98.625
"16093","49132","2020",23,23,0,176734.8,1711.391,107.4783
"16094","49135","2020",6,6,0,260833.3,2142.833,128.3333
"16095","49138","2020",33,33,0,140083.6,1423.394,98.30303
"16096","49140","2020",19,19,0,91190.53,1077.737,82.89474
"16097","49155","2020",15,15,0,187850,1849.133,108.1333
"16098","49160","2020",24,24,0,170145.8,1763.792,99.70833
"16099","49161","2020",4,4,0,81750,1245,65.25
"16100","49163","2020",33,32,1,131082.9,1324.909,97.87879
"16101","49167","2020",53,51,2,310149.2,2289.019,134.6981
"16102","49170","2020",9,9,0,141611.1,1459,104.8889
"16103","49171","2020",1,1,0,189000,1099,172
"16104","49174","2020",15,15,0,159466.7,1521,112.4667
"16105","49176","2020",64,62,2,175297.9,1774.266,100.6094
"16106","49178","2020",9,9,0,100155.6,1004.778,105
"16107","49180","2020",100,99,1,149705.6,1369.49,111.13
"16108","49182","2020",14,14,0,146035.7,1292.286,107.5
"16109","49183","2020",64,64,0,143518.8,1370.031,105.4688
"16110","49188","2020",10,10,0,156050,1743.6,96.1
"16111","49192","2020",25,25,0,151211.8,1546.36,96.48
"16112","49193","2020",44,44,0,151510.9,1481.932,104.6136
"16113","49194","2020",82,79,3,177596.6,1730.524,112.7317
"16114","49195","2020",16,16,0,216325.9,1879,110.3125
"16115","49200","2020",71,69,2,215533.7,1992.62,109.2394
"16116","49201","2020",25,25,0,161097.6,1505.52,109.08
"16117","49205","2020",15,15,0,137733.3,1215.533,112.4667
"16118","49209","2020",8,8,0,107562.5,1096.25,104.125
"16119","49211","2020",12,12,0,120750,1199.833,97.75
"16120","49214","2020",89,78,11,247613,2338.371,105.3371
"16121","49215","2020",45,44,1,125362,1241.756,103.2889
"16122","49216","2020",4,4,0,197500,1343.25,145.25
"16123","49217","2020",13,13,0,144993.5,1519,93.76923
"16124","49218","2020",183,181,2,126603,1241.486,104.6339
"16125","49219","2020",6,5,1,119833.3,914.5,121.3333
"16126","49220","2020",48,47,1,148429.1,1303.521,113
"16127","49221","2020",18,18,0,118105.6,986.1667,116.1667
"16128","49222","2020",21,21,0,219106.1,1899.619,118.8571
"16129","49223","2020",82,63,19,243763.5,2192,111.5122
"16130","49224","2020",14,14,0,152532.1,1274.286,118.9286
"16131","49228","2020",84,84,0,111591.5,1124.524,104.9286
"16132","49231","2020",10,10,0,162250,1712.2,94.3
"16133","49235","2020",3,3,0,70666.67,1429,54
"16134","49236","2020",3,3,0,87500,680.3333,126
"16135","49237","2020",1,1,0,54000,635,85
"16136","49240","2020",11,11,0,101045.5,1086.909,91.36364
"16137","49241","2020",34,34,0,269961.8,2215.588,121.7059
"16138","49244","2020",204,201,3,148293.6,1481.314,99.01471
"16139","49246","2020",144,115,29,227654,2380.549,98.66667
"16140","49247","2020",25,25,0,230673,1977.88,115.12
"16141","49248","2020",130,128,2,105652.2,1092.238,96.72308
"16142","49253","2020",27,27,0,130194.4,1262.37,108.7037
"16143","49257","2020",12,12,0,124383.3,1335.583,92.25
"16144","49259","2020",49,49,0,197446.5,1830.367,109.4082
"16145","49260","2020",30,30,0,170956.7,1666.467,103.1667
"16146","49261","2020",130,128,2,158896.8,1583.654,105.9231
"16147","49262","2020",3,3,0,212166.7,2055,104.3333
"16148","49266","2020",21,21,0,160381,1631.714,96.42857
"16149","49267","2020",97,74,23,235197.9,2341.021,102.5258
"16150","49269","2020",26,26,0,162618.3,1779.923,93.15385
"16151","49271","2020",25,25,0,212784.4,2050.8,104.72
"16152","49272","2020",15,15,0,128146.7,1316.933,98.86667
"16153","49278","2020",59,46,13,235592.2,2664.797,90.01695
"16154","49283","2020",44,44,0,202393.2,1934.023,106.6136
"16155","49284","2020",13,13,0,153038.8,1676.154,93.23077
"16156","49291","2020",5,5,0,58880,903.8,66.6
"16157","49292","2020",52,49,3,167769.2,1663.962,104.0962
"16158","49294","2020",28,28,0,264608.8,2270.179,116.2143
"16159","49298","2020",36,36,0,240906.2,2208.833,112
"16160","49299","2020",40,40,0,220577.5,1920.85,115.175
"16161","49301","2020",283,283,0,172132.4,1691.523,104.258
"16162","49302","2020",9,9,0,98733.33,1026.556,99.11111
"16163","49306","2020",19,18,1,241288.3,2339.526,103.1053
"16164","49307","2020",222,219,3,206578.5,1934.577,109.6757
"16165","49308","2020",29,28,1,291412.2,2493.931,120.2414
"16166","49310","2020",14,14,0,82192.86,863.6429,96.5
"16167","49311","2020",21,21,0,140766.7,1405.667,100.3333
"16168","49321","2020",5,5,0,138000,1523.6,87.6
"16169","49323","2020",78,68,10,224263.8,2195.013,102.6282
"16170","49326","2020",6,6,0,190666.7,1473.833,130.1667
"16171","49328","2020",529,310,219,133243.5,1489.028,87.66541
"16172","49329","2020",18,18,0,219316.1,2268.444,100.2222
"16173","49330","2020",21,21,0,180952.4,1667.476,113.619
"16174","49331","2020",242,214,28,117158.6,1262.628,92.33058
"16175","49332","2020",48,48,0,202724.5,1832.583,111.0208
"16176","49333","2020",50,48,2,172542.1,1686.76,104.68
"16177","49334","2020",4,4,0,81050,1111,75
"16178","49336","2020",10,10,0,84800,992,87.9
"16179","49338","2020",12,12,0,384036.7,2871.917,129.3333
"16180","49339","2020",22,22,0,229182.7,1915.136,128.0455
"16181","49341","2020",9,9,0,214577.8,1667.889,125.1111
"16182","49343","2020",37,36,1,182973,1871.811,99.08108
"16183","49344","2020",14,14,0,181108.7,1699.286,106.7857
"16184","49345","2020",76,76,0,190160.4,1564.987,118.7368
"16185","49347","2020",11,11,0,206663.6,1853,111.2727
"16186","49352","2020",14,14,0,136435.7,1480.786,91.92857
"16187","49353","2020",225,184,41,188324.5,2161.582,88.09333
"16188","49355","2020",34,34,0,134164.7,1454.559,91.85294
"16189","49358","2020",9,9,0,139526.7,1534.556,89.66667
"16190","49359","2020",10,10,0,144400,1450.4,101.8
"16191","49361","2020",25,25,0,127636,1291.6,107.48
"16192","49362","2020",15,15,0,214522,1789.4,119.2667
"16193","49364","2020",24,24,0,122875.2,1204.125,105.5833
"16194","49367","2020",79,78,1,157821.5,1571.443,105.1899
"16195","49368","2020",32,30,2,92926.56,1151.375,84.5
"16196","49369","2020",20,20,0,82311.25,915.25,91
"16197","49370","2020",4,4,0,149500,1327.75,108.25
"16198","49371","2020",18,18,0,171643.7,1403,128.2778
"16199","49373","2020",87,86,1,120314.2,1113.46,111.5862
"16200","49374","2020",19,19,0,153779.4,1627.526,98.26316
"16201","49377","2020",70,70,0,215732.1,1996.771,110.9857
"16202","49378","2020",30,28,2,140176.3,1578.333,89.9
"16203","49381","2020",19,19,0,152728.6,1499.737,100.5263
"16204","50002","2020",76,61,15,148375.1,1572.803,95.35526
"16205","50003","2020",79,71,8,285392.2,3406.19,92.83544
"16206","50004","2020",7,7,0,109902.9,1154.286,98
"16207","50006","2020",2,2,0,82500,728,98
"16208","50008","2020",7,7,0,211571.4,2029.143,109.1429
"16209","50013","2020",6,6,0,141000,2007.833,84.83333
"16210","50015","2020",15,15,0,178760,1633.267,119.3333
"16211","50016","2020",8,8,0,150906.2,1216,123.375
"16212","50019","2020",7,7,0,102928.6,1242,87.57143
"16213","50021","2020",3,2,1,358166.7,2077.333,152.3333
"16214","50023","2020",7,7,0,99285.71,1102.714,96
"16215","50024","2020",1,1,0,90000,517,174
"16216","50025","2020",155,102,53,157600.3,1704.535,94.48387
"16217","50026","2020",2,2,0,101500,1358.5,77.5
"16218","50027","2020",15,15,0,135252.7,1554.2,89.53333
"16219","50028","2020",3,3,0,154666.7,969,134
"16220","50029","2020",19,19,0,73989.47,930.1053,80.42105
"16221","50030","2020",12,9,3,210000,2582,86.75
"16222","50031","2020",112,82,30,185268.2,2491.134,76.9375
"16223","50032","2020",8,8,0,188187.5,1691.5,119.375
"16224","50033","2020",3,3,0,138166.7,1832,74.33333
"16225","50034","2020",3,3,0,130013.3,1010.333,129.3333
"16226","50036","2020",4,4,0,117875,1137.25,102.5
"16227","50038","2020",9,9,0,118444.4,1296.444,96.77778
"16228","50039","2020",3,3,0,80683.33,642.3333,117.6667
"16229","50040","2020",3,3,0,133523.3,1082.333,115
"16230","50041","2020",123,123,0,194646.3,2043.894,103.3496
"16231","50042","2020",6,6,0,124853.3,1331.5,104.3333
"16232","50044","2020",8,8,0,187937.5,1626.125,116.375
"16233","50045","2020",9,9,0,202133.3,2002.333,118.6667
"16234","50046","2020",5,5,0,146240,1301.8,106.4
"16235","50048","2020",5,5,0,96600,876.6,104.4
"16236","50049","2020",3,3,0,129305.3,1373.333,88.66667
"16237","50050","2020",1,1,0,55000,519,106
"16238","50052","2020",3,3,0,137366.7,1491,84.66667
"16239","50054","2020",3,3,0,117666.7,1493,71.66667
"16240","50055","2020",2,2,0,110000,1521,70
"16241","50058","2020",35,35,0,203971.4,1981.886,109.3429
"16242","50059","2020",3,3,0,164000,1755.667,94.66667
"16243","50060","2020",4,4,0,124055,1284.5,94
"16244","50062","2020",2,2,0,153050,1123.5,133.5
"16245","50064","2020",3,3,0,192666.7,1784.333,88
"16246","50066","2020",80,65,15,247686.5,3113.3,85.7
"16247","50069","2020",10,10,0,142575.4,1348.5,105.3
"16248","50070","2020",1,1,0,153000,1354,113
"16249","50072","2020",2,2,0,131000,1099,103
"16250","50074","2020",26,24,2,118111.6,1322.385,93.53846
"16251","50076","2020",64,58,6,214854.6,2769.359,82.59375
"16252","50077","2020",14,14,0,209757.2,2551.143,103.5
"16253","50078","2020",13,13,0,146473.8,1736,93.30769
"16254","50079","2020",3,3,0,169566.7,1278.667,138.6667
"16255","50081","2020",20,20,0,261082.5,2741.6,102.7
"16256","50082","2020",89,88,1,156427.8,1607.528,100.5506
"16257","50083","2020",7,7,0,166757.1,2054.143,83.57143
"16258","50084","2020",7,7,0,154142.9,1237.286,120.4286
"16259","50085","2020",21,21,0,240231,2219,118.4286
"16260","50086","2020",5,5,0,119800,1709.2,70.4
"16261","50087","2020",21,21,0,166476.2,1657.286,106.5714
"16262","50088","2020",5,5,0,75089,907.4,86
"16263","50090","2020",14,14,0,90028.57,1278.714,91.5
"16264","50092","2020",14,14,0,138587.9,1230.286,109.7143
"16265","50093","2020",8,8,0,97086.62,893.25,106.375
"16266","50094","2020",9,9,0,119033.3,1090.333,111.7778
"16267","50095","2020",22,22,0,148756.8,1161.636,125.1818
"16268","50096","2020",5,5,0,143600,1418.4,101.2
"16269","50097","2020",4,4,0,154375,1801,86.75
"16270","50098","2020",14,14,0,104178.6,1166.071,96.21429
"16271","50099","2020",125,110,15,135268.7,1444.816,97.864
"16272","50102","2020",38,33,5,279050.9,2820.632,98.42105
"16273","50105","2020",4,4,0,181875,1451.5,131.5
"16274","50106","2020",2,2,0,150000,1514,99
"16275","50108","2020",10,10,0,143780,1256.5,113.8
"16276","50109","2020",35,35,0,122617.1,1454.314,90.71429
"16277","50110","2020",16,16,0,129454.2,1207.062,109.4375
"16278","50111","2020",28,28,0,113276.8,1113.429,101.7143
"16279","50112","2020",10,10,0,146935,1226.9,120.4
"16280","50115","2020",8,8,0,138312.5,1361.25,102.375
"16281","50117","2020",11,11,0,181609.1,2524.545,72.90909
"16282","50118","2020",4,4,0,103500,1357.75,72.75
"16283","50120","2020",2,2,0,229000,2011,116.5
"16284","50121","2020",2,2,0,101650,1725.5,80.5
"16285","50124","2020",1,1,0,69900,1127,62
"16286","50126","2020",2,2,0,114750,1334,81.5
"16287","50129","2020",1019,676,343,158541.4,1917.001,83.64966
"16288","50130","2020",7,7,0,93714.29,1401.714,69.42857
"16289","50135","2020",2,2,0,240000,2857,84
"16290","50137","2020",11,11,0,129440.7,1319.455,100.8182
"16291","50138","2020",8,8,0,108558.8,1122.5,105.75
"16292","50139","2020",43,43,0,170051,1444.953,118.5349
"16293","50142","2020",24,24,0,160000,1865.583,91.875
"16294","50143","2020",16,16,0,200791.7,2040.125,100.75
"16295","50144","2020",12,12,0,68781.67,928.9167,82.08333
"16296","50145","2020",7,7,0,143192.9,1389,97.14286
"16297","50146","2020",3,3,0,132100,1565.333,82.33333
"16298","50147","2020",128,81,47,131564.2,1562.055,85.5
"16299","50148","2020",10,10,0,167425,1383.5,129.4
"16300","50149","2020",16,16,0,181231.2,1980.188,93.625
"16301","50150","2020",5,5,0,115800,1109.6,98.8
"16302","50151","2020",31,30,1,145099.8,1648.903,90.19355
"16303","50152","2020",1,1,0,118000,2107,56
"16304","50155","2020",4,4,0,131250,1428.25,85.75
"16305","50156","2020",1,1,0,142000,1578,90
"16306","50158","2020",6,6,0,117000,1092.667,120.3333
"16307","50159","2020",7,7,0,114314.3,1081,105.5714
"16308","50161","2020",10,10,0,116700,1099.2,98.5
"16309","50162","2020",19,19,0,205546.8,2108.421,98.94737
"16310","50164","2020",15,15,0,139462.5,1121.6,125.2667
"16311","50165","2020",77,47,30,231257.9,2894.208,83.24675
"16312","50166","2020",3,3,0,102666.7,1140.333,89.66667
"16313","50167","2020",17,17,0,219437.4,2340.118,103.8235
"16314","50168","2020",39,39,0,118567.7,1459,86.74359
"16315","50172","2020",6,6,0,187325,1473.833,122.5
"16316","50174","2020",3,3,0,183333.3,1717,100
"16317","50176","2020",5,5,0,173000,1450.2,118.4
"16318","50177","2020",9,9,0,107411.1,1246.444,84.44444
"16319","50178","2020",13,13,0,177011.5,2753.692,78.23077
"16320","50181","2020",2,2,0,128000,1232,126
"16321","50182","2020",5,5,0,74500,1042.4,70.8
"16322","50183","2020",8,8,0,132462.5,1440.25,104.375
"16323","50184","2020",14,14,0,165071.4,1795.929,93.78571
"16324","50185","2020",10,10,0,132530,1242.8,110.4
"16325","50186","2020",3,3,0,159000,1634.667,93
"16326","50188","2020",12,12,0,119541.7,1363.417,85.58333
"16327","50190","2020",3,3,0,146733.3,2266.667,79
"16328","50192","2020",5,5,0,129108,1031.4,132.4
"16329","50193","2020",5,5,0,86010,920,94.2
"16330","50194","2020",4,4,0,102750,1013.5,87.25
"16331","50195","2020",5,5,0,115600,1044,112.4
"16332","50196","2020",11,11,0,182761.7,1854.273,103.0909
"16333","50197","2020",41,41,0,106381.8,1285.561,82.60976
"16334","50198","2020",6,6,0,130833.3,1525,84.66667
"16335","50199","2020",8,8,0,221071.9,2410,96.125
"16336","50200","2020",18,18,0,90293.94,1054.667,96.22222
"16337","50205","2020",4,4,0,191000,1909.25,102.5
"16338","50207","2020",1,1,0,157000,946,166
"16339","50208","2020",1,1,0,63500,520,122
"16340","50209","2020",12,12,0,163791.7,1740.75,96.41667
"16341","50210","2020",7,7,0,103478.6,957.5714,114
"16342","50214","2020",5,5,0,99000,1146.6,88.6
"16343","50215","2020",44,42,2,191132.6,2323.682,86.95455
"16344","50216","2020",6,6,0,112404.2,1341.333,81.83333
"16345","50217","2020",8,8,0,116881.2,1226.25,95.625
"16346","50218","2020",347,126,221,193836.6,2719.092,73.47839
"16347","50219","2020",11,11,0,155936.4,1454.182,108.8182
"16348","50222","2020",12,12,0,187100,1792,106
"16349","50225","2020",3,3,0,75833.33,754,101
"16350","50227","2020",5,5,0,108000,1430.4,73.6
"16351","50228","2020",26,26,0,124103.5,1137.038,109.8462
"16352","50229","2020",2,2,0,130422.5,2006.5,66
"16353","50230","2020",9,9,0,236077.8,2003.444,121.4444
"16354","50231","2020",31,29,2,189516.1,2415.29,86.74194
"16355","50232","2020",8,8,0,106062.5,1479.875,82.75
"16356","50233","2020",3,3,0,169333.3,1747.333,99.66667
"16357","50235","2020",3,3,0,205866.7,1667.333,121.3333
"16358","50236","2020",65,62,3,131562.3,1314.923,104.6769
"16359","50237","2020",29,28,1,109189.7,1341.724,85.31034
"16360","50238","2020",2,2,0,87500,1700,55
"16361","50239","2020",19,19,0,139142.1,1181.053,124.3158
"16362","50240","2020",5,5,0,192800,2046.6,97
"16363","50241","2020",1,1,0,42000,1448,29
"16364","50243","2020",6,6,0,185000,1721.667,106.5
"16365","50246","2020",1,1,0,183000,1605,114
"16366","50247","2020",3,3,0,145333.3,1501.667,94.66667
"16367","50251","2020",2,2,0,95000,1045,108
"16368","50252","2020",13,13,0,169441.5,2104.231,95.53846
"16369","50253","2020",4,4,0,184632.5,1543.75,143
"16370","50256","2020",58,58,0,132858.1,1428.828,94.18966
"16371","50258","2020",1,1,0,112250,2079,54
"16372","50259","2020",9,9,0,93777.78,985,96.55556
"16373","50260","2020",33,33,0,60086.36,756.5152,80.12121
"16374","50262","2020",10,10,0,91575,854.3,106
"16375","50263","2020",7,7,0,78771.43,1321.714,68.42857
"16376","50265","2020",4,4,0,145500,1617,103.5
"16377","50266","2020",6,6,0,126583.3,1048.667,124.5
"16378","50267","2020",30,29,1,117175.8,1370.3,87.76667
"16379","50268","2020",4,4,0,108475,1094.5,100.25
"16380","50269","2020",2,2,0,169200,1714,98.5
"16381","50270","2020",11,11,0,151209.1,1389.545,108.6364
"16382","50271","2020",2,2,0,117500,1296.5,87.5
"16383","50272","2020",19,19,0,166289.5,1995.579,89.94737
"16384","50273","2020",28,28,0,100056.6,1012.393,99.67857
"16385","50274","2020",10,10,0,115310,1381.9,78.2
"16386","50275","2020",4,4,0,62737,917.25,71.25
"16387","50276","2020",7,7,0,59642.86,807.7143,80.71429
"16388","50277","2020",9,9,0,223222.2,2072.778,103.2222
"16389","50278","2020",6,6,0,148416.7,1482.5,103.8333
"16390","50279","2020",13,13,0,109107.7,1135.154,97.69231
"16391","50281","2020",17,17,0,109582.4,1262.588,89.23529
"16392","50282","2020",2,2,0,106250,1063,101
"16393","50285","2020",4,4,0,187750,3748.25,53.25
"16394","50288","2020",14,14,0,150633.6,1681,92.35714
"16395","50289","2020",7,7,0,108857.1,956.5714,116.4286
"16396","50290","2020",7,7,0,125314.3,1585.857,80.57143
"16397","50291","2020",2,2,0,92250,1214,72
"16398","50292","2020",44,44,0,132838.1,1262.409,110.8409
"16399","50294","2020",13,13,0,243515.4,1831.462,138.6154
"16400","50295","2020",2,2,0,146223.5,1153.5,136
"16401","50296","2020",4,4,0,244800,2688.5,102.5
"16402","50297","2020",15,15,0,139566.7,1412.733,100.5333
"16403","50298","2020",4,4,0,134000,926,141.5
"16404","50299","2020",6,6,0,154191.7,1487.167,107.1667
"16405","50300","2020",6,6,0,76000,882.3333,84.66667
"16406","50302","2020",3,3,0,126666.7,933,134.3333
"16407","50304","2020",2,2,0,214500,2113.5,93
"16408","50305","2020",9,9,0,173206.1,1955,92.44444
"16409","50310","2020",3,3,0,202000,1407,146
"16410","50311","2020",5,5,0,139500,1358.8,106.6
"16411","50312","2020",4,4,0,90125,1001,89.5
"16412","50315","2020",8,8,0,99062.5,1113.75,90.125
"16413","50317","2020",4,4,0,83500,1025.25,84.5
"16414","50321","2020",6,6,0,151750,1035.333,152.6667
"16415","50324","2020",1,1,0,90000,662,136
"16416","50326","2020",8,8,0,96171.88,1307.25,83.25
"16417","50327","2020",3,3,0,112333.3,965.3333,115
"16418","50328","2020",8,8,0,138475,1256.375,115.75
"16419","50332","2020",13,13,0,195419.2,1890.615,103.2308
"16420","50334","2020",4,4,0,39250,630,66.75
"16421","50335","2020",9,9,0,185722.2,1793.444,104.4444
"16422","50336","2020",5,5,0,145000,1590.6,87.6
"16423","50338","2020",10,10,0,105800,914.8,114.8
"16424","50340","2020",3,3,0,73183.33,931,83.66667
"16425","50341","2020",32,32,0,130839.2,1483.375,90.59375
"16426","50342","2020",11,11,0,184189.5,2016.182,96.09091
"16427","50345","2020",9,9,0,177116.3,1468.111,120.3333
"16428","50347","2020",1,1,0,154000,1540,100
"16429","50349","2020",37,33,4,167321.6,1922.865,89.78378
"16430","50350","2020",8,8,0,99062.5,790,125.125
"16431","50352","2020",5,5,0,109500,1002.2,108.8
"16432","50356","2020",10,10,0,115010,1087,122.1
"16433","50357","2020",4,4,0,126358,1935.25,63.5
"16434","50359","2020",51,46,5,84410.78,923.2157,91.5098
"16435","50360","2020",2,2,0,127500,2060,74
"16436","50361","2020",4,4,0,105875,1108.25,107.5
"16437","50362","2020",5,5,0,158600,1264.2,131.6
"16438","50363","2020",12,12,0,138253.6,1079.083,132.0833
"16439","50364","2020",13,13,0,91269.23,1178.308,79.69231
"16440","50365","2020",7,7,0,145671.4,1432.143,108.5714
"16441","50368","2020",1,1,0,140000,824,170
"16442","50369","2020",12,12,0,194274.2,1930.917,100.0833
"16443","50370","2020",6,6,0,97833.33,1207,84
"16444","50371","2020",8,8,0,66437.5,816.625,82
"16445","50373","2020",1,1,0,229000,1957,117
"16446","50374","2020",1,1,0,85000,1466,58
"16447","50376","2020",4,4,0,229250,1776.25,133.5
"16448","50378","2020",12,12,0,128477.8,1032.917,127.6667
"16449","50379","2020",2,2,0,46000,759,60
"16450","50382","2020",8,8,0,229712.5,1948.25,119.5
"16451","50384","2020",4,4,0,105250,1376.75,75
"16452","50387","2020",8,8,0,140747.5,1429.5,103.875
"16453","50388","2020",13,13,0,156515.4,1663.462,96.23077
"16454","50389","2020",7,7,0,95642.86,996.2857,91
"16455","50390","2020",3,3,0,173333.3,1451,118.6667
"16456","50391","2020",28,25,3,112553.6,1161.75,98.82143
"16457","50393","2020",32,32,0,113073.1,1117.344,99.59375
"16458","50394","2020",29,28,1,84522.41,1005.379,86.34483
"16459","50395","2020",2,2,0,102500,1089.5,93
"16460","50397","2020",5,5,0,159700,2157.6,92.6
"16461","50398","2020",3,3,0,135500,1251.333,114
"16462","50399","2020",3,3,0,123666.7,1219,99
"16463","50400","2020",73,73,0,118202.6,1088.164,112.6301
"16464","50401","2020",6,6,0,171666.7,1548.5,116.6667
"16465","50402","2020",30,30,0,182464.8,2092.933,95.93333
"16466","50403","2020",47,47,0,128036.4,1932.872,71.21277
"16467","50405","2020",1,1,0,84000,1400,60
"16468","50407","2020",11,11,0,177823.9,1579.091,118.3636
"16469","50408","2020",4,4,0,137250,1556.5,87.75
"16470","50409","2020",39,36,3,109690.2,1044.846,96.53846
"16471","50410","2020",82,65,17,116770,1225.317,95
"16472","50411","2020",4,4,0,153777.5,1419.5,107
"16473","50412","2020",59,59,0,187144.6,2119.746,91.27119
"16474","50413","2020",7,7,0,124428.6,1565.286,83.42857
"16475","50417","2020",29,28,1,133156.6,1567.207,86.65517
"16476","50419","2020",53,53,0,149927.4,1502.642,103.1321
"16477","50420","2020",11,11,0,109454.5,993.9091,106.7273
"16478","50421","2020",9,9,0,196511.1,2024.333,94.55556
"16479","50422","2020",1,1,0,110000,846,130
"16480","50423","2020",2,2,0,106000,859,120
"16481","50425","2020",13,13,0,150861.5,1368.385,119.3077
"16482","50426","2020",10,10,0,106500,1103.3,94.4
"16483","50428","2020",14,14,0,71428.57,1019.071,78.07143
"16484","50429","2020",26,26,0,188367.7,1865.077,100.8077
"16485","50430","2020",2,2,0,325000,1802,156
"16486","50431","2020",19,19,0,114892.1,1515.895,97.73684
"16487","50433","2020",23,22,1,168570.2,1934.391,91.52174
"16488","50435","2020",10,10,0,151000,1582.7,94.2
"16489","50436","2020",11,11,0,112710.9,1118,106.5455
"16490","50437","2020",12,12,0,122708.3,1405.75,107.9167
"16491","50442","2020",7,7,0,155357.1,1954.143,83.42857
"16492","50443","2020",8,8,0,61925,710.875,86.375
"16493","50444","2020",25,25,0,131040,1285.36,101.8
"16494","50445","2020",5,5,0,127300,1154,121.6
"16495","50446","2020",13,13,0,147565.4,1182.923,123.1538
"16496","50447","2020",5,5,0,220010,2208,100
"16497","50448","2020",19,19,0,119187.7,1284.053,94.31579
"16498","50450","2020",3,3,0,89333.33,1780.667,51
"16499","50451","2020",5,5,0,175054.4,1924.8,95
"16500","50452","2020",6,6,0,115481.7,1395.5,90.66667
"16501","50453","2020",10,10,0,150813.2,1196.5,120.8
"16502","50454","2020",5,5,0,198600,2059,104.2
"16503","50455","2020",7,7,0,165758.6,1274.429,125.1429
"16504","50456","2020",11,11,0,106165.4,1507.727,80.27273
"16505","50462","2020",13,13,0,72960.54,1206.462,82.53846
"16506","50463","2020",16,16,0,109240.6,1116.688,95.1875
"16507","50464","2020",8,8,0,137006.2,1376.75,106.875
"16508","50467","2020",1,1,0,1e+05,855,117
"16509","50468","2020",9,9,0,116722.2,1058.111,110
"16510","50469","2020",5,5,0,165800,1896.8,93.8
"16511","50471","2020",6,6,0,148250,1934,74.83333
"16512","50472","2020",4,4,0,153625,1293.25,113.25
"16513","50473","2020",9,9,0,156533.3,1317.778,127.4444
"16514","50474","2020",7,7,0,48728.57,654,82.42857
"16515","50475","2020",9,9,0,161126,1490.222,108.7778
"16516","50476","2020",9,9,0,122177.8,1217.444,106.7778
"16517","50478","2020",5,5,0,129000,1314.4,98.8
"16518","50479","2020",1,1,0,75000,652,115
"16519","50480","2020",9,9,0,214751.1,1969.444,108
"16520","50481","2020",35,34,1,172554,2497.314,82.88571
"16521","50482","2020",3,3,0,105833.3,868,123
"16522","50483","2020",17,17,0,152635.3,1284.647,117.4118
"16523","50484","2020",64,58,6,111906.1,1186.422,97.57812
"16524","50486","2020",10,10,0,125374,1419.2,98.9
"16525","50487","2020",57,54,3,108993.1,1133.263,97.17544
"16526","50488","2020",6,6,0,154279.3,1257.333,129.6667
"16527","50489","2020",8,8,0,140100,1488.125,98.375
"16528","50490","2020",13,13,0,216415.4,2242.231,112.2308
"16529","50491","2020",4,4,0,134523.5,1272.5,109
"16530","50492","2020",32,32,0,155564.1,1345.594,116.6562
"16531","50493","2020",27,27,0,198494,1866.926,110.8889
"16532","50495","2020",1,1,0,174000,1115,156
"16533","50496","2020",18,13,5,137830.6,2039.167,66.5
"16534","50498","2020",12,12,0,152287.1,1763.25,88.83333
"16535","50499","2020",7,7,0,88857.14,968,99.71429
"16536","50500","2020",11,11,0,80700,946,84
"16537","50502","2020",296,159,137,118182.6,1423.72,81.7027
"16538","50504","2020",2,2,0,115750,1215.5,96
"16539","50505","2020",10,10,0,160842,1452.5,107.1
"16540","50506","2020",5,5,0,178000,1847.2,95.6
"16541","50507","2020",6,6,0,343466.7,2329.833,141
"16542","50509","2020",13,13,0,163038.5,1686.846,99.30769
"16543","50510","2020",5,5,0,161550,1589.8,103.2
"16544","50511","2020",3,3,0,265278.3,4679.667,111.6667
"16545","50512","2020",6,6,0,148583.3,1236,123.1667
"16546","50513","2020",3,3,0,96333.33,708,133
"16547","50514","2020",3,3,0,111900,1110,94.66667
"16548","50517","2020",2,2,0,255000,1986,123.5
"16549","50518","2020",4,4,0,110975,1061.25,106.5
"16550","50519","2020",6,6,0,253711.3,2109.667,119.3333
"16551","50521","2020",4,4,0,77325,685.25,109.5
"16552","50522","2020",3,3,0,142000,1695,90.33333
"16553","50523","2020",55,52,3,122981.9,1398.291,92.54545
"16554","50525","2020",10,10,0,80262,1012.3,83.6
"16555","50528","2020",4,4,0,68000,960.5,73.75
"16556","50529","2020",1,1,0,68000,810,84
"16557","50531","2020",8,8,0,161300,1657.375,116.75
"16558","50532","2020",97,80,17,235980.5,3100.474,83.60825
"16559","50533","2020",4,4,0,54875,794.5,69.5
"16560","50535","2020",6,6,0,177087.5,1715.667,104.5
"16561","50536","2020",8,8,0,186112.5,1840.5,100.625
"16562","50537","2020",13,13,0,158474.4,1477.538,105.7692
"16563","50538","2020",3,3,0,173500,1317.333,132.3333
"16564","50539","2020",26,26,0,121055.8,1448.346,86.84615
"16565","50540","2020",10,10,0,213950,2027.5,109.6
"16566","50541","2020",26,26,0,205451.6,1900.923,105.3462
"16567","50542","2020",9,9,0,116522.2,1005,107.7778
"16568","50543","2020",10,10,0,124199.2,1532,81.7
"16569","50546","2020",53,53,0,124646.5,1147.868,107.9057
"16570","50548","2020",3,3,0,119333.3,2074.667,61.33333
"16571","50549","2020",4,4,0,147250,1434,104
"16572","50550","2020",36,36,0,125453.4,1220.639,104.1667
"16573","50551","2020",24,24,0,149500,1377.25,109.5833
"16574","50553","2020",7,7,0,185985.7,2665,70.85714
"16575","50554","2020",21,21,0,185118.2,1819.143,103.1429
"16576","50556","2020",6,6,0,93707.83,909,102.8333
"16577","50562","2020",34,29,5,204992.9,2494.324,85.47059
"16578","50563","2020",9,9,0,114666.7,1071.111,104.8889
"16579","50564","2020",15,15,0,167020,1268.933,133.8
"16580","50565","2020",38,33,5,144779.6,1883.947,81.86842
"16581","50567","2020",17,17,0,177044.1,1654.529,109.2941
"16582","50568","2020",7,7,0,129928.6,1316.571,108.5714
"16583","50569","2020",6,6,0,128583.3,1148.5,113.3333
"16584","50570","2020",3,3,0,97333.33,882.6667,108
"16585","50572","2020",3,3,0,157333.3,1648.667,95.66667
"16586","50574","2020",1,1,0,45000,600,75
"16587","50575","2020",8,8,0,228112.5,2237.5,103.5
"16588","50576","2020",11,11,0,209636.4,2240.727,96.54545
"16589","50577","2020",4,4,0,147500,1626,90.5
"16590","50579","2020",15,15,0,179216.7,1688.6,106.4
"16591","50580","2020",2,2,0,247500,3044,98.5
"16592","50582","2020",47,47,0,100092.9,1029.298,100.7872
"16593","50584","2020",2,2,0,164500,2147.5,81
"16594","50585","2020",22,22,0,172343.2,2045.545,88.77273
"16595","50588","2020",7,7,0,184071.4,1808.571,98
"16596","50589","2020",3,3,0,80966.67,957,87
"16597","50590","2020",9,9,0,135906.7,1756.333,94.33333
"16598","50591","2020",33,33,0,82712.12,911.3939,101.7576
"16599","50592","2020",34,34,0,138182.4,1293.735,104.8529
"16600","50593","2020",6,6,0,119850,1376,86.83333
"16601","50594","2020",15,15,0,204103.3,2014.8,103.9333
"16602","50596","2020",2,2,0,128500,972,116.5
"16603","50597","2020",9,9,0,147944.4,1552.444,103.2222
"16604","50598","2020",4,3,1,61250,847.5,86.75
"16605","50599","2020",22,22,0,184286.8,1887.5,97.22727
"16606","50601","2020",46,45,1,123305.7,1278.109,99.34783
"16607","50603","2020",11,11,0,197045.5,1744.182,118.3636
"16608","50604","2020",7,7,0,171557,1513.286,117.5714
"16609","50606","2020",4,4,0,110625,1242,89
"16610","50607","2020",4,4,0,685961,4418.75,142
"16611","50609","2020",2,2,0,152500,2080.5,74.5
"16612","50610","2020",1,1,0,176000,1676,105
"16613","50612","2020",12,12,0,188633.3,2598.167,84.83333
"16614","50613","2020",12,12,0,155208.3,1691.583,99
"16615","50615","2020",88,75,13,162899.3,1824.966,93.17045
"16616","50616","2020",25,25,0,192950.6,1712.68,111.76
"16617","50617","2020",4,4,0,165000,1111.25,145.75
"16618","50618","2020",6,6,0,237604.2,1885.833,122
"16619","50619","2020",8,8,0,138625,2168.25,80.875
"16620","50621","2020",3,3,0,163266.7,1543.667,112.3333
"16621","50624","2020",6,6,0,134516.7,1584.333,85.33333
"16622","50626","2020",15,15,0,118633.3,1195.8,95.86667
"16623","50628","2020",4,4,0,122000,1645.75,85.5
"16624","50629","2020",11,11,0,118598.2,1179.455,98.72727
"16625","50633","2020",3,3,0,185666.7,1586.667,98.66667
"16626","50634","2020",1,1,0,121000,1017,119
"16627","50637","2020",4,4,0,61670,793,78.5
"16628","50639","2020",53,45,8,100796.8,1255.755,80.26415
"16629","50641","2020",6,6,0,147166.7,1202.333,120.3333
"16630","50643","2020",10,10,0,177500,2157.7,85.4
"16631","50647","2020",13,13,0,230548.2,2002.923,107.0769
"16632","50648","2020",14,14,0,182104.3,1800,106.2857
"16633","51001","2020",1,1,0,156300,1718,91
"16634","51002","2020",15,14,1,178009.3,1837.6,99.06667
"16635","51004","2020",2,2,0,142500,865.5,169.5
"16636","51005","2020",1,1,0,262000,996,263
"16637","51006","2020",3,3,0,143666.7,1593.333,91
"16638","51007","2020",7,7,0,148149.7,1186.714,120.4286
"16639","51008","2020",2,2,0,71250,1092,60.5
"16640","51009","2020",6,6,0,121916.7,1291.167,101
"16641","51010","2020",1,1,0,82000,745,110
"16642","51014","2020",2,2,0,137500,1923.5,76
"16643","51016","2020",5,5,0,140360,1245.2,129.4
"16644","51017","2020",1,1,0,50000,562,89
"16645","51018","2020",3,3,0,162490,1612.333,94.66667
"16646","51019","2020",4,4,0,237875,1776.5,136.25
"16647","51022","2020",2,2,0,170250,1527.5,111.5
"16648","51023","2020",2,2,0,121250,1079.5,99
"16649","51025","2020",14,14,0,225107.1,2171.929,105.6429
"16650","51027","2020",3,3,0,86333.33,737.6667,106.6667
"16651","51028","2020",17,13,4,153988.5,2913.235,77.17647
"16652","51029","2020",18,17,1,175300,1855.167,95.72222
"16653","51030","2020",65,60,5,178743.6,1835.846,97.78462
"16654","51031","2020",2,2,0,210175,1886,112
"16655","51032","2020",11,11,0,116180.9,1266.182,96.90909
"16656","51033","2020",3,3,0,85666.67,961.3333,104.3333
"16657","51035","2020",2,2,0,56250,486,121.5
"16658","51036","2020",4,4,0,87750,1222.75,93.5
"16659","51037","2020",5,5,0,187000,1769,106.8
"16660","51039","2020",2,2,0,106000,714.5,154
"16661","51040","2020",1,1,0,68000,1097,62
"16662","51041","2020",2,2,0,116250,1062,107.5
"16663","51042","2020",7,7,0,91085.71,916.1429,95.42857
"16664","51043","2020",35,35,0,196341.5,1912.543,103.8286
"16665","51044","2020",6,6,0,257175,2052.667,148.5
"16666","51046","2020",10,10,0,255619.8,2283.9,118.1
"16667","51047","2020",1,1,0,87000,1192,73
"16668","51048","2020",5,5,0,175200,1263.4,141.4
"16669","51049","2020",4,4,0,155475,1185,127.25
"16670","51050","2020",4,4,0,109755,1406.25,79.25
"16671","51051","2020",3,3,0,236883.3,1903.333,126.3333
"16672","51052","2020",9,9,0,267706.6,2054.556,127.7778
"16673","51053","2020",2,2,0,95000,915.5,102
"16674","51054","2020",17,17,0,154086.8,1421.706,114.9412
"16675","51055","2020",72,56,16,211075.2,2206.194,94.65278
"16676","51056","2020",5,5,0,119678,1253.6,91.8
"16677","51057","2020",1,1,0,92000,1415,65
"16678","51058","2020",30,17,13,318665.7,3132.333,106.8333
"16679","51059","2020",4,4,0,141225,1282,120.5
"16680","51060","2020",1,1,0,138000,1160,119
"16681","51062","2020",2,2,0,51780,595,86.5
"16682","51065","2020",5,5,0,124600,1049.4,120.8
"16683","51066","2020",3,3,0,124833.3,920.6667,138.3333
"16684","51068","2020",1,1,0,135750,1655,82
"16685","51069","2020",2,2,0,291900,1731.5,162
"16686","51070","2020",2,2,0,290000,2179,127.5
"16687","51071","2020",3,3,0,121333.3,900.6667,168.3333
"16688","51073","2020",1,1,0,85000,1062,80
"16689","51074","2020",20,20,0,184081.5,1936.9,100.2
"16690","51075","2020",20,20,0,254377.9,2402,106.65
"16691","51076","2020",2,2,0,294500,2231.5,133.5
"16692","51077","2020",2,2,0,209350,2414,102.5
"16693","51078","2020",5,5,0,212540,1796.8,126.2
"16694","51079","2020",9,9,0,157500,1544.667,107.1111
"16695","51080","2020",2,2,0,132825,1387,99
"16696","51081","2020",2,2,0,248000,3499,71.5
"16697","51083","2020",2,2,0,102985,1061.5,113
"16698","51085","2020",3,3,0,120000,1504,88.66667
"16699","51086","2020",4,4,0,202750,1988.25,109
"16700","51087","2020",3,3,0,192833.3,2028.333,121.6667
"16701","51088","2020",5,5,0,263144,2073.6,135.2
"16702","51089","2020",2,2,0,336765,2124.5,170
"16703","51090","2020",6,6,0,140231.7,1480.333,101.8333
"16704","51091","2020",3,3,0,126666.7,1024.333,122.3333
"16705","51092","2020",4,4,0,180347.5,1404.5,129.75
"16706","51093","2020",8,8,0,256787.5,2134.375,124.25
"16707","51094","2020",2,2,0,135800,1036,131
"16708","51095","2020",1,1,0,153400,935,164
"16709","51097","2020",3,3,0,107200,1101.667,92.33333
"16710","51098","2020",2,2,0,81325,807.5,105
"16711","51099","2020",5,5,0,145738,1336.8,110.6
"16712","51101","2020",4,4,0,281375,2494.75,120
"16713","51102","2020",4,4,0,257107.5,2124,122
"16714","51104","2020",1,1,0,65000,722,90
"16715","51105","2020",19,19,0,286948.8,2824.263,101.8421
"16716","51106","2020",3,3,0,80950,1046.333,76.66667
"16717","51107","2020",5,5,0,134000,1276.2,110.4
"16718","51108","2020",513,225,288,120802.1,1467.659,81.54386
"16719","51109","2020",3,3,0,134466,1394.667,98.33333
"16720","51110","2020",1,1,0,145000,1629,89
"16721","51111","2020",1,1,0,1e+05,606,165
"16722","51112","2020",3,3,0,179666.7,1742,97.66667
"16723","51115","2020",8,8,0,312525,2750.5,118.75
"16724","51116","2020",6,6,0,157916.7,1636,104.3333
"16725","51117","2020",2,2,0,211000,1634.5,133.5
"16726","51118","2020",11,11,0,373550,2454.636,150.6364
"16727","51119","2020",4,4,0,236250,2485,92.5
"16728","51121","2020",8,8,0,104661.6,1219.875,93.375
"16729","51122","2020",1,1,0,270000,1800,150
"16730","51129","2020",2,2,0,134500,1031.5,132.5
"16731","51130","2020",3,3,0,112580,1029.333,108.3333
"16732","51132","2020",1,1,0,56000,400,140
"16733","51134","2020",2,2,0,135250,1240,110
"16734","51135","2020",3,3,0,133433.3,1194.667,108.6667
"16735","51136","2020",5,5,0,117700,1055.6,112
"16736","51137","2020",1,1,0,173000,2012,86
"16737","51139","2020",1,1,0,140000,993,141
"16738","51140","2020",6,6,0,218866.7,1578.667,149.6667
"16739","51141","2020",12,10,2,153725,1397.75,114.3333
"16740","51142","2020",2,2,0,216500,1834,119.5
"16741","51144","2020",7,7,0,90628.57,831.1429,103.1429
"16742","51145","2020",7,7,0,380980,2591.857,145.5714
"16743","51147","2020",2,2,0,176750,1931,91.5
"16744","51148","2020",5,5,0,80406,941,82.6
"16745","51149","2020",1,1,0,265100,2087,127
"16746","51150","2020",1,1,0,275000,2926,94
"16747","51151","2020",1,1,0,70500,792,89
"16748","51152","2020",8,7,1,312337.5,2112.875,148.5
"16749","51153","2020",15,15,0,257341.6,2217.8,125.5333
"16750","51154","2020",7,7,0,127214.3,1266.429,122.4286
"16751","51155","2020",4,4,0,104000,1141,90.25
"16752","51157","2020",2,2,0,90500,928,97.5
"16753","51158","2020",3,3,0,141666.7,1248.667,114.6667
"16754","51160","2020",20,20,0,157504,1720.5,95.3
"16755","51161","2020",8,8,0,140100,1579.375,87
"16756","51162","2020",16,16,0,105406.2,1019.062,105.375
"16757","51163","2020",2,2,0,95000,1192,79
"16758","51164","2020",1,1,0,81000,779,104
"16759","51165","2020",8,8,0,136540,1326.375,105.125
"16760","51167","2020",1,1,0,40000,533,75
"16761","51168","2020",1,1,0,162000,1296,125
"16762","51171","2020",12,11,1,227647.7,2105.667,110.1667
"16763","51172","2020",76,57,19,242196,2545.684,98.52632
"16764","51173","2020",1,1,0,156400,759,206
"16765","51174","2020",2,2,0,260050,1556.5,170.5
"16766","51175","2020",2,2,0,144000,1536,94.5
"16767","51177","2020",3,3,0,459350,2461,194.3333
"16768","51179","2020",1,1,0,156000,821,190
"16769","51181","2020",4,4,0,193780,1318.75,157.75
"16770","51183","2020",16,16,0,276987.5,2448.812,121.0625
"16771","51184","2020",4,4,0,121772.5,1391.75,86.25
"16772","51185","2020",2,2,0,82500,844,98
"16773","51186","2020",1,1,0,34000,654,52
"16774","51187","2020",4,4,0,181860,1285.25,130.25
"16775","51188","2020",4,4,0,249800,2397.25,125
"16776","51190","2020",2,2,0,292800,2175,143
"16777","51192","2020",7,7,0,125421.4,1518,91.71429
"16778","51193","2020",25,24,1,170140.6,1605.36,106.08
"16779","51194","2020",4,4,0,169550,1310.25,126.75
"16780","51195","2020",8,8,0,142486.9,1351.75,99.875
"16781","51196","2020",14,12,2,182793.1,1788.429,101.2143
"16782","51197","2020",1,1,0,180400,1203,150
"16783","51198","2020",5,5,0,198076,1985.8,112.6
"16784","51199","2020",5,5,0,121700,1376,90
"16785","51200","2020",3,3,0,113333.3,1540.333,75.66667
"16786","51201","2020",1,1,0,211550,1679,126
"16787","51202","2020",7,6,1,154359.7,1784.571,92.57143
"16788","51203","2020",1,1,0,235900,1512,156
"16789","51204","2020",20,20,0,157150,1539.15,106.35
"16790","51205","2020",2,2,0,205425,1812.5,115.5
"16791","51208","2020",3,3,0,212533.3,1864,114
"16792","51210","2020",14,11,3,237554.3,2322.714,96.85714
"16793","51211","2020",1,1,0,140000,979,143
"16794","51212","2020",1,1,0,163000,1264,129
"16795","51215","2020",1,1,0,165000,1065,155
"16796","51216","2020",4,4,0,150925,1765.5,101.25
"16797","51217","2020",32,29,3,111906.2,1321.562,88.28125
"16798","51219","2020",2,2,0,81750,860,98.5
"16799","51220","2020",1,1,0,356400,1176,303
"16800","51224","2020",1,1,0,85000,988,86
"16801","51225","2020",3,3,0,228000,2445.667,97
"16802","51226","2020",2,2,0,72500,804,87
"16803","51227","2020",5,5,0,222000,1954.2,117.2
"16804","51228","2020",1,1,0,269000,1416,190
"16805","51230","2020",341,147,194,139549.3,1877.906,73.45161
"16806","51231","2020",5,5,0,255690.8,2014.4,123.2
"16807","51232","2020",6,6,0,235048.5,1595.5,156.6667
"16808","51233","2020",1,1,0,190000,1845,103
"16809","51234","2020",9,9,0,117444.4,1014.778,111.7778
"16810","51235","2020",4,4,0,160035,1185.75,132.5
"16811","51236","2020",1,1,0,175000,700,250
"16812","51237","2020",30,30,0,130062.5,1317.167,113.0333
"16813","51238","2020",5,5,0,154720,1451.6,108.2
"16814","51239","2020",3,3,0,147016.7,1534,91.66667
"16815","51240","2020",2,2,0,138550,1161,119.5
"16816","51241","2020",3,3,0,119166.7,714,152.6667
"16817","51242","2020",54,49,5,166210.4,1710.296,97.98148
"16818","51243","2020",5,5,0,95110.8,996,95.2
"16819","51244","2020",1,1,0,180000,1314,137
"16820","51245","2020",5,5,0,197600,1883.8,105
"16821","51246","2020",1,1,0,85000,825,103
"16822","51247","2020",3,3,0,63661,922.3333,67.66667
"16823","51248","2020",28,28,0,108418.9,1177.286,98.42857
"16824","51249","2020",1,1,0,268400,965,278
"16825","51250","2020",66,56,10,150094.3,1604.879,93.43939
"16826","51252","2020",2,2,0,107500,848.5,126.5
"16827","51253","2020",4,4,0,139125,919.5,161
"16828","51254","2020",2,2,0,47000,610.5,70.5
"16829","51255","2020",1,1,0,119840,744,161
"16830","51256","2020",3,3,0,248127.3,1975.333,127
"16831","51258","2020",5,5,0,139798,1537,95.2
"16832","51259","2020",1,1,0,189000,2148,88
"16833","51262","2020",21,15,6,113027.6,1301.19,84.57143
"16834","51263","2020",3,3,0,116666.7,1119,114.6667
"16835","51264","2020",6,6,0,120608.3,1331.833,97.33333
"16836","51265","2020",9,9,0,132888.9,1190.556,123
"16837","51266","2020",5,5,0,192200,1814.4,108
"16838","51267","2020",3,3,0,257666.7,2275,114.6667
"16839","51268","2020",3,3,0,165000,1237.667,129.6667
"16840","51269","2020",15,15,0,123727.3,1957.867,71.4
"16841","51270","2020",3,3,0,108966.7,1070.333,100.6667
"16842","51272","2020",4,4,0,64000,612.25,108.75
"16843","51273","2020",2,2,0,82900,1101.5,76.5
"16844","51274","2020",1,1,0,141000,1259,112
"16845","51275","2020",2,2,0,167225,1348,123.5
"16846","51276","2020",2,2,0,172500,1540.5,123
"16847","51277","2020",6,6,0,165365,1275,132.1667
"16848","51278","2020",5,5,0,183637,1611.6,118.2
"16849","51279","2020",3,3,0,131933.3,1325,97.33333
"16850","51281","2020",4,4,0,196250,2052.5,103.5
"16851","51282","2020",21,20,1,396582.4,2728.81,145.9048
"16852","51283","2020",2,2,0,87500,930.5,95
"16853","51285","2020",3,3,0,439140,5135.667,98.33333
"16854","51286","2020",2,2,0,136750,1050.5,139
"16855","51287","2020",9,9,0,209530,2177.222,95.55556
"16856","51288","2020",2,2,0,129625,1196,110
"16857","51289","2020",5,5,0,125600,963.8,143.6
"16858","51290","2020",2,2,0,122500,721.5,167
"16859","51291","2020",15,15,0,255580,2202.467,115.2667
"16860","51292","2020",2,2,0,52500,478.5,116
"16861","51293","2020",8,8,0,182237.5,1815.75,108.625
"16862","51295","2020",1,1,0,80000,1127,71
"16863","51298","2020",6,6,0,93416.67,996,93.5
"16864","51299","2020",15,15,0,202332.7,1777.733,118.7333
"16865","51300","2020",3,3,0,155633.3,1283.333,124
"16866","51301","2020",1,1,0,273000,1606,170
"16867","51302","2020",3,3,0,148000,1160.333,118.3333
"16868","51303","2020",10,10,0,142750,1432.2,101.9
"16869","51304","2020",2,2,0,83500,1015,89
"16870","51305","2020",1,1,0,235000,1780,132
"16871","51306","2020",1,1,0,110000,866,127
"16872","51308","2020",21,20,1,249046.2,2337.619,109.3333
"16873","51309","2020",1,1,0,135000,844,160
"16874","51311","2020",2,2,0,132000,1083,135
"16875","51312","2020",7,7,0,209195.7,1780.286,128
"16876","51313","2020",6,6,0,109000,1135.833,97.66667
"16877","51315","2020",2,2,0,143500,1797.5,81
"16878","51316","2020",3,3,0,145000,1097.333,147
"16879","51317","2020",1,1,0,94000,614,153
"16880","51318","2020",4,4,0,478587.5,3374,143.5
"16881","51319","2020",1,1,0,135990,978,139
"16882","51320","2020",2,2,0,594307.5,5132,110.5
"16883","51321","2020",1,1,0,284000,1893,150
"16884","51322","2020",3,3,0,112666.7,911,118.6667
"16885","51323","2020",3,3,0,95166.67,941,101
"16886","51324","2020",2,2,0,128250,1208,107
"16887","51325","2020",1,1,0,39000,780,50
"16888","51326","2020",11,11,0,160506.9,1633.182,98.18182
"16889","51327","2020",3,3,0,94766.67,944,94
"16890","51328","2020",12,12,0,118266.7,1127,105.25
"16891","51329","2020",16,16,0,288214.9,2255.875,128.5625
"16892","51333","2020",8,8,0,279041,2328.375,118.75
"16893","51334","2020",2,2,0,190000,1524,117.5
"16894","51337","2020",4,4,0,201000,1817.25,115.25
"16895","51338","2020",9,9,0,170611.1,1696.222,102.1111
"16896","51339","2020",5,5,0,158839.2,1594.6,98.4
"16897","51340","2020",2,2,0,82000,911,78.5
"16898","51341","2020",2,2,0,78000,825.5,94.5
"16899","51342","2020",4,4,0,239775,2374,102.25
"16900","51343","2020",8,8,0,134937.5,990.375,139
"16901","51344","2020",13,13,0,207292.3,2254.846,92.38462
"16902","51345","2020",7,7,0,171131.4,1631.143,109.4286
"16903","51346","2020",14,14,0,107785.7,1093,101.4286
"16904","51348","2020",2,2,0,183293,1349,144
"16905","51350","2020",1,1,0,1e+05,1190,84
"16906","51352","2020",6,6,0,123566.7,1214.833,107.5
"16907","51353","2020",1,1,0,152129,1463,104
"16908","51354","2020",4,4,0,249750,1556,154.5
"16909","51355","2020",2,2,0,67250,691,105
"16910","51357","2020",2,2,0,110500,1156,83
"16911","51358","2020",7,6,1,69500,1203.571,69.71429
"16912","51359","2020",1,1,0,236000,2408,98
"16913","51360","2020",7,6,1,120471.4,1354.571,87.14286
"16914","51362","2020",5,5,0,302777.2,1968,147
"16915","51363","2020",3,3,0,170166.7,1680,105
"16916","51364","2020",1,1,0,398000,2274,175
"16917","51365","2020",11,11,0,275439.5,2240.364,122.8182
"16918","51367","2020",1,1,0,255000,1032,247
"16919","51369","2020",2,2,0,143750,1763,81.5
"16920","51370","2020",3,3,0,101858.3,1214.667,77.33333
"16921","51372","2020",4,4,0,204906.2,1894.5,109
"16922","51373","2020",1,1,0,193500,1573,123
"16923","51375","2020",4,4,0,332077.5,2776.25,118.75
"16924","51376","2020",1,1,0,136500,1276,107
"16925","51378","2020",3,3,0,264116.7,1790.333,135.3333
"16926","51379","2020",7,7,0,188284.3,2045.714,103.5714
"16927","51380","2020",36,35,1,117732.2,1198.778,99.22222
"16928","51381","2020",10,5,5,117535,1412.9,75.1
"16929","51382","2020",2,2,0,189500,1572.5,121
"16930","51384","2020",4,4,0,209000,2074.5,108
"16931","51386","2020",4,4,0,101875,954.75,111
"16932","51387","2020",2,2,0,91250,961,95.5
"16933","51388","2020",31,31,0,149092.4,1594.903,99.16129
"16934","51389","2020",12,12,0,154825.8,1516.833,108.6667
"16935","51390","2020",10,10,0,210526,1781.6,121
"16936","51391","2020",20,20,0,234328.8,2302.25,106.45
"16937","51392","2020",2,2,0,260200,1827,144
"16938","51395","2020",2,2,0,166500,1502.5,110
"16939","51396","2020",1,1,0,157700,1752,90
"16940","51398","2020",3,3,0,175000,1295.667,147.3333
"16941","51399","2020",5,5,0,104700,813.2,126.6
"16942","51402","2020",5,5,0,146800,1533.2,114
"16943","51403","2020",5,5,0,213756.2,1967.8,118.8
"16944","51404","2020",1,1,0,135000,1227,110
"16945","51406","2020",1,1,0,33000,375,88
"16946","51407","2020",9,9,0,126443.8,1592.333,85.11111
"16947","51409","2020",6,6,0,173666.7,1331.333,134.6667
"16948","51410","2020",5,5,0,190560,2076.6,88.8
"16949","51413","2020",6,6,0,182453.5,1928.167,96.83333
"16950","51414","2020",3,3,0,94333.33,826,98.33333
"16951","51415","2020",4,4,0,128250,1371.5,96.25
"16952","51416","2020",15,14,1,125766.7,1263.8,99.8
"16953","51417","2020",6,6,0,192961.7,2981,88.16667
"16954","51418","2020",4,4,0,219335,2204.25,107.25
"16955","51419","2020",3,3,0,126833.3,1483,94.33333
"16956","51421","2020",3,3,0,140333.3,1542.333,91.33333
"16957","51422","2020",5,5,0,395152.8,2534,148.8
"16958","51423","2020",18,18,0,94800,956.7222,102.5
"16959","51424","2020",1,1,0,70000,824,85
"16960","51425","2020",1,1,0,185000,1194,155
"16961","51428","2020",2,2,0,210450,1301,179
"16962","51429","2020",3,3,0,355766,2337.333,154.6667
"16963","51430","2020",1,1,0,250000,1121,223
"16964","51431","2020",17,17,0,218085.6,2163.294,107.8235
"16965","51432","2020",15,15,0,109913.3,1224.467,92.86667
"16966","51433","2020",2,2,0,95075,1044,89
"16967","51434","2020",7,7,0,204707.1,1901.286,109.5714
"16968","51436","2020",8,8,0,187000,1407.375,132.875
"16969","51438","2020",1,1,0,96500,731,132
"16970","51439","2020",4,4,0,274895,2017.75,142
"16971","51440","2020",21,20,1,154032.9,1508,106.3333
"16972","51442","2020",1,1,0,35000,583,60
"16973","51443","2020",2,2,0,136000,1487,93
"16974","51444","2020",9,9,0,210338.9,1966,112.2222
"16975","51445","2020",2,2,0,292525,1775.5,161.5
"16976","51446","2020",3,3,0,128333.3,1027,129.3333
"16977","51447","2020",5,5,0,179590,1814,105.8
"16978","51448","2020",13,13,0,110915.4,1492,76.84615
"16979","51449","2020",13,13,0,256564.6,2496.462,108.3846
"16980","51450","2020",6,6,0,277541.7,2138.667,122
"16981","51451","2020",1,1,0,95000,1377,69
"16982","51453","2020",9,9,0,174777.8,1759.889,100
"16983","51454","2020",2643,581,2062,170228.3,2436.571,70.41392
"16984","51455","2020",1,1,0,158000,1629,97
"16985","51460","2020",1,1,0,173000,1018,170
"16986","51461","2020",10,10,0,252999.7,2387.9,108.3
"16987","51463","2020",1,1,0,85000,1149,74
"16988","51464","2020",2,2,0,146675,1175,123.5
"16989","51465","2020",2,2,0,160000,2416,66
"16990","51466","2020",4,4,0,183750,1418.75,128
"16991","51468","2020",6,6,0,363590,1976.833,186.3333
"16992","51471","2020",3,3,0,235283.3,2379.333,138.6667
"16993","51472","2020",13,12,1,155523.1,1283.462,120.2308
"16994","51473","2020",1,1,0,89000,1156,77
"16995","51474","2020",42,17,25,189062.4,2465.548,77.14286
"16996","51475","2020",2,2,0,88950,1006.5,91.5
"16997","51476","2020",9,7,2,178333.1,1574.222,126.8889
"16998","51477","2020",4,4,0,277410,2278.25,128.5
"16999","51478","2020",4,4,0,123750,1362.5,86.5
"17000","51479","2020",2,2,0,160250,1445,111
"17001","51480","2020",4,4,0,136375,2352.5,70.25
"17002","51482","2020",6,6,0,151500,1510,101.1667
"17003","51483","2020",2,2,0,205000,1653.5,133.5
"17004","51484","2020",2,2,0,148300,1667.5,103
"17005","51485","2020",4,4,0,217350,1837.25,122.25
"17006","51486","2020",3,3,0,170641.7,1714.667,106
"17007","51487","2020",4,4,0,265150,1452.25,174.5
"17008","51488","2020",5,5,0,191070,1716.2,112.8
"17009","51490","2020",1,1,0,189000,1268,149
"17010","51491","2020",1,1,0,45000,570,79
"17011","51492","2020",19,19,0,112716.3,1266.263,86.05263
"17012","51493","2020",3,3,0,271493.3,2652,115.6667
"17013","51496","2020",6,6,0,205322.5,1524.667,132.1667
"17014","51498","2020",2,2,0,143500,1179.5,130
"17015","51499","2020",4,4,0,168445.8,1519.25,114
"17016","51500","2020",1,1,0,120000,930,129
"17017","51501","2020",4,4,0,130875.2,1094.75,120.5
"17018","51502","2020",2,2,0,142500,1039,157
"17019","51504","2020",10,10,0,215700,2405.7,90.5
"17020","51505","2020",3,3,0,186833.3,1194.667,156
"17021","51506","2020",54,33,21,152112.4,1560.722,93.37037
"17022","51507","2020",42,37,5,126633.3,1235.976,106.5476
"17023","51508","2020",4,4,0,138450,990,142
"17024","51509","2020",1,1,0,136000,1030,132
"17025","51510","2020",1,1,0,40000,444,90
"17026","51511","2020",2,2,0,139495,1414.5,100
"17027","51513","2020",5,5,0,125130,1182,113
"17028","51515","2020",5,5,0,74000,892.6,86.4
"17029","51516","2020",1,1,0,99000,917,108
"17030","51517","2020",2,2,0,140000,864.5,155
"17031","51518","2020",4,4,0,430550,2852,149.25
"17032","51519","2020",1,1,0,41500,494,84
"17033","51520","2020",1,1,0,60000,857,70
"17034","51521","2020",3,3,0,103690,976.3333,109.3333
"17035","51522","2020",1,1,0,140000,1443,97
"17036","51523","2020",2,2,0,192500,1776,116
"17037","51524","2020",2,2,0,87500,1280.5,68.5
"17038","51525","2020",23,23,0,178502.2,1786.261,101.3043
"17039","51526","2020",4,4,0,129250,1841,83.25
"17040","51527","2020",5,5,0,156398,1584.4,118.8
"17041","51529","2020",7,7,0,241579.1,2287.143,108.7143
"17042","51530","2020",14,14,0,205505.7,1739.143,129.2857
"17043","51531","2020",17,17,0,72311.24,779.4118,95.23529
"17044","51532","2020",3,3,0,173600,2693,74.66667
"17045","51534","2020",4,4,0,116750,1019.75,102
"17046","51535","2020",70,57,13,118893.4,1421.157,91.91429
"17047","51536","2020",21,16,5,212040.5,2351.143,90.47619
"17048","51537","2020",2,2,0,127000,867.5,145
"17049","51539","2020",1,1,0,1e+05,690,145
"17050","51542","2020",3,3,0,125833.3,909.3333,131
"17051","51544","2020",9,9,0,122855.6,1196.222,107.6667
"17052","51545","2020",6,6,0,157848.3,1250.333,133.6667
"17053","51546","2020",4,4,0,119750,1325.5,88
"17054","51547","2020",3,3,0,105166.7,1067,100.3333
"17055","51548","2020",6,6,0,181883.3,1859.333,99.16667
"17056","51550","2020",1,1,0,75000,833,90
"17057","51551","2020",1,1,0,105000,1061,99
"17058","51552","2020",3,3,0,154733.3,1436.667,107.3333
"17059","51553","2020",4,4,0,175001.2,1584.25,118.25
"17060","51555","2020",1,1,0,175000,907,193
"17061","51556","2020",5,5,0,149100,1333.6,114.8
"17062","51557","2020",7,7,0,111785.7,1190.286,95.42857
"17063","51558","2020",3,3,0,131866.7,1323,120
"17064","51559","2020",33,31,2,135468.8,1481.03,93.78788
"17065","51560","2020",2,2,0,145500,1326,104.5
"17066","51562","2020",17,17,0,241460.7,2239.529,110.1765
"17067","51564","2020",7,7,0,159278.6,1424.286,111.7143
"17068","51566","2020",1,1,0,242000,2086,116
"17069","51567","2020",8,8,0,123487.5,1210.125,104.375
"17070","51568","2020",3,3,0,275333.3,3008.333,91.33333
"17071","51569","2020",1,1,0,310000,3010,103
"17072","51570","2020",2,2,0,94700,798.5,119
"17073","51571","2020",13,12,1,240012.7,1837.615,140.4615
"17074","51572","2020",3,3,0,149400,1430,102.3333
"17075","51573","2020",143,82,61,222707.5,2447.643,92.30769
"17076","51574","2020",2,2,0,147750,1052.5,142
"17077","51576","2020",20,19,1,165448.5,1698.45,98.15
"17078","51577","2020",2,2,0,291850,1623,208
"17079","51579","2020",3,3,0,154666.7,1229.333,108.3333
"17080","51580","2020",3,3,0,124666.7,1720,71.33333
"17081","51581","2020",3,3,0,204166.7,1450,139.6667
"17082","51582","2020",4,4,0,295666.8,2347.5,128.25
"17083","51583","2020",1,1,0,93000,715,130
"17084","51584","2020",1,1,0,542450,3545,153
"17085","51585","2020",9,8,1,106222.2,1254.778,82.77778
"17086","51586","2020",3,3,0,209290,2042.667,105
"17087","51587","2020",5,5,0,192000,1247.8,158.8
"17088","51588","2020",4,3,1,74125,792.75,96
"17089","51590","2020",5,5,0,111820,978.8,116
"17090","51591","2020",1,1,0,78000,1560,50
"17091","51592","2020",2,2,0,188000,1647,109.5
"17092","51594","2020",2,2,0,85000,701.5,118.5
"17093","51596","2020",4,4,0,130750,1143.75,100.75
"17094","51597","2020",3,3,0,221166.7,1621.333,138.3333
"17095","51598","2020",5,5,0,79780,1008.6,75.8
"17096","51599","2020",2,2,0,107250,967.5,104
"17097","51601","2020",4,4,0,158625,1311,127.25
"17098","51602","2020",2,2,0,89475,872,93.5
"17099","51603","2020",2,2,0,168750,1828.5,94
"17100","51604","2020",3,3,0,188166.7,1562.667,125
"17101","51605","2020",2,2,0,207500,1703.5,118.5
"17102","51607","2020",3,3,0,134366.7,2223,61.66667
"17103","51609","2020",9,9,0,138180.6,1490.444,92.77778
"17104","51610","2020",3,3,0,162283.3,1185.333,133.6667
"17105","51611","2020",2,2,0,142930,1464.5,98
"17106","51612","2020",40,37,3,133908.2,1166.45,118.05
"17107","51613","2020",13,13,0,201696.2,1844.846,109.8462
"17108","51614","2020",14,14,0,197067.9,1915.429,110.7857
"17109","51616","2020",5,5,0,188680,1514.8,125
"17110","51617","2020",14,14,0,208625,1965.071,111.7143
"17111","51618","2020",5,5,0,136800,1618,83.6
"17112","51619","2020",1,1,0,107500,1396,77
"17113","51620","2020",2,2,0,50500,660,75
"17114","51621","2020",3,3,0,92333.33,636.6667,136
"17115","51622","2020",7,5,2,198214.3,2025.857,95.85714
"17116","51623","2020",6,6,0,213569.3,1787.167,116.3333
"17117","51624","2020",10,10,0,158859,1586.7,122.1
"17118","51625","2020",3,3,0,122000,1554,81.66667
"17119","51626","2020",2,2,0,108125,1091,100
"17120","51627","2020",1,1,0,160000,1649,97
"17121","51628","2020",1,1,0,99000,853,116
"17122","51629","2020",14,13,1,252167.9,2402,113.5714
"17123","51631","2020",6,6,0,314876.7,2718,113.5
"17124","51632","2020",4,4,0,124750,1310,97.25
"17125","51633","2020",6,6,0,301333.3,2441.333,146.1667
"17126","51634","2020",1,1,0,199550,1512,132
"17127","51635","2020",3,3,0,53033.33,478.3333,111.6667
"17128","51636","2020",5,5,0,185700,1496.4,122.4
"17129","51637","2020",3,3,0,231500,1946,127
"17130","51638","2020",1,1,0,115000,1597,72
"17131","51639","2020",1,1,0,1e+05,1786,56
"17132","51640","2020",2,2,0,98000,982,94
"17133","51641","2020",2,2,0,166550,1192,141
"17134","51642","2020",1,1,0,193500,1536,126
"17135","51643","2020",7,6,1,141227,1445.429,96.14286
"17136","51644","2020",3,3,0,192333.3,1817.667,106
"17137","51645","2020",1,1,0,55874,542,103
"17138","51646","2020",1,1,0,25000,410,61
"17139","51647","2020",6,6,0,96436.67,1141,84.33333
"17140","51648","2020",4,4,0,181762.5,1475.5,127.25
"17141","51649","2020",106,77,29,102049.5,1155.208,86.91509
"17142","51650","2020",1,1,0,30000,370,81
"17143","51652","2020",1,1,0,94000,1044,90
"17144","51654","2020",2,2,0,224650,1165.5,194
"17145","51655","2020",2,2,0,166000,1602.5,105.5
"17146","51656","2020",5,5,0,124800,1263.4,105.6
"17147","51657","2020",3,3,0,265133.3,1950.667,134
"17148","51660","2020",32,32,0,222780,2092.219,110.7812
"17149","51662","2020",59,46,13,235799.1,2178.203,108.9831
"17150","51663","2020",18,11,7,117377.8,1574.111,71.88889
"17151","52003","2020",3,3,0,56666.67,1175.333,68
"17152","52006","2020",2,2,0,122500,1668.5,69
"17153","52008","2020",3,3,0,141343.3,892,144.3333
"17154","52012","2020",1,1,0,71500,550,130
"17155","52014","2020",2,2,0,145000,1277,114.5
"17156","52016","2020",2,2,0,153750,841,174
"17157","52017","2020",11,11,0,102768.3,847.8182,121.4545
"17158","52021","2020",2,2,0,186250,1399,132.5
"17159","52022","2020",3,3,0,52666.67,535,90.33333
"17160","52023","2020",1,1,0,90000,703,128
"17161","52025","2020",2,2,0,123281,1010,123.5
"17162","52027","2020",1,1,0,55000,393,140
"17163","52029","2020",5,5,0,63400,789.2,75.8
"17164","52031","2020",4,4,0,133000,1276.5,111.75
"17165","52033","2020",1,1,0,148000,886,167
"17166","52034","2020",1,1,0,176780,1133,156
"17167","52035","2020",1,1,0,47000,783,60
"17168","52037","2020",6,6,0,98950,1336.833,82.83333
"17169","52038","2020",1,1,0,40000,519,77
"17170","52040","2020",1,1,0,44000,454,97
"17171","52042","2020",1,1,0,91650,495,185
"17172","52043","2020",2,2,0,75250,600,126.5
"17173","52044","2020",2,2,0,89000,611,138.5
"17174","52045","2020",13,13,0,140416.9,1571.923,90.46154
"17175","52047","2020",1,1,0,37500,417,90
"17176","52050","2020",19,19,0,99328.37,1139.895,88.15789
"17177","52058","2020",17,16,1,105735.3,1303.706,88.82353
"17178","52060","2020",25,23,2,97685.12,895.52,118.84
"17179","52061","2020",2,2,0,90000,863,103
"17180","52062","2020",2,2,0,158000,1205,131
"17181","52063","2020",1,1,0,226000,753,300
"17182","52064","2020",3,3,0,90000,648,148.3333
"17183","52065","2020",1,1,0,26000,433,60
"17184","52067","2020",1,1,0,28000,444,63
"17185","52072","2020",3,3,0,146666.7,1327,117.6667
"17186","52074","2020",5,4,1,76890,1050,77
"17187","52075","2020",3,3,0,150500,1622,99
"17188","52076","2020",3,3,0,75000,637,118.3333
"17189","52079","2020",5,5,0,65800,776.2,81.2
"17190","52082","2020",1,1,0,1e+05,581,172
"17191","52083","2020",8,8,0,65062.5,744.5,86
"17192","52087","2020",1,1,0,278457,1881,148
"17193","52088","2020",4,4,0,101000,1183.5,90.25
"17194","52090","2020",1,1,0,1e+05,746,134
"17195","52092","2020",3,3,0,64333.33,590,106.3333
"17196","52093","2020",19,19,0,77523.68,946.3158,82.73684
"17197","52094","2020",3,3,0,47000,991,75.33333
"17198","52095","2020",1,1,0,118000,1192,99
"17199","52097","2020",2,2,0,70000,755.5,75
"17200","52099","2020",6,6,0,96333.33,1193.5,84
"17201","52102","2020",4,3,1,170000,1474.5,117.5
"17202","52104","2020",10,10,0,149345,1588.1,96.2
"17203","52106","2020",3,3,0,92333.33,1029.667,97.33333
"17204","52107","2020",2,2,0,144200,995.5,145
"17205","52110","2020",1,1,0,55000,440,125
"17206","52113","2020",5,5,0,107640,866.6,125.2
"17207","52114","2020",19,18,1,85557.89,798.7368,108.9474
"17208","52118","2020",3,3,0,60666.67,695,91.66667
"17209","52119","2020",1,1,0,212500,957,222
"17210","52120","2020",1,1,0,63725,996,64
"17211","52121","2020",220,134,86,109339.5,1310.414,84.87273
"17212","52122","2020",1,1,0,149100,789,189
"17213","52123","2020",11,10,1,91690.91,1002.091,96.36364
"17214","52125","2020",15,14,1,159382,1341.133,116.1333
"17215","52126","2020",1,1,0,43000,524,82
"17216","52130","2020",5,5,0,109800,907.4,131.2
"17217","52132","2020",1,1,0,110000,775,142
"17218","52134","2020",2,2,0,185000,1076.5,171.5
"17219","52140","2020",5,5,0,114723.2,848,127
"17220","52141","2020",2,2,0,192500,2118,96
"17221","52145","2020",3,3,0,59166.67,515,116.6667
"17222","52149","2020",1,1,0,105000,1082,97
"17223","52151","2020",1,1,0,125000,735,170
"17224","52155","2020",8,8,0,88237.5,869.25,98.375
"17225","52156","2020",4,4,0,69125,782.25,82
"17226","52158","2020",3,3,0,117000,940,121.6667
"17227","52159","2020",1,1,0,50000,667,75
"17228","52161","2020",1,1,0,125000,1330,94
"17229","52163","2020",2,2,0,35750,465.5,76
"17230","52165","2020",3,3,0,88333.33,797.3333,121
"17231","52167","2020",2,2,0,87500,674.5,124
"17232","52169","2020",2,2,0,150500,1129,133
"17233","52171","2020",1,1,0,150000,833,180
"17234","52172","2020",4,4,0,121125,720.5,178.75
"17235","52175","2020",3,3,0,103877.3,636.6667,148.3333
"17236","52177","2020",6,6,0,103000,793.6667,115
"17237","52178","2020",5,5,0,147720,1202.8,132.8
"17238","52181","2020",1,1,0,35000,385,91
"17239","52182","2020",27,27,0,112051.9,1104.519,105.1481
"17240","52187","2020",4,4,0,56875,559.75,103.25
"17241","52189","2020",3,3,0,84166.67,823.3333,102.6667
"17242","52190","2020",7,7,0,77142.86,648.1429,110.8571
"17243","52193","2020",3,3,0,158066.7,1580,102
"17244","52194","2020",20,20,0,110497.5,1160.5,97.2
"17245","52200","2020",1,1,0,135000,1227,110
"17246","52201","2020",1,1,0,105000,1400,75
"17247","52203","2020",1,1,0,76000,894,85
"17248","52205","2020",10,10,0,127423,1243.3,103.8
"17249","52211","2020",15,14,1,81300,899.2,91.26667
"17250","52212","2020",5,5,0,84020,2207,91.6
"17251","52213","2020",1,1,0,80000,762,105
"17252","52214","2020",1,1,0,192300,1814,106
"17253","52217","2020",1,1,0,35000,412,85
"17254","52223","2020",1,1,0,21500,371,58
"17255","52228","2020",1,1,0,190000,876,217
"17256","52229","2020",2,2,0,45000,459.5,106
"17257","52230","2020",1,0,1,92000,1260,73
"17258","52231","2020",2,2,0,85000,785,112
"17259","52235","2020",1,1,0,153000,900,170
"17260","52237","2020",5,5,0,115960,1177.2,110.8
"17261","52240","2020",1,1,0,161500,956,169
"17262","52243","2020",1,1,0,55000,387,142
"17263","52244","2020",6,6,0,109166.7,1006.667,107.5
"17264","52246","2020",5,5,0,159000,1224.2,143.8
"17265","52247","2020",2,2,0,89500,595.5,166.5
"17266","52248","2020",4,4,0,98000,909.25,103
"17267","52249","2020",1,1,0,30000,333,90
"17268","52250","2020",29,24,5,77642.24,846.3103,87.82759
"17269","52251","2020",4,4,0,183725,1555.75,109.5
"17270","52253","2020",1,1,0,90000,359,251
"17271","52256","2020",1,1,0,160000,1633,98
"17272","52258","2020",8,8,0,77368.75,718.625,105.75
"17273","52260","2020",2,2,0,80220,770.5,99
"17274","52265","2020",10,10,0,111750,1174.1,94.7
"17275","52267","2020",2,2,0,151000,1414.5,107
"17276","52269","2020",71,47,24,102588.4,1110.732,95.61972
"17277","52271","2020",3,3,0,46966.67,385,125
"17278","52272","2020",1,1,0,35000,438,80
"17279","52274","2020",3,3,0,92666.67,787.3333,123.3333
"17280","52278","2020",2,2,0,37500,548.5,74
"17281","52280","2020",1,1,0,133000,1430,93
"17282","52282","2020",6,6,0,133583.3,1218,111.8333
"17283","52284","2020",2,2,0,88250,528,173
"17284","52286","2020",1,1,0,66000,437,151
"17285","52287","2020",1,1,0,50000,435,115
"17286","52288","2020",1,1,0,40000,421,95
"17287","52289","2020",2,2,0,97500,624.5,173
"17288","52291","2020",2,2,0,64500,411.5,152.5
"17289","52292","2020",6,6,0,162983.3,1087.833,147.8333
"17290","52294","2020",3,3,0,97833.33,956.6667,94.66667
"17291","52295","2020",4,4,0,91875,960.75,90.25
"17292","52297","2020",1,1,0,187000,1612,116
"17293","52298","2020",2,2,0,115000,916,109
"17294","52302","2020",1,1,0,30000,625,48
"17295","52305","2020",4,4,0,90200,812,104.75
"17296","52306","2020",2,2,0,113500,1132,98.5
"17297","52308","2020",5,5,0,62660,660.4,97.2
"17298","52310","2020",1,1,0,31000,443,70
"17299","52315","2020",2,2,0,113167.5,966.5,131
"17300","52320","2020",2,2,0,89500,886,102
"17301","52321","2020",1,1,0,25000,446,56
"17302","52322","2020",2,2,0,153290,1028.5,146
"17303","52325","2020",1,1,0,30000,441,68
"17304","52326","2020",1,1,0,160000,1600,100
"17305","52327","2020",7,7,0,102441.4,1088.857,95
"17306","52330","2020",3,3,0,88333.33,649.3333,129
"17307","52331","2020",24,24,0,111145.2,1050.875,105.7083
"17308","52332","2020",17,16,1,94082.35,793.7647,119.7059
"17309","52335","2020",3,3,0,66333.33,626.6667,105
"17310","52346","2020",1,1,0,30000,667,45
"17311","52347","2020",1,1,0,158500,1299,122
"17312","52348","2020",5,5,0,118300,888.2,134.8
"17313","52349","2020",4,4,0,186525,1083.5,152.5
"17314","52353","2020",51,48,3,89362.41,878.2941,105.0392
"17315","52354","2020",2,2,0,1e+05,667,132
"17316","52355","2020",3,3,0,81333.33,786.6667,102.3333
"17317","52356","2020",1,1,0,95000,1159,82
"17318","52357","2020",2,2,0,90000,966.5,89
"17319","52358","2020",1,1,0,15000,385,39
"17320","52360","2020",1,1,0,128000,1580,81
"17321","52362","2020",3,3,0,186150,1127,164.3333
"17322","52365","2020",7,7,0,79142.86,568.8571,141.2857
"17323","52367","2020",1,1,0,110000,738,149
"17324","52370","2020",2,2,0,55000,604,98.5
"17325","52371","2020",2,2,0,45000,581.5,79.5
"17326","52374","2020",3,3,0,100333.3,841.3333,122.6667
"17327","52376","2020",1,1,0,88000,1443,61
"17328","52380","2020",4,4,0,192125,1939,102
"17329","52383","2020",1,1,0,26000,650,40
"17330","52384","2020",2,2,0,158500,859,195.5
"17331","52385","2020",1,1,0,64400,1288,50
"17332","52386","2020",4,4,0,94347.5,801.25,115.5
"17333","52391","2020",2,2,0,163125,1368.5,119
"17334","52398","2020",8,8,0,85875,693.125,127.125
"17335","52399","2020",2,2,0,74000,634,111.5
"17336","52401","2020",1,1,0,60000,667,90
"17337","52403","2020",1,1,0,167830,1526,110
"17338","52405","2020",12,12,0,94600,853.3333,123
"17339","52407","2020",1,1,0,96500,854,113
"17340","52411","2020",13,13,0,118103.8,1277.231,97.76923
"17341","52413","2020",1,1,0,137000,945,145
"17342","52414","2020",10,10,0,121929,1269.9,94.8
"17343","52419","2020",1,1,0,90000,529,170
"17344","52421","2020",2,2,0,131000,1097,116
"17345","52422","2020",1,1,0,180000,1200,150
"17346","52423","2020",6,6,0,56000,609.3333,92.66667
"17347","52425","2020",3,3,0,60000,606.6667,102.3333
"17348","52429","2020",3,3,0,153166.7,1702.667,89.66667
"17349","52431","2020",1,1,0,151000,944,160
"17350","52432","2020",21,21,0,106571,913.4762,110.1905
"17351","52433","2020",1,1,0,30000,345,87
"17352","52440","2020",3,2,1,82500,958,83
"17353","52442","2020",1,1,0,80000,419,191
"17354","52443","2020",1,1,0,57000,760,75
"17355","52444","2020",2,2,0,111750,1352.5,86
"17356","52446","2020",3,3,0,99433.33,773.3333,127
"17357","52447","2020",1,1,0,120000,1348,89
"17358","52448","2020",232,160,72,92411.05,1156.362,81.7931
"17359","52449","2020",9,9,0,142800.6,1201.889,108.5556
"17360","52450","2020",4,4,0,66750,824,83.75
"17361","52452","2020",1,1,0,58000,644,90
"17362","52453","2020",2,2,0,201000,1424,155.5
"17363","52455","2020",2,2,0,43500,534.5,80.5
"17364","52456","2020",1,1,0,77000,1185,65
"17365","52457","2020",1,1,0,155000,1761,88
"17366","52459","2020",1,1,0,30000,333,90
"17367","52461","2020",5,5,0,77360,799,104
"17368","52464","2020",1,1,0,55000,550,100
"17369","52468","2020",1,1,0,44000,440,100
"17370","52469","2020",5,5,0,167000,1290.6,132.8
"17371","52473","2020",2,2,0,44000,567,75
"17372","52476","2020",1,0,1,80000,800,100
"17373","52479","2020",3,3,0,81666.67,1060,94
"17374","52480","2020",5,5,0,77800,995.6,76.4
"17375","52484","2020",2,2,0,72688,1071,67
"17376","52488","2020",2,2,0,57987.5,649,89.5
"17377","52490","2020",6,6,0,92916.67,778.6667,122.6667
"17378","52491","2020",1,1,0,68200,467,146
"17379","52492","2020",5,5,0,65800,977.6,71.8
"17380","52494","2020",3,3,0,155000,1618.667,104.3333
"17381","52495","2020",1,1,0,30000,385,78
"17382","52497","2020",3,3,0,123556.3,1060.333,116.6667
"17383","52499","2020",2,2,0,47750,543,92
"17384","52500","2020",5,5,0,130000,1602.6,84.8
"17385","52506","2020",1,1,0,49000,392,125
"17386","52507","2020",2,2,0,147500,1457.5,101.5
"17387","52510","2020",1,1,0,50000,575,87
"17388","52512","2020",3,3,0,55333.33,877.6667,57.66667
"17389","52514","2020",3,3,0,193970,1411,136.6667
"17390","52517","2020",1,1,0,86000,619,139
"17391","52518","2020",2,2,0,61500,878.5,71.5
"17392","52520","2020",1,1,0,71450,656,109
"17393","52522","2020",6,6,0,111500,1174.833,95.83333
"17394","52524","2020",2,2,0,94500,914.5,120
"17395","52525","2020",1,1,0,35000,389,90
"17396","52529","2020",12,12,0,86041.67,672.6667,120.6667
"17397","52534","2020",16,16,0,129412.5,1418.688,92.4375
"17398","52535","2020",10,10,0,149360,1355.7,109
"17399","52538","2020",6,6,0,122250,944.3333,128.6667
"17400","52539","2020",1,1,0,70000,376,186
"17401","52540","2020",1,1,0,71000,568,125
"17402","52543","2020",2,2,0,93245,762,119.5
"17403","52547","2020",2,2,0,171000,1374.5,124.5
"17404","52548","2020",1,1,0,173000,1254,138
"17405","52550","2020",20,20,0,70485.6,752.6,93.35
"17406","53001","2020",23,23,0,198869.4,2181.435,104.3043
"17407","53002","2020",8,8,0,120456.2,1207.75,93.375
"17408","53003","2020",35,35,0,100077.1,1100.057,86.62857
"17409","53005","2020",37,37,0,128143.2,1315.892,102.8378
"17410","53007","2020",36,36,0,196879.2,1766.028,112.1111
"17411","53008","2020",15,15,0,120682.7,1035.4,124.2667
"17412","53009","2020",10,10,0,202115,1483.6,130.9
"17413","53010","2020",9,9,0,89888.89,940.3333,97
"17414","53011","2020",6,6,0,127416.7,1263.333,101.8333
"17415","53012","2020",6,6,0,101016.7,840,108
"17416","53013","2020",6,6,0,59750,1025.167,57.5
"17417","53015","2020",31,31,0,131721,1313.355,100.4194
"17418","53016","2020",25,24,1,64770.8,756.52,99.04
"17419","53017","2020",9,9,0,73133.33,858.1111,83.22222
"17420","53018","2020",16,16,0,93687.5,987.375,95.125
"17421","53019","2020",2,2,0,56500,815,76.5
"17422","53021","2020",6,6,0,168083.3,1529.167,112.8333
"17423","53022","2020",9,9,0,156196.7,1585.556,100.6667
"17424","53023","2020",11,11,0,171154.5,1430.273,119.7273
"17425","53025","2020",19,19,0,88300,991.2632,88.21053
"17426","53026","2020",7,7,0,125142.9,1406.571,85.14286
"17427","53027","2020",3,3,0,86833.33,825.6667,114
"17428","53028","2020",7,7,0,114114.3,1083.286,109.8571
"17429","53029","2020",25,25,0,120221.2,1111.6,110.2
"17430","53030","2020",5,5,0,117078,1282.2,94.8
"17431","53031","2020",5,5,0,124914,1490.8,90.2
"17432","53034","2020",60,60,0,200763.7,1865,108.2167
"17433","53035","2020",6,6,0,110008.3,1267.167,89.83333
"17434","53036","2020",16,16,0,152018.8,1329.438,106
"17435","53037","2020",11,11,0,128272.7,1287.636,100.9091
"17436","53039","2020",25,25,0,121348,1361.12,93.24
"17437","53040","2020",7,7,0,116634.3,1246,90.14286
"17438","53041","2020",5,5,0,88560,823.8,100.8
"17439","53042","2020",21,21,0,128918.3,1182.286,112.2857
"17440","53043","2020",11,11,0,90927.27,915,94.27273
"17441","53045","2020",9,9,0,156166.7,1632.556,119.5556
"17442","53046","2020",4,4,0,117500,844.5,133.75
"17443","53047","2020",3,3,0,56010,766.6667,70.66667
"17444","53048","2020",30,26,4,147078.3,1496.567,103.3667
"17445","53049","2020",10,10,0,134920,1349.2,98.7
"17446","53051","2020",10,10,0,120100,1270.3,110.9
"17447","53052","2020",4,4,0,110500,1505,77.75
"17448","53053","2020",11,11,0,105002,1012,108.8182
"17449","53054","2020",68,63,5,206980.4,1976.338,106.6618
"17450","53055","2020",8,8,0,73912.5,947.125,81
"17451","53056","2020",12,12,0,162408.3,1490.083,110.0833
"17452","53057","2020",5,5,0,66600,858.8,81
"17453","53058","2020",4,4,0,152500,1313.25,119
"17454","53059","2020",7,7,0,183221.4,2054.143,93.42857
"17455","53061","2020",5,5,0,46400,712.2,63.6
"17456","53062","2020",246,217,29,145394.7,1564.593,94.0122
"17457","53063","2020",9,9,0,138255.6,1277.556,115.8889
"17458","53064","2020",18,18,0,102963.9,934.0556,109.8889
"17459","53066","2020",18,18,0,140636.1,1269.5,110.2222
"17460","53067","2020",3,3,0,141000,976.3333,148
"17461","53068","2020",6,6,0,106084.8,1055.333,117
"17462","53069","2020",5,5,0,68930,1198,88
"17463","53071","2020",8,8,0,76079.5,841.25,91.625
"17464","53072","2020",23,23,0,139882.4,1198.522,114.8261
"17465","53073","2020",16,16,0,56591.88,616.875,89.8125
"17466","53074","2020",9,9,0,84094.44,984,90.11111
"17467","53075","2020",1,1,0,1e+05,1111,90
"17468","53076","2020",10,10,0,105250,998,107.5
"17469","53077","2020",35,34,1,113583.9,1149.8,99.71429
"17470","53078","2020",10,10,0,149306,1515.7,98.1
"17471","53079","2020",8,8,0,97173.75,1070.875,120.625
"17472","53080","2020",6,6,0,100488.3,836.8333,113.1667
"17473","53082","2020",4,4,0,143250,1756.25,86.5
"17474","53083","2020",7,7,0,81554.29,788.4286,103.7143
"17475","53084","2020",67,66,1,99194.27,1060.836,90.71642
"17476","53085","2020",6,6,0,134366.7,1151,117.1667
"17477","53086","2020",7,7,0,98500,991.8571,95.57143
"17478","53087","2020",4,4,0,144750,1425.5,99.25
"17479","53088","2020",9,9,0,88877.78,786,107.7778
"17480","53089","2020",16,16,0,108328.1,1097.5,95.25
"17481","53090","2020",2,2,0,120000,1307.5,92
"17482","53091","2020",7,7,0,93167.71,895.7143,103.7143
"17483","53093","2020",6,6,0,85333.33,951,87.66667
"17484","53094","2020",31,30,1,146809.7,1429.645,101.3548
"17485","53096","2020",96,92,4,96893.83,1050.99,92.22917
"17486","53097","2020",93,86,7,119469.8,1325.387,93.03226
"17487","53098","2020",10,10,0,93049,975.2,93.8
"17488","53099","2020",17,16,1,174907.6,1693.706,107.0588
"17489","53100","2020",27,27,0,88284.44,1006.741,89.77778
"17490","53101","2020",11,11,0,164000,1759.364,91.27273
"17491","53102","2020",6,6,0,137083.3,1296.5,103
"17492","53103","2020",22,22,0,163836.4,1586.182,105.9091
"17493","53104","2020",23,23,0,108490,1181.565,92.82609
"17494","53105","2020",3,3,0,155000,1281.667,126
"17495","53106","2020",7,7,0,74928.57,830.7143,88
"17496","53107","2020",50,48,2,84376,970.1,91.92
"17497","53108","2020",9,9,0,153055.6,1289.889,118.1111
"17498","53109","2020",5,5,0,85400,1169.6,69
"17499","53110","2020",18,18,0,105086.7,1103.667,95.11111
"17500","53111","2020",6,6,0,184833.3,3066.833,102.5
"17501","53112","2020",6,6,0,125477.5,1270,94.33333
"17502","53113","2020",11,11,0,100632.7,971.2727,106.5455
"17503","53114","2020",3,3,0,52333.33,482,118
"17504","53115","2020",6,6,0,138166.7,1175.5,115.6667
"17505","53116","2020",10,10,0,78800,743.1,104.8
"17506","53117","2020",9,9,0,170388.9,1411.111,124.7778
"17507","53118","2020",2,2,0,70000,1194,65
"17508","53119","2020",43,43,0,215359.2,1950.744,113.9302
"17509","53120","2020",4,4,0,52750,705.25,68.5
"17510","53121","2020",16,16,0,80436.88,944.25,85.625
"17511","53122","2020",11,11,0,96400,951.4545,102.0909
"17512","53123","2020",23,23,0,87970.83,1010.739,87.43478
"17513","53124","2020",23,22,1,136456.5,1224.435,115.6087
"17514","53125","2020",27,27,0,90429.63,1032.667,91.44444
"17515","53126","2020",16,16,0,89325,1455.938,83.25
"17516","53127","2020",32,32,0,84333.59,937.2188,88.1875
"17517","53128","2020",5,5,0,79000,1124,73
"17518","53129","2020",5,5,0,101468,976.8,104.6
"17519","53130","2020",800,429,371,157538.1,1870.335,83.83125
"17520","53131","2020",3,3,0,90000,929.6667,93.33333
"17521","53132","2020",4,4,0,90600,1003.25,92.25
"17522","53133","2020",9,9,0,84034.44,944.1111,90.77778
"17523","53134","2020",1,1,0,115000,1353,85
"17524","53135","2020",7,7,0,103450.1,1265.714,90.71429
"17525","53136","2020",19,19,0,144451.3,1360.737,105.2632
"17526","53137","2020",33,32,1,134370,1334.848,98.12121
"17527","53139","2020",3,3,0,96333.33,1082,87
"17528","53140","2020",41,41,0,184883.2,1830.293,101.8537
"17529","53141","2020",14,14,0,168785.7,1874,97.35714
"17530","53142","2020",8,8,0,106687.5,1128.125,102.625
"17531","53143","2020",4,4,0,165250,1565.5,105.5
"17532","53144","2020",3,3,0,132383.3,1065.667,118
"17533","53145","2020",6,6,0,102250,1030.333,99.83333
"17534","53146","2020",17,17,0,169658.8,1596.471,119.9412
"17535","53147","2020",166,124,42,125860.1,1362.627,96.07229
"17536","53148","2020",6,6,0,109350,979.6667,109.8333
"17537","53150","2020",2,2,0,160000,980.5,148.5
"17538","53151","2020",13,13,0,110273.8,1238.615,96.53846
"17539","53152","2020",37,33,4,132603.8,1347.486,101.3784
"17540","53153","2020",10,10,0,129600,1158.8,114
"17541","53154","2020",16,16,0,73825,776.4375,102.3125
"17542","53155","2020",15,15,0,110935.3,1096,96.53333
"17543","53156","2020",7,7,0,119285.7,1385.857,84.85714
"17544","53157","2020",15,15,0,172743.3,1505.267,111.8
"17545","53158","2020",9,8,1,107333.3,1329.333,80
"17546","53160","2020",3,3,0,69166.67,1024.667,71.33333
"17547","53161","2020",63,62,1,125475.4,1222.143,104.127
"17548","53162","2020",14,10,4,129244.6,1327.071,92.07143
"17549","53163","2020",8,8,0,101267.4,1375.375,85
"17550","53164","2020",9,9,0,70685.56,742.8889,92.88889
"17551","53165","2020",2,2,0,74755,679.5,123.5
"17552","53168","2020",17,16,1,149588.2,1171.647,133.9412
"17553","53169","2020",7,7,0,103771.4,1180,94.28571
"17554","53170","2020",15,15,0,76343.33,1086.467,75.06667
"17555","53172","2020",4,4,0,178050,1426,122.25
"17556","53173","2020",1,1,0,28000,384,73
"17557","53174","2020",12,12,0,149947.2,1368,108
"17558","53175","2020",8,8,0,127125,1624.125,78.5
"17559","53176","2020",9,9,0,109498.9,1020.556,109.4444
"17560","53177","2020",7,6,1,67351.57,789.5714,85.42857
"17561","53178","2020",1,1,0,75000,735,102
"17562","53179","2020",5,5,0,112740,998.4,111.8
"17563","53180","2020",12,12,0,103475,854.6667,117.3333
"17564","53181","2020",10,10,0,116046,1011.4,117.9
"17565","53182","2020",32,31,1,96790.62,1148.062,84.9375
"17566","53184","2020",2,2,0,211700,1098.5,241
"17567","53185","2020",31,31,0,87697.77,928.7742,94.77419
"17568","53186","2020",31,31,0,118055.6,1225.032,94.77419
"17569","53187","2020",3,3,0,111000,889.6667,126
"17570","53188","2020",26,26,0,61015.38,771.0769,76.84615
"17571","53189","2020",1,1,0,36500,676,54
"17572","53190","2020",6,6,0,75783.33,1060.167,74.66667
"17573","53191","2020",4,4,0,88975,885,94
"17574","53192","2020",9,9,0,93266.67,1065.333,110.1111
"17575","53193","2020",5,5,0,174060,1402.6,120
"17576","53195","2020",9,9,0,144621.7,1496.222,110.8889
"17577","53196","2020",4,4,0,58750,662.75,91.5
"17578","53197","2020",19,19,0,100994.7,1007.474,100.6842
"17579","53198","2020",4,4,0,66625,813.75,73.75
"17580","53199","2020",5,5,0,90860.2,817.4,113.4
"17581","53200","2020",11,11,0,147493.5,1485.727,97.27273
"17582","53201","2020",79,75,4,182361.6,1901.797,98.49367
"17583","53202","2020",10,10,0,107695,1006.8,102.8
"17584","53203","2020",6,6,0,126833.3,1156,110.1667
"17585","53204","2020",7,7,0,61850,1034.714,59.85714
"17586","53206","2020",1,1,0,137000,1030,133
"17587","53208","2020",6,6,0,59250,680.8333,85.33333
"17588","53209","2020",5,5,0,163000,1250.8,138.2
"17589","53210","2020",20,20,0,133672.6,1185.25,110.2
"17590","53211","2020",17,17,0,92583.24,825.8824,108.6471
"17591","53212","2020",9,9,0,106713.4,1066.889,99.77778
"17592","53213","2020",7,7,0,162615.9,1075.286,146.5714
"17593","53214","2020",2,2,0,50000,606,80
"17594","53216","2020",15,13,2,94618.67,1196.867,80.46667
"17595","53218","2020",13,13,0,126354.3,1262.077,98.30769
"17596","53219","2020",15,13,2,132418,1334.867,107.8667
"17597","53220","2020",3,3,0,102983.3,960.6667,105.6667
"17598","53221","2020",4,4,0,94400,1028.25,97
"17599","53222","2020",4,4,0,92075,1008.75,86.25
"17600","53223","2020",10,10,0,92145,826,110.5
"17601","53224","2020",16,16,0,176605.6,1658.75,107.6875
"17602","53225","2020",13,13,0,106843.8,1082.846,98.53846
"17603","53226","2020",14,14,0,100896.4,1190.714,84.5
"17604","53228","2020",10,10,0,114550,1015.2,108.4
"17605","53229","2020",32,31,1,168847.6,1729.281,99.03125
"17606","53230","2020",5,5,0,87500,1045.8,85.4
"17607","53232","2020",4,4,0,151750,1441,115.75
"17608","53233","2020",2,2,0,111000,947,117
"17609","53234","2020",5,5,0,110000,1187.6,97
"17610","53235","2020",8,8,0,72051.25,872,90.375
"17611","53236","2020",5,5,0,71490,747.4,112.8
"17612","53237","2020",6,6,0,111116.7,984.1667,128.6667
"17613","53238","2020",17,17,0,60927.06,736.2353,84.35294
"17614","53240","2020",6,6,0,95752.17,882.3333,106.1667
"17615","53242","2020",6,6,0,78613.33,874.1667,89
"17616","53243","2020",24,24,0,146292.5,1427.333,97.70833
"17617","53245","2020",12,12,0,73541.67,974.6667,79.58333
"17618","53246","2020",24,24,0,111065,1172.625,100.5833
"17619","53247","2020",26,26,0,131769.2,1392.923,93.53846
"17620","53248","2020",2,2,0,39500,428,100.5
"17621","53249","2020",8,8,0,107963.8,1226.75,89.5
"17622","53250","2020",4,4,0,140255,1286.5,111
"17623","53251","2020",7,7,0,101443.9,1108.286,90.42857
"17624","53253","2020",5,5,0,84980,808.4,113.6
"17625","53255","2020",29,29,0,129717.2,1330.207,96
"17626","53256","2020",6,6,0,69091.67,1029.667,75.66667
"17627","53257","2020",7,7,0,97967.71,1103.429,98.71429
"17628","53258","2020",10,10,0,95800,940.9,105.5
"17629","53259","2020",3,3,0,74333.33,996.6667,69
"17630","53260","2020",4,4,0,115054.8,1223.25,103.25
"17631","53261","2020",5,5,0,78236.8,928.2,95
"17632","53262","2020",9,9,0,152008.6,1164.222,115.5556
"17633","53263","2020",9,9,0,66755.56,971.3333,74.55556
"17634","53264","2020",1,1,0,142000,1352,105
"17635","53265","2020",14,14,0,79625.36,1122.357,77.92857
"17636","53266","2020",4,3,1,78000,1004.25,76.75
"17637","53267","2020",23,23,0,117266.7,1380.174,87.65217
"17638","53269","2020",10,10,0,66107.5,771.2,79.7
"17639","53270","2020",7,7,0,86837.14,921.2857,92.14286
"17640","53271","2020",31,28,3,86458.81,882.0323,93.83871
"17641","53272","2020",2,2,0,60750,627,91.5
"17642","53273","2020",17,17,0,126411.8,1220.353,107
"17643","53276","2020",20,20,0,94333.6,1052.75,88.3
"17644","54001","2020",3,3,0,153900,1306.333,118
"17645","54004","2020",2,2,0,45000,359,125
"17646","54006","2020",2,2,0,220600,1865,119
"17647","54007","2020",7,7,0,114038.6,1226,92.71429
"17648","54008","2020",8,8,0,185406.2,1626,118.125
"17649","54009","2020",1,1,0,230000,1643,140
"17650","54010","2020",4,4,0,137017.5,1424.75,90.5
"17651","54011","2020",9,7,2,149088.9,1213.111,124.7778
"17652","54012","2020",6,6,0,224566.7,1722,144
"17653","54013","2020",1,1,0,60000,545,110
"17654","54014","2020",2,2,0,51630,699.5,68
"17655","54015","2020",1,1,0,120000,706,170
"17656","54016","2020",2,2,0,203475,1376,167
"17657","54017","2020",2,2,0,57500,585.5,99.5
"17658","54018","2020",3,3,0,145583.3,1336.667,128.3333
"17659","54019","2020",4,4,0,89000,756.25,121
"17660","54020","2020",2,2,0,156500,2215.5,75
"17661","54021","2020",1,1,0,178800,1528,117
"17662","54022","2020",8,8,0,149437.5,1142.625,133.5
"17663","54023","2020",2,2,0,101000,898,133.5
"17664","54024","2020",9,9,0,168101.1,1701,102.6667
"17665","54025","2020",24,21,3,211519.8,1831.542,117.25
"17666","54026","2020",5,5,0,128800,1162.6,102.8
"17667","54027","2020",12,9,3,167058.3,1702.833,94.75
"17668","54028","2020",42,28,14,109713.8,1297.952,85.90476
"17669","54029","2020",25,20,5,212822.7,1850.4,116.44
"17670","54030","2020",2,2,0,59750,498,115.5
"17671","54031","2020",8,8,0,125751.2,1207.375,99.875
"17672","54032","2020",2,2,0,268050,1729.5,166.5
"17673","54033","2020",1,1,0,69500,599,116
"17674","54034","2020",2,1,1,103250,1110.5,105
"17675","54035","2020",1,1,0,92000,662,139
"17676","54036","2020",15,15,0,154312.5,1550.8,103.6
"17677","54037","2020",3,3,0,240383.3,2197.667,106.6667
"17678","54038","2020",7,7,0,130388.6,1127.429,113.8571
"17679","54039","2020",46,37,9,90159.13,873.3696,105.6522
"17680","54040","2020",18,16,2,72759.61,878.8889,88.22222
"17681","54041","2020",4,4,0,90125,885.25,96
"17682","54042","2020",2,1,1,157050,2382,75.5
"17683","54043","2020",9,6,3,174564.4,1466.556,120.7778
"17684","54044","2020",1,1,0,104000,743,140
"17685","54045","2020",6,6,0,166666.7,1345.833,133.1667
"17686","54046","2020",7,6,1,161821.4,1862.286,114.2857
"17687","54048","2020",4,4,0,193768.8,1551.25,121.75
"17688","54049","2020",3,3,0,129716.7,2197.333,64.66667
"17689","54051","2020",16,13,3,195243.7,1798.438,108
"17690","54053","2020",1,1,0,114000,1213,94
"17691","54054","2020",10,9,1,167500,1574.9,106
"17692","54055","2020",3,3,0,142617.3,1431.667,99.33333
"17693","54056","2020",2,2,0,115500,944,132.5
"17694","54058","2020",1,1,0,178100,1855,96
"17695","54059","2020",8,8,0,176306.2,1687.5,112
"17696","54060","2020",22,22,0,149152.3,1574.727,98.72727
"17697","54061","2020",2,2,0,179000,1543.5,116.5
"17698","54062","2020",4,4,0,207000,1555.5,147
"17699","54063","2020",2,1,1,115000,941,128.5
"17700","54064","2020",6,6,0,69163.33,547.6667,121
"17701","54065","2020",14,14,0,136832.1,1196.571,121.5714
"17702","54066","2020",7,6,1,186968.6,1756.143,109.2857
"17703","54067","2020",10,9,1,151900,1383.4,113
"17704","54069","2020",7,7,0,294628.6,2212.429,141.4286
"17705","54070","2020",1,0,1,130000,861,151
"17706","54071","2020",2,2,0,147000,1564.5,95
"17707","54073","2020",8,8,0,140881.2,1407.75,97.25
"17708","54074","2020",1,1,0,133000,1255,106
"17709","54075","2020",5,5,0,121200,1091,122.8
"17710","54076","2020",31,24,7,159795.2,1440.839,110.129
"17711","54077","2020",9,9,0,95032.22,898.3333,110.5556
"17712","54079","2020",42,33,9,138699.9,1503.143,94.5
"17713","54080","2020",17,17,0,146187.9,1319.176,112.7647
"17714","54081","2020",9,9,0,140555.6,1264,108.1111
"17715","54083","2020",1,1,0,125500,794,158
"17716","54084","2020",21,21,0,113376.2,1319.048,86
"17717","54086","2020",3,3,0,171800,1631,115
"17718","54088","2020",1,1,0,150000,732,205
"17719","54089","2020",20,15,5,198216,1907.15,108.25
"17720","54090","2020",52,39,13,180860,1842.212,98.90385
"17721","54091","2020",4,4,0,176250,1404.25,137
"17722","54092","2020",3,3,0,81013.33,896,86.33333
"17723","54093","2020",1,1,0,302500,1108,273
"17724","54094","2020",1,1,0,108500,2170,50
"17725","54096","2020",4,4,0,173327.5,1508.5,110.5
"17726","54098","2020",1,1,0,130000,1182,110
"17727","54099","2020",139,80,59,129223.7,1435.518,89.13669
"17728","54100","2020",9,9,0,198341.1,1871.778,108
"17729","54102","2020",7,6,1,185714.3,1256.429,170.4286
"17730","54103","2020",2,2,0,161000,2091,81
"17731","54104","2020",2,2,0,168000,1985.5,96.5
"17732","54105","2020",4,4,0,140405,1253.5,107.25
"17733","54108","2020",5,5,0,228300,1576.6,141.4
"17734","54109","2020",7,6,1,172150,1753.714,96
"17735","54110","2020",3,3,0,170666.7,1633,105.6667
"17736","54111","2020",40,33,7,112205.4,1364.3,79.025
"17737","54112","2020",8,8,0,131750,1148,123.25
"17738","54113","2020",16,14,2,199144.4,1943.062,104.125
"17739","54114","2020",5,4,1,196200,1787.4,113.4
"17740","54115","2020",74,44,30,134866.6,1592.081,83.35135
"17741","54116","2020",26,26,0,180605.9,1796.346,101.4615
"17742","54117","2020",3,3,0,116383.3,677.3333,170.6667
"17743","54118","2020",12,12,0,146583.3,1968.833,84.16667
"17744","54120","2020",1,1,0,97000,1078,90
"17745","54121","2020",1,1,0,104000,1130,92
"17746","54122","2020",8,7,1,165118.8,1531.375,110
"17747","54123","2020",15,13,2,165185.3,1944.333,88.73333
"17748","54125","2020",5,5,0,153080,1453,111.8
"17749","54126","2020",2,2,0,256200,1792,145
"17750","54127","2020",6,6,0,307353.3,2384.167,131
"17751","54128","2020",6,3,3,114883.3,1048.833,113.3333
"17752","54129","2020",17,16,1,89950,933.4706,101.6471
"17753","54130","2020",2,2,0,110750,1139,105
"17754","54131","2020",3,3,0,226252.7,1634,142
"17755","54132","2020",1,1,0,205000,2303,89
"17756","54133","2020",3,3,0,61666.67,573,103.3333
"17757","54134","2020",4,4,0,120137.5,1472,91.25
"17758","54135","2020",13,13,0,173924.4,1682.615,109.3846
"17759","54136","2020",27,25,2,146182.6,1559.556,96.59259
"17760","54137","2020",6,4,2,205600,1386.333,142.8333
"17761","54138","2020",47,33,14,246345.7,2164.957,117.4468
"17762","54139","2020",3,3,0,221866.7,2194.667,101.6667
"17763","54141","2020",1,1,0,159600,2128,75
"17764","54142","2020",1,1,0,80000,500,160
"17765","54143","2020",5,5,0,125105,1037.6,118.6
"17766","54144","2020",3,3,0,138500,1535.333,89.33333
"17767","54145","2020",10,10,0,144095,1484.7,101.8
"17768","54146","2020",4,4,0,147448.8,980.25,149.75
"17769","54148","2020",6,6,0,184666.7,1100.333,184.3333
"17770","54149","2020",27,27,0,172404.1,2023.778,86.2963
"17771","54150","2020",37,28,9,144289.4,1600.73,91.48649
"17772","54151","2020",16,14,2,210756.2,2006,107.375
"17773","54152","2020",36,30,6,155873.3,1672.972,95.02778
"17774","54154","2020",7,7,0,131921.4,1224.143,110.8571
"17775","54155","2020",6,6,0,148916.7,1357.667,115
"17776","54156","2020",8,8,0,125368.8,1104.5,118.125
"17777","54157","2020",62,54,8,150077.7,1541.194,99.5
"17778","54159","2020",160,141,19,147502.5,1590.594,95.5875
"17779","54160","2020",10,10,0,126190,1154.9,114.1
"17780","54161","2020",4,4,0,78525,757,105.5
"17781","54162","2020",18,16,2,98404.17,1015.5,96.11111
"17782","54163","2020",3,3,0,136666.7,965.3333,139
"17783","54165","2020",5,5,0,577200,3792.2,164.2
"17784","54167","2020",22,20,2,167420.5,1613.545,109.0909
"17785","54168","2020",3,3,0,284000,1628,185.6667
"17786","54169","2020",1,1,0,173946,1689,103
"17787","54170","2020",2,2,0,164500,1898.5,87.5
"17788","54171","2020",17,16,1,194264.7,1904.353,103.6471
"17789","54172","2020",4,4,0,269375,1861.25,146.75
"17790","54173","2020",1,1,0,75000,517,145
"17791","54174","2020",41,27,14,151435.7,1479.878,100.878
"17792","54175","2020",10,10,0,151070,1111.5,150.7
"17793","54176","2020",11,11,0,103077.3,1176.727,100.8182
"17794","54177","2020",2,2,0,142425,815.5,159.5
"17795","54178","2020",1,1,0,125000,845,148
"17796","54179","2020",2,2,0,229250,1741.5,134.5
"17797","54180","2020",1,1,0,95000,990,96
"17798","54181","2020",10,10,0,206529.1,2188.5,95.2
"17799","54182","2020",7,4,3,83928.57,941.2857,99.85714
"17800","54183","2020",1,1,0,71990,791,91
"17801","54184","2020",146,52,94,150611.8,1873.062,79.9863
"17802","54185","2020",2,2,0,97000,634,155
"17803","54186","2020",7,7,0,221571.4,1981.857,109.8571
"17804","54187","2020",3,3,0,82750,678.3333,117
"17805","54188","2020",8,7,1,189750,1745.5,109
"17806","54189","2020",9,9,0,120475.6,1020.556,128.2222
"17807","54190","2020",5,5,0,102410,836.8,129.8
"17808","54191","2020",2,2,0,52000,478.5,101
"17809","54192","2020",3,3,0,139166.7,1562,91.33333
"17810","54193","2020",2,2,0,170000,1838.5,92.5
"17811","54194","2020",3,2,1,151166.7,1473,115
"17812","54195","2020",5,5,0,156520,1594.8,96
"17813","54196","2020",13,12,1,217647.7,1657.077,130
"17814","54197","2020",12,11,1,245864.8,2203.917,111.4167
"17815","54198","2020",2,2,0,166170,1465,115
"17816","54199","2020",4,4,0,51750,469.25,114
"17817","54200","2020",3,3,0,140666.7,736,264.3333
"17818","54201","2020",3,3,0,121100,1206.667,103
"17819","54202","2020",5,5,0,351430,2142.2,153.6
"17820","54203","2020",2,2,0,96306.5,643.5,149
"17821","54205","2020",24,22,2,116088,1262.833,95.20833
"17822","54206","2020",4,4,0,117937.5,886,123.75
"17823","54208","2020",6,6,0,138883.3,1765.667,99
"17824","54209","2020",1,1,0,116270,1789,65
"17825","54210","2020",3,3,0,127666.7,1029,132.3333
"17826","54211","2020",3,3,0,75433.33,723.3333,124
"17827","54212","2020",3,3,0,112666.7,1329.333,85
"17828","54213","2020",4,4,0,167900,1081,155.5
"17829","54214","2020",11,11,0,205750.9,1466.091,150.9091
"17830","54215","2020",100,64,36,136464.5,1554.14,89.75
"17831","54216","2020",1,1,0,173850,1087,160
"17832","54217","2020",1,1,0,70000,778,90
"17833","54218","2020",3,3,0,130833.3,1795.333,74.66667
"17834","54220","2020",2,2,0,116850,765,180.5
"17835","54221","2020",4,4,0,132162.5,1272.25,105.5
"17836","54222","2020",15,13,2,125993.3,1311.867,101.3333
"17837","54223","2020",3,3,0,234156.7,1178,208.3333
"17838","54224","2020",3,3,0,103000,1141.667,97.33333
"17839","54225","2020",1,1,0,271950,2176,125
"17840","54226","2020",2,2,0,124000,874.5,142
"17841","54227","2020",20,20,0,119350.8,1354.4,86.6
"17842","54228","2020",1,1,0,39000,534,73
"17843","54229","2020",13,13,0,96020.77,1027.615,106.6154
"17844","54230","2020",1,1,0,32000,582,55
"17845","54231","2020",3,3,0,98116.67,1030,92.66667
"17846","54232","2020",31,29,2,203693.5,1893.71,110.5161
"17847","54234","2020",36,26,10,175653.7,1877.278,91.05556
"17848","54235","2020",4,4,0,152802.5,1454.75,136.5
"17849","54236","2020",6,6,0,96333.33,900.5,105.5
"17850","54237","2020",3,3,0,127333.3,1314.667,96.33333
"17851","54238","2020",1,1,0,40000,1053,38
"17852","54239","2020",1,0,1,105000,1010,104
"17853","54240","2020",2,2,0,124150,1329,93.5
"17854","54241","2020",1,1,0,36000,346,104
"17855","54242","2020",1,1,0,1e+05,1176,85
"17856","54243","2020",2,2,0,76250,1187,66.5
"17857","54246","2020",1,1,0,160000,1231,130
"17858","54247","2020",1,1,0,215960,1393,155
"17859","54249","2020",3,3,0,151166.7,1738.333,90.33333
"17860","54250","2020",13,13,0,199160.2,1533.462,127.9231
"17861","54252","2020",7,5,2,106607.1,916.8571,119.2857
"17862","54253","2020",11,9,2,143472.8,1526.091,94.45455
"17863","54254","2020",39,37,2,174298.1,1826.615,96.17949
"17864","54255","2020",1,1,0,48290,402,120
"17865","54256","2020",4,4,0,202125,1654.5,122.75
"17866","54257","2020",52,47,5,227127.4,2188.558,104.3462
"17867","54259","2020",3,3,0,143533.3,1566.667,95.66667
"17868","54260","2020",6,6,0,152491.7,1628.5,90.83333
"17869","54261","2020",61,39,22,127700.3,1573.754,83.11475
"17870","54262","2020",1,1,0,232500,1029,226
"17871","54263","2020",94,74,20,102063.1,1193.66,84.38298
"17872","54264","2020",1,1,0,82031,603,136
"17873","54265","2020",32,24,8,244032.8,2445.688,103.25
"17874","54266","2020",5,5,0,100200,1162.4,88
"17875","54268","2020",1,1,0,75000,833,90
"17876","54269","2020",5,5,0,182040,1563,123
"17877","54270","2020",55,42,13,175382.9,1987.727,90.09091
"17878","54271","2020",1,1,0,91000,758,120
"17879","54272","2020",5,5,0,194200,1550.8,121.8
"17880","54273","2020",113,100,13,129794.5,1479.044,88.84071
"17881","54274","2020",109,47,62,126426.9,1718.541,72.73394
"17882","54275","2020",5,5,0,122960,1343.2,118.8
"17883","54276","2020",6,6,0,149703.3,1507,103.8333
"17884","54277","2020",8,8,0,124537.5,1155.875,105.25
"17885","54278","2020",2,2,0,162625,1187.5,158
"17886","54279","2020",9,9,0,125067.8,1337.556,91.66667
"17887","54280","2020",116,71,45,76396.22,933.8793,83.53448
"17888","54281","2020",11,10,1,157768.2,1308.182,123.3636
"17889","54282","2020",3,3,0,153000,1253,128.6667
"17890","54283","2020",1,1,0,150000,1579,95
"17891","54284","2020",29,28,1,82824.24,998.4138,82.48276
"17892","54285","2020",1,1,0,114000,1839,62
"17893","54286","2020",28,25,3,142285,1539.464,94.03571
"17894","54288","2020",10,10,0,142310,1619.1,97.3
"17895","54289","2020",4,4,0,236225,1746.25,136.75
"17896","54290","2020",5,5,0,121300,1079.4,120.4
"17897","54291","2020",3,3,0,106466.7,1089.667,101.6667
"17898","54293","2020",1,1,0,110500,1052,105
"17899","54295","2020",21,20,1,125938.1,1153.286,112.4286
"17900","54296","2020",2,2,0,294500,2071,141.5
"17901","54297","2020",4,4,0,98250,939.5,116.25
"17902","54298","2020",1,1,0,93000,930,100
"17903","54299","2020",3,3,0,140400,790.6667,169.6667
"17904","54300","2020",67,49,18,177752.7,1919.179,92.79104
"17905","54301","2020",1,1,0,140500,976,144
"17906","54302","2020",8,8,0,169131.2,1839.5,102.375
"17907","54303","2020",6,6,0,128141.7,1247.333,103.3333
"17908","54304","2020",184,48,136,174604.5,2072.891,81.47283
"17909","54305","2020",27,23,4,213804.1,1942.111,110.4074
"17910","54306","2020",6,6,0,109833.3,824.6667,129.8333
"17911","54309","2020",5,5,0,249802,1783,144.2
"17912","54311","2020",12,11,1,148305.5,1473.417,101.1667
"17913","54312","2020",3,3,0,151366.7,1842,82
"17914","54313","2020",6,6,0,121850,1232.333,99.5
"17915","54314","2020",42,36,6,236465.6,2301,102.4762
"17916","54315","2020",7,6,1,154200,1208.429,138.4286
"17917","54316","2020",1,1,0,282270,1526,185
"17918","54317","2020",1,1,0,155000,1292,120
"17919","54318","2020",95,88,7,174060.4,1606.284,109.0632
"17920","54320","2020",2,1,1,125250,1453,94
"17921","54321","2020",21,12,9,168302.4,1864.667,90.90476
"17922","54322","2020",77,51,26,121203.3,1198.831,97.45455
"17923","54323","2020",191,103,88,148847.4,1632.366,92.30366
"17924","54324","2020",2,2,0,139075,1124,129
"17925","54325","2020",1,1,0,186000,954,195
"17926","54326","2020",4,4,0,187687.5,1629,121
"17927","54327","2020",11,10,1,205354.5,2032.909,109.3636
"17928","54328","2020",56,46,10,234185.1,2318.25,101.6786
"17929","54329","2020",250,124,126,112704.2,1202.928,94.764
"17930","54330","2020",6,5,1,268046.8,1970.5,149.3333
"17931","54331","2020",7,7,0,80928.57,692.8571,113.1429
"17932","54332","2020",20,15,5,203505,1756.65,119.7
"17933","54333","2020",1,1,0,225000,1829,123
"17934","54334","2020",8,8,0,146180,1403.875,107.75
"17935","54335","2020",9,7,2,189455.6,1325.111,135.8889
"17936","54336","2020",13,13,0,208250.8,1801.308,113.2308
"17937","54337","2020",3,3,0,219666.7,2162.333,100.6667
"17938","54338","2020",10,10,0,175240,1857.8,93.9
"17939","54339","2020",148,71,77,164664.8,1853.669,86.84459
"17940","54340","2020",2,2,0,170950,1551.5,108
"17941","54343","2020",2,2,0,129750,821,163
"17942","54344","2020",2,2,0,125200,1427,91.5
"17943","54345","2020",3,3,0,149803.3,1304.667,115.6667
"17944","54346","2020",2,2,0,107500,1002,107
"17945","54348","2020",5,5,0,125050,797.8,157.6
"17946","54349","2020",2,2,0,85000,734,113
"17947","54350","2020",6,6,0,154666.7,1152.833,133.6667
"17948","54351","2020",24,18,6,147678.3,1719.75,87.08333
"17949","54352","2020",16,16,0,130719.4,1472.125,95.1875
"17950","54353","2020",8,8,0,149543.8,1665.125,91.25
"17951","54354","2020",1,1,0,275000,1833,150
"17952","54357","2020",100,49,51,134608.2,1797.04,73.51
"17953","54359","2020",5,4,1,151204.6,1313.8,114.8
"17954","54360","2020",6,6,0,185508.3,1541.833,120.5
"17955","54362","2020",26,22,4,143436.3,1493.192,96.07692
"17956","54363","2020",4,4,0,265815,1345,211.25
"17957","54364","2020",19,17,2,178489.5,1825.105,105.5789
"17958","54365","2020",4,4,0,126575,1386,110
"17959","54366","2020",18,16,2,193118.3,1888.389,105.7778
"17960","54367","2020",32,30,2,197596.1,2002.156,99.53125
"17961","54368","2020",1,1,0,58000,374,155
"17962","54369","2020",5,5,0,149550,1604,92.6
"17963","54370","2020",2,2,0,73500,710,104
"17964","54371","2020",12,12,0,167695,1913.75,85.08333
"17965","54372","2020",8,8,0,177348.8,1774.5,103.875
"17966","54373","2020",9,8,1,147480,1694,100.8889
"17967","54374","2020",1,1,0,247000,2308,107
"17968","54375","2020",17,15,2,148930.6,1796.941,87.70588
"17969","54376","2020",6,6,0,185750,2665,82.33333
"17970","54378","2020",7,7,0,174500,2113.571,92.28571
"17971","54379","2020",5,5,0,141487.8,1239.2,122.8
"17972","54380","2020",7,7,0,167935.7,1332,126.1429
"17973","54381","2020",1,1,0,44800,540,83
"17974","54382","2020",65,56,9,164242.9,1823.6,89.07692
"17975","54383","2020",9,9,0,185422.2,1810.889,101.1111
"17976","54385","2020",16,16,0,174643.1,1655.5,113
"17977","54386","2020",1,1,0,45000,523,86
"17978","54387","2020",3,2,1,107800,1376.333,75
"17979","54388","2020",1,1,0,80000,941,85
"17980","54389","2020",2,2,0,170375,1384,122.5
"17981","54391","2020",22,20,2,94996.14,1272.273,74.36364
"17982","54392","2020",3,3,0,142166.7,1393,105
"17983","54393","2020",6,6,0,78800,950.5,77
"17984","54394","2020",4,4,0,241000,2333.75,118.75
"17985","54395","2020",2038,209,1829,149277.9,2173.914,68.60059
"17986","54396","2020",3,3,0,44666.67,548.3333,79.66667
"17987","54397","2020",96,84,12,156897.2,1755.312,89.69792
"17988","54398","2020",1,1,0,187700,1478,127
"17989","54399","2020",1,1,0,70000,500,140
"17990","54400","2020",13,13,0,179953.8,2024.077,97.38462
"17991","54402","2020",8,8,0,174021.2,1428,130.125
"17992","54403","2020",20,20,0,196425.5,1734.95,112.7
"17993","54405","2020",9,9,0,162777.8,1495.111,112.6667
"17994","54406","2020",2,2,0,85500,717.5,116.5
"17995","54407","2020",2,2,0,129200,1018,132.5
"17996","54408","2020",5,5,0,122424,1253.8,92.2
"17997","54409","2020",1,1,0,208000,1486,140
"17998","54410","2020",3,3,0,130966.7,1436.667,91.66667
"17999","54412","2020",2,2,0,59750,789,91.5
"18000","54414","2020",5,5,0,134500,1277,100.8
"18001","54415","2020",42,29,13,139621.7,1564.357,89.85714
"18002","54416","2020",2,2,0,159850,1299,134.5
"18003","54417","2020",2,2,0,179775,1372.5,129.5
"18004","54418","2020",6,6,0,83998.33,730.8333,127.1667
"18005","54421","2020",5,5,0,83940,593.2,141.8
"18006","54423","2020",3,3,0,128000,841,151
"18007","54425","2020",35,30,5,105874,1163.257,93.48571
"18008","54426","2020",10,7,3,134157,1253.7,114.2
"18009","54427","2020",2,2,0,105000,1223.5,73
"18010","54428","2020",11,9,2,130590.9,1454.273,85
"18011","54429","2020",3,3,0,97003.33,1091.333,81
"18012","54430","2020",53,41,12,136458,1615.585,84.0566
"18013","54431","2020",177,98,79,146343.9,1641.814,92.30508
"18014","54432","2020",32,28,4,120662.5,1438.812,87.78125
"18015","54433","2020",3,3,0,170333.3,1249.333,128.3333
"18016","54434","2020",5,5,0,113540,859.2,124.8
"18017","54435","2020",4,4,0,169423,1468,116.25
"18018","54436","2020",1,1,0,290000,1871,155
"18019","54437","2020",10,10,0,215380,1759.3,124.8
"18020","54438","2020",1,1,0,131000,1092,120
"18021","54439","2020",73,52,21,201461.4,2059.11,95.42466
"18022","54440","2020",3,3,0,123333.3,1008.667,126
"18023","54441","2020",6,6,0,158750,1226.5,133
"18024","54442","2020",4,4,0,125075,1173,116.5
"18025","54443","2020",1,1,0,172850,1728,100
"18026","54444","2020",2,2,0,131285.5,1210,117.5
"18027","54445","2020",1,1,0,190000,1131,168
"18028","54446","2020",1,1,0,57000,518,110
"18029","54447","2020",2,2,0,94500,746.5,120
"18030","54449","2020",20,20,0,188076.6,1735.2,107.25
"18031","54450","2020",1,1,0,45000,489,92
"18032","54451","2020",61,44,17,152656.1,1582.852,94.2623
"18033","54452","2020",1,1,0,155570,737,211
"18034","54453","2020",5,5,0,119420,882.4,126
"18035","54455","2020",1,1,0,197600,890,222
"18036","54456","2020",3,3,0,228500,1504.667,149.6667
"18037","54457","2020",1,1,0,60000,382,157
"18038","54458","2020",3,3,0,118000,977.6667,115.3333
"18039","54459","2020",22,18,4,242677.3,2118.273,112.5455
"18040","54460","2020",2,2,0,193500,1323,159.5
"18041","54461","2020",2,2,0,272500,6490.5,86.5
"18042","54462","2020",28,24,4,174541.1,1649.536,109.1429
"18043","54464","2020",2,2,0,191500,1578.5,121
"18044","54465","2020",8,7,1,160375,1451.125,110.625
"18045","54466","2020",6,6,0,137666.7,1260.167,110
"18046","54467","2020",2,2,0,130075,1073,123
"18047","54469","2020",3,2,1,191840,2106,93.33333
"18048","54470","2020",1,1,0,45000,865,52
"18049","54471","2020",2,2,0,65500,537.5,132
"18050","54472","2020",13,12,1,130436.4,1079.308,119.1538
"18051","54473","2020",2,2,0,177165,1502.5,122.5
"18052","54474","2020",1,1,0,235000,1992,118
"18053","54476","2020",3,3,0,114800,1386.667,91
"18054","54477","2020",2,2,0,189500,1315.5,169.5
"18055","54478","2020",3,2,1,211860,1460.667,145.3333
"18056","54479","2020",1,0,1,60000,513,117
"18057","54480","2020",2,2,0,85500,962.5,86.5
"18058","54481","2020",1,1,0,144450,1521,95
"18059","54482","2020",188,63,125,144559.8,1873.926,77.37766
"18060","54483","2020",107,66,41,146712.2,1628.841,91.29907
"18061","54485","2020",4,4,0,176762.5,1552.5,119.75
"18062","54486","2020",1,1,0,175000,1842,95
"18063","54487","2020",3,3,0,130333.3,953.3333,143.3333
"18064","54488","2020",2,2,0,53500,753,78
"18065","54489","2020",1,1,0,90000,529,170
"18066","54490","2020",18,17,1,180536.6,1934.389,98.77778
"18067","54491","2020",4,4,0,142437.5,1198.25,124.5
"18068","54492","2020",1,1,0,150000,1095,137
"18069","54493","2020",39,31,8,124333.3,1492.077,83.20513
"18070","54494","2020",1,1,0,142000,1246,114
"18071","54495","2020",41,41,0,232907,2198.561,109.5366
"18072","54496","2020",6,5,1,89808.33,805.8333,111.1667
"18073","54498","2020",70,68,2,196725.5,2060.743,96.52857
"18074","54499","2020",2,2,0,198495,1474.5,155
"18075","54500","2020",3,3,0,97333.33,893.6667,108.3333
"18076","54501","2020",3,3,0,65000,523.6667,129.3333
"18077","54502","2020",2,2,0,166635,1377.5,125
"18078","54504","2020",6,6,0,135900,1791.833,74.5
"18079","54505","2020",11,11,0,218984.5,1715.182,132.2727
"18080","54507","2020",1,1,0,137750,1548,89
"18081","54508","2020",1,1,0,198000,1980,100
"18082","54509","2020",11,11,0,142765.7,1661.364,88.54545
"18083","54510","2020",3,3,0,201055,1350.333,147
"18084","54511","2020",1,1,0,175500,975,180
"18085","54513","2020",8,8,0,135738.8,1575.25,92
"18086","54514","2020",3,3,0,174333.3,1675.333,110.6667
"18087","54515","2020",4,4,0,125127.5,1185,100
"18088","54517","2020",3,3,0,220766.7,1708.333,123.3333
"18089","54518","2020",8,8,0,105839.4,1102.875,95.375
"18090","54519","2020",4,4,0,90125,942.75,97
"18091","54520","2020",2,2,0,190300,1184,161
"18092","54521","2020",29,24,5,167147.1,1883,83.41379
"18093","54523","2020",2,2,0,169750,977,183.5
"18094","54524","2020",1,1,0,165000,1719,96
"18095","54525","2020",8,7,1,302577.9,2170.75,138.625
"18096","54526","2020",130,85,45,158698.9,1903.477,82.97692
"18097","54527","2020",7,7,0,218857.1,1770.286,123.5714
"18098","54528","2020",186,103,83,130127.5,1407.747,91.41398
"18099","54533","2020",39,32,7,142564.9,1652.128,87.15385
"18100","54534","2020",5,5,0,139223.8,1082.4,133.2
"18101","54535","2020",2,2,0,158000,1451.5,109
"18102","54536","2020",36,35,1,113457.6,1227.222,90.08333
"18103","54537","2020",4,4,0,283588,2408.25,114.25
"18104","54538","2020",4,4,0,136662.5,1117,114.25
"18105","54539","2020",3,3,0,71000,740.3333,102
"18106","54540","2020",7,7,0,63842.86,647.2857,99.28571
"18107","54541","2020",1,1,0,178600,1751,102
"18108","54542","2020",32,29,3,150144.4,1602.312,93.53125
"18109","54544","2020",1,1,0,215000,1344,160
"18110","54545","2020",5,5,0,116991,893.8,128.8
"18111","54546","2020",12,10,2,175058.3,1596.917,118.0833
"18112","54547","2020",392,107,285,129464.4,1804.832,71.59184
"18113","54548","2020",6,6,0,89583.33,851.3333,109.6667
"18114","54549","2020",48,36,12,135377,1598.812,85.52083
"18115","54550","2020",3,2,1,165666.7,1480.333,107.6667
"18116","54552","2020",1,1,0,70500,742,95
"18117","54553","2020",1,1,0,148000,2691,55
"18118","54554","2020",2,2,0,256625,2113.5,120.5
"18119","54555","2020",2,2,0,98875,833,114
"18120","54556","2020",2,2,0,87000,746.5,141.5
"18121","54557","2020",31,28,3,260647.8,2070.355,128.129
"18122","54558","2020",2,2,0,136175,2157.5,63.5
"18123","54559","2020",1,1,0,233120,2649,88
"18124","54560","2020",1,1,0,75000,750,100
"18125","54563","2020",15,15,0,152526.7,1374.267,118.3333
"18126","54564","2020",1,1,0,40000,471,85
"18127","54565","2020",1,1,0,163000,1753,93
"18128","54567","2020",3,3,0,150433.3,994.3333,148.6667
"18129","54568","2020",2,2,0,168050,1696,106.5
"18130","54569","2020",2,2,0,260175,1697.5,161
"18131","54570","2020",10,10,0,120985,1100.7,112.7
"18132","54571","2020",9,9,0,234496.3,2046.556,113.7778
"18133","54572","2020",10,9,1,150290,1833.9,87.7
"18134","54573","2020",7,7,0,157171.4,1083.143,151.1429
"18135","54574","2020",5,5,0,270618,1860.2,143
"18136","54575","2020",19,14,5,209115.3,1648.947,129.0526
"18137","54577","2020",4,3,1,188875,1527.5,132.25
"18138","54578","2020",213,82,131,163830.6,2088.859,78.53052
"18139","54579","2020",1,1,0,60500,605,100
"18140","54580","2020",194,134,60,159099.1,2040.526,78.27835
"18141","54582","2020",4,4,0,131825,1283.25,104
"18142","54583","2020",5,5,0,218690,1743.8,121.6
"18143","54584","2020",10,9,1,270535.5,1842,150.6
"18144","54585","2020",9,9,0,126972.2,1244.667,92.66667
"18145","54586","2020",8,7,1,121100,1186.125,102.125
"18146","54587","2020",3,3,0,146380.7,1317.667,122.3333
"18147","54588","2020",3,3,0,160183.3,1494.667,107.3333
"18148","54589","2020",3,3,0,150000,1114,187.3333
"18149","54590","2020",7,7,0,185671.4,1563.143,115
"18150","54591","2020",4,4,0,190550,2222.25,85.25
"18151","54593","2020",9,9,0,152272.2,1668,104.7778
"18152","54594","2020",1,1,0,71600,559,128
"18153","54595","2020",6,6,0,141258.3,1445.333,99.66667
"18154","54596","2020",15,13,2,196477.2,1832.267,109.8
"18155","54597","2020",12,12,0,84790.83,1236.25,82.58333
"18156","54598","2020",5,5,0,139200,1014.6,145.8
"18157","54600","2020",1,1,0,154990,1000,155
"18158","54602","2020",1,1,0,96500,1060,91
"18159","55001","2020",3,3,0,78133.33,943.3333,83.33333
"18160","55002","2020",1,1,0,70000,619,113
"18161","55007","2020",3,3,0,149600,1282.667,116
"18162","55008","2020",1,1,0,120000,1062,113
"18163","55009","2020",10,10,0,120230,1005.7,112.4
"18164","55010","2020",30,29,1,128068.3,1365.567,98.5
"18165","55011","2020",2,2,0,140250,2855.5,52
"18166","55012","2020",7,7,0,118785.7,942.7143,116.8571
"18167","55013","2020",4,4,0,156750,1173,136
"18168","55014","2020",8,8,0,78225,707.25,109
"18169","55015","2020",4,4,0,85125,937.25,91.5
"18170","55017","2020",2,2,0,76900,641,121
"18171","55021","2020",2,2,0,90100,662.5,125
"18172","55022","2020",3,3,0,86500,612,144.3333
"18173","55023","2020",1,1,0,96000,1371,70
"18174","55024","2020",1,1,0,140000,1321,106
"18175","55025","2020",1,1,0,66000,660,100
"18176","55027","2020",1,1,0,156750,750,209
"18177","55028","2020",3,3,0,97000,801.3333,127.3333
"18178","55029","2020",182,102,80,104924.6,1118.055,93.31868
"18179","55034","2020",1,1,0,167000,1722,97
"18180","55035","2020",2,2,0,184300,1218,150
"18181","55037","2020",2,2,0,92500,685,162.5
"18182","55038","2020",2,2,0,44000,660,72.5
"18183","55040","2020",3,3,0,65333.33,786.3333,85
"18184","55041","2020",11,11,0,148890.9,1297.818,116.0909
"18185","55042","2020",4,4,0,132375,1035.5,129.25
"18186","55043","2020",46,29,17,114157.6,1245.152,93.95652
"18187","55044","2020",1,1,0,143000,1192,120
"18188","55045","2020",4,4,0,118212.8,1218.75,94.5
"18189","55046","2020",2,2,0,111625,933.5,117.5
"18190","55049","2020",1,1,0,99800,1468,68
"18191","55051","2020",3,3,0,64666.67,512.3333,119.3333
"18192","55053","2020",5,5,0,64040,787,84.6
"18193","55054","2020",2,2,0,68425,457.5,147.5
"18194","55055","2020",1,1,0,75000,833,90
"18195","55058","2020",2,2,0,96500,848,108.5
"18196","55059","2020",3,3,0,99000,711.6667,114.6667
"18197","55060","2020",5,5,0,139260,969.2,141.8
"18198","55061","2020",3,3,0,71833.33,715.6667,102.6667
"18199","55062","2020",1,1,0,73500,514,143
"18200","55063","2020",55,51,4,91454.13,950.4,92.12727
"18201","55064","2020",2,2,0,43100,554,82.5
"18202","55065","2020",2,2,0,78441,750.5,108.5
"18203","55066","2020",2,2,0,58500,678,87.5
"18204","55067","2020",3,3,0,162445.7,966.6667,163.6667
"18205","55068","2020",2,2,0,130900,781,141.5
"18206","55069","2020",2,2,0,97000,958.5,100
"18207","55071","2020",6,6,0,68333.33,715.3333,93.5
"18208","55072","2020",2,2,0,198250,1742,167.5
"18209","55073","2020",6,6,0,164853.3,1447.667,123.1667
"18210","55075","2020",3,3,0,88666.67,845.6667,103.3333
"18211","55076","2020",2,2,0,70500,1090,67.5
"18212","55078","2020",2,2,0,106000,697.5,162
"18213","55079","2020",11,11,0,176045.5,1520.182,113.1818
"18214","55080","2020",1,1,0,35000,438,80
"18215","55081","2020",1,1,0,40000,400,100
"18216","55082","2020",1,1,0,83000,847,98
"18217","55083","2020",4,4,0,135500,908.5,144.75
"18218","55084","2020",2,2,0,74750,469.5,163.5
"18219","55085","2020",2,2,0,82500,720.5,111.5
"18220","55093","2020",4,4,0,141625,1386.25,108.5
"18221","55094","2020",6,6,0,149137.5,1359.667,115.8333
"18222","55095","2020",1,1,0,50000,625,80
"18223","55096","2020",1,1,0,20500,331,62
"18224","55097","2020",5,5,0,105400,1129.2,96
"18225","55099","2020",3,3,0,71833.33,719.3333,101.3333
"18226","55100","2020",1,1,0,189000,1118,169
"18227","55101","2020",2,2,0,168000,1307,130.5
"18228","55102","2020",6,6,0,200500,1835.667,106
"18229","55105","2020",3,3,0,107666.7,1161.333,81.66667
"18230","55106","2020",1,1,0,294567,4909,60
"18231","55108","2020",2,2,0,26000,397.5,65.5
"18232","55109","2020",5,5,0,59800,711.2,80.8
"18233","55110","2020",4,4,0,137000,1120,131.25
"18234","55111","2020",7,7,0,149071.4,1144,138.8571
"18235","55113","2020",1,1,0,58700,452,130
"18236","55114","2020",3,3,0,83680,1148.333,77
"18237","55117","2020",12,12,0,100821.2,843,124.6667
"18238","55118","2020",3,3,0,91333.33,820.3333,111.3333
"18239","55120","2020",9,9,0,163000.6,1437.333,119.7778
"18240","55121","2020",2,2,0,163625,1592.5,96.5
"18241","55122","2020",48,35,13,97683.33,974.7917,97.72917
"18242","55123","2020",6,6,0,80416.67,1374,76.83333
"18243","55124","2020",2,2,0,125000,962,121.5
"18244","55125","2020",9,9,0,131166.7,1246.222,117.4444
"18245","55132","2020",38,32,6,110473.4,974.5,118.7368
"18246","55133","2020",1,1,0,38000,373,102
"18247","55134","2020",1,1,0,70000,631,111
"18248","55137","2020",1,1,0,63000,525,120
"18249","55138","2020",2,2,0,123000,2577.5,53.5
"18250","55142","2020",1,1,0,90000,692,130
"18251","55144","2020",5,5,0,74664,811.8,91
"18252","55145","2020",3,3,0,128110,839.6667,145
"18253","55146","2020",2,2,0,49250,615.5,102
"18254","55148","2020",1,1,0,94502,1050,90
"18255","55149","2020",3,3,0,120733.3,1023.333,128.6667
"18256","55150","2020",8,8,0,51500,507.625,103.625
"18257","55153","2020",4,4,0,139000,1250,113.75
"18258","55154","2020",13,13,0,133384.6,1258,110.8462
"18259","55155","2020",6,6,0,98305.5,874.8333,113.1667
"18260","55156","2020",7,7,0,135382.6,1203,114.2857
"18261","55157","2020",1,1,0,25000,403,62
"18262","55158","2020",4,4,0,163612.5,1472.25,127.5
"18263","55159","2020",1,1,0,160000,632,253
"18264","55160","2020",1,1,0,146100,931,157
"18265","55163","2020",1,1,0,55000,377,146
"18266","55165","2020",3,3,0,85000,879.6667,91
"18267","55166","2020",16,16,0,127887.5,1440.875,92.4375
"18268","55167","2020",3,3,0,63333.33,634.6667,104.6667
"18269","55169","2020",6,5,1,167283.3,1697.333,95
"18270","55170","2020",3,3,0,54500,581.6667,93.66667
"18271","55171","2020",6,6,0,110100,1090.5,105
"18272","55172","2020",2,2,0,85000,1003,88
"18273","55174","2020",1,1,0,120000,571,210
"18274","55175","2020",1,1,0,84600,513,165
"18275","55178","2020",2,2,0,120750,913.5,131.5
"18276","55180","2020",4,4,0,118762.5,793,156.25
"18277","55181","2020",41,38,3,122317.8,1180.878,107.5366
"18278","55183","2020",1,1,0,230000,2396,96
"18279","55184","2020",21,21,0,123819,1199.762,103.1429
"18280","55186","2020",19,19,0,129530,1268.842,103.5263
"18281","55188","2020",1,1,0,30000,462,65
"18282","55192","2020",1,1,0,70000,619,113
"18283","55193","2020",3,3,0,68333.33,739,90.66667
"18284","55195","2020",8,8,0,103750,796.625,125.375
"18285","55196","2020",3,3,0,58833.33,763,78
"18286","55198","2020",12,12,0,107833.3,1037.333,105.5833
"18287","55199","2020",2,2,0,70000,690,98
"18288","55200","2020",1,1,0,225000,1324,170
"18289","55202","2020",1,1,0,73300,524,140
"18290","55206","2020",3,3,0,110783.3,747.3333,151.3333
"18291","55211","2020",1,1,0,141000,627,225
"18292","55212","2020",1,1,0,83000,553,150
"18293","55214","2020",4,4,0,87625,766.25,119
"18294","55215","2020",8,8,0,84750,860.25,110.75
"18295","55216","2020",2,2,0,114525,1045.5,107.5
"18296","55217","2020",2,2,0,37000,543,68.5
"18297","55219","2020",1,1,0,216500,1850,117
"18298","55220","2020",1,1,0,49500,430,115
"18299","55221","2020",2,2,0,109300,1027.5,111
"18300","55222","2020",1,1,0,81000,438,185
"18301","55224","2020",4,4,0,160075,1912.25,97
"18302","55225","2020",1,1,0,80000,606,132
"18303","55226","2020",1,1,0,178500,1623,110
"18304","55228","2020",3,3,0,45809,648.3333,69.66667
"18305","55229","2020",9,9,0,121605.6,1128.889,105.6667
"18306","55232","2020",2,2,0,160057,1107,146.5
"18307","55236","2020",7,7,0,111771.4,1099.571,104.2857
"18308","55237","2020",3,3,0,186000,1650.667,117.3333
"18309","55243","2020",1,1,0,78000,1733,45
"18310","55244","2020",1,1,0,50000,714,70
"18311","55247","2020",1,1,0,47500,428,111
"18312","55248","2020",3,3,0,77666.67,824.3333,84
"18313","55250","2020",3,3,0,73666.67,872.6667,91.66667
"18314","55251","2020",1,1,0,50000,847,59
"18315","55252","2020",2,2,0,116000,1157.5,98
"18316","55253","2020",8,8,0,104500,960.625,110
"18317","55255","2020",2,2,0,92000,1144,89
"18318","55258","2020",9,9,0,119877.8,875.3333,144
"18319","55260","2020",2,2,0,45000,491.5,90.5
"18320","55261","2020",2,2,0,125000,1121,109.5
"18321","55262","2020",1,1,0,82000,828,99
"18322","55263","2020",1,1,0,115000,865,133
"18323","55264","2020",6,6,0,102300,994.6667,106.6667
"18324","55265","2020",2,2,0,197150,1312,158.5
"18325","55267","2020",5,5,0,128840,1427.8,96
"18326","55268","2020",3,3,0,92333.33,754,146
"18327","55269","2020",1,1,0,80000,1143,70
"18328","55271","2020",4,4,0,106000,981.75,110
"18329","55272","2020",4,4,0,109750,940.5,111.25
"18330","55274","2020",2,2,0,102500,1061,96.5
"18331","55276","2020",7,7,0,173715.7,1432.571,116.8571
"18332","55279","2020",6,6,0,101833.3,936.6667,106.1667
"18333","55282","2020",2,2,0,125665,1216,129.5
"18334","55284","2020",2,2,0,71250,458,145
"18335","55285","2020",3,3,0,52500,548.3333,94
"18336","55286","2020",3,3,0,160000,1679.333,95.33333
"18337","55288","2020",11,11,0,97990.73,813.9091,129.4545
"18338","55290","2020",1,1,0,160000,865,185
"18339","55291","2020",30,24,6,90623.33,1004.133,90
"18340","55293","2020",1,1,0,128800,859,150
"18341","55295","2020",1,1,0,215000,1838,117
"18342","55296","2020",7,6,1,89828.57,875.8571,99.71429
"18343","55297","2020",1,1,0,103000,1839,56
"18344","55298","2020",2,2,0,183950,1051,175
"18345","55299","2020",1,1,0,75000,610,123
"18346","55300","2020",3,3,0,119316.7,1605,85.66667
"18347","55302","2020",10,10,0,108650,1078.1,104.3
"18348","55303","2020",6,6,0,80837.5,978.5,106.6667
"18349","55306","2020",2,2,0,141000,1194,128.5
"18350","55312","2020",2,2,0,91000,1820,50
"18351","55315","2020",1,1,0,46380,386,120
"18352","55316","2020",3,3,0,120000,690,188
"18353","55317","2020",1,1,0,115000,852,135
"18354","55321","2020",2,2,0,112500,1198.5,93
"18355","55326","2020",1,1,0,104500,692,151
"18356","55327","2020",4,4,0,69000,648,117.75
"18357","55328","2020",1,1,0,97000,1078,90
"18358","55331","2020",1,1,0,62000,827,75
"18359","55332","2020",4,4,0,85050,843.25,100.5
"18360","55334","2020",3,3,0,132566.7,840,163
"18361","55335","2020",2,2,0,65000,851,75
"18362","55338","2020",3,3,0,53000,530.6667,100.3333
"18363","55339","2020",3,3,0,88333.67,720.6667,122
"18364","55340","2020",4,4,0,112100,946.25,120.75
"18365","55341","2020",3,3,0,165166.7,825,201.6667
"18366","55344","2020",1,1,0,40000,348,115
"18367","55345","2020",6,6,0,107364,1054,99.5
"18368","55346","2020",7,7,0,75857.14,793.1429,101.4286
"18369","55347","2020",4,4,0,112975,1147,99.25
"18370","55348","2020",3,3,0,71666.67,681.6667,111
"18371","55349","2020",1,1,0,65000,542,120
"18372","55350","2020",1,1,0,40000,367,109
"18373","55351","2020",18,16,2,126361.3,1134.389,118.6667
"18374","55352","2020",3,3,0,102916.7,1087.333,94.33333
"18375","55353","2020",2,2,0,125500,1386,94
"18376","55358","2020",1,1,0,62000,689,90
"18377","55359","2020",1,1,0,119000,930,128
"18378","55360","2020",1,1,0,20000,526,38
"18379","55362","2020",1,1,0,95000,1118,85
"18380","55363","2020",2,2,0,111772.5,753,144
"18381","55364","2020",3,3,0,105033.3,1129.333,96
"18382","55365","2020",4,4,0,69950,786.25,99.75
"18383","55366","2020",15,14,1,134616.7,1183.333,116.2667
"18384","55368","2020",2,2,0,110000,856,102.5
"18385","55369","2020",9,9,0,118191.1,1239.889,98.22222
"18386","55370","2020",1,1,0,105000,583,180
"18387","55371","2020",2,2,0,71900,829.5,103
"18388","55372","2020",2,2,0,69500,606,112
"18389","55376","2020",1,1,0,136500,1645,83
"18390","55377","2020",1,1,0,130000,1182,110
"18391","55378","2020",2,2,0,81750,696,119.5
"18392","55379","2020",1,1,0,76000,950,80
"18393","55381","2020",1,1,0,50000,338,148
"18394","55382","2020",3,3,0,78500,723,118.3333
"18395","55384","2020",2,2,0,52500,620.5,86
"18396","55385","2020",5,5,0,120100,1081.8,107.4
"18397","55386","2020",4,4,0,125575,1109,110
"18398","55387","2020",2,2,0,105000,1013.5,103
"18399","55388","2020",1,1,0,50000,333,150
"18400","55389","2020",4,4,0,95000,710.75,123.75
"18401","55391","2020",3,3,0,54500,919.3333,60.33333
"18402","55394","2020",1,1,0,145000,5577,26
"18403","55396","2020",5,5,0,89780,573.4,151
"18404","55397","2020",4,4,0,95125,836,125.25
"18405","55398","2020",10,10,0,95030,879.8,105.1
"18406","55401","2020",2,2,0,115575,1099.5,103
"18407","55404","2020",3,3,0,72833.33,573,112.6667
"18408","55405","2020",1,1,0,130000,1413,92
"18409","55408","2020",2,2,0,120000,1062.5,113
"18410","55409","2020",2,2,0,92750,684,145
"18411","55410","2020",2,2,0,125000,1339.5,106.5
"18412","55412","2020",3,3,0,89683.33,1019.667,85.66667
"18413","55414","2020",1,1,0,180000,1200,150
"18414","55416","2020",3,3,0,54066.67,493.6667,101
"18415","55419","2020",1,1,0,240000,1244,193
"18416","55420","2020",1,1,0,38000,507,75
"18417","55421","2020",1,1,0,115000,846,136
"18418","55422","2020",1,1,0,24000,1263,19
"18419","55423","2020",3,3,0,70666.67,1227.667,60
"18420","55424","2020",1,1,0,120000,686,175
"18421","55426","2020",2,2,0,106000,718,131.5
"18422","55427","2020",22,22,0,104718.2,1172.636,89.72727
"18423","55428","2020",3,3,0,42173.33,468,93.33333
"18424","55429","2020",2,2,0,144750,1508,99.5
"18425","55431","2020",1,1,0,180000,1154,156
"18426","55433","2020",3,3,0,101666.7,911.3333,105.3333
"18427","55434","2020",1,1,0,49500,378,131
"18428","55435","2020",4,4,0,79750,791,105
"18429","55437","2020",2,2,0,98700,760,130
"18430","55438","2020",5,5,0,91217.8,712.4,135.4
"18431","55442","2020",3,3,0,144833.3,814.6667,160
"18432","55443","2020",3,3,0,156716.7,1308,130.6667
"18433","55444","2020",3,2,1,103333.3,1018.667,95
"18434","55445","2020",1,1,0,190000,1357,140
"18435","55446","2020",1,1,0,116600,777,150
"18436","55447","2020",3,3,0,102900,1017,96.33333
"18437","55449","2020",2,2,0,92500,1019,103
"18438","55452","2020",2,2,0,171750,949.5,154
"18439","55453","2020",4,4,0,145037.5,1207,134.75
"18440","55454","2020",3,3,0,114833.3,866.3333,131
"18441","55456","2020",3,3,0,143833.3,1838.333,83.66667
"18442","55457","2020",6,4,2,145721.7,1533.167,100.5
"18443","55458","2020",8,8,0,144525,1190.875,115.5
"18444","55459","2020",2,2,0,92500,3282,47.5
"18445","55460","2020",1,1,0,107500,747,144
"18446","55461","2020",6,6,0,107734.2,914.5,117
"18447","55462","2020",8,8,0,94300.62,1060.875,100
"18448","55463","2020",37,35,2,93594.19,956.2703,99.24324
"18449","55464","2020",3,3,0,256633.3,1975,126
"18450","55466","2020",4,4,0,107181.2,786,140.75
"18451","55467","2020",7,7,0,100171.4,868.8571,120.4286
"18452","55470","2020",1,1,0,150000,1364,110
"18453","55471","2020",2,2,0,76500,609,130.5
"18454","55473","2020",5,4,1,137000,1531.4,101.4
"18455","55475","2020",2,2,0,77500,652.5,115.5
"18456","55476","2020",3,2,1,116600,955,111
"18457","55477","2020",11,11,0,128409.1,1105.091,119.3636
"18458","55479","2020",1,1,0,165500,1118,148
"18459","55481","2020",2,2,0,93850,1233,82
"18460","55485","2020",3,3,0,74500,820.3333,94.33333
"18461","55487","2020",2,2,0,57500,585.5,97.5
"18462","55488","2020",2,2,0,110000,1182,92
"18463","55489","2020",2,2,0,74750,679.5,110
"18464","55490","2020",3,3,0,104516.7,797.6667,153
"18465","55492","2020",10,10,0,100630,1004.2,105.8
"18466","55493","2020",2,2,0,75000,980,82
"18467","55494","2020",4,4,0,115087.5,1204.75,97.75
"18468","55495","2020",2,2,0,200500,2027,99
"18469","55496","2020",12,12,0,100720.8,1096.917,101.6667
"18470","55497","2020",9,9,0,126955.6,1151.778,120.3333
"18471","55498","2020",5,5,0,146120,1002.6,145.4
"18472","55500","2020",9,9,0,116444.4,971.5556,126.7778
"18473","55501","2020",6,6,0,150416.7,1521.167,133.5
"18474","55502","2020",17,17,0,87617.65,876.8235,106.0588
"18475","55503","2020",1,1,0,102000,903,113
"18476","55504","2020",10,10,0,87950,1002.3,86.8
"18477","55505","2020",30,23,7,142983.7,1464.967,100.3333
"18478","55507","2020",2,2,0,161775,1613,117.5
"18479","55508","2020",6,6,0,147500,1281.5,125.1667
"18480","55509","2020",3,3,0,86448,1712.667,82.66667
"18481","55510","2020",3,3,0,83333.33,723.3333,120.3333
"18482","55511","2020",1,0,1,53000,662,80
"18483","55512","2020",3,3,0,89333.33,861.3333,112.6667
"18484","55515","2020",3,3,0,91701,1887,62
"18485","55516","2020",4,4,0,58650,805.75,76.25
"18486","55517","2020",6,6,0,100911.7,911.3333,112.1667
"18487","55518","2020",3,3,0,118500,707,193.3333
"18488","55519","2020",12,12,0,134269.2,1290.75,114.75
"18489","55520","2020",4,4,0,145845.2,1320.5,112.75
"18490","55521","2020",3,3,0,162846.7,1050.667,153
"18491","55522","2020",5,5,0,81470,874.6,83.6
"18492","55523","2020",4,4,0,156802.5,1388.75,118.5
"18493","55525","2020",1,1,0,85900,1087,79
"18494","55526","2020",5,5,0,106872.2,971,108
"18495","55527","2020",6,5,1,80216.67,734.5,103
"18496","55528","2020",2,2,0,222500,1182.5,178
"18497","55532","2020",4,4,0,83250,1567,63
"18498","55533","2020",17,17,0,84592.65,816.2941,99.82353
"18499","55537","2020",1,1,0,115000,1292,89
"18500","55540","2020",1,1,0,114000,708,161
"18501","55541","2020",4,4,0,98650,776.75,107.5
"18502","55543","2020",11,11,0,135493.6,1039,128.5455
"18503","55544","2020",1,1,0,78000,867,90
"18504","55545","2020",205,124,81,130655.2,1486.639,91.38537
"18505","55546","2020",2,2,0,109500,1259.5,88
"18506","55547","2020",2,2,0,105000,952.5,112.5
"18507","55549","2020",2,2,0,93750,791,118
"18508","55551","2020",19,19,0,117215.9,1113.526,109
"18509","55552","2020",1,1,0,168000,1615,104
"18510","55553","2020",15,14,1,97766.67,892.2,110.6
"18511","55554","2020",1,1,0,53333,544,98
"18512","55557","2020",2,2,0,106230.5,807,136
"18513","55561","2020",1,1,0,72000,878,82
"18514","55565","2020",1,1,0,80000,1096,73
"18515","55566","2020",1,1,0,172000,2150,80
"18516","55568","2020",5,5,0,112786,1217.6,90.6
"18517","55569","2020",2,2,0,94500,1165.5,104
"18518","55570","2020",1,1,0,25000,758,33
"18519","55571","2020",1,1,0,46000,590,78
"18520","55573","2020",16,16,0,103855.9,1168.75,88.75
"18521","55578","2020",2,2,0,109170,1180,93
"18522","55579","2020",1,1,0,98800,1620,61
"18523","55581","2020",1,1,0,75000,625,120
"18524","55582","2020",1,1,0,75000,708,106
"18525","55583","2020",3,3,0,129333.3,1033.667,146.3333
"18526","55584","2020",3,3,0,89166.67,802.3333,103
"18527","55586","2020",1,1,0,54500,509,107
"18528","56001","2020",42,40,2,152492.5,1437.976,107.6667
"18529","56002","2020",44,40,4,228393.9,2309.114,97.77273
"18530","56003","2020",86,64,22,472742.5,3667.709,120.1395
"18531","56004","2020",36,33,3,176167.9,2211.806,79.94444
"18532","56005","2020",163,78,85,315399.3,4347.988,69.73006
"18533","56006","2020",18,18,0,100110,1154.056,98.16667
"18534","56007","2020",275,115,160,213283.3,2838.535,75.74545
"18535","56008","2020",73,64,9,434241,3743.301,119.1781
"18536","56009","2020",17,17,0,296778.2,3459.882,88.23529
"18537","56010","2020",98,82,16,146782.7,1586.306,96.38776
"18538","56011","2020",36,36,0,122260.1,1434.806,90.88889
"18539","56012","2020",16,15,1,186914.9,1635.25,121
"18540","56013","2020",87,71,16,228314.8,2647.839,91.86207
"18541","56014","2020",22,22,0,125513.6,1240.818,105.2273
"18542","56015","2020",32,32,0,212019.2,1904.406,111.25
"18543","56017","2020",36,36,0,165163.8,1713.5,98.75
"18544","56018","2020",23,20,3,204299.7,2192.609,99.56522
"18545","56019","2020",5,5,0,83620,966.2,91.4
"18546","56020","2020",14,14,0,143427.5,1420.286,95.78571
"18547","56021","2020",23,23,0,188826.1,1830.696,104.3913
"18548","56022","2020",23,23,0,184501.8,1624.565,119.9565
"18549","56023","2020",85,76,9,249426.7,2437.765,104.4824
"18550","56024","2020",21,21,0,125677.4,1352.905,93.90476
"18551","56025","2020",3,3,0,53333.33,729.6667,75.33333
"18552","56026","2020",32,31,1,115316.9,1293.531,90.53125
"18553","56027","2020",14,14,0,107845,1258.357,89
"18554","56028","2020",20,20,0,115192.8,1382.6,78.95
"18555","56029","2020",6,6,0,214166.7,2085,103.3333
"18556","56030","2020",22,21,1,180815.9,2368.136,87.63636
"18557","56031","2020",51,51,0,197224.4,1747.078,115.7647
"18558","56032","2020",16,16,0,124078.8,1372.812,88.125
"18559","56033","2020",58,56,2,104438.4,1163.138,90.24138
"18560","56034","2020",223,94,129,315414.5,4641.57,70.90583
"18561","56035","2020",13,13,0,130157.7,1226.462,101.3846
"18562","56036","2020",79,70,9,202207.9,1898.886,106.0127
"18563","56039","2020",15,15,0,120471.3,1579.267,92.4
"18564","56040","2020",42,40,2,183444,1743.429,107.9048
"18565","56041","2020",42,40,2,110938.1,1389.262,81.64286
"18566","56042","2020",20,20,0,175973.3,1844.6,95.35
"18567","56043","2020",13,13,0,111685.2,1107.462,106.8462
"18568","56044","2020",7,7,0,120247.7,1125,103.7143
"18569","56045","2020",8,8,0,149125,1404.375,98
"18570","56046","2020",41,40,1,354364.8,3031.39,122.8049
"18571","56047","2020",12,12,0,95250,922.0833,102.1667
"18572","56048","2020",14,14,0,109335.7,1414.929,86.78571
"18573","56050","2020",14,14,0,168313.5,1636.357,113.4286
"18574","56051","2020",22,22,0,125111.4,1438.273,89.81818
"18575","56052","2020",90,60,30,250098.7,3776.711,74.48889
"18576","56053","2020",97,89,8,197859.8,1912.103,105.9485
"18577","56054","2020",64,47,17,215906,2930.266,80.6875
"18578","56055","2020",71,47,24,235324,2876.704,88.43662
"18579","56056","2020",4,4,0,115875,691.25,145.75
"18580","56057","2020",62,60,2,113051.8,1178.403,91.72581
"18581","56058","2020",45,45,0,178877.6,1991.578,97.6
"18582","56060","2020",17,17,0,114739.6,1090.235,102.7059
"18583","56061","2020",54,54,0,127554.7,1500.056,96.2963
"18584","56062","2020",19,17,2,181742.4,2525.474,77.36842
"18585","56063","2020",32,29,3,217910.9,2011.312,110.8125
"18586","56065","2020",9,9,0,182300,1617.111,115.3333
"18587","56066","2020",64,64,0,91598.12,993.7969,97.35938
"18588","56067","2020",64,60,4,241003.1,2259.031,111.1094
"18589","56068","2020",7,7,0,131507.1,1067.429,133.8571
"18590","56069","2020",60,57,3,297204.6,3740.55,81.16667
"18591","56070","2020",42,42,0,122924.7,1394.19,92.69048
"18592","56071","2020",11,11,0,98345.45,1160.727,87.18182
"18593","56072","2020",5,5,0,66416,855.2,81.6
"18594","56073","2020",31,31,0,69954.84,842.871,88.41935
"18595","56074","2020",25,25,0,135938.2,1317.96,106
"18596","56075","2020",76,68,8,137872.1,1393.289,100.1974
"18597","56076","2020",26,26,0,118907.7,1117.423,104.1154
"18598","56077","2020",10,10,0,170105,1962.7,93.6
"18599","56078","2020",224,159,65,235893.1,2771.79,89.14286
"18600","56079","2020",24,24,0,108295.8,1125.333,91.20833
"18601","56080","2020",19,19,0,103220.6,993.8947,103.3684
"18602","56081","2020",62,62,0,95869.08,1025.323,96.04839
"18603","56082","2020",10,10,0,105475,1086.4,90.5
"18604","56083","2020",273,163,110,162480.3,1937.121,85.28205
"18605","56084","2020",13,13,0,262261.5,2479.538,107.3846
"18606","56085","2020",1,1,0,380000,6230,61
"18607","56086","2020",2,2,0,208890,3299.5,63
"18608","56087","2020",13,9,4,480976.9,5943.923,76.76923
"18609","56088","2020",9,9,0,355374.8,3927.667,101.3333
"18610","56089","2020",43,43,0,125949.8,1229.605,103.9535
"18611","56090","2020",88,86,2,173781,1703.955,102.2841
"18612","56091","2020",46,44,2,133553.5,1361.109,102.4348
"18613","56092","2020",6,6,0,73666.67,848.1667,86.5
"18614","56093","2020",10,10,0,101137,1004.5,99.3
"18615","56094","2020",79,72,7,242527.2,2123.278,115.557
"18616","56096","2020",8,8,0,207250,2217.875,99
"18617","56097","2020",43,35,8,183622.9,1857.628,101.4419
"18618","56098","2020",346,250,96,169643.4,1954.624,88.93642
"18619","56099","2020",13,13,0,75021.08,894.4615,88.23077
"18620","56100","2020",50,49,1,81244.58,985.78,86.12
"18621","56101","2020",100,91,9,190519,1830.69,104.98
"18622","56102","2020",30,30,0,97924.97,1075.667,92.7
"18623","56103","2020",5,5,0,144299.2,1163.6,115.6
"18624","56104","2020",5,5,0,142000,1794.6,89.4
"18625","56105","2020",26,26,0,86509.12,924.9231,93.57692
"18626","56106","2020",17,15,2,427753.8,4146.235,102
"18627","56107","2020",146,96,50,362994.9,3774.37,100.0205
"18628","56108","2020",10,10,0,200690,1597.2,131.5
"18629","56109","2020",12,12,0,152944.8,1799,84.25
"18630","56110","2020",24,24,0,87693.75,1005.208,86.29167
"18631","56111","2020",38,37,1,134206.9,1395.684,96.47368
"18632","56112","2020",12,12,0,98021.83,1150.667,90.5
"18633","56113","2020",21,21,0,97796.67,1061.238,91.38095
"18634","56114","2020",38,37,1,278484.9,3949.158,72.42105
"18635","56115","2020",20,20,0,249504.7,2054.4,120.7
"18636","56116","2020",43,37,6,382121,4459.651,85.2093
"18637","56117","2020",73,52,21,134316.9,1564.959,87.60274
"18638","56118","2020",76,58,18,191789.3,2479.987,78.51316
"18639","56119","2020",46,46,0,262013.8,2592.261,111.8043
"18640","56120","2020",26,26,0,216016.8,2164.346,105.4231
"18641","56121","2020",1070,328,742,156587.8,2053.565,76.30748
"18642","56122","2020",23,23,0,142031.3,1250.174,115.3043
"18643","56123","2020",19,19,0,128697.8,1320.421,98.42105
"18644","56124","2020",45,37,8,136220.9,1504.956,89.97778
"18645","56125","2020",24,23,1,163043.8,1454.417,115.1667
"18646","56126","2020",39,39,0,170701.1,1739.692,97.69231
"18647","56127","2020",50,49,1,105171.3,1224.82,91.5
"18648","56128","2020",21,21,0,145776.2,1491.714,102.5714
"18649","56129","2020",25,25,0,90530.04,1019.28,93.52
"18650","56130","2020",40,40,0,231389.1,2267.675,104.475
"18651","56131","2020",21,21,0,79890.48,956,94
"18652","56132","2020",27,26,1,275809.9,2378.556,114.9259
"18653","56133","2020",13,13,0,140938.5,1451.692,98.92308
"18654","56134","2020",20,20,0,97768.4,950.5,109.95
"18655","56135","2020",25,24,1,127923.2,1519.68,86.32
"18656","56136","2020",10,10,0,126324,1192.6,107.4
"18657","56137","2020",37,36,1,230156.6,2146.568,111.6216
"18658","56139","2020",1,1,0,157000,1744,90
"18659","56140","2020",52,51,1,136758.1,1409.558,100.0769
"18660","56141","2020",29,29,0,167698.1,1548.207,109.6552
"18661","56143","2020",79,72,7,225098.1,2219.013,104.4684
"18662","56144","2020",49,49,0,119600,1303.306,95.77551
"18663","56145","2020",16,16,0,120874.4,1158,100.625
"18664","56146","2020",25,25,0,134461.4,1161.88,121.04
"18665","56147","2020",64,64,0,169730.4,1711.734,103.8281
"18666","56148","2020",18,18,0,229667.1,2244.222,104.4444
"18667","56149","2020",34,34,0,195241.1,1749.382,117.9412
"18668","56151","2020",49,49,0,155358.2,1469.286,106.551
"18669","56152","2020",70,45,25,259400.9,3395.4,79.34286
"18670","56153","2020",41,39,2,153216.7,1519.61,100.3415
"18671","56154","2020",31,31,0,113521.8,1209.548,91.51613
"18672","56155","2020",107,99,8,223811.6,2868.178,79.92523
"18673","56156","2020",6,6,0,121865.8,1266,91.33333
"18674","56157","2020",33,33,0,173769.5,1626.576,110.9091
"18675","56158","2020",102,62,40,216582.4,2606.882,84.93137
"18676","56159","2020",25,25,0,151043.1,1498,104.4
"18677","56160","2020",28,28,0,102312.5,1177.429,94.03571
"18678","56161","2020",47,39,8,251308.6,2579.064,99.70213
"18679","56162","2020",272,202,70,274604.5,2950.562,96.91912
"18680","56163","2020",27,27,0,91905.37,955.7037,96.22222
"18681","56164","2020",108,78,30,255048.8,2565.602,100.6759
"18682","56165","2020",141,93,48,146205.8,1701.702,86.24823
"18683","56166","2020",68,64,4,183970.8,1702.132,113.3971
"18684","56167","2020",23,20,3,245285.7,2583.304,100.2174
"18685","56168","2020",41,34,7,309833,2920.268,105.5366
"18686","56169","2020",83,72,11,260311.7,2778.373,98.20482
"18687","56170","2020",30,30,0,129822.7,1429.533,99.63333
"18688","56171","2020",29,29,0,159126.9,1434.759,112.2759
"18689","56172","2020",50,50,0,144716,1430.8,100.8
"18690","56173","2020",80,79,1,113276.7,1309.125,88.975
"18691","56174","2020",32,32,0,176539.7,1740.031,107.5625
"18692","56175","2020",39,36,3,229871,2370.692,98.4359
"18693","56176","2020",81,59,22,248246.6,2495.086,98.33333
"18694","56177","2020",114,104,10,202494.5,1999.026,102.4737
"18695","56178","2020",250,150,100,106484.8,1363.368,80.168
"18696","56179","2020",36,35,1,205183.3,2011.417,107.0278
"18697","56180","2020",13,13,0,128887.4,1207.385,106.4615
"18698","56181","2020",64,40,24,221935.3,2880.359,77.09375
"18699","56182","2020",27,27,0,121808.4,1235.704,91.2963
"18700","56184","2020",115,96,19,163924.5,1833.052,94.55652
"18701","56185","2020",115,109,6,219467.9,2128.843,104.4348
"18702","56186","2020",221,86,135,237635.6,4145.421,61.36199
"18703","56188","2020",31,31,0,135472.6,1621.581,89.16129
"18704","56189","2020",10,10,0,84424.1,1180.9,74.8
"18705","56190","2020",21,21,0,99129.52,1037.667,94
"18706","56191","2020",9,9,0,104814.4,955.1111,111.8889
"18707","56193","2020",91,91,0,201950,2250.495,93.62637
"18708","56194","2020",38,37,1,106596.6,1193.553,86.78947
"18709","56195","2020",18,3,15,104355.6,2368.111,44.72222
"18710","56196","2020",14,10,4,124809.6,1595.429,82.21429
"18711","56197","2020",37,36,1,134843.1,1685.459,91.45946
"18712","56198","2020",26,25,1,111824.4,1077.538,111.2308
"18713","56199","2020",12,12,0,77389.17,886.6667,90.66667
"18714","56200","2020",21,21,0,97589.9,1010.619,94.71429
"18715","56201","2020",10,10,0,116400,967.5,115.8
"18716","56202","2020",8,8,0,123254.4,1247.875,103.125
"18717","56203","2020",17,17,0,103547.1,1107.765,93.05882
"18718","56204","2020",6,6,0,124916.7,1211.333,106.5
"18719","56205","2020",19,19,0,415275.5,3653.421,114.7368
"18720","56206","2020",166,130,36,247252,2525.988,100.4819
"18721","56207","2020",18,18,0,120948.3,1244.889,95.22222
"18722","56208","2020",3,3,0,123333.3,1139,100
"18723","56209","2020",3,3,0,68666.67,1023,67
"18724","56210","2020",15,15,0,81520,900.3333,93.73333
"18725","56211","2020",18,18,0,126280.6,1259.722,98.72222
"18726","56212","2020",37,37,0,139083.2,1579.027,94.67568
"18727","56213","2020",9,9,0,139913.2,1120.111,123.4444
"18728","56214","2020",85,73,12,294701.4,3567.353,88.16471
"18729","56215","2020",21,21,0,131591.5,1263.857,109.8095
"18730","56216","2020",7,7,0,74998.57,903.7143,90.28571
"18731","56218","2020",19,19,0,116530,1375.684,85.05263
"18732","56219","2020",19,19,0,196555.3,1978.053,105
"18733","56220","2020",19,19,0,269407.1,2342.368,116.2105
"18734","56221","2020",17,17,0,109500,1225.941,86.70588
"18735","56222","2020",38,33,5,151808.6,1375.053,108.9737
"18736","56223","2020",30,30,0,112872.2,1266.4,91.16667
"18737","56224","2020",6,6,0,151770.8,1549.167,97.66667
"18738","56225","2020",5,5,0,178210,1694.4,105.6
"18739","56226","2020",9,9,0,133126.7,1225.889,113
"18740","56227","2020",8,8,0,74062.5,927.625,80.75
"18741","56228","2020",10,10,0,148300,1493.9,98
"18742","56229","2020",35,34,1,97039.03,1404.771,83.31429
"18743","56230","2020",8,8,0,92098.75,1030.375,90.375
"18744","56231","2020",52,46,6,252658.4,2255.615,116.0962
"18745","56232","2020",9,9,0,94763.33,1121.778,78
"18746","56233","2020",44,29,15,362239.5,3721.795,95.86364
"18747","56234","2020",74,59,15,331575.8,3817.257,88.2027
"18748","56236","2020",20,20,0,106985.8,1189.2,97.45
"18749","56237","2020",21,21,0,146067.6,1487.095,99.04762
"18750","56238","2020",13,13,0,115411.5,1200.385,106
"18751","56239","2020",23,23,0,119891.6,1329.217,95.3913
"18752","56240","2020",280,221,59,274964.4,3323.121,89.80357
"18753","56241","2020",17,14,3,348684.3,3845.059,95.58824
"18754","56242","2020",10,10,0,102800,1139.2,93.8
"18755","56243","2020",174,101,73,251817.7,3197.454,79.24138
"18756","56244","2020",52,52,0,122834.8,1248.135,97.73077
"18757","56245","2020",9,9,0,89214.44,892.1111,102.8889
"18758","56246","2020",22,22,0,144072.7,1448.955,92.59091
"18759","56247","2020",59,59,0,222860.4,2043.051,112.322
"18760","56248","2020",63,62,1,306520.4,2749.111,116.9524
"18761","56249","2020",26,25,1,142082.3,1337.885,107.3462
"18762","56250","2020",13,13,0,146030.8,1425.769,104.5385
"18763","56251","2020",92,86,6,290796.6,2639.478,109.6848
"18764","56252","2020",28,28,0,312730,2787.786,115
"18765","56253","2020",13,13,0,79288.08,1254,63.76923
"18766","56254","2020",28,27,1,157766.1,1672.357,99.21429
"18767","56255","2020",35,28,7,214938.4,2159.486,101.5714
"18768","56256","2020",5,5,0,91610,953,98
"18769","56257","2020",18,18,0,79191.61,801.5,96.22222
"18770","56258","2020",69,42,27,421953.4,4538.304,93.84058
"18771","56259","2020",20,20,0,196669,2079.65,96.85
"18772","56260","2020",1131,318,813,225118.2,3176.521,70.27321
"18773","56261","2020",16,16,0,180487.2,1588.562,111.1875
"18774","56262","2020",47,33,14,279742,3420.511,83.34043
"18775","56263","2020",35,29,6,248618.4,2297.743,108.2286
"18776","56264","2020",4,4,0,93224.75,1009.25,93.75
"18777","58001","2020",2,2,0,41750,622,59.5
"18778","58002","2020",10,10,0,77200,954.5,81.8
"18779","58003","2020",10,10,0,74800,854.2,91.2
"18780","58004","2020",8,8,0,84312.5,1066.625,83.625
"18781","58005","2020",2,2,0,77000,737,107.5
"18782","58006","2020",10,10,0,115024,1091.2,97.8
"18783","58007","2020",3,3,0,58000,709,81
"18784","58008","2020",2,2,0,56000,818,69
"18785","58009","2020",4,4,0,70500,950,81.5
"18786","58010","2020",13,13,0,114007.7,963.2308,117.3077
"18787","58011","2020",6,6,0,66000,816.1667,82.66667
"18788","58012","2020",11,11,0,92272.73,1053.364,88.36364
"18789","58013","2020",3,3,0,80833.33,815.3333,90.33333
"18790","58014","2020",1,1,0,37000,860,43
"18791","58015","2020",6,6,0,70333.33,792.3333,92.5
"18792","58016","2020",5,5,0,96600,725.6,121
"18793","58017","2020",8,8,0,80080,1042.75,81.75
"18794","58019","2020",2,2,0,33500,691.5,57.5
"18795","58020","2020",2,2,0,63500,716,88.5
"18796","58021","2020",1,1,0,20000,385,52
"18797","58023","2020",6,6,0,134720.5,988.1667,136.8333
"18798","58024","2020",2,2,0,86500,817.5,90.5
"18799","58025","2020",2,1,1,43000,641.5,65.5
"18800","58026","2020",2,2,0,93000,874,93.5
"18801","58027","2020",1,1,0,270000,964,280
"18802","58028","2020",1,1,0,44000,564,78
"18803","58029","2020",1,1,0,61000,847,72
"18804","58030","2020",6,6,0,75916.67,954.8333,80.33333
"18805","58031","2020",8,8,0,119381.2,974.5,142.25
"18806","58032","2020",3,3,0,57533.33,775.6667,72.66667
"18807","58033","2020",4,4,0,82500,708,116.5
"18808","58035","2020",7,7,0,122802.1,1081.143,106.7143
"18809","58036","2020",9,9,0,105388.9,995.2222,115.3333
"18810","58037","2020",8,8,0,61550,843.75,73.25
"18811","58038","2020",1,1,0,117000,1045,112
"18812","58039","2020",5,5,0,44000,610.4,73.2
"18813","58041","2020",6,5,1,71500,684,113.1667
"18814","58042","2020",3,3,0,81666.67,1135,102
"18815","58043","2020",1,1,0,73000,1043,70
"18816","58044","2020",12,12,0,57500,844.3333,67.91667
"18817","58045","2020",1,1,0,79900,918,87
"18818","58046","2020",18,16,2,64494.44,823.0556,79.33333
"18819","58047","2020",12,12,0,63767.5,835.1667,82.66667
"18820","58048","2020",2,2,0,56750,875,67
"18821","58049","2020",1,1,0,88000,967,91
"18822","58050","2020",1,1,0,34000,567,60
"18823","58051","2020",10,10,0,136150,1156.4,113.1
"18824","58052","2020",3,3,0,209336.7,1406.333,165.3333
"18825","58053","2020",8,8,0,80250,748.375,97.75
"18826","58054","2020",2,2,0,65000,958.5,78
"18827","58055","2020",12,12,0,85750,861.1667,98.08333
"18828","58056","2020",2,2,0,177687.5,1337.5,119.5
"18829","58057","2020",10,10,0,92450,1052.2,87.4
"18830","58058","2020",11,11,0,70226.36,672.2727,102.5455
"18831","58059","2020",71,58,13,91527.8,1010.451,92.1831
"18832","58060","2020",11,11,0,81200,801.2727,100.9091
"18833","58061","2020",4,4,0,72451.25,979,73.5
"18834","58062","2020",14,14,0,78707.43,1041.643,79.78571
"18835","58063","2020",9,9,0,69100,841.5556,75.44444
"18836","58064","2020",13,13,0,69846.15,794.6154,88.23077
"18837","58065","2020",16,16,0,59218.75,698.125,93.3125
"18838","58066","2020",1,1,0,76000,1206,63
"18839","58067","2020",12,12,0,149787.3,1398.333,108.5833
"18840","58068","2020",7,7,0,115915.7,1404.714,79.28571
"18841","58070","2020",1,1,0,132500,1380,96
"18842","58071","2020",1,1,0,130000,812,160
"18843","58072","2020",2,2,0,122125,1575.5,77.5
"18844","58073","2020",1,1,0,30000,625,48
"18845","58074","2020",2,2,0,233400,1139,222
"18846","58075","2020",3,3,0,87333.33,834.3333,100.6667
"18847","58076","2020",2,2,0,63500,636.5,103.5
"18848","58077","2020",5,5,0,73800,1006.8,80.2
"18849","58078","2020",2,2,0,36750,702,55
"18850","58079","2020",31,25,6,66719.35,739.9032,83.96774
"18851","58080","2020",3,3,0,60446.67,1346,46
"18852","58081","2020",7,7,0,74857.14,895.4286,80.57143
"18853","58082","2020",11,11,0,94581.82,1147.545,84
"18854","58083","2020",16,15,1,101386.9,1023.562,93.6875
"18855","58085","2020",6,5,1,95500,1033.167,104.1667
"18856","58086","2020",164,149,15,102675.9,1126.341,89.86585
"18857","58087","2020",9,9,0,116666.7,1127.111,96.44444
"18858","58088","2020",39,33,6,117089.4,1263.179,90.30769
"18859","58089","2020",2,2,0,81500,685,119
"18860","58090","2020",2,2,0,91500,691.5,136
"18861","58092","2020",7,7,0,71500,1166.286,77.42857
"18862","58093","2020",1,1,0,24500,331,74
"18863","58094","2020",5,5,0,147200,1596,76.8
"18864","58095","2020",60,43,17,96395.1,1092.817,86.36667
"18865","58096","2020",2,2,0,89000,976.5,93.5
"18866","58097","2020",2,2,0,105850,1113.5,95
"18867","58098","2020",4,4,0,96000,1007.75,80.75
"18868","58099","2020",3,3,0,56500,614,84.33333
"18869","58101","2020",2,2,0,47500,649,76
"18870","58102","2020",30,29,1,78664.1,834.7667,94.43333
"18871","58103","2020",4,4,0,85500,862.75,108.5
"18872","58104","2020",16,16,0,129562.5,1285.688,101.125
"18873","58105","2020",3,3,0,1e+05,1118.667,89
"18874","58106","2020",8,8,0,185883.8,1705,95.25
"18875","58107","2020",3,3,0,23333.33,461.3333,55.66667
"18876","58108","2020",2,2,0,88500,1700,60
"18877","58109","2020",14,14,0,87392.86,1035.714,89.92857
"18878","58110","2020",2,2,0,116500,1122,98
"18879","58111","2020",5,5,0,68036.6,1083.8,70
"18880","58112","2020",7,7,0,113714.3,1322.143,87.14286
"18881","58113","2020",2,2,0,35000,493.5,87
"18882","58114","2020",3,3,0,99400,1012.667,90.66667
"18883","58115","2020",4,4,0,89625,952.5,95
"18884","58116","2020",3,3,0,109000,1093.333,92
"18885","58117","2020",34,29,5,89672.44,1130.353,80.94118
"18886","58118","2020",7,6,1,59464.29,762.2857,80.85714
"18887","58120","2020",5,5,0,116350,1205.4,108.6
"18888","58121","2020",28,24,4,99436.43,1246.25,78.64286
"18889","58122","2020",12,12,0,88558.33,954.25,99.58333
"18890","58123","2020",2,2,0,42500,851,44.5
"18891","58124","2020",6,6,0,136166.7,1321.833,107
"18892","58125","2020",1,1,0,99000,1165,85
"18893","58126","2020",12,12,0,157547.4,1367.667,119.3333
"18894","58127","2020",5,5,0,85060,865,105
"18895","58128","2020",5,5,0,84800,707.2,121.2
"18896","58129","2020",5,5,0,95600,1222.6,72
"18897","58130","2020",1,1,0,28000,933,30
"18898","58131","2020",23,22,1,95328.26,1266.261,75.08696
"18899","58132","2020",3,3,0,51666.67,611,87.66667
"18900","58133","2020",2,2,0,64400,964,70.5
"18901","58134","2020",41,34,7,71851.71,912.0976,77.07317
"18902","58135","2020",2,2,0,137750,1939.5,72.5
"18903","58136","2020",1,1,0,115000,657,175
"18904","58137","2020",2,2,0,49500,1078,44.5
"18905","58138","2020",5,5,0,139700,1042.8,125.4
"18906","58139","2020",5,5,0,84800,918.8,84.8
"18907","58140","2020",4,4,0,96750,1410,73.25
"18908","58141","2020",4,4,0,88875,1090,77.5
"18909","58142","2020",5,5,0,86500,643.2,105.4
"18910","58143","2020",1,1,0,120000,1043,115
"18911","58144","2020",8,8,0,99687.5,876.5,108
"18912","58145","2020",25,24,1,101174,1062.32,98.76
"18913","58146","2020",4,4,0,75231.25,800,93.5
"18914","58147","2020",3,3,0,153376.7,1267.333,118.3333
"18915","58148","2020",4,4,0,118500,1332,89.5
"18916","58149","2020",30,29,1,105944.4,1058.6,102.0333
"18917","58151","2020",60,59,1,62813.57,869.1,76.23333
"18918","58152","2020",16,16,0,119593.8,1252.875,93.125
"18919","58153","2020",3,3,0,225666.7,1273.333,170.6667
"18920","58155","2020",9,9,0,137138.9,1033.333,126.7778
"18921","58156","2020",2,2,0,96500,863.5,143
"18922","58157","2020",11,11,0,89337.64,839.2727,114
"18923","58158","2020",4,4,0,148395,1180.75,120
"18924","58159","2020",3,3,0,77666.67,750.6667,98
"18925","58160","2020",57,56,1,145879.8,1398.719,103.0702
"18926","58161","2020",4,4,0,137675,1348.25,84.75
"18927","58162","2020",3,3,0,43000,656.6667,74
"18928","58163","2020",5,5,0,43000,714.6,62.2
"18929","58164","2020",7,7,0,113428.6,1119.857,96.71429
"18930","58165","2020",2,2,0,116375,1408,108.5
"18931","58166","2020",9,9,0,62222.22,774.2222,80.22222
"18932","58168","2020",5,5,0,60818.2,749.4,86.8
"18933","58169","2020",1,1,0,670000,1994,336
"18934","58170","2020",7,6,1,38000,670.1429,55.71429
"18935","58171","2020",4,4,0,52750,725.75,77.5
"18936","58172","2020",4,4,0,124945,1379.5,84.5
"18937","58173","2020",3,3,0,113000,1115.333,107
"18938","58174","2020",1,1,0,89400,745,120
"18939","58175","2020",7,7,0,116328.6,763.2857,125.4286
"18940","58176","2020",8,8,0,123887.5,1073.75,110.75
"18941","58177","2020",6,6,0,138161.7,1585.5,95.66667
"18942","58178","2020",4,4,0,57250,922.5,63.75
"18943","58179","2020",1,1,0,150000,833,180
"18944","58180","2020",15,14,1,111766.7,1496.8,80.6
"18945","58181","2020",3,3,0,52666.67,713,83.66667
"18946","58182","2020",20,20,0,78552.5,828,92.15
"18947","58183","2020",2,2,0,68000,1110.5,61.5
"18948","58184","2020",9,9,0,77900,957,89.88889
"18949","58185","2020",9,9,0,53722.22,657.4444,86
"18950","58187","2020",9,9,0,59111.11,778.8889,76.33333
"18951","58188","2020",2,2,0,71650,814,84.5
"18952","58189","2020",7,7,0,245142.9,1671.857,123.1429
"18953","58190","2020",3,3,0,43250,774,58.33333
"18954","58191","2020",3,3,0,243666.7,2258.667,102.3333
"18955","58192","2020",2,2,0,93000,1031,91
"18956","58193","2020",27,25,2,100518.5,1009.741,105.7778
"18957","58194","2020",507,215,292,84450.32,1107.487,75.0355
"18958","58195","2020",3,3,0,79801,1090.667,68.33333
"18959","58196","2020",6,5,1,85916.67,793.5,115.5
"18960","58197","2020",3,3,0,62333.33,695.6667,92.33333
"18961","58198","2020",5,5,0,82470,1008.6,84.8
"18962","58199","2020",7,7,0,68071.43,565,121.5714
"18963","58200","2020",4,4,0,108000,984.5,94
"18964","58201","2020",5,5,0,63800,692,91.8
"18965","58202","2020",1,1,0,43322,425,102
"18966","58203","2020",4,4,0,115250,1091,110.5
"18967","58204","2020",13,13,0,100153.8,1028.462,105.3077
"18968","58205","2020",12,12,0,86491.25,884.8333,89.16667
"18969","58207","2020",14,13,1,141642.9,1369.071,107.6429
"18970","58208","2020",3,3,0,52833.33,527,99.66667
"18971","58209","2020",4,4,0,81750,1041.75,78.25
"18972","58210","2020",13,13,0,63077.69,897.8462,72.38462
"18973","58211","2020",8,8,0,132375,1058,126.125
"18974","58212","2020",4,4,0,77625,812.5,97.25
"18975","58213","2020",4,4,0,96000,1144.75,79.5
"18976","58214","2020",41,39,2,131807.2,1302.146,100.0488
"18977","58215","2020",33,33,0,90789.03,1085.697,82.57576
"18978","58216","2020",3,3,0,104333.3,1114.333,105.3333
"18979","58217","2020",4,4,0,89425,885.25,100.75
"18980","58218","2020",21,20,1,71254.29,863.9524,91.57143
"18981","58219","2020",5,5,0,115400,1170.6,109.2
"18982","58220","2020",8,8,0,102062.5,962,101.5
"18983","58221","2020",2,2,0,132815,1436.5,85
"18984","58222","2020",2,2,0,114500,1254.5,92
"18985","58223","2020",5,5,0,57500,869.2,66.6
"18986","58224","2020",2,2,0,137500,925.5,140
"18987","58225","2020",3,2,1,55000,459.6667,113.3333
"18988","58226","2020",1,1,0,32000,390,82
"18989","58227","2020",29,28,1,75261.17,952,73.82759
"18990","58228","2020",8,8,0,103625,919.125,112.25
"18991","58229","2020",7,7,0,90914.29,1006.571,92.42857
"18992","58230","2020",1,1,0,87000,906,96
"18993","58231","2020",2,2,0,56250,660,86
"18994","58232","2020",14,14,0,115949.3,1106.857,102.5
"18995","58233","2020",7,7,0,81857.14,914.1429,89
"18996","58234","2020",1,1,0,72500,537,135
"18997","58235","2020",7,7,0,84571.43,917,92.14286
"18998","58236","2020",4,4,0,58500,638,91.75
"18999","58238","2020",21,20,1,124759.5,1347.667,94.19048
"19000","58239","2020",3,3,0,87000,915,99.33333
"19001","58240","2020",3,3,0,102000,1303,103.6667
"19002","58241","2020",6,6,0,80166.67,887.6667,87.16667
"19003","58242","2020",1,1,0,20000,833,24
"19004","58243","2020",1,1,0,1e+05,2381,42
"19005","58244","2020",3,3,0,101333.3,1380.333,72
"19006","58246","2020",14,14,0,62571.43,813.2857,77.42857
"19007","58247","2020",5,5,0,132000,1334.8,95.2
"19008","58248","2020",1,1,0,152000,1267,120
"19009","58249","2020",4,4,0,48500,895.5,53.25
"19010","58250","2020",22,22,0,89772.73,1063.773,85.54545
"19011","58251","2020",8,8,0,115750,1069.625,106.875
"19012","58252","2020",3,3,0,106333.3,831.3333,128
"19013","58253","2020",2,2,0,92250,992,93
"19014","58254","2020",6,6,0,160311.2,1118.5,144
"19015","58255","2020",6,6,0,238000,1934.333,102.8333
"19016","58256","2020",7,7,0,82428.57,905.7143,94
"19017","58257","2020",4,4,0,92250,704.5,115.75
"19018","58258","2020",4,4,0,123750,1287.5,95.25
"19019","58260","2020",19,19,0,114220.3,1121.158,103.5263
"19020","58261","2020",17,17,0,115647.1,1172.118,99.70588
"19021","58263","2020",4,4,0,61500,514.75,121.25
"19022","58264","2020",28,27,1,87040.04,1057.821,88.67857
"19023","58265","2020",7,7,0,116142.9,1265,91.28571
"19024","58266","2020",2,2,0,57500,600,95
"19025","58267","2020",11,11,0,65222.73,702.1818,99
"19026","58268","2020",2,2,0,43750,892.5,49.5
"19027","58269","2020",5,5,0,92500,1136.2,87
"19028","58270","2020",10,10,0,73500,917.2,81.2
"19029","58271","2020",1,1,0,175000,962,182
"19030","58272","2020",3,3,0,50000,658.6667,78.66667
"19031","58273","2020",11,11,0,124272.7,1178.182,109.6364
"19032","58274","2020",3,3,0,99333.33,1016.333,83.33333
"19033","58275","2020",5,5,0,69976,932,79
"19034","58276","2020",8,8,0,50000,813.125,62.75
"19035","58277","2020",4,4,0,160846.2,1388.75,114
"19036","58278","2020",11,9,2,106609.1,1285.818,88.27273
"19037","58279","2020",3,3,0,97100,1165.333,101.3333
"19038","58280","2020",5,5,0,139700,1134.2,112.8
"19039","58281","2020",18,18,0,84661.11,1070.778,81.88889
"19040","58282","2020",6,6,0,73916.67,898,84
"19041","58283","2020",4,4,0,81250,865.25,101.5
"19042","58284","2020",1,1,0,60000,882,68
"19043","58285","2020",2,2,0,53500,742,71
"19044","58286","2020",9,9,0,90627.78,858.7778,114.5556
"19045","58287","2020",7,7,0,104142.9,1083.714,91.28571
"19046","58288","2020",1,1,0,28700,957,30
"19047","58289","2020",5,5,0,71800,849.8,91.6
"19048","58290","2020",1,1,0,80000,4000,20
"19049","58291","2020",1,1,0,60000,1667,36
"19050","58292","2020",4,4,0,91848.75,1154.5,80
"19051","58293","2020",2,2,0,81750,1303,60.5
"19052","58294","2020",1,1,0,50000,694,72
"19053","58295","2020",19,19,0,110905.4,1298.684,101.8421
"19054","58296","2020",6,6,0,163500,3207.5,81.66667
"19055","58297","2020",6,6,0,68666.67,739.1667,86
"19056","58299","2020",4,4,0,94297.5,1209.75,96.5
"19057","58300","2020",14,14,0,138667.5,1318.143,105.4286
"19058","58301","2020",12,12,0,64000,845.5,78.5
"19059","58302","2020",12,12,0,107879.2,1052,104
"19060","58303","2020",86,72,14,110794.1,1487.988,78.15116
"19061","58304","2020",16,15,1,59156.25,870,74.125
"19062","58305","2020",4,4,0,71000,607.5,119
"19063","58306","2020",5,5,0,209700,1482.8,132.6
"19064","58308","2020",2,2,0,44500,1961.5,38
"19065","58309","2020",19,19,0,82665.53,897.4211,90.21053
"19066","58310","2020",2,2,0,51500,541,112.5
"19067","58311","2020",5,5,0,113691,1019,103.8
"19068","58312","2020",5,5,0,61200,624.6,97.6
"19069","58313","2020",3,3,0,155016.7,1292.333,119
"19070","59001","2020",9,9,0,121237.8,1227.556,97.55556
"19071","59002","2020",53,52,1,115643.8,1205.377,100.5283
"19072","59003","2020",1,1,0,214850,1546,139
"19073","59004","2020",18,18,0,290347.8,2065.889,141.8889
"19074","59005","2020",57,51,6,181330.8,2002.474,91.42105
"19075","59006","2020",3,3,0,138800,1361.333,100
"19076","59007","2020",12,12,0,141416.7,1276.667,110.8333
"19077","59008","2020",93,90,3,110135.2,1157.71,97.70968
"19078","59009","2020",701,385,316,233614.6,3178.361,78.40942
"19079","59010","2020",2,2,0,146900,1627.5,92
"19080","59011","2020",155,148,7,201800.6,2131.813,95.96129
"19081","59012","2020",30,30,0,115481.7,1158.233,98.2
"19082","59013","2020",15,14,1,330547,2955.667,114.9333
"19083","59014","2020",161,129,32,94231.24,1216.466,81.60248
"19084","59015","2020",38,38,0,141073.9,1569.184,93.65789
"19085","59016","2020",19,19,0,165962.4,1693.105,99.31579
"19086","59017","2020",480,361,119,138496.8,1833.729,78.20417
"19087","59018","2020",18,18,0,184930,1690.278,110.2222
"19088","59019","2020",8,8,0,153468.8,1963.75,85.625
"19089","59021","2020",18,18,0,129452.3,1491.444,87.55556
"19090","59022","2020",30,30,0,248725,2427.733,102.9
"19091","59023","2020",5,5,0,113600,951.8,115
"19092","59024","2020",49,49,0,132779.2,1375.224,94.79592
"19093","59025","2020",18,18,0,313802.8,2870.167,121.9444
"19094","59026","2020",10,10,0,136346.7,1388.9,94
"19095","59027","2020",18,18,0,169844.4,1683.944,99.55556
"19096","59028","2020",61,61,0,116755.3,1309.475,90.11475
"19097","59029","2020",16,16,0,279559.7,2420.688,117.75
"19098","59031","2020",5,5,0,202412,1572.4,134
"19099","59032","2020",77,67,10,135042.3,1674.61,87.57143
"19100","59033","2020",91,90,1,110516.4,1225.692,92.27473
"19101","59034","2020",34,26,8,309032.4,2807.588,112.7647
"19102","59035","2020",21,21,0,123792.9,1207.286,106.2857
"19103","59036","2020",31,30,1,99314.52,925.0968,110.7419
"19104","59037","2020",44,44,0,81896.59,991,86.47727
"19105","59038","2020",18,18,0,152850,1424.944,104.2222
"19106","59039","2020",7,7,0,213050,1898.429,112.4286
"19107","59041","2020",24,24,0,108883.3,1209.542,87.75
"19108","59042","2020",14,14,0,289996.4,2510.357,117.7857
"19109","59043","2020",203,144,59,180606.6,2182.034,85.07882
"19110","59044","2020",76,74,2,269428.8,2692.737,103.1053
"19111","59046","2020",15,15,0,172013.3,1506.2,115.2667
"19112","59047","2020",5,5,0,165047,1396.6,115
"19113","59048","2020",6,6,0,150833.3,1399.333,107.6667
"19114","59049","2020",3,3,0,93200,1015,94.33333
"19115","59050","2020",5,5,0,165155,1257.2,141.4
"19116","59051","2020",100,89,11,142448.2,1696.18,87.1
"19117","59052","2020",55,54,1,158598.8,1682.855,99.70909
"19118","59053","2020",41,40,1,122602,1346.22,89.82927
"19119","59054","2020",11,11,0,123681.8,1385.182,86.45455
"19120","59055","2020",8,8,0,82187.5,946,86.5
"19121","59056","2020",5,5,0,282940,2274.8,123.6
"19122","59057","2020",12,12,0,142526.2,1165.833,125.9167
"19123","59058","2020",14,14,0,145212.7,1336.5,111.8571
"19124","59059","2020",6,6,0,58916.67,641.3333,88.66667
"19125","59060","2020",4,4,0,178750,1337.75,131.5
"19126","59061","2020",4,4,0,186250,1585.5,131.5
"19127","59062","2020",5,5,0,104395.6,1263.2,104.4
"19128","59063","2020",28,28,0,99987.5,1008.786,101.4286
"19129","59064","2020",14,14,0,207478.6,1723.786,119.5714
"19130","59065","2020",8,8,0,118293.8,946.25,137.125
"19131","59066","2020",1,1,0,36000,600,60
"19132","59067","2020",40,34,6,176582.1,1855.125,98.75
"19133","59068","2020",33,32,1,129577.9,1441.939,94.69697
"19134","59069","2020",12,12,0,157608.3,1408.083,115.75
"19135","59070","2020",9,9,0,162216.7,1336.111,116.7778
"19136","59071","2020",20,20,0,339443.5,2619.75,138.8
"19137","59072","2020",3,3,0,138333.3,1821,77.33333
"19138","59073","2020",5,5,0,229250,2764.8,83.6
"19139","59074","2020",34,34,0,112138.2,1006.382,112.3529
"19140","59075","2020",10,10,0,145608.5,1235.2,121.1
"19141","59076","2020",4,4,0,89500,1049.75,76.75
"19142","59077","2020",4,4,0,219825,1946.75,115.25
"19143","59078","2020",7,7,0,209644.4,1466.143,138.4286
"19144","59079","2020",50,45,5,116039.5,1391.3,85.2
"19145","59080","2020",39,39,0,238813.1,2225,112.3077
"19146","59081","2020",1,1,0,34000,378,90
"19147","59082","2020",16,16,0,264696.9,1881.312,142.9375
"19148","59083","2020",3,3,0,220666.7,1684.667,128.6667
"19149","59084","2020",26,26,0,197374.3,1785.346,118
"19150","59085","2020",2,2,0,226445,1402.5,140.5
"19151","59086","2020",28,27,1,198418.8,2251.714,91
"19152","59087","2020",6,6,0,169766.7,1421.833,122.6667
"19153","59088","2020",44,43,1,310578.2,2432.682,129.9545
"19154","59089","2020",21,21,0,164526.2,1473.667,112.2857
"19155","59090","2020",120,112,8,452172.8,3728.483,119.5667
"19156","59091","2020",2,2,0,180850,1697,106.5
"19157","59092","2020",49,48,1,133599.4,1472.571,90.10204
"19158","59093","2020",1,1,0,124500,1209,103
"19159","59094","2020",56,53,3,139917.4,1461.911,95.03571
"19160","59096","2020",25,25,0,333792,2554.56,131
"19161","59097","2020",3,3,0,114733.3,931.6667,113.6667
"19162","59098","2020",65,55,10,268781.9,2467.785,111.3538
"19163","59099","2020",31,31,0,129093.8,1182.548,108.1935
"19164","59100","2020",1,1,0,258000,2367,109
"19165","59101","2020",5,5,0,130400,2484.2,55.8
"19166","59102","2020",3,3,0,127833.3,1433.667,85.66667
"19167","59103","2020",1,1,0,225780,2377,95
"19168","59104","2020",45,45,0,102752.5,1119.333,94.93333
"19169","59105","2020",17,17,0,229965.2,2090.059,111
"19170","59106","2020",15,14,1,233206.7,2723.333,84.66667
"19171","59107","2020",153,73,80,152312.5,2523.105,66.76471
"19172","59108","2020",9,9,0,113522.8,906,121.3333
"19173","59109","2020",11,11,0,284300,2068.364,137.5455
"19174","59110","2020",11,11,0,233163.6,1965.909,121.9091
"19175","59111","2020",5,5,0,208600,1893.4,108.4
"19176","59112","2020",110,109,1,114773.2,1285.518,93.98182
"19177","59113","2020",10,10,0,145660,1369.1,112.3
"19178","59114","2020",17,17,0,192123,1956.412,107.5882
"19179","59115","2020",7,6,1,157253.6,1288.286,116.1429
"19180","59116","2020",6,6,0,180791.7,1585.167,108.6667
"19181","59117","2020",11,11,0,173384.5,1592.636,113.4545
"19182","59118","2020",30,30,0,94739.17,911.1,102.8333
"19183","59119","2020",6,6,0,174683.3,1796.333,101.5
"19184","59120","2020",32,32,0,221017.6,1769.344,123.4375
"19185","59121","2020",9,9,0,174266.7,1324.333,127.6667
"19186","59122","2020",438,304,134,113603.4,1414.459,83.97717
"19187","59123","2020",24,23,1,240826.9,2232.625,111.2083
"19188","59124","2020",26,26,0,318180.8,2659.615,122.8462
"19189","59125","2020",8,8,0,169862.5,1469.875,127.25
"19190","59126","2020",16,16,0,151307.5,1395.375,108.875
"19191","59128","2020",46,19,27,266142.6,3225.978,83.69565
"19192","59129","2020",21,21,0,296498.8,2607.524,116
"19193","59130","2020",17,17,0,186061.9,1531.941,126.0588
"19194","59131","2020",80,80,0,151356.4,1688.037,90.6375
"19195","59132","2020",12,12,0,159625,1256.167,136.9167
"19196","59133","2020",12,11,1,229108.3,2203,105.3333
"19197","59134","2020",17,17,0,130982.7,1430.176,93.94118
"19198","59135","2020",33,32,1,173805.6,1728.939,97.78788
"19199","59136","2020",75,70,5,71146.24,859.6933,85.30667
"19200","59137","2020",8,8,0,104185.2,1266,91
"19201","59138","2020",11,11,0,125318.2,963.6364,127.9091
"19202","59139","2020",201,185,16,84818.97,997.4378,87.0398
"19203","59140","2020",6,6,0,76333.33,845.5,89.33333
"19204","59141","2020",13,13,0,148023.1,1241.769,124.6923
"19205","59142","2020",10,10,0,129400,1353,94.5
"19206","59143","2020",102,97,5,215755.8,2125.873,103.2353
"19207","59144","2020",10,10,0,207200,1841.3,116.8
"19208","59145","2020",6,6,0,221166.7,2133.833,100.5
"19209","59146","2020",40,39,1,334518.2,3056.275,108.275
"19210","59148","2020",3,3,0,153906.7,1393.333,112
"19211","59149","2020",11,11,0,100127.3,1145.818,87.09091
"19212","59150","2020",3,3,0,444033.3,3065.667,154
"19213","59151","2020",15,15,0,126448.9,1422,90.33333
"19214","59152","2020",138,131,7,210981.1,2103.051,102.471
"19215","59153","2020",77,73,4,106784.9,1213.468,89.49351
"19216","59155","2020",268,244,24,142062.4,1653.03,87.93657
"19217","59156","2020",25,21,4,128291,1544.32,86.4
"19218","59157","2020",20,20,0,135736,1366.7,110.7
"19219","59158","2020",43,43,0,252387.7,2365.488,108.7907
"19220","59159","2020",8,7,1,234543.8,2732.625,104.625
"19221","59160","2020",30,30,0,130031.7,1362.167,98.13333
"19222","59161","2020",11,11,0,168505.5,1379.545,119.8182
"19223","59162","2020",8,8,0,195662.5,1625.375,124.625
"19224","59163","2020",371,246,125,213421.6,2436.976,86.06199
"19225","59164","2020",3,3,0,130916.7,1198.333,110
"19226","59165","2020",77,77,0,156189.6,1624.974,98.01299
"19227","59166","2020",18,18,0,183160.3,1670.278,110.6111
"19228","59167","2020",2,2,0,160600,2189.5,73
"19229","59168","2020",85,77,8,287027.6,2721.271,103.1882
"19230","59169","2020",3,3,0,147666.7,1154.333,123.6667
"19231","59170","2020",46,46,0,98443.91,1237.978,85.43478
"19232","59172","2020",193,187,6,75521.97,961.0052,83.21762
"19233","59173","2020",28,26,2,270107.9,2531.857,105.5357
"19234","59174","2020",3,3,0,123333.3,888.3333,141
"19235","59175","2020",1,1,0,3e+05,1613,186
"19236","59176","2020",11,11,0,148900,1430.182,106.7273
"19237","59177","2020",6,6,0,98166.67,955.1667,108.1667
"19238","59178","2020",507,277,230,127959.5,1579.868,84.27022
"19239","59179","2020",94,91,3,118739.6,1268.436,93.35106
"19240","59180","2020",17,17,0,234165.3,2357.824,107.8824
"19241","59181","2020",7,7,0,122512.4,1959,79
"19242","59182","2020",3,3,0,110050,1424,136.6667
"19243","59183","2020",1189,677,512,149861.6,1745.952,87.55593
"19244","59184","2020",4,4,0,151975,1383.75,114.75
"19245","59185","2020",11,11,0,165911.4,1462.909,112.9091
"19246","59186","2020",5,5,0,146220,1036,149
"19247","59187","2020",1,1,0,146000,1327,110
"19248","59188","2020",6,6,0,168466.7,1389,130.3333
"19249","59189","2020",25,25,0,194226,1603.52,126.72
"19250","59190","2020",9,9,0,184540.6,1537.667,123.8889
"19251","59191","2020",6,6,0,100750,1242.5,85.33333
"19252","59192","2020",5,5,0,104418,1078.4,94.8
"19253","59193","2020",41,41,0,268623.5,2458.146,107.2195
"19254","59194","2020",19,17,2,137118.4,1204,118.0526
"19255","59195","2020",7,7,0,315757.1,2914,108.1429
"19256","59196","2020",20,19,1,370367.5,3111,123.4
"19257","59197","2020",31,31,0,291829,2736.032,108
"19258","59198","2020",3,3,0,159333.3,2191.333,90
"19259","59199","2020",8,8,0,170225,1545,108.25
"19260","59200","2020",9,9,0,172884.9,1433.111,118.2222
"19261","59201","2020",8,8,0,313818.8,2382.875,133.375
"19262","59202","2020",84,75,9,190244.6,2095.429,92.5119
"19263","59203","2020",21,21,0,147778.6,1494.476,100.619
"19264","59204","2020",6,6,0,152250,1228.833,124.3333
"19265","59205","2020",76,75,1,108756.2,1258.461,88.21053
"19266","59206","2020",42,41,1,120220.7,1203.548,99.2381
"19267","59207","2020",40,40,0,134859.5,1318.05,101.25
"19268","59208","2020",5,5,0,545980,4106.4,138.8
"19269","59209","2020",9,9,0,188027.2,1435.889,126.3333
"19270","59210","2020",24,23,1,183302.1,1742.208,105.4583
"19271","59211","2020",16,16,0,193724.1,1804.938,115.3125
"19272","59212","2020",76,69,7,165171,1789.013,94.81579
"19273","59213","2020",2,2,0,122000,1102,109.5
"19274","59214","2020",16,16,0,204048.4,1585.562,133.6875
"19275","59215","2020",7,7,0,238535.7,1498.143,153.7143
"19276","59216","2020",2,2,0,92850,1131.5,88
"19277","59217","2020",4,4,0,199715.2,1823.25,109
"19278","59218","2020",20,19,1,93015.65,1049.95,85.7
"19279","59219","2020",11,11,0,175121.6,1471.727,126.2727
"19280","59220","2020",262,206,56,186686.1,2348.905,80.06107
"19281","59221","2020",30,20,10,137530.7,1729.7,78.03333
"19282","59222","2020",37,37,0,273182.4,2411.405,116.2703
"19283","59223","2020",8,8,0,134731.2,1274.875,111.375
"19284","59224","2020",25,25,0,117512.4,1543.12,82.28
"19285","59225","2020",61,61,0,124394.2,1330.984,98.62295
"19286","59226","2020",15,15,0,138525.6,1149.2,118.5333
"19287","59227","2020",49,49,0,139333.6,1533.571,97.32653
"19288","59228","2020",11,11,0,143768.2,1597.182,90.63636
"19289","59229","2020",4,4,0,146550,1146.75,127.75
"19290","59230","2020",59,53,6,122780.2,1721.898,96.98305
"19291","59231","2020",13,13,0,135558.1,1492,91.38462
"19292","59232","2020",2,2,0,167475,1391,120.5
"19293","59233","2020",6,6,0,187333.3,1541.5,131.6667
"19294","59234","2020",64,63,1,140228.6,1533.375,95.04688
"19295","59236","2020",4,4,0,90250,743.25,119.25
"19296","59237","2020",8,8,0,256443.8,2067.875,122.25
"19297","59238","2020",19,19,0,170013.2,1550.474,115.3684
"19298","59239","2020",30,30,0,173973.7,1752.167,103.7667
"19299","59240","2020",2,2,0,208825,1394,156.5
"19300","59241","2020",7,7,0,81980,773.7143,101.4286
"19301","59242","2020",6,6,0,149026.7,1382.333,109.8333
"19302","59243","2020",17,16,1,116337.2,1357.059,91.70588
"19303","59244","2020",19,19,0,118877.4,1239.105,96.73684
"19304","59246","2020",7,7,0,166857.1,1135.571,141.5714
"19305","59247","2020",17,17,0,275941.8,2786.471,98
"19306","59249","2020",137,128,9,80324.2,943.9489,87.42336
"19307","59250","2020",28,25,3,263598.7,2620.357,103.2143
"19308","59251","2020",2,2,0,244500,2039.5,120.5
"19309","59252","2020",33,30,3,286819.1,2708.879,106.1515
"19310","59253","2020",69,68,1,101027.5,1106.913,93.7971
"19311","59254","2020",13,13,0,125891.5,1298.154,94.38462
"19312","59255","2020",3,3,0,112000,1153.333,98.33333
"19313","59256","2020",43,41,2,251981,2701.488,96.13953
"19314","59257","2020",13,13,0,334192.3,2354.231,141.6923
"19315","59258","2020",21,21,0,288554.8,2564.429,119
"19316","59259","2020",7,7,0,173792.9,1655.286,102.5714
"19317","59260","2020",49,49,0,192291.6,1864.184,103.7551
"19318","59261","2020",13,13,0,80076.92,948.5385,80.53846
"19319","59262","2020",27,27,0,208537,1961.037,113.1852
"19320","59263","2020",13,13,0,190071.9,1703.154,112
"19321","59264","2020",7,7,0,187714.3,1706,118.5714
"19322","59265","2020",37,37,0,186176,1504.378,124.6757
"19323","59266","2020",51,51,0,231602.2,2241.804,102.9216
"19324","59267","2020",3,3,0,177350,1388.667,126
"19325","59268","2020",79,69,10,141193.7,1632.177,86.16456
"19326","59269","2020",26,26,0,139496.4,1285.769,113.5385
"19327","59270","2020",4,4,0,134625,1338.75,102.75
"19328","59271","2020",114,96,18,131481.9,1448.675,92.32456
"19329","59272","2020",69,68,1,121333.6,1457.159,83.65217
"19330","59273","2020",132,118,14,152795.8,1628.53,93.97727
"19331","59274","2020",15,15,0,116333.3,1006.6,123.4
"19332","59275","2020",11,11,0,443436.4,3167.273,145.9091
"19333","59276","2020",35,35,0,146135.9,1559.971,94.74286
"19334","59277","2020",5,5,0,116000,1588.2,75
"19335","59278","2020",77,69,8,215490.7,2310.584,95.93506
"19336","59279","2020",286,243,43,184431.2,2015.409,91.46853
"19337","59280","2020",8,8,0,139243.8,1572.625,96.875
"19338","59281","2020",13,13,0,222244.6,2007.154,112.0769
"19339","59282","2020",5,5,0,78200,1178.4,67.8
"19340","59283","2020",6,6,0,170183.3,1560.667,107.3333
"19341","59284","2020",47,45,2,191856.4,1794.681,107.6383
"19342","59285","2020",18,18,0,125148.9,1345.444,90.5
"19343","59286","2020",237,189,48,171197.8,2116.278,81.31646
"19344","59287","2020",1,1,0,174600,1455,120
"19345","59288","2020",25,25,0,127407.5,1351.6,95.48
"19346","59289","2020",20,20,0,104326,1052.15,99.9
"19347","59290","2020",2,2,0,129000,2001.5,68
"19348","59291","2020",123,119,4,92360.24,1010.325,89.99187
"19349","59292","2020",19,18,1,127951.6,1353.368,95.10526
"19350","59293","2020",16,16,0,157050.6,1476.062,107
"19351","59294","2020",2,2,0,110000,1163,96
"19352","59295","2020",264,226,38,157867,1804.11,88.43561
"19353","59296","2020",7,7,0,153714.3,1388,112.5714
"19354","59297","2020",19,19,0,140047.9,1435.842,100.2105
"19355","59299","2020",214,203,11,255875.9,2463.533,101.4626
"19356","59300","2020",5,5,0,90740,1025,86.8
"19357","59301","2020",44,44,0,173456,1763.864,108.5682
"19358","59302","2020",32,30,2,131995.2,1559.781,91.1875
"19359","59303","2020",21,21,0,276110.9,2366.952,113.6667
"19360","59304","2020",2,2,0,327500,2218.5,146.5
"19361","59305","2020",8,8,0,170863.8,1749.5,99.375
"19362","59306","2020",2,2,0,108000,1116.5,93.5
"19363","59307","2020",11,11,0,105065.6,1258.636,85.54545
"19364","59308","2020",7,7,0,206100,1573.857,132.4286
"19365","59309","2020",38,38,0,170340.1,1620.079,106.4474
"19366","59310","2020",12,12,0,170021.3,1547.667,108.4167
"19367","59311","2020",9,9,0,93500,974.8889,100
"19368","59312","2020",12,12,0,102762.5,1288.583,81.5
"19369","59313","2020",15,15,0,132788.7,1460.6,92.46667
"19370","59314","2020",27,27,0,170818.7,1741.074,100.3333
"19371","59315","2020",10,10,0,161417,1347.2,119.4
"19372","59316","2020",35,35,0,252700,2322.143,110.7714
"19373","59317","2020",133,133,0,158598.9,1982.917,81.49624
"19374","59318","2020",14,14,0,154791.1,1431.429,110.6429
"19375","59319","2020",31,31,0,220226.4,1968.645,112.129
"19376","59320","2020",28,28,0,211126.1,2146.536,99.03571
"19377","59321","2020",5,5,0,76000,757,103.2
"19378","59322","2020",39,38,1,116999.1,1172.103,100.359
"19379","59323","2020",6,6,0,223908.3,2045.667,108.8333
"19380","59324","2020",76,74,2,91568.96,1066.447,87
"19381","59325","2020",6,6,0,207383.3,1510.833,135.1667
"19382","59326","2020",20,20,0,207414.6,1820.4,118.1
"19383","59327","2020",45,40,5,142997.8,1558.422,92.4
"19384","59328","2020",481,324,157,280712.6,3196.152,86.76507
"19385","59329","2020",44,40,4,140361.1,1563.364,89.31818
"19386","59330","2020",25,25,0,218534,2105.52,109.92
"19387","59331","2020",37,36,1,96565.14,1076.757,94.51351
"19388","59332","2020",34,20,14,136657.8,1762.265,78.79412
"19389","59333","2020",2,2,0,121500,863.5,137.5
"19390","59334","2020",13,13,0,146193.2,1554.308,93.23077
"19391","59335","2020",40,38,2,235112.9,2189.875,112.8
"19392","59336","2020",18,18,0,106109.8,1135.333,92.33333
"19393","59337","2020",11,11,0,165713.6,1804.909,104.5455
"19394","59338","2020",10,10,0,201400,2177.5,98.2
"19395","59339","2020",120,112,8,232431.5,2578.942,91.4
"19396","59340","2020",51,38,13,176552.1,2087.549,82.07843
"19397","59341","2020",8,8,0,136843.8,1271.375,108.375
"19398","59342","2020",3,3,0,122501.7,1185,118
"19399","59343","2020",96,82,14,244655.6,2730.948,90.76042
"19400","59344","2020",16,16,0,108443.2,1091.812,100.3125
"19401","59345","2020",26,25,1,155752,1586.231,98.03846
"19402","59346","2020",38,38,0,240043.9,2764.789,90.60526
"19403","59347","2020",12,12,0,119523.5,1286.083,87.16667
"19404","59348","2020",10,10,0,105002.5,1189.4,85.6
"19405","59349","2020",34,33,1,124028.5,1128.324,109.1471
"19406","59350","2020",4102,1156,2946,211125.3,3389.723,66.23647
"19407","59351","2020",2,2,0,138875,1308,101.5
"19408","59352","2020",112,99,13,282066.3,2790.009,101.0268
"19409","59353","2020",3,3,0,186366.7,2185.333,102.3333
"19410","59354","2020",2,2,0,207000,1857,111.5
"19411","59356","2020",24,24,0,424396.5,3044.167,144.0417
"19412","59357","2020",19,19,0,151005.3,1521.474,109.7368
"19413","59358","2020",12,12,0,180762.5,1584.083,110.6667
"19414","59359","2020",60,60,0,172727.5,1763.633,98.25
"19415","59360","2020",299,165,134,151298.2,2241.144,70.32776
"19416","59361","2020",43,43,0,78005.93,967.2093,80.4186
"19417","59363","2020",13,13,0,175100.8,1644.923,110.6154
"19418","59364","2020",13,13,0,345920,2565.462,138.6923
"19419","59365","2020",58,50,8,79827.24,1010.103,78.37931
"19420","59366","2020",4,4,0,194312.5,1655,118.25
"19421","59367","2020",229,183,46,188400.9,2205.21,86.91266
"19422","59368","2020",515,174,341,249564.1,3167.334,78.29126
"19423","59369","2020",50,47,3,144296.3,1495.4,96.2
"19424","59370","2020",14,14,0,181211.8,1652.857,111.3571
"19425","59371","2020",8,8,0,403969,2915.25,140.875
"19426","59372","2020",9,9,0,108017.2,1302.333,82.77778
"19427","59375","2020",55,55,0,196069.1,1757.818,115.3455
"19428","59377","2020",22,22,0,145969.4,1313.682,111.0455
"19429","59378","2020",701,416,285,321292.3,3472.514,89.17261
"19430","59379","2020",17,17,0,163180.2,1690.412,97.11765
"19431","59381","2020",7,7,0,183285.7,1369.286,135.4286
"19432","59382","2020",13,13,0,95519.38,906,110.4615
"19433","59383","2020",155,137,18,116993.9,1409.677,83.20645
"19434","59384","2020",9,8,1,131055.6,1247.556,113.8889
"19435","59385","2020",33,33,0,117099,1193.545,96.30303
"19436","59386","2020",185,124,61,233189.5,3080.189,79.15676
"19437","59387","2020",20,20,0,103780.5,1212.1,86.35
"19438","59388","2020",25,25,0,250798,2323.4,108.12
"19439","59389","2020",30,29,1,116987.6,1180.033,97.2
"19440","59390","2020",25,25,0,132427.6,1404.64,95.8
"19441","59391","2020",4,4,0,175000,1328.75,128.25
"19442","59392","2020",306,234,72,92412.27,1073.725,88.0817
"19443","59393","2020",9,9,0,130397.8,1506.556,86.44444
"19444","59394","2020",8,8,0,90418.75,1002.125,89.375
"19445","59395","2020",8,8,0,126187.5,1100.875,112.25
"19446","59396","2020",12,12,0,175345,1570.583,109.1667
"19447","59397","2020",6,6,0,142816.7,1361.167,113.1667
"19448","59398","2020",45,43,2,484910.3,3153.644,154.1778
"19449","59399","2020",12,12,0,241775,2008.5,123.5
"19450","59400","2020",155,150,5,157398.3,1648.645,98.49677
"19451","59401","2020",24,23,1,207152.4,2157.25,96.875
"19452","59402","2020",8,8,0,166125,1744.375,98.5
"19453","59403","2020",7,7,0,189234.3,1501.571,133.4286
"19454","59405","2020",3,3,0,159226.7,1921.667,83
"19455","59406","2020",2,2,0,65000,1053,67
"19456","59407","2020",10,10,0,189237,1726.9,102.6
"19457","59408","2020",26,26,0,206322.1,2067.192,106.1923
"19458","59409","2020",32,32,0,118248.2,1269.875,94.375
"19459","59410","2020",246,137,109,181856,2403.167,75.37398
"19460","59411","2020",33,33,0,298258.2,2617.545,122.5152
"19461","59412","2020",1,1,0,220000,2018,109
"19462","59413","2020",8,8,0,109225,1285.625,84.875
"19463","59414","2020",37,34,3,141067.4,1525.919,92.54054
"19464","59415","2020",5,5,0,137073,1294.6,106
"19465","59416","2020",33,33,0,188977.3,1729.758,113.3333
"19466","59418","2020",13,13,0,151547.6,1269.692,122.6154
"19467","59419","2020",27,27,0,245513,1953.407,123.4444
"19468","59420","2020",1,1,0,170000,1090,156
"19469","59421","2020",219,170,49,332066.4,3131.68,101.8356
"19470","59422","2020",10,10,0,185880,1767.7,110.9
"19471","59423","2020",9,9,0,215244.4,1949,111.3333
"19472","59424","2020",11,10,1,117706.4,1309,89.72727
"19473","59425","2020",3,3,0,182000,1665.667,113.3333
"19474","59426","2020",121,112,9,226424.2,2373.43,96.95041
"19475","59427","2020",6,6,0,211333.3,2122,97.83333
"19476","59428","2020",43,43,0,123234.2,1356.023,90.62791
"19477","59429","2020",37,37,0,97184.86,1078.297,92.08108
"19478","59430","2020",15,15,0,102043.3,1117.867,89.13333
"19479","59431","2020",98,93,5,238108.2,2171.796,109.3673
"19480","59432","2020",1,1,0,140000,1414,99
"19481","59433","2020",8,8,0,130053.1,1323.375,107.875
"19482","59434","2020",19,19,0,243201.2,2024.263,123
"19483","59435","2020",36,35,1,239245,2239.917,110.75
"19484","59436","2020",12,12,0,149066.7,1434.25,105.75
"19485","59437","2020",6,6,0,271425,2032.833,129.3333
"19486","59438","2020",6,6,0,166891.7,1402.5,115.3333
"19487","59439","2020",2,2,0,155250,1382,128
"19488","59440","2020",6,6,0,96166.67,1192.5,80.16667
"19489","59441","2020",7,7,0,163042.9,1620.143,111.4286
"19490","59442","2020",1,1,0,229500,1765,130
"19491","59443","2020",3,3,0,178333.3,1140.333,160.6667
"19492","59444","2020",11,11,0,102741.4,1096,85.09091
"19493","59445","2020",18,18,0,111819.4,1004.056,109
"19494","59446","2020",10,8,2,245802.1,1949.3,122.3
"19495","59447","2020",105,103,2,132056,1419.829,92.80952
"19496","59448","2020",8,8,0,131002.5,1429.75,101.625
"19497","59449","2020",119,97,22,212330.3,2090.891,103.0168
"19498","59450","2020",7,7,0,135451.3,1314,102.2857
"19499","59451","2020",8,8,0,196687.5,1364.875,132.5
"19500","59452","2020",55,55,0,163045.5,1592.909,105.6727
"19501","59453","2020",12,12,0,190841.9,1928,101.8333
"19502","59454","2020",5,5,0,182020,1604.4,111.6
"19503","59455","2020",10,10,0,206125.8,1673.4,126.5
"19504","59456","2020",43,42,1,133277.2,1510.837,90.37209
"19505","59457","2020",136,113,23,216262.8,2405.956,89.08088
"19506","59458","2020",16,16,0,335673.8,3184.062,105.25
"19507","59459","2020",43,41,2,138075.9,1519.93,91.60465
"19508","59461","2020",1,1,0,350000,1606,218
"19509","59462","2020",72,55,17,227311.6,2204.181,106.6944
"19510","59463","2020",16,16,0,161737.5,1480.562,108.625
"19511","59464","2020",18,18,0,122062.2,1139.389,102.9444
"19512","59465","2020",6,6,0,146250,1545.333,97.83333
"19513","59466","2020",42,39,3,226655.6,2542.667,90.5
"19514","59467","2020",22,22,0,114534.9,1256.636,91.59091
"19515","59468","2020",2,2,0,200300,1962,101.5
"19516","59469","2020",7,7,0,246652.9,2185,118.5714
"19517","59470","2020",24,24,0,281972.5,2629.542,109.4167
"19518","59471","2020",34,34,0,173508.8,1782.529,96.67647
"19519","59472","2020",5,5,0,155478,1622.4,92.8
"19520","59473","2020",4,4,0,207725,1593,118.5
"19521","59474","2020",11,11,0,116025.5,1093.455,105.6364
"19522","59475","2020",24,24,0,114734.2,1266.75,89.79167
"19523","59476","2020",40,39,1,140730.2,1499.95,93.325
"19524","59477","2020",61,55,6,181940.7,2082,88.72131
"19525","59478","2020",14,14,0,198345.7,1788.214,105.7143
"19526","59479","2020",34,34,0,137102.9,1426.471,100.0588
"19527","59480","2020",7,6,1,193955.7,2464.571,84.14286
"19528","59481","2020",59,58,1,139742.2,1437.797,97.94915
"19529","59482","2020",79,78,1,278891.1,2614.152,107.3291
"19530","59483","2020",2,2,0,110000,1115.5,92
"19531","59484","2020",53,47,6,93667.02,1166.774,82.71698
"19532","59485","2020",27,27,0,103473.1,977.5556,110.6296
"19533","59486","2020",37,37,0,163655.5,1630.649,99.43243
"19534","59487","2020",16,16,0,395140.1,2749.812,147.3125
"19535","59488","2020",24,23,1,122224.5,1328.208,91.66667
"19536","59489","2020",48,48,0,188770.3,1839.271,102.9792
"19537","59490","2020",1,1,0,107400,918,117
"19538","59491","2020",120,112,8,122363.7,1291.425,92.35833
"19539","59492","2020",3,3,0,111600,1133,99.66667
"19540","59493","2020",2,2,0,248000,1070.5,231.5
"19541","59494","2020",3,3,0,140666.7,1430.667,99
"19542","59495","2020",25,25,0,110122.2,1238.76,89.92
"19543","59496","2020",4,4,0,76575,870.25,87.25
"19544","59497","2020",32,31,1,143973.1,1556.062,98.5
"19545","59498","2020",2,2,0,163500,1037,154
"19546","59499","2020",14,14,0,192791.1,1770.357,115.6429
"19547","59500","2020",6,6,0,139876.7,1197.167,130.8333
"19548","59501","2020",13,13,0,174795.4,1518.615,117.0769
"19549","59502","2020",13,12,1,107011.5,1057.769,100.1538
"19550","59504","2020",40,40,0,102784.8,1147.7,86.6
"19551","59505","2020",3,3,0,216366.7,2032.667,110
"19552","59506","2020",3,3,0,165000,1637,100.6667
"19553","59507","2020",331,212,119,180058.6,2303.42,81.06949
"19554","59508","2020",176,149,27,262257.8,2684.67,97.84091
"19555","59509","2020",50,50,0,151788.9,1506.56,102.22
"19556","59511","2020",21,21,0,233816.6,2326.857,104.0476
"19557","59512","2020",996,634,362,141201.1,1615.975,88.56124
"19558","59513","2020",2,2,0,108300,1184.5,91.5
"19559","59514","2020",66,52,14,103001.4,1096.742,91.51515
"19560","59515","2020",7,7,0,130920,1075.857,117.5714
"19561","59516","2020",10,10,0,169906,2005.3,98.2
"19562","59517","2020",13,13,0,163313.1,1479.385,120.3077
"19563","59518","2020",2,2,0,172500,1564,115
"19564","59519","2020",18,18,0,303405.6,2663.944,123.1667
"19565","59520","2020",13,13,0,112372.8,1087.462,101.8462
"19566","59521","2020",3,3,0,149433.3,1495,93.66667
"19567","59522","2020",34,34,0,325508.6,2849.647,118.7353
"19568","59523","2020",26,26,0,304424.2,2904.192,105.1538
"19569","59524","2020",83,83,0,217289.8,2394.578,92.54217
"19570","59525","2020",29,28,1,103056.6,1063.759,107.5862
"19571","59526","2020",202,201,1,155986.4,1621.178,96.22772
"19572","59527","2020",210,118,92,209118.7,2859.595,73.95714
"19573","59528","2020",18,18,0,147715.7,1365.833,112.3333
"19574","59529","2020",5,5,0,129200,1010.6,131.4
"19575","59530","2020",5,5,0,191700,1585.2,119.2
"19576","59531","2020",6,6,0,98666.67,923,109.6667
"19577","59532","2020",3,3,0,255866.7,2058,132.3333
"19578","59533","2020",24,24,0,104702.1,1152.75,92.04167
"19579","59534","2020",6,6,0,71400,788,94.16667
"19580","59535","2020",22,22,0,258236.4,2447.727,104.3636
"19581","59536","2020",5,5,0,164420,1802.2,91
"19582","59537","2020",7,7,0,144008.6,1413.429,102.5714
"19583","59538","2020",9,9,0,201688.9,1756,113.8889
"19584","59539","2020",10,10,0,135530,1422.3,93.2
"19585","59541","2020",8,8,0,127625,1219.25,99.875
"19586","59542","2020",10,10,0,136358.6,1144.8,119.7
"19587","59543","2020",12,12,0,120837.1,1303.583,95.66667
"19588","59544","2020",130,93,37,147841.8,1715.162,86.16154
"19589","59545","2020",11,11,0,77636.36,745.0909,101.5455
"19590","59546","2020",14,14,0,150617.9,1467.071,102.7143
"19591","59547","2020",16,16,0,104225.9,978.6875,105.9375
"19592","59548","2020",8,8,0,186343.8,1344,147.625
"19593","59549","2020",3,3,0,175300,1269.667,138.3333
"19594","59550","2020",36,36,0,185338.6,1839.861,104.1389
"19595","59551","2020",16,16,0,322067.5,2438.938,133.9375
"19596","59552","2020",2,2,0,111000,812.5,137
"19597","59553","2020",60,60,0,251690.9,2384.1,107.2333
"19598","59554","2020",5,5,0,261238,2059,127
"19599","59555","2020",20,20,0,99479.9,1026.55,100
"19600","59556","2020",3,3,0,151666.7,1449,104.3333
"19601","59557","2020",39,31,8,172635.5,1733.103,98.79487
"19602","59558","2020",21,21,0,153333.8,1404.095,112.2857
"19603","59559","2020",27,27,0,240771.7,1994.296,120.3333
"19604","59560","2020",169,143,26,199388.8,2378.574,85.43195
"19605","59562","2020",4,4,0,165625,1556,112.25
"19606","59563","2020",2,2,0,108250,721,139.5
"19607","59564","2020",29,24,5,105362.2,1298.207,82.10345
"19608","59565","2020",8,8,0,196925.8,1859.625,111.625
"19609","59566","2020",66,52,14,222063.7,2620.364,84.83333
"19610","59567","2020",7,7,0,154173.9,1317.857,126.7143
"19611","59568","2020",4,4,0,193750,1872.75,103.25
"19612","59569","2020",170,146,24,109161.4,1326.394,81.89412
"19613","59570","2020",13,13,0,231046.2,2233.462,115.0769
"19614","59571","2020",59,56,3,90684.42,1038.339,87.33898
"19615","59572","2020",15,15,0,116653.1,942.2667,130.5333
"19616","59573","2020",1,1,0,192000,1164,165
"19617","59574","2020",117,107,10,114495.8,1339.094,87.76068
"19618","59575","2020",5,5,0,223005.4,1836.4,126.6
"19619","59576","2020",10,10,0,190700,1776,105.3
"19620","59577","2020",7,7,0,157300,1686.571,95.71429
"19621","59578","2020",19,19,0,177900,1585.947,108.1579
"19622","59579","2020",18,18,0,158518.1,1640.111,96.88889
"19623","59580","2020",39,38,1,189966.7,2118.333,91.76923
"19624","59581","2020",45,45,0,233159.4,2143.6,110.0889
"19625","59582","2020",16,16,0,196631.2,1904.562,108.375
"19626","59583","2020",7,7,0,176285.7,1321.571,137.8571
"19627","59584","2020",9,9,0,160612.2,1506,116.5556
"19628","59585","2020",50,35,15,218965,2701.62,84.46
"19629","59586","2020",100,91,9,266780.5,2687.79,97.5
"19630","59587","2020",7,7,0,215500,1876,115.4286
"19631","59588","2020",91,89,2,228262.5,1968.538,117.6484
"19632","59589","2020",31,31,0,141071.3,1525.161,93.06452
"19633","59590","2020",9,9,0,142433.3,1538.111,95.22222
"19634","59591","2020",9,9,0,139361.1,1326.333,106.7778
"19635","59592","2020",69,68,1,210055.4,2058.406,101.9565
"19636","59593","2020",9,9,0,184916.7,1632.111,111.1111
"19637","59594","2020",22,22,0,171686.4,1591.636,109.9545
"19638","59595","2020",6,6,0,226618.8,1774,131.1667
"19639","59596","2020",7,7,0,269142.9,2324.857,120.5714
"19640","59597","2020",9,9,0,212772.2,1716.111,123
"19641","59598","2020",61,61,0,244989.7,2436.033,103.5574
"19642","59599","2020",1488,1018,470,146427.7,1763.886,84.70766
"19643","59600","2020",10,10,0,254295,2315.7,107
"19644","59601","2020",32,31,1,107021.9,988.9688,108.4375
"19645","59602","2020",13,12,1,247683.1,2864.308,91.15385
"19646","59603","2020",69,62,7,115010.5,1367.623,84.49275
"19647","59604","2020",4,4,0,118500,1111.75,102.75
"19648","59605","2020",17,16,1,216770,1845.118,115.4118
"19649","59606","2020",763,388,375,134961.5,1759.944,79.3945
"19650","59607","2020",7,7,0,146614.3,1244.143,113.8571
"19651","59608","2020",12,12,0,176925,1595,108.1667
"19652","59609","2020",24,15,9,238100,2713.458,87.66667
"19653","59610","2020",11,11,0,171636.4,1731.545,99.45455
"19654","59611","2020",28,20,8,345143.6,3344.107,103.3571
"19655","59612","2020",5,5,0,136200,1310,103.6
"19656","59613","2020",7,7,0,159454.3,1447.857,110.4286
"19657","59614","2020",20,20,0,89872.5,977.3,93.85
"19658","59615","2020",34,34,0,195477.8,1673.618,120.6471
"19659","59616","2020",100,99,1,120035.2,1285.3,93.56
"19660","59617","2020",2,2,0,204750,2136.5,97
"19661","59618","2020",11,11,0,169245.5,1358,127.8182
"19662","59619","2020",12,12,0,195875,1812.75,112.5833
"19663","59620","2020",11,11,0,154500,1458.273,102.5455
"19664","59622","2020",18,18,0,123383.3,1200.944,101
"19665","59623","2020",9,9,0,128161.1,1205.778,111.1111
"19666","59624","2020",30,30,0,89605,825.5333,108.0667
"19667","59625","2020",3,3,0,120733.3,938.3333,129.3333
"19668","59626","2020",16,16,0,190279.7,1701.688,120.375
"19669","59627","2020",7,7,0,123357.1,1068,111.4286
"19670","59628","2020",4,4,0,99850,1278.5,89.5
"19671","59629","2020",19,19,0,182162.1,1755.737,106.3684
"19672","59630","2020",32,31,1,204939.3,2075.125,101.5
"19673","59631","2020",27,27,0,98811.67,979.8519,106.7037
"19674","59632","2020",48,48,0,168944.6,1639.188,102.8125
"19675","59633","2020",7,7,0,141207.1,1605.571,102.4286
"19676","59634","2020",6,6,0,196530,1726.833,115.8333
"19677","59635","2020",6,6,0,185961.7,1655,114.5
"19678","59636","2020",162,129,33,291339.3,3070.667,94.40741
"19679","59637","2020",15,15,0,236193.3,2211.667,105.0667
"19680","59638","2020",14,14,0,362178.6,2848.214,128.4286
"19681","59639","2020",15,15,0,181256.7,1495.667,117.6
"19682","59640","2020",11,11,0,170190.9,1728.364,103.9091
"19683","59641","2020",16,16,0,209726.9,1980.25,107.25
"19684","59642","2020",7,7,0,273185.7,1905.857,140.8571
"19685","59643","2020",2,2,0,152500,1780,105.5
"19686","59645","2020",6,6,0,119833.3,1567.5,83.33333
"19687","59646","2020",326,260,66,298905.5,3054.929,94.90491
"19688","59647","2020",26,25,1,119265,1192.192,103.8462
"19689","59648","2020",196,112,84,182546.7,2138.347,83.59184
"19690","59649","2020",3,3,0,143333.3,1498.333,94.33333
"19691","59650","2020",450,414,36,151135.4,1851.996,83.06
"19692","59651","2020",27,27,0,75688.89,979.2593,80.59259
"19693","59652","2020",9,9,0,143716.7,1278.667,112.8889
"19694","59653","2020",95,92,3,211014.4,2179.579,99.36842
"19695","59654","2020",56,56,0,115829.6,1182.536,97.53571
"19696","59655","2020",3,3,0,209833.3,2140.333,91
"19697","59656","2020",60,39,21,251231.2,2911.933,91.6
"19698","59657","2020",12,12,0,179860.8,1638.5,112.1667
"19699","59658","2020",5,5,0,229900,2297.4,101.2
"19700","59659","2020",28,27,1,95858.89,948.9643,102.8214
"19701","59660","2020",29,27,2,285356.2,2601.897,112.2069
"19702","59661","2020",1,1,0,225000,1891,119
"19703","59662","2020",12,12,0,194549.2,1905.25,108.9167
"19704","59663","2020",58,49,9,186111.9,1928.069,104.0172
"19705","59664","2020",4,4,0,172204,1488.5,108.25
"19706","59665","2020",2,2,0,147795,1434,96.5
"19707","59666","2020",19,19,0,187140,1710.474,112.3684
"19708","59667","2020",4,4,0,242550,2159.5,121.5
"19709","59668","2020",26,17,9,194790,2209.423,92.23077
"19710","59669","2020",2,2,0,126500,954,132
"19711","59670","2020",17,16,1,186332.4,2387.588,81
"19712","60001","2020",11,11,0,115954.5,1197.818,111.1818
"19713","60002","2020",12,12,0,182566.7,1900.75,97.83333
"19714","60003","2020",5,5,0,178700,1634.2,105.4
"19715","60004","2020",6,6,0,176500,2186.833,99.16667
"19716","60005","2020",26,24,2,209676.9,2293.692,95.84615
"19717","60006","2020",18,16,2,206285.6,2142.5,100.8333
"19718","60007","2020",55,53,2,214424,2183.873,101.0545
"19719","60008","2020",4,4,0,196750,2228,88.75
"19720","60009","2020",14,14,0,292586.4,2255.786,130.7143
"19721","60010","2020",21,21,0,231096.6,2425.143,96.85714
"19722","60011","2020",4,4,0,107500,1535.75,77
"19723","60012","2020",52,47,5,198524.4,2283.173,92.65385
"19724","60013","2020",15,15,0,226400,2063.2,112.6667
"19725","60015","2020",22,20,2,166745.5,1766.182,98.90909
"19726","60016","2020",4,4,0,243000,1934,127.5
"19727","60017","2020",11,11,0,162631.8,1550.545,114
"19728","60019","2020",4,4,0,195000,1485.25,127.75
"19729","60020","2020",1,1,0,202000,1820,111
"19730","60021","2020",6,6,0,94616.67,1311.667,83.33333
"19731","60022","2020",9,9,0,404552.4,3203.667,134.1111
"19732","60024","2020",8,8,0,251791.9,2005.375,132.125
"19733","60025","2020",33,30,3,165243.6,1795.788,97.78788
"19734","60026","2020",6,6,0,116833.3,1136.667,108.3333
"19735","60028","2020",6,6,0,4e+05,3222,136
"19736","60029","2020",28,27,1,193620,2080.321,98.21429
"19737","60030","2020",4,4,0,227531.2,2092.25,109.75
"19738","60031","2020",3,3,0,249833.3,1689,149.6667
"19739","60032","2020",9,9,0,149822.2,1769.222,90.77778
"19740","60033","2020",14,14,0,326083.4,2829,119.3571
"19741","60034","2020",17,16,1,189041.2,1978.412,101.2353
"19742","60035","2020",3,3,0,113333.3,1240.667,89.33333
"19743","60036","2020",3,3,0,238466.7,2325.667,115.6667
"19744","60037","2020",5,5,0,130560,1288.8,101.2
"19745","60039","2020",12,12,0,100701.2,1362.667,81
"19746","60040","2020",7,7,0,180600,1983.286,103.2857
"19747","60041","2020",20,20,0,195732.5,2166.45,88.05
"19748","60042","2020",21,21,0,211264.5,2061.714,104.8571
"19749","60043","2020",4,4,0,159241,1604,99.75
"19750","60044","2020",25,24,1,186720,2142.76,90
"19751","60045","2020",10,8,2,286615,2717.6,106.7
"19752","60046","2020",2,2,0,264500,2247.5,117.5
"19753","60047","2020",11,11,0,207020.7,2203.182,93.90909
"19754","60048","2020",2,2,0,300500,1901,160.5
"19755","60049","2020",1,1,0,98000,1114,88
"19756","60050","2020",3,3,0,210433.3,2395,90
"19757","60051","2020",3,3,0,75166.67,668.6667,117.3333
"19758","60052","2020",1,1,0,127900,2030,63
"19759","60053","2020",5,5,0,118580,1214.2,102.4
"19760","60054","2020",11,11,0,275832.7,2244.364,132
"19761","60055","2020",7,7,0,176428.6,1823.143,98.85714
"19762","60056","2020",1,1,0,240000,3934,61
"19763","60057","2020",646,279,367,136666.3,1848.392,75.1192
"19764","60058","2020",4,4,0,118000,1798.25,71.5
"19765","60059","2020",4,4,0,186750,1132,139.75
"19766","60060","2020",17,6,11,209358.2,2696.176,84.17647
"19767","60061","2020",1,1,0,190000,1900,100
"19768","60062","2020",1,1,0,125000,1179,106
"19769","60063","2020",7,7,0,182285.7,1990.857,104
"19770","60064","2020",21,21,0,170604.8,1902.619,93.04762
"19771","60065","2020",15,15,0,208946.1,2550.933,94.13333
"19772","60066","2020",3,3,0,182666.7,2532.333,74
"19773","60067","2020",19,18,1,183966.3,2399.053,81.15789
"19774","60068","2020",54,51,3,170204.6,2007.778,87.64815
"19775","60069","2020",19,14,5,194223.7,2298.474,85.42105
"19776","60070","2020",4,4,0,239750,1627.5,148.5
"19777","60071","2020",1,1,0,128000,1910,67
"19778","60072","2020",6,6,0,138833.3,1440,103.1667
"19779","60073","2020",6,6,0,224166.7,2149.833,115
"19780","60074","2020",15,13,2,267921.7,3115,89.93333
"19781","60075","2020",1,1,0,135000,2288,59
"19782","60076","2020",4,4,0,146878.8,1434,104.25
"19783","60077","2020",3,3,0,150000,1490,98.33333
"19784","60079","2020",8,7,1,221368.8,2405.375,95.5
"19785","60081","2020",3,3,0,269333.3,1982.667,141.3333
"19786","60082","2020",9,9,0,127822.2,1855.556,80
"19787","60083","2020",8,8,0,180668.8,1625.625,107.25
"19788","60084","2020",4,4,0,204000,1742.25,113.25
"19789","60085","2020",3,3,0,85624.67,754,119.6667
"19790","60086","2020",27,24,3,250263.6,2579.778,101.5926
"19791","60087","2020",4,4,0,401200,2990.25,136.5
"19792","60088","2020",67,55,12,235150.4,2701.119,91.86567
"19793","60089","2020",8,8,0,271812.4,2110.25,136.25
"19794","60090","2020",7,7,0,210100,2112.857,100.4286
"19795","60091","2020",9,9,0,231166.7,2349.556,98.66667
"19796","60092","2020",3,3,0,267333.3,2045,134.3333
"19797","60093","2020",10,10,0,144000,1485.4,102.8
"19798","60094","2020",5,5,0,161800,1887.2,96.6
"19799","60095","2020",10,10,0,247570,2526.4,102.6
"19800","60097","2020",6,6,0,198000,1910.833,107
"19801","60098","2020",1,1,0,185000,1682,110
"19802","60099","2020",1,1,0,175000,1296,135
"19803","60100","2020",1,1,0,588420,3097,190
"19804","60101","2020",20,19,1,210152.2,2229.15,96.15
"19805","60102","2020",20,20,0,192046.4,2315.55,86
"19806","60103","2020",32,31,1,184130.9,1989.219,95.5
"19807","60104","2020",49,49,0,123971,1432.878,89.2449
"19808","60105","2020",3,3,0,114166.7,1478.333,76
"19809","60106","2020",20,20,0,207877.9,2142.45,106.95
"19810","60107","2020",44,42,2,206274.2,2197.295,99.68182
"19811","60108","2020",6,6,0,156233.3,1898.333,88.33333
"19812","60109","2020",4,4,0,213624.2,1532.5,148.5
"19813","60111","2020",2,2,0,115332.5,1716,72.5
"19814","60112","2020",7,7,0,155285.7,2099,81.14286
"19815","60113","2020",3,3,0,109666.7,1438,75.33333
"19816","60114","2020",4,4,0,181210,1785.5,105
"19817","60115","2020",12,12,0,168250,2229,85.08333
"19818","60116","2020",48,47,1,188198.6,1908.229,103.2083
"19819","60117","2020",3,3,0,118691.7,1358,83.33333
"19820","60119","2020",17,17,0,149835.3,1593.118,93.94118
"19821","60120","2020",12,12,0,181466.7,2414,78.33333
"19822","60121","2020",2,2,0,200150,1264.5,155
"19823","60122","2020",6,6,0,162166.7,1203.5,132.1667
"19824","60123","2020",8,8,0,120230.2,1360.375,92
"19825","60124","2020",5,5,0,114000,1519,78
"19826","60125","2020",11,11,0,270495.5,2133.364,133.0909
"19827","60126","2020",6,6,0,124690,1242.833,99.83333
"19828","60127","2020",13,13,0,159373.1,1505.231,108.1538
"19829","60128","2020",2,2,0,127500,756.5,174
"19830","60129","2020",16,16,0,130512.5,1559.812,86.3125
"19831","60130","2020",5,5,0,216788,2034.8,129.6
"19832","60131","2020",1,1,0,160000,1060,151
"19833","60132","2020",1,1,0,134790,2246,60
"19834","60133","2020",10,10,0,159650,1671.7,100.9
"19835","60134","2020",22,22,0,202595.5,2201.318,98.90909
"19836","60135","2020",32,32,0,195225.7,2153.906,92.8125
"19837","60136","2020",7,7,0,166857.1,1625.857,108.2857
"19838","60137","2020",4,4,0,222250,1967.75,114.5
"19839","60138","2020",15,12,3,361760,2978.933,114.4
"19840","60139","2020",130,83,47,211137.6,2963.369,75.05385
"19841","60140","2020",10,10,0,221114.6,2058.7,118.6
"19842","60141","2020",196,32,164,294195.6,4143.827,71.95408
"19843","60142","2020",42,29,13,275207.9,3142.786,90.16667
"19844","60143","2020",42,39,3,212822.3,2205.81,104.7619
"19845","60144","2020",3,3,0,255000,2782.333,91.33333
"19846","60145","2020",12,12,0,210208.3,2158.083,102.8333
"19847","60146","2020",5,5,0,115700,1413.6,81.2
"19848","60147","2020",13,13,0,186398.5,1947.077,101.6923
"19849","60148","2020",6,5,1,223369.5,2818,79.16667
"19850","60149","2020",22,22,0,237059.1,2412.727,104.4545
"19851","60150","2020",13,13,0,157237.3,1751.231,95.76923
"19852","60151","2020",56,51,5,225626.4,2338.821,98.64286
"19853","60152","2020",2,2,0,203500,2153,93
"19854","60153","2020",3,3,0,119666.7,1024,107.3333
"19855","60154","2020",22,21,1,243230,2579.455,99.81818
"19856","60155","2020",49,44,5,198977.5,2331.082,88.18367
"19857","60156","2020",35,27,8,203425.1,2288.543,89.25714
"19858","60157","2020",175,96,79,148320.7,2005.8,76.50857
"19859","60158","2020",3,3,0,96666.67,1493,76.66667
"19860","60159","2020",672,168,504,184974.6,2447.161,75.09524
"19861","60160","2020",14,14,0,210407.1,1624.286,134.5714
"19862","60161","2020",1,1,0,90000,1406,64
"19863","60162","2020",2,2,0,217500,2278,94.5
"19864","60163","2020",5,5,0,117900,1366.6,92.6
"19865","60164","2020",10,10,0,168294.3,1558.1,109.9
"19866","60165","2020",8,8,0,263206.2,2378.625,117
"19867","60166","2020",9,9,0,221688.8,2037,113.8889
"19868","60167","2020",10,10,0,138402.3,1411.8,107.9
"19869","60168","2020",3,3,0,159066.7,1428.333,125
"19870","60169","2020",18,18,0,204890,2136.056,97.72222
"19871","60170","2020",10,10,0,400300,3142.2,128.7
"19872","60171","2020",2,2,0,140000,1355.5,110
"19873","60172","2020",81,48,33,312933.6,3605.864,92.67901
"19874","60173","2020",14,10,4,164403.6,1933.643,94.35714
"19875","60174","2020",3,3,0,105473.3,902.3333,118
"19876","60175","2020",226,56,170,109710.9,1792.951,60.50885
"19877","60176","2020",214,144,70,206787.5,2661.972,79.8271
"19878","60177","2020",4,4,0,188950,1892.75,102.25
"19879","60178","2020",46,38,8,123052.9,1522.804,83.69565
"19880","60179","2020",5,5,0,133000,1342,131
"19881","60180","2020",6,6,0,172777.5,1723.333,112.6667
"19882","60181","2020",15,15,0,115336.7,1233.333,95.93333
"19883","60182","2020",4,4,0,142750,1117.25,132.5
"19884","60183","2020",5,5,0,131640,1366.4,101.8
"19885","60184","2020",5,5,0,277600,2278.4,129
"19886","60185","2020",17,17,0,217705.9,2781.353,82.58824
"19887","60186","2020",5,5,0,174612.8,1712.6,103.2
"19888","60187","2020",14,14,0,162785.7,1936.143,88.57143
"19889","60188","2020",28,28,0,159069.5,1897.107,89.89286
"19890","60189","2020",10,10,0,152955,1441.7,117.2
"19891","60190","2020",2,2,0,220000,2236,122
"19892","60191","2020",12,12,0,159474.6,1606.417,99.41667
"19893","60192","2020",3,3,0,180000,1759.667,111.3333
"19894","60193","2020",1,1,0,150000,1327,113
"19895","60194","2020",4,4,0,79750,1585.75,51.5
"19896","60195","2020",8,7,1,274697.5,2568.5,113
"19897","60196","2020",16,16,0,229601.5,2221.688,105.75
"19898","60197","2020",18,17,1,243182,2565.611,97.33333
"19899","60200","2020",4,4,0,127577.5,1597.5,82.75
"19900","60201","2020",5,5,0,131920,1317,102.4
"19901","60203","2020",3,2,1,292790,2727.667,114.3333
"19902","60204","2020",2,2,0,67500,1334,55
"19903","60206","2020",19,19,0,200584.2,1888.474,111.6316
"19904","60207","2020",5,5,0,168130,1895.8,95.8
"19905","60208","2020",4,4,0,348710,2532.25,142.25
"19906","60209","2020",8,8,0,183750,2211.5,85.125
"19907","60210","2020",2,2,0,238000,1941,123.5
"19908","60211","2020",15,15,0,139240.3,1659.933,82.46667
"19909","60212","2020",19,18,1,218310.5,2481,93.94737
"19910","60213","2020",15,13,2,278840.1,2379.467,118.8
"19911","60214","2020",6,6,0,112166.7,1099.833,104.1667
"19912","60215","2020",5,5,0,189600,1903.4,90.2
"19913","60216","2020",2,2,0,144000,2781.5,64
"19914","60217","2020",3,3,0,149000,2725.333,52.33333
"19915","60218","2020",20,19,1,253685,2410.55,107.1
"19916","60219","2020",2,2,0,69500,787,91
"19917","60220","2020",5,5,0,185050,1691.6,120.8
"19918","60221","2020",10,10,0,93189,1457.2,80.3
"19919","60222","2020",4,4,0,135447.5,1176,115.75
"19920","60223","2020",46,46,0,201393.2,2068.304,101.9348
"19921","60224","2020",3,3,0,203850.7,2198.667,95.33333
"19922","60225","2020",12,12,0,149684.2,1829.167,85.08333
"19923","60226","2020",4,3,1,239500,2520,98
"19924","60227","2020",6,6,0,142392.7,1362.667,104.3333
"19925","60228","2020",8,8,0,216816,2241.125,102.125
"19926","60229","2020",2,2,0,246750,3472.5,73
"19927","60230","2020",7,7,0,158480,1897.857,91.57143
"19928","60231","2020",9,8,1,279635.6,2389.778,120.4444
"19929","60232","2020",7,6,1,168335.7,1643.857,103.7143
"19930","60233","2020",17,17,0,98511.76,1317.059,81.23529
"19931","60234","2020",37,29,8,174403.5,2197.865,80.37838
"19932","60235","2020",17,17,0,187911.8,2266.588,94.70588
"19933","60236","2020",1,1,0,87900,586,150
"19934","60237","2020",2,2,0,51250,1172,45
"19935","60238","2020",28,26,2,276892.9,2763.036,109.0357
"19936","60239","2020",9,9,0,206180.6,2468.556,89.66667
"19937","60240","2020",5,5,0,226700,3669.2,96
"19938","60241","2020",7,7,0,322492.9,2795.571,120.2857
"19939","60242","2020",5,5,0,158120.8,1747,88.4
"19940","60243","2020",3,3,0,214266.7,2262.667,95.66667
"19941","60244","2020",1,1,0,136000,907,150
"19942","60245","2020",28,28,0,122410.7,1398.571,91.96429
"19943","60247","2020",1,1,0,250000,2632,95
"19944","60249","2020",3,3,0,221333.3,1793,122
"19945","60250","2020",7,7,0,138571.4,1472.857,129.1429
"19946","60251","2020",1,1,0,220000,1774,124
"19947","60252","2020",3,3,0,289666.7,3184.333,91.33333
"19948","60253","2020",8,8,0,161375,1605.875,104.875
"19949","60254","2020",8,6,2,193362.5,1785.75,103.5
"19950","60255","2020",8,8,0,66312.5,766.875,94.25
"19951","60256","2020",26,26,0,218636.5,2011,114.9615
"19952","60257","2020",16,16,0,227387.8,2318.75,101.1875
"19953","60258","2020",3,3,0,116666.7,1222,141.3333
"19954","60259","2020",11,11,0,259427.3,2680.818,109.9091
"19955","60260","2020",8,8,0,219937.5,2464.375,97.125
"19956","60261","2020",7,7,0,311521.4,2559.429,126
"19957","60262","2020",3,3,0,124641.7,1417.667,89.33333
"19958","60263","2020",2,2,0,104000,1191.5,91
"19959","60264","2020",6,6,0,188500,2227,93.83333
"19960","60265","2020",11,10,1,161698.3,1734.182,103.7273
"19961","60267","2020",1,1,0,175000,1108,158
"19962","60268","2020",6,6,0,115083.3,1418.833,80.83333
"19963","60269","2020",1,1,0,320000,1882,170
"19964","60270","2020",3,3,0,160924.3,1645.333,101.3333
"19965","60271","2020",2,2,0,332500,3319.5,119.5
"19966","60272","2020",7,7,0,172714.3,2039,89.42857
"19967","60273","2020",8,8,0,216312.5,2254,99
"19968","60274","2020",9,9,0,250335.9,2268.111,115.5556
"19969","60275","2020",2,2,0,162500,2182,75
"19970","60276","2020",4,4,0,162240,2367.25,81.5
"19971","60277","2020",5,5,0,224000,2797,80.8
"19972","60278","2020",3,3,0,82333.33,856.6667,92
"19973","60279","2020",3,3,0,219000,2283.667,100.3333
"19974","60280","2020",1,1,0,103100,1031,100
"19975","60281","2020",8,8,0,148250,1730.875,96.375
"19976","60282","2020",147,99,48,321850.3,3501.367,94.38776
"19977","60284","2020",18,18,0,235978.9,2188.556,114.3333
"19978","60285","2020",5,5,0,170000,2038.4,86.8
"19979","60286","2020",27,26,1,115750.7,1462.185,82.11111
"19980","60287","2020",2,2,0,112500,1386.5,85
"19981","60288","2020",3,3,0,116833.3,1564,71.33333
"19982","60289","2020",7,7,0,153321.4,1620.286,93.71429
"19983","60290","2020",12,12,0,185027.2,2159.667,89.75
"19984","60291","2020",17,17,0,128132.4,1422.294,92.52941
"19985","60292","2020",1,1,0,353850,896,395
"19986","60293","2020",4,4,0,305345,3167.75,103.25
"19987","60294","2020",1,1,0,162000,1688,96
"19988","60295","2020",7,7,0,131715.1,1534.143,94
"19989","60296","2020",2,2,0,82500,1472,64.5
"19990","60297","2020",4,4,0,127750,1187.25,105.75
"19991","60298","2020",10,10,0,152345,1642.4,89.7
"19992","60299","2020",10,10,0,106850,1299.1,82.1
"19993","60301","2020",1,1,0,160000,800,200
"19994","60302","2020",8,8,0,177250,1920.25,100.625
"19995","60304","2020",4,4,0,205000,2014.5,109.5
"19996","60305","2020",3,3,0,177166.7,2186.333,85.66667
"19997","60306","2020",3,3,0,121833.3,1333.333,98
"19998","60307","2020",14,14,0,245010.7,2156.214,112.2857
"19999","60308","2020",7,7,0,191095.7,2145.429,101.1429
"20000","60309","2020",13,11,2,238194.6,2538.923,100.3077
"20001","60310","2020",6,6,0,204750,1647.833,120.6667
"20002","60311","2020",4,4,0,92625,1129.75,88.5
"20003","60312","2020",2,2,0,200500,2799,87
"20004","60313","2020",22,21,1,184232.3,2076.273,96.54545
"20005","60314","2020",2,2,0,71000,959,74
"20006","60315","2020",4,4,0,151302,1899.25,79.5
"20007","60316","2020",11,11,0,236765.9,2530.091,92.63636
"20008","60317","2020",11,11,0,193318.2,2039.545,96.81818
"20009","60318","2020",5,5,0,284000,1947.2,149.6
"20010","60319","2020",6,6,0,162750,2137.333,79
"20011","60320","2020",4,4,0,2e+05,1878.75,104.5
"20012","60321","2020",12,12,0,216737.5,2738.417,84.33333
"20013","60322","2020",4,4,0,194550,2345.25,89.5
"20014","60323","2020",9,9,0,147894.4,1949,84.22222
"20015","60324","2020",9,9,0,180196.7,1594.111,122.6667
"20016","60325","2020",26,22,4,233968.8,2312.654,104.9615
"20017","60327","2020",13,13,0,200038.5,2473.923,86.69231
"20018","60328","2020",2,2,0,172500,1823.5,94.5
"20019","60329","2020",2,2,0,145736.5,1083.5,118.5
"20020","60330","2020",19,18,1,215851.7,2105.895,108.8421
"20021","60331","2020",9,9,0,195832.2,1694.111,123
"20022","60332","2020",8,8,0,206898.8,2115.875,97.5
"20023","60333","2020",23,21,2,148630.4,1602.87,104.4348
"20024","60334","2020",16,16,0,224837.1,2280.125,100.75
"20025","60335","2020",2,2,0,120000,1628,73.5
"20026","60336","2020",1,1,0,1e+05,1282,78
"20027","60337","2020",10,9,1,306780.7,2349.5,132.8
"20028","60338","2020",70,54,16,251024.3,2544,100.0429
"20029","60339","2020",2,2,0,251000,1309,221.5
"20030","60340","2020",5,5,0,115810,1461.4,83.8
"20031","60341","2020",23,23,0,280350,2988.391,102.7391
"20032","60342","2020",60,48,12,161857.5,2063.65,80.6
"20033","60343","2020",15,15,0,178347.1,1946.4,92.86667
"20034","60344","2020",3,3,0,276216.7,2075.333,143
"20035","60345","2020",2,2,0,166500,2027.5,82.5
"20036","60346","2020",166,125,41,449934.4,3786.283,129.8855
"20037","60347","2020",5,5,0,97400,1038.8,102.8
"20038","60348","2020",3,3,0,105666.7,779.6667,137.6667
"20039","60350","2020",17,17,0,175905.9,1543.647,118.0588
"20040","60351","2020",1,1,0,110000,1392,79
"20041","60352","2020",4,4,0,192425,2022.5,96.25
"20042","60353","2020",1,1,0,147000,1157,127
"20043","60355","2020",7,7,0,232442.9,2043.714,117
"20044","60356","2020",8,7,1,242525,2527,100.375
"20045","60357","2020",7,7,0,151314.3,1509.857,100.2857
"20046","60358","2020",13,9,4,200938.5,2450.462,83.76923
"20047","60360","2020",86,63,23,138140.7,1949.023,73.69767
"20048","60361","2020",10,10,0,257300,2368.6,110.9
"20049","60362","2020",3,3,0,123000,1161.667,104.6667
"20050","60363","2020",2,2,0,292775,1441,189
"20051","60364","2020",10,7,3,165962.5,1775.8,98.7
"20052","60365","2020",5,5,0,183400,1474.2,130.8
"20053","60366","2020",2,2,0,170000,2364,81.5
"20054","60367","2020",7,4,3,141500,1877.143,78.42857
"20055","60368","2020",31,30,1,158640.9,1805.935,90.90323
"20056","60369","2020",15,14,1,255630,2097,128.8667
"20057","60370","2020",15,15,0,197612,2356,86.73333
"20058","60371","2020",1,1,0,160000,1600,100
"20059","60372","2020",4,4,0,216000,1677.75,132
"20060","60373","2020",13,13,0,184605.4,1872.692,101.6154
"20061","60374","2020",29,28,1,161658.8,1769.207,99.41379
"20062","60375","2020",5,5,0,207580,2092.8,115
"20063","60376","2020",2,2,0,212534,2317,90.5
"20064","60377","2020",1,1,0,74000,673,110
"20065","60378","2020",8,8,0,195987.5,2092.625,97.5
"20066","60379","2020",9,9,0,141200,1465.667,98.88889
"20067","60380","2020",31,30,1,174945.2,2113.226,86.09677
"20068","60381","2020",2,2,0,158000,1387,121
"20069","60382","2020",147,92,55,194885.4,2390.986,84.9932
"20070","60383","2020",6,6,0,224891.7,1517,156.6667
"20071","60385","2020",16,16,0,166803.1,2236.5,77.375
"20072","60386","2020",3,3,0,198140,1546,128.6667
"20073","60387","2020",17,17,0,116776.5,1363.529,95.05882
"20074","60388","2020",1,1,0,170000,2464,69
"20075","60389","2020",3,3,0,119000,1453,82.33333
"20076","60390","2020",9,9,0,170603.7,1417.556,119.2222
"20077","60391","2020",4,4,0,336687.5,3114.5,113
"20078","60392","2020",7,7,0,177845.7,1873.286,95.28571
"20079","60393","2020",8,8,0,162575,2185.625,73
"20080","60394","2020",3,3,0,151333.3,1692.667,107
"20081","60395","2020",168,121,47,172448.3,2152.792,82.09524
"20082","60396","2020",6,6,0,159636.7,1806,94.66667
"20083","60397","2020",1,1,0,80000,667,120
"20084","60398","2020",30,23,7,231339.4,2994.533,78.5
"20085","60399","2020",1,1,0,105000,2188,48
"20086","60400","2020",5,5,0,194135.8,1452.6,143
"20087","60401","2020",11,11,0,247132.8,2554.545,111.8182
"20088","60403","2020",30,29,1,215507.6,1686.9,85.83333
"20089","60404","2020",12,11,1,159708.3,2015.083,82.25
"20090","60405","2020",14,14,0,128708.9,1207,106.8571
"20091","60406","2020",8,8,0,182562.5,2040.625,90
"20092","60407","2020",5,5,0,112258,1265.2,86
"20093","60408","2020",7,6,1,188357.1,1650.714,123.5714
"20094","60409","2020",18,18,0,191510.6,2313.611,85.66667
"20095","60410","2020",2,2,0,151500,1503,111.5
"20096","60411","2020",15,15,0,233786,2936.2,89.53333
"20097","60412","2020",15,15,0,237685.9,2651.733,93.53333
"20098","60413","2020",1,1,0,305000,3144,97
"20099","60414","2020",98,73,25,152324.6,1910.276,82.61224
"20100","60416","2020",2,2,0,61000,1926.5,31
"20101","60418","2020",6,6,0,196916.7,1948.5,111
"20102","60420","2020",14,14,0,238571.4,2325.5,102.9286
"20103","60421","2020",8,8,0,316908.1,3218.75,94.375
"20104","60422","2020",1,1,0,420000,2270,185
"20105","60423","2020",16,16,0,158778.1,1647.938,95.4375
"20106","60424","2020",4,4,0,197950,1635.75,114.25
"20107","60425","2020",3,3,0,105333.3,1326.333,75.66667
"20108","60426","2020",7,7,0,180126.7,2052.286,87.42857
"20109","60427","2020",3,3,0,285383.3,2112.333,148.3333
"20110","60428","2020",12,12,0,223550,1933.417,121.5833
"20111","60429","2020",4,4,0,313912.5,2730.75,116.75
"20112","60430","2020",13,13,0,212630.8,1863.154,125.0769
"20113","60431","2020",6,6,0,161505,1722,97.66667
"20114","60432","2020",14,9,5,272029.3,2957.429,90.21429
"20115","60433","2020",16,16,0,224943,2103.312,112.8125
"20116","60434","2020",1,1,0,74000,1057,70
"20117","60435","2020",4,4,0,115000,1273.25,87.5
"20118","60436","2020",1,1,0,198000,900,220
"20119","60438","2020",1,1,0,108000,2400,45
"20120","60439","2020",87,63,24,141150,2023.655,73.32184
"20121","60440","2020",11,11,0,199500,2055.636,103.0909
"20122","60441","2020",9,9,0,282784.7,2610.556,110.1111
"20123","60442","2020",4,4,0,171750,1400,124.25
"20124","60443","2020",6,6,0,140500,1462,96
"20125","60444","2020",2,2,0,114000,1360.5,86.5
"20126","60445","2020",5,5,0,139510,2016,122.2
"20127","60446","2020",50,34,16,208536.6,2746.28,82.56
"20128","60447","2020",8,8,0,245076.2,2098.375,107.875
"20129","60448","2020",12,12,0,176750,1955.167,92.75
"20130","60449","2020",1,1,0,180000,2069,87
"20131","60450","2020",57,42,15,201587.3,2578.982,84.22807
"20132","60451","2020",21,20,1,198694.2,1992.857,105.8571
"20133","60452","2020",11,11,0,294603.6,2403.455,128.4545
"20134","60454","2020",9,8,1,206134.4,2194.333,95.11111
"20135","60456","2020",16,16,0,178765.6,1905.188,100.5
"20136","60457","2020",1,1,0,173000,1201,144
"20137","60458","2020",1,1,0,190000,1959,97
"20138","60459","2020",2,2,0,167500,1782.5,95
"20139","60460","2020",2,2,0,280000,2122.5,131.5
"20140","60461","2020",1,1,0,181000,2479,73
"20141","60462","2020",30,28,2,216693.3,2309.567,100.9333
"20142","60463","2020",197,87,110,127732.2,1734.36,75.7665
"20143","60464","2020",16,16,0,215696.9,2253.812,102.5625
"20144","60465","2020",2,2,0,160000,1383,116
"20145","60466","2020",2,2,0,209000,1986.5,112.5
"20146","60468","2020",3,3,0,142666.7,1636.333,87.33333
"20147","60469","2020",10,10,0,300770,2176.7,141
"20148","60470","2020",8,8,0,145967.4,1685.75,90.375
"20149","60471","2020",143,99,44,122775.3,1429.175,86.07692
"20150","60473","2020",3,3,0,263333.3,2603.333,100.3333
"20151","60474","2020",4,4,0,136612.5,1395,105
"20152","60476","2020",1,1,0,120000,1101,109
"20153","60477","2020",10,10,0,176560,1510.6,121.7
"20154","60479","2020",5,5,0,236050,2398.2,105
"20155","60480","2020",6,6,0,192835.7,1888,110.3333
"20156","60481","2020",6,6,0,220829.2,2220,103.1667
"20157","60482","2020",43,41,2,359565.6,3419.256,110.2326
"20158","60483","2020",5,5,0,102000,1960,58.6
"20159","60484","2020",6,6,0,162666.7,1884.833,89.5
"20160","60485","2020",3,3,0,162500,1436.333,114.6667
"20161","60486","2020",12,12,0,148941.7,1395.75,102.3333
"20162","60487","2020",4,4,0,208750,1783.75,118
"20163","60488","2020",5,5,0,149100,1287.6,131.8
"20164","60489","2020",20,19,1,253107.5,2401.7,117.2
"20165","60490","2020",4,4,0,180250,2278.5,80.75
"20166","60491","2020",34,30,4,210182.4,2277.206,101.9412
"20167","60492","2020",17,17,0,168552.4,1945,89.29412
"20168","60493","2020",4,4,0,128500,1752,89.25
"20169","60494","2020",22,18,4,306784.5,3362.409,96.90909
"20170","60495","2020",11,11,0,110034.7,1091.909,104.4545
"20171","60496","2020",3,3,0,141783.3,1532.333,92
"20172","60497","2020",3,3,0,202333.3,1939,104.6667
"20173","60498","2020",1,1,0,124000,1204,103
"20174","60499","2020",2,2,0,188850,1292,149
"20175","60500","2020",56,28,28,217143.9,3182.304,70.66071
"20176","60501","2020",11,11,0,178821.4,1837.455,97.72727
"20177","60503","2020",1,1,0,110000,1467,75
"20178","60504","2020",17,17,0,231950,2067.588,115.9412
"20179","60505","2020",13,10,3,269066.9,3088.462,90.23077
"20180","60506","2020",8,8,0,124312.5,1694.5,76.25
"20181","60507","2020",5,5,0,105800,950.6,113
"20182","60508","2020",40,32,8,189111.8,2308.775,83.225
"20183","60509","2020",162,102,60,165144.4,2183.272,76.38272
"20184","60510","2020",11,11,0,195818.2,2038,98.63636
"20185","60511","2020",5,5,0,152800,1752,91.6
"20186","60512","2020",7,7,0,249642.9,2304.286,109.8571
"20187","60513","2020",46,39,7,261430.5,2970.587,88.95652
"20188","60514","2020",2,2,0,188500,1544.5,127
"20189","60515","2020",2,2,0,202000,1967.5,102.5
"20190","60516","2020",9,9,0,147388.9,1636.778,90.33333
"20191","60517","2020",9,8,1,225363.9,2637.333,88.44444
"20192","60518","2020",3,3,0,153333.3,1531.333,107
"20193","60519","2020",1,1,0,1e+05,1250,80
"20194","60520","2020",2,2,0,175500,1657,106
"20195","60521","2020",6,6,0,103166.7,1445.833,70.5
"20196","60522","2020",2,2,0,111000,1215,97
"20197","60523","2020",14,14,0,215282.5,2156.357,101.5
"20198","60524","2020",44,23,21,147427.3,2144.182,72.06818
"20199","60525","2020",3,3,0,202000,2488.667,78
"20200","60526","2020",18,14,4,110127.8,1666.167,76.44444
"20201","60528","2020",2,2,0,169750,2060.5,85
"20202","60530","2020",2,2,0,154750,1998,74
"20203","60531","2020",10,10,0,263110,2113.6,131
"20204","60533","2020",26,24,2,135801.9,1832.538,79.65385
"20205","60534","2020",11,11,0,231104.5,2201,109.0909
"20206","60535","2020",2,2,0,132500,864.5,153.5
"20207","60536","2020",4,4,0,291814.8,2358.25,122.25
"20208","60537","2020",37,35,2,152525.7,1908.432,81.56757
"20209","60538","2020",4,4,0,188250,1745,122
"20210","60539","2020",12,12,0,226683.3,2212.75,106.5833
"20211","60541","2020",6,6,0,244879.2,2094.667,123.5
"20212","60542","2020",14,14,0,197752.1,2374.357,84.21429
"20213","60543","2020",1,1,0,296000,1794,165
"20214","60544","2020",3,3,0,105000,1060,101
"20215","60545","2020",5,5,0,105660,1209.8,86.6
"20216","60546","2020",2,2,0,255500,4057.5,67
"20217","60547","2020",8,8,0,272194.9,2469.5,110.25
"20218","60548","2020",6,6,0,261000,2442.5,110.5
"20219","60549","2020",3,3,0,132000,1022.333,125
"20220","60550","2020",1,1,0,170000,1441,118
"20221","60551","2020",6,6,0,354166.7,2159.167,160.5
"20222","60552","2020",1,1,0,198000,990,200
"20223","60554","2020",10,10,0,167885,1869.1,91.2
"20224","60555","2020",2,2,0,92500,1221.5,75
"20225","60556","2020",1,1,0,55000,1410,39
"20226","60557","2020",5,5,0,156600,1704,97.4
"20227","60558","2020",12,12,0,157358.3,1818.167,88.41667
"20228","60559","2020",6,6,0,196666.7,1809.333,113
"20229","60560","2020",6,6,0,330127.7,2778.667,120.1667
"20230","60561","2020",2,2,0,281775,3013,103
"20231","60562","2020",16,16,0,241455.1,2303.438,110.5
"20232","60563","2020",10,10,0,198550,2102.1,97.3
"20233","60564","2020",1,1,0,139000,2279,61
"20234","60565","2020",10,10,0,154054.6,1746.1,94
"20235","60566","2020",5,5,0,119100,1280.2,92.6
"20236","60567","2020",7,7,0,151222.9,2008.143,81.85714
"20237","60568","2020",2,2,0,149750,1679,88.5
"20238","60569","2020",6,6,0,431000,2681,157.3333
"20239","60570","2020",23,22,1,227676.1,2517,93.91304
"20240","60572","2020",2,2,0,175250,2200.5,87
"20241","60573","2020",2,2,0,138500,1763,77
"20242","60574","2020",9,9,0,196188.9,1996,101
"20243","60575","2020",49,44,5,206725.3,2108.388,103.8776
"20244","60576","2020",4,4,0,153566,1628.5,95.25
"20245","60577","2020",24,24,0,130270.8,1742,79.125
"20246","60578","2020",15,13,2,222669.8,2548.333,93.73333
"20247","60579","2020",8,8,0,326812.5,2725,123.375
"20248","60581","2020",60,42,18,122732.3,1652.1,76.35
"20249","60582","2020",12,12,0,182116.7,2016.75,90.75
"20250","60583","2020",5,5,0,205200,1831.4,114.8
"20251","60584","2020",43,35,8,221194.3,2759.07,81.67442
"20252","60585","2020",3,3,0,143333.3,1552.333,93
"20253","60586","2020",13,13,0,205283.5,2058.077,104.5385
"20254","60587","2020",21,18,3,204842.9,2054.905,100.2381
"20255","60588","2020",3,3,0,145000,1147.667,127.3333
"20256","60589","2020",30,19,11,215803.3,2733.233,80.4
"20257","60590","2020",10,10,0,150989.9,1522.1,101.7
"20258","60591","2020",16,16,0,199076.2,2158.062,96.25
"20259","60592","2020",11,11,0,111022,1440,75.81818
"20260","60593","2020",2,2,0,138500,1680.5,83
"20261","60594","2020",5,5,0,170540,1502.2,115.6
"20262","60595","2020",3,3,0,201566.7,2398.667,99
"20263","60596","2020",5,5,0,108000,1395.8,79.2
"20264","60597","2020",14,14,0,200202.9,2252.929,90.35714
"20265","60598","2020",8,8,0,240125,2819.625,81.875
"20266","60599","2020",1,1,0,195000,2031,96
"20267","60600","2020",4,4,0,229871.2,2380,94.75
"20268","60601","2020",8,5,3,130737.5,2060,64.75
"20269","60603","2020",12,10,2,153150,1277.5,128.8333
"20270","60604","2020",2,2,0,108500,1505,72.5
"20271","60605","2020",3,3,0,134800,1081,126.3333
"20272","60608","2020",5,5,0,122300,1218,97.2
"20273","60609","2020",17,17,0,198679.4,1793.941,109.8235
"20274","60610","2020",11,11,0,134281.8,1322.182,93.72727
"20275","60611","2020",7,7,0,144714.4,1530.429,100.1429
"20276","60612","2020",193,75,118,266698.5,3224.062,83.47668
"20277","60613","2020",2,2,0,249000,2100,119
"20278","60614","2020",1,1,0,185000,3083,60
"20279","60615","2020",2,2,0,64500,770.5,76.5
"20280","60616","2020",36,35,1,156562.4,1826.667,90
"20281","60617","2020",1,1,0,250000,1923,130
"20282","60618","2020",3,3,0,172533.3,2322.667,78.66667
"20283","60619","2020",19,17,2,265510.5,3262.947,84.26316
"20284","60620","2020",9,9,0,264811.1,2194.333,121
"20285","60621","2020",2,2,0,56500,791,64.5
"20286","60622","2020",8,8,0,146337.6,1841.25,84.5
"20287","60623","2020",14,12,2,92292.14,1294.429,73.5
"20288","60624","2020",5,5,0,159000,1943.8,84.4
"20289","60625","2020",6,6,0,154878.2,1519.667,104
"20290","60626","2020",16,16,0,153798.1,1885,91.75
"20291","60627","2020",6,6,0,128916.7,1474.667,89
"20292","60628","2020",8,7,1,145137.5,1932.125,74.875
"20293","60629","2020",3,3,0,109333.3,1142.333,94
"20294","60630","2020",4,4,0,214900,2123.25,114.75
"20295","60631","2020",19,16,3,253465.7,3099.579,83.94737
"20296","60632","2020",14,14,0,125135.6,1388.357,91.78571
"20297","60633","2020",8,8,0,129312.5,1418.625,103
"20298","60634","2020",4,4,0,144000,1063.25,120.25
"20299","60635","2020",15,13,2,169145.3,2421.933,75.86667
"20300","60636","2020",49,45,4,152343.5,1816.837,87.77551
"20301","60637","2020",7,7,0,177571.4,2060.143,96.28571
"20302","60638","2020",9,9,0,216495,2191.222,99
"20303","60639","2020",20,19,1,226668,2737.8,88.85
"20304","60640","2020",1,1,0,248000,1341,185
"20305","60641","2020",25,25,0,167152,1812.6,99.76
"20306","60642","2020",12,12,0,171458.3,1679.833,103.9167
"20307","60643","2020",24,24,0,104458.3,1511.667,76.04167
"20308","60644","2020",26,23,3,213695.4,2024.154,113.0385
"20309","60645","2020",4,4,0,225962.5,2212.25,110.5
"20310","60646","2020",10,10,0,201300,1763.4,117.4
"20311","60647","2020",25,25,0,176087,1915.88,96
"20312","60648","2020",4,4,0,145000,1726,85.75
"20313","60650","2020",7,7,0,199185.7,1993.429,99.57143
"20314","60651","2020",24,24,0,217752.5,2265.75,100.4583
"20315","60652","2020",22,22,0,197421.8,2219.545,101.2727
"20316","60653","2020",4,4,0,137500,1533.25,92.25
"20317","60654","2020",7,7,0,184428.6,1930,113.2857
"20318","60655","2020",6,6,0,103000,1217.167,83.66667
"20319","60656","2020",3,3,0,187833.3,4819.667,66.66667
"20320","60657","2020",3,3,0,158500,1557.333,105
"20321","60658","2020",11,11,0,188090.9,2008.545,97.45455
"20322","60659","2020",2,2,0,253475,1870.5,173
"20323","60660","2020",9,9,0,257524.7,2178.333,117.6667
"20324","60661","2020",11,9,2,160469,2009.545,81.09091
"20325","60662","2020",7,7,0,174183.6,1811.286,97.85714
"20326","60663","2020",3,3,0,186000,2352,78
"20327","60664","2020",3,3,0,142166.7,1726,87
"20328","60665","2020",33,19,14,178524.2,2056.061,87.63636
"20329","60666","2020",21,19,2,253666.7,2980.143,89.19048
"20330","60667","2020",45,32,13,169569.6,2273.422,76.51111
"20331","60668","2020",4,4,0,202875,2049.5,113.75
"20332","60669","2020",6,6,0,263750,2279.667,119.5
"20333","60670","2020",53,47,6,247932.4,2438.547,102.5472
"20334","60671","2020",3,3,0,298033.3,2766,109
"20335","60672","2020",4,4,0,167181.2,1726.25,94.75
"20336","60673","2020",2,2,0,147500,2375,84.5
"20337","60674","2020",17,17,0,227670.1,2068.765,113.0588
"20338","60675","2020",5,5,0,145100,1563,87.2
"20339","60676","2020",4,4,0,140500,1383.75,103.5
"20340","60677","2020",6,6,0,140333.3,1475.5,99.16667
"20341","60678","2020",17,16,1,235197.1,2678.471,95.35294
"20342","60679","2020",2,2,0,194375,2366.5,83
"20343","60681","2020",9,9,0,213531.1,1975.778,130.7778
"20344","60682","2020",10,10,0,321097,2954.8,117.6
"20345","60683","2020",4,4,0,181838,1845,92.5
"20346","60684","2020",74,52,22,176499.3,2472.973,78.33784
"20347","60685","2020",8,8,0,193990.6,2244.5,90
"20348","60686","2020",37,36,1,258700,2924.892,94.10811
"20349","60687","2020",2,2,0,148500,2078,77
"20350","60688","2020",2,2,0,283750,1742,173
"20351","60689","2020",18,18,0,298091.1,2132.833,143.6111
"20352","60691","2020",6,6,0,150166.7,1512.333,94.33333
"20353","60692","2020",5,5,0,118312.8,1348,97.4
"20354","60693","2020",2,2,0,117500,971.5,132
"20355","60695","2020",29,22,7,355233,3656.517,107.5517
"20356","60698","2020",7,7,0,177934.4,1672.429,112.2857
"20357","60699","2020",2,2,0,145500,1521,110.5
"20358","60700","2020",17,17,0,208447.6,2427.235,88.11765
"20359","60701","2020",12,11,1,136033.2,1447.667,93.91667
"20360","60702","2020",2,2,0,118000,2560,84
"20361","60703","2020",6,6,0,204585,1963.667,108.3333
"20362","61001","2020",351,204,147,104850,1285.846,81.18519
"20363","61002","2020",12,12,0,100250,1072.667,91.16667
"20364","61005","2020",3,3,0,85633.33,1091.333,79.33333
"20365","61006","2020",125,95,30,115015.6,1414.112,83.352
"20366","61007","2020",64,62,2,93597.33,1072.734,91.40625
"20367","61008","2020",17,17,0,100552.9,1166.118,89.11765
"20368","61010","2020",3,3,0,243831.7,1298.333,160.6667
"20369","61011","2020",3,3,0,166120,1404.333,126.6667
"20370","61012","2020",7,7,0,96626.43,1064.429,85.28571
"20371","61013","2020",3,3,0,107333.3,830,127
"20372","61014","2020",6,6,0,276552.3,1624,136.3333
"20373","61015","2020",6,6,0,100500,1528.5,66.5
"20374","61017","2020",3,3,0,122166.7,1623.333,75
"20375","61018","2020",1,1,0,149000,1120,133
"20376","61020","2020",1,1,0,167000,1031,162
"20377","61021","2020",4,4,0,74000,944.75,77.75
"20378","61023","2020",11,11,0,151027.3,1387.545,108
"20379","61024","2020",2,2,0,1e+05,1178.5,81.5
"20380","61026","2020",3,3,0,93666.67,1306,65
"20381","61028","2020",14,14,0,113128.6,1074.786,107.2857
"20382","61029","2020",13,13,0,108611.5,1022.077,106.1538
"20383","61030","2020",1,1,0,79000,975,81
"20384","61032","2020",5,5,0,131188,1427.2,98.6
"20385","61034","2020",4,4,0,155000,1295.5,150
"20386","61035","2020",4,4,0,101250,1090.25,88.25
"20387","61036","2020",5,5,0,134800,1341.8,109
"20388","61037","2020",1,1,0,360000,1593,226
"20389","61038","2020",21,18,3,116744.8,1475.143,81.47619
"20390","61039","2020",1,1,0,189500,1579,120
"20391","61040","2020",10,10,0,84485,1092,81.8
"20392","61043","2020",13,13,0,108923.1,1163.308,94.23077
"20393","61044","2020",4,4,0,152747.5,1326.75,120
"20394","61046","2020",2,2,0,87950,796,100.5
"20395","61048","2020",1,1,0,117000,1376,85
"20396","61049","2020",1,1,0,60000,571,105
"20397","61050","2020",25,25,0,201383.2,1648.12,113.92
"20398","61051","2020",2,2,0,227500,2425,95.5
"20399","61052","2020",4,4,0,118000,1274.5,92.25
"20400","61053","2020",4,4,0,94625,1114.25,84.25
"20401","61054","2020",7,7,0,95357.14,1171.429,92.71429
"20402","61055","2020",11,11,0,74309.09,779.1818,86.63636
"20403","61056","2020",1,1,0,266000,2046,130
"20404","61060","2020",2,2,0,152500,1544,107
"20405","61061","2020",39,38,1,108161.5,1285.103,84.30769
"20406","61062","2020",2,2,0,150000,1056,143.5
"20407","61063","2020",18,17,1,97111.11,1033,94.5
"20408","61064","2020",3,3,0,251000,2305.667,110.6667
"20409","61066","2020",3,3,0,106100,684.6667,151.3333
"20410","61067","2020",4,4,0,214500,1416.75,156
"20411","61069","2020",1,1,0,113500,631,180
"20412","61070","2020",6,6,0,85897.33,1112.667,77.66667
"20413","61071","2020",8,8,0,143505.4,1190.375,119.125
"20414","61072","2020",7,7,0,116071.4,1275.286,88.85714
"20415","61074","2020",6,5,1,66666.67,823.6667,90.83333
"20416","61075","2020",19,19,0,93072.21,946.4211,100.2105
"20417","61076","2020",1,1,0,188500,1178,160
"20418","61077","2020",8,8,0,116255,1251.375,93.875
"20419","61078","2020",7,7,0,95028.71,1098.857,83.85714
"20420","61079","2020",31,31,0,108784.5,1230.484,84
"20421","61080","2020",3,3,0,87666.67,799.6667,108
"20422","61081","2020",8,8,0,119637.5,1072.125,111.25
"20423","61082","2020",1,1,0,120000,1026,117
"20424","61086","2020",4,4,0,140500,1459,97.5
"20425","61087","2020",5,5,0,128200,1245,109.6
"20426","61088","2020",4,4,0,146495.5,2758,62.5
"20427","61089","2020",3,3,0,153166.7,1421.667,100
"20428","61091","2020",8,8,0,159941.2,1037.625,139
"20429","61092","2020",11,11,0,133720,1496.818,89.18182
"20430","61093","2020",12,12,0,90907.5,1044.75,86.08333
"20431","61094","2020",9,9,0,117966.7,1422.778,83.66667
"20432","61095","2020",1,1,0,165000,2171,76
"20433","61096","2020",27,27,0,76461.85,871.7778,89.96296
"20434","61097","2020",14,14,0,127929.4,1363.214,98.07143
"20435","61098","2020",3,3,0,133000,1426.667,93.66667
"20436","61099","2020",5,5,0,93300,1006.8,94.4
"20437","61100","2020",2,2,0,108750,1538.5,71
"20438","61101","2020",1,1,0,103000,1212,85
"20439","61102","2020",6,6,0,102350,945.8333,99.66667
"20440","61103","2020",3,3,0,120666.7,2446.333,70
"20441","61104","2020",1,1,0,63000,663,95
"20442","61105","2020",4,4,0,185252.5,1525,114.75
"20443","61107","2020",6,6,0,104622.8,1219.667,99.16667
"20444","61108","2020",5,5,0,118480,1822.8,80.6
"20445","61111","2020",3,3,0,164000,1434.667,120
"20446","61113","2020",2,2,0,315000,1601,180
"20447","61114","2020",2,2,0,152500,1480.5,102.5
"20448","61116","2020",35,34,1,124337.1,1250.257,103.4286
"20449","61117","2020",36,34,2,159325,1750.639,99.19444
"20450","61118","2020",2,2,0,124125,1372.5,90.5
"20451","61120","2020",3,3,0,259583.3,1647.667,192
"20452","61121","2020",10,10,0,122960,1120.1,107.5
"20453","61122","2020",2,2,0,194500,1865,105
"20454","61123","2020",2,2,0,134750,1422,96
"20455","61124","2020",7,7,0,112699.3,1010.857,114.4286
"20456","61126","2020",3,3,0,116433.3,1205.333,92.33333
"20457","61129","2020",3,3,0,190000,1160.333,162.3333
"20458","61130","2020",5,5,0,99470,1236.2,80
"20459","61133","2020",15,15,0,114172,1322.8,89.46667
"20460","61138","2020",3,3,0,456625.7,5212.667,84
"20461","61139","2020",8,8,0,248466.4,1706.25,119
"20462","61140","2020",8,8,0,171506.2,1604.125,100.875
"20463","61141","2020",6,6,0,151243.3,1259.667,119.5
"20464","61142","2020",4,4,0,171537.5,1690,95.25
"20465","61143","2020",40,39,1,128976,1451.85,88.5
"20466","61145","2020",55,52,3,105697.3,993.2182,105.8909
"20467","61146","2020",3,3,0,141800,1351,103.6667
"20468","61148","2020",3,3,0,130368.3,1412.667,88
"20469","61149","2020",2,2,0,113250,1069,91.5
"20470","61150","2020",12,12,0,141891.7,1401.667,106.8333
"20471","61151","2020",7,7,0,128214.3,1297,105
"20472","61152","2020",4,4,0,153175,1196,144
"20473","61153","2020",23,22,1,124847.8,1550.609,89.91304
"20474","61156","2020",8,7,1,51737.5,677.75,76.25
"20475","61158","2020",1,1,0,75000,872,86
"20476","61159","2020",2,2,0,108000,883.5,111
"20477","61160","2020",7,7,0,136671.4,1450.714,89.28571
"20478","61162","2020",5,5,0,133200,1278.4,111.4
"20479","61163","2020",18,17,1,103838.9,1165.111,87.05556
"20480","61164","2020",1,1,0,77500,816,95
"20481","61165","2020",14,14,0,190778.6,2159,98.14286
"20482","61166","2020",5,5,0,91593.4,1111,81.6
"20483","61167","2020",54,53,1,92539.19,1003.593,95.33333
"20484","61168","2020",53,49,4,100131.5,1031.547,96.71698
"20485","61169","2020",8,8,0,94807.75,1110.125,82.125
"20486","61170","2020",2,2,0,118000,1017,111
"20487","61171","2020",2,2,0,106250,1052,86.5
"20488","61176","2020",3,3,0,69400,1027.667,73
"20489","61178","2020",1,1,0,88000,1143,77
"20490","61180","2020",7,7,0,161766.1,1358.143,112.2857
"20491","61181","2020",26,22,4,84019.23,926.9231,92.92308
"20492","61182","2020",5,5,0,77400,1000.2,77.6
"20493","61183","2020",5,5,0,150000,1485,114.8
"20494","61187","2020",4,4,0,154062.5,1572.5,103
"20495","61188","2020",2,2,0,240922,1221.5,191
"20496","61189","2020",6,6,0,89650,1197.667,87.66667
"20497","61190","2020",2,2,0,123500,1038,121
"20498","61192","2020",2,2,0,115000,1112.5,101
"20499","61193","2020",7,7,0,98657.14,1028.714,90.85714
"20500","61194","2020",10,10,0,166900,1320.9,132.2
"20501","61195","2020",3,3,0,126500,977,120.3333
"20502","61196","2020",26,25,1,139303.1,1453.808,103.2692
"20503","61197","2020",5,5,0,81800,999.8,87.8
"20504","61198","2020",2,2,0,164735,1110.5,140.5
"20505","61199","2020",9,9,0,123916.7,1000.556,133.3333
"20506","61202","2020",8,8,0,169262.5,1076.875,148.5
"20507","61203","2020",22,22,0,156294.1,1531.591,102.6364
"20508","61206","2020",4,4,0,113625,1351.5,81.75
"20509","61207","2020",15,15,0,125166.7,1220.6,98.06667
"20510","61208","2020",6,6,0,179210,1551.5,123.8333
"20511","61209","2020",9,9,0,121016.7,960,119.5556
"20512","61210","2020",3,3,0,63600,1051.333,61
"20513","61211","2020",30,30,0,108293.3,1212.433,102
"20514","61212","2020",2,2,0,145000,1678.5,86.5
"20515","61213","2020",6,6,0,112083.3,1699.667,87.33333
"20516","61214","2020",93,82,11,111448.9,1246.839,90.6129
"20517","61215","2020",6,6,0,104268.3,1321.833,81
"20518","61216","2020",3,3,0,105666.7,1237,95.66667
"20519","61217","2020",2,2,0,82500,988,84.5
"20520","61218","2020",16,16,0,104896.9,1279.312,82.5
"20521","61219","2020",3,3,0,136300,1860,71
"20522","61221","2020",3,3,0,113194.7,1085,105
"20523","61222","2020",7,7,0,98857.14,924.5714,114.2857
"20524","61224","2020",6,6,0,161666.8,1634.667,103
"20525","61228","2020",14,14,0,106007.1,1383.429,81.14286
"20526","61229","2020",3,3,0,196666.7,1776.333,112
"20527","61230","2020",90,90,0,139123.8,1469.489,101.4556
"20528","61232","2020",15,15,0,79217.27,815.8667,106.3333
"20529","61233","2020",3,3,0,138333.3,1406.333,99.66667
"20530","61234","2020",15,15,0,158200,1323.933,122.9333
"20531","61237","2020",5,5,0,110702,1233.2,86.4
"20532","61238","2020",2,2,0,117000,1670.5,70.5
"20533","61240","2020",13,13,0,110123.2,1046.769,104.6923
"20534","61241","2020",16,16,0,127665,1256.438,98.125
"20535","61242","2020",9,9,0,154277.8,1902.556,91.55556
"20536","61243","2020",7,7,0,87342.86,1134.571,80.71429
"20537","61244","2020",4,4,0,95500,1074.25,86.75
"20538","61248","2020",9,9,0,79736.67,922.4444,84.33333
"20539","61251","2020",1,1,0,125400,1475,85
"20540","61252","2020",2,2,0,82750,814,104.5
"20541","61255","2020",18,18,0,98889.44,1245.444,94.88889
"20542","61256","2020",3,3,0,107833.3,1068.667,103.3333
"20543","61257","2020",1,1,0,148000,1663,89
"20544","61258","2020",9,9,0,105489,1186,88.11111
"20545","61259","2020",3,3,0,151666.7,1284,121
"20546","61260","2020",7,7,0,75049.86,786.7143,84.57143
"20547","61261","2020",3,3,0,78333.33,1119.667,71
"20548","61262","2020",2,2,0,99750,1614,64
"20549","61263","2020",6,6,0,149916.7,1385.833,97.83333
"20550","61265","2020",3,3,0,52366.67,712.6667,78
"20551","61266","2020",4,4,0,127500,1428.75,94.5
"20552","61267","2020",4,4,0,131000,877.75,148.5
"20553","61268","2020",4,4,0,118550,1549.25,74.75
"20554","61269","2020",7,7,0,155557.1,970.8571,137.4286
"20555","61271","2020",2,2,0,145350,1111.5,127
"20556","61272","2020",1,1,0,105000,981,107
"20557","61273","2020",1,1,0,127000,1427,89
"20558","61274","2020",5,5,0,162960,1286.4,140.4
"20559","61275","2020",19,19,0,64644.21,854.3158,88.84211
"20560","61276","2020",3,3,0,88000,792,109.6667
"20561","61277","2020",2,2,0,361750,1701.5,211
"20562","61278","2020",16,16,0,114756.6,1370.062,81.875
"20563","61279","2020",8,8,0,170606.2,1434,134.625
"20564","61281","2020",3,3,0,102666.7,918.6667,110.3333
"20565","61283","2020",2,2,0,110000,1641.5,67
"20566","61284","2020",5,5,0,210512.8,1472.2,139.2
"20567","61286","2020",1,1,0,208550,1328,157
"20568","61287","2020",7,6,1,92128.57,1098.143,85.42857
"20569","61288","2020",3,3,0,107666.7,1142,94.66667
"20570","61289","2020",2,2,0,87500,757.5,119.5
"20571","61290","2020",4,4,0,98750,1043.5,95.5
"20572","61292","2020",5,5,0,114860,1477,91
"20573","61293","2020",53,51,2,158681.3,1560.094,105.8868
"20574","61294","2020",9,9,0,74933.33,1019,73.88889
"20575","61295","2020",2,2,0,187000,1173.5,158.5
"20576","61297","2020",8,7,1,40038.75,700.875,59.5
"20577","61298","2020",4,4,0,261375,1834,155
"20578","61300","2020",10,10,0,176100,1410.1,128.3
"20579","61301","2020",1,1,0,18000,600,30
"20580","61303","2020",5,5,0,115000,953.2,117.8
"20581","61304","2020",2,2,0,106635,1356,79.5
"20582","61307","2020",10,10,0,118103.4,1313.9,103
"20583","61308","2020",1,1,0,119000,1384,86
"20584","61309","2020",39,39,0,139910.6,1471.641,96.89744
"20585","61310","2020",2,2,0,96500,946.5,115.5
"20586","61314","2020",7,7,0,108357.1,1254.857,85.57143
"20587","61316","2020",1,1,0,149000,1447,103
"20588","61317","2020",2,2,0,65000,1026,79
"20589","61319","2020",5,5,0,163800,1548.2,101.2
"20590","61321","2020",1,1,0,30000,556,54
"20591","61323","2020",2,2,0,75500,1647.5,47.5
"20592","61324","2020",24,24,0,91110.88,942.75,97.5
"20593","61326","2020",2,2,0,104000,881.5,117
"20594","61327","2020",9,9,0,214111.1,2928,91.22222
"20595","61328","2020",3,3,0,169333.3,1435.667,118.3333
"20596","61329","2020",7,7,0,100314.3,1148.143,90.14286
"20597","61330","2020",6,6,0,117543.3,801.3333,135.6667
"20598","61331","2020",6,6,0,162916.7,1101.5,142.6667
"20599","61332","2020",1,1,0,80000,1000,80
"20600","61333","2020",3,3,0,130833.3,1199.667,94
"20601","61336","2020",4,4,0,225075,1831.5,132.25
"20602","61339","2020",41,41,0,109999.3,1186.829,96.43902
"20603","61341","2020",21,21,0,166698.1,1386.905,120.619
"20604","61342","2020",21,21,0,104271.4,1122.143,90.47619
"20605","61344","2020",14,14,0,112714.7,1153.643,107.2143
"20606","61345","2020",45,45,0,126952,1293.511,97.48889
"20607","61346","2020",9,9,0,188216.1,1441.667,122.6667
"20608","61347","2020",2,2,0,76000,803,99
"20609","61348","2020",5,5,0,144230,1372.8,103.8
"20610","61349","2020",2,2,0,50000,845.5,70.5
"20611","61350","2020",2,2,0,76500,979.5,78
"20612","61351","2020",4,4,0,150375,1275.5,117
"20613","61352","2020",2,2,0,146500,1120,136.5
"20614","61357","2020",2,2,0,66000,769,92.5
"20615","61358","2020",2,2,0,87635,1186.5,75.5
"20616","61360","2020",5,5,0,135800,1667.2,79.2
"20617","61361","2020",1,1,0,70000,729,96
"20618","61362","2020",3,3,0,110225,1385,80
"20619","61363","2020",4,4,0,124250,1848.25,74.5
"20620","61365","2020",10,10,0,137083.5,1229.2,113.8
"20621","61366","2020",2,2,0,103750,1050.5,113
"20622","61367","2020",3,3,0,234666.7,1405.333,171.6667
"20623","61369","2020",12,12,0,89186.67,968.1667,91.08333
"20624","61370","2020",2,2,0,67500,982,68.5
"20625","61371","2020",2,2,0,55750,1008.5,56.5
"20626","61372","2020",3,3,0,133333.3,1643.333,82
"20627","61373","2020",7,7,0,157494.3,1550.286,102.8571
"20628","61374","2020",2,2,0,67350,895,77.5
"20629","61375","2020",20,20,0,168225,1306.45,131.35
"20630","61376","2020",11,11,0,76768.64,744.6364,93.18182
"20631","61379","2020",12,12,0,184833.3,1597.833,118.5
"20632","61381","2020",1,1,0,65000,1327,49
"20633","61382","2020",15,15,0,123837.3,1175.267,102
"20634","61385","2020",10,10,0,119500,1406.9,95.1
"20635","61386","2020",10,10,0,100650,982.6,109.7
"20636","61387","2020",12,12,0,84279.17,1291.833,69.41667
"20637","61388","2020",9,9,0,73444.44,1143.667,72.66667
"20638","61389","2020",15,15,0,83813.33,985.6,83.66667
"20639","61390","2020",1,1,0,80000,1176,68
"20640","61391","2020",57,48,9,104575.4,1264.351,82.61404
"20641","61392","2020",3,3,0,107000,1287.667,77
"20642","61393","2020",5,5,0,254435.4,2723,88.6
"20643","61394","2020",16,16,0,120250,1298.5,89.125
"20644","61395","2020",5,5,0,147600,1276.2,120.4
"20645","61397","2020",48,47,1,144321.8,1558.958,92.20833
"20646","61398","2020",1,1,0,142000,893,159
"20647","61400","2020",7,7,0,159000,1480.143,125.7143
"20648","61401","2020",1,1,0,157500,949,166
"20649","61402","2020",7,7,0,68857.14,962.5714,73.42857
"20650","61404","2020",9,9,0,142201.1,1529.222,94.22222
"20651","61405","2020",4,4,0,134750,808.75,150.5
"20652","61406","2020",3,3,0,80666.67,700.6667,118.3333
"20653","61407","2020",8,8,0,96125,1194.5,80.375
"20654","61408","2020",5,5,0,77720,824.8,98.4
"20655","61411","2020",7,7,0,114700,1447,86.28571
"20656","61412","2020",3,3,0,107700,1023,100
"20657","61413","2020",3,3,0,103264,1063.333,97.66667
"20658","61414","2020",12,12,0,105916.7,1218.167,87.75
"20659","61415","2020",6,6,0,204210.5,2005.5,131.1667
"20660","61418","2020",4,4,0,191750,1748.75,120.25
"20661","61419","2020",7,7,0,109071.4,1147.143,100.4286
"20662","61421","2020",11,11,0,75955.82,788.6364,91
"20663","61422","2020",14,13,1,117955.7,1101.571,106.2143
"20664","61423","2020",13,13,0,106692.3,1359.846,79.46154
"20665","61424","2020",1,1,0,120000,1043,115
"20666","61425","2020",5,5,0,136400,1349.2,93.2
"20667","61426","2020",20,20,0,123644,1642.2,81.9
"20668","61427","2020",5,5,0,120000,978.8,126.2
"20669","61429","2020",18,18,0,150179.8,1795,92.16667
"20670","61432","2020",3,3,0,141666.7,1080,134.3333
"20671","61433","2020",3,3,0,223666.7,3431,92
"20672","61435","2020",6,6,0,185000,1748.167,119.8333
"20673","61436","2020",3,3,0,113000,1338.667,100
"20674","61438","2020",2,2,0,227500,2270,100
"20675","61439","2020",5,5,0,107100,1038.6,89.4
"20676","61440","2020",7,7,0,134285.7,1535.571,85.85714
"20677","61442","2020",1,1,0,139700,896,156
"20678","61443","2020",5,5,0,117780,1371.6,85.4
"20679","61444","2020",3,3,0,121000,1440,79.33333
"20680","61445","2020",7,7,0,97162.86,967.1429,95.85714
"20681","61446","2020",6,6,0,116333.3,1551,88.83333
"20682","61447","2020",8,8,0,104354.1,1178.875,85.875
"20683","61448","2020",2,2,0,155750,1001,154.5
"20684","61450","2020",1,1,0,380000,3800,100
"20685","61451","2020",2,2,0,36500,522,70.5
"20686","61452","2020",5,5,0,87780,1002.4,84.2
"20687","61453","2020",5,5,0,87000,771.8,108.2
"20688","61454","2020",5,5,0,109700,1316.2,96.6
"20689","61456","2020",19,19,0,122500,1217.105,102.5789
"20690","61457","2020",7,7,0,154546.4,1675.571,100.4286
"20691","61459","2020",3,3,0,135933.3,1445.667,89.66667
"20692","61460","2020",7,7,0,79721.43,1054,67
"20693","61461","2020",1,1,0,110000,1375,80
"20694","61462","2020",8,8,0,161131.2,1573.75,104.125
"20695","61463","2020",19,19,0,120216.9,1166.474,98.47368
"20696","61464","2020",33,28,5,109094.2,1282.848,104.2424
"20697","61466","2020",20,20,0,119563.8,1125.35,108.2
"20698","61467","2020",1,1,0,223200,1744,128
"20699","61472","2020",5,5,0,158600,2236.2,105.8
"20700","61473","2020",4,4,0,110125,963.5,125.5
"20701","61474","2020",51,51,0,137163.7,1174.49,113.3333
"20702","61475","2020",13,13,0,111269.2,1433.462,78.53846
"20703","61476","2020",3,3,0,170000,1248.333,139
"20704","61479","2020",1,1,0,190000,1776,107
"20705","61480","2020",4,4,0,68500,846.75,82
"20706","61481","2020",4,4,0,179750,1220.25,127
"20707","61482","2020",5,5,0,97600,1237.6,71.8
"20708","61483","2020",110,35,75,88992.93,1661.764,61.07273
"20709","61484","2020",42,41,1,131171.8,1350.69,101.1429
"20710","61485","2020",2,2,0,118925,894.5,129.5
"20711","61486","2020",58,58,0,89302.07,905.7241,99.43103
"20712","61487","2020",3,3,0,96966.67,993,97
"20713","61488","2020",3,3,0,115143,1116.333,94.66667
"20714","61490","2020",2,2,0,110000,1125,91
"20715","61491","2020",57,55,2,125218,1296.158,100.9123
"20716","61493","2020",3,3,0,146893,1149.333,135.3333
"20717","61494","2020",13,12,1,111369.2,971.3846,105.8462
"20718","61497","2020",14,14,0,159514.3,1576,106.5714
"20719","61498","2020",2,2,0,101500,1523.5,63
"20720","61499","2020",3,3,0,149666.7,927,152
"20721","61500","2020",1,1,0,110000,1250,88
"20722","61501","2020",12,12,0,140340.2,1572.083,87.16667
"20723","61502","2020",2,2,0,137400,1120.5,122.5
"20724","61503","2020",8,8,0,82937.5,916,89.375
"20725","61505","2020",1,1,0,257000,2142,120
"20726","61507","2020",5,5,0,224060,1674.2,117.2
"20727","61508","2020",47,41,6,99154.45,1022.383,93.80851
"20728","61510","2020",3,3,0,123333.3,1137,107.3333
"20729","61512","2020",2,2,0,218450,1406.5,159
"20730","62001","2020",20,20,0,203377.5,2023.75,100.65
"20731","62002","2020",2,2,0,103875,960,101
"20732","62003","2020",9,6,3,231278.3,2111.556,108.6667
"20733","62004","2020",131,98,33,150801.4,1848.672,84.87786
"20734","62005","2020",12,12,0,108612.5,1275.5,91.66667
"20735","62006","2020",3,3,0,160000,1034,149
"20736","62007","2020",9,9,0,264855.6,2209.556,125.7778
"20737","62008","2020",6,6,0,193823.2,1918.5,100
"20738","62009","2020",2,2,0,146750,1598.5,91.5
"20739","62010","2020",4,4,0,167362.5,1736.25,97.5
"20740","62011","2020",10,10,0,254641,1709.6,155.4
"20741","62012","2020",2,2,0,291000,2353,126.5
"20742","62013","2020",19,19,0,132252.6,1677,82
"20743","62014","2020",129,117,12,128561.9,1350.302,96.68217
"20744","62015","2020",2,2,0,174000,1763.5,100.5
"20745","62016","2020",2,2,0,337475,1892.5,180
"20746","62017","2020",3,3,0,117900,1206.333,110.3333
"20747","62018","2020",7,7,0,138638.6,1148,118.4286
"20748","62019","2020",43,38,5,163056.3,1642.326,102.2558
"20749","62020","2020",9,9,0,211377.8,1770.333,126.1111
"20750","62021","2020",6,6,0,175050,1752.667,111.6667
"20751","62023","2020",39,39,0,117982.7,1258.667,95.58974
"20752","62024","2020",3,3,0,164750,1738.667,94.33333
"20753","62025","2020",50,36,14,225657,2677.88,90.88
"20754","62026","2020",1,1,0,79335,721,110
"20755","62027","2020",1,1,0,153000,1485,103
"20756","62028","2020",10,10,0,111400,1057.7,106
"20757","62029","2020",6,6,0,115100,1219.667,93.5
"20758","62030","2020",6,6,0,132083.3,1304,101.1667
"20759","62031","2020",12,12,0,155763.3,1284.75,118.8333
"20760","62032","2020",42,42,0,158821.8,1592.429,101.5952
"20761","62033","2020",54,54,0,145294.4,1561.593,93.88889
"20762","62034","2020",27,27,0,153181.1,1538.444,103.037
"20763","62035","2020",69,69,0,140192.9,1397.536,100.9855
"20764","62036","2020",6,6,0,125500,1320.167,96.66667
"20765","62037","2020",38,30,8,219703.7,2137.263,105.4474
"20766","62038","2020",41,41,0,168455,1728.829,104.1463
"20767","62039","2020",10,10,0,172100,1779.5,97
"20768","62040","2020",103,98,5,139408.9,1496.67,94.08738
"20769","62041","2020",656,289,367,139196,2012.184,72.60061
"20770","62042","2020",12,12,0,189770,1779.75,108.5
"20771","62043","2020",19,19,0,175457.9,1736.316,105.7895
"20772","62044","2020",5,5,0,192954,1790.6,115.4
"20773","62045","2020",12,11,1,174889.2,1629.333,111.5
"20774","62046","2020",15,15,0,120976.7,1336.133,90.53333
"20775","62047","2020",2,2,0,120000,896.5,127
"20776","62048","2020",129,121,8,100478.8,1124.705,95.34109
"20777","62049","2020",3,3,0,163633.3,2024.667,79.33333
"20778","62050","2020",14,14,0,101628.6,1062.286,94
"20779","62051","2020",55,55,0,162999,1776.036,92.07273
"20780","62052","2020",8,8,0,218490,1956.75,111.875
"20781","62053","2020",13,13,0,133769.2,1474.231,91.53846
"20782","62054","2020",16,16,0,219878.2,2304.062,100.5625
"20783","62055","2020",7,7,0,188042.9,1513.857,126.5714
"20784","62056","2020",11,10,1,268913.6,3090.182,90.81818
"20785","62057","2020",67,62,5,160733.7,1678.687,97.10448
"20786","62058","2020",1,1,0,220000,1538,143
"20787","62059","2020",4,4,0,190000,1634,124
"20788","62060","2020",33,33,0,82962.58,962.7879,86.33333
"20789","62061","2020",3,3,0,145666.7,1394.333,103
"20790","62063","2020",15,15,0,122923.3,1407.2,89.2
"20791","62064","2020",3,3,0,136000,1126.333,120.6667
"20792","62065","2020",157,141,16,120170.8,1408.268,85.57962
"20793","62067","2020",4,4,0,136450,1404,104.5
"20794","62068","2020",3,3,0,95180,1102.667,89.33333
"20795","62069","2020",2,2,0,172050,1969,82.5
"20796","62070","2020",2,2,0,156700,1580.5,98.5
"20797","62071","2020",5,5,0,136600,1243.6,106.2
"20798","62072","2020",2,2,0,165500,1795.5,91.5
"20799","62073","2020",16,16,0,209359.4,1963.062,109.375
"20800","62074","2020",4,4,0,139000,1328,97.5
"20801","62075","2020",17,17,0,201726.5,1655.588,129.7647
"20802","62076","2020",1,1,0,178000,2342,76
"20803","62077","2020",3,3,0,188500,1990.333,98
"20804","62078","2020",16,16,0,187070.5,1915.375,102.3125
"20805","62080","2020",29,25,4,102155.9,1192.655,88.44828
"20806","62081","2020",7,7,0,166142.9,1613.714,101.4286
"20807","62082","2020",6,6,0,107166.7,1067.333,102.1667
"20808","62083","2020",63,62,1,122607.2,1289.508,99.52381
"20809","62084","2020",3,3,0,106333.3,996,110
"20810","62086","2020",2,2,0,116650,821,146
"20811","62087","2020",8,8,0,155112.5,1582,103.25
"20812","62088","2020",7,7,0,152171.4,1423.714,107.1429
"20813","62089","2020",6,6,0,207583.3,2089.5,103.6667
"20814","62090","2020",3,3,0,142666.7,1059.667,140
"20815","62091","2020",1,1,0,96000,1920,50
"20816","62092","2020",3,3,0,162000,1030,149
"20817","62093","2020",3,3,0,114000,1249.333,91
"20818","62094","2020",3,3,0,107000,1782.667,58.66667
"20819","62095","2020",3,3,0,127000,1075.667,121.6667
"20820","62096","2020",5,5,0,94200,924,109.8
"20821","62097","2020",7,7,0,160471.4,1504.714,105.1429
"20822","62099","2020",81,65,16,160727.3,1787.765,89.77778
"20823","62100","2020",17,17,0,128058.8,1438.471,87.88235
"20824","62102","2020",3,3,0,153333.3,1432.667,107.6667
"20825","62104","2020",3,3,0,220993.3,1755.667,126
"20826","62105","2020",3,3,0,336766.7,1915.333,165
"20827","62106","2020",6,6,0,181795.8,1880.5,97.5
"20828","62108","2020",486,199,287,127526.9,2369.175,58.46914
"20829","62109","2020",2,2,0,86000,904.5,101
"20830","62111","2020",6,6,0,150423.8,1256.333,120.8333
"20831","62112","2020",5,5,0,113500,1160.2,96.6
"20832","62113","2020",5,5,0,168310,1578.8,107.6
"20833","62115","2020",5,5,0,156600,1764.4,94.4
"20834","62116","2020",7,7,0,149000,1454.286,103.4286
"20835","62117","2020",9,9,0,88100,868.4444,103.7778
"20836","62118","2020",2,2,0,120000,1494.5,80.5
"20837","62119","2020",372,246,126,117450.3,1436.355,82.55376
"20838","62120","2020",5,5,0,140740,1259,110.8
"20839","62121","2020",3,3,0,108333.3,1441.333,75.33333
"20840","62122","2020",5,5,0,109600,1055.4,106.4
"20841","62123","2020",8,8,0,192200,1837.375,106.375
"20842","62124","2020",2,2,0,150300,1707,95
"20843","62125","2020",3,3,0,267453.3,2373.333,115.6667
"20844","62126","2020",109,92,17,130141.6,1537.826,90.74312
"20845","62127","2020",1,1,0,110000,1294,85
"20846","62128","2020",54,52,2,139356.6,1543.63,92.98148
"20847","62129","2020",1,1,0,40000,444,90
"20848","62130","2020",9,9,0,108382.4,1098.667,108.4444
"20849","62132","2020",64,64,0,169198.7,1696.234,101.2344
"20850","62133","2020",65,63,2,109060,1324.938,85.66154
"20851","62134","2020",2,2,0,102500,998,103
"20852","62135","2020",5,5,0,179400,1509.2,112.6
"20853","62137","2020",2,2,0,117000,1244,97.5
"20854","62138","2020",12,12,0,118778.3,1201.167,100.8333
"20855","62139","2020",63,63,0,121219.9,1445.746,82.96825
"20856","62140","2020",6,6,0,142758.3,1486.333,97.66667
"20857","62141","2020",3,3,0,143000,1805.333,82
"20858","62142","2020",2,2,0,222500,1491.5,148
"20859","62143","2020",1,1,0,60000,400,150
"20860","62144","2020",6,6,0,224248.5,1866.667,126.8333
"20861","62145","2020",3,3,0,155623.3,1705.667,90.66667
"20862","62146","2020",5,5,0,140596,1234.6,107.8
"20863","62147","2020",3,3,0,194395.7,1515.667,149
"20864","62148","2020",3,3,0,173966.7,1789,99
"20865","62149","2020",1,1,0,247000,2375,104
"20866","62150","2020",4,4,0,169125,1999.25,84
"20867","62151","2020",9,9,0,132263.3,1244.333,107
"20868","62152","2020",2,2,0,173600,1336,123.5
"20869","62153","2020",7,7,0,102907.1,1041.571,95.71429
"20870","62154","2020",9,9,0,122133.3,897.8889,136.2222
"20871","62155","2020",9,9,0,111277.8,1376.111,85.33333
"20872","62156","2020",7,7,0,245707.4,1995.714,127.8571
"20873","62157","2020",1,1,0,2e+05,1600,125
"20874","62158","2020",5,5,0,52900,725.4,85
"20875","62160","2020",471,231,240,118785.2,1459.665,82.52017
"20876","62161","2020",11,11,0,138988.2,1433.182,101.0909
"20877","62162","2020",10,10,0,148115,1248.6,115.2
"20878","62163","2020",4,4,0,103945,1461.75,75.25
"20879","62164","2020",17,17,0,134676.5,1415.647,98.64706
"20880","62166","2020",4,4,0,133750,1769.25,76
"20881","62167","2020",1,1,0,120000,1558,77
"20882","62168","2020",14,14,0,142823.8,1331.643,115.3571
"20883","62169","2020",4,4,0,128750,1436.25,90.25
"20884","62170","2020",20,20,0,196312.4,1725.6,115.15
"20885","62171","2020",6,6,0,147833.3,1196.167,121.3333
"20886","62172","2020",6,6,0,138716.7,1310.667,114.8333
"20887","62173","2020",53,53,0,166438.1,1635.377,103.5472
"20888","62174","2020",15,15,0,193266.7,2021.533,99.26667
"20889","62175","2020",1,1,0,227000,1343,169
"20890","62176","2020",5,5,0,241200,2115.4,101.2
"20891","62177","2020",14,14,0,110211.4,1487.571,75.92857
"20892","62178","2020",184,165,19,105762.3,1187.239,91.3913
"20893","62179","2020",4,4,0,193575,2245,92.25
"20894","62180","2020",1,1,0,90000,796,113
"20895","62181","2020",15,15,0,136727.1,1290.4,108.0667
"20896","62182","2020",7,7,0,160100,1098,135.7143
"20897","62183","2020",7,7,0,112639.3,1270,91.28571
"20898","62184","2020",4,4,0,183947.5,2171,100
"20899","62185","2020",1,1,0,115000,1438,80
"20900","62186","2020",91,79,12,130833.7,1505.549,87.96703
"20901","62188","2020",33,33,0,106386.4,1182.97,88.57576
"20902","62189","2020",2,2,0,211625,1727.5,136
"20903","62190","2020",9,9,0,138372.2,1579.333,88.22222
"20904","62191","2020",4,4,0,168667.5,1658.75,116.25
"20905","62192","2020",5,5,0,146410,1152.8,132.2
"20906","62193","2020",931,719,212,120193.4,1495.81,83.21912
"20907","62194","2020",34,34,0,112239,1297.441,86.5
"20908","62195","2020",12,12,0,154100,1490.167,99.58333
"20909","62196","2020",13,13,0,193332,1726,108.9231
"20910","62197","2020",17,17,0,128482.4,1415.647,90.35294
"20911","62198","2020",2,2,0,178850,1361,131
"20912","62199","2020",6,6,0,231380,1984.167,127.8333
"20913","62200","2020",11,11,0,191518.2,1837.545,107.6364
"20914","62201","2020",165,82,83,129800.3,2685.036,51.55152
"20915","62202","2020",4,4,0,154540.5,1169.5,140
"20916","62203","2020",4,4,0,150250,1446.25,103.25
"20917","62204","2020",2,2,0,156500,1730,110.5
"20918","62205","2020",11,11,0,174698.2,1790.091,101.1818
"20919","62206","2020",1,1,0,230000,2110,109
"20920","62207","2020",6,6,0,192591.7,1834.667,104.1667
"20921","62209","2020",3,3,0,108333.3,1169.333,104
"20922","62211","2020",3,3,0,209500,2454,88.66667
"20923","62212","2020",7,7,0,146084.9,1151.143,118
"20924","62213","2020",12,12,0,286325.6,2100.333,144.75
"20925","62214","2020",6,6,0,218933.3,1889.5,115.5
"20926","62215","2020",200,191,9,150730.6,1628.71,92.375
"20927","62216","2020",2,2,0,147755,1490.5,101
"20928","62217","2020",26,26,0,106053.8,1225.346,89.46154
"20929","62218","2020",7,7,0,126342.9,1180,103.2857
"20930","62219","2020",5,5,0,122657,1097,112.8
"20931","62220","2020",12,12,0,105987.5,1188,90.25
"20932","62221","2020",2,2,0,116000,1373.5,85
"20933","62222","2020",5,5,0,120600,1180.8,113
"20934","62223","2020",4,4,0,178375,1430,130
"20935","62224","2020",31,31,0,141298.4,1368.129,104.4516
"20936","62225","2020",4,4,0,147587.5,1959.5,88
"20937","62228","2020",5,5,0,121000,1603.8,78.8
"20938","62229","2020",4,4,0,150437.5,1412,108.75
"20939","62230","2020",7,7,0,211300,1965.429,110.7143
"20940","62231","2020",2,2,0,82000,962,83
"20941","62232","2020",9,9,0,144019.9,1246.778,115.8889
"20942","62233","2020",7,7,0,150142.9,1714.286,88.57143
"20943","62234","2020",4,4,0,94250,955,103.75
"20944","62235","2020",31,31,0,306287.7,2353.645,133.0968
"20945","62236","2020",6,6,0,79000,854.5,101
"20946","62237","2020",6,6,0,210749.3,2612.667,84
"20947","62239","2020",27,24,3,201558.9,2157.444,95.55556
"20948","62240","2020",30,30,0,127083.5,1443.067,92.7
"20949","62241","2020",8,8,0,251000,1754.5,157.25
"20950","62243","2020",4,4,0,174250,1339.75,131.25
"20951","62244","2020",70,68,2,156967.9,1687.1,96.91429
"20952","62245","2020",8,8,0,163937.5,1868.75,91.125
"20953","62247","2020",4,4,0,157500,1325.75,125.5
"20954","62248","2020",5,5,0,109775.2,1547.4,73.4
"20955","62249","2020",105,105,0,140714.1,1644.733,88.57143
"20956","62250","2020",127,125,2,145303.8,1561.811,94.58268
"20957","62251","2020",3,3,0,172666.7,1816.333,95
"20958","62252","2020",19,19,0,239238.9,1960.474,127.8947
"20959","62254","2020",5,5,0,159920,1175.6,131.4
"20960","62255","2020",3,3,0,194716.7,1723,112.3333
"20961","62256","2020",3,3,0,69000,743.6667,92
"20962","62257","2020",12,12,0,99125,1047.333,96.91667
"20963","62258","2020",2,2,0,171000,1221.5,135
"20964","62259","2020",21,18,3,147846.1,1520.476,104.0952
"20965","62260","2020",1,1,0,130000,1477,88
"20966","62261","2020",259,119,140,202575,3250.896,64.7529
"20967","62262","2020",23,23,0,133103,1336.304,96.13043
"20968","62263","2020",67,67,0,181098.1,1861.94,97.29851
"20969","62264","2020",15,15,0,168136.7,1554.733,107.7333
"20970","62265","2020",7,7,0,127957.1,1124.429,117.4286
"20971","62266","2020",1,1,0,897000,11649,77
"20972","62267","2020",6,6,0,146333.3,1294.167,122.1667
"20973","62268","2020",79,79,0,98668.35,1184.152,84.98734
"20974","62269","2020",9,9,0,125250,1175,106.8889
"20975","62270","2020",73,63,10,105230.8,1173.589,88.08219
"20976","62271","2020",7,7,0,174057.1,1443.286,121.1429
"20977","62272","2020",4,4,0,149675,1744.75,93
"20978","62273","2020",10,10,0,156957,1337.8,124.9
"20979","62274","2020",73,72,1,149071.1,1596.932,95.71233
"20980","62275","2020",7,7,0,129985.7,1405.143,99.57143
"20981","62276","2020",83,82,1,157145.2,1606.108,99.89157
"20982","62277","2020",34,34,0,164247.6,1566,106.6176
"20983","62278","2020",8,8,0,185597.5,1556.125,116.75
"20984","62279","2020",13,13,0,269637.8,1855.846,145.3077
"20985","62280","2020",4,4,0,134625,1737,79
"20986","62281","2020",4,4,0,235625,2560.5,92
"20987","62282","2020",2,2,0,78250,802,97.5
"20988","62283","2020",1,1,0,142000,1340,106
"20989","62284","2020",23,23,0,140921.7,1294.565,110.2174
"20990","62285","2020",7,7,0,159821.4,1226.857,128.4286
"20991","62286","2020",3,3,0,175600,1292,141.6667
"20992","62288","2020",22,22,0,190770.7,1638.727,117.7273
"20993","62289","2020",11,11,0,173409.1,1713.091,106.8182
"20994","62290","2020",4,4,0,216750,1782,113.25
"20995","62291","2020",36,30,6,107631.1,1330.806,81.02778
"20996","62292","2020",10,10,0,169965,1548.6,106.9
"20997","62293","2020",3,3,0,110333.3,1448.333,92
"20998","62295","2020",11,11,0,108477.3,1248.909,88.90909
"20999","62296","2020",3,3,0,187200,1550.333,120
"21000","62297","2020",26,26,0,178867.7,1657,107.6154
"21001","62298","2020",3,3,0,139416.7,1297.333,106.3333
"21002","62299","2020",4,4,0,149438,1452.25,106
"21003","62300","2020",24,23,1,189928.4,2218.417,91.70833
"21004","62301","2020",2,2,0,56500,1118,54
"21005","62302","2020",2,2,0,135600,1316.5,103
"21006","62303","2020",1,1,0,55000,753,73
"21007","62304","2020",8,8,0,68388.75,908.125,73.875
"21008","62306","2020",4,4,0,111250,1113.25,96.25
"21009","62307","2020",4,4,0,210875,3217.5,72.5
"21010","62308","2020",3,3,0,126000,1829.333,90
"21011","62309","2020",22,22,0,137369.5,1400.182,98.5
"21012","62310","2020",12,12,0,151291.7,1578.5,96.5
"21013","62311","2020",20,20,0,165479,1805.1,90.3
"21014","62312","2020",4,4,0,146250,1653,85
"21015","62313","2020",13,13,0,90307.69,1133.615,80.46154
"21016","62314","2020",7,7,0,165014.3,1483.429,118.8571
"21017","62315","2020",3,3,0,263333.3,2314,119.6667
"21018","62316","2020",1,1,0,91000,396,230
"21019","62317","2020",7,7,0,146571.4,1465.571,98.71429
"21020","62318","2020",165,149,16,156986.7,2039.709,80.67879
"21021","62319","2020",2,2,0,161325,1712,94.5
"21022","62320","2020",3,3,0,193250,1595.333,119.6667
"21023","62321","2020",41,41,0,148277.2,1638.244,93.12195
"21024","62322","2020",2,2,0,70000,965.5,80.5
"21025","62323","2020",8,8,0,182170,1575.625,114
"21026","62324","2020",3,3,0,179583.3,2341,76.66667
"21027","62325","2020",11,11,0,167049.2,1807.545,98.27273
"21028","62326","2020",2,2,0,117500,1202,95
"21029","62327","2020",12,12,0,144892.1,1529.417,94.16667
"21030","62328","2020",10,10,0,94666,1032.1,88
"21031","62329","2020",21,21,0,156954.8,1412.714,114.8571
"21032","62330","2020",19,19,0,224991.8,2016.211,116.4737
"21033","62331","2020",13,12,1,150424.1,1812.692,83.53846
"21034","62332","2020",6,6,0,161450,1630.5,100
"21035","62333","2020",4,4,0,95575,868.25,108.5
"21036","62334","2020",13,13,0,192135.4,1514.923,135.3846
"21037","62335","2020",5,5,0,111200,1170,91.6
"21038","62336","2020",7,7,0,112442.9,860.8571,123.1429
"21039","62337","2020",3,3,0,121666.7,1037.667,118
"21040","62338","2020",32,30,2,321029.7,2773.938,116.5312
"21041","62339","2020",2,2,0,103000,565,179
"21042","62340","2020",11,11,0,122681,1014.636,119.8182
"21043","62341","2020",5,5,0,145950,1097.4,130.8
"21044","62342","2020",1,1,0,140000,859,163
"21045","62343","2020",6,6,0,157655,1434.5,115.5
"21046","62344","2020",1,1,0,80000,1600,50
"21047","62347","2020",1,1,0,103000,1120,92
"21048","62348","2020",2,2,0,118200,1094,112.5
"21049","62349","2020",24,24,0,159817.1,1550.083,105.1667
"21050","62350","2020",13,13,0,197246.2,1775.692,113.0769
"21051","62351","2020",65,64,1,125034.6,1465.277,88.15385
"21052","62352","2020",1,1,0,120000,1412,85
"21053","62354","2020",19,19,0,159189.2,1591.053,107.6842
"21054","62355","2020",8,8,0,175411.9,1645.75,105.625
"21055","62356","2020",7,7,0,166773.6,1697.429,100
"21056","62358","2020",2,2,0,282125,1781,172.5
"21057","62359","2020",6,6,0,100750,1096.333,92
"21058","62360","2020",6,6,0,148291.7,1493.333,104.3333
"21059","62361","2020",32,32,0,84634.38,903.4688,96.0625
"21060","62362","2020",2,2,0,212500,2140.5,105.5
"21061","62363","2020",5,5,0,162000,1528,106.6
"21062","62364","2020",19,19,0,116949.6,1043.632,107.7895
"21063","62365","2020",2,2,0,186350,1341,150.5
"21064","62366","2020",5,5,0,94700,1257,77.4
"21065","62367","2020",7,7,0,155962.9,1449.143,105.7143
"21066","62368","2020",1,1,0,45000,643,70
"21067","62369","2020",9,9,0,207666.7,1612.556,137.1111
"21068","62370","2020",2,2,0,128750,1084,120
"21069","62371","2020",25,25,0,207867.7,1764.32,118.96
"21070","62372","2020",1,1,0,30000,395,76
"21071","62373","2020",9,9,0,184385.8,1701.889,108
"21072","62374","2020",2,2,0,109200,1690.5,67
"21073","62376","2020",41,41,0,184283.1,1690.024,108.9024
"21074","62377","2020",7,7,0,116895.6,1398.857,85.71429
"21075","62378","2020",1,1,0,144900,1558,93
"21076","62379","2020",1,1,0,218500,2081,105
"21077","62380","2020",5,5,0,213150,1971.2,108.6
"21078","62381","2020",4,4,0,117695,1202,110.25
"21079","62382","2020",6,6,0,139333.3,1254.333,114.1667
"21080","62383","2020",14,14,0,180735.8,1739.929,104
"21081","62384","2020",6,6,0,119166.7,997.3333,118.5
"21082","62385","2020",5,5,0,69500,680,107.4
"21083","62386","2020",40,39,1,143720.2,1523.55,95.575
"21084","62387","2020",1,1,0,227200,2318,98
"21085","62388","2020",5,5,0,177800,1118.4,153.8
"21086","62390","2020",21,21,0,240303.8,2060.571,118
"21087","62391","2020",19,19,0,140327.9,1581.368,92.31579
"21088","62392","2020",3,3,0,150000,1211,128
"21089","62393","2020",14,14,0,180121.4,1608.143,106.0714
"21090","62396","2020",1,1,0,127000,1165,109
"21091","62397","2020",69,69,0,131950,1464.942,90.66667
"21092","62398","2020",2,2,0,183165,1467,124.5
"21093","62399","2020",6,6,0,199666.7,1875,103.8333
"21094","62400","2020",48,48,0,126135.3,1311.562,99.85417
"21095","62401","2020",52,52,0,159618.6,1841.827,87.65385
"21096","62402","2020",4,4,0,218235,1341.25,168.25
"21097","62403","2020",10,10,0,141115,1522.6,92.3
"21098","62404","2020",2,2,0,149750,1724,87
"21099","62405","2020",4,4,0,220875,1666,136.25
"21100","62406","2020",3,3,0,124093.3,1304,96
"21101","62407","2020",4,4,0,128625,1348.5,95.75
"21102","62408","2020",16,16,0,195093.1,1583.438,127.5
"21103","62409","2020",4,4,0,104900,1162.25,93.75
"21104","62410","2020",3,3,0,99666.67,1307,76.33333
"21105","62411","2020",1,1,0,68000,660,103
"21106","62412","2020",13,13,0,199853.8,1740.769,115.2308
"21107","62413","2020",139,132,7,135926.9,1548.964,89.30935
"21108","62414","2020",5,5,0,198292,1762.6,109.8
"21109","62415","2020",6,6,0,173166.7,1570.167,109.1667
"21110","62416","2020",2,2,0,120500,833,137
"21111","62418","2020",4,4,0,144750,1390,119.75
"21112","62421","2020",8,8,0,128151.2,1217.375,121
"21113","62422","2020",4,4,0,89962.5,936.25,97.5
"21114","62423","2020",11,11,0,190409.1,1543.182,128.5455
"21115","62424","2020",3,3,0,200666.7,1285,163.6667
"21116","62427","2020",350,324,26,127098.1,1341.323,94.94857
"21117","62428","2020",6,6,0,146666.7,1419.167,96.16667
"21118","62429","2020",1,1,0,172000,1303,132
"21119","62432","2020",9,9,0,149611.1,1543.556,102.4444
"21120","62433","2020",1,1,0,204000,1015,201
"21121","62434","2020",2,2,0,106250,791,137
"21122","62436","2020",2,2,0,115000,605,208
"21123","62437","2020",7,7,0,86357.14,950.1429,92.28571
"21124","62438","2020",5,5,0,240260,1911.8,121.2
"21125","62439","2020",2,2,0,231000,1559,148
"21126","62440","2020",18,18,0,107886.1,1019.722,103.8333
"21127","62441","2020",2,2,0,154350,1537.5,100.5
"21128","62442","2020",2,2,0,100500,1179,90
"21129","62443","2020",70,69,1,135935.3,1438.386,97.68571
"21130","62444","2020",4,4,0,219412.5,2899,74.75
"21131","62445","2020",13,11,2,172612.5,1453.692,119.4615
"21132","62446","2020",14,14,0,175658.8,1719.143,108.7143
"21133","62447","2020",28,24,4,91344.64,1004.179,92.42857
"21134","62448","2020",25,24,1,194627.8,1864.2,109.12
"21135","62449","2020",2,2,0,233000,5065,67.5
"21136","62450","2020",3,3,0,144944,1166.667,115.6667
"21137","62451","2020",9,9,0,123000,1142.667,114.4444
"21138","62452","2020",14,14,0,184982.1,1540.929,121.5
"21139","62453","2020",1,1,0,130000,1733,75
"21140","62454","2020",23,23,0,206839.1,1789.478,112.7391
"21141","62456","2020",15,15,0,146976.9,1447.533,100.9333
"21142","62457","2020",61,61,0,119532.1,1320.377,93.77049
"21143","62458","2020",10,10,0,125940,1514.7,84.4
"21144","62460","2020",3,3,0,162333.3,1857.667,87.33333
"21145","62461","2020",15,15,0,117193.3,1089.133,110.0667
"21146","62462","2020",1,1,0,113000,1119,101
"21147","62463","2020",6,6,0,107916.7,1025.5,104.3333
"21148","62464","2020",34,34,0,173039.6,1797.324,97.79412
"21149","62465","2020",3,3,0,96000,957.6667,117.3333
"21150","62466","2020",1,1,0,180000,1395,129
"21151","62467","2020",2,2,0,90000,1433.5,77.5
"21152","62468","2020",1,1,0,129500,1233,105
"21153","62469","2020",5,5,0,149860,1623.6,81.2
"21154","62471","2020",7,7,0,158364.3,1579.429,104.5714
"21155","62472","2020",6,6,0,243866.7,1668.667,148.1667
"21156","62473","2020",122,111,11,102602.6,1217.418,85.62295
"21157","62474","2020",15,14,1,164762,1785.6,91.33333
"21158","62475","2020",4,4,0,135750,1218.25,110.25
"21159","62476","2020",12,12,0,149254.2,1392.5,107.5833
"21160","62477","2020",8,8,0,218588.5,1574.625,140.125
"21161","62478","2020",5,5,0,181920,1706.6,105.8
"21162","62479","2020",20,20,0,130333.8,1365.6,98
"21163","62480","2020",34,34,0,169621.4,1558.559,108.0882
"21164","62481","2020",5,5,0,93900,838.8,124.8
"21165","62483","2020",3,3,0,195606.7,1853.333,108.3333
"21166","62484","2020",5,5,0,108126,1174.6,95.6
"21167","62485","2020",3,3,0,175483.3,1596,110.3333
"21168","62486","2020",14,14,0,116407.1,1374.429,88.14286
"21169","62487","2020",10,10,0,167666.1,1587.3,107.1
"21170","62488","2020",14,14,0,188107.1,1854.429,107.9286
"21171","62489","2020",43,43,0,125561.9,1262.047,99
"21172","62490","2020",2,2,0,176400,1595,111
"21173","62491","2020",78,77,1,208958.4,1932.821,108.7821
"21174","62492","2020",4,4,0,123125,1300.25,98.75
"21175","62493","2020",6,6,0,124633.7,1459.5,89.33333
"21176","62495","2020",2,2,0,199379.5,1416.5,139.5
"21177","62496","2020",1,1,0,240150,1421,169
"21178","62497","2020",65,65,0,151133.7,1556.969,98.06154
"21179","62498","2020",287,196,91,115455.3,1440.638,81.23345
"21180","62499","2020",2,2,0,137000,1206.5,113
"21181","62500","2020",8,8,0,137296.9,1315.25,101.125
"21182","62501","2020",4,4,0,106250,1464.5,73
"21183","62502","2020",62,62,0,235890,1913.016,127.129
"21184","62503","2020",1,1,0,180240,2048,88
"21185","62504","2020",2,2,0,135000,1566,83.5
"21186","62505","2020",3,3,0,259639,1741.667,149
"21187","62506","2020",12,12,0,188350,1457.833,132.1667
"21188","62507","2020",2,2,0,186700,1511.5,123.5
"21189","62508","2020",6,6,0,148333.3,1307,121.1667
"21190","62509","2020",6,6,0,149416.7,1192,121
"21191","62510","2020",225,200,25,119629,1402.267,87.19111
"21192","62511","2020",2,2,0,270000,2221,119
"21193","62512","2020",4,4,0,133620,1243,95
"21194","62513","2020",2,2,0,120000,836,150
"21195","62514","2020",3,3,0,178333.3,1380.333,131.6667
"21196","62515","2020",6,6,0,141856.7,1438.667,98.33333
"21197","62516","2020",149,148,1,103594.7,1107.946,91.2953
"21198","62517","2020",4,4,0,99762.5,1328.75,80.5
"21199","62518","2020",3,3,0,136500,1617,85.66667
"21200","62519","2020",4,4,0,110125,1133.75,97.5
"21201","62520","2020",22,22,0,240031.6,2058.318,126.7273
"21202","62521","2020",4,4,0,77898.25,1150.5,71
"21203","62522","2020",3,3,0,111666.7,960,108
"21204","62523","2020",72,71,1,134572.9,1611.542,87.69444
"21205","62524","2020",15,15,0,172722.7,1451.533,121.4
"21206","62525","2020",85,73,12,171390.3,1738.624,99.25882
"21207","62526","2020",1,1,0,167000,1722,97
"21208","62527","2020",3,3,0,226666.7,1602.333,155.6667
"21209","62528","2020",73,70,3,152695.1,1629.548,92.82192
"21210","62529","2020",21,21,0,272533.3,2024.238,133.8571
"21211","62530","2020",7,7,0,149085.7,1355.714,109.8571
"21212","62531","2020",14,14,0,168946.4,1726.071,99.85714
"21213","62532","2020",12,12,0,123772.2,1284.333,104.5
"21214","62534","2020",42,42,0,150744.9,1509.405,102.7857
"21215","62535","2020",1,1,0,380000,2289,166
"21216","62536","2020",4,4,0,164025,1750.5,89.75
"21217","62537","2020",1,1,0,105000,750,140
"21218","62538","2020",9,9,0,161555.6,1782.111,92.33333
"21219","62539","2020",1,1,0,137000,979,140
"21220","62540","2020",15,15,0,143163.3,1509.133,92.46667
"21221","62541","2020",2,2,0,127850,1055,127
"21222","62542","2020",3,3,0,113333.3,1459,87.66667
"21223","62543","2020",14,14,0,153467.5,1882,96.71429
"21224","62544","2020",1,1,0,135000,1116,121
"21225","62545","2020",1,1,0,90000,909,99
"21226","62546","2020",3,3,0,314800,1345.667,205.6667
"21227","62547","2020",3,3,0,120500,1248.667,86
"21228","62548","2020",121,116,5,185552.7,1831.43,104.5289
"21229","62549","2020",19,19,0,125507.9,1213.842,102.6842
"21230","62550","2020",16,16,0,114468.8,1131.625,105.3125
"21231","62551","2020",2,1,1,135000,1030.5,133
"21232","62552","2020",14,14,0,108321.4,1222.286,92.5
"21233","62553","2020",2,2,0,118000,1296,88
"21234","62554","2020",1,1,0,135000,1262,107
"21235","62555","2020",49,49,0,92160.86,1155.408,81.97959
"21236","62556","2020",8,8,0,111487.5,1711.625,72.625
"21237","62557","2020",29,29,0,174726.9,1655.828,105.3448
"21238","62558","2020",2,2,0,112500,800,138
"21239","62559","2020",12,12,0,160179.2,1589.667,103.8333
"21240","62560","2020",71,67,4,152822.5,1562.127,97.73239
"21241","62561","2020",4,4,0,108925,834.75,127
"21242","62562","2020",2,2,0,109500,1450,85
"21243","62563","2020",59,59,0,145444.9,1558.322,96.11864
"21244","62564","2020",1,1,0,150550,1255,120
"21245","62565","2020",2,2,0,50500,1786.5,58.5
"21246","62566","2020",6,6,0,243907.5,1834.667,131.6667
"21247","62567","2020",8,8,0,176773.8,1583.625,94.625
"21248","62568","2020",9,9,0,180138.9,1660,109.7778
"21249","62569","2020",10,10,0,91700,1254.8,79.8
"21250","62570","2020",100,99,1,129140.7,1471.92,88.61
"21251","62571","2020",218,120,98,184910.6,2913.656,68.38991
"21252","62572","2020",9,9,0,86666.67,822.4444,110.6667
"21253","62573","2020",46,46,0,167469.7,1776.109,97.36957
"21254","62574","2020",3,3,0,146000,898.3333,137.6667
"21255","62576","2020",3,3,0,231266.7,1307.333,168.6667
"21256","62579","2020",7,7,0,140743.6,1270,111
"21257","62580","2020",4,4,0,132250,1128.5,138.75
"21258","62581","2020",6,6,0,132848.3,1098,119.6667
"21259","62582","2020",8,8,0,195287.5,1908,104
"21260","62583","2020",5,5,0,142040,1271.6,105
"21261","62584","2020",12,12,0,196266.7,1874.167,106.9167
"21262","62585","2020",7,7,0,187128.6,1565.857,129.5714
"21263","62586","2020",3,3,0,311333.3,2120,143
"21264","62587","2020",82,74,8,119424,1315.22,91.23171
"21265","62588","2020",40,34,6,168912.9,1972.525,90.25
"21266","62589","2020",15,15,0,200173.3,1719.933,118.6667
"21267","62591","2020",1,1,0,140000,1373,102
"21268","62592","2020",5,5,0,176260.4,1562.2,116.4
"21269","62593","2020",2,2,0,126250,1785.5,71.5
"21270","62594","2020",2,2,0,142500,1937,76.5
"21271","62595","2020",13,13,0,173100,1424.231,117.2308
"21272","62596","2020",5,5,0,157800,1695,95
"21273","62597","2020",3,3,0,155000,1166.333,135.6667
"21274","62598","2020",4,4,0,96100,1481,59.75
"21275","62599","2020",2,2,0,185000,1236,153.5
"21276","62600","2020",2,2,0,96500,1088,85.5
"21277","62601","2020",4,4,0,74750,825.75,94.5
"21278","62602","2020",2,2,0,135000,2109.5,60
"21279","62603","2020",15,13,2,134720,1420.133,94.86667
"21280","62604","2020",210,102,108,307266,3721.319,89.99048
"21281","62606","2020",13,13,0,247094.9,2252.231,113.3846
"21282","62608","2020",3,3,0,72333.33,917,91
"21283","62609","2020",20,19,1,213730.5,1902.3,113.15
"21284","62610","2020",9,9,0,137877.8,1618.444,89.33333
"21285","62611","2020",3,3,0,150000,1260.667,118.6667
"21286","62612","2020",10,10,0,197807,1794.8,112.9
"21287","62613","2020",10,10,0,105950,1029.6,103.6
"21288","62614","2020",3,3,0,225466.7,2048,106
"21289","62615","2020",2,2,0,244000,1682.5,149
"21290","62617","2020",131,124,7,124933.4,1359.733,91.46565
"21291","62618","2020",8,8,0,173062.5,1584.5,113.125
"21292","62619","2020",1,1,0,128800,1515,85
"21293","62620","2020",18,18,0,131925,1398.278,99.5
"21294","62621","2020",16,16,0,171533.1,1563.125,111.625
"21295","62622","2020",5,5,0,219380,1960.2,105
"21296","62623","2020",8,8,0,190950,1823.875,110.75
"21297","62624","2020",51,51,0,131528.2,1449.235,93.70588
"21298","62626","2020",32,32,0,182800.2,2013.938,97.03125
"21299","62627","2020",12,12,0,202316.7,1822.5,111.1667
"21300","62628","2020",46,46,0,121841.8,1379.174,91.32609
"21301","62629","2020",3,3,0,148666.7,1478.333,101.6667
"21302","62630","2020",4,4,0,252000,1755.75,139.75
"21303","62631","2020",4,4,0,116750,1199.75,100.5
"21304","62632","2020",5,5,0,187150,1767.2,104.4
"21305","62633","2020",5,5,0,127360,1095.2,119
"21306","62634","2020",10,10,0,231784.7,2001.9,112.3
"21307","62635","2020",3,3,0,137666.7,1375.667,99.33333
"21308","62636","2020",3,3,0,212000,1571.333,146.3333
"21309","62637","2020",89,73,16,142601.3,1692.112,86.83146
"21310","62638","2020",12,12,0,140280.6,1469.917,101.1667
"21311","62639","2020",6,6,0,167623.3,1778.5,96.33333
"21312","62640","2020",5,5,0,99900,1117.8,93.2
"21313","62642","2020",2,2,0,144500,1313.5,110
"21314","62643","2020",154,140,14,133340.7,1466.266,91.69481
"21315","62644","2020",3,3,0,120833.3,1124.333,106.3333
"21316","62645","2020",74,72,2,159736.9,1686.122,95.10811
"21317","62646","2020",8,8,0,121131.2,1391.625,84.25
"21318","62647","2020",8,8,0,100653.8,1303,78.875
"21319","62648","2020",4,4,0,137250,1701.25,83.25
"21320","62649","2020",7,7,0,73220.71,823,88
"21321","62650","2020",10,10,0,189315,1689.7,110.8
"21322","62651","2020",3,3,0,118900,1383.333,86
"21323","62652","2020",19,19,0,104064.7,1144.368,92.94737
"21324","62653","2020",9,9,0,214555.6,2102.667,108.2222
"21325","62654","2020",11,11,0,213221.5,1985.091,108.7273
"21326","62655","2020",3,3,0,123333.3,1079.667,117
"21327","62656","2020",6,6,0,151645,1708,87.83333
"21328","62657","2020",3,3,0,116333.3,1478.333,85.33333
"21329","62658","2020",1,1,0,250200,1726,145
"21330","62660","2020",4,4,0,176225,1787.25,98.25
"21331","62661","2020",2,2,0,170550,1522,109
"21332","62662","2020",10,10,0,172950,1775.9,100.8
"21333","62663","2020",3,3,0,94000,1204,81.33333
"21334","62664","2020",2,2,0,134100,1539.5,99.5
"21335","62665","2020",3,3,0,156333.3,2222.333,73
"21336","62666","2020",45,45,0,124482.3,1430.089,91.73333
"21337","62667","2020",117,87,30,128373.8,1521.145,87.09402
"21338","62668","2020",6,6,0,91500,1022.833,86.33333
"21339","62669","2020",4,4,0,135750,1219.75,115.75
"21340","62670","2020",9,9,0,122944.4,1488.889,91.22222
"21341","62671","2020",1,1,0,142000,1711,83
"21342","62672","2020",6,6,0,145666.7,1496.167,98.5
"21343","62673","2020",9,9,0,123566.7,1196,107.1111
"21344","62674","2020",4,4,0,184750,1896.75,99.75
"21345","62675","2020",4,4,0,129612.5,1576.25,83
"21346","62676","2020",2,2,0,117775,1257,101
"21347","62677","2020",1,1,0,64000,753,85
"21348","62678","2020",11,11,0,162062.7,1640.091,102.6364
"21349","62679","2020",4,4,0,294837.5,1934.75,155.25
"21350","62680","2020",7,7,0,187185.7,2014.857,95
"21351","62681","2020",1,1,0,259900,2406,108
"21352","62683","2020",1,1,0,97000,647,150
"21353","62684","2020",44,44,0,161055.8,1669.795,98.18182
"21354","62686","2020",4,4,0,156250,1362,110.75
"21355","62688","2020",63,62,1,181036.7,1950.429,92.69841
"21356","62689","2020",4,4,0,134500,1267.25,104.75
"21357","62690","2020",7,7,0,97857.14,1117.714,91.57143
"21358","62691","2020",13,13,0,177038.5,1562.231,120
"21359","62693","2020",8,8,0,124125,1380.375,90.875
"21360","62694","2020",2,2,0,130000,977.5,127
"21361","62695","2020",6,6,0,96800,1261,76.5
"21362","62696","2020",2,2,0,82500,892,93.5
"21363","62697","2020",2,2,0,198300,1733,116.5
"21364","62698","2020",6,6,0,230500,1651.833,144.1667
"21365","62699","2020",5,5,0,180384.6,1384.8,133.2
"21366","62700","2020",2,2,0,248975,1369.5,203
"21367","62701","2020",1,1,0,197000,1642,120
"21368","62702","2020",2,2,0,263555,1595.5,161
"21369","62703","2020",7,7,0,165200,1731.429,100
"21370","62704","2020",5,5,0,109650,1075.4,110.8
"21371","62705","2020",25,25,0,150371.6,1804.68,83.72
"21372","62706","2020",37,37,0,241308.1,2243.973,110.1622
"21373","62709","2020",4,4,0,117125,1009.5,110
"21374","62710","2020",2,2,0,101000,1475,75
"21375","62711","2020",36,36,0,140229.7,1465.222,96.75
"21376","62712","2020",13,13,0,213258.8,1856.385,120.4615
"21377","62713","2020",21,21,0,162402.4,1458.571,112.8571
"21378","62714","2020",11,11,0,209096.4,1973,101.6364
"21379","62715","2020",3,3,0,120333.3,1135.333,102.3333
"21380","62716","2020",3,3,0,154400,1528.333,111.3333
"21381","62717","2020",3,3,0,111333.3,989,119
"21382","62718","2020",11,11,0,185661.8,2013.273,93.18182
"21383","62719","2020",4,4,0,117625,1157.75,99.75
"21384","62721","2020",15,15,0,161690,1528,106.8
"21385","62723","2020",6,6,0,169416.7,1820.5,89.33333
"21386","62724","2020",50,50,0,156929.3,1537.86,103.7
"21387","62725","2020",3,3,0,131000,1549.333,87
"21388","62726","2020",3,3,0,87500,1022,82
"21389","62727","2020",18,18,0,146817.8,1435.833,107.1667
"21390","62728","2020",7,7,0,141300,1206,120.5714
"21391","62729","2020",3,3,0,84666.67,1139.667,73.66667
"21392","62730","2020",26,26,0,153123.1,1536.577,101.5385
"21393","62731","2020",5,5,0,87300,939,89.8
"21394","62732","2020",2,2,0,110000,925,110
"21395","62733","2020",4,4,0,114250,1087.75,112.75
"21396","62734","2020",4,4,0,161375,1437.5,110.5
"21397","62735","2020",31,31,0,153451.1,1467.613,99.58065
"21398","62736","2020",52,44,8,217112,2102.058,104.5962
"21399","62737","2020",58,55,3,137978.4,1500.741,92.39655
"21400","62738","2020",4,4,0,130000,1092,120.75
"21401","62739","2020",4,4,0,185500,1446.75,126.5
"21402","62740","2020",1,1,0,157000,1467,107
"21403","62741","2020",3,3,0,103500,773.3333,126.6667
"21404","62742","2020",3,3,0,223666.7,2004.333,120
"21405","62743","2020",7,7,0,163577.9,1464.286,112.8571
"21406","62744","2020",54,43,11,196534.9,1908.352,103.7222
"21407","62745","2020",4,4,0,163437.5,1501.75,115.25
"21408","62746","2020",74,73,1,156237.1,1617.919,96.33784
"21409","62747","2020",1,1,0,270000,1588,170
"21410","62748","2020",24,24,0,195028.5,1839.167,110.1667
"21411","62749","2020",11,11,0,162468.6,1259.455,139.5455
"21412","62750","2020",2,2,0,90469.5,910.5,102
"21413","62751","2020",9,9,0,202797.8,1787.667,111.5556
"21414","62752","2020",22,22,0,306862.3,2141.591,152.2727
"21415","62753","2020",77,60,17,159120.3,1834.714,87.64935
"21416","62754","2020",5,5,0,179920,941.8,178.8
"21417","62755","2020",33,33,0,153977.3,1681.909,91.21212
"21418","62756","2020",14,14,0,158824.7,1637.357,95.78571
"21419","62757","2020",57,56,1,171088.9,1624.965,103.4035
"21420","62758","2020",135,104,31,148711.5,1667.393,92.46667
"21421","62759","2020",6,6,0,208771.7,1811.5,115.3333
"21422","62760","2020",1,1,0,83000,659,126
"21423","62761","2020",2,2,0,208110,1757.5,130
"21424","62763","2020",10,10,0,91950,961.1,93.2
"21425","62764","2020",31,28,3,170158.4,1611.839,106.7097
"21426","62765","2020",205,143,62,118076,1394.385,89.37073
"21427","62766","2020",9,9,0,209032.2,1724.778,126.1111
"21428","62767","2020",63,56,7,107984.6,1241.889,88.52381
"21429","62769","2020",8,8,0,302312.5,2364.375,126.875
"21430","62770","2020",23,23,0,143737,1447.913,98.3913
"21431","62771","2020",63,62,1,107353.2,1350.81,80.57143
"21432","62772","2020",9,9,0,165580.6,1740.111,96.44444
"21433","62773","2020",62,61,1,139421.3,1530.306,93.20968
"21434","62774","2020",47,41,6,180878.4,1953.638,92.2766
"21435","62775","2020",1,1,0,208000,2000,104
"21436","62776","2020",1,1,0,120000,930,129
"21437","62777","2020",2,2,0,102200,927.5,159.5
"21438","62779","2020",2,2,0,164625,1500.5,107.5
"21439","62780","2020",2,2,0,87500,1005,81.5
"21440","62781","2020",4,4,0,102892.5,1190.5,84
"21441","62782","2020",3,3,0,183333.3,1642.667,110
"21442","62783","2020",2,2,0,159900,1299,129
"21443","62784","2020",9,9,0,140394.4,1264,113
"21444","62785","2020",11,8,3,150645.5,1489.364,102.4545
"21445","62786","2020",1,1,0,140000,1386,101
"21446","62787","2020",1,1,0,85000,1417,60
"21447","62788","2020",5,5,0,216990,1645.6,128.8
"21448","62789","2020",5,5,0,135500,1236,109
"21449","62790","2020",2,2,0,147500,1394.5,106
"21450","62791","2020",2,2,0,88000,926.5,122.5
"21451","62792","2020",13,13,0,107527.7,1541.385,79.53846
"21452","62793","2020",7,7,0,161385.7,1808.286,88.28571
"21453","62794","2020",7,7,0,144823.4,1539.143,97.42857
"21454","62795","2020",2,2,0,126000,1150.5,109.5
"21455","62796","2020",4,4,0,182550,1189.75,160.75
"21456","62797","2020",7,7,0,202228.6,1608.286,135.7143
"21457","62798","2020",3,3,0,88000,1072,83.66667
"21458","62799","2020",9,9,0,217783.3,1940.556,112.8889
"21459","62800","2020",4,4,0,144000,1214.25,122
"21460","62801","2020",32,31,1,174012.3,1753.5,98.34375
"21461","62802","2020",1,1,0,140000,940,149
"21462","62803","2020",5,5,0,107033.4,1173,91.2
"21463","62804","2020",1,1,0,112500,1442,78
"21464","62805","2020",3,3,0,105181.7,1039,101
"21465","62806","2020",2,2,0,245000,2394.5,104
"21466","62808","2020",8,8,0,119375,1227.375,98
"21467","62810","2020",9,8,1,183688.9,1871,99
"21468","62811","2020",12,12,0,141546.9,1809,91.33333
"21469","62812","2020",4,4,0,134875,1193.75,119.25
"21470","62813","2020",4,4,0,176000,1509.25,107.75
"21471","62814","2020",1,1,0,36000,1091,33
"21472","62815","2020",2,2,0,77500,1190.5,65
"21473","62817","2020",11,10,1,164177.3,1428.727,113
"21474","62818","2020",3,3,0,104000,1356,78.66667
"21475","62819","2020",10,10,0,138384.8,1430.5,92.8
"21476","62820","2020",5,5,0,154000,1075.8,144.8
"21477","62821","2020",1,1,0,170000,2833,60
"21478","62822","2020",1,1,0,2e+05,2000,100
"21479","62823","2020",3,3,0,227000,2574,90.33333
"21480","62824","2020",7,7,0,158142.9,1415.143,118.5714
"21481","62825","2020",6,6,0,248241.7,1800,142.1667
"21482","62826","2020",434,135,299,495084,6682.276,74.67281
"21483","62827","2020",14,14,0,138185.7,1502.643,91.5
"21484","62828","2020",3,3,0,111666.7,1199,93.33333
"21485","62829","2020",1,1,0,55000,809,68
"21486","62830","2020",3,3,0,155566.7,833.3333,173.6667
"21487","62831","2020",2,2,0,136500,1283.5,108
"21488","62832","2020",10,10,0,183937.6,1868.4,100.8
"21489","62834","2020",4,4,0,120250,1159.25,105.5
"21490","62835","2020",4,4,0,124855,1018.25,124.5
"21491","62836","2020",8,8,0,236490,2024.25,120.125
"21492","62837","2020",3,3,0,73666.67,1014,69
"21493","62839","2020",9,9,0,117108.9,1285.556,97.55556
"21494","62840","2020",2,2,0,110500,1196.5,95.5
"21495","62841","2020",28,28,0,119058.1,1278.964,95
"21496","62842","2020",86,80,6,168728.7,1844.314,93.63953
"21497","62843","2020",1,1,0,139000,1738,80
"21498","62844","2020",10,10,0,106825,1181.5,96.8
"21499","62845","2020",4,4,0,197000,2082.25,93.75
"21500","62846","2020",44,44,0,145190,1555.318,91.25
"21501","62847","2020",21,21,0,154863,1614.286,95.33333
"21502","62848","2020",46,46,0,128885.8,1363.065,94.36957
"21503","62849","2020",23,23,0,233305.7,2072.304,117.6957
"21504","62850","2020",7,7,0,126428.6,1231.714,107.7143
"21505","62851","2020",10,10,0,246515,1840.8,138.7
"21506","62852","2020",18,18,0,195722.2,1719.889,119.0556
"21507","62853","2020",5,5,0,156260,1252,119.8
"21508","62854","2020",6,6,0,189228.3,1958.833,96
"21509","62855","2020",3,3,0,106333.3,1210,89
"21510","62856","2020",2,2,0,157525,1564.5,97
"21511","62857","2020",1,1,0,405000,1446,280
"21512","62858","2020",1,1,0,148950,2482,60
"21513","62859","2020",5,5,0,100727,1064.8,101.6
"21514","62860","2020",3,3,0,187833.3,1510.333,134
"21515","62861","2020",63,63,0,192899.2,1696.143,115.8254
"21516","62862","2020",1,1,0,60000,2400,25
"21517","62864","2020",10,10,0,151835,1552.4,99.4
"21518","62865","2020",52,52,0,146184,1549.942,99.73077
"21519","62866","2020",5,5,0,228016,1889.8,126.2
"21520","62867","2020",3,3,0,231666.7,1960,122.3333
"21521","62868","2020",6,6,0,138416.7,1159.167,136
"21522","62869","2020",7,7,0,202500,2095.714,95.28571
"21523","62870","2020",8,8,0,141856.2,1750.375,92.375
"21524","62871","2020",2,2,0,117500,777.5,164.5
"21525","62872","2020",1,1,0,80000,1778,45
"21526","62873","2020",7,7,0,245054.3,1703.429,148.5714
"21527","62874","2020",11,11,0,176200,1779.182,99.81818
"21528","62875","2020",17,17,0,169148.6,1892.294,94.64706
"21529","62876","2020",4,4,0,145375,1442,109.25
"21530","62877","2020",1,1,0,115000,1139,101
"21531","62878","2020",2,2,0,112500,981,119.5
"21532","62879","2020",2,2,0,99000,1030,94
"21533","62881","2020",2,2,0,82000,808,98.5
"21534","62882","2020",12,12,0,133895.8,1389.417,93.75
"21535","62883","2020",1,1,0,81000,1246,65
"21536","62885","2020",3,3,0,103250,1076,90.33333
"21537","62886","2020",1,1,0,122000,1271,96
"21538","62887","2020",4,4,0,163750,1935.25,102.25
"21539","62888","2020",3,3,0,153333.3,1177.333,141
"21540","62889","2020",5,5,0,396006,2367.6,168.8
"21541","62890","2020",5,5,0,99000,772.8,119.2
"21542","62892","2020",5,5,0,155790,1506.8,111
"21543","62893","2020",174,87,87,248382.1,3163.023,83.13793
"21544","62894","2020",52,50,2,198231.6,2129.385,96.34615
"21545","62895","2020",87,84,3,148148.5,1591.437,96.54023
"21546","62896","2020",5,5,0,182100,1597.6,116.8
"21547","62897","2020",2,2,0,178250,1601,112
"21548","62898","2020",2,2,0,261200,1568.5,170.5
"21549","62899","2020",37,25,12,318338.5,3918.946,86.78378
"21550","62900","2020",11,11,0,179518.2,1389.545,126.5455
"21551","62901","2020",13,13,0,201780.4,1772,119.7692
"21552","62902","2020",30,30,0,132333.6,1441.667,93.46667
"21553","62903","2020",3,3,0,180000,1556.333,118
"21554","62904","2020",5,5,0,156620,1537.2,106
"21555","62905","2020",14,14,0,212472.5,1625.429,129.5714
"21556","62906","2020",19,19,0,183000,1684.737,112.0526
"21557","62907","2020",36,36,0,164320.4,1767.694,96.36111
"21558","62908","2020",18,18,0,254335.1,2159.944,116.7222
"21559","62909","2020",7,7,0,98114.29,721.2857,136
"21560","63001","2020",21,20,1,120142.7,1289,99.33333
"21561","63002","2020",2,2,0,58750,651.5,85.5
"21562","63003","2020",67,59,8,105467.8,1100.746,97.64179
"21563","63004","2020",24,23,1,114469.4,1188.583,97
"21564","63005","2020",4,4,0,181287.5,1661.25,105.75
"21565","63006","2020",2,2,0,27936,538,52
"21566","63008","2020",5,5,0,111280,1170.8,87.8
"21567","63009","2020",8,7,1,69786.38,954.125,69.75
"21568","63010","2020",29,29,0,84162,957.6552,89.48276
"21569","63011","2020",2,2,0,137100,972,142
"21570","63012","2020",19,19,0,125295.9,1329.211,90.42105
"21571","63013","2020",18,18,0,185198.6,1890.5,100.8889
"21572","63014","2020",123,94,29,187478.6,2397.455,77.11382
"21573","63015","2020",8,8,0,104562.5,1162,99.625
"21574","63016","2020",15,15,0,67263.33,845.6,76.66667
"21575","63017","2020",2,2,0,65500,674.5,93
"21576","63019","2020",34,29,5,153572.6,1871.853,85.47059
"21577","63020","2020",2,2,0,206975,1971.5,105
"21578","63021","2020",5,5,0,141628,1535.8,94.6
"21579","63022","2020",40,39,1,99385.23,1343.425,77.35
"21580","63023","2020",11,11,0,89054.55,969.6364,89.45455
"21581","63024","2020",2,2,0,27500,609,50.5
"21582","63025","2020",3,3,0,107175,853.3333,134
"21583","63026","2020",30,30,0,249802.7,2311.9,111.1667
"21584","63027","2020",2,2,0,119000,1755.5,66
"21585","63028","2020",9,8,1,89722.22,1041.111,83
"21586","63029","2020",3,3,0,134836.7,1101.667,128.6667
"21587","63030","2020",4,4,0,204962.5,1613.75,146.5
"21588","63031","2020",8,8,0,132712.5,1395.75,98.25
"21589","63032","2020",157,60,97,173618.4,2169.115,79.17834
"21590","63033","2020",1,1,0,275500,1812,152
"21591","63034","2020",11,11,0,222845.5,1923.909,115.1818
"21592","63035","2020",20,20,0,195103.5,1787.7,106.95
"21593","63036","2020",4,4,0,151350,1331.5,100.25
"21594","63037","2020",5,5,0,74930,824.2,92.4
"21595","63038","2020",83,23,60,109546.4,2329.639,47.13253
"21596","63039","2020",5,5,0,50080,508.4,98.8
"21597","63040","2020",56,55,1,160858.8,1622.964,101.3393
"21598","63041","2020",3,3,0,99983.33,995.3333,102
"21599","63042","2020",29,27,2,164713.9,1731.724,93.10345
"21600","63043","2020",6,6,0,97541.67,856.5,113.8333
"21601","63044","2020",5,5,0,181070,1857.6,92.2
"21602","63045","2020",8,8,0,164064.2,1245,131.5
"21603","63046","2020",6,6,0,61928.33,671.6667,88.83333
"21604","63047","2020",70,28,42,75865.3,1335.257,64.32857
"21605","63048","2020",9,9,0,76111.11,798.2222,94.11111
"21606","63049","2020",6,6,0,198123.3,1732.667,121.1667
"21607","63050","2020",42,41,1,113117.2,1289.19,88
"21608","63051","2020",8,8,0,141412.5,1530.375,98.75
"21609","63052","2020",12,12,0,70500,843.8333,82.75
"21610","63053","2020",3,3,0,96610,826.6667,114
"21611","63054","2020",10,10,0,143705,1391.3,103.1
"21612","63055","2020",12,12,0,101895,1098.833,102.3333
"21613","63056","2020",12,12,0,123453.9,1290.25,94.41667
"21614","63057","2020",7,7,0,90734.29,1095.571,78.71429
"21615","63058","2020",5,5,0,309756,1794,153.4
"21616","63059","2020",2,2,0,81500,1621.5,49
"21617","63060","2020",1,1,0,53000,402,132
"21618","63061","2020",6,6,0,160796.7,1214.333,127.5
"21619","63062","2020",2,2,0,68516.5,908.5,69
"21620","63063","2020",90,75,15,188614.4,2041.267,94.53333
"21621","63065","2020",1,1,0,395000,1238,319
"21622","63066","2020",17,17,0,92000,938.4706,93.88235
"21623","63067","2020",4,4,0,94250,781.25,129.75
"21624","63069","2020",51,41,10,207888.1,2195.275,95.60784
"21625","63070","2020",78,68,10,232618.2,2440.385,95.80769
"21626","63071","2020",6,6,0,195208.3,1839.333,107.1667
"21627","63072","2020",12,10,2,84385,1006.167,81
"21628","63073","2020",5,5,0,236290,1589.4,146.8
"21629","63074","2020",2,2,0,110500,1953,53.5
"21630","63075","2020",416,64,352,179462.6,2403.514,71.84135
"21631","63076","2020",3,3,0,50956.67,652.3333,76.33333
"21632","63077","2020",18,17,1,152956.3,2118.222,83.33333
"21633","63079","2020",1,1,0,44800,448,100
"21634","63080","2020",11,10,1,155555.5,1535.545,97
"21635","63081","2020",5,5,0,72800,775.8,93.2
"21636","63082","2020",1,1,0,162590,1711,95
"21637","63083","2020",9,9,0,169166.7,1436.222,107.8889
"21638","63084","2020",25,25,0,268294,2543.56,109.92
"21639","63085","2020",13,13,0,129472.1,1352.615,96.38462
"21640","63086","2020",9,9,0,85360.22,859.2222,98.44444
"21641","63087","2020",1,1,0,19800,330,60
"21642","63088","2020",1,1,0,16000,667,24
"21643","63089","2020",8,7,1,237343.8,1884.375,127.25
"21644","63090","2020",3,3,0,221390,1670.667,131
"21645","63091","2020",11,11,0,129836.4,1284.727,96.45455
"21646","63092","2020",20,20,0,163858.8,1961.7,92.7
"21647","63093","2020",12,12,0,118932.4,1246.5,97.83333
"21648","63094","2020",9,9,0,70731.11,999.4444,77.88889
"21649","63095","2020",1,1,0,55000,786,70
"21650","63096","2020",2,2,0,97475,1220,85
"21651","63097","2020",1,1,0,70000,1000,70
"21652","63098","2020",8,6,2,94802.25,1646.625,58
"21653","63099","2020",32,31,1,209178.1,1976.719,102.9688
"21654","63100","2020",7,7,0,76042.86,849,82.85714
"21655","63101","2020",1,1,0,25000,417,60
"21656","63102","2020",8,8,0,64493.75,892.5,84
"21657","63103","2020",104,61,43,150202.4,2119.933,79.28846
"21658","63104","2020",4,4,0,75762.5,981.5,77.25
"21659","63105","2020",4,3,1,133750,1486.75,66.25
"21660","63106","2020",19,19,0,170736.7,1765.895,99.42105
"21661","63107","2020",7,7,0,212740,1980,110.7143
"21662","63108","2020",7,7,0,198015.7,1960,103.8571
"21663","63109","2020",6,6,0,178778.3,1818.333,103.6667
"21664","63110","2020",1,1,0,53000,331,160
"21665","63111","2020",1,1,0,46000,885,52
"21666","63112","2020",3,3,0,250333.3,1977.333,123
"21667","63113","2020",2266,357,1909,132558.7,2053.642,65.7308
"21668","63114","2020",3,3,0,72296,867.3333,85.66667
"21669","63115","2020",3,3,0,71166.67,1034,69.66667
"21670","63116","2020",31,30,1,121083.3,1553.29,77.74194
"21671","63117","2020",1,1,0,101445,774,131
"21672","63118","2020",1,1,0,97000,1276,76
"21673","63119","2020",1,1,0,105000,1567,67
"21674","63120","2020",15,14,1,172320,1655.4,101.3333
"21675","63121","2020",17,17,0,147604.3,1720.118,89.05882
"21676","63124","2020",250,164,86,190672.9,2224.144,86.26
"21677","63125","2020",49,49,0,113376.6,1153.265,96.85714
"21678","63126","2020",8,8,0,267456.2,2313.375,110.375
"21679","63128","2020",8,8,0,140406.2,1182.25,126.5
"21680","63129","2020",4,4,0,85500,1261,79.75
"21681","63130","2020",4,4,0,82813.75,980,84
"21682","63131","2020",12,12,0,177229.2,1724.75,109.75
"21683","63132","2020",20,20,0,83812.5,1017.1,88.85
"21684","63135","2020",6,5,1,121633.3,1746.833,70.5
"21685","63136","2020",9,9,0,82611.11,1056.556,80.88889
"21686","63137","2020",5,5,0,52270,719.4,70.8
"21687","63138","2020",3,3,0,146166.7,1276.667,111.6667
"21688","63139","2020",8,8,0,75685,859.125,85.875
"21689","63140","2020",1,1,0,75000,2083,36
"21690","63141","2020",16,15,1,356155.7,2692.25,130.625
"21691","63142","2020",8,8,0,85149.25,739.125,127
"21692","63143","2020",16,16,0,187672.8,1832.438,103.8125
"21693","63144","2020",8,6,2,93288.88,1763.75,69.625
"21694","63145","2020",2,2,0,107525,1247,95.5
"21695","63146","2020",9,9,0,178744.4,2024.889,92.44444
"21696","63147","2020",3,3,0,93800,1188.333,88
"21697","63148","2020",30,30,0,202520.3,1986.033,103.6
"21698","63149","2020",9,9,0,207616.7,1921.111,112.4444
"21699","63150","2020",14,14,0,207673.5,2323.286,98.85714
"21700","63151","2020",11,11,0,117715.5,1368.182,79.63636
"21701","63152","2020",3,3,0,96833.33,820.3333,141.3333
"21702","63153","2020",4,4,0,56625,761.5,72.5
"21703","63154","2020",2,2,0,207000,1854,113
"21704","63155","2020",6,6,0,122370,1310.167,96.16667
"21705","63156","2020",1,1,0,58000,829,70
"21706","63157","2020",3,3,0,173533.3,1466,122.6667
"21707","63158","2020",4,4,0,74907.5,989.5,86.75
"21708","63159","2020",1,1,0,117500,839,140
"21709","63160","2020",11,10,1,198942.7,1716.545,116.0909
"21710","63161","2020",2,2,0,100900,1068.5,95
"21711","63162","2020",6,6,0,96980.83,1097.833,96
"21712","63163","2020",9,9,0,139195.6,1203.222,119.4444
"21713","63164","2020",134,79,55,148179.4,1858.366,80.23881
"21714","63165","2020",7,7,0,71785.71,735.2857,101
"21715","63166","2020",3,3,0,201000,1569.333,132.3333
"21716","63167","2020",7,7,0,129185.7,1568.571,79.85714
"21717","63168","2020",7,7,0,205107.1,1617.429,130.4286
"21718","63170","2020",4,4,0,101000,1261,96.25
"21719","63171","2020",1,1,0,38000,731,52
"21720","63173","2020",7,7,0,59896.43,690.2857,87.42857
"21721","63174","2020",3,3,0,108000,885,108
"21722","63175","2020",1,1,0,58000,725,80
"21723","63177","2020",3,3,0,63250,1283.333,52.66667
"21724","63178","2020",192,94,98,132217.5,1693.656,79.25521
"21725","63179","2020",6,5,1,85708.33,2396.333,116.1667
"21726","63180","2020",14,14,0,170798.9,1629.5,110
"21727","63181","2020",6,6,0,199004,1999.333,98
"21728","63182","2020",12,12,0,103870.8,1263.417,77.66667
"21729","63183","2020",2,2,0,148000,2062,68.5
"21730","63184","2020",6,6,0,65983.33,753.3333,75.5
"21731","63185","2020",8,8,0,88462.5,1116,85
"21732","63187","2020",9,9,0,82207.78,993.8889,87.77778
"21733","63188","2020",1,1,0,265200,2600,102
"21734","63189","2020",4,4,0,90600,959.5,96.5
"21735","63190","2020",6,6,0,126601.7,976.3333,123.8333
"21736","63191","2020",1,1,0,65740,865,76
"21737","63192","2020",7,7,0,108657.1,1687.429,73.14286
"21738","63193","2020",87,73,14,178410.4,2125.207,84.94253
"21739","63194","2020",6,6,0,230247.3,1974.5,122
"21740","63195","2020",70,70,0,154476.5,1720.014,89.95714
"21741","63196","2020",4,4,0,94475,1211,84.5
"21742","63197","2020",2,2,0,129375,1267,102
"21743","63198","2020",13,13,0,163060.5,1704.538,100.0769
"21744","63199","2020",2,2,0,141200,1400,94.5
"21745","63200","2020",8,8,0,239236.2,2355.375,103.375
"21746","63201","2020",6,6,0,128451,1199.667,101.6667
"21747","63202","2020",2,2,0,133250,1306.5,103
"21748","63203","2020",4,4,0,251300,2445.5,101.75
"21749","63204","2020",12,12,0,199415.8,2010.917,98.75
"21750","63205","2020",6,6,0,76333.33,836.3333,97.5
"21751","63206","2020",8,8,0,124387.5,1263.25,101.625
"21752","63207","2020",12,12,0,75587.5,967.4167,87.16667
"21753","63208","2020",6,6,0,125178,1126.333,108.5
"21754","63209","2020",1,1,0,78130,1116,70
"21755","63210","2020",38,38,0,132372.5,1299.842,102.4474
"21756","63211","2020",16,15,1,108968.8,1229.562,97.4375
"21757","63212","2020",15,15,0,210323,1938.267,105.6667
"21758","63213","2020",23,23,0,247508.8,2180.652,117.0435
"21759","63214","2020",27,27,0,206266.3,2149.037,97.14815
"21760","63215","2020",7,7,0,197920,2121.286,99.14286
"21761","63216","2020",2,2,0,122000,987,125.5
"21762","63218","2020",5,5,0,104760,1054.8,97.4
"21763","63219","2020",7,7,0,160765.7,1780.571,98.57143
"21764","63221","2020",1,1,0,108000,1080,100
"21765","63222","2020",4,4,0,152185,1505.5,100.75
"21766","63223","2020",14,14,0,97338.29,1056.714,95.21429
"21767","63224","2020",20,19,1,230625,2336.9,103.25
"21768","63225","2020",25,25,0,70054.8,900.32,86.64
"21769","63226","2020",42,42,0,198558.9,1877.238,105.0952
"21770","63227","2020",24,24,0,195700.9,1882.375,98.83333
"21771","63228","2020",5,5,0,89960,833,104
"21772","63229","2020",20,20,0,153873.3,1598.7,98.65
"21773","63230","2020",2,2,0,101475,1008.5,99.5
"21774","63231","2020",21,19,2,78906.19,805.619,103
"21775","63232","2020",6,6,0,148321.5,1516,100
"21776","63233","2020",15,15,0,77216.27,805.6667,96.86667
"21777","63234","2020",18,18,0,147782.8,1352.333,108.1667
"21778","63235","2020",7,7,0,184631.4,1749,104.7143
"21779","63236","2020",99,16,83,92237.52,2277.727,43.32323
"21780","63237","2020",3,3,0,88433.33,605.3333,121.3333
"21781","63238","2020",4,4,0,132687.5,1991.25,66.5
"21782","63239","2020",8,8,0,219047.5,1876.625,121.125
"21783","63240","2020",4,3,1,223125,2564,105.75
"21784","63241","2020",7,7,0,223000,2065.857,105.5714
"21785","63242","2020",6,6,0,99100.67,1112.167,88.33333
"21786","63243","2020",5,5,0,47880,755.2,56.2
"21787","63244","2020",7,7,0,223057.1,2393,96.42857
"21788","63245","2020",50,49,1,225319.1,2059.18,110.7
"21789","63246","2020",14,7,7,73381.43,1209.286,62.07143
"21790","63247","2020",14,11,3,99249.64,1618.143,77.14286
"21791","63248","2020",8,7,1,137320.2,1399.625,113.75
"21792","63249","2020",2,2,0,142500,1254,114
"21793","63250","2020",5,5,0,214260,1858.4,120.4
"21794","63251","2020",4,4,0,49250,704.75,69.5
"21795","63252","2020",3,3,0,89666.67,1044,74.33333
"21796","63253","2020",2,2,0,185925,1357,143
"21797","63254","2020",19,18,1,194527.7,2107.684,89.73684
"21798","63255","2020",7,7,0,97542.86,859.1429,115.8571
"21799","63256","2020",4,4,0,60875,730.25,86.5
"21800","63257","2020",5,5,0,183773.8,1871.8,99
"21801","63258","2020",12,12,0,119735,1188.667,106.75
"21802","63259","2020",7,5,2,98369.14,1004.571,110.5714
"21803","63260","2020",3,3,0,99976.67,1014.333,100.6667
"21804","63261","2020",6,6,0,141713.3,1634.5,82.83333
"21805","63262","2020",33,33,0,233738.3,2234.667,103.3333
"21806","63263","2020",20,20,0,245160.5,2203.75,114.95
"21807","63264","2020",1,1,0,77890,1442,54
"21808","63265","2020",16,16,0,185155,1776.5,103.0625
"21809","63267","2020",11,11,0,109137.3,1202.727,89.45455
"21810","63268","2020",3,3,0,191766.7,2088.333,97.66667
"21811","63269","2020",12,11,1,143150,1795.583,81.58333
"21812","63270","2020",5,5,0,195520,1841.6,104.2
"21813","63271","2020",14,14,0,112903.6,1052.929,114.4286
"21814","63272","2020",32,25,7,231384.5,2371.406,101.3438
"21815","63273","2020",14,14,0,233659.3,2300.286,109.8571
"21816","63274","2020",5,5,0,186220,1706.4,103.6
"21817","63275","2020",11,11,0,126600,1488.091,88.36364
"21818","63276","2020",29,25,4,122887.7,1578.345,81.51724
"21819","63277","2020",1,1,0,201350,2014,100
"21820","63278","2020",7,7,0,258631.9,2344.857,112.2857
"21821","63279","2020",9,8,1,113388.9,2131.444,89.33333
"21822","63280","2020",3,3,0,185833.3,1417.333,122.6667
"21823","63281","2020",9,9,0,56500,673.6667,89.55556
"21824","63282","2020",22,22,0,144553.9,1549.682,89.45455
"21825","63283","2020",4,4,0,64812.5,783.75,82.25
"21826","63284","2020",146,139,7,203076.4,2090.062,98.67808
"21827","63285","2020",7,7,0,153577.1,1507,104.7143
"21828","63286","2020",7,7,0,174642.9,1363.857,137.7143
"21829","63287","2020",2,2,0,133925,1596,79.5
"21830","63288","2020",7,7,0,175814.3,1615.143,106.8571
"21831","63289","2020",3,3,0,89833.33,740,114
"21832","63290","2020",1,1,0,250000,1984,126
"21833","63291","2020",35,34,1,104977.1,1239.4,85.48571
"21834","63292","2020",2,2,0,99900,1572,80
"21835","63293","2020",5,5,0,79035.6,731,126.4
"21836","63294","2020",6,6,0,53833.33,743.3333,74
"21837","63295","2020",32,32,0,98931.56,1043.062,94.375
"21838","63296","2020",6,6,0,206950,1598.5,114.3333
"21839","63297","2020",4,4,0,130000,1448.5,85.25
"21840","63299","2020",5,5,0,88450,978.6,91
"21841","63300","2020",218,130,88,152170.9,1838.794,83.16972
"21842","63301","2020",9,9,0,102705.6,904.7778,125.7778
"21843","63302","2020",28,28,0,222379.6,2322.179,96.78571
"21844","63303","2020",1,1,0,80030,534,150
"21845","63304","2020",2,2,0,40000,571,70
"21846","63305","2020",5,4,1,131870,1343,96.8
"21847","63306","2020",7,7,0,261371.4,1820.714,144.8571
"21848","63307","2020",68,47,21,193565,2108.647,88.64706
"21849","63308","2020",93,28,65,167698.5,2082.914,74.84946
"21850","63309","2020",7,7,0,99169.29,1204.714,80.85714
"21851","63310","2020",1,1,0,60000,333,180
"21852","63311","2020",4,4,0,154897.5,1342,109.5
"21853","63312","2020",3,3,0,66050,727.3333,97.33333
"21854","63313","2020",1,1,0,1e+05,833,120
"21855","63314","2020",5,5,0,67934,923,68.2
"21856","63315","2020",18,18,0,201320.6,1607.944,127.7222
"21857","63317","2020",6,6,0,160433.3,1642.333,97.5
"21858","63318","2020",3,3,0,105000,1418.333,74
"21859","63319","2020",15,15,0,85205.33,1182.733,80.46667
"21860","63320","2020",1,1,0,60000,984,61
"21861","63321","2020",8,8,0,217136.9,1822.25,123.875
"21862","63322","2020",28,28,0,211164.3,2054.214,101.5714
"21863","63323","2020",3,3,0,59433.33,705,93.66667
"21864","63324","2020",7,7,0,110701.4,993.2857,120.1429
"21865","63325","2020",1,1,0,95500,974,98
"21866","63326","2020",8,8,0,160061.9,1521,101.125
"21867","63327","2020",33,31,2,216007,2385.636,93.12121
"21868","63328","2020",2,2,0,106700,803,122.5
"21869","63329","2020",2,2,0,70000,918.5,72.5
"21870","63330","2020",4,4,0,179837.5,1741.75,106
"21871","63331","2020",8,8,0,82887.5,1056.25,77.25
"21872","63332","2020",6,6,0,196178.3,1551.667,124.1667
"21873","63333","2020",2,2,0,47500,593.5,78.5
"21874","63334","2020",9,9,0,127496.8,1368.444,86.33333
"21875","63335","2020",7,7,0,95000,1375.143,74.85714
"21876","63336","2020",8,8,0,89855.62,1204.25,78.25
"21877","63337","2020",2,2,0,62250,695.5,89
"21878","63338","2020",38,34,4,64330.26,857.1842,82.84211
"21879","63339","2020",1,1,0,146400,783,187
"21880","63340","2020",2,2,0,159600,1628.5,98
"21881","63341","2020",6,6,0,62366.67,952.1667,70.83333
"21882","63342","2020",3,3,0,81133.33,1398.333,67.66667
"21883","63343","2020",5,5,0,106470,1119,99
"21884","63344","2020",6,6,0,86316.67,968.5,81.16667
"21885","63345","2020",26,25,1,227699.7,2145.654,104.3846
"21886","63346","2020",1,1,0,102100,1147,89
"21887","63347","2020",7,7,0,150907,1339.143,106.8571
"21888","63348","2020",3,3,0,65550,687.6667,91
"21889","63349","2020",37,35,2,125598.4,1323.595,100.1622
"21890","63350","2020",16,16,0,205007.1,2034.562,99.1875
"21891","63352","2020",12,12,0,88942.67,1061.917,90.83333
"21892","63353","2020",11,11,0,91751.36,1052,84.18182
"21893","63354","2020",14,14,0,84942.86,947.6429,82.92857
"21894","63355","2020",1,1,0,134150,877,153
"21895","63356","2020",4,4,0,71925,908.75,91.5
"21896","63357","2020",1,1,0,118650,848,140
"21897","63358","2020",4,4,0,146250,1274,115.5
"21898","63359","2020",1,1,0,116000,1349,86
"21899","63360","2020",4,4,0,71182.5,742.25,96.25
"21900","63362","2020",10,10,0,137714,1482.2,97.3
"21901","63363","2020",3,3,0,110070,1072,115.6667
"21902","63364","2020",7,7,0,192142.9,1616.714,118.8571
"21903","63365","2020",9,9,0,141638.9,1485.111,96
"21904","63366","2020",2,2,0,63000,691.5,92
"21905","63367","2020",1,1,0,110000,1000,110
"21906","63368","2020",18,18,0,171928.6,1541.5,108.8889
"21907","63369","2020",1,1,0,128000,1280,100
"21908","63370","2020",3,3,0,75533.33,816.3333,98
"21909","63371","2020",2,2,0,59500,623.5,92
"21910","63372","2020",9,9,0,134359.2,1555.222,99.11111
"21911","63373","2020",2,2,0,154000,1003.5,143
"21912","63374","2020",3,3,0,107166.7,1032.333,98.33333
"21913","63375","2020",4,4,0,159175,1541.25,104
"21914","63376","2020",2,2,0,60000,851.5,69
"21915","63377","2020",5,5,0,67380,816.2,90.4
"21916","63378","2020",11,11,0,169410.5,1665.273,103.8182
"21917","63379","2020",7,7,0,187935.7,1710.286,106
"21918","63380","2020",20,14,6,161623.7,1891.5,90.05
"21919","63381","2020",14,14,0,158813.2,1535.786,98.42857
"21920","63382","2020",6,6,0,118863.3,1221.667,96.66667
"21921","63383","2020",6,6,0,85000,1017.167,83
"21922","63384","2020",4,4,0,93237.5,1168,91.5
"21923","63385","2020",2,2,0,218500,1893,115.5
"21924","63386","2020",6,6,0,135504.2,1593.667,80.66667
"21925","63387","2020",9,9,0,150044.4,1353.667,127.8889
"21926","63388","2020",6,6,0,77666.67,569.1667,131.1667
"21927","63389","2020",2,2,0,129750,1649.5,75
"21928","63390","2020",4,4,0,105387.5,949.5,101.5
"21929","63391","2020",2,2,0,51615,374,139
"21930","63392","2020",11,11,0,144421.8,1662.273,86.09091
"21931","63393","2020",18,17,1,90040.56,968.2778,95.5
"21932","63394","2020",2,2,0,70500,751.5,95
"21933","63395","2020",18,18,0,171875.6,1721.278,99.27778
"21934","63396","2020",14,14,0,211475,1907.286,109.1429
"21935","63397","2020",12,12,0,56866.67,816.4167,70.83333
"21936","63398","2020",4,4,0,77562.5,983.75,91.5
"21937","63400","2020",13,13,0,137476.2,1226.538,113.6923
"21938","63401","2020",8,7,1,135305.1,1547.5,90
"21939","63402","2020",5,5,0,90320,1409.4,66.6
"21940","63403","2020",4,4,0,143037.5,1043.5,147.75
"21941","63404","2020",8,8,0,151996.2,1419.5,107.625
"21942","63405","2020",7,7,0,180768.6,1596.143,118
"21943","63406","2020",6,6,0,184496.7,1977,99.16667
"21944","63407","2020",5,5,0,126352,1487,97
"21945","63408","2020",4,4,0,69513.75,812,85.5
"21946","63409","2020",6,6,0,168683.3,1339.667,107.5
"21947","63410","2020",2,2,0,59500,873,85.5
"21948","63411","2020",7,7,0,117657.1,1419.714,89
"21949","63412","2020",3,3,0,89040,1147.667,85.33333
"21950","63413","2020",15,15,0,140902.1,1606.667,86.2
"21951","63414","2020",3,3,0,111107,1064.333,106.3333
"21952","63415","2020",14,14,0,114103.6,1114.571,98.64286
"21953","63416","2020",1,1,0,38000,1267,30
"21954","63417","2020",23,23,0,202785.4,2093.174,94.21739
"21955","63418","2020",4,4,0,162775,1471.25,111
"21956","63419","2020",14,14,0,78335.71,776.3571,100.1429
"21957","63420","2020",14,14,0,141973.6,1304.786,106.2857
"21958","63421","2020",1,1,0,152000,1134,134
"21959","63422","2020",6,6,0,154241.7,1411.833,103.3333
"21960","63423","2020",10,10,0,141954,1134.1,128.6
"21961","63424","2020",12,12,0,158491.7,1754.833,96.58333
"21962","63425","2020",19,18,1,224514.2,2053.105,105.7895
"21963","63426","2020",15,15,0,129336.7,1659.933,69.46667
"21964","63427","2020",6,6,0,188716.2,1847.5,102.8333
"21965","63428","2020",1,1,0,110000,1146,96
"21966","63429","2020",2,2,0,108750,1228.5,86
"21967","63430","2020",92,66,26,89038.22,1019.141,87.59783
"21968","63431","2020",3,3,0,152766.7,987.6667,175.6667
"21969","63432","2020",9,9,0,181714.6,1678.444,107.5556
"21970","63433","2020",3,3,0,69333.33,910,75.66667
"21971","63434","2020",14,14,0,75067.21,990.6429,80.42857
"21972","63435","2020",6,6,0,62500,1176.333,55.33333
"21973","63436","2020",1,1,0,62000,689,90
"21974","63437","2020",1,1,0,114000,1140,100
"21975","63438","2020",10,10,0,112703,1019.8,116.1
"21976","63439","2020",2,2,0,170000,1425,114.5
"21977","63440","2020",1,1,0,42000,646,65
"21978","63441","2020",5,5,0,55100,733,88.2
"21979","63442","2020",1,1,0,101950,927,110
"21980","63443","2020",3,3,0,188133.3,1915.667,102.3333
"21981","63444","2020",2,2,0,243850,1771.5,142.5
"21982","63445","2020",3,3,0,234766.7,1997,128.3333
"21983","63446","2020",6,6,0,226925,1934.333,117.6667
"21984","63448","2020",8,8,0,130625.6,1297.5,88.875
"21985","63449","2020",7,7,0,103992.9,1158.429,98.28571
"21986","63450","2020",3,3,0,120418.7,1065.667,115.3333
"21987","63451","2020",6,5,1,133531.7,1738.5,90.66667
"21988","63452","2020",4,4,0,131250,1783.75,84.75
"21989","63453","2020",58,58,0,182387.9,1910.759,98.56897
"21990","63454","2020",7,7,0,105685.7,1302.571,98.85714
"21991","63455","2020",45,44,1,291537.6,2285.978,121.9333
"21992","63456","2020",3,3,0,131666.7,2089.333,83
"21993","63457","2020",48,41,7,178265.9,1878.812,94.375
"21994","63459","2020",6,6,0,126820.8,1015.333,129.1667
"21995","63460","2020",4,4,0,79750,696.5,133
"21996","63461","2020",7,7,0,163772.9,1890.571,87.85714
"21997","63462","2020",4,4,0,76375,794.75,89
"21998","63463","2020",3,3,0,62000,839,83.33333
"21999","63464","2020",4,4,0,164625,1763.75,99.25
"22000","63465","2020",7,7,0,135464.3,1164.571,122.2857
"22001","63466","2020",6,6,0,77287.5,924.5,97
"22002","63467","2020",1,1,0,60000,882,68
"22003","63468","2020",3,3,0,57833.33,866.3333,80
"22004","63469","2020",10,10,0,120949.5,1376.1,86.8
"22005","63470","2020",52,49,3,192809.3,2043.615,90.15385
"22006","63471","2020",16,16,0,80101.88,974.875,81.4375
"22007","63472","2020",8,8,0,193577.5,1841.25,104
"22008","63473","2020",3,3,0,173633.3,1697.333,102.6667
"22009","64001","2020",1,1,0,192600,1235,156
"22010","64003","2020",3,3,0,200778.3,1705,123.6667
"22011","64004","2020",3,3,0,140416.7,1269.333,115
"22012","64005","2020",2,2,0,119645,2378.5,51.5
"22013","64006","2020",8,8,0,166305.6,1431.875,125.75
"22014","64007","2020",8,8,0,191191.9,1485.75,135
"22015","64008","2020",1,1,0,203700,2144,95
"22016","64009","2020",25,14,11,383717,3726.04,106.2
"22017","64010","2020",4,4,0,209600,2309.5,91
"22018","64012","2020",1,1,0,50000,495,101
"22019","64014","2020",4,2,2,216000,2504,81.75
"22020","64015","2020",1,1,0,173624,1189,146
"22021","64016","2020",3,3,0,141333.3,1339.667,98.66667
"22022","64017","2020",3,3,0,170293.3,1132.333,148.6667
"22023","64018","2020",2,2,0,307500,2320.5,131
"22024","64019","2020",1,1,0,128000,1133,113
"22025","64021","2020",7,7,0,216275.7,1970.143,110
"22026","64022","2020",1,1,0,380000,3725,102
"22027","64023","2020",3,3,0,123666.7,1731,78.66667
"22028","64024","2020",781,214,567,375785.6,4817.782,75.71703
"22029","64025","2020",2,2,0,224675,2099.5,107
"22030","64026","2020",1,1,0,2e+05,1835,109
"22031","64027","2020",2,2,0,234750,2355,100.5
"22032","64028","2020",3,3,0,139133.3,982.3333,141.6667
"22033","64029","2020",5,5,0,143700,1512.8,117.2
"22034","64031","2020",4,4,0,233815,1688,138.25
"22035","64032","2020",2,2,0,253125,2407.5,111.5
"22036","64034","2020",1,1,0,260000,1605,162
"22037","64035","2020",30,21,9,554862.9,4362.767,123.4667
"22038","64036","2020",1,1,0,300700,1634,184
"22039","64037","2020",9,9,0,303822.2,1996.111,145.3333
"22040","64038","2020",52,33,19,570105.2,4259.058,129.8269
"22041","64039","2020",3,3,0,161070,1492.333,116.3333
"22042","64040","2020",22,4,18,64203.64,1630.909,48.18182
"22043","64041","2020",12,10,2,197575,1708.167,118.75
"22044","64042","2020",10,10,0,194750,1416.9,138.7
"22045","64043","2020",5,5,0,146034,1416.4,101.6
"22046","64044","2020",2,2,0,162500,991,147
"22047","64045","2020",2,2,0,159006.5,1848.5,86
"22048","64046","2020",3,3,0,198333.3,1594.333,127.6667
"22049","64047","2020",3,1,2,119500,1736.333,61.66667
"22050","64048","2020",1,1,0,210000,2165,97
"22051","64051","2020",7,4,3,148192.6,1207.857,137.4286
"22052","64052","2020",1,1,0,56000,800,70
"22053","64053","2020",1,1,0,154350,1715,90
"22054","64054","2020",8,8,0,267615.6,1762.5,158.25
"22055","64056","2020",1,1,0,159000,1606,99
"22056","64057","2020",28,27,1,149624.7,1479.107,105.2857
"22057","64058","2020",9,9,0,135445,1324.222,105.2222
"22058","64059","2020",5,5,0,226320,2162.8,104.6
"22059","64060","2020",16,13,3,198606.9,2051.062,101.5
"22060","64061","2020",35,29,6,167268.3,1661.914,109.4857
"22061","64062","2020",21,17,4,126183.3,1398.143,98.38095
"22062","64063","2020",6,6,0,173966.7,1206,142.5
"22063","64064","2020",5,5,0,164000,1365.8,138
"22064","64065","2020",66,40,26,470466.3,4043.818,117.8182
"22065","64066","2020",4,4,0,255375,2866.25,102
"22066","64067","2020",28,27,1,232097.1,1928.893,123.3214
"22067","64068","2020",18,17,1,183926.4,1785.833,124.8333
"22068","64069","2020",4,4,0,65000,1237.25,54
"22069","64070","2020",3,3,0,230176,2103.333,113
"22070","64071","2020",1,1,0,167000,1670,100
"22071","64072","2020",4,4,0,271562.5,1981,136.5
"22072","64073","2020",2,2,0,257755,1993,131
"22073","64075","2020",2,2,0,140625,1111.5,146
"22074","64077","2020",2,2,0,197525,1917,103
"22075","64078","2020",2,2,0,182500,1415.5,130.5
"22076","64080","2020",12,12,0,218608.7,1891.917,117.9167
"22077","64082","2020",6,6,0,179939.2,1381.833,129.3333
"22078","64083","2020",3,3,0,231350,1379.667,167.6667
"22079","64084","2020",1,1,0,111900,1332,84
"22080","64085","2020",3,3,0,83333.33,1400,60.66667
"22081","64086","2020",4,3,1,253875,3063.5,82
"22082","64087","2020",8,8,0,203625,1446,142.625
"22083","64088","2020",1,1,0,180000,1538,117
"22084","64089","2020",1,1,0,237060,2026,117
"22085","64090","2020",1,1,0,340000,1250,272
"22086","64091","2020",7,7,0,201397.6,1865.571,107.4286
"22087","64092","2020",1,1,0,133000,1583,84
"22088","64093","2020",6,6,0,151466.7,1353.167,123.1667
"22089","64094","2020",19,14,5,307993.2,2575.105,121.0526
"22090","64095","2020",1,1,0,219600,1996,110
"22091","64096","2020",1,1,0,105500,1005,105
"22092","64097","2020",7,7,0,161642.9,1676.714,97.85714
"22093","64098","2020",1,1,0,59500,902,66
"22094","64100","2020",36,23,13,492091,4351.028,113.0833
"22095","64101","2020",4,4,0,199500,1842.25,122.5
"22096","64102","2020",975,74,901,231013.4,3438.269,66.66872
"22097","64103","2020",2,2,0,231102.5,1846.5,131.5
"22098","64104","2020",8,6,2,151650.6,1381.25,107.75
"22099","64105","2020",2,2,0,151900,1395.5,114.5
"22100","64106","2020",8,8,0,170166.8,1647.75,104.25
"22101","64107","2020",2,2,0,67500,767.5,111
"22102","64108","2020",7,7,0,131785.7,1260.714,112.2857
"22103","64109","2020",23,23,0,178481.6,1577.087,121.4348
"22104","64110","2020",4,4,0,185500,1039.75,177.25
"22105","64111","2020",4,4,0,144500,1403.75,139.5
"22106","64112","2020",8,8,0,169000,1353.375,128.75
"22107","64113","2020",2,2,0,145125,981,148
"22108","64114","2020",9,9,0,206238.9,1818.667,121
"22109","64115","2020",1,1,0,165000,2357,70
"22110","64116","2020",4,4,0,163925,1262.5,132.5
"22111","64117","2020",2,2,0,242300,1907.5,127.5
"22112","64119","2020",7,7,0,230727.1,1632.857,144.2857
"22113","64120","2020",3,3,0,178333.3,1730.667,111
"22114","64121","2020",1,1,0,437050,2601,168
"22115","64122","2020",802,129,673,447573.4,6509.726,69.75312
"22116","64123","2020",16,11,5,221359.2,2196.875,100
"22117","64124","2020",6,6,0,195538.3,1922.333,105.3333
"22118","64125","2020",157,67,90,483660.7,5743.452,81.84076
"22119","64126","2020",13,13,0,172971.5,1602.615,115
"22120","64127","2020",2,2,0,96000,924.5,108
"22121","64128","2020",1,1,0,50000,500,100
"22122","64129","2020",340,73,267,128559.6,1850.882,68.98824
"22123","64130","2020",13,8,5,326579.8,3691.385,95.76923
"22124","64131","2020",9,9,0,184989.1,1651.111,111.4444
"22125","64132","2020",67,37,30,217772.6,2100.299,101.8358
"22126","64133","2020",11,10,1,172804.5,1722.091,98.63636
"22127","64134","2020",3,1,2,261000,2821.667,95.66667
"22128","64135","2020",7,7,0,179197,1523.571,117.7143
"22129","64136","2020",2,2,0,248980,2543.5,137.5
"22130","64137","2020",8,8,0,226398.8,2028.375,111.625
"22131","64138","2020",33,33,0,194891.9,1720.121,114.2424
"22132","64139","2020",8,8,0,215418.8,1834.5,113.5
"22133","64140","2020",123,58,65,229080.6,3192.317,74.07317
"22134","64141","2020",2,2,0,248750,1635.5,150
"22135","64142","2020",10,10,0,267550,2133.9,130.2
"22136","64143","2020",4,4,0,170375,1420,127
"22137","64145","2020",7,7,0,212307.1,1804.286,127.2857
"22138","64146","2020",4,4,0,263725,1722.25,170.5
"22139","64147","2020",37,31,6,320797,2941.162,109.7297
"22140","64148","2020",9,9,0,216637.8,1459,143.8889
"22141","64149","2020",4,4,0,195550,1229.75,165.5
"22142","64152","2020",17,17,0,343994.6,2388.176,146.5882
"22143","64153","2020",1,1,0,132000,1320,100
"22144","64154","2020",1,1,0,160000,1569,102
"22145","64156","2020",7,6,1,148536.4,1149.857,132.5714
"22146","64157","2020",15,15,0,161848.7,1508.2,115.8667
"22147","64159","2020",2,2,0,126000,1329.5,99
"22148","64160","2020",127,50,77,232236,3111.787,78.07874
"22149","64161","2020",14,14,0,223117.5,1717.929,134.7143
"22150","64165","2020",4,4,0,120917.5,844.5,141.5
"22151","64166","2020",2,2,0,222500,1985,112
"22152","64167","2020",1,1,0,48650,748,65
"22153","64168","2020",9,9,0,223269,1227.889,195
"22154","64170","2020",2,2,0,227250,1407.5,158.5
"22155","64171","2020",2,2,0,232450,1765,131
"22156","64172","2020",3,3,0,146000,1923,77
"22157","64173","2020",2,2,0,226264.5,1374,168
"22158","64174","2020",2,2,0,122500,1385,73
"22159","64175","2020",1,1,0,108910,2094,52
"22160","64176","2020",4,4,0,235262.5,1801.25,128.25
"22161","64177","2020",5,5,0,169984.4,1536.8,115.2
"22162","64178","2020",9,9,0,195008.9,1630.667,123.5556
"22163","64179","2020",3,3,0,224880,2002.333,112
"22164","64180","2020",3,3,0,127633.3,1739.667,71.66667
"22165","64181","2020",3,3,0,149333.3,999.6667,150
"22166","64182","2020",1,1,0,48000,889,54
"22167","64183","2020",6,6,0,255270.5,1797.667,145.5
"22168","64184","2020",3,3,0,226550,1975.333,116.6667
"22169","64185","2020",1,1,0,117400,793,148
"22170","64187","2020",2,1,1,308500,2879,120
"22171","64188","2020",10,9,1,137710.8,1133.6,118.2
"22172","64189","2020",181,30,151,343039.1,4991.829,68.22099
"22173","64191","2020",24,22,2,161142.2,1485.333,114.2083
"22174","64193","2020",2,2,0,102500,2809.5,35.5
"22175","64194","2020",5,5,0,125749,1083,116.4
"22176","64196","2020",4,4,0,103675,847.75,130.5
"22177","64197","2020",1,1,0,170800,2033,84
"22178","64198","2020",15,15,0,237115,2289.933,110
"22179","64200","2020",1,1,0,236530,1434,165
"22180","64201","2020",2,2,0,194000,752.5,254
"22181","64202","2020",7,7,0,215840,1772.857,125
"22182","64203","2020",9,9,0,196824.4,1632,120.2222
"22183","64204","2020",60,12,48,75719.65,1583.883,49.26667
"22184","64205","2020",2,1,1,101425,1030.5,105.5
"22185","64206","2020",1,1,0,125000,1316,95
"22186","64207","2020",5,5,0,162000,1281.6,130.2
"22187","64208","2020",5,5,0,171770,1790.8,104.2
"22188","64209","2020",7,7,0,181828.6,1398.143,130.4286
"22189","64210","2020",2,2,0,249000,1287,200.5
"22190","64211","2020",1,1,0,185000,2056,90
"22191","64212","2020",2,2,0,205921,1505,162.5
"22192","64213","2020",11,9,2,321225.5,3384.909,106.1818
"22193","64214","2020",3,1,2,124350,1246,108.3333
"22194","64215","2020",1,1,0,99000,1414,70
"22195","64216","2020",8,8,0,227512.5,1968.25,120.5
"22196","64217","2020",6,6,0,180383.3,1363.333,138.8333
"22197","64218","2020",1,1,0,240000,5333,45
"22198","64220","2020",7,7,0,198171.4,1917,102.7143
"22199","64221","2020",1,1,0,313510,2090,150
"22200","64222","2020",1,1,0,1e+05,800,125
"22201","64223","2020",5,5,0,119419.4,1012,108.6
"22202","64224","2020",10,10,0,165625,1496.9,110.8
"22203","64225","2020",4,4,0,202850,1638.75,124.25
"22204","64226","2020",4,4,0,156750,1478.75,110.25
"22205","64227","2020",8,8,0,225871.1,2487.375,109.125
"22206","64228","2020",1,1,0,1e+05,645,155
"22207","64229","2020",1,0,1,88000,1660,53
"22208","64230","2020",67,55,12,216759.7,2013.522,111.6866
"22209","64231","2020",4,4,0,141250,1474,97.75
"22210","64232","2020",3,3,0,135000,947.6667,142
"22211","64233","2020",13,13,0,148534.6,1365.231,116.3846
"22212","64234","2020",6,6,0,204885.8,1390.333,156.5
"22213","64237","2020",38,17,21,182782.6,1911.632,98.76316
"22214","64238","2020",20,19,1,184441.2,1661.15,114.4
"22215","64239","2020",1,1,0,137000,1457,94
"22216","64240","2020",3,3,0,287810,2123.667,120.3333
"22217","64241","2020",3,3,0,124000,1092,108
"22218","64242","2020",2,2,0,472230,2000,250
"22219","64243","2020",3,3,0,224590,2025.333,111.3333
"22220","64244","2020",4,4,0,195042.5,1433.5,139
"22221","64245","2020",8,8,0,137753.1,1378.75,102
"22222","64247","2020",5,4,1,110200,1057.6,109.4
"22223","64249","2020",19,5,14,431588.2,6052.105,79.73684
"22224","64250","2020",11,10,1,245631.8,1917.364,133.6364
"22225","64251","2020",5,4,1,175968,1670.2,123.8
"22226","64252","2020",10,10,0,144900,1378.7,105.4
"22227","64253","2020",5,5,0,143840,1363.6,116
"22228","64254","2020",6,6,0,150342.5,1246.667,126.3333
"22229","64255","2020",5,4,1,337504,3086.2,109
"22230","64256","2020",76,40,36,227280.4,2620.237,89.90789
"22231","64257","2020",2,2,0,147500,2150,73
"22232","64259","2020",8,7,1,273597.5,2348.375,120
"22233","64260","2020",429,57,372,228217,3961.196,60.46154
"22234","64261","2020",4,4,0,129875,821.25,162
"22235","64262","2020",1,1,0,90000,1125,80
"22236","64263","2020",2,2,0,212422.5,2302,92
"22237","64265","2020",1,1,0,168000,1050,160
"22238","64266","2020",3,3,0,228716.7,1289.333,169.3333
"22239","64268","2020",2,2,0,209206,1401,145
"22240","64269","2020",68,64,4,292813.8,2386.338,120.7206
"22241","64270","2020",9,9,0,169658.9,1730.556,103.2222
"22242","64271","2020",1,1,0,250770,2090,120
"22243","64272","2020",1,1,0,41400,575,72
"22244","64273","2020",3,3,0,222976.7,1744,131.6667
"22245","64274","2020",1,1,0,80000,606,132
"22246","64275","2020",3,3,0,267162.3,2075,133.3333
"22247","64276","2020",2,2,0,101000,771,171.5
"22248","64277","2020",2,2,0,238830,2413.5,99
"22249","64279","2020",21,12,9,286153.3,3339.619,94.14286
"22250","64280","2020",3,3,0,109333.3,1054.333,124.6667
"22251","64281","2020",4,4,0,146250,1443.75,104.5
"22252","64282","2020",9,7,2,324076.1,2932.778,107.3333
"22253","64283","2020",1,1,0,64000,1422,45
"22254","64284","2020",103,59,44,193385.6,1959.835,100.7282
"22255","64286","2020",5,5,0,153600,1133.8,169.4
"22256","64287","2020",2,2,0,162500,1574,103
"22257","64288","2020",9,9,0,138020,1443.444,96.33333
"22258","64289","2020",12,11,1,250926.4,2223.25,124.1667
"22259","64290","2020",7,7,0,210792.9,1629.714,149.4286
"22260","64291","2020",4,4,0,88250,1241,76.75
"22261","64292","2020",3,3,0,116800,1178,96
"22262","64293","2020",2,2,0,177250,1377,127.5
"22263","64294","2020",1,1,0,290900,1021,285
"22264","64295","2020",1,1,0,162500,1128,144
"22265","64296","2020",1,1,0,210000,2059,102
"22266","64298","2020",1,1,0,115000,871,132
"22267","64299","2020",3,3,0,117850,1038,115.3333
"22268","64300","2020",9,9,0,138368.9,1648.889,88.55556
"22269","64301","2020",11,11,0,171932.7,1269.909,145.7273
"22270","64302","2020",5,5,0,191534,1838.8,106.2
"22271","64303","2020",2,2,0,112000,1251,91.5
"22272","64304","2020",41,27,14,308392,3310.976,98.02439
"22273","64305","2020",8,8,0,213355.2,1493.625,151.875
"22274","64306","2020",9,9,0,192861.1,1703.667,115.8889
"22275","64307","2020",4,4,0,134812.5,1160,123.5
"22276","64308","2020",4,4,0,159950,1365.25,111
"22277","64309","2020",3,3,0,103333.3,932.6667,116.3333
"22278","64310","2020",3,3,0,123333.3,1150.667,158
"22279","64311","2020",2,2,0,186050,1465,128.5
"22280","64314","2020",1,1,0,231000,1343,172
"22281","64315","2020",9,8,1,238251.1,2056.889,119
"22282","64317","2020",27,18,9,279707.3,3056.926,98.66667
"22283","64318","2020",2,2,0,139000,1590.5,84.5
"22284","64320","2020",48,17,31,99454.9,1691.083,69.5
"22285","64321","2020",1,1,0,180000,1161,155
"22286","64322","2020",1,1,0,175000,803,218
"22287","64324","2020",13,13,0,204056.6,1436.538,156.6923
"22288","64325","2020",1,1,0,140000,1918,73
"22289","64326","2020",1,1,0,130000,1300,100
"22290","64327","2020",2,2,0,183500,1215.5,154
"22291","64328","2020",9,9,0,134888.9,1666.667,84.22222
"22292","64329","2020",12,12,0,341939.2,2528.5,136.9167
"22293","64330","2020",7,6,1,128468.6,1349,111.5714
"22294","64331","2020",16,15,1,160731.2,1456.562,114.6875
"22295","64332","2020",1,1,0,170000,2537,67
"22296","64334","2020",6,6,0,164275,1761.833,111.3333
"22297","64335","2020",103,70,33,224144,2293.689,97.66019
"22298","64336","2020",4,4,0,202875,2275.25,93.75
"22299","64338","2020",1,1,0,115000,1150,100
"22300","64339","2020",9,6,3,133313.3,1373,97.55556
"22301","64340","2020",2,2,0,134500,995.5,153.5
"22302","64341","2020",2,2,0,173000,1744.5,107
"22303","64343","2020",7,6,1,200614.3,1791.714,117
"22304","64344","2020",4,4,0,218857.5,1844.75,127.25
"22305","64346","2020",1,1,0,182900,1550,118
"22306","64347","2020",1,1,0,190000,2184,87
"22307","64348","2020",202,116,86,196028,2164.535,89.72772
"22308","64349","2020",7,7,0,228442.9,1997.857,118.5714
"22309","64350","2020",8,4,4,267154.4,3142.5,94.625
"22310","64351","2020",5,5,0,126000,1384.4,93.2
"22311","64352","2020",5,5,0,235086,1298,186.4
"22312","64353","2020",9,7,2,187011.3,1582.889,115.5556
"22313","64354","2020",3,3,0,172455,1877.333,94.33333
"22314","64355","2020",1,1,0,235000,1407,167
"22315","64357","2020",1,1,0,110000,909,121
"22316","64358","2020",2,2,0,160650,2115,74.5
"22317","64359","2020",8,8,0,112683.8,834.875,142.75
"22318","64360","2020",1,1,0,133500,1628,82
"22319","64361","2020",1,1,0,218500,1392,157
"22320","64362","2020",2,2,0,367000,2771,133.5
"22321","64363","2020",2,2,0,187150,1326,152.5
"22322","64364","2020",4,4,0,308445,1995.75,162.75
"22323","64365","2020",4,4,0,173150,1455.75,118.75
"22324","64366","2020",3,3,0,113075.7,1032.667,100.6667
"22325","64367","2020",10,9,1,154912.9,1184.3,153.6
"22326","64368","2020",2,2,0,146000,1608,99
"22327","64369","2020",1,1,0,286000,1192,240
"22328","64370","2020",9,9,0,209616.1,1859.333,114.7778
"22329","64371","2020",37,29,8,109389.4,1261.027,95.89189
"22330","64372","2020",1,1,0,169000,1331,127
"22331","64373","2020",18,17,1,260235.8,2248.5,117.3889
"22332","64374","2020",12,12,0,228694.2,1981.083,122.3333
"22333","64375","2020",1,1,0,170000,2125,80
"22334","64376","2020",8,8,0,211943.8,1724.875,122.5
"22335","64377","2020",2,2,0,395450,1491.5,242
"22336","64378","2020",3,3,0,134850,1091.333,115.6667
"22337","64379","2020",3,3,0,133276.7,1438.667,93.33333
"22338","64380","2020",3,3,0,138666.7,1674.333,85.66667
"22339","64381","2020",3,3,0,225000,1245.333,186.3333
"22340","64382","2020",3,3,0,138166.7,1342.333,105
"22341","64385","2020",5,5,0,170030,1507.2,114.2
"22342","64386","2020",22,21,1,147715.6,1486.864,98.90909
"22343","64387","2020",4,4,0,239155,1887.5,126.25
"22344","64388","2020",1,1,0,140000,833,168
"22345","64389","2020",5,5,0,182280,1682.4,114
"22346","64390","2020",6,6,0,174773.3,1353.5,128
"22347","64391","2020",2,2,0,218377,1540,133
"22348","64393","2020",48,45,3,187043.3,1735.688,115.2917
"22349","64394","2020",1,1,0,242000,1424,170
"22350","64396","2020",12,12,0,149070.4,1506.417,104.75
"22351","64398","2020",5,5,0,155380,1072.4,153
"22352","64399","2020",25,24,1,282598.8,2291.8,129.08
"22353","64400","2020",10,9,1,170040,1626,108
"22354","64401","2020",2,2,0,172000,2299,77
"22355","64403","2020",4,4,0,133050.2,1480,94
"22356","64404","2020",4,4,0,126175,1034.75,133.5
"22357","64405","2020",39,32,7,224813.5,2024.282,107.8205
"22358","64406","2020",11,11,0,277359.5,1984.727,146.2727
"22359","64407","2020",71,58,13,382174,3525.028,112.2254
"22360","64409","2020",10,10,0,133402,1262.7,109
"22361","64410","2020",53,23,30,95677.36,1259.396,75.0566
"22362","64411","2020",2,2,0,143177.5,1146.5,124
"22363","64412","2020",2,2,0,90252.5,1187.5,78
"22364","64413","2020",9,7,2,185280,1969.444,95.11111
"22365","64415","2020",11,11,0,204674.4,2254.636,94.45455
"22366","64416","2020",14,12,2,117622.1,1076.5,120.6429
"22367","64417","2020",41,28,13,161943.9,1545.78,106.7805
"22368","64419","2020",25,23,2,233420.6,2105.6,122.6
"22369","64421","2020",10,10,0,178225,1647.3,117.9
"22370","64422","2020",173,79,94,102978.4,1288.832,81.68786
"22371","64423","2020",4,4,0,185561.5,1745,106.75
"22372","64424","2020",3,3,0,148058.3,1528.667,111.3333
"22373","64425","2020",6,5,1,129333.3,1168.833,110.3333
"22374","64426","2020",7,7,0,99814.29,997.8571,98.14286
"22375","64429","2020",3,3,0,146200,1830,82.66667
"22376","64430","2020",204,123,81,132091.6,1507.642,90.35784
"22377","64431","2020",4,4,0,192462.5,1846,104.25
"22378","64432","2020",2,2,0,138700,2089.5,62.5
"22379","64433","2020",1,1,0,140000,1556,90
"22380","64435","2020",3,3,0,125666.7,977.3333,133
"22381","64436","2020",8,8,0,166950,1746.625,99.75
"22382","64437","2020",1,1,0,405000,2035,199
"22383","64438","2020",2,2,0,234845,2130.5,110
"22384","64439","2020",15,15,0,256128.7,2249.6,117.3333
"22385","64440","2020",8,8,0,227156.9,1795.625,126
"22386","64441","2020",3,3,0,143333.3,1106.333,135.6667
"22387","64442","2020",6,6,0,165084.5,1379.167,122.3333
"22388","64443","2020",15,15,0,178049.3,1534.467,125.7333
"22389","64444","2020",2,2,0,113000,1279,84.5
"22390","64445","2020",1912,269,1643,127365.8,1845.897,69.21234
"22391","64446","2020",3,3,0,159833.3,1892.333,90.33333
"22392","64447","2020",2,2,0,116750,991,117.5
"22393","64448","2020",19,18,1,249236.8,2034.526,123.7895
"22394","64449","2020",1,1,0,108000,1091,99
"22395","64450","2020",3,3,0,171538.3,1186.667,139.6667
"22396","64451","2020",1,1,0,150000,1596,94
"22397","64452","2020",3,3,0,162333.3,1753.333,94.66667
"22398","64453","2020",30,28,2,165456.2,1496.4,125.5
"22399","64454","2020",1,1,0,185000,1022,181
"22400","64455","2020",3,3,0,128666.7,970.6667,143.6667
"22401","64456","2020",4,4,0,176295,1350.75,129
"22402","64457","2020",2,2,0,102500,721,165
"22403","64458","2020",3,3,0,112320,786.3333,137.3333
"22404","64459","2020",2,2,0,121500,818.5,149
"22405","64460","2020",7,7,0,198593,1461.286,144
"22406","64461","2020",22,22,0,126424.2,1313.818,96.09091
"22407","64462","2020",10,10,0,153389.8,1433.2,115.9
"22408","64463","2020",4,4,0,140000,1137.75,142.5
"22409","64465","2020",2,2,0,184500,1735,109
"22410","64466","2020",3,2,1,194000,1807,111.3333
"22411","64467","2020",6,5,1,209176.7,1598.167,131.8333
"22412","64468","2020",1,1,0,63000,516,122
"22413","64469","2020",1,1,0,378800,2914,130
"22414","64470","2020",4,4,0,227824.5,1951.5,120.5
"22415","64471","2020",4,4,0,207375,1317.25,146.25
"22416","64472","2020",9,9,0,255545.6,2167.444,122
"22417","64473","2020",2,2,0,112000,1595.5,70
"22418","64474","2020",1,1,0,105000,1105,95
"22419","64475","2020",3,3,0,112033.3,819.6667,166
"22420","64476","2020",2,2,0,255000,2358,115.5
"22421","64477","2020",8,8,0,161375,1519.25,104.75
"22422","64478","2020",5,5,0,302780,2356.4,127.8
"22423","64479","2020",2,2,0,253987,2214.5,115
"22424","64480","2020",1,1,0,60000,612,98
"22425","64481","2020",3,3,0,142666.7,1336.333,107
"22426","64482","2020",8,8,0,254975,1854.25,140
"22427","64483","2020",351,63,288,393230.9,5572.405,69.52707
"22428","64484","2020",5,4,1,228600,1612.4,158.8
"22429","64485","2020",23,15,8,206678,2447.217,87.04348
"22430","64486","2020",1,1,0,143000,1172,122
"22431","64487","2020",2,2,0,79000,917,87
"22432","64488","2020",6,6,0,269396.7,2404.667,117.8333
"22433","64490","2020",5,5,0,218540,1736.8,126
"22434","64491","2020",2,2,0,113000,1216.5,90
"22435","64492","2020",2,2,0,150000,1363.5,110
"22436","64493","2020",19,11,8,151297.4,1537.053,110.0526
"22437","64494","2020",5,5,0,233553.2,1935.4,122.8
"22438","64495","2020",54,19,35,220442.2,2896.926,79.27778
"22439","64496","2020",83,29,54,271696.9,3352.036,81.55422
"22440","64498","2020",2,2,0,307485,1473,195.5
"22441","64499","2020",104,76,28,164599.5,1561.962,105.7692
"22442","64500","2020",4,4,0,153750,936.5,153.25
"22443","64501","2020",5,5,0,130050,1055,127.2
"22444","64502","2020",19,19,0,148876.3,1574.421,90.36842
"22445","64503","2020",1,1,0,1e+05,746,134
"22446","64504","2020",24,14,10,392026.8,2895.542,128.1667
"22447","64505","2020",4,4,0,185675,1536.25,121
"22448","64506","2020",2,2,0,82000,885,95
"22449","64507","2020",1,1,0,221600,1802,123
"22450","64509","2020",1,1,0,120000,1319,91
"22451","64510","2020",9,9,0,140993.3,1216.778,122
"22452","64511","2020",39,37,2,248522.3,2115.487,121.1538
"22453","64512","2020",2,2,0,350000,1840.5,181
"22454","64513","2020",21,18,3,173184.4,1651,107.4762
"22455","64514","2020",1,1,0,190000,1863,102
"22456","64515","2020",4,4,0,193000,1373.75,140.5
"22457","64516","2020",3,3,0,159613.3,2006,78.33333
"22458","64517","2020",3,3,0,164333.3,1129,159
"22459","64518","2020",11,11,0,290063.6,2047.455,145.7273
"22460","64519","2020",57,54,3,254913.4,2115.684,123.1404
"22461","64520","2020",6,6,0,302495,2432,124.8333
"22462","64521","2020",3,2,1,124166.7,1951,61
"22463","64522","2020",3,2,1,194186.7,1294.333,147.6667
"22464","64523","2020",3,3,0,190733.3,1584,119.3333
"22465","64524","2020",3,3,0,133666.7,1417,96.33333
"22466","64525","2020",7,7,0,190971.4,1899.857,101.7143
"22467","64526","2020",18,17,1,189333.5,1707.5,113.8889
"22468","64527","2020",11,5,6,278500.8,3781.818,77.54545
"22469","64528","2020",1,0,1,90000,1125,80
"22470","64529","2020",5,5,0,163420,1344.4,120.6
"22471","64530","2020",3,3,0,145411.7,1516.667,97.66667
"22472","64531","2020",2,2,0,110000,750.5,172.5
"22473","64533","2020",5,4,1,71580,819.2,87.2
"22474","64534","2020",1,1,0,972325,4420,220
"22475","64535","2020",6,6,0,244713.3,1815.667,137.5
"22476","64536","2020",11,11,0,201595.5,1856.091,110.4545
"22477","64537","2020",1,1,0,111000,1542,72
"22478","64538","2020",19,9,10,141005.6,2195.053,63.73684
"22479","64539","2020",3,2,1,92666.67,1129.667,109.6667
"22480","64540","2020",37,33,4,362626,3014,123.6757
"22481","64541","2020",5,5,0,184720,1668.4,118.2
"22482","64542","2020",2,1,1,98000,1544.5,92.5
"22483","64543","2020",1,1,0,130000,1300,100
"22484","64545","2020",155,58,97,319789.2,3835.858,84.48387
"22485","64546","2020",30,25,5,250748.7,2603.033,103.8667
"22486","64547","2020",146,56,90,242825.3,3050.897,80.36986
"22487","64548","2020",1,1,0,148000,1805,82
"22488","64549","2020",9,9,0,235727.6,1903.333,129
"22489","64550","2020",8,8,0,297143.8,2398.375,126.75
"22490","64551","2020",2,2,0,210000,1685.5,144.5
"22491","64552","2020",1,1,0,83000,675,123
"22492","64555","2020",1,1,0,150000,915,164
"22493","64556","2020",2,2,0,180428.5,1908.5,95.5
"22494","64557","2020",7,7,0,133071.4,1329.286,99.85714
"22495","64558","2020",30,21,9,361246,3071.733,127.6333
"22496","64559","2020",9,9,0,137138.9,1114.333,126.5556
"22497","64560","2020",1,1,0,141000,1880,75
"22498","65001","2020",1,1,0,243000,2826,86
"22499","65002","2020",7,6,1,165428.6,1675.286,108.1429
"22500","65003","2020",7,3,4,103254.6,1857.286,51.57143
"22501","65004","2020",1,1,0,296000,2426,122
"22502","65005","2020",5,5,0,229800,1871.6,128
"22503","65006","2020",6,6,0,169333.3,1503.5,121.8333
"22504","65007","2020",13,12,1,170836.5,1470.615,125.3846
"22505","65009","2020",2,2,0,150500,1579,96
"22506","65010","2020",3,3,0,253890,2200.667,125.6667
"22507","65011","2020",3,3,0,125866.7,1371.333,94.33333
"22508","65012","2020",2,2,0,199650,1471,134.5
"22509","65014","2020",2,2,0,108150,1109.5,104
"22510","65015","2020",4,4,0,113250,713.25,160.75
"22511","65016","2020",1,1,0,256500,2138,120
"22512","65017","2020",26,4,22,70871.58,2008,39.30769
"22513","65018","2020",1,1,0,80000,471,170
"22514","65019","2020",7,7,0,193135,1416.714,138.2857
"22515","65020","2020",2,2,0,132300,1522,96.5
"22516","65021","2020",5,4,1,166992,1687,104.4
"22517","65022","2020",1,1,0,150000,1500,100
"22518","65024","2020",1,1,0,205000,1952,105
"22519","65025","2020",55,29,26,157947.8,1861.145,89.07273
"22520","65026","2020",2,2,0,228725,1106.5,207
"22521","65028","2020",1,1,0,230550,883,261
"22522","65029","2020",7,7,0,267197.1,2005,138.1429
"22523","65031","2020",28,8,20,83632.14,1678,56.92857
"22524","65032","2020",15,14,1,190884.6,2036.8,99.06667
"22525","65034","2020",1,1,0,283800,1819,156
"22526","65035","2020",7,7,0,125759.1,1077.286,130.7143
"22527","65036","2020",1,1,0,205000,3417,60
"22528","65039","2020",1,1,0,125000,1359,92
"22529","65040","2020",5,5,0,194890,1552.4,126
"22530","65042","2020",5,5,0,133170,1371.6,98
"22531","65043","2020",2,2,0,217000,1785.5,131.5
"22532","65044","2020",1,1,0,101500,1153,88
"22533","65045","2020",8,5,3,163722.5,2271,82.25
"22534","65046","2020",1,1,0,197050,1642,120
"22535","65047","2020",100,81,19,130760.2,1437.04,94.1
"22536","65048","2020",7,6,1,176185.7,1720.714,103.2857
"22537","65049","2020",6,6,0,125233.3,972.1667,132.3333
"22538","65050","2020",1,1,0,145000,1295,112
"22539","65051","2020",3,3,0,96833.33,907.6667,111.6667
"22540","65054","2020",7,7,0,116728.6,1074.286,118
"22541","65055","2020",3,3,0,195290.3,1737.667,112.6667
"22542","65056","2020",2,2,0,155000,1835,81.5
"22543","65057","2020",3,3,0,158133.3,1608.667,101.6667
"22544","65058","2020",2,2,0,149040,1450.5,95
"22545","65059","2020",212,72,140,97247.65,1660.462,63.35377
"22546","65060","2020",1,1,0,274200,2016,136
"22547","65061","2020",1,1,0,178600,1540,116
"22548","65062","2020",37,36,1,171677.5,1717.622,102.6486
"22549","65064","2020",2,2,0,282250,1909,127.5
"22550","65065","2020",4,4,0,188400,1525,124.25
"22551","65066","2020",1,1,0,160000,2353,68
"22552","65069","2020",18,17,1,139281.3,1332.167,103.1667
"22553","65070","2020",6,6,0,190416.7,2034.833,98.5
"22554","65072","2020",13,13,0,132862.1,1516.538,90.38462
"22555","65073","2020",1,1,0,217000,1750,124
"22556","65074","2020",1,1,0,44444,342,130
"22557","65077","2020",3,3,0,194596.7,1522.667,122.6667
"22558","65078","2020",8,8,0,81623.75,1200.875,72.625
"22559","65079","2020",1,1,0,175000,2083,84
"22560","65080","2020",2,2,0,219020,1906,113.5
"22561","65081","2020",2,2,0,177000,1587.5,116
"22562","65083","2020",3,3,0,173583.3,1316.333,125.6667
"22563","65084","2020",2,2,0,267055,1827.5,146
"22564","65085","2020",3,3,0,179674,1375.667,135.3333
"22565","65086","2020",1,1,0,40000,727,55
"22566","65087","2020",2,2,0,109000,900,111
"22567","65089","2020",3,3,0,91533,1014.333,87
"22568","65090","2020",1,1,0,158000,1436,110
"22569","65092","2020",2,2,0,93500,1453.5,76
"22570","65093","2020",4,4,0,101637.5,1547.25,69.75
"22571","65094","2020",5,5,0,144800,1137.8,137.4
"22572","65095","2020",4,4,0,145610,1263.75,122.25
"22573","65096","2020",2,2,0,151800,1773,85
"22574","65097","2020",1,1,0,115000,891,129
"22575","65098","2020",3,3,0,211893.7,2251,97
"22576","65099","2020",1,0,1,218300,2079,105
"22577","65100","2020",54,51,3,155157.2,1579.722,101.6667
"22578","65101","2020",8,8,0,126381.2,1306.25,105.375
"22579","65102","2020",1,1,0,225000,1184,190
"22580","65104","2020",2,2,0,205900,1619.5,132
"22581","65105","2020",6,6,0,143333.3,1231.167,115.5
"22582","65106","2020",3,0,3,115271.7,3359.333,33
"22583","65107","2020",2,2,0,276000,1789.5,153.5
"22584","65108","2020",9,9,0,193502.1,1695.444,112.5556
"22585","65111","2020",2,2,0,100500,1003.5,89
"22586","65112","2020",2,2,0,152500,1243.5,113
"22587","65115","2020",1,1,0,48000,774,62
"22588","65116","2020",7,6,1,185085.7,1734.714,109
"22589","65119","2020",5,5,0,114340,2270.4,94.4
"22590","65120","2020",1,1,0,183000,1452,126
"22591","65121","2020",3,3,0,137900,1450,96
"22592","65123","2020",52,37,15,123758.1,1838.731,75.01923
"22593","65125","2020",1,1,0,120370,792,152
"22594","65126","2020",4,4,0,121375,1121.75,129.5
"22595","65127","2020",16,14,2,134499.2,1494.188,92.75
"22596","65128","2020",1,1,0,108000,1440,75
"22597","65129","2020",12,12,0,127506.7,964.8333,127.9167
"22598","65130","2020",5,5,0,193000,857.8,204.8
"22599","65131","2020",2,2,0,155000,1052.5,147.5
"22600","65135","2020",1,1,0,72000,1108,65
"22601","65136","2020",1,1,0,120000,833,144
"22602","65137","2020",3,3,0,106533.3,972.3333,112
"22603","65138","2020",226,14,212,99432.35,2736.363,37.27876
"22604","65139","2020",1,1,0,1e+05,1053,95
"22605","65140","2020",2,2,0,315500,2662,118
"22606","65141","2020",2,2,0,206000,2108.5,104
"22607","65142","2020",7,7,0,144082.9,1202.857,135.2857
"22608","65143","2020",1,1,0,193000,1739,111
"22609","65144","2020",4,4,0,152297.5,2646.25,56.25
"22610","65145","2020",1,1,0,165000,1500,110
"22611","65146","2020",4,4,0,222502.5,1927.5,114.5
"22612","65147","2020",3,3,0,156300,1885.667,79.33333
"22613","65148","2020",3,3,0,88333.33,887.6667,101
"22614","65149","2020",3,3,0,202600,1604,131.3333
"22615","65150","2020",3,3,0,96533.33,1191.333,109.6667
"22616","65151","2020",1,1,0,177500,1325,134
"22617","65154","2020",2,2,0,117500,1027.5,119
"22618","65156","2020",3,3,0,233833.3,1886,137
"22619","65159","2020",2,2,0,201850,1368,149.5
"22620","65161","2020",1,1,0,214000,1259,170
"22621","65162","2020",1,1,0,115000,1278,90
"22622","65165","2020",2,2,0,200575,2044,144
"22623","65166","2020",1,1,0,179500,1795,100
"22624","65168","2020",18,3,15,133033.3,2783.722,49
"22625","65169","2020",1,1,0,1e+06,9804,102
"22626","65171","2020",2,1,1,145000,1801,76.5
"22627","65173","2020",6,4,2,88325,2348.167,44.5
"22628","65175","2020",2,2,0,30000,445.5,67
"22629","65176","2020",7,7,0,101428.6,935.1429,112.5714
"22630","65177","2020",4,4,0,158280,1141,134
"22631","65179","2020",1,1,0,174890,2915,60
"22632","65182","2020",6,6,0,199013.3,1667.167,127
"22633","65183","2020",8,8,0,132358.8,1226.375,114.25
"22634","65184","2020",2,2,0,114175,1397,90.5
"22635","65185","2020",3,3,0,173566.7,1548.667,111.6667
"22636","65187","2020",1,1,0,145000,1107,131
"22637","65189","2020",3,3,0,147416.7,1090.667,148.3333
"22638","65191","2020",3,3,0,113333.3,1021,115.3333
"22639","65192","2020",12,8,4,103020,1509.917,68.83333
"22640","65193","2020",1,1,0,138000,1200,115
"22641","65195","2020",14,4,10,122768.9,1770.286,57.57143
"22642","65196","2020",1,1,0,60000,857,70
"22643","65197","2020",1,1,0,155400,1351,115
"22644","65198","2020",9,9,0,170100.6,1491.444,121.4444
"22645","65199","2020",17,0,17,116517.5,2527.353,42.29412
"22646","65200","2020",4,4,0,169037.5,1631.5,121.25
"22647","65201","2020",2,2,0,151000,1374.5,110
"22648","65202","2020",3,3,0,321772,2029.667,162
"22649","65205","2020",2,2,0,285000,2511.5,117
"22650","65206","2020",3,3,0,218833.3,1647,141
"22651","65209","2020",2,2,0,107350,966,124.5
"22652","65212","2020",8,2,6,122862.5,2104.5,65.125
"22653","65217","2020",2,2,0,135000,1480,91
"22654","65218","2020",9,8,1,101944.4,1203.444,86.44444
"22655","65221","2020",3,3,0,134650,1088,122.3333
"22656","65222","2020",1,1,0,133000,1108,120
"22657","65223","2020",24,24,0,223518.5,2055.625,115.2917
"22658","65226","2020",27,25,2,223807.7,2008.889,117
"22659","65228","2020",2,2,0,80475,690.5,116.5
"22660","65230","2020",3,3,0,121666.7,947.3333,136
"22661","65232","2020",1,1,0,285000,1966,145
"22662","65233","2020",3,2,1,112666.7,1512,88.66667
"22663","65234","2020",1,0,1,158450,2476,64
"22664","65235","2020",42,42,0,187194,1803.952,104.8333
"22665","65236","2020",1,1,0,170000,1466,116
"22666","65237","2020",1,1,0,49000,700,70
"22667","65238","2020",3,3,0,235000,1989.667,112.6667
"22668","65239","2020",1,1,0,35000,530,66
"22669","65240","2020",4,4,0,282735,1578.5,185.5
"22670","65241","2020",1,1,0,153000,1962,78
"22671","65242","2020",4,4,0,213602.5,1782.5,122
"22672","65243","2020",7,7,0,152521.4,1260.286,126.7143
"22673","65244","2020",6,6,0,182591.7,1433.667,125.3333
"22674","65245","2020",2,2,0,51000,748.5,65
"22675","65248","2020",3,3,0,120166.7,1189.333,115
"22676","65249","2020",1,1,0,125000,1667,75
"22677","65250","2020",2,2,0,177757.5,1555.5,114.5
"22678","65251","2020",20,20,0,202927.5,1811.1,115.8
"22679","65252","2020",9,9,0,188820.2,1520.778,134.5556
"22680","65254","2020",4,4,0,99000,978,98.75
"22681","65255","2020",1,1,0,85000,859,99
"22682","65256","2020",3,3,0,131666.7,1513.333,90
"22683","65257","2020",2,2,0,223082.5,1486.5,153
"22684","65258","2020",72,46,26,99862.64,1116.181,89.80556
"22685","65259","2020",2,2,0,157500,1268,124.5
"22686","65262","2020",3,3,0,112100,921.6667,124.3333
"22687","65263","2020",1,1,0,130000,1429,91
"22688","65264","2020",4,4,0,153537.5,1370.75,115.75
"22689","65265","2020",3,3,0,140000,864.6667,137.3333
"22690","65266","2020",1,1,0,160000,1185,135
"22691","65267","2020",6,5,1,221087.7,2105,112.8333
"22692","65268","2020",3,3,0,217523.3,1939,103.3333
"22693","65270","2020",1,1,0,244000,2239,109
"22694","65271","2020",3,3,0,172766.7,1386,124.3333
"22695","65273","2020",1,1,0,106000,1472,72
"22696","65274","2020",2,2,0,258300,1254.5,197.5
"22697","65277","2020",1,1,0,70000,551,127
"22698","65278","2020",1,1,0,151000,1888,80
"22699","65279","2020",5,5,0,98183,876.8,115.6
"22700","65280","2020",3,3,0,139333.3,1284,100.3333
"22701","65281","2020",3,3,0,256906.7,1865.667,137.6667
"22702","65282","2020",11,4,7,160736.4,3331.636,50.09091
"22703","65283","2020",3,2,1,105116.7,1755.667,59.66667
"22704","65284","2020",10,10,0,188039.9,1695.8,115.6
"22705","65286","2020",261,97,164,84417.41,1245.502,74.06897
"22706","65287","2020",11,10,1,99039.36,1044.636,94.36364
"22707","65288","2020",2,2,0,157500,995,158
"22708","65290","2020",1,1,0,129000,1290,100
"22709","65291","2020",3,3,0,96666.67,1049.667,92.66667
"22710","65292","2020",4,4,0,151440,1370.75,111.5
"22711","65293","2020",3,3,0,114974.3,914,128
"22712","65294","2020",2,2,0,146000,1076.5,135
"22713","65295","2020",61,8,53,87374.28,2234.639,42.09836
"22714","65296","2020",3,3,0,87666.67,789.3333,116
"22715","65300","2020",3,3,0,147333.3,1815.333,82
"22716","65301","2020",6,6,0,194333.3,1598.5,124.6667
"22717","65303","2020",3,3,0,151666.7,1973.333,79.33333
"22718","65304","2020",37,35,2,113079.2,1106.324,101.6757
"22719","65305","2020",9,9,0,77464.44,1181.222,67.44444
"22720","65306","2020",3,3,0,215733.3,4036.333,77
"22721","65307","2020",2,2,0,110000,773,141.5
"22722","65308","2020",3,3,0,99833.33,986.6667,102
"22723","65310","2020",2,2,0,128000,1224.5,111.5
"22724","65311","2020",2,2,0,167575,1737.5,96
"22725","65313","2020",5,4,1,106760,1346.2,78.8
"22726","65315","2020",7,7,0,129928.6,1169.429,116
"22727","65316","2020",3,3,0,79500,810,96.33333
"22728","65318","2020",2,2,0,96250,1133,90
"22729","65319","2020",3,3,0,104200,794,139.6667
"22730","65320","2020",9,9,0,165595,1761.111,107.5556
"22731","65321","2020",3,3,0,195866.7,1983.333,101
"22732","65322","2020",2,2,0,207000,2614,79
"22733","65324","2020",2,2,0,112875,1198,94.5
"22734","65325","2020",1,1,0,264230,1376,192
"22735","65326","2020",1,1,0,132000,1833,72
"22736","65327","2020",3,3,0,106333.3,1102.667,105
"22737","65328","2020",1,1,0,30000,390,77
"22738","65329","2020",7,7,0,97968.57,1357.571,80.14286
"22739","65330","2020",1,1,0,190000,2000,95
"22740","65331","2020",35,35,0,156454.3,1536.2,105.3143
"22741","65334","2020",3,3,0,172016.7,1803,93.33333
"22742","65335","2020",6,6,0,107533.3,1739.5,62.66667
"22743","65337","2020",1,1,0,45000,1216,37
"22744","65338","2020",3,3,0,153000,1373,110.6667
"22745","65339","2020",3,3,0,168200,1025.333,169.3333
"22746","65340","2020",26,25,1,174811.9,1696.846,104.7308
"22747","65343","2020",2,2,0,128000,1253.5,102
"22748","65344","2020",25,25,0,168982.6,1423.96,128.56
"22749","65346","2020",3,3,0,222633.3,1535.667,147
"22750","65347","2020",2,2,0,56500,1019,56.5
"22751","65348","2020",1,1,0,1e+05,1562,64
"22752","65350","2020",16,16,0,197660.4,1904.312,111.5
"22753","65351","2020",3,3,0,174540,1734.333,95.33333
"22754","65352","2020",2,2,0,190650,2280,113.5
"22755","65353","2020",3,2,1,96666.67,899.3333,102
"22756","65354","2020",1,1,0,80160,891,90
"22757","65356","2020",1,1,0,77000,939,82
"22758","65360","2020",3,3,0,160650,1217,136
"22759","65361","2020",1,1,0,98000,754,130
"22760","65362","2020",21,13,8,139107.1,1605.857,88.09524
"22761","65363","2020",4,4,0,163875,1330.75,129
"22762","65366","2020",7,6,1,124857.1,1291.857,98.28571
"22763","65367","2020",2,2,0,194325,1697,115.5
"22764","65369","2020",5,5,0,175570,1672.8,113.2
"22765","65370","2020",12,12,0,153074.2,1593,95.5
"22766","65372","2020",5,5,0,183396,1540.2,149.6
"22767","65373","2020",3,3,0,352910,2934.667,130.3333
"22768","65374","2020",1,1,0,56000,1600,35
"22769","65375","2020",18,17,1,117866.7,1308.778,93.27778
"22770","65376","2020",3,3,0,173500,1210,148.6667
"22771","65377","2020",3,3,0,153333.3,1020,150.3333
"22772","65378","2020",2,2,0,115000,1191,109
"22773","65380","2020",2,2,0,205172.5,1893.5,108.5
"22774","65382","2020",2,2,0,75000,835.5,91
"22775","65384","2020",3,2,1,119261.7,1562.667,76.33333
"22776","65385","2020",1,1,0,138600,2475,56
"22777","65386","2020",1,1,0,111000,1110,100
"22778","65387","2020",4,4,0,109250,1324.5,103.25
"22779","65388","2020",183,13,170,109421,2671.322,40.18579
"22780","65389","2020",16,16,0,116340.6,1297.312,96.0625
"22781","65390","2020",3,3,0,137300,1227.667,121.3333
"22782","65392","2020",5,5,0,185600,2156.4,94.6
"22783","65393","2020",2,2,0,162500,1469,108
"22784","65394","2020",7,7,0,100870.1,1020.286,95.28571
"22785","65395","2020",16,14,2,114628.1,1308.688,95.6875
"22786","65396","2020",11,7,4,155631.8,1636.636,110.9091
"22787","65397","2020",1,1,0,97300,541,180
"22788","65398","2020",5,5,0,77040,1171.4,68.6
"22789","65399","2020",2,1,1,180399.5,2164.5,99.5
"22790","65400","2020",1,1,0,182000,1400,130
"22791","65401","2020",9,9,0,227895.7,1713.444,125.5556
"22792","65404","2020",3,3,0,150000,1572.333,101.3333
"22793","65405","2020",1,1,0,138000,1725,80
"22794","65406","2020",3,3,0,116369.7,1409.333,92
"22795","65407","2020",2,2,0,128350,1191,126.5
"22796","65408","2020",12,9,3,79970.83,1008.167,79.66667
"22797","65409","2020",7,7,0,121500,991.1429,121.5714
"22798","65410","2020",6,6,0,87666.67,975.5,96.66667
"22799","65412","2020",2,2,0,206000,1659.5,157
"22800","65413","2020",7,4,3,124435.7,1599.429,82.57143
"22801","65415","2020",2,2,0,146000,1484,95.5
"22802","65416","2020",4,4,0,95500,1511.25,67
"22803","65417","2020",57,50,7,152288.7,1581,97.36842
"22804","65418","2020",2,2,0,162500,1306,120
"22805","65420","2020",4,4,0,168300,1547.75,101.75
"22806","65422","2020",3,3,0,232602.7,1463.667,169.3333
"22807","65423","2020",2,2,0,165000,1088.5,153.5
"22808","65424","2020",3,2,1,137666.7,2465,62
"22809","65425","2020",3,3,0,207183.3,1473.333,145.3333
"22810","65426","2020",1,1,0,216150,2162,100
"22811","65427","2020",8,8,0,98765.38,1181.375,89.625
"22812","65428","2020",1,1,0,83000,943,88
"22813","65429","2020",5,5,0,125817.6,1300.2,104
"22814","65431","2020",6,6,0,84016.67,1131.167,85.5
"22815","65432","2020",1,1,0,129500,1295,100
"22816","65433","2020",35,25,10,140241.7,1566.286,89.88571
"22817","65435","2020",8,6,2,133388.1,1828,78.5
"22818","65436","2020",4,4,0,191500,1529.75,126
"22819","65437","2020",1,1,0,157607,1751,90
"22820","65439","2020",2,2,0,130500,1460,89.5
"22821","65440","2020",813,207,606,93606.06,1318.809,72.21894
"22822","65441","2020",2,2,0,111000,925,120
"22823","65442","2020",2,2,0,90000,907,99.5
"22824","65444","2020",3,3,0,198616.7,1312,153.3333
"22825","65445","2020",2,2,0,199725,1455.5,124
"22826","65446","2020",3,3,0,202150,1184.667,169.6667
"22827","65447","2020",21,19,2,133129.2,1232.524,106.7143
"22828","65449","2020",2,2,0,78210,741.5,102
"22829","65451","2020",9,9,0,170560.6,1373.778,137.2222
"22830","65452","2020",13,13,0,97788.85,800,126
"22831","65453","2020",1,1,0,113553,1081,105
"22832","65454","2020",1,1,0,53772,815,66
"22833","65455","2020",7,7,0,140000,1103.429,130
"22834","65456","2020",3,3,0,201066.7,2043,99.33333
"22835","65458","2020",1,1,0,224400,2640,85
"22836","65459","2020",1,1,0,120000,1043,115
"22837","65460","2020",56,50,6,131030.7,1304.643,106.3036
"22838","65462","2020",4,4,0,129675,1082.5,108
"22839","65464","2020",4,4,0,200425,1785,111
"22840","65465","2020",28,4,24,108989.3,2476.107,44.89286
"22841","65466","2020",1,1,0,559410,2756,203
"22842","65467","2020",1,1,0,325000,2031,160
"22843","65469","2020",2,1,1,87500,1805.5,47.5
"22844","65471","2020",16,3,13,136719.7,3279.562,42.25
"22845","65472","2020",2,2,0,130250,1337.5,98
"22846","65473","2020",7,7,0,153010,1941.143,85.71429
"22847","65477","2020",1,1,0,145000,1115,130
"22848","65478","2020",1,1,0,95000,1357,70
"22849","65479","2020",4,4,0,243475,2303.75,104
"22850","65481","2020",36,5,31,68769.17,1875.389,35.66667
"22851","65482","2020",2,2,0,141300,744,190
"22852","66002","2020",54,46,8,231241.1,2449.574,95.05556
"22853","66003","2020",202,21,181,68380.4,1357.391,50.18317
"22854","66004","2020",171,37,134,109430.8,2485.404,41.08187
"22855","66005","2020",9,7,2,190017.8,2592.333,73.66667
"22856","66006","2020",4,4,0,55560,994,57.75
"22857","66008","2020",420,155,265,159835.1,3022.526,55.53571
"22858","66009","2020",44,35,9,125269.4,1391.75,87.63636
"22859","66010","2020",2,2,0,84150,2314,62
"22860","66011","2020",69,61,8,184936.2,2083.841,90.49275
"22861","66012","2020",53,42,11,183928.1,2174.434,84.60377
"22862","66013","2020",2,1,1,65000,962,67
"22863","66014","2020",48,47,1,124783.9,1594,80.0625
"22864","66015","2020",27,25,2,171167.4,2173.148,90.18519
"22865","66016","2020",100,48,52,220361.9,3119.53,72.61
"22866","66017","2020",560,129,431,102051.6,2735.541,37.71429
"22867","66018","2020",3,3,0,84266.67,1126.667,72.33333
"22868","66019","2020",7,7,0,142751.4,1715.571,83.71429
"22869","66020","2020",126,43,83,147100,2665.889,52.80952
"22870","66021","2020",93,89,4,213761.4,2050.387,103.5376
"22871","66023","2020",12,11,1,126860.8,1430.667,84.66667
"22872","66024","2020",105,81,24,166894.6,2042.933,82.98095
"22873","66025","2020",15,6,9,149666,2035.667,80.6
"22874","66026","2020",18,17,1,275730.6,2452.111,112.8333
"22875","66027","2020",11,9,2,173043.9,1611.364,110.1818
"22876","66028","2020",154,129,25,230205.3,2214.792,102.5714
"22877","66029","2020",6,6,0,369091.7,3536,90.33333
"22878","66030","2020",3,3,0,204083.3,2362.667,77.66667
"22879","66032","2020",3,3,0,195000,2150.667,106
"22880","66033","2020",5,5,0,277038.8,2906.8,97.2
"22881","66034","2020",4,4,0,55750,1181.5,55
"22882","66035","2020",2,2,0,35000,634,55
"22883","66036","2020",4,4,0,77000,1001,87.25
"22884","66037","2020",542,152,390,158181.8,3027.688,53.31734
"22885","66038","2020",130,122,8,234196,2222.262,106.4846
"22886","66039","2020",4,4,0,49125,623.75,79.5
"22887","66041","2020",20,20,0,184022.5,1820.8,100.35
"22888","66042","2020",2,2,0,43750,742.5,58
"22889","66043","2020",1,1,0,134490,2402,56
"22890","66044","2020",5,5,0,415044,4317.2,90.8
"22891","66045","2020",18,18,0,162536.1,1482.5,106.6111
"22892","66046","2020",7,7,0,68887.86,721.4286,82.42857
"22893","66047","2020",1,1,0,1e+05,1250,80
"22894","66048","2020",30,6,24,137519.5,2135.267,69.13333
"22895","66049","2020",142,94,48,186372.3,2079.493,89.06338
"22896","66050","2020",77,66,11,173542.9,1908.182,90.1039
"22897","66051","2020",4,4,0,105250,1380.25,72.25
"22898","66052","2020",12,12,0,175967.5,1782.25,101.1667
"22899","66053","2020",99,28,71,235825.9,4477.939,56.76768
"22900","66054","2020",2,2,0,95500,1279.5,75
"22901","66055","2020",12,12,0,150659.2,1542.75,93.25
"22902","66056","2020",13,13,0,133653.8,1811.923,77
"22903","66057","2020",14,14,0,104759.5,1458.643,79.14286
"22904","66058","2020",30,29,1,171280.2,1756.233,95.96667
"22905","66059","2020",44,37,7,219438.7,2284.75,95.43182
"22906","66060","2020",6,5,1,119985,1146.333,108.3333
"22907","66061","2020",4,4,0,120975,1443,76.5
"22908","66062","2020",6,2,4,194166.7,2675.167,76
"22909","66063","2020",4,4,0,317850,2687,122.25
"22910","66064","2020",10,6,4,221160,2203.8,95.6
"22911","66065","2020",121,100,21,169832.5,2029.074,87.10744
"22912","66066","2020",14,9,5,142906.4,2856,71.71429
"22913","66067","2020",18,1,17,111338.9,1988.389,58.72222
"22914","66068","2020",3,3,0,126706.7,1643.667,77
"22915","66069","2020",56,49,7,149816.6,1703.696,87.44643
"22916","66070","2020",7,7,0,107430.1,1001.143,107.5714
"22917","66071","2020",52,51,1,106953.5,1404.154,77.23077
"22918","66072","2020",13,4,9,140219.2,2327.846,59.23077
"22919","66073","2020",4,4,0,127500,2268,63.75
"22920","66074","2020",4,4,0,183250,1768.75,93.75
"22921","66075","2020",23,19,4,152401.7,2991.696,54.43478
"22922","66076","2020",3,3,0,96636.67,933.3333,95.33333
"22923","66077","2020",2,2,0,109500,1099.5,103.5
"22924","66078","2020",8,8,0,170428.1,1771.5,96
"22925","66079","2020",4,4,0,63625,816.75,78.5
"22926","66080","2020",6,5,1,69585,1252.667,61.5
"22927","66081","2020",3,3,0,270321.7,2066.667,161.6667
"22928","66082","2020",29,18,11,168129.4,2496.103,68.51724
"22929","66083","2020",1,1,0,30000,1071,28
"22930","66084","2020",31,30,1,188086.7,1924.129,97.41935
"22931","66085","2020",3,3,0,117333.3,1556.333,70.66667
"22932","66088","2020",79,69,10,144282,1634.911,86.31646
"22933","66089","2020",4,4,0,166762,1182,124.5
"22934","66090","2020",2,2,0,106000,1250.5,84
"22935","66091","2020",2,1,1,159575,1934,72
"22936","66092","2020",3,3,0,104833.3,969,112.3333
"22937","66093","2020",44,42,2,286536.8,2578.75,111.2273
"22938","66094","2020",45,40,5,228008.6,2317.244,98.37778
"22939","66095","2020",10,6,4,156603.3,1974.4,80.6
"22940","66096","2020",22,20,2,132254.6,1375.227,100.3182
"22941","66097","2020",3,3,0,64333.33,893,70.66667
"22942","66098","2020",10,7,3,213653.8,2731.1,69.7
"22943","66099","2020",7,7,0,216285.7,2305.286,94.14286
"22944","66101","2020",28,28,0,207674.9,2197.607,96.57143
"22945","66103","2020",10,10,0,128463,1738.6,88.3
"22946","66104","2020",18,17,1,159552.8,1835.778,91.94444
"22947","66105","2020",13,13,0,177268.5,2659.308,75.92308
"22948","66106","2020",54,52,2,177838.9,1821.907,96.12963
"22949","66107","2020",18,18,0,73611.11,929.9444,81.88889
"22950","66108","2020",58,58,0,164615.3,1761.5,89.94828
"22951","66109","2020",5,5,0,244300,2037.6,112.6
"22952","66111","2020",5,5,0,102600,1127.4,81.6
"22953","66112","2020",4,4,0,405476,3027.75,137.25
"22954","66113","2020",7,4,3,116778.6,1644.286,71.42857
"22955","66114","2020",20,18,2,225382.2,2539.9,94.8
"22956","66115","2020",21,21,0,262204.3,2400.905,109
"22957","66116","2020",6,6,0,196730,1494.667,145.6667
"22958","66117","2020",2,1,1,110250,2060.5,58
"22959","66118","2020",12,12,0,161875,1779.5,91.75
"22960","66119","2020",3,3,0,65500,989.6667,65.33333
"22961","66120","2020",1,1,0,352300,2818,125
"22962","66121","2020",25,25,0,152669.6,1693.08,86.52
"22963","66123","2020",4,4,0,92902.5,1152.25,83.25
"22964","66124","2020",196,27,169,101268.3,2082.689,47.52041
"22965","66125","2020",2,1,1,53500,689,77.5
"22966","66126","2020",11,11,0,241757.3,2217.455,106.8182
"22967","66127","2020",25,25,0,165831.6,1822.28,94.84
"22968","66129","2020",31,30,1,173189.6,2020.258,89.19355
"22969","66130","2020",30,11,19,168657.3,2431.533,71.46667
"22970","66132","2020",9,7,2,198477.8,3165.333,73.11111
"22971","66133","2020",41,40,1,226520,2478.463,86.26829
"22972","66134","2020",25,24,1,182699.5,1905.24,99.28
"22973","66136","2020",2275,616,1659,121221.5,1581.143,75.20835
"22974","66137","2020",8,7,1,84750,935.375,88.625
"22975","66138","2020",23,22,1,156597.8,1949.13,80.21739
"22976","66139","2020",2,2,0,53458.5,733,75
"22977","66140","2020",46,46,0,173392.6,2099.217,87.08696
"22978","66141","2020",135,130,5,174840.1,1874.385,93.94074
"22979","66142","2020",1,1,0,118000,3371,35
"22980","66143","2020",2,2,0,34500,588.5,58.5
"22981","66144","2020",91,84,7,216038,2233.791,97.42857
"22982","66145","2020",34,33,1,190513.4,2055.265,92.76471
"22983","66146","2020",3,3,0,126483.3,2043,62.33333
"22984","66147","2020",6,3,3,54583.33,1247,50.66667
"22985","66148","2020",115,31,84,159736.4,2566.339,65.05217
"22986","66149","2020",97,72,25,122046.5,1535.784,80.78351
"22987","66150","2020",20,12,8,93048.75,1256.1,72.4
"22988","66151","2020",1,1,0,35000,365,96
"22989","66154","2020",18,11,7,105263.9,2465,44.44444
"22990","66155","2020",1,1,0,110000,1594,69
"22991","66156","2020",1,1,0,35000,833,42
"22992","66158","2020",5,5,0,108716,1277,88.2
"22993","66159","2020",1,1,0,148300,1705,87
"22994","66160","2020",21,18,3,238043.6,2403,99.42857
"22995","66161","2020",15,15,0,130600.7,1476,92
"22996","66162","2020",9,9,0,182543.3,1986.222,92.88889
"22997","66164","2020",106,79,27,150666.6,1785.481,84.61321
"22998","66165","2020",14,13,1,151821.4,1672.214,88.14286
"22999","66166","2020",5,5,0,90100,1122.4,88.4
"23000","66167","2020",22,16,6,191283.6,2550.045,76.18182
"23001","66168","2020",71,66,5,234798.7,2627.718,92.01408
"23002","66169","2020",6,6,0,157335.2,1491.5,102.5
"23003","66171","2020",640,286,354,154565.3,3161.228,52.22344
"23004","66172","2020",199,131,68,189163.7,2095.92,89.59799
"23005","66173","2020",19,18,1,147967.4,1828,81.63158
"23006","66174","2020",29,28,1,154011.7,1926.966,80.86207
"23007","66175","2020",54,51,3,213955.3,2184.685,101.463
"23008","66176","2020",63,60,3,180832.5,2089.873,88.25397
"23009","66177","2020",26,26,0,220119.8,2095.077,106.2692
"23010","66178","2020",29,26,3,225123.9,2025.552,114.7931
"23011","66179","2020",32,27,5,122200.4,1329.25,81.65625
"23012","66180","2020",157,140,17,176808.7,2082.847,84.36943
"23013","66181","2020",14,8,6,142886.9,2334.714,57.85714
"23014","66182","2020",149,119,30,164928.1,3078.544,56.97315
"23015","66183","2020",5,4,1,178592,1706.2,102.8
"23016","66184","2020",1,1,0,19500,390,50
"23017","66185","2020",6,6,0,241883.3,2307.333,100.6667
"23018","66186","2020",51,46,5,218462.6,2265.314,95.7451
"23019","66187","2020",37,35,2,114673.5,1235.892,91.86486
"23020","66188","2020",18,11,7,149895.8,2330.111,65.66667
"23021","66189","2020",84,67,17,244318.5,2435.06,100.3214
"23022","66190","2020",43,40,3,133441,1938.581,72.69767
"23023","66191","2020",2,2,0,136750,1631.5,84.5
"23024","66192","2020",3,3,0,71000,1019,77.33333
"23025","66193","2020",6,6,0,55333.33,1193.167,51.33333
"23026","66194","2020",9,9,0,164584.4,1757.556,99.44444
"23027","66195","2020",110,103,7,206880.2,2104.864,98.52727
"23028","66196","2020",68,67,1,215429.2,2375.75,97.11765
"23029","66198","2020",7,7,0,87642.86,1123.429,85.71429
"23030","66199","2020",3,3,0,112333.3,2527.667,41.33333
"23031","66201","2020",1,1,0,87000,1115,78
"23032","66202","2020",4,0,4,96375,2125.75,47.5
"23033","66203","2020",1,1,0,79000,878,90
"23034","66204","2020",8,8,0,196578.8,2313.5,95
"23035","66205","2020",15,14,1,116004.5,1363.067,80.66667
"23036","66206","2020",4,4,0,103833.8,1003.75,107.25
"23037","66207","2020",13,12,1,156295.4,1905.538,84.23077
"23038","66208","2020",25,24,1,216419.9,2223.4,100.16
"23039","66210","2020",104,82,22,186615.3,2270.077,84.86538
"23040","66211","2020",4,4,0,278511.2,2207,132.25
"23041","66212","2020",118,114,4,167080.2,2537.619,69.48305
"23042","66213","2020",116,106,10,185890.7,1928.095,96.85345
"23043","66214","2020",20,19,1,181223.1,1940.8,93
"23044","66216","2020",1,1,0,78000,624,125
"23045","66217","2020",39,38,1,195311.6,1871.949,103.3077
"23046","66218","2020",8,6,2,206557.6,3119.125,78.375
"23047","66219","2020",2,2,0,120950,1397.5,86.5
"23048","66220","2020",2,2,0,131465,2174,60.5
"23049","66221","2020",1,1,0,190000,1638,116
"23050","66222","2020",68,26,42,95678.69,1404.088,61.27941
"23051","66223","2020",5,3,2,146104,2039,63.4
"23052","66224","2020",51,45,6,175618.4,1905.118,90.56863
"23053","66225","2020",45,42,3,231647.7,2304.267,104.7333
"23054","66226","2020",28,28,0,179506.8,2188.107,83.89286
"23055","66227","2020",70,63,7,229698.6,2293.457,100.7857
"23056","66228","2020",22,21,1,172168.6,1931.136,90.95455
"23057","66230","2020",43,41,2,141123.7,1698,88.27907
"23058","66231","2020",7,7,0,74725,1202,61.28571
"23059","66232","2020",3,3,0,45800,882.3333,61
"23060","66233","2020",5,4,1,191889.2,2946.4,68.2
"23061","66234","2020",5,5,0,85120,807,106.8
"23062","69001","2020",7,7,0,226582.9,1963.286,117.8571
"23063","69002","2020",3,3,0,218808.3,1269.333,172.6667
"23064","69003","2020",39,14,25,286562.1,3557,82.48718
"23065","69004","2020",12,10,2,270195,2779.833,98.33333
"23066","69005","2020",8,6,2,239805,2924.625,81.875
"23067","69006","2020",60,46,14,141768.5,1528.367,92.88333
"23068","69007","2020",27,20,7,234115.6,2649.778,90.77778
"23069","69008","2020",7,7,0,204347.1,1742.429,113.4286
"23070","69009","2020",117,79,38,287834.3,2976.231,97.54701
"23071","69010","2020",102,24,78,197215.4,2476.794,78.55882
"23072","69012","2020",8,8,0,181056.2,1501.5,118.375
"23073","69013","2020",59,32,27,244102.9,2474.034,99.33898
"23074","69014","2020",7,7,0,225164.3,1754.857,130.4286
"23075","69016","2020",4,4,0,114000,1063.25,98.5
"23076","69017","2020",11,10,1,363298.6,3062.636,116.8182
"23077","69018","2020",31,25,6,170459.5,1515.387,109.2581
"23078","69019","2020",190,106,84,200712.3,2332.532,86.50526
"23079","69020","2020",14,6,8,230945.4,2747.643,84
"23080","69021","2020",37,32,5,246349.3,2306.919,110.2703
"23081","69022","2020",12,12,0,208026.9,1861.667,123.5
"23082","69023","2020",26,26,0,325637.1,2739.077,118.3077
"23083","69024","2020",61,37,24,278422.6,2716.836,111.7049
"23084","69026","2020",5,5,0,237880,2727.2,92.8
"23085","69027","2020",166,90,76,323484.7,3799.904,87.83735
"23086","69028","2020",68,46,22,416231.8,3831.088,108.5588
"23087","69029","2020",529,101,428,229672.1,3101.342,73.23629
"23088","69030","2020",8,7,1,138112.5,1587.375,88.75
"23089","69031","2020",18,15,3,248013.9,2423.111,102.8889
"23090","69032","2020",23,18,5,276562.2,2620.174,105.913
"23091","69033","2020",31,26,5,501293.1,4222.968,122.1613
"23092","69034","2020",671,68,603,327979.7,4307.04,75.07452
"23093","69035","2020",4,4,0,178475,1574.75,119
"23094","69036","2020",14,12,2,203010.8,2238.214,91.21429
"23095","69037","2020",12,12,0,133386.7,1598.833,94.91667
"23096","69038","2020",13,13,0,164516.2,1421.615,110.5385
"23097","69039","2020",11,11,0,179927.3,1811.091,94.63636
"23098","69040","2020",89,24,65,339287.5,3980.809,83.33708
"23099","69042","2020",6,6,0,258650,2619.167,102.5
"23100","69043","2020",93,60,33,433274.5,4245.204,104.8602
"23101","69044","2020",68,39,29,603264.4,4947.118,119.9412
"23102","69045","2020",13,8,5,184126.9,1930.923,99.76923
"23103","69046","2020",54,43,11,434522.6,3737.63,119.8704
"23104","69047","2020",13,11,2,371587.7,3413,99.38462
"23105","69049","2020",43,30,13,381613.3,3494.628,109.5349
"23106","69050","2020",26,24,2,307803.6,2847.077,106.0385
"23107","69051","2020",13,13,0,328671.2,3148.692,111.8462
"23108","69052","2020",49,44,5,384207.5,3878.571,100.8571
"23109","69053","2020",3,3,0,141983.3,1541.667,97
"23110","69054","2020",5,5,0,166700,1421.6,111.6
"23111","69055","2020",17,9,8,327003.5,3069.647,111.7647
"23112","69056","2020",31,19,12,257904.7,2824.065,90.45161
"23113","69057","2020",5,5,0,153640,1680.8,101.4
"23114","69058","2020",5,5,0,186922,1933.6,102.2
"23115","69059","2020",13,10,3,382986.1,4358.615,90.38462
"23116","69060","2020",9,9,0,154911.1,1923.889,99
"23117","69061","2020",25,21,4,265743.6,2435.4,118.8
"23118","69062","2020",4,4,0,255012.5,2571,104.25
"23119","69063","2020",71,35,36,550882.4,4610.254,115.2254
"23120","69064","2020",50,29,21,195535.8,2277.36,91.28
"23121","69065","2020",13,11,2,214336.5,2229.846,97.23077
"23122","69066","2020",49,46,3,108964.1,1120.551,101.6531
"23123","69067","2020",26,21,5,217192.1,2137.115,98.42308
"23124","69068","2020",45,29,16,318327.6,3627.956,86.02222
"23125","69069","2020",167,75,92,340005.6,3924.401,86.4491
"23126","69070","2020",16,16,0,128212.5,1292.75,95.9375
"23127","69071","2020",12,7,5,370222.5,3354.917,114.9167
"23128","69072","2020",103,69,34,525174,4678.524,114.8252
"23129","69074","2020",16,14,2,287977.5,3000.438,97.8125
"23130","69075","2020",1,1,0,282000,2541,111
"23131","69076","2020",37,31,6,487999.3,3801.189,134.2703
"23132","69077","2020",12,12,0,277150.8,2448.333,113.9167
"23133","69078","2020",11,9,2,258972.7,2209.909,120.1818
"23134","69080","2020",20,16,4,274461.3,2488.55,110
"23135","69081","2020",241,49,192,399460,4323.079,90.74689
"23136","69082","2020",4,4,0,214750,2115.5,105.25
"23137","69083","2020",14,14,0,346540.9,3351.571,103.9286
"23138","69084","2020",16,14,2,191346.2,1756,113.1875
"23139","69085","2020",18,9,9,339291.7,3400.389,95.66667
"23140","69086","2020",18,15,3,369542.2,3502.389,101.9444
"23141","69087","2020",44,30,14,426698.6,4215.023,103.4545
"23142","69088","2020",137,16,121,261277.7,3211,78.9635
"23143","69089","2020",188,61,127,351010.2,3969.899,86.26064
"23144","69090","2020",7,7,0,232542.9,2310.429,97.28571
"23145","69091","2020",220,103,117,170010.3,2132.359,81.26818
"23146","69092","2020",65,41,24,269177.9,2623.462,102.0462
"23147","69093","2020",18,18,0,143266.7,1479.556,98.72222
"23148","69094","2020",80,46,34,317643.8,3710.525,86.75
"23149","69095","2020",4,4,0,195225,2250,87.25
"23150","69096","2020",152,64,88,190817.1,2326.151,82.48684
"23151","69097","2020",6,6,0,181100,1731.667,104
"23152","69098","2020",3,3,0,130833.3,1085,120
"23153","69099","2020",23,22,1,173342.2,1514.087,114.3913
"23154","69100","2020",119,50,69,279327.1,3071.311,90.55462
"23155","69102","2020",7,7,0,144612.4,1446.286,113.4286
"23156","69103","2020",13,13,0,179260,1770.077,111.4615
"23157","69104","2020",9,7,2,121011.1,1173.667,108.8889
"23158","69105","2020",17,16,1,267856.8,2412.059,123.5882
"23159","69106","2020",15,14,1,456865.3,3157.933,146.9333
"23160","69107","2020",9,8,1,173395,1904.778,93.11111
"23161","69108","2020",16,16,0,266521.9,2335.25,116
"23162","69109","2020",12,12,0,201591.2,1693.167,119.75
"23163","69110","2020",24,22,2,228102.9,2049.542,120.4167
"23164","69111","2020",8,4,4,302232.5,2335.75,133.125
"23165","69112","2020",78,52,26,408672.6,3981.859,104.0256
"23166","69113","2020",12,11,1,230520.8,1964.917,119.9167
"23167","69115","2020",72,40,32,247801.5,2519.139,93.25
"23168","69116","2020",42,31,11,594282.3,4767.119,128.5238
"23169","69117","2020",45,39,6,440290.3,3852,121.5111
"23170","69118","2020",30,22,8,229213,2548.2,92.03333
"23171","69119","2020",5,5,0,226336,2213.4,105
"23172","69120","2020",8,8,0,174612.5,1826.25,96.75
"23173","69121","2020",26,16,10,343973.1,3529.385,96.73077
"23174","69122","2020",27,21,6,316968.3,2968.222,111.5556
"23175","69123","2020",7117,189,6928,320879,4850.844,67.0118
"23176","69124","2020",3,3,0,122833.3,1007,100.3333
"23177","69125","2020",15,9,6,266272,3045.6,89.4
"23178","69126","2020",7,7,0,376934.3,3096.714,131.8571
"23179","69127","2020",32,22,10,463821.6,4204.125,109.6562
"23180","69130","2020",7,7,0,91930,1257,76.14286
"23181","69131","2020",33,21,12,309506.2,3152.727,98.12121
"23182","69132","2020",6,6,0,224641.7,1830.833,125
"23183","69134","2020",2,2,0,416450,3370.5,157.5
"23184","69135","2020",29,27,2,126264.1,1297.414,104.7586
"23185","69136","2020",31,27,4,322730.6,3499,96.74194
"23186","69137","2020",3,3,0,299633.3,2232.333,133.6667
"23187","69138","2020",11,11,0,250456.4,2203.909,121.2727
"23188","69139","2020",13,12,1,153576.5,1625.846,100.1538
"23189","69140","2020",25,25,0,453073.7,3639.76,128.8
"23190","69141","2020",58,28,30,292413.3,3325.724,86.48276
"23191","69142","2020",110,6,104,232941.8,3145.727,70.21818
"23192","69143","2020",129,35,94,250748.7,3102.07,81.02326
"23193","69145","2020",9,9,0,248025,2262.556,114.7778
"23194","69148","2020",24,16,8,381265.7,3382.875,112.9167
"23195","69149","2020",371,62,309,240561.5,3462.146,70.33962
"23196","69151","2020",25,17,8,214407.6,2267.44,96.32
"23197","69152","2020",109,31,78,218772,2863.55,76.0367
"23198","69153","2020",21,21,0,578292.4,4200.238,141.2857
"23199","69154","2020",39,27,12,369093.3,3545.41,107.6923
"23200","69155","2020",10,10,0,223915.2,1925.8,115.7
"23201","69156","2020",30,27,3,391779.2,3458.733,113.8333
"23202","69157","2020",55,52,3,288437.6,2676.382,110.3818
"23203","69159","2020",49,45,4,347706.8,2839.041,125.8367
"23204","69160","2020",16,16,0,109810,1168.438,104.0625
"23205","69161","2020",7,7,0,178428.6,1331.286,131.5714
"23206","69162","2020",15,15,0,187430.3,1989.933,92.13333
"23207","69163","2020",57,42,15,320848.1,3066.035,108.4386
"23208","69164","2020",8,8,0,80937.5,844.375,104.25
"23209","69165","2020",13,13,0,278859.6,2231.308,130.3846
"23210","69166","2020",3,3,0,258616.7,2758.667,92.33333
"23211","69167","2020",6,6,0,190966.7,1910.667,109.5
"23212","69168","2020",16,10,6,457853,3947.25,108.8125
"23213","69169","2020",3,3,0,101666.7,1177.333,81.66667
"23214","69170","2020",8,7,1,221599,3227.625,69.875
"23215","69171","2020",27,15,12,196327,2245.741,90
"23216","69172","2020",11,11,0,247218.2,2108.909,116.0909
"23217","69173","2020",11,7,4,252446.4,2491.455,108.1818
"23218","69174","2020",5,5,0,224000,2387.6,99.2
"23219","69175","2020",10,10,0,268455,2314.9,121.8
"23220","69176","2020",47,35,12,343665.5,3433.574,99.61702
"23221","69177","2020",13,12,1,328780.6,2880.154,116.7692
"23222","69178","2020",10,9,1,192853.8,2091.1,94
"23223","69179","2020",33,27,6,315056,3264.818,99.60606
"23224","69180","2020",9,9,0,235500,2247,114.3333
"23225","69181","2020",2,2,0,162750,1402,108.5
"23226","69182","2020",9,9,0,68912.78,876.7778,79.33333
"23227","69183","2020",11,11,0,117585.5,1521.545,84.36364
"23228","69184","2020",9,8,1,208833.3,2251.111,90.88889
"23229","69186","2020",6,6,0,107325,1623,65
"23230","69187","2020",6,6,0,215230,2111.333,106
"23231","69188","2020",10,10,0,172261.5,1861.5,89.6
"23232","69189","2020",31,8,23,174554.7,2323.581,74.22581
"23233","69190","2020",22,19,3,504785.7,3706.091,141.2273
"23234","69191","2020",100,66,34,629761,5369.56,117.33
"23235","69192","2020",1,1,0,51000,1700,30
"23236","69193","2020",12,12,0,328633.3,2401.833,136.0833
"23237","69194","2020",81,55,26,748525.2,5142.173,145.2963
"23238","69196","2020",10,9,1,196116.3,1735,117.7
"23239","69197","2020",31,29,2,249740.1,2265.194,109.5484
"23240","69198","2020",6,6,0,202275,2210.5,95.66667
"23241","69199","2020",185,28,157,140374.1,2253.205,63.91351
"23242","69200","2020",17,14,3,221054.1,2036.412,112.4118
"23243","69201","2020",17,11,6,125158.8,1617.059,77.94118
"23244","69202","2020",312,59,253,357611.9,3835.763,89.49038
"23245","69203","2020",13,12,1,217785.4,2244.308,98.53846
"23246","69204","2020",260,116,144,352605.5,3800.769,90.77692
"23247","69205","2020",64,43,21,394418.4,4169.359,96.59375
"23248","69206","2020",59,47,12,254929.3,2369.797,111.8136
"23249","69207","2020",37,18,19,345947.4,3526.703,100.4865
"23250","69208","2020",19,18,1,400420,3006.053,133.0526
"23251","69209","2020",5,5,0,129600,1274,102.4
"23252","69212","2020",3,3,0,585666.7,2992,188.3333
"23253","69214","2020",13,13,0,144461.5,1254.538,117.3846
"23254","69215","2020",10,6,4,277368,2219.6,124.8
"23255","69216","2020",8,8,0,218751.2,2134.625,102.375
"23256","69217","2020",16,16,0,146819.7,1411.375,100.1875
"23257","69218","2020",7,7,0,206907.1,2165.714,95.71429
"23258","69219","2020",32,23,9,278464,2857.969,100.2812
"23259","69220","2020",27,23,4,184205.6,1932.074,95.55556
"23260","69225","2020",5,5,0,287937.2,2998,100.4
"23261","69227","2020",27,23,4,289538,2973.556,99.96296
"23262","69228","2020",34,28,6,281558.8,2875.206,99.05882
"23263","69229","2020",12,12,0,131705.8,1367.083,96.66667
"23264","69230","2020",1,1,0,165000,1650,100
"23265","69231","2020",21,19,2,349821.1,3266.667,108.619
"23266","69233","2020",16,15,1,511257.5,4441.188,120.5625
"23267","69234","2020",12,12,0,282924.8,2628.167,109.5833
"23268","69235","2020",19,8,11,204398.2,2486.737,84.68421
"23269","69236","2020",6,6,0,222014.3,1933.667,116.8333
"23270","69238","2020",52,32,20,170003,1941.962,88.75
"23271","69239","2020",16,15,1,290341.9,2447.938,119.3125
"23272","69240","2020",10,10,0,91581,1188.9,74.6
"23273","69241","2020",28,19,9,327311.8,3120.214,107.2143
"23274","69242","2020",11,10,1,236807.3,2102.364,115.5455
"23275","69243","2020",120,45,75,154321.6,1682.458,94.73333
"23276","69244","2020",403,84,319,356021.9,4328.767,79.17618
"23277","69245","2020",8,8,0,234916.2,1968.125,115.375
"23278","69246","2020",23,23,0,330937.2,3126.522,116.9565
"23279","69248","2020",71,65,6,114295.4,1191.592,95.90141
"23280","69249","2020",40,31,9,292356.6,3049.625,97.5
"23281","69250","2020",54,42,12,503678.5,4511.778,114.1481
"23282","69252","2020",4,4,0,273625,2507.75,110.5
"23283","69253","2020",6,6,0,415736.7,2596.333,167.5
"23284","69254","2020",18,16,2,158149.7,1837.222,88
"23285","69255","2020",58,44,14,359312.9,3401.345,105.1897
"23286","69256","2020",446,96,350,168814.9,2486.917,69.35426
"23287","69257","2020",14,11,3,165035.4,1667.929,91.85714
"23288","69258","2020",5,5,0,154922,1439.2,107.6
"23289","69259","2020",557,97,460,176560.8,2618.343,68.77738
"23290","69260","2020",79,27,52,312836.1,3569.177,89
"23291","69263","2020",12,12,0,151658.3,1570.5,106.6667
"23292","69264","2020",645,101,544,155542,2291.35,69.02171
"23293","69265","2020",13,9,4,313668.1,2984.538,107.1538
"23294","69266","2020",2381,117,2264,227260.4,3769.352,62.07098
"23295","69267","2020",18,17,1,256532.2,2310,115.7222
"23296","69268","2020",45,28,17,405893.6,4196.978,100.2667
"23297","69269","2020",10,9,1,255055.5,2101.7,123.7
"23298","69270","2020",47,32,15,371863.1,3607,104.5532
"23299","69271","2020",112,60,52,385860,4038.321,95.44643
"23300","69272","2020",37,30,7,323129.2,3579.676,95.97297
"23301","69273","2020",128,67,61,277267.9,3208.914,84.52344
"23302","69275","2020",351,98,253,235673.8,3197.678,73.56695
"23303","69276","2020",117,64,53,230033.2,2799.248,83.2906
"23304","69277","2020",146,105,41,431913.9,4378.411,101.1164
"23305","69278","2020",54,34,20,311872.1,3351.185,94.7037
"23306","69279","2020",52,49,3,383962.1,3889.731,101.8846
"23307","69280","2020",15,13,2,308237.5,3033,108.2
"23308","69281","2020",20,17,3,403814.2,3563.95,113.75
"23309","69282","2020",427,221,206,282659.1,3406.89,82.83138
"23310","69283","2020",171,110,61,298580.1,3466.228,86.88304
"23311","69284","2020",43,40,3,486900.1,4231.209,114.8837
"23312","69285","2020",46,38,8,319353.3,3144.739,102.5
"23313","69286","2020",273,95,178,269408.1,3006.879,87.58974
"23314","69287","2020",65,48,17,402295.8,3782.954,107.3846
"23315","69288","2020",68,47,21,307306,3587.029,87.48529
"23316","69289","2020",67,51,16,355065.5,3535.209,105.0149
"23317","69290","2020",644,140,504,217294.5,2803.901,77.45807
"23318","69291","2020",67,38,29,298396.6,3074.91,98.41791
"23319","69292","2020",81,12,69,258141.5,3351.741,78.96296
"23320","69293","2020",25,17,8,417565.9,4172.12,103.36
"23321","69294","2020",41,17,24,244719.4,3123,80.87805
"23322","69295","2020",11,7,4,314403.9,3596.182,94.72727
"23323","69296","2020",32,23,9,341161.2,3571.594,101.0312
"23324","69297","2020",63,53,10,345145.1,3414.365,102.2381
"23325","69298","2020",39,22,17,328871.5,3523.821,95.51282
"23326","69299","2020",26,23,3,327614.8,3185.885,102.4231
"23327","70002","2020",4,4,0,106025,856.75,126.25
"23328","70004","2020",4,4,0,106452.8,892,116.5
"23329","70006","2020",18,18,0,92227.78,938.5556,94.77778
"23330","70007","2020",3,3,0,132000,1071,108.6667
"23331","70010","2020",2,2,0,44000,568,80
"23332","70011","2020",3,3,0,130666.7,1163.333,113
"23333","70012","2020",9,9,0,88200,845.4444,103.1111
"23334","70013","2020",1,1,0,551000,2755,200
"23335","70014","2020",4,4,0,101475,1251.25,79
"23336","70015","2020",3,3,0,76833.33,910.6667,77
"23337","70016","2020",1,1,0,178600,1363,131
"23338","70017","2020",2,2,0,82045.5,1028.5,88.5
"23339","70018","2020",8,7,1,159850,1405.875,122.875
"23340","70019","2020",1,1,0,146500,2007,73
"23341","70020","2020",3,3,0,119783.3,1054.667,113
"23342","70021","2020",1,1,0,285000,1792,159
"23343","70022","2020",1,1,0,130000,855,152
"23344","70023","2020",2,2,0,229850,2660.5,95
"23345","70024","2020",7,7,0,139428.6,869.2857,140.4286
"23346","70025","2020",6,6,0,72183.33,613.3333,113.3333
"23347","70026","2020",30,26,4,105994.7,1058.2,98.66667
"23348","70027","2020",3,3,0,36666.67,478.3333,78.33333
"23349","70029","2020",3,3,0,135740,1560.333,96.33333
"23350","70031","2020",9,9,0,90000,1061,87
"23351","70036","2020",1,1,0,329400,2370,139
"23352","70037","2020",7,7,0,110571.4,1008.714,112.4286
"23353","70038","2020",7,7,0,113571.4,814.7143,135.2857
"23354","70039","2020",4,4,0,106075,1059,96
"23355","70040","2020",2,2,0,112100,656,171
"23356","70041","2020",5,5,0,103600,753.8,137.8
"23357","70042","2020",3,3,0,120183.3,1166,103.3333
"23358","70043","2020",2,2,0,96000,1012.5,95.5
"23359","70044","2020",5,5,0,128400,1080,115.8
"23360","70045","2020",1,1,0,241530,2013,120
"23361","70046","2020",1,1,0,160000,1168,137
"23362","70048","2020",1,1,0,83000,1012,82
"23363","70051","2020",1,1,0,105000,729,144
"23364","70052","2020",6,6,0,138316.7,960.5,142.5
"23365","70054","2020",1,1,0,116000,1303,89
"23366","70055","2020",6,6,0,86116.67,907.1667,89.5
"23367","70056","2020",8,7,1,74588.12,614.5,120.25
"23368","70057","2020",1,1,0,2e+05,1111,180
"23369","70058","2020",10,10,0,98430,828.5,121.1
"23370","70059","2020",3,2,1,106266.7,1079.667,106.6667
"23371","70060","2020",1,1,0,272400,1434,190
"23372","70061","2020",3,3,0,113003.3,1083.333,102.6667
"23373","70062","2020",1,1,0,146400,1591,92
"23374","70063","2020",5,5,0,153805.4,1091.6,121.8
"23375","70064","2020",2,2,0,228500,1435,165.5
"23376","70065","2020",4,4,0,73375,1064.25,76.5
"23377","70066","2020",1,1,0,61380,472,130
"23378","70067","2020",1,1,0,156500,1232,127
"23379","70070","2020",1,1,0,65000,389,167
"23380","70071","2020",4,4,0,113875,2216.25,63.5
"23381","70072","2020",1,1,0,35000,350,100
"23382","70074","2020",7,7,0,82114.29,728.2857,115.5714
"23383","70075","2020",1,1,0,239720,1642,146
"23384","70076","2020",4,4,0,145250,1337,112.75
"23385","70077","2020",2,2,0,39500,418.5,95
"23386","70079","2020",3,3,0,137333.3,1196.667,116.3333
"23387","70080","2020",1,1,0,134600,765,176
"23388","70081","2020",4,4,0,115656.2,971.5,121.5
"23389","70082","2020",1,1,0,84000,1091,77
"23390","70083","2020",8,8,0,60937.5,693.5,86.75
"23391","70084","2020",6,6,0,234700,2373.167,99.5
"23392","70085","2020",6,6,0,166821.7,1405.667,121.6667
"23393","70087","2020",2,1,1,95600,1023.5,97
"23394","70088","2020",1,1,0,158641,985,161
"23395","70089","2020",2,2,0,123895,1288.5,117.5
"23396","70091","2020",4,4,0,57375,693.75,82.5
"23397","70092","2020",2,2,0,207275,1283.5,185
"23398","70093","2020",7,7,0,104485.7,825.2857,135.5714
"23399","70094","2020",2,2,0,35000,451.5,77.5
"23400","70095","2020",9,9,0,95461.11,769.7778,129.5556
"23401","70096","2020",8,8,0,155040.4,1566.125,104.25
"23402","70097","2020",2,2,0,63000,593,113.5
"23403","70098","2020",3,3,0,137433.3,1078,130.3333
"23404","70099","2020",1,1,0,96000,1011,95
"23405","70100","2020",2,2,0,105500,857,128
"23406","70101","2020",4,4,0,110250,932.75,120.75
"23407","70102","2020",2,2,0,143000,1875.5,76
"23408","70104","2020",7,7,0,146471.4,1109.286,132.1429
"23409","70106","2020",4,4,0,93125,709,137.5
"23410","70107","2020",7,7,0,143714.3,1439,103.8571
"23411","70109","2020",2,1,1,165000,1795,94.5
"23412","70111","2020",1,1,0,175000,1346,130
"23413","70112","2020",3,3,0,54316.67,577,94.66667
"23414","70113","2020",4,4,0,116250,1315,88.25
"23415","70114","2020",5,5,0,96230,833,108.8
"23416","70115","2020",1,1,0,235800,1583,149
"23417","70116","2020",6,4,2,160175,1542.333,105.1667
"23418","70117","2020",17,12,5,163408.8,1700.941,112.7647
"23419","70118","2020",1,1,0,189000,2077,91
"23420","70119","2020",4,4,0,240757.5,1925,137.5
"23421","70120","2020",34,32,2,130785.1,1278.147,100.9412
"23422","70121","2020",5,5,0,158323.2,1169.8,136
"23423","70122","2020",27,25,2,92436.67,946.9259,97.51852
"23424","70124","2020",1,1,0,195150,1212,161
"23425","70125","2020",3,3,0,128373.3,1198.667,111.3333
"23426","70126","2020",5,5,0,109233.6,799,144.2
"23427","70128","2020",3,3,0,123333.3,1368,90.66667
"23428","70129","2020",2,2,0,112800,740,135
"23429","70130","2020",1,1,0,28300,643,44
"23430","70132","2020",6,6,0,142870,1108,117.6667
"23431","70133","2020",3,3,0,112583.3,1518,82
"23432","70134","2020",3,3,0,113166.7,973.3333,115
"23433","70135","2020",1,1,0,147910,993,149
"23434","70136","2020",7,5,2,137204.3,1267,109.5714
"23435","70137","2020",2,2,0,112500,1072.5,101
"23436","70138","2020",1,1,0,134000,1196,112
"23437","70140","2020",1,1,0,189000,1181,160
"23438","70142","2020",4,4,0,116050,1174,111.25
"23439","70145","2020",1,1,0,1e+05,909,110
"23440","70146","2020",3,3,0,106666.7,1140.333,98.66667
"23441","70147","2020",1,1,0,188000,1938,97
"23442","70149","2020",7,7,0,151785.7,1471.571,109.4286
"23443","70150","2020",7,4,3,83621.43,1085.429,75.57143
"23444","70151","2020",1,1,0,169180,2142,79
"23445","70152","2020",5,5,0,150630,1205.4,135.2
"23446","70153","2020",1,1,0,95000,704,135
"23447","70154","2020",4,4,0,128125,1050.25,108.75
"23448","70155","2020",9,9,0,136111.1,1111.778,123.2222
"23449","70157","2020",5,5,0,120800,1204.8,104.8
"23450","70158","2020",1,1,0,166250,899,185
"23451","70159","2020",1,1,0,171000,2138,80
"23452","70160","2020",2,2,0,144000,1578,90.5
"23453","70162","2020",9,9,0,175472.2,1593.444,118.2222
"23454","70163","2020",7,7,0,165100,1329.143,121
"23455","70164","2020",1,1,0,180000,1192,151
"23456","70165","2020",4,4,0,131500,1157,114.5
"23457","70166","2020",1,1,0,105000,1061,99
"23458","70167","2020",6,6,0,95925,949.5,107.5
"23459","70168","2020",2,2,0,105000,1484.5,85
"23460","70169","2020",2,2,0,61000,493.5,117.5
"23461","70170","2020",2,2,0,81500,601.5,135.5
"23462","70171","2020",10,10,0,97635,873,109.7
"23463","70172","2020",1,1,0,380000,2568,148
"23464","70174","2020",1,1,0,202000,860,235
"23465","70175","2020",1,1,0,75000,469,160
"23466","70176","2020",1,1,0,72000,758,95
"23467","70177","2020",6,6,0,68525,753.3333,92.66667
"23468","70178","2020",8,8,0,122814.1,1143.5,117.75
"23469","70179","2020",1,1,0,258000,1458,177
"23470","70180","2020",4,4,0,66875,560.75,121.5
"23471","70182","2020",2,2,0,228500,1468.5,135
"23472","70183","2020",1,1,0,56570,658,86
"23473","70184","2020",14,10,4,137727.1,1634.857,83.14286
"23474","70185","2020",1,1,0,80000,667,120
"23475","70186","2020",1,1,0,106950,955,112
"23476","70187","2020",2,2,0,157925,1523,103
"23477","70189","2020",2,2,0,243050,2067,110
"23478","70190","2020",2,2,0,86900,1094,90
"23479","70192","2020",1,1,0,158500,821,193
"23480","70194","2020",2,2,0,74500,662.5,116
"23481","70195","2020",2,2,0,179050,1334.5,150
"23482","70196","2020",1,1,0,120800,1024,118
"23483","70197","2020",7,7,0,136857.1,1250.857,109.2857
"23484","70198","2020",12,10,2,124944.2,1381.917,107
"23485","70199","2020",1,1,0,123600,1144,108
"23486","70201","2020",2,2,0,56750,616.5,93
"23487","70202","2020",2,0,2,628750,5846,103.5
"23488","70203","2020",1,1,0,95000,546,174
"23489","70206","2020",6,6,0,221029.2,1649,137
"23490","70207","2020",44,39,5,143962.7,1474.909,101.5
"23491","70208","2020",3,3,0,144833.3,1163,131.6667
"23492","70210","2020",3,3,0,164533.3,2370,75.33333
"23493","70211","2020",2,2,0,69250,557,122
"23494","70214","2020",2,2,0,86135,499.5,158.5
"23495","70215","2020",3,3,0,184626.7,1569.667,118
"23496","70216","2020",7,7,0,132121.4,1168.429,109.2857
"23497","70217","2020",1,1,0,220000,2857,77
"23498","70218","2020",2,2,0,83000,1061.5,81.5
"23499","70219","2020",3,3,0,116850,1114.333,108
"23500","70220","2020",3,3,0,108166.7,1171.333,94.33333
"23501","70221","2020",2,2,0,110000,1092,101
"23502","70222","2020",2,2,0,120950,2997.5,46.5
"23503","70224","2020",2,2,0,147750,1214.5,128
"23504","70226","2020",2,2,0,149250,1589.5,92.5
"23505","70227","2020",3,3,0,100416.7,886.6667,116.3333
"23506","70228","2020",7,6,1,79714.29,969.8571,86.42857
"23507","70229","2020",5,4,1,126700,1717.4,79.2
"23508","70230","2020",2,2,0,62525,824,82.5
"23509","70231","2020",1,1,0,142000,959,148
"23510","70233","2020",2,2,0,145000,844.5,146
"23511","70234","2020",2,2,0,182650,1094.5,173.5
"23512","70235","2020",5,5,0,109210,1141.6,91.8
"23513","70236","2020",2,2,0,199500,2313.5,95.5
"23514","70237","2020",1,1,0,40000,455,88
"23515","70240","2020",19,19,0,106384.2,813.3158,127.4737
"23516","70242","2020",3,3,0,46833.33,682,78.66667
"23517","70243","2020",1,1,0,81450,1131,72
"23518","70244","2020",1,1,0,80000,1111,72
"23519","70245","2020",25,25,0,116614,1007.84,123.44
"23520","70247","2020",2,2,0,119850,871.5,139.5
"23521","70248","2020",2,2,0,172500,1485,124.5
"23522","70250","2020",4,4,0,169612.5,1313.5,133.25
"23523","70253","2020",3,3,0,154333.3,1303.667,110.6667
"23524","70254","2020",2,2,0,165750,2130.5,80
"23525","70255","2020",6,6,0,116000,1235.833,94
"23526","70256","2020",11,11,0,122468.6,1088.727,116.1818
"23527","70257","2020",7,7,0,115797.1,1140.143,103.2857
"23528","70258","2020",19,17,2,116912.3,1116,107.3158
"23529","70259","2020",4,4,0,153187.5,1593.5,94.25
"23530","70260","2020",5,5,0,140830,1478.4,96.6
"23531","70261","2020",15,13,2,146509.3,1515.4,110.7333
"23532","70265","2020",2,2,0,134000,1117,120
"23533","70267","2020",2,2,0,88000,860.5,98
"23534","70268","2020",2,2,0,54000,721,91
"23535","70271","2020",10,10,0,96305,990.3,99
"23536","70272","2020",2,2,0,89590.5,777,102.5
"23537","70275","2020",1,1,0,171000,2165,79
"23538","70276","2020",3,3,0,59333.33,777.3333,76.66667
"23539","70277","2020",2,1,1,249850,1865.5,120
"23540","70278","2020",4,4,0,194800,1426,152.5
"23541","70279","2020",40,23,17,96617.38,1089.65,88.1
"23542","70280","2020",9,9,0,116894.4,1108.556,111.1111
"23543","70282","2020",14,11,3,100248.7,981.3571,104.7143
"23544","70283","2020",5,4,1,86320,854.8,97.2
"23545","70284","2020",4,4,0,145500,1314.75,106
"23546","70285","2020",96,62,34,128186.3,1435.844,90.11458
"23547","70286","2020",5,4,1,118400,1715,81.8
"23548","70288","2020",3,3,0,187250,1455.667,130
"23549","70289","2020",2,2,0,105070,1382,76
"23550","70290","2020",3,3,0,113333.3,998,121.3333
"23551","70291","2020",3,3,0,40500,416.6667,95
"23552","70292","2020",21,20,1,82387.14,739.1905,114.3333
"23553","70293","2020",1,1,0,290525,998,291
"23554","70294","2020",6,6,0,148216.7,1457.667,99.83333
"23555","70295","2020",1,1,0,90000,947,95
"23556","70296","2020",1,1,0,150000,1442,104
"23557","70298","2020",3,3,0,128000,1043.333,118.3333
"23558","70299","2020",5,5,0,96260,704.4,152.6
"23559","70301","2020",1,1,0,31700,423,75
"23560","70304","2020",1,1,0,112960,1141,99
"23561","70306","2020",4,4,0,174546.8,1159.5,135.5
"23562","70307","2020",1,1,0,68000,1133,60
"23563","70308","2020",5,5,0,64019.2,648.6,93.6
"23564","70309","2020",6,6,0,113333.3,961.6667,110
"23565","70310","2020",82,61,21,114574.9,1098.5,104.6463
"23566","70311","2020",89,40,49,83634.72,942.9438,87.53933
"23567","70312","2020",4,4,0,209100,1861.5,106
"23568","70313","2020",8,8,0,190062.5,1979.25,107.5
"23569","70314","2020",2,2,0,61875,1004,62.5
"23570","70315","2020",2,2,0,150675,995,162
"23571","70316","2020",1,1,0,157000,1308,120
"23572","70317","2020",1,1,0,96000,1021,94
"23573","70318","2020",9,9,0,104288.9,969.1111,108.3333
"23574","70319","2020",1,1,0,219750,1427,154
"23575","70320","2020",1,1,0,57500,357,161
"23576","70321","2020",10,10,0,125738,1306.8,97.1
"23577","70322","2020",4,4,0,105250,972.75,108.5
"23578","70324","2020",8,8,0,133708.8,1237.5,110.625
"23579","70325","2020",3,3,0,199166.7,1305.333,177
"23580","70326","2020",1,1,0,213509,1750,122
"23581","70327","2020",3,3,0,146000,1203,113.3333
"23582","70328","2020",1,1,0,45000,682,66
"23583","70329","2020",1,1,0,53000,716,74
"23584","70330","2020",1,1,0,295000,1821,162
"23585","70331","2020",5,5,0,95500,854.2,111.6
"23586","70334","2020",15,11,4,139292.7,1424.333,98
"23587","70338","2020",4,4,0,92812.5,783.25,138.25
"23588","70339","2020",17,14,3,115447.1,1128.647,107.6471
"23589","70340","2020",1,1,0,155000,1062,146
"23590","70341","2020",1,1,0,106700,821,130
"23591","70343","2020",4,4,0,124475,1290.5,87.75
"23592","70344","2020",3,3,0,54000,439.6667,122
"23593","70347","2020",3,3,0,105600,1422,76.66667
"23594","70348","2020",6,6,0,100081.7,1465.667,73.66667
"23595","70349","2020",2,2,0,93600,1207,91.5
"23596","70350","2020",2,2,0,52500,666.5,80.5
"23597","70351","2020",1,1,0,51000,689,74
"23598","70353","2020",4,4,0,167807,1608.25,102.75
"23599","70355","2020",2,2,0,185750,1291.5,151
"23600","70356","2020",2,2,0,163600,1167.5,129.5
"23601","70357","2020",8,8,0,163176.2,1609.5,109.625
"23602","70359","2020",1,1,0,88900,889,100
"23603","70360","2020",1,1,0,25000,417,60
"23604","70361","2020",1,1,0,181085,1332,136
"23605","70362","2020",1,1,0,74000,673,110
"23606","70363","2020",4,4,0,176800,1399.25,131.5
"23607","70364","2020",1,1,0,45000,643,70
"23608","70366","2020",1,1,0,155000,783,198
"23609","70368","2020",1,1,0,90000,1000,90
"23610","70369","2020",3,3,0,64166.67,592,96
"23611","70371","2020",1,1,0,58000,387,150
"23612","70372","2020",3,3,0,147966.7,1021.333,125.3333
"23613","70373","2020",3,3,0,58400,447.6667,132.6667
"23614","70374","2020",1,1,0,255000,1594,160
"23615","70376","2020",3,3,0,206626.7,1577,138
"23616","70378","2020",14,11,3,129346.2,1295.929,106.4286
"23617","70381","2020",1,1,0,205000,1864,110
"23618","70383","2020",3,3,0,277340,2319.333,124
"23619","70384","2020",3,3,0,114666.7,1149.333,110.6667
"23620","70385","2020",4,4,0,122750,1142.25,112.75
"23621","70386","2020",1,1,0,145000,1250,116
"23622","70387","2020",7,7,0,96285.71,967.8571,108.7143
"23623","70388","2020",15,13,2,125897.3,1332.4,102.2667
"23624","70389","2020",1,1,0,76000,655,116
"23625","70390","2020",7,6,1,128857.1,1164.286,107
"23626","70392","2020",1,1,0,79000,798,99
"23627","70393","2020",3,3,0,164113.3,1447.333,114.6667
"23628","70394","2020",1,1,0,271660,6792,40
"23629","70395","2020",1,1,0,65000,533,122
"23630","70397","2020",2,2,0,137125,1360,110
"23631","70398","2020",1,1,0,120000,828,145
"23632","70399","2020",2,2,0,42450,435,98
"23633","70400","2020",2,2,0,102500,1003.5,101.5
"23634","70401","2020",1,1,0,74000,740,100
"23635","70402","2020",6,6,0,89666.67,1057.833,94.5
"23636","70403","2020",2,2,0,82750,871,98
"23637","70404","2020",10,10,0,67783.6,644.3,101.8
"23638","70405","2020",1,1,0,155000,1703,91
"23639","70406","2020",3,3,0,63500,736.3333,90
"23640","70407","2020",2,2,0,164695,1524,94.5
"23641","70408","2020",11,11,0,131979.1,1427.091,96
"23642","70409","2020",1,1,0,130000,591,220
"23643","70410","2020",9,9,0,123711.1,1298.222,97.11111
"23644","70413","2020",18,17,1,130602.8,1332.778,109.6667
"23645","70414","2020",4,3,1,81750,946.25,93.5
"23646","70415","2020",4,4,0,64437.5,611.25,100.5
"23647","70416","2020",4,4,0,160000,1256.5,136.25
"23648","70417","2020",2,2,0,102825,1058.5,94.5
"23649","70418","2020",4,4,0,95921.25,1096.25,83.5
"23650","70419","2020",6,6,0,111991.7,958,115.1667
"23651","70421","2020",36,31,5,99778.33,1084.5,90.47222
"23652","70422","2020",2,2,0,62000,793.5,93.5
"23653","70423","2020",2,2,0,66000,823.5,95
"23654","70426","2020",3,3,0,135783.3,1225.333,110.6667
"23655","70427","2020",3,3,0,58833.33,518.6667,112
"23656","70428","2020",10,8,2,163655.6,1566.1,106.6
"23657","70429","2020",6,6,0,122225,1158.333,104.5
"23658","70430","2020",1,1,0,65500,851,77
"23659","70431","2020",3,3,0,166333.3,1267,136.6667
"23660","70432","2020",4,4,0,152637.5,1041.75,148.75
"23661","70433","2020",15,14,1,155094,1671.2,92.93333
"23662","70435","2020",7,7,0,100285.7,1002.714,103.1429
"23663","70436","2020",2,2,0,90500,796.5,107.5
"23664","70438","2020",2,2,0,71500,473.5,148.5
"23665","70439","2020",6,6,0,170788.3,1554,111.3333
"23666","70441","2020",1,1,0,165000,1684,98
"23667","70442","2020",1,1,0,100500,1117,90
"23668","70443","2020",1,1,0,104000,1733,60
"23669","70444","2020",2,2,0,106500,1376,83
"23670","70445","2020",1,1,0,266096,1454,183
"23671","70446","2020",8,8,0,127850,1103.875,113.875
"23672","70447","2020",21,19,2,202917.5,1836.762,110.4762
"23673","70448","2020",2,2,0,68500,800.5,83
"23674","70449","2020",1,1,0,35000,574,61
"23675","70451","2020",18,12,6,95330.56,1026,92.27778
"23676","70452","2020",4,4,0,161125,1499.5,111
"23677","70453","2020",2,2,0,260000,1508,172.5
"23678","70455","2020",17,13,4,98973.53,1136.235,91.88235
"23679","70456","2020",2,2,0,135000,1072.5,130
"23680","70457","2020",2,2,0,177075,1400,117
"23681","70459","2020",8,8,0,127525,1225.75,105.75
"23682","70460","2020",7,7,0,164671.4,1881.857,99.14286
"23683","70463","2020",2,2,0,136505.5,1458,94
"23684","70464","2020",12,12,0,112605.8,1144.083,98.08333
"23685","70467","2020",21,19,2,87475.24,840.1905,103.619
"23686","70468","2020",1,1,0,69000,690,100
"23687","70469","2020",1,1,0,125140,920,136
"23688","70470","2020",1,1,0,105000,656,160
"23689","70472","2020",6,6,0,68259.33,757.3333,92.83333
"23690","70473","2020",20,17,3,91322.5,1026.55,88.85
"23691","70474","2020",1,1,0,95000,497,191
"23692","70477","2020",6,6,0,212633.3,1576.333,138.6667
"23693","70478","2020",9,9,0,150083.3,1429.222,103
"23694","70479","2020",2,2,0,132000,1010.5,132.5
"23695","70480","2020",3,3,0,87766.67,875.3333,85.66667
"23696","70481","2020",6,6,0,76783.33,927.1667,83.5
"23697","70482","2020",11,10,1,127695.5,1001,124.3636
"23698","70483","2020",2,2,0,127500,1312.5,125
"23699","70484","2020",4,4,0,109375,1213.5,96
"23700","70485","2020",5,5,0,75238,712.8,104.2
"23701","70487","2020",7,7,0,107500,1079.857,96.85714
"23702","70488","2020",2,2,0,74150,624,120
"23703","70489","2020",16,16,0,96921.88,1564.75,84.6875
"23704","70490","2020",1,1,0,77500,711,109
"23705","70491","2020",5,5,0,96660,1007.6,100.8
"23706","70492","2020",4,4,0,67900,746.5,99.75
"23707","70493","2020",3,3,0,250600,2193,114
"23708","70494","2020",3,3,0,225375,2064.333,112.6667
"23709","70498","2020",3,3,0,163666.7,1465,116.6667
"23710","70499","2020",1,1,0,79500,1169,68
"23711","70500","2020",2,2,0,65000,722,89.5
"23712","70503","2020",3,3,0,157666.7,1429,116.6667
"23713","70504","2020",5,5,0,72160,1023.6,79.6
"23714","70505","2020",2,2,0,132000,1183,111.5
"23715","70506","2020",5,5,0,161724,1696.4,96
"23716","70507","2020",1,1,0,250500,1802,139
"23717","70510","2020",2,2,0,117965,1132.5,108.5
"23718","70511","2020",2,2,0,66000,702,97
"23719","70512","2020",2,2,0,54560,656.5,79.5
"23720","70513","2020",31,24,7,139087.4,1306.129,106.4839
"23721","70514","2020",7,7,0,140585.7,1233.286,129.8571
"23722","70515","2020",1,1,0,1e+05,2564,39
"23723","70516","2020",5,5,0,116520,961,119.2
"23724","70517","2020",5,5,0,165290,1588,104.2
"23725","70518","2020",1,1,0,165000,1100,150
"23726","70519","2020",1,1,0,30000,1667,18
"23727","70520","2020",2,2,0,157850,1273.5,126.5
"23728","70521","2020",2,2,0,78500,656,100
"23729","70522","2020",3,3,0,85333.33,805.6667,105
"23730","70523","2020",1,1,0,122000,1488,82
"23731","70524","2020",3,3,0,124583.3,1210,119.6667
"23732","70525","2020",5,5,0,85740,852.4,98.2
"23733","70526","2020",11,10,1,74909.09,726.8182,107.7273
"23734","70527","2020",1,1,0,215000,1654,130
"23735","70528","2020",3,3,0,102333.3,747,139.6667
"23736","70529","2020",5,5,0,99600,1037.8,97.8
"23737","70530","2020",3,3,0,133283.3,1201,109
"23738","70532","2020",4,4,0,187500,1284.75,140.75
"23739","70533","2020",1,1,0,195000,1266,154
"23740","70534","2020",2,2,0,54000,729,79.5
"23741","70536","2020",1,1,0,94900,999,95
"23742","70537","2020",3,3,0,165000,1178.667,145
"23743","70539","2020",4,4,0,59500.25,663.75,94.25
"23744","70541","2020",2,2,0,120750,1247.5,96
"23745","70542","2020",1,1,0,103000,572,180
"23746","70544","2020",1,1,0,80000,833,96
"23747","70545","2020",3,3,0,106066.7,790.6667,141.3333
"23748","70546","2020",4,4,0,85125,914.5,96
"23749","70549","2020",1,1,0,139150,1480,94
"23750","70550","2020",207,58,149,96261.5,1230.174,77.37681
"23751","70552","2020",1,1,0,155000,1281,121
"23752","70554","2020",1,1,0,74000,841,88
"23753","70555","2020",3,3,0,123316.7,1165.667,110.6667
"23754","70558","2020",2,2,0,172500,714,228
"23755","70559","2020",3,3,0,198416.7,1783.667,111
"23756","70560","2020",1,1,0,70000,583,120
"23757","70561","2020",16,14,2,108008.1,1035.188,104.375
"23758","70562","2020",1,1,0,70000,933,75
"23759","70563","2020",2,2,0,89950,1215,75
"23760","70564","2020",5,5,0,105250,984.8,115.8
"23761","70567","2020",1,1,0,65000,380,171
"23762","70568","2020",1,1,0,78000,488,160
"23763","70572","2020",5,5,0,73690,695.6,99.6
"23764","70573","2020",2,2,0,63750,1399,91.5
"23765","70575","2020",9,8,1,168193.9,1930.333,90.33333
"23766","70576","2020",1,1,0,65000,411,158
"23767","70577","2020",2,2,0,132750,1344,98
"23768","70578","2020",3,3,0,185466.7,1807.667,102.3333
"23769","70579","2020",5,5,0,203800,1884.6,106
"23770","70580","2020",3,3,0,175500,2104.333,96.66667
"23771","70581","2020",6,6,0,121928.3,1207.833,102.8333
"23772","70582","2020",1,1,0,115000,1127,102
"23773","70583","2020",4,4,0,128750,2039.5,76.75
"23774","71001","2020",14,14,0,120687.4,1210.929,98.35714
"23775","71002","2020",13,13,0,142547.7,1465,114.8462
"23776","71003","2020",13,13,0,166416.9,1503.077,112.0769
"23777","71004","2020",15,15,0,264593.3,2203.267,114.7333
"23778","71005","2020",3,3,0,115000,1153.333,83
"23779","71006","2020",4,4,0,155705,1279.75,115.25
"23780","71009","2020",22,22,0,94817.95,1105.045,91.90909
"23781","71010","2020",10,10,0,143695.6,1216.7,121.3
"23782","71011","2020",7,6,1,191932.1,1358.143,135.7143
"23783","71012","2020",4,4,0,169492.8,967,156.25
"23784","71013","2020",5,5,0,106500,854.2,114.8
"23785","71014","2020",148,88,60,103219,1096.993,94.5473
"23786","71015","2020",9,9,0,129429.8,1088.111,114.7778
"23787","71016","2020",11,11,0,168831.4,1590.273,108.5455
"23788","71017","2020",4,4,0,202144,1531.25,142
"23789","71018","2020",8,8,0,108312.5,1091.375,100.25
"23790","71019","2020",1,1,0,336300,1978,170
"23791","71020","2020",2,2,0,90000,922,90
"23792","71021","2020",7,7,0,178888.6,1409.857,131.1429
"23793","71022","2020",4,4,0,118375,1230.5,95.75
"23794","71023","2020",15,15,0,124806.7,1116.8,108.6
"23795","71024","2020",2,2,0,120650,1029,107.5
"23796","71025","2020",5,5,0,86930,888.8,87
"23797","71026","2020",7,7,0,120243.9,1320.429,91.71429
"23798","71027","2020",10,10,0,144619.6,1510.4,94.8
"23799","71028","2020",2,2,0,85000,1240.5,74.5
"23800","71029","2020",5,5,0,99680,1396.4,68.6
"23801","71030","2020",1,1,0,60000,612,98
"23802","71031","2020",1,1,0,64000,928,69
"23803","71032","2020",9,9,0,196550,1858.556,100.2222
"23804","71033","2020",7,7,0,165738.6,1572.429,109.5714
"23805","71034","2020",5,5,0,142872,1289,108.4
"23806","71035","2020",1,1,0,141530,2483,57
"23807","71036","2020",2,2,0,35750,794.5,47.5
"23808","71037","2020",4,4,0,159500,1668,112.75
"23809","71038","2020",5,5,0,128520,1048,122.2
"23810","71039","2020",2,2,0,275000,1602.5,171.5
"23811","71040","2020",64,62,2,118363.2,1267.766,94.59375
"23812","71041","2020",2,2,0,48500,656,68
"23813","71042","2020",6,6,0,70833.33,872,82.66667
"23814","71043","2020",4,4,0,86250,1230.75,69.25
"23815","71044","2020",6,6,0,105000,1066.5,108.1667
"23816","71045","2020",1,1,0,95000,864,110
"23817","71046","2020",3,3,0,107500,1546,72
"23818","71047","2020",47,43,4,87878.47,966.9787,90.17021
"23819","71048","2020",1,1,0,122580,1135,108
"23820","71050","2020",12,12,0,163862.1,1545.917,100
"23821","71051","2020",3,3,0,183080,1920.333,98
"23822","71052","2020",11,11,0,121495.5,1268.545,99.36364
"23823","71054","2020",12,12,0,130425,1470.833,93.25
"23824","71056","2020",37,35,2,139171.8,1252.054,112.6216
"23825","71057","2020",1,1,0,1e+05,1053,95
"23826","71058","2020",5,5,0,136780,1349.8,102
"23827","71059","2020",43,40,3,141681.3,1406.558,103.3953
"23828","71060","2020",4,4,0,118218.8,1467.25,83.5
"23829","71061","2020",9,9,0,114124.4,1169.556,102.4444
"23830","71062","2020",6,6,0,154783.3,1602.833,90.33333
"23831","71063","2020",20,20,0,130188.5,1073.55,124
"23832","71064","2020",9,9,0,146077.8,1318.222,114.4444
"23833","71065","2020",6,6,0,143800,1515.833,94.66667
"23834","71066","2020",2,2,0,207200,1465,137
"23835","71067","2020",3,3,0,117423.3,1683.667,70.66667
"23836","71068","2020",1,1,0,55000,965,57
"23837","71069","2020",5,5,0,317554.2,1964.4,162.8
"23838","71070","2020",27,24,3,202618.5,1722.259,113.8889
"23839","71071","2020",9,8,1,92177.78,752.4444,108.6667
"23840","71072","2020",2,2,0,161500,1538,105
"23841","71073","2020",61,44,17,135157.2,1654.033,83.77049
"23842","71074","2020",5,5,0,220206,1868,119.4
"23843","71075","2020",18,15,3,66519.44,819.3333,82.94444
"23844","71076","2020",729,119,610,100303.4,1298.262,75.19342
"23845","71077","2020",10,10,0,133195,1341.2,101.3
"23846","71078","2020",4,4,0,165000,1647.5,108.5
"23847","71079","2020",3,3,0,73333.33,927,82.66667
"23848","71081","2020",33,23,10,143608.8,1400.182,99.60606
"23849","71082","2020",5,5,0,105200,834.8,135.2
"23850","71084","2020",2,2,0,365470,2659.5,135.5
"23851","71085","2020",2,2,0,138000,1097,120
"23852","71086","2020",7,7,0,124971.4,1092.429,119.4286
"23853","71087","2020",4,4,0,118800,1484.25,81.75
"23854","71088","2020",4,4,0,133475,1205.75,104.25
"23855","71089","2020",1,1,0,103000,1451,71
"23856","71090","2020",30,25,5,206883.7,1985.567,108.8
"23857","71091","2020",3,3,0,110000,1255.667,110
"23858","71092","2020",11,11,0,133200,1284.636,112.6364
"23859","71093","2020",14,14,0,104246.4,1109.786,96.21429
"23860","71094","2020",2,2,0,99500,1373,69.5
"23861","71095","2020",3,3,0,82900,868.6667,86.66667
"23862","71096","2020",2,1,1,42500,682,60
"23863","71097","2020",8,8,0,118450,1247.125,95.625
"23864","71098","2020",6,6,0,66100,867.5,78.5
"23865","71099","2020",4,4,0,203037.5,1645.5,126
"23866","71100","2020",1,1,0,33500,609,55
"23867","71101","2020",10,10,0,126368.5,1240,97.3
"23868","71102","2020",5,5,0,170690,1847.8,95.4
"23869","71103","2020",3,3,0,160159.3,1722.667,93.33333
"23870","71104","2020",5,5,0,95800,1033,98.8
"23871","71105","2020",101,51,50,195454.2,2056.02,92.63366
"23872","71106","2020",29,20,9,112089,1130.862,97.82759
"23873","71107","2020",4,4,0,131250,1441.5,93.5
"23874","71108","2020",2,2,0,123500,1267,97.5
"23875","71109","2020",3,2,1,152720,2159.667,77.33333
"23876","71110","2020",6,6,0,117416.7,1075.167,109
"23877","71111","2020",1,1,0,113000,1130,100
"23878","71112","2020",1,1,0,265000,2208,120
"23879","71113","2020",5,5,0,75250,1026.4,107.4
"23880","71115","2020",4,4,0,184450,1434,121.5
"23881","71117","2020",13,13,0,235091.5,1914.769,122.6154
"23882","71118","2020",80,62,18,140004.1,1642.775,84.9875
"23883","71119","2020",10,9,1,171880,1471,117.2
"23884","71120","2020",45,34,11,113130.9,1146.778,102.6667
"23885","71121","2020",5,5,0,204904,1777.4,113.2
"23886","71122","2020",7,7,0,150452.9,1521.857,96
"23887","71123","2020",6,6,0,101536.2,955.3333,110
"23888","71124","2020",5,5,0,115400,1279.6,90.2
"23889","71126","2020",4,4,0,196416.8,1934.5,124.75
"23890","71127","2020",3,3,0,177155.7,1442.333,129
"23891","71129","2020",3,3,0,81981.67,666.3333,116.6667
"23892","71130","2020",7,7,0,106428.6,1738.429,63.85714
"23893","71131","2020",4,4,0,85875,1115.25,75.75
"23894","71132","2020",37,37,0,121536.8,1221.351,106.8649
"23895","71133","2020",20,14,6,94652.5,956.35,99.25
"23896","71134","2020",13,13,0,148693.5,1403.154,104.7692
"23897","71135","2020",6,6,0,173726,1771.5,98.66667
"23898","71136","2020",1,1,0,20000,455,44
"23899","71137","2020",54,38,16,176716.4,1784.611,102.7222
"23900","71139","2020",4,4,0,119900,844.5,118.5
"23901","71140","2020",1,1,0,107585,672,160
"23902","71141","2020",9,9,0,125011.1,956.1111,126.2222
"23903","71142","2020",3,3,0,77000,691.3333,122
"23904","71143","2020",2,2,0,162000,2131.5,79
"23905","71144","2020",2,2,0,86320,897.5,94.5
"23906","71145","2020",10,10,0,104847,1434.2,78.1
"23907","71146","2020",4,4,0,168150,1657.25,101.75
"23908","71147","2020",2,2,0,145575,1266,116
"23909","71148","2020",11,11,0,104681.8,947.2727,110.9091
"23910","71149","2020",17,17,0,122306.5,1206.294,107.5882
"23911","71150","2020",35,33,2,205926.1,1860.029,113.4286
"23912","71151","2020",2,2,0,195550,1431.5,120
"23913","71152","2020",5,5,0,92200,810.8,118.8
"23914","71153","2020",189,102,87,87091.8,1112.619,79.7619
"23915","71154","2020",19,18,1,188199.2,1699.579,116.2105
"23916","71155","2020",7,7,0,69214.29,672.8571,102.8571
"23917","71156","2020",1,1,0,85260,1066,80
"23918","71157","2020",15,15,0,111000,1313.267,87.46667
"23919","71158","2020",19,18,1,204770,2047.947,100.7368
"23920","71159","2020",3,3,0,164666.7,1287.333,109.3333
"23921","71160","2020",1,1,0,135000,1350,100
"23922","71161","2020",4,4,0,62000,678,86.25
"23923","71162","2020",10,10,0,103541,1196,87.5
"23924","71163","2020",2,2,0,177775,1579.5,112
"23925","71164","2020",4,4,0,124475,1940.25,69
"23926","71165","2020",13,13,0,91708.08,987.3077,82.38462
"23927","71166","2020",3,3,0,67000,1067.333,70.33333
"23928","71167","2020",4,4,0,127675,1310,95.75
"23929","71168","2020",5,5,0,121160,1616.2,82
"23930","71169","2020",6,5,1,200967.2,1923,102
"23931","71170","2020",23,23,0,197903.5,1894.739,105.913
"23932","71171","2020",5,5,0,73300,829.2,89.6
"23933","71172","2020",2,2,0,97500,770,112
"23934","71173","2020",7,7,0,121928.6,1207.143,98.14286
"23935","71174","2020",2,2,0,120500,2055,56
"23936","71175","2020",11,11,0,140181.8,1496.364,94.54545
"23937","71176","2020",95,66,29,93327.48,1022.811,90.07368
"23938","71177","2020",12,11,1,137858.3,1405.167,100.75
"23939","71178","2020",17,17,0,120067.6,1299.471,95.76471
"23940","71179","2020",2,2,0,142005,1094,140
"23941","71181","2020",1,1,0,1e+05,935,107
"23942","71182","2020",20,19,1,302707,1989.75,160.8
"23943","71183","2020",1,1,0,137900,1149,120
"23944","71184","2020",6,6,0,80725,921.1667,78.83333
"23945","71185","2020",5,5,0,66000,825.2,80.4
"23946","71186","2020",7,7,0,104501.6,734.8571,127.1429
"23947","71187","2020",18,14,4,102271.1,1307.389,77.72222
"23948","71188","2020",3,3,0,135958.3,1055.333,122.3333
"23949","71189","2020",23,23,0,180750.4,1671.565,109.3043
"23950","71190","2020",29,29,0,74709.62,868.7586,86.44828
"23951","71191","2020",3,3,0,121666.7,1113.667,112.6667
"23952","71192","2020",23,23,0,91640.26,983.4783,91.69565
"23953","71193","2020",10,10,0,159333,1465.3,116.3
"23954","71194","2020",6,6,0,202003.3,1512.833,130.8333
"23955","71196","2020",12,12,0,140400,1105.583,133.4167
"23956","71198","2020",10,10,0,126220,1152.1,109.3
"23957","71199","2020",1,1,0,65000,602,108
"23958","71200","2020",8,8,0,189675,1525.875,135
"23959","71201","2020",2,2,0,50150,629,79.5
"23960","71202","2020",22,21,1,156730,1557.591,101.7273
"23961","71203","2020",2,2,0,114000,954,115
"23962","71204","2020",10,10,0,210793,1590,131.9
"23963","71205","2020",15,15,0,128960,1133,110.7333
"23964","71207","2020",3,3,0,125999.7,1681.333,75.33333
"23965","71208","2020",4,4,0,63000,805,72
"23966","71209","2020",16,16,0,149875,1223.312,119.375
"23967","71210","2020",2,2,0,276790,2938,85
"23968","71212","2020",18,17,1,101983.3,1111.333,90.44444
"23969","71213","2020",8,8,0,109312.5,1245,89.875
"23970","71214","2020",10,10,0,125050,1088.4,112.9
"23971","71215","2020",1,1,0,61600,622,99
"23972","71216","2020",1,1,0,22500,489,46
"23973","71217","2020",4,4,0,127000,1354.75,94.5
"23974","71218","2020",13,13,0,158196.2,1402.615,112.5385
"23975","71219","2020",8,8,0,125607.5,1481.125,87.5
"23976","71220","2020",6,6,0,95148.33,1064.833,85.83333
"23977","71221","2020",54,49,5,227442.6,1819.981,120.4815
"23978","71222","2020",13,13,0,206783.5,1477.077,146.6154
"23979","71223","2020",9,9,0,98438.89,1119.778,93.33333
"23980","71224","2020",1,1,0,70000,1429,49
"23981","71225","2020",8,8,0,181908.8,1657.375,108
"23982","71227","2020",7,7,0,103642.9,915.4286,117.7143
"23983","71228","2020",3,3,0,75933.33,849,76.66667
"23984","71229","2020",3,3,0,1e+05,778.3333,111.3333
"23985","71230","2020",77,68,9,76670.26,812.0519,94.92208
"23986","71231","2020",11,11,0,138410.2,1143.182,119.9091
"23987","71232","2020",3,3,0,65333.33,947.3333,66.33333
"23988","71233","2020",5,5,0,125108.8,1151,109.2
"23989","71234","2020",5,5,0,110200,1340.2,83.2
"23990","71235","2020",14,14,0,265035.7,2099.571,123.4286
"23991","71236","2020",14,14,0,173939.3,1722.929,93.92857
"23992","71237","2020",4,4,0,91112.5,980,90.25
"23993","71238","2020",15,15,0,146910,1222.2,125.5333
"23994","71239","2020",11,11,0,80493.64,1043.545,83.81818
"23995","71240","2020",6,6,0,204500,1645,134.5
"23996","71241","2020",2,2,0,144200,1349.5,112
"23997","71242","2020",7,7,0,169296.9,1698.143,109.5714
"23998","71243","2020",5,5,0,149560,1217.6,126.8
"23999","71244","2020",8,8,0,136125,1365.875,97.75
"24000","71245","2020",5,5,0,126580,1371.6,93.6
"24001","71246","2020",7,7,0,91285.71,998.7143,100.2857
"24002","71247","2020",2,2,0,135285,1610,90
"24003","71248","2020",13,13,0,115120.6,1302.692,87
"24004","71249","2020",12,12,0,151004.2,1531.583,103.5
"24005","71250","2020",18,18,0,218230.6,2070.778,111.3333
"24006","71251","2020",10,10,0,133086,1396.2,102.3
"24007","71252","2020",3,3,0,173333.3,1865.333,94
"24008","71253","2020",9,9,0,204972.2,1953,104.6667
"24009","71254","2020",2,2,0,109270,1243,90.5
"24010","71255","2020",3,3,0,154048.3,1383.667,111
"24011","71256","2020",6,6,0,134483.3,1569.167,89.66667
"24012","71257","2020",7,7,0,149642.9,1274,117.2857
"24013","71258","2020",8,8,0,197546.2,1858.875,125.5
"24014","71259","2020",5,5,0,150792,1292.4,116.4
"24015","71261","2020",7,7,0,204298.6,1281,145.4286
"24016","71262","2020",2,2,0,103125,1144,84
"24017","71263","2020",102,76,26,123553.5,1358.647,93.13725
"24018","71264","2020",8,8,0,168900,1703.875,100.5
"24019","71266","2020",12,12,0,53357.5,707,81
"24020","71267","2020",13,11,2,218634.6,2563.615,97.69231
"24021","71268","2020",1,0,1,58300,511,114
"24022","71269","2020",51,25,26,115872.7,1591.706,75.05882
"24023","71270","2020",453,115,338,126100.7,1573.649,79.95585
"24024","71271","2020",6,6,0,132491.7,1110.5,122.5
"24025","71272","2020",2,2,0,69350,757.5,102.5
"24026","71273","2020",1,1,0,38000,633,60
"24027","71274","2020",5,5,0,129800,1371.2,93.2
"24028","71275","2020",22,19,3,113086.8,1097.591,103.6364
"24029","71276","2020",1,1,0,91000,791,115
"24030","71277","2020",11,11,0,138017.7,1135.273,122.3636
"24031","71278","2020",1,1,0,290000,1758,165
"24032","71279","2020",8,8,0,151058.8,1244.125,132.75
"24033","71280","2020",1,1,0,43000,544,79
"24034","71281","2020",4,4,0,143087.5,1244.5,104
"24035","71282","2020",10,9,1,99263,832.7,121
"24036","71283","2020",13,13,0,154538.8,1539.692,100.3846
"24037","71284","2020",2,2,0,141775,1165,119
"24038","71285","2020",6,6,0,78220.17,874.6667,89
"24039","71286","2020",4,4,0,105041.2,1013.5,111.25
"24040","71287","2020",1,1,0,171731,2020,85
"24041","71289","2020",12,11,1,112494.2,1133.75,97.58333
"24042","71290","2020",4,4,0,95200,1510.5,58.25
"24043","71291","2020",11,11,0,123024.8,1146,120.4545
"24044","71292","2020",17,17,0,246301.2,1911.706,137.9412
"24045","71293","2020",7,7,0,129042.9,1355.571,100.8571
"24046","71294","2020",11,10,1,164886.4,1504.818,104.5455
"24047","71295","2020",21,21,0,118509,1201.095,95.38095
"24048","71296","2020",11,11,0,177651.4,1775.909,102.4545
"24049","71297","2020",14,14,0,119359.3,903.4286,125.6429
"24050","71299","2020",2,2,0,192375,1377.5,138
"24051","71300","2020",3,3,0,109333.3,1466,76
"24052","71301","2020",2,2,0,59000,754,79.5
"24053","71302","2020",4,4,0,159950,1587.75,120
"24054","71303","2020",14,14,0,147178.6,1509.143,92.92857
"24055","71305","2020",13,12,1,185943.1,1431.154,133.4615
"24056","71306","2020",166,128,38,85590.93,964.9398,87.72892
"24057","71307","2020",4,4,0,174455,1543.75,108.5
"24058","71308","2020",2,2,0,252000,1242,206
"24059","71309","2020",22,20,2,128933.4,1288.591,99.81818
"24060","71310","2020",43,36,7,113309.1,1268.721,92.44186
"24061","71311","2020",4,4,0,160375,1345,115.25
"24062","71312","2020",2,2,0,152500,1130.5,128.5
"24063","71313","2020",3,3,0,141100,945.6667,148
"24064","71314","2020",4,4,0,111950,1159.25,93.5
"24065","71315","2020",2,2,0,180500,1388.5,135
"24066","71316","2020",5,5,0,105610,976.8,102
"24067","71317","2020",2,2,0,113910,1147.5,99.5
"24068","71318","2020",23,23,0,135449.6,1261.217,107.6087
"24069","71319","2020",20,18,2,107525,1070.6,106.4
"24070","71320","2020",2,2,0,110000,1315.5,82.5
"24071","71321","2020",4,4,0,148750,1354.5,107.75
"24072","71322","2020",2,2,0,103900,742,140.5
"24073","71323","2020",4,4,0,95250,1435.5,69.5
"24074","71324","2020",5,5,0,120118,1181.6,103.6
"24075","71325","2020",17,17,0,101408.2,918,107.2941
"24076","71326","2020",14,14,0,127678.6,1189.143,105.6429
"24077","71327","2020",3,3,0,120433.3,1162.667,103.6667
"24078","71328","2020",16,16,0,146442.8,1397.125,104.125
"24079","71329","2020",10,10,0,82900,799.3,103.5
"24080","71330","2020",9,9,0,63373.33,666.1111,97.33333
"24081","71331","2020",1,1,0,209000,972,215
"24082","71332","2020",2,2,0,109500,1133.5,98
"24083","71333","2020",17,17,0,151382.4,1475.941,106.0588
"24084","71334","2020",5,4,1,121417.8,1148.6,109.8
"24085","71335","2020",1,1,0,2e+05,1429,140
"24086","71336","2020",29,28,1,166185.5,1542.069,109.5517
"24087","71337","2020",6,6,0,150764.2,1251.333,136.3333
"24088","71338","2020",2,2,0,344500,3575,98
"24089","71339","2020",7,7,0,165821.4,1200.857,131.1429
"24090","71340","2020",16,16,0,96293.44,1104.438,91.8125
"24091","71341","2020",6,5,1,122416.7,1409.167,87
"24092","71342","2020",140,93,47,119552.1,1551.121,84.75
"24093","71343","2020",8,8,0,139562.5,1301.375,104.125
"24094","71344","2020",1,1,0,109500,2147,51
"24095","71345","2020",8,8,0,169528.1,1342.25,130.75
"24096","71346","2020",21,19,2,70425.24,796.2857,91.19048
"24097","71347","2020",4,4,0,122712.5,1310.25,89.5
"24098","71349","2020",1,1,0,78000,542,144
"24099","71350","2020",8,8,0,136787.5,1640.375,78.125
"24100","71351","2020",33,32,1,113117.4,1231.424,90.93939
"24101","71352","2020",1,1,0,130000,1008,129
"24102","71353","2020",4,4,0,123734.2,1803.75,75
"24103","71354","2020",11,11,0,122763.6,1289.182,103.9091
"24104","71355","2020",7,7,0,157928.6,1503,112.1429
"24105","71356","2020",6,6,0,132893,1300.167,105.6667
"24106","71357","2020",5,5,0,107115.8,1107.4,96.4
"24107","71358","2020",3,3,0,281500,1459,188.6667
"24108","71359","2020",7,6,1,160637.9,1486.571,113
"24109","71360","2020",24,23,1,193133.3,1821.833,105.1667
"24110","71362","2020",4,4,0,177150,1909.5,99
"24111","71363","2020",4,4,0,120250,687.75,156.25
"24112","71364","2020",4,4,0,103625,893.75,122.25
"24113","71365","2020",9,9,0,145682.2,1451.444,106.2222
"24114","71366","2020",4,4,0,123860,1148.5,125
"24115","71367","2020",6,6,0,97166.67,1191,87
"24116","71368","2020",5,5,0,149721.4,1534.8,121.8
"24117","71369","2020",6,6,0,147016.7,1653.5,93.83333
"24118","71370","2020",2,2,0,72500,892.5,69
"24119","71371","2020",27,25,2,240735.2,2174.519,113.6296
"24120","71372","2020",23,21,2,192904.6,1982.391,104.2174
"24121","71373","2020",24,24,0,133470.8,1192.167,116.8333
"24122","71374","2020",1,1,0,80000,2667,30
"24123","71376","2020",11,11,0,83497.64,1010.818,80.18182
"24124","71377","2020",1,1,0,85000,895,95
"24125","71378","2020",22,22,0,174866.4,1665.636,111.3636
"24126","71379","2020",25,25,0,141745.6,1344.4,106.92
"24127","71380","2020",8,8,0,196193.8,1519.25,132.375
"24128","71381","2020",3,3,0,156000,1244.667,120.6667
"24129","71382","2020",12,12,0,109185.4,947.4167,112.4167
"24130","71383","2020",7,7,0,136194.3,1269,116.1429
"24131","71385","2020",11,10,1,183218.6,1669.818,105.8182
"24132","71386","2020",1,1,0,160000,1455,110
"24133","71387","2020",4,4,0,176500,1348.5,115.25
"24134","71388","2020",8,8,0,113618.8,1149.125,101.875
"24135","71389","2020",5,5,0,112444.4,1114.6,94.6
"24136","71390","2020",11,11,0,119519.1,1315,97
"24137","71391","2020",12,10,2,137444.1,1616.333,112.3333
"24138","71392","2020",12,12,0,108050.3,1151.333,90.16667
"24139","71393","2020",6,6,0,128853,1341.167,89.5
"24140","71394","2020",10,10,0,90750,1113.2,79.7
"24141","71395","2020",2,2,0,178000,1547,115
"24142","71396","2020",14,14,0,71821.43,1037.929,78.42857
"24143","71397","2020",4,4,0,231343.8,1648.75,139
"24144","71398","2020",15,15,0,150653.3,1471.067,102.4667
"24145","71399","2020",11,10,1,104445.5,1258.545,89.81818
"24146","71400","2020",3,3,0,134000,1539,101
"24147","71401","2020",15,15,0,111685.7,1269.267,92
"24148","71402","2020",8,8,0,163692.5,1548.75,110.375
"24149","71403","2020",2,2,0,161600,1703.5,92.5
"24150","71404","2020",14,12,2,176620.7,1976.286,89.71429
"24151","71405","2020",4,4,0,103250,1299,74.25
"24152","71406","2020",1,1,0,75000,524,143
"24153","71407","2020",4,4,0,87910,1078,86.5
"24154","71408","2020",4,4,0,249550,1287.25,195.5
"24155","71409","2020",4,4,0,138692.5,1151.5,122
"24156","71410","2020",15,15,0,120923.3,1186.4,106.9333
"24157","71411","2020",1,1,0,247700,1318,188
"24158","71412","2020",12,12,0,143694.2,1441.333,102.1667
"24159","71413","2020",8,8,0,167258.1,1142.875,141.125
"24160","71414","2020",6,6,0,165866.7,1424.333,123.3333
"24161","71415","2020",1,1,0,175000,2011,87
"24162","71416","2020",6,6,0,174194.2,1634.333,116.5
"24163","71417","2020",16,15,1,156087.5,1415.5,114.375
"24164","71419","2020",40,39,1,124330,1243.7,101.925
"24165","71420","2020",29,27,2,168873.4,1757.69,100.8276
"24166","71421","2020",2,2,0,141500,1211,118
"24167","71422","2020",1,1,0,75000,1705,44
"24168","71423","2020",5,5,0,153400,1563.8,98.4
"24169","71424","2020",2,2,0,86640,887,95.5
"24170","71425","2020",3,3,0,188400,1335.333,122
"24171","71426","2020",11,11,0,184676.4,1631.636,100.6364
"24172","71428","2020",8,8,0,106925,1032.75,102.75
"24173","71430","2020",2,2,0,173500,1478.5,119
"24174","71431","2020",3,3,0,137208.3,1402,102.3333
"24175","71433","2020",11,10,1,199781.8,1516.545,119.6364
"24176","71434","2020",4,4,0,193275,1029,179.5
"24177","71435","2020",4,4,0,147725,1609,91
"24178","71436","2020",4,3,1,107500,1228,87.5
"24179","71437","2020",4,4,0,145624.8,1573.5,93.25
"24180","71438","2020",8,8,0,78738.75,962.625,82.875
"24181","71439","2020",8,8,0,175987.5,1533.25,113.875
"24182","71440","2020",5,5,0,120200,854.4,138.6
"24183","71441","2020",3,3,0,92666.67,1110.667,81.33333
"24184","71442","2020",23,22,1,146978.3,1424.913,101.913
"24185","71443","2020",11,10,1,220045.5,1919.364,117.7273
"24186","71444","2020",11,11,0,150950,1417.455,104.3636
"24187","71445","2020",67,54,13,143877.2,1609.254,90.89552
"24188","71446","2020",5,5,0,153600,1207.2,126
"24189","71447","2020",6,6,0,202916.7,1678.5,133.8333
"24190","71448","2020",13,13,0,176489.2,1708.385,104.8462
"24191","71449","2020",1,1,0,125000,2358,53
"24192","71452","2020",1,1,0,51500,548,94
"24193","71453","2020",3,3,0,193906.7,1893.667,101.3333
"24194","71454","2020",2,2,0,144500,1535.5,95.5
"24195","71455","2020",7,7,0,90571.43,1222.571,71.71429
"24196","71456","2020",15,15,0,127313.3,1278.6,101.9333
"24197","71458","2020",1,1,0,118000,1297,91
"24198","71459","2020",1,1,0,172500,2104,82
"24199","71460","2020",7,7,0,201214.3,2103.571,98.28571
"24200","71461","2020",2,2,0,110392.5,1050.5,104.5
"24201","71462","2020",7,7,0,92428.57,1027.143,90.57143
"24202","71463","2020",5,5,0,119900,1143.4,116.8
"24203","71464","2020",3,3,0,72333.33,1234.667,62.33333
"24204","71465","2020",2,2,0,134875.5,1141,119.5
"24205","71466","2020",2,2,0,44000,812.5,54
"24206","71468","2020",9,9,0,125444.4,1301,95.11111
"24207","71469","2020",8,8,0,97500,993.125,101.375
"24208","71470","2020",3,3,0,243256.7,1627.667,143.6667
"24209","71471","2020",1,1,0,123500,1372,90
"24210","71472","2020",4,3,1,74000,955,75.5
"24211","71473","2020",4,4,0,57250,774.5,79.5
"24212","71474","2020",2,2,0,104000,1198,82.5
"24213","71475","2020",59,47,12,144850,1684.407,87.01695
"24214","71477","2020",2,2,0,85500,1186.5,75
"24215","71478","2020",2,2,0,35500,643,52.5
"24216","71479","2020",18,16,2,107420,1259.556,89.55556
"24217","71480","2020",14,14,0,135750,1298.714,108.9286
"24218","71481","2020",25,24,1,201464.6,1972.68,111.56
"24219","71482","2020",9,9,0,137227.8,1133.111,115.4444
"24220","71483","2020",3,3,0,130333.3,1122,130.3333
"24221","71484","2020",26,25,1,122072.6,1150.077,102.8846
"24222","71485","2020",6,6,0,140125,1348.5,110.1667
"24223","71486","2020",88,82,6,104085.8,1110.42,92.01136
"24224","71488","2020",2,2,0,122500,1083.5,134.5
"24225","71489","2020",13,13,0,169945.4,1499.231,121.8462
"24226","71490","2020",10,10,0,132689,1225.7,98.7
"24227","71491","2020",12,12,0,127599.5,1094.5,112.4167
"24228","71493","2020",4,4,0,88125,1449.25,61
"24229","71494","2020",11,10,1,179826.8,1777.182,102.8182
"24230","71495","2020",14,13,1,130214.3,1242.786,107.4286
"24231","71496","2020",4,4,0,365848.5,2778,133
"24232","71497","2020",16,13,3,215198.1,2077.188,105.625
"24233","71498","2020",4,4,0,136000,1501.75,92.5
"24234","71499","2020",42,42,0,89930.24,1034,85.85714
"24235","71500","2020",1,1,0,168000,1768,95
"24236","71501","2020",1,1,0,450000,2500,180
"24237","71502","2020",10,10,0,174815,1698.1,104.3
"24238","71503","2020",2,2,0,138725,822.5,172
"24239","71504","2020",2,2,0,33025,563.5,75
"24240","71505","2020",1,1,0,110000,1100,100
"24241","71506","2020",15,15,0,128311.3,1427.6,94
"24242","71507","2020",4,4,0,57375,1189.5,55.5
"24243","71508","2020",8,8,0,131191.5,1374.5,104.25
"24244","71509","2020",9,9,0,111166.7,917.5556,116.8889
"24245","71510","2020",7,7,0,104571.4,1216,86.42857
"24246","71512","2020",27,25,2,144711.9,1452.259,101.4074
"24247","71513","2020",14,12,2,163851.2,1782.5,98
"24248","71514","2020",8,8,0,138310.1,1299.75,102.875
"24249","71515","2020",1,1,0,104400,809,129
"24250","71516","2020",14,14,0,199135,1784.5,106.5714
"24251","71517","2020",5,5,0,115112,980.8,114.4
"24252","71518","2020",6,6,0,234341.7,1465.167,141.5
"24253","71519","2020",1,1,0,180000,1765,102
"24254","71520","2020",12,12,0,140382.8,1494.167,97.75
"24255","71521","2020",2,2,0,167500,1630.5,83
"24256","71522","2020",36,36,0,150839.4,1388.556,106.2778
"24257","71523","2020",19,19,0,141424.7,1476.474,99.89474
"24258","71524","2020",3,3,0,155000,1382,113
"24259","71525","2020",5,5,0,210860,1909.4,111
"24260","71526","2020",3,3,0,182041.7,1283,149
"24261","71527","2020",3,3,0,100100,1433,71.66667
"24262","71528","2020",43,41,2,144872.4,1531.651,97.16279
"24263","71529","2020",5,5,0,118600,1256.2,94
"24264","71530","2020",10,10,0,99965,1021.8,93.4
"24265","71531","2020",2,2,0,77500,841,89.5
"24266","71533","2020",6,6,0,213116.7,1398.5,151.8333
"24267","71534","2020",3,3,0,82666.67,1084.667,72
"24268","71535","2020",4,4,0,143625,1256.75,109.75
"24269","71537","2020",4,4,0,86937.5,896.5,97.75
"24270","71538","2020",9,9,0,156244.6,1400.333,124
"24271","71539","2020",1,1,0,150000,1429,105
"24272","71540","2020",17,16,1,105683.8,1115.882,95.17647
"24273","71541","2020",4,4,0,110337.5,1063.5,103
"24274","71542","2020",23,22,1,70785,941.2174,79.30435
"24275","71543","2020",101,62,39,103833.2,1199.812,85.61386
"24276","71544","2020",3,3,0,112666.7,1117.333,91
"24277","71545","2020",13,13,0,140366.5,1695.538,93.53846
"24278","71546","2020",7,7,0,108814.3,1424.857,83.85714
"24279","71547","2020",3,3,0,125666.7,1146,98.33333
"24280","71548","2020",3,3,0,197666.7,1741,115.3333
"24281","71549","2020",5,5,0,156380,1464,119.6
"24282","71550","2020",19,18,1,141828.2,1333.947,112.4737
"24283","71551","2020",5,5,0,158570,1996.6,97.8
"24284","71552","2020",5,5,0,126000,1258.6,99.8
"24285","71553","2020",8,8,0,145541.2,1223.125,108.5
"24286","71554","2020",3,3,0,72333.33,802,83
"24287","71555","2020",21,21,0,148966.2,1336.476,110.619
"24288","71556","2020",4,3,1,199075,2441.75,80.5
"24289","71557","2020",11,11,0,176600,1465.545,121.4545
"24290","71558","2020",20,20,0,139963.4,1273.05,109.6
"24291","71559","2020",3,3,0,85666.67,1005.667,84.33333
"24292","71561","2020",7,7,0,102447.1,1003.571,99.42857
"24293","71562","2020",3,3,0,114333.3,1006.333,109.3333
"24294","71563","2020",1,1,0,65000,2167,30
"24295","71564","2020",10,10,0,118300,1239.7,96.3
"24296","71565","2020",3,3,0,135033.3,1042.333,136
"24297","71566","2020",14,12,2,120128.6,1270.214,93.5
"24298","71567","2020",2,2,0,282500,1915,137
"24299","71570","2020",4,4,0,118250,1302.25,97.25
"24300","71571","2020",9,9,0,152364.4,1521.111,100.2222
"24301","71573","2020",3,3,0,154275.7,1478.667,103.6667
"24302","71574","2020",15,14,1,189544,1633.133,115.4
"24303","71576","2020",4,4,0,111125,1482,74
"24304","71578","2020",2,2,0,100500,1325,75.5
"24305","71579","2020",1,1,0,43000,589,73
"24306","71580","2020",8,8,0,130812.5,1400.625,95.25
"24307","71581","2020",1,1,0,60000,706,85
"24308","71582","2020",10,10,0,131872.5,1469.3,91.1
"24309","71583","2020",8,8,0,220415.9,2497.625,89.375
"24310","71584","2020",13,13,0,147408.8,1501.077,102.4615
"24311","71585","2020",12,12,0,197780.8,1969.333,108.5833
"24312","71586","2020",5,5,0,123650,1064.2,126
"24313","71588","2020",4,4,0,98720,1201.5,81.25
"24314","71589","2020",1,1,0,102500,1235,83
"24315","71590","2020",3,3,0,219640,1955.333,107.3333
"24316","71591","2020",5,5,0,206998,2859,83.2
"24317","72001","2020",29,29,0,187395.2,1613.724,118.2414
"24318","72002","2020",7,7,0,65142.86,832.5714,83.14286
"24319","72003","2020",79,47,32,121696.3,1444.139,81.24051
"24320","72004","2020",8,8,0,137937.5,1287.375,104.75
"24321","72005","2020",14,14,0,150654.3,1275.143,115.7143
"24322","72006","2020",17,17,0,122842.1,1362.882,91.64706
"24323","72007","2020",3,3,0,124166.7,1165.667,112.6667
"24324","72008","2020",100,99,1,176783.4,1799.57,101.28
"24325","72009","2020",2,2,0,203500,1300.5,147.5
"24326","72010","2020",1,1,0,255000,3643,70
"24327","72011","2020",15,15,0,109165.3,1244.8,91.66667
"24328","72012","2020",11,11,0,101162,1133.909,89.36364
"24329","72013","2020",35,35,0,89695.71,1049.829,86.48571
"24330","72015","2020",4,4,0,134437.5,1144.25,103.5
"24331","72016","2020",18,18,0,174827.9,1852.5,103.4444
"24332","72017","2020",2,2,0,99000,1326.5,81.5
"24333","72018","2020",2,2,0,77500,899.5,87.5
"24334","72019","2020",6,6,0,93416.67,938.5,99.16667
"24335","72020","2020",15,15,0,88515.67,1327.333,65.46667
"24336","72021","2020",15,15,0,96902,1179.333,86.53333
"24337","72022","2020",18,18,0,133666.7,1304.333,107
"24338","72023","2020",34,34,0,116896.2,1323.765,94.91176
"24339","72024","2020",38,38,0,179566.9,1737.447,105.8158
"24340","72025","2020",30,30,0,128638.4,1394,101.0667
"24341","72026","2020",13,13,0,134012.3,1424.385,96.61538
"24342","72027","2020",4,4,0,196250,1439.75,125.25
"24343","72028","2020",8,8,0,126500,1305.25,95.75
"24344","72029","2020",41,41,0,94475.37,944.0244,98.09756
"24345","72031","2020",8,8,0,107312.5,1039,102
"24346","72032","2020",3,3,0,52333.33,914.3333,63
"24347","72034","2020",3,3,0,198333.3,1736.667,112.3333
"24348","72035","2020",29,29,0,90857.76,1023.31,89.89655
"24349","72036","2020",2,2,0,131750,1165.5,115
"24350","72037","2020",2,2,0,123000,1270,102
"24351","72038","2020",7,7,0,84500,879.8571,100
"24352","72039","2020",71,69,2,95607.11,1085.606,89.8169
"24353","72040","2020",5,5,0,164900,1086.8,157.4
"24354","72041","2020",6,6,0,110091.7,1073.833,109.1667
"24355","72042","2020",31,31,0,116951.6,1212.935,96.80645
"24356","72043","2020",4,4,0,103100,1143,93.25
"24357","72044","2020",7,7,0,126978.6,1252.857,105.4286
"24358","72045","2020",14,14,0,154058.2,1426.571,106.7143
"24359","72046","2020",26,26,0,124346.9,1393.423,92.53846
"24360","72047","2020",27,27,0,139545.6,1422.852,101
"24361","72048","2020",6,6,0,143750,1318.833,108.8333
"24362","72049","2020",2,2,0,72500,819.5,95.5
"24363","72050","2020",27,26,1,108722.2,1077.63,103.037
"24364","72051","2020",42,41,1,137515.5,1215.952,114.5238
"24365","72052","2020",12,12,0,115116.7,1000.417,109.4167
"24366","72053","2020",15,15,0,145933.3,1453,100.4
"24367","72054","2020",42,41,1,165493.2,1729.143,98.35714
"24368","72056","2020",12,11,1,142533.3,1648.083,84.16667
"24369","72058","2020",74,74,0,220200.4,1954.676,114.2973
"24370","72059","2020",12,12,0,99233.75,1104.167,93.16667
"24371","72060","2020",7,7,0,100857.1,1157.429,92.28571
"24372","72061","2020",22,22,0,142386.4,1270.318,114.8182
"24373","72062","2020",11,11,0,138363.6,1481.273,90.36364
"24374","72064","2020",7,7,0,81105.71,1012.429,76.71429
"24375","72065","2020",19,19,0,254521.1,2114.263,125.1053
"24376","72066","2020",5,5,0,143000,1656.6,86.6
"24377","72067","2020",13,13,0,106484.6,1222.077,90
"24378","72068","2020",30,28,2,97528.17,1314.5,84.2
"24379","72070","2020",4,4,0,121500,1019,121.5
"24380","72071","2020",92,88,4,111652.3,1101.38,94.92391
"24381","72072","2020",7,7,0,136309.6,1285.143,108.1429
"24382","72073","2020",14,14,0,150985.5,1463.929,104.1429
"24383","72074","2020",5,5,0,227236,1467.6,151.4
"24384","72075","2020",14,14,0,131797.1,1657.786,78.21429
"24385","72076","2020",5,5,0,170985,1280.6,137.4
"24386","72077","2020",5,5,0,68900,779.8,95
"24387","72078","2020",4,4,0,74850,1060.25,71.75
"24388","72079","2020",6,6,0,109430.2,1220.833,86.66667
"24389","72080","2020",20,20,0,164907,1620.7,104.2
"24390","72083","2020",4,4,0,124000,954,123.75
"24391","72084","2020",22,22,0,139150,1261.455,118.5
"24392","72085","2020",3,3,0,63333.33,755.6667,80.33333
"24393","72086","2020",1,1,0,410000,1864,220
"24394","72087","2020",5,5,0,120000,1074,106
"24395","72088","2020",5,5,0,92600,963,104.2
"24396","72089","2020",24,24,0,126355,1470.458,84.16667
"24397","72090","2020",39,38,1,103029.3,1348.795,80.30769
"24398","72091","2020",3,3,0,92233.33,825.3333,104.3333
"24399","72093","2020",14,14,0,133315,1638.143,88.85714
"24400","72094","2020",8,8,0,77125,1106.375,73.25
"24401","72095","2020",61,43,18,181418.5,1801.344,98.31148
"24402","72096","2020",23,23,0,138519,1399.304,97.52174
"24403","72098","2020",6,6,0,120266.7,988.3333,120.8333
"24404","72099","2020",7,7,0,162597.1,1440,114.7143
"24405","72100","2020",3,3,0,138666.7,1093,119.3333
"24406","72101","2020",13,13,0,138816.2,1226.385,118.0769
"24407","72102","2020",2,2,0,165000,1289.5,121
"24408","72103","2020",12,12,0,89200,962.1667,96
"24409","72104","2020",9,8,1,65722.22,780.5556,84.55556
"24410","72105","2020",5,5,0,152000,1425.2,100
"24411","72106","2020",7,7,0,154142.9,1496.571,103.4286
"24412","72107","2020",6,6,0,139174.5,1242.833,114.1667
"24413","72109","2020",8,8,0,64900,780.375,83.875
"24414","72110","2020",10,10,0,149700,1286,125.4
"24415","72111","2020",8,8,0,113646.2,1281.625,98.875
"24416","72112","2020",9,9,0,86666.67,1074.556,77.88889
"24417","72113","2020",8,8,0,153906.9,1998.625,93.125
"24418","72114","2020",8,8,0,85750,998.375,85.125
"24419","72115","2020",7,7,0,84452.43,1065.571,87.57143
"24420","72118","2020",25,25,0,82666,936.76,85.76
"24421","72119","2020",13,13,0,181096.2,1611.231,109.7692
"24422","72120","2020",4,4,0,84500,766.25,100.75
"24423","72121","2020",5,5,0,96300,1090,94.4
"24424","72122","2020",9,9,0,137078.9,1345.778,106.1111
"24425","72124","2020",68,63,5,154437.6,1506.029,103.2353
"24426","72125","2020",5,5,0,87400,997.4,88
"24427","72126","2020",3,3,0,144350,991,143.3333
"24428","72127","2020",27,27,0,172250.7,1710.889,102.5926
"24429","72128","2020",10,10,0,96300,1069.4,88.4
"24430","72129","2020",7,7,0,136143,1334,104.2857
"24431","72130","2020",4,4,0,159500,1606.75,98
"24432","72131","2020",7,7,0,97758.57,1249,76.57143
"24433","72132","2020",1,1,0,38500,481,80
"24434","72133","2020",12,12,0,205750,1968.25,104.25
"24435","72134","2020",15,15,0,115563.5,1063,119.4
"24436","72135","2020",6,6,0,103333.3,1124.333,92.5
"24437","72136","2020",4,4,0,124250,1002.75,115.25
"24438","72137","2020",26,26,0,161126.1,1374.5,118.1538
"24439","72138","2020",60,60,0,71418.25,828.8333,88.75
"24440","72139","2020",9,9,0,77666.67,926.5556,82.55556
"24441","72141","2020",9,9,0,123980,1175.222,105.7778
"24442","72142","2020",1,1,0,198000,1320,150
"24443","72143","2020",27,27,0,94757.59,1104.074,86.07407
"24444","72144","2020",12,12,0,118433.3,975.3333,98
"24445","72146","2020",38,37,1,184691.5,1793.079,109.2368
"24446","72147","2020",16,16,0,164250,1820.875,93.6875
"24447","72148","2020",1,1,0,85000,1062,80
"24448","72149","2020",8,8,0,126500,1188.75,111.125
"24449","72150","2020",17,17,0,152285.5,1437.412,109.5294
"24450","72151","2020",11,10,1,146045.5,1859.727,86
"24451","72152","2020",5,5,0,118700,1175.2,103.4
"24452","72153","2020",14,14,0,107703,1186.429,94.35714
"24453","72154","2020",186,173,13,156348.2,1549.812,104.1344
"24454","72155","2020",24,24,0,156195,1542.833,102.7083
"24455","72156","2020",14,14,0,86059.57,1080.571,80.71429
"24456","72157","2020",14,14,0,134415,1334.786,103.9286
"24457","72158","2020",20,20,0,119498.1,1167.9,102.45
"24458","72160","2020",8,8,0,137509.6,1675,94.25
"24459","72161","2020",17,17,0,91247.06,1057.588,85.58824
"24460","72163","2020",7,7,0,115928.6,1006.857,114.1429
"24461","72165","2020",27,27,0,149714.8,1451.37,101.4815
"24462","72166","2020",6,6,0,153918.3,1789.833,87.16667
"24463","72167","2020",9,9,0,163933.3,1510.889,119
"24464","72168","2020",29,28,1,97693.31,1170.655,83.93103
"24465","72169","2020",17,17,0,192764.7,1901.412,97.64706
"24466","72170","2020",3,3,0,72333.33,860.3333,85.66667
"24467","72171","2020",3,3,0,96000,864.3333,126.6667
"24468","72172","2020",8,8,0,133895,1079.375,125.25
"24469","72173","2020",11,11,0,119227.3,1258,90.81818
"24470","72174","2020",1,1,0,17500,398,44
"24471","72175","2020",17,16,1,130408.9,1374.706,103.4118
"24472","72176","2020",47,46,1,89152.55,1034.532,84.97872
"24473","72177","2020",6,6,0,118133.3,1217.833,103.8333
"24474","72178","2020",1,1,0,168000,1312,128
"24475","72179","2020",41,41,0,106587.8,1128.829,94.82927
"24476","72180","2020",80,70,10,83176.25,975.325,84.5375
"24477","72181","2020",2634,1267,1367,131998.1,1738.664,74.31739
"24478","72182","2020",32,32,0,109210.9,1028.75,104.1875
"24479","72183","2020",20,20,0,97752.5,1099,93.25
"24480","72184","2020",5,5,0,104080,1049.6,96.8
"24481","72185","2020",10,10,0,99400,993.9,100.4
"24482","72186","2020",15,15,0,128947.3,1493.867,89.73333
"24483","72187","2020",20,20,0,118335,1099.05,109.05
"24484","72188","2020",4,4,0,74897,850,85.75
"24485","72189","2020",29,29,0,95362.76,1003.586,97.82759
"24486","72190","2020",1,1,0,57000,864,66
"24487","72191","2020",39,39,0,106774.1,1135.026,95.15385
"24488","72192","2020",5,5,0,91200,928.2,106.6
"24489","72193","2020",7,7,0,86542.86,895.1429,96.57143
"24490","72194","2020",3,3,0,135480.3,1579.667,87.66667
"24491","72195","2020",19,19,0,141684.1,1236.263,116.5789
"24492","72196","2020",11,11,0,99656.36,980.7273,103.7273
"24493","72197","2020",10,10,0,133042.2,1278.9,101.6
"24494","72198","2020",29,28,1,205908.6,1859.448,111.4138
"24495","72199","2020",4,4,0,61812.5,848.75,72.5
"24496","72200","2020",54,54,0,174227.4,1753.537,102.5
"24497","72201","2020",5,5,0,184040,1983,92.4
"24498","72202","2020",3,3,0,110333.3,889.6667,123.6667
"24499","72204","2020",6,6,0,70825,723.8333,96.16667
"24500","72205","2020",30,30,0,147823.7,1444.833,100.7
"24501","72208","2020",8,8,0,120510,1052.125,100.625
"24502","72209","2020",5,5,0,65800,772.6,90
"24503","72210","2020",7,7,0,127428.6,1099.286,115.4286
"24504","72211","2020",9,9,0,82871.11,961.4444,91.77778
"24505","72212","2020",14,13,1,145503,1528.571,98
"24506","72213","2020",66,63,3,168725.9,1907.621,98.21212
"24507","72215","2020",17,17,0,111700,1275.647,89.47059
"24508","72216","2020",8,8,0,142137.5,1213.5,113.375
"24509","72217","2020",30,30,0,170198.7,1876.933,92.03333
"24510","72218","2020",7,7,0,110600,1006.143,100.5714
"24511","72219","2020",6,6,0,176000,1366.167,133.6667
"24512","72220","2020",13,13,0,126546.2,1535.769,89.69231
"24513","72221","2020",4,4,0,118087.5,1131,107.5
"24514","72222","2020",6,6,0,85000,886.1667,100.3333
"24515","72223","2020",39,39,0,101626.3,1097.154,103.359
"24516","72224","2020",12,12,0,136479.2,1389.667,102.4167
"24517","72225","2020",9,9,0,137320.2,1015.111,130.2222
"24518","72226","2020",19,19,0,149111.6,1392.842,110.3158
"24519","72227","2020",1,1,0,130000,867,150
"24520","72228","2020",26,26,0,120173.7,1119.962,113.5769
"24521","72229","2020",4,4,0,89125,830.75,105.25
"24522","72230","2020",16,16,0,144764.5,1411.938,103.375
"24523","72231","2020",53,52,1,178939.3,1815.453,101.2453
"24524","72232","2020",5,5,0,155900,1446.8,107.4
"24525","72233","2020",1,1,0,205000,837,245
"24526","72234","2020",3,3,0,132166.7,1460.333,97.66667
"24527","72235","2020",3,3,0,82833.33,807.3333,103
"24528","72236","2020",2,2,0,152000,1100.5,143.5
"24529","72237","2020",8,8,0,136000,1220.25,113.125
"24530","72238","2020",1,1,0,175000,1667,105
"24531","72239","2020",7,7,0,151000,1311.429,114.7143
"24532","72241","2020",32,32,0,121875,1259.312,97.84375
"24533","72243","2020",19,19,0,130813.2,1234.158,101.0526
"24534","72244","2020",33,30,3,111181.8,1210.121,95.42424
"24535","72245","2020",11,11,0,100088.7,1181.636,84.90909
"24536","72246","2020",2,2,0,47250,529,82.5
"24537","72247","2020",14,14,0,184564.3,1914.214,96.85714
"24538","72248","2020",15,15,0,117132.7,1221.667,98.26667
"24539","72249","2020",4,4,0,176250,1382.75,121.25
"24540","72250","2020",4,4,0,47625,619,76.5
"24541","72251","2020",6,6,0,75815,735.3333,102.3333
"24542","72252","2020",25,25,0,123038,1167.64,105.84
"24543","72253","2020",9,9,0,132001.1,1463.556,94.77778
"24544","72254","2020",3,3,0,54166.67,945.6667,61
"24545","72255","2020",6,6,0,89333.33,776.8333,107.8333
"24546","72256","2020",9,9,0,91200,894.5556,100.4444
"24547","72257","2020",26,26,0,285760,2240.115,129
"24548","72259","2020",3,3,0,104233.3,1081.667,90
"24549","72260","2020",39,33,6,205830.8,1782.333,111.5385
"24550","72261","2020",4,4,0,180000,1745.25,106
"24551","72262","2020",43,42,1,88262.28,969.8605,90.76744
"24552","72264","2020",108,87,21,118537,1283.898,89.53704
"24553","72265","2020",3,3,0,86500,1022.667,84
"24554","72266","2020",5,5,0,131072,1148.8,110.6
"24555","72267","2020",14,14,0,122052,1057,118.7143
"24556","72268","2020",14,14,0,159214.3,1304,122.3571
"24557","72269","2020",25,24,1,78380,843.52,90.48
"24558","72270","2020",4,4,0,117250,1049.5,107
"24559","72271","2020",14,14,0,149678.1,1701.714,99.07143
"24560","72272","2020",6,6,0,63750,802.1667,76.33333
"24561","72273","2020",5,5,0,102630,809.8,112.8
"24562","72274","2020",4,4,0,83000,616.5,131.5
"24563","72275","2020",15,15,0,190669,1547.533,117.4667
"24564","72276","2020",45,45,0,89375.44,1070.556,81.48889
"24565","72277","2020",1,1,0,175000,951,184
"24566","72278","2020",18,18,0,90222.22,927,92.61111
"24567","72279","2020",5,5,0,142560,1375.4,100.8
"24568","72280","2020",24,23,1,201340.8,1969.417,105.2917
"24569","72281","2020",5,5,0,162600,1184.4,126.6
"24570","72282","2020",2,2,0,104000,1171.5,91.5
"24571","72283","2020",5,5,0,122000,1221.2,104.8
"24572","72286","2020",4,4,0,81875,885.75,87
"24573","72287","2020",28,28,0,158570.5,1488,110.0357
"24574","72289","2020",29,29,0,115359.5,1388.241,84.96552
"24575","72290","2020",20,20,0,165905,1703,95.95
"24576","72291","2020",17,17,0,111857.4,1262,93.17647
"24577","72292","2020",4,4,0,215250,1618,131.25
"24578","72293","2020",4,4,0,99000.75,1066.25,91
"24579","72294","2020",14,13,1,90617.86,1323.714,75.28571
"24580","72295","2020",6,6,0,86000,864.8333,92.66667
"24581","72296","2020",12,12,0,98870.83,1133.667,91.08333
"24582","72297","2020",8,8,0,108125,1155,92.625
"24583","72298","2020",11,11,0,117830.5,1179.727,103.8182
"24584","72299","2020",43,43,0,133536.7,1413.302,98.7907
"24585","72300","2020",41,40,1,146843.9,1464.707,102.9756
"24586","72302","2020",5,5,0,90957,838.6,111.4
"24587","72303","2020",8,8,0,76875,1092.125,69.5
"24588","72305","2020",14,14,0,110250,1134.429,96.57143
"24589","72306","2020",22,22,0,160681.4,1442.455,112.0909
"24590","72307","2020",3,3,0,119000,1044,118.6667
"24591","72308","2020",27,27,0,133500,1321.074,103.5926
"24592","72309","2020",12,12,0,85791.67,896.9167,95
"24593","72310","2020",28,28,0,223326.4,2110.786,113.8929
"24594","72311","2020",8,8,0,124901.8,1120.875,108.5
"24595","72312","2020",3,3,0,117433.3,1074,115.6667
"24596","72313","2020",1,1,0,73500,817,90
"24597","72314","2020",6,6,0,96633.33,923,95.16667
"24598","72315","2020",15,15,0,79366.67,844.9333,92.26667
"24599","72316","2020",15,15,0,139400,1149.867,120.2
"24600","72317","2020",10,10,0,104920,881.8,108.8
"24601","72319","2020",9,9,0,149714.8,1371.667,108.8889
"24602","72320","2020",30,30,0,236246.7,2150.333,109.7667
"24603","72321","2020",6,6,0,178833.3,1036.167,147.3333
"24604","72322","2020",7,7,0,105928.6,1379,83.71429
"24605","72323","2020",7,7,0,115071.4,1248.286,93.14286
"24606","72324","2020",5,5,0,114200,1360.8,86.6
"24607","72325","2020",12,12,0,91072.92,952.9167,90.25
"24608","72326","2020",4,4,0,100019,1268.5,80.5
"24609","72327","2020",4,4,0,98500,1079,96.25
"24610","72328","2020",44,43,1,245866.6,2342.909,112.3182
"24611","72329","2020",34,34,0,187774.1,1648.029,119.2941
"24612","72330","2020",8,8,0,89531.25,908.625,94.875
"24613","72331","2020",13,13,0,107323.1,1024.462,103.6923
"24614","72332","2020",5,5,0,93970,971.2,91.4
"24615","72333","2020",8,8,0,84062.5,978.625,85.625
"24616","72334","2020",32,31,1,91150,1014.438,90.875
"24617","72335","2020",20,20,0,127337.1,1387.1,93.2
"24618","72336","2020",16,16,0,136312.5,1278.562,103.9375
"24619","72337","2020",11,11,0,101945.5,1032.727,100.7273
"24620","72338","2020",5,5,0,128600,1498,90.4
"24621","72339","2020",4,4,0,270000,1790,150.25
"24622","72340","2020",19,19,0,149210.5,1379.474,115.7895
"24623","72341","2020",4,4,0,171218.8,1750.75,91.75
"24624","72342","2020",2,2,0,287000,1628.5,170
"24625","72343","2020",4,4,0,163500,1127.5,145.75
"24626","72344","2020",38,38,0,187814.1,1799.526,105.7632
"24627","72345","2020",3,3,0,124000,1152,117.3333
"24628","72346","2020",46,45,1,123531.2,1348.217,89.02174
"24629","72347","2020",7,7,0,88324.43,930.1429,103.5714
"24630","72348","2020",3,3,0,84666.67,912.3333,80.33333
"24631","72349","2020",8,8,0,134437.5,1175.125,115.625
"24632","72350","2020",37,37,0,167712.2,1605.324,106.973
"24633","72351","2020",14,14,0,106993,1017.5,105.0714
"24634","72352","2020",3,3,0,110000,1443,78.33333
"24635","72353","2020",9,9,0,95466.67,1034.889,94.77778
"24636","72354","2020",1,1,0,20000,377,53
"24637","72356","2020",8,8,0,112187.5,1090.875,106.375
"24638","72357","2020",10,10,0,127680,1253,101.3
"24639","72358","2020",21,21,0,111845.7,1265.667,90.85714
"24640","72359","2020",25,25,0,137215.6,1464.56,94.88
"24641","72360","2020",12,12,0,190333.3,1807.167,111.5
"24642","72361","2020",7,7,0,116500,967.2857,117.7143
"24643","72362","2020",6,6,0,95825,652.8333,134.8333
"24644","72363","2020",22,22,0,131329.2,1249.273,104.1818
"24645","72364","2020",21,21,0,81010.1,965.5238,81.95238
"24646","72366","2020",7,7,0,171740,2763.714,69.57143
"24647","72367","2020",6,6,0,92166.67,1021,98.5
"24648","72368","2020",6,6,0,88500,813.6667,107.1667
"24649","72369","2020",5,5,0,154617.4,1365.6,117
"24650","72370","2020",4,4,0,65000,784.75,97.75
"24651","72372","2020",1,1,0,125000,962,130
"24652","72373","2020",33,33,0,117141.8,1158.515,95.66667
"24653","72374","2020",8,8,0,143487.5,1018.125,116.875
"24654","72375","2020",8,8,0,118875,1144.375,108.875
"24655","72376","2020",8,8,0,89876.5,1253.625,71.875
"24656","72377","2020",15,15,0,109373.3,1019.4,107
"24657","72378","2020",14,14,0,150321.4,1317.357,116.7857
"24658","72379","2020",1,1,0,69000,575,120
"24659","72380","2020",14,14,0,123192.8,1131.643,111.5714
"24660","72381","2020",18,18,0,204241.4,1776.5,119.7778
"24661","72382","2020",16,16,0,141342.5,1319.688,105
"24662","72383","2020",2,2,0,192500,1079.5,164.5
"24663","72385","2020",29,29,0,125353.3,1375,95.24138
"24664","72386","2020",50,50,0,250378,2047.68,127.58
"24665","73001","2020",8,4,4,172825.6,2340.5,69.25
"24666","73003","2020",37,19,18,182935.9,2576.865,73.32432
"24667","73004","2020",31,8,23,94226.45,1947.71,52.54839
"24668","73005","2020",2,2,0,141000,1847.5,75
"24669","73006","2020",136,28,108,161408.7,3192.441,52.18382
"24670","73007","2020",17,13,4,193923.9,2059.941,97.17647
"24671","73008","2020",718,98,620,218453.4,3529.365,63.25627
"24672","73010","2020",87,62,25,290248.1,3005.207,97.41379
"24673","73011","2020",294,58,236,147526,2029.49,73.16327
"24674","73013","2020",28,6,22,117828.2,2353.821,47.75
"24675","73015","2020",149,17,132,388858.4,7529.705,50.75839
"24676","73017","2020",14,12,2,326770.6,2697.143,124.7143
"24677","73018","2020",17,10,7,177148.5,2060.529,84.41176
"24678","73019","2020",4,4,0,192342.5,1906,99.5
"24679","73020","2020",4,4,0,228918.8,2137.5,112.25
"24680","73021","2020",10,10,0,187837,2072.1,97.6
"24681","73022","2020",4,4,0,277122.5,2868.25,117.25
"24682","73023","2020",23,0,23,96723.26,2810.826,34.21739
"24683","73024","2020",76,7,69,127040.8,3564.961,36.51316
"24684","73025","2020",6,6,0,186716.7,1820.667,109.5
"24685","73026","2020",5,3,2,110724.2,1588.8,73.8
"24686","73027","2020",3,3,0,208866.7,1872.333,112.3333
"24687","73028","2020",5,5,0,164664,1486.6,116.6
"24688","73029","2020",48,15,33,246288.2,2873.979,85.08333
"24689","73030","2020",45,13,32,232773.5,2812.2,83.4
"24690","73031","2020",68,13,55,242699.2,3116.074,76.70588
"24691","73032","2020",18,15,3,167742.2,1935.333,84.16667
"24692","73033","2020",8,8,0,231012.1,2362.375,104.375
"24693","73034","2020",61,25,36,196048.8,3482.984,58.62295
"24694","73036","2020",6,5,1,255962.5,2366.667,108.1667
"24695","73039","2020",3,3,0,191600,1535.333,133.6667
"24696","73040","2020",16,3,13,137505.9,3336.312,42.3125
"24697","73041","2020",2,2,0,151192.5,1905.5,78
"24698","73042","2020",1,1,0,157000,2415,65
"24699","73043","2020",19,9,10,298634.8,2995.842,104.7368
"24700","73047","2020",12,1,11,146845.8,3433.167,46.66667
"24701","73048","2020",5,5,0,190750,1683.2,118.8
"24702","73049","2020",1,1,0,60000,750,80
"24703","73050","2020",4,2,2,295112.5,4446.5,66.25
"24704","73051","2020",51,19,32,271925,3570.275,79.64706
"24705","73052","2020",3,3,0,178800,2856.333,62.66667
"24706","73053","2020",2,2,0,234660,1903,128.5
"24707","73054","2020",267,19,248,176373,3913.427,46.27341
"24708","73055","2020",31,14,17,271182.3,3672.806,77.29032
"24709","73057","2020",36,2,34,112956,3529.25,34.97222
"24710","73058","2020",15,9,6,135105.3,1732.133,81.33333
"24711","73059","2020",39,30,9,475492.5,4581.872,108.8462
"24712","73061","2020",2,2,0,125175,1752.5,68
"24713","73063","2020",11,9,2,182534.5,2141.909,86
"24714","73064","2020",97,15,82,209725.4,3006.99,70.64948
"24715","73065","2020",932,100,832,177636.7,2532.595,71.30258
"24716","73067","2020",13,8,5,163120.8,1823.231,86.76923
"24717","73068","2020",5,5,0,207134,2267.4,107.4
"24718","73069","2020",14,13,1,191834.4,2112.5,95.42857
"24719","73070","2020",10,8,2,158584.2,1831.7,90.8
"24720","73071","2020",28,6,22,229379.8,4687.786,49.75
"24721","73072","2020",7,7,0,78228.57,2198.571,47
"24722","73073","2020",9,9,0,268199.4,2405.222,115.6667
"24723","73074","2020",4,4,0,215195,2827.5,81.25
"24724","73075","2020",5,5,0,225034,2518.8,103.2
"24725","73076","2020",5,5,0,373600.2,2569.8,142.6
"24726","73077","2020",9,6,3,227151.8,2620.333,91.77778
"24727","73078","2020",3,3,0,267046.7,3215,89.33333
"24728","73079","2020",10,9,1,247137.9,2364.8,105.6
"24729","73081","2020",12,10,2,176461.7,1957.583,95.33333
"24730","73082","2020",3,3,0,306133.3,3054,100.3333
"24731","73083","2020",1,1,0,212000,2356,90
"24732","73084","2020",5,5,0,277170,2664.4,96.8
"24733","73085","2020",22,20,2,211701.8,2237.136,99.68182
"24734","73086","2020",1,1,0,510200,3001,170
"24735","73087","2020",67,11,56,202770.3,2729.418,73.50746
"24736","73088","2020",30,5,25,177955.2,3845.867,45.63333
"24737","73089","2020",20,19,1,209029.9,2257.45,94.55
"24738","73090","2020",3,3,0,102011.7,1403.333,68.66667
"24739","73091","2020",2,2,0,319725,3998,87.5
"24740","73092","2020",2,2,0,178000,2475.5,91.5
"24741","73094","2020",23,8,15,312443.5,5025.261,60.6087
"24742","73095","2020",3,2,1,191816.7,1838.333,98
"24743","73096","2020",14,14,0,323062.6,2506.643,131.9286
"24744","73097","2020",4,4,0,250131.5,2931.25,97.5
"24745","73098","2020",32,17,15,174856.1,2643.781,68.3125
"24746","73099","2020",5,4,1,146674,2330.2,60
"24747","73100","2020",29,28,1,201290.7,1969.724,103.8966
"24748","73103","2020",50,19,31,297974.4,3523.5,83.9
"24749","73104","2020",6,6,0,285707.5,2565,119.8333
"24750","73105","2020",13,8,5,119673.1,1616.077,79.76923
"24751","73106","2020",5,5,0,129242.4,1711.2,87
"24752","73107","2020",14,12,2,163125.7,1860.571,84.42857
"24753","73109","2020",11,8,3,120097.3,2303,90.90909
"24754","73110","2020",8,8,0,144187.5,1767.625,86.875
"24755","73113","2020",2,2,0,136400,1145.5,112.5
"24756","73114","2020",23,6,17,151054.7,3244.957,44.82609
"24757","73116","2020",100,7,93,115756,2838.62,37.44
"24758","73117","2020",10,0,10,47214,710.8,65
"24759","73119","2020",1,1,0,63000,630,100
"24760","73120","2020",4,4,0,187237.5,1974,99.25
"24761","73121","2020",19,9,10,182499.5,2088.789,84.36842
"24762","73122","2020",7,7,0,236638.6,1894.571,128.2857
"24763","73123","2020",46,6,40,176441.1,3325.196,57.82609
"24764","73124","2020",33,23,10,229394.2,2394.636,97.60606
"24765","73128","2020",51,22,29,316633.3,3749.255,86.03922
"24766","73129","2020",15,13,2,212726,2102.467,101.8
"24767","73130","2020",18,14,4,206766.7,2279.389,90.94444
"24768","73131","2020",5,5,0,183590,2094.8,99.4
"24769","73132","2020",83,7,76,217782.6,5807.337,38.44578
"24770","73133","2020",4,4,0,173796.8,1812.25,98
"24771","73135","2020",8,8,0,180003.5,1737.25,101.875
"24772","73137","2020",42,7,35,213748.7,3199.929,69
"24773","73138","2020",4,4,0,143766.2,2624,82.5
"24774","73139","2020",3,3,0,154372.3,1940.333,76.66667
"24775","73140","2020",3,3,0,192424,1523.333,128
"24776","73141","2020",8,8,0,247393.8,2658.75,94.125
"24777","73142","2020",34,6,28,232171.7,3968.5,60.76471
"24778","73145","2020",5,3,2,195155.6,2184,82
"24779","73146","2020",9,7,2,216751.1,2433.333,94
"24780","73147","2020",3,3,0,226100,2139,103.3333
"24781","73149","2020",8,8,0,190106.8,1696.25,122
"24782","73150","2020",263,24,239,144932.1,3809.399,39.37262
"24783","73151","2020",40,31,9,288550.2,2913.725,104.5
"24784","73152","2020",1,0,1,1e+05,1282,78
"24785","73153","2020",14,14,0,277001.4,2383.357,129.0714
"24786","73154","2020",44,40,4,312510.1,2629.318,118.2727
"24787","73155","2020",29,16,13,315532.9,3502.448,89.27586
"24788","73156","2020",8,8,0,187020.6,1436.625,129.75
"24789","73157","2020",100,10,90,85703.29,1908.54,49.4
"24790","73159","2020",12,9,3,227736.5,2387.25,97.16667
"24791","73160","2020",12,9,3,338672.9,3262.25,104.3333
"24792","73161","2020",12,8,4,234827.8,2260.75,96.25
"24793","73162","2020",11,10,1,213561.8,2368.818,91
"24794","73164","2020",14,11,3,350579.6,3318.643,111.3571
"24795","73166","2020",1,1,0,1e+05,1316,76
"24796","73168","2020",3,3,0,101833.3,1067,101.3333
"24797","73170","2020",9,9,0,184584.4,2293.667,84
"24798","73171","2020",51,14,37,169925.8,2131.588,81.45098
"24799","73173","2020",3,2,1,120666.7,1501,80
"24800","73175","2020",6,6,0,104070.8,2059.167,58.16667
"24801","73176","2020",49,5,44,155462.6,3781.531,39.67347
"24802","73177","2020",2,2,0,86725,1190,71
"24803","73178","2020",12,12,0,275537.5,3087.167,95.33333
"24804","73179","2020",147,48,99,248548.5,3029.619,82.20408
"24805","73180","2020",7,7,0,212440,2322.286,95
"24806","73181","2020",32,4,28,125963.1,1703.219,73.59375
"24807","73182","2020",34,22,12,323387.1,3690.882,92.14706
"24808","73183","2020",22,17,5,348039.5,3666.136,108.5
"24809","73184","2020",11,11,0,289103.5,2532.818,122.7273
"24810","73186","2020",51,5,46,190782.1,3901.137,45.56863
"24811","73187","2020",34,21,13,130740.3,2019.118,70.02941
"24812","73188","2020",11,11,0,161798.9,2029.455,75
"24813","73190","2020",5,4,1,150630,2492.8,66.4
"24814","73191","2020",22,16,6,255799,2802,92.90909
"24815","73192","2020",4,4,0,206571.2,2028.25,114
"24816","73193","2020",1,1,0,334800,3250,103
"24817","73194","2020",11,4,7,115005.5,2166.636,55.81818
"24818","73196","2020",8,6,2,255331.2,2465.875,97.625
"24819","73197","2020",18,3,15,171216.6,3401.167,50.77778
"24820","73200","2020",5,3,2,216052,2514.4,85.4
"24821","73201","2020",11,7,4,147711.8,2192.727,69.81818
"24822","73202","2020",6,5,1,255643.3,2943.167,89.16667
"24823","73204","2020",19,11,8,149321.3,1908.211,77.36842
"24824","73205","2020",4,4,0,140362.5,1874.25,88.25
"24825","73206","2020",45,5,40,181692.2,4052.044,43.11111
"24826","73207","2020",8,8,0,166634.8,1805.875,93.5
"24827","73208","2020",14,13,1,482695.9,4486.786,117.9286
"24828","73210","2020",2,2,0,340575,2425,183
"24829","73211","2020",13,10,3,258480.2,1994.692,134.5385
"24830","73212","2020",23,16,7,152203.9,1538.826,98.52174
"24831","73213","2020",127,25,102,223728.5,2784.591,80.1811
"24832","73214","2020",2,2,0,124000,1319,87.5
"24833","73215","2020",51,23,28,162715.4,2052.588,85.7451
"24834","73216","2020",4,4,0,212979.8,2800.75,81
"24835","73217","2020",4,3,1,159260,1800.5,89
"24836","73218","2020",11,9,2,170775.6,1805.364,86.27273
"24837","73219","2020",14,12,2,263515.4,2676.143,101.0714
"24838","73220","2020",6,6,0,143851.7,1600.667,96.83333
"24839","73222","2020",69,24,45,271888.5,3312.667,82.15942
"24840","73223","2020",12,9,3,133926.5,1594.083,90.5
"24841","73224","2020",13,12,1,194910.2,1964.154,96.61538
"24842","73225","2020",28,15,13,310247.7,2831.929,105.0357
"24843","73226","2020",16,14,2,233004.4,1945.562,118.75
"24844","73227","2020",109,16,93,497529,8473.642,55.15596
"24845","73228","2020",8,6,2,335437.5,3006.375,111.875
"24846","73229","2020",7,6,1,126467.1,1547.714,84.71429
"24847","73230","2020",6,5,1,116548.7,1832.833,62.66667
"24848","73231","2020",17,15,2,102320.6,1367.471,78.11765
"24849","73232","2020",21,9,12,443083.1,5465.286,82.09524
"24850","73233","2020",1,1,0,169055,2915,58
"24851","73234","2020",7,1,6,80642.86,1378.857,58.14286
"24852","73235","2020",76,10,66,109144,2839.053,38.68421
"24853","73236","2020",49,38,11,173319.5,1846.531,96.4898
"24854","73237","2020",5,5,0,133310,1603.4,74.6
"24855","73240","2020",10,8,2,263425.3,2240.1,110.7
"24856","73241","2020",15,15,0,213491,1897.267,126.2667
"24857","73242","2020",33,2,31,93437.45,2188.576,43.27273
"24858","73243","2020",23,15,8,211665.7,2734.304,81.30435
"24859","73245","2020",7,5,2,182689.7,1868,96.57143
"24860","73246","2020",3,2,1,236650,2654.667,86.33333
"24861","73247","2020",13,13,0,201763.7,2421.231,92.61538
"24862","73248","2020",73,14,59,144910.8,1861.726,86.21918
"24863","73249","2020",26,10,16,281463.7,3384.423,83.03846
"24864","73250","2020",19,15,4,161046.8,1704.263,96.52632
"24865","73252","2020",3,3,0,155446.7,1675.667,91.66667
"24866","73253","2020",12,5,7,149447.5,1978.25,74.08333
"24867","73254","2020",2,2,0,135500,904.5,171.5
"24868","73255","2020",9,9,0,140841.1,1818.333,78.22222
"24869","73256","2020",5,3,2,94362,1350.4,67
"24870","73257","2020",290,32,258,225674.3,5696.728,39.58966
"24871","73258","2020",5,5,0,84300,1185.6,75.6
"24872","73259","2020",6,6,0,175615.8,3054.667,82.5
"24873","73261","2020",37,18,19,96188.65,1182.541,83.78378
"24874","73262","2020",9,4,5,165391.7,2570.556,72.66667
"24875","73263","2020",10,9,1,342042.5,3683.3,96.9
"24876","73265","2020",5,4,1,380235.4,2662.8,132.8
"24877","73267","2020",7,5,2,175753.6,2127.714,80.85714
"24878","73268","2020",6,6,0,106290,2017.167,50
"24879","73269","2020",9,9,0,264490,2357,115.5556
"24880","73270","2020",48,36,12,184912.6,2171.062,87.79167
"24881","73271","2020",6,6,0,241575,2364.5,105
"24882","73272","2020",3,3,0,202666.7,3510,88
"24883","73273","2020",5,5,0,228278.8,2450.8,99.2
"24884","73274","2020",15,14,1,206364.3,3221.333,68.93333
"24885","73275","2020",10,10,0,255350,2523.2,103.9
"24886","73276","2020",7,7,0,237351.9,2549.714,104.8571
"24887","73278","2020",14,13,1,166863.6,1828.071,90.42857
"24888","73280","2020",47,2,45,107240.5,2764.128,37.38298
"24889","73281","2020",8,8,0,357424.8,2469.25,149.25
"24890","73282","2020",10,7,3,242095,3016.2,84.9
"24891","73283","2020",8,6,2,168966.2,2034.375,78.5
"24892","73284","2020",15,5,10,165831.5,2072.533,87.46667
"24893","73285","2020",31,6,25,253056.6,2831.516,90.51613
"24894","73286","2020",14,10,4,194633.1,2053.786,93.28571
"24895","73288","2020",15,7,8,272156.9,2823,96.73333
"24896","73289","2020",8,8,0,138152.5,1310.875,117.75
"24897","73290","2020",72,10,62,131294.7,2945.542,47.29167
"24898","73292","2020",3,3,0,243183.3,2320.333,110
"24899","73293","2020",9,9,0,247335.7,3157.889,89.88889
"24900","73294","2020",6,6,0,176180,1801.5,102.6667
"24901","73296","2020",99,6,93,280876.6,6265.303,40.56566
"24902","73297","2020",7,7,0,238268.6,2078,122
"24903","73298","2020",5,5,0,224132.2,2293.6,106.6
"24904","73299","2020",2,2,0,163050,2337,67.5
"24905","73300","2020",53,29,24,443430.4,4088.358,109.0566
"24906","73301","2020",8,5,3,359570,3876,102.5
"24907","73302","2020",3,3,0,268663.3,1419,194
"24908","73303","2020",53,30,23,168119,1913.226,90.75472
"24909","73304","2020",62,0,62,412835,9876.565,39.12903
"24910","73306","2020",84,11,73,194187,4101.56,50.52381
"24911","73307","2020",107,8,99,104342.9,2824.187,37.07477
"24912","73308","2020",7,6,1,200315.3,2488.857,79.71429
"24913","73309","2020",4,4,0,174000,2054.25,95.5
"24914","73310","2020",9,8,1,271386.7,2856.556,106.2222
"24915","73311","2020",3,3,0,84716.67,848,101.3333
"24916","73312","2020",11,11,0,276502.9,2429.727,126.2727
"24917","73313","2020",2,2,0,227932.5,1964.5,118
"24918","73314","2020",6,4,2,208573.3,1827.833,112.6667
"24919","73315","2020",5,5,0,227900,1617.6,144
"24920","73316","2020",2,1,1,295175,1986.5,147
"24921","73317","2020",54,11,43,283034.2,4833.204,62.14815
"24922","73318","2020",119,1,118,58038.57,1895.286,29
"24923","73320","2020",7,6,1,194197.1,1929.286,110.5714
"24924","73322","2020",27,2,25,108718.8,2837.185,38.11111
"24925","73323","2020",1,1,0,183810,1718,107
"24926","73324","2020",1,1,0,341150,3412,100
"24927","73326","2020",20,14,6,310206.4,2773.65,112.8
"24928","73327","2020",4,4,0,192537.5,1566.25,120.5
"24929","73328","2020",18,11,7,377285.2,3712.389,98.11111
"24930","73329","2020",41,11,30,172951.7,2191.829,60.34146
"24931","73330","2020",59,36,23,153339.4,1929.119,85.9322
"24932","74001","2020",59,22,37,176876,2864.712,58.11864
"24933","74002","2020",44,32,12,284738.2,3172.386,91.25
"24934","74003","2020",12,11,1,641877.4,5368,125.6667
"24935","74004","2020",3,3,0,169166.7,2164.667,76
"24936","74005","2020",60,47,13,336535.6,3568.517,96.75
"24937","74006","2020",36,6,30,300111.1,4100.417,73.5
"24938","74007","2020",25,11,14,323520,3804.72,86.28
"24939","74008","2020",104,8,96,219138.8,3598.26,61.22115
"24940","74009","2020",7,6,1,460571.4,3100.286,143.7143
"24941","74010","2020",1908,191,1717,327461.2,4546.919,71.87945
"24942","74012","2020",592,21,571,199185.4,3175.318,64.48649
"24943","74013","2020",26,19,7,422959.9,4100.038,106.9231
"24944","74014","2020",203,16,187,199924,4144.596,44.63547
"24945","74015","2020",7,6,1,339006.6,3491.571,99.57143
"24946","74016","2020",44,13,31,376648.8,4617,82.31818
"24947","74018","2020",27,12,15,338161.5,3672.593,94
"24948","74019","2020",48,11,37,369840.5,4920.771,78.0625
"24949","74020","2020",16,15,1,398117.4,3483.438,114.625
"24950","74021","2020",20,15,5,373276.2,3443.2,109.05
"24951","74024","2020",27,20,7,272946.7,3002.296,92.48148
"24952","74025","2020",16,13,3,391107.8,3150.062,127.125
"24953","74026","2020",72,32,40,294733.3,3732.819,80.04167
"24954","74027","2020",2,1,1,192500,1942,97.5
"24955","74029","2020",6,5,1,173250,2675.833,82.16667
"24956","74030","2020",1,1,0,340000,2833,120
"24957","74031","2020",36,23,13,438877.4,4534.75,94.41667
"24958","74032","2020",46,14,32,124927,2222.543,56.08696
"24959","74033","2020",51,17,34,179296.1,3079.431,56.2549
"24960","74034","2020",39,14,25,171613.1,2747.462,57.64103
"24961","74035","2020",7,7,0,290060.7,2863,105.8571
"24962","74036","2020",5,3,2,571532,5573.6,117.6
"24963","74037","2020",26,15,11,278093.8,3134.385,93.84615
"24964","74038","2020",24,13,11,196985.4,2980.583,60.20833
"24965","74040","2020",43,17,26,305739.8,3967.814,78.16279
"24966","74041","2020",2,2,0,207250,2018,100.5
"24967","74042","2020",175,47,128,200242.6,2678.114,75.38286
"24968","74043","2020",56,32,24,308816.4,3729.054,85.66071
"24969","74044","2020",11,6,5,514079.5,4253.364,123.2727
"24970","74045","2020",4,4,0,148660,3975,33.75
"24971","74046","2020",6,5,1,397255,3318.167,121.6667
"24972","74048","2020",11,10,1,358536.4,3411,112.7273
"24973","74049","2020",6,5,1,179250,3467.333,57.66667
"24974","74050","2020",9,9,0,247376.7,3222.111,77.22222
"24975","74051","2020",10,10,0,328172,3504.5,96.1
"24976","74052","2020",17,10,7,329889.2,3657.471,88.29412
"24977","74053","2020",10,10,0,266890,2555.3,106.7
"24978","74054","2020",7,7,0,386100.7,3238.857,119.7143
"24979","74055","2020",5,4,1,443266,2548.4,168
"24980","74056","2020",313,50,263,442434.2,7417.942,56.92971
"24981","74057","2020",12,9,3,314899.2,2910.167,109.5
"24982","74058","2020",33,4,29,196334.7,3929.788,49.09091
"24983","74059","2020",3,3,0,332666.7,4104,102
"24984","74061","2020",17,10,7,340360.2,4011.176,86.76471
"24985","74062","2020",19,11,8,376897.4,4218,92.05263
"24986","74063","2020",145,14,131,254016.2,4795.566,49.08966
"24987","74064","2020",7,5,2,334844.3,2426.857,137.8571
"24988","74065","2020",1,1,0,3e+05,3030,99
"24989","74067","2020",18,13,5,330088.1,3235,104.6111
"24990","74068","2020",1,1,0,385000,2984,129
"24991","74069","2020",8,3,5,358056.2,4320.375,82.375
"24992","74070","2020",79,38,41,404228.1,3981.43,100.5949
"24993","74071","2020",3,3,0,335505,2032.667,154.6667
"24994","74072","2020",4,4,0,390505,3344.25,117.25
"24995","74073","2020",11,11,0,347750,3349.091,122.5455
"24996","74074","2020",14,7,7,363578.6,3758.5,106.5
"24997","74075","2020",14,10,4,355254.3,3045.357,122.1429
"24998","74076","2020",19,19,0,458234.7,3731.684,124.4737
"24999","74077","2020",8,6,2,238806.2,2762.875,87.875
"25000","74078","2020",5,5,0,252970,3319.6,80.8
"25001","74079","2020",8,6,2,369737.2,3502.125,109.25
"25002","74080","2020",84,14,70,423604.8,7151.833,56.66667
"25003","74081","2020",203,41,162,174150.1,2326.833,74.73892
"25004","74082","2020",66,28,38,448500.3,4631.121,93.59091
"25005","74083","2020",113,28,85,425366.8,4980.788,71.93805
"25006","74085","2020",72,6,66,201349.2,4306.222,46.29167
"25007","74086","2020",12,11,1,359979.2,3532.917,109.3333
"25008","74087","2020",29,17,12,296948.3,3324.31,93.55172
"25009","74088","2020",19,13,6,388828.5,3781,106.9474
"25010","74089","2020",25,11,14,276172,3600.96,72.6
"25011","74090","2020",15,7,8,349734.7,3776.667,91.4
"25012","74091","2020",6,5,1,271966.7,3722,82.5
"25013","74094","2020",95,74,21,410411.7,4131.179,102.4211
"25014","74095","2020",6,6,0,326230.2,3201.833,100.5
"25015","74096","2020",73,32,41,323189.5,3907.726,83.06849
"25016","74097","2020",14,12,2,351860.4,3084.5,119.3571
"25017","74098","2020",25,19,6,554940.1,4618.16,122.52
"25018","74099","2020",39,6,33,352468.6,5601.282,47.23077
"25019","74100","2020",10,10,0,245520.1,2700.8,89.3
"25020","74101","2020",10,3,7,303035,3545.5,84
"25021","74102","2020",18,13,5,466357.8,4352.056,116.3889
"25022","74103","2020",19,15,4,323266.8,3693.684,100.2105
"25023","74104","2020",60,26,34,310586.9,3559.533,91.01667
"25024","74105","2020",124,53,71,298209.2,3464.855,88.91129
"25025","74106","2020",9,9,0,437163.3,3995.778,102.6667
"25026","74107","2020",1,1,0,332000,1677,198
"25027","74108","2020",21,5,16,398906,6148.286,71.85714
"25028","74109","2020",8,8,0,277962.5,2738.75,105.25
"25029","74111","2020",4,2,2,209000,2804,69.75
"25030","74112","2020",128,41,87,378162.6,4542.422,82
"25031","74114","2020",7,6,1,455801.4,6028.429,87.71429
"25032","74116","2020",23,20,3,471581.7,3953.261,123.1739
"25033","74117","2020",8,8,0,395048.8,3295.625,121.875
"25034","74118","2020",43,11,32,311903,4196.326,74.65116
"25035","74119","2020",222,36,186,275354.6,3834.658,70.92342
"25036","74121","2020",30,16,14,348205.4,4107.333,86.33333
"25037","74122","2020",13,7,6,325675.8,3675.462,96.61538
"25038","74123","2020",90,45,45,221002,2803.056,81.03333
"25039","74124","2020",19,16,3,414806.3,3837.789,114
"25040","74126","2020",17,17,0,308359.7,3731.647,89.88235
"25041","74127","2020",12,12,0,297845.8,3798.417,85.25
"25042","74128","2020",45,33,12,375450.9,3774,105.1333
"25043","74129","2020",3,3,0,245780,2968.667,77.33333
"25044","74130","2020",7,7,0,254614.3,1818.571,122.2857
"25045","74131","2020",19,13,6,291496.3,2612.316,109.8947
"25046","74133","2020",216,24,192,203343.6,3289.616,59.9537
"25047","74134","2020",96,19,77,377878.4,6867.635,53.96875
"25048","74135","2020",15,4,11,148796.5,2465.533,57.66667
"25049","74136","2020",124,15,109,255538.9,5300.524,47.45968
"25050","74137","2020",40,14,26,336140.8,3908.075,88.4
"25051","74138","2020",19,7,12,316583.7,3195.895,101.8421
"25052","74139","2020",16,13,3,245404.4,3419.562,78.375
"25053","74140","2020",46,28,18,203542.1,2766.413,72.43478
"25054","74141","2020",11,10,1,266170,2703.273,96.90909
"25055","74142","2020",6,6,0,307598,2633,122
"25056","74143","2020",124,29,95,306801.3,5376.863,56.74194
"25057","74144","2020",12,8,4,329776.9,3082.25,111.0833
"25058","74145","2020",9,7,2,397122.2,4010.556,99.33333
"25059","74146","2020",23,22,1,373931.5,3633.348,105.3043
"25060","74147","2020",15,4,11,302333.3,3683.133,83.46667
"25061","74148","2020",3,1,2,155316.7,2424.333,73.66667
"25062","74150","2020",18,15,3,403336.9,4401.5,95.5
"25063","74151","2020",10,10,0,269705.5,2615.1,106.6
"25064","74152","2020",16,11,5,374460.6,4399.688,85.125
"25065","74153","2020",50,38,12,398622,3844.5,110.2
"25066","74154","2020",45,26,19,272575.8,3810.667,79.37778
"25067","74155","2020",7,7,0,170463.4,2082.571,83.71429
"25068","74156","2020",14,14,0,367677.9,3326.929,113.4286
"25069","74157","2020",20,18,2,338734.5,3923.85,94.25
"25070","74158","2020",16,12,4,441920,3948.5,112.125
"25071","74159","2020",37,15,22,173558.1,2739.405,68.83784
"25072","74160","2020",96,14,82,218792.9,4542.844,42.23958
"25073","74161","2020",14,13,1,359090.7,3743.286,106.6429
"25074","74162","2020",4,4,0,366750,3970.25,89.5
"25075","74163","2020",24,21,3,416213.8,3516.458,115.125
"25076","74164","2020",70,38,32,227397.8,2766.3,87.85714
"25077","74165","2020",8,7,1,313517.5,3684.25,92.5
"25078","74166","2020",24,17,7,310199.6,3450.75,99.41667
"25079","74167","2020",10,9,1,278807.2,2543.1,116
"25080","74168","2020",21,16,5,317031.1,3290.333,103.0476
"25081","74169","2020",64,29,35,257300.8,2794.391,87.75
"25082","74170","2020",6,6,0,262458.3,2499.667,103
"25083","74171","2020",24,20,4,400398,3750.167,115.9167
"25084","74172","2020",19,13,6,336782.4,4229.053,84.78947
"25085","74173","2020",222,27,195,544612.3,7572.45,66.80631
"25086","74174","2020",9,9,0,204325.6,2396.889,97.44444
"25087","74175","2020",10,6,4,258550,3099.4,84.7
"25088","74176","2020",35,17,18,638461,5770.743,109.2857
"25089","74177","2020",9,9,0,446150,3948,116.8889
"25090","74178","2020",12,12,0,256549.1,2779.833,105.25
"25091","74179","2020",10,9,1,286132,3093.5,88
"25092","74180","2020",37,29,8,442534.6,4258.486,112.1622
"25093","74183","2020",40,23,17,214687.5,3213.375,71.675
"25094","74184","2020",18,14,4,321261.1,3171.556,104.0556
"25095","74185","2020",38,29,9,358929.6,3874.289,96.21053
"25096","74186","2020",8,7,1,346801,2982.375,116.125
"25097","74188","2020",15,6,9,469862.7,5663.667,82.06667
"25098","74189","2020",42,18,24,194192.4,2752.024,66.69048
"25099","74190","2020",82,8,74,151779.1,3640.451,40.70732
"25100","74191","2020",246,21,225,270575,6237.439,42.76423
"25101","74192","2020",18,17,1,271778.3,2780.333,112.0556
"25102","74193","2020",9,7,2,302994.7,3876.667,92.55556
"25103","74194","2020",9,7,2,398855.3,3590.667,112.5556
"25104","74195","2020",3,3,0,372308,3413,108.6667
"25105","74196","2020",3,3,0,251378.3,1566.333,158.6667
"25106","74197","2020",48,15,33,219079.6,3331.354,66.29167
"25107","74198","2020",8,6,2,453195,4510.75,102.75
"25108","74199","2020",10,7,3,660500,5934,120.2
"25109","74200","2020",47,31,16,411584.3,4210.511,100.9574
"25110","74201","2020",36,13,23,367579.8,4897.194,76.25
"25111","74202","2020",16,5,11,330985,4068.875,86.375
"25112","74203","2020",2,2,0,198450,5381.5,40
"25113","74205","2020",24,9,15,158674.8,2700.167,55.29167
"25114","74206","2020",7,4,3,205744.7,2795.714,74.42857
"25115","74208","2020",156,64,92,251225.3,2992.833,86.19231
"25116","74209","2020",21,19,2,413134.4,3290.714,135.9524
"25117","74210","2020",15,7,8,266986.7,2784.067,94.8
"25118","74211","2020",27,18,9,336414.1,3415.815,101.5556
"25119","74212","2020",28,18,10,233771.6,2607.643,89.42857
"25120","74213","2020",90,23,67,359778,4392.889,81.23333
"25121","74215","2020",135,8,127,190967.2,4137.941,42.37778
"25122","74216","2020",13,7,6,331734.8,4424.154,82.69231
"25123","74218","2020",117,52,65,318458.1,3849.308,82.71795
"25124","74219","2020",13,7,6,395926.9,4000.077,95.84615
"25125","74220","2020",88,29,59,319791.2,3846.773,85.89773
"25126","74221","2020",4,2,2,266787.5,3553,81.5
"25127","74222","2020",9,1,8,198727.8,2926,70.77778
"25128","74223","2020",4,3,1,466250,5720.5,155.5
"25129","74224","2020",136,34,102,240749.6,3146.294,77.08824
"25130","74225","2020",202,38,164,186963.6,2652.386,71.28218
"25131","74226","2020",8,8,0,219677.5,3262.125,64.625
"25132","74228","2020",2,1,1,349627,4629.5,76.5
"25133","74229","2020",34,25,9,392995.6,3996.706,105.7941
"25134","74231","2020",7,7,0,295714.3,3685,80.28571
"25135","74232","2020",6,4,2,411769.2,3821.5,106.8333
"25136","74233","2020",29,10,19,249551.9,2820.172,90.58621
"25137","74234","2020",5,5,0,296476,2997.6,104.6
"25138","74235","2020",7,5,2,352435.7,3214.857,111.5714
"25139","74236","2020",295,61,234,266389.7,4122.075,59.03051
"25140","74237","2020",22,4,18,197864.5,3003.364,66.5
"25141","74238","2020",78,16,62,190453.9,3449.038,51.87179
"25142","74239","2020",37,16,21,337333.1,5018.486,72.62162
"25143","74240","2020",13,13,0,343033.7,3284.846,108.1538
"25144","74241","2020",66,25,41,178519.5,2602.288,66.40909
"25145","74242","2020",84,45,39,495015.6,4953.583,97.33333
"25146","74243","2020",236,34,202,342891.3,4217.373,80.83898
"25147","74244","2020",17,13,4,312426.5,3226,99.70588
"25148","74249","2020",24,13,11,267875.8,3455.208,79.125
"25149","74250","2020",98,48,50,285071.4,3349.418,86.20408
"25150","74252","2020",12,9,3,314237.5,3067.083,100.4167
"25151","74253","2020",14,14,0,304973.6,3696.143,94.92857
"25152","74254","2020",1,1,0,535000,4777,112
"25153","74255","2020",27,23,4,320912.8,3056.778,108
"25154","74256","2020",255,32,223,191838.6,2890.012,66.17255
"25155","74257","2020",2,2,0,341350,3090,111
"25156","74258","2020",150,32,118,258625.2,4212.247,59.94667
"25157","74259","2020",6,6,0,322483.3,3523.5,93
"25158","74260","2020",9,8,1,382171.1,3483.778,110.1111
"25159","74261","2020",7,6,1,283793.6,4128.714,78.28571
"25160","74262","2020",13,11,2,334284.6,3762.769,96.92308
"25161","74263","2020",106,76,30,354397.5,3837.066,93.98113
"25162","74264","2020",118,48,70,202429.8,2497.186,83.16949
"25163","74265","2020",14,10,4,263155.3,3654.786,80.07143
"25164","74266","2020",23,15,8,428913,5066.826,83.21739
"25165","74267","2020",59,28,31,545833.8,5536.492,97.50847
"25166","74269","2020",31,17,14,208531.9,2490.194,85.70968
"25167","74271","2020",6,5,1,366666.7,4030.333,89.83333
"25168","74272","2020",38,24,14,384162.6,4068.263,95.34211
"25169","74273","2020",16,13,3,206989.9,2945.812,70.6875
"25170","74275","2020",54,26,28,477339.2,4288.389,99.35185
"25171","74276","2020",94,32,62,191913,3461.351,55.75532
"25172","74278","2020",78,20,58,214262.9,2678.679,77.17949
"25173","74279","2020",101,15,86,121962.7,2916.911,43.66337
"25174","74280","2020",86,32,54,256461.2,3847.674,71.01163
"25175","74281","2020",659,82,577,211567.2,3104.66,68.72989
"25176","74282","2020",115,88,27,437140.3,3899.565,112.8435
"25177","74283","2020",16,14,2,379750,3247.75,120.875
"25178","74284","2020",11,6,5,209226.9,2598,83.54545
"25179","74285","2020",2,2,0,504650,3149,171.5
"25180","74286","2020",8,6,2,219158.6,2554.125,92.625
"25181","74287","2020",9,7,2,283595.7,2874.556,111
"25182","74288","2020",88,30,58,290935.6,3630.739,80.44318
"25183","74289","2020",40,33,7,244020.5,2785.725,92.85
"25184","74290","2020",11,6,5,312739.1,5398,57.90909
"25185","74291","2020",5,5,0,417800,4265.4,91.8
"25186","74292","2020",9,9,0,437332.7,3355.444,136.6667
"25187","74293","2020",60,34,26,417361.2,4346.5,95.28333
"25188","74294","2020",24,17,7,279952.3,4330.292,71.54167
"25189","74295","2020",4,4,0,252403,2775.25,91
"25190","74296","2020",14,8,6,402652.1,3569.786,115.1429
"25191","74297","2020",15,13,2,325614.3,3530.067,94.2
"25192","74298","2020",137,47,90,317135.2,3953.847,79.9635
"25193","74299","2020",40,22,18,849420.1,7291.975,118.875
"25194","74301","2020",10,8,2,218324,2702.7,96.6
"25195","74302","2020",16,11,5,399948.4,4462.375,89.875
"25196","74303","2020",39,21,18,402052.7,4564.564,87.61538
"25197","74304","2020",9,8,1,325170.6,2881.778,114
"25198","74305","2020",103,32,71,274700.7,3704.922,74.26214
"25199","74306","2020",5,5,0,357280,3128.4,128.6
"25200","74307","2020",13,7,6,370523.5,3732,100.2308
"25201","74308","2020",6,6,0,433890,3578.5,141.8333
"25202","74309","2020",62,35,27,378758.1,4046,96.22581
"25203","74310","2020",7,7,0,410903.6,3355.571,123.5714
"25204","74311","2020",72,39,33,274269.4,3333.333,82.875
"25205","74312","2020",13,7,6,278146.9,2899.692,96
"25206","74313","2020",14,8,6,321711.5,3594.714,98.21429
"25207","74314","2020",16,14,2,396758.8,3855.125,104.1875
"25208","74315","2020",19,17,2,503584.8,4000.105,123.2632
"25209","75056","2020",24583,91,24492,542412.4,10415.65,51.82065
"25210","76001","2020",14,14,0,193640.4,1758.429,112.7857
"25211","76002","2020",8,8,0,175062.5,1432.75,124.25
"25212","76004","2020",4,4,0,106875,1298.75,88.75
"25213","76005","2020",57,47,10,165424.8,2029.772,81.64912
"25214","76006","2020",3,3,0,190500,2055.667,96
"25215","76007","2020",5,5,0,219760,1671.6,140.2
"25216","76008","2020",8,8,0,201381.2,1662,123.875
"25217","76009","2020",5,5,0,170000,2067,97.2
"25218","76011","2020",4,4,0,211725,2004,103.5
"25219","76012","2020",7,7,0,196772.1,1760.286,112.5714
"25220","76013","2020",6,6,0,163583.3,1750.333,102.8333
"25221","76014","2020",21,20,1,170770.7,2069.048,91.47619
"25222","76015","2020",6,6,0,200091.7,1686,119.3333
"25223","76016","2020",1,1,0,168000,2585,65
"25224","76018","2020",20,20,0,154265,1677.4,94.65
"25225","76019","2020",7,7,0,208342.9,1859.429,115.7143
"25226","76020","2020",11,11,0,164478.2,1519.091,102.6364
"25227","76021","2020",5,5,0,189808,1793,110.8
"25228","76022","2020",1,1,0,259500,1663,156
"25229","76023","2020",1,1,0,175000,2215,79
"25230","76024","2020",2,2,0,205500,1110.5,193
"25231","76025","2020",7,7,0,130311.3,1557.143,77.71429
"25232","76026","2020",38,31,7,134428.2,1600.474,84.52632
"25233","76028","2020",1,1,0,68500,685,100
"25234","76029","2020",6,6,0,89333.33,1205.833,74.5
"25235","76030","2020",10,10,0,217288,1803.3,116.2
"25236","76032","2020",4,4,0,176750,1869.5,95.25
"25237","76033","2020",9,9,0,194066.7,1920,107.8889
"25238","76034","2020",39,36,3,159610.2,1685.051,99.05128
"25239","76035","2020",27,27,0,122394.4,1139.333,107.3333
"25240","76036","2020",10,10,0,148092.5,1612.9,94.1
"25241","76038","2020",8,8,0,190875,1756.125,112.75
"25242","76039","2020",8,8,0,312271.9,2012.375,139.75
"25243","76040","2020",1,1,0,155000,1845,84
"25244","76041","2020",10,10,0,199150,1979.1,106.5
"25245","76042","2020",3,3,0,56000,923,56
"25246","76043","2020",3,3,0,159966.7,1885.333,85
"25247","76045","2020",2,2,0,216075,1725.5,126
"25248","76046","2020",12,12,0,163600.2,1487.167,114.6667
"25249","76047","2020",5,5,0,116200,1180.6,98
"25250","76048","2020",2,2,0,146000,1446,92
"25251","76049","2020",6,6,0,99750,1626.167,67.66667
"25252","76050","2020",7,7,0,136200,1541,86.42857
"25253","76051","2020",26,26,0,137040.4,1514.308,89.03846
"25254","76052","2020",3,3,0,157533.3,1374,123.3333
"25255","76053","2020",3,3,0,103556.7,1123,99.33333
"25256","76054","2020",9,8,1,124611.1,1526.889,87.22222
"25257","76055","2020",5,5,0,221567.4,1595,137
"25258","76056","2020",11,11,0,180432.7,1603.545,115.8182
"25259","76057","2020",146,138,8,166577.2,1857.068,89.69178
"25260","76058","2020",1,1,0,137000,1522,90
"25261","76059","2020",4,4,0,90111,1311.25,66.25
"25262","76060","2020",4,4,0,179500,1340.25,143.25
"25263","76062","2020",1,1,0,154550,3220,48
"25264","76063","2020",7,7,0,201485.7,1979.286,104
"25265","76064","2020",4,4,0,248000,2951.75,86.5
"25266","76065","2020",4,4,0,99500,1173,92.25
"25267","76066","2020",2,2,0,239000,1893,124.5
"25268","76067","2020",12,12,0,151104.2,1591.333,106
"25269","76068","2020",8,8,0,174062.5,1936.625,94.125
"25270","76069","2020",27,27,0,256241.9,2288.259,114.1111
"25271","76070","2020",10,10,0,135920,1344.4,103.6
"25272","76071","2020",6,6,0,113250,1289.167,92.5
"25273","76072","2020",6,6,0,154175,1651.833,104.5
"25274","76075","2020",3,3,0,136833.3,1723,74.66667
"25275","76076","2020",2,2,0,223500,2064,109
"25276","76077","2020",5,5,0,110960,1138.6,99.4
"25277","76079","2020",4,4,0,158750,1801.75,88.5
"25278","76082","2020",4,4,0,214375,2027,107.25
"25279","76083","2020",4,4,0,140000,1719.25,80.75
"25280","76084","2020",1,1,0,110000,982,112
"25281","76085","2020",4,4,0,270750,1835.75,165.5
"25282","76086","2020",3,3,0,156833.3,1709,92.33333
"25283","76087","2020",8,8,0,152625,1380.5,112.5
"25284","76088","2020",4,4,0,168125,1637.5,109.75
"25285","76090","2020",10,10,0,185595,2271.8,82.1
"25286","76091","2020",2,2,0,157500,1374.5,114.5
"25287","76092","2020",8,8,0,172437.5,1770.875,102.125
"25288","76093","2020",9,9,0,162933.3,2295.222,79
"25289","76094","2020",2,2,0,219369.5,2333.5,102.5
"25290","76095","2020",126,59,67,196304.8,2017.119,90.75397
"25291","76096","2020",6,6,0,125833.3,1622.667,77
"25292","76097","2020",1,1,0,132000,2444,54
"25293","76099","2020",8,8,0,201012.5,1826.875,110.375
"25294","76100","2020",17,17,0,208649.4,1838.765,117.0588
"25295","76101","2020",19,18,1,107463.2,1410.526,75.42105
"25296","76103","2020",106,65,41,224945.7,2343.047,94.84906
"25297","76104","2020",3,3,0,153000,3175.667,60.66667
"25298","76105","2020",8,8,0,248437.5,1872.5,137.5
"25299","76106","2020",12,12,0,256445.8,1928.083,134.9167
"25300","76107","2020",2,2,0,164000,1675,100
"25301","76108","2020",261,132,129,294689.3,2931.467,100.8697
"25302","76111","2020",7,7,0,229585.7,1877.143,123.4286
"25303","76112","2020",1,1,0,380000,3089,123
"25304","76113","2020",3,3,0,146500,1772.667,83.33333
"25305","76114","2020",185,166,19,104216.6,1357.476,77.68108
"25306","76115","2020",4,4,0,166625,1544,109
"25307","76116","2020",44,44,0,233123.2,2211.591,108.2045
"25308","76117","2020",12,12,0,202829.2,1965.083,107.4167
"25309","76118","2020",2,2,0,167500,1617.5,103
"25310","76120","2020",5,5,0,133237,1222.2,111
"25311","76121","2020",5,5,0,171500,2064,100.6
"25312","76122","2020",6,6,0,140333.3,1195.333,120.5
"25313","76123","2020",14,14,0,262239.3,2449.571,107.7143
"25314","76124","2020",9,9,0,171988.9,1702.111,108.2222
"25315","76125","2020",19,19,0,137708.4,1457.895,98.10526
"25316","76126","2020",2,2,0,168500,1476,114
"25317","76128","2020",9,9,0,114570.4,1768.111,71.55556
"25318","76129","2020",5,5,0,127100,1210.8,110.6
"25319","76130","2020",6,6,0,151666.7,1604.167,97.83333
"25320","76131","2020",15,13,2,149836.7,1631.333,96.46667
"25321","76132","2020",7,7,0,188776.4,1825.286,107.7143
"25322","76133","2020",6,6,0,103458.3,1627,64.66667
"25323","76134","2020",10,10,0,148038.6,1984,74.4
"25324","76135","2020",7,7,0,213521.4,2025.571,108.2857
"25325","76136","2020",10,10,0,163535.1,1497.7,114.2
"25326","76138","2020",6,6,0,195416.7,1707,115.8333
"25327","76139","2020",1,1,0,180000,1343,134
"25328","76140","2020",3,3,0,174983.3,1643.667,125.3333
"25329","76141","2020",16,16,0,114978.1,2014.438,76.5625
"25330","76142","2020",3,3,0,192000,1481,115.3333
"25331","76143","2020",14,14,0,164878.6,1888.643,88.85714
"25332","76144","2020",1,1,0,170000,1382,123
"25333","76146","2020",32,31,1,181000,1939.5,100.4688
"25334","76147","2020",10,10,0,162590,1845.6,102.8
"25335","76148","2020",10,10,0,120873,1233.1,94.2
"25336","76149","2020",3,3,0,137500,1415.333,96.66667
"25337","76151","2020",9,9,0,173244.4,2214,82.11111
"25338","76152","2020",8,8,0,189481.2,1870.5,110
"25339","76153","2020",6,6,0,145783.3,1392.333,106
"25340","76154","2020",3,3,0,92983.33,1633,59
"25341","76155","2020",3,3,0,167966.7,1365.333,130.3333
"25342","76156","2020",5,5,0,155574,1402.2,112.2
"25343","76157","2020",106,58,48,139220.9,1711.887,81.70755
"25344","76158","2020",6,6,0,179716.7,1650.333,111.8333
"25345","76159","2020",43,41,2,138117.3,1417.395,99.16279
"25346","76160","2020",1,1,0,57000,781,73
"25347","76161","2020",2,2,0,130000,1835.5,74
"25348","76162","2020",6,6,0,134194.3,1517,87
"25349","76163","2020",6,6,0,195000,1736.5,114.6667
"25350","76164","2020",55,35,20,148681,1748.782,88
"25351","76165","2020",129,99,30,128756.6,1478.341,88.54264
"25352","76166","2020",5,5,0,137600,1257.4,115.6
"25353","76167","2020",24,24,0,275129.2,2384.125,119.9583
"25354","76169","2020",19,19,0,251803.9,2234.526,128.6316
"25355","76170","2020",1,1,0,140000,1867,75
"25356","76171","2020",1,1,0,70000,778,90
"25357","76172","2020",5,5,0,235616,2580,92
"25358","76173","2020",7,7,0,211700,1596.286,126.4286
"25359","76174","2020",9,9,0,186105.7,1895.667,99.55556
"25360","76175","2020",4,4,0,126000,1222.25,103.25
"25361","76176","2020",4,4,0,227362.5,2402.5,97
"25362","76177","2020",1,1,0,338000,1502,225
"25363","76178","2020",37,32,5,140983.5,1653.054,86.83784
"25364","76179","2020",19,18,1,194778.9,1696.211,117.5263
"25365","76180","2020",2,2,0,166000,1528,109
"25366","76182","2020",2,2,0,149000,1155.5,132.5
"25367","76183","2020",8,8,0,181050,1760.25,108.5
"25368","76184","2020",1,1,0,285000,2080,137
"25369","76185","2020",4,4,0,110625,1235,91.75
"25370","76186","2020",6,6,0,170833.3,1636.5,112.3333
"25371","76187","2020",2,2,0,190000,1713,111
"25372","76188","2020",7,7,0,183071.4,1573.286,122.8571
"25373","76189","2020",5,5,0,132080,1863,70.2
"25374","76190","2020",5,5,0,187170,1959,96.2
"25375","76192","2020",82,69,13,129365.1,1929,71
"25376","76193","2020",6,6,0,150333.3,1426.167,105.3333
"25377","76194","2020",5,5,0,224980,1575.4,158.8
"25378","76195","2020",3,3,0,156333.3,1949.333,95
"25379","76196","2020",1,1,0,104000,1051,99
"25380","76197","2020",4,4,0,121250,1497,88.5
"25381","76198","2020",14,14,0,175982.1,1829.929,100.2143
"25382","76199","2020",5,5,0,114900,1181.8,96.2
"25383","76200","2020",8,8,0,138475,1447,96.625
"25384","76201","2020",10,10,0,194300,2133.7,97.9
"25385","76202","2020",5,5,0,76200,1031.4,70
"25386","76203","2020",8,8,0,167250,1573.375,107.875
"25387","76204","2020",1,1,0,95000,1250,76
"25388","76205","2020",2,2,0,186400,1644.5,127
"25389","76206","2020",2,2,0,319500,2439.5,134.5
"25390","76207","2020",3,3,0,77000,1144.667,68.33333
"25391","76208","2020",5,5,0,210700,1769.4,116.4
"25392","76209","2020",8,8,0,180250,2183.125,94.375
"25393","76210","2020",6,5,1,115416.7,1382.667,83.16667
"25394","76211","2020",6,6,0,140501.7,1552.167,95.83333
"25395","76212","2020",100,72,28,136989,1799.32,78.98
"25396","76213","2020",8,8,0,190642,1642.5,119.375
"25397","76214","2020",2,2,0,139850,1597.5,90.5
"25398","76216","2020",170,94,76,135235.5,1899.518,71.73529
"25399","76217","2020",579,207,372,120886.4,1840.523,67.99136
"25400","76218","2020",2,2,0,223750,2426.5,107.5
"25401","76219","2020",34,31,3,152234,1709.971,99.05882
"25402","76220","2020",6,6,0,172133.3,1453,117.5
"25403","76221","2020",4,4,0,151952.5,1781.75,112.5
"25404","76222","2020",53,48,5,170195.8,1907.547,92.03774
"25405","76223","2020",9,9,0,162722.2,1399.667,120.2222
"25406","76224","2020",14,14,0,176346.4,1957.857,93.92857
"25407","76225","2020",3,3,0,214000,2028.333,109.6667
"25408","76226","2020",3,3,0,267333.3,1970.667,137.3333
"25409","76227","2020",3,3,0,226283.3,1989,113.3333
"25410","76228","2020",1,1,0,150000,1667,90
"25411","76229","2020",7,7,0,160285.7,1796.857,93
"25412","76230","2020",2,2,0,306300,2803,103.5
"25413","76231","2020",146,73,73,112393.4,1335.411,85.70548
"25414","76232","2020",6,6,0,158416.7,1776.667,91.16667
"25415","76233","2020",2,2,0,51500,723.5,72
"25416","76234","2020",12,12,0,221033.3,2219.5,104.9167
"25417","76235","2020",23,23,0,172010.4,1530.739,111.6522
"25418","76236","2020",5,5,0,141100,1424,104.8
"25419","76237","2020",4,4,0,131500,1171.5,106.75
"25420","76238","2020",33,33,0,226860.9,2114.212,109.8485
"25421","76239","2020",5,5,0,208800,2262.2,90.8
"25422","76240","2020",12,10,2,155025,2047,72.75
"25423","76241","2020",1,1,0,241500,2195,110
"25424","76242","2020",2,2,0,213000,1661.5,131.5
"25425","76243","2020",4,4,0,221700,1586.75,142.25
"25426","76244","2020",6,6,0,160416.7,1548.167,108
"25427","76245","2020",24,24,0,201435,2077.958,106.0833
"25428","76247","2020",5,5,0,96254,988,95.2
"25429","76249","2020",13,13,0,188246.2,1734.462,112.4615
"25430","76250","2020",8,8,0,203650,1948.5,111.875
"25431","76251","2020",6,6,0,150689.7,1838.667,88.5
"25432","76252","2020",13,13,0,142569.2,1531.923,94.38462
"25433","76253","2020",15,11,4,184975.2,1550.733,123.6667
"25434","76254","2020",44,31,13,193180.7,2622.909,75.13636
"25435","76255","2020",130,100,30,115742.8,1363.477,84.85385
"25436","76258","2020",51,48,3,150287.3,1572.137,96.15686
"25437","76259","2020",333,219,114,132628.8,1800.45,73.61562
"25438","76260","2020",24,23,1,137939.6,1817.458,80.95833
"25439","76261","2020",4,4,0,89050,998,90.5
"25440","76262","2020",4,4,0,207777.5,2671.5,78.75
"25441","76263","2020",17,17,0,140394.1,1605.588,94.17647
"25442","76264","2020",6,6,0,193216.7,1488.333,137.8333
"25443","76265","2020",1,1,0,97000,1128,86
"25444","76266","2020",9,9,0,152594.4,1764,88.33333
"25445","76268","2020",1,1,0,160000,2222,72
"25446","76269","2020",4,4,0,158000,1682.5,96
"25447","76270","2020",27,27,0,319407.4,2664.963,120.1111
"25448","76271","2020",18,18,0,178584.4,1632.5,111.3333
"25449","76272","2020",12,12,0,133375,1398.583,95.33333
"25450","76273","2020",6,6,0,274833.3,1938.667,143
"25451","76275","2020",17,17,0,270438.2,2533.294,106.7647
"25452","76276","2020",57,49,8,111974.2,1379.07,83.80702
"25453","76278","2020",3,3,0,82666.67,1363.667,61
"25454","76279","2020",3,3,0,139833.3,1258.333,108
"25455","76280","2020",1,1,0,105000,2188,48
"25456","76281","2020",17,16,1,214529.4,2211.235,101.5294
"25457","76282","2020",10,10,0,164866,1909.9,86.6
"25458","76284","2020",4,4,0,140000,1147,142.25
"25459","76285","2020",4,4,0,198550,1773.5,112
"25460","76286","2020",6,6,0,110916.7,1223,89.5
"25461","76287","2020",12,12,0,227950,1872.917,125.3333
"25462","76288","2020",2,2,0,182900,2641.5,68.5
"25463","76289","2020",22,21,1,199277.3,2013.273,104.8182
"25464","76290","2020",4,4,0,228975,1923,127.25
"25465","76291","2020",19,19,0,153180.3,1658.579,92.42105
"25466","76292","2020",1,1,0,80000,1600,50
"25467","76293","2020",7,7,0,150842.9,1532.714,102
"25468","76294","2020",8,8,0,153000,1532,107.75
"25469","76295","2020",17,16,1,98898.59,1166,91.41176
"25470","76296","2020",34,34,0,217189.7,2061.971,111.8235
"25471","76297","2020",10,10,0,111605,1366.3,102.2
"25472","76298","2020",3,3,0,286333.3,1937.667,148.3333
"25473","76299","2020",6,6,0,164291.7,1397.5,125.5
"25474","76300","2020",6,6,0,179833.3,1314,136.5
"25475","76302","2020",1,1,0,305000,2075,147
"25476","76303","2020",7,7,0,269628.6,2013.714,147
"25477","76304","2020",4,4,0,225775,1659.25,142.25
"25478","76305","2020",60,59,1,163983.1,2063.633,81.68333
"25479","76306","2020",5,5,0,167815,2306.4,85.2
"25480","76307","2020",19,18,1,221236.8,2215.684,104.1053
"25481","76308","2020",5,5,0,196700,1683,126.6
"25482","76309","2020",4,4,0,152000,1955.75,78.5
"25483","76311","2020",4,4,0,156750,1634.25,100.75
"25484","76312","2020",69,60,9,125329.7,1499.971,89.88406
"25485","76313","2020",12,12,0,324492.5,2410.083,139.75
"25486","76314","2020",9,9,0,184444.4,2003.778,97.22222
"25487","76315","2020",8,8,0,176421.4,1502.25,120
"25488","76316","2020",6,6,0,204433.3,1720,125.1667
"25489","76318","2020",4,4,0,214500,1707.25,125.75
"25490","76319","2020",91,89,2,171768.8,1936.769,93.96703
"25491","76320","2020",2,2,0,102500,1585,66.5
"25492","76321","2020",17,17,0,142276.5,1633.294,92.29412
"25493","76322","2020",139,97,42,176127.6,2285.986,77.67626
"25494","76323","2020",1,1,0,105000,1312,80
"25495","76324","2020",6,6,0,184711.7,1430.667,120.3333
"25496","76325","2020",10,10,0,136114.2,1300.3,103.2
"25497","76327","2020",8,8,0,143437.5,1652.75,85.25
"25498","76328","2020",2,2,0,185180,1803,102.5
"25499","76329","2020",40,35,5,136259.6,1577.725,87.05
"25500","76330","2020",11,11,0,150340.9,1698,97.45455
"25501","76331","2020",6,6,0,150033.3,1571,93.5
"25502","76332","2020",9,9,0,133422.2,1441.444,103.3333
"25503","76333","2020",6,6,0,108491.7,1166,103
"25504","76334","2020",7,7,0,140471.4,1843.714,89.57143
"25505","76335","2020",1,1,0,150000,833,180
"25506","76336","2020",12,12,0,162019.2,1806.667,95.25
"25507","76338","2020",7,7,0,176571.4,1447.286,123.4286
"25508","76339","2020",6,6,0,269083.3,2014,139.1667
"25509","76340","2020",10,10,0,177980,1649.1,110.8
"25510","76341","2020",99,64,35,141616.2,1878.263,77.17172
"25511","76342","2020",11,11,0,144820.5,1555.273,96.81818
"25512","76343","2020",3,3,0,100666.7,1305.667,74.66667
"25513","76344","2020",8,8,0,90000,1072.875,82.375
"25514","76345","2020",1,1,0,35000,1094,32
"25515","76346","2020",9,9,0,109055.6,1298.889,89
"25516","76347","2020",4,4,0,214250,1737.25,125
"25517","76348","2020",9,9,0,200355.6,1908.111,108.2222
"25518","76349","2020",25,25,0,207470.2,2135.44,95.16
"25519","76350","2020",2,2,0,156750,1864,81.5
"25520","76351","2020",2701,913,1788,148045,2134.122,69.44058
"25521","76352","2020",3,3,0,166550,1849.333,96.33333
"25522","76353","2020",1,1,0,92000,773,119
"25523","76354","2020",16,16,0,241340.6,2140.625,112.8125
"25524","76355","2020",11,11,0,128315.5,1538.909,83.36364
"25525","76356","2020",2,2,0,170000,1173.5,145
"25526","76357","2020",7,7,0,234928.6,2363,107.5714
"25527","76358","2020",4,4,0,133050,1502.75,112.5
"25528","76359","2020",2,2,0,213500,1459,146
"25529","76360","2020",2,2,0,113725,1189,88.5
"25530","76361","2020",7,7,0,303957.1,2246.857,136.5714
"25531","76362","2020",2,2,0,207500,1892,106
"25532","76363","2020",2,2,0,135500,1521,89
"25533","76364","2020",8,8,0,130908.8,1374.5,97.5
"25534","76365","2020",6,6,0,185783.3,1891.333,105.6667
"25535","76366","2020",60,57,3,153373.2,1848.367,88
"25536","76367","2020",41,41,0,283182.9,2355.585,119.6829
"25537","76368","2020",2,2,0,310000,1577.5,215.5
"25538","76369","2020",7,7,0,164914.3,1693.571,97.14286
"25539","76370","2020",4,4,0,206250,1756.5,126
"25540","76371","2020",1,1,0,123345,1370,90
"25541","76372","2020",4,4,0,141200,1629.75,100.75
"25542","76373","2020",5,5,0,148480,1911.6,80.8
"25543","76374","2020",14,14,0,117263.6,1365.286,86.21429
"25544","76375","2020",4,4,0,338750,1938.75,152.5
"25545","76377","2020",43,43,0,320656.7,2634.233,124.9302
"25546","76378","2020",25,23,2,159352,1709.16,95.64
"25547","76379","2020",3,3,0,247633.3,2014.333,118
"25548","76380","2020",5,5,0,136550,1617.8,82.6
"25549","76381","2020",1,1,0,180500,2375,76
"25550","76382","2020",15,15,0,167700,1760.067,96.93333
"25551","76383","2020",1,1,0,119000,1545,77
"25552","76384","2020",130,106,24,120763.7,1607.7,77.7
"25553","76385","2020",12,12,0,199587.5,1764.333,116
"25554","76386","2020",2,2,0,171000,1733,98
"25555","76387","2020",4,4,0,162750,1749.5,96.5
"25556","76388","2020",7,7,0,164434.3,1827.429,98.42857
"25557","76389","2020",3,3,0,153666.7,1523.667,109
"25558","76390","2020",10,9,1,154250,1791.3,91.2
"25559","76391","2020",30,30,0,206740,1811.867,118.2333
"25560","76392","2020",18,17,1,115022.2,1202.778,99.94444
"25561","76394","2020",11,11,0,115163.6,1426,78.45455
"25562","76395","2020",11,11,0,153813.6,1640.545,94.09091
"25563","76396","2020",8,8,0,193125,1880.125,109.125
"25564","76397","2020",11,11,0,139743.6,1271.909,114.8182
"25565","76398","2020",10,10,0,166430,1599.7,104.8
"25566","76399","2020",3,3,0,142100,1271.667,110
"25567","76400","2020",24,21,3,170210.8,1889.542,90.625
"25568","76401","2020",28,28,0,153115.7,1657.893,98.67857
"25569","76402","2020",80,78,2,180640.6,1937.8,97.6125
"25570","76403","2020",3,3,0,98333.33,2095,55.66667
"25571","76404","2020",12,12,0,185936.6,1681.417,128.8333
"25572","76405","2020",1,1,0,210500,1754,120
"25573","76406","2020",9,6,3,153671.9,1743.778,81.55556
"25574","76407","2020",3,3,0,187333.3,1500,122.3333
"25575","76408","2020",11,11,0,211300.9,2592.182,86.63636
"25576","76409","2020",8,8,0,192000,1968.875,99.125
"25577","76410","2020",120,50,70,105090.5,1479.95,73.9
"25578","76411","2020",3,3,0,115700,1381,75.33333
"25579","76412","2020",7,7,0,186271.4,2035.714,90.71429
"25580","76413","2020",5,5,0,252800,1832.8,130
"25581","76414","2020",16,16,0,196802.4,1727.312,113.375
"25582","76415","2020",2,2,0,161500,2150,83.5
"25583","76416","2020",6,6,0,147833.3,1485.667,100.8333
"25584","76417","2020",4,4,0,163539.5,1444.5,119.25
"25585","76418","2020",20,20,0,180132.5,1843.3,107.45
"25586","76419","2020",5,5,0,173500,1436.2,102.8
"25587","76420","2020",3,3,0,139500,1459.333,96.66667
"25588","76421","2020",12,12,0,199729.2,1930.917,107.3333
"25589","76422","2020",2,2,0,147750,1862,83
"25590","76423","2020",2,2,0,209500,1540.5,127.5
"25591","76424","2020",1,1,0,90000,720,125
"25592","76425","2020",1,1,0,145375,1615,90
"25593","76426","2020",4,4,0,116875,1466.25,77.5
"25594","76427","2020",7,7,0,147357.1,1562,97.71429
"25595","76428","2020",1,1,0,280000,1972,142
"25596","76429","2020",112,75,37,259269.6,2662.679,99.65179
"25597","76430","2020",1,1,0,190000,1027,185
"25598","76432","2020",2,2,0,78400,794.5,98
"25599","76433","2020",10,10,0,197642,1934.2,107.1
"25600","76434","2020",14,14,0,186517.9,1702.071,111.5
"25601","76435","2020",4,4,0,198700,1773.5,109.5
"25602","76436","2020",5,5,0,224600,1977.4,116
"25603","76437","2020",10,10,0,170320,1626.7,110.4
"25604","76438","2020",1,1,0,166000,2635,63
"25605","76439","2020",3,3,0,211868,1557.333,156
"25606","76440","2020",1,1,0,199500,2057,97
"25607","76441","2020",10,10,0,96500,1259.1,74.7
"25608","76442","2020",2,2,0,212500,1762.5,119
"25609","76443","2020",11,11,0,202909.1,1928.818,107.1818
"25610","76445","2020",9,9,0,145911.1,1441.333,105
"25611","76446","2020",18,18,0,285136.7,2053.167,144.9444
"25612","76447","2020",186,141,45,206990.2,2280.812,92.06452
"25613","76448","2020",18,18,0,211260.6,1936.222,110.1111
"25614","76449","2020",9,9,0,138422.8,1630.222,88.22222
"25615","76450","2020",3,3,0,196500,1937.667,101.3333
"25616","76451","2020",331,122,209,245149.5,2430.272,95.23565
"25617","76452","2020",54,54,0,166581.5,1755.963,93.48148
"25618","76453","2020",8,8,0,169125,1780.125,95.375
"25619","76454","2020",3,3,0,130333.3,1491.333,95.66667
"25620","76455","2020",8,8,0,150737.5,1344.5,117.25
"25621","76456","2020",6,6,0,152083.3,1921.167,91.33333
"25622","76457","2020",11,9,2,151918.2,1741.182,88.27273
"25623","76458","2020",6,6,0,196500,1947.167,107.8333
"25624","76459","2020",7,7,0,123992.9,1560.143,85.85714
"25625","76460","2020",2,2,0,80000,1131.5,71.5
"25626","76461","2020",11,11,0,147909.1,1560.909,103.8182
"25627","76462","2020",50,44,6,126264.4,1472.4,91.54
"25628","76463","2020",8,8,0,158225,2027.875,87.875
"25629","76464","2020",36,36,0,238690.9,1956.694,125.8611
"25630","76465","2020",5,5,0,130000,1349.2,103.6
"25631","76467","2020",22,22,0,153129.5,1623.773,93.68182
"25632","76468","2020",16,16,0,191857.5,1823.625,111.4375
"25633","76469","2020",7,7,0,132092.9,1554.714,95.57143
"25634","76470","2020",6,6,0,107066.7,1678.667,68
"25635","76471","2020",10,10,0,179700,2036.2,98.5
"25636","76472","2020",7,7,0,155857.1,1782.429,92
"25637","76473","2020",8,8,0,166381.2,1722.125,99.875
"25638","76474","2020",79,73,6,181133.6,1932.671,94.27848
"25639","76475","2020",62,50,12,247311.9,2490.419,104.6774
"25640","76476","2020",122,117,5,153898.1,1616.049,98.93443
"25641","76477","2020",7,6,1,236635.7,1480.857,157.1429
"25642","76478","2020",3,3,0,153500,1427,115
"25643","76479","2020",3,3,0,78333.33,1119.667,67.33333
"25644","76480","2020",9,9,0,227597.8,2194.111,111.4444
"25645","76481","2020",59,58,1,293172.2,2729.356,113.9661
"25646","76482","2020",38,37,1,203910.3,1951.526,104.6842
"25647","76483","2020",5,5,0,124620,1344.8,91.8
"25648","76484","2020",100,99,1,144868.1,1776.18,82.27
"25649","76485","2020",3,3,0,143000,2681,70
"25650","76486","2020",17,17,0,123302.9,1588.824,80.11765
"25651","76487","2020",5,5,0,82000,1443.2,62.2
"25652","76488","2020",5,5,0,170820,1540.8,118.2
"25653","76489","2020",6,6,0,251883.3,1818,143.6667
"25654","76490","2020",12,12,0,165386.2,1618.583,103.4167
"25655","76491","2020",11,11,0,169340.9,1680.545,104.3636
"25656","76492","2020",5,5,0,145555,1614.8,111
"25657","76493","2020",7,7,0,161214.3,1309.571,120
"25658","76494","2020",4,4,0,176500,1645.5,137
"25659","76495","2020",61,58,3,159572,1741.918,90.42623
"25660","76497","2020",76,55,21,148218,1893.263,77.96053
"25661","76498","2020",324,216,108,124655.9,1848.136,70.50926
"25662","76499","2020",17,17,0,172580.1,1642.529,112.5882
"25663","76500","2020",6,6,0,143966.7,1319,100.6667
"25664","76501","2020",3,3,0,340766.7,2032.333,167
"25665","76502","2020",7,7,0,183442.9,1743.857,107.8571
"25666","76503","2020",9,9,0,251761.1,2037.111,123.6667
"25667","76504","2020",4,4,0,154425,1471.75,117.75
"25668","76506","2020",8,8,0,180550,1917.375,100.25
"25669","76507","2020",9,9,0,171388.9,1260.222,130.3333
"25670","76508","2020",6,6,0,195675,2347,87.16667
"25671","76509","2020",3,3,0,337433.3,2432.333,144.3333
"25672","76510","2020",4,4,0,138250,1274,111.25
"25673","76511","2020",2,2,0,128500,1892.5,69.5
"25674","76513","2020",4,4,0,156442.5,1619.25,102.25
"25675","76514","2020",13,13,0,236092.2,2537.462,95.30769
"25676","76515","2020",11,9,2,181154.6,2229.091,86.72727
"25677","76516","2020",7,7,0,159314.3,1391,120.8571
"25678","76517","2020",32,32,0,308440,2515.812,131.9375
"25679","76518","2020",4,4,0,127445,1503,81
"25680","76519","2020",4,4,0,192100,1712.25,119.5
"25681","76520","2020",7,7,0,99071.43,1231,82.57143
"25682","76521","2020",2,2,0,242500,1547.5,154.5
"25683","76522","2020",17,17,0,227664.7,2247.294,101.2941
"25684","76523","2020",2,2,0,111500,1148.5,97
"25685","76524","2020",3,3,0,86000,1310,84.33333
"25686","76527","2020",6,6,0,97000,1155.667,86.16667
"25687","76528","2020",6,6,0,150333.3,1483.167,101.6667
"25688","76529","2020",7,7,0,200992.9,2083.714,104.4286
"25689","76530","2020",4,4,0,150250,1795.25,90.75
"25690","76531","2020",6,6,0,198166.7,1748.5,122.1667
"25691","76532","2020",8,8,0,200925,1918.375,105.625
"25692","76533","2020",12,12,0,246275,2279.75,111
"25693","76534","2020",29,24,5,200375.1,2064.414,98.55172
"25694","76535","2020",8,8,0,108181.2,1206.5,91.5
"25695","76536","2020",14,14,0,175267.1,1700.143,106.2857
"25696","76537","2020",3,3,0,123000,573.3333,205
"25697","76538","2020",6,6,0,151241.7,1465.167,111.5
"25698","76540","2020",2312,400,1912,155826,2591.099,62.44334
"25699","76541","2020",8,8,0,251554.9,2116.25,119.125
"25700","76542","2020",4,4,0,159750,1164.75,128
"25701","76543","2020",4,4,0,163225,1871,89.25
"25702","76544","2020",1,1,0,175000,1458,120
"25703","76545","2020",28,22,6,127343.2,1596.357,79.71429
"25704","76546","2020",6,6,0,167566.7,1541.333,113.6667
"25705","76547","2020",8,8,0,200523.8,1924,105.125
"25706","76548","2020",8,8,0,236818.8,1752.125,129.75
"25707","76549","2020",1,1,0,70000,1628,43
"25708","76550","2020",19,19,0,173839.5,2005.789,89.36842
"25709","76551","2020",7,6,1,196771.4,1819.571,111.1429
"25710","76552","2020",153,88,65,360608.3,3347.373,105.915
"25711","76553","2020",2,2,0,140000,1732,82.5
"25712","76554","2020",7,7,0,191071.4,1982.429,100.1429
"25713","76555","2020",8,8,0,324206.2,2139.25,160.75
"25714","76556","2020",16,16,0,175200,1662.125,102.875
"25715","76557","2020",21,21,0,148639.4,1717.571,92.80952
"25716","76558","2020",8,8,0,231612.5,2258.875,106.375
"25717","76559","2020",2,2,0,118250,1201,103.5
"25718","76560","2020",15,15,0,284362,2352.4,122.2667
"25719","76561","2020",91,66,25,129550.6,1543.231,85.91209
"25720","76562","2020",13,12,1,136936.9,1537.308,94.30769
"25721","76563","2020",19,19,0,195980.3,2055.579,96.47368
"25722","76564","2020",6,6,0,196448.3,2774.667,66.66667
"25723","76565","2020",11,10,1,137090.9,1484.455,101.1818
"25724","76566","2020",8,8,0,157812.5,1569.75,105.125
"25725","76567","2020",3,3,0,148926.7,1222.667,126.6667
"25726","76568","2020",5,5,0,287920,2536,117
"25727","76569","2020",5,5,0,189800,1391.4,149
"25728","76570","2020",3,3,0,133666.7,1245.667,109.3333
"25729","76571","2020",9,9,0,133077.8,1407.889,91.77778
"25730","76573","2020",4,4,0,165000,1589.75,104.75
"25731","76574","2020",4,4,0,184000,1582.75,119
"25732","76575","2020",262,206,56,142471,1804.847,81.0229
"25733","76576","2020",11,11,0,166958.2,1674.182,101.8182
"25734","76577","2020",6,6,0,161666.7,1641,105.1667
"25735","76578","2020",2,2,0,94750,1251.5,83
"25736","76580","2020",14,14,0,303031.1,2154.786,140.8571
"25737","76581","2020",5,5,0,172100,1834.4,97.4
"25738","76582","2020",3,3,0,146500,1507.667,97
"25739","76583","2020",4,4,0,183955,1969.5,95.5
"25740","76584","2020",1,1,0,168000,1647,102
"25741","76585","2020",6,6,0,192662.5,1742.5,118.6667
"25742","76586","2020",11,11,0,198670,1814.909,113.8182
"25743","76587","2020",6,6,0,171600,1498.333,121.6667
"25744","76588","2020",9,9,0,153696.7,1494.444,101.7778
"25745","76589","2020",3,3,0,155666.7,1795,86.66667
"25746","76590","2020",8,8,0,158387.5,1427.875,128.5
"25747","76591","2020",13,13,0,216626.9,2012.077,113.7692
"25748","76592","2020",6,6,0,176916.7,2140.5,98.5
"25749","76593","2020",5,5,0,201200,2042.2,97.6
"25750","76594","2020",14,14,0,191378.6,1875,106
"25751","76595","2020",28,28,0,234940.7,2276.571,110.1786
"25752","76596","2020",15,15,0,228182,2150.533,113.0667
"25753","76597","2020",8,8,0,123050,1153,96.375
"25754","76598","2020",5,5,0,89800,1210,73.6
"25755","76599","2020",67,46,21,199306,2482.731,85.35821
"25756","76600","2020",27,25,2,173270.4,1934.741,89.55556
"25757","76601","2020",1,1,0,350000,3182,110
"25758","76602","2020",13,13,0,165373.8,1641,105.1538
"25759","76603","2020",8,8,0,144768.8,1326.25,115.25
"25760","76604","2020",1,1,0,295000,2323,127
"25761","76605","2020",8,8,0,266125,2367.875,116.75
"25762","76608","2020",16,16,0,213575,1983.125,109.75
"25763","76609","2020",9,9,0,222327.8,1798.222,130.2222
"25764","76610","2020",19,19,0,181471.6,1722.368,110.8947
"25765","76611","2020",1,1,0,160000,1860,86
"25766","76612","2020",2,2,0,61500,1228.5,53
"25767","76613","2020",22,22,0,163522.7,1947.955,86.86364
"25768","76614","2020",16,16,0,254425,1973.312,130.875
"25769","76615","2020",12,12,0,281062.5,1974,153.3333
"25770","76616","2020",21,20,1,265967,2675.333,100.5714
"25771","76617","2020",22,22,0,366134.1,2458.182,154.6818
"25772","76618","2020",121,121,0,174789.8,1887.669,98.04132
"25773","76619","2020",4,4,0,159167.5,1642.75,104.75
"25774","76620","2020",3,3,0,141833.3,1611.667,86
"25775","76621","2020",19,19,0,154097.4,1596.842,107.1579
"25776","76622","2020",3,3,0,231333.3,1768.333,136.6667
"25777","76624","2020",49,49,0,147251,1763.388,86.65306
"25778","76626","2020",8,8,0,141100,1372.25,99.875
"25779","76627","2020",25,25,0,188706.4,2072.72,97.28
"25780","76628","2020",12,12,0,157423.8,1902.25,87
"25781","76629","2020",2,2,0,132500,1614.5,79
"25782","76630","2020",2,2,0,171482,2238,79
"25783","76631","2020",20,20,0,189562.9,1747.7,113.7
"25784","76632","2020",9,9,0,154444.4,1659.556,91
"25785","76634","2020",7,7,0,238584.3,1748.571,141.4286
"25786","76635","2020",3,3,0,67000,782.6667,86
"25787","76636","2020",29,29,0,203012.1,1895.483,105.8276
"25788","76637","2020",20,19,1,165722.5,1928.2,91.25
"25789","76638","2020",17,17,0,133388.2,1460.882,93.82353
"25790","76640","2020",92,72,20,145290.3,1703,90.48913
"25791","76641","2020",7,7,0,199767.1,1761.571,116.1429
"25792","76642","2020",4,4,0,151500,2254.75,79
"25793","76644","2020",12,12,0,151507.3,1546.833,94.16667
"25794","76645","2020",2,2,0,65000,1382,65
"25795","76646","2020",12,12,0,182694.2,1688.667,110
"25796","76647","2020",62,39,23,197198.9,2021.065,97.90323
"25797","76648","2020",30,30,0,152616.7,1535.667,104.7
"25798","76649","2020",17,17,0,156185.9,1440,114.5294
"25799","76650","2020",12,12,0,218238.3,2264,100.25
"25800","76651","2020",11,11,0,138454.5,1359,99.63636
"25801","76652","2020",7,7,0,85040.86,1379.714,64.85714
"25802","76653","2020",3,3,0,173333.3,1286.667,140
"25803","76654","2020",6,6,0,160025,1786.833,91.66667
"25804","76655","2020",95,60,35,134686.5,1834.821,78.76842
"25805","76656","2020",10,10,0,212423.5,1639,134.8
"25806","76657","2020",16,16,0,214006.2,2068.125,109.25
"25807","76658","2020",5,5,0,237840,2283.4,110.8
"25808","76660","2020",7,7,0,160785.7,1818.143,88.85714
"25809","76662","2020",1,1,0,130000,1383,94
"25810","76663","2020",22,22,0,173418.2,1805.227,100.7727
"25811","76664","2020",2,2,0,149500,1636,95.5
"25812","76665","2020",7,7,0,145328.6,1738.286,88.71429
"25813","76666","2020",8,8,0,183800,1177.5,152.75
"25814","76667","2020",3,3,0,191444,1615.333,121.3333
"25815","76668","2020",5,5,0,191900,1858.2,104.2
"25816","76669","2020",5,5,0,157700,1858.6,85.4
"25817","76670","2020",7,7,0,210371.4,2818,90.71429
"25818","76671","2020",2,2,0,118750,1398,87.5
"25819","76672","2020",13,13,0,108726.9,1281.231,79.92308
"25820","76673","2020",11,11,0,227445.5,2087.091,118.6364
"25821","76675","2020",11,11,0,191754.5,1575.182,123.5455
"25822","76676","2020",6,6,0,127666.7,1417.333,104.3333
"25823","76677","2020",5,5,0,119800,1038.8,115.4
"25824","76678","2020",17,17,0,175029.4,1534.176,100.5294
"25825","76679","2020",2,2,0,115000,1189,97
"25826","76680","2020",2,2,0,164500,1599,100
"25827","76681","2020",476,325,151,150182.1,2052.96,74.40546
"25828","76682","2020",10,10,0,215625,1881.3,114.4
"25829","76683","2020",10,10,0,232170,2115.5,113.7
"25830","76684","2020",17,16,1,185288.2,2079.176,99.23529
"25831","76685","2020",7,7,0,140616.9,1530.429,95.71429
"25832","76686","2020",7,7,0,154784.3,1854.143,94.28571
"25833","76688","2020",7,7,0,207828.6,1585.714,131.5714
"25834","76689","2020",3,3,0,174533.3,1647,106
"25835","76690","2020",8,8,0,151921,1576.5,98.125
"25836","76691","2020",1,1,0,215000,1344,160
"25837","76692","2020",3,3,0,222333.3,1990,114
"25838","76693","2020",8,8,0,207500,2542.25,87.75
"25839","76694","2020",1,1,0,60000,1154,52
"25840","76695","2020",2,2,0,127000,838,151.5
"25841","76697","2020",8,8,0,173375,1388.5,123.5
"25842","76698","2020",7,7,0,183760,2313,81.71429
"25843","76699","2020",7,7,0,153857.1,1600.286,100.2857
"25844","76700","2020",20,18,2,136173.5,1444.65,95.15
"25845","76702","2020",8,8,0,218150,1818.125,125
"25846","76703","2020",1,1,0,286500,1637,175
"25847","76705","2020",19,19,0,184894.7,1911.842,97
"25848","76706","2020",9,9,0,182694.4,1680.667,116.3333
"25849","76707","2020",15,15,0,181516.7,1713.533,107.8667
"25850","76708","2020",4,4,0,173200,2201.5,79.25
"25851","76709","2020",39,33,6,114082.3,1501.051,78.15385
"25852","76710","2020",1,1,0,225000,1875,120
"25853","76711","2020",133,71,62,92136.1,1800.662,54.27068
"25854","76712","2020",11,11,0,196840.9,1835.818,108.6364
"25855","76714","2020",13,13,0,220076.9,2160.615,109.1538
"25856","76715","2020",9,9,0,173000,1938.556,91.44444
"25857","76716","2020",15,15,0,191702,2123.667,90.13333
"25858","76717","2020",5,5,0,187036,1602.6,119.6
"25859","76718","2020",17,17,0,229130.6,2037.647,117.0588
"25860","76719","2020",8,8,0,203176.2,1572.375,124.25
"25861","76720","2020",13,11,2,355176.2,2702.077,129.8462
"25862","76721","2020",7,7,0,149142.9,1598.429,98.85714
"25863","76723","2020",4,4,0,155750,1244.75,131.25
"25864","76724","2020",1,1,0,145000,1208,120
"25865","76725","2020",6,6,0,181600,1771.333,102.3333
"25866","76726","2020",10,10,0,225550,2063.2,117.6
"25867","76727","2020",12,12,0,149895.8,1393.417,107.8333
"25868","76728","2020",8,8,0,249192.5,2160.875,117.125
"25869","76731","2020",3,3,0,157800,2032.667,77.33333
"25870","76732","2020",4,4,0,277095,1444,166
"25871","76733","2020",1,1,0,167000,1336,125
"25872","76734","2020",7,7,0,227842.9,2069,110.2857
"25873","76735","2020",24,17,7,223637.5,2649.292,95.45833
"25874","76736","2020",15,15,0,169633.3,1865.2,96.46667
"25875","76737","2020",5,5,0,211130,1819.2,116
"25876","76738","2020",14,14,0,218329.3,1868.357,119.1429
"25877","76739","2020",6,6,0,106446.7,1081,98.66667
"25878","76740","2020",5,5,0,288700,2092.4,138.6
"25879","76741","2020",4,4,0,278250,1813,156.75
"25880","76743","2020",28,28,0,167257.1,1789.321,95.39286
"25881","76744","2020",5,5,0,128000,1477,87.6
"25882","76745","2020",5,5,0,151566,1622.4,98.8
"25883","76746","2020",4,4,0,151050,1601,93.75
"25884","76747","2020",1,1,0,232000,2829,82
"25885","76748","2020",11,11,0,192381.8,1541.455,122.1818
"25886","76749","2020",5,5,0,146040,1634.8,95.4
"25887","76750","2020",18,18,0,125627.8,1484.833,84.27778
"25888","76751","2020",18,18,0,169327.8,1746.444,102.1667
"25889","76752","2020",23,20,3,160487,1742.043,94.6087
"25890","76753","2020",15,15,0,244217.3,2037.467,122.1333
"25891","76754","2020",27,24,3,164012.2,2328.259,75.03704
"25892","76755","2020",10,10,0,145810,1638.9,88.1
"25893","76756","2020",2,2,0,330150,1479.5,244
"25894","76757","2020",8,8,0,163381.2,1638.25,102.75
"25895","76758","2020",171,99,72,154910.8,1919.263,81.21637
"25896","76759","2020",7,7,0,145092.1,1783.714,81.85714
"25897","77001","2020",23,21,2,328775.2,2881.174,114.7391
"25898","77002","2020",12,12,0,227620.8,2402.167,99.25
"25899","77003","2020",4,4,0,198500,1573.25,154
"25900","77004","2020",8,7,1,223800,2703.75,88.625
"25901","77005","2020",46,33,13,329971.8,3319.261,101.5652
"25902","77006","2020",17,16,1,393640.7,3465.471,132.5882
"25903","77007","2020",4,4,0,216000,2673.5,79
"25904","77008","2020",17,17,0,261767.6,2888.824,98.58824
"25905","77009","2020",4,4,0,147750,1303.25,119.5
"25906","77010","2020",10,10,0,213615,2099.9,101.7
"25907","77011","2020",8,6,2,179388.8,1506.875,134.75
"25908","77012","2020",3,3,0,198133.3,1293.667,149
"25909","77013","2020",7,6,1,289835.1,2294,129.8571
"25910","77014","2020",218,58,160,217133.6,2883.165,75.75229
"25911","77015","2020",1,1,0,45000,692,65
"25912","77016","2020",18,18,0,152683.3,2022.667,80.77778
"25913","77018","2020",90,57,33,341931.6,3836.1,89.88889
"25914","77019","2020",9,9,0,177022.2,1675.667,116
"25915","77020","2020",18,17,1,229294.4,2043.833,122
"25916","77021","2020",4,4,0,100125,1279,71.25
"25917","77022","2020",25,23,2,758898.1,3942.68,186.32
"25918","77023","2020",8,8,0,230751.9,1899,122.375
"25919","77024","2020",9,8,1,218522.2,1751,133
"25920","77025","2020",15,15,0,140603,1491.6,102.8
"25921","77026","2020",5,5,0,147952,2026,78.6
"25922","77027","2020",17,16,1,96155.29,1078.118,92
"25923","77029","2020",6,6,0,271333.3,2277.333,123
"25924","77030","2020",4,4,0,201998.5,1396,155.25
"25925","77031","2020",10,9,1,292880,2432.6,126.5
"25926","77032","2020",17,17,0,165024.1,1731.647,103.6471
"25927","77033","2020",1,1,0,211000,2029,104
"25928","77034","2020",10,9,1,266876.5,2851.3,104.1
"25929","77035","2020",10,10,0,252761,1696,137.1
"25930","77036","2020",5,5,0,203700,1875.4,109.6
"25931","77037","2020",90,81,9,394874.7,3948.989,106.6778
"25932","77038","2020",4,4,0,439750,3142.25,171.5
"25933","77039","2020",13,12,1,333780.8,3116.692,111.0769
"25934","77040","2020",41,38,3,349026.7,2803.659,131.5366
"25935","77041","2020",5,5,0,228500,1783.6,133
"25936","77042","2020",63,62,1,212710.9,2242.968,99.65079
"25937","77043","2020",6,6,0,189416.7,1858,105
"25938","77044","2020",22,20,2,212972.7,2316.273,92.81818
"25939","77045","2020",7,7,0,194716.4,1905.429,117.7143
"25940","77046","2020",12,12,0,198315,1852.25,99.66667
"25941","77047","2020",13,13,0,314616.9,2848.154,114.4615
"25942","77048","2020",45,41,4,350170.9,3376.733,107.8222
"25943","77049","2020",11,11,0,280118.2,2156.909,142.4545
"25944","77050","2020",13,13,0,147569.2,1583.769,99.07692
"25945","77051","2020",23,23,0,149323,1491.957,103.9565
"25946","77052","2020",3,3,0,270333.3,2815,98.33333
"25947","77053","2020",291,121,170,228882.1,3436.546,70.36082
"25948","77054","2020",11,11,0,172181.8,2047.545,84.09091
"25949","77055","2020",77,15,62,207158.8,3086.169,67.45455
"25950","77056","2020",2,2,0,207650,1511,135
"25951","77057","2020",9,9,0,195111.1,1674.889,113.4444
"25952","77058","2020",425,105,320,284119.7,3960.842,74.37412
"25953","77059","2020",9,9,0,455222.2,4649.556,103
"25954","77060","2020",10,9,1,214180,1903.4,118.5
"25955","77061","2020",26,23,3,161526.2,1867.577,89.88462
"25956","77062","2020",7,6,1,314000,3509.143,94.28571
"25957","77063","2020",24,23,1,227675,2477.917,97.41667
"25958","77065","2020",14,14,0,341700,3554.071,101.7857
"25959","77066","2020",2,2,0,170000,1163,146.5
"25960","77067","2020",142,112,30,262432,2934.486,93.25352
"25961","77068","2020",3,3,0,177000,1680.667,113.3333
"25962","77069","2020",36,24,12,251851.6,2430.944,109.4167
"25963","77070","2020",14,14,0,257758.8,2264.143,121.7143
"25964","77071","2020",15,15,0,181086.7,1518.067,154.4667
"25965","77072","2020",5,5,0,114336,1616.4,85.4
"25966","77073","2020",4,4,0,198687.5,1692,123.75
"25967","77075","2020",23,21,2,369140.2,3558.913,104.8261
"25968","77076","2020",9,9,0,197333.2,2236.889,98.88889
"25969","77077","2020",17,17,0,251829.4,2490.294,109.9412
"25970","77078","2020",17,17,0,213882.4,2461,91.76471
"25971","77079","2020",79,63,16,176751.7,2363.772,79.22785
"25972","77080","2020",2,2,0,144000,1465,105
"25973","77081","2020",8,7,1,278980,3254.625,88.5
"25974","77082","2020",11,7,4,216163.6,2619.636,90.81818
"25975","77083","2020",231,82,149,265506.1,3521.675,78.31602
"25976","77084","2020",16,14,2,233843.8,2473.062,98.8125
"25977","77085","2020",53,30,23,314223,4036.491,79
"25978","77086","2020",26,25,1,231251.3,2524.615,95.03846
"25979","77087","2020",2,2,0,3e+05,3581,95.5
"25980","77088","2020",21,17,4,204863.8,2313.905,95.09524
"25981","77089","2020",11,11,0,202794.8,1992.727,104.9091
"25982","77090","2020",4,4,0,187500,1731.5,110
"25983","77091","2020",3,3,0,326473.3,3432,96.66667
"25984","77093","2020",3,3,0,260000,2119.333,156
"25985","77094","2020",5,3,2,207599,2897.6,76.2
"25986","77095","2020",15,13,2,300094.8,3538.333,86.73333
"25987","77096","2020",42,37,5,324437.8,3551.595,97.07143
"25988","77097","2020",2,2,0,176500,1937,90
"25989","77098","2020",5,5,0,182100,1938.2,94.8
"25990","77099","2020",49,48,1,149411.1,1707.551,92.26531
"25991","77100","2020",70,63,7,248231.8,2542.329,103.0857
"25992","77101","2020",17,17,0,179180.6,1608.059,113.1765
"25993","77102","2020",1,1,0,354500,3223,110
"25994","77103","2020",2,1,1,122500,2302.5,71
"25995","77104","2020",17,16,1,295105.9,3094.235,104.5294
"25996","77106","2020",17,17,0,204882.4,1938.941,117.7647
"25997","77107","2020",80,61,19,243713,2801.537,93.2375
"25998","77108","2020",675,288,387,245856.2,3446.31,73.77481
"25999","77109","2020",17,17,0,184529.4,1833.824,103.8235
"26000","77110","2020",2,2,0,246600,2242.5,121.5
"26001","77111","2020",91,34,57,356471.9,4513.857,82.92308
"26002","77112","2020",12,12,0,200443.3,2166.583,99.08333
"26003","77113","2020",20,20,0,205342.5,1940.4,108.95
"26004","77114","2020",44,33,11,290197.4,3315.977,88.68182
"26005","77115","2020",7,7,0,163857.1,1671.714,104.8571
"26006","77116","2020",20,20,0,211369.3,1855.85,117.95
"26007","77117","2020",20,15,5,159702.6,1505.55,111.3
"26008","77118","2020",179,98,81,271490.9,3637.894,79.96089
"26009","77119","2020",5,5,0,237370,2377.8,104.6
"26010","77120","2020",9,9,0,217666.7,2092.667,104.3333
"26011","77121","2020",33,20,13,304957.4,3832.182,81.60606
"26012","77122","2020",317,174,143,221099.9,2951.435,77.64038
"26013","77123","2020",7,7,0,238949.9,2586.571,105.7143
"26014","77124","2020",21,21,0,356578.2,3467.952,108.2857
"26015","77125","2020",23,21,2,280227.5,3057.391,105.3478
"26016","77126","2020",23,21,2,242217,2358.348,112.5217
"26017","77127","2020",31,14,17,222585.4,3072.194,75.96774
"26018","77128","2020",28,16,12,223808.4,2545.357,89.57143
"26019","77129","2020",15,15,0,184960,2126.133,91.8
"26020","77130","2020",14,13,1,256676.6,2729.857,99.78571
"26021","77131","2020",235,114,121,182364.9,2517.987,76.30638
"26022","77132","2020",40,33,7,309437.7,3368.875,97.1
"26023","77133","2020",3,3,0,256000,2017.333,126.3333
"26024","77134","2020",2,2,0,207500,1647.5,126
"26025","77135","2020",40,39,1,238215.5,2366.425,106.7
"26026","77136","2020",2,2,0,333000,2540,137.5
"26027","77137","2020",6,6,0,141850,1510.333,101.3333
"26028","77138","2020",11,10,1,257081.8,2861,113.2727
"26029","77139","2020",92,77,15,285562.3,3344.609,91.21739
"26030","77140","2020",4,4,0,180137.5,1891.75,96.5
"26031","77141","2020",8,6,2,247500,3666.75,72.375
"26032","77142","2020",65,46,19,268708.8,3178.062,92.33846
"26033","77143","2020",53,40,13,226570.3,3042.094,80.86792
"26034","77144","2020",5,5,0,323358,3089,106
"26035","77145","2020",10,10,0,273205,3018.3,98.3
"26036","77146","2020",18,15,3,330836.1,3680.611,94.44444
"26037","77147","2020",7,7,0,159400,1670.571,106.2857
"26038","77148","2020",34,31,3,186429.4,1956.382,96.05882
"26039","77150","2020",8,7,1,264656.2,2780.375,96.125
"26040","77151","2020",4,4,0,199500,1676,114.75
"26041","77152","2020",228,120,108,205410.8,2704.855,77.82895
"26042","77153","2020",165,102,63,242300,3216.382,78.59394
"26043","77154","2020",20,20,0,307367.2,2996.95,106.4
"26044","77155","2020",45,33,12,270259.2,3190.2,85.11111
"26045","77156","2020",8,8,0,185375,1919.25,97.5
"26046","77157","2020",12,12,0,178529.2,1723.5,107.3333
"26047","77158","2020",3,3,0,157000,1282.333,122
"26048","77159","2020",45,42,3,164038.2,1911.067,90.26667
"26049","77161","2020",13,13,0,241242.2,2475.462,100.1538
"26050","77162","2020",22,21,1,169255.8,1927.091,90.95455
"26051","77163","2020",6,5,1,240166.7,2614,92.16667
"26052","77164","2020",4,4,0,164060,1938.5,88.25
"26053","77165","2020",8,8,0,236559.6,2532.5,100.875
"26054","77167","2020",5,5,0,174880.4,1777.6,96.2
"26055","77168","2020",41,38,3,134223.7,1423.439,99.58537
"26056","77169","2020",87,34,53,281028,3443.172,84.18391
"26057","77171","2020",103,70,33,239047.2,3400.544,73.49515
"26058","77172","2020",18,18,0,195450.2,1748.111,126.0556
"26059","77173","2020",15,15,0,227646.7,2408.133,94.66667
"26060","77174","2020",9,9,0,159888.9,1469.222,112.6667
"26061","77175","2020",46,44,2,324621.5,2887.457,117.8043
"26062","77176","2020",55,44,11,220808.7,2602.891,87.07273
"26063","77177","2020",17,13,4,336882.4,3502.059,110.1176
"26064","77178","2020",12,10,2,166683.3,1618,104.75
"26065","77179","2020",16,16,0,278240.1,2738.25,104.25
"26066","77180","2020",12,12,0,497887.5,4371.417,134
"26067","77181","2020",48,22,26,335957.5,4497.417,75.95833
"26068","77182","2020",56,36,20,146201.4,1711.946,92.80357
"26069","77183","2020",140,77,63,166819.4,2253.693,77.42857
"26070","77184","2020",16,16,0,216456.2,1968.812,108.6875
"26071","77185","2020",7,7,0,510857.1,2792,170.1429
"26072","77186","2020",282,60,222,307251.1,4297.922,72.86879
"26073","77187","2020",10,10,0,114600,1274.4,94.9
"26074","77188","2020",18,16,2,314776.4,3336.444,109.3889
"26075","77190","2020",6,6,0,184500,1811,113.3333
"26076","77191","2020",17,16,1,237264.7,2502.588,96.58824
"26077","77192","2020",95,55,40,240599.4,2983.158,83.95789
"26078","77193","2020",3,3,0,297066.7,2795,107.3333
"26079","77194","2020",3,3,0,189000,2284.667,86
"26080","77195","2020",10,10,0,242949,2647.4,94.1
"26081","77196","2020",20,16,4,335467.5,3339.4,103.4
"26082","77197","2020",2,2,0,211000,2219.5,108
"26083","77198","2020",3,3,0,227178.3,1865,135.6667
"26084","77199","2020",23,23,0,250802,2610.826,98.26087
"26085","77200","2020",1,1,0,169000,1056,160
"26086","77201","2020",10,8,2,209475,2116.1,105.5
"26087","77202","2020",16,16,0,236106.2,2608.312,96.1875
"26088","77203","2020",18,18,0,360338.9,3286.889,129.0556
"26089","77204","2020",3,3,0,178666.7,2175.333,119
"26090","77205","2020",4,4,0,264250,2568.75,119.25
"26091","77206","2020",3,3,0,223000,2506.667,90
"26092","77207","2020",4,4,0,217500,1489.5,160.25
"26093","77208","2020",21,18,3,147635.7,1644.381,90.52381
"26094","77209","2020",13,9,4,317130.8,3500.462,90
"26095","77210","2020",42,40,2,178554.8,2126.881,88.92857
"26096","77211","2020",17,17,0,214843.5,2183.824,100.7647
"26097","77212","2020",1,1,0,80000,879,91
"26098","77214","2020",3,3,0,429992.7,3346,134
"26099","77215","2020",94,63,31,262965.8,3285.351,84.98936
"26100","77216","2020",23,23,0,255580.3,2476.826,104.913
"26101","77217","2020",49,40,9,317484.6,3269,106.3469
"26102","77218","2020",3,3,0,135666.7,1292.333,103.6667
"26103","77219","2020",46,46,0,256269.7,2714.304,99.93478
"26104","77220","2020",2,2,0,149500,1758,84.5
"26105","77221","2020",23,17,6,413494.5,3670.522,118.4783
"26106","77222","2020",73,43,30,216581.1,2793.849,79.9726
"26107","77223","2020",6,6,0,159283.3,1894.5,96.5
"26108","77224","2020",4,4,0,323625,2219.25,146.5
"26109","77225","2020",5,5,0,323930,2574.8,119.6
"26110","77226","2020",41,36,5,296602.8,3068.829,99.97561
"26111","77227","2020",9,9,0,113211.1,1225.778,99.77778
"26112","77228","2020",4,4,0,180000,2114.25,85.5
"26113","77229","2020",37,36,1,313495.6,3034.405,106.7027
"26114","77230","2020",4,4,0,137250,1334.25,105.25
"26115","77231","2020",11,10,1,215636.4,2311.182,98.54545
"26116","77232","2020",18,15,3,300601.9,3126.667,103.2222
"26117","77233","2020",4,2,2,174000,2597.25,69.75
"26118","77234","2020",7,6,1,310785.7,2724.429,119.7143
"26119","77235","2020",4,4,0,134050,1848.75,67.75
"26120","77236","2020",2,2,0,223000,2841,79
"26121","77237","2020",11,10,1,334434,3232.636,110.3636
"26122","77238","2020",53,46,7,192153.8,1965,102.6981
"26123","77239","2020",17,16,1,218532.4,2396.765,123.5294
"26124","77240","2020",29,27,2,173396.9,1767.345,101.6552
"26125","77241","2020",29,27,2,265375.4,2919.655,94.37931
"26126","77242","2020",4,4,0,133850,1829.75,73.5
"26127","77243","2020",319,131,188,262676.4,3963.84,70.1442
"26128","77244","2020",15,14,1,269257.7,2392,127.1333
"26129","77245","2020",5,5,0,248400,2381.2,106.4
"26130","77246","2020",10,10,0,169650,1822.8,96
"26131","77247","2020",8,8,0,181937.5,1525.25,125.75
"26132","77248","2020",7,7,0,303771.4,3474,97.85714
"26133","77249","2020",101,96,5,366776.2,3439.911,107.5446
"26134","77251","2020",167,74,93,223825.1,3109.359,74.00599
"26135","77252","2020",9,9,0,341250,3785.111,116.3333
"26136","77253","2020",4,4,0,208750,2203.5,100.5
"26137","77254","2020",18,16,2,313277.8,3067.556,105
"26138","77255","2020",24,24,0,266093.2,2984.917,95.875
"26139","77256","2020",3,3,0,142766.7,1023.333,128.3333
"26140","77257","2020",32,21,11,153446.1,2156.094,79.65625
"26141","77258","2020",123,17,106,228831.7,3516.114,67.13821
"26142","77259","2020",41,28,13,228376.3,2961.854,78.85366
"26143","77260","2020",13,13,0,187734.6,1995.846,101.6154
"26144","77261","2020",22,20,2,211402.8,1843.545,124.1364
"26145","77262","2020",7,7,0,156484.3,1129.143,141.8571
"26146","77263","2020",2,2,0,141500,1105.5,135
"26147","77264","2020",19,19,0,298110.5,2462.895,132.8421
"26148","77265","2020",31,25,6,182054.8,1910.903,96.06452
"26149","77266","2020",8,7,1,284750,2764.125,122.625
"26150","77267","2020",6,6,0,187966.7,1585.833,123.3333
"26151","77268","2020",146,80,66,384051.8,4261.096,94.94521
"26152","77269","2020",41,36,5,270034,2828.78,101.2195
"26153","77270","2020",8,8,0,229153.1,2968.75,82.5
"26154","77271","2020",1,1,0,206000,2102,98
"26155","77272","2020",17,16,1,162096.6,1680.412,98.70588
"26156","77273","2020",5,5,0,310900,2827.6,112.8
"26157","77274","2020",13,6,7,201883.1,2182.615,98.53846
"26158","77275","2020",3,3,0,190666.7,1718,117
"26159","77276","2020",29,25,4,312296.7,3056.862,107.4138
"26160","77277","2020",15,13,2,295213.3,2784.533,110.1333
"26161","77278","2020",10,10,0,236122,1978.2,119.4
"26162","77279","2020",27,26,1,167160.4,2124.296,81.03704
"26163","77280","2020",18,13,5,179486.9,2142,86.27778
"26164","77281","2020",17,17,0,234909.4,2162.353,113
"26165","77282","2020",1,1,0,263250,3134,84
"26166","77283","2020",16,16,0,173843.8,1874.812,103
"26167","77284","2020",697,147,550,179096.6,2899.357,64.83357
"26168","77285","2020",211,72,139,154468.8,1943.621,80.45498
"26169","77286","2020",2,2,0,182500,1119.5,154
"26170","77287","2020",14,14,0,126628.6,1194.286,112.0714
"26171","77288","2020",562,108,454,151470,2543.265,63.11922
"26172","77289","2020",3,3,0,217000,1763.667,126
"26173","77290","2020",15,14,1,144533.3,2415.333,65.13333
"26174","77291","2020",7,6,1,224320.7,2678.286,80.42857
"26175","77292","2020",11,11,0,321804.5,2791.636,118.8182
"26176","77293","2020",24,24,0,153422.9,2398.208,75.41667
"26177","77294","2020",193,147,46,245976.9,3371.192,76.89119
"26178","77295","2020",15,15,0,269877.9,2764.4,102.3333
"26179","77296","2020",197,94,103,207487.4,2842.487,75.08629
"26180","77297","2020",3,3,0,193966.7,1415,143
"26181","77298","2020",8,8,0,175678.8,1513.375,123.625
"26182","77300","2020",9,8,1,190555.6,2416.667,81.11111
"26183","77301","2020",3,3,0,124666.7,1607,73
"26184","77302","2020",32,31,1,207784.1,2045.625,106.3125
"26185","77303","2020",4,4,0,166425,1973.5,98.75
"26186","77305","2020",182,41,141,118923.7,1885.687,66.01648
"26187","77306","2020",5,5,0,325286,3146,126.8
"26188","77307","2020",265,48,217,259656.5,4240.23,63.39623
"26189","77308","2020",10,10,0,269300,2722.9,100.8
"26190","77309","2020",18,16,2,213008.3,3142.111,70.94444
"26191","77310","2020",6,6,0,169333.3,1289.667,143
"26192","77311","2020",25,24,1,157610,1714.4,94.52
"26193","77312","2020",56,49,7,253017.8,2632.786,101.1607
"26194","77313","2020",4,4,0,177000,2352.5,88.25
"26195","77314","2020",6,6,0,193191.7,1812.333,108.1667
"26196","77315","2020",45,38,7,275585,3405.267,89.35556
"26197","77316","2020",202,157,45,223180.6,2572.035,90.35149
"26198","77317","2020",47,39,8,197656,2393.83,86.76596
"26199","77318","2020",22,15,7,227777.7,2661.182,89.54545
"26200","77319","2020",4,4,0,132075,1283.75,108
"26201","77320","2020",57,52,5,237540.1,2572.526,101.807
"26202","77321","2020",9,7,2,162388.9,1965.111,84.22222
"26203","77322","2020",43,42,1,339123.4,3282.279,107.3023
"26204","77323","2020",17,13,4,247090.1,3092.176,81.52941
"26205","77325","2020",4,3,1,104500,944,108
"26206","77326","2020",66,42,24,247531.3,2837.47,88.81818
"26207","77327","2020",86,72,14,176246.1,2118.837,86.97674
"26208","77328","2020",5,5,0,239176,2390,103.2
"26209","77329","2020",7,7,0,252542.9,1870.429,135
"26210","77330","2020",95,79,16,260234.9,2910.4,95.05263
"26211","77331","2020",9,8,1,205247.8,1719.667,125.5556
"26212","77332","2020",2,2,0,253500,3094,79
"26213","77333","2020",156,86,70,151037.4,2104.462,76.41026
"26214","77335","2020",28,25,3,279072.3,3084.25,95.28571
"26215","77336","2020",17,13,4,290035.3,3069.588,99.23529
"26216","77337","2020",105,27,78,227438.1,3178.019,72.9619
"26217","77338","2020",9,9,0,239961.1,1907.111,136.6667
"26218","77339","2020",47,37,10,360072.9,2725.83,134
"26219","77340","2020",8,8,0,210625,1895.125,113.5
"26220","77341","2020",7,7,0,145000,1452.714,98.42857
"26221","77342","2020",4,4,0,156875,1838.75,87
"26222","77343","2020",8,8,0,178443.8,1901.5,106.75
"26223","77344","2020",29,20,9,257044.8,2706.931,97.03448
"26224","77345","2020",12,12,0,200200.5,1666.25,123.3333
"26225","77347","2020",8,8,0,119293.8,1556.375,77.125
"26226","77348","2020",6,6,0,171500,1563.833,112.6667
"26227","77349","2020",93,79,14,269912.9,2986.237,94.78495
"26228","77350","2020",271,179,92,290743.8,3680.018,83.1476
"26229","77352","2020",30,26,4,274546.6,3043.633,94.9
"26230","77353","2020",5,5,0,195730,1796.2,114.4
"26231","77354","2020",12,12,0,251550,2377.667,104.8333
"26232","77355","2020",1,1,0,117000,1581,74
"26233","77357","2020",11,11,0,248051.1,2357.273,106.8182
"26234","77358","2020",7,7,0,371671.4,3177,116.5714
"26235","77359","2020",33,32,1,327524.1,3278.485,105.8182
"26236","77360","2020",5,4,1,232172,2527,104
"26237","77361","2020",7,6,1,168870.7,2000.857,87.85714
"26238","77363","2020",26,13,13,263811.2,3479.808,79.34615
"26239","77364","2020",2,2,0,313500,2737.5,120
"26240","77365","2020",12,12,0,279970.8,2255.583,126
"26241","77366","2020",3,3,0,253833.3,3071.667,98.66667
"26242","77367","2020",1,1,0,319000,2492,128
"26243","77368","2020",4,4,0,201500,1961.75,105.25
"26244","77369","2020",9,9,0,282111.1,2772.444,102.2222
"26245","77370","2020",17,17,0,214000,1859.471,124.7059
"26246","77371","2020",61,58,3,227693,2644.049,94.60656
"26247","77372","2020",56,30,26,347943.2,3981.5,96.44643
"26248","77373","2020",502,262,240,278420,3842.026,75.09562
"26249","77374","2020",35,22,13,301187.1,3656.057,82.31429
"26250","77376","2020",11,11,0,322363.6,3153.909,109.3636
"26251","77377","2020",38,33,5,294074.2,3495.684,89.76316
"26252","77378","2020",57,27,30,225897.1,2888.544,83.63158
"26253","77379","2020",128,62,66,164428.7,2137.25,83.03125
"26254","77380","2020",1,1,0,110000,1571,70
"26255","77381","2020",12,12,0,241533.3,2002.167,129.6667
"26256","77382","2020",62,52,10,246413.5,3101.048,83.41935
"26257","77383","2020",8,8,0,223627,2539,93.625
"26258","77384","2020",20,19,1,223250,3553.3,66.85
"26259","77385","2020",36,34,2,169391.2,1939.778,103.9722
"26260","77386","2020",14,13,1,311552.5,2559.857,118.2857
"26261","77387","2020",3,3,0,187500,2213.333,92.33333
"26262","77388","2020",20,20,0,218101.2,2194.05,104.15
"26263","77389","2020",50,24,26,230097.7,2730.04,84.64
"26264","77390","2020",261,154,107,255010.7,3249.613,81.44061
"26265","77391","2020",7,7,0,200714.3,1604.429,132.8571
"26266","77392","2020",8,8,0,307441.1,3205.5,99
"26267","77393","2020",35,29,6,242467.1,2437.343,102.2571
"26268","77394","2020",26,24,2,323714.8,2744.077,124.9615
"26269","77395","2020",1,1,0,150000,1500,100
"26270","77396","2020",1,1,0,46000,836,55
"26271","77397","2020",33,33,0,167989.4,2029.485,89.12121
"26272","77398","2020",23,23,0,224682.6,2061.13,113.3913
"26273","77400","2020",30,27,3,240761.8,2616.367,104.6
"26274","77401","2020",12,12,0,234191.7,2576.75,91.16667
"26275","77402","2020",6,6,0,166000,1765.667,98.33333
"26276","77403","2020",12,12,0,140500,1470.667,99.41667
"26277","77404","2020",15,15,0,155250,1685.733,92.73333
"26278","77405","2020",34,34,0,217203.8,2005.676,112.1471
"26279","77406","2020",25,25,0,205721.7,2282.8,95.36
"26280","77407","2020",226,136,90,254394.9,2967.792,89.61947
"26281","77408","2020",7,7,0,256457.1,2820.143,92.71429
"26282","77409","2020",28,28,0,166162.8,2005.679,86.39286
"26283","77410","2020",4,3,1,387000,4317.75,105.25
"26284","77411","2020",8,8,0,237125,1936,133.375
"26285","77412","2020",7,7,0,293000,3517,88.71429
"26286","77413","2020",56,49,7,322713.6,3394.018,98.28571
"26287","77414","2020",6,6,0,172866.7,1820.5,98
"26288","77415","2020",19,19,0,234363.7,2657.842,93.94737
"26289","77416","2020",3,3,0,185500,1704,110
"26290","77417","2020",2,2,0,222705,2764.5,82
"26291","77418","2020",10,10,0,183135,1756.7,103
"26292","77419","2020",51,43,8,183106.8,2383.647,81.5098
"26293","77420","2020",39,33,6,263916.7,3182.026,86.61538
"26294","77421","2020",7,7,0,242471.4,1950.857,128
"26295","77423","2020",13,12,1,194684.6,1884.615,118.6154
"26296","77424","2020",6,6,0,181379.2,1823.5,119.3333
"26297","77425","2020",15,14,1,340821.7,2727.267,126.6667
"26298","77426","2020",6,6,0,271116.7,2814.5,101.8333
"26299","77427","2020",9,9,0,308904.7,2939.556,105.8889
"26300","77428","2020",11,11,0,210357.3,1993.545,103.9091
"26301","77429","2020",9,9,0,245455.6,2140.222,122
"26302","77430","2020",94,86,8,279363.1,2967.543,96.88298
"26303","77431","2020",87,79,8,198357.7,2074.437,97.78161
"26304","77432","2020",16,16,0,196059.4,2087.812,98.625
"26305","77433","2020",36,35,1,226511.7,2517.972,96.69444
"26306","77434","2020",11,11,0,191427.3,2059.818,99
"26307","77435","2020",21,21,0,340484.8,2672.905,128.1429
"26308","77436","2020",18,17,1,174138.9,1898.111,94.66667
"26309","77437","2020",42,36,6,255439.3,2965.31,88.69048
"26310","77438","2020",79,43,36,295505.7,3680.405,82.91139
"26311","77439","2020",15,15,0,177153.3,2074.4,88
"26312","77440","2020",16,16,0,177040.6,2166.688,87.1875
"26313","77441","2020",42,39,3,316622.6,3133.738,101.7143
"26314","77442","2020",31,30,1,302601.3,2795.484,111.2581
"26315","77443","2020",6,6,0,236333.3,2639.833,90.66667
"26316","77444","2020",2,2,0,151000,1607,96
"26317","77445","2020",357,189,168,214254.2,2603.894,83.87115
"26318","77446","2020",9,9,0,149777.8,1801,85
"26319","77447","2020",21,17,4,337983.8,3361.095,114.9048
"26320","77448","2020",3,3,0,290666.7,2580,114.6667
"26321","77449","2020",104,25,79,295918,4399.192,69.19231
"26322","77450","2020",44,38,6,322001.2,3472.273,105.6591
"26323","77451","2020",10,10,0,187960,1963.2,101.6
"26324","77453","2020",14,13,1,277879.3,3104.571,97.07143
"26325","77454","2020",7,7,0,181428.6,2149.286,90
"26326","77455","2020",29,21,8,284895.7,3082.966,99.89655
"26327","77456","2020",6,6,0,183666.7,1598.833,115.5
"26328","77457","2020",13,12,1,268607.7,3196.308,85.15385
"26329","77458","2020",61,55,6,158724.4,1784.344,98.13115
"26330","77459","2020",25,25,0,170911.8,1676.96,106.56
"26331","77460","2020",5,5,0,208800,2025,103
"26332","77461","2020",10,10,0,164080,1510.2,110.2
"26333","77462","2020",5,2,3,202000,2761.6,79.2
"26334","77463","2020",49,40,9,306779,2788.02,121.3878
"26335","77464","2020",128,56,72,258833.4,3558.844,75.54688
"26336","77465","2020",14,14,0,176141.6,1730.786,109.0714
"26337","77466","2020",7,7,0,277785.7,2373,115.4286
"26338","77467","2020",3,3,0,127000,1841.333,96
"26339","77468","2020",228,50,178,228656.6,3239.482,73.81579
"26340","77469","2020",16,16,0,240293.8,2292.75,103.6875
"26341","77470","2020",87,54,33,263066.1,3462.701,80.05747
"26342","77471","2020",6,6,0,301000,2439.167,125.5
"26343","77472","2020",7,7,0,261714.3,1604.143,165.5714
"26344","77473","2020",15,15,0,281004.7,2162.6,132.6667
"26345","77474","2020",11,10,1,171369.7,2809.636,66.72727
"26346","77475","2020",62,52,10,229112.3,2817.532,82.95161
"26347","77477","2020",18,17,1,276900.6,2998.333,108.6111
"26348","77478","2020",18,17,1,180119.4,2258.111,83.05556
"26349","77479","2020",141,64,77,283609.2,3830.823,77.53901
"26350","77480","2020",10,10,0,249900,2644.1,96.9
"26351","77481","2020",4,4,0,213704,1851,119.5
"26352","77482","2020",35,35,0,169444,2090.543,87
"26353","77483","2020",27,24,3,219452.4,2622.481,86.51852
"26354","77484","2020",2,2,0,301000,2805.5,108
"26355","77485","2020",12,12,0,357558.3,2834,128.5833
"26356","77486","2020",17,16,1,198494.1,2223.588,98.47059
"26357","77487","2020",130,80,50,242065.2,2686.808,94.17692
"26358","77489","2020",2,2,0,270000,1425,212.5
"26359","77490","2020",14,13,1,188612,1908.429,109.5714
"26360","77492","2020",13,13,0,150884.6,1680.231,108.1538
"26361","77493","2020",18,14,4,265537.5,2870.5,94.5
"26362","77494","2020",27,27,0,209160.4,2323.63,92.92593
"26363","77495","2020",122,112,10,267345,2879.205,96.36066
"26364","77496","2020",2,2,0,238500,2035.5,119.5
"26365","77498","2020",4,4,0,357962.5,2754,131.75
"26366","77500","2020",12,12,0,183240.4,1836.5,105.75
"26367","77501","2020",13,13,0,194891.2,1953.615,103.3846
"26368","77504","2020",22,21,1,137445.5,1882,85.45455
"26369","77505","2020",3,3,0,224750,3302,65.66667
"26370","77506","2020",6,6,0,205533.3,1915.333,108.1667
"26371","77507","2020",2,2,0,158000,1502,106
"26372","77508","2020",20,19,1,382500,3481.15,121.5
"26373","77509","2020",9,9,0,181577.8,2141.444,91.44444
"26374","77510","2020",11,6,5,328772.7,3504.909,98.27273
"26375","77511","2020",11,5,6,172436.4,3360.545,54
"26376","77512","2020",16,16,0,156590.6,1765.5,90.75
"26377","77513","2020",80,34,46,220398.6,3124.25,73.65
"26378","77514","2020",363,175,188,214640.2,3259.686,68.88154
"26379","77515","2020",10,10,0,255890,2628.4,104.1
"26380","77516","2020",15,15,0,207870,1906.6,117.7333
"26381","77517","2020",28,18,10,283257.5,3555.75,96
"26382","77518","2020",2,2,0,662000,2315,286
"26383","77519","2020",16,16,0,174083.1,1478.938,120.75
"26384","77520","2020",17,16,1,286002.2,2239.706,132.5294
"26385","77521","2020",31,29,2,302806.8,3384.323,104.2258
"26386","77522","2020",4,4,0,136375,1428,96.75
"26387","77523","2020",7,7,0,125142.9,1291.857,107.2857
"26388","77524","2020",8,8,0,202375,1571.375,139.875
"26389","77525","2020",3,3,0,247183,3127.333,88
"26390","77526","2020",3,3,0,252180,2201.667,116
"26391","77527","2020",5,5,0,217800,2108.4,114.2
"26392","77528","2020",9,9,0,283050,2961.333,98.11111
"26393","77529","2020",30,30,0,329238.7,3044.1,121.8
"26394","77530","2020",3,3,0,180533.3,1966,96
"26395","77531","2020",19,18,1,142078.9,1873.947,84.94737
"26396","77533","2020",30,29,1,346994.3,2974.167,119.4667
"26397","77534","2020",13,12,1,284853.8,2853.769,103.6154
"26398","78003","2020",49,44,5,241873.9,2549.082,99.28571
"26399","78005","2020",216,87,129,254763.4,3606.032,72.29167
"26400","78006","2020",17,16,1,369389.7,2782.118,142.8235
"26401","78007","2020",12,12,0,741658.3,4637.333,162.4167
"26402","78009","2020",3,3,0,221666.7,2064.667,108
"26403","78010","2020",26,26,0,533878.5,3502.423,158.1154
"26404","78013","2020",2,2,0,277500,2942,94
"26405","78015","2020",221,104,117,296146.4,3533.136,85.52941
"26406","78020","2020",8,7,1,284911.2,2695.875,109.5
"26407","78029","2020",139,62,77,199056.9,2644.633,77.05755
"26408","78030","2020",7,6,1,325242.9,3044.286,118.5714
"26409","78031","2020",12,12,0,281563.5,2443.917,125.75
"26410","78033","2020",17,14,3,278630,3019.118,99.82353
"26411","78034","2020",17,17,0,366394.7,3196.471,124.9412
"26412","78036","2020",5,5,0,332070,2405.6,137.6
"26413","78043","2020",53,22,31,434495.6,4240.151,100.5283
"26414","78048","2020",22,19,3,389698.1,2941.591,138.5
"26415","78049","2020",26,25,1,342360.8,3991.731,97.19231
"26416","78050","2020",14,14,0,497685.1,3022.357,171.3571
"26417","78053","2020",3,3,0,311833.3,3008.333,106.6667
"26418","78057","2020",34,32,2,170695.6,2068.176,86.58824
"26419","78062","2020",98,77,21,287820.7,3332.765,89.34694
"26420","78068","2020",15,15,0,268341,2284.467,125.9333
"26421","78070","2020",4,4,0,252075,2560.75,96.5
"26422","78071","2020",11,11,0,231708.2,2345.364,100.5455
"26423","78072","2020",5,5,0,295264,2937,106.6
"26424","78073","2020",289,62,227,241353.4,3526.644,69.02422
"26425","78076","2020",6,6,0,292390,3003.5,99.5
"26426","78077","2020",15,14,1,261341.7,2684.067,104
"26427","78082","2020",5,5,0,211800,1626.4,132.4
"26428","78084","2020",4,4,0,319930,3760.25,84.75
"26429","78087","2020",27,19,8,261164.2,2969.889,92.25926
"26430","78089","2020",49,37,12,173419.9,2372.265,77.4898
"26431","78090","2020",39,33,6,255051.9,3120.103,83.82051
"26432","78092","2020",107,24,83,411865.6,4646.897,85.82243
"26433","78096","2020",4,4,0,259650,2051.5,142.75
"26434","78104","2020",8,8,0,234781.2,2125.25,110.75
"26435","78107","2020",27,25,2,243407.4,2446.852,102.1481
"26436","78108","2020",9,9,0,411311.6,3945.333,121
"26437","78113","2020",21,21,0,288514.3,2730.286,112.8571
"26438","78117","2020",73,31,42,513203.4,5421.808,94.9863
"26439","78118","2020",39,35,4,248580.1,2830.846,89.25641
"26440","78120","2020",30,30,0,363961.7,2945.2,131.5333
"26441","78123","2020",226,75,151,235226,3620.31,67.78319
"26442","78124","2020",195,78,117,408570.5,5396.764,77.00513
"26443","78125","2020",19,19,0,445453.9,3563.526,134
"26444","78126","2020",255,91,164,487515.1,4808.843,98.04314
"26445","78128","2020",22,17,5,345305.6,3596.5,101.7273
"26446","78133","2020",71,34,37,534933.8,4282.761,119.0282
"26447","78138","2020",110,69,41,227416.4,2908.027,80.69091
"26448","78140","2020",20,19,1,338640,3391.5,112.2
"26449","78143","2020",26,21,5,458289.4,4645.692,99
"26450","78146","2020",439,134,305,457196.8,5560.175,79.80182
"26451","78147","2020",7,7,0,237050,2019.857,119.8571
"26452","78152","2020",26,26,0,682467.9,4190.346,178.1923
"26453","78158","2020",246,66,180,579506.7,6325.028,87.84959
"26454","78160","2020",86,54,32,375989.9,3661.43,104.5581
"26455","78162","2020",9,9,0,417888.9,3132.778,145.3333
"26456","78163","2020",10,10,0,249692.5,2250,113.3
"26457","78164","2020",5,5,0,420400,3104.8,137.2
"26458","78165","2020",226,96,130,268571.4,3314.934,82.71239
"26459","78168","2020",33,25,8,282061.5,3483.939,83.24242
"26460","78171","2020",5,5,0,256899.8,2393.4,106.4
"26461","78172","2020",547,308,239,286296.2,3841.435,76.23035
"26462","78185","2020",6,6,0,362183.3,3081.667,122.6667
"26463","78188","2020",8,8,0,214125,1920.125,122.75
"26464","78189","2020",32,32,0,574320.3,4076.438,149.2188
"26465","78190","2020",113,50,63,709029.3,6539.628,104.2035
"26466","78192","2020",23,22,1,250075,2446.13,118.3043
"26467","78193","2020",18,14,4,400638.9,3382.889,125.2778
"26468","78194","2020",4,4,0,347250,2307,154.75
"26469","78196","2020",6,5,1,646493.3,5440.333,120.5
"26470","78202","2020",5,5,0,266093.2,2320.2,112.6
"26471","78206","2020",50,40,10,273549.1,3053.96,92.64
"26472","78208","2020",441,154,287,226167.1,2849.531,81.3356
"26473","78209","2020",13,12,1,287401.2,2378.154,127
"26474","78217","2020",71,56,15,255176.5,3070.803,88.5493
"26475","78220","2020",109,82,27,295325.2,3307.431,93.69725
"26476","78224","2020",92,58,34,627475.6,4870.087,131.3913
"26477","78227","2020",12,10,2,278862.5,3447.333,90.08333
"26478","78230","2020",7,6,1,256900,2769.286,92.57143
"26479","78231","2020",2,2,0,166000,2024.5,81.5
"26480","78233","2020",35,33,2,709090.7,4784.571,152.6857
"26481","78234","2020",4,4,0,329028.8,2763,119.75
"26482","78236","2020",10,10,0,321090.5,2600.9,128.4
"26483","78237","2020",2,2,0,199500,1346.5,214.5
"26484","78238","2020",35,29,6,251219.5,3177.4,81.62857
"26485","78239","2020",20,17,3,226762,2235.3,104.85
"26486","78242","2020",107,37,70,262209,3424.093,72.83178
"26487","78245","2020",5,5,0,285504,2265,136.4
"26488","78246","2020",11,11,0,257681.8,2813.091,96.81818
"26489","78255","2020",43,42,1,214209.3,2314.512,98.13953
"26490","78261","2020",8,7,1,308283.8,2593,123
"26491","78262","2020",22,19,3,398263.6,3248.773,118.5
"26492","78263","2020",52,47,5,412044.8,3214.865,133.9231
"26493","78264","2020",1,1,0,1190000,3043,391
"26494","78265","2020",34,34,0,326760.5,2976.735,115.3529
"26495","78267","2020",98,78,20,228854.9,2826.327,83.59184
"26496","78269","2020",16,14,2,341273.8,2987.25,120.625
"26497","78276","2020",10,10,0,222385,2669.9,90.1
"26498","78278","2020",3,3,0,356000,2453.333,139
"26499","78281","2020",8,7,1,291093.8,2011.625,154.125
"26500","78283","2020",2,2,0,316497.5,2499.5,135.5
"26501","78285","2020",5,5,0,320120,3154.6,102.8
"26502","78289","2020",20,17,3,649117.8,4140.1,162.7
"26503","78290","2020",19,17,2,192662.8,2472.632,79.21053
"26504","78291","2020",34,29,5,254448.2,2812.676,92.85294
"26505","78296","2020",4,4,0,264825,2528.75,105.75
"26506","78297","2020",241,78,163,309577.4,3968.485,80.44813
"26507","78299","2020",40,35,5,286236.1,3088.5,96.075
"26508","78300","2020",7,6,1,291385.7,2900,103.1429
"26509","78302","2020",5,5,0,469040,3552.8,135.6
"26510","78305","2020",2,2,0,338387.5,2905,123
"26511","78307","2020",21,21,0,337692.4,2650.286,139.1429
"26512","78310","2020",54,34,20,227077.3,3038.759,80.37037
"26513","78311","2020",458,226,232,368714.3,5115.295,73.8952
"26514","78314","2020",68,55,13,213391.2,2613.294,82.57353
"26515","78317","2020",11,11,0,274718.2,2465,117.7273
"26516","78320","2020",10,9,1,195342,1940.2,99.4
"26517","78321","2020",6,6,0,421891.7,3183.333,154.1667
"26518","78322","2020",76,43,33,516125.4,4902.342,107.5789
"26519","78324","2020",2,2,0,257855,2615,99
"26520","78325","2020",5,5,0,300800,3310.4,91.6
"26521","78327","2020",65,56,9,237474.8,3024.015,84.44615
"26522","78329","2020",13,13,0,309411.7,2470.923,131.8462
"26523","78334","2020",19,17,2,320973.1,3466.316,101.7895
"26524","78335","2020",155,114,41,202255.1,2402.987,88.47097
"26525","78337","2020",30,30,0,208661.5,2160.667,102.4667
"26526","78343","2020",7,6,1,673586.9,5438.571,126.4286
"26527","78344","2020",12,12,0,255233.4,2524.583,118
"26528","78346","2020",24,23,1,219517.1,2297.208,101.5833
"26529","78349","2020",5,5,0,390392.6,3009.6,128.8
"26530","78350","2020",93,27,66,518014.9,4861.645,104.2258
"26531","78354","2020",48,36,12,227230,2606.979,89.33333
"26532","78356","2020",131,85,46,327915.7,3501.954,95.26718
"26533","78358","2020",410,106,304,491171.9,6021.412,79.67561
"26534","78361","2020",367,106,261,165336.2,2584.049,66.55313
"26535","78362","2020",221,133,88,181516.6,2433.738,76.51584
"26536","78364","2020",5,5,0,491740,3375.2,146.8
"26537","78366","2020",3,3,0,460513.3,3603.333,121.6667
"26538","78367","2020",61,22,39,513264.2,4673.934,108.0328
"26539","78368","2020",24,23,1,349740.6,3023.625,120.1667
"26540","78372","2020",287,59,228,354910.6,4348.481,79.41812
"26541","78380","2020",90,72,18,304935.1,3368.067,94.01111
"26542","78381","2020",19,19,0,309665.5,2944.526,111.8421
"26543","78382","2020",59,41,18,298462,3623.729,83.40678
"26544","78383","2020",257,100,157,237686.8,3090.833,78.23346
"26545","78384","2020",22,21,1,513118.6,4195.455,128.3636
"26546","78385","2020",2,2,0,206500,1997.5,107
"26547","78389","2020",26,25,1,448457.7,3670.308,126.1923
"26548","78391","2020",8,8,0,226871.5,2918.75,78.5
"26549","78396","2020",69,46,23,554803.8,5747.812,97.75362
"26550","78397","2020",110,68,42,328497.3,3611.973,95.67273
"26551","78398","2020",14,14,0,487307.1,4077.214,132.1429
"26552","78401","2020",161,58,103,171343.8,2518.907,68.34783
"26553","78402","2020",62,51,11,256687.5,2939.726,91.69355
"26554","78403","2020",38,36,2,270634.7,2828.342,100.7632
"26555","78404","2020",4,4,0,385387.5,2709.75,151
"26556","78406","2020",5,5,0,1005623,5100.6,184.8
"26557","78407","2020",14,14,0,308053.3,2009.643,163.5
"26558","78410","2020",18,18,0,226056.1,2158.944,112.1667
"26559","78413","2020",4,4,0,299000,2494.25,116
"26560","78415","2020",13,13,0,453409.5,3365.462,144.9231
"26561","78416","2020",4,4,0,298112.5,2468.25,121.5
"26562","78417","2020",7,7,0,403800,2694,146.1429
"26563","78418","2020",187,102,85,461623.5,4951.241,93.65241
"26564","78420","2020",34,23,11,454646.7,4280.471,108.8235
"26565","78423","2020",395,111,284,310118,3922.78,80.05823
"26566","78431","2020",37,36,1,489557,3712.243,131.8649
"26567","78437","2020",9,9,0,290808.9,2446.222,123.7778
"26568","78440","2020",220,101,119,166100.6,2388.468,71.25
"26569","78442","2020",71,37,34,326564,3562.38,94.5493
"26570","78443","2020",15,14,1,426691.9,3403.8,134.3333
"26571","78444","2020",6,6,0,249116.7,2497.833,103.3333
"26572","78451","2020",17,16,1,264182.4,3032.529,92.82353
"26573","78455","2020",90,68,22,620267.3,5089.433,123.8111
"26574","78460","2020",13,13,0,282807.7,3013.231,97.46154
"26575","78464","2020",9,9,0,281505.6,2929.444,97.33333
"26576","78465","2020",28,28,0,341259.6,3518.25,101.5
"26577","78466","2020",136,109,27,531569,4513.654,119.9853
"26578","78470","2020",18,16,2,288383.3,2648.111,115.3889
"26579","78472","2020",5,5,0,159600,1781.8,89
"26580","78474","2020",8,7,1,236671.2,2955,82.25
"26581","78475","2020",3,3,0,312350,2750,114.3333
"26582","78478","2020",4,4,0,288425,1711.5,160.5
"26583","78481","2020",244,58,186,420742.5,5021.754,81.27459
"26584","78484","2020",9,6,3,219555.6,2322.556,95.33333
"26585","78486","2020",96,71,25,294781.6,3384.708,91.70833
"26586","78490","2020",408,155,253,256274.2,3175.728,81.36029
"26587","78497","2020",14,14,0,473175,3108.643,158.3571
"26588","78498","2020",387,80,307,266626.9,3976.941,67.86305
"26589","78499","2020",9,9,0,329983.3,2398.667,140.7778
"26590","78501","2020",52,50,2,229076.8,2596.308,90.36538
"26591","78502","2020",71,5,66,278041.8,4142.761,67.33803
"26592","78505","2020",7,7,0,298947.9,3070.857,103.5714
"26593","78506","2020",15,15,0,320481.3,2476.467,141.2
"26594","78513","2020",31,19,12,305939.7,3447.129,96.41935
"26595","78516","2020",15,14,1,344426.7,2463.067,148.1333
"26596","78517","2020",436,162,274,271907.1,3551.612,78.05505
"26597","78520","2020",11,10,1,274415.4,2698.455,111.5455
"26598","78522","2020",15,13,2,336334.1,2890.667,126.7333
"26599","78528","2020",4,4,0,212500,2440.5,94.25
"26600","78530","2020",4,4,0,360850,2579.75,138.5
"26601","78531","2020",78,72,6,237469.3,2473.615,101.1795
"26602","78536","2020",8,7,1,251241.5,2368,112
"26603","78537","2020",97,78,19,256058.1,2906,91.07216
"26604","78545","2020",272,42,230,279030.8,4220.39,67.30515
"26605","78548","2020",2,2,0,695725,3336,206
"26606","78550","2020",31,29,2,394718.8,3410.71,119
"26607","78551","2020",579,124,455,525948.5,6014.465,85.02591
"26608","78557","2020",13,13,0,342697.4,2784.385,124.6154
"26609","78558","2020",3,3,0,415266.7,2069,182
"26610","78559","2020",5,4,1,198400,2279.2,99.4
"26611","78561","2020",1,1,0,430000,4674,92
"26612","78562","2020",20,18,2,394641,3419.55,121.65
"26613","78564","2020",8,8,0,263045,2349.5,115.625
"26614","78565","2020",8,8,0,357025,2852.875,128.625
"26615","78567","2020",14,14,0,345004.4,2429.929,142.1429
"26616","78569","2020",11,10,1,228300,2247.364,108.1818
"26617","78571","2020",91,72,19,679886.5,4602.835,150.4945
"26618","78575","2020",106,82,24,433107.1,4506.33,103.8962
"26619","78576","2020",39,30,9,356510.4,3346.564,117.1026
"26620","78586","2020",635,260,375,306976.4,4439.913,71.22047
"26621","78588","2020",11,11,0,369208.2,2403.273,166
"26622","78590","2020",15,15,0,432852.7,3264.133,138.4667
"26623","78591","2020",34,31,3,258988.4,2578.588,110.0588
"26624","78597","2020",6,5,1,222283.3,1954.667,107
"26625","78601","2020",32,24,8,287598.6,2670.75,118.625
"26626","78605","2020",10,10,0,297305,3014.9,99.5
"26627","78608","2020",2,2,0,181775,2651,80
"26628","78609","2020",18,18,0,312676.1,3088.611,107.6667
"26629","78615","2020",14,8,6,291564.3,4017.714,72.85714
"26630","78616","2020",20,17,3,321773,2798.6,117.4
"26631","78618","2020",8,8,0,327818.8,2688.25,138
"26632","78620","2020",6,2,4,276233.3,4452.333,68
"26633","78621","2020",231,53,178,189470.1,2937.771,65.02597
"26634","78623","2020",9,5,4,300533.3,3676.556,79.55556
"26635","78624","2020",203,149,54,304134.2,3427.872,92.97537
"26636","78638","2020",68,54,14,301170.7,3172.779,100.7794
"26637","78640","2020",208,49,159,365975.1,4944.322,74.39904
"26638","78642","2020",192,75,117,287183.2,3378.271,83.98438
"26639","78643","2020",100,79,21,356113.2,3509.23,105.58
"26640","78644","2020",25,10,15,214326.4,3270.76,68.92
"26641","78646","2020",996,95,901,524792.2,6950.508,74.63554
"26642","78647","2020",10,9,1,207215,2297.2,91.2
"26643","78650","2020",224,96,128,727122.9,6861.214,100.7232
"26644","78653","2020",4,4,0,401295,3488,116.5
"26645","78655","2020",14,14,0,417500.6,3230.857,140.7857
"26646","78668","2020",13,13,0,261038.5,2155.308,138.3846
"26647","78672","2020",92,63,29,534406.3,4924.315,115.8478
"26648","78674","2020",185,138,47,315877.4,3757.941,84.39459
"26649","78677","2020",15,15,0,388341.9,2830.733,141.6
"26650","78681","2020",9,9,0,311703.3,3309.889,102.8889
"26651","78683","2020",45,40,5,385735.8,3849.622,106.0444
"26652","78686","2020",239,59,180,459517.4,6366.096,71.04184
"26653","78688","2020",108,71,37,439673.1,4444.435,99.94444
"26654","79001","2020",22,22,0,95566.82,846.1364,113.3182
"26655","79002","2020",8,8,0,103475,1132.625,96.625
"26656","79003","2020",54,54,0,174176.7,1598.574,106.1667
"26657","79005","2020",50,49,1,76284.42,859.2,86.7
"26658","79007","2020",5,5,0,98500,914.4,116.2
"26659","79008","2020",15,15,0,91266.67,913.2667,99.13333
"26660","79009","2020",5,5,0,116610,1126.6,113.6
"26661","79010","2020",13,13,0,92961.54,1260.692,83.15385
"26662","79012","2020",22,22,0,118409,1154.545,101.7273
"26663","79013","2020",39,39,0,124413.7,1180.974,110.1795
"26664","79014","2020",47,47,0,103735.1,992.1064,108.3404
"26665","79015","2020",2,2,0,105500,1140,94
"26666","79016","2020",4,4,0,72000,805.5,90
"26667","79018","2020",2,2,0,109557.5,805.5,143.5
"26668","79019","2020",3,3,0,42000,474,91
"26669","79020","2020",13,13,0,100230.2,1024.385,93.53846
"26670","79022","2020",3,3,0,101666.7,786.3333,128.6667
"26671","79023","2020",1,1,0,62060,372,167
"26672","79024","2020",22,22,0,157361.4,1423.636,111.5909
"26673","79025","2020",14,14,0,161342.5,1296.929,126
"26674","79029","2020",11,11,0,83127.27,936.5455,89.81818
"26675","79030","2020",11,11,0,155909.1,1137.364,138.6364
"26676","79031","2020",35,35,0,136628.1,1346.743,100.8
"26677","79032","2020",6,6,0,145083.3,1222.333,112.5
"26678","79034","2020",17,17,0,198855.5,1768.059,111.2353
"26679","79038","2020",10,10,0,94420,1045.7,93.2
"26680","79040","2020",1,1,0,87000,1243,70
"26681","79042","2020",3,3,0,114666.7,1203,95.33333
"26682","79046","2020",13,13,0,158920.8,1211.615,133.1538
"26683","79047","2020",9,9,0,101027.8,810.8889,127
"26684","79048","2020",78,78,0,145786.6,1484.949,101.2821
"26685","79049","2020",260,228,32,122941.6,1306.885,97.08462
"26686","79050","2020",7,7,0,171271.4,1178.857,142.8571
"26687","79056","2020",11,11,0,92184.55,939.4545,94.72727
"26688","79057","2020",23,23,0,122613,1075.87,118.1739
"26689","79058","2020",8,8,0,202812.5,2141.625,107
"26690","79059","2020",12,12,0,79504.17,1039.833,75.16667
"26691","79060","2020",1,1,0,61000,678,90
"26692","79061","2020",55,53,2,142094.1,1322.382,117.0545
"26693","79062","2020",65,64,1,109027,1127.077,97.46154
"26694","79063","2020",23,22,1,99669.57,965.5652,107.4348
"26695","79064","2020",8,8,0,112776.2,914.625,128.5
"26696","79066","2020",22,22,0,134694.5,1457,94.40909
"26697","79069","2020",8,8,0,110125,886.25,123.375
"26698","79070","2020",5,5,0,82400,709.2,124.4
"26699","79071","2020",7,7,0,143242.9,1144.286,127
"26700","79076","2020",33,33,0,121641.5,1063.97,113.3939
"26701","79077","2020",11,11,0,97989,1059.455,97.45455
"26702","79078","2020",13,13,0,127292.3,1015.615,126
"26703","79079","2020",88,87,1,132316.9,1299.261,102.625
"26704","79080","2020",39,39,0,114440.9,1135.359,103.7436
"26705","79081","2020",83,72,11,185909.1,1787.687,105.4096
"26706","79083","2020",52,52,0,98941.73,891.7885,115.4423
"26707","79084","2020",11,11,0,67672.73,672.7273,102.0909
"26708","79085","2020",4,4,0,104512.5,797.75,117.5
"26709","79086","2020",15,15,0,140294.7,1176.8,120.2667
"26710","79087","2020",8,8,0,120000,923.5,125.875
"26711","79088","2020",21,21,0,117800,1097.286,109.4286
"26712","79089","2020",2,2,0,72500,745,98.5
"26713","79090","2020",9,9,0,84806.67,740.6667,111.3333
"26714","79091","2020",12,12,0,143083.3,1252,117.5833
"26715","79092","2020",4,4,0,52250,616.25,89.75
"26716","79094","2020",16,16,0,108853.4,864.125,128.5625
"26717","79095","2020",18,18,0,94491.67,794.8889,120.9444
"26718","79096","2020",16,16,0,129104.6,1077.375,116.125
"26719","79100","2020",35,35,0,158976.2,1570.057,103.0571
"26720","79101","2020",36,36,0,131081.2,1208.333,109.1944
"26721","79102","2020",7,7,0,72514.29,764.8571,87.42857
"26722","79103","2020",27,27,0,94729.7,934.7407,102.7407
"26723","79104","2020",2,2,0,112450,1148,94.5
"26724","79105","2020",7,7,0,70071.43,790.2857,94.85714
"26725","79106","2020",4,4,0,98119.5,766,128.5
"26726","79108","2020",7,7,0,79785.71,837.1429,92.57143
"26727","79109","2020",48,48,0,173030.8,1643.25,108.1458
"26728","79111","2020",6,6,0,93666.67,1122.833,90.83333
"26729","79112","2020",14,14,0,172971.4,1523.5,120.9286
"26730","79114","2020",16,13,3,126624.4,1183.312,102.25
"26731","79115","2020",1,1,0,93000,744,125
"26732","79116","2020",15,15,0,102910,1030.8,104.3333
"26733","79117","2020",13,13,0,151363.1,1454.385,113.2308
"26734","79118","2020",7,7,0,105414.3,764.8571,131.4286
"26735","79119","2020",11,11,0,122710.9,1059.636,115.2727
"26736","79120","2020",9,9,0,110211.1,1040,106.3333
"26737","79121","2020",9,9,0,87911.11,939.3333,94.77778
"26738","79122","2020",6,6,0,127633.3,952,122.6667
"26739","79123","2020",40,40,0,102326.6,875.55,117.125
"26740","79124","2020",9,7,2,99830.22,1079,93.88889
"26741","79125","2020",21,21,0,147166.2,1417.333,102.8571
"26742","79126","2020",9,9,0,93231.11,1071.556,91.55556
"26743","79127","2020",15,15,0,188560.7,1288,143.4667
"26744","79128","2020",13,13,0,198518.5,1694.923,115.3077
"26745","79129","2020",19,19,0,177688.4,1579.526,116.5263
"26746","79130","2020",44,41,3,132843.5,1398.477,96.59091
"26747","79131","2020",8,8,0,78737.5,822.25,97.125
"26748","79132","2020",5,5,0,82180,659.2,109.4
"26749","79133","2020",19,19,0,171063.4,1544.579,109.7895
"26750","79134","2020",4,4,0,66100,806.25,84
"26751","79135","2020",14,14,0,89434.14,885.7143,95.42857
"26752","79136","2020",18,18,0,90398.28,769.1667,113.9444
"26753","79137","2020",12,12,0,160500,1561.667,107.5833
"26754","79140","2020",9,9,0,96120.11,668.8889,150.5556
"26755","79141","2020",3,3,0,68883.33,637,108.6667
"26756","79142","2020",1,1,0,76000,784,97
"26757","79144","2020",4,4,0,170125,1277.5,171.5
"26758","79145","2020",3,3,0,76366.67,882.3333,86.33333
"26759","79147","2020",10,10,0,127149,930,144.3
"26760","79148","2020",26,26,0,89338.46,864.8846,108.0385
"26761","79149","2020",2,2,0,100450,747,127.5
"26762","79150","2020",15,15,0,90771,776.5333,120.4
"26763","79152","2020",6,6,0,110933.3,956.8333,122.6667
"26764","79153","2020",5,5,0,196820,2354.4,86.4
"26765","79154","2020",8,8,0,90862.5,850.125,116.5
"26766","79156","2020",8,8,0,114100,942.75,125.5
"26767","79157","2020",11,11,0,116423.6,1217.273,92.81818
"26768","79158","2020",2,2,0,210000,1212.5,183.5
"26769","79159","2020",6,6,0,85750,713,113.8333
"26770","79160","2020",1,1,0,55000,591,93
"26771","79161","2020",13,13,0,119423.1,895.4615,135.2308
"26772","79162","2020",32,32,0,162009.4,1691.5,100.3125
"26773","79163","2020",15,15,0,93280,921.0667,104.0667
"26774","79164","2020",5,5,0,90800,889.2,96.4
"26775","79165","2020",1,1,0,150000,847,177
"26776","79166","2020",11,11,0,175381.8,1275.636,141.9091
"26777","79167","2020",4,4,0,142950,1019.75,132.5
"26778","79170","2020",52,52,0,160524.6,1525.385,109.1154
"26779","79172","2020",17,17,0,113745.9,1138.941,103.4706
"26780","79174","2020",79,74,5,118514.1,1098.684,113.557
"26781","79175","2020",7,7,0,121714.3,791.4286,164.5714
"26782","79176","2020",10,10,0,93695.4,893.3,100.2
"26783","79177","2020",4,4,0,115000,851.25,146
"26784","79179","2020",72,72,0,91900.53,868.25,107.0833
"26785","79180","2020",7,7,0,128575,993.5714,132
"26786","79183","2020",6,6,0,156416.7,1466.833,106.1667
"26787","79184","2020",29,28,1,93978.97,935.3448,104.2414
"26788","79185","2020",81,81,0,142397.6,1332.333,112.0864
"26789","79189","2020",21,21,0,123342.9,1128.143,108.2857
"26790","79190","2020",10,10,0,124425,811.7,149.5
"26791","79191","2020",1175,795,380,140633.7,1705.951,83.23149
"26792","79195","2020",52,52,0,105599.6,1065.731,96.44231
"26793","79196","2020",42,42,0,88644.31,886.4762,103.6905
"26794","79198","2020",4,4,0,97286.25,833,113.5
"26795","79200","2020",3,3,0,54000,647,79.33333
"26796","79201","2020",19,19,0,116474.5,984.1579,118.3158
"26797","79202","2020",192,162,30,107100.7,1190.312,89.19271
"26798","79203","2020",10,10,0,132760.4,1005.5,132.2
"26799","79204","2020",11,11,0,114090.9,987.3636,118.0909
"26800","79205","2020",2,2,0,33250,479.5,65.5
"26801","79207","2020",5,5,0,102620,1127.4,91.8
"26802","79208","2020",7,6,1,97957.14,974.8571,92.57143
"26803","79209","2020",8,8,0,59312.5,567,114.375
"26804","79210","2020",13,13,0,78466.92,921.1538,85.23077
"26805","79212","2020",6,6,0,121916.7,914.6667,136.6667
"26806","79213","2020",23,23,0,142728,1288.696,111.6522
"26807","79215","2020",4,3,1,84250,736.5,108.25
"26808","79216","2020",29,29,0,181845.1,1592.414,118.8966
"26809","79217","2020",12,12,0,176000,1269.5,142.5833
"26810","79218","2020",4,4,0,110250,924.75,125.5
"26811","79220","2020",8,8,0,211774.9,1314.75,155.625
"26812","79223","2020",2,2,0,189750,1240,165
"26813","79225","2020",5,5,0,111400,976.8,115.6
"26814","79226","2020",4,4,0,111625,829.75,140.25
"26815","79229","2020",10,10,0,184925,1356.1,136.3
"26816","79230","2020",14,14,0,78800,867.1429,98.78571
"26817","79231","2020",6,6,0,169500,1621.333,106.1667
"26818","79235","2020",12,12,0,117875,1136.75,100.8333
"26819","79236","2020",7,7,0,80285.71,716.1429,110.2857
"26820","79238","2020",6,6,0,133316.7,1102.5,120.6667
"26821","79239","2020",30,30,0,104620,1026.967,100.6
"26822","79241","2020",13,13,0,139480.8,1250.231,111.2308
"26823","79242","2020",15,15,0,115732.3,1017.867,109.6667
"26824","79243","2020",7,7,0,156754.7,1080.429,151.4286
"26825","79244","2020",3,3,0,156666.7,866.3333,150.3333
"26826","79246","2020",8,8,0,158752.1,1398.25,115.125
"26827","79249","2020",40,40,0,182597.5,1751.025,103.25
"26828","79250","2020",4,4,0,125850,1229.75,113.75
"26829","79251","2020",9,9,0,112666.7,976.8889,117
"26830","79252","2020",5,5,0,66800,618.2,95.4
"26831","79253","2020",9,9,0,133000,958.8889,136.3333
"26832","79254","2020",3,3,0,306603.3,1125.667,240.3333
"26833","79255","2020",3,3,0,101666.7,873.6667,113
"26834","79256","2020",5,5,0,86800,900.4,97
"26835","79257","2020",23,23,0,147816.9,1246.304,124.1739
"26836","79258","2020",6,6,0,73666.67,740.6667,96.16667
"26837","79259","2020",17,17,0,136391.4,1577.353,98.23529
"26838","79263","2020",7,7,0,108214.3,925.4286,114.7143
"26839","79265","2020",20,20,0,123051.8,1076.75,114.9
"26840","79267","2020",1,1,0,48000,774,62
"26841","79268","2020",16,16,0,78484.38,819.8125,96.0625
"26842","79269","2020",6,6,0,158416.7,1284.833,121.1667
"26843","79270","2020",111,100,11,101797.5,1082.369,95.67568
"26844","79271","2020",4,4,0,129750,1351.75,99
"26845","79273","2020",7,7,0,195214.3,1789.143,109.2857
"26846","79276","2020",15,15,0,159778.3,1396.267,118.7333
"26847","79277","2020",12,12,0,119750,1225.833,105.5833
"26848","79278","2020",2,2,0,107250,1188,84.5
"26849","79280","2020",15,15,0,109105.9,1228.6,108.7333
"26850","79281","2020",21,21,0,172619.1,1429.714,128.8095
"26851","79283","2020",19,19,0,173225.8,1563.684,111.0526
"26852","79284","2020",9,9,0,147388.9,1468.778,105.8889
"26853","79285","2020",29,29,0,126032.8,1036.621,123.7586
"26854","79286","2020",9,9,0,71355.56,743.5556,90.33333
"26855","79289","2020",9,9,0,134693.1,1354.556,99
"26856","79290","2020",14,14,0,129642.9,1105.929,115.2857
"26857","79293","2020",13,13,0,156161.5,1327.462,120
"26858","79294","2020",3,3,0,123333.3,1502,75.66667
"26859","79295","2020",5,5,0,135140,1022,131.8
"26860","79297","2020",9,9,0,107522.2,842.4444,140.1111
"26861","79298","2020",21,21,0,176002.4,1528.19,115.1905
"26862","79299","2020",29,29,0,109911.2,1081.966,102.2759
"26863","79300","2020",18,18,0,118933.3,1088.556,112.3889
"26864","79301","2020",6,6,0,143012.8,1216,117.5
"26865","79302","2020",30,29,1,137424,1158.633,119.8333
"26866","79303","2020",3,3,0,140640,1370.667,103.3333
"26867","79304","2020",10,9,1,154900,1402.9,107.5
"26868","79306","2020",1,1,0,152000,760,200
"26869","79307","2020",27,27,0,98688.89,890.2963,111.7778
"26870","79308","2020",12,12,0,203258.8,1657.583,122.3333
"26871","79309","2020",10,10,0,100054,910.7,108.3
"26872","79310","2020",4,4,0,148475,951.75,158.5
"26873","79311","2020",27,27,0,96414.07,1020.037,101.9259
"26874","79312","2020",2,2,0,107500,644.5,182
"26875","79313","2020",7,7,0,142407.1,1138.286,126
"26876","79316","2020",5,5,0,82300,689,122.8
"26877","79319","2020",6,6,0,127781.2,1020.5,123
"26878","79320","2020",10,10,0,138552.7,1159,121.2
"26879","79322","2020",25,24,1,129796.6,1152.84,116.32
"26880","79326","2020",15,15,0,101232.3,787.4667,124.5333
"26881","79329","2020",254,242,12,90850.19,969.8189,91.88189
"26882","79331","2020",1,1,0,133000,858,155
"26883","79332","2020",1,1,0,120000,952,126
"26884","79334","2020",26,26,0,150971.2,1227.154,126.1923
"26885","79335","2020",9,9,0,183802.2,1394.889,129.3333
"26886","79336","2020",1,1,0,85000,1604,53
"26887","79337","2020",12,12,0,134205,1238.25,104.5833
"26888","79338","2020",6,6,0,107025,780.1667,126.3333
"26889","79339","2020",39,39,0,102773.7,1031.59,106.5897
"26890","79340","2020",5,5,0,116280,1132.6,112.4
"26891","79341","2020",3,3,0,74663.33,1007,70
"26892","79342","2020",22,22,0,84903.05,789.8636,106.6364
"26893","79343","2020",4,4,0,122500,1037,117.5
"26894","79345","2020",12,12,0,79875,892.8333,89.08333
"26895","79346","2020",2,2,0,86000,880,96.5
"26896","79347","2020",14,14,0,113945.7,1360.714,100.6429
"26897","79348","2020",4,4,0,98825,890.75,117.75
"26898","79349","2020",1,1,0,77000,962,80
"26899","79350","2020",1,1,0,60000,2143,28
"26900","79351","2020",20,20,0,149793,1410.6,111.5
"26901","79352","2020",1,1,0,78000,667,117
"26902","79354","2020",11,11,0,97788.27,944.6364,103.6364
"26903","79355","2020",45,45,0,208043.8,1761.778,121.7778
"26904","79357","2020",2,2,0,161000,1027.5,156.5
"26905","80001","2020",279,200,79,122709.8,1532.86,82.03943
"26906","80002","2020",2,2,0,114500,1078,95.5
"26907","80003","2020",8,8,0,125512.5,985.125,147
"26908","80004","2020",2,2,0,152500,1666.5,92.5
"26909","80005","2020",2,2,0,130250,1241,103
"26910","80006","2020",1,1,0,85000,680,125
"26911","80008","2020",6,6,0,191030,1496.833,132.8333
"26912","80009","2020",8,8,0,141561.9,1355.5,109.875
"26913","80010","2020",28,28,0,162230.4,1631.143,102.3214
"26914","80011","2020",39,39,0,149067.1,1570,97.71795
"26915","80013","2020",21,20,1,118857.1,1245.524,99.71429
"26916","80015","2020",1,1,0,85000,885,96
"26917","80016","2020",122,109,13,112806.1,1355.008,84.65574
"26918","80017","2020",5,5,0,141185.4,1349.6,119.8
"26919","80018","2020",1,1,0,210000,1641,128
"26920","80019","2020",7,7,0,114071.4,1011,113.4286
"26921","80020","2020",5,5,0,299160,2054.8,170
"26922","80021","2020",1873,1009,864,158797.3,2261.248,72.19167
"26923","80022","2020",1,1,0,157000,654,240
"26924","80023","2020",2,2,0,104000,1232,88
"26925","80024","2020",3,3,0,296000,1889,151.6667
"26926","80025","2020",5,5,0,116180,1394,85.4
"26927","80028","2020",1,1,0,74500,784,95
"26928","80029","2020",9,9,0,168927.8,1815.222,99.11111
"26929","80030","2020",4,4,0,108750,1313,93.5
"26930","80031","2020",6,6,0,103333.3,1073.5,91.5
"26931","80032","2020",2,2,0,213350,1712.5,126
"26932","80033","2020",2,2,0,65000,731,90.5
"26933","80034","2020",7,7,0,101078.6,1078,89.85714
"26934","80036","2020",8,8,0,227668.8,1997.625,126.5
"26935","80038","2020",1,1,0,123000,976,126
"26936","80039","2020",82,58,24,112087.7,1729.207,67.73171
"26937","80040","2020",5,5,0,106456,1134,98
"26938","80042","2020",2,2,0,37775,635,59
"26939","80043","2020",3,3,0,77666.67,759.3333,94.66667
"26940","80044","2020",6,6,0,144608.3,1260.833,117.1667
"26941","80045","2020",1,1,0,77500,799,97
"26942","80046","2020",1,1,0,90000,833,108
"26943","80047","2020",7,7,0,187340,1857.143,96.71429
"26944","80048","2020",1,1,0,90000,1452,62
"26945","80049","2020",4,4,0,163375,1322.25,126.75
"26946","80050","2020",4,4,0,202750,2097.75,98.75
"26947","80051","2020",1,1,0,175000,2303,76
"26948","80052","2020",2,2,0,217645,1868.5,116.5
"26949","80053","2020",1,1,0,130000,949,137
"26950","80055","2020",2,2,0,75000,907,82
"26951","80057","2020",1,1,0,221520,1007,220
"26952","80058","2020",5,5,0,153800,1429.8,108
"26953","80060","2020",6,6,0,97416,1149,90.66667
"26954","80061","2020",5,5,0,71500,880.2,86
"26955","80062","2020",21,21,0,101316,1116.571,95.85714
"26956","80063","2020",13,13,0,119424.2,1283.385,91.76923
"26957","80065","2020",1,1,0,230000,1655,139
"26958","80066","2020",3,3,0,175200,1217,146
"26959","80067","2020",2,2,0,217500,1421.5,157.5
"26960","80068","2020",3,3,0,154500,1420.333,109.6667
"26961","80069","2020",3,3,0,119666.7,1247.333,93.33333
"26962","80070","2020",7,7,0,114857.1,1289.286,90.57143
"26963","80071","2020",31,31,0,92566.55,1072.613,84.67742
"26964","80073","2020",1,1,0,105000,577,182
"26965","80076","2020",5,5,0,108900,1215,89.4
"26966","80077","2020",4,4,0,173305.5,1769,98.25
"26967","80078","2020",3,3,0,197783.3,1568,130.6667
"26968","80079","2020",4,4,0,177125,1417.25,121.5
"26969","80080","2020",2,2,0,115000,1517.5,73
"26970","80082","2020",15,15,0,159132,1763,94.53333
"26971","80083","2020",2,2,0,169350,1456,134
"26972","80086","2020",14,14,0,97811.79,1031.786,96.78571
"26973","80087","2020",6,6,0,187716.7,1802,107.1667
"26974","80088","2020",5,5,0,89460,1119.4,80.6
"26975","80090","2020",2,2,0,54000,880.5,62
"26976","80092","2020",4,4,0,204125,2092.25,95.25
"26977","80093","2020",16,16,0,105425,1055.375,99.5625
"26978","80094","2020",7,7,0,180007.1,1675.286,116
"26979","80095","2020",3,3,0,158333.3,1288.333,124.6667
"26980","80096","2020",11,11,0,98571.82,1167.636,85.72727
"26981","80097","2020",2,2,0,169800,1332,126
"26982","80099","2020",2,2,0,174000,1471,119.5
"26983","80100","2020",2,2,0,116000,1305,86.5
"26984","80101","2020",4,4,0,123250,1447.25,86.25
"26985","80102","2020",4,4,0,112550,1372.75,85
"26986","80103","2020",1,1,0,250000,1202,208
"26987","80105","2020",1,1,0,30000,441,68
"26988","80106","2020",3,3,0,212133.3,1470,146.3333
"26989","80107","2020",4,4,0,146517.5,1961,74.25
"26990","80108","2020",2,2,0,125000,723,177.5
"26991","80109","2020",10,10,0,119100,1371.7,97.8
"26992","80110","2020",9,9,0,190539.1,1915.444,102
"26993","80112","2020",2,2,0,1e+05,1210,79
"26994","80113","2020",4,4,0,134000,1579.5,92.25
"26995","80114","2020",5,5,0,198360,1678.8,117.8
"26996","80116","2020",5,5,0,117080,833,142.6
"26997","80117","2020",1,1,0,190000,2568,74
"26998","80118","2020",4,4,0,79500,1027.75,75.5
"26999","80119","2020",5,5,0,121820,1219.6,109.8
"27000","80120","2020",5,5,0,175400,2088,86
"27001","80121","2020",2,2,0,159372.5,1047,152.5
"27002","80122","2020",3,3,0,90666.67,1401.667,64.66667
"27003","80123","2020",7,7,0,166671.4,1728.429,97.42857
"27004","80124","2020",9,9,0,155302.8,1493.778,110.7778
"27005","80125","2020",2,2,0,129000,978,127
"27006","80126","2020",6,6,0,109166.7,1214.167,89
"27007","80127","2020",7,7,0,111842.9,1325,91.57143
"27008","80128","2020",1,1,0,80000,1212,66
"27009","80129","2020",5,5,0,109176.8,1416.8,89
"27010","80130","2020",1,1,0,272000,1876,145
"27011","80131","2020",38,37,1,268980.9,2269.395,107.4737
"27012","80132","2020",3,3,0,143166.7,1356,94.33333
"27013","80133","2020",5,5,0,186420,1452,120
"27014","80135","2020",1,1,0,80000,1667,48
"27015","80136","2020",14,14,0,115057.1,1496,90.28571
"27016","80137","2020",4,4,0,194411.2,1896,106.5
"27017","80138","2020",1,1,0,140000,1167,120
"27018","80140","2020",3,3,0,68333.33,950,77
"27019","80141","2020",5,5,0,126170,1051.8,112.8
"27020","80142","2020",4,4,0,142500,1667.75,89.25
"27021","80143","2020",5,5,0,123600,1274.8,100.8
"27022","80144","2020",9,9,0,112333.3,1050.333,105.2222
"27023","80145","2020",2,2,0,117500,1269,90
"27024","80146","2020",2,2,0,1e+05,1775,57
"27025","80147","2020",3,3,0,128866.7,1195.333,100.6667
"27026","80148","2020",5,5,0,124850,1481.4,95.6
"27027","80149","2020",4,4,0,215490.2,2048.25,100.25
"27028","80150","2020",1,1,0,146500,1382,106
"27029","80151","2020",3,3,0,125000,1423,84.66667
"27030","80152","2020",7,7,0,98771.43,1596.714,67.28571
"27031","80153","2020",1,1,0,85000,1062,80
"27032","80155","2020",2,2,0,142000,974.5,146
"27033","80156","2020",7,7,0,210192.9,1672.714,122.1429
"27034","80158","2020",3,3,0,149473.3,1043.667,146
"27035","80159","2020",3,3,0,245333.3,2177.333,117.6667
"27036","80160","2020",12,12,0,203608.3,2443.25,88.66667
"27037","80161","2020",1,1,0,145493,1164,125
"27038","80162","2020",12,12,0,114096.7,1523.25,76.5
"27039","80163","2020",3,3,0,125166.7,1227.333,99
"27040","80164","2020",51,50,1,175529,2044.216,85.58824
"27041","80165","2020",1,1,0,130000,2766,47
"27042","80166","2020",3,3,0,75500,943.6667,80.66667
"27043","80167","2020",6,6,0,176383.3,1459.333,127.8333
"27044","80168","2020",16,16,0,141953.1,1274.562,122.5625
"27045","80170","2020",1,1,0,281000,1171,240
"27046","80171","2020",8,8,0,171000,1495.25,116.375
"27047","80172","2020",9,9,0,67833.33,1214.556,66.88889
"27048","80173","2020",3,3,0,201295,2325.667,89.33333
"27049","80174","2020",5,5,0,149970,1555,94.2
"27050","80176","2020",4,4,0,119625,1896.75,68
"27051","80177","2020",7,7,0,119478.6,882.5714,146.1429
"27052","80179","2020",2,2,0,144080,1374.5,107
"27053","80180","2020",1,1,0,82000,1025,80
"27054","80181","2020",1,1,0,130000,1300,100
"27055","80182","2020",144,99,45,120353.8,2214.729,58.79861
"27056","80183","2020",1,1,0,41000,471,87
"27057","80184","2020",7,7,0,122547,1254.857,94.14286
"27058","80185","2020",2,2,0,120000,1355.5,88.5
"27059","80186","2020",17,17,0,121757.6,1207.882,107.4706
"27060","80187","2020",5,5,0,121100,1646,77.2
"27061","80188","2020",4,4,0,98750,989.25,125.5
"27062","80189","2020",2,2,0,147450,1472,100.5
"27063","80190","2020",8,7,1,126312.5,1157.75,112.25
"27064","80191","2020",2,2,0,111625,1171,89.5
"27065","80192","2020",3,3,0,112000,1001,104.3333
"27066","80193","2020",4,4,0,98250,880,114.25
"27067","80195","2020",2,2,0,58000,765,81.5
"27068","80196","2020",3,3,0,100730,1135,88.33333
"27069","80198","2020",5,5,0,251030,2583.2,100.2
"27070","80199","2020",8,8,0,88572.25,1228.75,78.125
"27071","80200","2020",2,2,0,160000,1956,80.5
"27072","80202","2020",2,2,0,81350,1175,55
"27073","80203","2020",2,2,0,147475,1483,100
"27074","80204","2020",12,12,0,111133.3,970.25,119
"27075","80205","2020",19,19,0,111247.4,1380.632,89.52632
"27076","80207","2020",2,2,0,124500,1178,108.5
"27077","80208","2020",2,2,0,60000,912,64
"27078","80210","2020",1,1,0,95000,1827,52
"27079","80211","2020",20,20,0,141741.2,1542.65,90.75
"27080","80212","2020",85,78,7,151938.5,1743.282,88.2
"27081","80213","2020",7,7,0,179228.6,1997.857,97.57143
"27082","80214","2020",9,9,0,127375.6,1344.111,94.44444
"27083","80216","2020",2,2,0,81000,793,110
"27084","80220","2020",2,2,0,146200,1095,122.5
"27085","80221","2020",3,3,0,120833.3,1181.333,105.6667
"27086","80222","2020",13,12,1,117307.7,1306.231,98.92308
"27087","80223","2020",3,3,0,158650,1644.333,94.33333
"27088","80224","2020",3,3,0,194887.7,1422.667,149.3333
"27089","80225","2020",1,1,0,187690,2085,90
"27090","80226","2020",3,3,0,152000,1131,124.6667
"27091","80227","2020",4,4,0,170750,1998.75,95
"27092","80228","2020",92,72,20,215265.4,3244.609,71.61957
"27093","80229","2020",9,5,4,157326.9,1568.333,101.2222
"27094","80230","2020",3,3,0,134833.3,1165.667,117
"27095","80231","2020",1,1,0,158000,752,210
"27096","80232","2020",1,1,0,119000,1082,110
"27097","80233","2020",1,1,0,79500,704,113
"27098","80234","2020",9,9,0,137600,1655.778,86.33333
"27099","80235","2020",13,13,0,110561.5,1337.462,87.15385
"27100","80236","2020",9,9,0,143031.8,1272.667,109.3333
"27101","80237","2020",11,11,0,140818.2,1623.818,87.81818
"27102","80238","2020",6,6,0,136083.3,1313,104.8333
"27103","80239","2020",1,1,0,55000,982,56
"27104","80240","2020",21,20,1,124353.6,1303.571,99.47619
"27105","80241","2020",15,15,0,157336.7,1492.533,121.2
"27106","80242","2020",5,5,0,146700,1930,75.8
"27107","80244","2020",4,4,0,114950,1159.75,117
"27108","80245","2020",1,1,0,143000,1723,83
"27109","80246","2020",2,2,0,126000,1220.5,101.5
"27110","80247","2020",9,9,0,84644.44,1028,90.88889
"27111","80248","2020",9,9,0,111444.4,1447.444,83.77778
"27112","80249","2020",7,7,0,152185.7,1647.857,113
"27113","80250","2020",7,7,0,122250,1076.857,104.5714
"27114","80251","2020",4,4,0,140812.5,1472.25,100.25
"27115","80252","2020",4,4,0,113500,1569,82
"27116","80253","2020",74,60,14,104048.3,1227.257,83.86486
"27117","80256","2020",20,18,2,173500,2057.85,88.9
"27118","80258","2020",2,2,0,87780,1232.5,74
"27119","80259","2020",1,1,0,20000,345,58
"27120","80260","2020",6,6,0,187666.7,1688.167,114.1667
"27121","80261","2020",18,17,1,476461,3142.778,155.9444
"27122","80262","2020",6,6,0,141091.5,1573.833,89.66667
"27123","80263","2020",1,1,0,175000,1768,99
"27124","80264","2020",4,4,0,68420,950,74.5
"27125","80265","2020",4,4,0,146375,1596.75,93.25
"27126","80266","2020",3,3,0,163000,1393.333,116.6667
"27127","80267","2020",4,4,0,97825,1232.75,79.5
"27128","80268","2020",7,7,0,164714.3,1443.571,107.1429
"27129","80269","2020",1,1,0,130000,619,210
"27130","80270","2020",1,1,0,130000,674,193
"27131","80271","2020",14,14,0,91006.43,933.9286,93.78571
"27132","80272","2020",2,2,0,54500,641.5,87.5
"27133","80273","2020",6,6,0,118900,1239.667,95.66667
"27134","80274","2020",24,23,1,96516.67,1064.917,92.75
"27135","80275","2020",4,4,0,112147.5,1334.5,80.25
"27136","80276","2020",5,5,0,100160,1056.2,87.8
"27137","80278","2020",5,5,0,139491,1168.4,138.4
"27138","80279","2020",13,13,0,99800,1113.846,93.46154
"27139","80280","2020",2,2,0,82000,967,82.5
"27140","80282","2020",7,7,0,136800,1563.143,88.28571
"27141","80283","2020",3,3,0,170733.3,1283.333,135.3333
"27142","80284","2020",7,7,0,80714.29,896.1429,83.28571
"27143","80285","2020",2,2,0,100400,1237,76.5
"27144","80287","2020",4,4,0,245000,2025.5,121.5
"27145","80288","2020",2,2,0,100500,891,112.5
"27146","80290","2020",5,5,0,122300,1187.6,106
"27147","80291","2020",3,3,0,216666.7,2097.667,103
"27148","80292","2020",2,2,0,172500,862,167.5
"27149","80293","2020",2,2,0,115000,1457,78.5
"27150","80294","2020",1,1,0,60000,800,75
"27151","80295","2020",8,8,0,77812.5,1195.75,63.5
"27152","80296","2020",16,16,0,100077.1,1067.438,91.875
"27153","80297","2020",1,1,0,236550,2232,106
"27154","80298","2020",5,5,0,116571,1035.4,116.6
"27155","80299","2020",1,1,0,115000,1139,101
"27156","80300","2020",5,5,0,191810,1402.2,129
"27157","80301","2020",2,2,0,151500,1425,105.5
"27158","80302","2020",1,1,0,119000,1506,79
"27159","80303","2020",4,4,0,146212.5,2185.25,73
"27160","80304","2020",1,1,0,128050,963,133
"27161","80305","2020",7,7,0,232457.1,2464.143,96.85714
"27162","80306","2020",1,1,0,130000,1667,78
"27163","80307","2020",4,4,0,145566.8,1658.75,86.5
"27164","80308","2020",27,27,0,117403.7,1336.333,90.74074
"27165","80310","2020",8,8,0,136675,1431.25,99.375
"27166","80311","2020",3,3,0,111666.7,1065.333,101.3333
"27167","80312","2020",7,7,0,108471.4,1127.143,100.7143
"27168","80313","2020",3,3,0,117400,1255.333,113.3333
"27169","80314","2020",1,1,0,119731,1710,70
"27170","80315","2020",4,4,0,196775,1585.25,128
"27171","80316","2020",15,15,0,170466.7,1746.133,99.46667
"27172","80317","2020",3,3,0,125666.7,1117,114.6667
"27173","80318","2020",32,32,0,104444.7,1123.375,91.46875
"27174","80319","2020",1,1,0,173000,1680,103
"27175","80320","2020",2,2,0,118500,1140.5,99.5
"27176","80321","2020",6,6,0,185158.3,1527.5,142.1667
"27177","80322","2020",2,2,0,98500,1061,105
"27178","80324","2020",2,2,0,182000,1181,151
"27179","80325","2020",1,1,0,60000,750,80
"27180","80326","2020",1,1,0,160000,1404,114
"27181","80327","2020",1,1,0,92000,1136,81
"27182","80328","2020",8,8,0,78191.25,841.625,82.375
"27183","80329","2020",1,1,0,196100,1431,137
"27184","80330","2020",1,1,0,1e+05,658,152
"27185","80331","2020",6,6,0,142350,1244,114.6667
"27186","80332","2020",6,6,0,158750,1352.833,121.3333
"27187","80333","2020",150,59,91,158379.9,3212.94,51.96
"27188","80334","2020",1,1,0,285000,1939,147
"27189","80335","2020",4,4,0,124892.5,1674.25,94.5
"27190","80336","2020",1,1,0,140000,1273,110
"27191","80337","2020",2,2,0,175000,1157,145.5
"27192","80338","2020",12,11,1,123706.7,1247.5,94.25
"27193","80339","2020",1,1,0,135000,985,137
"27194","80341","2020",3,3,0,146333.3,1707.333,86
"27195","80342","2020",3,3,0,84333.33,825.3333,92
"27196","80343","2020",1,1,0,199180,1934,103
"27197","80344","2020",2,2,0,161250,1315.5,119.5
"27198","80345","2020",3,3,0,82666.67,1059.667,73.33333
"27199","80346","2020",3,3,0,107000,1176,90
"27200","80347","2020",4,4,0,135050,1164,118.75
"27201","80348","2020",3,3,0,119666.7,1418,90
"27202","80350","2020",9,9,0,153780,1741.667,94.11111
"27203","80351","2020",3,3,0,172333.3,1299.333,123.6667
"27204","80352","2020",4,4,0,175750,1611,110
"27205","80353","2020",1,1,0,137500,1261,109
"27206","80354","2020",1,1,0,91000,1379,66
"27207","80355","2020",1,1,0,150000,1724,87
"27208","80357","2020",3,3,0,97733.33,1110.667,95.33333
"27209","80360","2020",21,21,0,95761.9,1134.333,81.71429
"27210","80361","2020",1,1,0,145000,1318,110
"27211","80362","2020",4,4,0,147937.5,1615.5,92
"27212","80364","2020",12,12,0,131481,1472.083,94.16667
"27213","80365","2020",1,1,0,175000,845,207
"27214","80366","2020",7,7,0,119735.7,1336.857,95.71429
"27215","80367","2020",4,4,0,50250,1069.5,56.75
"27216","80368","2020",45,36,9,98683.11,1236.8,82.22222
"27217","80371","2020",1,1,0,135000,1570,86
"27218","80372","2020",2,2,0,70250,931,97
"27219","80373","2020",47,47,0,92594.26,1210.468,80.23404
"27220","80374","2020",3,3,0,140650,1006.333,135.6667
"27221","80375","2020",2,2,0,148500,1407,105.5
"27222","80376","2020",11,11,0,228254.5,2112.727,109.0909
"27223","80377","2020",5,5,0,113200,1102.6,98.8
"27224","80378","2020",1,1,0,30000,435,69
"27225","80379","2020",8,8,0,249150,2036,126.75
"27226","80380","2020",2,2,0,72007.5,829,93.5
"27227","80381","2020",1,1,0,128000,1067,120
"27228","80383","2020",1,1,0,102000,1545,66
"27229","80384","2020",1,1,0,70000,778,90
"27230","80385","2020",5,5,0,208680,1887.4,118
"27231","80386","2020",2,2,0,129000,1169.5,116
"27232","80387","2020",2,2,0,260450,2055,127
"27233","80388","2020",2,2,0,132625,1093.5,118
"27234","80390","2020",6,6,0,147166.7,1401.333,125.3333
"27235","80392","2020",2,2,0,107500,934.5,116
"27236","80393","2020",5,5,0,163000,1298.6,128.4
"27237","80395","2020",3,3,0,119195.3,1410.333,84.66667
"27238","80396","2020",2,2,0,173750,1177,147
"27239","80399","2020",2,2,0,209500,1973.5,104.5
"27240","80400","2020",7,7,0,152880,1775,88.71429
"27241","80402","2020",2,2,0,95000,701.5,141
"27242","80403","2020",4,4,0,158125,2632.75,69.5
"27243","80405","2020",7,7,0,183082.9,1679.857,105.8571
"27244","80406","2020",13,13,0,85834.62,1024.462,84.76923
"27245","80407","2020",3,3,0,145333.3,1797.667,87.66667
"27246","80408","2020",3,3,0,95000,1009.667,93
"27247","80409","2020",3,3,0,97666.67,1226.667,81
"27248","80410","2020",51,48,3,81361.75,918.2941,93.31373
"27249","80411","2020",10,10,0,146044,1800,84.5
"27250","80412","2020",5,5,0,118400,1420.4,77
"27251","80413","2020",3,3,0,95471.33,991,110.3333
"27252","80415","2020",15,15,0,168464,1584.533,112.6
"27253","80416","2020",7,7,0,144614.3,1515.143,91.57143
"27254","80417","2020",15,15,0,94398.67,1264.6,80
"27255","80418","2020",1,1,0,56000,1400,40
"27256","80420","2020",2,2,0,108982.5,953,111
"27257","80421","2020",4,4,0,140600,1503.5,92.75
"27258","80422","2020",7,7,0,175500,1525.429,115.5714
"27259","80423","2020",3,3,0,197115,1783.667,116.3333
"27260","80424","2020",6,6,0,261066.7,2240.167,129.1667
"27261","80425","2020",3,3,0,110333.3,1093.667,102
"27262","80426","2020",6,6,0,156083.3,1323,109.1667
"27263","80427","2020",3,3,0,211116.7,1450.333,147.3333
"27264","80428","2020",3,3,0,80666.67,1062.667,72
"27265","80429","2020",2,2,0,102500,842.5,127
"27266","80430","2020",4,4,0,132800,1032,128.25
"27267","80431","2020",2,2,0,226700,2954,78
"27268","80432","2020",1,1,0,192800,736,262
"27269","80434","2020",5,5,0,101860,1052.2,88.8
"27270","80436","2020",8,8,0,121375,1199,103.5
"27271","80437","2020",2,2,0,135160,1534,95.5
"27272","80438","2020",7,7,0,80074.29,861.2857,89.14286
"27273","80439","2020",1,1,0,33000,458,72
"27274","80440","2020",1,1,0,114000,870,131
"27275","80442","2020",15,15,0,109614.4,872.6,135.4667
"27276","80443","2020",19,19,0,110072.4,1120,101.1053
"27277","80444","2020",5,5,0,136440,1283.2,106.2
"27278","80445","2020",2,2,0,103000,1159.5,94
"27279","80446","2020",6,6,0,127450,1065.5,115.6667
"27280","80449","2020",2,2,0,131000,1730,86.5
"27281","80450","2020",1,1,0,60000,1500,40
"27282","80452","2020",5,5,0,183776,1477.2,127.8
"27283","80455","2020",1,1,0,75000,1230,61
"27284","80456","2020",9,9,0,131300,1515.111,96
"27285","80458","2020",6,6,0,224748.3,1773,130.5
"27286","80459","2020",2,2,0,109000,893.5,122
"27287","80461","2020",2,2,0,372725,2450,176
"27288","80462","2020",4,4,0,152500,1267,135
"27289","80463","2020",11,11,0,179422.7,2066.273,97.45455
"27290","80464","2020",13,13,0,173196.1,1792.846,99.76923
"27291","80465","2020",3,3,0,127883.3,1195,127.3333
"27292","80466","2020",1,1,0,38000,452,84
"27293","80468","2020",1,1,0,183000,1989,92
"27294","80469","2020",3,3,0,163233.3,2387.667,79
"27295","80470","2020",2,2,0,155050,1365,116
"27296","80473","2020",6,6,0,139833.3,1177,122.1667
"27297","80474","2020",3,3,0,107503.7,1038.667,113
"27298","80475","2020",2,2,0,120000,1271.5,92
"27299","80476","2020",4,4,0,94375,1160,81.25
"27300","80477","2020",1,1,0,25000,556,45
"27301","80479","2020",2,2,0,90000,657.5,132.5
"27302","80481","2020",5,5,0,111258,1241.2,89.8
"27303","80482","2020",2,2,0,86500,1224.5,66.5
"27304","80484","2020",6,6,0,77250,908.5,93.16667
"27305","80485","2020",3,3,0,157000,1642,100
"27306","80486","2020",11,11,0,107209.1,1255,87.18182
"27307","80487","2020",3,3,0,193447.3,1290.667,137.3333
"27308","80488","2020",20,20,0,106119.8,1609.65,75.5
"27309","80489","2020",57,49,8,157945.6,2098.246,76.82456
"27310","80490","2020",2,2,0,79150,1006.5,78.5
"27311","80493","2020",1,1,0,45000,375,120
"27312","80494","2020",3,3,0,139666.7,1213.667,117.3333
"27313","80495","2020",4,4,0,103087.5,723.75,133.5
"27314","80496","2020",5,5,0,176200,1882.2,93
"27315","80497","2020",2,2,0,257500,1693,165.5
"27316","80498","2020",10,10,0,114660,967.8,117.1
"27317","80499","2020",2,2,0,172500,1753.5,99
"27318","80500","2020",3,3,0,111333.3,1475.667,73.66667
"27319","80501","2020",4,4,0,102475,1104.75,97.25
"27320","80502","2020",2,2,0,91200,1177,77.5
"27321","80503","2020",1,1,0,1e+05,901,111
"27322","80504","2020",1,1,0,80000,952,84
"27323","80505","2020",2,2,0,95200,1339.5,70.5
"27324","80507","2020",14,13,1,173642.1,1819.571,97.64286
"27325","80511","2020",1,1,0,173000,1802,96
"27326","80512","2020",14,14,0,134871.4,1548.857,91.28571
"27327","80513","2020",3,3,0,127250,1056.333,98
"27328","80514","2020",3,3,0,114333.3,921,124.6667
"27329","80515","2020",1,1,0,155000,1250,124
"27330","80516","2020",3,3,0,76066.67,953.3333,88
"27331","80517","2020",2,2,0,167000,1317,123
"27332","80518","2020",9,9,0,111344.4,1261.444,91.66667
"27333","80519","2020",5,5,0,91400,1093.2,90.8
"27334","80520","2020",8,8,0,107092.5,1102.25,95.875
"27335","80521","2020",3,3,0,130380,991.3333,133.3333
"27336","80522","2020",1,1,0,148000,1057,140
"27337","80523","2020",13,13,0,118507.7,1248.308,94.84615
"27338","80524","2020",8,8,0,154281.2,1459.875,105.75
"27339","80525","2020",3,3,0,162333.3,1490,105.6667
"27340","80526","2020",5,5,0,181680,1403.8,125.8
"27341","80527","2020",3,3,0,91466.67,1152,91.66667
"27342","80528","2020",2,2,0,126000,1306.5,108.5
"27343","80529","2020",3,3,0,200666.7,1956.667,101.6667
"27344","80530","2020",5,5,0,171800,1682,103
"27345","80531","2020",1,1,0,104000,1387,75
"27346","80533","2020",111,53,58,95058.61,1802.667,56.11712
"27347","80535","2020",2,2,0,77500,1156.5,56
"27348","80536","2020",1,1,0,56500,856,66
"27349","80540","2020",4,4,0,98325,1139,85.25
"27350","80541","2020",2,2,0,137500,2000,67.5
"27351","80542","2020",6,6,0,140270.8,1704.5,84.83333
"27352","80543","2020",1,1,0,27500,353,78
"27353","80544","2020",2,2,0,114000,1129.5,92
"27354","80545","2020",7,7,0,133761.4,1479.714,98
"27355","80546","2020",7,7,0,187450,1525.857,119.7143
"27356","80547","2020",3,3,0,158500,1594,97
"27357","80548","2020",8,8,0,119750,1354.5,92.375
"27358","80549","2020",6,6,0,127666.7,1421.667,93
"27359","80552","2020",14,14,0,87866.43,983.4286,92.5
"27360","80553","2020",4,4,0,156975,1792.25,98.5
"27361","80554","2020",13,12,1,128811.5,1326.538,106
"27362","80555","2020",8,8,0,148281.2,1059.625,142.5
"27363","80556","2020",5,5,0,155172,1822.8,83.8
"27364","80557","2020",7,7,0,250517.1,1355,135.5714
"27365","80558","2020",1,1,0,140000,2090,67
"27366","80559","2020",1,1,0,129800,2060,63
"27367","80560","2020",4,4,0,132625,1159.25,113.75
"27368","80561","2020",64,62,2,116399.8,1417.375,86.0625
"27369","80562","2020",4,4,0,240787.5,2077.75,121.75
"27370","80563","2020",1,1,0,70000,833,84
"27371","80565","2020",1,1,0,267000,1420,188
"27372","80566","2020",5,5,0,102550,868.6,114
"27373","80568","2020",3,3,0,122000,1546,78.33333
"27374","80569","2020",6,6,0,116500,1183.167,98.5
"27375","80570","2020",38,38,0,128187.4,1679.526,79.73684
"27376","80571","2020",2,2,0,170000,1949,88
"27377","80572","2020",6,6,0,149558.3,1800.167,83.33333
"27378","80573","2020",5,5,0,121600,1563.4,84
"27379","80574","2020",2,2,0,150250,1558,96.5
"27380","80575","2020",1,1,0,95000,1319,72
"27381","80576","2020",5,5,0,98144,1135.8,89.4
"27382","80577","2020",3,3,0,145500,1771,81.66667
"27383","80578","2020",5,5,0,143900,1566.8,94.6
"27384","80579","2020",10,10,0,89650,1040.4,85.1
"27385","80580","2020",9,9,0,160045.6,1600.778,94.88889
"27386","80582","2020",11,11,0,152572.7,1692.273,94
"27387","80583","2020",5,5,0,194390,2030,94.6
"27388","80584","2020",18,18,0,176254.2,1648.5,107.5556
"27389","80585","2020",32,32,0,98187.5,1029.406,97.5
"27390","80586","2020",4,4,0,98250,905.75,114.5
"27391","80587","2020",1,1,0,46000,1070,43
"27392","80588","2020",7,7,0,135250,1307,102.4286
"27393","80589","2020",1,1,0,90000,1084,83
"27394","80590","2020",2,2,0,156300,1522.5,103
"27395","80592","2020",5,5,0,86700,1075,82.2
"27396","80593","2020",7,7,0,107728.6,1238.143,91.42857
"27397","80595","2020",4,4,0,174875,1713.25,101.5
"27398","80596","2020",2,2,0,95000,813,117.5
"27399","80597","2020",10,10,0,99500,1218.3,79.6
"27400","80598","2020",10,10,0,171116.3,1515.2,118
"27401","80599","2020",2,2,0,142925,1073,131.5
"27402","80600","2020",9,9,0,219351.4,2222.222,107.1111
"27403","80601","2020",6,6,0,143104.2,1009.833,138.1667
"27404","80602","2020",1,1,0,65000,867,75
"27405","80603","2020",7,7,0,126707.1,1532,81.85714
"27406","80604","2020",1,1,0,50000,562,89
"27407","80605","2020",2,2,0,130750,1188.5,145.5
"27408","80606","2020",7,7,0,87271.43,1058.571,84.14286
"27409","80607","2020",1,1,0,168200,2273,74
"27410","80609","2020",4,4,0,202542.5,1483,155.75
"27411","80611","2020",18,18,0,164596.9,1668.5,104.3889
"27412","80613","2020",10,10,0,128380,1355,97.6
"27413","80614","2020",3,3,0,101666.7,944.3333,107.6667
"27414","80615","2020",2,2,0,136500,1368,112
"27415","80616","2020",1,1,0,39550,618,64
"27416","80617","2020",3,3,0,109666.7,1237.333,91.66667
"27417","80618","2020",15,15,0,129991.8,1445.4,89.26667
"27418","80619","2020",11,11,0,175336.4,1662.545,99.18182
"27419","80620","2020",78,71,7,113541.1,1195.859,95.67949
"27420","80621","2020",5,5,0,108400,982.4,115
"27421","80622","2020",24,24,0,136131.2,1504.958,90.29167
"27422","80624","2020",6,6,0,158033.3,1703.333,92.66667
"27423","80625","2020",15,15,0,128120,1699,83.06667
"27424","80626","2020",3,3,0,178666.7,1276.667,141.3333
"27425","80627","2020",12,12,0,230360.6,2100.5,108.5
"27426","80628","2020",5,5,0,137100,1289.4,106.6
"27427","80629","2020",1,1,0,126000,1145,110
"27428","80630","2020",22,22,0,142098.4,1483.818,108.6364
"27429","80631","2020",2,2,0,72000,1106,67
"27430","80632","2020",36,26,10,226286.5,2534.861,92.72222
"27431","80633","2020",15,15,0,147170,1577.067,95.06667
"27432","80634","2020",13,13,0,194231.5,1981.846,99.92308
"27433","80635","2020",21,21,0,89140,1169.524,76.71429
"27434","80637","2020",2,2,0,158145,1398,113
"27435","80639","2020",8,8,0,227940,1954.125,118
"27436","80640","2020",2,2,0,136850,1283,109
"27437","80642","2020",4,4,0,147735,1130.5,133.25
"27438","80643","2020",4,4,0,230750,1523.25,142.75
"27439","80644","2020",10,10,0,105270,1058.9,101.1
"27440","80645","2020",5,5,0,130314,1419.2,109
"27441","80647","2020",5,5,0,125992,1231.6,106
"27442","80648","2020",5,5,0,107860,1313.4,87.4
"27443","80649","2020",106,67,39,154738,2719,61.54717
"27444","80650","2020",9,9,0,171734.4,1924.778,86.77778
"27445","80651","2020",4,4,0,52500,844.75,65.25
"27446","80652","2020",15,15,0,136289.1,1597.4,96.8
"27447","80654","2020",5,5,0,109365,1373.6,77
"27448","80655","2020",11,11,0,73409.09,977.6364,77.72727
"27449","80656","2020",13,12,1,175995.8,1690.077,109.5385
"27450","80657","2020",4,4,0,131625,1493.5,100
"27451","80658","2020",2,2,0,86350,856.5,106.5
"27452","80659","2020",2,2,0,208725,1281.5,189.5
"27453","80661","2020",6,6,0,205566.7,1864,119.8333
"27454","80662","2020",1,1,0,60000,462,130
"27455","80663","2020",4,4,0,60750,990.25,61.5
"27456","80664","2020",1,1,0,110000,743,148
"27457","80665","2020",4,4,0,225000,2336,97.25
"27458","80667","2020",1,1,0,154500,1266,122
"27459","80669","2020",6,6,0,131416.7,1397,94.33333
"27460","80670","2020",6,6,0,196875,1842.667,111.1667
"27461","80671","2020",2,2,0,104950,823.5,123
"27462","80672","2020",11,11,0,166329.1,1827.091,90.81818
"27463","80673","2020",3,3,0,157666.7,1451.667,117.6667
"27464","80674","2020",55,53,2,163084,2007.509,82.4
"27465","80675","2020",1,1,0,107000,1372,78
"27466","80676","2020",2,2,0,57500,622.5,89
"27467","80677","2020",24,24,0,76611.04,824.625,94.79167
"27468","80678","2020",8,8,0,147875,1582.5,102.25
"27469","80679","2020",8,8,0,82927.5,1050,88.125
"27470","80680","2020",27,27,0,107335.6,1224.259,94.44444
"27471","80681","2020",2,2,0,77500,999,74
"27472","80682","2020",2,2,0,74425,1435,52.5
"27473","80684","2020",1,1,0,35000,398,88
"27474","80685","2020",60,49,11,92090,1253.55,76.6
"27475","80686","2020",7,7,0,221500,1519.857,150.5714
"27476","80687","2020",1,1,0,95000,1484,64
"27477","80688","2020",42,40,2,149403.6,1756.333,92.28571
"27478","80690","2020",10,10,0,271152.2,1989,143.5
"27479","80691","2020",5,5,0,118740,1558.4,76.4
"27480","80692","2020",9,9,0,189777.8,1600.667,116.4444
"27481","80693","2020",1,1,0,141000,1128,125
"27482","80694","2020",3,3,0,95533.33,1483,70.66667
"27483","80695","2020",7,7,0,102564.3,1376,75.14286
"27484","80696","2020",15,15,0,361470.3,2241.4,158
"27485","80697","2020",2,2,0,233750,972,231.5
"27486","80698","2020",2,2,0,147500,1970.5,84
"27487","80699","2020",1,1,0,129000,1252,103
"27488","80700","2020",10,10,0,106000,1323.5,84.4
"27489","80701","2020",2,2,0,103850,741.5,126
"27490","80702","2020",18,18,0,308638.9,2326.278,132.3333
"27491","80703","2020",6,6,0,87283.33,812.1667,106.8333
"27492","80704","2020",4,4,0,120500,1696.75,74.75
"27493","80706","2020",20,20,0,110052.5,1160.35,92.4
"27494","80707","2020",1,1,0,73500,845,87
"27495","80708","2020",1,1,0,160000,1839,87
"27496","80709","2020",1,1,0,205000,1723,119
"27497","80710","2020",7,7,0,120192.9,1250.714,102.8571
"27498","80711","2020",28,28,0,89075,1037.821,85.71429
"27499","80713","2020",2,2,0,182500,2360,77.5
"27500","80714","2020",9,9,0,122744.4,1616.778,84.77778
"27501","80716","2020",10,10,0,121843,1142.6,101.1
"27502","80717","2020",17,16,1,165960.6,1634,110.6471
"27503","80718","2020",14,14,0,156121.4,1657,95.92857
"27504","80719","2020",1,1,0,76000,1056,72
"27505","80721","2020",45,36,9,275378.6,3299.2,85.13333
"27506","80722","2020",10,10,0,143918,1414.9,100
"27507","80724","2020",32,32,0,243582.1,2193.25,108.875
"27508","80725","2020",29,20,9,215812.3,2309.931,95.17241
"27509","80726","2020",3,3,0,124333.3,1455.667,86.66667
"27510","80728","2020",1,1,0,170000,1910,89
"27511","80729","2020",4,4,0,88750,1117.75,86
"27512","80730","2020",15,15,0,259852.5,2278.6,117.8667
"27513","80732","2020",9,9,0,91555.56,1130.778,81
"27514","80734","2020",1,1,0,62500,868,72
"27515","80736","2020",1,1,0,140000,1414,99
"27516","80737","2020",3,3,0,80333.33,851.6667,89.33333
"27517","80738","2020",1,1,0,198500,1323,150
"27518","80740","2020",4,4,0,166985,1500.75,135.25
"27519","80741","2020",1,1,0,156000,1642,95
"27520","80742","2020",1,1,0,105000,1221,86
"27521","80743","2020",3,3,0,88333.33,1574.333,52.33333
"27522","80746","2020",6,6,0,205833.3,1838.667,115
"27523","80747","2020",1,1,0,82000,713,115
"27524","80748","2020",2,2,0,58475,626.5,89.5
"27525","80749","2020",2,2,0,99750,891.5,117
"27526","80750","2020",2,2,0,187500,1148.5,163.5
"27527","80751","2020",7,7,0,219671.4,1841,124.2857
"27528","80752","2020",8,8,0,205764.2,2019.75,101.5
"27529","80753","2020",1,1,0,80000,1250,64
"27530","80754","2020",1,1,0,73300,873,84
"27531","80755","2020",4,4,0,257750,3484.25,101
"27532","80758","2020",1,1,0,245700,1755,140
"27533","80759","2020",6,6,0,157333.3,1149.833,145.6667
"27534","80760","2020",3,3,0,154666.7,1261.333,124
"27535","80762","2020",7,7,0,82600,867.4286,98.14286
"27536","80763","2020",1,1,0,165000,1587,104
"27537","80764","2020",2,2,0,128500,2439,61
"27538","80765","2020",11,11,0,119225.5,1239.636,93.36364
"27539","80766","2020",4,4,0,85250,879.25,106.75
"27540","80767","2020",5,5,0,184476,1624.8,118.6
"27541","80769","2020",2,2,0,128700,1564,82.5
"27542","80770","2020",11,11,0,93795.45,1162.909,80.81818
"27543","80774","2020",1,1,0,165000,1250,132
"27544","80775","2020",6,6,0,114166.7,1420,78.83333
"27545","80776","2020",3,3,0,186333.3,1745,108.6667
"27546","80777","2020",2,2,0,119500,824,140
"27547","80778","2020",2,2,0,132500,1291,105.5
"27548","80779","2020",12,12,0,158750,1607,101.1667
"27549","80780","2020",5,5,0,126800,1980,66.2
"27550","80781","2020",5,5,0,134384,1535.6,90.4
"27551","80782","2020",3,3,0,231566.7,1692.667,136.6667
"27552","80783","2020",1,1,0,115050,685,168
"27553","80784","2020",2,2,0,80500,1667.5,45
"27554","80785","2020",5,5,0,224448,2343.2,98.6
"27555","80786","2020",3,3,0,208600,2188.333,93.66667
"27556","80788","2020",1,1,0,40000,435,92
"27557","80789","2020",4,4,0,132425,1123.25,125.75
"27558","80790","2020",1,1,0,60000,1500,40
"27559","80791","2020",6,6,0,227833.3,2921.5,82.83333
"27560","80792","2020",2,2,0,206625,1877,109
"27561","80793","2020",26,23,3,136686.8,1594.731,89.5
"27562","80795","2020",9,9,0,110833.3,1418.333,74.88889
"27563","80797","2020",1,1,0,110000,618,178
"27564","80798","2020",16,16,0,233991.9,2081.125,119.5
"27565","80799","2020",64,62,2,170401.9,1852.406,95.25
"27566","80800","2020",1,1,0,115000,2054,56
"27567","80801","2020",6,6,0,133520,1209,104.3333
"27568","80802","2020",5,5,0,72200,815.8,91.4
"27569","80803","2020",4,4,0,132125,1225.25,107.75
"27570","80804","2020",2,2,0,75000,1092.5,70
"27571","80805","2020",4,4,0,111750,1394.25,80.5
"27572","80806","2020",9,9,0,194115.6,2030.111,95
"27573","80807","2020",4,4,0,145887.5,1675.25,88.5
"27574","80808","2020",4,4,0,151555,1372,106.5
"27575","80809","2020",4,4,0,105750,1008.5,103.75
"27576","80810","2020",2,2,0,104955,1279.5,82.5
"27577","80811","2020",7,7,0,96000,1105.857,86.71429
"27578","80812","2020",1,1,0,38000,745,51
"27579","80813","2020",2,2,0,107750,1485,73
"27580","80814","2020",8,8,0,98812.5,1250.375,80.875
"27581","80815","2020",7,7,0,146042.9,1521.143,100.1429
"27582","80820","2020",11,11,0,149945.5,1342.727,120
"27583","80821","2020",4,4,0,123740,1636,81.25
"27584","80822","2020",2,2,0,125750,1360.5,90
"27585","80823","2020",1,1,0,30000,1250,24
"27586","80824","2020",5,5,0,101440,1221,75.8
"27587","80826","2020",21,16,5,113997.3,1817.619,65.52381
"27588","80827","2020",7,7,0,87914.29,1304.143,65.42857
"27589","80828","2020",1,1,0,76000,710,107
"27590","80830","2020",1,1,0,202500,1620,125
"27591","80832","2020",2,2,0,252000,1481.5,182
"27592","80833","2020",1,1,0,156900,1538,102
"27593","80834","2020",6,6,0,110950,1576.667,75.16667
"27594","80835","2020",4,4,0,122965,1637.5,75.5
"27595","80836","2020",1,1,0,171000,1402,122
"27596","81001","2020",2,2,0,137500,1472.5,92.5
"27597","81002","2020",28,28,0,128586.1,1281.393,100.3929
"27598","81003","2020",5,4,1,80300,839.8,88.6
"27599","81004","2020",776,404,372,157665.2,1993.99,82.99356
"27600","81005","2020",6,6,0,144050,1182.333,115.3333
"27601","81006","2020",1,1,0,135000,2700,50
"27602","81010","2020",14,14,0,117946.4,1397.214,85.5
"27603","81011","2020",11,11,0,259006.8,1973.273,125.5455
"27604","81013","2020",1,1,0,159750,1699,94
"27605","81014","2020",16,16,0,139429.4,1468.312,95.9375
"27606","81015","2020",2,2,0,250240,1592.5,157.5
"27607","81016","2020",7,7,0,86357.14,1003.286,87
"27608","81017","2020",1,1,0,267000,1768,151
"27609","81018","2020",27,26,1,178616,1777.111,101.6296
"27610","81019","2020",2,2,0,51240,1343.5,43.5
"27611","81020","2020",2,2,0,155650,1588,99
"27612","81021","2020",70,69,1,114145.3,1178.043,98.45714
"27613","81022","2020",1,1,0,338000,2840,119
"27614","81023","2020",3,3,0,44350,600.6667,85
"27615","81024","2020",7,7,0,213663,1614.571,129
"27616","81025","2020",1,1,0,205000,1139,180
"27617","81026","2020",7,7,0,194412.9,1551.143,138
"27618","81028","2020",5,5,0,69800,792.2,95.8
"27619","81029","2020",3,3,0,418100,2074.667,180
"27620","81030","2020",1,1,0,278600,1895,147
"27621","81031","2020",8,8,0,87736.62,1018.5,92.5
"27622","81032","2020",10,10,0,207500,1630.1,131.4
"27623","81033","2020",27,26,1,116108.9,1205.185,100.7407
"27624","81034","2020",10,10,0,67400,877.8,82.1
"27625","81035","2020",1,1,0,283990,2367,120
"27626","81036","2020",15,15,0,145770.5,1309.6,109.1333
"27627","81037","2020",28,28,0,88527.86,1027.929,90.35714
"27628","81038","2020",25,25,0,202720.2,1807,115.64
"27629","81039","2020",19,18,1,146918.4,1564.053,90.57895
"27630","81040","2020",1,1,0,75000,904,83
"27631","81041","2020",1,1,0,2e+05,5128,39
"27632","81042","2020",36,36,0,161046.2,1523.528,106.4722
"27633","81043","2020",8,8,0,194180,1565.25,125.25
"27634","81044","2020",1,1,0,317500,2442,130
"27635","81045","2020",8,8,0,142181.2,1406,106.5
"27636","81046","2020",15,15,0,189063.3,1601.6,122.8
"27637","81047","2020",2,2,0,139000,1262.5,108.5
"27638","81048","2020",34,29,5,137175.6,1545.559,88.05882
"27639","81049","2020",3,3,0,165766.7,1760,100.6667
"27640","81050","2020",6,6,0,180241.7,1494.167,122.5
"27641","81051","2020",14,14,0,144628.8,1446.5,100.5714
"27642","81052","2020",17,17,0,231664.1,1936.059,122
"27643","81053","2020",13,13,0,81957.69,985,90.46154
"27644","81054","2020",12,12,0,172766.7,1644.667,107.8333
"27645","81055","2020",15,14,1,111826.7,937.6,114.5333
"27646","81056","2020",1,1,0,140000,1167,120
"27647","81058","2020",1,1,0,260000,2222,117
"27648","81059","2020",4,4,0,189750,2024.75,94.25
"27649","81060","2020",122,114,8,104982.1,1112.648,99.54918
"27650","81061","2020",3,3,0,382216.7,2022.333,187.6667
"27651","81062","2020",17,17,0,91488.76,1023.471,92.76471
"27652","81063","2020",14,13,1,299496.9,2464.929,107.1429
"27653","81064","2020",11,11,0,176957.3,1435.909,122.9091
"27654","81065","2020",613,431,182,131071.7,1462.365,91.06199
"27655","81066","2020",3,3,0,124500,1200.333,101.6667
"27656","81067","2020",6,6,0,252458.3,1694.5,149.8333
"27657","81068","2020",2,2,0,194000,1734.5,110
"27658","81069","2020",18,16,2,207696.6,1838.333,123.5556
"27659","81070","2020",36,36,0,233352.2,2147.056,108.6111
"27660","81071","2020",2,2,0,50000,790,56.5
"27661","81073","2020",3,3,0,124883.3,1314.667,94
"27662","81074","2020",16,16,0,223413.9,1830.188,123
"27663","81075","2020",7,7,0,138671.4,1367,109.2857
"27664","81076","2020",9,9,0,229980.6,1635.556,140.4444
"27665","81077","2020",11,11,0,68369.55,950.0909,77.27273
"27666","81078","2020",12,12,0,124881.7,1223.833,101.5
"27667","81079","2020",12,12,0,211782.5,1549.583,144
"27668","81080","2020",2,2,0,329411,3223,103.5
"27669","81081","2020",15,15,0,139056,1147.067,128.0667
"27670","81082","2020",1,1,0,25000,625,40
"27671","81083","2020",5,5,0,128406,1432,83.2
"27672","81084","2020",5,5,0,128000,968,137
"27673","81086","2020",1,1,0,95000,1000,95
"27674","81088","2020",6,6,0,209008.3,2075.333,101.8333
"27675","81089","2020",4,3,1,79993.75,980.5,81.5
"27676","81090","2020",5,5,0,342710,2505.8,132.8
"27677","81092","2020",13,13,0,198519.7,1736.462,117.4615
"27678","81093","2020",5,5,0,183600,1613.4,117.8
"27679","81094","2020",6,6,0,101333.3,1041.833,94.83333
"27680","81095","2020",1,1,0,125000,1250,100
"27681","81096","2020",5,5,0,120122,1325.6,102
"27682","81097","2020",10,10,0,197482.5,1735.6,114.4
"27683","81098","2020",6,6,0,206500,1726.167,117.5
"27684","81099","2020",253,191,62,154679.8,1670.881,93.58498
"27685","81100","2020",1,1,0,81000,818,99
"27686","81101","2020",15,15,0,151540,1549.2,100.8
"27687","81102","2020",1,1,0,3e+05,2000,150
"27688","81103","2020",5,5,0,75012,740.4,87.8
"27689","81104","2020",14,13,1,204160.7,1987.929,109.4286
"27690","81105","2020",167,144,23,120451.7,1289.192,97.01796
"27691","81106","2020",6,6,0,171333.3,1502.167,120.1667
"27692","81108","2020",1,1,0,120000,1224,98
"27693","81109","2020",2,2,0,165000,1729.5,97
"27694","81110","2020",1,1,0,165115,1179,140
"27695","81112","2020",9,9,0,228428,1835.667,122.5556
"27696","81114","2020",3,3,0,161083.3,1331.333,118.3333
"27697","81115","2020",36,35,1,78683.53,930.2222,81.22222
"27698","81116","2020",23,23,0,214228.3,2254.696,103.0435
"27699","81117","2020",2,2,0,185525,2104,88.5
"27700","81118","2020",2,2,0,125500,1134.5,116
"27701","81119","2020",8,8,0,199171.2,1506.5,127.875
"27702","81120","2020",85,78,7,133138,1395.847,96.01176
"27703","81121","2020",5,5,0,99600,1368,80.4
"27704","81123","2020",2,2,0,150020,1290.5,121
"27705","81124","2020",30,28,2,98460.1,1223.767,81.26667
"27706","81125","2020",4,4,0,62700,1029.5,70.75
"27707","81126","2020",2,2,0,210843.5,1960,107.5
"27708","81128","2020",24,23,1,98232.12,1128.667,96.91667
"27709","81129","2020",2,2,0,66500,536.5,126.5
"27710","81130","2020",26,18,8,128205.6,1471.731,86.46154
"27711","81131","2020",29,29,0,238058.5,1916.862,117.069
"27712","81132","2020",11,11,0,125608.4,1334,101.7273
"27713","81133","2020",4,4,0,166625,1605.75,98.25
"27714","81134","2020",4,4,0,112578.8,1082.25,121.75
"27715","81136","2020",2,2,0,106550,1548.5,66.5
"27716","81137","2020",2,2,0,54000,962.5,50
"27717","81138","2020",7,7,0,179442.9,1933.714,93.28571
"27718","81139","2020",12,11,1,182013.7,1359.917,131.1667
"27719","81140","2020",152,113,39,187430.7,1896.105,97.28947
"27720","81141","2020",1,1,0,71936,899,80
"27721","81142","2020",8,8,0,136957.4,1018,146.5
"27722","81143","2020",12,12,0,201862.5,1776.417,115
"27723","81144","2020",35,35,0,181031.4,1729.429,109.1714
"27724","81145","2020",71,64,7,194751,1845.887,107.493
"27725","81146","2020",3,3,0,170833.3,1582.333,105
"27726","81147","2020",10,10,0,163831,1553.6,121
"27727","81148","2020",2,2,0,17500,540,34
"27728","81149","2020",7,7,0,199574.3,1514.714,128.8571
"27729","81150","2020",3,3,0,274856.3,1976.667,141.6667
"27730","81152","2020",2,2,0,254750,1622,156.5
"27731","81154","2020",2,2,0,262500,1793.5,121.5
"27732","81156","2020",33,33,0,219248.1,2069.303,107.0909
"27733","81157","2020",4,4,0,188873.8,1513.25,130.5
"27734","81158","2020",3,3,0,86066.67,1225.333,70.66667
"27735","81159","2020",3,2,1,202714,1802.333,112.3333
"27736","81160","2020",5,5,0,64200,635.8,97.6
"27737","81161","2020",2,2,0,105215,1099.5,104.5
"27738","81162","2020",4,4,0,399250,1660.5,212
"27739","81163","2020",158,128,30,96598.26,959.1013,103.1899
"27740","81164","2020",6,6,0,161250,1423.833,120.3333
"27741","81165","2020",2,2,0,111000,1939.5,57
"27742","81168","2020",18,18,0,112545.3,1249.889,90.5
"27743","81170","2020",18,17,1,146398.1,1225.167,125.2778
"27744","81171","2020",23,23,0,203885.7,1756.348,111.7826
"27745","81173","2020",2,2,0,241972,1682.5,142.5
"27746","81174","2020",7,7,0,176071.4,1608.429,113.7143
"27747","81175","2020",2,2,0,79500,971.5,65.5
"27748","81176","2020",2,2,0,306925,2225,122.5
"27749","81177","2020",4,4,0,154225,1286.75,117.5
"27750","81178","2020",4,4,0,250000,1907.25,136.5
"27751","81180","2020",8,8,0,189148.8,1230.125,150
"27752","81182","2020",19,18,1,101654.3,979.3684,118.7895
"27753","81183","2020",2,2,0,82500,826,99
"27754","81184","2020",2,2,0,43250,845.5,55.5
"27755","81185","2020",4,4,0,239885,2284.75,104.75
"27756","81186","2020",3,3,0,157250,1027,153.3333
"27757","81187","2020",3,3,0,134266.7,1574,91.66667
"27758","81188","2020",6,6,0,96516.67,901.3333,118.5
"27759","81190","2020",3,3,0,126000,1345,97.33333
"27760","81191","2020",2,2,0,157500,1309,126
"27761","81192","2020",12,12,0,82023.33,1007.167,84.75
"27762","81193","2020",15,15,0,95199.33,1516.867,69.33333
"27763","81195","2020",7,7,0,164441.1,1355.714,125.5714
"27764","81196","2020",10,10,0,130275,1215.8,102.7
"27765","81197","2020",3,3,0,193656.7,1650.333,143.3333
"27766","81198","2020",2,2,0,208650,1916.5,116
"27767","81200","2020",8,8,0,174358.8,1856.875,94.625
"27768","81201","2020",10,10,0,103800,981.7,111.3
"27769","81202","2020",12,11,1,201629.2,1518.75,131.75
"27770","81203","2020",3,3,0,100666.7,927.3333,99.66667
"27771","81204","2020",27,26,1,145872.2,1403.778,110.4074
"27772","81205","2020",6,6,0,184333.3,1215.167,141.8333
"27773","81206","2020",11,11,0,123610.5,1364.636,88.27273
"27774","81207","2020",2,2,0,123250,1055.5,104
"27775","81208","2020",5,5,0,182294,1691.6,107.2
"27776","81209","2020",40,40,0,158165.1,1462.8,113.425
"27777","81210","2020",8,8,0,137683.8,1256,126.125
"27778","81211","2020",4,4,0,230690,1999.25,109.5
"27779","81212","2020",1,1,0,526200,2447,215
"27780","81214","2020",3,3,0,173933.3,1303,135.3333
"27781","81215","2020",4,4,0,289425,2606,131
"27782","81216","2020",3,3,0,2e+05,2757.667,96
"27783","81217","2020",8,8,0,258200,1702.375,145.5
"27784","81218","2020",38,38,0,250608.3,2177,118.1579
"27785","81219","2020",27,27,0,178986.6,1472.926,127.7037
"27786","81220","2020",61,57,4,202772.4,1931.377,111.3934
"27787","81221","2020",2,2,0,57500,610,95
"27788","81222","2020",41,39,2,134855,1315.268,104
"27789","81224","2020",2,2,0,106650,862.5,123.5
"27790","81225","2020",10,9,1,176363,1557.3,114
"27791","81227","2020",26,25,1,121373.1,1229.231,100.9231
"27792","81229","2020",1,1,0,234000,1120,209
"27793","81230","2020",10,10,0,117160.1,1103.8,125.8
"27794","81231","2020",2,2,0,64250,946,75
"27795","81232","2020",5,5,0,211611.2,1663.4,124.2
"27796","81233","2020",17,17,0,148883.6,1510.706,107.8824
"27797","81234","2020",5,5,0,221230,1855,123.6
"27798","81235","2020",8,8,0,148512.5,1234.375,119
"27799","81236","2020",6,6,0,235318.3,1813.167,127.3333
"27800","81237","2020",2,2,0,134880,1278,101.5
"27801","81238","2020",19,19,0,107386.8,1263.053,88.21053
"27802","81239","2020",17,17,0,86547.06,754.5294,116.9412
"27803","81240","2020",2,2,0,65000,1676.5,45.5
"27804","81242","2020",1,1,0,218000,2057,106
"27805","81243","2020",3,3,0,212693.3,1385,150.3333
"27806","81244","2020",21,21,0,95953.81,1106.381,87
"27807","81245","2020",8,8,0,123630.6,1383.375,97.125
"27808","81246","2020",1,1,0,505000,2525,200
"27809","81248","2020",5,5,0,181383,1258,147
"27810","81249","2020",9,9,0,117611.1,1239.111,104.6667
"27811","81250","2020",1,1,0,229500,1366,168
"27812","81251","2020",9,8,1,211423.8,1991.222,110.8889
"27813","81253","2020",4,4,0,166612.5,1539.75,106.75
"27814","81254","2020",2,2,0,270250,2442.5,120.5
"27815","81255","2020",8,8,0,227506.2,1862.625,116.625
"27816","81257","2020",88,74,14,150739.6,1620.852,95.21591
"27817","81258","2020",3,3,0,204950,1507,136.6667
"27818","81259","2020",1,1,0,85000,850,100
"27819","81261","2020",6,6,0,239150,2603.167,98
"27820","81262","2020",2,2,0,475100,2099,207.5
"27821","81263","2020",6,6,0,91908.33,940,95
"27822","81264","2020",1,1,0,180000,1667,108
"27823","81265","2020",2,2,0,129500,2627.5,45
"27824","81266","2020",19,18,1,159626.9,1437.421,110.5263
"27825","81267","2020",15,15,0,83364,930.5333,103.4
"27826","81268","2020",3,3,0,60416.67,1303,50.33333
"27827","81269","2020",4,4,0,164812.2,1449.75,125.75
"27828","81271","2020",128,114,14,211208.6,2176.266,97.04688
"27829","81272","2020",6,6,0,226933.3,1698.667,136.5
"27830","81273","2020",43,43,0,171114.9,1534.93,109.1628
"27831","81274","2020",8,8,0,188843.8,1866.125,103.375
"27832","81275","2020",2,2,0,90000,1041.5,85
"27833","81276","2020",16,16,0,151900.4,1606.562,96.875
"27834","81277","2020",4,4,0,167750,1504,132.5
"27835","81278","2020",3,3,0,44883.33,618.6667,71.66667
"27836","81279","2020",6,6,0,110366.7,1128.167,91.66667
"27837","81280","2020",7,7,0,151364.3,1339.286,117.1429
"27838","81281","2020",19,19,0,173958.9,1521.947,119.2105
"27839","81282","2020",1,1,0,137000,979,140
"27840","81283","2020",12,11,1,220445,1812.167,130.3333
"27841","81284","2020",21,20,1,171891.2,1841.19,96.28571
"27842","81285","2020",4,4,0,119375,1505,101.5
"27843","81286","2020",11,11,0,157217.3,1433,111
"27844","81287","2020",1,1,0,165000,917,180
"27845","81288","2020",39,35,4,143826,1453.692,101.641
"27846","81289","2020",33,32,1,141365.5,1478,100.0606
"27847","81290","2020",2,2,0,121950,1527.5,77
"27848","81291","2020",3,3,0,112666.7,1060.667,113.3333
"27849","81292","2020",6,6,0,100316.7,1147.333,92.5
"27850","81293","2020",1,1,0,1e+05,820,122
"27851","81294","2020",12,12,0,224508.3,1738.417,133.6667
"27852","81295","2020",11,11,0,117786.2,1415.273,78.27273
"27853","81297","2020",14,14,0,206671.4,1826.357,110.6429
"27854","81298","2020",3,3,0,286766.7,2132,133.3333
"27855","81299","2020",5,5,0,354386.8,2164.2,138.8
"27856","81300","2020",4,4,0,206500,1810.5,132.25
"27857","81302","2020",2,2,0,93500,1399,70.5
"27858","81303","2020",4,4,0,135750,1228,111
"27859","81304","2020",4,4,0,140750,953,156.75
"27860","81305","2020",16,16,0,79878.12,887.5,106.9375
"27861","81306","2020",6,6,0,160350,1570.833,103.1667
"27862","81307","2020",11,11,0,164713.2,1613.727,98.18182
"27863","81308","2020",9,9,0,85416.67,791.5556,123.5556
"27864","81309","2020",6,6,0,111783.3,1433,90
"27865","81310","2020",2,2,0,372461.5,2511.5,147
"27866","81311","2020",10,10,0,191934,1519.9,124.2
"27867","81312","2020",6,6,0,161033.3,1741.167,95.83333
"27868","81313","2020",2,2,0,313357.5,1537.5,212
"27869","81314","2020",14,13,1,74714.29,798.9286,96.85714
"27870","81315","2020",11,10,1,156503.5,1725.909,94.63636
"27871","81316","2020",4,4,0,181750,2041.5,94.75
"27872","81317","2020",10,10,0,135549.8,1060.5,131.1
"27873","81318","2020",3,3,0,243940,1669.333,161.6667
"27874","81319","2020",6,6,0,250274.5,1728,151.6667
"27875","81320","2020",3,3,0,271768.3,1709.333,175
"27876","81321","2020",2,2,0,130500,888,137
"27877","81322","2020",1,1,0,147830,1540,96
"27878","81323","2020",7,7,0,319064.3,2066.429,152.8571
"27879","81324","2020",1,1,0,267750,2177,123
"27880","81325","2020",17,17,0,205464.7,1603.294,130.6471
"27881","81326","2020",3,3,0,202883.3,1683,124.6667
"27882","82001","2020",9,9,0,187374.4,1440.222,138
"27883","82002","2020",31,28,3,159363.2,1741.194,93.32258
"27884","82003","2020",4,4,0,155150,1352,127.25
"27885","82005","2020",19,18,1,191726.2,2047.105,108.0526
"27886","82006","2020",1,1,0,115000,958,120
"27887","82008","2020",18,17,1,140966.1,1183.056,124
"27888","82010","2020",5,5,0,160200,1199.6,129
"27889","82011","2020",14,14,0,163932,1541.857,109.6429
"27890","82012","2020",6,6,0,163500,1397.667,116.8333
"27891","82013","2020",52,48,4,118816,1262.5,97.67308
"27892","82014","2020",1,1,0,328000,3859,85
"27893","82015","2020",1,1,0,244550,2038,120
"27894","82016","2020",3,3,0,224933.3,1907,108
"27895","82017","2020",16,16,0,243496.9,2089.688,125.3125
"27896","82018","2020",13,13,0,184909.1,1762.923,106.7692
"27897","82019","2020",9,9,0,134668.3,1156.111,135.7778
"27898","82020","2020",6,6,0,191375,1463.333,130.3333
"27899","82021","2020",1,1,0,182150,1822,100
"27900","82022","2020",5,5,0,162380,1511,110.6
"27901","82023","2020",16,16,0,136163.1,1386.875,97.8125
"27902","82024","2020",4,4,0,302653.2,2635,130.5
"27903","82025","2020",37,33,4,202310.7,1947.027,111.4054
"27904","82026","2020",19,19,0,163978.9,1634.053,104.8947
"27905","82027","2020",20,20,0,248790.6,2226.4,118.6
"27906","82028","2020",8,8,0,195125,1952.625,103.25
"27907","82030","2020",4,4,0,170927.5,1414.75,124.25
"27908","82031","2020",10,10,0,116362,1272,93.4
"27909","82032","2020",9,9,0,144740.6,1224.444,123.7778
"27910","82033","2020",207,151,56,129189.5,1422.3,92.72947
"27911","82034","2020",1,1,0,60000,588,102
"27912","82035","2020",5,5,0,210927,2015.2,107.2
"27913","82036","2020",2,2,0,156000,1284.5,140
"27914","82037","2020",122,89,33,124114.1,1448.697,85.5082
"27915","82038","2020",31,31,0,151323.5,1710.71,94.09677
"27916","82039","2020",9,9,0,199194.4,1836.556,108.1111
"27917","82040","2020",3,3,0,164666.7,1882.333,85.33333
"27918","82041","2020",3,3,0,103506.7,1264.667,79
"27919","82042","2020",19,17,2,155933.5,1565.053,108.2105
"27920","82043","2020",2,2,0,294025,1544,191
"27921","82044","2020",23,17,6,172107.8,1657.217,101.3043
"27922","82045","2020",9,9,0,183572.2,1581.444,124.4444
"27923","82046","2020",1,1,0,170000,944,180
"27924","82047","2020",1,1,0,433000,3608,120
"27925","82048","2020",23,21,2,177234.3,1817,101.2174
"27926","82049","2020",17,17,0,152147.1,1468.294,105.7647
"27927","82050","2020",18,18,0,137566.7,1360.833,105.4444
"27928","82051","2020",8,8,0,147956.2,1165.625,134.25
"27929","82052","2020",12,12,0,190454.2,1565.083,125.1667
"27930","82053","2020",1,1,0,193000,1838,105
"27931","82054","2020",6,6,0,153516,1303.5,120.5
"27932","82055","2020",1,1,0,168000,1400,120
"27933","82056","2020",1,1,0,468000,3120,150
"27934","82057","2020",7,7,0,208403,2055.714,113.1429
"27935","82058","2020",1,1,0,218400,1200,182
"27936","82059","2020",2,2,0,107000,714,141
"27937","82060","2020",2,2,0,140000,1285,108.5
"27938","82061","2020",4,4,0,112625,1439,80.75
"27939","82062","2020",25,24,1,168236,1628.28,104.44
"27940","82063","2020",7,7,0,165867.1,1420,117.1429
"27941","82065","2020",4,4,0,111562.5,1063.75,112.25
"27942","82066","2020",12,12,0,159975,1580.417,101.8333
"27943","82067","2020",3,3,0,179533.3,1515.333,118
"27944","82068","2020",2,2,0,159000,1192,133.5
"27945","82069","2020",3,3,0,205761.7,1783.667,107.6667
"27946","82070","2020",1,1,0,185600,1375,135
"27947","82071","2020",1,1,0,60000,750,80
"27948","82072","2020",5,5,0,158800,1547.2,104.8
"27949","82073","2020",6,6,0,138400,1635.667,88.16667
"27950","82074","2020",2,2,0,182000,1063.5,170
"27951","82075","2020",59,54,5,185962.4,1997.797,96.62712
"27952","82076","2020",11,11,0,180151.5,1729.182,102.5455
"27953","82077","2020",1,1,0,192500,1750,110
"27954","82078","2020",2,2,0,133500,1538,87.5
"27955","82079","2020",39,39,0,200155.9,2161.385,108.6923
"27956","82080","2020",10,10,0,146163.4,1773.4,101.8
"27957","82081","2020",3,3,0,119333.3,1018.667,107.3333
"27958","82082","2020",3,3,0,104666.7,1282.667,81.33333
"27959","82083","2020",2,2,0,63500,685,97.5
"27960","82084","2020",2,2,0,305939.5,1842,187
"27961","82085","2020",11,11,0,193042.7,1619.091,128.6364
"27962","82086","2020",3,3,0,120500,1212,102.6667
"27963","82087","2020",28,28,0,130677.1,1223.214,116.8214
"27964","82088","2020",21,21,0,119658.1,1486.714,91.52381
"27965","82089","2020",20,20,0,91629,802.6,119.4
"27966","82090","2020",13,13,0,150358.9,1501.692,102.1538
"27967","82091","2020",3,3,0,174333.3,1741.667,101
"27968","82092","2020",2,2,0,199475,1566,127.5
"27969","82093","2020",9,8,1,124798.3,1119.222,108.3333
"27970","82094","2020",22,22,0,108869.1,1095.045,102.5
"27971","82095","2020",4,4,0,209575,1788.25,125
"27972","82096","2020",64,51,13,137164,1507.734,89.78125
"27973","82097","2020",18,18,0,119800,1059.611,108.8889
"27974","82098","2020",11,11,0,227867.4,2219,104.3636
"27975","82099","2020",4,4,0,170025,1754.5,96.5
"27976","82100","2020",5,5,0,190611,1887.2,104
"27977","82101","2020",15,15,0,148066.7,1292.867,118.1333
"27978","82102","2020",3,3,0,133166.7,1131.333,111.6667
"27979","82103","2020",1,1,0,244000,1461,167
"27980","82104","2020",5,5,0,237171,1515.2,160.2
"27981","82105","2020",26,26,0,166971.3,1425.308,122.4231
"27982","82106","2020",3,3,0,144333.3,1432,101.3333
"27983","82108","2020",18,18,0,164733.9,1552.778,107.6667
"27984","82110","2020",8,8,0,213768.8,1607.25,140.625
"27985","82111","2020",2,2,0,137500,1005.5,134.5
"27986","82112","2020",152,126,26,116008.3,1273.362,93.79605
"27987","82113","2020",16,15,1,157857.5,1755.125,96.3125
"27988","82114","2020",5,5,0,217730,1566.4,145.6
"27989","82115","2020",26,25,1,153068.7,1717.654,91.76923
"27990","82116","2020",3,3,0,237333.3,2372.333,112.6667
"27991","82117","2020",33,33,0,184647.5,1534.091,126.6667
"27992","82118","2020",1,1,0,121000,1274,95
"27993","82119","2020",2,2,0,134000,1511.5,89.5
"27994","82120","2020",4,4,0,171075,1286,138
"27995","82121","2020",1006,529,477,157507.9,1797.025,86.80815
"27996","82122","2020",1,1,0,205600,1713,120
"27997","82123","2020",24,16,8,180003.3,1794.125,101.0833
"27998","82124","2020",43,32,11,181530,1832.837,94.39535
"27999","82125","2020",81,73,8,190736,1785.259,106.5926
"28000","82126","2020",11,11,0,223181.8,2571.091,103.1818
"28001","82127","2020",6,6,0,152032.5,1438,107.1667
"28002","82129","2020",1,1,0,108585,970,112
"28003","82130","2020",2,2,0,227500,1997.5,119
"28004","82131","2020",25,25,0,173331.2,1576.04,119.88
"28005","82132","2020",14,14,0,190096.4,1763.786,105.3571
"28006","82134","2020",73,62,11,161620,1640.932,100.7808
"28007","82135","2020",13,13,0,178523.1,2070.692,86.76923
"28008","82136","2020",20,20,0,217243.7,2259.7,99.1
"28009","82137","2020",11,11,0,161328.2,1521.727,100.3636
"28010","82138","2020",5,5,0,162400,1105,142.6
"28011","82139","2020",1,1,0,195000,1548,126
"28012","82140","2020",2,2,0,164050,982.5,190
"28013","82141","2020",7,6,1,80502.71,745.8571,111
"28014","82142","2020",18,18,0,223504.6,2196.333,104.1667
"28015","82143","2020",2,2,0,390375,2190,170
"28016","82144","2020",8,8,0,184600,1851.625,100.375
"28017","82145","2020",4,4,0,216117.5,1316,163
"28018","82147","2020",7,7,0,137857.1,2068.143,70.71429
"28019","82148","2020",25,25,0,126040.5,1396.28,93.68
"28020","82149","2020",30,30,0,166323.7,1521.633,113.8333
"28021","82150","2020",10,10,0,169650,1448.9,118.4
"28022","82151","2020",13,13,0,177185.4,1507,122.8462
"28023","82152","2020",10,8,2,119083,1356.3,87.5
"28024","82153","2020",1,1,0,477000,1611,296
"28025","82154","2020",3,3,0,227786,1869,115
"28026","82155","2020",36,34,2,176293.2,1761.417,100.7222
"28027","82156","2020",1,1,0,153800,1099,140
"28028","82157","2020",2,2,0,113430,1009.5,112.5
"28029","82158","2020",2,2,0,121200,1656.5,73
"28030","82159","2020",4,4,0,172000,1983.75,88.25
"28031","82160","2020",3,3,0,73141,734,102.6667
"28032","82161","2020",48,39,9,160859.7,1677.271,94.33333
"28033","82162","2020",2,2,0,201400,1601,127.5
"28034","82163","2020",1,1,0,129000,992,130
"28035","82165","2020",8,7,1,149634.4,1389.625,120.5
"28036","82166","2020",4,4,0,177926,1566.75,113.25
"28037","82167","2020",19,19,0,208148.9,1910.947,118.6842
"28038","82168","2020",4,4,0,99812.5,756.75,144.5
"28039","82169","2020",17,17,0,114931.7,1175.941,99.88235
"28040","82170","2020",2,2,0,228297.5,2174,102.5
"28041","82171","2020",21,21,0,149878.3,1629.905,100.7143
"28042","82172","2020",5,5,0,224104,1467.2,137.2
"28043","82173","2020",17,15,2,145023.5,1423.471,105.0588
"28044","82174","2020",3,3,0,178871.7,1807.667,90
"28045","82175","2020",1,1,0,92500,1101,84
"28046","82176","2020",7,7,0,173262.9,1700,105
"28047","82177","2020",2,2,0,232500,1876,136.5
"28048","82178","2020",10,10,0,187080,1687.5,111.7
"28049","82179","2020",41,41,0,136006.7,1510.976,93.04878
"28050","82180","2020",8,8,0,120172,992.875,130
"28051","82181","2020",3,3,0,220538.3,1759,124.6667
"28052","82182","2020",3,3,0,122181.3,1788,77.66667
"28053","82183","2020",1,1,0,108000,844,128
"28054","82184","2020",6,6,0,158856.7,1323.167,104.6667
"28055","82185","2020",3,3,0,224120,1367,174
"28056","82186","2020",71,63,8,124121.5,1514.972,92.09859
"28057","82187","2020",21,20,1,133331.7,1564.762,97.66667
"28058","82188","2020",5,5,0,169200,1250.2,139.4
"28059","82189","2020",13,13,0,104982.8,1050.846,101.2308
"28060","82190","2020",95,63,32,136565.7,1667.642,81.78947
"28061","82191","2020",5,5,0,171100.6,1600.2,103
"28062","82192","2020",7,7,0,217788.6,1654.714,129
"28063","82193","2020",3,3,0,122700,1267.333,102.3333
"28064","82194","2020",8,7,1,156718.8,1836.5,88.625
"28065","82195","2020",8,8,0,198095.1,1671.375,121.625
"28066","83001","2020",42,38,4,512929,4016.405,126
"28067","83002","2020",4,3,1,129000,1386.75,78.75
"28068","83003","2020",23,21,2,254691.7,2358.565,109.2174
"28069","83004","2020",125,89,36,255308.8,2685.504,93.264
"28070","83005","2020",11,11,0,168020.9,1953.545,82.81818
"28071","83006","2020",3,3,0,210617.7,1830.667,117.3333
"28072","83007","2020",48,34,14,247441.6,2293.729,102.9583
"28073","83008","2020",79,48,31,290012.3,3337.848,84.35443
"28074","83009","2020",474,78,396,330565.9,5608.715,59.27848
"28075","83010","2020",4,3,1,73750,1407,58.75
"28076","83011","2020",38,31,7,223725,2294.579,93.05263
"28077","83012","2020",72,41,31,168109.7,2068.278,80.11111
"28078","83013","2020",10,10,0,165201,1942.4,93.4
"28079","83014","2020",4,4,0,212500,2171.5,93
"28080","83015","2020",7,3,4,161523.9,2666.429,62.42857
"28081","83016","2020",188,118,70,333983,3876.154,87.08511
"28082","83017","2020",40,26,14,203731.2,2545.45,85.125
"28083","83018","2020",54,49,5,270841.7,2473.944,111.0741
"28084","83019","2020",316,131,185,373589.7,5024.237,67.50316
"28085","83020","2020",1,1,0,150000,1415,106
"28086","83021","2020",47,41,6,246051.1,2861.191,92.2766
"28087","83023","2020",263,154,109,180015.1,2216.308,81.30798
"28088","83025","2020",31,22,9,242914.5,2784.387,89.35484
"28089","83026","2020",37,35,2,194851.4,2133.892,94.08108
"28090","83027","2020",60,47,13,543804.7,5005.25,111.7667
"28091","83028","2020",36,27,9,296498.3,2607.583,101.5556
"28092","83029","2020",55,42,13,322313,3075.345,108.1091
"28093","83030","2020",26,24,2,283693,2501,110.2692
"28094","83031","2020",65,50,15,244271.8,2706.615,91.6
"28095","83032","2020",77,62,15,220652.1,2478.506,89.09091
"28096","83033","2020",36,34,2,260945.6,2983.583,90.47222
"28097","83034","2020",212,92,120,398250.5,5027.59,77.58491
"28098","83035","2020",86,77,9,317478.6,4081.058,78.30233
"28099","83036","2020",370,76,294,281288.4,4881.249,56.2
"28100","83037","2020",23,20,3,259374,2902.391,92.26087
"28101","83038","2020",8,8,0,246300,2018.5,114.5
"28102","83039","2020",1,1,0,760000,1900,400
"28103","83040","2020",1,1,0,180000,1875,96
"28104","83041","2020",19,17,2,267638.7,2510.526,113.8421
"28105","83042","2020",185,73,112,255413.9,3699.33,71.05946
"28106","83043","2020",29,24,5,259283.1,2584.31,92.93103
"28107","83044","2020",3,2,1,64333.33,1155.333,52.33333
"28108","83045","2020",13,13,0,273406.8,2759.615,87.53846
"28109","83046","2020",64,52,12,345097.8,3082.656,109.0781
"28110","83047","2020",204,150,54,324861.4,3634.652,90.79412
"28111","83048","2020",191,75,116,438145.5,5614.88,70.32461
"28112","83049","2020",183,119,64,251912.1,3024.311,82.98361
"28113","83050","2020",665,243,422,183028.6,2206.099,79.64361
"28114","83051","2020",27,22,5,297738.9,2547,111.5185
"28115","83052","2020",9,9,0,157133.3,2081.778,77
"28116","83053","2020",32,27,5,345222,3318.062,108.4062
"28117","83054","2020",116,68,48,308201,3579.284,86.27586
"28118","83055","2020",128,93,35,298347.8,3379.531,94.44531
"28119","83056","2020",43,40,3,288104.1,2787.163,101.9535
"28120","83057","2020",53,49,4,282057.2,2746.453,103.4717
"28121","83058","2020",103,84,19,269527.3,2771.184,97.39806
"28122","83059","2020",73,53,20,220164.5,2811.767,81.91781
"28123","83060","2020",6,6,0,215716.7,1515.833,143.6667
"28124","83061","2020",1485,322,1163,238561,3708.687,64.85993
"28125","83062","2020",326,109,217,253352.9,3390.169,75.52147
"28126","83063","2020",48,37,11,390892,3704.292,101.7083
"28127","83064","2020",92,87,5,307929.2,2908.533,106.9891
"28128","83065","2020",109,90,19,742449,6079.982,103.9358
"28129","83066","2020",20,19,1,201935,2180.1,92
"28130","83067","2020",87,69,18,182079.9,2184.747,81.95402
"28131","83068","2020",247,121,126,621598.3,6519.255,93.61943
"28132","83069","2020",1107,242,865,248241.3,3738.234,65.73984
"28133","83070","2020",306,59,247,263755,5256.448,48.9085
"28134","83071","2020",314,135,179,258387.2,4576.978,58.65605
"28135","83072","2020",206,147,59,285255.7,2738.529,100.5583
"28136","83073","2020",178,121,57,206576.9,2466.831,85.43258
"28137","83074","2020",4,4,0,167000,2246,96.75
"28138","83075","2020",12,12,0,191275,2211.833,85.08333
"28139","83076","2020",19,18,1,253020.1,2743.947,99.36842
"28140","83077","2020",37,34,3,258944.3,2453,102.8919
"28141","83078","2020",12,12,0,308925,2857.083,114.0833
"28142","83079","2020",38,23,15,318568.4,3725.579,83.97368
"28143","83080","2020",26,25,1,257011.5,2802.808,96.76923
"28144","83081","2020",114,91,23,363235.8,3479.904,105.6228
"28145","83082","2020",6,4,2,189800,2260.833,79.33333
"28146","83083","2020",29,25,4,231856.3,2566.69,90.27586
"28147","83084","2020",16,15,1,198093.9,2081.062,92.75
"28148","83085","2020",62,48,14,298195.7,3284.306,93.14516
"28149","83086","2020",158,102,56,248678.9,2666.886,88.52532
"28150","83087","2020",92,76,16,300486.9,3146.63,98.47826
"28151","83088","2020",51,48,3,298827.4,2676.471,113.6275
"28152","83089","2020",11,9,2,294553.6,3480.364,101.9091
"28153","83090","2020",148,78,70,310854.7,3668.169,79.40541
"28154","83091","2020",6,4,2,215791.7,2490.667,98.33333
"28155","83092","2020",91,69,22,212684.4,2492.637,87.38462
"28156","83093","2020",27,21,6,282391,3070.815,94.88889
"28157","83094","2020",87,66,21,425364.4,4249.701,96.74713
"28158","83095","2020",18,16,2,149287.2,1861.5,80.27778
"28159","83096","2020",25,20,5,254595.8,3264.08,78.28
"28160","83097","2020",71,59,12,334055.1,3577.296,98.74648
"28161","83098","2020",161,50,111,298641.6,3908.335,74.91925
"28162","83099","2020",130,52,78,239629.4,3161.315,78.07692
"28163","83100","2020",63,48,15,218282.9,2583.937,84.50794
"28164","83101","2020",38,29,9,1163611,9309.605,120.5789
"28165","83102","2020",63,61,2,238744.8,2630.095,97.12698
"28166","83103","2020",30,24,6,375614.7,3870.433,94.36667
"28167","83104","2020",97,88,9,231566.1,2374.155,97.09278
"28168","83106","2020",96,90,6,274330.7,2855.292,96.01042
"28169","83107","2020",502,310,192,387522.4,4372.659,85.90637
"28170","83108","2020",49,43,6,228176.8,2499.245,95.87755
"28171","83109","2020",3,3,0,134333.3,1551.667,81.33333
"28172","83110","2020",25,20,5,220766.8,2343.8,92.2
"28173","83111","2020",43,41,2,230627.6,2775.535,88.53488
"28174","83112","2020",286,97,189,368051,5373.049,68.78322
"28175","83113","2020",44,43,1,193251.3,2249.091,83.54545
"28176","83114","2020",10,9,1,173634,2361.3,71.8
"28177","83115","2020",508,158,350,404501.8,5060.494,72.45866
"28178","83116","2020",258,206,52,293674.6,3034.915,96.35659
"28179","83117","2020",34,31,3,346816.5,3014.882,123.2941
"28180","83118","2020",1347,335,1012,318595.4,4252.714,73.60728
"28181","83119","2020",135,28,107,696567.8,8303.793,77.11852
"28182","83120","2020",76,44,32,289475.9,3314.474,89.22368
"28183","83121","2020",86,63,23,228564.3,2388.953,92.76744
"28184","83122","2020",13,5,8,138446.7,2436.462,70.84615
"28185","83123","2020",521,158,363,371817.5,5332.013,69.15931
"28186","83124","2020",63,57,6,378288.6,3244.762,117.9524
"28187","83125","2020",49,44,5,261421,2822.306,94.12245
"28188","83126","2020",1251,330,921,206274.5,3173.914,66.18945
"28189","83127","2020",29,23,6,274015.2,3483.931,80.03448
"28190","83128","2020",17,17,0,281921.4,2579.941,107.8824
"28191","83129","2020",874,298,576,289251.1,4456.07,66.34325
"28192","83130","2020",172,111,61,277522.6,3193.616,86.46512
"28193","83131","2020",78,64,14,323590.2,3626.269,91.53846
"28194","83132","2020",30,27,3,371794.3,3313.333,112.7333
"28195","83133","2020",21,16,5,379130.7,3552,103.2381
"28196","83134","2020",39,37,2,281189.7,3159.641,90.02564
"28197","83135","2020",34,32,2,197747.6,2211.765,94.38235
"28198","83136","2020",50,45,5,265958.3,2895.48,93.42
"28199","83137","2020",3100,497,2603,183502.4,2761.564,64.9829
"28200","83138","2020",63,59,4,260851.6,3754.952,73.73016
"28201","83139","2020",23,22,1,356532.6,2823.174,121.087
"28202","83140","2020",80,65,15,249372.6,2591.85,96.575
"28203","83141","2020",94,77,17,260796.9,2572.649,102.0106
"28204","83143","2020",70,59,11,239774.5,2657.171,95.57143
"28205","83144","2020",369,99,270,236665.4,3211.141,74.30894
"28206","83145","2020",23,18,5,166688,1885,86.91304
"28207","83146","2020",41,36,5,174333.4,2336.073,78.4878
"28208","83148","2020",219,180,39,239368.2,2748.078,88.86301
"28209","83149","2020",24,18,6,305392.5,2951.25,100.2083
"28210","83150","2020",54,40,14,195451.6,2299.87,85.24074
"28211","83151","2020",21,20,1,160822.8,2440.429,82.2381
"28212","83152","2020",38,25,13,820744.2,6924.474,110.1316
"28213","83153","2020",195,26,169,188348.9,3948.549,48.12821
"28214","83154","2020",19,19,0,309872.7,2918.684,112.3684
"28215","84001","2020",37,29,8,286478.9,2752.405,107.2703
"28216","84002","2020",17,15,2,353208.8,3743.235,92.88235
"28217","84003","2020",168,88,80,176604.6,1823.577,90.91071
"28218","84004","2020",97,87,10,214918,2430.577,88.29897
"28219","84005","2020",2,2,0,120000,3100,62
"28220","84007","2020",1595,468,1127,148975.4,2321.47,66.22571
"28221","84008","2020",10,10,0,370998.5,2859.8,121.7
"28222","84009","2020",21,18,3,227902.7,2500.19,97.33333
"28223","84010","2020",7,6,1,384821.4,3306,117.7143
"28224","84011","2020",7,7,0,382542.9,3240.143,115.8571
"28225","84012","2020",25,21,4,227176,2626.16,85.88
"28226","84013","2020",6,5,1,570166.3,3660.833,140.6667
"28227","84014","2020",24,20,4,182782.1,2558.708,79.70833
"28228","84015","2020",2,2,0,202350,2358,87.5
"28229","84016","2020",54,48,6,229947.6,2305.148,99.35185
"28230","84017","2020",56,53,3,266188.8,2766.875,100.7143
"28231","84018","2020",11,11,0,321643.6,3326,97
"28232","84019","2020",156,124,32,160384.4,1796.551,88.10256
"28233","84020","2020",21,15,6,432802,4408.619,103.2381
"28234","84021","2020",1,1,0,50000,1923,26
"28235","84022","2020",7,7,0,172994.3,2122.429,78.71429
"28236","84024","2020",4,4,0,277812.5,3240.75,87
"28237","84025","2020",38,35,3,491163.2,3713.763,132.2632
"28238","84026","2020",52,35,17,233885,2985.615,78.09615
"28239","84027","2020",23,19,4,211658.3,2139.913,104.6087
"28240","84028","2020",10,9,1,241595,2325.4,109.2
"28241","84029","2020",39,38,1,226883,2356.077,100.1026
"28242","84030","2020",52,43,9,212291.9,2662.865,83.25
"28243","84031","2020",380,200,180,164811.5,2067.553,80.52368
"28244","84032","2020",5,5,0,270922,2814.8,101.8
"28245","84033","2020",3,3,0,186333.3,1161.667,131.6667
"28246","84034","2020",50,42,8,310872,3059.48,104.78
"28247","84035","2020",358,182,176,182576.2,2191.631,80.70391
"28248","84036","2020",33,27,6,288682.4,2605.576,110.2424
"28249","84037","2020",13,12,1,227215.4,2762.769,85.69231
"28250","84038","2020",36,31,5,326326,2920.667,112.5
"28251","84039","2020",56,40,16,212453.7,2420.429,91.375
"28252","84040","2020",5,5,0,287796,2562,105.2
"28253","84041","2020",9,9,0,352305.2,2670.111,129.5556
"28254","84042","2020",24,20,4,276654.2,3029.375,87.45833
"28255","84043","2020",110,86,24,219240.7,2399.645,94.50909
"28256","84044","2020",21,19,2,316257.1,3171.238,96.66667
"28257","84045","2020",7,7,0,602307.1,3692.143,171.8571
"28258","84046","2020",11,11,0,271019.1,2571.091,102.8182
"28259","84047","2020",41,41,0,302102.2,2941.268,105.0732
"28260","84049","2020",1,0,1,294000,3231,91
"28261","84050","2020",49,49,0,789744.2,5283.041,150.0612
"28262","84051","2020",22,20,2,489836.4,4002.455,111.7727
"28263","84052","2020",13,13,0,363184.6,3352.846,102.6154
"28264","84053","2020",22,21,1,303417,2482.727,124.9091
"28265","84054","2020",324,207,117,285191.1,3126.87,90.42284
"28266","84055","2020",6,6,0,352013.3,2734.5,138.1667
"28267","84056","2020",42,35,7,218151,2405.69,90.04762
"28268","84057","2020",5,3,2,402824,3632.2,114
"28269","84058","2020",11,10,1,493454.5,4197.727,124.0909
"28270","84059","2020",7,7,0,304885.7,2954.571,88.71429
"28271","84060","2020",1,1,0,497000,2761,180
"28272","84061","2020",4,4,0,323870.5,2374,154.5
"28273","84062","2020",24,20,4,371514.4,3159,116.5833
"28274","84063","2020",3,3,0,261750,3182,85.33333
"28275","84064","2020",37,24,13,165285.2,1770,90.32432
"28276","84065","2020",71,65,6,304232.3,3056.352,104.6197
"28277","84066","2020",5,5,0,317908.6,2848.2,111.2
"28278","84067","2020",20,19,1,255500,3085.3,87.75
"28279","84068","2020",25,17,8,496028,3986.88,111.48
"28280","84069","2020",43,32,11,193678.8,2224.465,84.74419
"28281","84070","2020",18,17,1,234756.1,2442.222,94.55556
"28282","84071","2020",21,20,1,400812.6,3291.905,118.8571
"28283","84072","2020",69,62,7,292733.2,2827.899,104.9855
"28284","84073","2020",17,16,1,633963.9,4389.882,150.2353
"28285","84074","2020",44,41,3,283588,2856.295,98.86364
"28286","84075","2020",5,5,0,237970,1989.2,113.4
"28287","84076","2020",22,20,2,266768.2,2903.545,93.86364
"28288","84077","2020",2,2,0,417738,2631,159.5
"28289","84078","2020",34,30,4,203062.1,1937.059,102.7941
"28290","84079","2020",7,7,0,232107.9,2287,92.28571
"28291","84080","2020",143,100,43,209234.9,2465.168,87.27972
"28292","84081","2020",104,72,32,227506.7,2599.452,90.45192
"28293","84082","2020",28,23,5,240492,2445.429,102.3214
"28294","84083","2020",35,27,8,183313.3,1809.943,97.62857
"28295","84084","2020",24,21,3,297255.8,3093.917,97.54167
"28296","84085","2020",12,12,0,503958.3,4215.333,115.3333
"28297","84086","2020",21,17,4,606267.1,4901.095,129.3333
"28298","84087","2020",358,192,166,165929.1,2030.969,81.39944
"28299","84088","2020",129,112,17,352396,3138.225,111.0853
"28300","84089","2020",309,159,150,225291.7,2985.375,76.1521
"28301","84090","2020",10,9,1,300891.5,3119.9,99.3
"28302","84091","2020",47,43,4,215204.1,2173.17,98.48936
"28303","84092","2020",244,119,125,151142.9,1935.984,76.70082
"28304","84093","2020",20,20,0,352167.6,3251.15,110.5
"28305","84094","2020",6,5,1,286290,2755.5,105.1667
"28306","84095","2020",11,8,3,364088.2,3725.545,98.90909
"28307","84096","2020",8,8,0,344681.2,2650.25,127.25
"28308","84097","2020",8,8,0,237468.1,1703.625,137.75
"28309","84098","2020",6,6,0,242809.3,2469,99.33333
"28310","84099","2020",64,58,6,368916.6,3223.641,111.2969
"28311","84100","2020",5,5,0,401380,4284.6,111.6
"28312","84101","2020",5,5,0,242720,2594.4,111.2
"28313","84102","2020",29,28,1,428822.9,3433.621,122.4483
"28314","84103","2020",17,13,4,248065.5,2404.471,95.64706
"28315","84104","2020",23,22,1,310127.3,2699.826,120.087
"28316","84105","2020",12,12,0,211441.7,2500.917,82.33333
"28317","84106","2020",27,21,6,228950.4,2523,93.55556
"28318","84107","2020",10,10,0,184709,2192,90.1
"28319","84108","2020",27,27,0,256997,2710.741,95.25926
"28320","84109","2020",2,2,0,484500,5101.5,105
"28321","84110","2020",2,2,0,237750,1716,144.5
"28322","84111","2020",2,2,0,539500,3946,151
"28323","84112","2020",8,8,0,192902.5,1896.75,92.375
"28324","84113","2020",4,4,0,270625,3119,98
"28325","84114","2020",4,4,0,265008.2,2260,112.25
"28326","84115","2020",4,4,0,282864,2493.75,126
"28327","84116","2020",6,6,0,318560,2966.167,105
"28328","84117","2020",4,4,0,186250,2419.5,70.25
"28329","84118","2020",59,56,3,358225.5,3159.356,113.5254
"28330","84119","2020",74,57,17,270208.4,2651,102.5405
"28331","84120","2020",3,3,0,101333.3,1336.667,69.66667
"28332","84121","2020",1,1,0,275000,3125,88
"28333","84122","2020",55,49,6,269462.2,2598.109,100.6182
"28334","84123","2020",14,13,1,254075,2556.5,111.1429
"28335","84124","2020",33,20,13,347376.5,4008.818,81.21212
"28336","84125","2020",4,4,0,281930.2,2036,124.25
"28337","84126","2020",17,16,1,418158.8,2746.529,152.8235
"28338","84127","2020",33,30,3,245647,2646.273,98.54545
"28339","84129","2020",224,147,77,173212,2046.446,83.28571
"28340","84130","2020",1,1,0,690000,3399,203
"28341","84131","2020",24,23,1,410741.7,3432.083,122.8333
"28342","84132","2020",89,71,18,256375.1,2671.663,96.76404
"28343","84133","2020",50,42,8,299360.8,2716.14,103.7
"28344","84134","2020",4,4,0,219870,2141.75,102
"28345","84135","2020",24,24,0,341401.7,2386.458,142.125
"28346","84136","2020",14,10,4,306078.6,2754.929,104.3571
"28347","84137","2020",82,52,30,266265.1,2935.585,92.96341
"28348","84138","2020",122,91,31,150236,1722.689,87.12295
"28349","84139","2020",7,5,2,273507.1,2843.143,105.8571
"28350","84140","2020",6,4,2,367535.3,3081.5,100.8333
"28351","84141","2020",122,109,13,239046.3,2571.434,95.13934
"28352","84142","2020",33,31,2,325306,3300.909,100.6667
"28353","84143","2020",15,15,0,449440.1,3558.333,132.7333
"28354","84144","2020",14,13,1,169642.9,2076.071,83
"28355","84145","2020",14,14,0,326256.1,2933.643,105.1429
"28356","84146","2020",3,3,0,222400,3405,74.33333
"28357","84147","2020",38,29,9,295245.6,3042.816,99.47368
"28358","84148","2020",26,25,1,233703.8,2503.115,94.5
"28359","84149","2020",12,12,0,214442.7,2151.917,106.6667
"28360","84150","2020",29,27,2,232208.1,2061.241,109.3793
"28361","84151","2020",5,4,1,253700,2886.8,84.6
"28362","85001","2020",174,160,14,155847.2,2451.052,69.5
"28363","85002","2020",49,49,0,162761.4,2054.776,77
"28364","85003","2020",144,137,7,186680.4,1960.5,98.27083
"28365","85004","2020",92,92,0,176478.3,1993.707,92.22826
"28366","85005","2020",16,16,0,112418.8,1062,107
"28367","85006","2020",43,43,0,170860,1764.279,101.9767
"28368","85008","2020",89,88,1,186354.9,1810.382,105.427
"28369","85009","2020",11,11,0,156081.8,1362.455,115.4545
"28370","85010","2020",29,29,0,155165,1786.897,86
"28371","85011","2020",72,67,5,244062.3,3176.5,78.97222
"28372","85012","2020",103,79,24,170630.2,2353.282,78.57282
"28373","85013","2020",14,13,1,137439.3,1232.5,114.9286
"28374","85014","2020",18,18,0,107716.7,1166.889,90.5
"28375","85015","2020",28,28,0,164427.9,1653.143,102.5714
"28376","85016","2020",30,29,1,176691.7,1730.967,102.5667
"28377","85017","2020",17,17,0,166835.3,1940.059,87.52941
"28378","85018","2020",74,72,2,176348.9,2031.054,90.08108
"28379","85019","2020",79,79,0,170622.3,1872.633,93.56962
"28380","85020","2020",52,52,0,168838.5,1425.385,123.5577
"28381","85021","2020",16,16,0,179566.2,1881.875,94.5625
"28382","85022","2020",26,26,0,174805.7,1850.192,97.15385
"28383","85023","2020",9,9,0,166208.9,1343,121.2222
"28384","85024","2020",30,29,1,164866.5,1696.5,100.5667
"28385","85025","2020",25,25,0,166936,1638.12,105.32
"28386","85026","2020",16,16,0,150756.2,1676.562,91.125
"28387","85028","2020",11,11,0,125000,1115.182,115.4545
"28388","85029","2020",36,36,0,144692.8,1862.667,89.94444
"28389","85031","2020",35,35,0,130167.9,1339.771,97.6
"28390","85033","2020",10,10,0,100200,960.6,101.8
"28391","85034","2020",38,38,0,153933.6,1383.342,112.9737
"28392","85035","2020",234,188,46,213585.5,3339.594,69.89316
"28393","85036","2020",8,8,0,93225,1030,94.625
"28394","85037","2020",10,10,0,140489.2,1327.2,112.3
"28395","85038","2020",36,33,3,165452.6,1645.194,105.3333
"28396","85039","2020",36,36,0,177924.9,1701.333,105.5556
"28397","85040","2020",26,26,0,139727.1,1249.462,118.2308
"28398","85041","2020",6,6,0,98400,908.5,110.3333
"28399","85042","2020",33,32,1,134458.9,1240.545,114.5758
"28400","85045","2020",30,30,0,171621.7,2132,82.66667
"28401","85046","2020",46,46,0,160811.7,1567.435,103.2391
"28402","85047","2020",379,280,99,205316.6,2281.237,91.69393
"28403","85049","2020",34,34,0,166189.7,1539.824,112.4706
"28404","85050","2020",60,60,0,149510.3,1525.033,98.23333
"28405","85051","2020",121,108,13,124971.2,1337.909,95.23967
"28406","85053","2020",5,5,0,110080,1043.4,106.4
"28407","85054","2020",12,12,0,142645.8,1757.083,82.66667
"28408","85055","2020",14,14,0,127253.6,1394.571,93.14286
"28409","85056","2020",7,7,0,144314.3,948.7143,152.7143
"28410","85058","2020",5,5,0,138300,1390,101.8
"28411","85059","2020",42,40,2,104005.1,1082.452,95.30952
"28412","85061","2020",26,25,1,140061,1450.308,100.6923
"28413","85062","2020",18,17,1,180436.1,1775.556,103.2778
"28414","85064","2020",22,22,0,133743.2,1368.864,96.86364
"28415","85065","2020",39,38,1,145137,1500.564,101.1795
"28416","85066","2020",10,10,0,84082,1067.6,82.6
"28417","85067","2020",9,8,1,113888.9,1009,106
"28418","85070","2020",75,71,4,184358.4,1970.373,93.78667
"28419","85071","2020",65,64,1,182925.3,2018.877,92.95385
"28420","85072","2020",18,18,0,170272.2,1551.444,113.7778
"28421","85073","2020",13,13,0,147230,1459.231,99.46154
"28422","85074","2020",3,3,0,141666.7,1330.333,108.6667
"28423","85076","2020",31,31,0,207939.4,2175.71,98.32258
"28424","85077","2020",14,14,0,110185,1347.143,84.21429
"28425","85078","2020",13,13,0,137897.3,1527.462,90.84615
"28426","85080","2020",24,24,0,124345.8,1281.875,104.375
"28427","85081","2020",57,57,0,191207.7,1842.158,104.1579
"28428","85082","2020",40,39,1,175764.5,1855.025,93.2
"28429","85083","2020",45,45,0,331412.4,4025.711,90.08889
"28430","85084","2020",91,90,1,168951,1692.495,99.28571
"28431","85086","2020",25,25,0,146651.6,1501.08,100
"28432","85087","2020",8,8,0,69411.25,872.625,85.75
"28433","85088","2020",84,77,7,258405.4,2700.048,97.17857
"28434","85089","2020",65,63,2,165785.4,1724.277,96.81538
"28435","85090","2020",63,63,0,125800.8,1278.968,100
"28436","85092","2020",224,178,46,119354.5,1230.938,98.70982
"28437","85093","2020",15,15,0,148413.3,1416.467,102.0667
"28438","85094","2020",18,17,1,107633.3,917.7222,114.3889
"28439","85095","2020",33,33,0,176817.3,1687.152,105.9091
"28440","85096","2020",92,91,1,206129.1,1987.185,105.9348
"28441","85097","2020",24,24,0,171220.8,1574.042,109.8333
"28442","85098","2020",22,22,0,213801.4,2034.364,104.1364
"28443","85099","2020",20,20,0,195369.2,1799.4,115.85
"28444","85100","2020",34,34,0,228285.4,2653.676,88.97059
"28445","85101","2020",12,12,0,184708.3,1667.75,110
"28446","85102","2020",11,11,0,138995.1,1341.636,117
"28447","85103","2020",39,39,0,190287.3,1911.564,100.4359
"28448","85104","2020",22,21,1,137831.4,1728.091,82.13636
"28449","85105","2020",14,14,0,89475,839.0714,107.0714
"28450","85106","2020",70,68,2,264919.6,3682.129,76.2
"28451","85108","2020",37,37,0,173438.4,1673.216,104.6757
"28452","85109","2020",164,141,23,173365,1908.744,92.65244
"28453","85110","2020",13,13,0,128658.9,1206.769,116.3077
"28454","85111","2020",28,28,0,126291.1,1400.5,89.64286
"28455","85112","2020",61,60,1,247140.9,2321.049,109.8689
"28456","85113","2020",105,103,2,434687.7,4625.352,94.26667
"28457","85114","2020",164,125,39,203145.3,2847.89,73.01829
"28458","85115","2020",7,7,0,153742.9,1347.714,125.2857
"28459","85116","2020",12,12,0,186576.5,1717,116.25
"28460","85117","2020",12,12,0,152975,1399.833,111.8333
"28461","85118","2020",40,40,0,175122.9,1759.95,102.925
"28462","85119","2020",20,19,1,167769.2,1634.75,102.25
"28463","85120","2020",33,33,0,191941.5,2349.545,88
"28464","85121","2020",22,22,0,123932.7,1242.955,104.9545
"28465","85123","2020",6,6,0,169466.7,1440.167,131
"28466","85125","2020",5,5,0,160012,1290.6,122.4
"28467","85126","2020",14,14,0,134764.3,1134.214,128.9286
"28468","85127","2020",120,99,21,175987.8,2578.258,72.1
"28469","85128","2020",181,154,27,137404.3,1568.122,88.42541
"28470","85129","2020",39,39,0,186518.7,1640.128,111.0769
"28471","85130","2020",21,20,1,159257.1,1568.762,102.7619
"28472","85131","2020",19,19,0,142994.8,1454.895,96.84211
"28473","85132","2020",16,16,0,88638.12,972.875,93.9375
"28474","85133","2020",8,8,0,104824.4,1252.5,91
"28475","85134","2020",8,8,0,109706.2,1323.25,78.125
"28476","85135","2020",62,59,3,129864.4,1393.516,93.80645
"28477","85136","2020",3,3,0,120000,1229.333,92
"28478","85137","2020",9,9,0,144746.7,1140.778,131.6667
"28479","85138","2020",13,13,0,171238.5,1795.923,94.61538
"28480","85139","2020",7,7,0,109914.3,1178.286,106.5714
"28481","85140","2020",20,20,0,120185,1195.35,103.95
"28482","85141","2020",11,11,0,89318.18,956.0909,97.09091
"28483","85142","2020",11,11,0,114427.3,1369,82.90909
"28484","85143","2020",29,29,0,119021,1305.31,93.93103
"28485","85144","2020",8,8,0,169712.5,1781.5,95.125
"28486","85145","2020",11,11,0,104726.9,1008.636,108.6364
"28487","85146","2020",199,175,24,188364.3,2053.769,94.46231
"28488","85147","2020",42,42,0,86826.9,916.9524,95.45238
"28489","85148","2020",15,15,0,138500,1198.8,117.8
"28490","85149","2020",1,1,0,130000,1111,117
"28491","85151","2020",90,89,1,163955.6,1697.222,96.77778
"28492","85152","2020",81,79,2,193132.8,1953.494,101.1605
"28493","85153","2020",30,30,0,130735,1281.267,102.7667
"28494","85154","2020",34,32,2,125657.1,1177.618,109.5294
"28495","85155","2020",52,52,0,228182.4,2040.942,109.5577
"28496","85156","2020",40,40,0,175255,1829.5,96.325
"28497","85157","2020",11,11,0,131464.5,1327.818,104.8182
"28498","85158","2020",17,17,0,120965.9,1179.353,107.5882
"28499","85159","2020",36,36,0,143958.2,1287.917,112.1667
"28500","85160","2020",43,41,2,182164.4,1865.372,97.81395
"28501","85161","2020",42,42,0,177679,1698.619,104.4524
"28502","85162","2020",20,20,0,143618,1232.55,117.5
"28503","85163","2020",152,130,22,368580.3,4477.658,84.99342
"28504","85164","2020",86,56,30,164673.4,2834.628,64.62791
"28505","85167","2020",13,13,0,160284.6,1200,135.5385
"28506","85169","2020",21,21,0,160702.4,1680.571,98
"28507","85171","2020",22,22,0,116954.5,1237.409,97.95455
"28508","85172","2020",39,39,0,183694.5,2121.128,89.82051
"28509","85174","2020",11,11,0,147928.3,1408.273,105.2727
"28510","85175","2020",7,7,0,128812.9,1692.429,100.4286
"28511","85176","2020",10,10,0,161743.7,1407.9,110.3
"28512","85177","2020",20,20,0,113281.2,1137.85,101.9
"28513","85178","2020",100,100,0,184290.2,1751.38,107.29
"28514","85179","2020",26,26,0,168839.6,1660.923,103.0385
"28515","85181","2020",10,10,0,136750,1521,123.6
"28516","85182","2020",71,65,6,129706.9,1338.028,98.3662
"28517","85184","2020",5,5,0,105680,999.8,120.8
"28518","85185","2020",12,12,0,174541.7,1601.833,108.3333
"28519","85186","2020",5,4,1,159930,1476.4,95.4
"28520","85187","2020",6,6,0,91150,1095.5,84.33333
"28521","85188","2020",18,18,0,120643.6,1259.111,99.16667
"28522","85189","2020",25,25,0,212029.2,2079.2,104.12
"28523","85190","2020",34,30,4,155949.4,1683.559,102.2059
"28524","85191","2020",915,519,396,158721.3,2026.843,79.99454
"28525","85192","2020",5,5,0,99400,1085.4,89
"28526","85193","2020",7,7,0,106428.6,1500.143,74.71429
"28527","85194","2020",1450,844,606,261447.9,3662.589,74.58897
"28528","85196","2020",24,24,0,121121.6,1431.042,87.54167
"28529","85197","2020",44,44,0,161626.1,1576.75,105.3409
"28530","85198","2020",18,18,0,159611.1,1629.944,98.72222
"28531","85199","2020",6,6,0,123500,1233.5,104.6667
"28532","85200","2020",24,24,0,182960.4,1766.292,105.0417
"28533","85201","2020",24,24,0,171316.7,1785.708,99.83333
"28534","85202","2020",24,24,0,128535.4,1257.917,100.25
"28535","85204","2020",44,44,0,172073.7,1784.614,98.65909
"28536","85205","2020",8,8,0,120625,1094,101.25
"28537","85206","2020",15,15,0,77784.53,1056.467,67.8
"28538","85207","2020",15,15,0,145740.7,1811.867,84.93333
"28539","85208","2020",24,24,0,165964.4,1640.333,106.2083
"28540","85209","2020",15,15,0,135710,1205.6,116.9333
"28541","85210","2020",33,33,0,160097.3,1694.242,101.4242
"28542","85211","2020",28,27,1,180313.4,1898.929,96.32143
"28543","85213","2020",59,58,1,161547.9,1469.441,107.7288
"28544","85214","2020",47,47,0,253416.5,2342.085,109.1277
"28545","85215","2020",33,33,0,148516.1,1566.848,95.48485
"28546","85216","2020",26,26,0,164219.2,1553.615,106.1538
"28547","85218","2020",21,21,0,142978.6,1604.81,93.7619
"28548","85220","2020",20,20,0,130520.6,1367.7,99.45
"28549","85221","2020",38,38,0,196412.7,2059.289,96.31579
"28550","85222","2020",304,176,128,252120.7,3768.155,70.64474
"28551","85223","2020",39,39,0,132941.1,1204.718,115.0513
"28552","85226","2020",667,304,363,153373.6,2695.873,57.03298
"28553","85227","2020",26,26,0,122519.2,1277.923,101.6923
"28554","85229","2020",11,11,0,105863.6,1001.091,107.3636
"28555","85231","2020",27,27,0,188616.7,2079.519,93
"28556","85232","2020",20,20,0,116870,1094.8,104.45
"28557","85233","2020",11,11,0,143998.7,1443.545,111.4545
"28558","85234","2020",597,280,317,156420.9,2654.73,61.48911
"28559","85235","2020",5,5,0,84040,840.4,106.2
"28560","85236","2020",36,36,0,207190.6,2083.833,100.5278
"28561","85237","2020",6,6,0,102916.7,956,108
"28562","85238","2020",19,18,1,132385,1630.263,85.89474
"28563","85239","2020",11,11,0,219590,1957.091,113
"28564","85240","2020",21,21,0,142391.7,1351.857,104.5714
"28565","85242","2020",4,4,0,139562.5,1726.75,82.75
"28566","85243","2020",60,60,0,190592.8,2555.883,80.65
"28567","85244","2020",9,9,0,114200,1126,100.8889
"28568","85245","2020",1,1,0,53000,515,103
"28569","85246","2020",26,26,0,120676.3,1387.923,89.38462
"28570","85247","2020",5,5,0,119560,1296.6,93
"28571","85248","2020",6,6,0,136816.7,1138.167,122
"28572","85250","2020",31,31,0,196690.8,2028.355,99.29032
"28573","85251","2020",12,12,0,129220.8,1203.75,108.0833
"28574","85252","2020",6,6,0,132133.3,1333.5,117.1667
"28575","85254","2020",25,25,0,126589.3,1155.12,104.92
"28576","85255","2020",72,71,1,139768.6,1722.931,83.16667
"28577","85256","2020",14,14,0,117607.1,1454.071,84.14286
"28578","85259","2020",14,13,1,191097.1,1728.714,108.4286
"28579","85260","2020",17,17,0,161764.7,1562.529,107.1176
"28580","85261","2020",1,1,0,140000,1120,125
"28581","85262","2020",50,42,8,169300.5,1916.18,89.26
"28582","85264","2020",16,16,0,100750,1010.25,102
"28583","85265","2020",10,10,0,142386,1173.5,119.1
"28584","85266","2020",16,16,0,126822.5,1213.875,104.9375
"28585","85267","2020",14,14,0,156767.1,1614.143,101.6429
"28586","85268","2020",30,30,0,197901.3,2122.333,93.86667
"28587","85269","2020",7,7,0,94142.86,1488.571,79
"28588","85271","2020",8,8,0,210418.8,2506.625,84.875
"28589","85273","2020",28,28,0,199850.6,1958.607,103.5
"28590","85274","2020",13,13,0,117190,934,140.9231
"28591","85276","2020",11,11,0,109522.7,1095.364,98.45455
"28592","85277","2020",33,33,0,140874.2,1536.394,94.60606
"28593","85278","2020",71,63,8,190952.9,3023.239,70.91549
"28594","85280","2020",51,51,0,210793.4,1975.588,107.9412
"28595","85281","2020",20,20,0,139888,1231.1,116.7
"28596","85282","2020",10,10,0,114665.2,1216.7,97.2
"28597","85284","2020",80,80,0,208712.6,2078.85,101.75
"28598","85285","2020",13,13,0,150876.9,1539.769,99.30769
"28599","85286","2020",12,12,0,129338.7,1354.75,91.91667
"28600","85287","2020",6,6,0,113166.7,955.3333,107.8333
"28601","85288","2020",280,185,95,217169.8,2622.307,79.53929
"28602","85289","2020",10,10,0,90600,1015.7,90.2
"28603","85290","2020",9,9,0,135433.3,1235.333,107.8889
"28604","85291","2020",27,24,3,138956,1358.37,101.0741
"28605","85292","2020",13,13,0,140693.1,1212.769,121.5385
"28606","85293","2020",13,13,0,122496.6,1396.308,92.15385
"28607","85294","2020",248,218,30,195896.3,3118.306,67.07258
"28608","85295","2020",22,22,0,187750.5,1778.5,107.9091
"28609","85296","2020",15,15,0,145166.7,1417.267,103.0667
"28610","85297","2020",26,26,0,116130.8,1297.385,94.34615
"28611","85298","2020",31,30,1,191904,1909.613,98.54839
"28612","85300","2020",59,59,0,184782.7,1784.288,106.1864
"28613","85301","2020",21,21,0,139581,1484.238,96.04762
"28614","85302","2020",43,42,1,153452.9,1619.93,94.16279
"28615","85303","2020",22,22,0,123072.7,1209,109.2273
"28616","85304","2020",19,19,0,141951.1,1364.895,114.1579
"28617","85305","2020",27,27,0,115585.6,1181.111,99.37037
"28618","85306","2020",7,7,0,148342.9,1301.429,117.5714
"28619","86001","2020",11,11,0,86628.82,1058.818,85.72727
"28620","86002","2020",8,8,0,117375,1381.5,84.25
"28621","86003","2020",4,4,0,104250,972,106.5
"28622","86004","2020",11,11,0,115035.5,1167.636,111.3636
"28623","86005","2020",9,9,0,114335.6,1052,112.7778
"28624","86006","2020",12,12,0,73916.67,838.5,85.33333
"28625","86007","2020",18,18,0,138838.1,1461.556,95.27778
"28626","86008","2020",5,5,0,139180,769.8,149.6
"28627","86009","2020",19,19,0,105210.5,1139.158,96
"28628","86010","2020",14,14,0,147877.9,1458.643,107.0714
"28629","86011","2020",4,4,0,129900,1002,116
"28630","86012","2020",3,3,0,97778.33,779.3333,141.6667
"28631","86014","2020",22,22,0,161911.4,1625.045,102.8636
"28632","86015","2020",34,34,0,94145.21,987.0882,93.67647
"28633","86016","2020",26,26,0,172479,1635.385,111.8462
"28634","86017","2020",11,11,0,118911.8,1313.636,96.45455
"28635","86018","2020",4,4,0,132010,1361.25,100
"28636","86019","2020",24,24,0,121278.8,1198.708,100
"28637","86020","2020",4,4,0,135000,1401.5,93.5
"28638","86022","2020",7,7,0,182842.9,1174.143,145.7143
"28639","86023","2020",4,4,0,150875,855,193
"28640","86024","2020",17,17,0,155123.5,1621.176,97.58824
"28641","86025","2020",3,3,0,97466.67,629.6667,117.6667
"28642","86026","2020",6,6,0,129358.3,1197.167,124.8333
"28643","86027","2020",25,24,1,167323,1800.32,94.52
"28644","86028","2020",13,13,0,189730.8,1671.077,114.6154
"28645","86029","2020",18,18,0,129200.6,1156,120.4444
"28646","86031","2020",18,18,0,120246.1,1357.278,91.05556
"28647","86032","2020",24,24,0,162823.1,1290.083,128.1667
"28648","86034","2020",11,11,0,118533.6,1252.818,113
"28649","86035","2020",5,5,0,184200,1289.6,125.8
"28650","86036","2020",8,8,0,131103.8,1371,98.375
"28651","86037","2020",4,4,0,84375,659,119.5
"28652","86038","2020",1,1,0,90000,1098,82
"28653","86039","2020",12,12,0,101269.5,1061.5,97.91667
"28654","86040","2020",5,5,0,69580,626.2,101
"28655","86041","2020",155,90,65,155951.2,1851.174,83.34194
"28656","86042","2020",16,16,0,118375,1238.5,96.1875
"28657","86044","2020",6,6,0,81000,949.1667,86.16667
"28658","86045","2020",23,23,0,135173.9,1347.304,101.4348
"28659","86046","2020",16,16,0,118175.1,1384.938,87.6875
"28660","86047","2020",7,7,0,117410.7,1183.571,105.5714
"28661","86048","2020",17,17,0,170253.6,1558.176,118.1765
"28662","86049","2020",6,6,0,96416.67,873.3333,107.8333
"28663","86050","2020",7,7,0,119524.3,1319.143,96.14286
"28664","86051","2020",2,2,0,90615,1040.5,90.5
"28665","86052","2020",7,7,0,102714.3,1173,109.7143
"28666","86053","2020",30,30,0,147507.1,1266.867,116.6
"28667","86054","2020",8,8,0,62162.5,745.375,88.875
"28668","86055","2020",4,4,0,66976,681,98
"28669","86058","2020",10,10,0,144784.1,1568.4,110.1
"28670","86059","2020",5,5,0,88800,1059,83.8
"28671","86061","2020",15,15,0,79492.33,965.9333,87.4
"28672","86062","2020",67,54,13,152107,1816.224,91.22388
"28673","86063","2020",5,5,0,136093,1500,87.6
"28674","86064","2020",7,7,0,73160,638.2857,110
"28675","86065","2020",9,9,0,139488.9,1263.222,113.2222
"28676","86066","2020",452,340,112,113078.8,1255.701,89.9292
"28677","86068","2020",24,24,0,99910.08,1069.083,91.29167
"28678","86069","2020",5,5,0,82200,830.4,108
"28679","86070","2020",100,90,10,114692.4,1310.58,88.73
"28680","86072","2020",3,3,0,60000,952.3333,67.66667
"28681","86073","2020",5,5,0,77000,733.8,106.6
"28682","86074","2020",11,11,0,143597.7,1230.455,118.0909
"28683","86075","2020",12,12,0,130525,1248.833,106.9167
"28684","86076","2020",35,35,0,186272.1,1635.057,116.8286
"28685","86077","2020",16,16,0,88611.88,965.4375,88.0625
"28686","86078","2020",43,43,0,81136.98,897.2791,97.11628
"28687","86079","2020",6,6,0,86435,731.3333,108.6667
"28688","86080","2020",11,11,0,170154.5,1387.364,134.3636
"28689","86081","2020",15,15,0,145763.3,1362.733,110.8
"28690","86082","2020",56,55,1,114450.4,1034.768,113.625
"28691","86083","2020",15,14,1,132760,1634.267,89.13333
"28692","86084","2020",7,7,0,43685.71,675.7143,74.14286
"28693","86085","2020",1,1,0,113000,1329,85
"28694","86086","2020",10,10,0,94036.6,1068.2,90.6
"28695","86087","2020",5,5,0,97300,777,125.6
"28696","86088","2020",7,6,1,219276.6,1976.714,111.8571
"28697","86089","2020",5,5,0,103090,898.2,109.4
"28698","86090","2020",2,2,0,90000,745,129.5
"28699","86091","2020",6,6,0,361195,2736,152.6667
"28700","86092","2020",39,38,1,124905.3,1242.795,100.6923
"28701","86093","2020",2,2,0,116500,1266,92
"28702","86094","2020",9,9,0,128222.2,1259.778,104.4444
"28703","86095","2020",56,56,0,158722.7,1567.429,103.0714
"28704","86096","2020",5,5,0,112200,1138.6,98
"28705","86097","2020",5,5,0,73700,612,118.2
"28706","86098","2020",3,3,0,70400,764,93.33333
"28707","86099","2020",18,18,0,145916.7,1533.667,97.16667
"28708","86100","2020",45,42,3,200084.4,1959.267,109.4444
"28709","86102","2020",6,6,0,149316.7,1287.667,113.8333
"28710","86103","2020",17,17,0,113600,1272,92.76471
"28711","86104","2020",7,7,0,79510,816.1429,96.14286
"28712","86105","2020",2,2,0,122950,1030,120.5
"28713","86106","2020",3,3,0,93333.33,485.6667,174.6667
"28714","86107","2020",12,12,0,73116.67,1002.583,72.75
"28715","86108","2020",3,3,0,78000,823.3333,92.66667
"28716","86109","2020",3,3,0,66666.67,1281.333,67.33333
"28717","86110","2020",3,3,0,122253.3,821.6667,138.6667
"28718","86111","2020",21,21,0,121889,1129.524,111.2857
"28719","86112","2020",24,24,0,82325,937.2917,92.95833
"28720","86113","2020",31,30,1,153064.2,1559.161,100.7742
"28721","86114","2020",9,9,0,190377.8,1725.111,109.5556
"28722","86115","2020",106,93,13,158136.4,1690.349,99.46226
"28723","86116","2020",11,11,0,116915.2,1073.545,107.7273
"28724","86117","2020",4,4,0,118825,1331.5,89.25
"28725","86118","2020",4,4,0,97000,926.25,106
"28726","86119","2020",2,2,0,65150,1357.5,60
"28727","86120","2020",16,15,1,77289.38,915.75,81.8125
"28728","86121","2020",20,20,0,110720,1091.75,99.6
"28729","86122","2020",1,1,0,1e+05,1042,96
"28730","86123","2020",46,46,0,123407.3,1249.609,103.6957
"28731","86124","2020",6,6,0,152991.7,1966.667,80.5
"28732","86125","2020",14,14,0,103830,1039.286,98.5
"28733","86126","2020",9,9,0,104801.1,965.2222,111.3333
"28734","86127","2020",3,3,0,111300,1172,91.66667
"28735","86128","2020",42,42,0,125789.3,1217.881,105.8333
"28736","86129","2020",9,9,0,123095.6,1299.667,96.77778
"28737","86130","2020",8,8,0,74375,1028.5,85.625
"28738","86131","2020",10,10,0,107530,1004.2,118.9
"28739","86132","2020",6,6,0,75475,793.8333,104.3333
"28740","86133","2020",54,54,0,164572.3,1734.556,94.48148
"28741","86134","2020",1,1,0,304640,1061,287
"28742","86135","2020",5,5,0,162900,1497.4,107.6
"28743","86136","2020",7,7,0,99142.86,862.1429,107.1429
"28744","86137","2020",86,77,9,103344.1,1053.337,96.80233
"28745","86138","2020",7,7,0,84964.29,598.8571,138.1429
"28746","86139","2020",32,32,0,92903.12,1008.719,91.75
"28747","86140","2020",27,27,0,99941.52,1043.815,95.88889
"28748","86141","2020",14,14,0,141228.6,1126.214,126
"28749","86142","2020",8,8,0,154112.6,1160,144
"28750","86143","2020",1,1,0,54500,940,58
"28751","86144","2020",4,4,0,147237.5,1548.25,113.5
"28752","86145","2020",16,16,0,165743.9,1456.75,116.8125
"28753","86147","2020",8,8,0,149562.5,1276.25,123
"28754","86148","2020",4,4,0,125905,993,122.25
"28755","86149","2020",5,5,0,91000,932.2,103.6
"28756","86150","2020",4,4,0,97600,1127,85
"28757","86151","2020",1,1,0,74500,2483,30
"28758","86152","2020",14,14,0,101574.3,1145.929,89.5
"28759","86153","2020",12,12,0,91708.33,1044.5,85.83333
"28760","86154","2020",1,1,0,68000,1046,65
"28761","86156","2020",4,4,0,100500,862.25,118.5
"28762","86157","2020",69,61,8,189687.7,2008.232,97.49275
"28763","86158","2020",68,64,4,174183.4,1726.5,104.3824
"28764","86159","2020",9,9,0,100444.4,951.5556,122.3333
"28765","86160","2020",42,42,0,108313.6,1129.738,99.38095
"28766","86161","2020",12,12,0,99642.5,976.75,100.8333
"28767","86162","2020",6,6,0,138673.3,1088.667,130.3333
"28768","86163","2020",42,41,1,220878.1,1918,115.0714
"28769","86164","2020",6,6,0,109316.7,1149.167,103
"28770","86165","2020",94,83,11,101711.6,1294.745,93.7766
"28771","86167","2020",8,8,0,94000,923.25,97
"28772","86169","2020",4,4,0,97250,1078,90
"28773","86170","2020",16,16,0,67908.56,791.875,86.375
"28774","86171","2020",11,11,0,77681.82,772.7273,103.1818
"28775","86172","2020",2,2,0,49750,595.5,86.5
"28776","86173","2020",9,9,0,147911.1,1445.556,125.6667
"28777","86174","2020",69,69,0,137896.9,1406.913,100.1014
"28778","86175","2020",4,3,1,49500,731.25,59
"28779","86177","2020",81,72,9,164893.7,1616.037,106.358
"28780","86178","2020",23,23,0,151212.7,1573.348,96.65217
"28781","86180","2020",27,27,0,196953.7,1692.37,117.7407
"28782","86181","2020",3,3,0,86000,628.6667,137.6667
"28783","86182","2020",6,6,0,86450,1104.333,81
"28784","86183","2020",25,25,0,129438.5,1256.84,110
"28785","86184","2020",13,13,0,123214.6,1311.923,98.84615
"28786","86186","2020",12,12,0,210209.2,1426.833,143.3333
"28787","86187","2020",3,3,0,177333.3,1673.333,106
"28788","86189","2020",5,5,0,111390,947.6,109.8
"28789","86190","2020",8,8,0,117240,1153.375,102
"28790","86191","2020",3,3,0,94000,1041,87
"28791","86193","2020",15,15,0,98913.33,911.9333,106.6
"28792","86194","2020",1507,547,960,129523,1942.365,70.00133
"28793","86195","2020",8,8,0,108421.2,1091.25,98.375
"28794","86197","2020",6,6,0,63766.67,1065.667,68.16667
"28795","86198","2020",7,7,0,195428.6,1470.286,133.4286
"28796","86200","2020",8,8,0,103837.5,904.75,108.375
"28797","86201","2020",5,5,0,110900,1067.2,108.2
"28798","86202","2020",9,9,0,142573.3,1092.778,121.2222
"28799","86203","2020",15,15,0,62500,904.9333,70.4
"28800","86204","2020",27,27,0,203019.9,1728.037,118.1481
"28801","86205","2020",3,3,0,73500,698,108.3333
"28802","86207","2020",40,25,15,104252.9,1495.275,76.05
"28803","86209","2020",33,33,0,155397,1571.061,100.2121
"28804","86210","2020",15,15,0,121693.3,1119.267,109.4
"28805","86211","2020",12,12,0,91608.33,902.75,100.5833
"28806","86213","2020",37,37,0,108192.4,1086.486,100.2703
"28807","86214","2020",111,81,30,163737,1871.126,89.98198
"28808","86217","2020",3,3,0,80666.67,935.3333,98.66667
"28809","86218","2020",5,5,0,80700,860.6,89.6
"28810","86220","2020",5,5,0,133980,957.4,134.8
"28811","86221","2020",9,9,0,158944.4,1272.111,126.8889
"28812","86222","2020",45,44,1,187685.9,1669.222,115.9778
"28813","86223","2020",20,20,0,100725.5,908.7,104.2
"28814","86224","2020",9,9,0,115708.8,1230.889,100.2222
"28815","86225","2020",20,19,1,82150,833.65,105.85
"28816","86226","2020",31,31,0,177679.6,1580.452,117.5484
"28817","86227","2020",4,4,0,76000,817.25,102.25
"28818","86228","2020",3,3,0,72333.33,868,86
"28819","86229","2020",6,6,0,77583.33,984.1667,78.16667
"28820","86230","2020",5,5,0,72641,1046.2,83.2
"28821","86231","2020",11,11,0,80104.55,739.6364,108.5455
"28822","86233","2020",40,40,0,112748.4,1125.85,96.975
"28823","86234","2020",6,6,0,70250,730.8333,94.83333
"28824","86235","2020",10,10,0,97250,886.4,108.6
"28825","86236","2020",14,14,0,129932.2,1566.071,80.71429
"28826","86237","2020",11,11,0,100084.5,1030.636,96.09091
"28827","86239","2020",4,4,0,100787.5,1067.25,98.75
"28828","86241","2020",10,10,0,59360,777.3,77.1
"28829","86242","2020",3,3,0,50333.33,525,93.33333
"28830","86244","2020",18,18,0,81460,820.6667,100.3333
"28831","86245","2020",20,20,0,117993.5,1277.7,93.6
"28832","86246","2020",14,14,0,68351.93,683.9286,97.64286
"28833","86247","2020",6,6,0,86250,890,102.5
"28834","86248","2020",3,3,0,50000,771,74.66667
"28835","86249","2020",3,3,0,102333.3,1043.667,105
"28836","86250","2020",5,5,0,94963,936.2,98.8
"28837","86252","2020",7,7,0,174177.7,1318.429,135.4286
"28838","86253","2020",6,6,0,88699.83,1023.333,83.83333
"28839","86254","2020",9,9,0,122288.9,1306.333,92.11111
"28840","86255","2020",16,16,0,85887.5,782.5,109.875
"28841","86256","2020",12,12,0,181791.7,1807.583,106.1667
"28842","86257","2020",4,4,0,163875,1254.5,134.5
"28843","86258","2020",24,24,0,102105,1098.375,96.58333
"28844","86260","2020",7,7,0,129071.4,994.2857,138.4286
"28845","86261","2020",21,21,0,187988.6,1742.381,107.9048
"28846","86262","2020",8,8,0,103812.5,1170.5,90.75
"28847","86263","2020",35,34,1,159762.9,1664.943,97.62857
"28848","86264","2020",8,8,0,104875,888.375,123.25
"28849","86265","2020",8,8,0,167750,1272.5,124.5
"28850","86266","2020",2,2,0,196506,917.5,206
"28851","86268","2020",11,11,0,164727.3,1721.727,99.54545
"28852","86270","2020",2,2,0,90000,902,96
"28853","86271","2020",12,12,0,125975,1364.167,100.4167
"28854","86272","2020",39,39,0,138213.3,1254.821,111.4103
"28855","86273","2020",11,11,0,92490.91,1112.636,85.90909
"28856","86274","2020",6,6,0,99750,1029.5,92.5
"28857","86275","2020",9,9,0,116466.7,1182.222,92.77778
"28858","86276","2020",11,11,0,102200,857.1818,126.5455
"28859","86279","2020",8,8,0,96125,905.75,113.75
"28860","86280","2020",4,4,0,68750,711,102.5
"28861","86281","2020",66,66,0,153664.5,1376.076,113.3939
"28862","86284","2020",3,3,0,396673.3,2158,158
"28863","86285","2020",11,11,0,126418.2,1190.909,104.9091
"28864","86286","2020",6,6,0,188647.8,2307.667,107
"28865","86287","2020",2,2,0,118500,1280.5,93
"28866","86288","2020",12,12,0,65291.67,710.9167,91.58333
"28867","86289","2020",18,18,0,133417.8,1248.167,108.8889
"28868","86290","2020",19,19,0,161018.7,1603.368,101.8947
"28869","86291","2020",3,3,0,117033.3,859.6667,113.6667
"28870","86292","2020",9,9,0,179005.6,1465.556,120.7778
"28871","86293","2020",57,57,0,144216.3,1424.053,103.0351
"28872","86294","2020",50,49,1,162382.3,1541.3,106.66
"28873","86295","2020",15,15,0,97950.53,943.0667,100.1333
"28874","86296","2020",2,2,0,135995,1397,97.5
"28875","86297","2020",75,74,1,186419.4,1858.187,101.04
"28876","86298","2020",34,25,9,118368,2318.265,80.79412
"28877","86299","2020",7,7,0,137157.1,1012.143,141.1429
"28878","86300","2020",8,8,0,140912.5,1614.75,89.875
"28879","87001","2020",82,79,3,153255.1,1573.207,100.2805
"28880","87002","2020",58,53,5,126115.7,1415.879,91.18966
"28881","87003","2020",12,12,0,73636.25,844,86.58333
"28882","87004","2020",2,2,0,116137.5,991,107
"28883","87005","2020",9,9,0,145711.1,1580.556,86
"28884","87006","2020",2,2,0,51000,627.5,81.5
"28885","87007","2020",4,4,0,62325,746,84
"28886","87008","2020",1,1,0,80000,530,151
"28887","87009","2020",9,9,0,121038.9,1112.222,115.7778
"28888","87011","2020",40,37,3,87408.38,945.425,99.525
"28889","87012","2020",10,10,0,102687,951.9,117.4
"28890","87013","2020",5,5,0,85250,943.2,92.6
"28891","87014","2020",25,23,2,114044.7,1226.8,89.28
"28892","87015","2020",10,10,0,162207.6,1462.1,112.7
"28893","87016","2020",6,6,0,68500,817.5,85.66667
"28894","87017","2020",5,5,0,122010,1130.8,111
"28895","87018","2020",8,8,0,98750,949.625,114.625
"28896","87019","2020",26,26,0,203374.5,1862.769,109.0385
"28897","87020","2020",13,13,0,193878.5,1935.769,100.8462
"28898","87021","2020",30,30,0,150553.3,1666.8,91.03333
"28899","87022","2020",2,2,0,86500,1020.5,88
"28900","87023","2020",3,3,0,119000,1163,105.6667
"28901","87024","2020",21,21,0,88693.76,984.9048,92.90476
"28902","87025","2020",9,8,1,172527.8,1489.111,119.2222
"28903","87027","2020",26,24,2,84112.12,889.2692,92.69231
"28904","87028","2020",29,29,0,105049.3,1064.724,100.2759
"28905","87029","2020",7,7,0,93700,1050.143,87.42857
"28906","87030","2020",10,10,0,175012,1531.4,113.9
"28907","87031","2020",2,2,0,68750,729.5,94
"28908","87032","2020",20,20,0,84496.25,1083.55,77.35
"28909","87033","2020",12,12,0,100805.7,1131.5,88.66667
"28910","87034","2020",14,14,0,93628.93,955.1429,102.0714
"28911","87035","2020",5,5,0,151000,1576.2,100.8
"28912","87036","2020",17,17,0,98643.35,1055.294,99
"28913","87037","2020",4,4,0,132450,1162,120.5
"28914","87038","2020",30,30,0,188856.6,1764.067,108.3333
"28915","87039","2020",11,11,0,97540.91,1114,89.63636
"28916","87040","2020",20,20,0,97595.55,1024.1,95.3
"28917","87041","2020",44,44,0,92019.2,928.6364,102.0227
"28918","87042","2020",8,8,0,133375,1181.5,115.375
"28919","87043","2020",5,5,0,110173.4,1158.4,97.6
"28920","87044","2020",9,9,0,161050,1321,120.3333
"28921","87045","2020",13,13,0,164257.7,1655.692,98.46154
"28922","87046","2020",19,19,0,121486.3,1189.895,100.4211
"28923","87047","2020",22,22,0,129630.2,1294.091,97.45455
"28924","87048","2020",62,52,10,168089.5,1587.226,106.8065
"28925","87049","2020",20,20,0,97083,1102.85,92.65
"28926","87050","2020",111,93,18,187503.2,1726.342,110.8919
"28927","87051","2020",19,18,1,96563.16,1149.263,86.89474
"28928","87052","2020",3,3,0,49333.33,1355.667,40
"28929","87053","2020",4,4,0,134950,1254.5,104
"28930","87054","2020",22,22,0,99710.23,1154.273,93.09091
"28931","87056","2020",1,1,0,145000,993,146
"28932","87057","2020",5,5,0,72569.8,624.8,117.2
"28933","87058","2020",4,4,0,129750,1308.25,107.5
"28934","87059","2020",24,23,1,81088.75,774.4583,98.41667
"28935","87060","2020",17,17,0,126106.4,1441.647,86.94118
"28936","87061","2020",8,8,0,68418.62,737.625,90
"28937","87062","2020",4,4,0,113100,1300,86.5
"28938","87063","2020",8,8,0,123818.8,1565.625,81
"28939","87064","2020",20,20,0,106045,999,110
"28940","87065","2020",48,44,4,183967.7,1672.938,112.125
"28941","87066","2020",12,12,0,120875,1361.417,92
"28942","87067","2020",10,10,0,60370,766.9,78.7
"28943","87068","2020",3,3,0,110186,1503.667,95
"28944","87069","2020",1,1,0,89842,1797,50
"28945","87070","2020",13,13,0,153276.5,1424.615,108.1538
"28946","87071","2020",4,4,0,127550,884.75,125
"28947","87072","2020",4,4,0,98407.5,1194.75,81.5
"28948","87073","2020",7,7,0,134602.4,1395.286,94.14286
"28949","87075","2020",86,74,12,166549.8,1781.349,96.19767
"28950","87076","2020",4,4,0,64500,676.75,96
"28951","87077","2020",8,8,0,116450,1140.5,99.75
"28952","87078","2020",9,9,0,137772.1,1255.444,119.6667
"28953","87079","2020",13,13,0,89857.69,1049.846,89.07692
"28954","87080","2020",2,2,0,127500,950.5,134
"28955","87081","2020",11,11,0,165827.3,1493.182,115.9091
"28956","87082","2020",32,32,0,106260.3,1205.281,90.09375
"28957","87083","2020",9,9,0,75711.11,916.2222,86.44444
"28958","87084","2020",1,1,0,206700,1308,158
"28959","87085","2020",2077,644,1433,115062.8,1584.455,72.31584
"28960","87086","2020",21,21,0,81940.48,843.9524,100.5238
"28961","87087","2020",16,15,1,58864.69,715,87.625
"28962","87088","2020",17,17,0,117252.9,1332.706,89.88235
"28963","87089","2020",21,21,0,87180.86,848.9048,101.8095
"28964","87090","2020",5,5,0,77100,747.6,96
"28965","87091","2020",12,12,0,101005,1467,89.33333
"28966","87092","2020",8,8,0,95411.25,928.75,104
"28967","87093","2020",4,4,0,90250,1350,72.25
"28968","87094","2020",12,12,0,125199.5,1317.417,92.08333
"28969","87095","2020",13,13,0,121263.1,1136.538,107.7692
"28970","87096","2020",11,11,0,73145.45,1323.636,73.54545
"28971","87097","2020",22,22,0,73809.77,822.7727,92.63636
"28972","87099","2020",3,3,0,131666.7,764.6667,179.3333
"28973","87100","2020",2,2,0,69500,919.5,64
"28974","87101","2020",1,1,0,32000,390,82
"28975","87103","2020",22,22,0,99276.18,1050.455,95.77273
"28976","87104","2020",8,8,0,101457.5,1070.875,97.25
"28977","87105","2020",13,13,0,104092.3,1103.385,97.30769
"28978","87106","2020",33,32,1,124020,1185.121,109.0909
"28979","87107","2020",14,14,0,126042.5,1332.929,96.21429
"28980","87108","2020",5,4,1,78039.4,997,90.6
"28981","87109","2020",6,6,0,138116.7,1236.667,99.83333
"28982","87110","2020",19,19,0,132490.8,1542.105,96.57895
"28983","87111","2020",31,31,0,119183.2,1097.484,111.9355
"28984","87112","2020",6,6,0,98000,1260.167,85.66667
"28985","87113","2020",53,53,0,146919.8,1682.868,89.30189
"28986","87114","2020",143,122,21,169514.3,1695.615,101.4476
"28987","87115","2020",3,3,0,100766.7,847,130.6667
"28988","87116","2020",16,16,0,113027.9,1121.688,103.4375
"28989","87117","2020",23,23,0,86020,1067.652,83.82609
"28990","87118","2020",16,16,0,93089.56,970.4375,98.6875
"28991","87119","2020",22,22,0,114646.8,1236.545,96.5
"28992","87120","2020",13,13,0,103003.8,1178.154,93.15385
"28993","87121","2020",8,8,0,85410.75,702.875,117
"28994","87122","2020",16,16,0,127259.7,1126,115.4375
"28995","87123","2020",4,4,0,93875,991.5,105
"28996","87124","2020",6,6,0,111166.7,1233.167,91.16667
"28997","87125","2020",64,63,1,161042.2,1636.797,101.2031
"28998","87126","2020",55,54,1,101128.6,1141.782,91.12727
"28999","87127","2020",4,4,0,82250,1102.5,81.75
"29000","87128","2020",17,17,0,98277.65,1107.059,89.17647
"29001","87129","2020",12,12,0,126579.2,1313.083,97.91667
"29002","87130","2020",2,2,0,79000,834,92.5
"29003","87131","2020",15,15,0,105608.7,1145.267,94.33333
"29004","87132","2020",2,2,0,94435,1707,50
"29005","87133","2020",5,5,0,59194.6,568.2,105.8
"29006","87135","2020",14,14,0,95571.43,818.6429,118.4286
"29007","87137","2020",2,2,0,53085,732.5,72.5
"29008","87138","2020",12,12,0,83555.83,1028.167,81.41667
"29009","87139","2020",7,7,0,99750.71,1321.714,79.85714
"29010","87140","2020",16,16,0,131693.3,1557.062,85.625
"29011","87141","2020",12,12,0,95780,1091,85.58333
"29012","87142","2020",5,5,0,64960,705,94.2
"29013","87143","2020",22,22,0,140376.4,1455.909,101.3182
"29014","87144","2020",8,8,0,144600,1668.5,92.875
"29015","87145","2020",5,5,0,88414.4,933,115.2
"29016","87146","2020",16,16,0,114785.9,1466.125,89.5
"29017","87147","2020",1,1,0,91000,1083,84
"29018","87148","2020",4,4,0,138500,1322,101.75
"29019","87149","2020",4,4,0,102110.5,718,148.75
"29020","87150","2020",6,6,0,123933.3,1031.833,116
"29021","87151","2020",7,7,0,187700,1343,139.2857
"29022","87152","2020",19,19,0,123081.6,1455.526,89.15789
"29023","87153","2020",6,6,0,48143.33,872,61.5
"29024","87154","2020",154,140,14,131969.3,1417.909,99.06494
"29025","87156","2020",19,19,0,214081.6,1435,151.1579
"29026","87157","2020",13,13,0,105069.2,1207.615,96.53846
"29027","87158","2020",22,21,1,99072.5,1091.955,93.68182
"29028","87159","2020",4,4,0,88467.5,861.5,106.75
"29029","87160","2020",8,8,0,88687.5,918.5,91.5
"29030","87161","2020",62,53,9,117299.6,1201.339,99.37097
"29031","87162","2020",7,7,0,121992.9,976.1429,122
"29032","87163","2020",1,1,0,155000,1192,130
"29033","87164","2020",9,9,0,120930.6,1536,89.33333
"29034","87165","2020",4,4,0,123250,760.75,133
"29035","87166","2020",13,13,0,166219.2,1527.769,113.7692
"29036","87167","2020",12,12,0,147586,1497.833,104.8333
"29037","87168","2020",22,21,1,96730.45,905.5,103.7273
"29038","87169","2020",9,9,0,136866.7,1425.333,93.77778
"29039","87170","2020",5,5,0,91570,1133.6,87.4
"29040","87172","2020",2,2,0,58000,696.5,72.5
"29041","87174","2020",17,17,0,106236.8,1256.882,87.76471
"29042","87176","2020",13,12,1,132583.1,1475.231,89.61538
"29043","87177","2020",24,24,0,147211.7,1538.958,102.2917
"29044","87178","2020",39,39,0,133791.4,1344.128,98.48718
"29045","87179","2020",3,3,0,87032.67,789.6667,106.3333
"29046","87180","2020",9,9,0,105206.1,780.6667,124.6667
"29047","87181","2020",12,12,0,77017.5,821.1667,102.3333
"29048","87182","2020",19,19,0,86156.47,853.6842,97.52632
"29049","87183","2020",8,8,0,115937.5,1215.75,98
"29050","87185","2020",35,35,0,137440.3,1379.171,98.77143
"29051","87186","2020",6,6,0,100960.3,1213,91
"29052","87187","2020",106,97,9,115345.7,1284.528,92.96226
"29053","87188","2020",3,3,0,96333.33,1187,82
"29054","87189","2020",10,10,0,137252.4,1192.2,112.5
"29055","87190","2020",11,11,0,95225.45,1281.364,81.36364
"29056","87191","2020",20,20,0,123388.1,1209.15,103.7
"29057","87192","2020",20,18,2,180747.5,1989.3,117.7
"29058","87193","2020",1,1,0,58000,1450,40
"29059","87194","2020",4,4,0,82750,906.25,95.75
"29060","87197","2020",7,7,0,124927.4,1387.429,92.42857
"29061","87198","2020",11,11,0,91195.45,894,95.36364
"29062","87199","2020",12,12,0,90300.42,1067.333,84.08333
"29063","87200","2020",2,2,0,81500,789,103.5
"29064","87201","2020",49,49,0,190646.1,1751.265,112.3265
"29065","87202","2020",23,23,0,154295.1,1170.174,132.7391
"29066","87203","2020",20,20,0,107980,1123.1,95.5
"29067","87204","2020",4,4,0,119375,971.25,119.25
"29068","87205","2020",22,21,1,239543.3,2259.727,109.2727
"29069","87206","2020",3,3,0,111533.3,1044.333,97.33333
"29070","88003","2020",1,1,0,144500,1326,109
"29071","88004","2020",1,1,0,20000,345,58
"29072","88005","2020",9,9,0,142201.7,1357.111,110.7778
"29073","88006","2020",3,3,0,89300,848,116.3333
"29074","88008","2020",2,2,0,80755,720,108
"29075","88009","2020",41,39,2,148602,1566.61,99.31707
"29076","88011","2020",7,6,1,153227.1,1332.857,115.8571
"29077","88012","2020",20,16,4,110450,1245.85,85.95
"29078","88014","2020",1,1,0,97000,1617,60
"29079","88015","2020",2,2,0,69000,552.5,113
"29080","88016","2020",1,1,0,47000,588,80
"29081","88017","2020",1,1,0,165000,859,192
"29082","88019","2020",2,2,0,108500,1095.5,91.5
"29083","88020","2020",1,1,0,60200,557,108
"29084","88021","2020",1,1,0,122000,968,126
"29085","88022","2020",2,2,0,86500,756,110
"29086","88023","2020",1,1,0,105000,808,130
"29087","88024","2020",1,1,0,132050,1158,114
"29088","88025","2020",1,1,0,45500,337,135
"29089","88026","2020",5,5,0,213140,1821.6,115.6
"29090","88027","2020",3,3,0,133200,1054.667,121
"29091","88028","2020",5,4,1,116700,1206.4,101.4
"29092","88029","2020",24,23,1,84396,858.3333,105.1667
"29093","88031","2020",1,1,0,67960,557,122
"29094","88032","2020",16,16,0,159265,1556.25,105
"29095","88033","2020",3,3,0,157480,1026.333,159.3333
"29096","88035","2020",2,2,0,117500,1393,84.5
"29097","88037","2020",7,7,0,159348.6,2020.857,82.85714
"29098","88039","2020",3,3,0,94266.67,809.6667,120.3333
"29099","88040","2020",1,1,0,143500,1527,94
"29100","88041","2020",1,1,0,182800,1677,109
"29101","88042","2020",1,1,0,38000,543,70
"29102","88043","2020",2,2,0,125500,1091.5,110
"29103","88044","2020",8,8,0,88912.5,864.5,96
"29104","88045","2020",1,1,0,15000,375,40
"29105","88047","2020",1,1,0,138000,1516,91
"29106","88048","2020",12,12,0,118150,1162.75,102.0833
"29107","88049","2020",3,3,0,125333.3,900.3333,136.6667
"29108","88050","2020",3,3,0,98688.33,1055,92
"29109","88051","2020",3,3,0,106245,833.6667,118.6667
"29110","88053","2020",1,1,0,46250,1217,38
"29111","88054","2020",5,5,0,150060,1241,114.4
"29112","88055","2020",3,3,0,63780,648.6667,104
"29113","88056","2020",2,2,0,47000,516,85
"29114","88057","2020",2,2,0,41500,375,109.5
"29115","88058","2020",1,1,0,30000,400,75
"29116","88059","2020",8,7,1,86359.38,1127.25,88.875
"29117","88061","2020",2,2,0,174280,1189.5,143
"29118","88063","2020",1,1,0,110000,873,126
"29119","88064","2020",1,1,0,157850,1644,96
"29120","88065","2020",1,1,0,175000,1620,108
"29121","88068","2020",9,9,0,156575.6,1389.444,112.4444
"29122","88069","2020",3,3,0,178000,1003.667,179
"29123","88073","2020",2,2,0,77500,830.5,94.5
"29124","88074","2020",1,1,0,170000,977,174
"29125","88075","2020",107,49,58,135853,2103.505,71.69159
"29126","88076","2020",6,6,0,81916.67,732.8333,115.6667
"29127","88077","2020",7,7,0,106042.9,1008.571,123
"29128","88078","2020",30,21,9,95213.33,987.2333,99.36667
"29129","88079","2020",9,9,0,119236.1,1096.889,118
"29130","88080","2020",2,2,0,106000,861,121.5
"29131","88081","2020",34,27,7,102701.2,1219.147,93.11765
"29132","88082","2020",16,15,1,88080.62,844.6875,105.875
"29133","88083","2020",3,2,1,102933.3,881.3333,118
"29134","88084","2020",3,3,0,160166.7,1650.667,95.66667
"29135","88085","2020",4,4,0,105750,1422.75,82
"29136","88086","2020",5,4,1,112820,1001.2,113.2
"29137","88087","2020",50,29,21,129678.8,1377.94,85.98
"29138","88088","2020",5,5,0,135984,1243.4,141
"29139","88089","2020",11,11,0,122165.5,979.0909,124.8182
"29140","88090","2020",51,39,12,142618.5,1366.588,107.2941
"29141","88092","2020",7,7,0,98628.57,985.2857,112.5714
"29142","88094","2020",19,15,4,148283.2,1367.684,102.7895
"29143","88095","2020",20,20,0,113376.8,1107.5,103.25
"29144","88096","2020",1,1,0,132590,947,140
"29145","88097","2020",1,1,0,32000,889,36
"29146","88098","2020",9,7,2,125185.6,1320.444,96.44444
"29147","88099","2020",12,10,2,149758.3,1512.833,100.1667
"29148","88101","2020",9,8,1,172011.1,1424.333,118.7778
"29149","88104","2020",2,2,0,104475,1015,100
"29150","88105","2020",2,2,0,41500,549,73
"29151","88106","2020",24,24,0,176798.5,1873.625,101.5833
"29152","88107","2020",1,1,0,141500,1179,120
"29153","88108","2020",9,9,0,120500,1081.222,122.3333
"29154","88109","2020",2,2,0,92500,941.5,97.5
"29155","88110","2020",1,1,0,192000,1920,100
"29156","88111","2020",5,5,0,122442,1118.8,108.2
"29157","88113","2020",2,2,0,322470,1411.5,233
"29158","88114","2020",36,28,8,108771.4,1191.667,93.47222
"29159","88115","2020",21,20,1,136034,1245.095,115.8095
"29160","88116","2020",43,28,15,110302,1163.93,96.39535
"29161","88117","2020",1,1,0,155000,1033,150
"29162","88118","2020",12,12,0,124280,1178.917,108.5
"29163","88120","2020",7,4,3,71857.14,714.1429,99.14286
"29164","88121","2020",1,1,0,25000,357,70
"29165","88122","2020",3,2,1,98000,1019.667,99.66667
"29166","88123","2020",3,3,0,82500,682,131.3333
"29167","88124","2020",7,6,1,87955.71,848.5714,104.4286
"29168","88126","2020",15,9,6,161753.3,1426.933,112.9333
"29169","88130","2020",3,3,0,115500,955,121
"29170","88132","2020",16,14,2,148036.2,1402,107.4375
"29171","88134","2020",5,3,2,130600,1388.4,92
"29172","88135","2020",2,2,0,123150,1393.5,88.5
"29173","88136","2020",10,10,0,146748.7,1404.1,110.5
"29174","88140","2020",1,1,0,105900,1246,85
"29175","88142","2020",3,3,0,205536.7,1215,161
"29176","88145","2020",4,4,0,79500,813,102
"29177","88146","2020",1,1,0,23000,479,48
"29178","88147","2020",4,4,0,146075,1917.25,83
"29179","88148","2020",33,27,6,157829.2,1488.03,107.6364
"29180","88150","2020",3,3,0,80176.67,914.3333,97
"29181","88151","2020",11,11,0,104615.9,809.8182,127.1818
"29182","88152","2020",3,3,0,130600,1278.333,102.3333
"29183","88154","2020",2,2,0,64750,600.5,109
"29184","88157","2020",11,10,1,182436.4,2318.182,101.3636
"29185","88158","2020",22,16,6,103018.2,1108.773,93.18182
"29186","88159","2020",5,5,0,145820,1393,100
"29187","88160","2020",489,200,289,113908.1,1310.885,84.58078
"29188","88161","2020",3,3,0,81000,1244.667,82
"29189","88163","2020",7,7,0,175322.9,1695.571,105.4286
"29190","88165","2020",15,15,0,116501.7,1214.867,98.33333
"29191","88166","2020",7,7,0,141093.6,1642.286,79
"29192","88167","2020",1,1,0,93600,1017,92
"29193","88168","2020",1,1,0,60250,568,106
"29194","88169","2020",2,2,0,153712.5,1618,100.5
"29195","88170","2020",11,10,1,110436.7,1043,102.5455
"29196","88172","2020",2,2,0,77000,977,79
"29197","88173","2020",8,8,0,156287.5,1609,98.25
"29198","88175","2020",3,3,0,184543.7,1440,119.6667
"29199","88176","2020",8,8,0,70603.88,773.375,90.5
"29200","88177","2020",6,5,1,186466.7,1862.833,98.33333
"29201","88178","2020",20,20,0,188674,1751,107.9
"29202","88179","2020",1,1,0,135000,964,140
"29203","88181","2020",38,26,12,105122.7,1141.5,91.07895
"29204","88182","2020",1,1,0,55000,550,100
"29205","88183","2020",1,1,0,62500,595,105
"29206","88184","2020",5,5,0,73180,857.6,90.6
"29207","88186","2020",1,1,0,67000,670,100
"29208","88188","2020",18,16,2,112659.4,1233.5,96.22222
"29209","88189","2020",4,4,0,90925,1085.25,85.5
"29210","88190","2020",4,4,0,96604.5,968.5,97
"29211","88192","2020",3,3,0,120333.3,717,163
"29212","88193","2020",2,2,0,166750,2122,81
"29213","88195","2020",4,4,0,58000,490,116.5
"29214","88196","2020",221,76,145,170079,2405.986,74.59276
"29215","88197","2020",4,4,0,120500,1315,102
"29216","88198","2020",16,15,1,174009.4,1867.875,96.6875
"29217","88199","2020",1,1,0,121000,858,141
"29218","88201","2020",11,10,1,147239.9,1162.182,132.4545
"29219","88202","2020",2,2,0,95625,1085.5,88
"29220","88203","2020",1,1,0,145000,1495,97
"29221","88205","2020",2,2,0,108851,1287.5,105
"29222","88206","2020",14,14,0,94935.71,964,101.7143
"29223","88208","2020",1,1,0,90000,750,120
"29224","88209","2020",108,71,37,139439.2,1452.963,97.21296
"29225","88212","2020",5,5,0,80780,723.8,116.6
"29226","88213","2020",9,9,0,121279.9,1450.889,82.11111
"29227","88216","2020",6,6,0,132083.3,1356.333,98.16667
"29228","88218","2020",36,30,6,106759.4,1263.861,92.72222
"29229","88219","2020",1,1,0,76150,464,164
"29230","88221","2020",6,6,0,82083.33,516.5,144.3333
"29231","88222","2020",2,2,0,128100,1026,121.5
"29232","88223","2020",1,1,0,66000,455,145
"29233","88224","2020",2,2,0,135515,1340,112
"29234","88225","2020",16,16,0,167413.1,1341.625,129.1875
"29235","88226","2020",1,1,0,97300,1058,92
"29236","88228","2020",3,3,0,105000,749.6667,139
"29237","88229","2020",2,2,0,74000,781.5,92
"29238","88230","2020",1,1,0,30000,400,75
"29239","88231","2020",4,4,0,107902.5,1053.75,103.25
"29240","88232","2020",2,2,0,100650,558,172.5
"29241","88236","2020",1,1,0,162000,1080,150
"29242","88237","2020",2,2,0,143200,663.5,219.5
"29243","88238","2020",2,2,0,114000,671.5,169.5
"29244","88239","2020",1,1,0,105000,955,110
"29245","88241","2020",3,3,0,82100,634.3333,140
"29246","88243","2020",7,6,1,109328.6,1134.143,91.14286
"29247","88244","2020",10,10,0,111792.5,1370.6,94.9
"29248","88245","2020",4,4,0,154050,1432.25,107.5
"29249","88246","2020",4,3,1,70710,652.5,112.75
"29250","88247","2020",9,8,1,131537.8,1449.889,91.77778
"29251","88248","2020",1,1,0,50000,1000,50
"29252","88249","2020",1,1,0,72000,692,104
"29253","88250","2020",4,2,2,99000,1221.25,85
"29254","88251","2020",10,10,0,200135,1424.6,140
"29255","88252","2020",1,1,0,40597,338,120
"29256","88253","2020",6,3,3,161457,1553.5,96.16667
"29257","88254","2020",1,1,0,35000,583,60
"29258","88256","2020",6,6,0,90750,1403.667,78.5
"29259","88257","2020",4,4,0,155750,939,165.25
"29260","88258","2020",5,5,0,85200,842,104
"29261","88259","2020",1,1,0,89000,533,167
"29262","88261","2020",3,3,0,168000,1400,120.3333
"29263","88262","2020",9,7,2,98153.89,925.5556,107.8889
"29264","88263","2020",2,2,0,115805,1931,63.5
"29265","88264","2020",1,1,0,87580,706,124
"29266","88266","2020",11,8,3,90538.18,1081.182,96.45455
"29267","88267","2020",4,4,0,71175,723,102.5
"29268","88268","2020",1,1,0,125000,912,137
"29269","88269","2020",3,3,0,247333.3,2182.667,107.6667
"29270","88270","2020",24,24,0,87347.08,835.9583,105.875
"29271","88271","2020",1,1,0,158000,1816,87
"29272","88272","2020",1,1,0,75000,750,100
"29273","88273","2020",8,7,1,172395,1586.5,113.875
"29274","88275","2020",3,3,0,80900,1306.667,68
"29275","88276","2020",7,7,0,88000,991.8571,87.14286
"29276","88277","2020",1,1,0,20000,417,48
"29277","88280","2020",1,1,0,200600,1686,119
"29278","88281","2020",4,4,0,69412.5,889.25,82.25
"29279","88284","2020",7,7,0,195857.1,1760.857,106.1429
"29280","88285","2020",4,4,0,163675,1307.25,125.75
"29281","88286","2020",3,3,0,94000,762.6667,122.6667
"29282","88289","2020",4,4,0,99002.5,1001,97.25
"29283","88290","2020",1,1,0,1e+05,2000,50
"29284","88291","2020",3,3,0,63633.33,597.3333,101
"29285","88292","2020",11,10,1,93463.64,774.8182,119.6364
"29286","88293","2020",3,3,0,79796.67,585,124.6667
"29287","88294","2020",6,6,0,111250,1294.833,87.83333
"29288","88295","2020",4,4,0,111570,1168.5,106.5
"29289","88296","2020",2,2,0,32750,459.5,79
"29290","88297","2020",2,2,0,75500,890.5,85
"29291","88299","2020",6,6,0,90791.67,1022.5,93.66667
"29292","88300","2020",3,3,0,96900,854.6667,111.3333
"29293","88301","2020",2,2,0,102550,821.5,120.5
"29294","88302","2020",13,12,1,131101.9,1501.077,93.15385
"29295","88304","2020",58,41,17,95770.34,1038.052,91.43103
"29296","88305","2020",1,1,0,75000,517,145
"29297","88306","2020",1,1,0,147500,1553,95
"29298","88308","2020",4,4,0,104823.8,1148.5,86.5
"29299","88309","2020",1,1,0,170000,756,225
"29300","88310","2020",10,10,0,99206,710.4,139.6
"29301","88312","2020",3,3,0,132916.7,922.3333,133.3333
"29302","88313","2020",12,11,1,147332.4,1128.667,139.6667
"29303","88314","2020",2,2,0,32505,461.5,70.5
"29304","88315","2020",2,2,0,135000,1690.5,91.5
"29305","88317","2020",14,14,0,111833.9,1074.357,106.2143
"29306","88318","2020",1,1,0,80000,615,130
"29307","88319","2020",35,32,3,100647.4,1056.114,92.25714
"29308","88320","2020",10,10,0,158857,1428,119.1
"29309","88321","2020",54,39,15,90738.33,898.2222,96.75926
"29310","88322","2020",3,3,0,148733.3,1183.333,126.3333
"29311","88324","2020",4,4,0,77500,677,113.25
"29312","88325","2020",2,2,0,158750,1211.5,133
"29313","88326","2020",1,1,0,322300,2238,144
"29314","88327","2020",23,22,1,136274.7,1383.174,104.3913
"29315","88328","2020",7,7,0,162585.7,1396.857,115.5714
"29316","88330","2020",1,1,0,56000,589,95
"29317","88332","2020",1,1,0,130000,2826,46
"29318","88333","2020",3,3,0,111116.7,958.3333,116.3333
"29319","88334","2020",1,1,0,73000,709,103
"29320","88335","2020",2,2,0,138000,1115.5,123.5
"29321","88336","2020",2,2,0,95075,1709.5,58.5
"29322","88338","2020",1,1,0,35000,412,85
"29323","88340","2020",4,4,0,99750,984,104
"29324","88341","2020",9,5,4,102788.9,1091,88.77778
"29325","88342","2020",1,1,0,145000,1510,96
"29326","88343","2020",1,1,0,137700,1377,100
"29327","88344","2020",1,1,0,20000,500,40
"29328","88345","2020",3,3,0,61966.67,1166,81.33333
"29329","88346","2020",5,5,0,89255.2,827.6,110.2
"29330","88347","2020",1,1,0,60000,652,92
"29331","88349","2020",29,25,4,109316.2,1139.448,102.0345
"29332","88350","2020",2,2,0,103930.5,696.5,144.5
"29333","88351","2020",28,20,8,103835,1324.25,86.67857
"29334","88352","2020",1,1,0,85000,773,110
"29335","88353","2020",1,1,0,90000,909,99
"29336","88354","2020",1,1,0,110000,1294,85
"29337","88355","2020",10,10,0,125270,903.2,124.5
"29338","88356","2020",2,2,0,86500,901,89.5
"29339","88357","2020",13,13,0,107248.3,1036.077,107.7692
"29340","88358","2020",12,10,2,140450,1506.167,93.58333
"29341","88359","2020",1,1,0,170100,1031,165
"29342","88360","2020",1,1,0,59000,766,77
"29343","88361","2020",19,16,3,99305.74,1113.842,90.73684
"29344","88362","2020",1,1,0,50211,628,80
"29345","88363","2020",3,3,0,104166.7,716,145.3333
"29346","88364","2020",1,1,0,66000,825,80
"29347","88365","2020",1,1,0,46000,605,76
"29348","88366","2020",1,1,0,54000,540,100
"29349","88367","2020",33,24,9,95733.61,915.3939,104.0606
"29350","88368","2020",1,1,0,65000,385,169
"29351","88369","2020",10,9,1,121046.2,1329.8,97.9
"29352","88371","2020",16,15,1,97278.12,943.75,106.75
"29353","88372","2020",61,50,11,97353.28,1066.607,94.62295
"29354","88373","2020",6,6,0,54484.17,976,64.33333
"29355","88374","2020",1,1,0,224000,1211,185
"29356","88375","2020",7,7,0,165331.4,1345.857,140.5714
"29357","88376","2020",3,2,1,114500,1571.333,67.33333
"29358","88377","2020",1,1,0,107990,560,193
"29359","88379","2020",6,6,0,116375.8,1179.833,100.6667
"29360","88380","2020",2,2,0,149500,2108.5,71
"29361","88381","2020",4,4,0,78450,810.25,104
"29362","88383","2020",131,32,99,90433.37,1146.435,78.53435
"29363","88385","2020",4,4,0,110462.5,1204.75,92.25
"29364","88386","2020",4,4,0,181875,1687.5,113
"29365","88387","2020",1,1,0,76000,835,91
"29366","88388","2020",1,1,0,304000,2171,140
"29367","88390","2020",1,1,0,48000,716,67
"29368","88391","2020",15,15,0,129965.3,1803.6,78.73333
"29369","88393","2020",4,4,0,90500,1010,88.5
"29370","88395","2020",3,3,0,108903.3,776,148
"29371","88398","2020",2,2,0,158000,1339.5,106
"29372","88400","2020",3,3,0,95000,620.3333,155.3333
"29373","88401","2020",3,3,0,140833.3,672,182.3333
"29374","88402","2020",1,1,0,107500,1208,89
"29375","88403","2020",2,2,0,94419.5,853.5,105
"29376","88408","2020",41,29,12,112222.7,1056.683,106
"29377","88409","2020",18,16,2,143139.4,1499.167,96.72222
"29378","88410","2020",6,6,0,99250,1047.333,97.5
"29379","88411","2020",1,1,0,77785,1296,60
"29380","88412","2020",6,6,0,124666.7,1093,119.1667
"29381","88413","2020",265,122,143,100871.6,1099.362,91.50943
"29382","88415","2020",46,31,15,121248.7,1301.478,93.32609
"29383","88416","2020",1,1,0,65000,508,128
"29384","88417","2020",4,3,1,71375,718.5,84.25
"29385","88418","2020",5,5,0,114366,1073.2,112
"29386","88419","2020",2,2,0,122000,1189.5,102
"29387","88421","2020",2,2,0,108250,885,108.5
"29388","88423","2020",21,21,0,135817.4,1400.905,100.1429
"29389","88424","2020",33,23,10,135493.3,1441.667,94.63636
"29390","88426","2020",15,14,1,110859,1257.133,95.93333
"29391","88427","2020",1,1,0,50000,413,121
"29392","88428","2020",12,12,0,128608.3,1262,109.4167
"29393","88429","2020",54,47,7,131717.1,1408.056,99.18519
"29394","88430","2020",3,3,0,55566.67,573,102.3333
"29395","88431","2020",4,4,0,83550,738,112.25
"29396","88432","2020",1,1,0,87450,781,112
"29397","88433","2020",1,1,0,87000,813,107
"29398","88434","2020",1,1,0,90000,1023,88
"29399","88435","2020",4,4,0,198500,1305.5,153.25
"29400","88436","2020",1,1,0,204300,2961,69
"29401","88437","2020",2,2,0,126050,944.5,150
"29402","88438","2020",5,5,0,158080,1355.8,120.8
"29403","88439","2020",16,16,0,171742.5,1995.062,95.9375
"29404","88440","2020",3,3,0,96500,779,128.6667
"29405","88442","2020",9,7,2,118155.6,1167.222,113.5556
"29406","88443","2020",1,1,0,60000,508,118
"29407","88444","2020",8,8,0,74574.62,825.75,94.375
"29408","88445","2020",35,22,13,139089,1228.943,107.7143
"29409","88446","2020",3,3,0,134166.7,1274.667,115.6667
"29410","88447","2020",29,26,3,109243.2,1115.069,106.1724
"29411","88449","2020",4,4,0,138000,853,152.75
"29412","88450","2020",6,6,0,52100,543.1667,91.83333
"29413","88451","2020",21,17,4,77323.29,732.0952,109.9524
"29414","88452","2020",1,1,0,110000,917,120
"29415","88454","2020",3,3,0,91600,883,102.3333
"29416","88457","2020",1,1,0,138250,940,147
"29417","88458","2020",3,3,0,118052,863,149.3333
"29418","88459","2020",2,2,0,164654,1250.5,130
"29419","88460","2020",6,6,0,100668.3,921.6667,104.3333
"29420","88461","2020",1,1,0,65050,793,82
"29421","88462","2020",18,16,2,140734.5,1307,112.3889
"29422","88463","2020",16,16,0,172620.8,1604.375,111.6875
"29423","88464","2020",5,5,0,164888,1710.6,113
"29424","88465","2020",88,60,28,103431.5,1148.716,88.86364
"29425","88467","2020",7,7,0,169428.6,1311.571,115.5714
"29426","88468","2020",24,18,6,130437.5,1305.708,105.4583
"29427","88470","2020",23,18,5,165599.1,1763.217,101.4783
"29428","88471","2020",1,1,0,44000,454,97
"29429","88473","2020",2,2,0,78250,921,85
"29430","88475","2020",1,1,0,75000,625,120
"29431","88476","2020",1,1,0,120000,2000,60
"29432","88479","2020",7,7,0,62385.71,724.4286,88.14286
"29433","88480","2020",1,1,0,125000,1042,120
"29434","88481","2020",14,14,0,154461.6,1529.214,106.7143
"29435","88483","2020",37,36,1,156050.8,1695.919,95.02703
"29436","88484","2020",9,8,1,118944.4,1243,94
"29437","88485","2020",1,1,0,208600,1862,112
"29438","88486","2020",35,30,5,136449,1357.486,99
"29439","88487","2020",48,44,4,115621,1133.458,103.6458
"29440","88488","2020",3,3,0,115400,706.6667,154.3333
"29441","88490","2020",2,2,0,103325,1148,90
"29442","88492","2020",4,4,0,184440,2746.25,80.5
"29443","88493","2020",1,1,0,148800,827,180
"29444","88494","2020",2,2,0,92250,974,100.5
"29445","88497","2020",8,8,0,82992.5,818.375,99.375
"29446","88498","2020",1,1,0,26600,436,61
"29447","88499","2020",1,1,0,356500,2546,140
"29448","88500","2020",31,22,9,130437.7,1465.387,97.35484
"29449","88501","2020",3,3,0,155000,983.3333,157
"29450","88503","2020",3,3,0,76666.67,601.3333,127
"29451","88504","2020",3,3,0,94166.67,653,168.3333
"29452","88505","2020",3,3,0,170433.3,1879.333,89.66667
"29453","88506","2020",5,5,0,122712,1316.2,94.4
"29454","88507","2020",1,1,0,105000,827,127
"29455","88508","2020",5,5,0,72100,647,114.2
"29456","88511","2020",2,2,0,72250,868.5,85
"29457","88512","2020",1,1,0,90000,900,100
"29458","88513","2020",19,19,0,132984.2,1388.579,99.42105
"29459","88514","2020",1,1,0,95000,864,110
"29460","88515","2020",3,3,0,87000,1048,86.33333
"29461","88516","2020",91,54,37,111488,1274.89,86.26374
"29462","88517","2020",1,1,0,221400,1665,133
"29463","88519","2020",8,7,1,89501.25,1013.125,90.375
"29464","88520","2020",7,7,0,94890.14,1087,91.42857
"29465","88521","2020",3,3,0,88853.33,873.6667,106.3333
"29466","88522","2020",1,1,0,190000,1357,140
"29467","88523","2020",1,1,0,45000,409,110
"29468","88524","2020",6,6,0,76351.67,684.5,111.1667
"29469","88526","2020",4,4,0,127800,1588.25,91.5
"29470","88527","2020",3,3,0,111333.3,874.3333,129.3333
"29471","88528","2020",4,3,1,126750,1327.75,97
"29472","88530","2020",26,26,0,111458.1,1131.538,108.5769
"29473","88531","2020",41,29,12,193445.5,2577.098,78.70732
"29474","89002","2020",1,1,0,80000,941,85
"29475","89003","2020",39,39,0,123243.6,1394.154,98.07692
"29476","89004","2020",5,5,0,148490,1459.8,108.6
"29477","89005","2020",16,16,0,76658.75,828.75,94.125
"29478","89006","2020",3,3,0,96000,835.3333,116.3333
"29479","89007","2020",7,7,0,75285.71,745.5714,106.8571
"29480","89008","2020",3,3,0,68833.33,887.3333,73.33333
"29481","89009","2020",4,4,0,100770.8,1336.5,77.25
"29482","89010","2020",1,1,0,3e+05,1429,210
"29483","89011","2020",1,1,0,63787,619,103
"29484","89012","2020",1,1,0,178000,1391,128
"29485","89013","2020",44,43,1,129712.1,1455.909,93.22727
"29486","89014","2020",9,8,1,98333.33,889.2222,104.5556
"29487","89015","2020",11,11,0,85845.45,920.8182,81.09091
"29488","89017","2020",2,2,0,93500,988.5,99
"29489","89018","2020",15,15,0,108186.7,1174.8,92.6
"29490","89019","2020",2,2,0,46500,727.5,60.5
"29491","89020","2020",2,2,0,62000,493.5,129.5
"29492","89021","2020",8,8,0,122650,1031.75,113.75
"29493","89023","2020",9,9,0,124492.2,1433.444,82.66667
"29494","89024","2020",555,232,323,115188.3,1560.822,74.82883
"29495","89025","2020",62,40,22,111595.3,1339.306,82.43548
"29496","89027","2020",8,8,0,123340,1107.75,133.625
"29497","89028","2020",2,2,0,112500,807.5,139.5
"29498","89029","2020",14,14,0,126874.4,1436.929,92.14286
"29499","89030","2020",9,9,0,111351.1,1098.667,100.4444
"29500","89031","2020",8,8,0,117812.5,1461.5,84
"29501","89032","2020",3,3,0,101666.7,1354.667,75.33333
"29502","89033","2020",7,7,0,125292.6,1117.857,112.7143
"29503","89034","2020",5,5,0,73215.6,1065.8,64
"29504","89035","2020",8,8,0,106000,1030.5,103.625
"29505","89036","2020",7,7,0,171671.4,1614.857,103.2857
"29506","89037","2020",4,4,0,101250,1026.25,100.5
"29507","89040","2020",3,3,0,49866.67,550.3333,91.33333
"29508","89041","2020",1,1,0,20000,417,48
"29509","89042","2020",1,1,0,172750,1919,90
"29510","89043","2020",2,2,0,113850,812.5,138.5
"29511","89044","2020",2,2,0,42500,808,50
"29512","89045","2020",1,1,0,132473,1027,129
"29513","89046","2020",25,24,1,68137.6,815.4,87.32
"29514","89048","2020",8,8,0,146275,1420.375,106.625
"29515","89050","2020",17,14,3,115304.9,1346.353,84.29412
"29516","89051","2020",10,10,0,103150,1163.2,87.1
"29517","89053","2020",5,5,0,115000,1566.8,86.2
"29518","89054","2020",21,21,0,127502.4,1600.81,82.90476
"29519","89055","2020",37,37,0,92261.62,1164.054,79.08108
"29520","89056","2020",6,6,0,89500,958.5,87.5
"29521","89057","2020",6,6,0,94416.67,893.6667,88.16667
"29522","89058","2020",3,3,0,124666.7,936,151
"29523","89059","2020",13,13,0,106179.2,1165.231,89.46154
"29524","89060","2020",8,8,0,121950,1192.75,103.75
"29525","89061","2020",1,1,0,120000,1165,103
"29526","89063","2020",19,19,0,118446.8,1408.316,88.73684
"29527","89065","2020",2,2,0,87500,1376,64
"29528","89066","2020",12,12,0,121292.5,1161.833,105.5833
"29529","89067","2020",20,19,1,102950,1276.8,80.45
"29530","89068","2020",29,27,2,128036.2,1457.621,86.41379
"29531","89069","2020",10,10,0,95500,1030,96.1
"29532","89071","2020",3,3,0,51900,915,57.33333
"29533","89072","2020",5,5,0,78374,1245,67.6
"29534","89073","2020",27,27,0,105640.5,1141.259,88.40741
"29535","89074","2020",25,25,0,148622,1638,90.52
"29536","89075","2020",8,8,0,129375,1652.75,94.875
"29537","89076","2020",10,10,0,142711,945.7,149.2
"29538","89077","2020",22,22,0,178655.4,1710.227,108.4091
"29539","89079","2020",6,6,0,147333.3,1223.5,128.6667
"29540","89080","2020",12,12,0,206583.9,1547,133.4167
"29541","89081","2020",1,1,0,40000,1600,25
"29542","89083","2020",29,29,0,177226,1460.552,125.2069
"29543","89084","2020",5,5,0,78400,785.2,121.8
"29544","89085","2020",23,23,0,92739.13,1285.826,73.13043
"29545","89086","2020",88,88,0,117283.8,1203.716,100.3977
"29546","89087","2020",4,4,0,122000,988.5,126
"29547","89088","2020",9,9,0,135623.6,1212.667,134.1111
"29548","89089","2020",8,8,0,106975,1068.625,97.375
"29549","89091","2020",12,12,0,82666.67,826,100.6667
"29550","89092","2020",2,2,0,67500,905,71
"29551","89093","2020",11,10,1,127805.7,1450.818,92
"29552","89094","2020",11,11,0,116904.5,1176.091,100
"29553","89095","2020",2,2,0,120000,821.5,157
"29554","89096","2020",12,12,0,148880.3,1326.75,123.6667
"29555","89098","2020",2,2,0,70150,710,107
"29556","89099","2020",28,28,0,93129.64,1171.857,79.60714
"29557","89100","2020",35,32,3,127024.6,1459.514,91.97143
"29558","89101","2020",4,4,0,110500,1239.25,91.75
"29559","89102","2020",27,27,0,139313,1506.259,95.22222
"29560","89104","2020",6,6,0,90000,968.8333,94.5
"29561","89105","2020",7,7,0,110857.1,1184,95.85714
"29562","89108","2020",1,1,0,145000,1179,123
"29563","89111","2020",3,3,0,73200,752,107.6667
"29564","89112","2020",2,2,0,109425,1267.5,84.5
"29565","89113","2020",7,7,0,139571.4,1433.857,98.14286
"29566","89115","2020",3,3,0,104333.3,1096,91.66667
"29567","89116","2020",5,5,0,183200,1089,162.6
"29568","89117","2020",6,6,0,109500,1091.667,99.16667
"29569","89118","2020",7,7,0,140685.7,1057.857,119.4286
"29570","89119","2020",5,5,0,114600,1109.6,89.6
"29571","89120","2020",3,3,0,95666.67,802.3333,119.6667
"29572","89122","2020",6,6,0,132033.3,1196.833,108
"29573","89123","2020",4,4,0,107769.2,937.25,112
"29574","89124","2020",13,13,0,128672.3,1480.769,93.07692
"29575","89125","2020",10,10,0,94099.5,950.9,107.8
"29576","89126","2020",1,1,0,90000,1343,67
"29577","89127","2020",8,8,0,143743.8,1366.25,129.25
"29578","89128","2020",1,1,0,146080,1461,100
"29579","89129","2020",6,6,0,61416.67,746.8333,88
"29580","89130","2020",15,15,0,115933.3,1154.267,103.0667
"29581","89131","2020",6,6,0,97666.67,727.6667,132
"29582","89132","2020",2,2,0,305000,1265,205.5
"29583","89133","2020",8,8,0,145687.5,1590.25,85
"29584","89134","2020",4,4,0,101125,1308,83
"29585","89136","2020",8,8,0,200035,2090.625,97.375
"29586","89137","2020",1,1,0,72000,637,113
"29587","89139","2020",17,17,0,134902.9,1304.412,111.7059
"29588","89141","2020",1,1,0,64355,775,83
"29589","89142","2020",26,26,0,115807.7,1249.462,101.6923
"29590","89143","2020",6,6,0,181206,1144.833,170.6667
"29591","89144","2020",16,16,0,133366.3,1387.562,100.5
"29592","89145","2020",6,6,0,118833.3,922.5,122.3333
"29593","89147","2020",8,8,0,106393.9,1347.875,84.875
"29594","89148","2020",7,7,0,84571.43,807.1429,103.7143
"29595","89149","2020",1,1,0,40000,784,51
"29596","89150","2020",6,5,1,142730,1217.5,113.6667
"29597","89151","2020",25,25,0,78716.48,1274.56,63.16
"29598","89152","2020",8,8,0,107000,1307.75,87.625
"29599","89153","2020",7,7,0,89792.86,1114.857,80.14286
"29600","89154","2020",15,15,0,131283.3,1331.733,104.6
"29601","89155","2020",9,9,0,139988.9,1702.111,91.22222
"29602","89156","2020",6,6,0,124201.7,1673.833,85.5
"29603","89158","2020",10,10,0,60900,681.4,92.1
"29604","89159","2020",3,3,0,112480,1525.667,71.33333
"29605","89160","2020",8,8,0,122462.5,1166.125,104
"29606","89161","2020",6,6,0,71333.33,725.3333,97.33333
"29607","89162","2020",2,2,0,182000,2245.5,80
"29608","89163","2020",7,7,0,167142.9,1281.429,128.8571
"29609","89164","2020",2,2,0,141500,1030.5,137
"29610","89165","2020",2,2,0,237250,990,239
"29611","89167","2020",17,17,0,144408.8,1299.941,118.7059
"29612","89169","2020",14,14,0,106000,1193.143,99.78571
"29613","89170","2020",1,1,0,106000,1178,90
"29614","89171","2020",3,3,0,108000,1307.667,86.33333
"29615","89172","2020",7,7,0,174464.3,1528.571,115.4286
"29616","89173","2020",5,5,0,64100,695.2,81.6
"29617","89175","2020",1,1,0,130000,1313,99
"29618","89176","2020",5,5,0,131200,1459.8,95.4
"29619","89177","2020",1,1,0,42000,512,82
"29620","89179","2020",8,8,0,97181.88,1164.25,87.875
"29621","89180","2020",13,13,0,143376.5,1183.615,130.2308
"29622","89181","2020",5,5,0,115636,1214,99.2
"29623","89182","2020",2,2,0,78250,492,155
"29624","89186","2020",6,6,0,113548.3,1060.833,111.8333
"29625","89188","2020",4,4,0,158705,1662.25,98
"29626","89189","2020",5,5,0,123800,1499,81
"29627","89190","2020",2,2,0,69600,907,73
"29628","89194","2020",2,2,0,127000,1044.5,124.5
"29629","89195","2020",13,13,0,193038.5,1435.769,137.3846
"29630","89196","2020",20,20,0,102345,1083,91.85
"29631","89197","2020",5,5,0,81480,967.6,78.6
"29632","89198","2020",32,30,2,137339.1,1833.531,84.625
"29633","89199","2020",8,8,0,118666.1,1161.625,102.75
"29634","89200","2020",1,1,0,170500,1160,147
"29635","89201","2020",32,31,1,147840.9,1566.469,97.21875
"29636","89202","2020",5,5,0,72380,1047,70
"29637","89203","2020",4,4,0,194375,1583,113.5
"29638","89204","2020",4,4,0,105500,915.5,90.5
"29639","89205","2020",4,4,0,116609.8,1065.75,113.25
"29640","89206","2020",99,82,17,101701.8,1274.343,87.11111
"29641","89208","2020",5,5,0,87200,758.6,126.2
"29642","89209","2020",7,7,0,142285.7,1520.143,93.57143
"29643","89210","2020",1,1,0,35000,500,70
"29644","89211","2020",1,1,0,130000,610,213
"29645","89212","2020",6,6,0,132150,1380.667,96
"29646","89214","2020",5,5,0,157370,996.8,167.2
"29647","89215","2020",3,3,0,267223.3,1630,125.3333
"29648","89216","2020",15,15,0,161944.3,1453.133,111.1333
"29649","89217","2020",2,2,0,60000,791.5,77.5
"29650","89218","2020",23,21,2,100760.9,1262.435,79.91304
"29651","89219","2020",1,1,0,110000,748,147
"29652","89220","2020",4,4,0,75500,714.5,106
"29653","89221","2020",4,4,0,81508.75,1019.5,83.25
"29654","89222","2020",7,7,0,151436,1169.429,129.8571
"29655","89223","2020",11,11,0,96758.18,790.9091,115.7273
"29656","89224","2020",1,1,0,60000,500,120
"29657","89226","2020",1,1,0,76667,902,85
"29658","89227","2020",16,16,0,115725,1150.688,102.625
"29659","89228","2020",20,19,1,194700,1586.85,125.65
"29660","89229","2020",14,14,0,118600,1368.214,94.35714
"29661","89230","2020",2,2,0,87500,1428,70.5
"29662","89232","2020",7,7,0,98142.86,921.8571,95.42857
"29663","89233","2020",5,5,0,77600,888,88
"29664","89234","2020",1,1,0,24000,500,48
"29665","89235","2020",9,9,0,166054.4,1311.556,132.8889
"29666","89236","2020",7,7,0,159928.6,1488.429,105
"29667","89237","2020",9,9,0,86588.89,1107.889,80.55556
"29668","89238","2020",13,13,0,49403.69,807.9231,68.15385
"29669","89239","2020",16,16,0,176742.8,1678.188,113.125
"29670","89240","2020",8,8,0,147000,1213.625,124.5
"29671","89242","2020",19,19,0,110397.7,1093.158,100.9474
"29672","89244","2020",4,4,0,107262.5,1043,100.5
"29673","89245","2020",10,10,0,199100,1476.4,135.5
"29674","89246","2020",3,3,0,41000,510.6667,88.33333
"29675","89247","2020",6,6,0,92833.33,774.3333,130.3333
"29676","89249","2020",1,1,0,54375,336,162
"29677","89250","2020",2,2,0,48500,749.5,62.5
"29678","89251","2020",10,10,0,98286.5,1175.8,85.4
"29679","89252","2020",3,3,0,136666.7,1379.333,107.6667
"29680","89253","2020",7,7,0,58085.71,862.7143,73.14286
"29681","89254","2020",13,13,0,157450.2,1139.308,130.2308
"29682","89255","2020",15,15,0,127106.7,1660.8,87.86667
"29683","89256","2020",5,5,0,101530,988.8,97.8
"29684","89257","2020",81,71,10,84128.4,1153.025,75.67901
"29685","89259","2020",4,4,0,81125,904.75,88.75
"29686","89261","2020",5,4,1,94700,1018.6,100.6
"29687","89262","2020",2,2,0,72000,778.5,87.5
"29688","89263","2020",34,33,1,143440,1714.353,86.11765
"29689","89264","2020",21,21,0,132859.5,1247.524,110.1905
"29690","89265","2020",9,9,0,107171.3,1210.222,91.44444
"29691","89266","2020",5,5,0,51000,657.4,84.2
"29692","89267","2020",3,3,0,266666.7,2016.333,139.3333
"29693","89268","2020",10,10,0,95490,1008.8,100
"29694","89270","2020",2,2,0,78500,587.5,110.5
"29695","89271","2020",2,2,0,103700,1090,100.5
"29696","89272","2020",4,4,0,133602.5,1138.5,123.5
"29697","89273","2020",8,8,0,112572.2,1129.875,102.125
"29698","89274","2020",9,9,0,169688.9,1804.222,95.22222
"29699","89276","2020",17,16,1,109186.5,910.2353,123.7647
"29700","89277","2020",5,5,0,114500,1099.8,102.4
"29701","89278","2020",6,6,0,128466.7,1268.5,104.6667
"29702","89279","2020",10,9,1,147401.4,1406.1,106.7
"29703","89280","2020",4,4,0,107500,1024.5,113.75
"29704","89281","2020",4,4,0,99000,1840.25,53.75
"29705","89282","2020",9,9,0,113718.9,1206.444,84.55556
"29706","89283","2020",5,5,0,76084.6,978.2,79
"29707","89284","2020",2,2,0,125000,766,141.5
"29708","89285","2020",6,6,0,156000,1464.833,103.8333
"29709","89286","2020",17,17,0,159208.9,1192.647,134.6471
"29710","89287","2020",52,44,8,130313.5,1521.769,90.44231
"29711","89288","2020",2,2,0,95000,633,160.5
"29712","89289","2020",8,8,0,164625,1443.875,116
"29713","89291","2020",5,2,3,125340,1390,86
"29714","89292","2020",7,7,0,123857.1,984.8571,127.2857
"29715","89295","2020",9,9,0,187160.9,1684.556,120.1111
"29716","89298","2020",12,12,0,153110.8,1301,124.6667
"29717","89299","2020",1,1,0,90000,783,115
"29718","89302","2020",5,5,0,158130,1408.2,121.6
"29719","89303","2020",6,6,0,137561.3,894.3333,162.3333
"29720","89304","2020",14,14,0,169585.7,1333.786,137.4286
"29721","89306","2020",5,5,0,159500,1391.8,105.2
"29722","89307","2020",9,9,0,133663.3,1256.333,107.3333
"29723","89308","2020",2,2,0,220500,1002,234
"29724","89309","2020",53,48,5,123158.1,1524.019,84.20755
"29725","89310","2020",4,4,0,88750,880.5,104.75
"29726","89311","2020",15,15,0,119228.1,1349.467,99
"29727","89312","2020",1,1,0,70700,895,79
"29728","89313","2020",7,7,0,101564.3,1197.429,82.57143
"29729","89314","2020",5,5,0,143020,841.8,173.4
"29730","89315","2020",1,1,0,180000,1059,170
"29731","89316","2020",3,3,0,132000,1080,118
"29732","89318","2020",10,10,0,114635,1286.2,97.9
"29733","89319","2020",9,9,0,155238.9,1345.444,106.7778
"29734","89320","2020",2,2,0,90000,1086.5,78.5
"29735","89321","2020",6,6,0,71239.33,650.1667,108.8333
"29736","89323","2020",1,1,0,109000,717,152
"29737","89324","2020",17,17,0,106580,1105.412,91.23529
"29738","89325","2020",2,2,0,150500,1581,95.5
"29739","89326","2020",18,18,0,162613.7,1616.722,104.1667
"29740","89327","2020",5,5,0,105630,1428.8,73.8
"29741","89328","2020",5,5,0,176000,1642.4,103.2
"29742","89331","2020",6,6,0,86916.67,964,96.5
"29743","89332","2020",13,13,0,203965.3,1629.308,128.6923
"29744","89333","2020",1,1,0,59000,532,111
"29745","89334","2020",6,6,0,117500,1138.5,107.8333
"29746","89335","2020",9,9,0,96222.22,1292.444,73.88889
"29747","89336","2020",5,5,0,114300,863.6,131.4
"29748","89337","2020",12,12,0,114744.2,1466,79.5
"29749","89338","2020",30,26,4,143173.3,1532.867,103.1333
"29750","89339","2020",2,2,0,63533.5,852,68
"29751","89341","2020",9,9,0,126600,1078.556,112.3333
"29752","89342","2020",11,11,0,164481.8,1750.545,93.72727
"29753","89344","2020",20,20,0,92666.5,1200.2,77.55
"29754","89345","2020",41,37,4,90646.29,1049.756,89.43902
"29755","89346","2020",41,35,6,151253.7,1630.049,97.21951
"29756","89347","2020",9,9,0,90333.33,1145.222,75.55556
"29757","89348","2020",40,38,2,110412.6,1434.175,83.05
"29758","89349","2020",10,10,0,104250,1099.1,90.8
"29759","89350","2020",2,2,0,90000,1607,55
"29760","89351","2020",2,2,0,82500,1477.5,66.5
"29761","89352","2020",5,5,0,134300,1277.8,127
"29762","89353","2020",10,10,0,112290,1130.1,100.3
"29763","89354","2020",17,17,0,156500,1621.882,97.05882
"29764","89355","2020",4,4,0,150625,1220.75,133
"29765","89359","2020",14,13,1,82214.29,1004.143,82.07143
"29766","89360","2020",1,1,0,180000,1875,96
"29767","89361","2020",5,4,1,133599,1146.2,114.6
"29768","89362","2020",3,3,0,97666.67,696.3333,115.6667
"29769","89363","2020",3,3,0,82166.67,936.3333,84.66667
"29770","89364","2020",8,8,0,93562.5,1295.375,70.625
"29771","89365","2020",8,8,0,98106.25,1157.75,81.75
"29772","89367","2020",10,10,0,80050,860.5,109.2
"29773","89368","2020",14,14,0,73964.29,967.4286,77.35714
"29774","89369","2020",7,7,0,149285.7,1770,90.71429
"29775","89370","2020",24,22,2,119506.7,1412.833,91
"29776","89371","2020",2,2,0,172205,1088.5,129
"29777","89373","2020",9,9,0,197888.9,1873,111.5556
"29778","89374","2020",1,1,0,78000,661,118
"29779","89376","2020",3,3,0,101815,932.6667,113.3333
"29780","89377","2020",1,1,0,44000,512,86
"29781","89378","2020",8,8,0,129937.5,1449.875,89
"29782","89379","2020",1,1,0,95000,1000,95
"29783","89380","2020",16,11,5,214127.5,2572,89.875
"29784","89382","2020",23,20,3,119787.5,1262.826,101.1304
"29785","89383","2020",1,1,0,120000,1348,89
"29786","89384","2020",4,4,0,115000,1178,99
"29787","89385","2020",4,4,0,77685,1139.25,82.5
"29788","89386","2020",2,2,0,55750,668.5,83.5
"29789","89387","2020",398,179,219,119304,1568.299,77.01508
"29790","89388","2020",9,9,0,92539.56,1299.333,74.22222
"29791","89390","2020",13,13,0,146376.9,1466.692,107.2308
"29792","89391","2020",25,24,1,131305.4,1456.4,93.72
"29793","89392","2020",5,5,0,87380,1014.8,88.6
"29794","89393","2020",4,4,0,94291.75,1015.5,99.25
"29795","89394","2020",2,2,0,59750,984.5,61
"29796","89395","2020",13,12,1,83793.85,1243.769,90.92308
"29797","89397","2020",17,17,0,132829.4,1198.706,109.8824
"29798","89398","2020",3,3,0,130666.7,1047.667,126.6667
"29799","89399","2020",24,24,0,154981.2,1579.042,101.3333
"29800","89400","2020",4,4,0,61300,844,74.5
"29801","89402","2020",2,2,0,114500,1046,108
"29802","89403","2020",3,3,0,90466.67,799.3333,95.33333
"29803","89404","2020",6,6,0,182833.3,1374.5,131.6667
"29804","89405","2020",7,7,0,115714.3,980.5714,112.2857
"29805","89406","2020",2,2,0,77500,818,85
"29806","89407","2020",14,14,0,103453.6,1202.571,89.85714
"29807","89408","2020",11,11,0,103488.8,1116.727,97.54545
"29808","89409","2020",5,5,0,81000,1060,69.6
"29809","89411","2020",12,12,0,144700,1320,113.9167
"29810","89412","2020",2,2,0,113765,1605,68
"29811","89414","2020",33,26,7,118813.6,1319.909,89.24242
"29812","89416","2020",8,8,0,69408.75,918.5,79.625
"29813","89418","2020",43,37,6,113362.8,1144.698,100.0465
"29814","89419","2020",49,45,4,118951.2,1312.122,91.55102
"29815","89420","2020",26,26,0,87404.65,1186.077,75.92308
"29816","89423","2020",2,2,0,62000,708.5,85.5
"29817","89424","2020",3,3,0,104333.3,870,115.3333
"29818","89425","2020",9,9,0,90338.89,1067.778,91.33333
"29819","89426","2020",8,8,0,122687.5,1163.25,110.75
"29820","89427","2020",8,8,0,87218.75,961,93.875
"29821","89428","2020",19,19,0,122913.2,1216.579,102.5789
"29822","89431","2020",3,3,0,96666.67,1054.333,94.66667
"29823","89432","2020",13,13,0,136457.7,1299.769,105.6154
"29824","89433","2020",7,7,0,104716.3,1023.714,107
"29825","89434","2020",7,7,0,140428.6,1481.429,93.71429
"29826","89436","2020",20,20,0,84460,956.05,88.15
"29827","89437","2020",4,4,0,86825,1084,78
"29828","89438","2020",22,22,0,161252.7,1460.636,114.7727
"29829","89439","2020",19,18,1,102686.8,1089.684,97.31579
"29830","89440","2020",7,7,0,114285.7,910.7143,138.4286
"29831","89441","2020",18,18,0,67025.22,729.8333,100.2778
"29832","89442","2020",7,7,0,110428.6,1414.714,81.14286
"29833","89443","2020",24,24,0,151212.6,1546.708,100.5
"29834","89446","2020",6,6,0,354947.3,3261.333,140
"29835","89447","2020",4,4,0,102775,1314.75,84
"29836","89449","2020",29,29,0,166496.9,1750.759,101.1724
"29837","89450","2020",4,4,0,222850,1687.5,138.5
"29838","89451","2020",1,1,0,44000,1158,38
"29839","89452","2020",4,4,0,89750,1134.25,75.75
"29840","89453","2020",12,12,0,163799.1,1797.75,92.91667
"29841","89456","2020",9,9,0,154214.4,1674.111,95.66667
"29842","89458","2020",4,4,0,100587.5,1118.25,93.25
"29843","89459","2020",3,3,0,152833.3,2114.333,73
"29844","89460","2020",53,50,3,164500.7,1896.66,91.92453
"29845","89461","2020",18,17,1,113055.5,1038.833,113.3889
"29846","89462","2020",6,6,0,80833.33,975.5,81.33333
"29847","89464","2020",104,92,12,112692.5,1346.673,85.20192
"29848","89465","2020",12,12,0,85472.92,1352.417,65.08333
"29849","89466","2020",4,4,0,172750,1696.5,105.25
"29850","89467","2020",14,14,0,132795.6,1217.786,112.2143
"29851","89468","2020",8,8,0,85368.75,1113.875,84.75
"29852","89469","2020",22,22,0,123327.5,1192,107.3636
"29853","89470","2020",3,3,0,150833.3,977.6667,155.6667
"29854","89471","2020",1,1,0,158000,1646,96
"29855","89472","2020",10,10,0,101637.5,1047.9,99.3
"29856","89474","2020",6,6,0,54666.67,797,74.33333
"29857","89475","2020",4,4,0,45625,632.75,73.25
"29858","89477","2020",2,2,0,58000,1078.5,53
"29859","89478","2020",13,13,0,132111.5,1443.615,90.38462
"29860","89479","2020",4,4,0,164583.2,1185.75,138.25
"29861","89480","2020",15,15,0,163253.3,1848.8,100.3333
"29862","89481","2020",1,1,0,38000,633,60
"29863","89482","2020",3,3,0,97633.33,926.6667,107.6667
"29864","89483","2020",6,6,0,134333.3,1051.833,132.1667
"29865","89485","2020",3,3,0,115383.3,1191.333,97
"29866","89486","2020",1,1,0,121866,609,200
"29867","90001","2020",12,12,0,192904.2,1843.75,108.25
"29868","90002","2020",4,4,0,198132.5,1924.25,104.5
"29869","90003","2020",9,7,2,145466.7,1373.556,104.1111
"29870","90004","2020",2,2,0,214200,2014.5,114.5
"29871","90005","2020",2,1,1,187250,1478.5,138
"29872","90006","2020",7,7,0,108514.3,1358.286,84.14286
"29873","90008","2020",43,20,23,132049.4,1507.651,88.23256
"29874","90009","2020",46,24,22,123463.5,1337.37,95.67391
"29875","90010","2020",656,99,557,98022.85,1351.343,72.37652
"29876","90011","2020",1,1,0,270860,1662,163
"29877","90012","2020",9,8,1,173453.8,1718.889,102.2222
"29878","90013","2020",1,1,0,164570,2420,68
"29879","90014","2020",9,9,0,219422.2,1598.111,138.1111
"29880","90015","2020",3,2,1,199916.7,1756.333,115.6667
"29881","90017","2020",15,12,3,133298,1425.6,95.93333
"29882","90018","2020",3,3,0,221246.7,1923.333,117.3333
"29883","90019","2020",4,3,1,199550,1590.75,124
"29884","90020","2020",3,3,0,237583.3,1800,133.6667
"29885","90021","2020",1,1,0,308833,2358,131
"29886","90022","2020",30,22,8,143540,1514.967,95.36667
"29887","90023","2020",15,13,2,136016.7,1583.733,88.33333
"29888","90025","2020",7,4,3,101842.9,1021,95.71429
"29889","90026","2020",13,10,3,201071.5,1617.615,122.5385
"29890","90027","2020",1,1,0,185000,2202,84
"29891","90028","2020",3,3,0,164666.7,1395.333,121
"29892","90029","2020",15,9,6,131757.3,1328.467,101.3333
"29893","90030","2020",3,3,0,227950,1693.333,132.6667
"29894","90031","2020",4,4,0,197792.5,1660.5,120.75
"29895","90032","2020",47,20,27,135658.9,1507.447,90.46809
"29896","90033","2020",64,32,32,141886.1,1600.328,92.1875
"29897","90034","2020",5,4,1,209990.2,1500.6,141.2
"29898","90035","2020",4,4,0,184307.5,1431.25,131.25
"29899","90036","2020",3,3,0,319433.3,1974,161.3333
"29900","90037","2020",12,9,3,141655.8,1587.833,98.5
"29901","90039","2020",42,31,11,172421.7,1627.5,105.881
"29902","90041","2020",10,5,5,145206,1525.1,92
"29903","90042","2020",21,19,2,210255.2,1755.429,120.8571
"29904","90043","2020",10,10,0,213755.5,1853,117.3
"29905","90044","2020",5,5,0,302240,2287.6,134.6
"29906","90045","2020",6,6,0,161883.3,1748.333,101.8333
"29907","90046","2020",4,4,0,186925,1638.5,115.25
"29908","90047","2020",4,4,0,211900,2248.25,94
"29909","90049","2020",5,4,1,175100,1711.6,106
"29910","90050","2020",2,2,0,250600,1920,139
"29911","90051","2020",2,2,0,317575,2294.5,169
"29912","90052","2020",33,18,15,129387,1221.667,109.6061
"29913","90053","2020",28,18,10,131596.4,1534.607,85.28571
"29914","90054","2020",4,4,0,180250,1451.25,137.5
"29915","90055","2020",2,2,0,205405,1751.5,117
"29916","90056","2020",14,13,1,174475,1845.571,94.07143
"29917","90057","2020",9,9,0,231761.1,1963.333,122.7778
"29918","90058","2020",5,4,1,156660,1705.4,94.4
"29919","90059","2020",1,1,0,211700,1735,122
"29920","90062","2020",2,2,0,172250,1287.5,127.5
"29921","90063","2020",4,4,0,190500,1619.5,118.75
"29922","90064","2020",1,1,0,5e+05,2283,219
"29923","90065","2020",19,17,2,134373.7,1306.895,103.4211
"29924","90066","2020",5,5,0,181502,1367.6,132.6
"29925","90067","2020",2,2,0,225700,2233,100
"29926","90068","2020",16,12,4,187190.8,1862.312,101.75
"29927","90069","2020",14,10,4,166308.6,1576.5,114.9286
"29928","90070","2020",4,4,0,167145,1113,142
"29929","90071","2020",9,8,1,193566.7,2026,99.66667
"29930","90072","2020",13,6,7,113988.1,1470.769,78.30769
"29931","90074","2020",1,1,0,237000,1623,146
"29932","90075","2020",39,25,14,186365.6,1891.359,98.89744
"29933","90076","2020",12,9,3,172937.1,1894.917,94.41667
"29934","90077","2020",4,4,0,129250,1230.75,106
"29935","90078","2020",1,1,0,321000,2169,148
"29936","90079","2020",4,4,0,137625,1756,82.75
"29937","90081","2020",6,6,0,184575,1871.167,97.16667
"29938","90082","2020",3,3,0,307700,1785.333,176.3333
"29939","90084","2020",2,2,0,164670,1404,120
"29940","90085","2020",2,2,0,20425,1304.5,18.5
"29941","90087","2020",12,12,0,200696.2,1810.667,114.25
"29942","90088","2020",10,9,1,153405,1657.7,93.4
"29943","90089","2020",16,7,9,165562.5,1879.625,93.5
"29944","90090","2020",1,1,0,82000,683,120
"29945","90091","2020",6,6,0,231941.7,1668,151.3333
"29946","90093","2020",15,12,3,229362,1560.667,146.6
"29947","90094","2020",5,3,2,162440,1888.6,89.6
"29948","90096","2020",1,1,0,235000,1880,125
"29949","90097","2020",7,5,2,161971.4,1674,100.5714
"29950","90098","2020",3,2,1,119351.7,1340.667,90
"29951","90099","2020",59,24,35,107024.6,1435.153,74.89831
"29952","90101","2020",3,3,0,185333.3,1807.667,102.6667
"29953","90102","2020",5,5,0,190740,1875,113.6
"29954","90103","2020",7,5,2,203195.7,1764.714,120.5714
"29955","90104","2020",8,6,2,203727.5,2131,96.625
"29956","91001","2020",1,1,0,112000,2667,42
"29957","91016","2020",72,56,16,185861.6,2019.319,91.83333
"29958","91017","2020",21,19,2,282737.9,2929.333,103.5238
"29959","91021","2020",140,30,110,201378.1,3261.007,65.06429
"29960","91027","2020",385,145,240,240123.5,3652.371,68.55065
"29961","91035","2020",4,4,0,180875,2382,76.25
"29962","91037","2020",6,6,0,331233.3,2963.833,116.5
"29963","91038","2020",20,16,4,284045.5,2920.3,103.4
"29964","91041","2020",17,15,2,336520.6,3103.588,110
"29965","91044","2020",58,37,21,301927.3,3776.431,85.56897
"29966","91045","2020",107,83,24,245083.6,3137.421,80.53271
"29967","91047","2020",16,10,6,205768.8,2694.188,84.25
"29968","91064","2020",50,23,27,397993.2,4606.4,85.16
"29969","91067","2020",2,2,0,208500,2256,97.5
"29970","91069","2020",6,6,0,278391.7,2592.167,105
"29971","91075","2020",2,2,0,263000,2663,94
"29972","91079","2020",5,5,0,277220,2412.6,122.4
"29973","91080","2020",18,15,3,243688.9,2645.056,93.05556
"29974","91081","2020",7,7,0,200700,2210.714,98.71429
"29975","91085","2020",39,31,8,235418.2,3127.462,76.23077
"29976","91086","2020",149,119,30,277524.4,2850.094,98.84564
"29977","91093","2020",8,8,0,397243.8,3380.75,128.75
"29978","91095","2020",35,29,6,237174.5,2853.114,82.25714
"29979","91097","2020",119,39,80,189666.2,2520.336,78.09244
"29980","91098","2020",5,3,2,183675.2,2312.8,79.2
"29981","91099","2020",66,57,9,246371.2,2641.894,99.31818
"29982","91100","2020",10,10,0,274900,2778.6,100.4
"29983","91103","2020",308,140,168,230898,3154.435,75.04545
"29984","91105","2020",80,78,2,287142,3194.475,96.0125
"29985","91106","2020",19,19,0,275880.5,2999.737,97.05263
"29986","91109","2020",18,17,1,253084.4,2810.611,96.27778
"29987","91111","2020",26,21,5,305556.8,3281.346,94.96154
"29988","91112","2020",3,3,0,246020,1803,157.3333
"29989","91114","2020",343,162,181,272324.6,3505.242,81.18367
"29990","91115","2020",47,31,16,261668.1,2997.149,92.74468
"29991","91121","2020",12,12,0,227000,2944.75,92.75
"29992","91122","2020",117,92,25,392107.6,3964.427,105.7179
"29993","91129","2020",52,45,7,262428.5,2849.904,100.9615
"29994","91130","2020",27,22,5,229530.7,2397.185,101.8889
"29995","91131","2020",4,4,0,224500,1530.75,158.25
"29996","91132","2020",13,10,3,189265.4,2694.692,83.15385
"29997","91135","2020",23,22,1,289737.3,2854.826,105.8261
"29998","91136","2020",27,22,5,306778.4,3696.926,87.66667
"29999","91137","2020",3,3,0,176666.7,2160,86
"30000","91148","2020",3,3,0,264263.3,3096,90
"30001","91156","2020",30,25,5,253558.9,2923.9,97.4
"30002","91159","2020",27,24,3,268707.4,2898.296,97.07407
"30003","91161","2020",370,42,328,179020.6,2727.165,69.08919
"30004","91174","2020",712,150,562,150691.9,2647.048,59.03933
"30005","91175","2020",33,23,10,226403.3,3241.697,85.69697
"30006","91179","2020",65,32,33,229514.6,2816.2,83.27692
"30007","91180","2020",6,6,0,293008.3,3280,92.16667
"30008","91184","2020",8,8,0,260502.5,2306.25,123
"30009","91186","2020",7,7,0,391457.9,3058.143,139.1429
"30010","91191","2020",151,42,109,223566.7,2975.96,76.29801
"30011","91195","2020",11,9,2,278348.8,3168.273,95
"30012","91198","2020",23,18,5,239334,2613.565,96.17391
"30013","91200","2020",156,81,75,230656.8,2880.91,82.64103
"30014","91201","2020",328,203,125,265123.3,3313.884,83.30488
"30015","91204","2020",14,10,4,251175,3060.214,91.5
"30016","91207","2020",65,52,13,257302.8,2988.692,89.04615
"30017","91215","2020",118,44,74,172454.1,2278.78,76.18644
"30018","91216","2020",129,89,40,277942.5,3654.217,77.37209
"30019","91223","2020",360,134,226,155244.7,2390.167,68.35278
"30020","91225","2020",31,24,7,410522.8,3362.903,125.8065
"30021","91226","2020",103,59,44,231257,4012,72.07767
"30022","91228","2020",682,117,565,159700.4,2347.971,69.96628
"30023","91232","2020",69,51,18,248830.8,2899.942,90.17391
"30024","91235","2020",71,19,52,185387.5,3028.761,62.67606
"30025","91240","2020",5,3,2,217080,2852,78.8
"30026","91243","2020",30,26,4,343393.9,3049.2,117.6
"30027","91244","2020",15,9,6,239743.3,3249,75.06667
"30028","91247","2020",8,7,1,265062.5,2410.375,124.375
"30029","91248","2020",2,1,1,178500,1616.5,110
"30030","91249","2020",63,51,12,322110.9,3060.778,110.0476
"30031","91272","2020",214,105,109,375154.5,3940.014,100.014
"30032","91273","2020",24,24,0,238577.1,2531.792,99.58333
"30033","91274","2020",17,12,5,330651.5,3458.588,99.41176
"30034","91275","2020",29,24,5,392561.8,4051.172,109.2069
"30035","91284","2020",15,14,1,276325.3,2774.133,106.1333
"30036","91286","2020",33,20,13,193422.4,2493.879,80.81818
"30037","91292","2020",13,13,0,325100,3231.923,101.8462
"30038","91293","2020",12,10,2,243500,2522.083,97.25
"30039","91294","2020",11,10,1,232336.4,2176.182,112.2727
"30040","91312","2020",121,90,31,424912.9,4955.025,90.81818
"30041","91315","2020",111,102,9,290762.8,3247.811,96.88288
"30042","91318","2020",31,30,1,290445.2,3171.194,96.3871
"30043","91319","2020",7,7,0,384675.7,3354.429,136.8571
"30044","91326","2020",250,53,197,225969.8,3738.016,60.212
"30045","91330","2020",87,66,21,244146.1,3172.161,80.14943
"30046","91332","2020",21,11,10,226630,3117.19,77.80952
"30047","91333","2020",79,66,13,294993.9,3141.329,98.22785
"30048","91338","2020",75,60,15,360115.7,3523.24,105.52
"30049","91339","2020",97,69,28,270596.5,3319.897,83.8866
"30050","91340","2020",90,68,22,246186.3,2884.511,88.35556
"30051","91345","2020",296,81,215,207472.6,3056.517,69.5777
"30052","91347","2020",91,64,27,275032.4,3408.363,85.38462
"30053","91359","2020",53,40,13,206326.9,2471.34,87.90566
"30054","91363","2020",113,85,28,310324.5,3373.947,95.68142
"30055","91374","2020",2,2,0,240000,2535,102.5
"30056","91376","2020",72,51,21,270153.4,3458.833,84.18056
"30057","91377","2020",469,51,418,266092.8,3890.601,70.14925
"30058","91378","2020",4,3,1,300329,2700,119.25
"30059","91386","2020",208,140,68,273180.2,3002.543,94.10096
"30060","91390","2020",64,55,9,203708.6,2186.766,99.29688
"30061","91393","2020",11,11,0,209309.1,2213.455,99.72727
"30062","91399","2020",2,2,0,264000,2245,119.5
"30063","91405","2020",90,75,15,269143.6,2926.078,94.85556
"30064","91408","2020",18,18,0,341213.3,3172.556,107.2778
"30065","91411","2020",20,18,2,371316.5,3559.45,106.45
"30066","91412","2020",8,8,0,279400,2385,130.625
"30067","91414","2020",14,11,3,170691.8,1855.786,98.28571
"30068","91421","2020",262,149,113,290315.8,3812.034,79.60305
"30069","91425","2020",147,70,77,260298.7,3470.224,76.36054
"30070","91432","2020",175,99,76,276615.1,3665.029,77.96571
"30071","91433","2020",67,41,26,244996.9,2645.433,98.26866
"30072","91434","2020",280,179,101,263545.7,3373.125,79.675
"30073","91435","2020",7,7,0,458428.6,3135.857,156
"30074","91441","2020",4,4,0,356287.5,2677.75,136.25
"30075","91457","2020",54,53,1,285896.1,3103.815,94.42593
"30076","91458","2020",59,40,19,309153.6,3331.458,94.13559
"30077","91461","2020",42,35,7,278436.2,3138.5,93.42857
"30078","91463","2020",17,17,0,319427.1,2826.118,119.1765
"30079","91468","2020",30,25,5,256908.4,3097.633,90.2
"30080","91469","2020",10,10,0,229087,2467.6,95.5
"30081","91471","2020",160,92,68,365254,4398.669,87.3875
"30082","91473","2020",3,3,0,258333.3,2372.667,117
"30083","91477","2020",413,134,279,304980.6,4130.76,75.49153
"30084","91479","2020",67,46,21,283420.4,4085.269,74.67164
"30085","91482","2020",9,9,0,310300,3367.444,95.11111
"30086","91494","2020",49,40,9,294324,3235,93.2449
"30087","91495","2020",6,6,0,197166.7,2049.167,101
"30088","91507","2020",6,6,0,220333.3,2695.5,85.16667
"30089","91508","2020",2,2,0,269000,1875,144
"30090","91511","2020",50,35,15,154739.1,1819.4,90.46
"30091","91514","2020",105,65,40,264851.6,3403.857,79.17143
"30092","91519","2020",11,11,0,219172.7,2499.364,98.81818
"30093","91521","2020",342,102,240,177866.6,2475.614,72.12281
"30094","91525","2020",30,24,6,290811.3,3197.767,105.6333
"30095","91533","2020",33,26,7,217313,2415.121,93.36364
"30096","91534","2020",43,37,6,448405.6,4692.442,108.4419
"30097","91538","2020",5,4,1,370190,3728.8,100.2
"30098","91540","2020",72,52,20,239575.6,2896.764,90.05556
"30099","91544","2020",7,6,1,231663.4,2606.857,89.14286
"30100","91546","2020",11,11,0,316174.5,3245.545,101.8182
"30101","91547","2020",7,7,0,231598.6,2359.714,99
"30102","91549","2020",425,250,175,273095.4,3503.852,80.05412
"30103","91552","2020",128,85,43,251998.1,2989.258,85.57031
"30104","91553","2020",129,91,38,294222.8,3263.093,94.60465
"30105","91556","2020",7,6,1,223285.7,2410,94.42857
"30106","91560","2020",6,5,1,307500,3781.167,90.33333
"30107","91568","2020",13,12,1,361561.5,3234.462,113.3077
"30108","91570","2020",265,103,162,205790.7,2680.943,78.09057
"30109","91573","2020",155,85,70,263255,3327.09,81.41935
"30110","91577","2020",85,68,17,286814.5,3067.871,98.68235
"30111","91578","2020",5,5,0,394756,3016.8,135
"30112","91579","2020",52,34,18,243840.9,2961.058,83.90385
"30113","91581","2020",17,17,0,305623.5,2954.588,103.7647
"30114","91587","2020",79,45,34,294442.6,3384.025,90.29114
"30115","91589","2020",504,282,222,245503.4,3558.202,71.54762
"30116","91593","2020",30,24,6,262320.5,2478.833,111.3333
"30117","91599","2020",22,21,1,272615.5,2904.409,104.1364
"30118","91600","2020",84,52,32,293805,3085.417,101.8571
"30119","91602","2020",3,3,0,258466.7,3083.667,83.66667
"30120","91613","2020",2,2,0,170500,1201,140.5
"30121","91617","2020",47,30,17,277071.9,3598.745,82.53191
"30122","91619","2020",3,3,0,287100,2671.667,110
"30123","91629","2020",14,14,0,275285.7,2456.929,128.7857
"30124","91630","2020",33,32,1,333413.8,2926.061,120.1212
"30125","91631","2020",33,29,4,426656.8,3351.636,133.6364
"30126","91634","2020",23,17,6,294621.7,2923.13,113.8696
"30127","91635","2020",24,22,2,482874.6,4897.958,102.5833
"30128","91639","2020",14,13,1,256164.3,2993.714,88.92857
"30129","91645","2020",179,102,77,489703,4993.832,99.16201
"30130","91648","2020",45,23,22,215575.4,3033.756,75.55556
"30131","91649","2020",38,33,5,273563.2,3080.526,92.10526
"30132","91654","2020",9,9,0,213506.4,2812,75.66667
"30133","91657","2020",271,161,110,241731.5,3448.125,72.8893
"30134","91659","2020",69,51,18,232902.6,2863.42,83.50725
"30135","91661","2020",122,53,69,310478.9,3859.008,82.18033
"30136","91662","2020",12,12,0,280039.9,3159.917,93.75
"30137","91665","2020",83,64,19,319244,3554.024,92.93976
"30138","91666","2020",36,31,5,292372.3,3289.917,92.33333
"30139","91667","2020",88,66,22,303387,3615.205,88.53409
"30140","91671","2020",7,7,0,246747.1,2599.143,99.57143
"30141","91679","2020",17,13,4,409677.6,4554.353,92.58824
"30142","91685","2020",67,46,21,290363.1,3445.328,85.35821
"30143","91687","2020",383,162,221,220219.8,3311.909,69.55091
"30144","91689","2020",98,34,64,317833.5,4453.867,73.77551
"30145","91691","2020",437,211,226,270992.7,3462.332,80.52403
"30146","91692","2020",206,12,194,167080.7,2449.311,70.90291
"30147","92002","2020",656,204,452,409093.8,5562.238,75.34756
"30148","92004","2020",1293,104,1189,413690.5,6749.72,60.71462
"30149","92007","2020",211,46,165,339500.7,5376.194,64.54502
"30150","92009","2020",462,77,385,445455.6,6831.212,63.73593
"30151","92012","2020",1718,30,1688,570463.4,9074.307,62.27881
"30152","92014","2020",236,58,178,473265.3,6140.458,75.74153
"30153","92019","2020",349,47,302,374917.2,4867.544,76.31805
"30154","92020","2020",410,49,361,376812.6,6155.007,61.62195
"30155","92022","2020",268,58,210,407450.3,6001.821,68.10448
"30156","92023","2020",616,188,428,470714.9,6370.284,72.96266
"30157","92024","2020",631,9,622,336850.3,7198.399,46.73376
"30158","92025","2020",1015,315,700,423627.3,5928.018,68.66995
"30159","92026","2020",1044,38,1006,439658.6,7212.544,61.03448
"30160","92032","2020",213,32,181,344815.4,4977.239,69.00939
"30161","92033","2020",258,66,192,626849.4,6425.008,94.04264
"30162","92035","2020",481,41,440,453374.1,7010.11,63.26819
"30163","92036","2020",189,35,154,284578.9,4649.905,62.50265
"30164","92040","2020",695,35,660,502159.3,8171.235,60.96691
"30165","92044","2020",896,4,892,550479.2,9627.581,56.87946
"30166","92046","2020",252,59,193,446521.5,7262.413,61.11905
"30167","92047","2020",16,11,5,961555.9,7249,131.6875
"30168","92048","2020",570,71,499,441075.8,5912.488,71.66491
"30169","92049","2020",608,10,598,418508.3,7800.88,53.32401
"30170","92050","2020",572,164,408,390859.4,5862.226,67.92483
"30171","92051","2020",742,7,735,857258.6,10646.62,79.56739
"30172","92060","2020",325,32,293,377350.6,5578.834,68.07077
"30173","92062","2020",592,19,573,413292.9,7317.179,56.9848
"30174","92063","2020",987,176,811,453360.8,6125.198,72.15502
"30175","92064","2020",426,53,373,667909.2,7429.089,86.12911
"30176","92071","2020",208,48,160,620470.9,6781.212,90.125
"30177","92072","2020",317,68,249,532014.2,6508.372,78.6183
"30178","92073","2020",554,75,479,508194.5,7219.821,70.84116
"30179","92075","2020",328,18,310,388017.6,7101.216,55.13415
"30180","92076","2020",148,52,96,700365.9,6121.736,112.75
"30181","92077","2020",139,23,116,584979.3,6107.173,93.35252
"30182","92078","2020",149,11,138,201889.2,3304.919,61.33557
"30183","93001","2020",544,55,489,192740.7,4051.369,49.71875
"30184","93005","2020",601,343,258,241800.5,3455.529,73.94509
"30185","93006","2020",301,53,248,326807.8,5630.213,59.35548
"30186","93007","2020",318,178,140,239239.7,3696.063,67.80503
"30187","93008","2020",169,67,102,216049.8,3314.089,67.97041
"30188","93010","2020",385,178,207,217251.3,3431.187,65.86234
"30189","93013","2020",156,26,130,189003.4,3488.647,57.07051
"30190","93014","2020",218,68,150,144015.5,2107.358,69.09633
"30191","93015","2020",78,43,35,247353.5,2923.782,86.65385
"30192","93027","2020",164,37,127,182845.9,3171.829,61.0061
"30193","93029","2020",587,283,304,221082.3,3685.334,62.48722
"30194","93030","2020",37,6,31,171800.4,2786.757,65.18919
"30195","93031","2020",396,69,327,184530.1,2999.927,63.38889
"30196","93032","2020",502,231,271,252840.8,3608.382,71.14542
"30197","93033","2020",141,88,53,334823.3,4488.05,76.75887
"30198","93039","2020",76,4,72,225917.2,3563.842,64.69737
"30199","93045","2020",249,27,222,376049.8,7144.116,52.79116
"30200","93046","2020",638,228,410,208892.6,3232.099,66.90752
"30201","93047","2020",236,176,60,254999.7,3316.178,80.6822
"30202","93048","2020",1039,194,845,383313.7,6421.391,60.44658
"30203","93049","2020",255,109,146,278876.6,4241.776,67.62353
"30204","93050","2020",326,77,249,221640.8,3438.35,67.79448
"30205","93051","2020",787,205,582,263924.3,4183.536,66.15629
"30206","93053","2020",316,89,227,241232.3,3886.965,64.0981
"30207","93055","2020",539,29,510,334023.5,6250.226,53.40631
"30208","93057","2020",354,148,206,236363.9,3592.073,67.88983
"30209","93059","2020",197,99,98,197855.1,3069.66,66.68528
"30210","93061","2020",179,12,167,303442.8,6292.547,47.16201
"30211","93062","2020",265,77,188,338030.8,4297.377,79.36604
"30212","93063","2020",285,95,190,356522.2,5646.189,64.29474
"30213","93064","2020",504,108,396,253038.2,4002.067,65.18056
"30214","93066","2020",834,73,761,212002.9,4021.71,54.21223
"30215","93070","2020",484,28,456,339504.5,6416.998,52.94215
"30216","93071","2020",304,145,159,196987.4,2935.204,70.82566
"30217","93072","2020",159,74,85,188558,3043.157,65.16981
"30218","93073","2020",338,219,119,233950.5,3182.494,77.71302
"30219","93074","2020",89,35,54,204549.2,3148.618,68.50562
"30220","93077","2020",408,183,225,297665.8,4048.091,74.33824
"30221","93078","2020",291,164,127,214669.1,2997.997,74.44674
"30222","93079","2020",40,25,15,196049.1,3029.775,69.075
"30223","94001","2020",85,22,63,203379.8,2935.294,71.37647
"30224","94002","2020",522,61,461,285626.3,5296.51,55.28927
"30225","94003","2020",176,49,127,336851.3,6035.267,57.13068
"30226","94004","2020",190,41,149,205451.3,3029.347,70.48421
"30227","94011","2020",81,33,48,268914.4,3991.21,71.16049
"30228","94015","2020",228,73,155,406134.6,5029.592,80.48246
"30229","94016","2020",279,73,206,366261.1,5511.889,67.51613
"30230","94017","2020",811,338,473,289655.2,4138.224,72.03453
"30231","94018","2020",354,4,350,447248.5,7790.599,58.04802
"30232","94019","2020",278,93,185,290659.4,3873.651,76.07914
"30233","94021","2020",170,33,137,268539.2,3729.394,73.66471
"30234","94022","2020",517,107,410,231013.8,3898.648,61.61702
"30235","94028","2020",834,80,754,255479.6,4047.084,65.42926
"30236","94033","2020",596,175,421,404850.2,6167.169,66.44463
"30237","94034","2020",348,39,309,236899.7,3536.764,67.85345
"30238","94037","2020",138,19,119,313608,6102.464,53.80435
"30239","94038","2020",310,88,222,322168.9,4550.11,73.38387
"30240","94041","2020",462,46,416,286951.4,5365.896,54.19481
"30241","94042","2020",275,61,214,396231.3,5989.582,66.39636
"30242","94043","2020",196,10,186,312556.4,6185.959,52.87755
"30243","94044","2020",352,95,257,220892.9,3305.497,69.36932
"30244","94046","2020",677,115,562,345449.2,5809.068,60.14771
"30245","94047","2020",61,45,16,307963.1,3378.672,94.40984
"30246","94048","2020",43,37,6,376747,3374.395,114.8372
"30247","94052","2020",613,81,532,439492,6609.217,66.07993
"30248","94053","2020",55,32,23,328885.9,3981.255,84.34545
"30249","94054","2020",187,69,118,244992,3599.578,68.51872
"30250","94055","2020",132,127,5,402012.3,4601.045,93.78788
"30251","94056","2020",43,33,10,269116.2,3188.186,90.16279
"30252","94058","2020",617,127,490,376217.5,5708.042,65.60454
"30253","94059","2020",306,80,226,280161.1,3751.183,75.66013
"30254","94060","2020",118,90,28,272512.7,3375.822,84.08475
"30255","94065","2020",61,11,50,272246.7,3863.656,69.68852
"30256","94067","2020",301,12,289,627175.9,9243.169,66.53488
"30257","94068","2020",1260,414,846,465838.1,6168.233,75.56349
"30258","94069","2020",196,10,186,369135.2,6248.52,59.90816
"30259","94070","2020",52,44,8,427266,3273.904,136.9423
"30260","94071","2020",319,175,144,346969.1,4022.828,89.59875
"30261","94073","2020",406,87,319,267314.6,3943.65,68.63054
"30262","94074","2020",65,30,35,255372.7,3488.015,76.4
"30263","94075","2020",164,112,52,314717.3,3430.476,98.73171
"30264","94076","2020",448,94,354,312119.3,5419.699,59.77679
"30265","94077","2020",201,111,90,240030.5,3916.279,66.29851
"30266","94078","2020",266,100,166,172499.9,3034.342,59.51128
"30267","94079","2020",350,129,221,298238.6,4182.231,72.04286
"30268","94080","2020",764,21,743,491404.4,8940.134,54.41099
"30269","94081","2020",650,184,466,282212.2,4520.808,63.66
"30270","95002","2020",17,15,2,378000.9,2835.824,148.2941
"30271","95008","2020",16,15,1,224062.5,2226.438,106.9375
"30272","95011","2020",10,9,1,220450,2626.1,88.5
"30273","95012","2020",5,3,2,120000,1671.4,79.8
"30274","95014","2020",24,18,6,410605.4,3937.292,106.4583
"30275","95018","2020",1156,473,683,231809.5,3608.162,66.99308
"30276","95019","2020",131,89,42,247200.8,3239.916,80.0687
"30277","95023","2020",8,8,0,318106.2,3046.375,102.75
"30278","95024","2020",2,2,0,174000,2524.5,70
"30279","95026","2020",52,42,10,296572,2838.481,103.8077
"30280","95028","2020",21,15,6,284193.8,3524.381,85.85714
"30281","95039","2020",133,116,17,308466.5,3921.113,85.82707
"30282","95040","2020",10,10,0,290050,2869.1,107
"30283","95042","2020",37,33,4,282914.7,3049.108,94.2973
"30284","95046","2020",2,2,0,181820,1774,103
"30285","95051","2020",140,98,42,326275.4,4058.714,83.26429
"30286","95052","2020",179,65,114,174517.6,2969.911,62.17877
"30287","95054","2020",3,2,1,193770,2050,91.66667
"30288","95055","2020",9,7,2,207238.9,2897.556,73.88889
"30289","95056","2020",24,21,3,242229.2,3144.5,84.66667
"30290","95058","2020",23,22,1,272697.8,2873.174,100.5652
"30291","95059","2020",9,9,0,306778.9,2507.444,125.3333
"30292","95060","2020",107,69,38,300361.4,3884.318,81.6729
"30293","95061","2020",7,7,0,326722.9,2938.714,115.2857
"30294","95063","2020",344,146,198,274076.4,4153.849,66.83721
"30295","95074","2020",10,9,1,351098,3420.3,111.6
"30296","95078","2020",29,20,9,254045.7,2867.069,92.2069
"30297","95088","2020",11,4,7,194859.1,3194.455,61.63636
"30298","95091","2020",65,50,15,289182.7,3369.923,89.04615
"30299","95094","2020",4,3,1,266250,3522.75,81.25
"30300","95101","2020",6,6,0,157948.7,1971.667,88.33333
"30301","95102","2020",8,8,0,447481.2,3024.25,148.5
"30302","95110","2020",1,1,0,266000,3023,88
"30303","95116","2020",51,48,3,243597.9,2797.667,88.72549
"30304","95119","2020",8,8,0,189696.8,2300.5,87.875
"30305","95120","2020",37,36,1,321348.6,3589.865,97.81081
"30306","95127","2020",733,170,563,198070.7,3065.542,68.69031
"30307","95134","2020",61,52,9,301140.8,3278.656,99.85246
"30308","95139","2020",1,1,0,155000,1449,107
"30309","95142","2020",38,31,7,224173.9,2896.158,82.10526
"30310","95149","2020",45,41,4,288072.9,3113.644,99.33333
"30311","95150","2020",10,10,0,195910,2079.1,95.9
"30312","95151","2020",5,5,0,295160,3579.4,85.8
"30313","95154","2020",3,3,0,301333.3,2743.333,107.6667
"30314","95157","2020",2,2,0,220000,2698,81.5
"30315","95166","2020",7,7,0,297414.3,2799.571,111.8571
"30316","95169","2020",11,10,1,277072.7,2715.545,103
"30317","95170","2020",4,3,1,271250,2852,106.75
"30318","95176","2020",348,177,171,316418.9,4299.486,75.90805
"30319","95177","2020",21,20,1,321631,2953.619,116.4286
"30320","95181","2020",4,3,1,257711.2,3045.5,87
"30321","95183","2020",86,51,35,272047.7,3285.419,86.03488
"30322","95197","2020",313,113,200,280086.8,3786.45,73.90415
"30323","95199","2020",214,92,122,237591.4,3405.864,73.36916
"30324","95203","2020",281,127,154,305403.4,4045.865,77.85765
"30325","95205","2020",96,47,49,244930.5,3186.646,79.48958
"30326","95210","2020",201,41,160,422599.2,5566.214,74.45274
"30327","95211","2020",33,29,4,307764.5,3297.697,96.27273
"30328","95213","2020",11,11,0,336995.5,3156.636,112.3636
"30329","95214","2020",1,1,0,385000,2567,150
"30330","95218","2020",255,114,141,249055.8,3159.78,80.96078
"30331","95219","2020",296,103,193,285783.9,3929.128,75.10135
"30332","95229","2020",137,57,80,239904.4,3291.343,75.10219
"30333","95241","2020",29,22,7,254090.1,3021,87.41379
"30334","95250","2020",110,94,16,232757.6,2972.5,82.32727
"30335","95252","2020",549,123,426,215475.7,3149.922,69.61202
"30336","95253","2020",5,3,2,274860,2853.2,97.6
"30337","95254","2020",6,6,0,327416.7,3086.667,106
"30338","95256","2020",44,34,10,319940.1,3622.727,90
"30339","95257","2020",78,55,23,322266.8,3966.5,83.37179
"30340","95258","2020",6,5,1,264550,3157.333,89
"30341","95268","2020",175,56,119,162157.3,2464.874,66.66857
"30342","95270","2020",12,9,3,232558.3,1963.75,128.75
"30343","95271","2020",8,8,0,351750,3326.125,112.25
"30344","95277","2020",181,86,95,201847.3,3029.409,70.55801
"30345","95280","2020",232,197,35,234728.2,3381.905,75.81897
"30346","95282","2020",1,1,0,225000,1923,117
"30347","95287","2020",8,7,1,316925,3733.625,87
"30348","95288","2020",117,69,48,280353.9,3479.718,82.58974
"30349","95295","2020",1,1,0,331000,5172,64
"30350","95298","2020",13,13,0,339310.8,2849.538,122.8462
"30351","95301","2020",13,10,3,204018.5,2357.846,86.76923
"30352","95303","2020",5,2,3,219850.2,2581.8,90.2
"30353","95304","2020",5,5,0,284009.8,3570.2,98.8
"30354","95306","2020",385,203,182,295173.9,3963.875,77.16883
"30355","95308","2020",10,6,4,248588,3654.2,79.3
"30356","95309","2020",2,2,0,311975,2476,126
"30357","95313","2020",206,85,121,299796.6,3916.049,79.21359
"30358","95316","2020",4,4,0,216925,2528,99.5
"30359","95323","2020",201,166,35,267987,3048.687,91.77114
"30360","95328","2020",11,6,5,323353.2,2980.364,103.7273
"30361","95341","2020",3,3,0,428050,3653.333,127.6667
"30362","95348","2020",2,2,0,220400,2801.5,76.5
"30363","95351","2020",114,62,52,211927,3004.798,73.58772
"30364","95352","2020",68,47,21,281752.1,3148.309,91.61765
"30365","95353","2020",31,18,13,263941.9,3497.032,80.32258
"30366","95355","2020",80,63,17,229944.8,2778.95,87.775
"30367","95365","2020",11,11,0,311113.4,2884.545,107.5455
"30368","95369","2020",31,14,17,335506,3688.355,96.35484
"30369","95370","2020",55,44,11,234001.1,2965.655,85.14545
"30370","95371","2020",74,67,7,237441.1,3016.095,84.09459
"30371","95387","2020",1,1,0,595650,2949,202
"30372","95388","2020",65,47,18,236924.9,2975.585,81.78462
"30373","95392","2020",87,72,15,312117.1,3393.908,93.88506
"30374","95394","2020",138,91,47,274891.7,3422.5,82.76812
"30375","95395","2020",12,11,1,291500,2796,107.4167
"30376","95409","2020",19,10,9,217868.4,3145.579,75.15789
"30377","95422","2020",8,7,1,292343.8,3175.875,97.25
"30378","95424","2020",241,111,130,251592.4,3388.282,75.40249
"30379","95426","2020",46,39,7,428571.6,3909.826,113.413
"30380","95427","2020",153,63,90,232807.8,3090.255,77.11765
"30381","95428","2020",347,130,217,353650.1,4020.311,88.36311
"30382","95429","2020",5,5,0,279594.2,1970.2,154.6
"30383","95430","2020",54,43,11,303815.2,3212.648,97.51852
"30384","95436","2020",14,13,1,305321.4,3171.429,100.7143
"30385","95438","2020",2,2,0,363000,2550,142.5
"30386","95445","2020",6,6,0,266104.8,2819.5,95.5
"30387","95446","2020",31,29,2,308108.1,3176,111.6129
"30388","95447","2020",3,3,0,289400,1814.667,158.3333
"30389","95450","2020",19,18,1,390242.4,3671.474,109.3684
"30390","95452","2020",16,11,5,276403.1,3145.125,91.375
"30391","95456","2020",11,10,1,286836.4,2500.182,123.3636
"30392","95459","2020",13,12,1,311721.2,3008.231,112.0769
"30393","95462","2020",6,6,0,304333.3,2404.333,144.1667
"30394","95476","2020",177,138,39,284629.7,3397.028,89.0452
"30395","95480","2020",98,83,15,325158.4,3649.878,94.68367
"30396","95483","2020",2,2,0,370000,3380.5,119.5
"30397","95487","2020",112,51,61,190334.5,2874.259,67.625
"30398","95488","2020",108,62,46,259752.5,3644.917,76.46296
"30399","95489","2020",9,9,0,433822.2,3259.667,143.3333
"30400","95491","2020",134,63,71,270936.8,3653.284,76.3806
"30401","95493","2020",3,3,0,212533.3,2179,97.33333
"30402","95500","2020",445,124,321,212895.2,3176.935,70.19775
"30403","95504","2020",59,51,8,288475.2,3452.22,89.62712
"30404","95509","2020",47,40,7,258508.5,3069.894,87.59574
"30405","95510","2020",5,3,2,390890,2949.2,130.4
"30406","95523","2020",10,5,5,131300,2089.5,61.9
"30407","95527","2020",27,16,11,221211.5,3507.222,67.59259
"30408","95529","2020",14,14,0,344871.4,2916,138.5714
"30409","95535","2020",9,9,0,396228.3,3170.556,130.1111
"30410","95539","2020",192,94,98,278702.6,3460.995,81.18229
"30411","95541","2020",11,9,2,196954.5,1963,100.0909
"30412","95543","2020",3,3,0,286333.3,2629,122.6667
"30413","95554","2020",16,16,0,236618.9,2723.25,95.0625
"30414","95555","2020",232,57,175,288986,3899.599,73.33621
"30415","95563","2020",259,137,122,291034.6,3999.042,76.21622
"30416","95566","2020",30,25,5,228805.7,2974,82.16667
"30417","95572","2020",267,81,186,201148.9,3176.596,66.1985
"30418","95574","2020",95,72,23,409232.1,4158.632,102.3158
"30419","95580","2020",28,24,4,444593.9,2990.857,154.25
"30420","95582","2020",402,133,269,252064.4,3726.095,69.76119
"30421","95584","2020",7,5,2,235451.4,2696.714,89.71429
"30422","95585","2020",297,81,216,175874.1,2380.896,75.85522
"30423","95592","2020",28,27,1,285967.3,2981.536,106.1429
"30424","95594","2020",23,17,6,263482.6,3049.13,89.86957
"30425","95598","2020",230,128,102,333434.5,3961.922,84.82609
"30426","95604","2020",58,22,36,198253.5,2560.5,79.53448
"30427","95607","2020",367,152,215,248258.3,3363.602,75.20436
"30428","95610","2020",3,3,0,342383.3,3153.333,113.3333
"30429","95611","2020",1,1,0,280000,4746,59
"30430","95612","2020",51,34,17,218714.1,3156.216,72.96078
"30431","95625","2020",14,14,0,275605.7,3287.643,86.64286
"30432","95627","2020",11,10,1,334990.8,2945.273,118.6364
"30433","95628","2020",38,33,5,324895.6,3569.342,95.42105
"30434","95637","2020",201,133,68,274993.1,3377.99,83.73632
"30435","95641","2020",50,30,20,267136.7,3192.26,88.7
"30436","95651","2020",22,21,1,250477.5,2351.818,115.5455
"30437","95652","2020",78,61,17,268045.5,3122.244,88.94872
"30438","95656","2020",3,3,0,211333.3,2154,97
"30439","95658","2020",20,20,0,375394.8,3132.35,125.75
"30440","95660","2020",10,8,2,300125,3761.6,83.6
"30441","95675","2020",17,9,8,264970.6,3184.529,92.41176
"30442","95676","2020",11,11,0,246482.3,2604.636,107.8182
"30443","95678","2020",17,15,2,340220.4,3322.588,112.4118
"30444","95680","2020",138,51,87,168773.1,2552.283,69.33333
"30445","95682","2020",1,1,0,393606,3280,120
"30446","95690","2020",5,5,0,230000,3072.4,76.6
"30447",NA,"2020",8675,NA,NA,202507.2,2694.542,76.20507
